time,subj_course_id,sec_code,sec_id,prof,available,waitlist,total,enrolled_ct
1650539673986,COGS 9,A01,083615,Staff,0,16,60,60
1650539680020,COGS 11,A01,083617,Boyle; Mary E. T.,19,0,40,21
1650539686052,COGS 13,A01,083071,Staff,0,35,40,40
1650539692082,COGS 14A,A01,092681,Staff,0,26,100,100
1650539698116,COGS 14B,A01,083073,Cheng; Tzu-Han,0,12,50,50
1650539704147,COGS 17,A01,092677,Staff,19,0,75,56
1650539710179,COGS 100,A01,083619,Staff,0,26,60,60
1650539716216,COGS 101A,A01,083621,Davis; Joshua Daniel,0,26,60,60
1650539722243,COGS 101B,A01,091572,Staff,1,5,60,59
1650539728277,COGS 101C,A01,083625,Delgado; Tania,15,0,30,15
1650539734310,COGS 107A,A01,083627,Boyle; Mary E. T.,0,11,60,60
1650539740336,COGS 118A,A01,083075,Staff,0,3,60,60
1650539746373,CSE 3,A50,083646,Miranda; Gregory Joseph,20,0,38,18
1650539746373,CSE 3,A51,083647,Miranda; Gregory Joseph,36,0,37,1
1650539752403,CSE 8A,A50,083650,Miranda; Gregory Joseph,0,29,40,40
1650539758437,CSE 11,A01,083080,Cao; Yingjun,0,94,40,40
1650539764471,CSE 12,A01,083652,Staff,0,17,100,100
1650539770498,CSE 15L,A01,083654,Staff,0,1,50,50
1650539770498,CSE 15L,A02,083655,Staff,0,0,50,50
1650539776530,CSE 20,A01,083657,Staff,51,0,80,29
1650539782561,CSE 30,A01,083084,Eldon; John,0,77,40,40
1650539788590,CSE 100,A01,083659,Cao; Yingjun,0,66,50,50
1650539794624,CSE 134B,A01,083661,Powell; Thomas Allan,0,34,65,65
1650539800652,CSE 140,A01,083663,Staff,0,5,75,75
1650539806697,CSE 140L,A01,083088,Eldon; John,0,11,75,75
1650539812727,CSE 175,A01,083665,Kumar; Rakesh,7,0,25,18
1650539818760,CSE 190,A00,092507,Dubnov; Shlomo,10,0,20,10
1650539824795,ECE 45,A01,083139,Staff,0,1,60,60
1650539830842,ECE 65,A50,083695,Staff,0,6,30,30
1650539836875,ECE 109,A01,091882,Touri; Behrouz,33,0,70,37
1650539842907,ECE 180,A00,083140,Abi Samra; Nicholas Camill,21,0,30,9
1650539842907,ECE 180,B00,083141,Abi Samra; Nicholas Camill,0,0,30,30
1650539848939,MATH 10A,A01,083735,Patchell; Gregory David,5,0,30,25
1650539848939,MATH 10A,A02,083736,Patchell; Gregory David,27,0,30,3
1650539848939,MATH 10A,A03,083737,Patchell; Gregory David,24,0,30,6
1650539854967,MATH 10B,A01,083207,Staff,0,9,30,30
1650539854967,MATH 10B,A02,083208,Staff,0,7,30,30
1650539854967,MATH 10B,B01,083739,Staff,12,0,30,18
1650539854967,MATH 10B,B02,083740,Staff,28,0,30,2
1650539860997,MATH 18,A01,083743,Staff,1,0,30,29
1650539860997,MATH 18,A02,083744,Staff,26,0,30,4
1650539860997,MATH 18,A03,083745,Staff,22,0,30,8
1650539860997,MATH 18,A04,083746,Staff,26,0,30,4
1650539860997,MATH 18,B01,083748,Staff,0,12,30,30
1650539860997,MATH 18,B02,083749,Staff,0,12,30,30
1650539860997,MATH 18,B03,083750,Staff,0,11,30,30
1650539860997,MATH 18,B04,083751,Staff,0,12,30,30
1650539867026,MATH 20A,A01,083754,Staff,22,0,40,18
1650539873060,MATH 20B,A01,083756,Staff,0,11,30,30
1650539873060,MATH 20B,A02,083757,Staff,0,12,30,30
1650539879091,MATH 20C,A01,083760,Staff,0,16,30,30
1650539879091,MATH 20C,A02,083761,Staff,2,14,30,28
1650539879091,MATH 20C,B01,083762,Staff,12,0,30,18
1650539879091,MATH 20C,B02,083763,Staff,28,0,30,2
1650539885124,MATH 20D,A01,083765,Staff,0,1,30,30
1650539885124,MATH 20D,A02,083766,Staff,7,0,30,23
1650539885124,MATH 20D,A03,083767,Staff,25,0,30,5
1650539891152,MATH 20E,A01,083771,Staff,6,0,30,24
1650539891152,MATH 20E,A02,083772,Staff,18,0,30,12
1650539891152,MATH 20E,B01,083773,Staff,0,0,30,30
1650539891152,MATH 20E,B02,083774,Staff,10,0,30,20
1650539897187,MATH 103A,A01,083777,Staff,0,15,30,30
1650539897187,MATH 103A,A02,083778,Staff,0,14,30,30
1650539897187,MATH 103A,B01,083779,Staff,0,13,30,30
1650539897187,MATH 103A,B02,083780,Staff,0,13,30,30
1650539903216,MATH 105,A01,085443,Staff,0,21,30,30
1650539909246,MATH 109,A01,083213,Anzaldo; Leesa B,0,8,30,30
1650539909246,MATH 109,A02,083214,Anzaldo; Leesa B,0,7,30,30
1650539909246,MATH 109,B01,083215,Anzaldo; Leesa B,0,5,30,30
1650539909246,MATH 109,B02,083216,Anzaldo; Leesa B,0,6,30,30
1650539915287,MATH 142A,A01,083219,Chow; Bennett,0,16,30,30
1650539915287,MATH 142A,A02,083220,Chow; Bennett,0,14,30,30
1650539915287,MATH 142A,B01,083221,Chow; Bennett,0,13,30,30
1650539915287,MATH 142A,B02,083222,Chow; Bennett,0,13,30,30
1650539921315,MATH 193A,A01,083224,Staff,0,6,30,30
1650539921315,MATH 193A,A02,083225,Staff,0,5,30,30
1650539921315,MATH 193A,A03,083781,Staff,0,5,30,30
1650539921315,MATH 193A,A04,083782,Staff,0,7,30,30
1650539927340,MATH 197,001,091859,McAuley; Julian John,9998,0,9999,1
1650539933428,COGS 9,A01,083615,Staff,0,16,60,60
1650539939458,COGS 11,A01,083617,Boyle; Mary E. T.,19,0,40,21
1650539945483,COGS 13,A01,083071,Staff,0,35,40,40
1650539951515,COGS 14A,A01,092681,Staff,0,26,100,100
1650539957546,COGS 14B,A01,083073,Cheng; Tzu-Han,0,12,50,50
1650539963587,COGS 17,A01,092677,Staff,19,0,75,56
1650539969615,COGS 100,A01,083619,Staff,0,26,60,60
1650539975644,COGS 101A,A01,083621,Davis; Joshua Daniel,0,26,60,60
1650539981676,COGS 101B,A01,091572,Staff,1,5,60,59
1650539987708,COGS 101C,A01,083625,Delgado; Tania,15,0,30,15
1650539993735,COGS 107A,A01,083627,Boyle; Mary E. T.,0,11,60,60
1650539999761,COGS 118A,A01,083075,Staff,0,3,60,60
1650540005795,CSE 3,A50,083646,Miranda; Gregory Joseph,20,0,38,18
1650540005795,CSE 3,A51,083647,Miranda; Gregory Joseph,36,0,37,1
1650540011823,CSE 8A,A50,083650,Miranda; Gregory Joseph,0,29,40,40
1650540017854,CSE 11,A01,083080,Cao; Yingjun,0,94,40,40
1650540023886,CSE 12,A01,083652,Staff,0,17,100,100
1650540029916,CSE 15L,A01,083654,Staff,0,1,50,50
1650540029916,CSE 15L,A02,083655,Staff,0,0,50,50
1650540035943,CSE 20,A01,083657,Staff,51,0,80,29
1650540041975,CSE 30,A01,083084,Eldon; John,0,77,40,40
1650540048004,CSE 100,A01,083659,Cao; Yingjun,0,66,50,50
1650540054039,CSE 134B,A01,083661,Powell; Thomas Allan,0,34,65,65
1650540060068,CSE 140,A01,083663,Staff,0,5,75,75
1650540066307,CSE 140L,A01,083088,Eldon; John,0,11,75,75
1650540072333,CSE 175,A01,083665,Kumar; Rakesh,7,0,25,18
1650540078925,CSE 190,A00,092507,Dubnov; Shlomo,10,0,20,10
1650540084953,ECE 45,A01,083139,Staff,0,1,60,60
1650540090983,ECE 65,A50,083695,Staff,0,6,30,30
1650540097015,ECE 109,A01,091882,Touri; Behrouz,33,0,70,37
1650540103044,ECE 180,A00,083140,Abi Samra; Nicholas Camill,21,0,30,9
1650540103044,ECE 180,B00,083141,Abi Samra; Nicholas Camill,0,0,30,30
1650540109082,MATH 10A,A01,083735,Patchell; Gregory David,5,0,30,25
1650540109082,MATH 10A,A02,083736,Patchell; Gregory David,27,0,30,3
1650540109082,MATH 10A,A03,083737,Patchell; Gregory David,24,0,30,6
1650540115111,MATH 10B,A01,083207,Staff,0,9,30,30
1650540115111,MATH 10B,A02,083208,Staff,0,7,30,30
1650540115111,MATH 10B,B01,083739,Staff,12,0,30,18
1650540115111,MATH 10B,B02,083740,Staff,28,0,30,2
1650540121144,MATH 18,A01,083743,Staff,1,0,30,29
1650540121144,MATH 18,A02,083744,Staff,26,0,30,4
1650540121144,MATH 18,A03,083745,Staff,22,0,30,8
1650540121144,MATH 18,A04,083746,Staff,26,0,30,4
1650540121144,MATH 18,B01,083748,Staff,0,12,30,30
1650540121144,MATH 18,B02,083749,Staff,0,12,30,30
1650540121144,MATH 18,B03,083750,Staff,0,11,30,30
1650540121144,MATH 18,B04,083751,Staff,0,12,30,30
1650540127176,MATH 20A,A01,083754,Staff,22,0,40,18
1650540133205,MATH 20B,A01,083756,Staff,0,11,30,30
1650540133205,MATH 20B,A02,083757,Staff,0,12,30,30
1650540139233,MATH 20C,A01,083760,Staff,0,16,30,30
1650540139233,MATH 20C,A02,083761,Staff,2,14,30,28
1650540139233,MATH 20C,B01,083762,Staff,12,0,30,18
1650540139233,MATH 20C,B02,083763,Staff,28,0,30,2
1650540145257,MATH 20D,A01,083765,Staff,0,1,30,30
1650540145257,MATH 20D,A02,083766,Staff,7,0,30,23
1650540145257,MATH 20D,A03,083767,Staff,25,0,30,5
1650540151290,MATH 20E,A01,083771,Staff,6,0,30,24
1650540151290,MATH 20E,A02,083772,Staff,18,0,30,12
1650540151290,MATH 20E,B01,083773,Staff,0,0,30,30
1650540151290,MATH 20E,B02,083774,Staff,10,0,30,20
1650540157324,MATH 103A,A01,083777,Staff,0,15,30,30
1650540157324,MATH 103A,A02,083778,Staff,0,14,30,30
1650540157324,MATH 103A,B01,083779,Staff,0,13,30,30
1650540157324,MATH 103A,B02,083780,Staff,0,13,30,30
1650540163350,MATH 105,A01,085443,Staff,0,21,30,30
1650540169382,MATH 109,A01,083213,Anzaldo; Leesa B,0,8,30,30
1650540169382,MATH 109,A02,083214,Anzaldo; Leesa B,0,7,30,30
1650540169382,MATH 109,B01,083215,Anzaldo; Leesa B,0,5,30,30
1650540169382,MATH 109,B02,083216,Anzaldo; Leesa B,0,6,30,30
1650540175410,MATH 142A,A01,083219,Chow; Bennett,0,16,30,30
1650540175410,MATH 142A,A02,083220,Chow; Bennett,0,14,30,30
1650540175410,MATH 142A,B01,083221,Chow; Bennett,0,13,30,30
1650540175410,MATH 142A,B02,083222,Chow; Bennett,0,13,30,30
1650540181440,MATH 193A,A01,083224,Staff,0,6,30,30
1650540181440,MATH 193A,A02,083225,Staff,0,5,30,30
1650540181440,MATH 193A,A03,083781,Staff,0,5,30,30
1650540181440,MATH 193A,A04,083782,Staff,0,7,30,30
1650540187478,MATH 197,001,091859,McAuley; Julian John,9998,0,9999,1
1650540193571,COGS 9,A01,083615,Staff,0,16,60,60
1650540199601,COGS 11,A01,083617,Boyle; Mary E. T.,19,0,40,21
1650540205630,COGS 13,A01,083071,Staff,0,35,40,40
1650540211658,COGS 14A,A01,092681,Staff,0,26,100,100
1650540217692,COGS 14B,A01,083073,Cheng; Tzu-Han,0,12,50,50
1650540223721,COGS 17,A01,092677,Staff,19,0,75,56
1650540229757,COGS 100,A01,083619,Staff,0,26,60,60
1650540235784,COGS 101A,A01,083621,Davis; Joshua Daniel,0,26,60,60
1650540241812,COGS 101B,A01,091572,Staff,1,5,60,59
1650540247919,COGS 101C,A01,083625,Delgado; Tania,15,0,30,15
1650540253946,COGS 107A,A01,083627,Boyle; Mary E. T.,0,11,60,60
1650540259978,COGS 118A,A01,083075,Staff,0,3,60,60
1650540266007,CSE 3,A50,083646,Miranda; Gregory Joseph,20,0,38,18
1650540266007,CSE 3,A51,083647,Miranda; Gregory Joseph,36,0,37,1
1650540272035,CSE 8A,A50,083650,Miranda; Gregory Joseph,0,29,40,40
1650540278067,CSE 11,A01,083080,Cao; Yingjun,0,94,40,40
1650540284099,CSE 12,A01,083652,Staff,0,17,100,100
1650540290131,CSE 15L,A01,083654,Staff,0,1,50,50
1650540290131,CSE 15L,A02,083655,Staff,0,0,50,50
1650540296159,CSE 20,A01,083657,Staff,51,0,80,29
1650540302188,CSE 30,A01,083084,Eldon; John,0,77,40,40
1650540308215,CSE 100,A01,083659,Cao; Yingjun,0,66,50,50
1650540314240,CSE 134B,A01,083661,Powell; Thomas Allan,0,34,65,65
1650540320271,CSE 140,A01,083663,Staff,0,5,75,75
1650540326301,CSE 140L,A01,083088,Eldon; John,0,11,75,75
1650540332337,CSE 175,A01,083665,Kumar; Rakesh,7,0,25,18
1650540338369,CSE 190,A00,092507,Dubnov; Shlomo,10,0,20,10
1650540344397,ECE 45,A01,083139,Staff,0,1,60,60
1650540350429,ECE 65,A50,083695,Staff,0,6,30,30
1650540356461,ECE 109,A01,091882,Touri; Behrouz,33,0,70,37
1650540362494,ECE 180,A00,083140,Abi Samra; Nicholas Camill,21,0,30,9
1650540362494,ECE 180,B00,083141,Abi Samra; Nicholas Camill,0,0,30,30
1650540368530,MATH 10A,A01,083735,Patchell; Gregory David,5,0,30,25
1650540368530,MATH 10A,A02,083736,Patchell; Gregory David,27,0,30,3
1650540368530,MATH 10A,A03,083737,Patchell; Gregory David,24,0,30,6
1650540374564,MATH 10B,A01,083207,Staff,0,9,30,30
1650540374564,MATH 10B,A02,083208,Staff,0,7,30,30
1650540374564,MATH 10B,B01,083739,Staff,12,0,30,18
1650540374564,MATH 10B,B02,083740,Staff,28,0,30,2
1650540380594,MATH 18,A01,083743,Staff,1,0,30,29
1650540380594,MATH 18,A02,083744,Staff,26,0,30,4
1650540380594,MATH 18,A03,083745,Staff,22,0,30,8
1650540380594,MATH 18,A04,083746,Staff,26,0,30,4
1650540380594,MATH 18,B01,083748,Staff,0,12,30,30
1650540380594,MATH 18,B02,083749,Staff,0,12,30,30
1650540380594,MATH 18,B03,083750,Staff,0,11,30,30
1650540380594,MATH 18,B04,083751,Staff,0,12,30,30
1650540386624,MATH 20A,A01,083754,Staff,22,0,40,18
1650540392651,MATH 20B,A01,083756,Staff,0,11,30,30
1650540392651,MATH 20B,A02,083757,Staff,0,12,30,30
1650540398688,MATH 20C,A01,083760,Staff,0,16,30,30
1650540398688,MATH 20C,A02,083761,Staff,2,14,30,28
1650540398688,MATH 20C,B01,083762,Staff,12,0,30,18
1650540398688,MATH 20C,B02,083763,Staff,28,0,30,2
1650540404713,MATH 20D,A01,083765,Staff,0,1,30,30
1650540404713,MATH 20D,A02,083766,Staff,7,0,30,23
1650540404713,MATH 20D,A03,083767,Staff,25,0,30,5
1650540410748,MATH 20E,A01,083771,Staff,6,0,30,24
1650540410748,MATH 20E,A02,083772,Staff,18,0,30,12
1650540410748,MATH 20E,B01,083773,Staff,0,0,30,30
1650540410748,MATH 20E,B02,083774,Staff,10,0,30,20
1650540416777,MATH 103A,A01,083777,Staff,0,15,30,30
1650540416777,MATH 103A,A02,083778,Staff,0,14,30,30
1650540416777,MATH 103A,B01,083779,Staff,0,13,30,30
1650540416777,MATH 103A,B02,083780,Staff,0,13,30,30
1650540422816,MATH 105,A01,085443,Staff,0,21,30,30
1650540428843,MATH 109,A01,083213,Anzaldo; Leesa B,0,8,30,30
1650540428843,MATH 109,A02,083214,Anzaldo; Leesa B,0,7,30,30
1650540428843,MATH 109,B01,083215,Anzaldo; Leesa B,0,5,30,30
1650540428843,MATH 109,B02,083216,Anzaldo; Leesa B,0,6,30,30
1650540434877,MATH 142A,A01,083219,Chow; Bennett,0,16,30,30
1650540434877,MATH 142A,A02,083220,Chow; Bennett,0,14,30,30
1650540434877,MATH 142A,B01,083221,Chow; Bennett,0,13,30,30
1650540434877,MATH 142A,B02,083222,Chow; Bennett,0,13,30,30
1650540440905,MATH 193A,A01,083224,Staff,0,6,30,30
1650540440905,MATH 193A,A02,083225,Staff,0,5,30,30
1650540440905,MATH 193A,A03,083781,Staff,0,5,30,30
1650540440905,MATH 193A,A04,083782,Staff,0,7,30,30
1650540446934,MATH 197,001,091859,McAuley; Julian John,9998,0,9999,1
1650540453007,COGS 9,A01,083615,Staff,0,16,60,60
1650540459034,COGS 11,A01,083617,Boyle; Mary E. T.,19,0,40,21
1650540465062,COGS 13,A01,083071,Staff,0,35,40,40
1650540471092,COGS 14A,A01,092681,Staff,0,26,100,100
1650540477120,COGS 14B,A01,083073,Cheng; Tzu-Han,0,12,50,50
1650540483145,COGS 17,A01,092677,Staff,19,0,75,56
1650540489173,COGS 100,A01,083619,Staff,0,26,60,60
1650540495206,COGS 101A,A01,083621,Davis; Joshua Daniel,0,26,60,60
1650540501234,COGS 101B,A01,091572,Staff,1,5,60,59
1650540507259,COGS 101C,A01,083625,Delgado; Tania,15,0,30,15
1650540513286,COGS 107A,A01,083627,Boyle; Mary E. T.,0,11,60,60
1650540519312,COGS 118A,A01,083075,Staff,0,3,60,60
1650540525346,CSE 3,A50,083646,Miranda; Gregory Joseph,20,0,38,18
1650540525346,CSE 3,A51,083647,Miranda; Gregory Joseph,36,0,37,1
1650540531376,CSE 8A,A50,083650,Miranda; Gregory Joseph,0,29,40,40
1650540537404,CSE 11,A01,083080,Cao; Yingjun,0,94,40,40
1650540543430,CSE 12,A01,083652,Staff,0,17,100,100
1650540549459,CSE 15L,A01,083654,Staff,0,1,50,50
1650540549459,CSE 15L,A02,083655,Staff,0,0,50,50
1650540555492,CSE 20,A01,083657,Staff,51,0,80,29
1650540561529,CSE 30,A01,083084,Eldon; John,0,77,40,40
1650540567557,CSE 100,A01,083659,Cao; Yingjun,0,66,50,50
1650540573589,CSE 134B,A01,083661,Powell; Thomas Allan,0,34,65,65
1650540579615,CSE 140,A01,083663,Staff,0,5,75,75
1650540585644,CSE 140L,A01,083088,Eldon; John,0,11,75,75
1650540591674,CSE 175,A01,083665,Kumar; Rakesh,7,0,25,18
1650540597702,CSE 190,A00,092507,Dubnov; Shlomo,10,0,20,10
1650540603732,ECE 45,A01,083139,Staff,0,1,60,60
1650540609760,ECE 65,A50,083695,Staff,0,6,30,30
1650540615793,ECE 109,A01,091882,Touri; Behrouz,33,0,70,37
1650540621825,ECE 180,A00,083140,Abi Samra; Nicholas Camill,21,0,30,9
1650540621825,ECE 180,B00,083141,Abi Samra; Nicholas Camill,0,0,30,30
1650540627852,MATH 10A,A01,083735,Patchell; Gregory David,5,0,30,25
1650540627852,MATH 10A,A02,083736,Patchell; Gregory David,27,0,30,3
1650540627852,MATH 10A,A03,083737,Patchell; Gregory David,24,0,30,6
1650540633885,MATH 10B,A01,083207,Staff,0,9,30,30
1650540633885,MATH 10B,A02,083208,Staff,0,7,30,30
1650540633885,MATH 10B,B01,083739,Staff,12,0,30,18
1650540633885,MATH 10B,B02,083740,Staff,28,0,30,2
1650540639916,MATH 18,A01,083743,Staff,1,0,30,29
1650540639916,MATH 18,A02,083744,Staff,26,0,30,4
1650540639916,MATH 18,A03,083745,Staff,22,0,30,8
1650540639916,MATH 18,A04,083746,Staff,26,0,30,4
1650540639916,MATH 18,B01,083748,Staff,0,12,30,30
1650540639916,MATH 18,B02,083749,Staff,0,12,30,30
1650540639916,MATH 18,B03,083750,Staff,0,11,30,30
1650540639916,MATH 18,B04,083751,Staff,0,12,30,30
1650540645944,MATH 20A,A01,083754,Staff,22,0,40,18
1650540651974,MATH 20B,A01,083756,Staff,0,11,30,30
1650540651974,MATH 20B,A02,083757,Staff,0,12,30,30
1650540658001,MATH 20C,A01,083760,Staff,0,16,30,30
1650540658001,MATH 20C,A02,083761,Staff,2,14,30,28
1650540658001,MATH 20C,B01,083762,Staff,12,0,30,18
1650540658001,MATH 20C,B02,083763,Staff,28,0,30,2
1650540664031,MATH 20D,A01,083765,Staff,0,1,30,30
1650540664031,MATH 20D,A02,083766,Staff,7,0,30,23
1650540664031,MATH 20D,A03,083767,Staff,25,0,30,5
1650540670059,MATH 20E,A01,083771,Staff,6,0,30,24
1650540670059,MATH 20E,A02,083772,Staff,18,0,30,12
1650540670059,MATH 20E,B01,083773,Staff,0,0,30,30
1650540670059,MATH 20E,B02,083774,Staff,10,0,30,20
1650540676086,MATH 103A,A01,083777,Staff,0,15,30,30
1650540676086,MATH 103A,A02,083778,Staff,0,14,30,30
1650540676086,MATH 103A,B01,083779,Staff,0,13,30,30
1650540676086,MATH 103A,B02,083780,Staff,0,13,30,30
1650540682115,MATH 105,A01,085443,Staff,0,21,30,30
1650540688142,MATH 109,A01,083213,Anzaldo; Leesa B,0,8,30,30
1650540688142,MATH 109,A02,083214,Anzaldo; Leesa B,0,7,30,30
1650540688142,MATH 109,B01,083215,Anzaldo; Leesa B,0,5,30,30
1650540688142,MATH 109,B02,083216,Anzaldo; Leesa B,0,6,30,30
1650540694171,MATH 142A,A01,083219,Chow; Bennett,0,16,30,30
1650540694171,MATH 142A,A02,083220,Chow; Bennett,0,14,30,30
1650540694171,MATH 142A,B01,083221,Chow; Bennett,0,13,30,30
1650540694171,MATH 142A,B02,083222,Chow; Bennett,0,13,30,30
1650540700200,MATH 193A,A01,083224,Staff,0,6,30,30
1650540700200,MATH 193A,A02,083225,Staff,0,5,30,30
1650540700200,MATH 193A,A03,083781,Staff,0,5,30,30
1650540700200,MATH 193A,A04,083782,Staff,0,7,30,30
1650540706229,MATH 197,001,091859,McAuley; Julian John,9998,0,9999,1
1650540712295,COGS 9,A01,083615,Staff,0,16,60,60
1650540718321,COGS 11,A01,083617,Boyle; Mary E. T.,19,0,40,21
1650540724346,COGS 13,A01,083071,Staff,0,35,40,40
1650540730371,COGS 14A,A01,092681,Staff,0,26,100,100
1650540736396,COGS 14B,A01,083073,Cheng; Tzu-Han,0,12,50,50
1650540742424,COGS 17,A01,092677,Staff,19,0,75,56
1650540748452,COGS 100,A01,083619,Staff,0,26,60,60
1650540754478,COGS 101A,A01,083621,Davis; Joshua Daniel,0,26,60,60
1650540760509,COGS 101B,A01,091572,Staff,1,5,60,59
1650540766537,COGS 101C,A01,083625,Delgado; Tania,15,0,30,15
1650540772566,COGS 107A,A01,083627,Boyle; Mary E. T.,0,11,60,60
1650540778592,COGS 118A,A01,083075,Staff,0,3,60,60
1650540784622,CSE 3,A50,083646,Miranda; Gregory Joseph,20,0,38,18
1650540784622,CSE 3,A51,083647,Miranda; Gregory Joseph,36,0,37,1
1650540790647,CSE 8A,A50,083650,Miranda; Gregory Joseph,0,29,40,40
1650540796675,CSE 11,A01,083080,Cao; Yingjun,0,94,40,40
1650540802705,CSE 12,A01,083652,Staff,0,17,100,100
1650540808738,CSE 15L,A01,083654,Staff,0,1,50,50
1650540808738,CSE 15L,A02,083655,Staff,0,0,50,50
1650540814768,CSE 20,A01,083657,Staff,51,0,80,29
1650540820795,CSE 30,A01,083084,Eldon; John,0,77,40,40
1650540826828,CSE 100,A01,083659,Cao; Yingjun,0,66,50,50
1650540832860,CSE 134B,A01,083661,Powell; Thomas Allan,0,34,65,65
1650540838890,CSE 140,A01,083663,Staff,0,5,75,75
1650540844992,CSE 140L,A01,083088,Eldon; John,0,11,75,75
1650540851021,CSE 175,A01,083665,Kumar; Rakesh,7,0,25,18
1650540857048,CSE 190,A00,092507,Dubnov; Shlomo,10,0,20,10
1650540863075,ECE 45,A01,083139,Staff,0,1,60,60
1650540869108,ECE 65,A50,083695,Staff,0,6,30,30
1650540875137,ECE 109,A01,091882,Touri; Behrouz,33,0,70,37
1650540881165,ECE 180,A00,083140,Abi Samra; Nicholas Camill,21,0,30,9
1650540881165,ECE 180,B00,083141,Abi Samra; Nicholas Camill,0,0,30,30
1650540887197,MATH 10A,A01,083735,Patchell; Gregory David,5,0,30,25
1650540887197,MATH 10A,A02,083736,Patchell; Gregory David,27,0,30,3
1650540887197,MATH 10A,A03,083737,Patchell; Gregory David,24,0,30,6
1650540893227,MATH 10B,A01,083207,Staff,0,9,30,30
1650540893227,MATH 10B,A02,083208,Staff,0,7,30,30
1650540893227,MATH 10B,B01,083739,Staff,12,0,30,18
1650540893227,MATH 10B,B02,083740,Staff,28,0,30,2
1650540899258,MATH 18,A01,083743,Staff,1,0,30,29
1650540899258,MATH 18,A02,083744,Staff,26,0,30,4
1650540899258,MATH 18,A03,083745,Staff,22,0,30,8
1650540899258,MATH 18,A04,083746,Staff,26,0,30,4
1650540899258,MATH 18,B01,083748,Staff,0,12,30,30
1650540899258,MATH 18,B02,083749,Staff,0,12,30,30
1650540899258,MATH 18,B03,083750,Staff,0,11,30,30
1650540899258,MATH 18,B04,083751,Staff,0,12,30,30
1650540905292,MATH 20A,A01,083754,Staff,22,0,40,18
1650540911325,MATH 20B,A01,083756,Staff,0,11,30,30
1650540911325,MATH 20B,A02,083757,Staff,0,12,30,30
1650540917353,MATH 20C,A01,083760,Staff,0,16,30,30
1650540917353,MATH 20C,A02,083761,Staff,2,14,30,28
1650540917353,MATH 20C,B01,083762,Staff,12,0,30,18
1650540917353,MATH 20C,B02,083763,Staff,28,0,30,2
1650540923380,MATH 20D,A01,083765,Staff,0,1,30,30
1650540923380,MATH 20D,A02,083766,Staff,7,0,30,23
1650540923380,MATH 20D,A03,083767,Staff,25,0,30,5
1650540929408,MATH 20E,A01,083771,Staff,6,0,30,24
1650540929408,MATH 20E,A02,083772,Staff,18,0,30,12
1650540929408,MATH 20E,B01,083773,Staff,0,0,30,30
1650540929408,MATH 20E,B02,083774,Staff,10,0,30,20
1650540935437,MATH 103A,A01,083777,Staff,0,15,30,30
1650540935437,MATH 103A,A02,083778,Staff,0,14,30,30
1650540935437,MATH 103A,B01,083779,Staff,0,13,30,30
1650540935437,MATH 103A,B02,083780,Staff,0,13,30,30
1650540941475,MATH 105,A01,085443,Staff,0,21,30,30
1650540955052,MATH 109,A01,083213,Anzaldo; Leesa B,0,8,30,30
1650540955052,MATH 109,A02,083214,Anzaldo; Leesa B,0,7,30,30
1650540955052,MATH 109,B01,083215,Anzaldo; Leesa B,0,5,30,30
1650540955052,MATH 109,B02,083216,Anzaldo; Leesa B,0,6,30,30
1650540961172,MATH 142A,A01,083219,Chow; Bennett,0,16,30,30
1650540961172,MATH 142A,A02,083220,Chow; Bennett,0,14,30,30
1650540961172,MATH 142A,B01,083221,Chow; Bennett,0,13,30,30
1650540961172,MATH 142A,B02,083222,Chow; Bennett,0,13,30,30
1650540978685,MATH 193A,A01,083224,Staff,0,6,30,30
1650540978685,MATH 193A,A02,083225,Staff,0,5,30,30
1650540978685,MATH 193A,A03,083781,Staff,0,5,30,30
1650540978685,MATH 193A,A04,083782,Staff,0,7,30,30
1650540984716,MATH 197,001,091859,McAuley; Julian John,9998,0,9999,1
1650541003847,COGS 9,A01,083615,Staff,0,16,60,60
1650541009885,COGS 11,A01,083617,Boyle; Mary E. T.,19,0,40,21
1650541028793,COGS 13,A01,083071,Staff,0,35,40,40
1650541034830,COGS 14A,A01,092681,Staff,0,26,100,100
1650541053772,COGS 14B,A01,083073,Cheng; Tzu-Han,0,12,50,50
1650541059801,COGS 17,A01,092677,Staff,19,0,75,56
1650541078437,COGS 100,A01,083619,Staff,0,26,60,60
1650541084478,COGS 101A,A01,083621,Davis; Joshua Daniel,0,26,60,60
1650541099289,COGS 101B,A01,091572,Staff,1,5,60,59
1650541105318,COGS 101C,A01,083625,Delgado; Tania,15,0,30,15
1650541111352,COGS 107A,A01,083627,Boyle; Mary E. T.,0,11,60,60
1650541117378,COGS 118A,A01,083075,Staff,0,3,60,60
1650541123412,CSE 3,A50,083646,Miranda; Gregory Joseph,20,0,38,18
1650541123412,CSE 3,A51,083647,Miranda; Gregory Joseph,36,0,37,1
1650541129446,CSE 8A,A50,083650,Miranda; Gregory Joseph,0,29,40,40
1650541135477,CSE 11,A01,083080,Cao; Yingjun,0,94,40,40
1650541141505,CSE 12,A01,083652,Staff,0,17,100,100
1650541147530,CSE 15L,A01,083654,Staff,0,1,50,50
1650541147530,CSE 15L,A02,083655,Staff,0,0,50,50
1650541153558,CSE 20,A01,083657,Staff,51,0,80,29
1650541159595,CSE 30,A01,083084,Eldon; John,0,77,40,40
1650541165629,CSE 100,A01,083659,Cao; Yingjun,0,66,50,50
1650541171666,CSE 134B,A01,083661,Powell; Thomas Allan,0,34,65,65
1650541177695,CSE 140,A01,083663,Staff,0,5,75,75
1650541183721,CSE 140L,A01,083088,Eldon; John,0,11,75,75
1650541189754,CSE 175,A01,083665,Kumar; Rakesh,7,0,25,18
1650541195783,CSE 190,A00,092507,Dubnov; Shlomo,10,0,20,10
1650541201820,ECE 45,A01,083139,Staff,0,1,60,60
1650541207852,ECE 65,A50,083695,Staff,0,6,30,30
1650541213881,ECE 109,A01,091882,Touri; Behrouz,33,0,70,37
1650541219910,ECE 180,A00,083140,Abi Samra; Nicholas Camill,21,0,30,9
1650541219910,ECE 180,B00,083141,Abi Samra; Nicholas Camill,0,0,30,30
1650541225939,MATH 10A,A01,083735,Patchell; Gregory David,5,0,30,25
1650541225939,MATH 10A,A02,083736,Patchell; Gregory David,27,0,30,3
1650541225939,MATH 10A,A03,083737,Patchell; Gregory David,24,0,30,6
1650541231973,MATH 10B,A01,083207,Staff,0,9,30,30
1650541231973,MATH 10B,A02,083208,Staff,0,7,30,30
1650541231973,MATH 10B,B01,083739,Staff,12,0,30,18
1650541231973,MATH 10B,B02,083740,Staff,28,0,30,2
1650541238008,MATH 18,A01,083743,Staff,1,0,30,29
1650541238008,MATH 18,A02,083744,Staff,26,0,30,4
1650541238008,MATH 18,A03,083745,Staff,22,0,30,8
1650541238008,MATH 18,A04,083746,Staff,26,0,30,4
1650541238008,MATH 18,B01,083748,Staff,0,12,30,30
1650541238008,MATH 18,B02,083749,Staff,0,12,30,30
1650541238008,MATH 18,B03,083750,Staff,0,11,30,30
1650541238008,MATH 18,B04,083751,Staff,0,12,30,30
1650541244033,MATH 20A,A01,083754,Staff,22,0,40,18
1650541250061,MATH 20B,A01,083756,Staff,0,11,30,30
1650541250061,MATH 20B,A02,083757,Staff,0,12,30,30
1650541256095,MATH 20C,A01,083760,Staff,0,16,30,30
1650541256095,MATH 20C,A02,083761,Staff,2,14,30,28
1650541256095,MATH 20C,B01,083762,Staff,12,0,30,18
1650541256095,MATH 20C,B02,083763,Staff,28,0,30,2
1650541262127,MATH 20D,A01,083765,Staff,0,1,30,30
1650541262127,MATH 20D,A02,083766,Staff,7,0,30,23
1650541262127,MATH 20D,A03,083767,Staff,25,0,30,5
1650541268162,MATH 20E,A01,083771,Staff,6,0,30,24
1650541268162,MATH 20E,A02,083772,Staff,18,0,30,12
1650541268162,MATH 20E,B01,083773,Staff,0,0,30,30
1650541268162,MATH 20E,B02,083774,Staff,10,0,30,20
1650541274197,MATH 103A,A01,083777,Staff,0,15,30,30
1650541274197,MATH 103A,A02,083778,Staff,0,14,30,30
1650541274197,MATH 103A,B01,083779,Staff,0,13,30,30
1650541274197,MATH 103A,B02,083780,Staff,0,13,30,30
1650541280230,MATH 105,A01,085443,Staff,0,21,30,30
1650541286266,MATH 109,A01,083213,Anzaldo; Leesa B,0,8,30,30
1650541286266,MATH 109,A02,083214,Anzaldo; Leesa B,0,7,30,30
1650541286266,MATH 109,B01,083215,Anzaldo; Leesa B,0,5,30,30
1650541286266,MATH 109,B02,083216,Anzaldo; Leesa B,0,6,30,30
1650541292300,MATH 142A,A01,083219,Chow; Bennett,0,16,30,30
1650541292300,MATH 142A,A02,083220,Chow; Bennett,0,14,30,30
1650541292300,MATH 142A,B01,083221,Chow; Bennett,0,13,30,30
1650541292300,MATH 142A,B02,083222,Chow; Bennett,0,13,30,30
1650541298328,MATH 193A,A01,083224,Staff,0,6,30,30
1650541298328,MATH 193A,A02,083225,Staff,0,5,30,30
1650541298328,MATH 193A,A03,083781,Staff,0,5,30,30
1650541298328,MATH 193A,A04,083782,Staff,0,7,30,30
1650541304358,MATH 197,001,091859,McAuley; Julian John,9998,0,9999,1
1650541310433,COGS 9,A01,083615,Staff,0,16,60,60
1650541316464,COGS 11,A01,083617,Boyle; Mary E. T.,19,0,40,21
1650541322490,COGS 13,A01,083071,Staff,0,35,40,40
1650541328519,COGS 14A,A01,092681,Staff,0,26,100,100
1650541334551,COGS 14B,A01,083073,Cheng; Tzu-Han,0,12,50,50
1650541340588,COGS 17,A01,092677,Staff,19,0,75,56
1650541346623,COGS 100,A01,083619,Staff,0,26,60,60
1650541352659,COGS 101A,A01,083621,Davis; Joshua Daniel,0,26,60,60
1650541358692,COGS 101B,A01,091572,Staff,1,5,60,59
1650541364717,COGS 101C,A01,083625,Delgado; Tania,15,0,30,15
1650541370744,COGS 107A,A01,083627,Boyle; Mary E. T.,0,11,60,60
1650541376773,COGS 118A,A01,083075,Staff,0,3,60,60
1650541382801,CSE 3,A50,083646,Miranda; Gregory Joseph,20,0,38,18
1650541382801,CSE 3,A51,083647,Miranda; Gregory Joseph,36,0,37,1
1650541388826,CSE 8A,A50,083650,Miranda; Gregory Joseph,0,29,40,40
1650541394866,CSE 11,A01,083080,Cao; Yingjun,0,94,40,40
1650541400892,CSE 12,A01,083652,Staff,0,17,100,100
1650541406915,CSE 15L,A01,083654,Staff,0,1,50,50
1650541406915,CSE 15L,A02,083655,Staff,0,0,50,50
1650541412946,CSE 20,A01,083657,Staff,51,0,80,29
1650541418975,CSE 30,A01,083084,Eldon; John,0,77,40,40
1650541425009,CSE 100,A01,083659,Cao; Yingjun,0,66,50,50
1650541431037,CSE 134B,A01,083661,Powell; Thomas Allan,0,34,65,65
1650541437065,CSE 140,A01,083663,Staff,0,5,75,75
1650541443092,CSE 140L,A01,083088,Eldon; John,0,11,75,75
1650541449122,CSE 175,A01,083665,Kumar; Rakesh,7,0,25,18
1650541455151,CSE 190,A00,092507,Dubnov; Shlomo,10,0,20,10
1650541461176,ECE 45,A01,083139,Staff,0,1,60,60
1650541467201,ECE 65,A50,083695,Staff,0,6,30,30
1650541480719,ECE 109,A01,091882,Touri; Behrouz,33,0,70,37
1650541486745,ECE 180,A00,083140,Abi Samra; Nicholas Camill,21,0,30,9
1650541486745,ECE 180,B00,083141,Abi Samra; Nicholas Camill,0,0,30,30
1650541493380,MATH 10A,A01,083735,Patchell; Gregory David,5,0,30,25
1650541493380,MATH 10A,A02,083736,Patchell; Gregory David,27,0,30,3
1650541493380,MATH 10A,A03,083737,Patchell; Gregory David,24,0,30,6
1650541499421,MATH 10B,A01,083207,Staff,0,9,30,30
1650541499421,MATH 10B,A02,083208,Staff,0,7,30,30
1650541499421,MATH 10B,B01,083739,Staff,12,0,30,18
1650541499421,MATH 10B,B02,083740,Staff,28,0,30,2
1650541505448,MATH 18,A01,083743,Staff,1,0,30,29
1650541505448,MATH 18,A02,083744,Staff,26,0,30,4
1650541505448,MATH 18,A03,083745,Staff,22,0,30,8
1650541505448,MATH 18,A04,083746,Staff,26,0,30,4
1650541505448,MATH 18,B01,083748,Staff,0,12,30,30
1650541505448,MATH 18,B02,083749,Staff,0,12,30,30
1650541505448,MATH 18,B03,083750,Staff,0,11,30,30
1650541505448,MATH 18,B04,083751,Staff,0,12,30,30
1650541511473,MATH 20A,A01,083754,Staff,22,0,40,18
1650541517503,MATH 20B,A01,083756,Staff,0,11,30,30
1650541517503,MATH 20B,A02,083757,Staff,0,12,30,30
1650541523530,MATH 20C,A01,083760,Staff,0,16,30,30
1650541523530,MATH 20C,A02,083761,Staff,2,14,30,28
1650541523530,MATH 20C,B01,083762,Staff,12,0,30,18
1650541523530,MATH 20C,B02,083763,Staff,28,0,30,2
1650541529646,MATH 20D,A01,083765,Staff,0,1,30,30
1650541529646,MATH 20D,A02,083766,Staff,7,0,30,23
1650541529646,MATH 20D,A03,083767,Staff,25,0,30,5
1650541535681,MATH 20E,A01,083771,Staff,6,0,30,24
1650541535681,MATH 20E,A02,083772,Staff,18,0,30,12
1650541535681,MATH 20E,B01,083773,Staff,0,0,30,30
1650541535681,MATH 20E,B02,083774,Staff,10,0,30,20
1650541541711,MATH 103A,A01,083777,Staff,0,15,30,30
1650541541711,MATH 103A,A02,083778,Staff,0,14,30,30
1650541541711,MATH 103A,B01,083779,Staff,0,13,30,30
1650541541711,MATH 103A,B02,083780,Staff,0,13,30,30
1650541547736,MATH 105,A01,085443,Staff,0,21,30,30
1650541553764,MATH 109,A01,083213,Anzaldo; Leesa B,0,8,30,30
1650541553764,MATH 109,A02,083214,Anzaldo; Leesa B,0,7,30,30
1650541553764,MATH 109,B01,083215,Anzaldo; Leesa B,0,5,30,30
1650541553764,MATH 109,B02,083216,Anzaldo; Leesa B,0,6,30,30
1650541559795,MATH 142A,A01,083219,Chow; Bennett,0,16,30,30
1650541559795,MATH 142A,A02,083220,Chow; Bennett,0,14,30,30
1650541559795,MATH 142A,B01,083221,Chow; Bennett,0,13,30,30
1650541559795,MATH 142A,B02,083222,Chow; Bennett,0,13,30,30
1650541565823,MATH 193A,A01,083224,Staff,0,6,30,30
1650541565823,MATH 193A,A02,083225,Staff,0,5,30,30
1650541565823,MATH 193A,A03,083781,Staff,0,5,30,30
1650541565823,MATH 193A,A04,083782,Staff,0,7,30,30
1650541571848,MATH 197,001,091859,McAuley; Julian John,9998,0,9999,1
1650541577921,COGS 9,A01,083615,Staff,0,16,60,60
1650541583946,COGS 11,A01,083617,Boyle; Mary E. T.,19,0,40,21
1650541589974,COGS 13,A01,083071,Staff,0,35,40,40
1650541595999,COGS 14A,A01,092681,Staff,0,26,100,100
1650541602027,COGS 14B,A01,083073,Cheng; Tzu-Han,0,12,50,50
1650541608052,COGS 17,A01,092677,Staff,19,0,75,56
1650541614081,COGS 100,A01,083619,Staff,0,26,60,60
1650541620107,COGS 101A,A01,083621,Davis; Joshua Daniel,0,26,60,60
1650541626136,COGS 101B,A01,091572,Staff,1,5,60,59
1650541632162,COGS 101C,A01,083625,Delgado; Tania,15,0,30,15
1650541638188,COGS 107A,A01,083627,Boyle; Mary E. T.,0,11,60,60
1650541644213,COGS 118A,A01,083075,Staff,0,3,60,60
1650541650242,CSE 3,A50,083646,Miranda; Gregory Joseph,20,0,38,18
1650541650242,CSE 3,A51,083647,Miranda; Gregory Joseph,36,0,37,1
1650541656267,CSE 8A,A50,083650,Miranda; Gregory Joseph,0,29,40,40
1650541662295,CSE 11,A01,083080,Cao; Yingjun,0,94,40,40
1650541668324,CSE 12,A01,083652,Staff,0,17,100,100
1650541674349,CSE 15L,A01,083654,Staff,0,1,50,50
1650541674349,CSE 15L,A02,083655,Staff,0,0,50,50
1650541680376,CSE 20,A01,083657,Staff,51,0,80,29
1650541686412,CSE 30,A01,083084,Eldon; John,0,77,40,40
1650541692441,CSE 100,A01,083659,Cao; Yingjun,0,66,50,50
1650541698467,CSE 134B,A01,083661,Powell; Thomas Allan,0,34,65,65
1650541704491,CSE 140,A01,083663,Staff,0,5,75,75
1650541710521,CSE 140L,A01,083088,Eldon; John,0,11,75,75
1650541716545,CSE 175,A01,083665,Kumar; Rakesh,7,0,25,18
1650541722575,CSE 190,A00,092507,Dubnov; Shlomo,10,0,20,10
1650541728603,ECE 45,A01,083139,Staff,0,1,60,60
1650541734632,ECE 65,A50,083695,Staff,0,6,30,30
1650541740657,ECE 109,A01,091882,Touri; Behrouz,33,0,70,37
1650541746687,ECE 180,A00,083140,Abi Samra; Nicholas Camill,21,0,30,9
1650541746687,ECE 180,B00,083141,Abi Samra; Nicholas Camill,0,0,30,30
1650541752714,MATH 10A,A01,083735,Patchell; Gregory David,5,0,30,25
1650541752714,MATH 10A,A02,083736,Patchell; Gregory David,27,0,30,3
1650541752714,MATH 10A,A03,083737,Patchell; Gregory David,24,0,30,6
1650541758745,MATH 10B,A01,083207,Staff,0,9,30,30
1650541758745,MATH 10B,A02,083208,Staff,0,7,30,30
1650541758745,MATH 10B,B01,083739,Staff,12,0,30,18
1650541758745,MATH 10B,B02,083740,Staff,28,0,30,2
1650541764779,MATH 18,A01,083743,Staff,1,0,30,29
1650541764779,MATH 18,A02,083744,Staff,26,0,30,4
1650541764779,MATH 18,A03,083745,Staff,22,0,30,8
1650541764779,MATH 18,A04,083746,Staff,26,0,30,4
1650541764779,MATH 18,B01,083748,Staff,0,12,30,30
1650541764779,MATH 18,B02,083749,Staff,0,12,30,30
1650541764779,MATH 18,B03,083750,Staff,0,11,30,30
1650541764779,MATH 18,B04,083751,Staff,0,12,30,30
1650541770803,MATH 20A,A01,083754,Staff,22,0,40,18
1650541776829,MATH 20B,A01,083756,Staff,0,11,30,30
1650541776829,MATH 20B,A02,083757,Staff,0,12,30,30
1650541782858,MATH 20C,A01,083760,Staff,0,16,30,30
1650541782858,MATH 20C,A02,083761,Staff,2,14,30,28
1650541782858,MATH 20C,B01,083762,Staff,12,0,30,18
1650541782858,MATH 20C,B02,083763,Staff,28,0,30,2
1650541788888,MATH 20D,A01,083765,Staff,0,1,30,30
1650541788888,MATH 20D,A02,083766,Staff,7,0,30,23
1650541788888,MATH 20D,A03,083767,Staff,25,0,30,5
1650541794914,MATH 20E,A01,083771,Staff,6,0,30,24
1650541794914,MATH 20E,A02,083772,Staff,18,0,30,12
1650541794914,MATH 20E,B01,083773,Staff,0,0,30,30
1650541794914,MATH 20E,B02,083774,Staff,10,0,30,20
1650541800941,MATH 103A,A01,083777,Staff,0,15,30,30
1650541800941,MATH 103A,A02,083778,Staff,0,14,30,30
1650541800941,MATH 103A,B01,083779,Staff,0,13,30,30
1650541800941,MATH 103A,B02,083780,Staff,0,13,30,30
1650541806967,MATH 105,A01,085443,Staff,0,21,30,30
1650541812993,MATH 109,A01,083213,Anzaldo; Leesa B,0,8,30,30
1650541812993,MATH 109,A02,083214,Anzaldo; Leesa B,0,7,30,30
1650541812993,MATH 109,B01,083215,Anzaldo; Leesa B,0,5,30,30
1650541812993,MATH 109,B02,083216,Anzaldo; Leesa B,0,6,30,30
1650541819025,MATH 142A,A01,083219,Chow; Bennett,0,16,30,30
1650541819025,MATH 142A,A02,083220,Chow; Bennett,0,14,30,30
1650541819025,MATH 142A,B01,083221,Chow; Bennett,0,13,30,30
1650541819025,MATH 142A,B02,083222,Chow; Bennett,0,13,30,30
1650541825056,MATH 193A,A01,083224,Staff,0,6,30,30
1650541825056,MATH 193A,A02,083225,Staff,0,5,30,30
1650541825056,MATH 193A,A03,083781,Staff,0,5,30,30
1650541825056,MATH 193A,A04,083782,Staff,0,7,30,30
1650541831080,MATH 197,001,091859,McAuley; Julian John,9998,0,9999,1
1650541837160,COGS 9,A01,083615,Staff,0,16,60,60
1650541843188,COGS 11,A01,083617,Boyle; Mary E. T.,19,0,40,21
1650541849214,COGS 13,A01,083071,Staff,0,35,40,40
1650541855244,COGS 14A,A01,092681,Staff,0,26,100,100
1650541861272,COGS 14B,A01,083073,Cheng; Tzu-Han,0,12,50,50
1650541867303,COGS 17,A01,092677,Staff,19,0,75,56
1650541873330,COGS 100,A01,083619,Staff,0,26,60,60
1650541879363,COGS 101A,A01,083621,Davis; Joshua Daniel,0,26,60,60
1650541885393,COGS 101B,A01,091572,Staff,1,5,60,59
1650541891426,COGS 101C,A01,083625,Delgado; Tania,15,0,30,15
1650541897452,COGS 107A,A01,083627,Boyle; Mary E. T.,0,11,60,60
1650541903481,COGS 118A,A01,083075,Staff,0,3,60,60
1650541909514,CSE 3,A50,083646,Miranda; Gregory Joseph,20,0,38,18
1650541909514,CSE 3,A51,083647,Miranda; Gregory Joseph,36,0,37,1
1650541915547,CSE 8A,A50,083650,Miranda; Gregory Joseph,0,29,40,40
1650541921575,CSE 11,A01,083080,Cao; Yingjun,0,94,40,40
1650541927602,CSE 12,A01,083652,Staff,0,17,100,100
1650541933630,CSE 15L,A01,083654,Staff,0,1,50,50
1650541933630,CSE 15L,A02,083655,Staff,0,0,50,50
1650541939656,CSE 20,A01,083657,Staff,51,0,80,29
1650541945684,CSE 30,A01,083084,Eldon; John,0,77,40,40
1650541951711,CSE 100,A01,083659,Cao; Yingjun,0,66,50,50
1650541957738,CSE 134B,A01,083661,Powell; Thomas Allan,0,34,65,65
1650541963765,CSE 140,A01,083663,Staff,0,5,75,75
1650541969792,CSE 140L,A01,083088,Eldon; John,0,11,75,75
1650541975821,CSE 175,A01,083665,Kumar; Rakesh,7,0,25,18
1650541981849,CSE 190,A00,092507,Dubnov; Shlomo,10,0,20,10
1650541987881,ECE 45,A01,083139,Staff,0,1,60,60
1650541993916,ECE 65,A50,083695,Staff,0,6,30,30
1650541999942,ECE 109,A01,091882,Touri; Behrouz,33,0,70,37
1650542005971,ECE 180,A00,083140,Abi Samra; Nicholas Camill,21,0,30,9
1650542005971,ECE 180,B00,083141,Abi Samra; Nicholas Camill,0,0,30,30
1650542012004,MATH 10A,A01,083735,Patchell; Gregory David,5,0,30,25
1650542012004,MATH 10A,A02,083736,Patchell; Gregory David,27,0,30,3
1650542012004,MATH 10A,A03,083737,Patchell; Gregory David,24,0,30,6
1650542018031,MATH 10B,A01,083207,Staff,0,9,30,30
1650542018031,MATH 10B,A02,083208,Staff,0,7,30,30
1650542018031,MATH 10B,B01,083739,Staff,12,0,30,18
1650542018031,MATH 10B,B02,083740,Staff,28,0,30,2
1650542024064,MATH 18,A01,083743,Staff,1,0,30,29
1650542024064,MATH 18,A02,083744,Staff,26,0,30,4
1650542024064,MATH 18,A03,083745,Staff,22,0,30,8
1650542024064,MATH 18,A04,083746,Staff,26,0,30,4
1650542024064,MATH 18,B01,083748,Staff,0,12,30,30
1650542024064,MATH 18,B02,083749,Staff,0,12,30,30
1650542024064,MATH 18,B03,083750,Staff,0,11,30,30
1650542024064,MATH 18,B04,083751,Staff,0,12,30,30
1650542030090,MATH 20A,A01,083754,Staff,22,0,40,18
1650542036118,MATH 20B,A01,083756,Staff,0,11,30,30
1650542036118,MATH 20B,A02,083757,Staff,0,12,30,30
1650542042150,MATH 20C,A01,083760,Staff,0,16,30,30
1650542042150,MATH 20C,A02,083761,Staff,2,14,30,28
1650542042150,MATH 20C,B01,083762,Staff,12,0,30,18
1650542042150,MATH 20C,B02,083763,Staff,28,0,30,2
1650542048177,MATH 20D,A01,083765,Staff,0,1,30,30
1650542048177,MATH 20D,A02,083766,Staff,7,0,30,23
1650542048177,MATH 20D,A03,083767,Staff,25,0,30,5
1650542054207,MATH 20E,A01,083771,Staff,6,0,30,24
1650542054207,MATH 20E,A02,083772,Staff,18,0,30,12
1650542054207,MATH 20E,B01,083773,Staff,0,0,30,30
1650542054207,MATH 20E,B02,083774,Staff,10,0,30,20
1650542060243,MATH 103A,A01,083777,Staff,0,15,30,30
1650542060243,MATH 103A,A02,083778,Staff,0,14,30,30
1650542060243,MATH 103A,B01,083779,Staff,0,13,30,30
1650542060243,MATH 103A,B02,083780,Staff,0,13,30,30
1650542066269,MATH 105,A01,085443,Staff,0,21,30,30
1650542072296,MATH 109,A01,083213,Anzaldo; Leesa B,0,8,30,30
1650542072296,MATH 109,A02,083214,Anzaldo; Leesa B,0,7,30,30
1650542072296,MATH 109,B01,083215,Anzaldo; Leesa B,0,5,30,30
1650542072296,MATH 109,B02,083216,Anzaldo; Leesa B,0,6,30,30
1650542078332,MATH 142A,A01,083219,Chow; Bennett,0,16,30,30
1650542078332,MATH 142A,A02,083220,Chow; Bennett,0,14,30,30
1650542078332,MATH 142A,B01,083221,Chow; Bennett,0,13,30,30
1650542078332,MATH 142A,B02,083222,Chow; Bennett,0,13,30,30
1650542084358,MATH 193A,A01,083224,Staff,0,6,30,30
1650542084358,MATH 193A,A02,083225,Staff,0,5,30,30
1650542084358,MATH 193A,A03,083781,Staff,0,5,30,30
1650542084358,MATH 193A,A04,083782,Staff,0,7,30,30
1650542090389,MATH 197,001,091859,McAuley; Julian John,9998,0,9999,1
1650542096463,COGS 9,A01,083615,Staff,0,16,60,60
1650542102493,COGS 11,A01,083617,Boyle; Mary E. T.,19,0,40,21
1650542108520,COGS 13,A01,083071,Staff,0,35,40,40
1650542114552,COGS 14A,A01,092681,Staff,0,26,100,100
1650542120666,COGS 14B,A01,083073,Cheng; Tzu-Han,0,12,50,50
1650542126692,COGS 17,A01,092677,Staff,19,0,75,56
1650542132717,COGS 100,A01,083619,Staff,0,26,60,60
1650542138752,COGS 101A,A01,083621,Davis; Joshua Daniel,0,26,60,60
1650542144782,COGS 101B,A01,091572,Staff,1,5,60,59
1650542150810,COGS 101C,A01,083625,Delgado; Tania,15,0,30,15
1650542156850,COGS 107A,A01,083627,Boyle; Mary E. T.,0,11,60,60
1650542162881,COGS 118A,A01,083075,Staff,0,3,60,60
1650542168916,CSE 3,A50,083646,Miranda; Gregory Joseph,20,0,38,18
1650542168916,CSE 3,A51,083647,Miranda; Gregory Joseph,36,0,37,1
1650542174943,CSE 8A,A50,083650,Miranda; Gregory Joseph,0,29,40,40
1650542180974,CSE 11,A01,083080,Cao; Yingjun,0,94,40,40
1650542186999,CSE 12,A01,083652,Staff,0,17,100,100
1650542193026,CSE 15L,A01,083654,Staff,0,1,50,50
1650542193026,CSE 15L,A02,083655,Staff,0,0,50,50
1650542199054,CSE 20,A01,083657,Staff,51,0,80,29
1650542205092,CSE 30,A01,083084,Eldon; John,0,77,40,40
1650542211118,CSE 100,A01,083659,Cao; Yingjun,0,66,50,50
1650542217158,CSE 134B,A01,083661,Powell; Thomas Allan,0,34,65,65
1650542223185,CSE 140,A01,083663,Staff,0,5,75,75
1650542229214,CSE 140L,A01,083088,Eldon; John,0,11,75,75
1650542235245,CSE 175,A01,083665,Kumar; Rakesh,7,0,25,18
1650542241271,CSE 190,A00,092507,Dubnov; Shlomo,10,0,20,10
1650542247300,ECE 45,A01,083139,Staff,0,1,60,60
1650542253324,ECE 65,A50,083695,Staff,0,6,30,30
1650542259350,ECE 109,A01,091882,Touri; Behrouz,33,0,70,37
1650542265376,ECE 180,A00,083140,Abi Samra; Nicholas Camill,21,0,30,9
1650542265376,ECE 180,B00,083141,Abi Samra; Nicholas Camill,0,0,30,30
1650542271403,MATH 10A,A01,083735,Patchell; Gregory David,5,0,30,25
1650542271403,MATH 10A,A02,083736,Patchell; Gregory David,27,0,30,3
1650542271403,MATH 10A,A03,083737,Patchell; Gregory David,24,0,30,6
1650542277438,MATH 10B,A01,083207,Staff,0,9,30,30
1650542277438,MATH 10B,A02,083208,Staff,0,7,30,30
1650542277438,MATH 10B,B01,083739,Staff,12,0,30,18
1650542277438,MATH 10B,B02,083740,Staff,28,0,30,2
1650542283470,MATH 18,A01,083743,Staff,1,0,30,29
1650542283470,MATH 18,A02,083744,Staff,26,0,30,4
1650542283470,MATH 18,A03,083745,Staff,22,0,30,8
1650542283470,MATH 18,A04,083746,Staff,26,0,30,4
1650542283470,MATH 18,B01,083748,Staff,0,12,30,30
1650542283470,MATH 18,B02,083749,Staff,0,12,30,30
1650542283470,MATH 18,B03,083750,Staff,0,11,30,30
1650542283470,MATH 18,B04,083751,Staff,0,12,30,30
1650542289502,MATH 20A,A01,083754,Staff,22,0,40,18
1650542295530,MATH 20B,A01,083756,Staff,0,11,30,30
1650542295530,MATH 20B,A02,083757,Staff,0,12,30,30
1650542301560,MATH 20C,A01,083760,Staff,0,16,30,30
1650542301560,MATH 20C,A02,083761,Staff,2,14,30,28
1650542301560,MATH 20C,B01,083762,Staff,12,0,30,18
1650542301560,MATH 20C,B02,083763,Staff,28,0,30,2
1650542307588,MATH 20D,A01,083765,Staff,0,1,30,30
1650542307588,MATH 20D,A02,083766,Staff,7,0,30,23
1650542307588,MATH 20D,A03,083767,Staff,25,0,30,5
1650542313619,MATH 20E,A01,083771,Staff,6,0,30,24
1650542313619,MATH 20E,A02,083772,Staff,18,0,30,12
1650542313619,MATH 20E,B01,083773,Staff,0,0,30,30
1650542313619,MATH 20E,B02,083774,Staff,10,0,30,20
1650542319650,MATH 103A,A01,083777,Staff,0,15,30,30
1650542319650,MATH 103A,A02,083778,Staff,0,14,30,30
1650542319650,MATH 103A,B01,083779,Staff,0,13,30,30
1650542319650,MATH 103A,B02,083780,Staff,0,13,30,30
1650542325680,MATH 105,A01,085443,Staff,0,21,30,30
1650542331705,MATH 109,A01,083213,Anzaldo; Leesa B,0,8,30,30
1650542331705,MATH 109,A02,083214,Anzaldo; Leesa B,0,7,30,30
1650542331705,MATH 109,B01,083215,Anzaldo; Leesa B,0,5,30,30
1650542331705,MATH 109,B02,083216,Anzaldo; Leesa B,0,6,30,30
1650542337735,MATH 142A,A01,083219,Chow; Bennett,0,16,30,30
1650542337735,MATH 142A,A02,083220,Chow; Bennett,0,14,30,30
1650542337735,MATH 142A,B01,083221,Chow; Bennett,0,13,30,30
1650542337735,MATH 142A,B02,083222,Chow; Bennett,0,13,30,30
1650542343759,MATH 193A,A01,083224,Staff,0,6,30,30
1650542343759,MATH 193A,A02,083225,Staff,0,5,30,30
1650542343759,MATH 193A,A03,083781,Staff,0,5,30,30
1650542343759,MATH 193A,A04,083782,Staff,0,7,30,30
1650542349794,MATH 197,001,091859,McAuley; Julian John,9998,0,9999,1
1650542355886,COGS 9,A01,083615,Staff,0,16,60,60
1650542361910,COGS 11,A01,083617,Boyle; Mary E. T.,19,0,40,21
1650542367935,COGS 13,A01,083071,Staff,0,35,40,40
1650542373960,COGS 14A,A01,092681,Staff,0,26,100,100
1650542379995,COGS 14B,A01,083073,Cheng; Tzu-Han,0,12,50,50
1650542386021,COGS 17,A01,092677,Staff,19,0,75,56
1650542392056,COGS 100,A01,083619,Staff,0,26,60,60
1650542398086,COGS 101A,A01,083621,Davis; Joshua Daniel,0,26,60,60
1650542404111,COGS 101B,A01,091572,Staff,1,5,60,59
1650542410145,COGS 101C,A01,083625,Delgado; Tania,15,0,30,15
1650542416175,COGS 107A,A01,083627,Boyle; Mary E. T.,0,11,60,60
1650542422202,COGS 118A,A01,083075,Staff,0,3,60,60
1650542428230,CSE 3,A50,083646,Miranda; Gregory Joseph,20,0,38,18
1650542428230,CSE 3,A51,083647,Miranda; Gregory Joseph,36,0,37,1
1650542434259,CSE 8A,A50,083650,Miranda; Gregory Joseph,0,29,40,40
1650542440289,CSE 11,A01,083080,Cao; Yingjun,0,94,40,40
1650542446318,CSE 12,A01,083652,Staff,0,17,100,100
1650542452347,CSE 15L,A01,083654,Staff,0,1,50,50
1650542452347,CSE 15L,A02,083655,Staff,0,0,50,50
1650542458377,CSE 20,A01,083657,Staff,51,0,80,29
1650542464401,CSE 30,A01,083084,Eldon; John,0,77,40,40
1650542470431,CSE 100,A01,083659,Cao; Yingjun,0,66,50,50
1650542476458,CSE 134B,A01,083661,Powell; Thomas Allan,0,34,65,65
1650542482485,CSE 140,A01,083663,Staff,0,5,75,75
1650542488516,CSE 140L,A01,083088,Eldon; John,0,11,75,75
1650542494548,CSE 175,A01,083665,Kumar; Rakesh,7,0,25,18
1650542500574,CSE 190,A00,092507,Dubnov; Shlomo,10,0,20,10
1650542506601,ECE 45,A01,083139,Staff,0,1,60,60
1650542512630,ECE 65,A50,083695,Staff,0,6,30,30
1650542518658,ECE 109,A01,091882,Touri; Behrouz,33,0,70,37
1650542524691,ECE 180,A00,083140,Abi Samra; Nicholas Camill,21,0,30,9
1650542524691,ECE 180,B00,083141,Abi Samra; Nicholas Camill,0,0,30,30
1650542530724,MATH 10A,A01,083735,Patchell; Gregory David,5,0,30,25
1650542530724,MATH 10A,A02,083736,Patchell; Gregory David,27,0,30,3
1650542530724,MATH 10A,A03,083737,Patchell; Gregory David,24,0,30,6
1650542536756,MATH 10B,A01,083207,Staff,0,9,30,30
1650542536756,MATH 10B,A02,083208,Staff,0,7,30,30
1650542536756,MATH 10B,B01,083739,Staff,12,0,30,18
1650542536756,MATH 10B,B02,083740,Staff,28,0,30,2
1650542542785,MATH 18,A01,083743,Staff,1,0,30,29
1650542542785,MATH 18,A02,083744,Staff,26,0,30,4
1650542542785,MATH 18,A03,083745,Staff,22,0,30,8
1650542542785,MATH 18,A04,083746,Staff,26,0,30,4
1650542542785,MATH 18,B01,083748,Staff,0,12,30,30
1650542542785,MATH 18,B02,083749,Staff,0,12,30,30
1650542542785,MATH 18,B03,083750,Staff,0,11,30,30
1650542542785,MATH 18,B04,083751,Staff,0,12,30,30
1650542548819,MATH 20A,A01,083754,Staff,22,0,40,18
1650542554851,MATH 20B,A01,083756,Staff,0,11,30,30
1650542554851,MATH 20B,A02,083757,Staff,0,12,30,30
1650542560878,MATH 20C,A01,083760,Staff,0,16,30,30
1650542560878,MATH 20C,A02,083761,Staff,2,14,30,28
1650542560878,MATH 20C,B01,083762,Staff,12,0,30,18
1650542560878,MATH 20C,B02,083763,Staff,28,0,30,2
1650542566906,MATH 20D,A01,083765,Staff,0,1,30,30
1650542566906,MATH 20D,A02,083766,Staff,7,0,30,23
1650542566906,MATH 20D,A03,083767,Staff,25,0,30,5
1650542572935,MATH 20E,A01,083771,Staff,6,0,30,24
1650542572935,MATH 20E,A02,083772,Staff,18,0,30,12
1650542572935,MATH 20E,B01,083773,Staff,0,0,30,30
1650542572935,MATH 20E,B02,083774,Staff,10,0,30,20
1650542578982,MATH 103A,A01,083777,Staff,0,15,30,30
1650542578982,MATH 103A,A02,083778,Staff,0,14,30,30
1650542578982,MATH 103A,B01,083779,Staff,0,13,30,30
1650542578982,MATH 103A,B02,083780,Staff,0,13,30,30
1650542585007,MATH 105,A01,085443,Staff,0,21,30,30
1650542591042,MATH 109,A01,083213,Anzaldo; Leesa B,0,8,30,30
1650542591042,MATH 109,A02,083214,Anzaldo; Leesa B,0,7,30,30
1650542591042,MATH 109,B01,083215,Anzaldo; Leesa B,0,5,30,30
1650542591042,MATH 109,B02,083216,Anzaldo; Leesa B,0,6,30,30
1650542597069,MATH 142A,A01,083219,Chow; Bennett,0,16,30,30
1650542597069,MATH 142A,A02,083220,Chow; Bennett,0,14,30,30
1650542597069,MATH 142A,B01,083221,Chow; Bennett,0,13,30,30
1650542597069,MATH 142A,B02,083222,Chow; Bennett,0,13,30,30
1650542603100,MATH 193A,A01,083224,Staff,0,6,30,30
1650542603100,MATH 193A,A02,083225,Staff,0,5,30,30
1650542603100,MATH 193A,A03,083781,Staff,0,5,30,30
1650542603100,MATH 193A,A04,083782,Staff,0,7,30,30
1650542609126,MATH 197,001,091859,McAuley; Julian John,9998,0,9999,1
1650542615200,COGS 9,A01,083615,Staff,0,16,60,60
1650542621229,COGS 11,A01,083617,Boyle; Mary E. T.,19,0,40,21
1650542627265,COGS 13,A01,083071,Staff,0,35,40,40
1650542633291,COGS 14A,A01,092681,Staff,0,26,100,100
1650542639328,COGS 14B,A01,083073,Cheng; Tzu-Han,0,12,50,50
1650542645354,COGS 17,A01,092677,Staff,19,0,75,56
1650542651385,COGS 100,A01,083619,Staff,0,26,60,60
1650542657412,COGS 101A,A01,083621,Davis; Joshua Daniel,0,26,60,60
1650542663443,COGS 101B,A01,091572,Staff,1,5,60,59
1650542669500,COGS 101C,A01,083625,Delgado; Tania,15,0,30,15
1650542675535,COGS 107A,A01,083627,Boyle; Mary E. T.,0,11,60,60
1650542681562,COGS 118A,A01,083075,Staff,0,3,60,60
1650542687589,CSE 3,A50,083646,Miranda; Gregory Joseph,20,0,38,18
1650542687589,CSE 3,A51,083647,Miranda; Gregory Joseph,36,0,37,1
1650542693616,CSE 8A,A50,083650,Miranda; Gregory Joseph,0,29,40,40
1650542699644,CSE 11,A01,083080,Cao; Yingjun,0,94,40,40
1650542705678,CSE 12,A01,083652,Staff,0,17,100,100
1650542711707,CSE 15L,A01,083654,Staff,0,1,50,50
1650542711707,CSE 15L,A02,083655,Staff,0,0,50,50
1650542717819,CSE 20,A01,083657,Staff,51,0,80,29
1650542723875,CSE 30,A01,083084,Eldon; John,0,77,40,40
1650542729904,CSE 100,A01,083659,Cao; Yingjun,0,66,50,50
1650542735930,CSE 134B,A01,083661,Powell; Thomas Allan,0,34,65,65
1650542741955,CSE 140,A01,083663,Staff,0,5,75,75
1650542747986,CSE 140L,A01,083088,Eldon; John,0,11,75,75
1650542754020,CSE 175,A01,083665,Kumar; Rakesh,7,0,25,18
1650542760049,CSE 190,A00,092507,Dubnov; Shlomo,10,0,20,10
1650542766078,ECE 45,A01,083139,Staff,0,1,60,60
1650542772111,ECE 65,A50,083695,Staff,0,6,30,30
1650542778144,ECE 109,A01,091882,Touri; Behrouz,33,0,70,37
1650542784174,ECE 180,A00,083140,Abi Samra; Nicholas Camill,21,0,30,9
1650542784174,ECE 180,B00,083141,Abi Samra; Nicholas Camill,0,0,30,30
1650542790203,MATH 10A,A01,083735,Patchell; Gregory David,5,0,30,25
1650542790203,MATH 10A,A02,083736,Patchell; Gregory David,27,0,30,3
1650542790203,MATH 10A,A03,083737,Patchell; Gregory David,24,0,30,6
1650542796237,MATH 10B,A01,083207,Staff,0,9,30,30
1650542796237,MATH 10B,A02,083208,Staff,0,7,30,30
1650542796237,MATH 10B,B01,083739,Staff,12,0,30,18
1650542796237,MATH 10B,B02,083740,Staff,28,0,30,2
1650542802266,MATH 18,A01,083743,Staff,1,0,30,29
1650542802266,MATH 18,A02,083744,Staff,26,0,30,4
1650542802266,MATH 18,A03,083745,Staff,22,0,30,8
1650542802266,MATH 18,A04,083746,Staff,26,0,30,4
1650542802266,MATH 18,B01,083748,Staff,0,12,30,30
1650542802266,MATH 18,B02,083749,Staff,0,12,30,30
1650542802266,MATH 18,B03,083750,Staff,0,11,30,30
1650542802266,MATH 18,B04,083751,Staff,0,12,30,30
1650542808291,MATH 20A,A01,083754,Staff,22,0,40,18
1650542814322,MATH 20B,A01,083756,Staff,0,11,30,30
1650542814322,MATH 20B,A02,083757,Staff,0,12,30,30
1650542820347,MATH 20C,A01,083760,Staff,0,16,30,30
1650542820347,MATH 20C,A02,083761,Staff,2,14,30,28
1650542820347,MATH 20C,B01,083762,Staff,12,0,30,18
1650542820347,MATH 20C,B02,083763,Staff,28,0,30,2
1650542826376,MATH 20D,A01,083765,Staff,0,1,30,30
1650542826376,MATH 20D,A02,083766,Staff,7,0,30,23
1650542826376,MATH 20D,A03,083767,Staff,25,0,30,5
1650542832540,MATH 20E,A01,083771,Staff,6,0,30,24
1650542832540,MATH 20E,A02,083772,Staff,18,0,30,12
1650542832540,MATH 20E,B01,083773,Staff,0,0,30,30
1650542832540,MATH 20E,B02,083774,Staff,10,0,30,20
1650542838588,MATH 103A,A01,083777,Staff,0,15,30,30
1650542838588,MATH 103A,A02,083778,Staff,0,14,30,30
1650542838588,MATH 103A,B01,083779,Staff,0,13,30,30
1650542838588,MATH 103A,B02,083780,Staff,0,13,30,30
1650542844614,MATH 105,A01,085443,Staff,0,21,30,30
1650542850640,MATH 109,A01,083213,Anzaldo; Leesa B,0,8,30,30
1650542850640,MATH 109,A02,083214,Anzaldo; Leesa B,0,7,30,30
1650542850640,MATH 109,B01,083215,Anzaldo; Leesa B,0,5,30,30
1650542850640,MATH 109,B02,083216,Anzaldo; Leesa B,0,6,30,30
1650542856672,MATH 142A,A01,083219,Chow; Bennett,0,16,30,30
1650542856672,MATH 142A,A02,083220,Chow; Bennett,0,14,30,30
1650542856672,MATH 142A,B01,083221,Chow; Bennett,0,13,30,30
1650542856672,MATH 142A,B02,083222,Chow; Bennett,0,13,30,30
1650542862703,MATH 193A,A01,083224,Staff,0,6,30,30
1650542862703,MATH 193A,A02,083225,Staff,0,5,30,30
1650542862703,MATH 193A,A03,083781,Staff,0,5,30,30
1650542862703,MATH 193A,A04,083782,Staff,0,7,30,30
1650542868735,MATH 197,001,091859,McAuley; Julian John,9998,0,9999,1
1650542874915,COGS 9,A01,083615,Staff,0,16,60,60
1650542880952,COGS 11,A01,083617,Boyle; Mary E. T.,19,0,40,21
1650542886990,COGS 13,A01,083071,Staff,0,35,40,40
1650542893037,COGS 14A,A01,092681,Staff,0,26,100,100
1650542899064,COGS 14B,A01,083073,Cheng; Tzu-Han,0,12,50,50
1650542905090,COGS 17,A01,092677,Staff,19,0,75,56
1650542911120,COGS 100,A01,083619,Staff,0,26,60,60
1650542917148,COGS 101A,A01,083621,Davis; Joshua Daniel,0,26,60,60
1650542923174,COGS 101B,A01,091572,Staff,1,5,60,59
1650542929209,COGS 101C,A01,083625,Delgado; Tania,15,0,30,15
1650542935237,COGS 107A,A01,083627,Boyle; Mary E. T.,0,11,60,60
1650542941263,COGS 118A,A01,083075,Staff,0,3,60,60
1650542947298,CSE 3,A50,083646,Miranda; Gregory Joseph,20,0,38,18
1650542947298,CSE 3,A51,083647,Miranda; Gregory Joseph,36,0,37,1
1650542953339,CSE 8A,A50,083650,Miranda; Gregory Joseph,0,29,40,40
1650542959364,CSE 11,A01,083080,Cao; Yingjun,0,94,40,40
1650542965390,CSE 12,A01,083652,Staff,0,17,100,100
1650542971415,CSE 15L,A01,083654,Staff,0,1,50,50
1650542971415,CSE 15L,A02,083655,Staff,0,0,50,50
1650542977442,CSE 20,A01,083657,Staff,51,0,80,29
1650542983468,CSE 30,A01,083084,Eldon; John,0,77,40,40
1650542989494,CSE 100,A01,083659,Cao; Yingjun,0,66,50,50
1650542995530,CSE 134B,A01,083661,Powell; Thomas Allan,0,34,65,65
1650543001558,CSE 140,A01,083663,Staff,0,5,75,75
1650543007583,CSE 140L,A01,083088,Eldon; John,0,11,75,75
1650543013614,CSE 175,A01,083665,Kumar; Rakesh,7,0,25,18
1650543019648,CSE 190,A00,092507,Dubnov; Shlomo,10,0,20,10
1650543025676,ECE 45,A01,083139,Staff,0,1,60,60
1650543031714,ECE 65,A50,083695,Staff,0,6,30,30
1650543037745,ECE 109,A01,091882,Touri; Behrouz,33,0,70,37
1650543043772,ECE 180,A00,083140,Abi Samra; Nicholas Camill,21,0,30,9
1650543043772,ECE 180,B00,083141,Abi Samra; Nicholas Camill,0,0,30,30
1650543049807,MATH 10A,A01,083735,Patchell; Gregory David,5,0,30,25
1650543049807,MATH 10A,A02,083736,Patchell; Gregory David,27,0,30,3
1650543049807,MATH 10A,A03,083737,Patchell; Gregory David,24,0,30,6
1650543055837,MATH 10B,A01,083207,Staff,0,9,30,30
1650543055837,MATH 10B,A02,083208,Staff,0,7,30,30
1650543055837,MATH 10B,B01,083739,Staff,12,0,30,18
1650543055837,MATH 10B,B02,083740,Staff,28,0,30,2
1650543061874,MATH 18,A01,083743,Staff,1,0,30,29
1650543061874,MATH 18,A02,083744,Staff,26,0,30,4
1650543061874,MATH 18,A03,083745,Staff,22,0,30,8
1650543061874,MATH 18,A04,083746,Staff,26,0,30,4
1650543061874,MATH 18,B01,083748,Staff,0,12,30,30
1650543061874,MATH 18,B02,083749,Staff,0,12,30,30
1650543061874,MATH 18,B03,083750,Staff,0,11,30,30
1650543061874,MATH 18,B04,083751,Staff,0,12,30,30
1650543067903,MATH 20A,A01,083754,Staff,22,0,40,18
1650543073930,MATH 20B,A01,083756,Staff,0,11,30,30
1650543073930,MATH 20B,A02,083757,Staff,0,12,30,30
1650543079956,MATH 20C,A01,083760,Staff,0,16,30,30
1650543079956,MATH 20C,A02,083761,Staff,2,14,30,28
1650543079956,MATH 20C,B01,083762,Staff,12,0,30,18
1650543079956,MATH 20C,B02,083763,Staff,28,0,30,2
1650543085982,MATH 20D,A01,083765,Staff,0,1,30,30
1650543085982,MATH 20D,A02,083766,Staff,7,0,30,23
1650543085982,MATH 20D,A03,083767,Staff,25,0,30,5
1650543092016,MATH 20E,A01,083771,Staff,6,0,30,24
1650543092016,MATH 20E,A02,083772,Staff,18,0,30,12
1650543092016,MATH 20E,B01,083773,Staff,0,0,30,30
1650543092016,MATH 20E,B02,083774,Staff,10,0,30,20
1650543098047,MATH 103A,A01,083777,Staff,0,15,30,30
1650543098047,MATH 103A,A02,083778,Staff,0,14,30,30
1650543098047,MATH 103A,B01,083779,Staff,0,13,30,30
1650543098047,MATH 103A,B02,083780,Staff,0,13,30,30
1650543104074,MATH 105,A01,085443,Staff,0,21,30,30
1650543110103,MATH 109,A01,083213,Anzaldo; Leesa B,0,8,30,30
1650543110103,MATH 109,A02,083214,Anzaldo; Leesa B,0,7,30,30
1650543110103,MATH 109,B01,083215,Anzaldo; Leesa B,0,5,30,30
1650543110103,MATH 109,B02,083216,Anzaldo; Leesa B,0,6,30,30
1650543116131,MATH 142A,A01,083219,Chow; Bennett,0,16,30,30
1650543116131,MATH 142A,A02,083220,Chow; Bennett,0,14,30,30
1650543116131,MATH 142A,B01,083221,Chow; Bennett,0,13,30,30
1650543116131,MATH 142A,B02,083222,Chow; Bennett,0,13,30,30
1650543122161,MATH 193A,A01,083224,Staff,0,6,30,30
1650543122161,MATH 193A,A02,083225,Staff,0,5,30,30
1650543122161,MATH 193A,A03,083781,Staff,0,5,30,30
1650543122161,MATH 193A,A04,083782,Staff,0,7,30,30
1650543128191,MATH 197,001,091859,McAuley; Julian John,9998,0,9999,1
1650543134261,COGS 9,A01,083615,Staff,0,16,60,60
1650543140293,COGS 11,A01,083617,Boyle; Mary E. T.,19,0,40,21
1650543146320,COGS 13,A01,083071,Staff,0,35,40,40
1650543152344,COGS 14A,A01,092681,Staff,0,26,100,100
1650543158367,COGS 14B,A01,083073,Cheng; Tzu-Han,0,12,50,50
1650543164391,COGS 17,A01,092677,Staff,19,0,75,56
1650543170420,COGS 100,A01,083619,Staff,0,26,60,60
1650543176449,COGS 101A,A01,083621,Davis; Joshua Daniel,0,26,60,60
1650543182479,COGS 101B,A01,091572,Staff,1,5,60,59
1650543188503,COGS 101C,A01,083625,Delgado; Tania,15,0,30,15
1650543194529,COGS 107A,A01,083627,Boyle; Mary E. T.,0,11,60,60
1650543200558,COGS 118A,A01,083075,Staff,0,3,60,60
1650543206590,CSE 3,A50,083646,Miranda; Gregory Joseph,20,0,38,18
1650543206590,CSE 3,A51,083647,Miranda; Gregory Joseph,36,0,37,1
1650543212616,CSE 8A,A50,083650,Miranda; Gregory Joseph,0,29,40,40
1650543218644,CSE 11,A01,083080,Cao; Yingjun,0,94,40,40
1650543224674,CSE 12,A01,083652,Staff,0,17,100,100
1650543230701,CSE 15L,A01,083654,Staff,0,1,50,50
1650543230701,CSE 15L,A02,083655,Staff,0,0,50,50
1650543236727,CSE 20,A01,083657,Staff,51,0,80,29
1650543242753,CSE 30,A01,083084,Eldon; John,0,77,40,40
1650543248779,CSE 100,A01,083659,Cao; Yingjun,0,66,50,50
1650543254808,CSE 134B,A01,083661,Powell; Thomas Allan,0,34,65,65
1650543260841,CSE 140,A01,083663,Staff,0,5,75,75
1650543266867,CSE 140L,A01,083088,Eldon; John,0,11,75,75
1650543272892,CSE 175,A01,083665,Kumar; Rakesh,7,0,25,18
1650543278927,CSE 190,A00,092507,Dubnov; Shlomo,10,0,20,10
1650543284953,ECE 45,A01,083139,Staff,0,1,60,60
1650543290980,ECE 65,A50,083695,Staff,0,6,30,30
1650543297007,ECE 109,A01,091882,Touri; Behrouz,33,0,70,37
1650543303036,ECE 180,A00,083140,Abi Samra; Nicholas Camill,21,0,30,9
1650543303036,ECE 180,B00,083141,Abi Samra; Nicholas Camill,0,0,30,30
1650543309064,MATH 10A,A01,083735,Patchell; Gregory David,5,0,30,25
1650543309064,MATH 10A,A02,083736,Patchell; Gregory David,27,0,30,3
1650543309064,MATH 10A,A03,083737,Patchell; Gregory David,24,0,30,6
1650543315187,MATH 10B,A01,083207,Staff,0,9,30,30
1650543315187,MATH 10B,A02,083208,Staff,0,7,30,30
1650543315187,MATH 10B,B01,083739,Staff,12,0,30,18
1650543315187,MATH 10B,B02,083740,Staff,28,0,30,2
1650543321221,MATH 18,A01,083743,Staff,1,0,30,29
1650543321221,MATH 18,A02,083744,Staff,26,0,30,4
1650543321221,MATH 18,A03,083745,Staff,22,0,30,8
1650543321221,MATH 18,A04,083746,Staff,26,0,30,4
1650543321221,MATH 18,B01,083748,Staff,0,12,30,30
1650543321221,MATH 18,B02,083749,Staff,0,12,30,30
1650543321221,MATH 18,B03,083750,Staff,0,11,30,30
1650543321221,MATH 18,B04,083751,Staff,0,12,30,30
1650543327251,MATH 20A,A01,083754,Staff,22,0,40,18
1650543333281,MATH 20B,A01,083756,Staff,0,11,30,30
1650543333281,MATH 20B,A02,083757,Staff,0,12,30,30
1650543339311,MATH 20C,A01,083760,Staff,0,16,30,30
1650543339311,MATH 20C,A02,083761,Staff,2,14,30,28
1650543339311,MATH 20C,B01,083762,Staff,12,0,30,18
1650543339311,MATH 20C,B02,083763,Staff,28,0,30,2
1650543345339,MATH 20D,A01,083765,Staff,0,1,30,30
1650543345339,MATH 20D,A02,083766,Staff,7,0,30,23
1650543345339,MATH 20D,A03,083767,Staff,25,0,30,5
1650543351371,MATH 20E,A01,083771,Staff,6,0,30,24
1650543351371,MATH 20E,A02,083772,Staff,18,0,30,12
1650543351371,MATH 20E,B01,083773,Staff,0,0,30,30
1650543351371,MATH 20E,B02,083774,Staff,10,0,30,20
1650543357405,MATH 103A,A01,083777,Staff,0,15,30,30
1650543357405,MATH 103A,A02,083778,Staff,0,14,30,30
1650543357405,MATH 103A,B01,083779,Staff,0,13,30,30
1650543357405,MATH 103A,B02,083780,Staff,0,13,30,30
1650543363435,MATH 105,A01,085443,Staff,0,21,30,30
1650543369464,MATH 109,A01,083213,Anzaldo; Leesa B,0,8,30,30
1650543369464,MATH 109,A02,083214,Anzaldo; Leesa B,0,7,30,30
1650543369464,MATH 109,B01,083215,Anzaldo; Leesa B,0,5,30,30
1650543369464,MATH 109,B02,083216,Anzaldo; Leesa B,0,6,30,30
1650543375489,MATH 142A,A01,083219,Chow; Bennett,0,16,30,30
1650543375489,MATH 142A,A02,083220,Chow; Bennett,0,14,30,30
1650543375489,MATH 142A,B01,083221,Chow; Bennett,0,13,30,30
1650543375489,MATH 142A,B02,083222,Chow; Bennett,0,13,30,30
1650543381513,MATH 193A,A01,083224,Staff,0,6,30,30
1650543381513,MATH 193A,A02,083225,Staff,0,5,30,30
1650543381513,MATH 193A,A03,083781,Staff,0,5,30,30
1650543381513,MATH 193A,A04,083782,Staff,0,7,30,30
1650543387544,MATH 197,001,091859,McAuley; Julian John,9998,0,9999,1
1650543393612,COGS 9,A01,083615,Staff,0,16,60,60
1650543399640,COGS 11,A01,083617,Boyle; Mary E. T.,19,0,40,21
1650543405667,COGS 13,A01,083071,Staff,0,35,40,40
1650543411692,COGS 14A,A01,092681,Staff,0,26,100,100
1650543417718,COGS 14B,A01,083073,Cheng; Tzu-Han,0,12,50,50
1650543423742,COGS 17,A01,092677,Staff,19,0,75,56
1650543429777,COGS 100,A01,083619,Staff,0,26,60,60
1650543435802,COGS 101A,A01,083621,Davis; Joshua Daniel,0,26,60,60
1650543441836,COGS 101B,A01,091572,Staff,1,5,60,59
1650543447862,COGS 101C,A01,083625,Delgado; Tania,15,0,30,15
1650543453893,COGS 107A,A01,083627,Boyle; Mary E. T.,0,11,60,60
1650543459917,COGS 118A,A01,083075,Staff,0,3,60,60
1650543465943,CSE 3,A50,083646,Miranda; Gregory Joseph,20,0,38,18
1650543465943,CSE 3,A51,083647,Miranda; Gregory Joseph,36,0,37,1
1650543471969,CSE 8A,A50,083650,Miranda; Gregory Joseph,0,29,40,40
1650543477995,CSE 11,A01,083080,Cao; Yingjun,0,94,40,40
1650543484025,CSE 12,A01,083652,Staff,0,17,100,100
1650543490051,CSE 15L,A01,083654,Staff,0,1,50,50
1650543490051,CSE 15L,A02,083655,Staff,0,0,50,50
1650543496080,CSE 20,A01,083657,Staff,51,0,80,29
1650543502105,CSE 30,A01,083084,Eldon; John,0,77,40,40
1650543508145,CSE 100,A01,083659,Cao; Yingjun,0,66,50,50
1650543514173,CSE 134B,A01,083661,Powell; Thomas Allan,0,34,65,65
1650543520200,CSE 140,A01,083663,Staff,0,5,75,75
1650543526227,CSE 140L,A01,083088,Eldon; John,0,11,75,75
1650543532252,CSE 175,A01,083665,Kumar; Rakesh,7,0,25,18
1650543538279,CSE 190,A00,092507,Dubnov; Shlomo,10,0,20,10
1650543544308,ECE 45,A01,083139,Staff,0,1,60,60
1650543550331,ECE 65,A50,083695,Staff,0,6,30,30
1650543556356,ECE 109,A01,091882,Touri; Behrouz,33,0,70,37
1650543562384,ECE 180,A00,083140,Abi Samra; Nicholas Camill,21,0,30,9
1650543562384,ECE 180,B00,083141,Abi Samra; Nicholas Camill,0,0,30,30
1650543568417,MATH 10A,A01,083735,Patchell; Gregory David,5,0,30,25
1650543568417,MATH 10A,A02,083736,Patchell; Gregory David,27,0,30,3
1650543568417,MATH 10A,A03,083737,Patchell; Gregory David,24,0,30,6
1650543574443,MATH 10B,A01,083207,Staff,0,9,30,30
1650543574443,MATH 10B,A02,083208,Staff,0,7,30,30
1650543574443,MATH 10B,B01,083739,Staff,12,0,30,18
1650543574443,MATH 10B,B02,083740,Staff,28,0,30,2
1650543580477,MATH 18,A01,083743,Staff,1,0,30,29
1650543580477,MATH 18,A02,083744,Staff,26,0,30,4
1650543580477,MATH 18,A03,083745,Staff,22,0,30,8
1650543580477,MATH 18,A04,083746,Staff,26,0,30,4
1650543580477,MATH 18,B01,083748,Staff,0,12,30,30
1650543580477,MATH 18,B02,083749,Staff,0,12,30,30
1650543580477,MATH 18,B03,083750,Staff,0,11,30,30
1650543580477,MATH 18,B04,083751,Staff,0,12,30,30
1650543586505,MATH 20A,A01,083754,Staff,22,0,40,18
1650543592532,MATH 20B,A01,083756,Staff,0,11,30,30
1650543592532,MATH 20B,A02,083757,Staff,0,12,30,30
1650543598559,MATH 20C,A01,083760,Staff,0,16,30,30
1650543598559,MATH 20C,A02,083761,Staff,2,14,30,28
1650543598559,MATH 20C,B01,083762,Staff,12,0,30,18
1650543598559,MATH 20C,B02,083763,Staff,28,0,30,2
1650543604588,MATH 20D,A01,083765,Staff,0,1,30,30
1650543604588,MATH 20D,A02,083766,Staff,7,0,30,23
1650543604588,MATH 20D,A03,083767,Staff,25,0,30,5
1650543610616,MATH 20E,A01,083771,Staff,6,0,30,24
1650543610616,MATH 20E,A02,083772,Staff,18,0,30,12
1650543610616,MATH 20E,B01,083773,Staff,0,0,30,30
1650543610616,MATH 20E,B02,083774,Staff,10,0,30,20
1650543616650,MATH 103A,A01,083777,Staff,0,15,30,30
1650543616650,MATH 103A,A02,083778,Staff,0,14,30,30
1650543616650,MATH 103A,B01,083779,Staff,0,13,30,30
1650543616650,MATH 103A,B02,083780,Staff,0,13,30,30
1650543622680,MATH 105,A01,085443,Staff,0,21,30,30
1650543628708,MATH 109,A01,083213,Anzaldo; Leesa B,0,8,30,30
1650543628708,MATH 109,A02,083214,Anzaldo; Leesa B,0,7,30,30
1650543628708,MATH 109,B01,083215,Anzaldo; Leesa B,0,5,30,30
1650543628708,MATH 109,B02,083216,Anzaldo; Leesa B,0,6,30,30
1650543634742,MATH 142A,A01,083219,Chow; Bennett,0,16,30,30
1650543634742,MATH 142A,A02,083220,Chow; Bennett,0,14,30,30
1650543634742,MATH 142A,B01,083221,Chow; Bennett,0,13,30,30
1650543634742,MATH 142A,B02,083222,Chow; Bennett,0,13,30,30
1650543640771,MATH 193A,A01,083224,Staff,0,6,30,30
1650543640771,MATH 193A,A02,083225,Staff,0,5,30,30
1650543640771,MATH 193A,A03,083781,Staff,0,5,30,30
1650543640771,MATH 193A,A04,083782,Staff,0,7,30,30
1650543646798,MATH 197,001,091859,McAuley; Julian John,9998,0,9999,1
1650543652884,COGS 9,A01,083615,Staff,0,16,60,60
1650543658915,COGS 11,A01,083617,Boyle; Mary E. T.,19,0,40,21
1650543664942,COGS 13,A01,083071,Staff,0,35,40,40
1650543670974,COGS 14A,A01,092681,Staff,0,26,100,100
1650543677006,COGS 14B,A01,083073,Cheng; Tzu-Han,0,12,50,50
1650543683036,COGS 17,A01,092677,Staff,19,0,75,56
1650543689060,COGS 100,A01,083619,Staff,0,26,60,60
1650543695088,COGS 101A,A01,083621,Davis; Joshua Daniel,0,26,60,60
1650543701114,COGS 101B,A01,091572,Staff,1,5,60,59
1650543707141,COGS 101C,A01,083625,Delgado; Tania,15,0,30,15
1650543713167,COGS 107A,A01,083627,Boyle; Mary E. T.,0,11,60,60
1650543719197,COGS 118A,A01,083075,Staff,0,3,60,60
1650543725230,CSE 3,A50,083646,Miranda; Gregory Joseph,20,0,38,18
1650543725230,CSE 3,A51,083647,Miranda; Gregory Joseph,36,0,37,1
1650543731256,CSE 8A,A50,083650,Miranda; Gregory Joseph,0,29,40,40
1650543737288,CSE 11,A01,083080,Cao; Yingjun,0,94,40,40
1650543743312,CSE 12,A01,083652,Staff,0,17,100,100
1650543749340,CSE 15L,A01,083654,Staff,0,1,50,50
1650543749340,CSE 15L,A02,083655,Staff,0,0,50,50
1650543755369,CSE 20,A01,083657,Staff,51,0,80,29
1650543761394,CSE 30,A01,083084,Eldon; John,0,77,40,40
1650543767423,CSE 100,A01,083659,Cao; Yingjun,0,66,50,50
1650543773453,CSE 134B,A01,083661,Powell; Thomas Allan,0,34,65,65
1650543779481,CSE 140,A01,083663,Staff,0,5,75,75
1650543785509,CSE 140L,A01,083088,Eldon; John,0,11,75,75
1650543791534,CSE 175,A01,083665,Kumar; Rakesh,7,0,25,18
1650543797562,CSE 190,A00,092507,Dubnov; Shlomo,10,0,20,10
1650543803586,ECE 45,A01,083139,Staff,0,1,60,60
1650543809614,ECE 65,A50,083695,Staff,0,6,30,30
1650543815642,ECE 109,A01,091882,Touri; Behrouz,33,0,70,37
1650543821675,ECE 180,A00,083140,Abi Samra; Nicholas Camill,21,0,30,9
1650543821675,ECE 180,B00,083141,Abi Samra; Nicholas Camill,0,0,30,30
1650543827710,MATH 10A,A01,083735,Patchell; Gregory David,5,0,30,25
1650543827710,MATH 10A,A02,083736,Patchell; Gregory David,27,0,30,3
1650543827710,MATH 10A,A03,083737,Patchell; Gregory David,24,0,30,6
1650543833740,MATH 10B,A01,083207,Staff,0,9,30,30
1650543833740,MATH 10B,A02,083208,Staff,0,7,30,30
1650543833740,MATH 10B,B01,083739,Staff,12,0,30,18
1650543833740,MATH 10B,B02,083740,Staff,28,0,30,2
1650543839777,MATH 18,A01,083743,Staff,1,0,30,29
1650543839777,MATH 18,A02,083744,Staff,26,0,30,4
1650543839777,MATH 18,A03,083745,Staff,22,0,30,8
1650543839777,MATH 18,A04,083746,Staff,26,0,30,4
1650543839777,MATH 18,B01,083748,Staff,0,12,30,30
1650543839777,MATH 18,B02,083749,Staff,0,12,30,30
1650543839777,MATH 18,B03,083750,Staff,0,11,30,30
1650543839777,MATH 18,B04,083751,Staff,0,12,30,30
1650543845801,MATH 20A,A01,083754,Staff,22,0,40,18
1650543851832,MATH 20B,A01,083756,Staff,0,11,30,30
1650543851832,MATH 20B,A02,083757,Staff,0,12,30,30
1650543857858,MATH 20C,A01,083760,Staff,0,16,30,30
1650543857858,MATH 20C,A02,083761,Staff,2,14,30,28
1650543857858,MATH 20C,B01,083762,Staff,12,0,30,18
1650543857858,MATH 20C,B02,083763,Staff,28,0,30,2
1650543863888,MATH 20D,A01,083765,Staff,0,1,30,30
1650543863888,MATH 20D,A02,083766,Staff,7,0,30,23
1650543863888,MATH 20D,A03,083767,Staff,25,0,30,5
1650543869916,MATH 20E,A01,083771,Staff,6,0,30,24
1650543869916,MATH 20E,A02,083772,Staff,18,0,30,12
1650543869916,MATH 20E,B01,083773,Staff,0,0,30,30
1650543869916,MATH 20E,B02,083774,Staff,10,0,30,20
1650543875942,MATH 103A,A01,083777,Staff,0,15,30,30
1650543875942,MATH 103A,A02,083778,Staff,0,14,30,30
1650543875942,MATH 103A,B01,083779,Staff,0,13,30,30
1650543875942,MATH 103A,B02,083780,Staff,0,13,30,30
1650543881968,MATH 105,A01,085443,Staff,0,21,30,30
1650543887995,MATH 109,A01,083213,Anzaldo; Leesa B,0,8,30,30
1650543887995,MATH 109,A02,083214,Anzaldo; Leesa B,0,7,30,30
1650543887995,MATH 109,B01,083215,Anzaldo; Leesa B,0,5,30,30
1650543887995,MATH 109,B02,083216,Anzaldo; Leesa B,0,6,30,30
1650543894023,MATH 142A,A01,083219,Chow; Bennett,0,16,30,30
1650543894023,MATH 142A,A02,083220,Chow; Bennett,0,14,30,30
1650543894023,MATH 142A,B01,083221,Chow; Bennett,0,13,30,30
1650543894023,MATH 142A,B02,083222,Chow; Bennett,0,13,30,30
1650543900048,MATH 193A,A01,083224,Staff,0,6,30,30
1650543900048,MATH 193A,A02,083225,Staff,0,5,30,30
1650543900048,MATH 193A,A03,083781,Staff,0,5,30,30
1650543900048,MATH 193A,A04,083782,Staff,0,7,30,30
1650543906073,MATH 197,001,091859,McAuley; Julian John,9998,0,9999,1
1650543912226,COGS 9,A01,083615,Staff,0,16,60,60
1650543918251,COGS 11,A01,083617,Boyle; Mary E. T.,19,0,40,21
1650543924282,COGS 13,A01,083071,Staff,0,35,40,40
1650543930309,COGS 14A,A01,092681,Staff,0,26,100,100
1650543936336,COGS 14B,A01,083073,Cheng; Tzu-Han,0,12,50,50
1650543942361,COGS 17,A01,092677,Staff,19,0,75,56
1650543948386,COGS 100,A01,083619,Staff,0,26,60,60
1650543954412,COGS 101A,A01,083621,Davis; Joshua Daniel,0,26,60,60
1650543960437,COGS 101B,A01,091572,Staff,1,5,60,59
1650543966464,COGS 101C,A01,083625,Delgado; Tania,15,0,30,15
1650543972497,COGS 107A,A01,083627,Boyle; Mary E. T.,0,11,60,60
1650543978524,COGS 118A,A01,083075,Staff,0,3,60,60
1650543984552,CSE 3,A50,083646,Miranda; Gregory Joseph,20,0,38,18
1650543984552,CSE 3,A51,083647,Miranda; Gregory Joseph,36,0,37,1
1650543990576,CSE 8A,A50,083650,Miranda; Gregory Joseph,0,29,40,40
1650543996603,CSE 11,A01,083080,Cao; Yingjun,0,94,40,40
1650544002631,CSE 12,A01,083652,Staff,0,17,100,100
1650544008671,CSE 15L,A01,083654,Staff,0,1,50,50
1650544008671,CSE 15L,A02,083655,Staff,0,0,50,50
1650544014698,CSE 20,A01,083657,Staff,51,0,80,29
1650544020722,CSE 30,A01,083084,Eldon; John,0,77,40,40
1650544026752,CSE 100,A01,083659,Cao; Yingjun,0,66,50,50
1650544032782,CSE 134B,A01,083661,Powell; Thomas Allan,0,34,65,65
1650544038806,CSE 140,A01,083663,Staff,0,5,75,75
1650544044838,CSE 140L,A01,083088,Eldon; John,0,11,75,75
1650544050866,CSE 175,A01,083665,Kumar; Rakesh,7,0,25,18
1650544056892,CSE 190,A00,092507,Dubnov; Shlomo,10,0,20,10
1650544062918,ECE 45,A01,083139,Staff,0,1,60,60
1650544068946,ECE 65,A50,083695,Staff,0,6,30,30
1650544074972,ECE 109,A01,091882,Touri; Behrouz,33,0,70,37
1650544081001,ECE 180,A00,083140,Abi Samra; Nicholas Camill,21,0,30,9
1650544081001,ECE 180,B00,083141,Abi Samra; Nicholas Camill,0,0,30,30
1650544087029,MATH 10A,A01,083735,Patchell; Gregory David,5,0,30,25
1650544087029,MATH 10A,A02,083736,Patchell; Gregory David,27,0,30,3
1650544087029,MATH 10A,A03,083737,Patchell; Gregory David,24,0,30,6
1650544093057,MATH 10B,A01,083207,Staff,0,9,30,30
1650544093057,MATH 10B,A02,083208,Staff,0,7,30,30
1650544093057,MATH 10B,B01,083739,Staff,12,0,30,18
1650544093057,MATH 10B,B02,083740,Staff,28,0,30,2
1650544099096,MATH 18,A01,083743,Staff,1,0,30,29
1650544099096,MATH 18,A02,083744,Staff,26,0,30,4
1650544099096,MATH 18,A03,083745,Staff,22,0,30,8
1650544099096,MATH 18,A04,083746,Staff,26,0,30,4
1650544099096,MATH 18,B01,083748,Staff,0,12,30,30
1650544099096,MATH 18,B02,083749,Staff,0,12,30,30
1650544099096,MATH 18,B03,083750,Staff,0,11,30,30
1650544099096,MATH 18,B04,083751,Staff,0,12,30,30
1650544105129,MATH 20A,A01,083754,Staff,22,0,40,18
1650544111153,MATH 20B,A01,083756,Staff,0,11,30,30
1650544111153,MATH 20B,A02,083757,Staff,0,12,30,30
1650544117179,MATH 20C,A01,083760,Staff,0,16,30,30
1650544117179,MATH 20C,A02,083761,Staff,2,14,30,28
1650544117179,MATH 20C,B01,083762,Staff,12,0,30,18
1650544117179,MATH 20C,B02,083763,Staff,28,0,30,2
1650544123211,MATH 20D,A01,083765,Staff,0,1,30,30
1650544123211,MATH 20D,A02,083766,Staff,7,0,30,23
1650544123211,MATH 20D,A03,083767,Staff,25,0,30,5
1650544129243,MATH 20E,A01,083771,Staff,6,0,30,24
1650544129243,MATH 20E,A02,083772,Staff,18,0,30,12
1650544129243,MATH 20E,B01,083773,Staff,0,0,30,30
1650544129243,MATH 20E,B02,083774,Staff,10,0,30,20
1650544135275,MATH 103A,A01,083777,Staff,0,15,30,30
1650544135275,MATH 103A,A02,083778,Staff,0,14,30,30
1650544135275,MATH 103A,B01,083779,Staff,0,13,30,30
1650544135275,MATH 103A,B02,083780,Staff,0,13,30,30
1650544141301,MATH 105,A01,085443,Staff,0,21,30,30
1650544147328,MATH 109,A01,083213,Anzaldo; Leesa B,0,8,30,30
1650544147328,MATH 109,A02,083214,Anzaldo; Leesa B,0,7,30,30
1650544147328,MATH 109,B01,083215,Anzaldo; Leesa B,0,5,30,30
1650544147328,MATH 109,B02,083216,Anzaldo; Leesa B,0,6,30,30
1650544153368,MATH 142A,A01,083219,Chow; Bennett,0,16,30,30
1650544153368,MATH 142A,A02,083220,Chow; Bennett,0,14,30,30
1650544153368,MATH 142A,B01,083221,Chow; Bennett,0,13,30,30
1650544153368,MATH 142A,B02,083222,Chow; Bennett,0,13,30,30
1650544159392,MATH 193A,A01,083224,Staff,0,6,30,30
1650544159392,MATH 193A,A02,083225,Staff,0,5,30,30
1650544159392,MATH 193A,A03,083781,Staff,0,5,30,30
1650544159392,MATH 193A,A04,083782,Staff,0,7,30,30
1650544165419,MATH 197,001,091859,McAuley; Julian John,9998,0,9999,1
1650544171480,COGS 9,A01,083615,Staff,0,16,60,60
1650544177505,COGS 11,A01,083617,Boyle; Mary E. T.,19,0,40,21
1650544183529,COGS 13,A01,083071,Staff,0,35,40,40
1650544189553,COGS 14A,A01,092681,Staff,0,26,100,100
1650544195583,COGS 14B,A01,083073,Cheng; Tzu-Han,0,12,50,50
1650544201606,COGS 17,A01,092677,Staff,19,0,75,56
1650544207634,COGS 100,A01,083619,Staff,0,26,60,60
1650544213664,COGS 101A,A01,083621,Davis; Joshua Daniel,0,26,60,60
1650544219691,COGS 101B,A01,091572,Staff,1,5,60,59
1650544225721,COGS 101C,A01,083625,Delgado; Tania,15,0,30,15
1650544231750,COGS 107A,A01,083627,Boyle; Mary E. T.,0,11,60,60
1650544237775,COGS 118A,A01,083075,Staff,0,3,60,60
1650544243807,CSE 3,A50,083646,Miranda; Gregory Joseph,20,0,38,18
1650544243807,CSE 3,A51,083647,Miranda; Gregory Joseph,36,0,37,1
1650544249839,CSE 8A,A50,083650,Miranda; Gregory Joseph,0,29,40,40
1650544255867,CSE 11,A01,083080,Cao; Yingjun,0,94,40,40
1650544261893,CSE 12,A01,083652,Staff,0,17,100,100
1650544267917,CSE 15L,A01,083654,Staff,0,1,50,50
1650544267917,CSE 15L,A02,083655,Staff,0,0,50,50
1650544273941,CSE 20,A01,083657,Staff,51,0,80,29
1650544279969,CSE 30,A01,083084,Eldon; John,0,77,40,40
1650544285994,CSE 100,A01,083659,Cao; Yingjun,0,66,50,50
1650544292019,CSE 134B,A01,083661,Powell; Thomas Allan,0,34,65,65
1650544298050,CSE 140,A01,083663,Staff,0,5,75,75
1650544304077,CSE 140L,A01,083088,Eldon; John,0,11,75,75
1650544310102,CSE 175,A01,083665,Kumar; Rakesh,7,0,25,18
1650544316138,CSE 190,A00,092507,Dubnov; Shlomo,10,0,20,10
1650544322167,ECE 45,A01,083139,Staff,0,1,60,60
1650544328193,ECE 65,A50,083695,Staff,0,6,30,30
1650544334218,ECE 109,A01,091882,Touri; Behrouz,33,0,70,37
1650544340252,ECE 180,A00,083140,Abi Samra; Nicholas Camill,21,0,30,9
1650544340252,ECE 180,B00,083141,Abi Samra; Nicholas Camill,0,0,30,30
1650544346287,MATH 10A,A01,083735,Patchell; Gregory David,5,0,30,25
1650544346287,MATH 10A,A02,083736,Patchell; Gregory David,27,0,30,3
1650544346287,MATH 10A,A03,083737,Patchell; Gregory David,24,0,30,6
1650544352312,MATH 10B,A01,083207,Staff,0,9,30,30
1650544352312,MATH 10B,A02,083208,Staff,0,7,30,30
1650544352312,MATH 10B,B01,083739,Staff,12,0,30,18
1650544352312,MATH 10B,B02,083740,Staff,28,0,30,2
1650544358338,MATH 18,A01,083743,Staff,1,0,30,29
1650544358338,MATH 18,A02,083744,Staff,26,0,30,4
1650544358338,MATH 18,A03,083745,Staff,22,0,30,8
1650544358338,MATH 18,A04,083746,Staff,26,0,30,4
1650544358338,MATH 18,B01,083748,Staff,0,12,30,30
1650544358338,MATH 18,B02,083749,Staff,0,12,30,30
1650544358338,MATH 18,B03,083750,Staff,0,11,30,30
1650544358338,MATH 18,B04,083751,Staff,0,12,30,30
1650544364365,MATH 20A,A01,083754,Staff,22,0,40,18
1650544370391,MATH 20B,A01,083756,Staff,0,11,30,30
1650544370391,MATH 20B,A02,083757,Staff,0,12,30,30
1650544376423,MATH 20C,A01,083760,Staff,0,16,30,30
1650544376423,MATH 20C,A02,083761,Staff,2,14,30,28
1650544376423,MATH 20C,B01,083762,Staff,12,0,30,18
1650544376423,MATH 20C,B02,083763,Staff,28,0,30,2
1650544382453,MATH 20D,A01,083765,Staff,0,1,30,30
1650544382453,MATH 20D,A02,083766,Staff,7,0,30,23
1650544382453,MATH 20D,A03,083767,Staff,25,0,30,5
1650544388485,MATH 20E,A01,083771,Staff,6,0,30,24
1650544388485,MATH 20E,A02,083772,Staff,18,0,30,12
1650544388485,MATH 20E,B01,083773,Staff,0,0,30,30
1650544388485,MATH 20E,B02,083774,Staff,10,0,30,20
1650544394510,MATH 103A,A01,083777,Staff,0,15,30,30
1650544394510,MATH 103A,A02,083778,Staff,0,14,30,30
1650544394510,MATH 103A,B01,083779,Staff,0,13,30,30
1650544394510,MATH 103A,B02,083780,Staff,0,13,30,30
1650544400536,MATH 105,A01,085443,Staff,0,21,30,30
1650544406563,MATH 109,A01,083213,Anzaldo; Leesa B,0,8,30,30
1650544406563,MATH 109,A02,083214,Anzaldo; Leesa B,0,7,30,30
1650544406563,MATH 109,B01,083215,Anzaldo; Leesa B,0,5,30,30
1650544406563,MATH 109,B02,083216,Anzaldo; Leesa B,0,6,30,30
1650544412591,MATH 142A,A01,083219,Chow; Bennett,0,16,30,30
1650544412591,MATH 142A,A02,083220,Chow; Bennett,0,14,30,30
1650544412591,MATH 142A,B01,083221,Chow; Bennett,0,13,30,30
1650544412591,MATH 142A,B02,083222,Chow; Bennett,0,13,30,30
1650544418615,MATH 193A,A01,083224,Staff,0,6,30,30
1650544418615,MATH 193A,A02,083225,Staff,0,5,30,30
1650544418615,MATH 193A,A03,083781,Staff,0,5,30,30
1650544418615,MATH 193A,A04,083782,Staff,0,7,30,30
1650544424638,MATH 197,001,091859,McAuley; Julian John,9998,0,9999,1
1650544430701,COGS 9,A01,083615,Staff,0,16,60,60
1650544436734,COGS 11,A01,083617,Boyle; Mary E. T.,19,0,40,21
1650544442760,COGS 13,A01,083071,Staff,0,35,40,40
1650544448786,COGS 14A,A01,092681,Staff,0,26,100,100
1650544454822,COGS 14B,A01,083073,Cheng; Tzu-Han,0,12,50,50
1650544460852,COGS 17,A01,092677,Staff,19,0,75,56
1650544466888,COGS 100,A01,083619,Staff,0,26,60,60
1650544472914,COGS 101A,A01,083621,Davis; Joshua Daniel,0,26,60,60
1650544478939,COGS 101B,A01,091572,Staff,1,5,60,59
1650544484965,COGS 101C,A01,083625,Delgado; Tania,15,0,30,15
1650544490991,COGS 107A,A01,083627,Boyle; Mary E. T.,0,11,60,60
1650544497021,COGS 118A,A01,083075,Staff,0,3,60,60
1650544503139,CSE 3,A50,083646,Miranda; Gregory Joseph,20,0,38,18
1650544503139,CSE 3,A51,083647,Miranda; Gregory Joseph,36,0,37,1
1650544509166,CSE 8A,A50,083650,Miranda; Gregory Joseph,0,29,40,40
1650544515192,CSE 11,A01,083080,Cao; Yingjun,0,94,40,40
1650544521220,CSE 12,A01,083652,Staff,0,17,100,100
1650544527246,CSE 15L,A01,083654,Staff,0,1,50,50
1650544527246,CSE 15L,A02,083655,Staff,0,0,50,50
1650544533273,CSE 20,A01,083657,Staff,51,0,80,29
1650544539301,CSE 30,A01,083084,Eldon; John,0,77,40,40
1650544545325,CSE 100,A01,083659,Cao; Yingjun,0,66,50,50
1650544551354,CSE 134B,A01,083661,Powell; Thomas Allan,0,34,65,65
1650544557383,CSE 140,A01,083663,Staff,0,5,75,75
1650544563414,CSE 140L,A01,083088,Eldon; John,0,11,75,75
1650544569440,CSE 175,A01,083665,Kumar; Rakesh,7,0,25,18
1650544575472,CSE 190,A00,092507,Dubnov; Shlomo,10,0,20,10
1650544581506,ECE 45,A01,083139,Staff,0,1,60,60
1650544587534,ECE 65,A50,083695,Staff,0,6,30,30
1650544593561,ECE 109,A01,091882,Touri; Behrouz,33,0,70,37
1650544599585,ECE 180,A00,083140,Abi Samra; Nicholas Camill,21,0,30,9
1650544599585,ECE 180,B00,083141,Abi Samra; Nicholas Camill,0,0,30,30
1650544605609,MATH 10A,A01,083735,Patchell; Gregory David,5,0,30,25
1650544605609,MATH 10A,A02,083736,Patchell; Gregory David,27,0,30,3
1650544605609,MATH 10A,A03,083737,Patchell; Gregory David,24,0,30,6
1650544611653,MATH 10B,A01,083207,Staff,0,9,30,30
1650544611653,MATH 10B,A02,083208,Staff,0,7,30,30
1650544611653,MATH 10B,B01,083739,Staff,12,0,30,18
1650544611653,MATH 10B,B02,083740,Staff,28,0,30,2
1650544617684,MATH 18,A01,083743,Staff,1,0,30,29
1650544617684,MATH 18,A02,083744,Staff,26,0,30,4
1650544617684,MATH 18,A03,083745,Staff,22,0,30,8
1650544617684,MATH 18,A04,083746,Staff,26,0,30,4
1650544617684,MATH 18,B01,083748,Staff,0,12,30,30
1650544617684,MATH 18,B02,083749,Staff,0,12,30,30
1650544617684,MATH 18,B03,083750,Staff,0,11,30,30
1650544617684,MATH 18,B04,083751,Staff,0,12,30,30
1650544623711,MATH 20A,A01,083754,Staff,22,0,40,18
1650544629736,MATH 20B,A01,083756,Staff,0,11,30,30
1650544629736,MATH 20B,A02,083757,Staff,0,12,30,30
1650544635763,MATH 20C,A01,083760,Staff,0,16,30,30
1650544635763,MATH 20C,A02,083761,Staff,2,14,30,28
1650544635763,MATH 20C,B01,083762,Staff,12,0,30,18
1650544635763,MATH 20C,B02,083763,Staff,28,0,30,2
1650544641793,MATH 20D,A01,083765,Staff,0,1,30,30
1650544641793,MATH 20D,A02,083766,Staff,7,0,30,23
1650544641793,MATH 20D,A03,083767,Staff,25,0,30,5
1650544647818,MATH 20E,A01,083771,Staff,6,0,30,24
1650544647818,MATH 20E,A02,083772,Staff,18,0,30,12
1650544647818,MATH 20E,B01,083773,Staff,0,0,30,30
1650544647818,MATH 20E,B02,083774,Staff,10,0,30,20
1650544653845,MATH 103A,A01,083777,Staff,0,15,30,30
1650544653845,MATH 103A,A02,083778,Staff,0,14,30,30
1650544653845,MATH 103A,B01,083779,Staff,0,13,30,30
1650544653845,MATH 103A,B02,083780,Staff,0,13,30,30
1650544659870,MATH 105,A01,085443,Staff,0,21,30,30
1650544665900,MATH 109,A01,083213,Anzaldo; Leesa B,0,8,30,30
1650544665900,MATH 109,A02,083214,Anzaldo; Leesa B,0,7,30,30
1650544665900,MATH 109,B01,083215,Anzaldo; Leesa B,0,5,30,30
1650544665900,MATH 109,B02,083216,Anzaldo; Leesa B,0,6,30,30
1650544671930,MATH 142A,A01,083219,Chow; Bennett,0,16,30,30
1650544671930,MATH 142A,A02,083220,Chow; Bennett,0,14,30,30
1650544671930,MATH 142A,B01,083221,Chow; Bennett,0,13,30,30
1650544671930,MATH 142A,B02,083222,Chow; Bennett,0,13,30,30
1650544677956,MATH 193A,A01,083224,Staff,0,6,30,30
1650544677956,MATH 193A,A02,083225,Staff,0,5,30,30
1650544677956,MATH 193A,A03,083781,Staff,0,5,30,30
1650544677956,MATH 193A,A04,083782,Staff,0,7,30,30
1650544683984,MATH 197,001,091859,McAuley; Julian John,9998,0,9999,1
1650544690070,COGS 9,A01,083615,Staff,0,16,60,60
1650544696096,COGS 11,A01,083617,Boyle; Mary E. T.,19,0,40,21
1650544702126,COGS 13,A01,083071,Staff,0,35,40,40
1650544708149,COGS 14A,A01,092681,Staff,0,26,100,100
1650544714177,COGS 14B,A01,083073,Cheng; Tzu-Han,0,12,50,50
1650544720205,COGS 17,A01,092677,Staff,19,0,75,56
1650544726229,COGS 100,A01,083619,Staff,0,26,60,60
1650544732261,COGS 101A,A01,083621,Davis; Joshua Daniel,0,26,60,60
1650544738288,COGS 101B,A01,091572,Staff,1,5,60,59
1650544744313,COGS 101C,A01,083625,Delgado; Tania,15,0,30,15
1650544750343,COGS 107A,A01,083627,Boyle; Mary E. T.,0,11,60,60
1650544756367,COGS 118A,A01,083075,Staff,0,3,60,60
1650544762400,CSE 3,A50,083646,Miranda; Gregory Joseph,20,0,38,18
1650544762400,CSE 3,A51,083647,Miranda; Gregory Joseph,36,0,37,1
1650544768426,CSE 8A,A50,083650,Miranda; Gregory Joseph,0,29,40,40
1650544774452,CSE 11,A01,083080,Cao; Yingjun,0,94,40,40
1650544780477,CSE 12,A01,083652,Staff,0,17,100,100
1650544786513,CSE 15L,A01,083654,Staff,0,1,50,50
1650544786513,CSE 15L,A02,083655,Staff,0,0,50,50
1650544792544,CSE 20,A01,083657,Staff,51,0,80,29
1650544798574,CSE 30,A01,083084,Eldon; John,0,77,40,40
1650544804604,CSE 100,A01,083659,Cao; Yingjun,0,66,50,50
1650544810630,CSE 134B,A01,083661,Powell; Thomas Allan,0,34,65,65
1650544816658,CSE 140,A01,083663,Staff,0,5,75,75
1650544822684,CSE 140L,A01,083088,Eldon; John,0,11,75,75
1650544828711,CSE 175,A01,083665,Kumar; Rakesh,7,0,25,18
1650544834740,CSE 190,A00,092507,Dubnov; Shlomo,10,0,20,10
1650544840768,ECE 45,A01,083139,Staff,0,1,60,60
1650544846795,ECE 65,A50,083695,Staff,0,6,30,30
1650544852819,ECE 109,A01,091882,Touri; Behrouz,33,0,70,37
1650544858849,ECE 180,A00,083140,Abi Samra; Nicholas Camill,21,0,30,9
1650544858849,ECE 180,B00,083141,Abi Samra; Nicholas Camill,0,0,30,30
1650544864878,MATH 10A,A01,083735,Patchell; Gregory David,5,0,30,25
1650544864878,MATH 10A,A02,083736,Patchell; Gregory David,27,0,30,3
1650544864878,MATH 10A,A03,083737,Patchell; Gregory David,24,0,30,6
1650544870903,MATH 10B,A01,083207,Staff,0,9,30,30
1650544870903,MATH 10B,A02,083208,Staff,0,7,30,30
1650544870903,MATH 10B,B01,083739,Staff,12,0,30,18
1650544870903,MATH 10B,B02,083740,Staff,28,0,30,2
1650544876932,MATH 18,A01,083743,Staff,1,0,30,29
1650544876932,MATH 18,A02,083744,Staff,26,0,30,4
1650544876932,MATH 18,A03,083745,Staff,22,0,30,8
1650544876932,MATH 18,A04,083746,Staff,26,0,30,4
1650544876932,MATH 18,B01,083748,Staff,0,12,30,30
1650544876932,MATH 18,B02,083749,Staff,0,12,30,30
1650544876932,MATH 18,B03,083750,Staff,0,11,30,30
1650544876932,MATH 18,B04,083751,Staff,0,12,30,30
1650544882960,MATH 20A,A01,083754,Staff,22,0,40,18
1650544888991,MATH 20B,A01,083756,Staff,0,11,30,30
1650544888991,MATH 20B,A02,083757,Staff,0,12,30,30
1650544895020,MATH 20C,A01,083760,Staff,0,16,30,30
1650544895020,MATH 20C,A02,083761,Staff,2,14,30,28
1650544895020,MATH 20C,B01,083762,Staff,12,0,30,18
1650544895020,MATH 20C,B02,083763,Staff,28,0,30,2
1650544901043,MATH 20D,A01,083765,Staff,0,1,30,30
1650544901043,MATH 20D,A02,083766,Staff,7,0,30,23
1650544901043,MATH 20D,A03,083767,Staff,25,0,30,5
1650544907069,MATH 20E,A01,083771,Staff,6,0,30,24
1650544907069,MATH 20E,A02,083772,Staff,18,0,30,12
1650544907069,MATH 20E,B01,083773,Staff,0,0,30,30
1650544907069,MATH 20E,B02,083774,Staff,10,0,30,20
1650544913100,MATH 103A,A01,083777,Staff,0,15,30,30
1650544913100,MATH 103A,A02,083778,Staff,0,14,30,30
1650544913100,MATH 103A,B01,083779,Staff,0,13,30,30
1650544913100,MATH 103A,B02,083780,Staff,0,13,30,30
1650544919159,MATH 105,A01,085443,Staff,0,21,30,30
1650544925190,MATH 109,A01,083213,Anzaldo; Leesa B,0,8,30,30
1650544925190,MATH 109,A02,083214,Anzaldo; Leesa B,0,7,30,30
1650544925190,MATH 109,B01,083215,Anzaldo; Leesa B,0,5,30,30
1650544925190,MATH 109,B02,083216,Anzaldo; Leesa B,0,6,30,30
1650544931225,MATH 142A,A01,083219,Chow; Bennett,0,16,30,30
1650544931225,MATH 142A,A02,083220,Chow; Bennett,0,14,30,30
1650544931225,MATH 142A,B01,083221,Chow; Bennett,0,13,30,30
1650544931225,MATH 142A,B02,083222,Chow; Bennett,0,13,30,30
1650544937251,MATH 193A,A01,083224,Staff,0,6,30,30
1650544937251,MATH 193A,A02,083225,Staff,0,5,30,30
1650544937251,MATH 193A,A03,083781,Staff,0,5,30,30
1650544937251,MATH 193A,A04,083782,Staff,0,7,30,30
1650544943274,MATH 197,001,091859,McAuley; Julian John,9998,0,9999,1
1650544949335,COGS 9,A01,083615,Staff,0,16,60,60
1650544955373,COGS 11,A01,083617,Boyle; Mary E. T.,19,0,40,21
1650544961400,COGS 13,A01,083071,Staff,0,35,40,40
1650544967430,COGS 14A,A01,092681,Staff,0,26,100,100
1650544973460,COGS 14B,A01,083073,Cheng; Tzu-Han,0,12,50,50
1650544979488,COGS 17,A01,092677,Staff,19,0,75,56
1650544985512,COGS 100,A01,083619,Staff,0,26,60,60
1650544991540,COGS 101A,A01,083621,Davis; Joshua Daniel,0,26,60,60
1650544997569,COGS 101B,A01,091572,Staff,1,5,60,59
1650545003600,COGS 101C,A01,083625,Delgado; Tania,15,0,30,15
1650545009626,COGS 107A,A01,083627,Boyle; Mary E. T.,0,11,60,60
1650545015649,COGS 118A,A01,083075,Staff,0,3,60,60
1650545021676,CSE 3,A50,083646,Miranda; Gregory Joseph,20,0,38,18
1650545021676,CSE 3,A51,083647,Miranda; Gregory Joseph,36,0,37,1
1650545027702,CSE 8A,A50,083650,Miranda; Gregory Joseph,0,29,40,40
1650545033727,CSE 11,A01,083080,Cao; Yingjun,0,94,40,40
1650545039751,CSE 12,A01,083652,Staff,0,17,100,100
1650545045778,CSE 15L,A01,083654,Staff,0,1,50,50
1650545045778,CSE 15L,A02,083655,Staff,0,0,50,50
1650545051809,CSE 20,A01,083657,Staff,51,0,80,29
1650545057840,CSE 30,A01,083084,Eldon; John,0,77,40,40
1650545063866,CSE 100,A01,083659,Cao; Yingjun,0,66,50,50
1650545069892,CSE 134B,A01,083661,Powell; Thomas Allan,0,34,65,65
1650545075918,CSE 140,A01,083663,Staff,0,5,75,75
1650545081955,CSE 140L,A01,083088,Eldon; John,0,11,75,75
1650545087981,CSE 175,A01,083665,Kumar; Rakesh,7,0,25,18
1650545094008,CSE 190,A00,092507,Dubnov; Shlomo,10,0,20,10
1650545100144,ECE 45,A01,083139,Staff,0,1,60,60
1650545106170,ECE 65,A50,083695,Staff,0,6,30,30
1650545112201,ECE 109,A01,091882,Touri; Behrouz,33,0,70,37
1650545118227,ECE 180,A00,083140,Abi Samra; Nicholas Camill,21,0,30,9
1650545118227,ECE 180,B00,083141,Abi Samra; Nicholas Camill,0,0,30,30
1650545124252,MATH 10A,A01,083735,Patchell; Gregory David,5,0,30,25
1650545124252,MATH 10A,A02,083736,Patchell; Gregory David,27,0,30,3
1650545124252,MATH 10A,A03,083737,Patchell; Gregory David,24,0,30,6
1650545130279,MATH 10B,A01,083207,Staff,0,9,30,30
1650545130279,MATH 10B,A02,083208,Staff,0,7,30,30
1650545130279,MATH 10B,B01,083739,Staff,12,0,30,18
1650545130279,MATH 10B,B02,083740,Staff,28,0,30,2
1650545136307,MATH 18,A01,083743,Staff,1,0,30,29
1650545136307,MATH 18,A02,083744,Staff,26,0,30,4
1650545136307,MATH 18,A03,083745,Staff,22,0,30,8
1650545136307,MATH 18,A04,083746,Staff,26,0,30,4
1650545136307,MATH 18,B01,083748,Staff,0,12,30,30
1650545136307,MATH 18,B02,083749,Staff,0,12,30,30
1650545136307,MATH 18,B03,083750,Staff,0,11,30,30
1650545136307,MATH 18,B04,083751,Staff,0,12,30,30
1650545142330,MATH 20A,A01,083754,Staff,22,0,40,18
1650545148359,MATH 20B,A01,083756,Staff,0,11,30,30
1650545148359,MATH 20B,A02,083757,Staff,0,12,30,30
1650545154383,MATH 20C,A01,083760,Staff,0,16,30,30
1650545154383,MATH 20C,A02,083761,Staff,2,14,30,28
1650545154383,MATH 20C,B01,083762,Staff,12,0,30,18
1650545154383,MATH 20C,B02,083763,Staff,28,0,30,2
1650545160413,MATH 20D,A01,083765,Staff,0,1,30,30
1650545160413,MATH 20D,A02,083766,Staff,7,0,30,23
1650545160413,MATH 20D,A03,083767,Staff,25,0,30,5
1650545166439,MATH 20E,A01,083771,Staff,6,0,30,24
1650545166439,MATH 20E,A02,083772,Staff,18,0,30,12
1650545166439,MATH 20E,B01,083773,Staff,0,0,30,30
1650545166439,MATH 20E,B02,083774,Staff,10,0,30,20
1650545172470,MATH 103A,A01,083777,Staff,0,15,30,30
1650545172470,MATH 103A,A02,083778,Staff,0,14,30,30
1650545172470,MATH 103A,B01,083779,Staff,0,13,30,30
1650545172470,MATH 103A,B02,083780,Staff,0,13,30,30
1650545178494,MATH 105,A01,085443,Staff,0,21,30,30
1650545184533,MATH 109,A01,083213,Anzaldo; Leesa B,0,8,30,30
1650545184533,MATH 109,A02,083214,Anzaldo; Leesa B,0,7,30,30
1650545184533,MATH 109,B01,083215,Anzaldo; Leesa B,0,5,30,30
1650545184533,MATH 109,B02,083216,Anzaldo; Leesa B,0,6,30,30
1650545190561,MATH 142A,A01,083219,Chow; Bennett,0,16,30,30
1650545190561,MATH 142A,A02,083220,Chow; Bennett,0,14,30,30
1650545190561,MATH 142A,B01,083221,Chow; Bennett,0,13,30,30
1650545190561,MATH 142A,B02,083222,Chow; Bennett,0,13,30,30
1650545196597,MATH 193A,A01,083224,Staff,0,6,30,30
1650545196597,MATH 193A,A02,083225,Staff,0,5,30,30
1650545196597,MATH 193A,A03,083781,Staff,0,5,30,30
1650545196597,MATH 193A,A04,083782,Staff,0,7,30,30
1650545202631,MATH 197,001,091859,McAuley; Julian John,9998,0,9999,1
1650545208719,COGS 9,A01,083615,Staff,0,16,60,60
1650545214744,COGS 11,A01,083617,Boyle; Mary E. T.,19,0,40,21
1650545220774,COGS 13,A01,083071,Staff,0,35,40,40
1650545226802,COGS 14A,A01,092681,Staff,0,26,100,100
1650545232836,COGS 14B,A01,083073,Cheng; Tzu-Han,0,12,50,50
1650545238866,COGS 17,A01,092677,Staff,19,0,75,56
1650545244897,COGS 100,A01,083619,Staff,0,26,60,60
1650545250925,COGS 101A,A01,083621,Davis; Joshua Daniel,0,26,60,60
1650545256956,COGS 101B,A01,091572,Staff,1,5,60,59
1650545262986,COGS 101C,A01,083625,Delgado; Tania,15,0,30,15
1650545269012,COGS 107A,A01,083627,Boyle; Mary E. T.,0,11,60,60
1650545275039,COGS 118A,A01,083075,Staff,0,3,60,60
1650545281074,CSE 3,A50,083646,Miranda; Gregory Joseph,20,0,38,18
1650545281074,CSE 3,A51,083647,Miranda; Gregory Joseph,36,0,37,1
1650545287101,CSE 8A,A50,083650,Miranda; Gregory Joseph,0,29,40,40
1650545293126,CSE 11,A01,083080,Cao; Yingjun,0,94,40,40
1650545299153,CSE 12,A01,083652,Staff,0,17,100,100
1650545305184,CSE 15L,A01,083654,Staff,0,1,50,50
1650545305184,CSE 15L,A02,083655,Staff,0,0,50,50
1650545311211,CSE 20,A01,083657,Staff,51,0,80,29
1650545317237,CSE 30,A01,083084,Eldon; John,0,77,40,40
1650545323263,CSE 100,A01,083659,Cao; Yingjun,0,66,50,50
1650545329288,CSE 134B,A01,083661,Powell; Thomas Allan,0,34,65,65
1650545335312,CSE 140,A01,083663,Staff,0,5,75,75
1650545341338,CSE 140L,A01,083088,Eldon; John,0,11,75,75
1650545347372,CSE 175,A01,083665,Kumar; Rakesh,7,0,25,18
1650545353397,CSE 190,A00,092507,Dubnov; Shlomo,10,0,20,10
1650545359423,ECE 45,A01,083139,Staff,0,1,60,60
1650545365448,ECE 65,A50,083695,Staff,0,6,30,30
1650545371475,ECE 109,A01,091882,Touri; Behrouz,33,0,70,37
1650545377506,ECE 180,A00,083140,Abi Samra; Nicholas Camill,21,0,30,9
1650545377506,ECE 180,B00,083141,Abi Samra; Nicholas Camill,0,0,30,30
1650545383533,MATH 10A,A01,083735,Patchell; Gregory David,5,0,30,25
1650545383533,MATH 10A,A02,083736,Patchell; Gregory David,27,0,30,3
1650545383533,MATH 10A,A03,083737,Patchell; Gregory David,24,0,30,6
1650545389567,MATH 10B,A01,083207,Staff,0,9,30,30
1650545389567,MATH 10B,A02,083208,Staff,0,7,30,30
1650545389567,MATH 10B,B01,083739,Staff,12,0,30,18
1650545389567,MATH 10B,B02,083740,Staff,28,0,30,2
1650545395598,MATH 18,A01,083743,Staff,1,0,30,29
1650545395598,MATH 18,A02,083744,Staff,26,0,30,4
1650545395598,MATH 18,A03,083745,Staff,22,0,30,8
1650545395598,MATH 18,A04,083746,Staff,26,0,30,4
1650545395598,MATH 18,B01,083748,Staff,0,12,30,30
1650545395598,MATH 18,B02,083749,Staff,0,12,30,30
1650545395598,MATH 18,B03,083750,Staff,0,11,30,30
1650545395598,MATH 18,B04,083751,Staff,0,12,30,30
1650545401625,MATH 20A,A01,083754,Staff,22,0,40,18
1650545407655,MATH 20B,A01,083756,Staff,0,11,30,30
1650545407655,MATH 20B,A02,083757,Staff,0,12,30,30
1650545413709,MATH 20C,A01,083760,Staff,0,16,30,30
1650545413709,MATH 20C,A02,083761,Staff,2,14,30,28
1650545413709,MATH 20C,B01,083762,Staff,12,0,30,18
1650545413709,MATH 20C,B02,083763,Staff,28,0,30,2
1650545419762,MATH 20D,A01,083765,Staff,0,1,30,30
1650545419762,MATH 20D,A02,083766,Staff,7,0,30,23
1650545419762,MATH 20D,A03,083767,Staff,25,0,30,5
1650545425814,MATH 20E,A01,083771,Staff,6,0,30,24
1650545425814,MATH 20E,A02,083772,Staff,18,0,30,12
1650545425814,MATH 20E,B01,083773,Staff,0,0,30,30
1650545425814,MATH 20E,B02,083774,Staff,10,0,30,20
1650545431842,MATH 103A,A01,083777,Staff,0,15,30,30
1650545431842,MATH 103A,A02,083778,Staff,0,14,30,30
1650545431842,MATH 103A,B01,083779,Staff,0,13,30,30
1650545431842,MATH 103A,B02,083780,Staff,0,13,30,30
1650545437891,MATH 105,A01,085443,Staff,0,21,30,30
1650545443942,MATH 109,A01,083213,Anzaldo; Leesa B,0,8,30,30
1650545443942,MATH 109,A02,083214,Anzaldo; Leesa B,0,7,30,30
1650545443942,MATH 109,B01,083215,Anzaldo; Leesa B,0,5,30,30
1650545443942,MATH 109,B02,083216,Anzaldo; Leesa B,0,6,30,30
1650545449970,MATH 142A,A01,083219,Chow; Bennett,0,16,30,30
1650545449970,MATH 142A,A02,083220,Chow; Bennett,0,14,30,30
1650545449970,MATH 142A,B01,083221,Chow; Bennett,0,13,30,30
1650545449970,MATH 142A,B02,083222,Chow; Bennett,0,13,30,30
1650545456007,MATH 193A,A01,083224,Staff,0,6,30,30
1650545456007,MATH 193A,A02,083225,Staff,0,5,30,30
1650545456007,MATH 193A,A03,083781,Staff,0,5,30,30
1650545456007,MATH 193A,A04,083782,Staff,0,7,30,30
1650545462038,MATH 197,001,091859,McAuley; Julian John,9998,0,9999,1
1650545468142,COGS 9,A01,083615,Staff,0,16,60,60
1650545474176,COGS 11,A01,083617,Boyle; Mary E. T.,19,0,40,21
1650545480206,COGS 13,A01,083071,Staff,0,35,40,40
1650545486241,COGS 14A,A01,092681,Staff,0,26,100,100
1650545492273,COGS 14B,A01,083073,Cheng; Tzu-Han,0,12,50,50
1650545498302,COGS 17,A01,092677,Staff,19,0,75,56
1650545504329,COGS 100,A01,083619,Staff,0,26,60,60
1650545510356,COGS 101A,A01,083621,Davis; Joshua Daniel,0,26,60,60
1650545516386,COGS 101B,A01,091572,Staff,1,5,60,59
1650545522420,COGS 101C,A01,083625,Delgado; Tania,15,0,30,15
1650545528446,COGS 107A,A01,083627,Boyle; Mary E. T.,0,11,60,60
1650545534471,COGS 118A,A01,083075,Staff,0,3,60,60
1650545540503,CSE 3,A50,083646,Miranda; Gregory Joseph,20,0,38,18
1650545540503,CSE 3,A51,083647,Miranda; Gregory Joseph,36,0,37,1
1650545546528,CSE 8A,A50,083650,Miranda; Gregory Joseph,0,29,40,40
1650545552560,CSE 11,A01,083080,Cao; Yingjun,0,94,40,40
1650545558597,CSE 12,A01,083652,Staff,0,17,100,100
1650545564622,CSE 15L,A01,083654,Staff,0,1,50,50
1650545564622,CSE 15L,A02,083655,Staff,0,0,50,50
1650545570652,CSE 20,A01,083657,Staff,51,0,80,29
1650545576683,CSE 30,A01,083084,Eldon; John,0,77,40,40
1650545582711,CSE 100,A01,083659,Cao; Yingjun,0,66,50,50
1650545588736,CSE 134B,A01,083661,Powell; Thomas Allan,0,34,65,65
1650545594768,CSE 140,A01,083663,Staff,0,5,75,75
1650545600800,CSE 140L,A01,083088,Eldon; John,0,11,75,75
1650545606830,CSE 175,A01,083665,Kumar; Rakesh,7,0,25,18
1650545612858,CSE 190,A00,092507,Dubnov; Shlomo,10,0,20,10
1650545618885,ECE 45,A01,083139,Staff,0,1,60,60
1650545624911,ECE 65,A50,083695,Staff,0,6,30,30
1650545630943,ECE 109,A01,091882,Touri; Behrouz,33,0,70,37
1650545636969,ECE 180,A00,083140,Abi Samra; Nicholas Camill,21,0,30,9
1650545636969,ECE 180,B00,083141,Abi Samra; Nicholas Camill,0,0,30,30
1650545643013,MATH 10A,A01,083735,Patchell; Gregory David,5,0,30,25
1650545643013,MATH 10A,A02,083736,Patchell; Gregory David,27,0,30,3
1650545643013,MATH 10A,A03,083737,Patchell; Gregory David,24,0,30,6
1650545649039,MATH 10B,A01,083207,Staff,0,9,30,30
1650545649039,MATH 10B,A02,083208,Staff,0,7,30,30
1650545649039,MATH 10B,B01,083739,Staff,12,0,30,18
1650545649039,MATH 10B,B02,083740,Staff,28,0,30,2
1650545655076,MATH 18,A01,083743,Staff,1,0,30,29
1650545655076,MATH 18,A02,083744,Staff,26,0,30,4
1650545655076,MATH 18,A03,083745,Staff,22,0,30,8
1650545655076,MATH 18,A04,083746,Staff,26,0,30,4
1650545655076,MATH 18,B01,083748,Staff,0,12,30,30
1650545655076,MATH 18,B02,083749,Staff,0,12,30,30
1650545655076,MATH 18,B03,083750,Staff,0,11,30,30
1650545655076,MATH 18,B04,083751,Staff,0,12,30,30
1650545661100,MATH 20A,A01,083754,Staff,22,0,40,18
1650545667134,MATH 20B,A01,083756,Staff,0,11,30,30
1650545667134,MATH 20B,A02,083757,Staff,0,12,30,30
1650545673162,MATH 20C,A01,083760,Staff,0,16,30,30
1650545673162,MATH 20C,A02,083761,Staff,2,14,30,28
1650545673162,MATH 20C,B01,083762,Staff,12,0,30,18
1650545673162,MATH 20C,B02,083763,Staff,28,0,30,2
1650545679185,MATH 20D,A01,083765,Staff,0,1,30,30
1650545679185,MATH 20D,A02,083766,Staff,7,0,30,23
1650545679185,MATH 20D,A03,083767,Staff,25,0,30,5
1650545685217,MATH 20E,A01,083771,Staff,6,0,30,24
1650545685217,MATH 20E,A02,083772,Staff,18,0,30,12
1650545685217,MATH 20E,B01,083773,Staff,0,0,30,30
1650545685217,MATH 20E,B02,083774,Staff,10,0,30,20
1650545691253,MATH 103A,A01,083777,Staff,0,15,30,30
1650545691253,MATH 103A,A02,083778,Staff,0,14,30,30
1650545691253,MATH 103A,B01,083779,Staff,0,13,30,30
1650545691253,MATH 103A,B02,083780,Staff,0,13,30,30
1650545697370,MATH 105,A01,085443,Staff,0,21,30,30
1650545703407,MATH 109,A01,083213,Anzaldo; Leesa B,0,8,30,30
1650545703407,MATH 109,A02,083214,Anzaldo; Leesa B,0,7,30,30
1650545703407,MATH 109,B01,083215,Anzaldo; Leesa B,0,5,30,30
1650545703407,MATH 109,B02,083216,Anzaldo; Leesa B,0,6,30,30
1650545709433,MATH 142A,A01,083219,Chow; Bennett,0,16,30,30
1650545709433,MATH 142A,A02,083220,Chow; Bennett,0,14,30,30
1650545709433,MATH 142A,B01,083221,Chow; Bennett,0,13,30,30
1650545709433,MATH 142A,B02,083222,Chow; Bennett,0,13,30,30
1650545715464,MATH 193A,A01,083224,Staff,0,6,30,30
1650545715464,MATH 193A,A02,083225,Staff,0,5,30,30
1650545715464,MATH 193A,A03,083781,Staff,0,5,30,30
1650545715464,MATH 193A,A04,083782,Staff,0,7,30,30
1650545721487,MATH 197,001,091859,McAuley; Julian John,9998,0,9999,1
1650545727568,COGS 9,A01,083615,Staff,0,16,60,60
1650545733599,COGS 11,A01,083617,Boyle; Mary E. T.,19,0,40,21
1650545739626,COGS 13,A01,083071,Staff,0,35,40,40
1650545745653,COGS 14A,A01,092681,Staff,0,26,100,100
1650545751683,COGS 14B,A01,083073,Cheng; Tzu-Han,0,12,50,50
1650545757713,COGS 17,A01,092677,Staff,19,0,75,56
1650545763739,COGS 100,A01,083619,Staff,0,26,60,60
1650545769770,COGS 101A,A01,083621,Davis; Joshua Daniel,0,26,60,60
1650545775801,COGS 101B,A01,091572,Staff,1,5,60,59
1650545781833,COGS 101C,A01,083625,Delgado; Tania,15,0,30,15
1650545787861,COGS 107A,A01,083627,Boyle; Mary E. T.,0,11,60,60
1650545793893,COGS 118A,A01,083075,Staff,0,3,60,60
1650545799921,CSE 3,A50,083646,Miranda; Gregory Joseph,20,0,38,18
1650545799921,CSE 3,A51,083647,Miranda; Gregory Joseph,36,0,37,1
1650545805947,CSE 8A,A50,083650,Miranda; Gregory Joseph,0,29,40,40
1650545811979,CSE 11,A01,083080,Cao; Yingjun,0,94,40,40
1650545818004,CSE 12,A01,083652,Staff,0,17,100,100
1650545824029,CSE 15L,A01,083654,Staff,0,1,50,50
1650545824029,CSE 15L,A02,083655,Staff,0,0,50,50
1650545830060,CSE 20,A01,083657,Staff,51,0,80,29
1650545836104,CSE 30,A01,083084,Eldon; John,0,77,40,40
1650545842149,CSE 100,A01,083659,Cao; Yingjun,0,66,50,50
1650545848182,CSE 134B,A01,083661,Powell; Thomas Allan,0,34,65,65
1650545854207,CSE 140,A01,083663,Staff,0,5,75,75
1650545860237,CSE 140L,A01,083088,Eldon; John,0,11,75,75
1650545866271,CSE 175,A01,083665,Kumar; Rakesh,7,0,25,18
1650545872306,CSE 190,A00,092507,Dubnov; Shlomo,10,0,20,10
1650545878332,ECE 45,A01,083139,Staff,0,1,60,60
1650545884357,ECE 65,A50,083695,Staff,0,6,30,30
1650545890390,ECE 109,A01,091882,Touri; Behrouz,33,0,70,37
1650545896418,ECE 180,A00,083140,Abi Samra; Nicholas Camill,21,0,30,9
1650545896418,ECE 180,B00,083141,Abi Samra; Nicholas Camill,0,0,30,30
1650545902451,MATH 10A,A01,083735,Patchell; Gregory David,5,0,30,25
1650545902451,MATH 10A,A02,083736,Patchell; Gregory David,27,0,30,3
1650545902451,MATH 10A,A03,083737,Patchell; Gregory David,24,0,30,6
1650545908483,MATH 10B,A01,083207,Staff,0,9,30,30
1650545908483,MATH 10B,A02,083208,Staff,0,7,30,30
1650545908483,MATH 10B,B01,083739,Staff,12,0,30,18
1650545908483,MATH 10B,B02,083740,Staff,28,0,30,2
1650545914522,MATH 18,A01,083743,Staff,1,0,30,29
1650545914522,MATH 18,A02,083744,Staff,26,0,30,4
1650545914522,MATH 18,A03,083745,Staff,22,0,30,8
1650545914522,MATH 18,A04,083746,Staff,26,0,30,4
1650545914522,MATH 18,B01,083748,Staff,0,12,30,30
1650545914522,MATH 18,B02,083749,Staff,0,12,30,30
1650545914522,MATH 18,B03,083750,Staff,0,11,30,30
1650545914522,MATH 18,B04,083751,Staff,0,12,30,30
1650545920556,MATH 20A,A01,083754,Staff,22,0,40,18
1650545926583,MATH 20B,A01,083756,Staff,0,11,30,30
1650545926583,MATH 20B,A02,083757,Staff,0,12,30,30
1650545932616,MATH 20C,A01,083760,Staff,0,16,30,30
1650545932616,MATH 20C,A02,083761,Staff,2,14,30,28
1650545932616,MATH 20C,B01,083762,Staff,12,0,30,18
1650545932616,MATH 20C,B02,083763,Staff,28,0,30,2
1650545938645,MATH 20D,A01,083765,Staff,0,1,30,30
1650545938645,MATH 20D,A02,083766,Staff,7,0,30,23
1650545938645,MATH 20D,A03,083767,Staff,25,0,30,5
1650545944672,MATH 20E,A01,083771,Staff,6,0,30,24
1650545944672,MATH 20E,A02,083772,Staff,18,0,30,12
1650545944672,MATH 20E,B01,083773,Staff,0,0,30,30
1650545944672,MATH 20E,B02,083774,Staff,10,0,30,20
1650545950704,MATH 103A,A01,083777,Staff,0,15,30,30
1650545950704,MATH 103A,A02,083778,Staff,0,14,30,30
1650545950704,MATH 103A,B01,083779,Staff,0,13,30,30
1650545950704,MATH 103A,B02,083780,Staff,0,13,30,30
1650545956735,MATH 105,A01,085443,Staff,0,21,30,30
1650545962767,MATH 109,A01,083213,Anzaldo; Leesa B,0,8,30,30
1650545962767,MATH 109,A02,083214,Anzaldo; Leesa B,0,7,30,30
1650545962767,MATH 109,B01,083215,Anzaldo; Leesa B,0,5,30,30
1650545962767,MATH 109,B02,083216,Anzaldo; Leesa B,0,6,30,30
1650545968792,MATH 142A,A01,083219,Chow; Bennett,0,16,30,30
1650545968792,MATH 142A,A02,083220,Chow; Bennett,0,14,30,30
1650545968792,MATH 142A,B01,083221,Chow; Bennett,0,13,30,30
1650545968792,MATH 142A,B02,083222,Chow; Bennett,0,13,30,30
1650545974820,MATH 193A,A01,083224,Staff,0,6,30,30
1650545974820,MATH 193A,A02,083225,Staff,0,5,30,30
1650545974820,MATH 193A,A03,083781,Staff,0,5,30,30
1650545974820,MATH 193A,A04,083782,Staff,0,7,30,30
1650545980848,MATH 197,001,091859,McAuley; Julian John,9998,0,9999,1
1650545986923,COGS 9,A01,083615,Staff,0,16,60,60
1650545992955,COGS 11,A01,083617,Boyle; Mary E. T.,19,0,40,21
1650545998984,COGS 13,A01,083071,Staff,0,35,40,40
1650546005013,COGS 14A,A01,092681,Staff,0,26,100,100
1650546011039,COGS 14B,A01,083073,Cheng; Tzu-Han,0,12,50,50
1650546017064,COGS 17,A01,092677,Staff,19,0,75,56
1650546023088,COGS 100,A01,083619,Staff,0,26,60,60
1650546029118,COGS 101A,A01,083621,Davis; Joshua Daniel,0,26,60,60
1650546035143,COGS 101B,A01,091572,Staff,1,5,60,59
1650546041172,COGS 101C,A01,083625,Delgado; Tania,15,0,30,15
1650546047211,COGS 107A,A01,083627,Boyle; Mary E. T.,0,11,60,60
1650546053237,COGS 118A,A01,083075,Staff,0,3,60,60
1650546059263,CSE 3,A50,083646,Miranda; Gregory Joseph,20,0,38,18
1650546059263,CSE 3,A51,083647,Miranda; Gregory Joseph,36,0,37,1
1650546065297,CSE 8A,A50,083650,Miranda; Gregory Joseph,0,29,40,40
1650546071334,CSE 11,A01,083080,Cao; Yingjun,0,94,40,40
1650546077376,CSE 12,A01,083652,Staff,0,17,100,100
1650546083401,CSE 15L,A01,083654,Staff,0,1,50,50
1650546083401,CSE 15L,A02,083655,Staff,0,0,50,50
1650546089425,CSE 20,A01,083657,Staff,51,0,80,29
1650546095461,CSE 30,A01,083084,Eldon; John,0,77,40,40
1650546101488,CSE 100,A01,083659,Cao; Yingjun,0,66,50,50
1650546107515,CSE 134B,A01,083661,Powell; Thomas Allan,0,34,65,65
1650546113538,CSE 140,A01,083663,Staff,0,5,75,75
1650546119568,CSE 140L,A01,083088,Eldon; John,0,11,75,75
1650546125593,CSE 175,A01,083665,Kumar; Rakesh,7,0,25,18
1650546131625,CSE 190,A00,092507,Dubnov; Shlomo,10,0,20,10
1650546137655,ECE 45,A01,083139,Staff,0,1,60,60
1650546143682,ECE 65,A50,083695,Staff,0,6,30,30
1650546149707,ECE 109,A01,091882,Touri; Behrouz,33,0,70,37
1650546155732,ECE 180,A00,083140,Abi Samra; Nicholas Camill,21,0,30,9
1650546155732,ECE 180,B00,083141,Abi Samra; Nicholas Camill,0,0,30,30
1650546161767,MATH 10A,A01,083735,Patchell; Gregory David,5,0,30,25
1650546161767,MATH 10A,A02,083736,Patchell; Gregory David,27,0,30,3
1650546161767,MATH 10A,A03,083737,Patchell; Gregory David,24,0,30,6
1650546167793,MATH 10B,A01,083207,Staff,0,9,30,30
1650546167793,MATH 10B,A02,083208,Staff,0,7,30,30
1650546167793,MATH 10B,B01,083739,Staff,12,0,30,18
1650546167793,MATH 10B,B02,083740,Staff,28,0,30,2
1650546173836,MATH 18,A01,083743,Staff,1,0,30,29
1650546173836,MATH 18,A02,083744,Staff,26,0,30,4
1650546173836,MATH 18,A03,083745,Staff,22,0,30,8
1650546173836,MATH 18,A04,083746,Staff,26,0,30,4
1650546173836,MATH 18,B01,083748,Staff,0,12,30,30
1650546173836,MATH 18,B02,083749,Staff,0,12,30,30
1650546173836,MATH 18,B03,083750,Staff,0,11,30,30
1650546173836,MATH 18,B04,083751,Staff,0,12,30,30
1650546179860,MATH 20A,A01,083754,Staff,22,0,40,18
1650546185886,MATH 20B,A01,083756,Staff,0,11,30,30
1650546185886,MATH 20B,A02,083757,Staff,0,12,30,30
1650546191918,MATH 20C,A01,083760,Staff,0,16,30,30
1650546191918,MATH 20C,A02,083761,Staff,2,14,30,28
1650546191918,MATH 20C,B01,083762,Staff,12,0,30,18
1650546191918,MATH 20C,B02,083763,Staff,28,0,30,2
1650546197946,MATH 20D,A01,083765,Staff,0,1,30,30
1650546197946,MATH 20D,A02,083766,Staff,7,0,30,23
1650546197946,MATH 20D,A03,083767,Staff,25,0,30,5
1650546203972,MATH 20E,A01,083771,Staff,6,0,30,24
1650546203972,MATH 20E,A02,083772,Staff,18,0,30,12
1650546203972,MATH 20E,B01,083773,Staff,0,0,30,30
1650546203972,MATH 20E,B02,083774,Staff,10,0,30,20
1650546209998,MATH 103A,A01,083777,Staff,0,15,30,30
1650546209998,MATH 103A,A02,083778,Staff,0,14,30,30
1650546209998,MATH 103A,B01,083779,Staff,0,13,30,30
1650546209998,MATH 103A,B02,083780,Staff,0,13,30,30
1650546216029,MATH 105,A01,085443,Staff,0,21,30,30
1650546222059,MATH 109,A01,083213,Anzaldo; Leesa B,0,8,30,30
1650546222059,MATH 109,A02,083214,Anzaldo; Leesa B,0,7,30,30
1650546222059,MATH 109,B01,083215,Anzaldo; Leesa B,0,5,30,30
1650546222059,MATH 109,B02,083216,Anzaldo; Leesa B,0,6,30,30
1650546228101,MATH 142A,A01,083219,Chow; Bennett,0,16,30,30
1650546228101,MATH 142A,A02,083220,Chow; Bennett,0,14,30,30
1650546228101,MATH 142A,B01,083221,Chow; Bennett,0,13,30,30
1650546228101,MATH 142A,B02,083222,Chow; Bennett,0,13,30,30
1650546234128,MATH 193A,A01,083224,Staff,0,6,30,30
1650546234128,MATH 193A,A02,083225,Staff,0,5,30,30
1650546234128,MATH 193A,A03,083781,Staff,0,5,30,30
1650546234128,MATH 193A,A04,083782,Staff,0,7,30,30
1650546240154,MATH 197,001,091859,McAuley; Julian John,9998,0,9999,1
1650546246224,COGS 9,A01,083615,Staff,0,16,60,60
1650546252251,COGS 11,A01,083617,Boyle; Mary E. T.,19,0,40,21
1650546258283,COGS 13,A01,083071,Staff,0,35,40,40
1650546264308,COGS 14A,A01,092681,Staff,0,26,100,100
1650546270339,COGS 14B,A01,083073,Cheng; Tzu-Han,0,12,50,50
1650546276364,COGS 17,A01,092677,Staff,19,0,75,56
1650546282393,COGS 100,A01,083619,Staff,0,26,60,60
1650546288504,COGS 101A,A01,083621,Davis; Joshua Daniel,0,26,60,60
1650546294532,COGS 101B,A01,091572,Staff,1,5,60,59
1650546300560,COGS 101C,A01,083625,Delgado; Tania,15,0,30,15
1650546306586,COGS 107A,A01,083627,Boyle; Mary E. T.,0,11,60,60
1650546312613,COGS 118A,A01,083075,Staff,0,3,60,60
1650546318641,CSE 3,A50,083646,Miranda; Gregory Joseph,20,0,38,18
1650546318641,CSE 3,A51,083647,Miranda; Gregory Joseph,36,0,37,1
1650546324667,CSE 8A,A50,083650,Miranda; Gregory Joseph,0,29,40,40
1650546330690,CSE 11,A01,083080,Cao; Yingjun,0,94,40,40
1650546336720,CSE 12,A01,083652,Staff,0,17,100,100
1650546342746,CSE 15L,A01,083654,Staff,0,1,50,50
1650546342746,CSE 15L,A02,083655,Staff,0,0,50,50
1650546348770,CSE 20,A01,083657,Staff,51,0,80,29
1650546354794,CSE 30,A01,083084,Eldon; John,0,77,40,40
1650546360819,CSE 100,A01,083659,Cao; Yingjun,0,66,50,50
1650546366846,CSE 134B,A01,083661,Powell; Thomas Allan,0,34,65,65
1650546372873,CSE 140,A01,083663,Staff,0,5,75,75
1650546378902,CSE 140L,A01,083088,Eldon; John,0,11,75,75
1650546384945,CSE 175,A01,083665,Kumar; Rakesh,7,0,25,18
1650546390977,CSE 190,A00,092507,Dubnov; Shlomo,10,0,20,10
1650546397016,ECE 45,A01,083139,Staff,0,1,60,60
1650546403058,ECE 65,A50,083695,Staff,0,6,30,30
1650546409091,ECE 109,A01,091882,Touri; Behrouz,33,0,70,37
1650546415139,ECE 180,A00,083140,Abi Samra; Nicholas Camill,21,0,30,9
1650546415139,ECE 180,B00,083141,Abi Samra; Nicholas Camill,0,0,30,30
1650546421180,MATH 10A,A01,083735,Patchell; Gregory David,5,0,30,25
1650546421180,MATH 10A,A02,083736,Patchell; Gregory David,27,0,30,3
1650546421180,MATH 10A,A03,083737,Patchell; Gregory David,24,0,30,6
1650546427208,MATH 10B,A01,083207,Staff,0,9,30,30
1650546427208,MATH 10B,A02,083208,Staff,0,7,30,30
1650546427208,MATH 10B,B01,083739,Staff,12,0,30,18
1650546427208,MATH 10B,B02,083740,Staff,28,0,30,2
1650546433266,MATH 18,A01,083743,Staff,1,0,30,29
1650546433266,MATH 18,A02,083744,Staff,26,0,30,4
1650546433266,MATH 18,A03,083745,Staff,22,0,30,8
1650546433266,MATH 18,A04,083746,Staff,26,0,30,4
1650546433266,MATH 18,B01,083748,Staff,0,12,30,30
1650546433266,MATH 18,B02,083749,Staff,0,12,30,30
1650546433266,MATH 18,B03,083750,Staff,0,11,30,30
1650546433266,MATH 18,B04,083751,Staff,0,12,30,30
1650546439297,MATH 20A,A01,083754,Staff,22,0,40,18
1650546445329,MATH 20B,A01,083756,Staff,0,11,30,30
1650546445329,MATH 20B,A02,083757,Staff,0,12,30,30
1650546451357,MATH 20C,A01,083760,Staff,0,16,30,30
1650546451357,MATH 20C,A02,083761,Staff,2,14,30,28
1650546451357,MATH 20C,B01,083762,Staff,12,0,30,18
1650546451357,MATH 20C,B02,083763,Staff,28,0,30,2
1650546457383,MATH 20D,A01,083765,Staff,0,1,30,30
1650546457383,MATH 20D,A02,083766,Staff,7,0,30,23
1650546457383,MATH 20D,A03,083767,Staff,25,0,30,5
1650546463413,MATH 20E,A01,083771,Staff,6,0,30,24
1650546463413,MATH 20E,A02,083772,Staff,18,0,30,12
1650546463413,MATH 20E,B01,083773,Staff,0,0,30,30
1650546463413,MATH 20E,B02,083774,Staff,10,0,30,20
1650546469441,MATH 103A,A01,083777,Staff,0,15,30,30
1650546469441,MATH 103A,A02,083778,Staff,0,14,30,30
1650546469441,MATH 103A,B01,083779,Staff,0,13,30,30
1650546469441,MATH 103A,B02,083780,Staff,0,13,30,30
1650546475469,MATH 105,A01,085443,Staff,0,21,30,30
1650546481495,MATH 109,A01,083213,Anzaldo; Leesa B,0,8,30,30
1650546481495,MATH 109,A02,083214,Anzaldo; Leesa B,0,7,30,30
1650546481495,MATH 109,B01,083215,Anzaldo; Leesa B,0,5,30,30
1650546481495,MATH 109,B02,083216,Anzaldo; Leesa B,0,6,30,30
1650546487523,MATH 142A,A01,083219,Chow; Bennett,0,16,30,30
1650546487523,MATH 142A,A02,083220,Chow; Bennett,0,14,30,30
1650546487523,MATH 142A,B01,083221,Chow; Bennett,0,13,30,30
1650546487523,MATH 142A,B02,083222,Chow; Bennett,0,13,30,30
1650546493554,MATH 193A,A01,083224,Staff,0,6,30,30
1650546493554,MATH 193A,A02,083225,Staff,0,5,30,30
1650546493554,MATH 193A,A03,083781,Staff,0,5,30,30
1650546493554,MATH 193A,A04,083782,Staff,0,7,30,30
1650546499583,MATH 197,001,091859,McAuley; Julian John,9998,0,9999,1
1650546505660,COGS 9,A01,083615,Staff,0,16,60,60
1650546511695,COGS 11,A01,083617,Boyle; Mary E. T.,19,0,40,21
1650546517722,COGS 13,A01,083071,Staff,0,35,40,40
1650546523750,COGS 14A,A01,092681,Staff,0,26,100,100
1650546529782,COGS 14B,A01,083073,Cheng; Tzu-Han,0,12,50,50
1650546535807,COGS 17,A01,092677,Staff,19,0,75,56
1650546541834,COGS 100,A01,083619,Staff,0,26,60,60
1650546547865,COGS 101A,A01,083621,Davis; Joshua Daniel,0,26,60,60
1650546553900,COGS 101B,A01,091572,Staff,1,5,60,59
1650546559932,COGS 101C,A01,083625,Delgado; Tania,15,0,30,15
1650546565957,COGS 107A,A01,083627,Boyle; Mary E. T.,0,11,60,60
1650546571982,COGS 118A,A01,083075,Staff,0,3,60,60
1650546578015,CSE 3,A50,083646,Miranda; Gregory Joseph,20,0,38,18
1650546578015,CSE 3,A51,083647,Miranda; Gregory Joseph,36,0,37,1
1650546584046,CSE 8A,A50,083650,Miranda; Gregory Joseph,0,29,40,40
1650546590071,CSE 11,A01,083080,Cao; Yingjun,0,94,40,40
1650546596096,CSE 12,A01,083652,Staff,0,17,100,100
1650546602122,CSE 15L,A01,083654,Staff,0,1,50,50
1650546602122,CSE 15L,A02,083655,Staff,0,0,50,50
1650546608149,CSE 20,A01,083657,Staff,51,0,80,29
1650546614180,CSE 30,A01,083084,Eldon; John,0,77,40,40
1650546620212,CSE 100,A01,083659,Cao; Yingjun,0,66,50,50
1650546626241,CSE 134B,A01,083661,Powell; Thomas Allan,0,34,65,65
1650546632270,CSE 140,A01,083663,Staff,0,5,75,75
1650546638300,CSE 140L,A01,083088,Eldon; John,0,11,75,75
1650546644328,CSE 175,A01,083665,Kumar; Rakesh,7,0,25,18
1650546650354,CSE 190,A00,092507,Dubnov; Shlomo,10,0,20,10
1650546656379,ECE 45,A01,083139,Staff,0,1,60,60
1650546662405,ECE 65,A50,083695,Staff,0,6,30,30
1650546668432,ECE 109,A01,091882,Touri; Behrouz,33,0,70,37
1650546674462,ECE 180,A00,083140,Abi Samra; Nicholas Camill,21,0,30,9
1650546674462,ECE 180,B00,083141,Abi Samra; Nicholas Camill,0,0,30,30
1650546680494,MATH 10A,A01,083735,Patchell; Gregory David,5,0,30,25
1650546680494,MATH 10A,A02,083736,Patchell; Gregory David,27,0,30,3
1650546680494,MATH 10A,A03,083737,Patchell; Gregory David,24,0,30,6
1650546686521,MATH 10B,A01,083207,Staff,0,9,30,30
1650546686521,MATH 10B,A02,083208,Staff,0,7,30,30
1650546686521,MATH 10B,B01,083739,Staff,12,0,30,18
1650546686521,MATH 10B,B02,083740,Staff,28,0,30,2
1650546692554,MATH 18,A01,083743,Staff,1,0,30,29
1650546692554,MATH 18,A02,083744,Staff,26,0,30,4
1650546692554,MATH 18,A03,083745,Staff,22,0,30,8
1650546692554,MATH 18,A04,083746,Staff,26,0,30,4
1650546692554,MATH 18,B01,083748,Staff,0,12,30,30
1650546692554,MATH 18,B02,083749,Staff,0,12,30,30
1650546692554,MATH 18,B03,083750,Staff,0,11,30,30
1650546692554,MATH 18,B04,083751,Staff,0,12,30,30
1650546698577,MATH 20A,A01,083754,Staff,22,0,40,18
1650546704612,MATH 20B,A01,083756,Staff,0,11,30,30
1650546704612,MATH 20B,A02,083757,Staff,0,12,30,30
1650546710642,MATH 20C,A01,083760,Staff,0,16,30,30
1650546710642,MATH 20C,A02,083761,Staff,2,14,30,28
1650546710642,MATH 20C,B01,083762,Staff,12,0,30,18
1650546710642,MATH 20C,B02,083763,Staff,28,0,30,2
1650546716667,MATH 20D,A01,083765,Staff,0,1,30,30
1650546716667,MATH 20D,A02,083766,Staff,7,0,30,23
1650546716667,MATH 20D,A03,083767,Staff,25,0,30,5
1650546722700,MATH 20E,A01,083771,Staff,6,0,30,24
1650546722700,MATH 20E,A02,083772,Staff,18,0,30,12
1650546722700,MATH 20E,B01,083773,Staff,0,0,30,30
1650546722700,MATH 20E,B02,083774,Staff,10,0,30,20
1650546728728,MATH 103A,A01,083777,Staff,0,15,30,30
1650546728728,MATH 103A,A02,083778,Staff,0,14,30,30
1650546728728,MATH 103A,B01,083779,Staff,0,13,30,30
1650546728728,MATH 103A,B02,083780,Staff,0,13,30,30
1650546734760,MATH 105,A01,085443,Staff,0,21,30,30
1650546740790,MATH 109,A01,083213,Anzaldo; Leesa B,0,8,30,30
1650546740790,MATH 109,A02,083214,Anzaldo; Leesa B,0,7,30,30
1650546740790,MATH 109,B01,083215,Anzaldo; Leesa B,0,5,30,30
1650546740790,MATH 109,B02,083216,Anzaldo; Leesa B,0,6,30,30
1650546746817,MATH 142A,A01,083219,Chow; Bennett,0,16,30,30
1650546746817,MATH 142A,A02,083220,Chow; Bennett,0,14,30,30
1650546746817,MATH 142A,B01,083221,Chow; Bennett,0,13,30,30
1650546746817,MATH 142A,B02,083222,Chow; Bennett,0,13,30,30
1650546752844,MATH 193A,A01,083224,Staff,0,6,30,30
1650546752844,MATH 193A,A02,083225,Staff,0,5,30,30
1650546752844,MATH 193A,A03,083781,Staff,0,5,30,30
1650546752844,MATH 193A,A04,083782,Staff,0,7,30,30
1650546758886,MATH 197,001,091859,McAuley; Julian John,9998,0,9999,1
1650546764965,COGS 9,A01,083615,Staff,0,16,60,60
1650546770996,COGS 11,A01,083617,Boyle; Mary E. T.,19,0,40,21
1650546777023,COGS 13,A01,083071,Staff,0,35,40,40
1650546783050,COGS 14A,A01,092681,Staff,0,26,100,100
1650546789079,COGS 14B,A01,083073,Cheng; Tzu-Han,0,12,50,50
1650546795102,COGS 17,A01,092677,Staff,19,0,75,56
1650546801137,COGS 100,A01,083619,Staff,0,26,60,60
1650546807163,COGS 101A,A01,083621,Davis; Joshua Daniel,0,26,60,60
1650546813196,COGS 101B,A01,091572,Staff,1,5,60,59
1650546819220,COGS 101C,A01,083625,Delgado; Tania,15,0,30,15
1650546825255,COGS 107A,A01,083627,Boyle; Mary E. T.,0,11,60,60
1650546831282,COGS 118A,A01,083075,Staff,0,3,60,60
1650546837308,CSE 3,A50,083646,Miranda; Gregory Joseph,20,0,38,18
1650546837308,CSE 3,A51,083647,Miranda; Gregory Joseph,36,0,37,1
1650546843336,CSE 8A,A50,083650,Miranda; Gregory Joseph,0,29,40,40
1650546849362,CSE 11,A01,083080,Cao; Yingjun,0,94,40,40
1650546855388,CSE 12,A01,083652,Staff,0,17,100,100
1650546861415,CSE 15L,A01,083654,Staff,0,1,50,50
1650546861415,CSE 15L,A02,083655,Staff,0,0,50,50
1650546867438,CSE 20,A01,083657,Staff,51,0,80,29
1650546873468,CSE 30,A01,083084,Eldon; John,0,77,40,40
1650546879497,CSE 100,A01,083659,Cao; Yingjun,0,66,50,50
1650546885598,CSE 134B,A01,083661,Powell; Thomas Allan,0,34,65,65
1650546891622,CSE 140,A01,083663,Staff,0,5,75,75
1650546897651,CSE 140L,A01,083088,Eldon; John,0,11,75,75
1650546903682,CSE 175,A01,083665,Kumar; Rakesh,7,0,25,18
1650546909707,CSE 190,A00,092507,Dubnov; Shlomo,10,0,20,10
1650546915735,ECE 45,A01,083139,Staff,0,1,60,60
1650546921760,ECE 65,A50,083695,Staff,0,6,30,30
1650546927793,ECE 109,A01,091882,Touri; Behrouz,33,0,70,37
1650546933823,ECE 180,A00,083140,Abi Samra; Nicholas Camill,21,0,30,9
1650546933823,ECE 180,B00,083141,Abi Samra; Nicholas Camill,0,0,30,30
1650546939850,MATH 10A,A01,083735,Patchell; Gregory David,5,0,30,25
1650546939850,MATH 10A,A02,083736,Patchell; Gregory David,27,0,30,3
1650546939850,MATH 10A,A03,083737,Patchell; Gregory David,24,0,30,6
1650546945878,MATH 10B,A01,083207,Staff,0,9,30,30
1650546945878,MATH 10B,A02,083208,Staff,0,7,30,30
1650546945878,MATH 10B,B01,083739,Staff,12,0,30,18
1650546945878,MATH 10B,B02,083740,Staff,28,0,30,2
1650546951914,MATH 18,A01,083743,Staff,1,0,30,29
1650546951914,MATH 18,A02,083744,Staff,26,0,30,4
1650546951914,MATH 18,A03,083745,Staff,22,0,30,8
1650546951914,MATH 18,A04,083746,Staff,26,0,30,4
1650546951914,MATH 18,B01,083748,Staff,0,12,30,30
1650546951914,MATH 18,B02,083749,Staff,0,12,30,30
1650546951914,MATH 18,B03,083750,Staff,0,11,30,30
1650546951914,MATH 18,B04,083751,Staff,0,12,30,30
1650546957945,MATH 20A,A01,083754,Staff,22,0,40,18
1650546963981,MATH 20B,A01,083756,Staff,0,11,30,30
1650546963981,MATH 20B,A02,083757,Staff,0,12,30,30
1650546970007,MATH 20C,A01,083760,Staff,0,16,30,30
1650546970007,MATH 20C,A02,083761,Staff,2,14,30,28
1650546970007,MATH 20C,B01,083762,Staff,12,0,30,18
1650546970007,MATH 20C,B02,083763,Staff,28,0,30,2
1650546976039,MATH 20D,A01,083765,Staff,0,1,30,30
1650546976039,MATH 20D,A02,083766,Staff,7,0,30,23
1650546976039,MATH 20D,A03,083767,Staff,25,0,30,5
1650546982070,MATH 20E,A01,083771,Staff,6,0,30,24
1650546982070,MATH 20E,A02,083772,Staff,18,0,30,12
1650546982070,MATH 20E,B01,083773,Staff,0,0,30,30
1650546982070,MATH 20E,B02,083774,Staff,10,0,30,20
1650546988102,MATH 103A,A01,083777,Staff,0,15,30,30
1650546988102,MATH 103A,A02,083778,Staff,0,14,30,30
1650546988102,MATH 103A,B01,083779,Staff,0,13,30,30
1650546988102,MATH 103A,B02,083780,Staff,0,13,30,30
1650546994129,MATH 105,A01,085443,Staff,0,21,30,30
1650547000163,MATH 109,A01,083213,Anzaldo; Leesa B,0,8,30,30
1650547000163,MATH 109,A02,083214,Anzaldo; Leesa B,0,7,30,30
1650547000163,MATH 109,B01,083215,Anzaldo; Leesa B,0,5,30,30
1650547000163,MATH 109,B02,083216,Anzaldo; Leesa B,0,6,30,30
1650547006196,MATH 142A,A01,083219,Chow; Bennett,0,16,30,30
1650547006196,MATH 142A,A02,083220,Chow; Bennett,0,14,30,30
1650547006196,MATH 142A,B01,083221,Chow; Bennett,0,13,30,30
1650547006196,MATH 142A,B02,083222,Chow; Bennett,0,13,30,30
1650547012223,MATH 193A,A01,083224,Staff,0,6,30,30
1650547012223,MATH 193A,A02,083225,Staff,0,5,30,30
1650547012223,MATH 193A,A03,083781,Staff,0,5,30,30
1650547012223,MATH 193A,A04,083782,Staff,0,7,30,30
1650547018257,MATH 197,001,091859,McAuley; Julian John,9998,0,9999,1
1650547024322,COGS 9,A01,083615,Staff,0,16,60,60
1650547030348,COGS 11,A01,083617,Boyle; Mary E. T.,19,0,40,21
1650547036384,COGS 13,A01,083071,Staff,0,35,40,40
1650547042412,COGS 14A,A01,092681,Staff,0,26,100,100
1650547048439,COGS 14B,A01,083073,Cheng; Tzu-Han,0,12,50,50
1650547054476,COGS 17,A01,092677,Staff,19,0,75,56
1650547060502,COGS 100,A01,083619,Staff,0,26,60,60
1650547066532,COGS 101A,A01,083621,Davis; Joshua Daniel,0,26,60,60
1650547072562,COGS 101B,A01,091572,Staff,1,5,60,59
1650547078589,COGS 101C,A01,083625,Delgado; Tania,15,0,30,15
1650547084619,COGS 107A,A01,083627,Boyle; Mary E. T.,0,11,60,60
1650547090646,COGS 118A,A01,083075,Staff,0,3,60,60
1650547096674,CSE 3,A50,083646,Miranda; Gregory Joseph,20,0,38,18
1650547096674,CSE 3,A51,083647,Miranda; Gregory Joseph,36,0,37,1
1650547102710,CSE 8A,A50,083650,Miranda; Gregory Joseph,0,29,40,40
1650547108740,CSE 11,A01,083080,Cao; Yingjun,0,94,40,40
1650547114774,CSE 12,A01,083652,Staff,0,17,100,100
1650547120801,CSE 15L,A01,083654,Staff,0,1,50,50
1650547120801,CSE 15L,A02,083655,Staff,0,0,50,50
1650547126831,CSE 20,A01,083657,Staff,51,0,80,29
1650547132862,CSE 30,A01,083084,Eldon; John,0,77,40,40
1650547138889,CSE 100,A01,083659,Cao; Yingjun,0,66,50,50
1650547144922,CSE 134B,A01,083661,Powell; Thomas Allan,0,34,65,65
1650547150947,CSE 140,A01,083663,Staff,0,5,75,75
1650547156978,CSE 140L,A01,083088,Eldon; John,0,11,75,75
1650547163005,CSE 175,A01,083665,Kumar; Rakesh,7,0,25,18
1650547169038,CSE 190,A00,092507,Dubnov; Shlomo,10,0,20,10
1650547175070,ECE 45,A01,083139,Staff,0,1,60,60
1650547181104,ECE 65,A50,083695,Staff,0,6,30,30
1650547187137,ECE 109,A01,091882,Touri; Behrouz,33,0,70,37
1650547193170,ECE 180,A00,083140,Abi Samra; Nicholas Camill,21,0,30,9
1650547193170,ECE 180,B00,083141,Abi Samra; Nicholas Camill,0,0,30,30
1650547199200,MATH 10A,A01,083735,Patchell; Gregory David,5,0,30,25
1650547199200,MATH 10A,A02,083736,Patchell; Gregory David,27,0,30,3
1650547199200,MATH 10A,A03,083737,Patchell; Gregory David,24,0,30,6
1650547205229,MATH 10B,A01,083207,Staff,0,9,30,30
1650547205229,MATH 10B,A02,083208,Staff,0,7,30,30
1650547205229,MATH 10B,B01,083739,Staff,12,0,30,18
1650547205229,MATH 10B,B02,083740,Staff,28,0,30,2
1650547211263,MATH 18,A01,083743,Staff,1,0,30,29
1650547211263,MATH 18,A02,083744,Staff,26,0,30,4
1650547211263,MATH 18,A03,083745,Staff,22,0,30,8
1650547211263,MATH 18,A04,083746,Staff,26,0,30,4
1650547211263,MATH 18,B01,083748,Staff,0,12,30,30
1650547211263,MATH 18,B02,083749,Staff,0,12,30,30
1650547211263,MATH 18,B03,083750,Staff,0,11,30,30
1650547211263,MATH 18,B04,083751,Staff,0,12,30,30
1650547217291,MATH 20A,A01,083754,Staff,22,0,40,18
1650547223320,MATH 20B,A01,083756,Staff,0,11,30,30
1650547223320,MATH 20B,A02,083757,Staff,0,12,30,30
1650547229346,MATH 20C,A01,083760,Staff,0,16,30,30
1650547229346,MATH 20C,A02,083761,Staff,2,14,30,28
1650547229346,MATH 20C,B01,083762,Staff,12,0,30,18
1650547229346,MATH 20C,B02,083763,Staff,28,0,30,2
1650547235381,MATH 20D,A01,083765,Staff,0,1,30,30
1650547235381,MATH 20D,A02,083766,Staff,7,0,30,23
1650547235381,MATH 20D,A03,083767,Staff,25,0,30,5
1650547241408,MATH 20E,A01,083771,Staff,6,0,30,24
1650547241408,MATH 20E,A02,083772,Staff,18,0,30,12
1650547241408,MATH 20E,B01,083773,Staff,0,0,30,30
1650547241408,MATH 20E,B02,083774,Staff,10,0,30,20
1650547247436,MATH 103A,A01,083777,Staff,0,15,30,30
1650547247436,MATH 103A,A02,083778,Staff,0,14,30,30
1650547247436,MATH 103A,B01,083779,Staff,0,13,30,30
1650547247436,MATH 103A,B02,083780,Staff,0,13,30,30
1650547253476,MATH 105,A01,085443,Staff,0,21,30,30
1650547259505,MATH 109,A01,083213,Anzaldo; Leesa B,0,8,30,30
1650547259505,MATH 109,A02,083214,Anzaldo; Leesa B,0,7,30,30
1650547259505,MATH 109,B01,083215,Anzaldo; Leesa B,0,5,30,30
1650547259505,MATH 109,B02,083216,Anzaldo; Leesa B,0,6,30,30
1650547265540,MATH 142A,A01,083219,Chow; Bennett,0,16,30,30
1650547265540,MATH 142A,A02,083220,Chow; Bennett,0,14,30,30
1650547265540,MATH 142A,B01,083221,Chow; Bennett,0,13,30,30
1650547265540,MATH 142A,B02,083222,Chow; Bennett,0,13,30,30
1650547271566,MATH 193A,A01,083224,Staff,0,6,30,30
1650547271566,MATH 193A,A02,083225,Staff,0,5,30,30
1650547271566,MATH 193A,A03,083781,Staff,0,5,30,30
1650547271566,MATH 193A,A04,083782,Staff,0,7,30,30
1650547277593,MATH 197,001,091859,McAuley; Julian John,9998,0,9999,1
1650547283662,COGS 9,A01,083615,Staff,0,16,60,60
1650547289688,COGS 11,A01,083617,Boyle; Mary E. T.,19,0,40,21
1650547295714,COGS 13,A01,083071,Staff,0,35,40,40
1650547301749,COGS 14A,A01,092681,Staff,0,26,100,100
1650547307778,COGS 14B,A01,083073,Cheng; Tzu-Han,0,12,50,50
1650547313818,COGS 17,A01,092677,Staff,19,0,75,56
1650547319846,COGS 100,A01,083619,Staff,0,26,60,60
1650547325877,COGS 101A,A01,083621,Davis; Joshua Daniel,0,26,60,60
1650547331904,COGS 101B,A01,091572,Staff,1,5,60,59
1650547337938,COGS 101C,A01,083625,Delgado; Tania,15,0,30,15
1650547343967,COGS 107A,A01,083627,Boyle; Mary E. T.,0,11,60,60
1650547349994,COGS 118A,A01,083075,Staff,0,3,60,60
1650547356020,CSE 3,A50,083646,Miranda; Gregory Joseph,20,0,38,18
1650547356020,CSE 3,A51,083647,Miranda; Gregory Joseph,36,0,37,1
1650547362052,CSE 8A,A50,083650,Miranda; Gregory Joseph,0,29,40,40
1650547368077,CSE 11,A01,083080,Cao; Yingjun,0,94,40,40
1650547374107,CSE 12,A01,083652,Staff,0,17,100,100
1650547380144,CSE 15L,A01,083654,Staff,0,1,50,50
1650547380144,CSE 15L,A02,083655,Staff,0,0,50,50
1650547386171,CSE 20,A01,083657,Staff,51,0,80,29
1650547392196,CSE 30,A01,083084,Eldon; John,0,77,40,40
1650547398243,CSE 100,A01,083659,Cao; Yingjun,0,66,50,50
1650547404269,CSE 134B,A01,083661,Powell; Thomas Allan,0,34,65,65
1650547410292,CSE 140,A01,083663,Staff,0,5,75,75
1650547416319,CSE 140L,A01,083088,Eldon; John,0,11,75,75
1650547422348,CSE 175,A01,083665,Kumar; Rakesh,7,0,25,18
1650547428396,CSE 190,A00,092507,Dubnov; Shlomo,10,0,20,10
1650547434421,ECE 45,A01,083139,Staff,0,1,60,60
1650547440452,ECE 65,A50,083695,Staff,0,6,30,30
1650547446480,ECE 109,A01,091882,Touri; Behrouz,33,0,70,37
1650547452506,ECE 180,A00,083140,Abi Samra; Nicholas Camill,21,0,30,9
1650547452506,ECE 180,B00,083141,Abi Samra; Nicholas Camill,0,0,30,30
1650547458534,MATH 10A,A01,083735,Patchell; Gregory David,5,0,30,25
1650547458534,MATH 10A,A02,083736,Patchell; Gregory David,27,0,30,3
1650547458534,MATH 10A,A03,083737,Patchell; Gregory David,24,0,30,6
1650547464559,MATH 10B,A01,083207,Staff,0,9,30,30
1650547464559,MATH 10B,A02,083208,Staff,0,7,30,30
1650547464559,MATH 10B,B01,083739,Staff,12,0,30,18
1650547464559,MATH 10B,B02,083740,Staff,28,0,30,2
1650547470585,MATH 18,A01,083743,Staff,1,0,30,29
1650547470585,MATH 18,A02,083744,Staff,26,0,30,4
1650547470585,MATH 18,A03,083745,Staff,22,0,30,8
1650547470585,MATH 18,A04,083746,Staff,26,0,30,4
1650547470585,MATH 18,B01,083748,Staff,0,12,30,30
1650547470585,MATH 18,B02,083749,Staff,0,12,30,30
1650547470585,MATH 18,B03,083750,Staff,0,11,30,30
1650547470585,MATH 18,B04,083751,Staff,0,12,30,30
1650547476609,MATH 20A,A01,083754,Staff,22,0,40,18
1650547482722,MATH 20B,A01,083756,Staff,0,11,30,30
1650547482722,MATH 20B,A02,083757,Staff,0,12,30,30
1650547488751,MATH 20C,A01,083760,Staff,0,16,30,30
1650547488751,MATH 20C,A02,083761,Staff,2,14,30,28
1650547488751,MATH 20C,B01,083762,Staff,12,0,30,18
1650547488751,MATH 20C,B02,083763,Staff,28,0,30,2
1650547494777,MATH 20D,A01,083765,Staff,0,1,30,30
1650547494777,MATH 20D,A02,083766,Staff,7,0,30,23
1650547494777,MATH 20D,A03,083767,Staff,25,0,30,5
1650547500807,MATH 20E,A01,083771,Staff,6,0,30,24
1650547500807,MATH 20E,A02,083772,Staff,18,0,30,12
1650547500807,MATH 20E,B01,083773,Staff,0,0,30,30
1650547500807,MATH 20E,B02,083774,Staff,10,0,30,20
1650547506834,MATH 103A,A01,083777,Staff,0,15,30,30
1650547506834,MATH 103A,A02,083778,Staff,0,14,30,30
1650547506834,MATH 103A,B01,083779,Staff,0,13,30,30
1650547506834,MATH 103A,B02,083780,Staff,0,13,30,30
1650547512868,MATH 105,A01,085443,Staff,0,21,30,30
1650547518897,MATH 109,A01,083213,Anzaldo; Leesa B,0,8,30,30
1650547518897,MATH 109,A02,083214,Anzaldo; Leesa B,0,7,30,30
1650547518897,MATH 109,B01,083215,Anzaldo; Leesa B,0,5,30,30
1650547518897,MATH 109,B02,083216,Anzaldo; Leesa B,0,6,30,30
1650547524925,MATH 142A,A01,083219,Chow; Bennett,0,16,30,30
1650547524925,MATH 142A,A02,083220,Chow; Bennett,0,14,30,30
1650547524925,MATH 142A,B01,083221,Chow; Bennett,0,13,30,30
1650547524925,MATH 142A,B02,083222,Chow; Bennett,0,13,30,30
1650547530950,MATH 193A,A01,083224,Staff,0,6,30,30
1650547530950,MATH 193A,A02,083225,Staff,0,5,30,30
1650547530950,MATH 193A,A03,083781,Staff,0,5,30,30
1650547530950,MATH 193A,A04,083782,Staff,0,7,30,30
1650547536976,MATH 197,001,091859,McAuley; Julian John,9998,0,9999,1
1650547543050,COGS 9,A01,083615,Staff,0,16,60,60
1650547549077,COGS 11,A01,083617,Boyle; Mary E. T.,19,0,40,21
1650547555102,COGS 13,A01,083071,Staff,0,35,40,40
1650547561131,COGS 14A,A01,092681,Staff,0,26,100,100
1650547567158,COGS 14B,A01,083073,Cheng; Tzu-Han,0,12,50,50
1650547573183,COGS 17,A01,092677,Staff,19,0,75,56
1650547579217,COGS 100,A01,083619,Staff,0,26,60,60
1650547585246,COGS 101A,A01,083621,Davis; Joshua Daniel,0,26,60,60
1650547591272,COGS 101B,A01,091572,Staff,1,5,60,59
1650547597301,COGS 101C,A01,083625,Delgado; Tania,15,0,30,15
1650547603331,COGS 107A,A01,083627,Boyle; Mary E. T.,0,11,60,60
1650547609359,COGS 118A,A01,083075,Staff,0,3,60,60
1650547615385,CSE 3,A50,083646,Miranda; Gregory Joseph,20,0,38,18
1650547615385,CSE 3,A51,083647,Miranda; Gregory Joseph,36,0,37,1
1650547621435,CSE 8A,A50,083650,Miranda; Gregory Joseph,0,29,40,40
1650547627460,CSE 11,A01,083080,Cao; Yingjun,0,94,40,40
1650547633486,CSE 12,A01,083652,Staff,0,17,100,100
1650547639513,CSE 15L,A01,083654,Staff,0,1,50,50
1650547639513,CSE 15L,A02,083655,Staff,0,0,50,50
1650547645537,CSE 20,A01,083657,Staff,51,0,80,29
1650547651562,CSE 30,A01,083084,Eldon; John,0,77,40,40
1650547657587,CSE 100,A01,083659,Cao; Yingjun,0,66,50,50
1650547663616,CSE 134B,A01,083661,Powell; Thomas Allan,0,34,65,65
1650547669654,CSE 140,A01,083663,Staff,0,5,75,75
1650547675680,CSE 140L,A01,083088,Eldon; John,0,11,75,75
1650547681706,CSE 175,A01,083665,Kumar; Rakesh,7,0,25,18
1650547687735,CSE 190,A00,092507,Dubnov; Shlomo,10,0,20,10
1650547693760,ECE 45,A01,083139,Staff,0,1,60,60
1650547699785,ECE 65,A50,083695,Staff,0,6,30,30
1650547705818,ECE 109,A01,091882,Touri; Behrouz,33,0,70,37
1650547711843,ECE 180,A00,083140,Abi Samra; Nicholas Camill,21,0,30,9
1650547711843,ECE 180,B00,083141,Abi Samra; Nicholas Camill,0,0,30,30
1650547717873,MATH 10A,A01,083735,Patchell; Gregory David,5,0,30,25
1650547717873,MATH 10A,A02,083736,Patchell; Gregory David,27,0,30,3
1650547717873,MATH 10A,A03,083737,Patchell; Gregory David,24,0,30,6
1650547723899,MATH 10B,A01,083207,Staff,0,9,30,30
1650547723899,MATH 10B,A02,083208,Staff,0,7,30,30
1650547723899,MATH 10B,B01,083739,Staff,12,0,30,18
1650547723899,MATH 10B,B02,083740,Staff,28,0,30,2
1650547729925,MATH 18,A01,083743,Staff,1,0,30,29
1650547729925,MATH 18,A02,083744,Staff,26,0,30,4
1650547729925,MATH 18,A03,083745,Staff,22,0,30,8
1650547729925,MATH 18,A04,083746,Staff,26,0,30,4
1650547729925,MATH 18,B01,083748,Staff,0,12,30,30
1650547729925,MATH 18,B02,083749,Staff,0,12,30,30
1650547729925,MATH 18,B03,083750,Staff,0,11,30,30
1650547729925,MATH 18,B04,083751,Staff,0,12,30,30
1650547735954,MATH 20A,A01,083754,Staff,22,0,40,18
1650547741980,MATH 20B,A01,083756,Staff,0,11,30,30
1650547741980,MATH 20B,A02,083757,Staff,0,12,30,30
1650547748019,MATH 20C,A01,083760,Staff,0,16,30,30
1650547748019,MATH 20C,A02,083761,Staff,2,14,30,28
1650547748019,MATH 20C,B01,083762,Staff,12,0,30,18
1650547748019,MATH 20C,B02,083763,Staff,28,0,30,2
1650547754045,MATH 20D,A01,083765,Staff,0,1,30,30
1650547754045,MATH 20D,A02,083766,Staff,7,0,30,23
1650547754045,MATH 20D,A03,083767,Staff,25,0,30,5
1650547760070,MATH 20E,A01,083771,Staff,6,0,30,24
1650547760070,MATH 20E,A02,083772,Staff,18,0,30,12
1650547760070,MATH 20E,B01,083773,Staff,0,0,30,30
1650547760070,MATH 20E,B02,083774,Staff,10,0,30,20
1650547766101,MATH 103A,A01,083777,Staff,0,15,30,30
1650547766101,MATH 103A,A02,083778,Staff,0,14,30,30
1650547766101,MATH 103A,B01,083779,Staff,0,13,30,30
1650547766101,MATH 103A,B02,083780,Staff,0,13,30,30
1650547772129,MATH 105,A01,085443,Staff,0,21,30,30
1650547778158,MATH 109,A01,083213,Anzaldo; Leesa B,0,8,30,30
1650547778158,MATH 109,A02,083214,Anzaldo; Leesa B,0,7,30,30
1650547778158,MATH 109,B01,083215,Anzaldo; Leesa B,0,5,30,30
1650547778158,MATH 109,B02,083216,Anzaldo; Leesa B,0,6,30,30
1650547784184,MATH 142A,A01,083219,Chow; Bennett,0,16,30,30
1650547784184,MATH 142A,A02,083220,Chow; Bennett,0,14,30,30
1650547784184,MATH 142A,B01,083221,Chow; Bennett,0,13,30,30
1650547784184,MATH 142A,B02,083222,Chow; Bennett,0,13,30,30
1650547790217,MATH 193A,A01,083224,Staff,0,6,30,30
1650547790217,MATH 193A,A02,083225,Staff,0,5,30,30
1650547790217,MATH 193A,A03,083781,Staff,0,5,30,30
1650547790217,MATH 193A,A04,083782,Staff,0,7,30,30
1650547796247,MATH 197,001,091859,McAuley; Julian John,9998,0,9999,1
1650547802313,COGS 9,A01,083615,Staff,0,16,60,60
1650547808338,COGS 11,A01,083617,Boyle; Mary E. T.,19,0,40,21
1650547814366,COGS 13,A01,083071,Staff,0,35,40,40
1650547820397,COGS 14A,A01,092681,Staff,0,26,100,100
1650547826422,COGS 14B,A01,083073,Cheng; Tzu-Han,0,12,50,50
1650547832450,COGS 17,A01,092677,Staff,19,0,75,56
1650547838474,COGS 100,A01,083619,Staff,0,26,60,60
1650547844503,COGS 101A,A01,083621,Davis; Joshua Daniel,0,26,60,60
1650547850529,COGS 101B,A01,091572,Staff,1,5,60,59
1650547856553,COGS 101C,A01,083625,Delgado; Tania,15,0,30,15
1650547862585,COGS 107A,A01,083627,Boyle; Mary E. T.,0,11,60,60
1650547868614,COGS 118A,A01,083075,Staff,0,3,60,60
1650547874653,CSE 3,A50,083646,Miranda; Gregory Joseph,20,0,38,18
1650547874653,CSE 3,A51,083647,Miranda; Gregory Joseph,36,0,37,1
1650547880679,CSE 8A,A50,083650,Miranda; Gregory Joseph,0,29,40,40
1650547886705,CSE 11,A01,083080,Cao; Yingjun,0,94,40,40
1650547892732,CSE 12,A01,083652,Staff,0,17,100,100
1650547898761,CSE 15L,A01,083654,Staff,0,1,50,50
1650547898761,CSE 15L,A02,083655,Staff,0,0,50,50
1650547904786,CSE 20,A01,083657,Staff,51,0,80,29
1650547910811,CSE 30,A01,083084,Eldon; John,0,77,40,40
1650547916840,CSE 100,A01,083659,Cao; Yingjun,0,66,50,50
1650547922867,CSE 134B,A01,083661,Powell; Thomas Allan,0,34,65,65
1650547928892,CSE 140,A01,083663,Staff,0,5,75,75
1650547934916,CSE 140L,A01,083088,Eldon; John,0,11,75,75
1650547940953,CSE 175,A01,083665,Kumar; Rakesh,7,0,25,18
1650547946985,CSE 190,A00,092507,Dubnov; Shlomo,10,0,20,10
1650547953014,ECE 45,A01,083139,Staff,0,1,60,60
1650547959041,ECE 65,A50,083695,Staff,0,6,30,30
1650547965071,ECE 109,A01,091882,Touri; Behrouz,33,0,70,37
1650547971097,ECE 180,A00,083140,Abi Samra; Nicholas Camill,21,0,30,9
1650547971097,ECE 180,B00,083141,Abi Samra; Nicholas Camill,0,0,30,30
1650547977123,MATH 10A,A01,083735,Patchell; Gregory David,5,0,30,25
1650547977123,MATH 10A,A02,083736,Patchell; Gregory David,27,0,30,3
1650547977123,MATH 10A,A03,083737,Patchell; Gregory David,24,0,30,6
1650547983154,MATH 10B,A01,083207,Staff,0,9,30,30
1650547983154,MATH 10B,A02,083208,Staff,0,7,30,30
1650547983154,MATH 10B,B01,083739,Staff,12,0,30,18
1650547983154,MATH 10B,B02,083740,Staff,28,0,30,2
1650547989182,MATH 18,A01,083743,Staff,1,0,30,29
1650547989182,MATH 18,A02,083744,Staff,26,0,30,4
1650547989182,MATH 18,A03,083745,Staff,22,0,30,8
1650547989182,MATH 18,A04,083746,Staff,26,0,30,4
1650547989182,MATH 18,B01,083748,Staff,0,12,30,30
1650547989182,MATH 18,B02,083749,Staff,0,12,30,30
1650547989182,MATH 18,B03,083750,Staff,0,11,30,30
1650547989182,MATH 18,B04,083751,Staff,0,12,30,30
1650547995206,MATH 20A,A01,083754,Staff,22,0,40,18
1650548001230,MATH 20B,A01,083756,Staff,0,11,30,30
1650548001230,MATH 20B,A02,083757,Staff,0,12,30,30
1650548007256,MATH 20C,A01,083760,Staff,0,16,30,30
1650548007256,MATH 20C,A02,083761,Staff,2,14,30,28
1650548007256,MATH 20C,B01,083762,Staff,12,0,30,18
1650548007256,MATH 20C,B02,083763,Staff,28,0,30,2
1650548013284,MATH 20D,A01,083765,Staff,0,1,30,30
1650548013284,MATH 20D,A02,083766,Staff,7,0,30,23
1650548013284,MATH 20D,A03,083767,Staff,25,0,30,5
1650548019315,MATH 20E,A01,083771,Staff,6,0,30,24
1650548019315,MATH 20E,A02,083772,Staff,18,0,30,12
1650548019315,MATH 20E,B01,083773,Staff,0,0,30,30
1650548019315,MATH 20E,B02,083774,Staff,10,0,30,20
1650548025357,MATH 103A,A01,083777,Staff,0,15,30,30
1650548025357,MATH 103A,A02,083778,Staff,0,14,30,30
1650548025357,MATH 103A,B01,083779,Staff,0,13,30,30
1650548025357,MATH 103A,B02,083780,Staff,0,13,30,30
1650548031384,MATH 105,A01,085443,Staff,0,21,30,30
1650548037410,MATH 109,A01,083213,Anzaldo; Leesa B,0,8,30,30
1650548037410,MATH 109,A02,083214,Anzaldo; Leesa B,0,7,30,30
1650548037410,MATH 109,B01,083215,Anzaldo; Leesa B,0,5,30,30
1650548037410,MATH 109,B02,083216,Anzaldo; Leesa B,0,6,30,30
1650548043433,MATH 142A,A01,083219,Chow; Bennett,0,16,30,30
1650548043433,MATH 142A,A02,083220,Chow; Bennett,0,14,30,30
1650548043433,MATH 142A,B01,083221,Chow; Bennett,0,13,30,30
1650548043433,MATH 142A,B02,083222,Chow; Bennett,0,13,30,30
1650548049473,MATH 193A,A01,083224,Staff,0,6,30,30
1650548049473,MATH 193A,A02,083225,Staff,0,5,30,30
1650548049473,MATH 193A,A03,083781,Staff,0,5,30,30
1650548049473,MATH 193A,A04,083782,Staff,0,7,30,30
1650548055498,MATH 197,001,091859,McAuley; Julian John,9998,0,9999,1
1650548061558,COGS 9,A01,083615,Staff,0,16,60,60
1650548067583,COGS 11,A01,083617,Boyle; Mary E. T.,19,0,40,21
1650548073702,COGS 13,A01,083071,Staff,0,35,40,40
1650548079728,COGS 14A,A01,092681,Staff,0,26,100,100
1650548085754,COGS 14B,A01,083073,Cheng; Tzu-Han,0,12,50,50
1650548091781,COGS 17,A01,092677,Staff,19,0,75,56
1650548097822,COGS 100,A01,083619,Staff,0,26,60,60
1650548103850,COGS 101A,A01,083621,Davis; Joshua Daniel,0,26,60,60
1650548109878,COGS 101B,A01,091572,Staff,1,5,60,59
1650548115903,COGS 101C,A01,083625,Delgado; Tania,15,0,30,15
1650548121927,COGS 107A,A01,083627,Boyle; Mary E. T.,0,11,60,60
1650548127955,COGS 118A,A01,083075,Staff,0,3,60,60
1650548133985,CSE 3,A50,083646,Miranda; Gregory Joseph,20,0,38,18
1650548133985,CSE 3,A51,083647,Miranda; Gregory Joseph,36,0,37,1
1650548140010,CSE 8A,A50,083650,Miranda; Gregory Joseph,0,29,40,40
1650548146036,CSE 11,A01,083080,Cao; Yingjun,0,94,40,40
1650548152061,CSE 12,A01,083652,Staff,0,17,100,100
1650548158087,CSE 15L,A01,083654,Staff,0,1,50,50
1650548158087,CSE 15L,A02,083655,Staff,0,0,50,50
1650548164150,CSE 20,A01,083657,Staff,51,0,80,29
1650548170190,CSE 30,A01,083084,Eldon; John,0,77,40,40
1650548176221,CSE 100,A01,083659,Cao; Yingjun,0,66,50,50
1650548182249,CSE 134B,A01,083661,Powell; Thomas Allan,0,34,65,65
1650548188279,CSE 140,A01,083663,Staff,0,5,75,75
1650548194306,CSE 140L,A01,083088,Eldon; John,0,11,75,75
1650548200339,CSE 175,A01,083665,Kumar; Rakesh,7,0,25,18
1650548206376,CSE 190,A00,092507,Dubnov; Shlomo,10,0,20,10
1650548212401,ECE 45,A01,083139,Staff,0,1,60,60
1650548218428,ECE 65,A50,083695,Staff,0,6,30,30
1650548224457,ECE 109,A01,091882,Touri; Behrouz,33,0,70,37
1650548230482,ECE 180,A00,083140,Abi Samra; Nicholas Camill,21,0,30,9
1650548230482,ECE 180,B00,083141,Abi Samra; Nicholas Camill,0,0,30,30
1650548236516,MATH 10A,A01,083735,Patchell; Gregory David,5,0,30,25
1650548236516,MATH 10A,A02,083736,Patchell; Gregory David,27,0,30,3
1650548236516,MATH 10A,A03,083737,Patchell; Gregory David,24,0,30,6
1650548242546,MATH 10B,A01,083207,Staff,0,9,30,30
1650548242546,MATH 10B,A02,083208,Staff,0,7,30,30
1650548242546,MATH 10B,B01,083739,Staff,12,0,30,18
1650548242546,MATH 10B,B02,083740,Staff,28,0,30,2
1650548248573,MATH 18,A01,083743,Staff,1,0,30,29
1650548248573,MATH 18,A02,083744,Staff,26,0,30,4
1650548248573,MATH 18,A03,083745,Staff,22,0,30,8
1650548248573,MATH 18,A04,083746,Staff,26,0,30,4
1650548248573,MATH 18,B01,083748,Staff,0,12,30,30
1650548248573,MATH 18,B02,083749,Staff,0,12,30,30
1650548248573,MATH 18,B03,083750,Staff,0,11,30,30
1650548248573,MATH 18,B04,083751,Staff,0,12,30,30
1650548254601,MATH 20A,A01,083754,Staff,22,0,40,18
1650548260626,MATH 20B,A01,083756,Staff,0,11,30,30
1650548260626,MATH 20B,A02,083757,Staff,0,12,30,30
1650548266651,MATH 20C,A01,083760,Staff,0,16,30,30
1650548266651,MATH 20C,A02,083761,Staff,2,14,30,28
1650548266651,MATH 20C,B01,083762,Staff,12,0,30,18
1650548266651,MATH 20C,B02,083763,Staff,28,0,30,2
1650548272678,MATH 20D,A01,083765,Staff,0,1,30,30
1650548272678,MATH 20D,A02,083766,Staff,7,0,30,23
1650548272678,MATH 20D,A03,083767,Staff,25,0,30,5
1650548278707,MATH 20E,A01,083771,Staff,6,0,30,24
1650548278707,MATH 20E,A02,083772,Staff,18,0,30,12
1650548278707,MATH 20E,B01,083773,Staff,0,0,30,30
1650548278707,MATH 20E,B02,083774,Staff,10,0,30,20
1650548284736,MATH 103A,A01,083777,Staff,0,15,30,30
1650548284736,MATH 103A,A02,083778,Staff,0,14,30,30
1650548284736,MATH 103A,B01,083779,Staff,0,13,30,30
1650548284736,MATH 103A,B02,083780,Staff,0,13,30,30
1650548290762,MATH 105,A01,085443,Staff,0,21,30,30
1650548296790,MATH 109,A01,083213,Anzaldo; Leesa B,0,8,30,30
1650548296790,MATH 109,A02,083214,Anzaldo; Leesa B,0,7,30,30
1650548296790,MATH 109,B01,083215,Anzaldo; Leesa B,0,5,30,30
1650548296790,MATH 109,B02,083216,Anzaldo; Leesa B,0,6,30,30
1650548302820,MATH 142A,A01,083219,Chow; Bennett,0,16,30,30
1650548302820,MATH 142A,A02,083220,Chow; Bennett,0,14,30,30
1650548302820,MATH 142A,B01,083221,Chow; Bennett,0,13,30,30
1650548302820,MATH 142A,B02,083222,Chow; Bennett,0,13,30,30
1650548308849,MATH 193A,A01,083224,Staff,0,6,30,30
1650548308849,MATH 193A,A02,083225,Staff,0,5,30,30
1650548308849,MATH 193A,A03,083781,Staff,0,5,30,30
1650548308849,MATH 193A,A04,083782,Staff,0,7,30,30
1650548314874,MATH 197,001,091859,McAuley; Julian John,9998,0,9999,1
1650548320932,COGS 9,A01,083615,Staff,0,16,60,60
1650548326959,COGS 11,A01,083617,Boyle; Mary E. T.,19,0,40,21
1650548332983,COGS 13,A01,083071,Staff,0,35,40,40
1650548339009,COGS 14A,A01,092681,Staff,0,26,100,100
1650548345035,COGS 14B,A01,083073,Cheng; Tzu-Han,0,12,50,50
1650548351062,COGS 17,A01,092677,Staff,19,0,75,56
1650548357094,COGS 100,A01,083619,Staff,0,26,60,60
1650548363121,COGS 101A,A01,083621,Davis; Joshua Daniel,0,26,60,60
1650548369147,COGS 101B,A01,091572,Staff,1,5,60,59
1650548375181,COGS 101C,A01,083625,Delgado; Tania,15,0,30,15
1650548381210,COGS 107A,A01,083627,Boyle; Mary E. T.,0,11,60,60
1650548387241,COGS 118A,A01,083075,Staff,0,3,60,60
1650548393270,CSE 3,A50,083646,Miranda; Gregory Joseph,20,0,38,18
1650548393270,CSE 3,A51,083647,Miranda; Gregory Joseph,36,0,37,1
1650548399299,CSE 8A,A50,083650,Miranda; Gregory Joseph,0,29,40,40
1650548405322,CSE 11,A01,083080,Cao; Yingjun,0,94,40,40
1650548411354,CSE 12,A01,083652,Staff,0,17,100,100
1650548417387,CSE 15L,A01,083654,Staff,0,1,50,50
1650548417387,CSE 15L,A02,083655,Staff,0,0,50,50
1650548423413,CSE 20,A01,083657,Staff,51,0,80,29
1650548429442,CSE 30,A01,083084,Eldon; John,0,77,40,40
1650548435467,CSE 100,A01,083659,Cao; Yingjun,0,66,50,50
1650548441501,CSE 134B,A01,083661,Powell; Thomas Allan,0,34,65,65
1650548447527,CSE 140,A01,083663,Staff,0,5,75,75
1650548453556,CSE 140L,A01,083088,Eldon; John,0,11,75,75
1650548459581,CSE 175,A01,083665,Kumar; Rakesh,7,0,25,18
1650548465605,CSE 190,A00,092507,Dubnov; Shlomo,10,0,20,10
1650548471631,ECE 45,A01,083139,Staff,0,1,60,60
1650548477657,ECE 65,A50,083695,Staff,0,6,30,30
1650548483691,ECE 109,A01,091882,Touri; Behrouz,33,0,70,37
1650548489724,ECE 180,A00,083140,Abi Samra; Nicholas Camill,21,0,30,9
1650548489724,ECE 180,B00,083141,Abi Samra; Nicholas Camill,0,0,30,30
1650548495749,MATH 10A,A01,083735,Patchell; Gregory David,5,0,30,25
1650548495749,MATH 10A,A02,083736,Patchell; Gregory David,27,0,30,3
1650548495749,MATH 10A,A03,083737,Patchell; Gregory David,24,0,30,6
1650548501779,MATH 10B,A01,083207,Staff,0,9,30,30
1650548501779,MATH 10B,A02,083208,Staff,0,7,30,30
1650548501779,MATH 10B,B01,083739,Staff,12,0,30,18
1650548501779,MATH 10B,B02,083740,Staff,28,0,30,2
1650548507806,MATH 18,A01,083743,Staff,1,0,30,29
1650548507806,MATH 18,A02,083744,Staff,26,0,30,4
1650548507806,MATH 18,A03,083745,Staff,22,0,30,8
1650548507806,MATH 18,A04,083746,Staff,26,0,30,4
1650548507806,MATH 18,B01,083748,Staff,0,12,30,30
1650548507806,MATH 18,B02,083749,Staff,0,12,30,30
1650548507806,MATH 18,B03,083750,Staff,0,11,30,30
1650548507806,MATH 18,B04,083751,Staff,0,12,30,30
1650548513834,MATH 20A,A01,083754,Staff,22,0,40,18
1650548519859,MATH 20B,A01,083756,Staff,0,11,30,30
1650548519859,MATH 20B,A02,083757,Staff,0,12,30,30
1650548525885,MATH 20C,A01,083760,Staff,0,16,30,30
1650548525885,MATH 20C,A02,083761,Staff,2,14,30,28
1650548525885,MATH 20C,B01,083762,Staff,12,0,30,18
1650548525885,MATH 20C,B02,083763,Staff,28,0,30,2
1650548531913,MATH 20D,A01,083765,Staff,0,1,30,30
1650548531913,MATH 20D,A02,083766,Staff,7,0,30,23
1650548531913,MATH 20D,A03,083767,Staff,25,0,30,5
1650548537942,MATH 20E,A01,083771,Staff,6,0,30,24
1650548537942,MATH 20E,A02,083772,Staff,18,0,30,12
1650548537942,MATH 20E,B01,083773,Staff,0,0,30,30
1650548537942,MATH 20E,B02,083774,Staff,10,0,30,20
1650548543968,MATH 103A,A01,083777,Staff,0,15,30,30
1650548543968,MATH 103A,A02,083778,Staff,0,14,30,30
1650548543968,MATH 103A,B01,083779,Staff,0,13,30,30
1650548543968,MATH 103A,B02,083780,Staff,0,13,30,30
1650548549999,MATH 105,A01,085443,Staff,0,21,30,30
1650548556024,MATH 109,A01,083213,Anzaldo; Leesa B,0,8,30,30
1650548556024,MATH 109,A02,083214,Anzaldo; Leesa B,0,7,30,30
1650548556024,MATH 109,B01,083215,Anzaldo; Leesa B,0,5,30,30
1650548556024,MATH 109,B02,083216,Anzaldo; Leesa B,0,6,30,30
1650548562048,MATH 142A,A01,083219,Chow; Bennett,0,16,30,30
1650548562048,MATH 142A,A02,083220,Chow; Bennett,0,14,30,30
1650548562048,MATH 142A,B01,083221,Chow; Bennett,0,13,30,30
1650548562048,MATH 142A,B02,083222,Chow; Bennett,0,13,30,30
1650548568082,MATH 193A,A01,083224,Staff,0,6,30,30
1650548568082,MATH 193A,A02,083225,Staff,0,5,30,30
1650548568082,MATH 193A,A03,083781,Staff,0,5,30,30
1650548568082,MATH 193A,A04,083782,Staff,0,7,30,30
1650548574109,MATH 197,001,091859,McAuley; Julian John,9998,0,9999,1
1650548580164,COGS 9,A01,083615,Staff,0,16,60,60
1650548586188,COGS 11,A01,083617,Boyle; Mary E. T.,19,0,40,21
1650548592214,COGS 13,A01,083071,Staff,0,35,40,40
1650548598243,COGS 14A,A01,092681,Staff,0,26,100,100
1650548604269,COGS 14B,A01,083073,Cheng; Tzu-Han,0,12,50,50
1650548610299,COGS 17,A01,092677,Staff,19,0,75,56
1650548616322,COGS 100,A01,083619,Staff,0,26,60,60
1650548622347,COGS 101A,A01,083621,Davis; Joshua Daniel,0,26,60,60
1650548628372,COGS 101B,A01,091572,Staff,1,5,60,59
1650548634397,COGS 101C,A01,083625,Delgado; Tania,15,0,30,15
1650548640425,COGS 107A,A01,083627,Boyle; Mary E. T.,0,11,60,60
1650548646460,COGS 118A,A01,083075,Staff,0,3,60,60
1650548652488,CSE 3,A50,083646,Miranda; Gregory Joseph,20,0,38,18
1650548652488,CSE 3,A51,083647,Miranda; Gregory Joseph,36,0,37,1
1650548658516,CSE 8A,A50,083650,Miranda; Gregory Joseph,0,29,40,40
1650548664538,CSE 11,A01,083080,Cao; Yingjun,0,94,40,40
1650548670658,CSE 12,A01,083652,Staff,0,17,100,100
1650548676680,CSE 15L,A01,083654,Staff,0,1,50,50
1650548676680,CSE 15L,A02,083655,Staff,0,0,50,50
1650548682703,CSE 20,A01,083657,Staff,51,0,80,29
1650548688730,CSE 30,A01,083084,Eldon; John,0,77,40,40
1650548694757,CSE 100,A01,083659,Cao; Yingjun,0,66,50,50
1650548700797,CSE 134B,A01,083661,Powell; Thomas Allan,0,34,65,65
1650548706831,CSE 140,A01,083663,Staff,0,5,75,75
1650548712855,CSE 140L,A01,083088,Eldon; John,0,11,75,75
1650548718879,CSE 175,A01,083665,Kumar; Rakesh,7,0,25,18
1650548724924,CSE 190,A00,092507,Dubnov; Shlomo,10,0,20,10
1650548730950,ECE 45,A01,083139,Staff,0,1,60,60
1650548736978,ECE 65,A50,083695,Staff,0,6,30,30
1650548743002,ECE 109,A01,091882,Touri; Behrouz,33,0,70,37
1650548749035,ECE 180,A00,083140,Abi Samra; Nicholas Camill,21,0,30,9
1650548749035,ECE 180,B00,083141,Abi Samra; Nicholas Camill,0,0,30,30
1650548755060,MATH 10A,A01,083735,Patchell; Gregory David,5,0,30,25
1650548755060,MATH 10A,A02,083736,Patchell; Gregory David,27,0,30,3
1650548755060,MATH 10A,A03,083737,Patchell; Gregory David,24,0,30,6
1650548761098,MATH 10B,A01,083207,Staff,0,9,30,30
1650548761098,MATH 10B,A02,083208,Staff,0,7,30,30
1650548761098,MATH 10B,B01,083739,Staff,12,0,30,18
1650548761098,MATH 10B,B02,083740,Staff,28,0,30,2
1650548767133,MATH 18,A01,083743,Staff,1,0,30,29
1650548767133,MATH 18,A02,083744,Staff,26,0,30,4
1650548767133,MATH 18,A03,083745,Staff,22,0,30,8
1650548767133,MATH 18,A04,083746,Staff,26,0,30,4
1650548767133,MATH 18,B01,083748,Staff,0,12,30,30
1650548767133,MATH 18,B02,083749,Staff,0,12,30,30
1650548767133,MATH 18,B03,083750,Staff,0,11,30,30
1650548767133,MATH 18,B04,083751,Staff,0,12,30,30
1650548773156,MATH 20A,A01,083754,Staff,22,0,40,18
1650548779182,MATH 20B,A01,083756,Staff,0,11,30,30
1650548779182,MATH 20B,A02,083757,Staff,0,12,30,30
1650548785209,MATH 20C,A01,083760,Staff,0,16,30,30
1650548785209,MATH 20C,A02,083761,Staff,2,14,30,28
1650548785209,MATH 20C,B01,083762,Staff,12,0,30,18
1650548785209,MATH 20C,B02,083763,Staff,28,0,30,2
1650548791234,MATH 20D,A01,083765,Staff,0,1,30,30
1650548791234,MATH 20D,A02,083766,Staff,7,0,30,23
1650548791234,MATH 20D,A03,083767,Staff,25,0,30,5
1650548797256,MATH 20E,A01,083771,Staff,6,0,30,24
1650548797256,MATH 20E,A02,083772,Staff,18,0,30,12
1650548797256,MATH 20E,B01,083773,Staff,0,0,30,30
1650548797256,MATH 20E,B02,083774,Staff,10,0,30,20
1650548803283,MATH 103A,A01,083777,Staff,0,15,30,30
1650548803283,MATH 103A,A02,083778,Staff,0,14,30,30
1650548803283,MATH 103A,B01,083779,Staff,0,13,30,30
1650548803283,MATH 103A,B02,083780,Staff,0,13,30,30
1650548809308,MATH 105,A01,085443,Staff,0,21,30,30
1650548815333,MATH 109,A01,083213,Anzaldo; Leesa B,0,8,30,30
1650548815333,MATH 109,A02,083214,Anzaldo; Leesa B,0,7,30,30
1650548815333,MATH 109,B01,083215,Anzaldo; Leesa B,0,5,30,30
1650548815333,MATH 109,B02,083216,Anzaldo; Leesa B,0,6,30,30
1650548821356,MATH 142A,A01,083219,Chow; Bennett,0,16,30,30
1650548821356,MATH 142A,A02,083220,Chow; Bennett,0,14,30,30
1650548821356,MATH 142A,B01,083221,Chow; Bennett,0,13,30,30
1650548821356,MATH 142A,B02,083222,Chow; Bennett,0,13,30,30
1650548827379,MATH 193A,A01,083224,Staff,0,6,30,30
1650548827379,MATH 193A,A02,083225,Staff,0,5,30,30
1650548827379,MATH 193A,A03,083781,Staff,0,5,30,30
1650548827379,MATH 193A,A04,083782,Staff,0,7,30,30
1650548833401,MATH 197,001,091859,McAuley; Julian John,9998,0,9999,1
1650548839456,COGS 9,A01,083615,Staff,0,16,60,60
1650548845484,COGS 11,A01,083617,Boyle; Mary E. T.,19,0,40,21
1650548851513,COGS 13,A01,083071,Staff,0,35,40,40
1650548857537,COGS 14A,A01,092681,Staff,0,26,100,100
1650548863564,COGS 14B,A01,083073,Cheng; Tzu-Han,0,12,50,50
1650548869591,COGS 17,A01,092677,Staff,19,0,75,56
1650548875615,COGS 100,A01,083619,Staff,0,26,60,60
1650548881643,COGS 101A,A01,083621,Davis; Joshua Daniel,0,26,60,60
1650548887671,COGS 101B,A01,091572,Staff,1,5,60,59
1650548893697,COGS 101C,A01,083625,Delgado; Tania,15,0,30,15
1650548899723,COGS 107A,A01,083627,Boyle; Mary E. T.,0,11,60,60
1650548905746,COGS 118A,A01,083075,Staff,0,3,60,60
1650548911772,CSE 3,A50,083646,Miranda; Gregory Joseph,20,0,38,18
1650548911772,CSE 3,A51,083647,Miranda; Gregory Joseph,36,0,37,1
1650548917797,CSE 8A,A50,083650,Miranda; Gregory Joseph,0,29,40,40
1650548923823,CSE 11,A01,083080,Cao; Yingjun,0,94,40,40
1650548929848,CSE 12,A01,083652,Staff,0,17,100,100
1650548935876,CSE 15L,A01,083654,Staff,0,1,50,50
1650548935876,CSE 15L,A02,083655,Staff,0,0,50,50
1650548941904,CSE 20,A01,083657,Staff,51,0,80,29
1650548947939,CSE 30,A01,083084,Eldon; John,0,77,40,40
1650548953965,CSE 100,A01,083659,Cao; Yingjun,0,66,50,50
1650548959990,CSE 134B,A01,083661,Powell; Thomas Allan,0,34,65,65
1650548966023,CSE 140,A01,083663,Staff,0,5,75,75
1650548972054,CSE 140L,A01,083088,Eldon; John,0,11,75,75
1650548978077,CSE 175,A01,083665,Kumar; Rakesh,7,0,25,18
1650548984103,CSE 190,A00,092507,Dubnov; Shlomo,10,0,20,10
1650548990131,ECE 45,A01,083139,Staff,0,1,60,60
1650548996155,ECE 65,A50,083695,Staff,0,6,30,30
1650549002182,ECE 109,A01,091882,Touri; Behrouz,33,0,70,37
1650549008208,ECE 180,A00,083140,Abi Samra; Nicholas Camill,21,0,30,9
1650549008208,ECE 180,B00,083141,Abi Samra; Nicholas Camill,0,0,30,30
1650549014237,MATH 10A,A01,083735,Patchell; Gregory David,5,0,30,25
1650549014237,MATH 10A,A02,083736,Patchell; Gregory David,27,0,30,3
1650549014237,MATH 10A,A03,083737,Patchell; Gregory David,24,0,30,6
1650549020262,MATH 10B,A01,083207,Staff,0,9,30,30
1650549020262,MATH 10B,A02,083208,Staff,0,7,30,30
1650549020262,MATH 10B,B01,083739,Staff,12,0,30,18
1650549020262,MATH 10B,B02,083740,Staff,28,0,30,2
1650549026293,MATH 18,A01,083743,Staff,1,0,30,29
1650549026293,MATH 18,A02,083744,Staff,26,0,30,4
1650549026293,MATH 18,A03,083745,Staff,22,0,30,8
1650549026293,MATH 18,A04,083746,Staff,26,0,30,4
1650549026293,MATH 18,B01,083748,Staff,0,12,30,30
1650549026293,MATH 18,B02,083749,Staff,0,12,30,30
1650549026293,MATH 18,B03,083750,Staff,0,11,30,30
1650549026293,MATH 18,B04,083751,Staff,0,12,30,30
1650549032321,MATH 20A,A01,083754,Staff,22,0,40,18
1650549038345,MATH 20B,A01,083756,Staff,0,11,30,30
1650549038345,MATH 20B,A02,083757,Staff,0,12,30,30
1650549044373,MATH 20C,A01,083760,Staff,0,16,30,30
1650549044373,MATH 20C,A02,083761,Staff,2,14,30,28
1650549044373,MATH 20C,B01,083762,Staff,12,0,30,18
1650549044373,MATH 20C,B02,083763,Staff,28,0,30,2
1650549050400,MATH 20D,A01,083765,Staff,0,1,30,30
1650549050400,MATH 20D,A02,083766,Staff,7,0,30,23
1650549050400,MATH 20D,A03,083767,Staff,25,0,30,5
1650549056426,MATH 20E,A01,083771,Staff,6,0,30,24
1650549056426,MATH 20E,A02,083772,Staff,18,0,30,12
1650549056426,MATH 20E,B01,083773,Staff,0,0,30,30
1650549056426,MATH 20E,B02,083774,Staff,10,0,30,20
1650549062451,MATH 103A,A01,083777,Staff,0,15,30,30
1650549062451,MATH 103A,A02,083778,Staff,0,14,30,30
1650549062451,MATH 103A,B01,083779,Staff,0,13,30,30
1650549062451,MATH 103A,B02,083780,Staff,0,13,30,30
1650549068485,MATH 105,A01,085443,Staff,0,21,30,30
1650549074522,MATH 109,A01,083213,Anzaldo; Leesa B,0,8,30,30
1650549074522,MATH 109,A02,083214,Anzaldo; Leesa B,0,7,30,30
1650549074522,MATH 109,B01,083215,Anzaldo; Leesa B,0,5,30,30
1650549074522,MATH 109,B02,083216,Anzaldo; Leesa B,0,6,30,30
1650549080553,MATH 142A,A01,083219,Chow; Bennett,0,16,30,30
1650549080553,MATH 142A,A02,083220,Chow; Bennett,0,14,30,30
1650549080553,MATH 142A,B01,083221,Chow; Bennett,0,13,30,30
1650549080553,MATH 142A,B02,083222,Chow; Bennett,0,13,30,30
1650549086576,MATH 193A,A01,083224,Staff,0,6,30,30
1650549086576,MATH 193A,A02,083225,Staff,0,5,30,30
1650549086576,MATH 193A,A03,083781,Staff,0,5,30,30
1650549086576,MATH 193A,A04,083782,Staff,0,7,30,30
1650549092601,MATH 197,001,091859,McAuley; Julian John,9998,0,9999,1
1650549098666,COGS 9,A01,083615,Staff,0,16,60,60
1650549104689,COGS 11,A01,083617,Boyle; Mary E. T.,19,0,40,21
1650549110713,COGS 13,A01,083071,Staff,0,35,40,40
1650549116740,COGS 14A,A01,092681,Staff,0,26,100,100
1650549122766,COGS 14B,A01,083073,Cheng; Tzu-Han,0,12,50,50
1650549128791,COGS 17,A01,092677,Staff,19,0,75,56
1650549134819,COGS 100,A01,083619,Staff,0,26,60,60
1650549140845,COGS 101A,A01,083621,Davis; Joshua Daniel,0,26,60,60
1650549146876,COGS 101B,A01,091572,Staff,1,5,60,59
1650549152907,COGS 101C,A01,083625,Delgado; Tania,15,0,30,15
1650549158936,COGS 107A,A01,083627,Boyle; Mary E. T.,0,11,60,60
1650549164961,COGS 118A,A01,083075,Staff,0,3,60,60
1650549171004,CSE 3,A50,083646,Miranda; Gregory Joseph,20,0,38,18
1650549171004,CSE 3,A51,083647,Miranda; Gregory Joseph,36,0,37,1
1650549177029,CSE 8A,A50,083650,Miranda; Gregory Joseph,0,29,40,40
1650549183054,CSE 11,A01,083080,Cao; Yingjun,0,94,40,40
1650549189079,CSE 12,A01,083652,Staff,0,17,100,100
1650549195102,CSE 15L,A01,083654,Staff,0,1,50,50
1650549195102,CSE 15L,A02,083655,Staff,0,0,50,50
1650549201131,CSE 20,A01,083657,Staff,51,0,80,29
1650549207161,CSE 30,A01,083084,Eldon; John,0,77,40,40
1650549213190,CSE 100,A01,083659,Cao; Yingjun,0,66,50,50
1650549219215,CSE 134B,A01,083661,Powell; Thomas Allan,0,34,65,65
1650549225243,CSE 140,A01,083663,Staff,0,5,75,75
1650549231272,CSE 140L,A01,083088,Eldon; John,0,11,75,75
1650549237298,CSE 175,A01,083665,Kumar; Rakesh,7,0,25,18
1650549243324,CSE 190,A00,092507,Dubnov; Shlomo,10,0,20,10
1650549249352,ECE 45,A01,083139,Staff,0,1,60,60
1650549255375,ECE 65,A50,083695,Staff,0,6,30,30
1650549261399,ECE 109,A01,091882,Touri; Behrouz,33,0,70,37
1650549267515,ECE 180,A00,083140,Abi Samra; Nicholas Camill,21,0,30,9
1650549267515,ECE 180,B00,083141,Abi Samra; Nicholas Camill,0,0,30,30
1650549273546,MATH 10A,A01,083735,Patchell; Gregory David,5,0,30,25
1650549273546,MATH 10A,A02,083736,Patchell; Gregory David,27,0,30,3
1650549273546,MATH 10A,A03,083737,Patchell; Gregory David,24,0,30,6
1650549279571,MATH 10B,A01,083207,Staff,0,9,30,30
1650549279571,MATH 10B,A02,083208,Staff,0,7,30,30
1650549279571,MATH 10B,B01,083739,Staff,12,0,30,18
1650549279571,MATH 10B,B02,083740,Staff,28,0,30,2
1650549285598,MATH 18,A01,083743,Staff,1,0,30,29
1650549285598,MATH 18,A02,083744,Staff,26,0,30,4
1650549285598,MATH 18,A03,083745,Staff,22,0,30,8
1650549285598,MATH 18,A04,083746,Staff,26,0,30,4
1650549285598,MATH 18,B01,083748,Staff,0,12,30,30
1650549285598,MATH 18,B02,083749,Staff,0,12,30,30
1650549285598,MATH 18,B03,083750,Staff,0,11,30,30
1650549285598,MATH 18,B04,083751,Staff,0,12,30,30
1650549291624,MATH 20A,A01,083754,Staff,22,0,40,18
1650549297652,MATH 20B,A01,083756,Staff,0,11,30,30
1650549297652,MATH 20B,A02,083757,Staff,0,12,30,30
1650549303678,MATH 20C,A01,083760,Staff,0,16,30,30
1650549303678,MATH 20C,A02,083761,Staff,2,14,30,28
1650549303678,MATH 20C,B01,083762,Staff,12,0,30,18
1650549303678,MATH 20C,B02,083763,Staff,28,0,30,2
1650549309703,MATH 20D,A01,083765,Staff,0,1,30,30
1650549309703,MATH 20D,A02,083766,Staff,7,0,30,23
1650549309703,MATH 20D,A03,083767,Staff,25,0,30,5
1650549315729,MATH 20E,A01,083771,Staff,6,0,30,24
1650549315729,MATH 20E,A02,083772,Staff,18,0,30,12
1650549315729,MATH 20E,B01,083773,Staff,0,0,30,30
1650549315729,MATH 20E,B02,083774,Staff,10,0,30,20
1650549321757,MATH 103A,A01,083777,Staff,0,15,30,30
1650549321757,MATH 103A,A02,083778,Staff,0,14,30,30
1650549321757,MATH 103A,B01,083779,Staff,0,13,30,30
1650549321757,MATH 103A,B02,083780,Staff,0,13,30,30
1650549327783,MATH 105,A01,085443,Staff,0,21,30,30
1650549333816,MATH 109,A01,083213,Anzaldo; Leesa B,0,8,30,30
1650549333816,MATH 109,A02,083214,Anzaldo; Leesa B,0,7,30,30
1650549333816,MATH 109,B01,083215,Anzaldo; Leesa B,0,5,30,30
1650549333816,MATH 109,B02,083216,Anzaldo; Leesa B,0,6,30,30
1650549339841,MATH 142A,A01,083219,Chow; Bennett,0,16,30,30
1650549339841,MATH 142A,A02,083220,Chow; Bennett,0,14,30,30
1650549339841,MATH 142A,B01,083221,Chow; Bennett,0,13,30,30
1650549339841,MATH 142A,B02,083222,Chow; Bennett,0,13,30,30
1650549345872,MATH 193A,A01,083224,Staff,0,6,30,30
1650549345872,MATH 193A,A02,083225,Staff,0,5,30,30
1650549345872,MATH 193A,A03,083781,Staff,0,5,30,30
1650549345872,MATH 193A,A04,083782,Staff,0,7,30,30
1650549351897,MATH 197,001,091859,McAuley; Julian John,9998,0,9999,1
1650549357973,COGS 9,A01,083615,Staff,0,16,60,60
1650549363995,COGS 11,A01,083617,Boyle; Mary E. T.,19,0,40,21
1650549370019,COGS 13,A01,083071,Staff,0,35,40,40
1650549376049,COGS 14A,A01,092681,Staff,0,26,100,100
1650549382074,COGS 14B,A01,083073,Cheng; Tzu-Han,0,12,50,50
1650549388105,COGS 17,A01,092677,Staff,19,0,75,56
1650549394129,COGS 100,A01,083619,Staff,0,26,60,60
1650549400153,COGS 101A,A01,083621,Davis; Joshua Daniel,0,26,60,60
1650549406180,COGS 101B,A01,091572,Staff,1,5,60,59
1650549412204,COGS 101C,A01,083625,Delgado; Tania,15,0,30,15
1650549418229,COGS 107A,A01,083627,Boyle; Mary E. T.,0,11,60,60
1650549424262,COGS 118A,A01,083075,Staff,0,3,60,60
1650549430287,CSE 3,A50,083646,Miranda; Gregory Joseph,20,0,38,18
1650549430287,CSE 3,A51,083647,Miranda; Gregory Joseph,36,0,37,1
1650549436312,CSE 8A,A50,083650,Miranda; Gregory Joseph,0,29,40,40
1650549442340,CSE 11,A01,083080,Cao; Yingjun,0,94,40,40
1650549448363,CSE 12,A01,083652,Staff,0,17,100,100
1650549454390,CSE 15L,A01,083654,Staff,0,1,50,50
1650549454390,CSE 15L,A02,083655,Staff,0,0,50,50
1650549460415,CSE 20,A01,083657,Staff,51,0,80,29
1650549466447,CSE 30,A01,083084,Eldon; John,0,77,40,40
1650549472475,CSE 100,A01,083659,Cao; Yingjun,0,66,50,50
1650549478502,CSE 134B,A01,083661,Powell; Thomas Allan,0,34,65,65
1650549484533,CSE 140,A01,083663,Staff,0,5,75,75
1650549490557,CSE 140L,A01,083088,Eldon; John,0,11,75,75
1650549496589,CSE 175,A01,083665,Kumar; Rakesh,7,0,25,18
1650549502612,CSE 190,A00,092507,Dubnov; Shlomo,10,0,20,10
1650549508647,ECE 45,A01,083139,Staff,0,1,60,60
1650549514673,ECE 65,A50,083695,Staff,0,6,30,30
1650549520698,ECE 109,A01,091882,Touri; Behrouz,33,0,70,37
1650549526724,ECE 180,A00,083140,Abi Samra; Nicholas Camill,21,0,30,9
1650549526724,ECE 180,B00,083141,Abi Samra; Nicholas Camill,0,0,30,30
1650549532750,MATH 10A,A01,083735,Patchell; Gregory David,5,0,30,25
1650549532750,MATH 10A,A02,083736,Patchell; Gregory David,27,0,30,3
1650549532750,MATH 10A,A03,083737,Patchell; Gregory David,24,0,30,6
1650549538779,MATH 10B,A01,083207,Staff,0,9,30,30
1650549538779,MATH 10B,A02,083208,Staff,0,7,30,30
1650549538779,MATH 10B,B01,083739,Staff,12,0,30,18
1650549538779,MATH 10B,B02,083740,Staff,28,0,30,2
1650549544812,MATH 18,A01,083743,Staff,1,0,30,29
1650549544812,MATH 18,A02,083744,Staff,26,0,30,4
1650549544812,MATH 18,A03,083745,Staff,22,0,30,8
1650549544812,MATH 18,A04,083746,Staff,26,0,30,4
1650549544812,MATH 18,B01,083748,Staff,0,12,30,30
1650549544812,MATH 18,B02,083749,Staff,0,12,30,30
1650549544812,MATH 18,B03,083750,Staff,0,11,30,30
1650549544812,MATH 18,B04,083751,Staff,0,12,30,30
1650549550834,MATH 20A,A01,083754,Staff,22,0,40,18
1650549556872,MATH 20B,A01,083756,Staff,0,11,30,30
1650549556872,MATH 20B,A02,083757,Staff,0,12,30,30
1650549562898,MATH 20C,A01,083760,Staff,0,16,30,30
1650549562898,MATH 20C,A02,083761,Staff,2,14,30,28
1650549562898,MATH 20C,B01,083762,Staff,12,0,30,18
1650549562898,MATH 20C,B02,083763,Staff,28,0,30,2
1650549568921,MATH 20D,A01,083765,Staff,0,1,30,30
1650549568921,MATH 20D,A02,083766,Staff,7,0,30,23
1650549568921,MATH 20D,A03,083767,Staff,25,0,30,5
1650549574946,MATH 20E,A01,083771,Staff,6,0,30,24
1650549574946,MATH 20E,A02,083772,Staff,18,0,30,12
1650549574946,MATH 20E,B01,083773,Staff,0,0,30,30
1650549574946,MATH 20E,B02,083774,Staff,10,0,30,20
1650549580975,MATH 103A,A01,083777,Staff,0,15,30,30
1650549580975,MATH 103A,A02,083778,Staff,0,14,30,30
1650549580975,MATH 103A,B01,083779,Staff,0,13,30,30
1650549580975,MATH 103A,B02,083780,Staff,0,13,30,30
1650549586997,MATH 105,A01,085443,Staff,0,21,30,30
1650549593022,MATH 109,A01,083213,Anzaldo; Leesa B,0,8,30,30
1650549593022,MATH 109,A02,083214,Anzaldo; Leesa B,0,7,30,30
1650549593022,MATH 109,B01,083215,Anzaldo; Leesa B,0,5,30,30
1650549593022,MATH 109,B02,083216,Anzaldo; Leesa B,0,6,30,30
1650549599052,MATH 142A,A01,083219,Chow; Bennett,0,16,30,30
1650549599052,MATH 142A,A02,083220,Chow; Bennett,0,14,30,30
1650549599052,MATH 142A,B01,083221,Chow; Bennett,0,13,30,30
1650549599052,MATH 142A,B02,083222,Chow; Bennett,0,13,30,30
1650549605082,MATH 193A,A01,083224,Staff,0,6,30,30
1650549605082,MATH 193A,A02,083225,Staff,0,5,30,30
1650549605082,MATH 193A,A03,083781,Staff,0,5,30,30
1650549605082,MATH 193A,A04,083782,Staff,0,7,30,30
1650549611106,MATH 197,001,091859,McAuley; Julian John,9998,0,9999,1
1650549617162,COGS 9,A01,083615,Staff,0,16,60,60
1650549623193,COGS 11,A01,083617,Boyle; Mary E. T.,19,0,40,21
1650549629219,COGS 13,A01,083071,Staff,0,35,40,40
1650549635246,COGS 14A,A01,092681,Staff,0,26,100,100
1650549641277,COGS 14B,A01,083073,Cheng; Tzu-Han,0,12,50,50
1650549647310,COGS 17,A01,092677,Staff,19,0,75,56
1650549653336,COGS 100,A01,083619,Staff,0,26,60,60
1650549659364,COGS 101A,A01,083621,Davis; Joshua Daniel,0,26,60,60
1650549665394,COGS 101B,A01,091572,Staff,1,5,60,59
1650549671421,COGS 101C,A01,083625,Delgado; Tania,15,0,30,15
1650549677445,COGS 107A,A01,083627,Boyle; Mary E. T.,0,11,60,60
1650549683488,COGS 118A,A01,083075,Staff,0,3,60,60
1650549689515,CSE 3,A50,083646,Miranda; Gregory Joseph,20,0,38,18
1650549689515,CSE 3,A51,083647,Miranda; Gregory Joseph,36,0,37,1
1650549695546,CSE 8A,A50,083650,Miranda; Gregory Joseph,0,29,40,40
1650549701576,CSE 11,A01,083080,Cao; Yingjun,0,94,40,40
1650549707620,CSE 12,A01,083652,Staff,0,17,100,100
1650549713646,CSE 15L,A01,083654,Staff,0,1,50,50
1650549713646,CSE 15L,A02,083655,Staff,0,0,50,50
1650549719681,CSE 20,A01,083657,Staff,51,0,80,29
1650549725709,CSE 30,A01,083084,Eldon; John,0,77,40,40
1650549731735,CSE 100,A01,083659,Cao; Yingjun,0,66,50,50
1650549737764,CSE 134B,A01,083661,Powell; Thomas Allan,0,34,65,65
1650549743790,CSE 140,A01,083663,Staff,0,5,75,75
1650549749818,CSE 140L,A01,083088,Eldon; John,0,11,75,75
1650549755856,CSE 175,A01,083665,Kumar; Rakesh,7,0,25,18
1650549761881,CSE 190,A00,092507,Dubnov; Shlomo,10,0,20,10
1650549767910,ECE 45,A01,083139,Staff,0,1,60,60
1650549773936,ECE 65,A50,083695,Staff,0,6,30,30
1650549779964,ECE 109,A01,091882,Touri; Behrouz,33,0,70,37
1650549785994,ECE 180,A00,083140,Abi Samra; Nicholas Camill,21,0,30,9
1650549785994,ECE 180,B00,083141,Abi Samra; Nicholas Camill,0,0,30,30
1650549792024,MATH 10A,A01,083735,Patchell; Gregory David,5,0,30,25
1650549792024,MATH 10A,A02,083736,Patchell; Gregory David,27,0,30,3
1650549792024,MATH 10A,A03,083737,Patchell; Gregory David,24,0,30,6
1650549798054,MATH 10B,A01,083207,Staff,0,9,30,30
1650549798054,MATH 10B,A02,083208,Staff,0,7,30,30
1650549798054,MATH 10B,B01,083739,Staff,12,0,30,18
1650549798054,MATH 10B,B02,083740,Staff,28,0,30,2
1650549804080,MATH 18,A01,083743,Staff,1,0,30,29
1650549804080,MATH 18,A02,083744,Staff,26,0,30,4
1650549804080,MATH 18,A03,083745,Staff,22,0,30,8
1650549804080,MATH 18,A04,083746,Staff,26,0,30,4
1650549804080,MATH 18,B01,083748,Staff,0,12,30,30
1650549804080,MATH 18,B02,083749,Staff,0,12,30,30
1650549804080,MATH 18,B03,083750,Staff,0,11,30,30
1650549804080,MATH 18,B04,083751,Staff,0,12,30,30
1650549810106,MATH 20A,A01,083754,Staff,22,0,40,18
1650549816132,MATH 20B,A01,083756,Staff,0,11,30,30
1650549816132,MATH 20B,A02,083757,Staff,0,12,30,30
1650549822168,MATH 20C,A01,083760,Staff,0,16,30,30
1650549822168,MATH 20C,A02,083761,Staff,2,14,30,28
1650549822168,MATH 20C,B01,083762,Staff,12,0,30,18
1650549822168,MATH 20C,B02,083763,Staff,28,0,30,2
1650549828197,MATH 20D,A01,083765,Staff,0,1,30,30
1650549828197,MATH 20D,A02,083766,Staff,7,0,30,23
1650549828197,MATH 20D,A03,083767,Staff,25,0,30,5
1650549834225,MATH 20E,A01,083771,Staff,6,0,30,24
1650549834225,MATH 20E,A02,083772,Staff,18,0,30,12
1650549834225,MATH 20E,B01,083773,Staff,0,0,30,30
1650549834225,MATH 20E,B02,083774,Staff,10,0,30,20
1650549840250,MATH 103A,A01,083777,Staff,0,15,30,30
1650549840250,MATH 103A,A02,083778,Staff,0,14,30,30
1650549840250,MATH 103A,B01,083779,Staff,0,13,30,30
1650549840250,MATH 103A,B02,083780,Staff,0,13,30,30
1650549846276,MATH 105,A01,085443,Staff,0,21,30,30
1650549852303,MATH 109,A01,083213,Anzaldo; Leesa B,0,8,30,30
1650549852303,MATH 109,A02,083214,Anzaldo; Leesa B,0,7,30,30
1650549852303,MATH 109,B01,083215,Anzaldo; Leesa B,0,5,30,30
1650549852303,MATH 109,B02,083216,Anzaldo; Leesa B,0,6,30,30
1650549858328,MATH 142A,A01,083219,Chow; Bennett,0,16,30,30
1650549858328,MATH 142A,A02,083220,Chow; Bennett,0,14,30,30
1650549858328,MATH 142A,B01,083221,Chow; Bennett,0,13,30,30
1650549858328,MATH 142A,B02,083222,Chow; Bennett,0,13,30,30
1650549864444,MATH 193A,A01,083224,Staff,0,6,30,30
1650549864444,MATH 193A,A02,083225,Staff,0,5,30,30
1650549864444,MATH 193A,A03,083781,Staff,0,5,30,30
1650549864444,MATH 193A,A04,083782,Staff,0,7,30,30
1650549870477,MATH 197,001,091859,McAuley; Julian John,9998,0,9999,1
1650549876538,COGS 9,A01,083615,Staff,0,16,60,60
1650549882564,COGS 11,A01,083617,Boyle; Mary E. T.,19,0,40,21
1650549888588,COGS 13,A01,083071,Staff,0,35,40,40
1650549894622,COGS 14A,A01,092681,Staff,0,26,100,100
1650549900648,COGS 14B,A01,083073,Cheng; Tzu-Han,0,12,50,50
1650549906675,COGS 17,A01,092677,Staff,19,0,75,56
1650549912698,COGS 100,A01,083619,Staff,0,26,60,60
1650549918730,COGS 101A,A01,083621,Davis; Joshua Daniel,0,26,60,60
1650549924760,COGS 101B,A01,091572,Staff,1,5,60,59
1650549930786,COGS 101C,A01,083625,Delgado; Tania,15,0,30,15
1650549936813,COGS 107A,A01,083627,Boyle; Mary E. T.,0,11,60,60
1650549942841,COGS 118A,A01,083075,Staff,0,3,60,60
1650549948868,CSE 3,A50,083646,Miranda; Gregory Joseph,20,0,38,18
1650549948868,CSE 3,A51,083647,Miranda; Gregory Joseph,36,0,37,1
1650549954895,CSE 8A,A50,083650,Miranda; Gregory Joseph,0,29,40,40
1650549960921,CSE 11,A01,083080,Cao; Yingjun,0,94,40,40
1650549966946,CSE 12,A01,083652,Staff,0,17,100,100
1650549972974,CSE 15L,A01,083654,Staff,0,1,50,50
1650549972974,CSE 15L,A02,083655,Staff,0,0,50,50
1650549978999,CSE 20,A01,083657,Staff,51,0,80,29
1650549985023,CSE 30,A01,083084,Eldon; John,0,77,40,40
1650549991051,CSE 100,A01,083659,Cao; Yingjun,0,66,50,50
1650549997080,CSE 134B,A01,083661,Powell; Thomas Allan,0,34,65,65
1650550003118,CSE 140,A01,083663,Staff,0,5,75,75
1650550009142,CSE 140L,A01,083088,Eldon; John,0,11,75,75
1650550015168,CSE 175,A01,083665,Kumar; Rakesh,7,0,25,18
1650550021192,CSE 190,A00,092507,Dubnov; Shlomo,10,0,20,10
1650550027223,ECE 45,A01,083139,Staff,0,1,60,60
1650550033249,ECE 65,A50,083695,Staff,0,6,30,30
1650550039273,ECE 109,A01,091882,Touri; Behrouz,33,0,70,37
1650550045307,ECE 180,A00,083140,Abi Samra; Nicholas Camill,21,0,30,9
1650550045307,ECE 180,B00,083141,Abi Samra; Nicholas Camill,0,0,30,30
1650550051338,MATH 10A,A01,083735,Patchell; Gregory David,5,0,30,25
1650550051338,MATH 10A,A02,083736,Patchell; Gregory David,27,0,30,3
1650550051338,MATH 10A,A03,083737,Patchell; Gregory David,24,0,30,6
1650550057365,MATH 10B,A01,083207,Staff,0,9,30,30
1650550057365,MATH 10B,A02,083208,Staff,0,7,30,30
1650550057365,MATH 10B,B01,083739,Staff,12,0,30,18
1650550057365,MATH 10B,B02,083740,Staff,28,0,30,2
1650550063400,MATH 18,A01,083743,Staff,1,0,30,29
1650550063400,MATH 18,A02,083744,Staff,26,0,30,4
1650550063400,MATH 18,A03,083745,Staff,22,0,30,8
1650550063400,MATH 18,A04,083746,Staff,26,0,30,4
1650550063400,MATH 18,B01,083748,Staff,0,12,30,30
1650550063400,MATH 18,B02,083749,Staff,0,12,30,30
1650550063400,MATH 18,B03,083750,Staff,0,11,30,30
1650550063400,MATH 18,B04,083751,Staff,0,12,30,30
1650550069425,MATH 20A,A01,083754,Staff,22,0,40,18
1650550075453,MATH 20B,A01,083756,Staff,0,11,30,30
1650550075453,MATH 20B,A02,083757,Staff,0,12,30,30
1650550081480,MATH 20C,A01,083760,Staff,0,16,30,30
1650550081480,MATH 20C,A02,083761,Staff,2,14,30,28
1650550081480,MATH 20C,B01,083762,Staff,12,0,30,18
1650550081480,MATH 20C,B02,083763,Staff,28,0,30,2
1650550087509,MATH 20D,A01,083765,Staff,0,1,30,30
1650550087509,MATH 20D,A02,083766,Staff,7,0,30,23
1650550087509,MATH 20D,A03,083767,Staff,25,0,30,5
1650550093538,MATH 20E,A01,083771,Staff,6,0,30,24
1650550093538,MATH 20E,A02,083772,Staff,18,0,30,12
1650550093538,MATH 20E,B01,083773,Staff,0,0,30,30
1650550093538,MATH 20E,B02,083774,Staff,10,0,30,20
1650550099566,MATH 103A,A01,083777,Staff,0,15,30,30
1650550099566,MATH 103A,A02,083778,Staff,0,14,30,30
1650550099566,MATH 103A,B01,083779,Staff,0,13,30,30
1650550099566,MATH 103A,B02,083780,Staff,0,13,30,30
1650550105596,MATH 105,A01,085443,Staff,0,21,30,30
1650550111622,MATH 109,A01,083213,Anzaldo; Leesa B,0,8,30,30
1650550111622,MATH 109,A02,083214,Anzaldo; Leesa B,0,7,30,30
1650550111622,MATH 109,B01,083215,Anzaldo; Leesa B,0,5,30,30
1650550111622,MATH 109,B02,083216,Anzaldo; Leesa B,0,6,30,30
1650550117646,MATH 142A,A01,083219,Chow; Bennett,0,16,30,30
1650550117646,MATH 142A,A02,083220,Chow; Bennett,0,14,30,30
1650550117646,MATH 142A,B01,083221,Chow; Bennett,0,13,30,30
1650550117646,MATH 142A,B02,083222,Chow; Bennett,0,13,30,30
1650550123673,MATH 193A,A01,083224,Staff,0,6,30,30
1650550123673,MATH 193A,A02,083225,Staff,0,5,30,30
1650550123673,MATH 193A,A03,083781,Staff,0,5,30,30
1650550123673,MATH 193A,A04,083782,Staff,0,7,30,30
1650550129702,MATH 197,001,091859,McAuley; Julian John,9998,0,9999,1
1650550135766,COGS 9,A01,083615,Staff,0,16,60,60
1650550141792,COGS 11,A01,083617,Boyle; Mary E. T.,19,0,40,21
1650550147817,COGS 13,A01,083071,Staff,0,35,40,40
1650550153842,COGS 14A,A01,092681,Staff,0,26,100,100
1650550159865,COGS 14B,A01,083073,Cheng; Tzu-Han,0,12,50,50
1650550165891,COGS 17,A01,092677,Staff,19,0,75,56
1650550171915,COGS 100,A01,083619,Staff,0,26,60,60
1650550177938,COGS 101A,A01,083621,Davis; Joshua Daniel,0,26,60,60
1650550183966,COGS 101B,A01,091572,Staff,1,5,60,59
1650550189991,COGS 101C,A01,083625,Delgado; Tania,15,0,30,15
1650550196015,COGS 107A,A01,083627,Boyle; Mary E. T.,0,11,60,60
1650550202040,COGS 118A,A01,083075,Staff,0,3,60,60
1650550208070,CSE 3,A50,083646,Miranda; Gregory Joseph,20,0,38,18
1650550208070,CSE 3,A51,083647,Miranda; Gregory Joseph,36,0,37,1
1650550214095,CSE 8A,A50,083650,Miranda; Gregory Joseph,0,29,40,40
1650550220122,CSE 11,A01,083080,Cao; Yingjun,0,94,40,40
1650550226146,CSE 12,A01,083652,Staff,0,17,100,100
1650550232174,CSE 15L,A01,083654,Staff,0,1,50,50
1650550232174,CSE 15L,A02,083655,Staff,0,0,50,50
1650550238199,CSE 20,A01,083657,Staff,51,0,80,29
1650550244228,CSE 30,A01,083084,Eldon; John,0,77,40,40
1650550250253,CSE 100,A01,083659,Cao; Yingjun,0,66,50,50
1650550256283,CSE 134B,A01,083661,Powell; Thomas Allan,0,34,65,65
1650550262308,CSE 140,A01,083663,Staff,0,5,75,75
1650550268340,CSE 140L,A01,083088,Eldon; John,0,11,75,75
1650550274367,CSE 175,A01,083665,Kumar; Rakesh,7,0,25,18
1650550280394,CSE 190,A00,092507,Dubnov; Shlomo,10,0,20,10
1650550286418,ECE 45,A01,083139,Staff,0,1,60,60
1650550292442,ECE 65,A50,083695,Staff,0,6,30,30
1650550298469,ECE 109,A01,091882,Touri; Behrouz,33,0,70,37
1650550304493,ECE 180,A00,083140,Abi Samra; Nicholas Camill,21,0,30,9
1650550304493,ECE 180,B00,083141,Abi Samra; Nicholas Camill,0,0,30,30
1650550310521,MATH 10A,A01,083735,Patchell; Gregory David,5,0,30,25
1650550310521,MATH 10A,A02,083736,Patchell; Gregory David,27,0,30,3
1650550310521,MATH 10A,A03,083737,Patchell; Gregory David,24,0,30,6
1650550316545,MATH 10B,A01,083207,Staff,0,9,30,30
1650550316545,MATH 10B,A02,083208,Staff,0,7,30,30
1650550316545,MATH 10B,B01,083739,Staff,12,0,30,18
1650550316545,MATH 10B,B02,083740,Staff,28,0,30,2
1650550322582,MATH 18,A01,083743,Staff,1,0,30,29
1650550322582,MATH 18,A02,083744,Staff,26,0,30,4
1650550322582,MATH 18,A03,083745,Staff,22,0,30,8
1650550322582,MATH 18,A04,083746,Staff,26,0,30,4
1650550322582,MATH 18,B01,083748,Staff,0,12,30,30
1650550322582,MATH 18,B02,083749,Staff,0,12,30,30
1650550322582,MATH 18,B03,083750,Staff,0,11,30,30
1650550322582,MATH 18,B04,083751,Staff,0,12,30,30
1650550328614,MATH 20A,A01,083754,Staff,22,0,40,18
1650550334653,MATH 20B,A01,083756,Staff,0,11,30,30
1650550334653,MATH 20B,A02,083757,Staff,0,12,30,30
1650550340678,MATH 20C,A01,083760,Staff,0,16,30,30
1650550340678,MATH 20C,A02,083761,Staff,2,14,30,28
1650550340678,MATH 20C,B01,083762,Staff,12,0,30,18
1650550340678,MATH 20C,B02,083763,Staff,28,0,30,2
1650550346702,MATH 20D,A01,083765,Staff,0,1,30,30
1650550346702,MATH 20D,A02,083766,Staff,7,0,30,23
1650550346702,MATH 20D,A03,083767,Staff,25,0,30,5
1650550352730,MATH 20E,A01,083771,Staff,6,0,30,24
1650550352730,MATH 20E,A02,083772,Staff,18,0,30,12
1650550352730,MATH 20E,B01,083773,Staff,0,0,30,30
1650550352730,MATH 20E,B02,083774,Staff,10,0,30,20
1650550358756,MATH 103A,A01,083777,Staff,0,15,30,30
1650550358756,MATH 103A,A02,083778,Staff,0,14,30,30
1650550358756,MATH 103A,B01,083779,Staff,0,13,30,30
1650550358756,MATH 103A,B02,083780,Staff,0,13,30,30
1650550364782,MATH 105,A01,085443,Staff,0,21,30,30
1650550370811,MATH 109,A01,083213,Anzaldo; Leesa B,0,8,30,30
1650550370811,MATH 109,A02,083214,Anzaldo; Leesa B,0,7,30,30
1650550370811,MATH 109,B01,083215,Anzaldo; Leesa B,0,5,30,30
1650550370811,MATH 109,B02,083216,Anzaldo; Leesa B,0,6,30,30
1650550376835,MATH 142A,A01,083219,Chow; Bennett,0,16,30,30
1650550376835,MATH 142A,A02,083220,Chow; Bennett,0,14,30,30
1650550376835,MATH 142A,B01,083221,Chow; Bennett,0,13,30,30
1650550376835,MATH 142A,B02,083222,Chow; Bennett,0,13,30,30
1650550382860,MATH 193A,A01,083224,Staff,0,6,30,30
1650550382860,MATH 193A,A02,083225,Staff,0,5,30,30
1650550382860,MATH 193A,A03,083781,Staff,0,5,30,30
1650550382860,MATH 193A,A04,083782,Staff,0,7,30,30
1650550388882,MATH 197,001,091859,McAuley; Julian John,9998,0,9999,1
1650550394936,COGS 9,A01,083615,Staff,0,16,60,60
1650550400962,COGS 11,A01,083617,Boyle; Mary E. T.,19,0,40,21
1650550406990,COGS 13,A01,083071,Staff,0,35,40,40
1650550413026,COGS 14A,A01,092681,Staff,0,26,100,100
1650550419052,COGS 14B,A01,083073,Cheng; Tzu-Han,0,12,50,50
1650550425080,COGS 17,A01,092677,Staff,19,0,75,56
1650550431117,COGS 100,A01,083619,Staff,0,26,60,60
1650550437141,COGS 101A,A01,083621,Davis; Joshua Daniel,0,26,60,60
1650550443167,COGS 101B,A01,091572,Staff,1,5,60,59
1650550449198,COGS 101C,A01,083625,Delgado; Tania,15,0,30,15
1650550455312,COGS 107A,A01,083627,Boyle; Mary E. T.,0,11,60,60
1650550461337,COGS 118A,A01,083075,Staff,0,3,60,60
1650550467361,CSE 3,A50,083646,Miranda; Gregory Joseph,20,0,38,18
1650550467361,CSE 3,A51,083647,Miranda; Gregory Joseph,36,0,37,1
1650550473385,CSE 8A,A50,083650,Miranda; Gregory Joseph,0,29,40,40
1650550479413,CSE 11,A01,083080,Cao; Yingjun,0,94,40,40
1650550485450,CSE 12,A01,083652,Staff,0,17,100,100
1650550491473,CSE 15L,A01,083654,Staff,0,1,50,50
1650550491473,CSE 15L,A02,083655,Staff,0,0,50,50
1650550497498,CSE 20,A01,083657,Staff,51,0,80,29
1650550503525,CSE 30,A01,083084,Eldon; John,0,77,40,40
1650550509552,CSE 100,A01,083659,Cao; Yingjun,0,66,50,50
1650550515588,CSE 134B,A01,083661,Powell; Thomas Allan,0,34,65,65
1650550521610,CSE 140,A01,083663,Staff,0,5,75,75
1650550527634,CSE 140L,A01,083088,Eldon; John,0,11,75,75
1650550533659,CSE 175,A01,083665,Kumar; Rakesh,7,0,25,18
1650550539684,CSE 190,A00,092507,Dubnov; Shlomo,10,0,20,10
1650550545718,ECE 45,A01,083139,Staff,0,1,60,60
1650550551753,ECE 65,A50,083695,Staff,0,6,30,30
1650550557777,ECE 109,A01,091882,Touri; Behrouz,33,0,70,37
1650550563812,ECE 180,A00,083140,Abi Samra; Nicholas Camill,21,0,30,9
1650550563812,ECE 180,B00,083141,Abi Samra; Nicholas Camill,0,0,30,30
1650550569838,MATH 10A,A01,083735,Patchell; Gregory David,5,0,30,25
1650550569838,MATH 10A,A02,083736,Patchell; Gregory David,27,0,30,3
1650550569838,MATH 10A,A03,083737,Patchell; Gregory David,24,0,30,6
1650550575876,MATH 10B,A01,083207,Staff,0,9,30,30
1650550575876,MATH 10B,A02,083208,Staff,0,7,30,30
1650550575876,MATH 10B,B01,083739,Staff,12,0,30,18
1650550575876,MATH 10B,B02,083740,Staff,28,0,30,2
1650550581903,MATH 18,A01,083743,Staff,1,0,30,29
1650550581903,MATH 18,A02,083744,Staff,26,0,30,4
1650550581903,MATH 18,A03,083745,Staff,22,0,30,8
1650550581903,MATH 18,A04,083746,Staff,26,0,30,4
1650550581903,MATH 18,B01,083748,Staff,0,12,30,30
1650550581903,MATH 18,B02,083749,Staff,0,12,30,30
1650550581903,MATH 18,B03,083750,Staff,0,11,30,30
1650550581903,MATH 18,B04,083751,Staff,0,12,30,30
1650550587926,MATH 20A,A01,083754,Staff,22,0,40,18
1650550593953,MATH 20B,A01,083756,Staff,0,11,30,30
1650550593953,MATH 20B,A02,083757,Staff,0,12,30,30
1650550599978,MATH 20C,A01,083760,Staff,0,16,30,30
1650550599978,MATH 20C,A02,083761,Staff,2,14,30,28
1650550599978,MATH 20C,B01,083762,Staff,12,0,30,18
1650550599978,MATH 20C,B02,083763,Staff,28,0,30,2
1650550606003,MATH 20D,A01,083765,Staff,0,1,30,30
1650550606003,MATH 20D,A02,083766,Staff,7,0,30,23
1650550606003,MATH 20D,A03,083767,Staff,25,0,30,5
1650550612031,MATH 20E,A01,083771,Staff,6,0,30,24
1650550612031,MATH 20E,A02,083772,Staff,18,0,30,12
1650550612031,MATH 20E,B01,083773,Staff,0,0,30,30
1650550612031,MATH 20E,B02,083774,Staff,10,0,30,20
1650550618070,MATH 103A,A01,083777,Staff,0,15,30,30
1650550618070,MATH 103A,A02,083778,Staff,0,14,30,30
1650550618070,MATH 103A,B01,083779,Staff,0,13,30,30
1650550618070,MATH 103A,B02,083780,Staff,0,13,30,30
1650550624093,MATH 105,A01,085443,Staff,0,21,30,30
1650550630119,MATH 109,A01,083213,Anzaldo; Leesa B,0,8,30,30
1650550630119,MATH 109,A02,083214,Anzaldo; Leesa B,0,7,30,30
1650550630119,MATH 109,B01,083215,Anzaldo; Leesa B,0,5,30,30
1650550630119,MATH 109,B02,083216,Anzaldo; Leesa B,0,6,30,30
1650550636153,MATH 142A,A01,083219,Chow; Bennett,0,16,30,30
1650550636153,MATH 142A,A02,083220,Chow; Bennett,0,14,30,30
1650550636153,MATH 142A,B01,083221,Chow; Bennett,0,13,30,30
1650550636153,MATH 142A,B02,083222,Chow; Bennett,0,13,30,30
1650550642185,MATH 193A,A01,083224,Staff,0,6,30,30
1650550642185,MATH 193A,A02,083225,Staff,0,5,30,30
1650550642185,MATH 193A,A03,083781,Staff,0,5,30,30
1650550642185,MATH 193A,A04,083782,Staff,0,7,30,30
1650550648212,MATH 197,001,091859,McAuley; Julian John,9998,0,9999,1
1650550654280,COGS 9,A01,083615,Staff,0,16,60,60
1650550660305,COGS 11,A01,083617,Boyle; Mary E. T.,19,0,40,21
1650550666329,COGS 13,A01,083071,Staff,0,35,40,40
1650550672357,COGS 14A,A01,092681,Staff,0,26,100,100
1650550678381,COGS 14B,A01,083073,Cheng; Tzu-Han,0,12,50,50
1650550684407,COGS 17,A01,092677,Staff,19,0,75,56
1650550690433,COGS 100,A01,083619,Staff,0,26,60,60
1650550696467,COGS 101A,A01,083621,Davis; Joshua Daniel,0,26,60,60
1650550702505,COGS 101B,A01,091572,Staff,1,5,60,59
1650550708532,COGS 101C,A01,083625,Delgado; Tania,15,0,30,15
1650550714561,COGS 107A,A01,083627,Boyle; Mary E. T.,0,11,60,60
1650550720590,COGS 118A,A01,083075,Staff,0,3,60,60
1650550726613,CSE 3,A50,083646,Miranda; Gregory Joseph,20,0,38,18
1650550726613,CSE 3,A51,083647,Miranda; Gregory Joseph,36,0,37,1
1650550732641,CSE 8A,A50,083650,Miranda; Gregory Joseph,0,29,40,40
1650550738677,CSE 11,A01,083080,Cao; Yingjun,0,94,40,40
1650550744704,CSE 12,A01,083652,Staff,0,17,100,100
1650550750729,CSE 15L,A01,083654,Staff,0,1,50,50
1650550750729,CSE 15L,A02,083655,Staff,0,0,50,50
1650550756752,CSE 20,A01,083657,Staff,51,0,80,29
1650550762777,CSE 30,A01,083084,Eldon; John,0,77,40,40
1650550768800,CSE 100,A01,083659,Cao; Yingjun,0,66,50,50
1650550774830,CSE 134B,A01,083661,Powell; Thomas Allan,0,34,65,65
1650550780857,CSE 140,A01,083663,Staff,0,5,75,75
1650550786885,CSE 140L,A01,083088,Eldon; John,0,11,75,75
1650550792909,CSE 175,A01,083665,Kumar; Rakesh,7,0,25,18
1650550798934,CSE 190,A00,092507,Dubnov; Shlomo,10,0,20,10
1650550804963,ECE 45,A01,083139,Staff,0,1,60,60
1650550810990,ECE 65,A50,083695,Staff,0,6,30,30
1650550817014,ECE 109,A01,091882,Touri; Behrouz,33,0,70,37
1650550823041,ECE 180,A00,083140,Abi Samra; Nicholas Camill,21,0,30,9
1650550823041,ECE 180,B00,083141,Abi Samra; Nicholas Camill,0,0,30,30
1650550829075,MATH 10A,A01,083735,Patchell; Gregory David,5,0,30,25
1650550829075,MATH 10A,A02,083736,Patchell; Gregory David,27,0,30,3
1650550829075,MATH 10A,A03,083737,Patchell; Gregory David,24,0,30,6
1650550835100,MATH 10B,A01,083207,Staff,0,9,30,30
1650550835100,MATH 10B,A02,083208,Staff,0,7,30,30
1650550835100,MATH 10B,B01,083739,Staff,12,0,30,18
1650550835100,MATH 10B,B02,083740,Staff,28,0,30,2
1650550841130,MATH 18,A01,083743,Staff,1,0,30,29
1650550841130,MATH 18,A02,083744,Staff,26,0,30,4
1650550841130,MATH 18,A03,083745,Staff,22,0,30,8
1650550841130,MATH 18,A04,083746,Staff,26,0,30,4
1650550841130,MATH 18,B01,083748,Staff,0,12,30,30
1650550841130,MATH 18,B02,083749,Staff,0,12,30,30
1650550841130,MATH 18,B03,083750,Staff,0,11,30,30
1650550841130,MATH 18,B04,083751,Staff,0,12,30,30
1650550847157,MATH 20A,A01,083754,Staff,22,0,40,18
1650550853182,MATH 20B,A01,083756,Staff,0,11,30,30
1650550853182,MATH 20B,A02,083757,Staff,0,12,30,30
1650550859208,MATH 20C,A01,083760,Staff,0,16,30,30
1650550859208,MATH 20C,A02,083761,Staff,2,14,30,28
1650550859208,MATH 20C,B01,083762,Staff,12,0,30,18
1650550859208,MATH 20C,B02,083763,Staff,28,0,30,2
1650550865233,MATH 20D,A01,083765,Staff,0,1,30,30
1650550865233,MATH 20D,A02,083766,Staff,7,0,30,23
1650550865233,MATH 20D,A03,083767,Staff,25,0,30,5
1650550871257,MATH 20E,A01,083771,Staff,6,0,30,24
1650550871257,MATH 20E,A02,083772,Staff,18,0,30,12
1650550871257,MATH 20E,B01,083773,Staff,0,0,30,30
1650550871257,MATH 20E,B02,083774,Staff,10,0,30,20
1650550877292,MATH 103A,A01,083777,Staff,0,15,30,30
1650550877292,MATH 103A,A02,083778,Staff,0,14,30,30
1650550877292,MATH 103A,B01,083779,Staff,0,13,30,30
1650550877292,MATH 103A,B02,083780,Staff,0,13,30,30
1650550883318,MATH 105,A01,085443,Staff,0,21,30,30
1650550889346,MATH 109,A01,083213,Anzaldo; Leesa B,0,8,30,30
1650550889346,MATH 109,A02,083214,Anzaldo; Leesa B,0,7,30,30
1650550889346,MATH 109,B01,083215,Anzaldo; Leesa B,0,5,30,30
1650550889346,MATH 109,B02,083216,Anzaldo; Leesa B,0,6,30,30
1650550895381,MATH 142A,A01,083219,Chow; Bennett,0,16,30,30
1650550895381,MATH 142A,A02,083220,Chow; Bennett,0,14,30,30
1650550895381,MATH 142A,B01,083221,Chow; Bennett,0,13,30,30
1650550895381,MATH 142A,B02,083222,Chow; Bennett,0,13,30,30
1650550901408,MATH 193A,A01,083224,Staff,0,6,30,30
1650550901408,MATH 193A,A02,083225,Staff,0,5,30,30
1650550901408,MATH 193A,A03,083781,Staff,0,5,30,30
1650550901408,MATH 193A,A04,083782,Staff,0,7,30,30
1650550907432,MATH 197,001,091859,McAuley; Julian John,9998,0,9999,1
1650550913491,COGS 9,A01,083615,Staff,0,16,60,60
1650550919518,COGS 11,A01,083617,Boyle; Mary E. T.,19,0,40,21
1650550925549,COGS 13,A01,083071,Staff,0,35,40,40
1650550931572,COGS 14A,A01,092681,Staff,0,26,100,100
1650550937604,COGS 14B,A01,083073,Cheng; Tzu-Han,0,12,50,50
1650550943632,COGS 17,A01,092677,Staff,19,0,75,56
1650550949664,COGS 100,A01,083619,Staff,0,26,60,60
1650550955692,COGS 101A,A01,083621,Davis; Joshua Daniel,0,26,60,60
1650550961720,COGS 101B,A01,091572,Staff,1,5,60,59
1650550967747,COGS 101C,A01,083625,Delgado; Tania,15,0,30,15
1650550973774,COGS 107A,A01,083627,Boyle; Mary E. T.,0,11,60,60
1650550979799,COGS 118A,A01,083075,Staff,0,3,60,60
1650550985823,CSE 3,A50,083646,Miranda; Gregory Joseph,20,0,38,18
1650550985823,CSE 3,A51,083647,Miranda; Gregory Joseph,36,0,37,1
1650550991849,CSE 8A,A50,083650,Miranda; Gregory Joseph,0,29,40,40
1650550997876,CSE 11,A01,083080,Cao; Yingjun,0,94,40,40
1650551003900,CSE 12,A01,083652,Staff,0,17,100,100
1650551009928,CSE 15L,A01,083654,Staff,0,1,50,50
1650551009928,CSE 15L,A02,083655,Staff,0,0,50,50
1650551015953,CSE 20,A01,083657,Staff,51,0,80,29
1650551021977,CSE 30,A01,083084,Eldon; John,0,77,40,40
1650551028008,CSE 100,A01,083659,Cao; Yingjun,0,66,50,50
1650551034037,CSE 134B,A01,083661,Powell; Thomas Allan,0,34,65,65
1650551040060,CSE 140,A01,083663,Staff,0,5,75,75
1650551046090,CSE 140L,A01,083088,Eldon; John,0,11,75,75
1650551052209,CSE 175,A01,083665,Kumar; Rakesh,7,0,25,18
1650551058232,CSE 190,A00,092507,Dubnov; Shlomo,10,0,20,10
1650551064256,ECE 45,A01,083139,Staff,0,1,60,60
1650551070283,ECE 65,A50,083695,Staff,0,6,30,30
1650551076310,ECE 109,A01,091882,Touri; Behrouz,33,0,70,37
1650551082337,ECE 180,A00,083140,Abi Samra; Nicholas Camill,21,0,30,9
1650551082337,ECE 180,B00,083141,Abi Samra; Nicholas Camill,0,0,30,30
1650551088362,MATH 10A,A01,083735,Patchell; Gregory David,5,0,30,25
1650551088362,MATH 10A,A02,083736,Patchell; Gregory David,27,0,30,3
1650551088362,MATH 10A,A03,083737,Patchell; Gregory David,24,0,30,6
1650551094392,MATH 10B,A01,083207,Staff,0,9,30,30
1650551094392,MATH 10B,A02,083208,Staff,0,7,30,30
1650551094392,MATH 10B,B01,083739,Staff,12,0,30,18
1650551094392,MATH 10B,B02,083740,Staff,28,0,30,2
1650551100421,MATH 18,A01,083743,Staff,1,0,30,29
1650551100421,MATH 18,A02,083744,Staff,26,0,30,4
1650551100421,MATH 18,A03,083745,Staff,22,0,30,8
1650551100421,MATH 18,A04,083746,Staff,26,0,30,4
1650551100421,MATH 18,B01,083748,Staff,0,12,30,30
1650551100421,MATH 18,B02,083749,Staff,0,12,30,30
1650551100421,MATH 18,B03,083750,Staff,0,11,30,30
1650551100421,MATH 18,B04,083751,Staff,0,12,30,30
1650551106448,MATH 20A,A01,083754,Staff,22,0,40,18
1650551112472,MATH 20B,A01,083756,Staff,0,11,30,30
1650551112472,MATH 20B,A02,083757,Staff,0,12,30,30
1650551118501,MATH 20C,A01,083760,Staff,0,16,30,30
1650551118501,MATH 20C,A02,083761,Staff,2,14,30,28
1650551118501,MATH 20C,B01,083762,Staff,12,0,30,18
1650551118501,MATH 20C,B02,083763,Staff,28,0,30,2
1650551124525,MATH 20D,A01,083765,Staff,0,1,30,30
1650551124525,MATH 20D,A02,083766,Staff,7,0,30,23
1650551124525,MATH 20D,A03,083767,Staff,25,0,30,5
1650551130562,MATH 20E,A01,083771,Staff,6,0,30,24
1650551130562,MATH 20E,A02,083772,Staff,18,0,30,12
1650551130562,MATH 20E,B01,083773,Staff,0,0,30,30
1650551130562,MATH 20E,B02,083774,Staff,10,0,30,20
1650551136590,MATH 103A,A01,083777,Staff,0,15,30,30
1650551136590,MATH 103A,A02,083778,Staff,0,14,30,30
1650551136590,MATH 103A,B01,083779,Staff,0,13,30,30
1650551136590,MATH 103A,B02,083780,Staff,0,13,30,30
1650551142615,MATH 105,A01,085443,Staff,0,21,30,30
1650551148643,MATH 109,A01,083213,Anzaldo; Leesa B,0,8,30,30
1650551148643,MATH 109,A02,083214,Anzaldo; Leesa B,0,7,30,30
1650551148643,MATH 109,B01,083215,Anzaldo; Leesa B,0,5,30,30
1650551148643,MATH 109,B02,083216,Anzaldo; Leesa B,0,6,30,30
1650551154666,MATH 142A,A01,083219,Chow; Bennett,0,16,30,30
1650551154666,MATH 142A,A02,083220,Chow; Bennett,0,14,30,30
1650551154666,MATH 142A,B01,083221,Chow; Bennett,0,13,30,30
1650551154666,MATH 142A,B02,083222,Chow; Bennett,0,13,30,30
1650551160691,MATH 193A,A01,083224,Staff,0,6,30,30
1650551160691,MATH 193A,A02,083225,Staff,0,5,30,30
1650551160691,MATH 193A,A03,083781,Staff,0,5,30,30
1650551160691,MATH 193A,A04,083782,Staff,0,7,30,30
1650551166725,MATH 197,001,091859,McAuley; Julian John,9998,0,9999,1
1650551172787,COGS 9,A01,083615,Staff,0,16,60,60
1650551178815,COGS 11,A01,083617,Boyle; Mary E. T.,19,0,40,21
1650551184839,COGS 13,A01,083071,Staff,0,35,40,40
1650551190867,COGS 14A,A01,092681,Staff,0,26,100,100
1650551196893,COGS 14B,A01,083073,Cheng; Tzu-Han,0,12,50,50
1650551202920,COGS 17,A01,092677,Staff,19,0,75,56
1650551208946,COGS 100,A01,083619,Staff,0,26,60,60
1650551214974,COGS 101A,A01,083621,Davis; Joshua Daniel,0,26,60,60
1650551220998,COGS 101B,A01,091572,Staff,1,5,60,59
1650551227020,COGS 101C,A01,083625,Delgado; Tania,15,0,30,15
1650551233047,COGS 107A,A01,083627,Boyle; Mary E. T.,0,11,60,60
1650551239071,COGS 118A,A01,083075,Staff,0,3,60,60
1650551245104,CSE 3,A50,083646,Miranda; Gregory Joseph,20,0,38,18
1650551245104,CSE 3,A51,083647,Miranda; Gregory Joseph,36,0,37,1
1650551251127,CSE 8A,A50,083650,Miranda; Gregory Joseph,0,29,40,40
1650551257155,CSE 11,A01,083080,Cao; Yingjun,0,94,40,40
1650551263185,CSE 12,A01,083652,Staff,0,17,100,100
1650551269216,CSE 15L,A01,083654,Staff,0,1,50,50
1650551269216,CSE 15L,A02,083655,Staff,0,0,50,50
1650551275240,CSE 20,A01,083657,Staff,51,0,80,29
1650551281265,CSE 30,A01,083084,Eldon; John,0,77,40,40
1650551287292,CSE 100,A01,083659,Cao; Yingjun,0,66,50,50
1650551293335,CSE 134B,A01,083661,Powell; Thomas Allan,0,34,65,65
1650551299363,CSE 140,A01,083663,Staff,0,5,75,75
1650551305388,CSE 140L,A01,083088,Eldon; John,0,11,75,75
1650551311413,CSE 175,A01,083665,Kumar; Rakesh,7,0,25,18
1650551317439,CSE 190,A00,092507,Dubnov; Shlomo,10,0,20,10
1650551323466,ECE 45,A01,083139,Staff,0,1,60,60
1650551329490,ECE 65,A50,083695,Staff,0,6,30,30
1650551335516,ECE 109,A01,091882,Touri; Behrouz,33,0,70,37
1650551341540,ECE 180,A00,083140,Abi Samra; Nicholas Camill,21,0,30,9
1650551341540,ECE 180,B00,083141,Abi Samra; Nicholas Camill,0,0,30,30
1650551347580,MATH 10A,A01,083735,Patchell; Gregory David,5,0,30,25
1650551347580,MATH 10A,A02,083736,Patchell; Gregory David,27,0,30,3
1650551347580,MATH 10A,A03,083737,Patchell; Gregory David,24,0,30,6
1650551353607,MATH 10B,A01,083207,Staff,0,9,30,30
1650551353607,MATH 10B,A02,083208,Staff,0,7,30,30
1650551353607,MATH 10B,B01,083739,Staff,12,0,30,18
1650551353607,MATH 10B,B02,083740,Staff,28,0,30,2
1650551359632,MATH 18,A01,083743,Staff,1,0,30,29
1650551359632,MATH 18,A02,083744,Staff,26,0,30,4
1650551359632,MATH 18,A03,083745,Staff,22,0,30,8
1650551359632,MATH 18,A04,083746,Staff,26,0,30,4
1650551359632,MATH 18,B01,083748,Staff,0,12,30,30
1650551359632,MATH 18,B02,083749,Staff,0,12,30,30
1650551359632,MATH 18,B03,083750,Staff,0,11,30,30
1650551359632,MATH 18,B04,083751,Staff,0,12,30,30
1650551365657,MATH 20A,A01,083754,Staff,22,0,40,18
1650551371680,MATH 20B,A01,083756,Staff,0,11,30,30
1650551371680,MATH 20B,A02,083757,Staff,0,12,30,30
1650551377709,MATH 20C,A01,083760,Staff,0,16,30,30
1650551377709,MATH 20C,A02,083761,Staff,2,14,30,28
1650551377709,MATH 20C,B01,083762,Staff,12,0,30,18
1650551377709,MATH 20C,B02,083763,Staff,28,0,30,2
1650551383737,MATH 20D,A01,083765,Staff,0,1,30,30
1650551383737,MATH 20D,A02,083766,Staff,7,0,30,23
1650551383737,MATH 20D,A03,083767,Staff,25,0,30,5
1650551389766,MATH 20E,A01,083771,Staff,6,0,30,24
1650551389766,MATH 20E,A02,083772,Staff,18,0,30,12
1650551389766,MATH 20E,B01,083773,Staff,0,0,30,30
1650551389766,MATH 20E,B02,083774,Staff,10,0,30,20
1650551395791,MATH 103A,A01,083777,Staff,0,15,30,30
1650551395791,MATH 103A,A02,083778,Staff,0,14,30,30
1650551395791,MATH 103A,B01,083779,Staff,0,13,30,30
1650551395791,MATH 103A,B02,083780,Staff,0,13,30,30
1650551401815,MATH 105,A01,085443,Staff,0,21,30,30
1650551407840,MATH 109,A01,083213,Anzaldo; Leesa B,0,8,30,30
1650551407840,MATH 109,A02,083214,Anzaldo; Leesa B,0,7,30,30
1650551407840,MATH 109,B01,083215,Anzaldo; Leesa B,0,5,30,30
1650551407840,MATH 109,B02,083216,Anzaldo; Leesa B,0,6,30,30
1650551413872,MATH 142A,A01,083219,Chow; Bennett,0,16,30,30
1650551413872,MATH 142A,A02,083220,Chow; Bennett,0,14,30,30
1650551413872,MATH 142A,B01,083221,Chow; Bennett,0,13,30,30
1650551413872,MATH 142A,B02,083222,Chow; Bennett,0,13,30,30
1650551419897,MATH 193A,A01,083224,Staff,0,6,30,30
1650551419897,MATH 193A,A02,083225,Staff,0,5,30,30
1650551419897,MATH 193A,A03,083781,Staff,0,5,30,30
1650551419897,MATH 193A,A04,083782,Staff,0,7,30,30
1650551425920,MATH 197,001,091859,McAuley; Julian John,9998,0,9999,1
1650551431988,COGS 9,A01,083615,Staff,0,16,60,60
1650551438021,COGS 11,A01,083617,Boyle; Mary E. T.,19,0,40,21
1650551444048,COGS 13,A01,083071,Staff,0,35,40,40
1650551450074,COGS 14A,A01,092681,Staff,0,26,100,100
1650551456102,COGS 14B,A01,083073,Cheng; Tzu-Han,0,12,50,50
1650551462127,COGS 17,A01,092677,Staff,19,0,75,56
1650551468155,COGS 100,A01,083619,Staff,0,26,60,60
1650551474179,COGS 101A,A01,083621,Davis; Joshua Daniel,0,26,60,60
1650551480204,COGS 101B,A01,091572,Staff,1,5,60,59
1650551486229,COGS 101C,A01,083625,Delgado; Tania,15,0,30,15
1650551492259,COGS 107A,A01,083627,Boyle; Mary E. T.,0,11,60,60
1650551498287,COGS 118A,A01,083075,Staff,0,3,60,60
1650551504310,CSE 3,A50,083646,Miranda; Gregory Joseph,20,0,38,18
1650551504310,CSE 3,A51,083647,Miranda; Gregory Joseph,36,0,37,1
1650551510350,CSE 8A,A50,083650,Miranda; Gregory Joseph,0,29,40,40
1650551516371,CSE 11,A01,083080,Cao; Yingjun,0,94,40,40
1650551522394,CSE 12,A01,083652,Staff,0,17,100,100
1650551528421,CSE 15L,A01,083654,Staff,0,1,50,50
1650551528421,CSE 15L,A02,083655,Staff,0,0,50,50
1650551534447,CSE 20,A01,083657,Staff,51,0,80,29
1650551540474,CSE 30,A01,083084,Eldon; John,0,77,40,40
1650551546505,CSE 100,A01,083659,Cao; Yingjun,0,66,50,50
1650551552532,CSE 134B,A01,083661,Powell; Thomas Allan,0,34,65,65
1650551558555,CSE 140,A01,083663,Staff,0,5,75,75
1650551564581,CSE 140L,A01,083088,Eldon; John,0,11,75,75
1650551570606,CSE 175,A01,083665,Kumar; Rakesh,7,0,25,18
1650551576630,CSE 190,A00,092507,Dubnov; Shlomo,10,0,20,10
1650551582655,ECE 45,A01,083139,Staff,0,1,60,60
1650551588679,ECE 65,A50,083695,Staff,0,6,30,30
1650551594702,ECE 109,A01,091882,Touri; Behrouz,33,0,70,37
1650551600727,ECE 180,A00,083140,Abi Samra; Nicholas Camill,21,0,30,9
1650551600727,ECE 180,B00,083141,Abi Samra; Nicholas Camill,0,0,30,30
1650551606754,MATH 10A,A01,083735,Patchell; Gregory David,5,0,30,25
1650551606754,MATH 10A,A02,083736,Patchell; Gregory David,27,0,30,3
1650551606754,MATH 10A,A03,083737,Patchell; Gregory David,24,0,30,6
1650551612779,MATH 10B,A01,083207,Staff,0,9,30,30
1650551612779,MATH 10B,A02,083208,Staff,0,7,30,30
1650551612779,MATH 10B,B01,083739,Staff,12,0,30,18
1650551612779,MATH 10B,B02,083740,Staff,28,0,30,2
1650551618806,MATH 18,A01,083743,Staff,1,0,30,29
1650551618806,MATH 18,A02,083744,Staff,26,0,30,4
1650551618806,MATH 18,A03,083745,Staff,22,0,30,8
1650551618806,MATH 18,A04,083746,Staff,26,0,30,4
1650551618806,MATH 18,B01,083748,Staff,0,12,30,30
1650551618806,MATH 18,B02,083749,Staff,0,12,30,30
1650551618806,MATH 18,B03,083750,Staff,0,11,30,30
1650551618806,MATH 18,B04,083751,Staff,0,12,30,30
1650551624838,MATH 20A,A01,083754,Staff,22,0,40,18
1650551630871,MATH 20B,A01,083756,Staff,0,11,30,30
1650551630871,MATH 20B,A02,083757,Staff,0,12,30,30
1650551636899,MATH 20C,A01,083760,Staff,0,16,30,30
1650551636899,MATH 20C,A02,083761,Staff,2,14,30,28
1650551636899,MATH 20C,B01,083762,Staff,12,0,30,18
1650551636899,MATH 20C,B02,083763,Staff,28,0,30,2
1650551642923,MATH 20D,A01,083765,Staff,0,1,30,30
1650551642923,MATH 20D,A02,083766,Staff,7,0,30,23
1650551642923,MATH 20D,A03,083767,Staff,25,0,30,5
1650551649037,MATH 20E,A01,083771,Staff,6,0,30,24
1650551649037,MATH 20E,A02,083772,Staff,18,0,30,12
1650551649037,MATH 20E,B01,083773,Staff,0,0,30,30
1650551649037,MATH 20E,B02,083774,Staff,10,0,30,20
1650551655061,MATH 103A,A01,083777,Staff,0,15,30,30
1650551655061,MATH 103A,A02,083778,Staff,0,14,30,30
1650551655061,MATH 103A,B01,083779,Staff,0,13,30,30
1650551655061,MATH 103A,B02,083780,Staff,0,13,30,30
1650551661090,MATH 105,A01,085443,Staff,0,21,30,30
1650551667117,MATH 109,A01,083213,Anzaldo; Leesa B,0,8,30,30
1650551667117,MATH 109,A02,083214,Anzaldo; Leesa B,0,7,30,30
1650551667117,MATH 109,B01,083215,Anzaldo; Leesa B,0,5,30,30
1650551667117,MATH 109,B02,083216,Anzaldo; Leesa B,0,6,30,30
1650551673146,MATH 142A,A01,083219,Chow; Bennett,0,16,30,30
1650551673146,MATH 142A,A02,083220,Chow; Bennett,0,14,30,30
1650551673146,MATH 142A,B01,083221,Chow; Bennett,0,13,30,30
1650551673146,MATH 142A,B02,083222,Chow; Bennett,0,13,30,30
1650551679180,MATH 193A,A01,083224,Staff,0,6,30,30
1650551679180,MATH 193A,A02,083225,Staff,0,5,30,30
1650551679180,MATH 193A,A03,083781,Staff,0,5,30,30
1650551679180,MATH 193A,A04,083782,Staff,0,7,30,30
1650551685209,MATH 197,001,091859,McAuley; Julian John,9998,0,9999,1
1650551691281,COGS 9,A01,083615,Staff,0,16,60,60
1650551697307,COGS 11,A01,083617,Boyle; Mary E. T.,19,0,40,21
1650551703331,COGS 13,A01,083071,Staff,0,35,40,40
1650551709357,COGS 14A,A01,092681,Staff,0,26,100,100
1650551715388,COGS 14B,A01,083073,Cheng; Tzu-Han,0,12,50,50
1650551721411,COGS 17,A01,092677,Staff,19,0,75,56
1650551727435,COGS 100,A01,083619,Staff,0,26,60,60
1650551733461,COGS 101A,A01,083621,Davis; Joshua Daniel,0,26,60,60
1650551739484,COGS 101B,A01,091572,Staff,1,5,60,59
1650551745508,COGS 101C,A01,083625,Delgado; Tania,15,0,30,15
1650551751539,COGS 107A,A01,083627,Boyle; Mary E. T.,0,11,60,60
1650551757569,COGS 118A,A01,083075,Staff,0,3,60,60
1650551763595,CSE 3,A50,083646,Miranda; Gregory Joseph,20,0,38,18
1650551763595,CSE 3,A51,083647,Miranda; Gregory Joseph,36,0,37,1
1650551769624,CSE 8A,A50,083650,Miranda; Gregory Joseph,0,29,40,40
1650551775651,CSE 11,A01,083080,Cao; Yingjun,0,94,40,40
1650551781682,CSE 12,A01,083652,Staff,0,17,100,100
1650551787715,CSE 15L,A01,083654,Staff,0,1,50,50
1650551787715,CSE 15L,A02,083655,Staff,0,0,50,50
1650551793741,CSE 20,A01,083657,Staff,51,0,80,29
1650551799764,CSE 30,A01,083084,Eldon; John,0,77,40,40
1650551805796,CSE 100,A01,083659,Cao; Yingjun,0,66,50,50
1650551811822,CSE 134B,A01,083661,Powell; Thomas Allan,0,34,65,65
1650551817849,CSE 140,A01,083663,Staff,0,5,75,75
1650551823885,CSE 140L,A01,083088,Eldon; John,0,11,75,75
1650551829909,CSE 175,A01,083665,Kumar; Rakesh,7,0,25,18
1650551835933,CSE 190,A00,092507,Dubnov; Shlomo,10,0,20,10
1650551841964,ECE 45,A01,083139,Staff,0,1,60,60
1650551847987,ECE 65,A50,083695,Staff,0,6,30,30
1650551854012,ECE 109,A01,091882,Touri; Behrouz,33,0,70,37
1650551860036,ECE 180,A00,083140,Abi Samra; Nicholas Camill,21,0,30,9
1650551860036,ECE 180,B00,083141,Abi Samra; Nicholas Camill,0,0,30,30
1650551866059,MATH 10A,A01,083735,Patchell; Gregory David,5,0,30,25
1650551866059,MATH 10A,A02,083736,Patchell; Gregory David,27,0,30,3
1650551866059,MATH 10A,A03,083737,Patchell; Gregory David,24,0,30,6
1650551872086,MATH 10B,A01,083207,Staff,0,9,30,30
1650551872086,MATH 10B,A02,083208,Staff,0,7,30,30
1650551872086,MATH 10B,B01,083739,Staff,12,0,30,18
1650551872086,MATH 10B,B02,083740,Staff,28,0,30,2
1650551878116,MATH 18,A01,083743,Staff,1,0,30,29
1650551878116,MATH 18,A02,083744,Staff,26,0,30,4
1650551878116,MATH 18,A03,083745,Staff,22,0,30,8
1650551878116,MATH 18,A04,083746,Staff,26,0,30,4
1650551878116,MATH 18,B01,083748,Staff,0,12,30,30
1650551878116,MATH 18,B02,083749,Staff,0,12,30,30
1650551878116,MATH 18,B03,083750,Staff,0,11,30,30
1650551878116,MATH 18,B04,083751,Staff,0,12,30,30
1650551884146,MATH 20A,A01,083754,Staff,22,0,40,18
1650551890169,MATH 20B,A01,083756,Staff,0,11,30,30
1650551890169,MATH 20B,A02,083757,Staff,0,12,30,30
1650551896210,MATH 20C,A01,083760,Staff,0,16,30,30
1650551896210,MATH 20C,A02,083761,Staff,2,14,30,28
1650551896210,MATH 20C,B01,083762,Staff,12,0,30,18
1650551896210,MATH 20C,B02,083763,Staff,28,0,30,2
1650551902232,MATH 20D,A01,083765,Staff,0,1,30,30
1650551902232,MATH 20D,A02,083766,Staff,7,0,30,23
1650551902232,MATH 20D,A03,083767,Staff,25,0,30,5
1650551908258,MATH 20E,A01,083771,Staff,6,0,30,24
1650551908258,MATH 20E,A02,083772,Staff,18,0,30,12
1650551908258,MATH 20E,B01,083773,Staff,0,0,30,30
1650551908258,MATH 20E,B02,083774,Staff,10,0,30,20
1650551914285,MATH 103A,A01,083777,Staff,0,15,30,30
1650551914285,MATH 103A,A02,083778,Staff,0,14,30,30
1650551914285,MATH 103A,B01,083779,Staff,0,13,30,30
1650551914285,MATH 103A,B02,083780,Staff,0,13,30,30
1650551920308,MATH 105,A01,085443,Staff,0,21,30,30
1650551926331,MATH 109,A01,083213,Anzaldo; Leesa B,0,8,30,30
1650551926331,MATH 109,A02,083214,Anzaldo; Leesa B,0,7,30,30
1650551926331,MATH 109,B01,083215,Anzaldo; Leesa B,0,5,30,30
1650551926331,MATH 109,B02,083216,Anzaldo; Leesa B,0,6,30,30
1650551932354,MATH 142A,A01,083219,Chow; Bennett,0,16,30,30
1650551932354,MATH 142A,A02,083220,Chow; Bennett,0,14,30,30
1650551932354,MATH 142A,B01,083221,Chow; Bennett,0,13,30,30
1650551932354,MATH 142A,B02,083222,Chow; Bennett,0,13,30,30
1650551938385,MATH 193A,A01,083224,Staff,0,6,30,30
1650551938385,MATH 193A,A02,083225,Staff,0,5,30,30
1650551938385,MATH 193A,A03,083781,Staff,0,5,30,30
1650551938385,MATH 193A,A04,083782,Staff,0,7,30,30
1650551944418,MATH 197,001,091859,McAuley; Julian John,9998,0,9999,1
1650551950480,COGS 9,A01,083615,Staff,0,16,60,60
1650551956512,COGS 11,A01,083617,Boyle; Mary E. T.,19,0,40,21
1650551962540,COGS 13,A01,083071,Staff,0,35,40,40
1650551968566,COGS 14A,A01,092681,Staff,0,26,100,100
1650551974598,COGS 14B,A01,083073,Cheng; Tzu-Han,0,12,50,50
1650551980625,COGS 17,A01,092677,Staff,19,0,75,56
1650551986656,COGS 100,A01,083619,Staff,0,26,60,60
1650551992682,COGS 101A,A01,083621,Davis; Joshua Daniel,0,26,60,60
1650551998709,COGS 101B,A01,091572,Staff,1,5,60,59
1650552004737,COGS 101C,A01,083625,Delgado; Tania,15,0,30,15
1650552010778,COGS 107A,A01,083627,Boyle; Mary E. T.,0,11,60,60
1650552016806,COGS 118A,A01,083075,Staff,0,3,60,60
1650552022832,CSE 3,A50,083646,Miranda; Gregory Joseph,20,0,38,18
1650552022832,CSE 3,A51,083647,Miranda; Gregory Joseph,36,0,37,1
1650552028860,CSE 8A,A50,083650,Miranda; Gregory Joseph,0,29,40,40
1650552034883,CSE 11,A01,083080,Cao; Yingjun,0,94,40,40
1650552040910,CSE 12,A01,083652,Staff,0,17,100,100
1650552046938,CSE 15L,A01,083654,Staff,0,1,50,50
1650552046938,CSE 15L,A02,083655,Staff,0,0,50,50
1650552052962,CSE 20,A01,083657,Staff,51,0,80,29
1650552058986,CSE 30,A01,083084,Eldon; John,0,77,40,40
1650552065013,CSE 100,A01,083659,Cao; Yingjun,0,66,50,50
1650552071046,CSE 134B,A01,083661,Powell; Thomas Allan,0,34,65,65
1650552077072,CSE 140,A01,083663,Staff,0,5,75,75
1650552083100,CSE 140L,A01,083088,Eldon; John,0,11,75,75
1650552089132,CSE 175,A01,083665,Kumar; Rakesh,7,0,25,18
1650552095155,CSE 190,A00,092507,Dubnov; Shlomo,10,0,20,10
1650552101187,ECE 45,A01,083139,Staff,0,1,60,60
1650552107210,ECE 65,A50,083695,Staff,0,6,30,30
1650552113247,ECE 109,A01,091882,Touri; Behrouz,33,0,70,37
1650552119276,ECE 180,A00,083140,Abi Samra; Nicholas Camill,21,0,30,9
1650552119276,ECE 180,B00,083141,Abi Samra; Nicholas Camill,0,0,30,30
1650552125299,MATH 10A,A01,083735,Patchell; Gregory David,5,0,30,25
1650552125299,MATH 10A,A02,083736,Patchell; Gregory David,27,0,30,3
1650552125299,MATH 10A,A03,083737,Patchell; Gregory David,24,0,30,6
1650552131324,MATH 10B,A01,083207,Staff,0,9,30,30
1650552131324,MATH 10B,A02,083208,Staff,0,7,30,30
1650552131324,MATH 10B,B01,083739,Staff,12,0,30,18
1650552131324,MATH 10B,B02,083740,Staff,28,0,30,2
1650552137349,MATH 18,A01,083743,Staff,1,0,30,29
1650552137349,MATH 18,A02,083744,Staff,26,0,30,4
1650552137349,MATH 18,A03,083745,Staff,22,0,30,8
1650552137349,MATH 18,A04,083746,Staff,26,0,30,4
1650552137349,MATH 18,B01,083748,Staff,0,12,30,30
1650552137349,MATH 18,B02,083749,Staff,0,12,30,30
1650552137349,MATH 18,B03,083750,Staff,0,11,30,30
1650552137349,MATH 18,B04,083751,Staff,0,12,30,30
1650552143372,MATH 20A,A01,083754,Staff,22,0,40,18
1650552149399,MATH 20B,A01,083756,Staff,0,11,30,30
1650552149399,MATH 20B,A02,083757,Staff,0,12,30,30
1650552155431,MATH 20C,A01,083760,Staff,0,16,30,30
1650552155431,MATH 20C,A02,083761,Staff,2,14,30,28
1650552155431,MATH 20C,B01,083762,Staff,12,0,30,18
1650552155431,MATH 20C,B02,083763,Staff,28,0,30,2
1650552161454,MATH 20D,A01,083765,Staff,0,1,30,30
1650552161454,MATH 20D,A02,083766,Staff,7,0,30,23
1650552161454,MATH 20D,A03,083767,Staff,25,0,30,5
1650552167480,MATH 20E,A01,083771,Staff,6,0,30,24
1650552167480,MATH 20E,A02,083772,Staff,18,0,30,12
1650552167480,MATH 20E,B01,083773,Staff,0,0,30,30
1650552167480,MATH 20E,B02,083774,Staff,10,0,30,20
1650552173504,MATH 103A,A01,083777,Staff,0,15,30,30
1650552173504,MATH 103A,A02,083778,Staff,0,14,30,30
1650552173504,MATH 103A,B01,083779,Staff,0,13,30,30
1650552173504,MATH 103A,B02,083780,Staff,0,13,30,30
1650552179533,MATH 105,A01,085443,Staff,0,21,30,30
1650552185555,MATH 109,A01,083213,Anzaldo; Leesa B,0,8,30,30
1650552185555,MATH 109,A02,083214,Anzaldo; Leesa B,0,7,30,30
1650552185555,MATH 109,B01,083215,Anzaldo; Leesa B,0,5,30,30
1650552185555,MATH 109,B02,083216,Anzaldo; Leesa B,0,6,30,30
1650552191585,MATH 142A,A01,083219,Chow; Bennett,0,16,30,30
1650552191585,MATH 142A,A02,083220,Chow; Bennett,0,14,30,30
1650552191585,MATH 142A,B01,083221,Chow; Bennett,0,13,30,30
1650552191585,MATH 142A,B02,083222,Chow; Bennett,0,13,30,30
1650552197609,MATH 193A,A01,083224,Staff,0,6,30,30
1650552197609,MATH 193A,A02,083225,Staff,0,5,30,30
1650552197609,MATH 193A,A03,083781,Staff,0,5,30,30
1650552197609,MATH 193A,A04,083782,Staff,0,7,30,30
1650552203632,MATH 197,001,091859,McAuley; Julian John,9998,0,9999,1
1650552209693,COGS 9,A01,083615,Staff,0,16,60,60
1650552215717,COGS 11,A01,083617,Boyle; Mary E. T.,19,0,40,21
1650552221749,COGS 13,A01,083071,Staff,0,35,40,40
1650552227780,COGS 14A,A01,092681,Staff,0,26,100,100
1650552233808,COGS 14B,A01,083073,Cheng; Tzu-Han,0,12,50,50
1650552239935,COGS 17,A01,092677,Staff,19,0,75,56
1650552245960,COGS 100,A01,083619,Staff,0,26,60,60
1650552251986,COGS 101A,A01,083621,Davis; Joshua Daniel,0,26,60,60
1650552258008,COGS 101B,A01,091572,Staff,1,5,60,59
1650552264038,COGS 101C,A01,083625,Delgado; Tania,15,0,30,15
1650552270080,COGS 107A,A01,083627,Boyle; Mary E. T.,0,11,60,60
1650552276106,COGS 118A,A01,083075,Staff,0,3,60,60
1650552282135,CSE 3,A50,083646,Miranda; Gregory Joseph,20,0,38,18
1650552282135,CSE 3,A51,083647,Miranda; Gregory Joseph,36,0,37,1
1650552288165,CSE 8A,A50,083650,Miranda; Gregory Joseph,0,29,40,40
1650552294188,CSE 11,A01,083080,Cao; Yingjun,0,94,40,40
1650552300216,CSE 12,A01,083652,Staff,0,17,100,100
1650552306240,CSE 15L,A01,083654,Staff,0,1,50,50
1650552306240,CSE 15L,A02,083655,Staff,0,0,50,50
1650552312275,CSE 20,A01,083657,Staff,51,0,80,29
1650552318298,CSE 30,A01,083084,Eldon; John,0,77,40,40
1650552324327,CSE 100,A01,083659,Cao; Yingjun,0,66,50,50
1650552330350,CSE 134B,A01,083661,Powell; Thomas Allan,0,34,65,65
1650552336374,CSE 140,A01,083663,Staff,0,5,75,75
1650552342401,CSE 140L,A01,083088,Eldon; John,0,11,75,75
1650552348426,CSE 175,A01,083665,Kumar; Rakesh,7,0,25,18
1650552354449,CSE 190,A00,092507,Dubnov; Shlomo,10,0,20,10
1650552360476,ECE 45,A01,083139,Staff,0,1,60,60
1650552366501,ECE 65,A50,083695,Staff,0,6,30,30
1650552372525,ECE 109,A01,091882,Touri; Behrouz,33,0,70,37
1650552378553,ECE 180,A00,083140,Abi Samra; Nicholas Camill,21,0,30,9
1650552378553,ECE 180,B00,083141,Abi Samra; Nicholas Camill,0,0,30,30
1650552384576,MATH 10A,A01,083735,Patchell; Gregory David,5,0,30,25
1650552384576,MATH 10A,A02,083736,Patchell; Gregory David,27,0,30,3
1650552384576,MATH 10A,A03,083737,Patchell; Gregory David,24,0,30,6
1650552390605,MATH 10B,A01,083207,Staff,0,9,30,30
1650552390605,MATH 10B,A02,083208,Staff,0,7,30,30
1650552390605,MATH 10B,B01,083739,Staff,12,0,30,18
1650552390605,MATH 10B,B02,083740,Staff,28,0,30,2
1650552396629,MATH 18,A01,083743,Staff,1,0,30,29
1650552396629,MATH 18,A02,083744,Staff,26,0,30,4
1650552396629,MATH 18,A03,083745,Staff,22,0,30,8
1650552396629,MATH 18,A04,083746,Staff,26,0,30,4
1650552396629,MATH 18,B01,083748,Staff,0,12,30,30
1650552396629,MATH 18,B02,083749,Staff,0,12,30,30
1650552396629,MATH 18,B03,083750,Staff,0,11,30,30
1650552396629,MATH 18,B04,083751,Staff,0,12,30,30
1650552402652,MATH 20A,A01,083754,Staff,22,0,40,18
1650552408675,MATH 20B,A01,083756,Staff,0,11,30,30
1650552408675,MATH 20B,A02,083757,Staff,0,12,30,30
1650552414700,MATH 20C,A01,083760,Staff,0,16,30,30
1650552414700,MATH 20C,A02,083761,Staff,2,14,30,28
1650552414700,MATH 20C,B01,083762,Staff,12,0,30,18
1650552414700,MATH 20C,B02,083763,Staff,28,0,30,2
1650552420738,MATH 20D,A01,083765,Staff,0,1,30,30
1650552420738,MATH 20D,A02,083766,Staff,7,0,30,23
1650552420738,MATH 20D,A03,083767,Staff,25,0,30,5
1650552426765,MATH 20E,A01,083771,Staff,6,0,30,24
1650552426765,MATH 20E,A02,083772,Staff,18,0,30,12
1650552426765,MATH 20E,B01,083773,Staff,0,0,30,30
1650552426765,MATH 20E,B02,083774,Staff,10,0,30,20
1650552432789,MATH 103A,A01,083777,Staff,0,15,30,30
1650552432789,MATH 103A,A02,083778,Staff,0,14,30,30
1650552432789,MATH 103A,B01,083779,Staff,0,13,30,30
1650552432789,MATH 103A,B02,083780,Staff,0,13,30,30
1650552438822,MATH 105,A01,085443,Staff,0,21,30,30
1650552444850,MATH 109,A01,083213,Anzaldo; Leesa B,0,8,30,30
1650552444850,MATH 109,A02,083214,Anzaldo; Leesa B,0,7,30,30
1650552444850,MATH 109,B01,083215,Anzaldo; Leesa B,0,5,30,30
1650552444850,MATH 109,B02,083216,Anzaldo; Leesa B,0,6,30,30
1650552450874,MATH 142A,A01,083219,Chow; Bennett,0,16,30,30
1650552450874,MATH 142A,A02,083220,Chow; Bennett,0,14,30,30
1650552450874,MATH 142A,B01,083221,Chow; Bennett,0,13,30,30
1650552450874,MATH 142A,B02,083222,Chow; Bennett,0,13,30,30
1650552456908,MATH 193A,A01,083224,Staff,0,6,30,30
1650552456908,MATH 193A,A02,083225,Staff,0,5,30,30
1650552456908,MATH 193A,A03,083781,Staff,0,5,30,30
1650552456908,MATH 193A,A04,083782,Staff,0,7,30,30
1650552462942,MATH 197,001,091859,McAuley; Julian John,9998,0,9999,1
1650552469011,COGS 9,A01,083615,Staff,0,16,60,60
1650552475035,COGS 11,A01,083617,Boyle; Mary E. T.,19,0,40,21
1650552481077,COGS 13,A01,083071,Staff,0,35,40,40
1650552487103,COGS 14A,A01,092681,Staff,0,26,100,100
1650552493136,COGS 14B,A01,083073,Cheng; Tzu-Han,0,12,50,50
1650552499158,COGS 17,A01,092677,Staff,19,0,75,56
1650552505187,COGS 100,A01,083619,Staff,0,26,60,60
1650552511221,COGS 101A,A01,083621,Davis; Joshua Daniel,0,26,60,60
1650552517244,COGS 101B,A01,091572,Staff,1,5,60,59
1650552523274,COGS 101C,A01,083625,Delgado; Tania,15,0,30,15
1650552529298,COGS 107A,A01,083627,Boyle; Mary E. T.,0,11,60,60
1650552535319,COGS 118A,A01,083075,Staff,0,3,60,60
1650552541353,CSE 3,A50,083646,Miranda; Gregory Joseph,20,0,38,18
1650552541353,CSE 3,A51,083647,Miranda; Gregory Joseph,36,0,37,1
1650552547381,CSE 8A,A50,083650,Miranda; Gregory Joseph,0,29,40,40
1650552553408,CSE 11,A01,083080,Cao; Yingjun,0,94,40,40
1650552559434,CSE 12,A01,083652,Staff,0,17,100,100
1650552565458,CSE 15L,A01,083654,Staff,0,1,50,50
1650552565458,CSE 15L,A02,083655,Staff,0,0,50,50
1650552571483,CSE 20,A01,083657,Staff,51,0,80,29
1650552577508,CSE 30,A01,083084,Eldon; John,0,77,40,40
1650552583532,CSE 100,A01,083659,Cao; Yingjun,0,66,50,50
1650552589555,CSE 134B,A01,083661,Powell; Thomas Allan,0,34,65,65
1650552595578,CSE 140,A01,083663,Staff,0,5,75,75
1650552601602,CSE 140L,A01,083088,Eldon; John,0,11,75,75
1650552607628,CSE 175,A01,083665,Kumar; Rakesh,7,0,25,18
1650552613651,CSE 190,A00,092507,Dubnov; Shlomo,10,0,20,10
1650552619673,ECE 45,A01,083139,Staff,0,1,60,60
1650552625697,ECE 65,A50,083695,Staff,0,6,30,30
1650552631721,ECE 109,A01,091882,Touri; Behrouz,33,0,70,37
1650552637746,ECE 180,A00,083140,Abi Samra; Nicholas Camill,21,0,30,9
1650552637746,ECE 180,B00,083141,Abi Samra; Nicholas Camill,0,0,30,30
1650552643770,MATH 10A,A01,083735,Patchell; Gregory David,5,0,30,25
1650552643770,MATH 10A,A02,083736,Patchell; Gregory David,27,0,30,3
1650552643770,MATH 10A,A03,083737,Patchell; Gregory David,24,0,30,6
1650552649807,MATH 10B,A01,083207,Staff,0,9,30,30
1650552649807,MATH 10B,A02,083208,Staff,0,7,30,30
1650552649807,MATH 10B,B01,083739,Staff,12,0,30,18
1650552649807,MATH 10B,B02,083740,Staff,28,0,30,2
1650552655833,MATH 18,A01,083743,Staff,1,0,30,29
1650552655833,MATH 18,A02,083744,Staff,26,0,30,4
1650552655833,MATH 18,A03,083745,Staff,22,0,30,8
1650552655833,MATH 18,A04,083746,Staff,26,0,30,4
1650552655833,MATH 18,B01,083748,Staff,0,12,30,30
1650552655833,MATH 18,B02,083749,Staff,0,12,30,30
1650552655833,MATH 18,B03,083750,Staff,0,11,30,30
1650552655833,MATH 18,B04,083751,Staff,0,12,30,30
1650552661860,MATH 20A,A01,083754,Staff,22,0,40,18
1650552667884,MATH 20B,A01,083756,Staff,0,11,30,30
1650552667884,MATH 20B,A02,083757,Staff,0,12,30,30
1650552673907,MATH 20C,A01,083760,Staff,0,16,30,30
1650552673907,MATH 20C,A02,083761,Staff,2,14,30,28
1650552673907,MATH 20C,B01,083762,Staff,12,0,30,18
1650552673907,MATH 20C,B02,083763,Staff,28,0,30,2
1650552679934,MATH 20D,A01,083765,Staff,0,1,30,30
1650552679934,MATH 20D,A02,083766,Staff,7,0,30,23
1650552679934,MATH 20D,A03,083767,Staff,25,0,30,5
1650552685958,MATH 20E,A01,083771,Staff,6,0,30,24
1650552685958,MATH 20E,A02,083772,Staff,18,0,30,12
1650552685958,MATH 20E,B01,083773,Staff,0,0,30,30
1650552685958,MATH 20E,B02,083774,Staff,10,0,30,20
1650552691981,MATH 103A,A01,083777,Staff,0,15,30,30
1650552691981,MATH 103A,A02,083778,Staff,0,14,30,30
1650552691981,MATH 103A,B01,083779,Staff,0,13,30,30
1650552691981,MATH 103A,B02,083780,Staff,0,13,30,30
1650552698005,MATH 105,A01,085443,Staff,0,21,30,30
1650552704031,MATH 109,A01,083213,Anzaldo; Leesa B,0,8,30,30
1650552704031,MATH 109,A02,083214,Anzaldo; Leesa B,0,7,30,30
1650552704031,MATH 109,B01,083215,Anzaldo; Leesa B,0,5,30,30
1650552704031,MATH 109,B02,083216,Anzaldo; Leesa B,0,6,30,30
1650552710056,MATH 142A,A01,083219,Chow; Bennett,0,16,30,30
1650552710056,MATH 142A,A02,083220,Chow; Bennett,0,14,30,30
1650552710056,MATH 142A,B01,083221,Chow; Bennett,0,13,30,30
1650552710056,MATH 142A,B02,083222,Chow; Bennett,0,13,30,30
1650552716093,MATH 193A,A01,083224,Staff,0,6,30,30
1650552716093,MATH 193A,A02,083225,Staff,0,5,30,30
1650552716093,MATH 193A,A03,083781,Staff,0,5,30,30
1650552716093,MATH 193A,A04,083782,Staff,0,7,30,30
1650552722120,MATH 197,001,091859,McAuley; Julian John,9998,0,9999,1
1650552728179,COGS 9,A01,083615,Staff,0,16,60,60
1650552734207,COGS 11,A01,083617,Boyle; Mary E. T.,19,0,40,21
1650552740231,COGS 13,A01,083071,Staff,0,35,40,40
1650552746260,COGS 14A,A01,092681,Staff,0,26,100,100
1650552752284,COGS 14B,A01,083073,Cheng; Tzu-Han,0,12,50,50
1650552758309,COGS 17,A01,092677,Staff,19,0,75,56
1650552764336,COGS 100,A01,083619,Staff,0,26,60,60
1650552770360,COGS 101A,A01,083621,Davis; Joshua Daniel,0,26,60,60
1650552776386,COGS 101B,A01,091572,Staff,1,5,60,59
1650552782410,COGS 101C,A01,083625,Delgado; Tania,15,0,30,15
1650552788434,COGS 107A,A01,083627,Boyle; Mary E. T.,0,11,60,60
1650552794460,COGS 118A,A01,083075,Staff,0,3,60,60
1650552800496,CSE 3,A50,083646,Miranda; Gregory Joseph,20,0,38,18
1650552800496,CSE 3,A51,083647,Miranda; Gregory Joseph,36,0,37,1
1650552806525,CSE 8A,A50,083650,Miranda; Gregory Joseph,0,29,40,40
1650552812552,CSE 11,A01,083080,Cao; Yingjun,0,94,40,40
1650552818576,CSE 12,A01,083652,Staff,0,17,100,100
1650552824601,CSE 15L,A01,083654,Staff,0,1,50,50
1650552824601,CSE 15L,A02,083655,Staff,0,0,50,50
1650552830625,CSE 20,A01,083657,Staff,51,0,80,29
1650552836736,CSE 30,A01,083084,Eldon; John,0,77,40,40
1650552842762,CSE 100,A01,083659,Cao; Yingjun,0,66,50,50
1650552848794,CSE 134B,A01,083661,Powell; Thomas Allan,0,34,65,65
1650552854835,CSE 140,A01,083663,Staff,0,5,75,75
1650552860857,CSE 140L,A01,083088,Eldon; John,0,11,75,75
1650552866880,CSE 175,A01,083665,Kumar; Rakesh,7,0,25,18
1650552872908,CSE 190,A00,092507,Dubnov; Shlomo,10,0,20,10
1650552878935,ECE 45,A01,083139,Staff,0,1,60,60
1650552884958,ECE 65,A50,083695,Staff,0,6,30,30
1650552890984,ECE 109,A01,091882,Touri; Behrouz,33,0,70,37
1650552897010,ECE 180,A00,083140,Abi Samra; Nicholas Camill,21,0,30,9
1650552897010,ECE 180,B00,083141,Abi Samra; Nicholas Camill,0,0,30,30
1650552903035,MATH 10A,A01,083735,Patchell; Gregory David,5,0,30,25
1650552903035,MATH 10A,A02,083736,Patchell; Gregory David,27,0,30,3
1650552903035,MATH 10A,A03,083737,Patchell; Gregory David,24,0,30,6
1650552909059,MATH 10B,A01,083207,Staff,0,9,30,30
1650552909059,MATH 10B,A02,083208,Staff,0,7,30,30
1650552909059,MATH 10B,B01,083739,Staff,12,0,30,18
1650552909059,MATH 10B,B02,083740,Staff,28,0,30,2
1650552915087,MATH 18,A01,083743,Staff,1,0,30,29
1650552915087,MATH 18,A02,083744,Staff,26,0,30,4
1650552915087,MATH 18,A03,083745,Staff,22,0,30,8
1650552915087,MATH 18,A04,083746,Staff,26,0,30,4
1650552915087,MATH 18,B01,083748,Staff,0,12,30,30
1650552915087,MATH 18,B02,083749,Staff,0,12,30,30
1650552915087,MATH 18,B03,083750,Staff,0,11,30,30
1650552915087,MATH 18,B04,083751,Staff,0,12,30,30
1650552921112,MATH 20A,A01,083754,Staff,22,0,40,18
1650552927134,MATH 20B,A01,083756,Staff,0,11,30,30
1650552927134,MATH 20B,A02,083757,Staff,0,12,30,30
1650552933159,MATH 20C,A01,083760,Staff,0,16,30,30
1650552933159,MATH 20C,A02,083761,Staff,2,14,30,28
1650552933159,MATH 20C,B01,083762,Staff,12,0,30,18
1650552933159,MATH 20C,B02,083763,Staff,28,0,30,2
1650552939182,MATH 20D,A01,083765,Staff,0,1,30,30
1650552939182,MATH 20D,A02,083766,Staff,7,0,30,23
1650552939182,MATH 20D,A03,083767,Staff,25,0,30,5
1650552945216,MATH 20E,A01,083771,Staff,6,0,30,24
1650552945216,MATH 20E,A02,083772,Staff,18,0,30,12
1650552945216,MATH 20E,B01,083773,Staff,0,0,30,30
1650552945216,MATH 20E,B02,083774,Staff,10,0,30,20
1650552951239,MATH 103A,A01,083777,Staff,0,15,30,30
1650552951239,MATH 103A,A02,083778,Staff,0,14,30,30
1650552951239,MATH 103A,B01,083779,Staff,0,13,30,30
1650552951239,MATH 103A,B02,083780,Staff,0,13,30,30
1650552957266,MATH 105,A01,085443,Staff,0,21,30,30
1650552963292,MATH 109,A01,083213,Anzaldo; Leesa B,0,8,30,30
1650552963292,MATH 109,A02,083214,Anzaldo; Leesa B,0,7,30,30
1650552963292,MATH 109,B01,083215,Anzaldo; Leesa B,0,5,30,30
1650552963292,MATH 109,B02,083216,Anzaldo; Leesa B,0,6,30,30
1650552969316,MATH 142A,A01,083219,Chow; Bennett,0,16,30,30
1650552969316,MATH 142A,A02,083220,Chow; Bennett,0,14,30,30
1650552969316,MATH 142A,B01,083221,Chow; Bennett,0,13,30,30
1650552969316,MATH 142A,B02,083222,Chow; Bennett,0,13,30,30
1650552975340,MATH 193A,A01,083224,Staff,0,6,30,30
1650552975340,MATH 193A,A02,083225,Staff,0,5,30,30
1650552975340,MATH 193A,A03,083781,Staff,0,5,30,30
1650552975340,MATH 193A,A04,083782,Staff,0,7,30,30
1650552981363,MATH 197,001,091859,McAuley; Julian John,9998,0,9999,1
1650552987424,COGS 9,A01,083615,Staff,0,16,60,60
1650552993450,COGS 11,A01,083617,Boyle; Mary E. T.,19,0,40,21
1650552999475,COGS 13,A01,083071,Staff,0,35,40,40
1650553005503,COGS 14A,A01,092681,Staff,0,26,100,100
1650553011529,COGS 14B,A01,083073,Cheng; Tzu-Han,0,12,50,50
1650553017551,COGS 17,A01,092677,Staff,19,0,75,56
1650553023574,COGS 100,A01,083619,Staff,0,26,60,60
1650553029600,COGS 101A,A01,083621,Davis; Joshua Daniel,0,26,60,60
1650553035626,COGS 101B,A01,091572,Staff,1,5,60,59
1650553041649,COGS 101C,A01,083625,Delgado; Tania,15,0,30,15
1650553047673,COGS 107A,A01,083627,Boyle; Mary E. T.,0,11,60,60
1650553053699,COGS 118A,A01,083075,Staff,0,3,60,60
1650553059725,CSE 3,A50,083646,Miranda; Gregory Joseph,20,0,38,18
1650553059725,CSE 3,A51,083647,Miranda; Gregory Joseph,36,0,37,1
1650553065749,CSE 8A,A50,083650,Miranda; Gregory Joseph,0,29,40,40
1650553071775,CSE 11,A01,083080,Cao; Yingjun,0,94,40,40
1650553077797,CSE 12,A01,083652,Staff,0,17,100,100
1650553083825,CSE 15L,A01,083654,Staff,0,1,50,50
1650553083825,CSE 15L,A02,083655,Staff,0,0,50,50
1650553089849,CSE 20,A01,083657,Staff,51,0,80,29
1650553095880,CSE 30,A01,083084,Eldon; John,0,77,40,40
1650553101908,CSE 100,A01,083659,Cao; Yingjun,0,66,50,50
1650553107931,CSE 134B,A01,083661,Powell; Thomas Allan,0,34,65,65
1650553113969,CSE 140,A01,083663,Staff,0,5,75,75
1650553119993,CSE 140L,A01,083088,Eldon; John,0,11,75,75
1650553126018,CSE 175,A01,083665,Kumar; Rakesh,7,0,25,18
1650553132041,CSE 190,A00,092507,Dubnov; Shlomo,10,0,20,10
1650553138068,ECE 45,A01,083139,Staff,0,1,60,60
1650553144095,ECE 65,A50,083695,Staff,0,6,30,30
1650553150146,ECE 109,A01,091882,Touri; Behrouz,33,0,70,37
1650553156170,ECE 180,A00,083140,Abi Samra; Nicholas Camill,21,0,30,9
1650553156170,ECE 180,B00,083141,Abi Samra; Nicholas Camill,0,0,30,30
1650553162200,MATH 10A,A01,083735,Patchell; Gregory David,5,0,30,25
1650553162200,MATH 10A,A02,083736,Patchell; Gregory David,27,0,30,3
1650553162200,MATH 10A,A03,083737,Patchell; Gregory David,24,0,30,6
1650553168227,MATH 10B,A01,083207,Staff,0,9,30,30
1650553168227,MATH 10B,A02,083208,Staff,0,7,30,30
1650553168227,MATH 10B,B01,083739,Staff,12,0,30,18
1650553168227,MATH 10B,B02,083740,Staff,28,0,30,2
1650553174255,MATH 18,A01,083743,Staff,1,0,30,29
1650553174255,MATH 18,A02,083744,Staff,26,0,30,4
1650553174255,MATH 18,A03,083745,Staff,22,0,30,8
1650553174255,MATH 18,A04,083746,Staff,26,0,30,4
1650553174255,MATH 18,B01,083748,Staff,0,12,30,30
1650553174255,MATH 18,B02,083749,Staff,0,12,30,30
1650553174255,MATH 18,B03,083750,Staff,0,11,30,30
1650553174255,MATH 18,B04,083751,Staff,0,12,30,30
1650553180278,MATH 20A,A01,083754,Staff,22,0,40,18
1650553186307,MATH 20B,A01,083756,Staff,0,11,30,30
1650553186307,MATH 20B,A02,083757,Staff,0,12,30,30
1650553192331,MATH 20C,A01,083760,Staff,0,16,30,30
1650553192331,MATH 20C,A02,083761,Staff,2,14,30,28
1650553192331,MATH 20C,B01,083762,Staff,12,0,30,18
1650553192331,MATH 20C,B02,083763,Staff,28,0,30,2
1650553198361,MATH 20D,A01,083765,Staff,0,1,30,30
1650553198361,MATH 20D,A02,083766,Staff,7,0,30,23
1650553198361,MATH 20D,A03,083767,Staff,25,0,30,5
1650553204389,MATH 20E,A01,083771,Staff,6,0,30,24
1650553204389,MATH 20E,A02,083772,Staff,18,0,30,12
1650553204389,MATH 20E,B01,083773,Staff,0,0,30,30
1650553204389,MATH 20E,B02,083774,Staff,10,0,30,20
1650553210418,MATH 103A,A01,083777,Staff,0,15,30,30
1650553210418,MATH 103A,A02,083778,Staff,0,14,30,30
1650553210418,MATH 103A,B01,083779,Staff,0,13,30,30
1650553210418,MATH 103A,B02,083780,Staff,0,13,30,30
1650553216444,MATH 105,A01,085443,Staff,0,21,30,30
1650553222467,MATH 109,A01,083213,Anzaldo; Leesa B,0,8,30,30
1650553222467,MATH 109,A02,083214,Anzaldo; Leesa B,0,7,30,30
1650553222467,MATH 109,B01,083215,Anzaldo; Leesa B,0,5,30,30
1650553222467,MATH 109,B02,083216,Anzaldo; Leesa B,0,6,30,30
1650553228515,MATH 142A,A01,083219,Chow; Bennett,0,16,30,30
1650553228515,MATH 142A,A02,083220,Chow; Bennett,0,14,30,30
1650553228515,MATH 142A,B01,083221,Chow; Bennett,0,13,30,30
1650553228515,MATH 142A,B02,083222,Chow; Bennett,0,13,30,30
1650553234545,MATH 193A,A01,083224,Staff,0,6,30,30
1650553234545,MATH 193A,A02,083225,Staff,0,5,30,30
1650553234545,MATH 193A,A03,083781,Staff,0,5,30,30
1650553234545,MATH 193A,A04,083782,Staff,0,7,30,30
1650553240571,MATH 197,001,091859,McAuley; Julian John,9998,0,9999,1
1650553246625,COGS 9,A01,083615,Staff,0,16,60,60
1650553252656,COGS 11,A01,083617,Boyle; Mary E. T.,19,0,40,21
1650553258683,COGS 13,A01,083071,Staff,0,35,40,40
1650553264717,COGS 14A,A01,092681,Staff,0,26,100,100
1650553270741,COGS 14B,A01,083073,Cheng; Tzu-Han,0,12,50,50
1650553276765,COGS 17,A01,092677,Staff,19,0,75,56
1650553282791,COGS 100,A01,083619,Staff,0,26,60,60
1650553288815,COGS 101A,A01,083621,Davis; Joshua Daniel,0,26,60,60
1650553294842,COGS 101B,A01,091572,Staff,1,5,60,59
1650553300869,COGS 101C,A01,083625,Delgado; Tania,15,0,30,15
1650553306898,COGS 107A,A01,083627,Boyle; Mary E. T.,0,11,60,60
1650553312922,COGS 118A,A01,083075,Staff,0,3,60,60
1650553318949,CSE 3,A50,083646,Miranda; Gregory Joseph,20,0,38,18
1650553318949,CSE 3,A51,083647,Miranda; Gregory Joseph,36,0,37,1
1650553324973,CSE 8A,A50,083650,Miranda; Gregory Joseph,0,29,40,40
1650553330998,CSE 11,A01,083080,Cao; Yingjun,0,94,40,40
1650553337048,CSE 12,A01,083652,Staff,0,17,100,100
1650553343073,CSE 15L,A01,083654,Staff,0,1,50,50
1650553343073,CSE 15L,A02,083655,Staff,0,0,50,50
1650553349098,CSE 20,A01,083657,Staff,51,0,80,29
1650553355121,CSE 30,A01,083084,Eldon; John,0,77,40,40
1650553361156,CSE 100,A01,083659,Cao; Yingjun,0,66,50,50
1650553367185,CSE 134B,A01,083661,Powell; Thomas Allan,0,34,65,65
1650553373211,CSE 140,A01,083663,Staff,0,5,75,75
1650553379241,CSE 140L,A01,083088,Eldon; John,0,11,75,75
1650553385268,CSE 175,A01,083665,Kumar; Rakesh,7,0,25,18
1650553391292,CSE 190,A00,092507,Dubnov; Shlomo,10,0,20,10
1650553397319,ECE 45,A01,083139,Staff,0,1,60,60
1650553403353,ECE 65,A50,083695,Staff,0,6,30,30
1650553409379,ECE 109,A01,091882,Touri; Behrouz,33,0,70,37
1650553415407,ECE 180,A00,083140,Abi Samra; Nicholas Camill,21,0,30,9
1650553415407,ECE 180,B00,083141,Abi Samra; Nicholas Camill,0,0,30,30
1650553421435,MATH 10A,A01,083735,Patchell; Gregory David,5,0,30,25
1650553421435,MATH 10A,A02,083736,Patchell; Gregory David,27,0,30,3
1650553421435,MATH 10A,A03,083737,Patchell; Gregory David,24,0,30,6
1650553427459,MATH 10B,A01,083207,Staff,0,9,30,30
1650553427459,MATH 10B,A02,083208,Staff,0,7,30,30
1650553427459,MATH 10B,B01,083739,Staff,12,0,30,18
1650553427459,MATH 10B,B02,083740,Staff,28,0,30,2
1650553433583,MATH 18,A01,083743,Staff,1,0,30,29
1650553433583,MATH 18,A02,083744,Staff,26,0,30,4
1650553433583,MATH 18,A03,083745,Staff,22,0,30,8
1650553433583,MATH 18,A04,083746,Staff,26,0,30,4
1650553433583,MATH 18,B01,083748,Staff,0,12,30,30
1650553433583,MATH 18,B02,083749,Staff,0,12,30,30
1650553433583,MATH 18,B03,083750,Staff,0,11,30,30
1650553433583,MATH 18,B04,083751,Staff,0,12,30,30
1650553439610,MATH 20A,A01,083754,Staff,22,0,40,18
1650553445640,MATH 20B,A01,083756,Staff,0,11,30,30
1650553445640,MATH 20B,A02,083757,Staff,0,12,30,30
1650553451669,MATH 20C,A01,083760,Staff,0,16,30,30
1650553451669,MATH 20C,A02,083761,Staff,2,14,30,28
1650553451669,MATH 20C,B01,083762,Staff,12,0,30,18
1650553451669,MATH 20C,B02,083763,Staff,28,0,30,2
1650553457701,MATH 20D,A01,083765,Staff,0,1,30,30
1650553457701,MATH 20D,A02,083766,Staff,7,0,30,23
1650553457701,MATH 20D,A03,083767,Staff,25,0,30,5
1650553463727,MATH 20E,A01,083771,Staff,6,0,30,24
1650553463727,MATH 20E,A02,083772,Staff,18,0,30,12
1650553463727,MATH 20E,B01,083773,Staff,0,0,30,30
1650553463727,MATH 20E,B02,083774,Staff,10,0,30,20
1650553469752,MATH 103A,A01,083777,Staff,0,15,30,30
1650553469752,MATH 103A,A02,083778,Staff,0,14,30,30
1650553469752,MATH 103A,B01,083779,Staff,0,13,30,30
1650553469752,MATH 103A,B02,083780,Staff,0,13,30,30
1650553475783,MATH 105,A01,085443,Staff,0,21,30,30
1650553481811,MATH 109,A01,083213,Anzaldo; Leesa B,0,8,30,30
1650553481811,MATH 109,A02,083214,Anzaldo; Leesa B,0,7,30,30
1650553481811,MATH 109,B01,083215,Anzaldo; Leesa B,0,5,30,30
1650553481811,MATH 109,B02,083216,Anzaldo; Leesa B,0,6,30,30
1650553487837,MATH 142A,A01,083219,Chow; Bennett,0,16,30,30
1650553487837,MATH 142A,A02,083220,Chow; Bennett,0,14,30,30
1650553487837,MATH 142A,B01,083221,Chow; Bennett,0,13,30,30
1650553487837,MATH 142A,B02,083222,Chow; Bennett,0,13,30,30
1650553493863,MATH 193A,A01,083224,Staff,0,6,30,30
1650553493863,MATH 193A,A02,083225,Staff,0,5,30,30
1650553493863,MATH 193A,A03,083781,Staff,0,5,30,30
1650553493863,MATH 193A,A04,083782,Staff,0,7,30,30
1650553499887,MATH 197,001,091859,McAuley; Julian John,9998,0,9999,1
1650553505954,COGS 9,A01,083615,Staff,0,16,60,60
1650553511982,COGS 11,A01,083617,Boyle; Mary E. T.,19,0,40,21
1650553518007,COGS 13,A01,083071,Staff,0,35,40,40
1650553524034,COGS 14A,A01,092681,Staff,0,26,100,100
1650553530065,COGS 14B,A01,083073,Cheng; Tzu-Han,0,12,50,50
1650553536093,COGS 17,A01,092677,Staff,19,0,75,56
1650553542118,COGS 100,A01,083619,Staff,0,26,60,60
1650553548148,COGS 101A,A01,083621,Davis; Joshua Daniel,0,26,60,60
1650553554174,COGS 101B,A01,091572,Staff,1,5,60,59
1650553560206,COGS 101C,A01,083625,Delgado; Tania,15,0,30,15
1650553566457,COGS 107A,A01,083627,Boyle; Mary E. T.,0,11,60,60
1650553572483,COGS 118A,A01,083075,Staff,0,3,60,60
1650553578512,CSE 3,A50,083646,Miranda; Gregory Joseph,20,0,38,18
1650553578512,CSE 3,A51,083647,Miranda; Gregory Joseph,36,0,37,1
1650553584537,CSE 8A,A50,083650,Miranda; Gregory Joseph,0,29,40,40
1650553590571,CSE 11,A01,083080,Cao; Yingjun,0,94,40,40
1650553596595,CSE 12,A01,083652,Staff,0,17,100,100
1650553602621,CSE 15L,A01,083654,Staff,0,1,50,50
1650553602621,CSE 15L,A02,083655,Staff,0,0,50,50
1650553608648,CSE 20,A01,083657,Staff,51,0,80,29
1650553614676,CSE 30,A01,083084,Eldon; John,0,77,40,40
1650553620704,CSE 100,A01,083659,Cao; Yingjun,0,66,50,50
1650553626729,CSE 134B,A01,083661,Powell; Thomas Allan,0,34,65,65
1650553632756,CSE 140,A01,083663,Staff,0,5,75,75
1650553638781,CSE 140L,A01,083088,Eldon; John,0,11,75,75
1650553644807,CSE 175,A01,083665,Kumar; Rakesh,7,0,25,18
1650553650834,CSE 190,A00,092507,Dubnov; Shlomo,10,0,20,10
1650553656858,ECE 45,A01,083139,Staff,0,1,60,60
1650553673095,ECE 65,A50,083695,Staff,0,6,30,30
1650553679125,ECE 109,A01,091882,Touri; Behrouz,33,0,70,37
1650553685151,ECE 180,A00,083140,Abi Samra; Nicholas Camill,21,0,30,9
1650553685151,ECE 180,B00,083141,Abi Samra; Nicholas Camill,0,0,30,30
1650553691175,MATH 10A,A01,083735,Patchell; Gregory David,5,0,30,25
1650553691175,MATH 10A,A02,083736,Patchell; Gregory David,27,0,30,3
1650553691175,MATH 10A,A03,083737,Patchell; Gregory David,24,0,30,6
1650553697202,MATH 10B,A01,083207,Staff,0,9,30,30
1650553697202,MATH 10B,A02,083208,Staff,0,7,30,30
1650553697202,MATH 10B,B01,083739,Staff,12,0,30,18
1650553697202,MATH 10B,B02,083740,Staff,28,0,30,2
1650553703236,MATH 18,A01,083743,Staff,1,0,30,29
1650553703236,MATH 18,A02,083744,Staff,26,0,30,4
1650553703236,MATH 18,A03,083745,Staff,22,0,30,8
1650553703236,MATH 18,A04,083746,Staff,26,0,30,4
1650553703236,MATH 18,B01,083748,Staff,0,12,30,30
1650553703236,MATH 18,B02,083749,Staff,0,12,30,30
1650553703236,MATH 18,B03,083750,Staff,0,11,30,30
1650553703236,MATH 18,B04,083751,Staff,0,12,30,30
1650553709259,MATH 20A,A01,083754,Staff,22,0,40,18
1650553715284,MATH 20B,A01,083756,Staff,0,11,30,30
1650553715284,MATH 20B,A02,083757,Staff,0,12,30,30
1650553721314,MATH 20C,A01,083760,Staff,0,16,30,30
1650553721314,MATH 20C,A02,083761,Staff,2,14,30,28
1650553721314,MATH 20C,B01,083762,Staff,12,0,30,18
1650553721314,MATH 20C,B02,083763,Staff,28,0,30,2
1650553727338,MATH 20D,A01,083765,Staff,0,1,30,30
1650553727338,MATH 20D,A02,083766,Staff,7,0,30,23
1650553727338,MATH 20D,A03,083767,Staff,25,0,30,5
1650553733366,MATH 20E,A01,083771,Staff,6,0,30,24
1650553733366,MATH 20E,A02,083772,Staff,18,0,30,12
1650553733366,MATH 20E,B01,083773,Staff,0,0,30,30
1650553733366,MATH 20E,B02,083774,Staff,10,0,30,20
1650553739398,MATH 103A,A01,083777,Staff,0,15,30,30
1650553739398,MATH 103A,A02,083778,Staff,0,14,30,30
1650553739398,MATH 103A,B01,083779,Staff,0,13,30,30
1650553739398,MATH 103A,B02,083780,Staff,0,13,30,30
1650553745428,MATH 105,A01,085443,Staff,0,21,30,30
1650553751455,MATH 109,A01,083213,Anzaldo; Leesa B,0,8,30,30
1650553751455,MATH 109,A02,083214,Anzaldo; Leesa B,0,7,30,30
1650553751455,MATH 109,B01,083215,Anzaldo; Leesa B,0,5,30,30
1650553751455,MATH 109,B02,083216,Anzaldo; Leesa B,0,6,30,30
1650553757478,MATH 142A,A01,083219,Chow; Bennett,0,16,30,30
1650553757478,MATH 142A,A02,083220,Chow; Bennett,0,14,30,30
1650553757478,MATH 142A,B01,083221,Chow; Bennett,0,13,30,30
1650553757478,MATH 142A,B02,083222,Chow; Bennett,0,13,30,30
1650553763506,MATH 193A,A01,083224,Staff,0,6,30,30
1650553763506,MATH 193A,A02,083225,Staff,0,5,30,30
1650553763506,MATH 193A,A03,083781,Staff,0,5,30,30
1650553763506,MATH 193A,A04,083782,Staff,0,7,30,30
1650553769530,MATH 197,001,091859,McAuley; Julian John,9998,0,9999,1
1650553775582,COGS 9,A01,083615,Staff,0,16,60,60
1650553781606,COGS 11,A01,083617,Boyle; Mary E. T.,19,0,40,21
1650553787636,COGS 13,A01,083071,Staff,0,35,40,40
1650553793661,COGS 14A,A01,092681,Staff,0,26,100,100
1650553799690,COGS 14B,A01,083073,Cheng; Tzu-Han,0,12,50,50
1650553805721,COGS 17,A01,092677,Staff,19,0,75,56
1650553811748,COGS 100,A01,083619,Staff,0,26,60,60
1650553817773,COGS 101A,A01,083621,Davis; Joshua Daniel,0,26,60,60
1650553823799,COGS 101B,A01,091572,Staff,1,5,60,59
1650553829824,COGS 101C,A01,083625,Delgado; Tania,15,0,30,15
1650553835848,COGS 107A,A01,083627,Boyle; Mary E. T.,0,11,60,60
1650553841880,COGS 118A,A01,083075,Staff,0,3,60,60
1650553847910,CSE 3,A50,083646,Miranda; Gregory Joseph,20,0,38,18
1650553847910,CSE 3,A51,083647,Miranda; Gregory Joseph,36,0,37,1
1650553853937,CSE 8A,A50,083650,Miranda; Gregory Joseph,0,29,40,40
1650553859966,CSE 11,A01,083080,Cao; Yingjun,0,94,40,40
1650553866014,CSE 12,A01,083652,Staff,0,17,100,100
1650553872040,CSE 15L,A01,083654,Staff,0,1,50,50
1650553872040,CSE 15L,A02,083655,Staff,0,0,50,50
1650553878068,CSE 20,A01,083657,Staff,51,0,80,29
1650553884096,CSE 30,A01,083084,Eldon; John,0,77,40,40
1650553890121,CSE 100,A01,083659,Cao; Yingjun,0,66,50,50
1650553896152,CSE 134B,A01,083661,Powell; Thomas Allan,0,34,65,65
1650553902179,CSE 140,A01,083663,Staff,0,5,75,75
1650553908204,CSE 140L,A01,083088,Eldon; John,0,11,75,75
1650553914228,CSE 175,A01,083665,Kumar; Rakesh,7,0,25,18
1650553920255,CSE 190,A00,092507,Dubnov; Shlomo,10,0,20,10
1650553926291,ECE 45,A01,083139,Staff,0,1,60,60
1650553932315,ECE 65,A50,083695,Staff,0,6,30,30
1650553938340,ECE 109,A01,091882,Touri; Behrouz,33,0,70,37
1650553944363,ECE 180,A00,083140,Abi Samra; Nicholas Camill,21,0,30,9
1650553944363,ECE 180,B00,083141,Abi Samra; Nicholas Camill,0,0,30,30
1650553950393,MATH 10A,A01,083735,Patchell; Gregory David,5,0,30,25
1650553950393,MATH 10A,A02,083736,Patchell; Gregory David,27,0,30,3
1650553950393,MATH 10A,A03,083737,Patchell; Gregory David,24,0,30,6
1650553956417,MATH 10B,A01,083207,Staff,0,9,30,30
1650553956417,MATH 10B,A02,083208,Staff,0,7,30,30
1650553956417,MATH 10B,B01,083739,Staff,12,0,30,18
1650553956417,MATH 10B,B02,083740,Staff,28,0,30,2
1650553962445,MATH 18,A01,083743,Staff,1,0,30,29
1650553962445,MATH 18,A02,083744,Staff,26,0,30,4
1650553962445,MATH 18,A03,083745,Staff,22,0,30,8
1650553962445,MATH 18,A04,083746,Staff,26,0,30,4
1650553962445,MATH 18,B01,083748,Staff,0,12,30,30
1650553962445,MATH 18,B02,083749,Staff,0,12,30,30
1650553962445,MATH 18,B03,083750,Staff,0,11,30,30
1650553962445,MATH 18,B04,083751,Staff,0,12,30,30
1650553968469,MATH 20A,A01,083754,Staff,22,0,40,18
1650553974493,MATH 20B,A01,083756,Staff,0,11,30,30
1650553974493,MATH 20B,A02,083757,Staff,0,12,30,30
1650553980526,MATH 20C,A01,083760,Staff,0,16,30,30
1650553980526,MATH 20C,A02,083761,Staff,2,14,30,28
1650553980526,MATH 20C,B01,083762,Staff,12,0,30,18
1650553980526,MATH 20C,B02,083763,Staff,28,0,30,2
1650553986550,MATH 20D,A01,083765,Staff,0,1,30,30
1650553986550,MATH 20D,A02,083766,Staff,7,0,30,23
1650553986550,MATH 20D,A03,083767,Staff,25,0,30,5
1650553992574,MATH 20E,A01,083771,Staff,6,0,30,24
1650553992574,MATH 20E,A02,083772,Staff,18,0,30,12
1650553992574,MATH 20E,B01,083773,Staff,0,0,30,30
1650553992574,MATH 20E,B02,083774,Staff,10,0,30,20
1650553998598,MATH 103A,A01,083777,Staff,0,15,30,30
1650553998598,MATH 103A,A02,083778,Staff,0,14,30,30
1650553998598,MATH 103A,B01,083779,Staff,0,13,30,30
1650553998598,MATH 103A,B02,083780,Staff,0,13,30,30
1650554004622,MATH 105,A01,085443,Staff,0,21,30,30
1650554010652,MATH 109,A01,083213,Anzaldo; Leesa B,0,8,30,30
1650554010652,MATH 109,A02,083214,Anzaldo; Leesa B,0,7,30,30
1650554010652,MATH 109,B01,083215,Anzaldo; Leesa B,0,5,30,30
1650554010652,MATH 109,B02,083216,Anzaldo; Leesa B,0,6,30,30
1650554016681,MATH 142A,A01,083219,Chow; Bennett,0,16,30,30
1650554016681,MATH 142A,A02,083220,Chow; Bennett,0,14,30,30
1650554016681,MATH 142A,B01,083221,Chow; Bennett,0,13,30,30
1650554016681,MATH 142A,B02,083222,Chow; Bennett,0,13,30,30
1650554022707,MATH 193A,A01,083224,Staff,0,6,30,30
1650554022707,MATH 193A,A02,083225,Staff,0,5,30,30
1650554022707,MATH 193A,A03,083781,Staff,0,5,30,30
1650554022707,MATH 193A,A04,083782,Staff,0,7,30,30
1650554028740,MATH 197,001,091859,McAuley; Julian John,9998,0,9999,1
1650554034903,COGS 9,A01,083615,Staff,0,16,60,60
1650554040926,COGS 11,A01,083617,Boyle; Mary E. T.,19,0,40,21
1650554046957,COGS 13,A01,083071,Staff,0,35,40,40
1650554052983,COGS 14A,A01,092681,Staff,0,26,100,100
1650554059014,COGS 14B,A01,083073,Cheng; Tzu-Han,0,12,50,50
1650554065041,COGS 17,A01,092677,Staff,19,0,75,56
1650554071067,COGS 100,A01,083619,Staff,0,26,60,60
1650554077095,COGS 101A,A01,083621,Davis; Joshua Daniel,0,26,60,60
1650554083120,COGS 101B,A01,091572,Staff,1,5,60,59
1650554089145,COGS 101C,A01,083625,Delgado; Tania,15,0,30,15
1650554095168,COGS 107A,A01,083627,Boyle; Mary E. T.,0,11,60,60
1650554101196,COGS 118A,A01,083075,Staff,0,3,60,60
1650554107233,CSE 3,A50,083646,Miranda; Gregory Joseph,20,0,38,18
1650554107233,CSE 3,A51,083647,Miranda; Gregory Joseph,36,0,37,1
1650554113261,CSE 8A,A50,083650,Miranda; Gregory Joseph,0,29,40,40
1650554119287,CSE 11,A01,083080,Cao; Yingjun,0,94,40,40
1650554125310,CSE 12,A01,083652,Staff,0,17,100,100
1650554131339,CSE 15L,A01,083654,Staff,0,1,50,50
1650554131339,CSE 15L,A02,083655,Staff,0,0,50,50
1650554137367,CSE 20,A01,083657,Staff,51,0,80,29
1650554143397,CSE 30,A01,083084,Eldon; John,0,77,40,40
1650554149420,CSE 100,A01,083659,Cao; Yingjun,0,66,50,50
1650554155445,CSE 134B,A01,083661,Powell; Thomas Allan,0,34,65,65
1650554161473,CSE 140,A01,083663,Staff,0,5,75,75
1650554167499,CSE 140L,A01,083088,Eldon; John,0,11,75,75
1650554173523,CSE 175,A01,083665,Kumar; Rakesh,7,0,25,18
1650554179546,CSE 190,A00,092507,Dubnov; Shlomo,10,0,20,10
1650554185587,ECE 45,A01,083139,Staff,0,1,60,60
1650554191611,ECE 65,A50,083695,Staff,0,6,30,30
1650554197634,ECE 109,A01,091882,Touri; Behrouz,33,0,70,37
1650554203670,ECE 180,A00,083140,Abi Samra; Nicholas Camill,21,0,30,9
1650554203670,ECE 180,B00,083141,Abi Samra; Nicholas Camill,0,0,30,30
1650554209698,MATH 10A,A01,083735,Patchell; Gregory David,5,0,30,25
1650554209698,MATH 10A,A02,083736,Patchell; Gregory David,27,0,30,3
1650554209698,MATH 10A,A03,083737,Patchell; Gregory David,24,0,30,6
1650554215726,MATH 10B,A01,083207,Staff,0,9,30,30
1650554215726,MATH 10B,A02,083208,Staff,0,7,30,30
1650554215726,MATH 10B,B01,083739,Staff,12,0,30,18
1650554215726,MATH 10B,B02,083740,Staff,28,0,30,2
1650554221762,MATH 18,A01,083743,Staff,1,0,30,29
1650554221762,MATH 18,A02,083744,Staff,26,0,30,4
1650554221762,MATH 18,A03,083745,Staff,22,0,30,8
1650554221762,MATH 18,A04,083746,Staff,26,0,30,4
1650554221762,MATH 18,B01,083748,Staff,0,12,30,30
1650554221762,MATH 18,B02,083749,Staff,0,12,30,30
1650554221762,MATH 18,B03,083750,Staff,0,11,30,30
1650554221762,MATH 18,B04,083751,Staff,0,12,30,30
1650554227788,MATH 20A,A01,083754,Staff,22,0,40,18
1650554233815,MATH 20B,A01,083756,Staff,0,11,30,30
1650554233815,MATH 20B,A02,083757,Staff,0,12,30,30
1650554239839,MATH 20C,A01,083760,Staff,0,16,30,30
1650554239839,MATH 20C,A02,083761,Staff,2,14,30,28
1650554239839,MATH 20C,B01,083762,Staff,12,0,30,18
1650554239839,MATH 20C,B02,083763,Staff,28,0,30,2
1650554245865,MATH 20D,A01,083765,Staff,0,1,30,30
1650554245865,MATH 20D,A02,083766,Staff,7,0,30,23
1650554245865,MATH 20D,A03,083767,Staff,25,0,30,5
1650554251894,MATH 20E,A01,083771,Staff,6,0,30,24
1650554251894,MATH 20E,A02,083772,Staff,18,0,30,12
1650554251894,MATH 20E,B01,083773,Staff,0,0,30,30
1650554251894,MATH 20E,B02,083774,Staff,10,0,30,20
1650554257930,MATH 103A,A01,083777,Staff,0,15,30,30
1650554257930,MATH 103A,A02,083778,Staff,0,14,30,30
1650554257930,MATH 103A,B01,083779,Staff,0,13,30,30
1650554257930,MATH 103A,B02,083780,Staff,0,13,30,30
1650554263958,MATH 105,A01,085443,Staff,0,21,30,30
1650554269982,MATH 109,A01,083213,Anzaldo; Leesa B,0,8,30,30
1650554269982,MATH 109,A02,083214,Anzaldo; Leesa B,0,7,30,30
1650554269982,MATH 109,B01,083215,Anzaldo; Leesa B,0,5,30,30
1650554269982,MATH 109,B02,083216,Anzaldo; Leesa B,0,6,30,30
1650554276013,MATH 142A,A01,083219,Chow; Bennett,0,16,30,30
1650554276013,MATH 142A,A02,083220,Chow; Bennett,0,14,30,30
1650554276013,MATH 142A,B01,083221,Chow; Bennett,0,13,30,30
1650554276013,MATH 142A,B02,083222,Chow; Bennett,0,13,30,30
1650554282041,MATH 193A,A01,083224,Staff,0,6,30,30
1650554282041,MATH 193A,A02,083225,Staff,0,5,30,30
1650554282041,MATH 193A,A03,083781,Staff,0,5,30,30
1650554282041,MATH 193A,A04,083782,Staff,0,7,30,30
1650554288069,MATH 197,001,091859,McAuley; Julian John,9998,0,9999,1
1650554294124,COGS 9,A01,083615,Staff,0,16,60,60
1650554300150,COGS 11,A01,083617,Boyle; Mary E. T.,19,0,40,21
1650554306177,COGS 13,A01,083071,Staff,0,35,40,40
1650554312204,COGS 14A,A01,092681,Staff,0,26,100,100
1650554318227,COGS 14B,A01,083073,Cheng; Tzu-Han,0,12,50,50
1650554324264,COGS 17,A01,092677,Staff,19,0,75,56
1650554330288,COGS 100,A01,083619,Staff,0,26,60,60
1650554336311,COGS 101A,A01,083621,Davis; Joshua Daniel,0,26,60,60
1650554342336,COGS 101B,A01,091572,Staff,1,5,60,59
1650554348359,COGS 101C,A01,083625,Delgado; Tania,15,0,30,15
1650554354421,COGS 107A,A01,083627,Boyle; Mary E. T.,0,11,60,60
1650554360446,COGS 118A,A01,083075,Staff,0,3,60,60
1650554366470,CSE 3,A50,083646,Miranda; Gregory Joseph,20,0,38,18
1650554366470,CSE 3,A51,083647,Miranda; Gregory Joseph,36,0,37,1
1650554372498,CSE 8A,A50,083650,Miranda; Gregory Joseph,0,29,40,40
1650554378528,CSE 11,A01,083080,Cao; Yingjun,0,94,40,40
1650554384552,CSE 12,A01,083652,Staff,0,17,100,100
1650554390573,CSE 15L,A01,083654,Staff,0,1,50,50
1650554390573,CSE 15L,A02,083655,Staff,0,0,50,50
1650554396597,CSE 20,A01,083657,Staff,51,0,80,29
1650554402624,CSE 30,A01,083084,Eldon; John,0,77,40,40
1650554408647,CSE 100,A01,083659,Cao; Yingjun,0,66,50,50
1650554414674,CSE 134B,A01,083661,Powell; Thomas Allan,0,34,65,65
1650554420697,CSE 140,A01,083663,Staff,0,5,75,75
1650554426730,CSE 140L,A01,083088,Eldon; John,0,11,75,75
1650554432755,CSE 175,A01,083665,Kumar; Rakesh,7,0,25,18
1650554438778,CSE 190,A00,092507,Dubnov; Shlomo,10,0,20,10
1650554444801,ECE 45,A01,083139,Staff,0,1,60,60
1650554450831,ECE 65,A50,083695,Staff,0,6,30,30
1650554456856,ECE 109,A01,091882,Touri; Behrouz,33,0,70,37
1650554462879,ECE 180,A00,083140,Abi Samra; Nicholas Camill,21,0,30,9
1650554462879,ECE 180,B00,083141,Abi Samra; Nicholas Camill,0,0,30,30
1650554468903,MATH 10A,A01,083735,Patchell; Gregory David,5,0,30,25
1650554468903,MATH 10A,A02,083736,Patchell; Gregory David,27,0,30,3
1650554468903,MATH 10A,A03,083737,Patchell; Gregory David,24,0,30,6
1650554474927,MATH 10B,A01,083207,Staff,0,9,30,30
1650554474927,MATH 10B,A02,083208,Staff,0,7,30,30
1650554474927,MATH 10B,B01,083739,Staff,12,0,30,18
1650554474927,MATH 10B,B02,083740,Staff,28,0,30,2
1650554480956,MATH 18,A01,083743,Staff,1,0,30,29
1650554480956,MATH 18,A02,083744,Staff,26,0,30,4
1650554480956,MATH 18,A03,083745,Staff,22,0,30,8
1650554480956,MATH 18,A04,083746,Staff,26,0,30,4
1650554480956,MATH 18,B01,083748,Staff,0,12,30,30
1650554480956,MATH 18,B02,083749,Staff,0,12,30,30
1650554480956,MATH 18,B03,083750,Staff,0,11,30,30
1650554480956,MATH 18,B04,083751,Staff,0,12,30,30
1650554486988,MATH 20A,A01,083754,Staff,22,0,40,18
1650554493015,MATH 20B,A01,083756,Staff,0,11,30,30
1650554493015,MATH 20B,A02,083757,Staff,0,12,30,30
1650554499049,MATH 20C,A01,083760,Staff,0,16,30,30
1650554499049,MATH 20C,A02,083761,Staff,2,14,30,28
1650554499049,MATH 20C,B01,083762,Staff,12,0,30,18
1650554499049,MATH 20C,B02,083763,Staff,28,0,30,2
1650554505073,MATH 20D,A01,083765,Staff,0,1,30,30
1650554505073,MATH 20D,A02,083766,Staff,7,0,30,23
1650554505073,MATH 20D,A03,083767,Staff,25,0,30,5
1650554511098,MATH 20E,A01,083771,Staff,6,0,30,24
1650554511098,MATH 20E,A02,083772,Staff,18,0,30,12
1650554511098,MATH 20E,B01,083773,Staff,0,0,30,30
1650554511098,MATH 20E,B02,083774,Staff,10,0,30,20
1650554517122,MATH 103A,A01,083777,Staff,0,15,30,30
1650554517122,MATH 103A,A02,083778,Staff,0,14,30,30
1650554517122,MATH 103A,B01,083779,Staff,0,13,30,30
1650554517122,MATH 103A,B02,083780,Staff,0,13,30,30
1650554523146,MATH 105,A01,085443,Staff,0,21,30,30
1650554529169,MATH 109,A01,083213,Anzaldo; Leesa B,0,8,30,30
1650554529169,MATH 109,A02,083214,Anzaldo; Leesa B,0,7,30,30
1650554529169,MATH 109,B01,083215,Anzaldo; Leesa B,0,5,30,30
1650554529169,MATH 109,B02,083216,Anzaldo; Leesa B,0,6,30,30
1650554535196,MATH 142A,A01,083219,Chow; Bennett,0,16,30,30
1650554535196,MATH 142A,A02,083220,Chow; Bennett,0,14,30,30
1650554535196,MATH 142A,B01,083221,Chow; Bennett,0,13,30,30
1650554535196,MATH 142A,B02,083222,Chow; Bennett,0,13,30,30
1650554541222,MATH 193A,A01,083224,Staff,0,6,30,30
1650554541222,MATH 193A,A02,083225,Staff,0,5,30,30
1650554541222,MATH 193A,A03,083781,Staff,0,5,30,30
1650554541222,MATH 193A,A04,083782,Staff,0,7,30,30
1650554547247,MATH 197,001,091859,McAuley; Julian John,9998,0,9999,1
1650554553313,COGS 9,A01,083615,Staff,0,16,60,60
1650554559336,COGS 11,A01,083617,Boyle; Mary E. T.,19,0,40,21
1650554565360,COGS 13,A01,083071,Staff,0,35,40,40
1650554571387,COGS 14A,A01,092681,Staff,0,26,100,100
1650554577414,COGS 14B,A01,083073,Cheng; Tzu-Han,0,12,50,50
1650554583448,COGS 17,A01,092677,Staff,19,0,75,56
1650554589483,COGS 100,A01,083619,Staff,0,26,60,60
1650554595513,COGS 101A,A01,083621,Davis; Joshua Daniel,0,26,60,60
1650554601537,COGS 101B,A01,091572,Staff,1,5,60,59
1650554607565,COGS 101C,A01,083625,Delgado; Tania,15,0,30,15
1650554613590,COGS 107A,A01,083627,Boyle; Mary E. T.,0,11,60,60
1650554619620,COGS 118A,A01,083075,Staff,0,3,60,60
1650554625649,CSE 3,A50,083646,Miranda; Gregory Joseph,20,0,38,18
1650554625649,CSE 3,A51,083647,Miranda; Gregory Joseph,36,0,37,1
1650554631762,CSE 8A,A50,083650,Miranda; Gregory Joseph,0,29,40,40
1650554637786,CSE 11,A01,083080,Cao; Yingjun,0,94,40,40
1650554643812,CSE 12,A01,083652,Staff,0,17,100,100
1650554649836,CSE 15L,A01,083654,Staff,0,1,50,50
1650554649836,CSE 15L,A02,083655,Staff,0,0,50,50
1650554655862,CSE 20,A01,083657,Staff,51,0,80,29
1650554661886,CSE 30,A01,083084,Eldon; John,0,77,40,40
1650554667910,CSE 100,A01,083659,Cao; Yingjun,0,66,50,50
1650554673933,CSE 134B,A01,083661,Powell; Thomas Allan,0,34,65,65
1650554679970,CSE 140,A01,083663,Staff,0,5,75,75
1650554685994,CSE 140L,A01,083088,Eldon; John,0,11,75,75
1650554692022,CSE 175,A01,083665,Kumar; Rakesh,7,0,25,18
1650554698050,CSE 190,A00,092507,Dubnov; Shlomo,10,0,20,10
1650554704073,ECE 45,A01,083139,Staff,0,1,60,60
1650554710099,ECE 65,A50,083695,Staff,0,6,30,30
1650554716121,ECE 109,A01,091882,Touri; Behrouz,33,0,70,37
1650554722152,ECE 180,A00,083140,Abi Samra; Nicholas Camill,21,0,30,9
1650554722152,ECE 180,B00,083141,Abi Samra; Nicholas Camill,0,0,30,30
1650554728179,MATH 10A,A01,083735,Patchell; Gregory David,5,0,30,25
1650554728179,MATH 10A,A02,083736,Patchell; Gregory David,27,0,30,3
1650554728179,MATH 10A,A03,083737,Patchell; Gregory David,24,0,30,6
1650554734206,MATH 10B,A01,083207,Staff,0,9,30,30
1650554734206,MATH 10B,A02,083208,Staff,0,7,30,30
1650554734206,MATH 10B,B01,083739,Staff,12,0,30,18
1650554734206,MATH 10B,B02,083740,Staff,28,0,30,2
1650554740239,MATH 18,A01,083743,Staff,1,0,30,29
1650554740239,MATH 18,A02,083744,Staff,26,0,30,4
1650554740239,MATH 18,A03,083745,Staff,22,0,30,8
1650554740239,MATH 18,A04,083746,Staff,26,0,30,4
1650554740239,MATH 18,B01,083748,Staff,0,12,30,30
1650554740239,MATH 18,B02,083749,Staff,0,12,30,30
1650554740239,MATH 18,B03,083750,Staff,0,11,30,30
1650554740239,MATH 18,B04,083751,Staff,0,12,30,30
1650554746262,MATH 20A,A01,083754,Staff,22,0,40,18
1650554752289,MATH 20B,A01,083756,Staff,0,11,30,30
1650554752289,MATH 20B,A02,083757,Staff,0,12,30,30
1650554758312,MATH 20C,A01,083760,Staff,0,16,30,30
1650554758312,MATH 20C,A02,083761,Staff,2,14,30,28
1650554758312,MATH 20C,B01,083762,Staff,12,0,30,18
1650554758312,MATH 20C,B02,083763,Staff,28,0,30,2
1650554764336,MATH 20D,A01,083765,Staff,0,1,30,30
1650554764336,MATH 20D,A02,083766,Staff,7,0,30,23
1650554764336,MATH 20D,A03,083767,Staff,25,0,30,5
1650554770370,MATH 20E,A01,083771,Staff,6,0,30,24
1650554770370,MATH 20E,A02,083772,Staff,18,0,30,12
1650554770370,MATH 20E,B01,083773,Staff,0,0,30,30
1650554770370,MATH 20E,B02,083774,Staff,10,0,30,20
1650554776393,MATH 103A,A01,083777,Staff,0,15,30,30
1650554776393,MATH 103A,A02,083778,Staff,0,14,30,30
1650554776393,MATH 103A,B01,083779,Staff,0,13,30,30
1650554776393,MATH 103A,B02,083780,Staff,0,13,30,30
1650554782419,MATH 105,A01,085443,Staff,0,21,30,30
1650554788448,MATH 109,A01,083213,Anzaldo; Leesa B,0,8,30,30
1650554788448,MATH 109,A02,083214,Anzaldo; Leesa B,0,7,30,30
1650554788448,MATH 109,B01,083215,Anzaldo; Leesa B,0,5,30,30
1650554788448,MATH 109,B02,083216,Anzaldo; Leesa B,0,6,30,30
1650554794474,MATH 142A,A01,083219,Chow; Bennett,0,16,30,30
1650554794474,MATH 142A,A02,083220,Chow; Bennett,0,14,30,30
1650554794474,MATH 142A,B01,083221,Chow; Bennett,0,13,30,30
1650554794474,MATH 142A,B02,083222,Chow; Bennett,0,13,30,30
1650554800498,MATH 193A,A01,083224,Staff,0,6,30,30
1650554800498,MATH 193A,A02,083225,Staff,0,5,30,30
1650554800498,MATH 193A,A03,083781,Staff,0,5,30,30
1650554800498,MATH 193A,A04,083782,Staff,0,7,30,30
1650554806522,MATH 197,001,091859,McAuley; Julian John,9998,0,9999,1
1650554812585,COGS 9,A01,083615,Staff,0,16,60,60
1650554818613,COGS 11,A01,083617,Boyle; Mary E. T.,19,0,40,21
1650554824637,COGS 13,A01,083071,Staff,0,35,40,40
1650554830669,COGS 14A,A01,092681,Staff,0,26,100,100
1650554836693,COGS 14B,A01,083073,Cheng; Tzu-Han,0,12,50,50
1650554842724,COGS 17,A01,092677,Staff,19,0,75,56
1650554848748,COGS 100,A01,083619,Staff,0,26,60,60
1650554854771,COGS 101A,A01,083621,Davis; Joshua Daniel,0,26,60,60
1650554860795,COGS 101B,A01,091572,Staff,1,5,60,59
1650554866825,COGS 101C,A01,083625,Delgado; Tania,15,0,30,15
1650554872851,COGS 107A,A01,083627,Boyle; Mary E. T.,0,11,60,60
1650554878875,COGS 118A,A01,083075,Staff,0,3,60,60
1650554884900,CSE 3,A50,083646,Miranda; Gregory Joseph,20,0,38,18
1650554884900,CSE 3,A51,083647,Miranda; Gregory Joseph,36,0,37,1
1650554890924,CSE 8A,A50,083650,Miranda; Gregory Joseph,0,29,40,40
1650554896948,CSE 11,A01,083080,Cao; Yingjun,0,94,40,40
1650554902977,CSE 12,A01,083652,Staff,0,17,100,100
1650554909022,CSE 15L,A01,083654,Staff,0,1,50,50
1650554909022,CSE 15L,A02,083655,Staff,0,0,50,50
1650554915045,CSE 20,A01,083657,Staff,51,0,80,29
1650554921102,CSE 30,A01,083084,Eldon; John,0,77,40,40
1650554927130,CSE 100,A01,083659,Cao; Yingjun,0,66,50,50
1650554933160,CSE 134B,A01,083661,Powell; Thomas Allan,0,34,65,65
1650554939184,CSE 140,A01,083663,Staff,0,5,75,75
1650554945213,CSE 140L,A01,083088,Eldon; John,0,11,75,75
1650554951238,CSE 175,A01,083665,Kumar; Rakesh,7,0,25,18
1650554957264,CSE 190,A00,092507,Dubnov; Shlomo,10,0,20,10
1650554963297,ECE 45,A01,083139,Staff,0,1,60,60
1650554969321,ECE 65,A50,083695,Staff,0,6,30,30
1650554975354,ECE 109,A01,091882,Touri; Behrouz,33,0,70,37
1650554981380,ECE 180,A00,083140,Abi Samra; Nicholas Camill,21,0,30,9
1650554981380,ECE 180,B00,083141,Abi Samra; Nicholas Camill,0,0,30,30
1650554987404,MATH 10A,A01,083735,Patchell; Gregory David,5,0,30,25
1650554987404,MATH 10A,A02,083736,Patchell; Gregory David,27,0,30,3
1650554987404,MATH 10A,A03,083737,Patchell; Gregory David,24,0,30,6
1650554993432,MATH 10B,A01,083207,Staff,0,9,30,30
1650554993432,MATH 10B,A02,083208,Staff,0,7,30,30
1650554993432,MATH 10B,B01,083739,Staff,12,0,30,18
1650554993432,MATH 10B,B02,083740,Staff,28,0,30,2
1650554999458,MATH 18,A01,083743,Staff,1,0,30,29
1650554999458,MATH 18,A02,083744,Staff,26,0,30,4
1650554999458,MATH 18,A03,083745,Staff,22,0,30,8
1650554999458,MATH 18,A04,083746,Staff,26,0,30,4
1650554999458,MATH 18,B01,083748,Staff,0,12,30,30
1650554999458,MATH 18,B02,083749,Staff,0,12,30,30
1650554999458,MATH 18,B03,083750,Staff,0,11,30,30
1650554999458,MATH 18,B04,083751,Staff,0,12,30,30
1650555005490,MATH 20A,A01,083754,Staff,22,0,40,18
1650555011530,MATH 20B,A01,083756,Staff,0,11,30,30
1650555011530,MATH 20B,A02,083757,Staff,0,12,30,30
1650555017555,MATH 20C,A01,083760,Staff,0,16,30,30
1650555017555,MATH 20C,A02,083761,Staff,2,14,30,28
1650555017555,MATH 20C,B01,083762,Staff,12,0,30,18
1650555017555,MATH 20C,B02,083763,Staff,28,0,30,2
1650555023578,MATH 20D,A01,083765,Staff,0,1,30,30
1650555023578,MATH 20D,A02,083766,Staff,7,0,30,23
1650555023578,MATH 20D,A03,083767,Staff,25,0,30,5
1650555029608,MATH 20E,A01,083771,Staff,6,0,30,24
1650555029608,MATH 20E,A02,083772,Staff,18,0,30,12
1650555029608,MATH 20E,B01,083773,Staff,0,0,30,30
1650555029608,MATH 20E,B02,083774,Staff,10,0,30,20
1650555035637,MATH 103A,A01,083777,Staff,0,15,30,30
1650555035637,MATH 103A,A02,083778,Staff,0,14,30,30
1650555035637,MATH 103A,B01,083779,Staff,0,13,30,30
1650555035637,MATH 103A,B02,083780,Staff,0,13,30,30
1650555041668,MATH 105,A01,085443,Staff,0,21,30,30
1650555047696,MATH 109,A01,083213,Anzaldo; Leesa B,0,8,30,30
1650555047696,MATH 109,A02,083214,Anzaldo; Leesa B,0,7,30,30
1650555047696,MATH 109,B01,083215,Anzaldo; Leesa B,0,5,30,30
1650555047696,MATH 109,B02,083216,Anzaldo; Leesa B,0,6,30,30
1650555053724,MATH 142A,A01,083219,Chow; Bennett,0,16,30,30
1650555053724,MATH 142A,A02,083220,Chow; Bennett,0,14,30,30
1650555053724,MATH 142A,B01,083221,Chow; Bennett,0,13,30,30
1650555053724,MATH 142A,B02,083222,Chow; Bennett,0,13,30,30
1650555059749,MATH 193A,A01,083224,Staff,0,6,30,30
1650555059749,MATH 193A,A02,083225,Staff,0,5,30,30
1650555059749,MATH 193A,A03,083781,Staff,0,5,30,30
1650555059749,MATH 193A,A04,083782,Staff,0,7,30,30
1650555065776,MATH 197,001,091859,McAuley; Julian John,9998,0,9999,1
1650555071855,COGS 9,A01,083615,Staff,0,16,60,60
1650555077879,COGS 11,A01,083617,Boyle; Mary E. T.,19,0,40,21
1650555083906,COGS 13,A01,083071,Staff,0,35,40,40
1650555089930,COGS 14A,A01,092681,Staff,0,26,100,100
1650555095958,COGS 14B,A01,083073,Cheng; Tzu-Han,0,12,50,50
1650555102000,COGS 17,A01,092677,Staff,19,0,75,56
1650555108026,COGS 100,A01,083619,Staff,0,26,60,60
1650555114054,COGS 101A,A01,083621,Davis; Joshua Daniel,0,26,60,60
1650555120087,COGS 101B,A01,091572,Staff,1,5,60,59
1650555126121,COGS 101C,A01,083625,Delgado; Tania,15,0,30,15
1650555132149,COGS 107A,A01,083627,Boyle; Mary E. T.,0,11,60,60
1650555138174,COGS 118A,A01,083075,Staff,0,3,60,60
1650555144201,CSE 3,A50,083646,Miranda; Gregory Joseph,20,0,38,18
1650555144201,CSE 3,A51,083647,Miranda; Gregory Joseph,36,0,37,1
1650555150225,CSE 8A,A50,083650,Miranda; Gregory Joseph,0,29,40,40
1650555156253,CSE 11,A01,083080,Cao; Yingjun,0,94,40,40
1650555162280,CSE 12,A01,083652,Staff,0,17,100,100
1650555168304,CSE 15L,A01,083654,Staff,0,1,50,50
1650555168304,CSE 15L,A02,083655,Staff,0,0,50,50
1650555174345,CSE 20,A01,083657,Staff,51,0,80,29
1650555180377,CSE 30,A01,083084,Eldon; John,0,77,40,40
1650555186400,CSE 100,A01,083659,Cao; Yingjun,0,66,50,50
1650555192430,CSE 134B,A01,083661,Powell; Thomas Allan,0,34,65,65
1650555198453,CSE 140,A01,083663,Staff,0,5,75,75
1650555204478,CSE 140L,A01,083088,Eldon; John,0,11,75,75
1650555210502,CSE 175,A01,083665,Kumar; Rakesh,7,0,25,18
1650555216538,CSE 190,A00,092507,Dubnov; Shlomo,10,0,20,10
1650555222563,ECE 45,A01,083139,Staff,0,1,60,60
1650555228682,ECE 65,A50,083695,Staff,0,6,30,30
1650555234706,ECE 109,A01,091882,Touri; Behrouz,33,0,70,37
1650555240733,ECE 180,A00,083140,Abi Samra; Nicholas Camill,21,0,30,9
1650555240733,ECE 180,B00,083141,Abi Samra; Nicholas Camill,0,0,30,30
1650555246757,MATH 10A,A01,083735,Patchell; Gregory David,5,0,30,25
1650555246757,MATH 10A,A02,083736,Patchell; Gregory David,27,0,30,3
1650555246757,MATH 10A,A03,083737,Patchell; Gregory David,24,0,30,6
1650555252782,MATH 10B,A01,083207,Staff,0,9,30,30
1650555252782,MATH 10B,A02,083208,Staff,0,7,30,30
1650555252782,MATH 10B,B01,083739,Staff,12,0,30,18
1650555252782,MATH 10B,B02,083740,Staff,28,0,30,2
1650555258819,MATH 18,A01,083743,Staff,1,0,30,29
1650555258819,MATH 18,A02,083744,Staff,26,0,30,4
1650555258819,MATH 18,A03,083745,Staff,22,0,30,8
1650555258819,MATH 18,A04,083746,Staff,26,0,30,4
1650555258819,MATH 18,B01,083748,Staff,0,12,30,30
1650555258819,MATH 18,B02,083749,Staff,0,12,30,30
1650555258819,MATH 18,B03,083750,Staff,0,11,30,30
1650555258819,MATH 18,B04,083751,Staff,0,12,30,30
1650555264859,MATH 20A,A01,083754,Staff,22,0,40,18
1650555270897,MATH 20B,A01,083756,Staff,0,11,30,30
1650555270897,MATH 20B,A02,083757,Staff,0,12,30,30
1650555276926,MATH 20C,A01,083760,Staff,0,16,30,30
1650555276926,MATH 20C,A02,083761,Staff,2,14,30,28
1650555276926,MATH 20C,B01,083762,Staff,12,0,30,18
1650555276926,MATH 20C,B02,083763,Staff,28,0,30,2
1650555282959,MATH 20D,A01,083765,Staff,0,1,30,30
1650555282959,MATH 20D,A02,083766,Staff,7,0,30,23
1650555282959,MATH 20D,A03,083767,Staff,25,0,30,5
1650555288984,MATH 20E,A01,083771,Staff,6,0,30,24
1650555288984,MATH 20E,A02,083772,Staff,18,0,30,12
1650555288984,MATH 20E,B01,083773,Staff,0,0,30,30
1650555288984,MATH 20E,B02,083774,Staff,10,0,30,20
1650555295009,MATH 103A,A01,083777,Staff,0,15,30,30
1650555295009,MATH 103A,A02,083778,Staff,0,14,30,30
1650555295009,MATH 103A,B01,083779,Staff,0,13,30,30
1650555295009,MATH 103A,B02,083780,Staff,0,13,30,30
1650555301032,MATH 105,A01,085443,Staff,0,21,30,30
1650555307068,MATH 109,A01,083213,Anzaldo; Leesa B,0,8,30,30
1650555307068,MATH 109,A02,083214,Anzaldo; Leesa B,0,7,30,30
1650555307068,MATH 109,B01,083215,Anzaldo; Leesa B,0,5,30,30
1650555307068,MATH 109,B02,083216,Anzaldo; Leesa B,0,6,30,30
1650555313096,MATH 142A,A01,083219,Chow; Bennett,0,16,30,30
1650555313096,MATH 142A,A02,083220,Chow; Bennett,0,14,30,30
1650555313096,MATH 142A,B01,083221,Chow; Bennett,0,13,30,30
1650555313096,MATH 142A,B02,083222,Chow; Bennett,0,13,30,30
1650555319127,MATH 193A,A01,083224,Staff,1,6,30,29
1650555319127,MATH 193A,A02,083225,Staff,0,5,30,30
1650555319127,MATH 193A,A03,083781,Staff,0,5,30,30
1650555319127,MATH 193A,A04,083782,Staff,0,7,30,30
1650555325150,MATH 197,001,091859,McAuley; Julian John,9998,0,9999,1
1650555331210,COGS 9,A01,083615,Staff,0,16,60,60
1650555337246,COGS 11,A01,083617,Boyle; Mary E. T.,19,0,40,21
1650555343271,COGS 13,A01,083071,Staff,0,35,40,40
1650555349296,COGS 14A,A01,092681,Staff,0,26,100,100
1650555355323,COGS 14B,A01,083073,Cheng; Tzu-Han,0,12,50,50
1650555361349,COGS 17,A01,092677,Staff,19,0,75,56
1650555367382,COGS 100,A01,083619,Staff,0,26,60,60
1650555373417,COGS 101A,A01,083621,Davis; Joshua Daniel,0,26,60,60
1650555379442,COGS 101B,A01,091572,Staff,1,5,60,59
1650555385469,COGS 101C,A01,083625,Delgado; Tania,15,0,30,15
1650555391497,COGS 107A,A01,083627,Boyle; Mary E. T.,0,11,60,60
1650555397522,COGS 118A,A01,083075,Staff,0,3,60,60
1650555403559,CSE 3,A50,083646,Miranda; Gregory Joseph,20,0,38,18
1650555403559,CSE 3,A51,083647,Miranda; Gregory Joseph,36,0,37,1
1650555409586,CSE 8A,A50,083650,Miranda; Gregory Joseph,0,29,40,40
1650555415619,CSE 11,A01,083080,Cao; Yingjun,0,94,40,40
1650555421648,CSE 12,A01,083652,Staff,0,17,100,100
1650555427675,CSE 15L,A01,083654,Staff,0,1,50,50
1650555427675,CSE 15L,A02,083655,Staff,0,0,50,50
1650555433698,CSE 20,A01,083657,Staff,51,0,80,29
1650555439725,CSE 30,A01,083084,Eldon; John,0,77,40,40
1650555445757,CSE 100,A01,083659,Cao; Yingjun,0,66,50,50
1650555451787,CSE 134B,A01,083661,Powell; Thomas Allan,0,34,65,65
1650555457810,CSE 140,A01,083663,Staff,0,5,75,75
1650555463837,CSE 140L,A01,083088,Eldon; John,0,11,75,75
1650555469861,CSE 175,A01,083665,Kumar; Rakesh,7,0,25,18
1650555475893,CSE 190,A00,092507,Dubnov; Shlomo,10,0,20,10
1650555481917,ECE 45,A01,083139,Staff,0,1,60,60
1650555487942,ECE 65,A50,083695,Staff,0,6,30,30
1650555493968,ECE 109,A01,091882,Touri; Behrouz,33,0,70,37
1650555499992,ECE 180,A00,083140,Abi Samra; Nicholas Camill,21,0,30,9
1650555499992,ECE 180,B00,083141,Abi Samra; Nicholas Camill,0,0,30,30
1650555506020,MATH 10A,A01,083735,Patchell; Gregory David,5,0,30,25
1650555506020,MATH 10A,A02,083736,Patchell; Gregory David,27,0,30,3
1650555506020,MATH 10A,A03,083737,Patchell; Gregory David,24,0,30,6
1650555512051,MATH 10B,A01,083207,Staff,0,9,30,30
1650555512051,MATH 10B,A02,083208,Staff,0,7,30,30
1650555512051,MATH 10B,B01,083739,Staff,12,0,30,18
1650555512051,MATH 10B,B02,083740,Staff,28,0,30,2
1650555518077,MATH 18,A01,083743,Staff,1,0,30,29
1650555518077,MATH 18,A02,083744,Staff,26,0,30,4
1650555518077,MATH 18,A03,083745,Staff,22,0,30,8
1650555518077,MATH 18,A04,083746,Staff,26,0,30,4
1650555518077,MATH 18,B01,083748,Staff,0,12,30,30
1650555518077,MATH 18,B02,083749,Staff,0,12,30,30
1650555518077,MATH 18,B03,083750,Staff,0,11,30,30
1650555518077,MATH 18,B04,083751,Staff,0,12,30,30
1650555524106,MATH 20A,A01,083754,Staff,22,0,40,18
1650555530138,MATH 20B,A01,083756,Staff,0,11,30,30
1650555530138,MATH 20B,A02,083757,Staff,0,12,30,30
1650555536169,MATH 20C,A01,083760,Staff,0,16,30,30
1650555536169,MATH 20C,A02,083761,Staff,2,14,30,28
1650555536169,MATH 20C,B01,083762,Staff,12,0,30,18
1650555536169,MATH 20C,B02,083763,Staff,28,0,30,2
1650555542193,MATH 20D,A01,083765,Staff,0,1,30,30
1650555542193,MATH 20D,A02,083766,Staff,7,0,30,23
1650555542193,MATH 20D,A03,083767,Staff,25,0,30,5
1650555548221,MATH 20E,A01,083771,Staff,6,0,30,24
1650555548221,MATH 20E,A02,083772,Staff,18,0,30,12
1650555548221,MATH 20E,B01,083773,Staff,0,0,30,30
1650555548221,MATH 20E,B02,083774,Staff,10,0,30,20
1650555554258,MATH 103A,A01,083777,Staff,0,15,30,30
1650555554258,MATH 103A,A02,083778,Staff,0,14,30,30
1650555554258,MATH 103A,B01,083779,Staff,0,13,30,30
1650555554258,MATH 103A,B02,083780,Staff,0,13,30,30
1650555560288,MATH 105,A01,085443,Staff,0,21,30,30
1650555566316,MATH 109,A01,083213,Anzaldo; Leesa B,0,8,30,30
1650555566316,MATH 109,A02,083214,Anzaldo; Leesa B,0,7,30,30
1650555566316,MATH 109,B01,083215,Anzaldo; Leesa B,0,5,30,30
1650555566316,MATH 109,B02,083216,Anzaldo; Leesa B,0,6,30,30
1650555572355,MATH 142A,A01,083219,Chow; Bennett,0,16,30,30
1650555572355,MATH 142A,A02,083220,Chow; Bennett,0,14,30,30
1650555572355,MATH 142A,B01,083221,Chow; Bennett,0,13,30,30
1650555572355,MATH 142A,B02,083222,Chow; Bennett,0,13,30,30
1650555578382,MATH 193A,A01,083224,Staff,1,6,30,29
1650555578382,MATH 193A,A02,083225,Staff,0,5,30,30
1650555578382,MATH 193A,A03,083781,Staff,0,5,30,30
1650555578382,MATH 193A,A04,083782,Staff,0,7,30,30
1650555584406,MATH 197,001,091859,McAuley; Julian John,9998,0,9999,1
1650555590459,COGS 9,A01,083615,Staff,0,16,60,60
1650555596484,COGS 11,A01,083617,Boyle; Mary E. T.,19,0,40,21
1650555602512,COGS 13,A01,083071,Staff,0,35,40,40
1650555608538,COGS 14A,A01,092681,Staff,0,26,100,100
1650555614560,COGS 14B,A01,083073,Cheng; Tzu-Han,0,12,50,50
1650555620586,COGS 17,A01,092677,Staff,19,0,75,56
1650555626610,COGS 100,A01,083619,Staff,0,26,60,60
1650555632633,COGS 101A,A01,083621,Davis; Joshua Daniel,0,26,60,60
1650555638680,COGS 101B,A01,091572,Staff,1,5,60,59
1650555644706,COGS 101C,A01,083625,Delgado; Tania,15,0,30,15
1650555650748,COGS 107A,A01,083627,Boyle; Mary E. T.,0,11,60,60
1650555656783,COGS 118A,A01,083075,Staff,0,3,60,60
1650555662810,CSE 3,A50,083646,Miranda; Gregory Joseph,20,0,38,18
1650555662810,CSE 3,A51,083647,Miranda; Gregory Joseph,36,0,37,1
1650555668838,CSE 8A,A50,083650,Miranda; Gregory Joseph,0,29,40,40
1650555674866,CSE 11,A01,083080,Cao; Yingjun,0,94,40,40
1650555680895,CSE 12,A01,083652,Staff,0,17,100,100
1650555686920,CSE 15L,A01,083654,Staff,0,1,50,50
1650555686920,CSE 15L,A02,083655,Staff,0,0,50,50
1650555692949,CSE 20,A01,083657,Staff,51,0,80,29
1650555698976,CSE 30,A01,083084,Eldon; John,0,77,40,40
1650555705002,CSE 100,A01,083659,Cao; Yingjun,0,66,50,50
1650555711030,CSE 134B,A01,083661,Powell; Thomas Allan,0,34,65,65
1650555717054,CSE 140,A01,083663,Staff,0,5,75,75
1650555723081,CSE 140L,A01,083088,Eldon; John,0,11,75,75
1650555729109,CSE 175,A01,083665,Kumar; Rakesh,7,0,25,18
1650555735146,CSE 190,A00,092507,Dubnov; Shlomo,10,0,20,10
1650555741172,ECE 45,A01,083139,Staff,0,1,60,60
1650555747200,ECE 65,A50,083695,Staff,0,6,30,30
1650555753227,ECE 109,A01,091882,Touri; Behrouz,33,0,70,37
1650555759251,ECE 180,A00,083140,Abi Samra; Nicholas Camill,21,0,30,9
1650555759251,ECE 180,B00,083141,Abi Samra; Nicholas Camill,0,0,30,30
1650555765279,MATH 10A,A01,083735,Patchell; Gregory David,5,0,30,25
1650555765279,MATH 10A,A02,083736,Patchell; Gregory David,27,0,30,3
1650555765279,MATH 10A,A03,083737,Patchell; Gregory David,24,0,30,6
1650555771303,MATH 10B,A01,083207,Staff,0,9,30,30
1650555771303,MATH 10B,A02,083208,Staff,0,7,30,30
1650555771303,MATH 10B,B01,083739,Staff,12,0,30,18
1650555771303,MATH 10B,B02,083740,Staff,28,0,30,2
1650555777328,MATH 18,A01,083743,Staff,1,0,30,29
1650555777328,MATH 18,A02,083744,Staff,26,0,30,4
1650555777328,MATH 18,A03,083745,Staff,22,0,30,8
1650555777328,MATH 18,A04,083746,Staff,26,0,30,4
1650555777328,MATH 18,B01,083748,Staff,0,12,30,30
1650555777328,MATH 18,B02,083749,Staff,0,12,30,30
1650555777328,MATH 18,B03,083750,Staff,0,11,30,30
1650555777328,MATH 18,B04,083751,Staff,0,12,30,30
1650555783355,MATH 20A,A01,083754,Staff,22,0,40,18
1650555789381,MATH 20B,A01,083756,Staff,0,11,30,30
1650555789381,MATH 20B,A02,083757,Staff,0,12,30,30
1650555795408,MATH 20C,A01,083760,Staff,0,16,30,30
1650555795408,MATH 20C,A02,083761,Staff,2,14,30,28
1650555795408,MATH 20C,B01,083762,Staff,12,0,30,18
1650555795408,MATH 20C,B02,083763,Staff,28,0,30,2
1650555801436,MATH 20D,A01,083765,Staff,0,1,30,30
1650555801436,MATH 20D,A02,083766,Staff,7,0,30,23
1650555801436,MATH 20D,A03,083767,Staff,25,0,30,5
1650555807463,MATH 20E,A01,083771,Staff,6,0,30,24
1650555807463,MATH 20E,A02,083772,Staff,18,0,30,12
1650555807463,MATH 20E,B01,083773,Staff,0,0,30,30
1650555807463,MATH 20E,B02,083774,Staff,10,0,30,20
1650555813499,MATH 103A,A01,083777,Staff,0,15,30,30
1650555813499,MATH 103A,A02,083778,Staff,0,14,30,30
1650555813499,MATH 103A,B01,083779,Staff,0,13,30,30
1650555813499,MATH 103A,B02,083780,Staff,0,13,30,30
1650555819521,MATH 105,A01,085443,Staff,0,21,30,30
1650555825649,MATH 109,A01,083213,Anzaldo; Leesa B,0,8,30,30
1650555825649,MATH 109,A02,083214,Anzaldo; Leesa B,0,7,30,30
1650555825649,MATH 109,B01,083215,Anzaldo; Leesa B,0,5,30,30
1650555825649,MATH 109,B02,083216,Anzaldo; Leesa B,0,6,30,30
1650555831675,MATH 142A,A01,083219,Chow; Bennett,0,16,30,30
1650555831675,MATH 142A,A02,083220,Chow; Bennett,0,14,30,30
1650555831675,MATH 142A,B01,083221,Chow; Bennett,0,13,30,30
1650555831675,MATH 142A,B02,083222,Chow; Bennett,0,13,30,30
1650555837705,MATH 193A,A01,083224,Staff,1,6,30,29
1650555837705,MATH 193A,A02,083225,Staff,0,5,30,30
1650555837705,MATH 193A,A03,083781,Staff,0,5,30,30
1650555837705,MATH 193A,A04,083782,Staff,0,7,30,30
1650555843743,MATH 197,001,091859,McAuley; Julian John,9998,0,9999,1
1650555849794,COGS 9,A01,083615,Staff,0,16,60,60
1650555855818,COGS 11,A01,083617,Boyle; Mary E. T.,19,0,40,21
1650555861852,COGS 13,A01,083071,Staff,0,35,40,40
1650555867876,COGS 14A,A01,092681,Staff,0,26,100,100
1650555873903,COGS 14B,A01,083073,Cheng; Tzu-Han,0,12,50,50
1650555879928,COGS 17,A01,092677,Staff,19,0,75,56
1650555885952,COGS 100,A01,083619,Staff,0,26,60,60
1650555891975,COGS 101A,A01,083621,Davis; Joshua Daniel,0,26,60,60
1650555898000,COGS 101B,A01,091572,Staff,1,5,60,59
1650555904030,COGS 101C,A01,083625,Delgado; Tania,15,0,30,15
1650555910064,COGS 107A,A01,083627,Boyle; Mary E. T.,0,11,60,60
1650555916097,COGS 118A,A01,083075,Staff,0,3,60,60
1650555922121,CSE 3,A50,083646,Miranda; Gregory Joseph,20,0,38,18
1650555922121,CSE 3,A51,083647,Miranda; Gregory Joseph,36,0,37,1
1650555928145,CSE 8A,A50,083650,Miranda; Gregory Joseph,0,29,40,40
1650555934173,CSE 11,A01,083080,Cao; Yingjun,0,94,40,40
1650555940205,CSE 12,A01,083652,Staff,0,17,100,100
1650555946240,CSE 15L,A01,083654,Staff,0,1,50,50
1650555946240,CSE 15L,A02,083655,Staff,0,0,50,50
1650555952273,CSE 20,A01,083657,Staff,51,0,80,29
1650555958299,CSE 30,A01,083084,Eldon; John,0,77,40,40
1650555964325,CSE 100,A01,083659,Cao; Yingjun,0,66,50,50
1650555970352,CSE 134B,A01,083661,Powell; Thomas Allan,0,34,65,65
1650555976377,CSE 140,A01,083663,Staff,0,5,75,75
1650555982401,CSE 140L,A01,083088,Eldon; John,0,11,75,75
1650555988428,CSE 175,A01,083665,Kumar; Rakesh,7,0,25,18
1650555994454,CSE 190,A00,092507,Dubnov; Shlomo,10,0,20,10
1650556000483,ECE 45,A01,083139,Staff,0,1,60,60
1650556006506,ECE 65,A50,083695,Staff,0,6,30,30
1650556012539,ECE 109,A01,091882,Touri; Behrouz,33,0,70,37
1650556018567,ECE 180,A00,083140,Abi Samra; Nicholas Camill,21,0,30,9
1650556018567,ECE 180,B00,083141,Abi Samra; Nicholas Camill,0,0,30,30
1650556024591,MATH 10A,A01,083735,Patchell; Gregory David,5,0,30,25
1650556024591,MATH 10A,A02,083736,Patchell; Gregory David,27,0,30,3
1650556024591,MATH 10A,A03,083737,Patchell; Gregory David,24,0,30,6
1650556030619,MATH 10B,A01,083207,Staff,0,9,30,30
1650556030619,MATH 10B,A02,083208,Staff,0,7,30,30
1650556030619,MATH 10B,B01,083739,Staff,12,0,30,18
1650556030619,MATH 10B,B02,083740,Staff,28,0,30,2
1650556036652,MATH 18,A01,083743,Staff,1,0,30,29
1650556036652,MATH 18,A02,083744,Staff,26,0,30,4
1650556036652,MATH 18,A03,083745,Staff,22,0,30,8
1650556036652,MATH 18,A04,083746,Staff,26,0,30,4
1650556036652,MATH 18,B01,083748,Staff,0,12,30,30
1650556036652,MATH 18,B02,083749,Staff,0,12,30,30
1650556036652,MATH 18,B03,083750,Staff,0,11,30,30
1650556036652,MATH 18,B04,083751,Staff,0,12,30,30
1650556042677,MATH 20A,A01,083754,Staff,22,0,40,18
1650556048705,MATH 20B,A01,083756,Staff,0,11,30,30
1650556048705,MATH 20B,A02,083757,Staff,0,12,30,30
1650556054734,MATH 20C,A01,083760,Staff,0,16,30,30
1650556054734,MATH 20C,A02,083761,Staff,2,14,30,28
1650556054734,MATH 20C,B01,083762,Staff,12,0,30,18
1650556054734,MATH 20C,B02,083763,Staff,28,0,30,2
1650556060768,MATH 20D,A01,083765,Staff,0,1,30,30
1650556060768,MATH 20D,A02,083766,Staff,7,0,30,23
1650556060768,MATH 20D,A03,083767,Staff,25,0,30,5
1650556066792,MATH 20E,A01,083771,Staff,6,0,30,24
1650556066792,MATH 20E,A02,083772,Staff,18,0,30,12
1650556066792,MATH 20E,B01,083773,Staff,0,0,30,30
1650556066792,MATH 20E,B02,083774,Staff,10,0,30,20
1650556072816,MATH 103A,A01,083777,Staff,0,15,30,30
1650556072816,MATH 103A,A02,083778,Staff,0,14,30,30
1650556072816,MATH 103A,B01,083779,Staff,0,13,30,30
1650556072816,MATH 103A,B02,083780,Staff,0,13,30,30
1650556078840,MATH 105,A01,085443,Staff,0,21,30,30
1650556084866,MATH 109,A01,083213,Anzaldo; Leesa B,0,8,30,30
1650556084866,MATH 109,A02,083214,Anzaldo; Leesa B,0,7,30,30
1650556084866,MATH 109,B01,083215,Anzaldo; Leesa B,0,5,30,30
1650556084866,MATH 109,B02,083216,Anzaldo; Leesa B,0,6,30,30
1650556090895,MATH 142A,A01,083219,Chow; Bennett,0,16,30,30
1650556090895,MATH 142A,A02,083220,Chow; Bennett,0,14,30,30
1650556090895,MATH 142A,B01,083221,Chow; Bennett,0,13,30,30
1650556090895,MATH 142A,B02,083222,Chow; Bennett,0,13,30,30
1650556096920,MATH 193A,A01,083224,Staff,1,6,30,29
1650556096920,MATH 193A,A02,083225,Staff,0,5,30,30
1650556096920,MATH 193A,A03,083781,Staff,0,5,30,30
1650556096920,MATH 193A,A04,083782,Staff,0,7,30,30
1650556102949,MATH 197,001,091859,McAuley; Julian John,9998,0,9999,1
1650556109008,COGS 9,A01,083615,Staff,0,16,60,60
1650556115035,COGS 11,A01,083617,Boyle; Mary E. T.,19,0,40,21
1650556121059,COGS 13,A01,083071,Staff,0,35,40,40
1650556127083,COGS 14A,A01,092681,Staff,0,26,100,100
1650556133114,COGS 14B,A01,083073,Cheng; Tzu-Han,0,12,50,50
1650556139139,COGS 17,A01,092677,Staff,19,0,75,56
1650556145167,COGS 100,A01,083619,Staff,0,26,60,60
1650556151209,COGS 101A,A01,083621,Davis; Joshua Daniel,0,26,60,60
1650556157244,COGS 101B,A01,091572,Staff,1,5,60,59
1650556163280,COGS 101C,A01,083625,Delgado; Tania,15,0,30,15
1650556169311,COGS 107A,A01,083627,Boyle; Mary E. T.,0,11,60,60
1650556175360,COGS 118A,A01,083075,Staff,0,3,60,60
1650556181388,CSE 3,A50,083646,Miranda; Gregory Joseph,20,0,38,18
1650556181388,CSE 3,A51,083647,Miranda; Gregory Joseph,36,0,37,1
1650556187418,CSE 8A,A50,083650,Miranda; Gregory Joseph,0,29,40,40
1650556193453,CSE 11,A01,083080,Cao; Yingjun,0,94,40,40
1650556199476,CSE 12,A01,083652,Staff,0,17,100,100
1650556205500,CSE 15L,A01,083654,Staff,0,1,50,50
1650556205500,CSE 15L,A02,083655,Staff,0,0,50,50
1650556211528,CSE 20,A01,083657,Staff,51,0,80,29
1650556217555,CSE 30,A01,083084,Eldon; John,0,77,40,40
1650556223600,CSE 100,A01,083659,Cao; Yingjun,0,66,50,50
1650556229624,CSE 134B,A01,083661,Powell; Thomas Allan,0,34,65,65
1650556235656,CSE 140,A01,083663,Staff,0,5,75,75
1650556241680,CSE 140L,A01,083088,Eldon; John,0,11,75,75
1650556247714,CSE 175,A01,083665,Kumar; Rakesh,7,0,25,18
1650556253742,CSE 190,A00,092507,Dubnov; Shlomo,10,0,20,10
1650556259764,ECE 45,A01,083139,Staff,0,1,60,60
1650556265792,ECE 65,A50,083695,Staff,0,6,30,30
1650556271815,ECE 109,A01,091882,Touri; Behrouz,33,0,70,37
1650556277842,ECE 180,A00,083140,Abi Samra; Nicholas Camill,21,0,30,9
1650556277842,ECE 180,B00,083141,Abi Samra; Nicholas Camill,0,0,30,30
1650556283867,MATH 10A,A01,083735,Patchell; Gregory David,5,0,30,25
1650556283867,MATH 10A,A02,083736,Patchell; Gregory David,27,0,30,3
1650556283867,MATH 10A,A03,083737,Patchell; Gregory David,24,0,30,6
1650556289891,MATH 10B,A01,083207,Staff,0,9,30,30
1650556289891,MATH 10B,A02,083208,Staff,0,7,30,30
1650556289891,MATH 10B,B01,083739,Staff,12,0,30,18
1650556289891,MATH 10B,B02,083740,Staff,28,0,30,2
1650556295921,MATH 18,A01,083743,Staff,1,0,30,29
1650556295921,MATH 18,A02,083744,Staff,26,0,30,4
1650556295921,MATH 18,A03,083745,Staff,22,0,30,8
1650556295921,MATH 18,A04,083746,Staff,26,0,30,4
1650556295921,MATH 18,B01,083748,Staff,0,12,30,30
1650556295921,MATH 18,B02,083749,Staff,0,12,30,30
1650556295921,MATH 18,B03,083750,Staff,0,11,30,30
1650556295921,MATH 18,B04,083751,Staff,0,12,30,30
1650556301948,MATH 20A,A01,083754,Staff,22,0,40,18
1650556307976,MATH 20B,A01,083756,Staff,0,11,30,30
1650556307976,MATH 20B,A02,083757,Staff,0,12,30,30
1650556313999,MATH 20C,A01,083760,Staff,0,16,30,30
1650556313999,MATH 20C,A02,083761,Staff,2,14,30,28
1650556313999,MATH 20C,B01,083762,Staff,12,0,30,18
1650556313999,MATH 20C,B02,083763,Staff,28,0,30,2
1650556320025,MATH 20D,A01,083765,Staff,0,1,30,30
1650556320025,MATH 20D,A02,083766,Staff,7,0,30,23
1650556320025,MATH 20D,A03,083767,Staff,25,0,30,5
1650556326052,MATH 20E,A01,083771,Staff,6,0,30,24
1650556326052,MATH 20E,A02,083772,Staff,18,0,30,12
1650556326052,MATH 20E,B01,083773,Staff,0,0,30,30
1650556326052,MATH 20E,B02,083774,Staff,10,0,30,20
1650556332082,MATH 103A,A01,083777,Staff,0,15,30,30
1650556332082,MATH 103A,A02,083778,Staff,0,14,30,30
1650556332082,MATH 103A,B01,083779,Staff,0,13,30,30
1650556332082,MATH 103A,B02,083780,Staff,0,13,30,30
1650556338106,MATH 105,A01,085443,Staff,0,21,30,30
1650556344128,MATH 109,A01,083213,Anzaldo; Leesa B,0,8,30,30
1650556344128,MATH 109,A02,083214,Anzaldo; Leesa B,0,7,30,30
1650556344128,MATH 109,B01,083215,Anzaldo; Leesa B,0,5,30,30
1650556344128,MATH 109,B02,083216,Anzaldo; Leesa B,0,6,30,30
1650556350152,MATH 142A,A01,083219,Chow; Bennett,0,16,30,30
1650556350152,MATH 142A,A02,083220,Chow; Bennett,0,14,30,30
1650556350152,MATH 142A,B01,083221,Chow; Bennett,0,13,30,30
1650556350152,MATH 142A,B02,083222,Chow; Bennett,0,13,30,30
1650556356180,MATH 193A,A01,083224,Staff,1,6,30,29
1650556356180,MATH 193A,A02,083225,Staff,0,5,30,30
1650556356180,MATH 193A,A03,083781,Staff,0,5,30,30
1650556356180,MATH 193A,A04,083782,Staff,0,7,30,30
1650556362202,MATH 197,001,091859,McAuley; Julian John,9998,0,9999,1
1650556368262,COGS 9,A01,083615,Staff,0,16,60,60
1650556374286,COGS 11,A01,083617,Boyle; Mary E. T.,19,0,40,21
1650556380318,COGS 13,A01,083071,Staff,0,35,40,40
1650556386341,COGS 14A,A01,092681,Staff,0,26,100,100
1650556392364,COGS 14B,A01,083073,Cheng; Tzu-Han,0,12,50,50
1650556398388,COGS 17,A01,092677,Staff,19,0,75,56
1650556404423,COGS 100,A01,083619,Staff,0,26,60,60
1650556410447,COGS 101A,A01,083621,Davis; Joshua Daniel,0,26,60,60
1650556416570,COGS 101B,A01,091572,Staff,1,5,60,59
1650556422600,COGS 101C,A01,083625,Delgado; Tania,15,0,30,15
1650556428628,COGS 107A,A01,083627,Boyle; Mary E. T.,0,11,60,60
1650556434658,COGS 118A,A01,083075,Staff,0,3,60,60
1650556440691,CSE 3,A50,083646,Miranda; Gregory Joseph,20,0,38,18
1650556440691,CSE 3,A51,083647,Miranda; Gregory Joseph,36,0,37,1
1650556446717,CSE 8A,A50,083650,Miranda; Gregory Joseph,0,29,40,40
1650556452742,CSE 11,A01,083080,Cao; Yingjun,0,94,40,40
1650556458773,CSE 12,A01,083652,Staff,0,17,100,100
1650556464798,CSE 15L,A01,083654,Staff,0,1,50,50
1650556464798,CSE 15L,A02,083655,Staff,0,0,50,50
1650556470825,CSE 20,A01,083657,Staff,51,0,80,29
1650556476848,CSE 30,A01,083084,Eldon; John,0,77,40,40
1650556482872,CSE 100,A01,083659,Cao; Yingjun,0,66,50,50
1650556488905,CSE 134B,A01,083661,Powell; Thomas Allan,0,34,65,65
1650556494930,CSE 140,A01,083663,Staff,0,5,75,75
1650556500956,CSE 140L,A01,083088,Eldon; John,0,11,75,75
1650556506981,CSE 175,A01,083665,Kumar; Rakesh,7,0,25,18
1650556513004,CSE 190,A00,092507,Dubnov; Shlomo,10,0,20,10
1650556519030,ECE 45,A01,083139,Staff,0,1,60,60
1650556525058,ECE 65,A50,083695,Staff,0,6,30,30
1650556531086,ECE 109,A01,091882,Touri; Behrouz,33,0,70,37
1650556537119,ECE 180,A00,083140,Abi Samra; Nicholas Camill,21,0,30,9
1650556537119,ECE 180,B00,083141,Abi Samra; Nicholas Camill,0,0,30,30
1650556543146,MATH 10A,A01,083735,Patchell; Gregory David,5,0,30,25
1650556543146,MATH 10A,A02,083736,Patchell; Gregory David,27,0,30,3
1650556543146,MATH 10A,A03,083737,Patchell; Gregory David,24,0,30,6
1650556549172,MATH 10B,A01,083207,Staff,0,9,30,30
1650556549172,MATH 10B,A02,083208,Staff,0,7,30,30
1650556549172,MATH 10B,B01,083739,Staff,12,0,30,18
1650556549172,MATH 10B,B02,083740,Staff,28,0,30,2
1650556555197,MATH 18,A01,083743,Staff,1,0,30,29
1650556555197,MATH 18,A02,083744,Staff,26,0,30,4
1650556555197,MATH 18,A03,083745,Staff,22,0,30,8
1650556555197,MATH 18,A04,083746,Staff,26,0,30,4
1650556555197,MATH 18,B01,083748,Staff,0,12,30,30
1650556555197,MATH 18,B02,083749,Staff,0,12,30,30
1650556555197,MATH 18,B03,083750,Staff,0,11,30,30
1650556555197,MATH 18,B04,083751,Staff,0,12,30,30
1650556561223,MATH 20A,A01,083754,Staff,22,0,40,18
1650556567250,MATH 20B,A01,083756,Staff,0,11,30,30
1650556567250,MATH 20B,A02,083757,Staff,0,12,30,30
1650556573274,MATH 20C,A01,083760,Staff,0,16,30,30
1650556573274,MATH 20C,A02,083761,Staff,2,14,30,28
1650556573274,MATH 20C,B01,083762,Staff,12,0,30,18
1650556573274,MATH 20C,B02,083763,Staff,28,0,30,2
1650556579298,MATH 20D,A01,083765,Staff,0,1,30,30
1650556579298,MATH 20D,A02,083766,Staff,7,0,30,23
1650556579298,MATH 20D,A03,083767,Staff,25,0,30,5
1650556585321,MATH 20E,A01,083771,Staff,6,0,30,24
1650556585321,MATH 20E,A02,083772,Staff,18,0,30,12
1650556585321,MATH 20E,B01,083773,Staff,0,0,30,30
1650556585321,MATH 20E,B02,083774,Staff,10,0,30,20
1650556591351,MATH 103A,A01,083777,Staff,0,15,30,30
1650556591351,MATH 103A,A02,083778,Staff,0,14,30,30
1650556591351,MATH 103A,B01,083779,Staff,0,13,30,30
1650556591351,MATH 103A,B02,083780,Staff,0,13,30,30
1650556597376,MATH 105,A01,085443,Staff,0,21,30,30
1650556603402,MATH 109,A01,083213,Anzaldo; Leesa B,0,8,30,30
1650556603402,MATH 109,A02,083214,Anzaldo; Leesa B,0,7,30,30
1650556603402,MATH 109,B01,083215,Anzaldo; Leesa B,0,5,30,30
1650556603402,MATH 109,B02,083216,Anzaldo; Leesa B,0,6,30,30
1650556609431,MATH 142A,A01,083219,Chow; Bennett,0,16,30,30
1650556609431,MATH 142A,A02,083220,Chow; Bennett,0,14,30,30
1650556609431,MATH 142A,B01,083221,Chow; Bennett,0,13,30,30
1650556609431,MATH 142A,B02,083222,Chow; Bennett,0,13,30,30
1650556615456,MATH 193A,A01,083224,Staff,1,6,30,29
1650556615456,MATH 193A,A02,083225,Staff,0,5,30,30
1650556615456,MATH 193A,A03,083781,Staff,0,5,30,30
1650556615456,MATH 193A,A04,083782,Staff,0,7,30,30
1650556621479,MATH 197,001,091859,McAuley; Julian John,9998,0,9999,1
1650556627543,COGS 9,A01,083615,Staff,0,16,60,60
1650556633570,COGS 11,A01,083617,Boyle; Mary E. T.,19,0,40,21
1650556639594,COGS 13,A01,083071,Staff,0,35,40,40
1650556645620,COGS 14A,A01,092681,Staff,0,26,100,100
1650556651646,COGS 14B,A01,083073,Cheng; Tzu-Han,0,12,50,50
1650556657670,COGS 17,A01,092677,Staff,19,0,75,56
1650556663697,COGS 100,A01,083619,Staff,0,26,60,60
1650556669726,COGS 101A,A01,083621,Davis; Joshua Daniel,0,26,60,60
1650556675753,COGS 101B,A01,091572,Staff,1,5,60,59
1650556681784,COGS 101C,A01,083625,Delgado; Tania,15,0,30,15
1650556687809,COGS 107A,A01,083627,Boyle; Mary E. T.,0,11,60,60
1650556693840,COGS 118A,A01,083075,Staff,0,3,60,60
1650556699869,CSE 3,A50,083646,Miranda; Gregory Joseph,20,0,38,18
1650556699869,CSE 3,A51,083647,Miranda; Gregory Joseph,36,0,37,1
1650556705893,CSE 8A,A50,083650,Miranda; Gregory Joseph,0,29,40,40
1650556711919,CSE 11,A01,083080,Cao; Yingjun,0,94,40,40
1650556717945,CSE 12,A01,083652,Staff,0,17,100,100
1650556723969,CSE 15L,A01,083654,Staff,0,1,50,50
1650556723969,CSE 15L,A02,083655,Staff,0,0,50,50
1650556729994,CSE 20,A01,083657,Staff,51,0,80,29
1650556736021,CSE 30,A01,083084,Eldon; John,0,77,40,40
1650556742047,CSE 100,A01,083659,Cao; Yingjun,0,66,50,50
1650556748076,CSE 134B,A01,083661,Powell; Thomas Allan,0,34,65,65
1650556754101,CSE 140,A01,083663,Staff,0,5,75,75
1650556760138,CSE 140L,A01,083088,Eldon; John,0,11,75,75
1650556766175,CSE 175,A01,083665,Kumar; Rakesh,7,0,25,18
1650556772207,CSE 190,A00,092507,Dubnov; Shlomo,10,0,20,10
1650556778234,ECE 45,A01,083139,Staff,0,1,60,60
1650556784265,ECE 65,A50,083695,Staff,0,6,30,30
1650556790290,ECE 109,A01,091882,Touri; Behrouz,33,0,70,37
1650556796314,ECE 180,A00,083140,Abi Samra; Nicholas Camill,21,0,30,9
1650556796314,ECE 180,B00,083141,Abi Samra; Nicholas Camill,0,0,30,30
1650556802348,MATH 10A,A01,083735,Patchell; Gregory David,5,0,30,25
1650556802348,MATH 10A,A02,083736,Patchell; Gregory David,27,0,30,3
1650556802348,MATH 10A,A03,083737,Patchell; Gregory David,24,0,30,6
1650556808377,MATH 10B,A01,083207,Staff,0,9,30,30
1650556808377,MATH 10B,A02,083208,Staff,0,7,30,30
1650556808377,MATH 10B,B01,083739,Staff,12,0,30,18
1650556808377,MATH 10B,B02,083740,Staff,28,0,30,2
1650556814406,MATH 18,A01,083743,Staff,1,0,30,29
1650556814406,MATH 18,A02,083744,Staff,26,0,30,4
1650556814406,MATH 18,A03,083745,Staff,22,0,30,8
1650556814406,MATH 18,A04,083746,Staff,26,0,30,4
1650556814406,MATH 18,B01,083748,Staff,0,12,30,30
1650556814406,MATH 18,B02,083749,Staff,0,12,30,30
1650556814406,MATH 18,B03,083750,Staff,0,11,30,30
1650556814406,MATH 18,B04,083751,Staff,0,12,30,30
1650556820432,MATH 20A,A01,083754,Staff,22,0,40,18
1650556826455,MATH 20B,A01,083756,Staff,0,11,30,30
1650556826455,MATH 20B,A02,083757,Staff,0,12,30,30
1650556832478,MATH 20C,A01,083760,Staff,0,16,30,30
1650556832478,MATH 20C,A02,083761,Staff,2,14,30,28
1650556832478,MATH 20C,B01,083762,Staff,12,0,30,18
1650556832478,MATH 20C,B02,083763,Staff,28,0,30,2
1650556838503,MATH 20D,A01,083765,Staff,0,1,30,30
1650556838503,MATH 20D,A02,083766,Staff,7,0,30,23
1650556838503,MATH 20D,A03,083767,Staff,25,0,30,5
1650556844531,MATH 20E,A01,083771,Staff,6,0,30,24
1650556844531,MATH 20E,A02,083772,Staff,18,0,30,12
1650556844531,MATH 20E,B01,083773,Staff,0,0,30,30
1650556844531,MATH 20E,B02,083774,Staff,10,0,30,20
1650556850558,MATH 103A,A01,083777,Staff,0,15,30,30
1650556850558,MATH 103A,A02,083778,Staff,0,14,30,30
1650556850558,MATH 103A,B01,083779,Staff,0,13,30,30
1650556850558,MATH 103A,B02,083780,Staff,0,13,30,30
1650556856580,MATH 105,A01,085443,Staff,0,21,30,30
1650556862605,MATH 109,A01,083213,Anzaldo; Leesa B,0,8,30,30
1650556862605,MATH 109,A02,083214,Anzaldo; Leesa B,0,7,30,30
1650556862605,MATH 109,B01,083215,Anzaldo; Leesa B,0,5,30,30
1650556862605,MATH 109,B02,083216,Anzaldo; Leesa B,0,6,30,30
1650556868629,MATH 142A,A01,083219,Chow; Bennett,0,16,30,30
1650556868629,MATH 142A,A02,083220,Chow; Bennett,0,14,30,30
1650556868629,MATH 142A,B01,083221,Chow; Bennett,0,13,30,30
1650556868629,MATH 142A,B02,083222,Chow; Bennett,0,13,30,30
1650556874654,MATH 193A,A01,083224,Staff,1,6,30,29
1650556874654,MATH 193A,A02,083225,Staff,0,5,30,30
1650556874654,MATH 193A,A03,083781,Staff,0,5,30,30
1650556874654,MATH 193A,A04,083782,Staff,0,7,30,30
1650556880678,MATH 197,001,091859,McAuley; Julian John,9998,0,9999,1
1650556886748,COGS 9,A01,083615,Staff,0,16,60,60
1650556892778,COGS 11,A01,083617,Boyle; Mary E. T.,19,0,40,21
1650556898803,COGS 13,A01,083071,Staff,0,35,40,40
1650556904829,COGS 14A,A01,092681,Staff,0,26,100,100
1650556910852,COGS 14B,A01,083073,Cheng; Tzu-Han,0,12,50,50
1650556916877,COGS 17,A01,092677,Staff,19,0,75,56
1650556922912,COGS 100,A01,083619,Staff,0,26,60,60
1650556928940,COGS 101A,A01,083621,Davis; Joshua Daniel,0,26,60,60
1650556934983,COGS 101B,A01,091572,Staff,1,5,60,59
1650556941007,COGS 101C,A01,083625,Delgado; Tania,15,0,30,15
1650556947032,COGS 107A,A01,083627,Boyle; Mary E. T.,0,11,60,60
1650556953058,COGS 118A,A01,083075,Staff,0,3,60,60
1650556959086,CSE 3,A50,083646,Miranda; Gregory Joseph,20,0,38,18
1650556959086,CSE 3,A51,083647,Miranda; Gregory Joseph,36,0,37,1
1650556965110,CSE 8A,A50,083650,Miranda; Gregory Joseph,0,29,40,40
1650556971132,CSE 11,A01,083080,Cao; Yingjun,0,94,40,40
1650556977162,CSE 12,A01,083652,Staff,0,17,100,100
1650556983185,CSE 15L,A01,083654,Staff,0,1,50,50
1650556983185,CSE 15L,A02,083655,Staff,0,0,50,50
1650556989208,CSE 20,A01,083657,Staff,51,0,80,29
1650556995235,CSE 30,A01,083084,Eldon; John,0,77,40,40
1650557001264,CSE 100,A01,083659,Cao; Yingjun,0,66,50,50
1650557007287,CSE 134B,A01,083661,Powell; Thomas Allan,0,34,65,65
1650557013401,CSE 140,A01,083663,Staff,0,5,75,75
1650557019429,CSE 140L,A01,083088,Eldon; John,0,11,75,75
1650557025462,CSE 175,A01,083665,Kumar; Rakesh,7,0,25,18
1650557031487,CSE 190,A00,092507,Dubnov; Shlomo,10,0,20,10
1650557037516,ECE 45,A01,083139,Staff,0,1,60,60
1650557043541,ECE 65,A50,083695,Staff,0,6,30,30
1650557049577,ECE 109,A01,091882,Touri; Behrouz,33,0,70,37
1650557055610,ECE 180,A00,083140,Abi Samra; Nicholas Camill,21,0,30,9
1650557055610,ECE 180,B00,083141,Abi Samra; Nicholas Camill,0,0,30,30
1650557061636,MATH 10A,A01,083735,Patchell; Gregory David,5,0,30,25
1650557061636,MATH 10A,A02,083736,Patchell; Gregory David,27,0,30,3
1650557061636,MATH 10A,A03,083737,Patchell; Gregory David,24,0,30,6
1650557067664,MATH 10B,A01,083207,Staff,0,9,30,30
1650557067664,MATH 10B,A02,083208,Staff,0,7,30,30
1650557067664,MATH 10B,B01,083739,Staff,12,0,30,18
1650557067664,MATH 10B,B02,083740,Staff,28,0,30,2
1650557073690,MATH 18,A01,083743,Staff,1,0,30,29
1650557073690,MATH 18,A02,083744,Staff,26,0,30,4
1650557073690,MATH 18,A03,083745,Staff,22,0,30,8
1650557073690,MATH 18,A04,083746,Staff,26,0,30,4
1650557073690,MATH 18,B01,083748,Staff,0,13,30,30
1650557073690,MATH 18,B02,083749,Staff,0,12,30,30
1650557073690,MATH 18,B03,083750,Staff,0,11,30,30
1650557073690,MATH 18,B04,083751,Staff,0,12,30,30
1650557079727,MATH 20A,A01,083754,Staff,22,0,40,18
1650557085758,MATH 20B,A01,083756,Staff,0,11,30,30
1650557085758,MATH 20B,A02,083757,Staff,0,12,30,30
1650557091781,MATH 20C,A01,083760,Staff,0,16,30,30
1650557091781,MATH 20C,A02,083761,Staff,2,14,30,28
1650557091781,MATH 20C,B01,083762,Staff,12,0,30,18
1650557091781,MATH 20C,B02,083763,Staff,28,0,30,2
1650557097803,MATH 20D,A01,083765,Staff,0,1,30,30
1650557097803,MATH 20D,A02,083766,Staff,7,0,30,23
1650557097803,MATH 20D,A03,083767,Staff,25,0,30,5
1650557103852,MATH 20E,A01,083771,Staff,6,0,30,24
1650557103852,MATH 20E,A02,083772,Staff,18,0,30,12
1650557103852,MATH 20E,B01,083773,Staff,0,0,30,30
1650557103852,MATH 20E,B02,083774,Staff,10,0,30,20
1650557109876,MATH 103A,A01,083777,Staff,0,15,30,30
1650557109876,MATH 103A,A02,083778,Staff,0,14,30,30
1650557109876,MATH 103A,B01,083779,Staff,0,13,30,30
1650557109876,MATH 103A,B02,083780,Staff,0,13,30,30
1650557115899,MATH 105,A01,085443,Staff,0,21,30,30
1650557121936,MATH 109,A01,083213,Anzaldo; Leesa B,0,8,30,30
1650557121936,MATH 109,A02,083214,Anzaldo; Leesa B,0,7,30,30
1650557121936,MATH 109,B01,083215,Anzaldo; Leesa B,0,5,30,30
1650557121936,MATH 109,B02,083216,Anzaldo; Leesa B,0,6,30,30
1650557127964,MATH 142A,A01,083219,Chow; Bennett,0,16,30,30
1650557127964,MATH 142A,A02,083220,Chow; Bennett,0,14,30,30
1650557127964,MATH 142A,B01,083221,Chow; Bennett,0,13,30,30
1650557127964,MATH 142A,B02,083222,Chow; Bennett,0,13,30,30
1650557133987,MATH 193A,A01,083224,Staff,1,6,30,29
1650557133987,MATH 193A,A02,083225,Staff,0,5,30,30
1650557133987,MATH 193A,A03,083781,Staff,0,5,30,30
1650557133987,MATH 193A,A04,083782,Staff,0,7,30,30
1650557140009,MATH 197,001,091859,McAuley; Julian John,9998,0,9999,1
1650557146062,COGS 9,A01,083615,Staff,0,16,60,60
1650557152096,COGS 11,A01,083617,Boyle; Mary E. T.,19,0,40,21
1650557158129,COGS 13,A01,083071,Staff,0,35,40,40
1650557164152,COGS 14A,A01,092681,Staff,0,26,100,100
1650557170179,COGS 14B,A01,083073,Cheng; Tzu-Han,0,12,50,50
1650557176211,COGS 17,A01,092677,Staff,19,0,75,56
1650557182238,COGS 100,A01,083619,Staff,0,26,60,60
1650557188263,COGS 101A,A01,083621,Davis; Joshua Daniel,0,26,60,60
1650557194288,COGS 101B,A01,091572,Staff,1,5,60,59
1650557200324,COGS 101C,A01,083625,Delgado; Tania,15,0,30,15
1650557206354,COGS 107A,A01,083627,Boyle; Mary E. T.,0,11,60,60
1650557212382,COGS 118A,A01,083075,Staff,0,3,60,60
1650557218408,CSE 3,A50,083646,Miranda; Gregory Joseph,20,0,38,18
1650557218408,CSE 3,A51,083647,Miranda; Gregory Joseph,36,0,37,1
1650557224431,CSE 8A,A50,083650,Miranda; Gregory Joseph,0,29,40,40
1650557230457,CSE 11,A01,083080,Cao; Yingjun,0,94,40,40
1650557236482,CSE 12,A01,083652,Staff,0,17,100,100
1650557242506,CSE 15L,A01,083654,Staff,0,1,50,50
1650557242506,CSE 15L,A02,083655,Staff,0,0,50,50
1650557248529,CSE 20,A01,083657,Staff,51,0,80,29
1650557254565,CSE 30,A01,083084,Eldon; John,0,77,40,40
1650557260591,CSE 100,A01,083659,Cao; Yingjun,0,66,50,50
1650557266617,CSE 134B,A01,083661,Powell; Thomas Allan,0,34,65,65
1650557272647,CSE 140,A01,083663,Staff,0,5,75,75
1650557278674,CSE 140L,A01,083088,Eldon; John,0,11,75,75
1650557284702,CSE 175,A01,083665,Kumar; Rakesh,7,0,25,18
1650557290727,CSE 190,A00,092507,Dubnov; Shlomo,10,0,20,10
1650557296750,ECE 45,A01,083139,Staff,0,1,60,60
1650557302782,ECE 65,A50,083695,Staff,0,6,30,30
1650557308809,ECE 109,A01,091882,Touri; Behrouz,33,0,70,37
1650557314842,ECE 180,A00,083140,Abi Samra; Nicholas Camill,21,0,30,9
1650557314842,ECE 180,B00,083141,Abi Samra; Nicholas Camill,0,0,30,30
1650557320866,MATH 10A,A01,083735,Patchell; Gregory David,5,0,30,25
1650557320866,MATH 10A,A02,083736,Patchell; Gregory David,27,0,30,3
1650557320866,MATH 10A,A03,083737,Patchell; Gregory David,24,0,30,6
1650557326894,MATH 10B,A01,083207,Staff,0,9,30,30
1650557326894,MATH 10B,A02,083208,Staff,0,7,30,30
1650557326894,MATH 10B,B01,083739,Staff,12,0,30,18
1650557326894,MATH 10B,B02,083740,Staff,28,0,30,2
1650557332935,MATH 18,A01,083743,Staff,1,0,30,29
1650557332935,MATH 18,A02,083744,Staff,26,0,30,4
1650557332935,MATH 18,A03,083745,Staff,22,0,30,8
1650557332935,MATH 18,A04,083746,Staff,26,0,30,4
1650557332935,MATH 18,B01,083748,Staff,0,13,30,30
1650557332935,MATH 18,B02,083749,Staff,0,12,30,30
1650557332935,MATH 18,B03,083750,Staff,0,11,30,30
1650557332935,MATH 18,B04,083751,Staff,0,12,30,30
1650557338969,MATH 20A,A01,083754,Staff,22,0,40,18
1650557345000,MATH 20B,A01,083756,Staff,0,11,30,30
1650557345000,MATH 20B,A02,083757,Staff,0,12,30,30
1650557351025,MATH 20C,A01,083760,Staff,0,16,30,30
1650557351025,MATH 20C,A02,083761,Staff,2,14,30,28
1650557351025,MATH 20C,B01,083762,Staff,12,0,30,18
1650557351025,MATH 20C,B02,083763,Staff,28,0,30,2
1650557357051,MATH 20D,A01,083765,Staff,0,1,30,30
1650557357051,MATH 20D,A02,083766,Staff,7,0,30,23
1650557357051,MATH 20D,A03,083767,Staff,25,0,30,5
1650557363081,MATH 20E,A01,083771,Staff,6,0,30,24
1650557363081,MATH 20E,A02,083772,Staff,18,0,30,12
1650557363081,MATH 20E,B01,083773,Staff,0,0,30,30
1650557363081,MATH 20E,B02,083774,Staff,10,0,30,20
1650557369106,MATH 103A,A01,083777,Staff,0,15,30,30
1650557369106,MATH 103A,A02,083778,Staff,0,14,30,30
1650557369106,MATH 103A,B01,083779,Staff,0,13,30,30
1650557369106,MATH 103A,B02,083780,Staff,0,13,30,30
1650557375131,MATH 105,A01,085443,Staff,0,21,30,30
1650557381155,MATH 109,A01,083213,Anzaldo; Leesa B,0,8,30,30
1650557381155,MATH 109,A02,083214,Anzaldo; Leesa B,0,7,30,30
1650557381155,MATH 109,B01,083215,Anzaldo; Leesa B,0,5,30,30
1650557381155,MATH 109,B02,083216,Anzaldo; Leesa B,0,6,30,30
1650557387195,MATH 142A,A01,083219,Chow; Bennett,0,16,30,30
1650557387195,MATH 142A,A02,083220,Chow; Bennett,0,14,30,30
1650557387195,MATH 142A,B01,083221,Chow; Bennett,0,13,30,30
1650557387195,MATH 142A,B02,083222,Chow; Bennett,0,13,30,30
1650557393219,MATH 193A,A01,083224,Staff,1,6,30,29
1650557393219,MATH 193A,A02,083225,Staff,0,5,30,30
1650557393219,MATH 193A,A03,083781,Staff,0,5,30,30
1650557393219,MATH 193A,A04,083782,Staff,0,7,30,30
1650557399251,MATH 197,001,091859,McAuley; Julian John,9998,0,9999,1
1650557405310,COGS 9,A01,083615,Staff,0,16,60,60
1650557411332,COGS 11,A01,083617,Boyle; Mary E. T.,19,0,40,21
1650557417356,COGS 13,A01,083071,Staff,0,35,40,40
1650557423383,COGS 14A,A01,092681,Staff,0,26,100,100
1650557429409,COGS 14B,A01,083073,Cheng; Tzu-Han,0,12,50,50
1650557435433,COGS 17,A01,092677,Staff,19,0,75,56
1650557441464,COGS 100,A01,083619,Staff,0,26,60,60
1650557447489,COGS 101A,A01,083621,Davis; Joshua Daniel,0,26,60,60
1650557453513,COGS 101B,A01,091572,Staff,1,5,60,59
1650557459542,COGS 101C,A01,083625,Delgado; Tania,15,0,30,15
1650557465569,COGS 107A,A01,083627,Boyle; Mary E. T.,0,11,60,60
1650557471592,COGS 118A,A01,083075,Staff,0,3,60,60
1650557477618,CSE 3,A50,083646,Miranda; Gregory Joseph,20,0,38,18
1650557477618,CSE 3,A51,083647,Miranda; Gregory Joseph,36,0,37,1
1650557483649,CSE 8A,A50,083650,Miranda; Gregory Joseph,0,29,40,40
1650557489676,CSE 11,A01,083080,Cao; Yingjun,0,94,40,40
1650557495703,CSE 12,A01,083652,Staff,0,17,100,100
1650557501729,CSE 15L,A01,083654,Staff,0,1,50,50
1650557501729,CSE 15L,A02,083655,Staff,0,0,50,50
1650557507755,CSE 20,A01,083657,Staff,51,0,80,29
1650557513788,CSE 30,A01,083084,Eldon; John,0,77,40,40
1650557519812,CSE 100,A01,083659,Cao; Yingjun,0,66,50,50
1650557525836,CSE 134B,A01,083661,Powell; Thomas Allan,0,34,65,65
1650557531866,CSE 140,A01,083663,Staff,0,5,75,75
1650557537890,CSE 140L,A01,083088,Eldon; John,0,11,75,75
1650557543918,CSE 175,A01,083665,Kumar; Rakesh,7,0,25,18
1650557549946,CSE 190,A00,092507,Dubnov; Shlomo,10,0,20,10
1650557555972,ECE 45,A01,083139,Staff,0,1,60,60
1650557562001,ECE 65,A50,083695,Staff,0,6,30,30
1650557568024,ECE 109,A01,091882,Touri; Behrouz,33,0,70,37
1650557574074,ECE 180,A00,083140,Abi Samra; Nicholas Camill,21,0,30,9
1650557574074,ECE 180,B00,083141,Abi Samra; Nicholas Camill,0,0,30,30
1650557580101,MATH 10A,A01,083735,Patchell; Gregory David,5,0,30,25
1650557580101,MATH 10A,A02,083736,Patchell; Gregory David,27,0,30,3
1650557580101,MATH 10A,A03,083737,Patchell; Gregory David,24,0,30,6
1650557586131,MATH 10B,A01,083207,Staff,0,9,30,30
1650557586131,MATH 10B,A02,083208,Staff,0,7,30,30
1650557586131,MATH 10B,B01,083739,Staff,12,0,30,18
1650557586131,MATH 10B,B02,083740,Staff,28,0,30,2
1650557592161,MATH 18,A01,083743,Staff,1,0,30,29
1650557592161,MATH 18,A02,083744,Staff,26,0,30,4
1650557592161,MATH 18,A03,083745,Staff,22,0,30,8
1650557592161,MATH 18,A04,083746,Staff,26,0,30,4
1650557592161,MATH 18,B01,083748,Staff,0,13,30,30
1650557592161,MATH 18,B02,083749,Staff,0,12,30,30
1650557592161,MATH 18,B03,083750,Staff,0,11,30,30
1650557592161,MATH 18,B04,083751,Staff,0,12,30,30
1650557598185,MATH 20A,A01,083754,Staff,22,0,40,18
1650557604212,MATH 20B,A01,083756,Staff,0,11,30,30
1650557604212,MATH 20B,A02,083757,Staff,0,12,30,30
1650557610335,MATH 20C,A01,083760,Staff,0,16,30,30
1650557610335,MATH 20C,A02,083761,Staff,2,14,30,28
1650557610335,MATH 20C,B01,083762,Staff,12,0,30,18
1650557610335,MATH 20C,B02,083763,Staff,28,0,30,2
1650557616368,MATH 20D,A01,083765,Staff,0,1,30,30
1650557616368,MATH 20D,A02,083766,Staff,7,0,30,23
1650557616368,MATH 20D,A03,083767,Staff,25,0,30,5
1650557622391,MATH 20E,A01,083771,Staff,6,0,30,24
1650557622391,MATH 20E,A02,083772,Staff,18,0,30,12
1650557622391,MATH 20E,B01,083773,Staff,0,0,30,30
1650557622391,MATH 20E,B02,083774,Staff,10,0,30,20
1650557628424,MATH 103A,A01,083777,Staff,0,15,30,30
1650557628424,MATH 103A,A02,083778,Staff,0,14,30,30
1650557628424,MATH 103A,B01,083779,Staff,0,13,30,30
1650557628424,MATH 103A,B02,083780,Staff,0,13,30,30
1650557634446,MATH 105,A01,085443,Staff,0,21,30,30
1650557640481,MATH 109,A01,083213,Anzaldo; Leesa B,0,8,30,30
1650557640481,MATH 109,A02,083214,Anzaldo; Leesa B,0,7,30,30
1650557640481,MATH 109,B01,083215,Anzaldo; Leesa B,0,5,30,30
1650557640481,MATH 109,B02,083216,Anzaldo; Leesa B,0,6,30,30
1650557646505,MATH 142A,A01,083219,Chow; Bennett,0,16,30,30
1650557646505,MATH 142A,A02,083220,Chow; Bennett,0,14,30,30
1650557646505,MATH 142A,B01,083221,Chow; Bennett,0,13,30,30
1650557646505,MATH 142A,B02,083222,Chow; Bennett,0,13,30,30
1650557652534,MATH 193A,A01,083224,Staff,1,6,30,29
1650557652534,MATH 193A,A02,083225,Staff,0,5,30,30
1650557652534,MATH 193A,A03,083781,Staff,0,5,30,30
1650557652534,MATH 193A,A04,083782,Staff,0,7,30,30
1650557658556,MATH 197,001,091859,McAuley; Julian John,9998,0,9999,1
1650557664615,COGS 9,A01,083615,Staff,0,16,60,60
1650557670642,COGS 11,A01,083617,Boyle; Mary E. T.,19,0,40,21
1650557676668,COGS 13,A01,083071,Staff,0,35,40,40
1650557682697,COGS 14A,A01,092681,Staff,0,26,100,100
1650557688729,COGS 14B,A01,083073,Cheng; Tzu-Han,0,12,50,50
1650557694761,COGS 17,A01,092677,Staff,19,0,75,56
1650557700783,COGS 100,A01,083619,Staff,0,26,60,60
1650557706812,COGS 101A,A01,083621,Davis; Joshua Daniel,0,26,60,60
1650557712839,COGS 101B,A01,091572,Staff,1,5,60,59
1650557718867,COGS 101C,A01,083625,Delgado; Tania,15,0,30,15
1650557724895,COGS 107A,A01,083627,Boyle; Mary E. T.,0,11,60,60
1650557730921,COGS 118A,A01,083075,Staff,0,3,60,60
1650557736947,CSE 3,A50,083646,Miranda; Gregory Joseph,20,0,38,18
1650557736947,CSE 3,A51,083647,Miranda; Gregory Joseph,36,0,37,1
1650557742974,CSE 8A,A50,083650,Miranda; Gregory Joseph,0,29,40,40
1650557749006,CSE 11,A01,083080,Cao; Yingjun,0,94,40,40
1650557755032,CSE 12,A01,083652,Staff,0,17,100,100
1650557761058,CSE 15L,A01,083654,Staff,0,1,50,50
1650557761058,CSE 15L,A02,083655,Staff,0,0,50,50
1650557767087,CSE 20,A01,083657,Staff,51,0,80,29
1650557773124,CSE 30,A01,083084,Eldon; John,0,77,40,40
1650557779151,CSE 100,A01,083659,Cao; Yingjun,0,66,50,50
1650557785177,CSE 134B,A01,083661,Powell; Thomas Allan,0,34,65,65
1650557791204,CSE 140,A01,083663,Staff,0,5,75,75
1650557797229,CSE 140L,A01,083088,Eldon; John,0,11,75,75
1650557803269,CSE 175,A01,083665,Kumar; Rakesh,7,0,25,18
1650557809297,CSE 190,A00,092507,Dubnov; Shlomo,10,0,20,10
1650557815332,ECE 45,A01,083139,Staff,0,1,60,60
1650557821354,ECE 65,A50,083695,Staff,0,6,30,30
1650557827381,ECE 109,A01,091882,Touri; Behrouz,33,0,70,37
1650557833405,ECE 180,A00,083140,Abi Samra; Nicholas Camill,21,0,30,9
1650557833405,ECE 180,B00,083141,Abi Samra; Nicholas Camill,0,0,30,30
1650557839437,MATH 10A,A01,083735,Patchell; Gregory David,5,0,30,25
1650557839437,MATH 10A,A02,083736,Patchell; Gregory David,27,0,30,3
1650557839437,MATH 10A,A03,083737,Patchell; Gregory David,24,0,30,6
1650557845460,MATH 10B,A01,083207,Staff,0,9,30,30
1650557845460,MATH 10B,A02,083208,Staff,0,7,30,30
1650557845460,MATH 10B,B01,083739,Staff,12,0,30,18
1650557845460,MATH 10B,B02,083740,Staff,28,0,30,2
1650557851486,MATH 18,A01,083743,Staff,1,0,30,29
1650557851486,MATH 18,A02,083744,Staff,26,0,30,4
1650557851486,MATH 18,A03,083745,Staff,22,0,30,8
1650557851486,MATH 18,A04,083746,Staff,26,0,30,4
1650557851486,MATH 18,B01,083748,Staff,0,13,30,30
1650557851486,MATH 18,B02,083749,Staff,0,12,30,30
1650557851486,MATH 18,B03,083750,Staff,0,11,30,30
1650557851486,MATH 18,B04,083751,Staff,0,12,30,30
1650557857513,MATH 20A,A01,083754,Staff,22,0,40,18
1650557863541,MATH 20B,A01,083756,Staff,0,11,30,30
1650557863541,MATH 20B,A02,083757,Staff,0,12,30,30
1650557869566,MATH 20C,A01,083760,Staff,0,16,30,30
1650557869566,MATH 20C,A02,083761,Staff,2,14,30,28
1650557869566,MATH 20C,B01,083762,Staff,12,0,30,18
1650557869566,MATH 20C,B02,083763,Staff,28,0,30,2
1650557875594,MATH 20D,A01,083765,Staff,0,1,30,30
1650557875594,MATH 20D,A02,083766,Staff,7,0,30,23
1650557875594,MATH 20D,A03,083767,Staff,25,0,30,5
1650557881628,MATH 20E,A01,083771,Staff,6,0,30,24
1650557881628,MATH 20E,A02,083772,Staff,18,0,30,12
1650557881628,MATH 20E,B01,083773,Staff,0,0,30,30
1650557881628,MATH 20E,B02,083774,Staff,10,0,30,20
1650557887669,MATH 103A,A01,083777,Staff,0,15,30,30
1650557887669,MATH 103A,A02,083778,Staff,0,14,30,30
1650557887669,MATH 103A,B01,083779,Staff,0,13,30,30
1650557887669,MATH 103A,B02,083780,Staff,0,13,30,30
1650557893693,MATH 105,A01,085443,Staff,0,21,30,30
1650557899722,MATH 109,A01,083213,Anzaldo; Leesa B,0,8,30,30
1650557899722,MATH 109,A02,083214,Anzaldo; Leesa B,0,7,30,30
1650557899722,MATH 109,B01,083215,Anzaldo; Leesa B,0,5,30,30
1650557899722,MATH 109,B02,083216,Anzaldo; Leesa B,0,6,30,30
1650557905745,MATH 142A,A01,083219,Chow; Bennett,0,16,30,30
1650557905745,MATH 142A,A02,083220,Chow; Bennett,0,14,30,30
1650557905745,MATH 142A,B01,083221,Chow; Bennett,0,13,30,30
1650557905745,MATH 142A,B02,083222,Chow; Bennett,0,13,30,30
1650557911773,MATH 193A,A01,083224,Staff,1,6,30,29
1650557911773,MATH 193A,A02,083225,Staff,0,5,30,30
1650557911773,MATH 193A,A03,083781,Staff,0,5,30,30
1650557911773,MATH 193A,A04,083782,Staff,0,7,30,30
1650557917797,MATH 197,001,091859,McAuley; Julian John,9998,0,9999,1
1650557923857,COGS 9,A01,083615,Staff,0,16,60,60
1650557929880,COGS 11,A01,083617,Boyle; Mary E. T.,19,0,40,21
1650557935905,COGS 13,A01,083071,Staff,0,35,40,40
1650557941940,COGS 14A,A01,092681,Staff,0,26,100,100
1650557947961,COGS 14B,A01,083073,Cheng; Tzu-Han,0,12,50,50
1650557953984,COGS 17,A01,092677,Staff,19,0,75,56
1650557960007,COGS 100,A01,083619,Staff,0,26,60,60
1650557966041,COGS 101A,A01,083621,Davis; Joshua Daniel,0,26,60,60
1650557972064,COGS 101B,A01,091572,Staff,1,5,60,59
1650557978092,COGS 101C,A01,083625,Delgado; Tania,15,0,30,15
1650557984121,COGS 107A,A01,083627,Boyle; Mary E. T.,0,11,60,60
1650557990147,COGS 118A,A01,083075,Staff,0,3,60,60
1650557996170,CSE 3,A50,083646,Miranda; Gregory Joseph,20,0,38,18
1650557996170,CSE 3,A51,083647,Miranda; Gregory Joseph,36,0,37,1
1650558002202,CSE 8A,A50,083650,Miranda; Gregory Joseph,0,29,40,40
1650558008224,CSE 11,A01,083080,Cao; Yingjun,0,94,40,40
1650558014248,CSE 12,A01,083652,Staff,0,17,100,100
1650558020272,CSE 15L,A01,083654,Staff,0,1,50,50
1650558020272,CSE 15L,A02,083655,Staff,0,0,50,50
1650558026297,CSE 20,A01,083657,Staff,51,0,80,29
1650558032322,CSE 30,A01,083084,Eldon; John,0,77,40,40
1650558038350,CSE 100,A01,083659,Cao; Yingjun,0,66,50,50
1650558044375,CSE 134B,A01,083661,Powell; Thomas Allan,0,34,65,65
1650558050399,CSE 140,A01,083663,Staff,0,5,75,75
1650558056426,CSE 140L,A01,083088,Eldon; John,0,11,75,75
1650558062460,CSE 175,A01,083665,Kumar; Rakesh,7,0,25,18
1650558068487,CSE 190,A00,092507,Dubnov; Shlomo,10,0,20,10
1650558074522,ECE 45,A01,083139,Staff,0,1,60,60
1650558080548,ECE 65,A50,083695,Staff,0,6,30,30
1650558086574,ECE 109,A01,091882,Touri; Behrouz,33,0,70,37
1650558092598,ECE 180,A00,083140,Abi Samra; Nicholas Camill,21,0,30,9
1650558092598,ECE 180,B00,083141,Abi Samra; Nicholas Camill,0,0,30,30
1650558098622,MATH 10A,A01,083735,Patchell; Gregory David,5,0,30,25
1650558098622,MATH 10A,A02,083736,Patchell; Gregory David,27,0,30,3
1650558098622,MATH 10A,A03,083737,Patchell; Gregory David,24,0,30,6
1650558104664,MATH 10B,A01,083207,Staff,0,9,30,30
1650558104664,MATH 10B,A02,083208,Staff,0,8,30,30
1650558104664,MATH 10B,B01,083739,Staff,12,0,30,18
1650558104664,MATH 10B,B02,083740,Staff,28,0,30,2
1650558110690,MATH 18,A01,083743,Staff,1,0,30,29
1650558110690,MATH 18,A02,083744,Staff,26,0,30,4
1650558110690,MATH 18,A03,083745,Staff,22,0,30,8
1650558110690,MATH 18,A04,083746,Staff,26,0,30,4
1650558110690,MATH 18,B01,083748,Staff,0,13,30,30
1650558110690,MATH 18,B02,083749,Staff,0,12,30,30
1650558110690,MATH 18,B03,083750,Staff,0,11,30,30
1650558110690,MATH 18,B04,083751,Staff,0,12,30,30
1650558116716,MATH 20A,A01,083754,Staff,22,0,40,18
1650558122743,MATH 20B,A01,083756,Staff,0,11,30,30
1650558122743,MATH 20B,A02,083757,Staff,0,12,30,30
1650558128772,MATH 20C,A01,083760,Staff,0,16,30,30
1650558128772,MATH 20C,A02,083761,Staff,2,14,30,28
1650558128772,MATH 20C,B01,083762,Staff,12,0,30,18
1650558128772,MATH 20C,B02,083763,Staff,28,0,30,2
1650558134800,MATH 20D,A01,083765,Staff,0,1,30,30
1650558134800,MATH 20D,A02,083766,Staff,7,0,30,23
1650558134800,MATH 20D,A03,083767,Staff,25,0,30,5
1650558140837,MATH 20E,A01,083771,Staff,6,0,30,24
1650558140837,MATH 20E,A02,083772,Staff,18,0,30,12
1650558140837,MATH 20E,B01,083773,Staff,0,0,30,30
1650558140837,MATH 20E,B02,083774,Staff,10,0,30,20
1650558146872,MATH 103A,A01,083777,Staff,0,15,30,30
1650558146872,MATH 103A,A02,083778,Staff,0,14,30,30
1650558146872,MATH 103A,B01,083779,Staff,0,13,30,30
1650558146872,MATH 103A,B02,083780,Staff,0,13,30,30
1650558152895,MATH 105,A01,085443,Staff,0,21,30,30
1650558158923,MATH 109,A01,083213,Anzaldo; Leesa B,0,8,30,30
1650558158923,MATH 109,A02,083214,Anzaldo; Leesa B,0,7,30,30
1650558158923,MATH 109,B01,083215,Anzaldo; Leesa B,0,5,30,30
1650558158923,MATH 109,B02,083216,Anzaldo; Leesa B,0,6,30,30
1650558164948,MATH 142A,A01,083219,Chow; Bennett,0,16,30,30
1650558164948,MATH 142A,A02,083220,Chow; Bennett,0,14,30,30
1650558164948,MATH 142A,B01,083221,Chow; Bennett,0,13,30,30
1650558164948,MATH 142A,B02,083222,Chow; Bennett,0,13,30,30
1650558170975,MATH 193A,A01,083224,Staff,1,6,30,29
1650558170975,MATH 193A,A02,083225,Staff,0,5,30,30
1650558170975,MATH 193A,A03,083781,Staff,0,5,30,30
1650558170975,MATH 193A,A04,083782,Staff,0,7,30,30
1650558177000,MATH 197,001,091859,McAuley; Julian John,9998,0,9999,1
1650558183062,COGS 9,A01,083615,Staff,0,16,60,60
1650558189086,COGS 11,A01,083617,Boyle; Mary E. T.,19,0,40,21
1650558195123,COGS 13,A01,083071,Staff,0,35,40,40
1650558201238,COGS 14A,A01,092681,Staff,0,26,100,100
1650558207270,COGS 14B,A01,083073,Cheng; Tzu-Han,0,12,50,50
1650558213295,COGS 17,A01,092677,Staff,19,0,75,56
1650558219319,COGS 100,A01,083619,Staff,0,26,60,60
1650558225343,COGS 101A,A01,083621,Davis; Joshua Daniel,0,26,60,60
1650558231371,COGS 101B,A01,091572,Staff,1,5,60,59
1650558237413,COGS 101C,A01,083625,Delgado; Tania,15,0,30,15
1650558243436,COGS 107A,A01,083627,Boyle; Mary E. T.,0,11,60,60
1650558249462,COGS 118A,A01,083075,Staff,0,3,60,60
1650558255495,CSE 3,A50,083646,Miranda; Gregory Joseph,20,0,38,18
1650558255495,CSE 3,A51,083647,Miranda; Gregory Joseph,36,0,37,1
1650558261519,CSE 8A,A50,083650,Miranda; Gregory Joseph,0,29,40,40
1650558267541,CSE 11,A01,083080,Cao; Yingjun,0,94,40,40
1650558273578,CSE 12,A01,083652,Staff,0,17,100,100
1650558279610,CSE 15L,A01,083654,Staff,0,1,50,50
1650558279610,CSE 15L,A02,083655,Staff,0,0,50,50
1650558285633,CSE 20,A01,083657,Staff,51,0,80,29
1650558291660,CSE 30,A01,083084,Eldon; John,0,77,40,40
1650558297684,CSE 100,A01,083659,Cao; Yingjun,0,66,50,50
1650558303712,CSE 134B,A01,083661,Powell; Thomas Allan,0,34,65,65
1650558309737,CSE 140,A01,083663,Staff,0,5,75,75
1650558315765,CSE 140L,A01,083088,Eldon; John,0,11,75,75
1650558321791,CSE 175,A01,083665,Kumar; Rakesh,7,0,25,18
1650558327812,CSE 190,A00,092507,Dubnov; Shlomo,10,0,20,10
1650558333838,ECE 45,A01,083139,Staff,0,1,60,60
1650558339868,ECE 65,A50,083695,Staff,0,6,30,30
1650558345902,ECE 109,A01,091882,Touri; Behrouz,33,0,70,37
1650558351932,ECE 180,A00,083140,Abi Samra; Nicholas Camill,21,0,30,9
1650558351932,ECE 180,B00,083141,Abi Samra; Nicholas Camill,0,0,30,30
1650558357965,MATH 10A,A01,083735,Patchell; Gregory David,5,0,30,25
1650558357965,MATH 10A,A02,083736,Patchell; Gregory David,27,0,30,3
1650558357965,MATH 10A,A03,083737,Patchell; Gregory David,24,0,30,6
1650558363992,MATH 10B,A01,083207,Staff,0,9,30,30
1650558363992,MATH 10B,A02,083208,Staff,0,8,30,30
1650558363992,MATH 10B,B01,083739,Staff,12,0,30,18
1650558363992,MATH 10B,B02,083740,Staff,28,0,30,2
1650558370023,MATH 18,A01,083743,Staff,1,0,30,29
1650558370023,MATH 18,A02,083744,Staff,26,0,30,4
1650558370023,MATH 18,A03,083745,Staff,22,0,30,8
1650558370023,MATH 18,A04,083746,Staff,26,0,30,4
1650558370023,MATH 18,B01,083748,Staff,0,13,30,30
1650558370023,MATH 18,B02,083749,Staff,0,12,30,30
1650558370023,MATH 18,B03,083750,Staff,0,11,30,30
1650558370023,MATH 18,B04,083751,Staff,0,12,30,30
1650558376046,MATH 20A,A01,083754,Staff,22,0,40,18
1650558382070,MATH 20B,A01,083756,Staff,0,11,30,30
1650558382070,MATH 20B,A02,083757,Staff,0,12,30,30
1650558388099,MATH 20C,A01,083760,Staff,0,16,30,30
1650558388099,MATH 20C,A02,083761,Staff,2,14,30,28
1650558388099,MATH 20C,B01,083762,Staff,12,0,30,18
1650558388099,MATH 20C,B02,083763,Staff,28,0,30,2
1650558394130,MATH 20D,A01,083765,Staff,0,1,30,30
1650558394130,MATH 20D,A02,083766,Staff,7,0,30,23
1650558394130,MATH 20D,A03,083767,Staff,25,0,30,5
1650558400153,MATH 20E,A01,083771,Staff,6,0,30,24
1650558400153,MATH 20E,A02,083772,Staff,18,0,30,12
1650558400153,MATH 20E,B01,083773,Staff,0,0,30,30
1650558400153,MATH 20E,B02,083774,Staff,10,0,30,20
1650558406178,MATH 103A,A01,083777,Staff,0,15,30,30
1650558406178,MATH 103A,A02,083778,Staff,0,14,30,30
1650558406178,MATH 103A,B01,083779,Staff,0,13,30,30
1650558406178,MATH 103A,B02,083780,Staff,0,13,30,30
1650558412214,MATH 105,A01,085443,Staff,0,21,30,30
1650558418244,MATH 109,A01,083213,Anzaldo; Leesa B,0,8,30,30
1650558418244,MATH 109,A02,083214,Anzaldo; Leesa B,0,7,30,30
1650558418244,MATH 109,B01,083215,Anzaldo; Leesa B,0,5,30,30
1650558418244,MATH 109,B02,083216,Anzaldo; Leesa B,0,6,30,30
1650558424278,MATH 142A,A01,083219,Chow; Bennett,0,16,30,30
1650558424278,MATH 142A,A02,083220,Chow; Bennett,0,14,30,30
1650558424278,MATH 142A,B01,083221,Chow; Bennett,0,13,30,30
1650558424278,MATH 142A,B02,083222,Chow; Bennett,0,13,30,30
1650558430316,MATH 193A,A01,083224,Staff,1,6,30,29
1650558430316,MATH 193A,A02,083225,Staff,0,5,30,30
1650558430316,MATH 193A,A03,083781,Staff,0,5,30,30
1650558430316,MATH 193A,A04,083782,Staff,0,7,30,30
1650558436342,MATH 197,001,091859,McAuley; Julian John,9998,0,9999,1
1650558442393,COGS 9,A01,083615,Staff,0,16,60,60
1650558448419,COGS 11,A01,083617,Boyle; Mary E. T.,19,0,40,21
1650558454448,COGS 13,A01,083071,Staff,0,35,40,40
1650558460478,COGS 14A,A01,092681,Staff,0,27,100,100
1650558466515,COGS 14B,A01,083073,Cheng; Tzu-Han,0,12,50,50
1650558472548,COGS 17,A01,092677,Staff,19,0,75,56
1650558478573,COGS 100,A01,083619,Staff,0,26,60,60
1650558484597,COGS 101A,A01,083621,Davis; Joshua Daniel,0,26,60,60
1650558490625,COGS 101B,A01,091572,Staff,1,5,60,59
1650558496653,COGS 101C,A01,083625,Delgado; Tania,15,0,30,15
1650558502677,COGS 107A,A01,083627,Boyle; Mary E. T.,0,11,60,60
1650558508700,COGS 118A,A01,083075,Staff,0,3,60,60
1650558514724,CSE 3,A50,083646,Miranda; Gregory Joseph,20,0,38,18
1650558514724,CSE 3,A51,083647,Miranda; Gregory Joseph,36,0,37,1
1650558520747,CSE 8A,A50,083650,Miranda; Gregory Joseph,0,29,40,40
1650558526770,CSE 11,A01,083080,Cao; Yingjun,0,94,40,40
1650558532796,CSE 12,A01,083652,Staff,0,17,100,100
1650558538820,CSE 15L,A01,083654,Staff,0,1,50,50
1650558538820,CSE 15L,A02,083655,Staff,0,0,50,50
1650558544854,CSE 20,A01,083657,Staff,51,0,80,29
1650558550879,CSE 30,A01,083084,Eldon; John,0,77,40,40
1650558556902,CSE 100,A01,083659,Cao; Yingjun,0,66,50,50
1650558562927,CSE 134B,A01,083661,Powell; Thomas Allan,0,34,65,65
1650558568960,CSE 140,A01,083663,Staff,0,5,75,75
1650558574982,CSE 140L,A01,083088,Eldon; John,0,11,75,75
1650558581012,CSE 175,A01,083665,Kumar; Rakesh,7,0,25,18
1650558587035,CSE 190,A00,092507,Dubnov; Shlomo,10,0,20,10
1650558593059,ECE 45,A01,083139,Staff,0,1,60,60
1650558599085,ECE 65,A50,083695,Staff,0,6,30,30
1650558605115,ECE 109,A01,091882,Touri; Behrouz,33,0,70,37
1650558611156,ECE 180,A00,083140,Abi Samra; Nicholas Camill,21,0,30,9
1650558611156,ECE 180,B00,083141,Abi Samra; Nicholas Camill,0,0,30,30
1650558617180,MATH 10A,A01,083735,Patchell; Gregory David,5,0,30,25
1650558617180,MATH 10A,A02,083736,Patchell; Gregory David,27,0,30,3
1650558617180,MATH 10A,A03,083737,Patchell; Gregory David,24,0,30,6
1650558623204,MATH 10B,A01,083207,Staff,0,9,30,30
1650558623204,MATH 10B,A02,083208,Staff,0,8,30,30
1650558623204,MATH 10B,B01,083739,Staff,12,0,30,18
1650558623204,MATH 10B,B02,083740,Staff,28,0,30,2
1650558629240,MATH 18,A01,083743,Staff,1,0,30,29
1650558629240,MATH 18,A02,083744,Staff,26,0,30,4
1650558629240,MATH 18,A03,083745,Staff,22,0,30,8
1650558629240,MATH 18,A04,083746,Staff,26,0,30,4
1650558629240,MATH 18,B01,083748,Staff,0,13,30,30
1650558629240,MATH 18,B02,083749,Staff,0,12,30,30
1650558629240,MATH 18,B03,083750,Staff,0,11,30,30
1650558629240,MATH 18,B04,083751,Staff,0,12,30,30
1650558635273,MATH 20A,A01,083754,Staff,22,0,40,18
1650558641302,MATH 20B,A01,083756,Staff,0,11,30,30
1650558641302,MATH 20B,A02,083757,Staff,0,12,30,30
1650558647325,MATH 20C,A01,083760,Staff,0,16,30,30
1650558647325,MATH 20C,A02,083761,Staff,2,14,30,28
1650558647325,MATH 20C,B01,083762,Staff,12,0,30,18
1650558647325,MATH 20C,B02,083763,Staff,28,0,30,2
1650558653351,MATH 20D,A01,083765,Staff,0,1,30,30
1650558653351,MATH 20D,A02,083766,Staff,7,0,30,23
1650558653351,MATH 20D,A03,083767,Staff,25,0,30,5
1650558659378,MATH 20E,A01,083771,Staff,6,0,30,24
1650558659378,MATH 20E,A02,083772,Staff,18,0,30,12
1650558659378,MATH 20E,B01,083773,Staff,0,0,30,30
1650558659378,MATH 20E,B02,083774,Staff,10,0,30,20
1650558665408,MATH 103A,A01,083777,Staff,0,15,30,30
1650558665408,MATH 103A,A02,083778,Staff,0,14,30,30
1650558665408,MATH 103A,B01,083779,Staff,0,13,30,30
1650558665408,MATH 103A,B02,083780,Staff,0,13,30,30
1650558671431,MATH 105,A01,085443,Staff,0,21,30,30
1650558677468,MATH 109,A01,083213,Anzaldo; Leesa B,0,8,30,30
1650558677468,MATH 109,A02,083214,Anzaldo; Leesa B,0,7,30,30
1650558677468,MATH 109,B01,083215,Anzaldo; Leesa B,0,5,30,30
1650558677468,MATH 109,B02,083216,Anzaldo; Leesa B,0,6,30,30
1650558683494,MATH 142A,A01,083219,Chow; Bennett,0,16,30,30
1650558683494,MATH 142A,A02,083220,Chow; Bennett,0,14,30,30
1650558683494,MATH 142A,B01,083221,Chow; Bennett,0,13,30,30
1650558683494,MATH 142A,B02,083222,Chow; Bennett,0,13,30,30
1650558689528,MATH 193A,A01,083224,Staff,1,6,30,29
1650558689528,MATH 193A,A02,083225,Staff,0,5,30,30
1650558689528,MATH 193A,A03,083781,Staff,0,5,30,30
1650558689528,MATH 193A,A04,083782,Staff,0,7,30,30
1650558695553,MATH 197,001,091859,McAuley; Julian John,9998,0,9999,1
1650558701606,COGS 9,A01,083615,Staff,0,16,60,60
1650558707631,COGS 11,A01,083617,Boyle; Mary E. T.,19,0,40,21
1650558713655,COGS 13,A01,083071,Staff,0,35,40,40
1650558719680,COGS 14A,A01,092681,Staff,0,27,100,100
1650558725706,COGS 14B,A01,083073,Cheng; Tzu-Han,0,12,50,50
1650558731732,COGS 17,A01,092677,Staff,19,0,75,56
1650558737765,COGS 100,A01,083619,Staff,0,26,60,60
1650558743803,COGS 101A,A01,083621,Davis; Joshua Daniel,0,26,60,60
1650558749829,COGS 101B,A01,091572,Staff,1,5,60,59
1650558755857,COGS 101C,A01,083625,Delgado; Tania,15,0,30,15
1650558761880,COGS 107A,A01,083627,Boyle; Mary E. T.,0,11,60,60
1650558767904,COGS 118A,A01,083075,Staff,0,3,60,60
1650558773927,CSE 3,A50,083646,Miranda; Gregory Joseph,20,0,38,18
1650558773927,CSE 3,A51,083647,Miranda; Gregory Joseph,36,0,37,1
1650558779949,CSE 8A,A50,083650,Miranda; Gregory Joseph,0,29,40,40
1650558785973,CSE 11,A01,083080,Cao; Yingjun,0,94,40,40
1650558792010,CSE 12,A01,083652,Staff,0,17,100,100
1650558798150,CSE 15L,A01,083654,Staff,0,1,50,50
1650558798150,CSE 15L,A02,083655,Staff,0,0,50,50
1650558804187,CSE 20,A01,083657,Staff,51,0,80,29
1650558810213,CSE 30,A01,083084,Eldon; John,0,77,40,40
1650558816243,CSE 100,A01,083659,Cao; Yingjun,0,66,50,50
1650558822273,CSE 134B,A01,083661,Powell; Thomas Allan,0,34,65,65
1650558828297,CSE 140,A01,083663,Staff,0,5,75,75
1650558834321,CSE 140L,A01,083088,Eldon; John,0,11,75,75
1650558840343,CSE 175,A01,083665,Kumar; Rakesh,7,0,25,18
1650558846375,CSE 190,A00,092507,Dubnov; Shlomo,10,0,20,10
1650558852402,ECE 45,A01,083139,Staff,0,1,60,60
1650558858427,ECE 65,A50,083695,Staff,0,6,30,30
1650558864456,ECE 109,A01,091882,Touri; Behrouz,33,0,70,37
1650558870493,ECE 180,A00,083140,Abi Samra; Nicholas Camill,21,0,30,9
1650558870493,ECE 180,B00,083141,Abi Samra; Nicholas Camill,0,0,30,30
1650558876515,MATH 10A,A01,083735,Patchell; Gregory David,5,0,30,25
1650558876515,MATH 10A,A02,083736,Patchell; Gregory David,27,0,30,3
1650558876515,MATH 10A,A03,083737,Patchell; Gregory David,24,0,30,6
1650558882552,MATH 10B,A01,083207,Staff,0,9,30,30
1650558882552,MATH 10B,A02,083208,Staff,0,8,30,30
1650558882552,MATH 10B,B01,083739,Staff,12,0,30,18
1650558882552,MATH 10B,B02,083740,Staff,28,0,30,2
1650558888581,MATH 18,A01,083743,Staff,1,0,30,29
1650558888581,MATH 18,A02,083744,Staff,26,0,30,4
1650558888581,MATH 18,A03,083745,Staff,22,0,30,8
1650558888581,MATH 18,A04,083746,Staff,26,0,30,4
1650558888581,MATH 18,B01,083748,Staff,0,13,30,30
1650558888581,MATH 18,B02,083749,Staff,0,12,30,30
1650558888581,MATH 18,B03,083750,Staff,0,11,30,30
1650558888581,MATH 18,B04,083751,Staff,0,12,30,30
1650558894604,MATH 20A,A01,083754,Staff,22,0,40,18
1650558900628,MATH 20B,A01,083756,Staff,0,11,30,30
1650558900628,MATH 20B,A02,083757,Staff,0,12,30,30
1650558906651,MATH 20C,A01,083760,Staff,0,16,30,30
1650558906651,MATH 20C,A02,083761,Staff,2,14,30,28
1650558906651,MATH 20C,B01,083762,Staff,12,0,30,18
1650558906651,MATH 20C,B02,083763,Staff,28,0,30,2
1650558912679,MATH 20D,A01,083765,Staff,0,1,30,30
1650558912679,MATH 20D,A02,083766,Staff,7,0,30,23
1650558912679,MATH 20D,A03,083767,Staff,25,0,30,5
1650558918708,MATH 20E,A01,083771,Staff,6,0,30,24
1650558918708,MATH 20E,A02,083772,Staff,18,0,30,12
1650558918708,MATH 20E,B01,083773,Staff,0,0,30,30
1650558918708,MATH 20E,B02,083774,Staff,10,0,30,20
1650558924741,MATH 103A,A01,083777,Staff,0,15,30,30
1650558924741,MATH 103A,A02,083778,Staff,0,14,30,30
1650558924741,MATH 103A,B01,083779,Staff,0,13,30,30
1650558924741,MATH 103A,B02,083780,Staff,0,13,30,30
1650558930767,MATH 105,A01,085443,Staff,0,21,30,30
1650558936792,MATH 109,A01,083213,Anzaldo; Leesa B,0,8,30,30
1650558936792,MATH 109,A02,083214,Anzaldo; Leesa B,0,7,30,30
1650558936792,MATH 109,B01,083215,Anzaldo; Leesa B,0,5,30,30
1650558936792,MATH 109,B02,083216,Anzaldo; Leesa B,0,6,30,30
1650558942816,MATH 142A,A01,083219,Chow; Bennett,0,16,30,30
1650558942816,MATH 142A,A02,083220,Chow; Bennett,0,14,30,30
1650558942816,MATH 142A,B01,083221,Chow; Bennett,0,13,30,30
1650558942816,MATH 142A,B02,083222,Chow; Bennett,0,13,30,30
1650558948839,MATH 193A,A01,083224,Staff,1,6,30,29
1650558948839,MATH 193A,A02,083225,Staff,0,5,30,30
1650558948839,MATH 193A,A03,083781,Staff,0,5,30,30
1650558948839,MATH 193A,A04,083782,Staff,0,7,30,30
1650558954862,MATH 197,001,091859,McAuley; Julian John,9998,0,9999,1
1650558960919,COGS 9,A01,083615,Staff,0,16,60,60
1650558966943,COGS 11,A01,083617,Boyle; Mary E. T.,19,0,40,21
1650558972967,COGS 13,A01,083071,Staff,0,35,40,40
1650558978992,COGS 14A,A01,092681,Staff,0,27,100,100
1650558985045,COGS 14B,A01,083073,Cheng; Tzu-Han,0,12,50,50
1650558991071,COGS 17,A01,092677,Staff,19,0,75,56
1650558997098,COGS 100,A01,083619,Staff,0,26,60,60
1650559003122,COGS 101A,A01,083621,Davis; Joshua Daniel,0,26,60,60
1650559009147,COGS 101B,A01,091572,Staff,1,5,60,59
1650559015171,COGS 101C,A01,083625,Delgado; Tania,15,0,30,15
1650559021196,COGS 107A,A01,083627,Boyle; Mary E. T.,0,11,60,60
1650559027238,COGS 118A,A01,083075,Staff,0,3,60,60
1650559033261,CSE 3,A50,083646,Miranda; Gregory Joseph,20,0,38,18
1650559033261,CSE 3,A51,083647,Miranda; Gregory Joseph,36,0,37,1
1650559039286,CSE 8A,A50,083650,Miranda; Gregory Joseph,0,29,40,40
1650559045310,CSE 11,A01,083080,Cao; Yingjun,0,94,40,40
1650559051341,CSE 12,A01,083652,Staff,0,17,100,100
1650559057364,CSE 15L,A01,083654,Staff,0,1,50,50
1650559057364,CSE 15L,A02,083655,Staff,0,0,50,50
1650559063392,CSE 20,A01,083657,Staff,51,0,80,29
1650559069415,CSE 30,A01,083084,Eldon; John,0,77,40,40
1650559075439,CSE 100,A01,083659,Cao; Yingjun,0,66,50,50
1650559081466,CSE 134B,A01,083661,Powell; Thomas Allan,0,34,65,65
1650559087489,CSE 140,A01,083663,Staff,0,5,75,75
1650559093516,CSE 140L,A01,083088,Eldon; John,0,11,75,75
1650559099540,CSE 175,A01,083665,Kumar; Rakesh,7,0,25,18
1650559105571,CSE 190,A00,092507,Dubnov; Shlomo,10,0,20,10
1650559111604,ECE 45,A01,083139,Staff,0,1,60,60
1650559117631,ECE 65,A50,083695,Staff,0,6,30,30
1650559123660,ECE 109,A01,091882,Touri; Behrouz,33,0,70,37
1650559129688,ECE 180,A00,083140,Abi Samra; Nicholas Camill,21,0,30,9
1650559129688,ECE 180,B00,083141,Abi Samra; Nicholas Camill,0,0,30,30
1650559135711,MATH 10A,A01,083735,Patchell; Gregory David,5,0,30,25
1650559135711,MATH 10A,A02,083736,Patchell; Gregory David,27,0,30,3
1650559135711,MATH 10A,A03,083737,Patchell; Gregory David,24,0,30,6
1650559141734,MATH 10B,A01,083207,Staff,0,9,30,30
1650559141734,MATH 10B,A02,083208,Staff,0,8,30,30
1650559141734,MATH 10B,B01,083739,Staff,12,0,30,18
1650559141734,MATH 10B,B02,083740,Staff,28,0,30,2
1650559147759,MATH 18,A01,083743,Staff,1,0,30,29
1650559147759,MATH 18,A02,083744,Staff,26,0,30,4
1650559147759,MATH 18,A03,083745,Staff,22,0,30,8
1650559147759,MATH 18,A04,083746,Staff,26,0,30,4
1650559147759,MATH 18,B01,083748,Staff,0,13,30,30
1650559147759,MATH 18,B02,083749,Staff,0,12,30,30
1650559147759,MATH 18,B03,083750,Staff,0,11,30,30
1650559147759,MATH 18,B04,083751,Staff,0,12,30,30
1650559153789,MATH 20A,A01,083754,Staff,22,0,40,18
1650559159815,MATH 20B,A01,083756,Staff,0,11,30,30
1650559159815,MATH 20B,A02,083757,Staff,0,12,30,30
1650559165840,MATH 20C,A01,083760,Staff,0,16,30,30
1650559165840,MATH 20C,A02,083761,Staff,2,14,30,28
1650559165840,MATH 20C,B01,083762,Staff,12,0,30,18
1650559165840,MATH 20C,B02,083763,Staff,28,0,30,2
1650559171872,MATH 20D,A01,083765,Staff,0,1,30,30
1650559171872,MATH 20D,A02,083766,Staff,7,0,30,23
1650559171872,MATH 20D,A03,083767,Staff,25,0,30,5
1650559177908,MATH 20E,A01,083771,Staff,6,0,30,24
1650559177908,MATH 20E,A02,083772,Staff,18,0,30,12
1650559177908,MATH 20E,B01,083773,Staff,0,0,30,30
1650559177908,MATH 20E,B02,083774,Staff,10,0,30,20
1650559183932,MATH 103A,A01,083777,Staff,0,15,30,30
1650559183932,MATH 103A,A02,083778,Staff,0,14,30,30
1650559183932,MATH 103A,B01,083779,Staff,0,13,30,30
1650559183932,MATH 103A,B02,083780,Staff,0,13,30,30
1650559189971,MATH 105,A01,085443,Staff,0,21,30,30
1650559196003,MATH 109,A01,083213,Anzaldo; Leesa B,0,8,30,30
1650559196003,MATH 109,A02,083214,Anzaldo; Leesa B,0,7,30,30
1650559196003,MATH 109,B01,083215,Anzaldo; Leesa B,0,5,30,30
1650559196003,MATH 109,B02,083216,Anzaldo; Leesa B,0,6,30,30
1650559202032,MATH 142A,A01,083219,Chow; Bennett,0,16,30,30
1650559202032,MATH 142A,A02,083220,Chow; Bennett,0,14,30,30
1650559202032,MATH 142A,B01,083221,Chow; Bennett,0,13,30,30
1650559202032,MATH 142A,B02,083222,Chow; Bennett,0,13,30,30
1650559208072,MATH 193A,A01,083224,Staff,1,6,30,29
1650559208072,MATH 193A,A02,083225,Staff,0,5,30,30
1650559208072,MATH 193A,A03,083781,Staff,0,5,30,30
1650559208072,MATH 193A,A04,083782,Staff,0,7,30,30
1650559214097,MATH 197,001,091859,McAuley; Julian John,9998,0,9999,1
1650559220158,COGS 9,A01,083615,Staff,0,16,60,60
1650559226179,COGS 11,A01,083617,Boyle; Mary E. T.,19,0,40,21
1650559232206,COGS 13,A01,083071,Staff,0,35,40,40
1650559238232,COGS 14A,A01,092681,Staff,0,27,100,100
1650559244259,COGS 14B,A01,083073,Cheng; Tzu-Han,0,12,50,50
1650559250282,COGS 17,A01,092677,Staff,19,0,75,56
1650559256309,COGS 100,A01,083619,Staff,0,26,60,60
1650559262346,COGS 101A,A01,083621,Davis; Joshua Daniel,0,26,60,60
1650559268373,COGS 101B,A01,091572,Staff,1,5,60,59
1650559274415,COGS 101C,A01,083625,Delgado; Tania,15,0,30,15
1650559280439,COGS 107A,A01,083627,Boyle; Mary E. T.,0,11,60,60
1650559286473,COGS 118A,A01,083075,Staff,0,3,60,60
1650559292498,CSE 3,A50,083646,Miranda; Gregory Joseph,20,0,38,18
1650559292498,CSE 3,A51,083647,Miranda; Gregory Joseph,36,0,37,1
1650559298524,CSE 8A,A50,083650,Miranda; Gregory Joseph,0,29,40,40
1650559304550,CSE 11,A01,083080,Cao; Yingjun,0,94,40,40
1650559310572,CSE 12,A01,083652,Staff,0,17,100,100
1650559316605,CSE 15L,A01,083654,Staff,0,1,50,50
1650559316605,CSE 15L,A02,083655,Staff,0,0,50,50
1650559322629,CSE 20,A01,083657,Staff,51,0,80,29
1650559328664,CSE 30,A01,083084,Eldon; John,0,77,40,40
1650559334693,CSE 100,A01,083659,Cao; Yingjun,0,66,50,50
1650559340721,CSE 134B,A01,083661,Powell; Thomas Allan,0,34,65,65
1650559346744,CSE 140,A01,083663,Staff,0,5,75,75
1650559352769,CSE 140L,A01,083088,Eldon; John,0,11,75,75
1650559358796,CSE 175,A01,083665,Kumar; Rakesh,7,0,25,18
1650559364822,CSE 190,A00,092507,Dubnov; Shlomo,10,0,20,10
1650559370846,ECE 45,A01,083139,Staff,0,1,60,60
1650559376871,ECE 65,A50,083695,Staff,0,6,30,30
1650559382900,ECE 109,A01,091882,Touri; Behrouz,33,0,70,37
1650559388923,ECE 180,A00,083140,Abi Samra; Nicholas Camill,21,0,30,9
1650559388923,ECE 180,B00,083141,Abi Samra; Nicholas Camill,0,0,30,30
1650559395039,MATH 10A,A01,083735,Patchell; Gregory David,5,0,30,25
1650559395039,MATH 10A,A02,083736,Patchell; Gregory David,27,0,30,3
1650559395039,MATH 10A,A03,083737,Patchell; Gregory David,24,0,30,6
1650559401068,MATH 10B,A01,083207,Staff,0,9,30,30
1650559401068,MATH 10B,A02,083208,Staff,0,8,30,30
1650559401068,MATH 10B,B01,083739,Staff,12,0,30,18
1650559401068,MATH 10B,B02,083740,Staff,28,0,30,2
1650559407093,MATH 18,A01,083743,Staff,1,0,30,29
1650559407093,MATH 18,A02,083744,Staff,26,0,30,4
1650559407093,MATH 18,A03,083745,Staff,22,0,30,8
1650559407093,MATH 18,A04,083746,Staff,26,0,30,4
1650559407093,MATH 18,B01,083748,Staff,0,13,30,30
1650559407093,MATH 18,B02,083749,Staff,0,12,30,30
1650559407093,MATH 18,B03,083750,Staff,0,11,30,30
1650559407093,MATH 18,B04,083751,Staff,0,12,30,30
1650559413117,MATH 20A,A01,083754,Staff,21,0,40,19
1650559419145,MATH 20B,A01,083756,Staff,0,11,30,30
1650559419145,MATH 20B,A02,083757,Staff,0,12,30,30
1650559425168,MATH 20C,A01,083760,Staff,0,16,30,30
1650559425168,MATH 20C,A02,083761,Staff,2,14,30,28
1650559425168,MATH 20C,B01,083762,Staff,12,0,30,18
1650559425168,MATH 20C,B02,083763,Staff,28,0,30,2
1650559431194,MATH 20D,A01,083765,Staff,0,1,30,30
1650559431194,MATH 20D,A02,083766,Staff,7,0,30,23
1650559431194,MATH 20D,A03,083767,Staff,25,0,30,5
1650559437217,MATH 20E,A01,083771,Staff,6,0,30,24
1650559437217,MATH 20E,A02,083772,Staff,18,0,30,12
1650559437217,MATH 20E,B01,083773,Staff,0,0,30,30
1650559437217,MATH 20E,B02,083774,Staff,10,0,30,20
1650559443248,MATH 103A,A01,083777,Staff,0,15,30,30
1650559443248,MATH 103A,A02,083778,Staff,0,14,30,30
1650559443248,MATH 103A,B01,083779,Staff,0,13,30,30
1650559443248,MATH 103A,B02,083780,Staff,0,13,30,30
1650559449281,MATH 105,A01,085443,Staff,0,21,30,30
1650559455304,MATH 109,A01,083213,Anzaldo; Leesa B,0,8,30,30
1650559455304,MATH 109,A02,083214,Anzaldo; Leesa B,0,7,30,30
1650559455304,MATH 109,B01,083215,Anzaldo; Leesa B,0,5,30,30
1650559455304,MATH 109,B02,083216,Anzaldo; Leesa B,0,6,30,30
1650559461325,MATH 142A,A01,083219,Chow; Bennett,0,16,30,30
1650559461325,MATH 142A,A02,083220,Chow; Bennett,0,14,30,30
1650559461325,MATH 142A,B01,083221,Chow; Bennett,0,13,30,30
1650559461325,MATH 142A,B02,083222,Chow; Bennett,0,13,30,30
1650559467349,MATH 193A,A01,083224,Staff,1,6,30,29
1650559467349,MATH 193A,A02,083225,Staff,0,5,30,30
1650559467349,MATH 193A,A03,083781,Staff,0,5,30,30
1650559467349,MATH 193A,A04,083782,Staff,0,7,30,30
1650559473380,MATH 197,001,091859,McAuley; Julian John,9998,0,9999,1
1650559479433,COGS 9,A01,083615,Staff,0,16,60,60
1650559485467,COGS 11,A01,083617,Boyle; Mary E. T.,19,0,40,21
1650559491495,COGS 13,A01,083071,Staff,0,35,40,40
1650559497520,COGS 14A,A01,092681,Staff,0,27,100,100
1650559503542,COGS 14B,A01,083073,Cheng; Tzu-Han,0,12,50,50
1650559509567,COGS 17,A01,092677,Staff,19,0,75,56
1650559515591,COGS 100,A01,083619,Staff,0,26,60,60
1650559521614,COGS 101A,A01,083621,Davis; Joshua Daniel,0,26,60,60
1650559527641,COGS 101B,A01,091572,Staff,1,5,60,59
1650559533665,COGS 101C,A01,083625,Delgado; Tania,15,0,30,15
1650559539689,COGS 107A,A01,083627,Boyle; Mary E. T.,0,11,60,60
1650559545712,COGS 118A,A01,083075,Staff,0,3,60,60
1650559551740,CSE 3,A50,083646,Miranda; Gregory Joseph,20,0,38,18
1650559551740,CSE 3,A51,083647,Miranda; Gregory Joseph,36,0,37,1
1650559557774,CSE 8A,A50,083650,Miranda; Gregory Joseph,0,29,40,40
1650559563808,CSE 11,A01,083080,Cao; Yingjun,0,94,40,40
1650559569840,CSE 12,A01,083652,Staff,0,18,100,100
1650559575866,CSE 15L,A01,083654,Staff,0,1,50,50
1650559575866,CSE 15L,A02,083655,Staff,0,1,50,50
1650559581898,CSE 20,A01,083657,Staff,51,0,80,29
1650559587930,CSE 30,A01,083084,Eldon; John,0,77,40,40
1650559593956,CSE 100,A01,083659,Cao; Yingjun,0,66,50,50
1650559599983,CSE 134B,A01,083661,Powell; Thomas Allan,0,34,65,65
1650559606006,CSE 140,A01,083663,Staff,0,5,75,75
1650559612029,CSE 140L,A01,083088,Eldon; John,0,11,75,75
1650559618054,CSE 175,A01,083665,Kumar; Rakesh,7,0,25,18
1650559624078,CSE 190,A00,092507,Dubnov; Shlomo,10,0,20,10
1650559630104,ECE 45,A01,083139,Staff,0,1,60,60
1650559636133,ECE 65,A50,083695,Staff,0,6,30,30
1650559642158,ECE 109,A01,091882,Touri; Behrouz,33,0,70,37
1650559648190,ECE 180,A00,083140,Abi Samra; Nicholas Camill,21,0,30,9
1650559648190,ECE 180,B00,083141,Abi Samra; Nicholas Camill,0,0,30,30
1650559654218,MATH 10A,A01,083735,Patchell; Gregory David,5,0,30,25
1650559654218,MATH 10A,A02,083736,Patchell; Gregory David,27,0,30,3
1650559654218,MATH 10A,A03,083737,Patchell; Gregory David,24,0,30,6
1650559660258,MATH 10B,A01,083207,Staff,0,9,30,30
1650559660258,MATH 10B,A02,083208,Staff,0,8,30,30
1650559660258,MATH 10B,B01,083739,Staff,12,0,30,18
1650559660258,MATH 10B,B02,083740,Staff,28,0,30,2
1650559666288,MATH 18,A01,083743,Staff,1,0,30,29
1650559666288,MATH 18,A02,083744,Staff,26,0,30,4
1650559666288,MATH 18,A03,083745,Staff,22,0,30,8
1650559666288,MATH 18,A04,083746,Staff,26,0,30,4
1650559666288,MATH 18,B01,083748,Staff,0,13,30,30
1650559666288,MATH 18,B02,083749,Staff,0,12,30,30
1650559666288,MATH 18,B03,083750,Staff,0,11,30,30
1650559666288,MATH 18,B04,083751,Staff,0,12,30,30
1650559672312,MATH 20A,A01,083754,Staff,21,0,40,19
1650559678348,MATH 20B,A01,083756,Staff,0,11,30,30
1650559678348,MATH 20B,A02,083757,Staff,0,12,30,30
1650559684377,MATH 20C,A01,083760,Staff,0,16,30,30
1650559684377,MATH 20C,A02,083761,Staff,2,14,30,28
1650559684377,MATH 20C,B01,083762,Staff,12,0,30,18
1650559684377,MATH 20C,B02,083763,Staff,28,0,30,2
1650559690402,MATH 20D,A01,083765,Staff,0,1,30,30
1650559690402,MATH 20D,A02,083766,Staff,7,0,30,23
1650559690402,MATH 20D,A03,083767,Staff,25,0,30,5
1650559696434,MATH 20E,A01,083771,Staff,6,0,30,24
1650559696434,MATH 20E,A02,083772,Staff,18,0,30,12
1650559696434,MATH 20E,B01,083773,Staff,0,0,30,30
1650559696434,MATH 20E,B02,083774,Staff,10,0,30,20
1650559702457,MATH 103A,A01,083777,Staff,0,15,30,30
1650559702457,MATH 103A,A02,083778,Staff,0,14,30,30
1650559702457,MATH 103A,B01,083779,Staff,0,13,30,30
1650559702457,MATH 103A,B02,083780,Staff,0,13,30,30
1650559708496,MATH 105,A01,085443,Staff,0,21,30,30
1650559714524,MATH 109,A01,083213,Anzaldo; Leesa B,0,8,30,30
1650559714524,MATH 109,A02,083214,Anzaldo; Leesa B,0,7,30,30
1650559714524,MATH 109,B01,083215,Anzaldo; Leesa B,0,5,30,30
1650559714524,MATH 109,B02,083216,Anzaldo; Leesa B,0,6,30,30
1650559720554,MATH 142A,A01,083219,Chow; Bennett,0,16,30,30
1650559720554,MATH 142A,A02,083220,Chow; Bennett,0,14,30,30
1650559720554,MATH 142A,B01,083221,Chow; Bennett,0,13,30,30
1650559720554,MATH 142A,B02,083222,Chow; Bennett,0,13,30,30
1650559726577,MATH 193A,A01,083224,Staff,1,6,30,29
1650559726577,MATH 193A,A02,083225,Staff,0,5,30,30
1650559726577,MATH 193A,A03,083781,Staff,0,5,30,30
1650559726577,MATH 193A,A04,083782,Staff,0,7,30,30
1650559732610,MATH 197,001,091859,McAuley; Julian John,9998,0,9999,1
1650559738676,COGS 9,A01,083615,Staff,0,16,60,60
1650559744718,COGS 11,A01,083617,Boyle; Mary E. T.,19,0,40,21
1650559750742,COGS 13,A01,083071,Staff,0,35,40,40
1650559756767,COGS 14A,A01,092681,Staff,0,27,100,100
1650559762791,COGS 14B,A01,083073,Cheng; Tzu-Han,0,12,50,50
1650559768814,COGS 17,A01,092677,Staff,19,0,75,56
1650559774838,COGS 100,A01,083619,Staff,0,26,60,60
1650559780865,COGS 101A,A01,083621,Davis; Joshua Daniel,0,26,60,60
1650559786892,COGS 101B,A01,091572,Staff,1,5,60,59
1650559792926,COGS 101C,A01,083625,Delgado; Tania,15,0,30,15
1650559798951,COGS 107A,A01,083627,Boyle; Mary E. T.,0,11,60,60
1650559804977,COGS 118A,A01,083075,Staff,0,3,60,60
1650559811005,CSE 3,A50,083646,Miranda; Gregory Joseph,20,0,38,18
1650559811005,CSE 3,A51,083647,Miranda; Gregory Joseph,36,0,37,1
1650559817035,CSE 8A,A50,083650,Miranda; Gregory Joseph,0,29,40,40
1650559823067,CSE 11,A01,083080,Cao; Yingjun,0,94,40,40
1650559829091,CSE 12,A01,083652,Staff,0,18,100,100
1650559835114,CSE 15L,A01,083654,Staff,0,1,50,50
1650559835114,CSE 15L,A02,083655,Staff,0,1,50,50
1650559841140,CSE 20,A01,083657,Staff,51,0,80,29
1650559847164,CSE 30,A01,083084,Eldon; John,0,77,40,40
1650559853210,CSE 100,A01,083659,Cao; Yingjun,0,66,50,50
1650559859238,CSE 134B,A01,083661,Powell; Thomas Allan,0,34,65,65
1650559865277,CSE 140,A01,083663,Staff,0,5,75,75
1650559871302,CSE 140L,A01,083088,Eldon; John,0,11,75,75
1650559877325,CSE 175,A01,083665,Kumar; Rakesh,7,0,25,18
1650559883349,CSE 190,A00,092507,Dubnov; Shlomo,10,0,20,10
1650559889376,ECE 45,A01,083139,Staff,0,1,60,60
1650559895402,ECE 65,A50,083695,Staff,0,6,30,30
1650559901442,ECE 109,A01,091882,Touri; Behrouz,33,0,70,37
1650559907474,ECE 180,A00,083140,Abi Samra; Nicholas Camill,21,0,30,9
1650559907474,ECE 180,B00,083141,Abi Samra; Nicholas Camill,0,0,30,30
1650559913520,MATH 10A,A01,083735,Patchell; Gregory David,5,0,30,25
1650559913520,MATH 10A,A02,083736,Patchell; Gregory David,27,0,30,3
1650559913520,MATH 10A,A03,083737,Patchell; Gregory David,24,0,30,6
1650559919560,MATH 10B,A01,083207,Staff,0,9,30,30
1650559919560,MATH 10B,A02,083208,Staff,0,8,30,30
1650559919560,MATH 10B,B01,083739,Staff,12,0,30,18
1650559919560,MATH 10B,B02,083740,Staff,28,0,30,2
1650559925601,MATH 18,A01,083743,Staff,1,0,30,29
1650559925601,MATH 18,A02,083744,Staff,26,0,30,4
1650559925601,MATH 18,A03,083745,Staff,22,0,30,8
1650559925601,MATH 18,A04,083746,Staff,26,0,30,4
1650559925601,MATH 18,B01,083748,Staff,0,13,30,30
1650559925601,MATH 18,B02,083749,Staff,0,12,30,30
1650559925601,MATH 18,B03,083750,Staff,0,11,30,30
1650559925601,MATH 18,B04,083751,Staff,0,12,30,30
1650559931624,MATH 20A,A01,083754,Staff,21,0,40,19
1650559937648,MATH 20B,A01,083756,Staff,0,11,30,30
1650559937648,MATH 20B,A02,083757,Staff,0,12,30,30
1650559943688,MATH 20C,A01,083760,Staff,0,16,30,30
1650559943688,MATH 20C,A02,083761,Staff,2,14,30,28
1650559943688,MATH 20C,B01,083762,Staff,12,0,30,18
1650559943688,MATH 20C,B02,083763,Staff,28,0,30,2
1650559949716,MATH 20D,A01,083765,Staff,0,1,30,30
1650559949716,MATH 20D,A02,083766,Staff,7,0,30,23
1650559949716,MATH 20D,A03,083767,Staff,25,0,30,5
1650559955745,MATH 20E,A01,083771,Staff,6,0,30,24
1650559955745,MATH 20E,A02,083772,Staff,18,0,30,12
1650559955745,MATH 20E,B01,083773,Staff,0,0,30,30
1650559955745,MATH 20E,B02,083774,Staff,10,0,30,20
1650559961774,MATH 103A,A01,083777,Staff,0,15,30,30
1650559961774,MATH 103A,A02,083778,Staff,0,14,30,30
1650559961774,MATH 103A,B01,083779,Staff,0,13,30,30
1650559961774,MATH 103A,B02,083780,Staff,0,13,30,30
1650559967797,MATH 105,A01,085443,Staff,0,21,30,30
1650559973826,MATH 109,A01,083213,Anzaldo; Leesa B,0,8,30,30
1650559973826,MATH 109,A02,083214,Anzaldo; Leesa B,0,7,30,30
1650559973826,MATH 109,B01,083215,Anzaldo; Leesa B,0,5,30,30
1650559973826,MATH 109,B02,083216,Anzaldo; Leesa B,0,6,30,30
1650559979851,MATH 142A,A01,083219,Chow; Bennett,0,16,30,30
1650559979851,MATH 142A,A02,083220,Chow; Bennett,0,14,30,30
1650559979851,MATH 142A,B01,083221,Chow; Bennett,0,13,30,30
1650559979851,MATH 142A,B02,083222,Chow; Bennett,0,13,30,30
1650559985889,MATH 193A,A01,083224,Staff,1,6,30,29
1650559985889,MATH 193A,A02,083225,Staff,0,5,30,30
1650559985889,MATH 193A,A03,083781,Staff,0,6,30,30
1650559985889,MATH 193A,A04,083782,Staff,0,7,30,30
1650559992026,MATH 197,001,091859,McAuley; Julian John,9998,0,9999,1
1650559998114,COGS 9,A01,083615,Staff,0,16,60,60
1650560004154,COGS 11,A01,083617,Boyle; Mary E. T.,19,0,40,21
1650560010182,COGS 13,A01,083071,Staff,0,35,40,40
1650560016219,COGS 14A,A01,092681,Staff,0,27,100,100
1650560022244,COGS 14B,A01,083073,Cheng; Tzu-Han,0,12,50,50
1650560028269,COGS 17,A01,092677,Staff,19,0,75,56
1650560034295,COGS 100,A01,083619,Staff,0,26,60,60
1650560040336,COGS 101A,A01,083621,Davis; Joshua Daniel,0,26,60,60
1650560046360,COGS 101B,A01,091572,Staff,1,5,60,59
1650560052384,COGS 101C,A01,083625,Delgado; Tania,15,0,30,15
1650560058411,COGS 107A,A01,083627,Boyle; Mary E. T.,0,11,60,60
1650560064440,COGS 118A,A01,083075,Staff,0,3,60,60
1650560070467,CSE 3,A50,083646,Miranda; Gregory Joseph,20,0,38,18
1650560070467,CSE 3,A51,083647,Miranda; Gregory Joseph,36,0,37,1
1650560076492,CSE 8A,A50,083650,Miranda; Gregory Joseph,0,29,40,40
1650560082519,CSE 11,A01,083080,Cao; Yingjun,0,94,40,40
1650560088549,CSE 12,A01,083652,Staff,0,18,100,100
1650560094586,CSE 15L,A01,083654,Staff,0,1,50,50
1650560094586,CSE 15L,A02,083655,Staff,0,1,50,50
1650560100610,CSE 20,A01,083657,Staff,51,0,80,29
1650560106634,CSE 30,A01,083084,Eldon; John,0,77,40,40
1650560112669,CSE 100,A01,083659,Cao; Yingjun,0,66,50,50
1650560118694,CSE 134B,A01,083661,Powell; Thomas Allan,0,34,65,65
1650560124731,CSE 140,A01,083663,Staff,0,5,75,75
1650560130765,CSE 140L,A01,083088,Eldon; John,0,11,75,75
1650560136787,CSE 175,A01,083665,Kumar; Rakesh,7,0,25,18
1650560142810,CSE 190,A00,092507,Dubnov; Shlomo,10,0,20,10
1650560148835,ECE 45,A01,083139,Staff,0,1,60,60
1650560154860,ECE 65,A50,083695,Staff,0,6,30,30
1650560160884,ECE 109,A01,091882,Touri; Behrouz,33,0,70,37
1650560166911,ECE 180,A00,083140,Abi Samra; Nicholas Camill,21,0,30,9
1650560166911,ECE 180,B00,083141,Abi Samra; Nicholas Camill,0,0,30,30
1650560172946,MATH 10A,A01,083735,Patchell; Gregory David,5,0,30,25
1650560172946,MATH 10A,A02,083736,Patchell; Gregory David,27,0,30,3
1650560172946,MATH 10A,A03,083737,Patchell; Gregory David,24,0,30,6
1650560178976,MATH 10B,A01,083207,Staff,0,9,30,30
1650560178976,MATH 10B,A02,083208,Staff,0,8,30,30
1650560178976,MATH 10B,B01,083739,Staff,12,0,30,18
1650560178976,MATH 10B,B02,083740,Staff,28,0,30,2
1650560185008,MATH 18,A01,083743,Staff,1,0,30,29
1650560185008,MATH 18,A02,083744,Staff,26,0,30,4
1650560185008,MATH 18,A03,083745,Staff,22,0,30,8
1650560185008,MATH 18,A04,083746,Staff,26,0,30,4
1650560185008,MATH 18,B01,083748,Staff,0,13,30,30
1650560185008,MATH 18,B02,083749,Staff,0,12,30,30
1650560185008,MATH 18,B03,083750,Staff,0,11,30,30
1650560185008,MATH 18,B04,083751,Staff,0,12,30,30
1650560191030,MATH 20A,A01,083754,Staff,21,0,40,19
1650560197054,MATH 20B,A01,083756,Staff,0,11,30,30
1650560197054,MATH 20B,A02,083757,Staff,0,12,30,30
1650560203079,MATH 20C,A01,083760,Staff,0,16,30,30
1650560203079,MATH 20C,A02,083761,Staff,2,14,30,28
1650560203079,MATH 20C,B01,083762,Staff,12,0,30,18
1650560203079,MATH 20C,B02,083763,Staff,28,0,30,2
1650560209103,MATH 20D,A01,083765,Staff,0,1,30,30
1650560209103,MATH 20D,A02,083766,Staff,7,0,30,23
1650560209103,MATH 20D,A03,083767,Staff,25,0,30,5
1650560215130,MATH 20E,A01,083771,Staff,6,0,30,24
1650560215130,MATH 20E,A02,083772,Staff,18,0,30,12
1650560215130,MATH 20E,B01,083773,Staff,0,0,30,30
1650560215130,MATH 20E,B02,083774,Staff,10,0,30,20
1650560221155,MATH 103A,A01,083777,Staff,0,15,30,30
1650560221155,MATH 103A,A02,083778,Staff,0,14,30,30
1650560221155,MATH 103A,B01,083779,Staff,0,13,30,30
1650560221155,MATH 103A,B02,083780,Staff,0,13,30,30
1650560227178,MATH 105,A01,085443,Staff,0,21,30,30
1650560233212,MATH 109,A01,083213,Anzaldo; Leesa B,0,8,30,30
1650560233212,MATH 109,A02,083214,Anzaldo; Leesa B,0,7,30,30
1650560233212,MATH 109,B01,083215,Anzaldo; Leesa B,0,5,30,30
1650560233212,MATH 109,B02,083216,Anzaldo; Leesa B,0,6,30,30
1650560239237,MATH 142A,A01,083219,Chow; Bennett,0,16,30,30
1650560239237,MATH 142A,A02,083220,Chow; Bennett,0,14,30,30
1650560239237,MATH 142A,B01,083221,Chow; Bennett,0,13,30,30
1650560239237,MATH 142A,B02,083222,Chow; Bennett,0,13,30,30
1650560245262,MATH 193A,A01,083224,Staff,1,6,30,29
1650560245262,MATH 193A,A02,083225,Staff,0,5,30,30
1650560245262,MATH 193A,A03,083781,Staff,0,6,30,30
1650560245262,MATH 193A,A04,083782,Staff,0,7,30,30
1650560251289,MATH 197,001,091859,McAuley; Julian John,9998,0,9999,1
1650560257381,COGS 9,A01,083615,Staff,0,16,60,60
1650560263405,COGS 11,A01,083617,Boyle; Mary E. T.,19,0,40,21
1650560269442,COGS 13,A01,083071,Staff,0,35,40,40
1650560275464,COGS 14A,A01,092681,Staff,0,27,100,100
1650560281495,COGS 14B,A01,083073,Cheng; Tzu-Han,0,12,50,50
1650560287521,COGS 17,A01,092677,Staff,19,0,75,56
1650560293548,COGS 100,A01,083619,Staff,0,26,60,60
1650560299579,COGS 101A,A01,083621,Davis; Joshua Daniel,0,26,60,60
1650560305613,COGS 101B,A01,091572,Staff,1,5,60,59
1650560311643,COGS 101C,A01,083625,Delgado; Tania,15,0,30,15
1650560317667,COGS 107A,A01,083627,Boyle; Mary E. T.,0,11,60,60
1650560323690,COGS 118A,A01,083075,Staff,0,3,60,60
1650560329733,CSE 3,A50,083646,Miranda; Gregory Joseph,20,0,38,18
1650560329733,CSE 3,A51,083647,Miranda; Gregory Joseph,36,0,37,1
1650560335758,CSE 8A,A50,083650,Miranda; Gregory Joseph,0,29,40,40
1650560341793,CSE 11,A01,083080,Cao; Yingjun,0,94,40,40
1650560347820,CSE 12,A01,083652,Staff,0,18,100,100
1650560353844,CSE 15L,A01,083654,Staff,0,1,50,50
1650560353844,CSE 15L,A02,083655,Staff,0,1,50,50
1650560359875,CSE 20,A01,083657,Staff,51,0,80,29
1650560365902,CSE 30,A01,083084,Eldon; John,0,77,40,40
1650560371934,CSE 100,A01,083659,Cao; Yingjun,0,66,50,50
1650560377961,CSE 134B,A01,083661,Powell; Thomas Allan,0,34,65,65
1650560383986,CSE 140,A01,083663,Staff,0,5,75,75
1650560390009,CSE 140L,A01,083088,Eldon; John,0,11,75,75
1650560396032,CSE 175,A01,083665,Kumar; Rakesh,7,0,25,18
1650560402057,CSE 190,A00,092507,Dubnov; Shlomo,10,0,20,10
1650560408080,ECE 45,A01,083139,Staff,0,1,60,60
1650560414104,ECE 65,A50,083695,Staff,0,6,30,30
1650560420129,ECE 109,A01,091882,Touri; Behrouz,33,0,70,37
1650560426158,ECE 180,A00,083140,Abi Samra; Nicholas Camill,21,0,30,9
1650560426158,ECE 180,B00,083141,Abi Samra; Nicholas Camill,0,0,30,30
1650560432183,MATH 10A,A01,083735,Patchell; Gregory David,5,0,30,25
1650560432183,MATH 10A,A02,083736,Patchell; Gregory David,27,0,30,3
1650560432183,MATH 10A,A03,083737,Patchell; Gregory David,24,0,30,6
1650560438224,MATH 10B,A01,083207,Staff,0,9,30,30
1650560438224,MATH 10B,A02,083208,Staff,0,8,30,30
1650560438224,MATH 10B,B01,083739,Staff,12,0,30,18
1650560438224,MATH 10B,B02,083740,Staff,28,0,30,2
1650560444254,MATH 18,A01,083743,Staff,1,0,30,29
1650560444254,MATH 18,A02,083744,Staff,26,0,30,4
1650560444254,MATH 18,A03,083745,Staff,22,0,30,8
1650560444254,MATH 18,A04,083746,Staff,26,0,30,4
1650560444254,MATH 18,B01,083748,Staff,0,13,30,30
1650560444254,MATH 18,B02,083749,Staff,0,12,30,30
1650560444254,MATH 18,B03,083750,Staff,0,11,30,30
1650560444254,MATH 18,B04,083751,Staff,0,12,30,30
1650560450279,MATH 20A,A01,083754,Staff,21,0,40,19
1650560456308,MATH 20B,A01,083756,Staff,0,11,30,30
1650560456308,MATH 20B,A02,083757,Staff,0,12,30,30
1650560462332,MATH 20C,A01,083760,Staff,0,16,30,30
1650560462332,MATH 20C,A02,083761,Staff,2,14,30,28
1650560462332,MATH 20C,B01,083762,Staff,12,0,30,18
1650560462332,MATH 20C,B02,083763,Staff,28,0,30,2
1650560468359,MATH 20D,A01,083765,Staff,0,1,30,30
1650560468359,MATH 20D,A02,083766,Staff,7,0,30,23
1650560468359,MATH 20D,A03,083767,Staff,25,0,30,5
1650560474383,MATH 20E,A01,083771,Staff,6,0,30,24
1650560474383,MATH 20E,A02,083772,Staff,18,0,30,12
1650560474383,MATH 20E,B01,083773,Staff,0,0,30,30
1650560474383,MATH 20E,B02,083774,Staff,10,0,30,20
1650560480413,MATH 103A,A01,083777,Staff,0,15,30,30
1650560480413,MATH 103A,A02,083778,Staff,0,14,30,30
1650560480413,MATH 103A,B01,083779,Staff,0,13,30,30
1650560480413,MATH 103A,B02,083780,Staff,0,13,30,30
1650560486449,MATH 105,A01,085443,Staff,0,21,30,30
1650560492473,MATH 109,A01,083213,Anzaldo; Leesa B,0,8,30,30
1650560492473,MATH 109,A02,083214,Anzaldo; Leesa B,0,7,30,30
1650560492473,MATH 109,B01,083215,Anzaldo; Leesa B,0,5,30,30
1650560492473,MATH 109,B02,083216,Anzaldo; Leesa B,0,6,30,30
1650560498519,MATH 142A,A01,083219,Chow; Bennett,0,16,30,30
1650560498519,MATH 142A,A02,083220,Chow; Bennett,0,14,30,30
1650560498519,MATH 142A,B01,083221,Chow; Bennett,0,13,30,30
1650560498519,MATH 142A,B02,083222,Chow; Bennett,0,13,30,30
1650560504554,MATH 193A,A01,083224,Staff,1,6,30,29
1650560504554,MATH 193A,A02,083225,Staff,0,5,30,30
1650560504554,MATH 193A,A03,083781,Staff,0,6,30,30
1650560504554,MATH 193A,A04,083782,Staff,0,7,30,30
1650560510585,MATH 197,001,091859,McAuley; Julian John,9998,0,9999,1
1650560516650,COGS 9,A01,083615,Staff,0,16,60,60
1650560522674,COGS 11,A01,083617,Boyle; Mary E. T.,19,0,40,21
1650560528699,COGS 13,A01,083071,Staff,0,35,40,40
1650560534731,COGS 14A,A01,092681,Staff,0,27,100,100
1650560540759,COGS 14B,A01,083073,Cheng; Tzu-Han,0,12,50,50
1650560546785,COGS 17,A01,092677,Staff,19,0,75,56
1650560552819,COGS 100,A01,083619,Staff,0,26,60,60
1650560558850,COGS 101A,A01,083621,Davis; Joshua Daniel,0,26,60,60
1650560564873,COGS 101B,A01,091572,Staff,1,5,60,59
1650560570898,COGS 101C,A01,083625,Delgado; Tania,15,0,30,15
1650560576928,COGS 107A,A01,083627,Boyle; Mary E. T.,0,11,60,60
1650560583045,COGS 118A,A01,083075,Staff,0,3,60,60
1650560589076,CSE 3,A50,083646,Miranda; Gregory Joseph,20,0,38,18
1650560589076,CSE 3,A51,083647,Miranda; Gregory Joseph,36,0,37,1
1650560595103,CSE 8A,A50,083650,Miranda; Gregory Joseph,0,29,40,40
1650560601144,CSE 11,A01,083080,Cao; Yingjun,0,94,40,40
1650560607169,CSE 12,A01,083652,Staff,0,18,100,100
1650560613193,CSE 15L,A01,083654,Staff,0,1,50,50
1650560613193,CSE 15L,A02,083655,Staff,0,1,50,50
1650560619225,CSE 20,A01,083657,Staff,51,0,80,29
1650560625249,CSE 30,A01,083084,Eldon; John,0,77,40,40
1650560631275,CSE 100,A01,083659,Cao; Yingjun,0,66,50,50
1650560637311,CSE 134B,A01,083661,Powell; Thomas Allan,0,34,65,65
1650560643335,CSE 140,A01,083663,Staff,0,5,75,75
1650560649366,CSE 140L,A01,083088,Eldon; John,0,11,75,75
1650560655390,CSE 175,A01,083665,Kumar; Rakesh,7,0,25,18
1650560661425,CSE 190,A00,092507,Dubnov; Shlomo,10,0,20,10
1650560667454,ECE 45,A01,083139,Staff,0,1,60,60
1650560673478,ECE 65,A50,083695,Staff,0,6,30,30
1650560679509,ECE 109,A01,091882,Touri; Behrouz,33,0,70,37
1650560685532,ECE 180,A00,083140,Abi Samra; Nicholas Camill,21,0,30,9
1650560685532,ECE 180,B00,083141,Abi Samra; Nicholas Camill,0,0,30,30
1650560691565,MATH 10A,A01,083735,Patchell; Gregory David,5,0,30,25
1650560691565,MATH 10A,A02,083736,Patchell; Gregory David,27,0,30,3
1650560691565,MATH 10A,A03,083737,Patchell; Gregory David,24,0,30,6
1650560697587,MATH 10B,A01,083207,Staff,0,9,30,30
1650560697587,MATH 10B,A02,083208,Staff,0,8,30,30
1650560697587,MATH 10B,B01,083739,Staff,12,0,30,18
1650560697587,MATH 10B,B02,083740,Staff,28,0,30,2
1650560703613,MATH 18,A01,083743,Staff,1,0,30,29
1650560703613,MATH 18,A02,083744,Staff,26,0,30,4
1650560703613,MATH 18,A03,083745,Staff,22,0,30,8
1650560703613,MATH 18,A04,083746,Staff,26,0,30,4
1650560703613,MATH 18,B01,083748,Staff,0,13,30,30
1650560703613,MATH 18,B02,083749,Staff,0,12,30,30
1650560703613,MATH 18,B03,083750,Staff,0,11,30,30
1650560703613,MATH 18,B04,083751,Staff,0,12,30,30
1650560709643,MATH 20A,A01,083754,Staff,21,0,40,19
1650560715669,MATH 20B,A01,083756,Staff,0,11,30,30
1650560715669,MATH 20B,A02,083757,Staff,0,12,30,30
1650560721700,MATH 20C,A01,083760,Staff,0,16,30,30
1650560721700,MATH 20C,A02,083761,Staff,2,14,30,28
1650560721700,MATH 20C,B01,083762,Staff,12,0,30,18
1650560721700,MATH 20C,B02,083763,Staff,28,0,30,2
1650560727725,MATH 20D,A01,083765,Staff,0,1,30,30
1650560727725,MATH 20D,A02,083766,Staff,6,0,30,24
1650560727725,MATH 20D,A03,083767,Staff,25,0,30,5
1650560733748,MATH 20E,A01,083771,Staff,6,0,30,24
1650560733748,MATH 20E,A02,083772,Staff,18,0,30,12
1650560733748,MATH 20E,B01,083773,Staff,0,0,30,30
1650560733748,MATH 20E,B02,083774,Staff,10,0,30,20
1650560739772,MATH 103A,A01,083777,Staff,0,15,30,30
1650560739772,MATH 103A,A02,083778,Staff,0,14,30,30
1650560739772,MATH 103A,B01,083779,Staff,0,13,30,30
1650560739772,MATH 103A,B02,083780,Staff,0,13,30,30
1650560745809,MATH 105,A01,085443,Staff,0,21,30,30
1650560751844,MATH 109,A01,083213,Anzaldo; Leesa B,0,8,30,30
1650560751844,MATH 109,A02,083214,Anzaldo; Leesa B,0,7,30,30
1650560751844,MATH 109,B01,083215,Anzaldo; Leesa B,0,5,30,30
1650560751844,MATH 109,B02,083216,Anzaldo; Leesa B,0,6,30,30
1650560757873,MATH 142A,A01,083219,Chow; Bennett,0,16,30,30
1650560757873,MATH 142A,A02,083220,Chow; Bennett,0,14,30,30
1650560757873,MATH 142A,B01,083221,Chow; Bennett,0,13,30,30
1650560757873,MATH 142A,B02,083222,Chow; Bennett,0,13,30,30
1650560763897,MATH 193A,A01,083224,Staff,1,6,30,29
1650560763897,MATH 193A,A02,083225,Staff,0,5,30,30
1650560763897,MATH 193A,A03,083781,Staff,0,6,30,30
1650560763897,MATH 193A,A04,083782,Staff,0,7,30,30
1650560769921,MATH 197,001,091859,McAuley; Julian John,9998,0,9999,1
1650560775979,COGS 9,A01,083615,Staff,0,16,60,60
1650560782011,COGS 11,A01,083617,Boyle; Mary E. T.,19,0,40,21
1650560788036,COGS 13,A01,083071,Staff,0,35,40,40
1650560794059,COGS 14A,A01,092681,Staff,0,27,100,100
1650560800086,COGS 14B,A01,083073,Cheng; Tzu-Han,0,12,50,50
1650560806109,COGS 17,A01,092677,Staff,19,0,75,56
1650560812133,COGS 100,A01,083619,Staff,0,26,60,60
1650560818161,COGS 101A,A01,083621,Davis; Joshua Daniel,0,26,60,60
1650560824195,COGS 101B,A01,091572,Staff,1,5,60,59
1650560830223,COGS 101C,A01,083625,Delgado; Tania,15,0,30,15
1650560836246,COGS 107A,A01,083627,Boyle; Mary E. T.,0,11,60,60
1650560842269,COGS 118A,A01,083075,Staff,0,3,60,60
1650560848296,CSE 3,A50,083646,Miranda; Gregory Joseph,20,0,38,18
1650560848296,CSE 3,A51,083647,Miranda; Gregory Joseph,36,0,37,1
1650560854319,CSE 8A,A50,083650,Miranda; Gregory Joseph,0,29,40,40
1650560860343,CSE 11,A01,083080,Cao; Yingjun,0,94,40,40
1650560866370,CSE 12,A01,083652,Staff,0,18,100,100
1650560872399,CSE 15L,A01,083654,Staff,0,1,50,50
1650560872399,CSE 15L,A02,083655,Staff,0,1,50,50
1650560878434,CSE 20,A01,083657,Staff,51,0,80,29
1650560884458,CSE 30,A01,083084,Eldon; John,0,77,40,40
1650560890486,CSE 100,A01,083659,Cao; Yingjun,0,66,50,50
1650560896510,CSE 134B,A01,083661,Powell; Thomas Allan,0,34,65,65
1650560902533,CSE 140,A01,083663,Staff,0,5,75,75
1650560908559,CSE 140L,A01,083088,Eldon; John,0,11,75,75
1650560914583,CSE 175,A01,083665,Kumar; Rakesh,7,0,25,18
1650560920617,CSE 190,A00,092507,Dubnov; Shlomo,10,0,20,10
1650560926640,ECE 45,A01,083139,Staff,0,1,60,60
1650560932667,ECE 65,A50,083695,Staff,0,6,30,30
1650560938690,ECE 109,A01,091882,Touri; Behrouz,33,0,70,37
1650560944717,ECE 180,A00,083140,Abi Samra; Nicholas Camill,21,0,30,9
1650560944717,ECE 180,B00,083141,Abi Samra; Nicholas Camill,0,0,30,30
1650560950743,MATH 10A,A01,083735,Patchell; Gregory David,5,0,30,25
1650560950743,MATH 10A,A02,083736,Patchell; Gregory David,27,0,30,3
1650560950743,MATH 10A,A03,083737,Patchell; Gregory David,24,0,30,6
1650560956769,MATH 10B,A01,083207,Staff,0,9,30,30
1650560956769,MATH 10B,A02,083208,Staff,0,8,30,30
1650560956769,MATH 10B,B01,083739,Staff,12,0,30,18
1650560956769,MATH 10B,B02,083740,Staff,28,0,30,2
1650560962800,MATH 18,A01,083743,Staff,1,0,30,29
1650560962800,MATH 18,A02,083744,Staff,26,0,30,4
1650560962800,MATH 18,A03,083745,Staff,22,0,30,8
1650560962800,MATH 18,A04,083746,Staff,26,0,30,4
1650560962800,MATH 18,B01,083748,Staff,0,13,30,30
1650560962800,MATH 18,B02,083749,Staff,0,12,30,30
1650560962800,MATH 18,B03,083750,Staff,0,11,30,30
1650560962800,MATH 18,B04,083751,Staff,0,12,30,30
1650560968828,MATH 20A,A01,083754,Staff,21,0,40,19
1650560974869,MATH 20B,A01,083756,Staff,0,11,30,30
1650560974869,MATH 20B,A02,083757,Staff,0,12,30,30
1650560980898,MATH 20C,A01,083760,Staff,0,16,30,30
1650560980898,MATH 20C,A02,083761,Staff,2,14,30,28
1650560980898,MATH 20C,B01,083762,Staff,12,0,30,18
1650560980898,MATH 20C,B02,083763,Staff,28,0,30,2
1650560986921,MATH 20D,A01,083765,Staff,0,1,30,30
1650560986921,MATH 20D,A02,083766,Staff,6,0,30,24
1650560986921,MATH 20D,A03,083767,Staff,25,0,30,5
1650560992945,MATH 20E,A01,083771,Staff,6,0,30,24
1650560992945,MATH 20E,A02,083772,Staff,18,0,30,12
1650560992945,MATH 20E,B01,083773,Staff,0,0,30,30
1650560992945,MATH 20E,B02,083774,Staff,10,0,30,20
1650560998973,MATH 103A,A01,083777,Staff,0,15,30,30
1650560998973,MATH 103A,A02,083778,Staff,0,14,30,30
1650560998973,MATH 103A,B01,083779,Staff,0,13,30,30
1650560998973,MATH 103A,B02,083780,Staff,0,13,30,30
1650561005006,MATH 105,A01,085443,Staff,0,21,30,30
1650561011033,MATH 109,A01,083213,Anzaldo; Leesa B,0,8,30,30
1650561011033,MATH 109,A02,083214,Anzaldo; Leesa B,0,7,30,30
1650561011033,MATH 109,B01,083215,Anzaldo; Leesa B,0,5,30,30
1650561011033,MATH 109,B02,083216,Anzaldo; Leesa B,0,6,30,30
1650561017061,MATH 142A,A01,083219,Chow; Bennett,0,16,30,30
1650561017061,MATH 142A,A02,083220,Chow; Bennett,0,14,30,30
1650561017061,MATH 142A,B01,083221,Chow; Bennett,0,13,30,30
1650561017061,MATH 142A,B02,083222,Chow; Bennett,0,13,30,30
1650561023085,MATH 193A,A01,083224,Staff,1,6,30,29
1650561023085,MATH 193A,A02,083225,Staff,0,5,30,30
1650561023085,MATH 193A,A03,083781,Staff,0,6,30,30
1650561023085,MATH 193A,A04,083782,Staff,0,7,30,30
1650561029116,MATH 197,001,091859,McAuley; Julian John,9998,0,9999,1
1650561035179,COGS 9,A01,083615,Staff,0,16,60,60
1650561041214,COGS 11,A01,083617,Boyle; Mary E. T.,19,0,40,21
1650561047239,COGS 13,A01,083071,Staff,0,35,40,40
1650561053264,COGS 14A,A01,092681,Staff,0,27,100,100
1650561059290,COGS 14B,A01,083073,Cheng; Tzu-Han,0,12,50,50
1650561065314,COGS 17,A01,092677,Staff,19,0,75,56
1650561071342,COGS 100,A01,083619,Staff,0,26,60,60
1650561077365,COGS 101A,A01,083621,Davis; Joshua Daniel,0,26,60,60
1650561083391,COGS 101B,A01,091572,Staff,1,5,60,59
1650561089419,COGS 101C,A01,083625,Delgado; Tania,15,0,30,15
1650561095451,COGS 107A,A01,083627,Boyle; Mary E. T.,0,11,60,60
1650561101489,COGS 118A,A01,083075,Staff,0,3,60,60
1650561107525,CSE 3,A50,083646,Miranda; Gregory Joseph,20,0,38,18
1650561107525,CSE 3,A51,083647,Miranda; Gregory Joseph,36,0,37,1
1650561113549,CSE 8A,A50,083650,Miranda; Gregory Joseph,0,29,40,40
1650561119576,CSE 11,A01,083080,Cao; Yingjun,0,94,40,40
1650561125602,CSE 12,A01,083652,Staff,0,18,100,100
1650561131626,CSE 15L,A01,083654,Staff,0,1,50,50
1650561131626,CSE 15L,A02,083655,Staff,0,1,50,50
1650561137657,CSE 20,A01,083657,Staff,51,0,80,29
1650561143682,CSE 30,A01,083084,Eldon; John,0,77,40,40
1650561149716,CSE 100,A01,083659,Cao; Yingjun,0,66,50,50
1650561155740,CSE 134B,A01,083661,Powell; Thomas Allan,0,34,65,65
1650561161766,CSE 140,A01,083663,Staff,0,5,75,75
1650561167808,CSE 140L,A01,083088,Eldon; John,0,11,75,75
1650561173834,CSE 175,A01,083665,Kumar; Rakesh,7,0,25,18
1650561179945,CSE 190,A00,092507,Dubnov; Shlomo,10,0,20,10
1650561185969,ECE 45,A01,083139,Staff,0,1,60,60
1650561191994,ECE 65,A50,083695,Staff,0,6,30,30
1650561198017,ECE 109,A01,091882,Touri; Behrouz,33,0,70,37
1650561204049,ECE 180,A00,083140,Abi Samra; Nicholas Camill,21,0,30,9
1650561204049,ECE 180,B00,083141,Abi Samra; Nicholas Camill,0,0,30,30
1650561210076,MATH 10A,A01,083735,Patchell; Gregory David,5,0,30,25
1650561210076,MATH 10A,A02,083736,Patchell; Gregory David,27,0,30,3
1650561210076,MATH 10A,A03,083737,Patchell; Gregory David,24,0,30,6
1650561216100,MATH 10B,A01,083207,Staff,0,9,30,30
1650561216100,MATH 10B,A02,083208,Staff,0,8,30,30
1650561216100,MATH 10B,B01,083739,Staff,12,0,30,18
1650561216100,MATH 10B,B02,083740,Staff,28,0,30,2
1650561222132,MATH 18,A01,083743,Staff,1,0,30,29
1650561222132,MATH 18,A02,083744,Staff,26,0,30,4
1650561222132,MATH 18,A03,083745,Staff,22,0,30,8
1650561222132,MATH 18,A04,083746,Staff,26,0,30,4
1650561222132,MATH 18,B01,083748,Staff,0,13,30,30
1650561222132,MATH 18,B02,083749,Staff,0,12,30,30
1650561222132,MATH 18,B03,083750,Staff,0,11,30,30
1650561222132,MATH 18,B04,083751,Staff,0,12,30,30
1650561228162,MATH 20A,A01,083754,Staff,21,0,40,19
1650561234191,MATH 20B,A01,083756,Staff,0,11,30,30
1650561234191,MATH 20B,A02,083757,Staff,0,12,30,30
1650561240225,MATH 20C,A01,083760,Staff,0,16,30,30
1650561240225,MATH 20C,A02,083761,Staff,2,14,30,28
1650561240225,MATH 20C,B01,083762,Staff,12,0,30,18
1650561240225,MATH 20C,B02,083763,Staff,28,0,30,2
1650561246249,MATH 20D,A01,083765,Staff,0,1,30,30
1650561246249,MATH 20D,A02,083766,Staff,6,0,30,24
1650561246249,MATH 20D,A03,083767,Staff,25,0,30,5
1650561252292,MATH 20E,A01,083771,Staff,6,0,30,24
1650561252292,MATH 20E,A02,083772,Staff,18,0,30,12
1650561252292,MATH 20E,B01,083773,Staff,0,0,30,30
1650561252292,MATH 20E,B02,083774,Staff,10,0,30,20
1650561258320,MATH 103A,A01,083777,Staff,0,15,30,30
1650561258320,MATH 103A,A02,083778,Staff,0,14,30,30
1650561258320,MATH 103A,B01,083779,Staff,0,13,30,30
1650561258320,MATH 103A,B02,083780,Staff,0,13,30,30
1650561264345,MATH 105,A01,085443,Staff,0,21,30,30
1650561270367,MATH 109,A01,083213,Anzaldo; Leesa B,0,8,30,30
1650561270367,MATH 109,A02,083214,Anzaldo; Leesa B,0,7,30,30
1650561270367,MATH 109,B01,083215,Anzaldo; Leesa B,0,5,30,30
1650561270367,MATH 109,B02,083216,Anzaldo; Leesa B,0,6,30,30
1650561276417,MATH 142A,A01,083219,Chow; Bennett,0,16,30,30
1650561276417,MATH 142A,A02,083220,Chow; Bennett,0,14,30,30
1650561276417,MATH 142A,B01,083221,Chow; Bennett,0,13,30,30
1650561276417,MATH 142A,B02,083222,Chow; Bennett,0,13,30,30
1650561282445,MATH 193A,A01,083224,Staff,1,6,30,29
1650561282445,MATH 193A,A02,083225,Staff,0,5,30,30
1650561282445,MATH 193A,A03,083781,Staff,0,6,30,30
1650561282445,MATH 193A,A04,083782,Staff,0,7,30,30
1650561288493,MATH 197,001,091859,McAuley; Julian John,9998,0,9999,1
1650561294553,COGS 9,A01,083615,Staff,0,16,60,60
1650561300587,COGS 11,A01,083617,Boyle; Mary E. T.,19,0,40,21
1650561306611,COGS 13,A01,083071,Staff,0,35,40,40
1650561312635,COGS 14A,A01,092681,Staff,0,27,100,100
1650561318659,COGS 14B,A01,083073,Cheng; Tzu-Han,0,12,50,50
1650561324689,COGS 17,A01,092677,Staff,19,0,75,56
1650561330720,COGS 100,A01,083619,Staff,0,26,60,60
1650561336744,COGS 101A,A01,083621,Davis; Joshua Daniel,0,26,60,60
1650561342780,COGS 101B,A01,091572,Staff,1,5,60,59
1650561348805,COGS 101C,A01,083625,Delgado; Tania,15,0,30,15
1650561354843,COGS 107A,A01,083627,Boyle; Mary E. T.,0,11,60,60
1650561360883,COGS 118A,A01,083075,Staff,0,3,60,60
1650561366912,CSE 3,A50,083646,Miranda; Gregory Joseph,20,0,38,18
1650561366912,CSE 3,A51,083647,Miranda; Gregory Joseph,36,0,37,1
1650561372938,CSE 8A,A50,083650,Miranda; Gregory Joseph,0,29,40,40
1650561378962,CSE 11,A01,083080,Cao; Yingjun,0,94,40,40
1650561384984,CSE 12,A01,083652,Staff,0,18,100,100
1650561391015,CSE 15L,A01,083654,Staff,0,1,50,50
1650561391015,CSE 15L,A02,083655,Staff,0,1,50,50
1650561397042,CSE 20,A01,083657,Staff,51,0,80,29
1650561403065,CSE 30,A01,083084,Eldon; John,0,77,40,40
1650561409095,CSE 100,A01,083659,Cao; Yingjun,0,67,50,50
1650561415118,CSE 134B,A01,083661,Powell; Thomas Allan,0,34,65,65
1650561421141,CSE 140,A01,083663,Staff,0,5,75,75
1650561427167,CSE 140L,A01,083088,Eldon; John,0,11,75,75
1650561433193,CSE 175,A01,083665,Kumar; Rakesh,7,0,25,18
1650561439221,CSE 190,A00,092507,Dubnov; Shlomo,10,0,20,10
1650561445245,ECE 45,A01,083139,Staff,0,1,60,60
1650561451276,ECE 65,A50,083695,Staff,0,6,30,30
1650561457300,ECE 109,A01,091882,Touri; Behrouz,33,0,70,37
1650561463326,ECE 180,A00,083140,Abi Samra; Nicholas Camill,21,0,30,9
1650561463326,ECE 180,B00,083141,Abi Samra; Nicholas Camill,0,0,30,30
1650561469359,MATH 10A,A01,083735,Patchell; Gregory David,5,0,30,25
1650561469359,MATH 10A,A02,083736,Patchell; Gregory David,27,0,30,3
1650561469359,MATH 10A,A03,083737,Patchell; Gregory David,24,0,30,6
1650561475382,MATH 10B,A01,083207,Staff,0,9,30,30
1650561475382,MATH 10B,A02,083208,Staff,0,8,30,30
1650561475382,MATH 10B,B01,083739,Staff,12,0,30,18
1650561475382,MATH 10B,B02,083740,Staff,28,0,30,2
1650561481411,MATH 18,A01,083743,Staff,1,0,30,29
1650561481411,MATH 18,A02,083744,Staff,26,0,30,4
1650561481411,MATH 18,A03,083745,Staff,22,0,30,8
1650561481411,MATH 18,A04,083746,Staff,26,0,30,4
1650561481411,MATH 18,B01,083748,Staff,0,13,30,30
1650561481411,MATH 18,B02,083749,Staff,0,12,30,30
1650561481411,MATH 18,B03,083750,Staff,0,11,30,30
1650561481411,MATH 18,B04,083751,Staff,0,12,30,30
1650561487451,MATH 20A,A01,083754,Staff,21,0,40,19
1650561493477,MATH 20B,A01,083756,Staff,0,11,30,30
1650561493477,MATH 20B,A02,083757,Staff,0,12,30,30
1650561499504,MATH 20C,A01,083760,Staff,0,16,30,30
1650561499504,MATH 20C,A02,083761,Staff,2,14,30,28
1650561499504,MATH 20C,B01,083762,Staff,12,0,30,18
1650561499504,MATH 20C,B02,083763,Staff,28,0,30,2
1650561505533,MATH 20D,A01,083765,Staff,0,1,30,30
1650561505533,MATH 20D,A02,083766,Staff,6,0,30,24
1650561505533,MATH 20D,A03,083767,Staff,25,0,30,5
1650561511568,MATH 20E,A01,083771,Staff,6,0,30,24
1650561511568,MATH 20E,A02,083772,Staff,18,0,30,12
1650561511568,MATH 20E,B01,083773,Staff,0,0,30,30
1650561511568,MATH 20E,B02,083774,Staff,10,0,30,20
1650561517597,MATH 103A,A01,083777,Staff,0,15,30,30
1650561517597,MATH 103A,A02,083778,Staff,0,14,30,30
1650561517597,MATH 103A,B01,083779,Staff,0,13,30,30
1650561517597,MATH 103A,B02,083780,Staff,0,13,30,30
1650561523622,MATH 105,A01,085443,Staff,0,21,30,30
1650561529659,MATH 109,A01,083213,Anzaldo; Leesa B,0,8,30,30
1650561529659,MATH 109,A02,083214,Anzaldo; Leesa B,0,7,30,30
1650561529659,MATH 109,B01,083215,Anzaldo; Leesa B,0,5,30,30
1650561529659,MATH 109,B02,083216,Anzaldo; Leesa B,0,6,30,30
1650561535683,MATH 142A,A01,083219,Chow; Bennett,0,16,30,30
1650561535683,MATH 142A,A02,083220,Chow; Bennett,0,14,30,30
1650561535683,MATH 142A,B01,083221,Chow; Bennett,0,13,30,30
1650561535683,MATH 142A,B02,083222,Chow; Bennett,0,13,30,30
1650561541714,MATH 193A,A01,083224,Staff,1,6,30,29
1650561541714,MATH 193A,A02,083225,Staff,0,5,30,30
1650561541714,MATH 193A,A03,083781,Staff,0,6,30,30
1650561541714,MATH 193A,A04,083782,Staff,0,7,30,30
1650561547740,MATH 197,001,091859,McAuley; Julian John,9998,0,9999,1
1650561553792,COGS 9,A01,083615,Staff,0,16,60,60
1650561559835,COGS 11,A01,083617,Boyle; Mary E. T.,19,0,40,21
1650561565859,COGS 13,A01,083071,Staff,0,35,40,40
1650561571886,COGS 14A,A01,092681,Staff,0,27,100,100
1650561577909,COGS 14B,A01,083073,Cheng; Tzu-Han,0,12,50,50
1650561583937,COGS 17,A01,092677,Staff,18,0,75,57
1650561589963,COGS 100,A01,083619,Staff,0,26,60,60
1650561596002,COGS 101A,A01,083621,Davis; Joshua Daniel,0,26,60,60
1650561602033,COGS 101B,A01,091572,Staff,1,5,60,59
1650561608057,COGS 101C,A01,083625,Delgado; Tania,15,0,30,15
1650561614082,COGS 107A,A01,083627,Boyle; Mary E. T.,0,11,60,60
1650561620107,COGS 118A,A01,083075,Staff,0,3,60,60
1650561626143,CSE 3,A50,083646,Miranda; Gregory Joseph,20,0,38,18
1650561626143,CSE 3,A51,083647,Miranda; Gregory Joseph,36,0,37,1
1650561632173,CSE 8A,A50,083650,Miranda; Gregory Joseph,0,29,40,40
1650561638200,CSE 11,A01,083080,Cao; Yingjun,0,94,40,40
1650561644235,CSE 12,A01,083652,Staff,0,18,100,100
1650561650261,CSE 15L,A01,083654,Staff,0,1,50,50
1650561650261,CSE 15L,A02,083655,Staff,0,1,50,50
1650561656313,CSE 20,A01,083657,Staff,51,0,80,29
1650561662337,CSE 30,A01,083084,Eldon; John,0,77,40,40
1650561668360,CSE 100,A01,083659,Cao; Yingjun,0,67,50,50
1650561674390,CSE 134B,A01,083661,Powell; Thomas Allan,0,34,65,65
1650561680413,CSE 140,A01,083663,Staff,0,5,75,75
1650561686435,CSE 140L,A01,083088,Eldon; John,0,11,75,75
1650561692459,CSE 175,A01,083665,Kumar; Rakesh,7,0,25,18
1650561698485,CSE 190,A00,092507,Dubnov; Shlomo,10,0,20,10
1650561704509,ECE 45,A01,083139,Staff,0,1,60,60
1650561710564,ECE 65,A50,083695,Staff,0,6,30,30
1650561716596,ECE 109,A01,091882,Touri; Behrouz,33,0,70,37
1650561722623,ECE 180,A00,083140,Abi Samra; Nicholas Camill,21,0,30,9
1650561722623,ECE 180,B00,083141,Abi Samra; Nicholas Camill,0,0,30,30
1650561728647,MATH 10A,A01,083735,Patchell; Gregory David,5,0,30,25
1650561728647,MATH 10A,A02,083736,Patchell; Gregory David,27,0,30,3
1650561728647,MATH 10A,A03,083737,Patchell; Gregory David,24,0,30,6
1650561734681,MATH 10B,A01,083207,Staff,0,9,30,30
1650561734681,MATH 10B,A02,083208,Staff,0,8,30,30
1650561734681,MATH 10B,B01,083739,Staff,12,0,30,18
1650561734681,MATH 10B,B02,083740,Staff,28,0,30,2
1650561740707,MATH 18,A01,083743,Staff,1,0,30,29
1650561740707,MATH 18,A02,083744,Staff,26,0,30,4
1650561740707,MATH 18,A03,083745,Staff,22,0,30,8
1650561740707,MATH 18,A04,083746,Staff,26,0,30,4
1650561740707,MATH 18,B01,083748,Staff,0,13,30,30
1650561740707,MATH 18,B02,083749,Staff,0,12,30,30
1650561740707,MATH 18,B03,083750,Staff,0,11,30,30
1650561740707,MATH 18,B04,083751,Staff,0,12,30,30
1650561746732,MATH 20A,A01,083754,Staff,21,0,40,19
1650561752765,MATH 20B,A01,083756,Staff,0,11,30,30
1650561752765,MATH 20B,A02,083757,Staff,0,12,30,30
1650561758795,MATH 20C,A01,083760,Staff,0,16,30,30
1650561758795,MATH 20C,A02,083761,Staff,2,14,30,28
1650561758795,MATH 20C,B01,083762,Staff,12,0,30,18
1650561758795,MATH 20C,B02,083763,Staff,28,0,30,2
1650561764827,MATH 20D,A01,083765,Staff,0,1,30,30
1650561764827,MATH 20D,A02,083766,Staff,6,0,30,24
1650561764827,MATH 20D,A03,083767,Staff,25,0,30,5
1650561770856,MATH 20E,A01,083771,Staff,6,0,30,24
1650561770856,MATH 20E,A02,083772,Staff,18,0,30,12
1650561770856,MATH 20E,B01,083773,Staff,0,0,30,30
1650561770856,MATH 20E,B02,083774,Staff,10,0,30,20
1650561776967,MATH 103A,A01,083777,Staff,0,15,30,30
1650561776967,MATH 103A,A02,083778,Staff,0,14,30,30
1650561776967,MATH 103A,B01,083779,Staff,0,13,30,30
1650561776967,MATH 103A,B02,083780,Staff,0,13,30,30
1650561783004,MATH 105,A01,085443,Staff,0,21,30,30
1650561789028,MATH 109,A01,083213,Anzaldo; Leesa B,0,8,30,30
1650561789028,MATH 109,A02,083214,Anzaldo; Leesa B,0,7,30,30
1650561789028,MATH 109,B01,083215,Anzaldo; Leesa B,0,5,30,30
1650561789028,MATH 109,B02,083216,Anzaldo; Leesa B,0,6,30,30
1650561795059,MATH 142A,A01,083219,Chow; Bennett,0,16,30,30
1650561795059,MATH 142A,A02,083220,Chow; Bennett,0,14,30,30
1650561795059,MATH 142A,B01,083221,Chow; Bennett,0,13,30,30
1650561795059,MATH 142A,B02,083222,Chow; Bennett,0,13,30,30
1650561801088,MATH 193A,A01,083224,Staff,1,6,30,29
1650561801088,MATH 193A,A02,083225,Staff,0,5,30,30
1650561801088,MATH 193A,A03,083781,Staff,0,6,30,30
1650561801088,MATH 193A,A04,083782,Staff,0,7,30,30
1650561807115,MATH 197,001,091859,McAuley; Julian John,9998,0,9999,1
1650561813172,COGS 9,A01,083615,Staff,0,16,60,60
1650561819195,COGS 11,A01,083617,Boyle; Mary E. T.,19,0,40,21
1650561825217,COGS 13,A01,083071,Staff,0,35,40,40
1650561831241,COGS 14A,A01,092681,Staff,0,27,100,100
1650561837271,COGS 14B,A01,083073,Cheng; Tzu-Han,0,12,50,50
1650561843295,COGS 17,A01,092677,Staff,18,0,75,57
1650561849320,COGS 100,A01,083619,Staff,0,26,60,60
1650561855352,COGS 101A,A01,083621,Davis; Joshua Daniel,0,26,60,60
1650561861376,COGS 101B,A01,091572,Staff,1,5,60,59
1650561867411,COGS 101C,A01,083625,Delgado; Tania,15,0,30,15
1650561873434,COGS 107A,A01,083627,Boyle; Mary E. T.,0,11,60,60
1650561879464,COGS 118A,A01,083075,Staff,0,3,60,60
1650561885491,CSE 3,A50,083646,Miranda; Gregory Joseph,20,0,38,18
1650561885491,CSE 3,A51,083647,Miranda; Gregory Joseph,36,0,37,1
1650561891514,CSE 8A,A50,083650,Miranda; Gregory Joseph,0,29,40,40
1650561897539,CSE 11,A01,083080,Cao; Yingjun,0,94,40,40
1650561903567,CSE 12,A01,083652,Staff,0,18,100,100
1650561909590,CSE 15L,A01,083654,Staff,0,1,50,50
1650561909590,CSE 15L,A02,083655,Staff,0,1,50,50
1650561915614,CSE 20,A01,083657,Staff,51,0,80,29
1650561921637,CSE 30,A01,083084,Eldon; John,0,77,40,40
1650561927659,CSE 100,A01,083659,Cao; Yingjun,0,67,50,50
1650561933682,CSE 134B,A01,083661,Powell; Thomas Allan,0,34,65,65
1650561939713,CSE 140,A01,083663,Staff,0,5,75,75
1650561945739,CSE 140L,A01,083088,Eldon; John,0,11,75,75
1650561951763,CSE 175,A01,083665,Kumar; Rakesh,7,0,25,18
1650561957802,CSE 190,A00,092507,Dubnov; Shlomo,10,0,20,10
1650561963840,ECE 45,A01,083139,Staff,0,1,60,60
1650561969865,ECE 65,A50,083695,Staff,0,6,30,30
1650561975891,ECE 109,A01,091882,Touri; Behrouz,33,0,70,37
1650561981914,ECE 180,A00,083140,Abi Samra; Nicholas Camill,21,0,30,9
1650561981914,ECE 180,B00,083141,Abi Samra; Nicholas Camill,0,0,30,30
1650561987941,MATH 10A,A01,083735,Patchell; Gregory David,5,0,30,25
1650561987941,MATH 10A,A02,083736,Patchell; Gregory David,27,0,30,3
1650561987941,MATH 10A,A03,083737,Patchell; Gregory David,24,0,30,6
1650561993965,MATH 10B,A01,083207,Staff,0,9,30,30
1650561993965,MATH 10B,A02,083208,Staff,0,8,30,30
1650561993965,MATH 10B,B01,083739,Staff,12,0,30,18
1650561993965,MATH 10B,B02,083740,Staff,28,0,30,2
1650561999990,MATH 18,A01,083743,Staff,1,0,30,29
1650561999990,MATH 18,A02,083744,Staff,26,0,30,4
1650561999990,MATH 18,A03,083745,Staff,22,0,30,8
1650561999990,MATH 18,A04,083746,Staff,26,0,30,4
1650561999990,MATH 18,B01,083748,Staff,0,13,30,30
1650561999990,MATH 18,B02,083749,Staff,0,12,30,30
1650561999990,MATH 18,B03,083750,Staff,0,11,30,30
1650561999990,MATH 18,B04,083751,Staff,0,12,30,30
1650562006014,MATH 20A,A01,083754,Staff,21,0,40,19
1650562012046,MATH 20B,A01,083756,Staff,0,11,30,30
1650562012046,MATH 20B,A02,083757,Staff,0,12,30,30
1650562018083,MATH 20C,A01,083760,Staff,0,16,30,30
1650562018083,MATH 20C,A02,083761,Staff,2,14,30,28
1650562018083,MATH 20C,B01,083762,Staff,12,0,30,18
1650562018083,MATH 20C,B02,083763,Staff,28,0,30,2
1650562024110,MATH 20D,A01,083765,Staff,0,1,30,30
1650562024110,MATH 20D,A02,083766,Staff,6,0,30,24
1650562024110,MATH 20D,A03,083767,Staff,25,0,30,5
1650562030144,MATH 20E,A01,083771,Staff,6,0,30,24
1650562030144,MATH 20E,A02,083772,Staff,18,0,30,12
1650562030144,MATH 20E,B01,083773,Staff,0,0,30,30
1650562030144,MATH 20E,B02,083774,Staff,10,0,30,20
1650562036168,MATH 103A,A01,083777,Staff,0,15,30,30
1650562036168,MATH 103A,A02,083778,Staff,0,14,30,30
1650562036168,MATH 103A,B01,083779,Staff,0,13,30,30
1650562036168,MATH 103A,B02,083780,Staff,0,13,30,30
1650562042195,MATH 105,A01,085443,Staff,0,21,30,30
1650562048220,MATH 109,A01,083213,Anzaldo; Leesa B,0,8,30,30
1650562048220,MATH 109,A02,083214,Anzaldo; Leesa B,0,7,30,30
1650562048220,MATH 109,B01,083215,Anzaldo; Leesa B,0,5,30,30
1650562048220,MATH 109,B02,083216,Anzaldo; Leesa B,0,6,30,30
1650562054244,MATH 142A,A01,083219,Chow; Bennett,0,16,30,30
1650562054244,MATH 142A,A02,083220,Chow; Bennett,0,14,30,30
1650562054244,MATH 142A,B01,083221,Chow; Bennett,0,13,30,30
1650562054244,MATH 142A,B02,083222,Chow; Bennett,0,13,30,30
1650562060269,MATH 193A,A01,083224,Staff,1,6,30,29
1650562060269,MATH 193A,A02,083225,Staff,0,5,30,30
1650562060269,MATH 193A,A03,083781,Staff,0,6,30,30
1650562060269,MATH 193A,A04,083782,Staff,0,7,30,30
1650562066300,MATH 197,001,091859,McAuley; Julian John,9998,0,9999,1
1650562072362,COGS 9,A01,083615,Staff,0,16,60,60
1650562078399,COGS 11,A01,083617,Boyle; Mary E. T.,19,0,40,21
1650562084422,COGS 13,A01,083071,Staff,0,35,40,40
1650562090446,COGS 14A,A01,092681,Staff,0,27,100,100
1650562096472,COGS 14B,A01,083073,Cheng; Tzu-Han,0,12,50,50
1650562102505,COGS 17,A01,092677,Staff,18,0,75,57
1650562108538,COGS 100,A01,083619,Staff,0,26,60,60
1650562114563,COGS 101A,A01,083621,Davis; Joshua Daniel,0,26,60,60
1650562120586,COGS 101B,A01,091572,Staff,1,5,60,59
1650562126621,COGS 101C,A01,083625,Delgado; Tania,15,0,30,15
1650562132645,COGS 107A,A01,083627,Boyle; Mary E. T.,0,11,60,60
1650562138679,COGS 118A,A01,083075,Staff,0,3,60,60
1650562144711,CSE 3,A50,083646,Miranda; Gregory Joseph,20,0,38,18
1650562144711,CSE 3,A51,083647,Miranda; Gregory Joseph,36,0,37,1
1650562150737,CSE 8A,A50,083650,Miranda; Gregory Joseph,0,29,40,40
1650562156761,CSE 11,A01,083080,Cao; Yingjun,0,94,40,40
1650562162793,CSE 12,A01,083652,Staff,0,18,100,100
1650562168818,CSE 15L,A01,083654,Staff,0,1,50,50
1650562168818,CSE 15L,A02,083655,Staff,0,1,50,50
1650562174843,CSE 20,A01,083657,Staff,51,0,80,29
1650562180878,CSE 30,A01,083084,Eldon; John,0,77,40,40
1650562186901,CSE 100,A01,083659,Cao; Yingjun,0,67,50,50
1650562192926,CSE 134B,A01,083661,Powell; Thomas Allan,0,34,65,65
1650562198950,CSE 140,A01,083663,Staff,0,5,75,75
1650562204976,CSE 140L,A01,083088,Eldon; John,0,11,75,75
1650562210999,CSE 175,A01,083665,Kumar; Rakesh,7,0,25,18
1650562217021,CSE 190,A00,092507,Dubnov; Shlomo,10,0,20,10
1650562223048,ECE 45,A01,083139,Staff,0,1,60,60
1650562229072,ECE 65,A50,083695,Staff,0,6,30,30
1650562235095,ECE 109,A01,091882,Touri; Behrouz,33,0,70,37
1650562241122,ECE 180,A00,083140,Abi Samra; Nicholas Camill,21,0,30,9
1650562241122,ECE 180,B00,083141,Abi Samra; Nicholas Camill,0,0,30,30
1650562247161,MATH 10A,A01,083735,Patchell; Gregory David,5,0,30,25
1650562247161,MATH 10A,A02,083736,Patchell; Gregory David,27,0,30,3
1650562247161,MATH 10A,A03,083737,Patchell; Gregory David,24,0,30,6
1650562253192,MATH 10B,A01,083207,Staff,0,9,30,30
1650562253192,MATH 10B,A02,083208,Staff,0,8,30,30
1650562253192,MATH 10B,B01,083739,Staff,12,0,30,18
1650562253192,MATH 10B,B02,083740,Staff,28,0,30,2
1650562259229,MATH 18,A01,083743,Staff,1,0,30,29
1650562259229,MATH 18,A02,083744,Staff,26,0,30,4
1650562259229,MATH 18,A03,083745,Staff,22,0,30,8
1650562259229,MATH 18,A04,083746,Staff,26,0,30,4
1650562259229,MATH 18,B01,083748,Staff,0,13,30,30
1650562259229,MATH 18,B02,083749,Staff,0,12,30,30
1650562259229,MATH 18,B03,083750,Staff,0,11,30,30
1650562259229,MATH 18,B04,083751,Staff,0,12,30,30
1650562265254,MATH 20A,A01,083754,Staff,21,0,40,19
1650562271278,MATH 20B,A01,083756,Staff,0,11,30,30
1650562271278,MATH 20B,A02,083757,Staff,0,12,30,30
1650562277301,MATH 20C,A01,083760,Staff,0,16,30,30
1650562277301,MATH 20C,A02,083761,Staff,2,14,30,28
1650562277301,MATH 20C,B01,083762,Staff,12,0,30,18
1650562277301,MATH 20C,B02,083763,Staff,28,0,30,2
1650562283331,MATH 20D,A01,083765,Staff,0,1,30,30
1650562283331,MATH 20D,A02,083766,Staff,6,0,30,24
1650562283331,MATH 20D,A03,083767,Staff,25,0,30,5
1650562289359,MATH 20E,A01,083771,Staff,6,0,30,24
1650562289359,MATH 20E,A02,083772,Staff,18,0,30,12
1650562289359,MATH 20E,B01,083773,Staff,0,0,30,30
1650562289359,MATH 20E,B02,083774,Staff,10,0,30,20
1650562295413,MATH 103A,A01,083777,Staff,0,15,30,30
1650562295413,MATH 103A,A02,083778,Staff,0,14,30,30
1650562295413,MATH 103A,B01,083779,Staff,0,13,30,30
1650562295413,MATH 103A,B02,083780,Staff,0,13,30,30
1650562301446,MATH 105,A01,085443,Staff,0,21,30,30
1650562307513,MATH 109,A01,083213,Anzaldo; Leesa B,0,7,30,30
1650562307513,MATH 109,A02,083214,Anzaldo; Leesa B,0,7,30,30
1650562307513,MATH 109,B01,083215,Anzaldo; Leesa B,0,5,30,30
1650562307513,MATH 109,B02,083216,Anzaldo; Leesa B,0,6,30,30
1650562313542,MATH 142A,A01,083219,Chow; Bennett,0,16,30,30
1650562313542,MATH 142A,A02,083220,Chow; Bennett,0,14,30,30
1650562313542,MATH 142A,B01,083221,Chow; Bennett,0,13,30,30
1650562313542,MATH 142A,B02,083222,Chow; Bennett,0,13,30,30
1650562319580,MATH 193A,A01,083224,Staff,1,6,30,29
1650562319580,MATH 193A,A02,083225,Staff,0,5,30,30
1650562319580,MATH 193A,A03,083781,Staff,0,6,30,30
1650562319580,MATH 193A,A04,083782,Staff,0,7,30,30
1650562325635,MATH 197,001,091859,McAuley; Julian John,9998,0,9999,1
1650562331693,COGS 9,A01,083615,Staff,0,16,60,60
1650562337721,COGS 11,A01,083617,Boyle; Mary E. T.,19,0,40,21
1650562343744,COGS 13,A01,083071,Staff,0,35,40,40
1650562349787,COGS 14A,A01,092681,Staff,0,27,100,100
1650562355812,COGS 14B,A01,083073,Cheng; Tzu-Han,0,12,50,50
1650562361838,COGS 17,A01,092677,Staff,18,0,75,57
1650562367937,COGS 100,A01,083619,Staff,0,26,60,60
1650562373973,COGS 101A,A01,083621,Davis; Joshua Daniel,0,26,60,60
1650562379996,COGS 101B,A01,091572,Staff,1,5,60,59
1650562386023,COGS 101C,A01,083625,Delgado; Tania,15,0,30,15
1650562392055,COGS 107A,A01,083627,Boyle; Mary E. T.,0,11,60,60
1650562398079,COGS 118A,A01,083075,Staff,0,3,60,60
1650562404103,CSE 3,A50,083646,Miranda; Gregory Joseph,20,0,38,18
1650562404103,CSE 3,A51,083647,Miranda; Gregory Joseph,36,0,37,1
1650562410132,CSE 8A,A50,083650,Miranda; Gregory Joseph,0,29,40,40
1650562416155,CSE 11,A01,083080,Cao; Yingjun,0,94,40,40
1650562422191,CSE 12,A01,083652,Staff,0,18,100,100
1650562428214,CSE 15L,A01,083654,Staff,0,1,50,50
1650562428214,CSE 15L,A02,083655,Staff,0,1,50,50
1650562434238,CSE 20,A01,083657,Staff,51,0,80,29
1650562440262,CSE 30,A01,083084,Eldon; John,0,77,40,40
1650562446285,CSE 100,A01,083659,Cao; Yingjun,0,67,50,50
1650562452335,CSE 134B,A01,083661,Powell; Thomas Allan,0,34,65,65
1650562458368,CSE 140,A01,083663,Staff,0,5,75,75
1650562464391,CSE 140L,A01,083088,Eldon; John,0,11,75,75
1650562470417,CSE 175,A01,083665,Kumar; Rakesh,7,0,25,18
1650562476459,CSE 190,A00,092507,Dubnov; Shlomo,10,0,20,10
1650562482482,ECE 45,A01,083139,Staff,0,1,60,60
1650562488507,ECE 65,A50,083695,Staff,0,6,30,30
1650562494531,ECE 109,A01,091882,Touri; Behrouz,33,0,70,37
1650562500566,ECE 180,A00,083140,Abi Samra; Nicholas Camill,21,0,30,9
1650562500566,ECE 180,B00,083141,Abi Samra; Nicholas Camill,0,0,30,30
1650562506602,MATH 10A,A01,083735,Patchell; Gregory David,5,0,30,25
1650562506602,MATH 10A,A02,083736,Patchell; Gregory David,27,0,30,3
1650562506602,MATH 10A,A03,083737,Patchell; Gregory David,24,0,30,6
1650562512640,MATH 10B,A01,083207,Staff,0,9,30,30
1650562512640,MATH 10B,A02,083208,Staff,0,8,30,30
1650562512640,MATH 10B,B01,083739,Staff,11,0,30,19
1650562512640,MATH 10B,B02,083740,Staff,28,0,30,2
1650562518665,MATH 18,A01,083743,Staff,1,0,30,29
1650562518665,MATH 18,A02,083744,Staff,26,0,30,4
1650562518665,MATH 18,A03,083745,Staff,22,0,30,8
1650562518665,MATH 18,A04,083746,Staff,26,0,30,4
1650562518665,MATH 18,B01,083748,Staff,0,13,30,30
1650562518665,MATH 18,B02,083749,Staff,0,12,30,30
1650562518665,MATH 18,B03,083750,Staff,0,11,30,30
1650562518665,MATH 18,B04,083751,Staff,0,12,30,30
1650562524692,MATH 20A,A01,083754,Staff,21,0,40,19
1650562530716,MATH 20B,A01,083756,Staff,0,11,30,30
1650562530716,MATH 20B,A02,083757,Staff,0,12,30,30
1650562536740,MATH 20C,A01,083760,Staff,0,16,30,30
1650562536740,MATH 20C,A02,083761,Staff,2,14,30,28
1650562536740,MATH 20C,B01,083762,Staff,12,0,30,18
1650562536740,MATH 20C,B02,083763,Staff,28,0,30,2
1650562542762,MATH 20D,A01,083765,Staff,0,1,30,30
1650562542762,MATH 20D,A02,083766,Staff,7,0,30,23
1650562542762,MATH 20D,A03,083767,Staff,25,0,30,5
1650562548786,MATH 20E,A01,083771,Staff,6,0,30,24
1650562548786,MATH 20E,A02,083772,Staff,18,0,30,12
1650562548786,MATH 20E,B01,083773,Staff,0,0,30,30
1650562548786,MATH 20E,B02,083774,Staff,10,0,30,20
1650562554810,MATH 103A,A01,083777,Staff,0,15,30,30
1650562554810,MATH 103A,A02,083778,Staff,0,14,30,30
1650562554810,MATH 103A,B01,083779,Staff,0,13,30,30
1650562554810,MATH 103A,B02,083780,Staff,0,13,30,30
1650562560834,MATH 105,A01,085443,Staff,0,21,30,30
1650562566863,MATH 109,A01,083213,Anzaldo; Leesa B,0,7,30,30
1650562566863,MATH 109,A02,083214,Anzaldo; Leesa B,0,7,30,30
1650562566863,MATH 109,B01,083215,Anzaldo; Leesa B,0,5,30,30
1650562566863,MATH 109,B02,083216,Anzaldo; Leesa B,0,6,30,30
1650562572893,MATH 142A,A01,083219,Chow; Bennett,0,16,30,30
1650562572893,MATH 142A,A02,083220,Chow; Bennett,0,14,30,30
1650562572893,MATH 142A,B01,083221,Chow; Bennett,0,13,30,30
1650562572893,MATH 142A,B02,083222,Chow; Bennett,0,13,30,30
1650562578927,MATH 193A,A01,083224,Staff,1,6,30,29
1650562578927,MATH 193A,A02,083225,Staff,0,5,30,30
1650562578927,MATH 193A,A03,083781,Staff,0,6,30,30
1650562578927,MATH 193A,A04,083782,Staff,0,7,30,30
1650562584950,MATH 197,001,091859,McAuley; Julian John,9998,0,9999,1
1650562591001,COGS 9,A01,083615,Staff,0,16,60,60
1650562597028,COGS 11,A01,083617,Boyle; Mary E. T.,19,0,40,21
1650562603055,COGS 13,A01,083071,Staff,0,35,40,40
1650562609087,COGS 14A,A01,092681,Staff,0,27,100,100
1650562615113,COGS 14B,A01,083073,Cheng; Tzu-Han,0,12,50,50
1650562621139,COGS 17,A01,092677,Staff,18,0,75,57
1650562627234,COGS 100,A01,083619,Staff,0,26,60,60
1650562633261,COGS 101A,A01,083621,Davis; Joshua Daniel,0,26,60,60
1650562639286,COGS 101B,A01,091572,Staff,1,5,60,59
1650562645313,COGS 101C,A01,083625,Delgado; Tania,15,0,30,15
1650562651338,COGS 107A,A01,083627,Boyle; Mary E. T.,0,11,60,60
1650562657372,COGS 118A,A01,083075,Staff,0,3,60,60
1650562663406,CSE 3,A50,083646,Miranda; Gregory Joseph,20,0,38,18
1650562663406,CSE 3,A51,083647,Miranda; Gregory Joseph,36,0,37,1
1650562669434,CSE 8A,A50,083650,Miranda; Gregory Joseph,0,29,40,40
1650562675464,CSE 11,A01,083080,Cao; Yingjun,0,94,40,40
1650562681490,CSE 12,A01,083652,Staff,0,18,100,100
1650562687513,CSE 15L,A01,083654,Staff,0,1,50,50
1650562687513,CSE 15L,A02,083655,Staff,0,1,50,50
1650562693536,CSE 20,A01,083657,Staff,51,0,80,29
1650562699565,CSE 30,A01,083084,Eldon; John,0,77,40,40
1650562705588,CSE 100,A01,083659,Cao; Yingjun,0,67,50,50
1650562711619,CSE 134B,A01,083661,Powell; Thomas Allan,0,34,65,65
1650562717644,CSE 140,A01,083663,Staff,0,5,75,75
1650562723669,CSE 140L,A01,083088,Eldon; John,0,11,75,75
1650562729694,CSE 175,A01,083665,Kumar; Rakesh,7,0,25,18
1650562735720,CSE 190,A00,092507,Dubnov; Shlomo,10,0,20,10
1650562741742,ECE 45,A01,083139,Staff,0,1,60,60
1650562747767,ECE 65,A50,083695,Staff,0,6,30,30
1650562753802,ECE 109,A01,091882,Touri; Behrouz,33,0,70,37
1650562759827,ECE 180,A00,083140,Abi Samra; Nicholas Camill,21,0,30,9
1650562759827,ECE 180,B00,083141,Abi Samra; Nicholas Camill,0,0,30,30
1650562765854,MATH 10A,A01,083735,Patchell; Gregory David,5,0,30,25
1650562765854,MATH 10A,A02,083736,Patchell; Gregory David,27,0,30,3
1650562765854,MATH 10A,A03,083737,Patchell; Gregory David,24,0,30,6
1650562771881,MATH 10B,A01,083207,Staff,0,9,30,30
1650562771881,MATH 10B,A02,083208,Staff,0,8,30,30
1650562771881,MATH 10B,B01,083739,Staff,11,0,30,19
1650562771881,MATH 10B,B02,083740,Staff,28,0,30,2
1650562777906,MATH 18,A01,083743,Staff,1,0,30,29
1650562777906,MATH 18,A02,083744,Staff,26,0,30,4
1650562777906,MATH 18,A03,083745,Staff,22,0,30,8
1650562777906,MATH 18,A04,083746,Staff,26,0,30,4
1650562777906,MATH 18,B01,083748,Staff,0,13,30,30
1650562777906,MATH 18,B02,083749,Staff,0,12,30,30
1650562777906,MATH 18,B03,083750,Staff,0,11,30,30
1650562777906,MATH 18,B04,083751,Staff,0,12,30,30
1650562783929,MATH 20A,A01,083754,Staff,21,0,40,19
1650562789959,MATH 20B,A01,083756,Staff,0,11,30,30
1650562789959,MATH 20B,A02,083757,Staff,0,12,30,30
1650562795988,MATH 20C,A01,083760,Staff,0,16,30,30
1650562795988,MATH 20C,A02,083761,Staff,2,14,30,28
1650562795988,MATH 20C,B01,083762,Staff,12,0,30,18
1650562795988,MATH 20C,B02,083763,Staff,28,0,30,2
1650562802036,MATH 20D,A01,083765,Staff,0,1,30,30
1650562802036,MATH 20D,A02,083766,Staff,7,0,30,23
1650562802036,MATH 20D,A03,083767,Staff,25,0,30,5
1650562808061,MATH 20E,A01,083771,Staff,6,0,30,24
1650562808061,MATH 20E,A02,083772,Staff,18,0,30,12
1650562808061,MATH 20E,B01,083773,Staff,0,0,30,30
1650562808061,MATH 20E,B02,083774,Staff,10,0,30,20
1650562814086,MATH 103A,A01,083777,Staff,0,15,30,30
1650562814086,MATH 103A,A02,083778,Staff,0,14,30,30
1650562814086,MATH 103A,B01,083779,Staff,0,13,30,30
1650562814086,MATH 103A,B02,083780,Staff,0,13,30,30
1650562820110,MATH 105,A01,085443,Staff,0,21,30,30
1650562826171,MATH 109,A01,083213,Anzaldo; Leesa B,0,7,30,30
1650562826171,MATH 109,A02,083214,Anzaldo; Leesa B,0,7,30,30
1650562826171,MATH 109,B01,083215,Anzaldo; Leesa B,0,5,30,30
1650562826171,MATH 109,B02,083216,Anzaldo; Leesa B,0,6,30,30
1650562832199,MATH 142A,A01,083219,Chow; Bennett,0,16,30,30
1650562832199,MATH 142A,A02,083220,Chow; Bennett,0,14,30,30
1650562832199,MATH 142A,B01,083221,Chow; Bennett,0,13,30,30
1650562832199,MATH 142A,B02,083222,Chow; Bennett,0,13,30,30
1650562838239,MATH 193A,A01,083224,Staff,1,6,30,29
1650562838239,MATH 193A,A02,083225,Staff,0,5,30,30
1650562838239,MATH 193A,A03,083781,Staff,0,6,30,30
1650562838239,MATH 193A,A04,083782,Staff,0,7,30,30
1650562844264,MATH 197,001,091859,McAuley; Julian John,9998,0,9999,1
1650562850336,COGS 9,A01,083615,Staff,0,16,60,60
1650562856358,COGS 11,A01,083617,Boyle; Mary E. T.,19,0,40,21
1650562862382,COGS 13,A01,083071,Staff,0,35,40,40
1650562868408,COGS 14A,A01,092681,Staff,0,27,100,100
1650562874435,COGS 14B,A01,083073,Cheng; Tzu-Han,0,12,50,50
1650562880459,COGS 17,A01,092677,Staff,18,0,75,57
1650562886492,COGS 100,A01,083619,Staff,0,26,60,60
1650562892523,COGS 101A,A01,083621,Davis; Joshua Daniel,0,26,60,60
1650562898546,COGS 101B,A01,091572,Staff,1,5,60,59
1650562904569,COGS 101C,A01,083625,Delgado; Tania,15,0,30,15
1650562910592,COGS 107A,A01,083627,Boyle; Mary E. T.,0,11,60,60
1650562916620,COGS 118A,A01,083075,Staff,0,3,60,60
1650562922652,CSE 3,A50,083646,Miranda; Gregory Joseph,20,0,38,18
1650562922652,CSE 3,A51,083647,Miranda; Gregory Joseph,36,0,37,1
1650562928685,CSE 8A,A50,083650,Miranda; Gregory Joseph,0,29,40,40
1650562934730,CSE 11,A01,083080,Cao; Yingjun,0,94,40,40
1650562940755,CSE 12,A01,083652,Staff,0,18,100,100
1650562946786,CSE 15L,A01,083654,Staff,0,1,50,50
1650562946786,CSE 15L,A02,083655,Staff,0,1,50,50
1650562952811,CSE 20,A01,083657,Staff,51,0,80,29
1650562958848,CSE 30,A01,083084,Eldon; John,0,77,40,40
1650562964949,CSE 100,A01,083659,Cao; Yingjun,0,67,50,50
1650562970976,CSE 134B,A01,083661,Powell; Thomas Allan,0,34,65,65
1650562977004,CSE 140,A01,083663,Staff,0,5,75,75
1650562983029,CSE 140L,A01,083088,Eldon; John,0,11,75,75
1650562989054,CSE 175,A01,083665,Kumar; Rakesh,7,0,25,18
1650562995077,CSE 190,A00,092507,Dubnov; Shlomo,10,0,20,10
1650563001102,ECE 45,A01,083139,Staff,0,1,60,60
1650563007128,ECE 65,A50,083695,Staff,0,6,30,30
1650563013152,ECE 109,A01,091882,Touri; Behrouz,33,0,70,37
1650563019198,ECE 180,A00,083140,Abi Samra; Nicholas Camill,21,0,30,9
1650563019198,ECE 180,B00,083141,Abi Samra; Nicholas Camill,0,0,30,30
1650563025283,MATH 10A,A01,083735,Patchell; Gregory David,5,0,30,25
1650563025283,MATH 10A,A02,083736,Patchell; Gregory David,27,0,30,3
1650563025283,MATH 10A,A03,083737,Patchell; Gregory David,24,0,30,6
1650563031310,MATH 10B,A01,083207,Staff,0,9,30,30
1650563031310,MATH 10B,A02,083208,Staff,0,8,30,30
1650563031310,MATH 10B,B01,083739,Staff,11,0,30,19
1650563031310,MATH 10B,B02,083740,Staff,28,0,30,2
1650563037332,MATH 18,A01,083743,Staff,1,0,30,29
1650563037332,MATH 18,A02,083744,Staff,26,0,30,4
1650563037332,MATH 18,A03,083745,Staff,22,0,30,8
1650563037332,MATH 18,A04,083746,Staff,26,0,30,4
1650563037332,MATH 18,B01,083748,Staff,0,13,30,30
1650563037332,MATH 18,B02,083749,Staff,0,12,30,30
1650563037332,MATH 18,B03,083750,Staff,0,11,30,30
1650563037332,MATH 18,B04,083751,Staff,0,12,30,30
1650563043362,MATH 20A,A01,083754,Staff,21,0,40,19
1650563049396,MATH 20B,A01,083756,Staff,0,11,30,30
1650563049396,MATH 20B,A02,083757,Staff,0,12,30,30
1650563055423,MATH 20C,A01,083760,Staff,0,16,30,30
1650563055423,MATH 20C,A02,083761,Staff,2,14,30,28
1650563055423,MATH 20C,B01,083762,Staff,12,0,30,18
1650563055423,MATH 20C,B02,083763,Staff,28,0,30,2
1650563061452,MATH 20D,A01,083765,Staff,0,1,30,30
1650563061452,MATH 20D,A02,083766,Staff,7,0,30,23
1650563061452,MATH 20D,A03,083767,Staff,25,0,30,5
1650563067477,MATH 20E,A01,083771,Staff,6,0,30,24
1650563067477,MATH 20E,A02,083772,Staff,18,0,30,12
1650563067477,MATH 20E,B01,083773,Staff,0,0,30,30
1650563067477,MATH 20E,B02,083774,Staff,10,0,30,20
1650563073518,MATH 103A,A01,083777,Staff,0,15,30,30
1650563073518,MATH 103A,A02,083778,Staff,0,14,30,30
1650563073518,MATH 103A,B01,083779,Staff,0,13,30,30
1650563073518,MATH 103A,B02,083780,Staff,0,13,30,30
1650563079555,MATH 105,A01,085443,Staff,0,21,30,30
1650563085585,MATH 109,A01,083213,Anzaldo; Leesa B,0,7,30,30
1650563085585,MATH 109,A02,083214,Anzaldo; Leesa B,0,7,30,30
1650563085585,MATH 109,B01,083215,Anzaldo; Leesa B,0,5,30,30
1650563085585,MATH 109,B02,083216,Anzaldo; Leesa B,0,6,30,30
1650563091608,MATH 142A,A01,083219,Chow; Bennett,0,16,30,30
1650563091608,MATH 142A,A02,083220,Chow; Bennett,0,14,30,30
1650563091608,MATH 142A,B01,083221,Chow; Bennett,0,13,30,30
1650563091608,MATH 142A,B02,083222,Chow; Bennett,0,13,30,30
1650563097634,MATH 193A,A01,083224,Staff,1,6,30,29
1650563097634,MATH 193A,A02,083225,Staff,0,5,30,30
1650563097634,MATH 193A,A03,083781,Staff,0,6,30,30
1650563097634,MATH 193A,A04,083782,Staff,0,7,30,30
1650563103657,MATH 197,001,091859,McAuley; Julian John,9998,0,9999,1
1650563109731,COGS 9,A01,083615,Staff,0,16,60,60
1650563115754,COGS 11,A01,083617,Boyle; Mary E. T.,19,0,40,21
1650563121781,COGS 13,A01,083071,Staff,0,35,40,40
1650563127805,COGS 14A,A01,092681,Staff,0,27,100,100
1650563133838,COGS 14B,A01,083073,Cheng; Tzu-Han,0,12,50,50
1650563139862,COGS 17,A01,092677,Staff,18,0,75,57
1650563145886,COGS 100,A01,083619,Staff,0,26,60,60
1650563151913,COGS 101A,A01,083621,Davis; Joshua Daniel,0,26,60,60
1650563157937,COGS 101B,A01,091572,Staff,1,5,60,59
1650563163965,COGS 101C,A01,083625,Delgado; Tania,15,0,30,15
1650563169991,COGS 107A,A01,083627,Boyle; Mary E. T.,0,11,60,60
1650563176017,COGS 118A,A01,083075,Staff,0,3,60,60
1650563182042,CSE 3,A50,083646,Miranda; Gregory Joseph,20,0,38,18
1650563182042,CSE 3,A51,083647,Miranda; Gregory Joseph,36,0,37,1
1650563188068,CSE 8A,A50,083650,Miranda; Gregory Joseph,0,29,40,40
1650563194092,CSE 11,A01,083080,Cao; Yingjun,0,94,40,40
1650563200133,CSE 12,A01,083652,Staff,0,18,100,100
1650563206159,CSE 15L,A01,083654,Staff,0,1,50,50
1650563206159,CSE 15L,A02,083655,Staff,0,1,50,50
1650563212185,CSE 20,A01,083657,Staff,51,0,80,29
1650563218218,CSE 30,A01,083084,Eldon; John,0,77,40,40
1650563224247,CSE 100,A01,083659,Cao; Yingjun,0,67,50,50
1650563230274,CSE 134B,A01,083661,Powell; Thomas Allan,0,34,65,65
1650563236299,CSE 140,A01,083663,Staff,0,5,75,75
1650563242331,CSE 140L,A01,083088,Eldon; John,0,11,75,75
1650563248365,CSE 175,A01,083665,Kumar; Rakesh,7,0,25,18
1650563254402,CSE 190,A00,092507,Dubnov; Shlomo,10,0,20,10
1650563260434,ECE 45,A01,083139,Staff,0,1,60,60
1650563266470,ECE 65,A50,083695,Staff,0,6,30,30
1650563272508,ECE 109,A01,091882,Touri; Behrouz,33,0,70,37
1650563278534,ECE 180,A00,083140,Abi Samra; Nicholas Camill,21,0,30,9
1650563278534,ECE 180,B00,083141,Abi Samra; Nicholas Camill,0,0,30,30
1650563284558,MATH 10A,A01,083735,Patchell; Gregory David,5,0,30,25
1650563284558,MATH 10A,A02,083736,Patchell; Gregory David,27,0,30,3
1650563284558,MATH 10A,A03,083737,Patchell; Gregory David,24,0,30,6
1650563290603,MATH 10B,A01,083207,Staff,0,9,30,30
1650563290603,MATH 10B,A02,083208,Staff,0,8,30,30
1650563290603,MATH 10B,B01,083739,Staff,11,0,30,19
1650563290603,MATH 10B,B02,083740,Staff,28,0,30,2
1650563296633,MATH 18,A01,083743,Staff,1,0,30,29
1650563296633,MATH 18,A02,083744,Staff,26,0,30,4
1650563296633,MATH 18,A03,083745,Staff,22,0,30,8
1650563296633,MATH 18,A04,083746,Staff,26,0,30,4
1650563296633,MATH 18,B01,083748,Staff,0,14,30,30
1650563296633,MATH 18,B02,083749,Staff,0,12,30,30
1650563296633,MATH 18,B03,083750,Staff,0,12,30,30
1650563296633,MATH 18,B04,083751,Staff,0,12,30,30
1650563302655,MATH 20A,A01,083754,Staff,21,0,40,19
1650563308685,MATH 20B,A01,083756,Staff,0,11,30,30
1650563308685,MATH 20B,A02,083757,Staff,0,12,30,30
1650563314707,MATH 20C,A01,083760,Staff,0,16,30,30
1650563314707,MATH 20C,A02,083761,Staff,2,14,30,28
1650563314707,MATH 20C,B01,083762,Staff,12,0,30,18
1650563314707,MATH 20C,B02,083763,Staff,28,0,30,2
1650563320736,MATH 20D,A01,083765,Staff,0,1,30,30
1650563320736,MATH 20D,A02,083766,Staff,7,0,30,23
1650563320736,MATH 20D,A03,083767,Staff,25,0,30,5
1650563326763,MATH 20E,A01,083771,Staff,6,0,30,24
1650563326763,MATH 20E,A02,083772,Staff,18,0,30,12
1650563326763,MATH 20E,B01,083773,Staff,0,0,30,30
1650563326763,MATH 20E,B02,083774,Staff,10,0,30,20
1650563332797,MATH 103A,A01,083777,Staff,0,15,30,30
1650563332797,MATH 103A,A02,083778,Staff,0,14,30,30
1650563332797,MATH 103A,B01,083779,Staff,0,13,30,30
1650563332797,MATH 103A,B02,083780,Staff,0,13,30,30
1650563338821,MATH 105,A01,085443,Staff,0,21,30,30
1650563344846,MATH 109,A01,083213,Anzaldo; Leesa B,0,7,30,30
1650563344846,MATH 109,A02,083214,Anzaldo; Leesa B,0,7,30,30
1650563344846,MATH 109,B01,083215,Anzaldo; Leesa B,0,5,30,30
1650563344846,MATH 109,B02,083216,Anzaldo; Leesa B,0,6,30,30
1650563350876,MATH 142A,A01,083219,Chow; Bennett,0,16,30,30
1650563350876,MATH 142A,A02,083220,Chow; Bennett,0,14,30,30
1650563350876,MATH 142A,B01,083221,Chow; Bennett,0,13,30,30
1650563350876,MATH 142A,B02,083222,Chow; Bennett,0,13,30,30
1650563356917,MATH 193A,A01,083224,Staff,1,6,30,29
1650563356917,MATH 193A,A02,083225,Staff,0,5,30,30
1650563356917,MATH 193A,A03,083781,Staff,0,6,30,30
1650563356917,MATH 193A,A04,083782,Staff,0,7,30,30
1650563362954,MATH 197,001,091859,McAuley; Julian John,9998,0,9999,1
1650563369024,COGS 9,A01,083615,Staff,0,16,60,60
1650563375061,COGS 11,A01,083617,Boyle; Mary E. T.,19,0,40,21
1650563381112,COGS 13,A01,083071,Staff,0,35,40,40
1650563387138,COGS 14A,A01,092681,Staff,0,27,100,100
1650563393167,COGS 14B,A01,083073,Cheng; Tzu-Han,0,12,50,50
1650563399197,COGS 17,A01,092677,Staff,18,0,75,57
1650563405224,COGS 100,A01,083619,Staff,0,26,60,60
1650563411248,COGS 101A,A01,083621,Davis; Joshua Daniel,0,26,60,60
1650563417273,COGS 101B,A01,091572,Staff,1,5,60,59
1650563423296,COGS 101C,A01,083625,Delgado; Tania,15,0,30,15
1650563429327,COGS 107A,A01,083627,Boyle; Mary E. T.,0,11,60,60
1650563435351,COGS 118A,A01,083075,Staff,0,3,60,60
1650563441386,CSE 3,A50,083646,Miranda; Gregory Joseph,20,0,38,18
1650563441386,CSE 3,A51,083647,Miranda; Gregory Joseph,36,0,37,1
1650563447420,CSE 8A,A50,083650,Miranda; Gregory Joseph,0,29,40,40
1650563453449,CSE 11,A01,083080,Cao; Yingjun,0,94,40,40
1650563459471,CSE 12,A01,083652,Staff,0,18,100,100
1650563465495,CSE 15L,A01,083654,Staff,0,1,50,50
1650563465495,CSE 15L,A02,083655,Staff,0,1,50,50
1650563471529,CSE 20,A01,083657,Staff,51,0,80,29
1650563477553,CSE 30,A01,083084,Eldon; John,0,77,40,40
1650563483581,CSE 100,A01,083659,Cao; Yingjun,0,67,50,50
1650563489608,CSE 134B,A01,083661,Powell; Thomas Allan,0,34,65,65
1650563495640,CSE 140,A01,083663,Staff,0,5,75,75
1650563501675,CSE 140L,A01,083088,Eldon; John,0,11,75,75
1650563507702,CSE 175,A01,083665,Kumar; Rakesh,7,0,25,18
1650563513728,CSE 190,A00,092507,Dubnov; Shlomo,10,0,20,10
1650563519752,ECE 45,A01,083139,Staff,1,1,60,59
1650563525781,ECE 65,A50,083695,Staff,0,6,30,30
1650563531807,ECE 109,A01,091882,Touri; Behrouz,33,0,70,37
1650563537839,ECE 180,A00,083140,Abi Samra; Nicholas Camill,21,0,30,9
1650563537839,ECE 180,B00,083141,Abi Samra; Nicholas Camill,0,0,30,30
1650563543862,MATH 10A,A01,083735,Patchell; Gregory David,5,0,30,25
1650563543862,MATH 10A,A02,083736,Patchell; Gregory David,27,0,30,3
1650563543862,MATH 10A,A03,083737,Patchell; Gregory David,24,0,30,6
1650563549890,MATH 10B,A01,083207,Staff,0,9,30,30
1650563549890,MATH 10B,A02,083208,Staff,0,8,30,30
1650563549890,MATH 10B,B01,083739,Staff,11,0,30,19
1650563549890,MATH 10B,B02,083740,Staff,28,0,30,2
1650563555916,MATH 18,A01,083743,Staff,1,0,30,29
1650563555916,MATH 18,A02,083744,Staff,26,0,30,4
1650563555916,MATH 18,A03,083745,Staff,22,0,30,8
1650563555916,MATH 18,A04,083746,Staff,26,0,30,4
1650563555916,MATH 18,B01,083748,Staff,0,14,30,30
1650563555916,MATH 18,B02,083749,Staff,0,12,30,30
1650563555916,MATH 18,B03,083750,Staff,0,12,30,30
1650563555916,MATH 18,B04,083751,Staff,0,12,30,30
1650563562029,MATH 20A,A01,083754,Staff,21,0,40,19
1650563568053,MATH 20B,A01,083756,Staff,0,11,30,30
1650563568053,MATH 20B,A02,083757,Staff,0,12,30,30
1650563574080,MATH 20C,A01,083760,Staff,0,16,30,30
1650563574080,MATH 20C,A02,083761,Staff,2,14,30,28
1650563574080,MATH 20C,B01,083762,Staff,12,0,30,18
1650563574080,MATH 20C,B02,083763,Staff,28,0,30,2
1650563580104,MATH 20D,A01,083765,Staff,0,1,30,30
1650563580104,MATH 20D,A02,083766,Staff,7,0,30,23
1650563580104,MATH 20D,A03,083767,Staff,25,0,30,5
1650563586130,MATH 20E,A01,083771,Staff,6,0,30,24
1650563586130,MATH 20E,A02,083772,Staff,18,0,30,12
1650563586130,MATH 20E,B01,083773,Staff,0,0,30,30
1650563586130,MATH 20E,B02,083774,Staff,10,0,30,20
1650563592158,MATH 103A,A01,083777,Staff,0,15,30,30
1650563592158,MATH 103A,A02,083778,Staff,0,14,30,30
1650563592158,MATH 103A,B01,083779,Staff,0,13,30,30
1650563592158,MATH 103A,B02,083780,Staff,0,13,30,30
1650563598200,MATH 105,A01,085443,Staff,0,21,30,30
1650563604229,MATH 109,A01,083213,Anzaldo; Leesa B,0,7,30,30
1650563604229,MATH 109,A02,083214,Anzaldo; Leesa B,0,7,30,30
1650563604229,MATH 109,B01,083215,Anzaldo; Leesa B,0,5,30,30
1650563604229,MATH 109,B02,083216,Anzaldo; Leesa B,0,6,30,30
1650563610264,MATH 142A,A01,083219,Chow; Bennett,0,16,30,30
1650563610264,MATH 142A,A02,083220,Chow; Bennett,0,14,30,30
1650563610264,MATH 142A,B01,083221,Chow; Bennett,0,13,30,30
1650563610264,MATH 142A,B02,083222,Chow; Bennett,0,13,30,30
1650563616292,MATH 193A,A01,083224,Staff,1,6,30,29
1650563616292,MATH 193A,A02,083225,Staff,0,5,30,30
1650563616292,MATH 193A,A03,083781,Staff,0,6,30,30
1650563616292,MATH 193A,A04,083782,Staff,0,7,30,30
1650563622318,MATH 197,001,091859,McAuley; Julian John,9998,0,9999,1
1650563628370,COGS 9,A01,083615,Staff,0,16,60,60
1650563634397,COGS 11,A01,083617,Boyle; Mary E. T.,19,0,40,21
1650563640419,COGS 13,A01,083071,Staff,0,35,40,40
1650563646441,COGS 14A,A01,092681,Staff,0,27,100,100
1650563653051,COGS 14B,A01,083073,Cheng; Tzu-Han,0,12,50,50
1650563659080,COGS 17,A01,092677,Staff,18,0,75,57
1650563665104,COGS 100,A01,083619,Staff,0,26,60,60
1650563671127,COGS 101A,A01,083621,Davis; Joshua Daniel,0,26,60,60
1650563677150,COGS 101B,A01,091572,Staff,1,5,60,59
1650563683177,COGS 101C,A01,083625,Delgado; Tania,15,0,30,15
1650563689210,COGS 107A,A01,083627,Boyle; Mary E. T.,0,11,60,60
1650563695268,COGS 118A,A01,083075,Staff,0,3,60,60
1650563701292,CSE 3,A50,083646,Miranda; Gregory Joseph,20,0,38,18
1650563701292,CSE 3,A51,083647,Miranda; Gregory Joseph,36,0,37,1
1650563707321,CSE 8A,A50,083650,Miranda; Gregory Joseph,0,29,40,40
1650563713353,CSE 11,A01,083080,Cao; Yingjun,0,94,40,40
1650563719379,CSE 12,A01,083652,Staff,0,18,100,100
1650563725401,CSE 15L,A01,083654,Staff,0,1,50,50
1650563725401,CSE 15L,A02,083655,Staff,0,1,50,50
1650563731444,CSE 20,A01,083657,Staff,51,0,80,29
1650563737469,CSE 30,A01,083084,Eldon; John,0,77,40,40
1650563743498,CSE 100,A01,083659,Cao; Yingjun,0,67,50,50
1650563749525,CSE 134B,A01,083661,Powell; Thomas Allan,0,34,65,65
1650563767943,CSE 140,A01,083663,Staff,0,5,75,75
1650563773967,CSE 140L,A01,083088,Eldon; John,0,11,75,75
1650563780000,CSE 175,A01,083665,Kumar; Rakesh,7,0,25,18
1650563786023,CSE 190,A00,092507,Dubnov; Shlomo,10,0,20,10
1650563792053,ECE 45,A01,083139,Staff,1,1,60,59
1650563798097,ECE 65,A50,083695,Staff,0,6,30,30
1650563804127,ECE 109,A01,091882,Touri; Behrouz,33,0,70,37
1650563810150,ECE 180,A00,083140,Abi Samra; Nicholas Camill,21,0,30,9
1650563810150,ECE 180,B00,083141,Abi Samra; Nicholas Camill,0,0,30,30
1650563816178,MATH 10A,A01,083735,Patchell; Gregory David,5,0,30,25
1650563816178,MATH 10A,A02,083736,Patchell; Gregory David,27,0,30,3
1650563816178,MATH 10A,A03,083737,Patchell; Gregory David,24,0,30,6
1650563822201,MATH 10B,A01,083207,Staff,0,9,30,30
1650563822201,MATH 10B,A02,083208,Staff,0,8,30,30
1650563822201,MATH 10B,B01,083739,Staff,11,0,30,19
1650563822201,MATH 10B,B02,083740,Staff,28,0,30,2
1650563828230,MATH 18,A01,083743,Staff,1,0,30,29
1650563828230,MATH 18,A02,083744,Staff,26,0,30,4
1650563828230,MATH 18,A03,083745,Staff,22,0,30,8
1650563828230,MATH 18,A04,083746,Staff,26,0,30,4
1650563828230,MATH 18,B01,083748,Staff,0,14,30,30
1650563828230,MATH 18,B02,083749,Staff,0,12,30,30
1650563828230,MATH 18,B03,083750,Staff,0,12,30,30
1650563828230,MATH 18,B04,083751,Staff,0,12,30,30
1650563834253,MATH 20A,A01,083754,Staff,21,0,40,19
1650563840276,MATH 20B,A01,083756,Staff,0,11,30,30
1650563840276,MATH 20B,A02,083757,Staff,0,12,30,30
1650563846311,MATH 20C,A01,083760,Staff,0,16,30,30
1650563846311,MATH 20C,A02,083761,Staff,2,14,30,28
1650563846311,MATH 20C,B01,083762,Staff,12,0,30,18
1650563846311,MATH 20C,B02,083763,Staff,28,0,30,2
1650563852338,MATH 20D,A01,083765,Staff,0,1,30,30
1650563852338,MATH 20D,A02,083766,Staff,7,0,30,23
1650563852338,MATH 20D,A03,083767,Staff,25,0,30,5
1650563858362,MATH 20E,A01,083771,Staff,6,0,30,24
1650563858362,MATH 20E,A02,083772,Staff,18,0,30,12
1650563858362,MATH 20E,B01,083773,Staff,0,0,30,30
1650563858362,MATH 20E,B02,083774,Staff,10,0,30,20
1650563864394,MATH 103A,A01,083777,Staff,0,15,30,30
1650563864394,MATH 103A,A02,083778,Staff,0,14,30,30
1650563864394,MATH 103A,B01,083779,Staff,0,13,30,30
1650563864394,MATH 103A,B02,083780,Staff,0,13,30,30
1650563870420,MATH 105,A01,085443,Staff,0,21,30,30
1650563876461,MATH 109,A01,083213,Anzaldo; Leesa B,0,7,30,30
1650563876461,MATH 109,A02,083214,Anzaldo; Leesa B,0,7,30,30
1650563876461,MATH 109,B01,083215,Anzaldo; Leesa B,0,5,30,30
1650563876461,MATH 109,B02,083216,Anzaldo; Leesa B,0,6,30,30
1650563882489,MATH 142A,A01,083219,Chow; Bennett,0,16,30,30
1650563882489,MATH 142A,A02,083220,Chow; Bennett,0,14,30,30
1650563882489,MATH 142A,B01,083221,Chow; Bennett,0,13,30,30
1650563882489,MATH 142A,B02,083222,Chow; Bennett,0,13,30,30
1650563888512,MATH 193A,A01,083224,Staff,1,6,30,29
1650563888512,MATH 193A,A02,083225,Staff,0,5,30,30
1650563888512,MATH 193A,A03,083781,Staff,0,6,30,30
1650563888512,MATH 193A,A04,083782,Staff,0,7,30,30
1650563894558,MATH 197,001,091859,McAuley; Julian John,9998,0,9999,1
1650563900626,COGS 9,A01,083615,Staff,0,16,60,60
1650563906650,COGS 11,A01,083617,Boyle; Mary E. T.,19,0,40,21
1650563912680,COGS 13,A01,083071,Staff,0,35,40,40
1650563918704,COGS 14A,A01,092681,Staff,0,27,100,100
1650563924732,COGS 14B,A01,083073,Cheng; Tzu-Han,0,12,50,50
1650563930758,COGS 17,A01,092677,Staff,18,0,75,57
1650563936801,COGS 100,A01,083619,Staff,0,26,60,60
1650563942834,COGS 101A,A01,083621,Davis; Joshua Daniel,0,26,60,60
1650563948857,COGS 101B,A01,091572,Staff,1,5,60,59
1650563954879,COGS 101C,A01,083625,Delgado; Tania,15,0,30,15
1650563960910,COGS 107A,A01,083627,Boyle; Mary E. T.,0,11,60,60
1650563966933,COGS 118A,A01,083075,Staff,0,3,60,60
1650563972967,CSE 3,A50,083646,Miranda; Gregory Joseph,20,0,38,18
1650563972967,CSE 3,A51,083647,Miranda; Gregory Joseph,36,0,37,1
1650563979002,CSE 8A,A50,083650,Miranda; Gregory Joseph,0,29,40,40
1650563985027,CSE 11,A01,083080,Cao; Yingjun,0,94,40,40
1650563991052,CSE 12,A01,083652,Staff,0,18,100,100
1650563997088,CSE 15L,A01,083654,Staff,0,1,50,50
1650563997088,CSE 15L,A02,083655,Staff,0,1,50,50
1650564003113,CSE 20,A01,083657,Staff,51,0,80,29
1650564009140,CSE 30,A01,083084,Eldon; John,0,77,40,40
1650564015164,CSE 100,A01,083659,Cao; Yingjun,0,67,50,50
1650564021188,CSE 134B,A01,083661,Powell; Thomas Allan,0,34,65,65
1650564027211,CSE 140,A01,083663,Staff,0,5,75,75
1650564033245,CSE 140L,A01,083088,Eldon; John,0,11,75,75
1650564039268,CSE 175,A01,083665,Kumar; Rakesh,7,0,25,18
1650564045294,CSE 190,A00,092507,Dubnov; Shlomo,10,0,20,10
1650564051330,ECE 45,A01,083139,Staff,1,1,60,59
1650564057357,ECE 65,A50,083695,Staff,0,6,30,30
1650564063382,ECE 109,A01,091882,Touri; Behrouz,33,0,70,37
1650564069410,ECE 180,A00,083140,Abi Samra; Nicholas Camill,21,0,30,9
1650564069410,ECE 180,B00,083141,Abi Samra; Nicholas Camill,0,0,30,30
1650564075446,MATH 10A,A01,083735,Patchell; Gregory David,5,0,30,25
1650564075446,MATH 10A,A02,083736,Patchell; Gregory David,27,0,30,3
1650564075446,MATH 10A,A03,083737,Patchell; Gregory David,24,0,30,6
1650564081476,MATH 10B,A01,083207,Staff,0,9,30,30
1650564081476,MATH 10B,A02,083208,Staff,0,8,30,30
1650564081476,MATH 10B,B01,083739,Staff,11,0,30,19
1650564081476,MATH 10B,B02,083740,Staff,28,0,30,2
1650564087498,MATH 18,A01,083743,Staff,1,0,30,29
1650564087498,MATH 18,A02,083744,Staff,26,0,30,4
1650564087498,MATH 18,A03,083745,Staff,22,0,30,8
1650564087498,MATH 18,A04,083746,Staff,26,0,30,4
1650564087498,MATH 18,B01,083748,Staff,0,14,30,30
1650564087498,MATH 18,B02,083749,Staff,0,12,30,30
1650564087498,MATH 18,B03,083750,Staff,0,12,30,30
1650564087498,MATH 18,B04,083751,Staff,0,12,30,30
1650564093530,MATH 20A,A01,083754,Staff,21,0,40,19
1650564099562,MATH 20B,A01,083756,Staff,0,11,30,30
1650564099562,MATH 20B,A02,083757,Staff,0,12,30,30
1650564105589,MATH 20C,A01,083760,Staff,0,16,30,30
1650564105589,MATH 20C,A02,083761,Staff,2,14,30,28
1650564105589,MATH 20C,B01,083762,Staff,12,0,30,18
1650564105589,MATH 20C,B02,083763,Staff,28,0,30,2
1650564111612,MATH 20D,A01,083765,Staff,0,1,30,30
1650564111612,MATH 20D,A02,083766,Staff,7,0,30,23
1650564111612,MATH 20D,A03,083767,Staff,25,0,30,5
1650564117646,MATH 20E,A01,083771,Staff,7,0,30,23
1650564117646,MATH 20E,A02,083772,Staff,18,0,30,12
1650564117646,MATH 20E,B01,083773,Staff,0,0,30,30
1650564117646,MATH 20E,B02,083774,Staff,10,0,30,20
1650564123681,MATH 103A,A01,083777,Staff,0,15,30,30
1650564123681,MATH 103A,A02,083778,Staff,0,14,30,30
1650564123681,MATH 103A,B01,083779,Staff,0,13,30,30
1650564123681,MATH 103A,B02,083780,Staff,0,13,30,30
1650564129705,MATH 105,A01,085443,Staff,0,21,30,30
1650564135727,MATH 109,A01,083213,Anzaldo; Leesa B,0,7,30,30
1650564135727,MATH 109,A02,083214,Anzaldo; Leesa B,0,7,30,30
1650564135727,MATH 109,B01,083215,Anzaldo; Leesa B,0,5,30,30
1650564135727,MATH 109,B02,083216,Anzaldo; Leesa B,0,6,30,30
1650564141752,MATH 142A,A01,083219,Chow; Bennett,0,16,30,30
1650564141752,MATH 142A,A02,083220,Chow; Bennett,0,14,30,30
1650564141752,MATH 142A,B01,083221,Chow; Bennett,0,13,30,30
1650564141752,MATH 142A,B02,083222,Chow; Bennett,0,13,30,30
1650564147776,MATH 193A,A01,083224,Staff,1,6,30,29
1650564147776,MATH 193A,A02,083225,Staff,0,5,30,30
1650564147776,MATH 193A,A03,083781,Staff,0,6,30,30
1650564147776,MATH 193A,A04,083782,Staff,0,7,30,30
1650564153806,MATH 197,001,091859,McAuley; Julian John,9998,0,9999,1
1650564159860,COGS 9,A01,083615,Staff,0,16,60,60
1650564165959,COGS 11,A01,083617,Boyle; Mary E. T.,19,0,40,21
1650564171993,COGS 13,A01,083071,Staff,0,35,40,40
1650564178029,COGS 14A,A01,092681,Staff,0,27,100,100
1650564184052,COGS 14B,A01,083073,Cheng; Tzu-Han,0,12,50,50
1650564190076,COGS 17,A01,092677,Staff,18,0,75,57
1650564196109,COGS 100,A01,083619,Staff,0,26,60,60
1650564202132,COGS 101A,A01,083621,Davis; Joshua Daniel,0,26,60,60
1650564208162,COGS 101B,A01,091572,Staff,1,5,60,59
1650564214186,COGS 101C,A01,083625,Delgado; Tania,15,0,30,15
1650564220211,COGS 107A,A01,083627,Boyle; Mary E. T.,0,11,60,60
1650564226235,COGS 118A,A01,083075,Staff,0,3,60,60
1650564232272,CSE 3,A50,083646,Miranda; Gregory Joseph,20,0,38,18
1650564232272,CSE 3,A51,083647,Miranda; Gregory Joseph,36,0,37,1
1650564238299,CSE 8A,A50,083650,Miranda; Gregory Joseph,0,29,40,40
1650564244323,CSE 11,A01,083080,Cao; Yingjun,0,94,40,40
1650564250362,CSE 12,A01,083652,Staff,0,18,100,100
1650564256406,CSE 15L,A01,083654,Staff,0,1,50,50
1650564256406,CSE 15L,A02,083655,Staff,0,1,50,50
1650564262443,CSE 20,A01,083657,Staff,51,0,80,29
1650564268468,CSE 30,A01,083084,Eldon; John,0,77,40,40
1650564274491,CSE 100,A01,083659,Cao; Yingjun,0,67,50,50
1650564280521,CSE 134B,A01,083661,Powell; Thomas Allan,0,34,65,65
1650564286544,CSE 140,A01,083663,Staff,0,5,75,75
1650564292570,CSE 140L,A01,083088,Eldon; John,0,11,75,75
1650564298593,CSE 175,A01,083665,Kumar; Rakesh,7,0,25,18
1650564304617,CSE 190,A00,092507,Dubnov; Shlomo,10,0,20,10
1650564310647,ECE 45,A01,083139,Staff,1,1,60,59
1650564316686,ECE 65,A50,083695,Staff,0,6,30,30
1650564322710,ECE 109,A01,091882,Touri; Behrouz,33,0,70,37
1650564328734,ECE 180,A00,083140,Abi Samra; Nicholas Camill,21,0,30,9
1650564328734,ECE 180,B00,083141,Abi Samra; Nicholas Camill,0,0,30,30
1650564334760,MATH 10A,A01,083735,Patchell; Gregory David,5,0,30,25
1650564334760,MATH 10A,A02,083736,Patchell; Gregory David,27,0,30,3
1650564334760,MATH 10A,A03,083737,Patchell; Gregory David,24,0,30,6
1650564340790,MATH 10B,A01,083207,Staff,0,9,30,30
1650564340790,MATH 10B,A02,083208,Staff,0,8,30,30
1650564340790,MATH 10B,B01,083739,Staff,11,0,30,19
1650564340790,MATH 10B,B02,083740,Staff,28,0,30,2
1650564346823,MATH 18,A01,083743,Staff,1,0,30,29
1650564346823,MATH 18,A02,083744,Staff,26,0,30,4
1650564346823,MATH 18,A03,083745,Staff,22,0,30,8
1650564346823,MATH 18,A04,083746,Staff,26,0,30,4
1650564346823,MATH 18,B01,083748,Staff,0,14,30,30
1650564346823,MATH 18,B02,083749,Staff,0,12,30,30
1650564346823,MATH 18,B03,083750,Staff,0,12,30,30
1650564346823,MATH 18,B04,083751,Staff,0,12,30,30
1650564352860,MATH 20A,A01,083754,Staff,21,0,40,19
1650564358884,MATH 20B,A01,083756,Staff,0,11,30,30
1650564358884,MATH 20B,A02,083757,Staff,0,12,30,30
1650564364912,MATH 20C,A01,083760,Staff,0,16,30,30
1650564364912,MATH 20C,A02,083761,Staff,2,14,30,28
1650564364912,MATH 20C,B01,083762,Staff,12,0,30,18
1650564364912,MATH 20C,B02,083763,Staff,28,0,30,2
1650564370958,MATH 20D,A01,083765,Staff,0,1,30,30
1650564370958,MATH 20D,A02,083766,Staff,7,0,30,23
1650564370958,MATH 20D,A03,083767,Staff,25,0,30,5
1650564376985,MATH 20E,A01,083771,Staff,7,0,30,23
1650564376985,MATH 20E,A02,083772,Staff,18,0,30,12
1650564376985,MATH 20E,B01,083773,Staff,0,0,30,30
1650564376985,MATH 20E,B02,083774,Staff,10,0,30,20
1650564383023,MATH 103A,A01,083777,Staff,0,15,30,30
1650564383023,MATH 103A,A02,083778,Staff,0,14,30,30
1650564383023,MATH 103A,B01,083779,Staff,0,13,30,30
1650564383023,MATH 103A,B02,083780,Staff,0,13,30,30
1650564389052,MATH 105,A01,085443,Staff,0,21,30,30
1650564395080,MATH 109,A01,083213,Anzaldo; Leesa B,0,7,30,30
1650564395080,MATH 109,A02,083214,Anzaldo; Leesa B,0,7,30,30
1650564395080,MATH 109,B01,083215,Anzaldo; Leesa B,0,5,30,30
1650564395080,MATH 109,B02,083216,Anzaldo; Leesa B,0,6,30,30
1650564401112,MATH 142A,A01,083219,Chow; Bennett,0,16,30,30
1650564401112,MATH 142A,A02,083220,Chow; Bennett,0,14,30,30
1650564401112,MATH 142A,B01,083221,Chow; Bennett,0,13,30,30
1650564401112,MATH 142A,B02,083222,Chow; Bennett,0,13,30,30
1650564407153,MATH 193A,A01,083224,Staff,1,6,30,29
1650564407153,MATH 193A,A02,083225,Staff,0,5,30,30
1650564407153,MATH 193A,A03,083781,Staff,0,6,30,30
1650564407153,MATH 193A,A04,083782,Staff,0,7,30,30
1650564413179,MATH 197,001,091859,McAuley; Julian John,9998,0,9999,1
1650564419235,COGS 9,A01,083615,Staff,0,16,60,60
1650564425268,COGS 11,A01,083617,Boyle; Mary E. T.,19,0,40,21
1650564431290,COGS 13,A01,083071,Staff,0,35,40,40
1650564437320,COGS 14A,A01,092681,Staff,0,27,100,100
1650564443354,COGS 14B,A01,083073,Cheng; Tzu-Han,0,12,50,50
1650564449416,COGS 17,A01,092677,Staff,18,0,75,57
1650564455450,COGS 100,A01,083619,Staff,0,26,60,60
1650564461474,COGS 101A,A01,083621,Davis; Joshua Daniel,0,26,60,60
1650564467505,COGS 101B,A01,091572,Staff,1,5,60,59
1650564473532,COGS 101C,A01,083625,Delgado; Tania,15,0,30,15
1650564479555,COGS 107A,A01,083627,Boyle; Mary E. T.,0,11,60,60
1650564485581,COGS 118A,A01,083075,Staff,0,3,60,60
1650564491609,CSE 3,A50,083646,Miranda; Gregory Joseph,20,0,38,18
1650564491609,CSE 3,A51,083647,Miranda; Gregory Joseph,36,0,37,1
1650564497647,CSE 8A,A50,083650,Miranda; Gregory Joseph,0,29,40,40
1650564503685,CSE 11,A01,083080,Cao; Yingjun,0,94,40,40
1650564509707,CSE 12,A01,083652,Staff,0,18,100,100
1650564515737,CSE 15L,A01,083654,Staff,0,1,50,50
1650564515737,CSE 15L,A02,083655,Staff,0,1,50,50
1650564521761,CSE 20,A01,083657,Staff,51,0,80,29
1650564527786,CSE 30,A01,083084,Eldon; John,0,77,40,40
1650564533808,CSE 100,A01,083659,Cao; Yingjun,0,67,50,50
1650564539832,CSE 134B,A01,083661,Powell; Thomas Allan,0,34,65,65
1650564545859,CSE 140,A01,083663,Staff,0,5,75,75
1650564551886,CSE 140L,A01,083088,Eldon; John,0,11,75,75
1650564557910,CSE 175,A01,083665,Kumar; Rakesh,7,0,25,18
1650564563934,CSE 190,A00,092507,Dubnov; Shlomo,10,0,20,10
1650564569967,ECE 45,A01,083139,Staff,1,1,60,59
1650564575991,ECE 65,A50,083695,Staff,0,6,30,30
1650564582014,ECE 109,A01,091882,Touri; Behrouz,33,0,70,37
1650564588039,ECE 180,A00,083140,Abi Samra; Nicholas Camill,21,0,30,9
1650564588039,ECE 180,B00,083141,Abi Samra; Nicholas Camill,0,0,30,30
1650564594063,MATH 10A,A01,083735,Patchell; Gregory David,5,0,30,25
1650564594063,MATH 10A,A02,083736,Patchell; Gregory David,27,0,30,3
1650564594063,MATH 10A,A03,083737,Patchell; Gregory David,24,0,30,6
1650564600102,MATH 10B,A01,083207,Staff,0,9,30,30
1650564600102,MATH 10B,A02,083208,Staff,0,8,30,30
1650564600102,MATH 10B,B01,083739,Staff,11,0,30,19
1650564600102,MATH 10B,B02,083740,Staff,28,0,30,2
1650564606130,MATH 18,A01,083743,Staff,1,0,30,29
1650564606130,MATH 18,A02,083744,Staff,26,0,30,4
1650564606130,MATH 18,A03,083745,Staff,22,0,30,8
1650564606130,MATH 18,A04,083746,Staff,26,0,30,4
1650564606130,MATH 18,B01,083748,Staff,0,14,30,30
1650564606130,MATH 18,B02,083749,Staff,0,12,30,30
1650564606130,MATH 18,B03,083750,Staff,0,12,30,30
1650564606130,MATH 18,B04,083751,Staff,0,12,30,30
1650564612160,MATH 20A,A01,083754,Staff,21,0,40,19
1650564618187,MATH 20B,A01,083756,Staff,0,11,30,30
1650564618187,MATH 20B,A02,083757,Staff,0,12,30,30
1650564624210,MATH 20C,A01,083760,Staff,0,16,30,30
1650564624210,MATH 20C,A02,083761,Staff,2,14,30,28
1650564624210,MATH 20C,B01,083762,Staff,12,0,30,18
1650564624210,MATH 20C,B02,083763,Staff,28,0,30,2
1650564630248,MATH 20D,A01,083765,Staff,0,1,30,30
1650564630248,MATH 20D,A02,083766,Staff,7,0,30,23
1650564630248,MATH 20D,A03,083767,Staff,25,0,30,5
1650564636286,MATH 20E,A01,083771,Staff,7,0,30,23
1650564636286,MATH 20E,A02,083772,Staff,18,0,30,12
1650564636286,MATH 20E,B01,083773,Staff,0,0,30,30
1650564636286,MATH 20E,B02,083774,Staff,10,0,30,20
1650564642311,MATH 103A,A01,083777,Staff,0,15,30,30
1650564642311,MATH 103A,A02,083778,Staff,0,14,30,30
1650564642311,MATH 103A,B01,083779,Staff,0,13,30,30
1650564642311,MATH 103A,B02,083780,Staff,0,13,30,30
1650564648334,MATH 105,A01,085443,Staff,0,21,30,30
1650564654358,MATH 109,A01,083213,Anzaldo; Leesa B,0,7,30,30
1650564654358,MATH 109,A02,083214,Anzaldo; Leesa B,0,7,30,30
1650564654358,MATH 109,B01,083215,Anzaldo; Leesa B,0,5,30,30
1650564654358,MATH 109,B02,083216,Anzaldo; Leesa B,0,6,30,30
1650564660384,MATH 142A,A01,083219,Chow; Bennett,0,16,30,30
1650564660384,MATH 142A,A02,083220,Chow; Bennett,0,14,30,30
1650564660384,MATH 142A,B01,083221,Chow; Bennett,0,13,30,30
1650564660384,MATH 142A,B02,083222,Chow; Bennett,0,13,30,30
1650564666407,MATH 193A,A01,083224,Staff,1,6,30,29
1650564666407,MATH 193A,A02,083225,Staff,0,5,30,30
1650564666407,MATH 193A,A03,083781,Staff,0,6,30,30
1650564666407,MATH 193A,A04,083782,Staff,0,7,30,30
1650564672432,MATH 197,001,091859,McAuley; Julian John,9998,0,9999,1
1650564678502,COGS 9,A01,083615,Staff,0,16,60,60
1650564684531,COGS 11,A01,083617,Boyle; Mary E. T.,19,0,40,21
1650564690553,COGS 13,A01,083071,Staff,0,35,40,40
1650564696579,COGS 14A,A01,092681,Staff,0,27,100,100
1650564702604,COGS 14B,A01,083073,Cheng; Tzu-Han,0,12,50,50
1650564708630,COGS 17,A01,092677,Staff,18,0,75,57
1650564714656,COGS 100,A01,083619,Staff,0,26,60,60
1650564720678,COGS 101A,A01,083621,Davis; Joshua Daniel,0,26,60,60
1650564726704,COGS 101B,A01,091572,Staff,1,5,60,59
1650564732738,COGS 101C,A01,083625,Delgado; Tania,15,0,30,15
1650564738767,COGS 107A,A01,083627,Boyle; Mary E. T.,0,11,60,60
1650564744792,COGS 118A,A01,083075,Staff,0,3,60,60
1650564750825,CSE 3,A50,083646,Miranda; Gregory Joseph,20,0,38,18
1650564750825,CSE 3,A51,083647,Miranda; Gregory Joseph,36,0,37,1
1650564756852,CSE 8A,A50,083650,Miranda; Gregory Joseph,0,29,40,40
1650564762967,CSE 11,A01,083080,Cao; Yingjun,0,94,40,40
1650564768996,CSE 12,A01,083652,Staff,0,18,100,100
1650564775028,CSE 15L,A01,083654,Staff,0,1,50,50
1650564775028,CSE 15L,A02,083655,Staff,0,1,50,50
1650564781054,CSE 20,A01,083657,Staff,51,0,80,29
1650564787079,CSE 30,A01,083084,Eldon; John,0,77,40,40
1650564793102,CSE 100,A01,083659,Cao; Yingjun,0,67,50,50
1650564799128,CSE 134B,A01,083661,Powell; Thomas Allan,0,34,65,65
1650564805155,CSE 140,A01,083663,Staff,0,5,75,75
1650564811179,CSE 140L,A01,083088,Eldon; John,0,11,75,75
1650564817203,CSE 175,A01,083665,Kumar; Rakesh,7,0,25,18
1650564823235,CSE 190,A00,092507,Dubnov; Shlomo,10,0,20,10
1650564829258,ECE 45,A01,083139,Staff,1,1,60,59
1650564835281,ECE 65,A50,083695,Staff,0,6,30,30
1650564841307,ECE 109,A01,091882,Touri; Behrouz,33,0,70,37
1650564847334,ECE 180,A00,083140,Abi Samra; Nicholas Camill,21,0,30,9
1650564847334,ECE 180,B00,083141,Abi Samra; Nicholas Camill,0,0,30,30
1650564853363,MATH 10A,A01,083735,Patchell; Gregory David,5,0,30,25
1650564853363,MATH 10A,A02,083736,Patchell; Gregory David,27,0,30,3
1650564853363,MATH 10A,A03,083737,Patchell; Gregory David,24,0,30,6
1650564859390,MATH 10B,A01,083207,Staff,0,9,30,30
1650564859390,MATH 10B,A02,083208,Staff,0,8,30,30
1650564859390,MATH 10B,B01,083739,Staff,11,0,30,19
1650564859390,MATH 10B,B02,083740,Staff,28,0,30,2
1650564865418,MATH 18,A01,083743,Staff,1,0,30,29
1650564865418,MATH 18,A02,083744,Staff,26,0,30,4
1650564865418,MATH 18,A03,083745,Staff,22,0,30,8
1650564865418,MATH 18,A04,083746,Staff,26,0,30,4
1650564865418,MATH 18,B01,083748,Staff,0,14,30,30
1650564865418,MATH 18,B02,083749,Staff,0,12,30,30
1650564865418,MATH 18,B03,083750,Staff,0,12,30,30
1650564865418,MATH 18,B04,083751,Staff,0,12,30,30
1650564871443,MATH 20A,A01,083754,Staff,21,0,40,19
1650564877468,MATH 20B,A01,083756,Staff,0,11,30,30
1650564877468,MATH 20B,A02,083757,Staff,0,12,30,30
1650564883492,MATH 20C,A01,083760,Staff,0,16,30,30
1650564883492,MATH 20C,A02,083761,Staff,2,14,30,28
1650564883492,MATH 20C,B01,083762,Staff,12,0,30,18
1650564883492,MATH 20C,B02,083763,Staff,28,0,30,2
1650564889519,MATH 20D,A01,083765,Staff,0,1,30,30
1650564889519,MATH 20D,A02,083766,Staff,7,0,30,23
1650564889519,MATH 20D,A03,083767,Staff,25,0,30,5
1650564895543,MATH 20E,A01,083771,Staff,7,0,30,23
1650564895543,MATH 20E,A02,083772,Staff,18,0,30,12
1650564895543,MATH 20E,B01,083773,Staff,0,0,30,30
1650564895543,MATH 20E,B02,083774,Staff,10,0,30,20
1650564901573,MATH 103A,A01,083777,Staff,0,15,30,30
1650564901573,MATH 103A,A02,083778,Staff,0,14,30,30
1650564901573,MATH 103A,B01,083779,Staff,0,13,30,30
1650564901573,MATH 103A,B02,083780,Staff,0,13,30,30
1650564907600,MATH 105,A01,085443,Staff,0,21,30,30
1650564913627,MATH 109,A01,083213,Anzaldo; Leesa B,0,7,30,30
1650564913627,MATH 109,A02,083214,Anzaldo; Leesa B,0,7,30,30
1650564913627,MATH 109,B01,083215,Anzaldo; Leesa B,0,5,30,30
1650564913627,MATH 109,B02,083216,Anzaldo; Leesa B,0,6,30,30
1650564919649,MATH 142A,A01,083219,Chow; Bennett,0,16,30,30
1650564919649,MATH 142A,A02,083220,Chow; Bennett,0,14,30,30
1650564919649,MATH 142A,B01,083221,Chow; Bennett,0,13,30,30
1650564919649,MATH 142A,B02,083222,Chow; Bennett,0,13,30,30
1650564925674,MATH 193A,A01,083224,Staff,1,6,30,29
1650564925674,MATH 193A,A02,083225,Staff,0,5,30,30
1650564925674,MATH 193A,A03,083781,Staff,0,6,30,30
1650564925674,MATH 193A,A04,083782,Staff,0,7,30,30
1650564931700,MATH 197,001,091859,McAuley; Julian John,9998,0,9999,1
1650564937755,COGS 9,A01,083615,Staff,0,16,60,60
1650564943794,COGS 11,A01,083617,Boyle; Mary E. T.,19,0,40,21
1650564949826,COGS 13,A01,083071,Staff,0,35,40,40
1650564955851,COGS 14A,A01,092681,Staff,0,27,100,100
1650564961876,COGS 14B,A01,083073,Cheng; Tzu-Han,0,12,50,50
1650564967902,COGS 17,A01,092677,Staff,18,0,75,57
1650564973928,COGS 100,A01,083619,Staff,0,26,60,60
1650564979953,COGS 101A,A01,083621,Davis; Joshua Daniel,0,26,60,60
1650564985979,COGS 101B,A01,091572,Staff,1,5,60,59
1650564992005,COGS 101C,A01,083625,Delgado; Tania,15,0,30,15
1650564998033,COGS 107A,A01,083627,Boyle; Mary E. T.,0,11,60,60
1650565004066,COGS 118A,A01,083075,Staff,0,3,60,60
1650565010100,CSE 3,A50,083646,Miranda; Gregory Joseph,20,0,38,18
1650565010100,CSE 3,A51,083647,Miranda; Gregory Joseph,36,0,37,1
1650565016123,CSE 8A,A50,083650,Miranda; Gregory Joseph,0,29,40,40
1650565022147,CSE 11,A01,083080,Cao; Yingjun,0,94,40,40
1650565028193,CSE 12,A01,083652,Staff,0,18,100,100
1650565034231,CSE 15L,A01,083654,Staff,0,1,50,50
1650565034231,CSE 15L,A02,083655,Staff,0,1,50,50
1650565040259,CSE 20,A01,083657,Staff,51,0,80,29
1650565046286,CSE 30,A01,083084,Eldon; John,0,77,40,40
1650565052313,CSE 100,A01,083659,Cao; Yingjun,0,67,50,50
1650565058343,CSE 134B,A01,083661,Powell; Thomas Allan,0,34,65,65
1650565064368,CSE 140,A01,083663,Staff,0,5,75,75
1650565070400,CSE 140L,A01,083088,Eldon; John,0,11,75,75
1650565076430,CSE 175,A01,083665,Kumar; Rakesh,7,0,25,18
1650565082454,CSE 190,A00,092507,Dubnov; Shlomo,10,0,20,10
1650565088478,ECE 45,A01,083139,Staff,1,1,60,59
1650565094503,ECE 65,A50,083695,Staff,0,6,30,30
1650565100530,ECE 109,A01,091882,Touri; Behrouz,33,0,70,37
1650565106567,ECE 180,A00,083140,Abi Samra; Nicholas Camill,21,0,30,9
1650565106567,ECE 180,B00,083141,Abi Samra; Nicholas Camill,0,0,30,30
1650565112590,MATH 10A,A01,083735,Patchell; Gregory David,5,0,30,25
1650565112590,MATH 10A,A02,083736,Patchell; Gregory David,27,0,30,3
1650565112590,MATH 10A,A03,083737,Patchell; Gregory David,24,0,30,6
1650565118615,MATH 10B,A01,083207,Staff,0,9,30,30
1650565118615,MATH 10B,A02,083208,Staff,0,8,30,30
1650565118615,MATH 10B,B01,083739,Staff,11,0,30,19
1650565118615,MATH 10B,B02,083740,Staff,28,0,30,2
1650565124640,MATH 18,A01,083743,Staff,1,0,30,29
1650565124640,MATH 18,A02,083744,Staff,26,0,30,4
1650565124640,MATH 18,A03,083745,Staff,22,0,30,8
1650565124640,MATH 18,A04,083746,Staff,26,0,30,4
1650565124640,MATH 18,B01,083748,Staff,0,14,30,30
1650565124640,MATH 18,B02,083749,Staff,0,12,30,30
1650565124640,MATH 18,B03,083750,Staff,0,12,30,30
1650565124640,MATH 18,B04,083751,Staff,0,12,30,30
1650565130669,MATH 20A,A01,083754,Staff,21,0,40,19
1650565136701,MATH 20B,A01,083756,Staff,0,11,30,30
1650565136701,MATH 20B,A02,083757,Staff,0,12,30,30
1650565142731,MATH 20C,A01,083760,Staff,0,16,30,30
1650565142731,MATH 20C,A02,083761,Staff,2,14,30,28
1650565142731,MATH 20C,B01,083762,Staff,12,0,30,18
1650565142731,MATH 20C,B02,083763,Staff,28,0,30,2
1650565148757,MATH 20D,A01,083765,Staff,0,1,30,30
1650565148757,MATH 20D,A02,083766,Staff,7,0,30,23
1650565148757,MATH 20D,A03,083767,Staff,25,0,30,5
1650565154793,MATH 20E,A01,083771,Staff,7,0,30,23
1650565154793,MATH 20E,A02,083772,Staff,18,0,30,12
1650565154793,MATH 20E,B01,083773,Staff,0,0,30,30
1650565154793,MATH 20E,B02,083774,Staff,10,0,30,20
1650565160816,MATH 103A,A01,083777,Staff,0,15,30,30
1650565160816,MATH 103A,A02,083778,Staff,0,14,30,30
1650565160816,MATH 103A,B01,083779,Staff,0,13,30,30
1650565160816,MATH 103A,B02,083780,Staff,0,13,30,30
1650565166840,MATH 105,A01,085443,Staff,0,21,30,30
1650565172866,MATH 109,A01,083213,Anzaldo; Leesa B,0,7,30,30
1650565172866,MATH 109,A02,083214,Anzaldo; Leesa B,0,7,30,30
1650565172866,MATH 109,B01,083215,Anzaldo; Leesa B,0,5,30,30
1650565172866,MATH 109,B02,083216,Anzaldo; Leesa B,0,6,30,30
1650565178890,MATH 142A,A01,083219,Chow; Bennett,0,16,30,30
1650565178890,MATH 142A,A02,083220,Chow; Bennett,0,14,30,30
1650565178890,MATH 142A,B01,083221,Chow; Bennett,0,13,30,30
1650565178890,MATH 142A,B02,083222,Chow; Bennett,0,13,30,30
1650565184915,MATH 193A,A01,083224,Staff,1,6,30,29
1650565184915,MATH 193A,A02,083225,Staff,0,5,30,30
1650565184915,MATH 193A,A03,083781,Staff,0,6,30,30
1650565184915,MATH 193A,A04,083782,Staff,0,7,30,30
1650565190941,MATH 197,001,091859,McAuley; Julian John,9998,0,9999,1
1650565197001,COGS 9,A01,083615,Staff,0,16,60,60
1650565203027,COGS 11,A01,083617,Boyle; Mary E. T.,19,0,40,21
1650565209055,COGS 13,A01,083071,Staff,0,35,40,40
1650565215092,COGS 14A,A01,092681,Staff,0,27,100,100
1650565221115,COGS 14B,A01,083073,Cheng; Tzu-Han,0,12,50,50
1650565227137,COGS 17,A01,092677,Staff,18,0,75,57
1650565233160,COGS 100,A01,083619,Staff,0,26,60,60
1650565239191,COGS 101A,A01,083621,Davis; Joshua Daniel,0,26,60,60
1650565245216,COGS 101B,A01,091572,Staff,1,5,60,59
1650565251243,COGS 101C,A01,083625,Delgado; Tania,15,0,30,15
1650565257273,COGS 107A,A01,083627,Boyle; Mary E. T.,0,11,60,60
1650565263297,COGS 118A,A01,083075,Staff,0,3,60,60
1650565269330,CSE 3,A50,083646,Miranda; Gregory Joseph,20,0,38,18
1650565269330,CSE 3,A51,083647,Miranda; Gregory Joseph,36,0,37,1
1650565275362,CSE 8A,A50,083650,Miranda; Gregory Joseph,0,29,40,40
1650565281417,CSE 11,A01,083080,Cao; Yingjun,0,94,40,40
1650565287450,CSE 12,A01,083652,Staff,0,18,100,100
1650565293473,CSE 15L,A01,083654,Staff,0,1,50,50
1650565293473,CSE 15L,A02,083655,Staff,0,1,50,50
1650565299498,CSE 20,A01,083657,Staff,51,0,80,29
1650565305531,CSE 30,A01,083084,Eldon; John,0,77,40,40
1650565311554,CSE 100,A01,083659,Cao; Yingjun,0,67,50,50
1650565317596,CSE 134B,A01,083661,Powell; Thomas Allan,0,34,65,65
1650565323619,CSE 140,A01,083663,Staff,0,5,75,75
1650565329650,CSE 140L,A01,083088,Eldon; John,0,11,75,75
1650565335684,CSE 175,A01,083665,Kumar; Rakesh,7,0,25,18
1650565341709,CSE 190,A00,092507,Dubnov; Shlomo,10,0,20,10
1650565347735,ECE 45,A01,083139,Staff,1,1,60,59
1650565353767,ECE 65,A50,083695,Staff,0,6,30,30
1650565359891,ECE 109,A01,091882,Touri; Behrouz,33,0,70,37
1650565365915,ECE 180,A00,083140,Abi Samra; Nicholas Camill,21,0,30,9
1650565365915,ECE 180,B00,083141,Abi Samra; Nicholas Camill,0,0,30,30
1650565371938,MATH 10A,A01,083735,Patchell; Gregory David,5,0,30,25
1650565371938,MATH 10A,A02,083736,Patchell; Gregory David,27,0,30,3
1650565371938,MATH 10A,A03,083737,Patchell; Gregory David,24,0,30,6
1650565377970,MATH 10B,A01,083207,Staff,0,9,30,30
1650565377970,MATH 10B,A02,083208,Staff,0,8,30,30
1650565377970,MATH 10B,B01,083739,Staff,11,0,30,19
1650565377970,MATH 10B,B02,083740,Staff,28,0,30,2
1650565384001,MATH 18,A01,083743,Staff,1,0,30,29
1650565384001,MATH 18,A02,083744,Staff,26,0,30,4
1650565384001,MATH 18,A03,083745,Staff,22,0,30,8
1650565384001,MATH 18,A04,083746,Staff,26,0,30,4
1650565384001,MATH 18,B01,083748,Staff,0,14,30,30
1650565384001,MATH 18,B02,083749,Staff,0,12,30,30
1650565384001,MATH 18,B03,083750,Staff,0,12,30,30
1650565384001,MATH 18,B04,083751,Staff,0,12,30,30
1650565390026,MATH 20A,A01,083754,Staff,21,0,40,19
1650565396059,MATH 20B,A01,083756,Staff,0,11,30,30
1650565396059,MATH 20B,A02,083757,Staff,0,12,30,30
1650565402093,MATH 20C,A01,083760,Staff,0,16,30,30
1650565402093,MATH 20C,A02,083761,Staff,2,14,30,28
1650565402093,MATH 20C,B01,083762,Staff,12,0,30,18
1650565402093,MATH 20C,B02,083763,Staff,28,0,30,2
1650565408119,MATH 20D,A01,083765,Staff,0,1,30,30
1650565408119,MATH 20D,A02,083766,Staff,7,0,30,23
1650565408119,MATH 20D,A03,083767,Staff,25,0,30,5
1650565414146,MATH 20E,A01,083771,Staff,7,0,30,23
1650565414146,MATH 20E,A02,083772,Staff,18,0,30,12
1650565414146,MATH 20E,B01,083773,Staff,0,0,30,30
1650565414146,MATH 20E,B02,083774,Staff,10,0,30,20
1650565420173,MATH 103A,A01,083777,Staff,0,15,30,30
1650565420173,MATH 103A,A02,083778,Staff,0,14,30,30
1650565420173,MATH 103A,B01,083779,Staff,0,13,30,30
1650565420173,MATH 103A,B02,083780,Staff,0,13,30,30
1650565426203,MATH 105,A01,085443,Staff,0,21,30,30
1650565432226,MATH 109,A01,083213,Anzaldo; Leesa B,0,7,30,30
1650565432226,MATH 109,A02,083214,Anzaldo; Leesa B,0,7,30,30
1650565432226,MATH 109,B01,083215,Anzaldo; Leesa B,0,5,30,30
1650565432226,MATH 109,B02,083216,Anzaldo; Leesa B,0,6,30,30
1650565438254,MATH 142A,A01,083219,Chow; Bennett,0,16,30,30
1650565438254,MATH 142A,A02,083220,Chow; Bennett,0,14,30,30
1650565438254,MATH 142A,B01,083221,Chow; Bennett,0,13,30,30
1650565438254,MATH 142A,B02,083222,Chow; Bennett,0,13,30,30
1650565444283,MATH 193A,A01,083224,Staff,1,6,30,29
1650565444283,MATH 193A,A02,083225,Staff,0,5,30,30
1650565444283,MATH 193A,A03,083781,Staff,0,6,30,30
1650565444283,MATH 193A,A04,083782,Staff,0,7,30,30
1650565450309,MATH 197,001,091859,McAuley; Julian John,9998,0,9999,1
1650565456373,COGS 9,A01,083615,Staff,0,16,60,60
1650565462396,COGS 11,A01,083617,Boyle; Mary E. T.,19,0,40,21
1650565468420,COGS 13,A01,083071,Staff,0,35,40,40
1650565474457,COGS 14A,A01,092681,Staff,0,27,100,100
1650565480481,COGS 14B,A01,083073,Cheng; Tzu-Han,0,12,50,50
1650565486509,COGS 17,A01,092677,Staff,18,0,75,57
1650565492541,COGS 100,A01,083619,Staff,0,26,60,60
1650565498569,COGS 101A,A01,083621,Davis; Joshua Daniel,0,26,60,60
1650565504596,COGS 101B,A01,091572,Staff,1,5,60,59
1650565510631,COGS 101C,A01,083625,Delgado; Tania,15,0,30,15
1650565516662,COGS 107A,A01,083627,Boyle; Mary E. T.,0,11,60,60
1650565522688,COGS 118A,A01,083075,Staff,0,3,60,60
1650565528712,CSE 3,A50,083646,Miranda; Gregory Joseph,20,0,38,18
1650565528712,CSE 3,A51,083647,Miranda; Gregory Joseph,36,0,37,1
1650565534738,CSE 8A,A50,083650,Miranda; Gregory Joseph,0,29,40,40
1650565540785,CSE 11,A01,083080,Cao; Yingjun,0,94,40,40
1650565546810,CSE 12,A01,083652,Staff,0,18,100,100
1650565552837,CSE 15L,A01,083654,Staff,0,1,50,50
1650565552837,CSE 15L,A02,083655,Staff,0,1,50,50
1650565558864,CSE 20,A01,083657,Staff,51,0,80,29
1650565564890,CSE 30,A01,083084,Eldon; John,0,77,40,40
1650565570914,CSE 100,A01,083659,Cao; Yingjun,0,67,50,50
1650565576942,CSE 134B,A01,083661,Powell; Thomas Allan,0,34,65,65
1650565582978,CSE 140,A01,083663,Staff,0,5,75,75
1650565589005,CSE 140L,A01,083088,Eldon; John,0,11,75,75
1650565595031,CSE 175,A01,083665,Kumar; Rakesh,7,0,25,18
1650565601076,CSE 190,A00,092507,Dubnov; Shlomo,10,0,20,10
1650565607106,ECE 45,A01,083139,Staff,1,1,60,59
1650565613129,ECE 65,A50,083695,Staff,0,6,30,30
1650565619155,ECE 109,A01,091882,Touri; Behrouz,33,0,70,37
1650565625178,ECE 180,A00,083140,Abi Samra; Nicholas Camill,21,0,30,9
1650565625178,ECE 180,B00,083141,Abi Samra; Nicholas Camill,0,0,30,30
1650565631202,MATH 10A,A01,083735,Patchell; Gregory David,5,0,30,25
1650565631202,MATH 10A,A02,083736,Patchell; Gregory David,27,0,30,3
1650565631202,MATH 10A,A03,083737,Patchell; Gregory David,24,0,30,6
1650565637233,MATH 10B,A01,083207,Staff,0,9,30,30
1650565637233,MATH 10B,A02,083208,Staff,0,8,30,30
1650565637233,MATH 10B,B01,083739,Staff,11,0,30,19
1650565637233,MATH 10B,B02,083740,Staff,28,0,30,2
1650565643261,MATH 18,A01,083743,Staff,1,0,30,29
1650565643261,MATH 18,A02,083744,Staff,26,0,30,4
1650565643261,MATH 18,A03,083745,Staff,22,0,30,8
1650565643261,MATH 18,A04,083746,Staff,26,0,30,4
1650565643261,MATH 18,B01,083748,Staff,0,14,30,30
1650565643261,MATH 18,B02,083749,Staff,0,12,30,30
1650565643261,MATH 18,B03,083750,Staff,0,12,30,30
1650565643261,MATH 18,B04,083751,Staff,0,12,30,30
1650565649286,MATH 20A,A01,083754,Staff,21,0,40,19
1650565655320,MATH 20B,A01,083756,Staff,0,11,30,30
1650565655320,MATH 20B,A02,083757,Staff,0,12,30,30
1650565661347,MATH 20C,A01,083760,Staff,0,16,30,30
1650565661347,MATH 20C,A02,083761,Staff,2,14,30,28
1650565661347,MATH 20C,B01,083762,Staff,12,0,30,18
1650565661347,MATH 20C,B02,083763,Staff,28,0,30,2
1650565667370,MATH 20D,A01,083765,Staff,0,1,30,30
1650565667370,MATH 20D,A02,083766,Staff,7,0,30,23
1650565667370,MATH 20D,A03,083767,Staff,25,0,30,5
1650565673397,MATH 20E,A01,083771,Staff,7,0,30,23
1650565673397,MATH 20E,A02,083772,Staff,18,0,30,12
1650565673397,MATH 20E,B01,083773,Staff,0,0,30,30
1650565673397,MATH 20E,B02,083774,Staff,10,0,30,20
1650565679421,MATH 103A,A01,083777,Staff,0,15,30,30
1650565679421,MATH 103A,A02,083778,Staff,0,14,30,30
1650565679421,MATH 103A,B01,083779,Staff,0,13,30,30
1650565679421,MATH 103A,B02,083780,Staff,0,13,30,30
1650565685444,MATH 105,A01,085443,Staff,0,21,30,30
1650565691468,MATH 109,A01,083213,Anzaldo; Leesa B,0,7,30,30
1650565691468,MATH 109,A02,083214,Anzaldo; Leesa B,0,7,30,30
1650565691468,MATH 109,B01,083215,Anzaldo; Leesa B,0,5,30,30
1650565691468,MATH 109,B02,083216,Anzaldo; Leesa B,0,6,30,30
1650565697499,MATH 142A,A01,083219,Chow; Bennett,0,16,30,30
1650565697499,MATH 142A,A02,083220,Chow; Bennett,0,14,30,30
1650565697499,MATH 142A,B01,083221,Chow; Bennett,0,13,30,30
1650565697499,MATH 142A,B02,083222,Chow; Bennett,0,13,30,30
1650565703522,MATH 193A,A01,083224,Staff,1,6,30,29
1650565703522,MATH 193A,A02,083225,Staff,0,5,30,30
1650565703522,MATH 193A,A03,083781,Staff,0,6,30,30
1650565703522,MATH 193A,A04,083782,Staff,0,7,30,30
1650565709548,MATH 197,001,091859,McAuley; Julian John,9998,0,9999,1
1650565715618,COGS 9,A01,083615,Staff,0,16,60,60
1650565721651,COGS 11,A01,083617,Boyle; Mary E. T.,18,0,40,22
1650565727674,COGS 13,A01,083071,Staff,0,35,40,40
1650565733703,COGS 14A,A01,092681,Staff,0,27,100,100
1650565739732,COGS 14B,A01,083073,Cheng; Tzu-Han,0,12,50,50
1650565745758,COGS 17,A01,092677,Staff,18,0,75,57
1650565751793,COGS 100,A01,083619,Staff,0,26,60,60
1650565757817,COGS 101A,A01,083621,Davis; Joshua Daniel,0,26,60,60
1650565763843,COGS 101B,A01,091572,Staff,1,5,60,59
1650565769869,COGS 101C,A01,083625,Delgado; Tania,15,0,30,15
1650565775892,COGS 107A,A01,083627,Boyle; Mary E. T.,0,11,60,60
1650565781923,COGS 118A,A01,083075,Staff,0,3,60,60
1650565787946,CSE 3,A50,083646,Miranda; Gregory Joseph,20,0,38,18
1650565787946,CSE 3,A51,083647,Miranda; Gregory Joseph,36,0,37,1
1650565793970,CSE 8A,A50,083650,Miranda; Gregory Joseph,0,29,40,40
1650565799994,CSE 11,A01,083080,Cao; Yingjun,0,94,40,40
1650565806016,CSE 12,A01,083652,Staff,0,18,100,100
1650565812044,CSE 15L,A01,083654,Staff,0,1,50,50
1650565812044,CSE 15L,A02,083655,Staff,0,1,50,50
1650565818071,CSE 20,A01,083657,Staff,51,0,80,29
1650565824094,CSE 30,A01,083084,Eldon; John,0,77,40,40
1650565830123,CSE 100,A01,083659,Cao; Yingjun,0,67,50,50
1650565836147,CSE 134B,A01,083661,Powell; Thomas Allan,0,34,65,65
1650565842172,CSE 140,A01,083663,Staff,0,5,75,75
1650565848204,CSE 140L,A01,083088,Eldon; John,0,11,75,75
1650565854228,CSE 175,A01,083665,Kumar; Rakesh,7,0,25,18
1650565860259,CSE 190,A00,092507,Dubnov; Shlomo,10,0,20,10
1650565866283,ECE 45,A01,083139,Staff,1,1,60,59
1650565872309,ECE 65,A50,083695,Staff,1,6,30,29
1650565878333,ECE 109,A01,091882,Touri; Behrouz,33,0,70,37
1650565884363,ECE 180,A00,083140,Abi Samra; Nicholas Camill,21,0,30,9
1650565884363,ECE 180,B00,083141,Abi Samra; Nicholas Camill,0,0,30,30
1650565890401,MATH 10A,A01,083735,Patchell; Gregory David,5,0,30,25
1650565890401,MATH 10A,A02,083736,Patchell; Gregory David,27,0,30,3
1650565890401,MATH 10A,A03,083737,Patchell; Gregory David,24,0,30,6
1650565896432,MATH 10B,A01,083207,Staff,0,9,30,30
1650565896432,MATH 10B,A02,083208,Staff,0,8,30,30
1650565896432,MATH 10B,B01,083739,Staff,11,0,30,19
1650565896432,MATH 10B,B02,083740,Staff,28,0,30,2
1650565902459,MATH 18,A01,083743,Staff,1,0,30,29
1650565902459,MATH 18,A02,083744,Staff,26,0,30,4
1650565902459,MATH 18,A03,083745,Staff,22,0,30,8
1650565902459,MATH 18,A04,083746,Staff,26,0,30,4
1650565902459,MATH 18,B01,083748,Staff,0,14,30,30
1650565902459,MATH 18,B02,083749,Staff,0,12,30,30
1650565902459,MATH 18,B03,083750,Staff,0,12,30,30
1650565902459,MATH 18,B04,083751,Staff,0,12,30,30
1650565908484,MATH 20A,A01,083754,Staff,21,0,40,19
1650565914519,MATH 20B,A01,083756,Staff,0,11,30,30
1650565914519,MATH 20B,A02,083757,Staff,0,12,30,30
1650565920554,MATH 20C,A01,083760,Staff,0,16,30,30
1650565920554,MATH 20C,A02,083761,Staff,2,14,30,28
1650565920554,MATH 20C,B01,083762,Staff,12,0,30,18
1650565920554,MATH 20C,B02,083763,Staff,28,0,30,2
1650565926599,MATH 20D,A01,083765,Staff,0,1,30,30
1650565926599,MATH 20D,A02,083766,Staff,7,0,30,23
1650565926599,MATH 20D,A03,083767,Staff,25,0,30,5
1650565932637,MATH 20E,A01,083771,Staff,7,0,30,23
1650565932637,MATH 20E,A02,083772,Staff,18,0,30,12
1650565932637,MATH 20E,B01,083773,Staff,0,0,30,30
1650565932637,MATH 20E,B02,083774,Staff,10,0,30,20
1650565938662,MATH 103A,A01,083777,Staff,0,15,30,30
1650565938662,MATH 103A,A02,083778,Staff,0,14,30,30
1650565938662,MATH 103A,B01,083779,Staff,0,13,30,30
1650565938662,MATH 103A,B02,083780,Staff,0,13,30,30
1650565944685,MATH 105,A01,085443,Staff,0,21,30,30
1650565950713,MATH 109,A01,083213,Anzaldo; Leesa B,0,7,30,30
1650565950713,MATH 109,A02,083214,Anzaldo; Leesa B,0,7,30,30
1650565950713,MATH 109,B01,083215,Anzaldo; Leesa B,0,5,30,30
1650565950713,MATH 109,B02,083216,Anzaldo; Leesa B,0,6,30,30
1650565956832,MATH 142A,A01,083219,Chow; Bennett,0,16,30,30
1650565956832,MATH 142A,A02,083220,Chow; Bennett,0,14,30,30
1650565956832,MATH 142A,B01,083221,Chow; Bennett,0,13,30,30
1650565956832,MATH 142A,B02,083222,Chow; Bennett,0,13,30,30
1650565962867,MATH 193A,A01,083224,Staff,1,6,30,29
1650565962867,MATH 193A,A02,083225,Staff,0,5,30,30
1650565962867,MATH 193A,A03,083781,Staff,0,6,30,30
1650565962867,MATH 193A,A04,083782,Staff,0,7,30,30
1650565968890,MATH 197,001,091859,McAuley; Julian John,9998,0,9999,1
1650565974967,COGS 9,A01,083615,Staff,0,16,60,60
1650565980991,COGS 11,A01,083617,Boyle; Mary E. T.,18,0,40,22
1650565987017,COGS 13,A01,083071,Staff,0,35,40,40
1650565993044,COGS 14A,A01,092681,Staff,0,27,100,100
1650565999075,COGS 14B,A01,083073,Cheng; Tzu-Han,0,12,50,50
1650566005114,COGS 17,A01,092677,Staff,18,0,75,57
1650566011140,COGS 100,A01,083619,Staff,0,26,60,60
1650566017166,COGS 101A,A01,083621,Davis; Joshua Daniel,0,26,60,60
1650566023189,COGS 101B,A01,091572,Staff,1,5,60,59
1650566029215,COGS 101C,A01,083625,Delgado; Tania,15,0,30,15
1650566035239,COGS 107A,A01,083627,Boyle; Mary E. T.,0,12,60,60
1650566041265,COGS 118A,A01,083075,Staff,0,3,60,60
1650566047321,CSE 3,A50,083646,Miranda; Gregory Joseph,20,0,38,18
1650566047321,CSE 3,A51,083647,Miranda; Gregory Joseph,36,0,37,1
1650566053346,CSE 8A,A50,083650,Miranda; Gregory Joseph,0,29,40,40
1650566059373,CSE 11,A01,083080,Cao; Yingjun,0,93,40,40
1650566065410,CSE 12,A01,083652,Staff,0,18,100,100
1650566071437,CSE 15L,A01,083654,Staff,0,1,50,50
1650566071437,CSE 15L,A02,083655,Staff,0,1,50,50
1650566077461,CSE 20,A01,083657,Staff,51,0,80,29
1650566083484,CSE 30,A01,083084,Eldon; John,0,77,40,40
1650566089519,CSE 100,A01,083659,Cao; Yingjun,0,67,50,50
1650566095546,CSE 134B,A01,083661,Powell; Thomas Allan,0,34,65,65
1650566101572,CSE 140,A01,083663,Staff,0,5,75,75
1650566107614,CSE 140L,A01,083088,Eldon; John,0,11,75,75
1650566113642,CSE 175,A01,083665,Kumar; Rakesh,7,0,25,18
1650566119670,CSE 190,A00,092507,Dubnov; Shlomo,10,0,20,10
1650566125696,ECE 45,A01,083139,Staff,1,1,60,59
1650566131737,ECE 65,A50,083695,Staff,1,6,30,29
1650566137766,ECE 109,A01,091882,Touri; Behrouz,33,0,70,37
1650566143791,ECE 180,A00,083140,Abi Samra; Nicholas Camill,21,0,30,9
1650566143791,ECE 180,B00,083141,Abi Samra; Nicholas Camill,0,0,30,30
1650566149816,MATH 10A,A01,083735,Patchell; Gregory David,5,0,30,25
1650566149816,MATH 10A,A02,083736,Patchell; Gregory David,27,0,30,3
1650566149816,MATH 10A,A03,083737,Patchell; Gregory David,24,0,30,6
1650566155848,MATH 10B,A01,083207,Staff,0,9,30,30
1650566155848,MATH 10B,A02,083208,Staff,0,8,30,30
1650566155848,MATH 10B,B01,083739,Staff,11,0,30,19
1650566155848,MATH 10B,B02,083740,Staff,28,0,30,2
1650566161875,MATH 18,A01,083743,Staff,1,0,30,29
1650566161875,MATH 18,A02,083744,Staff,26,0,30,4
1650566161875,MATH 18,A03,083745,Staff,22,0,30,8
1650566161875,MATH 18,A04,083746,Staff,26,0,30,4
1650566161875,MATH 18,B01,083748,Staff,0,14,30,30
1650566161875,MATH 18,B02,083749,Staff,0,12,30,30
1650566161875,MATH 18,B03,083750,Staff,0,12,30,30
1650566161875,MATH 18,B04,083751,Staff,0,12,30,30
1650566167897,MATH 20A,A01,083754,Staff,21,0,40,19
1650566173921,MATH 20B,A01,083756,Staff,0,11,30,30
1650566173921,MATH 20B,A02,083757,Staff,0,12,30,30
1650566179945,MATH 20C,A01,083760,Staff,0,16,30,30
1650566179945,MATH 20C,A02,083761,Staff,2,14,30,28
1650566179945,MATH 20C,B01,083762,Staff,12,0,30,18
1650566179945,MATH 20C,B02,083763,Staff,28,0,30,2
1650566185970,MATH 20D,A01,083765,Staff,0,1,30,30
1650566185970,MATH 20D,A02,083766,Staff,7,0,30,23
1650566185970,MATH 20D,A03,083767,Staff,25,0,30,5
1650566192005,MATH 20E,A01,083771,Staff,7,0,30,23
1650566192005,MATH 20E,A02,083772,Staff,18,0,30,12
1650566192005,MATH 20E,B01,083773,Staff,0,0,30,30
1650566192005,MATH 20E,B02,083774,Staff,10,0,30,20
1650566198031,MATH 103A,A01,083777,Staff,0,15,30,30
1650566198031,MATH 103A,A02,083778,Staff,0,14,30,30
1650566198031,MATH 103A,B01,083779,Staff,0,13,30,30
1650566198031,MATH 103A,B02,083780,Staff,0,13,30,30
1650566204056,MATH 105,A01,085443,Staff,0,21,30,30
1650566210084,MATH 109,A01,083213,Anzaldo; Leesa B,0,7,30,30
1650566210084,MATH 109,A02,083214,Anzaldo; Leesa B,0,7,30,30
1650566210084,MATH 109,B01,083215,Anzaldo; Leesa B,0,5,30,30
1650566210084,MATH 109,B02,083216,Anzaldo; Leesa B,0,6,30,30
1650566216108,MATH 142A,A01,083219,Chow; Bennett,0,16,30,30
1650566216108,MATH 142A,A02,083220,Chow; Bennett,0,14,30,30
1650566216108,MATH 142A,B01,083221,Chow; Bennett,0,13,30,30
1650566216108,MATH 142A,B02,083222,Chow; Bennett,0,13,30,30
1650566222131,MATH 193A,A01,083224,Staff,1,6,30,29
1650566222131,MATH 193A,A02,083225,Staff,0,5,30,30
1650566222131,MATH 193A,A03,083781,Staff,0,6,30,30
1650566222131,MATH 193A,A04,083782,Staff,0,7,30,30
1650566228155,MATH 197,001,091859,McAuley; Julian John,9998,0,9999,1
1650566234216,COGS 9,A01,083615,Staff,0,16,60,60
1650566240244,COGS 11,A01,083617,Boyle; Mary E. T.,18,0,40,22
1650566246268,COGS 13,A01,083071,Staff,0,35,40,40
1650566252292,COGS 14A,A01,092681,Staff,0,27,100,100
1650566258323,COGS 14B,A01,083073,Cheng; Tzu-Han,0,12,50,50
1650566264346,COGS 17,A01,092677,Staff,18,0,75,57
1650566270368,COGS 100,A01,083619,Staff,0,26,60,60
1650566276395,COGS 101A,A01,083621,Davis; Joshua Daniel,0,26,60,60
1650566282430,COGS 101B,A01,091572,Staff,1,5,60,59
1650566288453,COGS 101C,A01,083625,Delgado; Tania,15,0,30,15
1650566294479,COGS 107A,A01,083627,Boyle; Mary E. T.,0,12,60,60
1650566300511,COGS 118A,A01,083075,Staff,0,3,60,60
1650566306534,CSE 3,A50,083646,Miranda; Gregory Joseph,20,0,38,18
1650566306534,CSE 3,A51,083647,Miranda; Gregory Joseph,36,0,37,1
1650566312558,CSE 8A,A50,083650,Miranda; Gregory Joseph,0,29,40,40
1650566318582,CSE 11,A01,083080,Cao; Yingjun,0,93,40,40
1650566324607,CSE 12,A01,083652,Staff,0,18,100,100
1650566330632,CSE 15L,A01,083654,Staff,0,1,50,50
1650566330632,CSE 15L,A02,083655,Staff,0,1,50,50
1650566336658,CSE 20,A01,083657,Staff,51,0,80,29
1650566342688,CSE 30,A01,083084,Eldon; John,0,77,40,40
1650566348712,CSE 100,A01,083659,Cao; Yingjun,0,67,50,50
1650566354741,CSE 134B,A01,083661,Powell; Thomas Allan,0,34,65,65
1650566360768,CSE 140,A01,083663,Staff,0,5,75,75
1650566366800,CSE 140L,A01,083088,Eldon; John,0,11,75,75
1650566372824,CSE 175,A01,083665,Kumar; Rakesh,7,0,25,18
1650566378879,CSE 190,A00,092507,Dubnov; Shlomo,10,0,20,10
1650566384904,ECE 45,A01,083139,Staff,1,1,60,59
1650566390930,ECE 65,A50,083695,Staff,1,6,30,29
1650566396964,ECE 109,A01,091882,Touri; Behrouz,33,0,70,37
1650566402987,ECE 180,A00,083140,Abi Samra; Nicholas Camill,21,0,30,9
1650566402987,ECE 180,B00,083141,Abi Samra; Nicholas Camill,0,0,30,30
1650566409019,MATH 10A,A01,083735,Patchell; Gregory David,5,0,30,25
1650566409019,MATH 10A,A02,083736,Patchell; Gregory David,27,0,30,3
1650566409019,MATH 10A,A03,083737,Patchell; Gregory David,24,0,30,6
1650566415045,MATH 10B,A01,083207,Staff,0,9,30,30
1650566415045,MATH 10B,A02,083208,Staff,0,8,30,30
1650566415045,MATH 10B,B01,083739,Staff,11,0,30,19
1650566415045,MATH 10B,B02,083740,Staff,28,0,30,2
1650566421069,MATH 18,A01,083743,Staff,1,0,30,29
1650566421069,MATH 18,A02,083744,Staff,26,0,30,4
1650566421069,MATH 18,A03,083745,Staff,22,0,30,8
1650566421069,MATH 18,A04,083746,Staff,26,0,30,4
1650566421069,MATH 18,B01,083748,Staff,0,14,30,30
1650566421069,MATH 18,B02,083749,Staff,0,12,30,30
1650566421069,MATH 18,B03,083750,Staff,0,12,30,30
1650566421069,MATH 18,B04,083751,Staff,0,12,30,30
1650566427092,MATH 20A,A01,083754,Staff,21,0,40,19
1650566433115,MATH 20B,A01,083756,Staff,0,11,30,30
1650566433115,MATH 20B,A02,083757,Staff,0,12,30,30
1650566439138,MATH 20C,A01,083760,Staff,0,16,30,30
1650566439138,MATH 20C,A02,083761,Staff,2,14,30,28
1650566439138,MATH 20C,B01,083762,Staff,12,0,30,18
1650566439138,MATH 20C,B02,083763,Staff,28,0,30,2
1650566445165,MATH 20D,A01,083765,Staff,0,1,30,30
1650566445165,MATH 20D,A02,083766,Staff,7,0,30,23
1650566445165,MATH 20D,A03,083767,Staff,25,0,30,5
1650566451201,MATH 20E,A01,083771,Staff,7,0,30,23
1650566451201,MATH 20E,A02,083772,Staff,18,0,30,12
1650566451201,MATH 20E,B01,083773,Staff,0,0,30,30
1650566451201,MATH 20E,B02,083774,Staff,10,0,30,20
1650566457229,MATH 103A,A01,083777,Staff,0,15,30,30
1650566457229,MATH 103A,A02,083778,Staff,0,14,30,30
1650566457229,MATH 103A,B01,083779,Staff,0,13,30,30
1650566457229,MATH 103A,B02,083780,Staff,0,13,30,30
1650566463278,MATH 105,A01,085443,Staff,0,21,30,30
1650566469305,MATH 109,A01,083213,Anzaldo; Leesa B,0,7,30,30
1650566469305,MATH 109,A02,083214,Anzaldo; Leesa B,0,7,30,30
1650566469305,MATH 109,B01,083215,Anzaldo; Leesa B,0,5,30,30
1650566469305,MATH 109,B02,083216,Anzaldo; Leesa B,0,6,30,30
1650566475328,MATH 142A,A01,083219,Chow; Bennett,0,16,30,30
1650566475328,MATH 142A,A02,083220,Chow; Bennett,0,14,30,30
1650566475328,MATH 142A,B01,083221,Chow; Bennett,0,13,30,30
1650566475328,MATH 142A,B02,083222,Chow; Bennett,0,13,30,30
1650566481362,MATH 193A,A01,083224,Staff,1,6,30,29
1650566481362,MATH 193A,A02,083225,Staff,0,5,30,30
1650566481362,MATH 193A,A03,083781,Staff,0,6,30,30
1650566481362,MATH 193A,A04,083782,Staff,0,7,30,30
1650566487392,MATH 197,001,091859,McAuley; Julian John,9998,0,9999,1
1650566493452,COGS 9,A01,083615,Staff,0,16,60,60
1650566499478,COGS 11,A01,083617,Boyle; Mary E. T.,18,0,40,22
1650566505507,COGS 13,A01,083071,Staff,0,35,40,40
1650566511531,COGS 14A,A01,092681,Staff,0,27,100,100
1650566517553,COGS 14B,A01,083073,Cheng; Tzu-Han,0,12,50,50
1650566523576,COGS 17,A01,092677,Staff,18,0,75,57
1650566529600,COGS 100,A01,083619,Staff,0,26,60,60
1650566535626,COGS 101A,A01,083621,Davis; Joshua Daniel,0,26,60,60
1650566541650,COGS 101B,A01,091572,Staff,1,5,60,59
1650566547766,COGS 101C,A01,083625,Delgado; Tania,15,0,30,15
1650566553791,COGS 107A,A01,083627,Boyle; Mary E. T.,0,12,60,60
1650566559823,COGS 118A,A01,083075,Staff,0,3,60,60
1650566565847,CSE 3,A50,083646,Miranda; Gregory Joseph,20,0,38,18
1650566565847,CSE 3,A51,083647,Miranda; Gregory Joseph,36,0,37,1
1650566571872,CSE 8A,A50,083650,Miranda; Gregory Joseph,0,29,40,40
1650566577896,CSE 11,A01,083080,Cao; Yingjun,0,93,40,40
1650566583929,CSE 12,A01,083652,Staff,0,18,100,100
1650566589960,CSE 15L,A01,083654,Staff,0,1,50,50
1650566589960,CSE 15L,A02,083655,Staff,0,1,50,50
1650566595999,CSE 20,A01,083657,Staff,51,0,80,29
1650566602035,CSE 30,A01,083084,Eldon; John,0,77,40,40
1650566608076,CSE 100,A01,083659,Cao; Yingjun,0,67,50,50
1650566614107,CSE 134B,A01,083661,Powell; Thomas Allan,0,34,65,65
1650566620132,CSE 140,A01,083663,Staff,0,5,75,75
1650566626164,CSE 140L,A01,083088,Eldon; John,0,11,75,75
1650566632190,CSE 175,A01,083665,Kumar; Rakesh,7,0,25,18
1650566638216,CSE 190,A00,092507,Dubnov; Shlomo,10,0,20,10
1650566644243,ECE 45,A01,083139,Staff,1,1,60,59
1650566650266,ECE 65,A50,083695,Staff,1,6,30,29
1650566656293,ECE 109,A01,091882,Touri; Behrouz,33,0,70,37
1650566662324,ECE 180,A00,083140,Abi Samra; Nicholas Camill,21,0,30,9
1650566662324,ECE 180,B00,083141,Abi Samra; Nicholas Camill,0,0,30,30
1650566668348,MATH 10A,A01,083735,Patchell; Gregory David,5,0,30,25
1650566668348,MATH 10A,A02,083736,Patchell; Gregory David,27,0,30,3
1650566668348,MATH 10A,A03,083737,Patchell; Gregory David,24,0,30,6
1650566674393,MATH 10B,A01,083207,Staff,0,9,30,30
1650566674393,MATH 10B,A02,083208,Staff,0,8,30,30
1650566674393,MATH 10B,B01,083739,Staff,11,0,30,19
1650566674393,MATH 10B,B02,083740,Staff,28,0,30,2
1650566680435,MATH 18,A01,083743,Staff,1,0,30,29
1650566680435,MATH 18,A02,083744,Staff,26,0,30,4
1650566680435,MATH 18,A03,083745,Staff,22,0,30,8
1650566680435,MATH 18,A04,083746,Staff,26,0,30,4
1650566680435,MATH 18,B01,083748,Staff,0,14,30,30
1650566680435,MATH 18,B02,083749,Staff,0,12,30,30
1650566680435,MATH 18,B03,083750,Staff,0,12,30,30
1650566680435,MATH 18,B04,083751,Staff,0,12,30,30
1650566686472,MATH 20A,A01,083754,Staff,21,0,40,19
1650566692502,MATH 20B,A01,083756,Staff,0,11,30,30
1650566692502,MATH 20B,A02,083757,Staff,0,12,30,30
1650566698528,MATH 20C,A01,083760,Staff,0,16,30,30
1650566698528,MATH 20C,A02,083761,Staff,2,14,30,28
1650566698528,MATH 20C,B01,083762,Staff,12,0,30,18
1650566698528,MATH 20C,B02,083763,Staff,28,0,30,2
1650566704555,MATH 20D,A01,083765,Staff,0,1,30,30
1650566704555,MATH 20D,A02,083766,Staff,7,0,30,23
1650566704555,MATH 20D,A03,083767,Staff,25,0,30,5
1650566710587,MATH 20E,A01,083771,Staff,7,0,30,23
1650566710587,MATH 20E,A02,083772,Staff,18,0,30,12
1650566710587,MATH 20E,B01,083773,Staff,0,0,30,30
1650566710587,MATH 20E,B02,083774,Staff,10,0,30,20
1650566716615,MATH 103A,A01,083777,Staff,0,15,30,30
1650566716615,MATH 103A,A02,083778,Staff,0,14,30,30
1650566716615,MATH 103A,B01,083779,Staff,0,13,30,30
1650566716615,MATH 103A,B02,083780,Staff,0,13,30,30
1650566722640,MATH 105,A01,085443,Staff,0,21,30,30
1650566728664,MATH 109,A01,083213,Anzaldo; Leesa B,0,7,30,30
1650566728664,MATH 109,A02,083214,Anzaldo; Leesa B,0,7,30,30
1650566728664,MATH 109,B01,083215,Anzaldo; Leesa B,0,5,30,30
1650566728664,MATH 109,B02,083216,Anzaldo; Leesa B,0,6,30,30
1650566734693,MATH 142A,A01,083219,Chow; Bennett,0,16,30,30
1650566734693,MATH 142A,A02,083220,Chow; Bennett,0,14,30,30
1650566734693,MATH 142A,B01,083221,Chow; Bennett,0,13,30,30
1650566734693,MATH 142A,B02,083222,Chow; Bennett,0,13,30,30
1650566740728,MATH 193A,A01,083224,Staff,1,6,30,29
1650566740728,MATH 193A,A02,083225,Staff,0,5,30,30
1650566740728,MATH 193A,A03,083781,Staff,0,6,30,30
1650566740728,MATH 193A,A04,083782,Staff,0,7,30,30
1650566746752,MATH 197,001,091859,McAuley; Julian John,9998,0,9999,1
1650566752834,COGS 9,A01,083615,Staff,0,16,60,60
1650566758868,COGS 11,A01,083617,Boyle; Mary E. T.,18,0,40,22
1650566764892,COGS 13,A01,083071,Staff,0,35,40,40
1650566770921,COGS 14A,A01,092681,Staff,0,27,100,100
1650566776948,COGS 14B,A01,083073,Cheng; Tzu-Han,0,12,50,50
1650566782970,COGS 17,A01,092677,Staff,18,0,75,57
1650566789008,COGS 100,A01,083619,Staff,0,26,60,60
1650566795032,COGS 101A,A01,083621,Davis; Joshua Daniel,0,26,60,60
1650566801066,COGS 101B,A01,091572,Staff,1,5,60,59
1650566807102,COGS 101C,A01,083625,Delgado; Tania,15,0,30,15
1650566813126,COGS 107A,A01,083627,Boyle; Mary E. T.,0,12,60,60
1650566819151,COGS 118A,A01,083075,Staff,0,3,60,60
1650566825177,CSE 3,A50,083646,Miranda; Gregory Joseph,20,0,38,18
1650566825177,CSE 3,A51,083647,Miranda; Gregory Joseph,36,0,37,1
1650566831203,CSE 8A,A50,083650,Miranda; Gregory Joseph,0,29,40,40
1650566837231,CSE 11,A01,083080,Cao; Yingjun,0,93,40,40
1650566843254,CSE 12,A01,083652,Staff,0,18,100,100
1650566849276,CSE 15L,A01,083654,Staff,0,1,50,50
1650566849276,CSE 15L,A02,083655,Staff,0,1,50,50
1650566855298,CSE 20,A01,083657,Staff,51,0,80,29
1650566861360,CSE 30,A01,083084,Eldon; John,0,77,40,40
1650566867385,CSE 100,A01,083659,Cao; Yingjun,0,67,50,50
1650566873409,CSE 134B,A01,083661,Powell; Thomas Allan,0,34,65,65
1650566879432,CSE 140,A01,083663,Staff,0,5,75,75
1650566885457,CSE 140L,A01,083088,Eldon; John,0,11,75,75
1650566891481,CSE 175,A01,083665,Kumar; Rakesh,7,0,25,18
1650566897513,CSE 190,A00,092507,Dubnov; Shlomo,10,0,20,10
1650566903540,ECE 45,A01,083139,Staff,1,1,60,59
1650566909568,ECE 65,A50,083695,Staff,1,6,30,29
1650566915591,ECE 109,A01,091882,Touri; Behrouz,33,0,70,37
1650566921638,ECE 180,A00,083140,Abi Samra; Nicholas Camill,21,0,30,9
1650566921638,ECE 180,B00,083141,Abi Samra; Nicholas Camill,0,0,30,30
1650566927673,MATH 10A,A01,083735,Patchell; Gregory David,5,0,30,25
1650566927673,MATH 10A,A02,083736,Patchell; Gregory David,27,0,30,3
1650566927673,MATH 10A,A03,083737,Patchell; Gregory David,24,0,30,6
1650566933700,MATH 10B,A01,083207,Staff,0,9,30,30
1650566933700,MATH 10B,A02,083208,Staff,0,8,30,30
1650566933700,MATH 10B,B01,083739,Staff,11,0,30,19
1650566933700,MATH 10B,B02,083740,Staff,28,0,30,2
1650566939729,MATH 18,A01,083743,Staff,1,0,30,29
1650566939729,MATH 18,A02,083744,Staff,26,0,30,4
1650566939729,MATH 18,A03,083745,Staff,22,0,30,8
1650566939729,MATH 18,A04,083746,Staff,26,0,30,4
1650566939729,MATH 18,B01,083748,Staff,0,14,30,30
1650566939729,MATH 18,B02,083749,Staff,0,12,30,30
1650566939729,MATH 18,B03,083750,Staff,0,12,30,30
1650566939729,MATH 18,B04,083751,Staff,0,12,30,30
1650566945761,MATH 20A,A01,083754,Staff,21,0,40,19
1650566951788,MATH 20B,A01,083756,Staff,0,11,30,30
1650566951788,MATH 20B,A02,083757,Staff,0,12,30,30
1650566957815,MATH 20C,A01,083760,Staff,0,16,30,30
1650566957815,MATH 20C,A02,083761,Staff,2,14,30,28
1650566957815,MATH 20C,B01,083762,Staff,12,0,30,18
1650566957815,MATH 20C,B02,083763,Staff,28,0,30,2
1650566963843,MATH 20D,A01,083765,Staff,0,1,30,30
1650566963843,MATH 20D,A02,083766,Staff,7,0,30,23
1650566963843,MATH 20D,A03,083767,Staff,25,0,30,5
1650566969872,MATH 20E,A01,083771,Staff,7,0,30,23
1650566969872,MATH 20E,A02,083772,Staff,18,0,30,12
1650566969872,MATH 20E,B01,083773,Staff,0,0,30,30
1650566969872,MATH 20E,B02,083774,Staff,10,0,30,20
1650566975897,MATH 103A,A01,083777,Staff,0,15,30,30
1650566975897,MATH 103A,A02,083778,Staff,0,14,30,30
1650566975897,MATH 103A,B01,083779,Staff,0,13,30,30
1650566975897,MATH 103A,B02,083780,Staff,0,13,30,30
1650566981935,MATH 105,A01,085443,Staff,0,21,30,30
1650566987964,MATH 109,A01,083213,Anzaldo; Leesa B,0,7,30,30
1650566987964,MATH 109,A02,083214,Anzaldo; Leesa B,0,7,30,30
1650566987964,MATH 109,B01,083215,Anzaldo; Leesa B,0,5,30,30
1650566987964,MATH 109,B02,083216,Anzaldo; Leesa B,0,6,30,30
1650566993992,MATH 142A,A01,083219,Chow; Bennett,0,16,30,30
1650566993992,MATH 142A,A02,083220,Chow; Bennett,0,14,30,30
1650566993992,MATH 142A,B01,083221,Chow; Bennett,0,13,30,30
1650566993992,MATH 142A,B02,083222,Chow; Bennett,0,13,30,30
1650567000020,MATH 193A,A01,083224,Staff,1,6,30,29
1650567000020,MATH 193A,A02,083225,Staff,0,5,30,30
1650567000020,MATH 193A,A03,083781,Staff,0,6,30,30
1650567000020,MATH 193A,A04,083782,Staff,0,7,30,30
1650567006050,MATH 197,001,091859,McAuley; Julian John,9998,0,9999,1
1650567012106,COGS 9,A01,083615,Staff,0,16,60,60
1650567018133,COGS 11,A01,083617,Boyle; Mary E. T.,19,0,40,21
1650567024162,COGS 13,A01,083071,Staff,0,35,40,40
1650567030214,COGS 14A,A01,092681,Staff,0,27,100,100
1650567036245,COGS 14B,A01,083073,Cheng; Tzu-Han,0,12,50,50
1650567042269,COGS 17,A01,092677,Staff,18,0,75,57
1650567048292,COGS 100,A01,083619,Staff,0,26,60,60
1650567054314,COGS 101A,A01,083621,Davis; Joshua Daniel,0,26,60,60
1650567060359,COGS 101B,A01,091572,Staff,1,5,60,59
1650567066382,COGS 101C,A01,083625,Delgado; Tania,15,0,30,15
1650567072404,COGS 107A,A01,083627,Boyle; Mary E. T.,0,12,60,60
1650567078432,COGS 118A,A01,083075,Staff,0,4,60,60
1650567084460,CSE 3,A50,083646,Miranda; Gregory Joseph,20,0,38,18
1650567084460,CSE 3,A51,083647,Miranda; Gregory Joseph,36,0,37,1
1650567090483,CSE 8A,A50,083650,Miranda; Gregory Joseph,0,29,40,40
1650567096523,CSE 11,A01,083080,Cao; Yingjun,0,93,40,40
1650567102547,CSE 12,A01,083652,Staff,0,18,100,100
1650567108570,CSE 15L,A01,083654,Staff,0,1,50,50
1650567108570,CSE 15L,A02,083655,Staff,0,1,50,50
1650567114611,CSE 20,A01,083657,Staff,51,0,80,29
1650567120634,CSE 30,A01,083084,Eldon; John,0,77,40,40
1650567126657,CSE 100,A01,083659,Cao; Yingjun,0,67,50,50
1650567132683,CSE 134B,A01,083661,Powell; Thomas Allan,0,34,65,65
1650567138717,CSE 140,A01,083663,Staff,0,5,75,75
1650567144814,CSE 140L,A01,083088,Eldon; John,0,11,75,75
1650567150842,CSE 175,A01,083665,Kumar; Rakesh,7,0,25,18
1650567156864,CSE 190,A00,092507,Dubnov; Shlomo,10,0,20,10
1650567162891,ECE 45,A01,083139,Staff,1,1,60,59
1650567168934,ECE 65,A50,083695,Staff,1,6,30,29
1650567174961,ECE 109,A01,091882,Touri; Behrouz,33,0,70,37
1650567180988,ECE 180,A00,083140,Abi Samra; Nicholas Camill,21,0,30,9
1650567180988,ECE 180,B00,083141,Abi Samra; Nicholas Camill,0,0,30,30
1650567187014,MATH 10A,A01,083735,Patchell; Gregory David,5,0,30,25
1650567187014,MATH 10A,A02,083736,Patchell; Gregory David,27,0,30,3
1650567187014,MATH 10A,A03,083737,Patchell; Gregory David,24,0,30,6
1650567193046,MATH 10B,A01,083207,Staff,0,9,30,30
1650567193046,MATH 10B,A02,083208,Staff,0,8,30,30
1650567193046,MATH 10B,B01,083739,Staff,11,0,30,19
1650567193046,MATH 10B,B02,083740,Staff,28,0,30,2
1650567199089,MATH 18,A01,083743,Staff,1,0,30,29
1650567199089,MATH 18,A02,083744,Staff,26,0,30,4
1650567199089,MATH 18,A03,083745,Staff,22,0,30,8
1650567199089,MATH 18,A04,083746,Staff,26,0,30,4
1650567199089,MATH 18,B01,083748,Staff,0,14,30,30
1650567199089,MATH 18,B02,083749,Staff,0,12,30,30
1650567199089,MATH 18,B03,083750,Staff,0,12,30,30
1650567199089,MATH 18,B04,083751,Staff,0,12,30,30
1650567205113,MATH 20A,A01,083754,Staff,21,0,40,19
1650567211148,MATH 20B,A01,083756,Staff,0,11,30,30
1650567211148,MATH 20B,A02,083757,Staff,0,12,30,30
1650567217185,MATH 20C,A01,083760,Staff,0,16,30,30
1650567217185,MATH 20C,A02,083761,Staff,2,14,30,28
1650567217185,MATH 20C,B01,083762,Staff,12,0,30,18
1650567217185,MATH 20C,B02,083763,Staff,28,0,30,2
1650567223209,MATH 20D,A01,083765,Staff,0,1,30,30
1650567223209,MATH 20D,A02,083766,Staff,7,0,30,23
1650567223209,MATH 20D,A03,083767,Staff,25,0,30,5
1650567229238,MATH 20E,A01,083771,Staff,7,0,30,23
1650567229238,MATH 20E,A02,083772,Staff,18,0,30,12
1650567229238,MATH 20E,B01,083773,Staff,0,0,30,30
1650567229238,MATH 20E,B02,083774,Staff,10,0,30,20
1650567235264,MATH 103A,A01,083777,Staff,0,15,30,30
1650567235264,MATH 103A,A02,083778,Staff,0,14,30,30
1650567235264,MATH 103A,B01,083779,Staff,0,13,30,30
1650567235264,MATH 103A,B02,083780,Staff,0,13,30,30
1650567241298,MATH 105,A01,085443,Staff,0,21,30,30
1650567247322,MATH 109,A01,083213,Anzaldo; Leesa B,0,7,30,30
1650567247322,MATH 109,A02,083214,Anzaldo; Leesa B,0,7,30,30
1650567247322,MATH 109,B01,083215,Anzaldo; Leesa B,0,5,30,30
1650567247322,MATH 109,B02,083216,Anzaldo; Leesa B,0,6,30,30
1650567253351,MATH 142A,A01,083219,Chow; Bennett,0,16,30,30
1650567253351,MATH 142A,A02,083220,Chow; Bennett,0,14,30,30
1650567253351,MATH 142A,B01,083221,Chow; Bennett,0,13,30,30
1650567253351,MATH 142A,B02,083222,Chow; Bennett,0,13,30,30
1650567259375,MATH 193A,A01,083224,Staff,1,6,30,29
1650567259375,MATH 193A,A02,083225,Staff,0,5,30,30
1650567259375,MATH 193A,A03,083781,Staff,0,6,30,30
1650567259375,MATH 193A,A04,083782,Staff,0,7,30,30
1650567265400,MATH 197,001,091859,McAuley; Julian John,9998,0,9999,1
1650567271493,COGS 9,A01,083615,Staff,0,16,60,60
1650567277518,COGS 11,A01,083617,Boyle; Mary E. T.,19,0,40,21
1650567283544,COGS 13,A01,083071,Staff,0,35,40,40
1650567289569,COGS 14A,A01,092681,Staff,0,27,100,100
1650567295592,COGS 14B,A01,083073,Cheng; Tzu-Han,0,12,50,50
1650567301615,COGS 17,A01,092677,Staff,18,0,75,57
1650567307648,COGS 100,A01,083619,Staff,0,26,60,60
1650567313670,COGS 101A,A01,083621,Davis; Joshua Daniel,0,26,60,60
1650567319698,COGS 101B,A01,091572,Staff,1,5,60,59
1650567325725,COGS 101C,A01,083625,Delgado; Tania,15,0,30,15
1650567331746,COGS 107A,A01,083627,Boyle; Mary E. T.,0,12,60,60
1650567337769,COGS 118A,A01,083075,Staff,0,4,60,60
1650567343791,CSE 3,A50,083646,Miranda; Gregory Joseph,20,0,38,18
1650567343791,CSE 3,A51,083647,Miranda; Gregory Joseph,36,0,37,1
1650567349816,CSE 8A,A50,083650,Miranda; Gregory Joseph,0,29,40,40
1650567355850,CSE 11,A01,083080,Cao; Yingjun,0,93,40,40
1650567361874,CSE 12,A01,083652,Staff,0,18,100,100
1650567367927,CSE 15L,A01,083654,Staff,0,1,50,50
1650567367927,CSE 15L,A02,083655,Staff,0,1,50,50
1650567373954,CSE 20,A01,083657,Staff,51,0,80,29
1650567379987,CSE 30,A01,083084,Eldon; John,0,77,40,40
1650567386021,CSE 100,A01,083659,Cao; Yingjun,0,67,50,50
1650567392044,CSE 134B,A01,083661,Powell; Thomas Allan,0,34,65,65
1650567398073,CSE 140,A01,083663,Staff,0,5,75,75
1650567404101,CSE 140L,A01,083088,Eldon; John,0,11,75,75
1650567410137,CSE 175,A01,083665,Kumar; Rakesh,7,0,25,18
1650567416161,CSE 190,A00,092507,Dubnov; Shlomo,10,0,20,10
1650567422187,ECE 45,A01,083139,Staff,1,1,60,59
1650567428216,ECE 65,A50,083695,Staff,1,6,30,29
1650567434246,ECE 109,A01,091882,Touri; Behrouz,33,0,70,37
1650567440279,ECE 180,A00,083140,Abi Samra; Nicholas Camill,21,0,30,9
1650567440279,ECE 180,B00,083141,Abi Samra; Nicholas Camill,0,0,30,30
1650567446313,MATH 10A,A01,083735,Patchell; Gregory David,5,0,30,25
1650567446313,MATH 10A,A02,083736,Patchell; Gregory David,27,0,30,3
1650567446313,MATH 10A,A03,083737,Patchell; Gregory David,24,0,30,6
1650567452341,MATH 10B,A01,083207,Staff,0,9,30,30
1650567452341,MATH 10B,A02,083208,Staff,0,8,30,30
1650567452341,MATH 10B,B01,083739,Staff,11,0,30,19
1650567452341,MATH 10B,B02,083740,Staff,28,0,30,2
1650567458370,MATH 18,A01,083743,Staff,1,0,30,29
1650567458370,MATH 18,A02,083744,Staff,26,0,30,4
1650567458370,MATH 18,A03,083745,Staff,22,0,30,8
1650567458370,MATH 18,A04,083746,Staff,26,0,30,4
1650567458370,MATH 18,B01,083748,Staff,0,14,30,30
1650567458370,MATH 18,B02,083749,Staff,0,12,30,30
1650567458370,MATH 18,B03,083750,Staff,0,12,30,30
1650567458370,MATH 18,B04,083751,Staff,0,12,30,30
1650567464398,MATH 20A,A01,083754,Staff,21,0,40,19
1650567470421,MATH 20B,A01,083756,Staff,0,11,30,30
1650567470421,MATH 20B,A02,083757,Staff,0,12,30,30
1650567476451,MATH 20C,A01,083760,Staff,0,16,30,30
1650567476451,MATH 20C,A02,083761,Staff,2,14,30,28
1650567476451,MATH 20C,B01,083762,Staff,12,0,30,18
1650567476451,MATH 20C,B02,083763,Staff,28,0,30,2
1650567482476,MATH 20D,A01,083765,Staff,0,1,30,30
1650567482476,MATH 20D,A02,083766,Staff,7,0,30,23
1650567482476,MATH 20D,A03,083767,Staff,25,0,30,5
1650567488498,MATH 20E,A01,083771,Staff,7,0,30,23
1650567488498,MATH 20E,A02,083772,Staff,17,0,30,13
1650567488498,MATH 20E,B01,083773,Staff,0,0,30,30
1650567488498,MATH 20E,B02,083774,Staff,10,0,30,20
1650567494530,MATH 103A,A01,083777,Staff,0,15,30,30
1650567494530,MATH 103A,A02,083778,Staff,0,14,30,30
1650567494530,MATH 103A,B01,083779,Staff,0,13,30,30
1650567494530,MATH 103A,B02,083780,Staff,0,13,30,30
1650567500555,MATH 105,A01,085443,Staff,0,21,30,30
1650567506582,MATH 109,A01,083213,Anzaldo; Leesa B,0,7,30,30
1650567506582,MATH 109,A02,083214,Anzaldo; Leesa B,0,7,30,30
1650567506582,MATH 109,B01,083215,Anzaldo; Leesa B,0,5,30,30
1650567506582,MATH 109,B02,083216,Anzaldo; Leesa B,0,6,30,30
1650567512615,MATH 142A,A01,083219,Chow; Bennett,0,16,30,30
1650567512615,MATH 142A,A02,083220,Chow; Bennett,0,14,30,30
1650567512615,MATH 142A,B01,083221,Chow; Bennett,0,13,30,30
1650567512615,MATH 142A,B02,083222,Chow; Bennett,0,13,30,30
1650567518639,MATH 193A,A01,083224,Staff,1,6,30,29
1650567518639,MATH 193A,A02,083225,Staff,0,5,30,30
1650567518639,MATH 193A,A03,083781,Staff,0,6,30,30
1650567518639,MATH 193A,A04,083782,Staff,0,7,30,30
1650567524672,MATH 197,001,091859,McAuley; Julian John,9998,0,9999,1
1650567530732,COGS 9,A01,083615,Staff,0,16,60,60
1650567536756,COGS 11,A01,083617,Boyle; Mary E. T.,19,0,40,21
1650567542780,COGS 13,A01,083071,Staff,0,35,40,40
1650567548802,COGS 14A,A01,092681,Staff,0,27,100,100
1650567554827,COGS 14B,A01,083073,Cheng; Tzu-Han,0,12,50,50
1650567560862,COGS 17,A01,092677,Staff,18,0,75,57
1650567566889,COGS 100,A01,083619,Staff,0,26,60,60
1650567572914,COGS 101A,A01,083621,Davis; Joshua Daniel,0,26,60,60
1650567578941,COGS 101B,A01,091572,Staff,1,5,60,59
1650567584964,COGS 101C,A01,083625,Delgado; Tania,15,0,30,15
1650567590994,COGS 107A,A01,083627,Boyle; Mary E. T.,0,12,60,60
1650567597022,COGS 118A,A01,083075,Staff,0,4,60,60
1650567603064,CSE 3,A50,083646,Miranda; Gregory Joseph,20,0,38,18
1650567603064,CSE 3,A51,083647,Miranda; Gregory Joseph,36,0,37,1
1650567609099,CSE 8A,A50,083650,Miranda; Gregory Joseph,0,29,40,40
1650567615141,CSE 11,A01,083080,Cao; Yingjun,0,93,40,40
1650567621167,CSE 12,A01,083652,Staff,0,18,100,100
1650567627191,CSE 15L,A01,083654,Staff,0,1,50,50
1650567627191,CSE 15L,A02,083655,Staff,0,1,50,50
1650567633213,CSE 20,A01,083657,Staff,51,0,80,29
1650567639240,CSE 30,A01,083084,Eldon; John,0,77,40,40
1650567645263,CSE 100,A01,083659,Cao; Yingjun,0,66,50,50
1650567651290,CSE 134B,A01,083661,Powell; Thomas Allan,0,34,65,65
1650567657314,CSE 140,A01,083663,Staff,0,5,75,75
1650567663353,CSE 140L,A01,083088,Eldon; John,0,11,75,75
1650567669384,CSE 175,A01,083665,Kumar; Rakesh,7,0,25,18
1650567675412,CSE 190,A00,092507,Dubnov; Shlomo,10,0,20,10
1650567681439,ECE 45,A01,083139,Staff,1,1,60,59
1650567687462,ECE 65,A50,083695,Staff,1,6,30,29
1650567693483,ECE 109,A01,091882,Touri; Behrouz,33,0,70,37
1650567699507,ECE 180,A00,083140,Abi Samra; Nicholas Camill,21,0,30,9
1650567699507,ECE 180,B00,083141,Abi Samra; Nicholas Camill,0,0,30,30
1650567705537,MATH 10A,A01,083735,Patchell; Gregory David,5,0,30,25
1650567705537,MATH 10A,A02,083736,Patchell; Gregory David,27,0,30,3
1650567705537,MATH 10A,A03,083737,Patchell; Gregory David,24,0,30,6
1650567711565,MATH 10B,A01,083207,Staff,0,9,30,30
1650567711565,MATH 10B,A02,083208,Staff,0,8,30,30
1650567711565,MATH 10B,B01,083739,Staff,11,0,30,19
1650567711565,MATH 10B,B02,083740,Staff,28,0,30,2
1650567717592,MATH 18,A01,083743,Staff,1,0,30,29
1650567717592,MATH 18,A02,083744,Staff,26,0,30,4
1650567717592,MATH 18,A03,083745,Staff,22,0,30,8
1650567717592,MATH 18,A04,083746,Staff,26,0,30,4
1650567717592,MATH 18,B01,083748,Staff,0,14,30,30
1650567717592,MATH 18,B02,083749,Staff,0,12,30,30
1650567717592,MATH 18,B03,083750,Staff,0,12,30,30
1650567717592,MATH 18,B04,083751,Staff,0,12,30,30
1650567723615,MATH 20A,A01,083754,Staff,21,0,40,19
1650567729638,MATH 20B,A01,083756,Staff,0,11,30,30
1650567729638,MATH 20B,A02,083757,Staff,0,12,30,30
1650567735671,MATH 20C,A01,083760,Staff,0,16,30,30
1650567735671,MATH 20C,A02,083761,Staff,2,14,30,28
1650567735671,MATH 20C,B01,083762,Staff,12,0,30,18
1650567735671,MATH 20C,B02,083763,Staff,28,0,30,2
1650567741788,MATH 20D,A01,083765,Staff,0,1,30,30
1650567741788,MATH 20D,A02,083766,Staff,7,0,30,23
1650567741788,MATH 20D,A03,083767,Staff,25,0,30,5
1650567747816,MATH 20E,A01,083771,Staff,7,0,30,23
1650567747816,MATH 20E,A02,083772,Staff,17,0,30,13
1650567747816,MATH 20E,B01,083773,Staff,0,0,30,30
1650567747816,MATH 20E,B02,083774,Staff,10,0,30,20
1650567753845,MATH 103A,A01,083777,Staff,0,15,30,30
1650567753845,MATH 103A,A02,083778,Staff,0,14,30,30
1650567753845,MATH 103A,B01,083779,Staff,0,13,30,30
1650567753845,MATH 103A,B02,083780,Staff,0,13,30,30
1650567759873,MATH 105,A01,085443,Staff,0,21,30,30
1650567765898,MATH 109,A01,083213,Anzaldo; Leesa B,0,7,30,30
1650567765898,MATH 109,A02,083214,Anzaldo; Leesa B,0,7,30,30
1650567765898,MATH 109,B01,083215,Anzaldo; Leesa B,0,5,30,30
1650567765898,MATH 109,B02,083216,Anzaldo; Leesa B,0,6,30,30
1650567771923,MATH 142A,A01,083219,Chow; Bennett,0,16,30,30
1650567771923,MATH 142A,A02,083220,Chow; Bennett,0,14,30,30
1650567771923,MATH 142A,B01,083221,Chow; Bennett,0,13,30,30
1650567771923,MATH 142A,B02,083222,Chow; Bennett,0,13,30,30
1650567777959,MATH 193A,A01,083224,Staff,1,6,30,29
1650567777959,MATH 193A,A02,083225,Staff,0,5,30,30
1650567777959,MATH 193A,A03,083781,Staff,0,6,30,30
1650567777959,MATH 193A,A04,083782,Staff,0,7,30,30
1650567783994,MATH 197,001,091859,McAuley; Julian John,9998,0,9999,1
1650567790091,COGS 9,A01,083615,Staff,0,16,60,60
1650567796122,COGS 11,A01,083617,Boyle; Mary E. T.,19,0,40,21
1650567802154,COGS 13,A01,083071,Staff,0,36,40,40
1650567808177,COGS 14A,A01,092681,Staff,0,27,100,100
1650567814209,COGS 14B,A01,083073,Cheng; Tzu-Han,0,12,50,50
1650567820259,COGS 17,A01,092677,Staff,18,0,75,57
1650567826283,COGS 100,A01,083619,Staff,1,26,60,59
1650567832308,COGS 101A,A01,083621,Davis; Joshua Daniel,0,26,60,60
1650567838330,COGS 101B,A01,091572,Staff,1,5,60,59
1650567844354,COGS 101C,A01,083625,Delgado; Tania,15,0,30,15
1650567850394,COGS 107A,A01,083627,Boyle; Mary E. T.,0,12,60,60
1650567856418,COGS 118A,A01,083075,Staff,0,4,60,60
1650567862443,CSE 3,A50,083646,Miranda; Gregory Joseph,20,0,38,18
1650567862443,CSE 3,A51,083647,Miranda; Gregory Joseph,36,0,37,1
1650567868469,CSE 8A,A50,083650,Miranda; Gregory Joseph,0,29,40,40
1650567874495,CSE 11,A01,083080,Cao; Yingjun,0,93,40,40
1650567880541,CSE 12,A01,083652,Staff,0,18,100,100
1650567886565,CSE 15L,A01,083654,Staff,0,1,50,50
1650567886565,CSE 15L,A02,083655,Staff,0,1,50,50
1650567892589,CSE 20,A01,083657,Staff,51,0,80,29
1650567898616,CSE 30,A01,083084,Eldon; John,0,77,40,40
1650567904641,CSE 100,A01,083659,Cao; Yingjun,0,66,50,50
1650567910664,CSE 134B,A01,083661,Powell; Thomas Allan,0,34,65,65
1650567916922,CSE 140,A01,083663,Staff,0,5,75,75
1650567922989,CSE 140L,A01,083088,Eldon; John,0,11,75,75
1650567929020,CSE 175,A01,083665,Kumar; Rakesh,7,0,25,18
1650567935046,CSE 190,A00,092507,Dubnov; Shlomo,10,0,20,10
1650567941092,ECE 45,A01,083139,Staff,1,1,60,59
1650567947115,ECE 65,A50,083695,Staff,1,6,30,29
1650567953139,ECE 109,A01,091882,Touri; Behrouz,33,0,70,37
1650567959186,ECE 180,A00,083140,Abi Samra; Nicholas Camill,21,0,30,9
1650567959186,ECE 180,B00,083141,Abi Samra; Nicholas Camill,0,0,30,30
1650567965211,MATH 10A,A01,083735,Patchell; Gregory David,5,0,30,25
1650567965211,MATH 10A,A02,083736,Patchell; Gregory David,27,0,30,3
1650567965211,MATH 10A,A03,083737,Patchell; Gregory David,24,0,30,6
1650567971244,MATH 10B,A01,083207,Staff,0,9,30,30
1650567971244,MATH 10B,A02,083208,Staff,0,8,30,30
1650567971244,MATH 10B,B01,083739,Staff,11,0,30,19
1650567971244,MATH 10B,B02,083740,Staff,28,0,30,2
1650567977276,MATH 18,A01,083743,Staff,1,0,30,29
1650567977276,MATH 18,A02,083744,Staff,26,0,30,4
1650567977276,MATH 18,A03,083745,Staff,22,0,30,8
1650567977276,MATH 18,A04,083746,Staff,26,0,30,4
1650567977276,MATH 18,B01,083748,Staff,0,14,30,30
1650567977276,MATH 18,B02,083749,Staff,0,12,30,30
1650567977276,MATH 18,B03,083750,Staff,0,12,30,30
1650567977276,MATH 18,B04,083751,Staff,0,12,30,30
1650567983307,MATH 20A,A01,083754,Staff,21,0,40,19
1650567989333,MATH 20B,A01,083756,Staff,0,11,30,30
1650567989333,MATH 20B,A02,083757,Staff,0,12,30,30
1650567995365,MATH 20C,A01,083760,Staff,0,16,30,30
1650567995365,MATH 20C,A02,083761,Staff,2,14,30,28
1650567995365,MATH 20C,B01,083762,Staff,12,0,30,18
1650567995365,MATH 20C,B02,083763,Staff,28,0,30,2
1650568001388,MATH 20D,A01,083765,Staff,0,1,30,30
1650568001388,MATH 20D,A02,083766,Staff,7,0,30,23
1650568001388,MATH 20D,A03,083767,Staff,25,0,30,5
1650568007421,MATH 20E,A01,083771,Staff,7,0,30,23
1650568007421,MATH 20E,A02,083772,Staff,17,0,30,13
1650568007421,MATH 20E,B01,083773,Staff,0,0,30,30
1650568007421,MATH 20E,B02,083774,Staff,10,0,30,20
1650568013447,MATH 103A,A01,083777,Staff,0,15,30,30
1650568013447,MATH 103A,A02,083778,Staff,0,14,30,30
1650568013447,MATH 103A,B01,083779,Staff,0,13,30,30
1650568013447,MATH 103A,B02,083780,Staff,0,13,30,30
1650568019473,MATH 105,A01,085443,Staff,0,21,30,30
1650568025498,MATH 109,A01,083213,Anzaldo; Leesa B,0,7,30,30
1650568025498,MATH 109,A02,083214,Anzaldo; Leesa B,0,7,30,30
1650568025498,MATH 109,B01,083215,Anzaldo; Leesa B,0,5,30,30
1650568025498,MATH 109,B02,083216,Anzaldo; Leesa B,0,6,30,30
1650568031525,MATH 142A,A01,083219,Chow; Bennett,0,16,30,30
1650568031525,MATH 142A,A02,083220,Chow; Bennett,0,14,30,30
1650568031525,MATH 142A,B01,083221,Chow; Bennett,0,13,30,30
1650568031525,MATH 142A,B02,083222,Chow; Bennett,0,13,30,30
1650568037552,MATH 193A,A01,083224,Staff,1,6,30,29
1650568037552,MATH 193A,A02,083225,Staff,0,5,30,30
1650568037552,MATH 193A,A03,083781,Staff,0,6,30,30
1650568037552,MATH 193A,A04,083782,Staff,0,7,30,30
1650568043584,MATH 197,001,091859,McAuley; Julian John,9998,0,9999,1
1650568049640,COGS 9,A01,083615,Staff,0,16,60,60
1650568055666,COGS 11,A01,083617,Boyle; Mary E. T.,19,0,40,21
1650568061690,COGS 13,A01,083071,Staff,0,36,40,40
1650568067717,COGS 14A,A01,092681,Staff,0,27,100,100
1650568073740,COGS 14B,A01,083073,Cheng; Tzu-Han,0,12,50,50
1650568079764,COGS 17,A01,092677,Staff,18,0,75,57
1650568085792,COGS 100,A01,083619,Staff,1,26,60,59
1650568091828,COGS 101A,A01,083621,Davis; Joshua Daniel,0,26,60,60
1650568097849,COGS 101B,A01,091572,Staff,1,5,60,59
1650568103885,COGS 101C,A01,083625,Delgado; Tania,15,0,30,15
1650568109913,COGS 107A,A01,083627,Boyle; Mary E. T.,0,12,60,60
1650568115935,COGS 118A,A01,083075,Staff,0,4,60,60
1650568121962,CSE 3,A50,083646,Miranda; Gregory Joseph,20,0,38,18
1650568121962,CSE 3,A51,083647,Miranda; Gregory Joseph,36,0,37,1
1650568127989,CSE 8A,A50,083650,Miranda; Gregory Joseph,0,29,40,40
1650568134013,CSE 11,A01,083080,Cao; Yingjun,0,93,40,40
1650568140064,CSE 12,A01,083652,Staff,0,18,100,100
1650568146089,CSE 15L,A01,083654,Staff,0,1,50,50
1650568146089,CSE 15L,A02,083655,Staff,0,1,50,50
1650568152118,CSE 20,A01,083657,Staff,51,0,80,29
1650568158140,CSE 30,A01,083084,Eldon; John,0,77,40,40
1650568164164,CSE 100,A01,083659,Cao; Yingjun,0,66,50,50
1650568170193,CSE 134B,A01,083661,Powell; Thomas Allan,0,34,65,65
1650568176224,CSE 140,A01,083663,Staff,0,5,75,75
1650568182247,CSE 140L,A01,083088,Eldon; John,0,11,75,75
1650568188275,CSE 175,A01,083665,Kumar; Rakesh,7,0,25,18
1650568194309,CSE 190,A00,092507,Dubnov; Shlomo,10,0,20,10
1650568200362,ECE 45,A01,083139,Staff,1,1,60,59
1650568206391,ECE 65,A50,083695,Staff,1,6,30,29
1650568212415,ECE 109,A01,091882,Touri; Behrouz,33,0,70,37
1650568218443,ECE 180,A00,083140,Abi Samra; Nicholas Camill,21,0,30,9
1650568218443,ECE 180,B00,083141,Abi Samra; Nicholas Camill,0,0,30,30
1650568224467,MATH 10A,A01,083735,Patchell; Gregory David,5,0,30,25
1650568224467,MATH 10A,A02,083736,Patchell; Gregory David,27,0,30,3
1650568224467,MATH 10A,A03,083737,Patchell; Gregory David,24,0,30,6
1650568230494,MATH 10B,A01,083207,Staff,0,9,30,30
1650568230494,MATH 10B,A02,083208,Staff,0,8,30,30
1650568230494,MATH 10B,B01,083739,Staff,11,0,30,19
1650568230494,MATH 10B,B02,083740,Staff,28,0,30,2
1650568236524,MATH 18,A01,083743,Staff,1,0,30,29
1650568236524,MATH 18,A02,083744,Staff,26,0,30,4
1650568236524,MATH 18,A03,083745,Staff,22,0,30,8
1650568236524,MATH 18,A04,083746,Staff,26,0,30,4
1650568236524,MATH 18,B01,083748,Staff,0,14,30,30
1650568236524,MATH 18,B02,083749,Staff,0,12,30,30
1650568236524,MATH 18,B03,083750,Staff,0,12,30,30
1650568236524,MATH 18,B04,083751,Staff,0,12,30,30
1650568242546,MATH 20A,A01,083754,Staff,21,0,40,19
1650568248587,MATH 20B,A01,083756,Staff,0,11,30,30
1650568248587,MATH 20B,A02,083757,Staff,0,12,30,30
1650568254615,MATH 20C,A01,083760,Staff,0,16,30,30
1650568254615,MATH 20C,A02,083761,Staff,2,14,30,28
1650568254615,MATH 20C,B01,083762,Staff,12,0,30,18
1650568254615,MATH 20C,B02,083763,Staff,28,0,30,2
1650568260669,MATH 20D,A01,083765,Staff,0,1,30,30
1650568260669,MATH 20D,A02,083766,Staff,7,0,30,23
1650568260669,MATH 20D,A03,083767,Staff,25,0,30,5
1650568266693,MATH 20E,A01,083771,Staff,7,0,30,23
1650568266693,MATH 20E,A02,083772,Staff,17,0,30,13
1650568266693,MATH 20E,B01,083773,Staff,0,0,30,30
1650568266693,MATH 20E,B02,083774,Staff,10,0,30,20
1650568272715,MATH 103A,A01,083777,Staff,0,15,30,30
1650568272715,MATH 103A,A02,083778,Staff,0,14,30,30
1650568272715,MATH 103A,B01,083779,Staff,0,13,30,30
1650568272715,MATH 103A,B02,083780,Staff,0,13,30,30
1650568278744,MATH 105,A01,085443,Staff,0,21,30,30
1650568284771,MATH 109,A01,083213,Anzaldo; Leesa B,0,7,30,30
1650568284771,MATH 109,A02,083214,Anzaldo; Leesa B,0,7,30,30
1650568284771,MATH 109,B01,083215,Anzaldo; Leesa B,0,5,30,30
1650568284771,MATH 109,B02,083216,Anzaldo; Leesa B,0,6,30,30
1650568290806,MATH 142A,A01,083219,Chow; Bennett,0,16,30,30
1650568290806,MATH 142A,A02,083220,Chow; Bennett,0,14,30,30
1650568290806,MATH 142A,B01,083221,Chow; Bennett,0,13,30,30
1650568290806,MATH 142A,B02,083222,Chow; Bennett,0,13,30,30
1650568296828,MATH 193A,A01,083224,Staff,1,6,30,29
1650568296828,MATH 193A,A02,083225,Staff,0,5,30,30
1650568296828,MATH 193A,A03,083781,Staff,0,6,30,30
1650568296828,MATH 193A,A04,083782,Staff,0,7,30,30
1650568302851,MATH 197,001,091859,McAuley; Julian John,9998,0,9999,1
1650568308910,COGS 9,A01,083615,Staff,0,16,60,60
1650568314933,COGS 11,A01,083617,Boyle; Mary E. T.,19,0,40,21
1650568320966,COGS 13,A01,083071,Staff,0,36,40,40
1650568326993,COGS 14A,A01,092681,Staff,0,27,100,100
1650568333105,COGS 14B,A01,083073,Cheng; Tzu-Han,0,12,50,50
1650568339131,COGS 17,A01,092677,Staff,18,0,75,57
1650568345162,COGS 100,A01,083619,Staff,1,26,60,59
1650568351199,COGS 101A,A01,083621,Davis; Joshua Daniel,0,26,60,60
1650568357230,COGS 101B,A01,091572,Staff,1,5,60,59
1650568363261,COGS 101C,A01,083625,Delgado; Tania,15,0,30,15
1650568369283,COGS 107A,A01,083627,Boyle; Mary E. T.,0,12,60,60
1650568375313,COGS 118A,A01,083075,Staff,0,4,60,60
1650568381338,CSE 3,A50,083646,Miranda; Gregory Joseph,20,0,38,18
1650568381338,CSE 3,A51,083647,Miranda; Gregory Joseph,36,0,37,1
1650568387362,CSE 8A,A50,083650,Miranda; Gregory Joseph,0,29,40,40
1650568393385,CSE 11,A01,083080,Cao; Yingjun,0,93,40,40
1650568399412,CSE 12,A01,083652,Staff,0,19,100,100
1650568405436,CSE 15L,A01,083654,Staff,0,1,50,50
1650568405436,CSE 15L,A02,083655,Staff,0,1,50,50
1650568411464,CSE 20,A01,083657,Staff,51,0,80,29
1650568417493,CSE 30,A01,083084,Eldon; John,0,77,40,40
1650568423517,CSE 100,A01,083659,Cao; Yingjun,0,66,50,50
1650568429546,CSE 134B,A01,083661,Powell; Thomas Allan,0,34,65,65
1650568435570,CSE 140,A01,083663,Staff,0,5,75,75
1650568441597,CSE 140L,A01,083088,Eldon; John,0,11,75,75
1650568447628,CSE 175,A01,083665,Kumar; Rakesh,7,0,25,18
1650568453675,CSE 190,A00,092507,Dubnov; Shlomo,10,0,20,10
1650568459705,ECE 45,A01,083139,Staff,1,1,60,59
1650568465734,ECE 65,A50,083695,Staff,1,6,30,29
1650568471758,ECE 109,A01,091882,Touri; Behrouz,33,0,70,37
1650568477787,ECE 180,A00,083140,Abi Samra; Nicholas Camill,21,0,30,9
1650568477787,ECE 180,B00,083141,Abi Samra; Nicholas Camill,0,0,30,30
1650568483820,MATH 10A,A01,083735,Patchell; Gregory David,5,0,30,25
1650568483820,MATH 10A,A02,083736,Patchell; Gregory David,27,0,30,3
1650568483820,MATH 10A,A03,083737,Patchell; Gregory David,24,0,30,6
1650568489843,MATH 10B,A01,083207,Staff,0,9,30,30
1650568489843,MATH 10B,A02,083208,Staff,0,8,30,30
1650568489843,MATH 10B,B01,083739,Staff,11,0,30,19
1650568489843,MATH 10B,B02,083740,Staff,28,0,30,2
1650568495871,MATH 18,A01,083743,Staff,1,0,30,29
1650568495871,MATH 18,A02,083744,Staff,26,0,30,4
1650568495871,MATH 18,A03,083745,Staff,22,0,30,8
1650568495871,MATH 18,A04,083746,Staff,26,0,30,4
1650568495871,MATH 18,B01,083748,Staff,0,14,30,30
1650568495871,MATH 18,B02,083749,Staff,0,12,30,30
1650568495871,MATH 18,B03,083750,Staff,0,12,30,30
1650568495871,MATH 18,B04,083751,Staff,0,12,30,30
1650568501894,MATH 20A,A01,083754,Staff,21,0,40,19
1650568507917,MATH 20B,A01,083756,Staff,0,11,30,30
1650568507917,MATH 20B,A02,083757,Staff,0,12,30,30
1650568513941,MATH 20C,A01,083760,Staff,0,16,30,30
1650568513941,MATH 20C,A02,083761,Staff,2,14,30,28
1650568513941,MATH 20C,B01,083762,Staff,12,0,30,18
1650568513941,MATH 20C,B02,083763,Staff,28,0,30,2
1650568519965,MATH 20D,A01,083765,Staff,0,1,30,30
1650568519965,MATH 20D,A02,083766,Staff,7,0,30,23
1650568519965,MATH 20D,A03,083767,Staff,25,0,30,5
1650568525993,MATH 20E,A01,083771,Staff,7,0,30,23
1650568525993,MATH 20E,A02,083772,Staff,17,0,30,13
1650568525993,MATH 20E,B01,083773,Staff,0,0,30,30
1650568525993,MATH 20E,B02,083774,Staff,10,0,30,20
1650568532021,MATH 103A,A01,083777,Staff,0,15,30,30
1650568532021,MATH 103A,A02,083778,Staff,0,14,30,30
1650568532021,MATH 103A,B01,083779,Staff,0,13,30,30
1650568532021,MATH 103A,B02,083780,Staff,0,13,30,30
1650568538044,MATH 105,A01,085443,Staff,0,21,30,30
1650568544078,MATH 109,A01,083213,Anzaldo; Leesa B,0,7,30,30
1650568544078,MATH 109,A02,083214,Anzaldo; Leesa B,0,7,30,30
1650568544078,MATH 109,B01,083215,Anzaldo; Leesa B,0,5,30,30
1650568544078,MATH 109,B02,083216,Anzaldo; Leesa B,0,6,30,30
1650568550116,MATH 142A,A01,083219,Chow; Bennett,0,16,30,30
1650568550116,MATH 142A,A02,083220,Chow; Bennett,0,14,30,30
1650568550116,MATH 142A,B01,083221,Chow; Bennett,0,13,30,30
1650568550116,MATH 142A,B02,083222,Chow; Bennett,0,13,30,30
1650568556145,MATH 193A,A01,083224,Staff,1,6,30,29
1650568556145,MATH 193A,A02,083225,Staff,0,5,30,30
1650568556145,MATH 193A,A03,083781,Staff,0,6,30,30
1650568556145,MATH 193A,A04,083782,Staff,0,7,30,30
1650568562168,MATH 197,001,091859,McAuley; Julian John,9998,0,9999,1
1650568568258,COGS 9,A01,083615,Staff,0,16,60,60
1650568574286,COGS 11,A01,083617,Boyle; Mary E. T.,19,0,40,21
1650568580311,COGS 13,A01,083071,Staff,0,36,40,40
1650568586344,COGS 14A,A01,092681,Staff,0,27,100,100
1650568592372,COGS 14B,A01,083073,Cheng; Tzu-Han,0,12,50,50
1650568598405,COGS 17,A01,092677,Staff,18,0,75,57
1650568604429,COGS 100,A01,083619,Staff,1,26,60,59
1650568610456,COGS 101A,A01,083621,Davis; Joshua Daniel,0,26,60,60
1650568616481,COGS 101B,A01,091572,Staff,1,5,60,59
1650568622503,COGS 101C,A01,083625,Delgado; Tania,15,0,30,15
1650568628534,COGS 107A,A01,083627,Boyle; Mary E. T.,0,12,60,60
1650568634557,COGS 118A,A01,083075,Staff,0,4,60,60
1650568640582,CSE 3,A50,083646,Miranda; Gregory Joseph,20,0,38,18
1650568640582,CSE 3,A51,083647,Miranda; Gregory Joseph,36,0,37,1
1650568646607,CSE 8A,A50,083650,Miranda; Gregory Joseph,0,29,40,40
1650568652642,CSE 11,A01,083080,Cao; Yingjun,0,93,40,40
1650568658672,CSE 12,A01,083652,Staff,0,19,100,100
1650568664696,CSE 15L,A01,083654,Staff,0,1,50,50
1650568664696,CSE 15L,A02,083655,Staff,0,1,50,50
1650568670722,CSE 20,A01,083657,Staff,51,0,80,29
1650568676762,CSE 30,A01,083084,Eldon; John,0,77,40,40
1650568682796,CSE 100,A01,083659,Cao; Yingjun,0,66,50,50
1650568688824,CSE 134B,A01,083661,Powell; Thomas Allan,0,34,65,65
1650568694855,CSE 140,A01,083663,Staff,0,5,75,75
1650568700878,CSE 140L,A01,083088,Eldon; John,0,11,75,75
1650568706904,CSE 175,A01,083665,Kumar; Rakesh,7,0,25,18
1650568712931,CSE 190,A00,092507,Dubnov; Shlomo,10,0,20,10
1650568718953,ECE 45,A01,083139,Staff,1,1,60,59
1650568724977,ECE 65,A50,083695,Staff,1,6,30,29
1650568731004,ECE 109,A01,091882,Touri; Behrouz,33,0,70,37
1650568737034,ECE 180,A00,083140,Abi Samra; Nicholas Camill,21,0,30,9
1650568737034,ECE 180,B00,083141,Abi Samra; Nicholas Camill,0,0,30,30
1650568743058,MATH 10A,A01,083735,Patchell; Gregory David,5,0,30,25
1650568743058,MATH 10A,A02,083736,Patchell; Gregory David,27,0,30,3
1650568743058,MATH 10A,A03,083737,Patchell; Gregory David,24,0,30,6
1650568749083,MATH 10B,A01,083207,Staff,0,9,30,30
1650568749083,MATH 10B,A02,083208,Staff,0,8,30,30
1650568749083,MATH 10B,B01,083739,Staff,11,0,30,19
1650568749083,MATH 10B,B02,083740,Staff,28,0,30,2
1650568755113,MATH 18,A01,083743,Staff,1,0,30,29
1650568755113,MATH 18,A02,083744,Staff,26,0,30,4
1650568755113,MATH 18,A03,083745,Staff,22,0,30,8
1650568755113,MATH 18,A04,083746,Staff,26,0,30,4
1650568755113,MATH 18,B01,083748,Staff,0,14,30,30
1650568755113,MATH 18,B02,083749,Staff,0,12,30,30
1650568755113,MATH 18,B03,083750,Staff,0,12,30,30
1650568755113,MATH 18,B04,083751,Staff,0,12,30,30
1650568761142,MATH 20A,A01,083754,Staff,21,0,40,19
1650568767167,MATH 20B,A01,083756,Staff,0,11,30,30
1650568767167,MATH 20B,A02,083757,Staff,0,12,30,30
1650568773191,MATH 20C,A01,083760,Staff,0,16,30,30
1650568773191,MATH 20C,A02,083761,Staff,2,14,30,28
1650568773191,MATH 20C,B01,083762,Staff,12,0,30,18
1650568773191,MATH 20C,B02,083763,Staff,28,0,30,2
1650568779213,MATH 20D,A01,083765,Staff,0,1,30,30
1650568779213,MATH 20D,A02,083766,Staff,7,0,30,23
1650568779213,MATH 20D,A03,083767,Staff,25,0,30,5
1650568785244,MATH 20E,A01,083771,Staff,7,0,30,23
1650568785244,MATH 20E,A02,083772,Staff,17,0,30,13
1650568785244,MATH 20E,B01,083773,Staff,0,0,30,30
1650568785244,MATH 20E,B02,083774,Staff,10,0,30,20
1650568791273,MATH 103A,A01,083777,Staff,0,15,30,30
1650568791273,MATH 103A,A02,083778,Staff,0,14,30,30
1650568791273,MATH 103A,B01,083779,Staff,0,13,30,30
1650568791273,MATH 103A,B02,083780,Staff,0,13,30,30
1650568797296,MATH 105,A01,085443,Staff,0,21,30,30
1650568803324,MATH 109,A01,083213,Anzaldo; Leesa B,0,7,30,30
1650568803324,MATH 109,A02,083214,Anzaldo; Leesa B,0,7,30,30
1650568803324,MATH 109,B01,083215,Anzaldo; Leesa B,0,5,30,30
1650568803324,MATH 109,B02,083216,Anzaldo; Leesa B,0,6,30,30
1650568809357,MATH 142A,A01,083219,Chow; Bennett,0,16,30,30
1650568809357,MATH 142A,A02,083220,Chow; Bennett,0,14,30,30
1650568809357,MATH 142A,B01,083221,Chow; Bennett,0,13,30,30
1650568809357,MATH 142A,B02,083222,Chow; Bennett,0,13,30,30
1650568815384,MATH 193A,A01,083224,Staff,1,6,30,29
1650568815384,MATH 193A,A02,083225,Staff,0,5,30,30
1650568815384,MATH 193A,A03,083781,Staff,0,6,30,30
1650568815384,MATH 193A,A04,083782,Staff,0,7,30,30
1650568821449,MATH 197,001,091859,McAuley; Julian John,9998,0,9999,1
1650568827514,COGS 9,A01,083615,Staff,0,16,60,60
1650568833541,COGS 11,A01,083617,Boyle; Mary E. T.,19,0,40,21
1650568839580,COGS 13,A01,083071,Staff,0,36,40,40
1650568845606,COGS 14A,A01,092681,Staff,0,27,100,100
1650568851629,COGS 14B,A01,083073,Cheng; Tzu-Han,0,12,50,50
1650568857652,COGS 17,A01,092677,Staff,18,0,75,57
1650568863681,COGS 100,A01,083619,Staff,1,26,60,59
1650568869709,COGS 101A,A01,083621,Davis; Joshua Daniel,0,26,60,60
1650568875732,COGS 101B,A01,091572,Staff,1,5,60,59
1650568881755,COGS 101C,A01,083625,Delgado; Tania,15,0,30,15
1650568887778,COGS 107A,A01,083627,Boyle; Mary E. T.,0,12,60,60
1650568893802,COGS 118A,A01,083075,Staff,0,4,60,60
1650568899830,CSE 3,A50,083646,Miranda; Gregory Joseph,20,0,38,18
1650568899830,CSE 3,A51,083647,Miranda; Gregory Joseph,36,0,37,1
1650568905854,CSE 8A,A50,083650,Miranda; Gregory Joseph,0,29,40,40
1650568911880,CSE 11,A01,083080,Cao; Yingjun,0,93,40,40
1650568917904,CSE 12,A01,083652,Staff,0,19,100,100
1650568923928,CSE 15L,A01,083654,Staff,0,1,50,50
1650568923928,CSE 15L,A02,083655,Staff,0,1,50,50
1650568930054,CSE 20,A01,083657,Staff,51,0,80,29
1650568936081,CSE 30,A01,083084,Eldon; John,0,77,40,40
1650568942105,CSE 100,A01,083659,Cao; Yingjun,0,66,50,50
1650568948130,CSE 134B,A01,083661,Powell; Thomas Allan,0,34,65,65
1650568954154,CSE 140,A01,083663,Staff,0,5,75,75
1650568960187,CSE 140L,A01,083088,Eldon; John,0,11,75,75
1650568966217,CSE 175,A01,083665,Kumar; Rakesh,7,0,25,18
1650568972251,CSE 190,A00,092507,Dubnov; Shlomo,10,0,20,10
1650568978286,ECE 45,A01,083139,Staff,1,1,60,59
1650568984326,ECE 65,A50,083695,Staff,1,6,30,29
1650568990357,ECE 109,A01,091882,Touri; Behrouz,33,0,70,37
1650568996390,ECE 180,A00,083140,Abi Samra; Nicholas Camill,21,0,30,9
1650568996390,ECE 180,B00,083141,Abi Samra; Nicholas Camill,0,0,30,30
1650569002425,MATH 10A,A01,083735,Patchell; Gregory David,5,0,30,25
1650569002425,MATH 10A,A02,083736,Patchell; Gregory David,27,0,30,3
1650569002425,MATH 10A,A03,083737,Patchell; Gregory David,24,0,30,6
1650569008452,MATH 10B,A01,083207,Staff,0,9,30,30
1650569008452,MATH 10B,A02,083208,Staff,0,8,30,30
1650569008452,MATH 10B,B01,083739,Staff,11,0,30,19
1650569008452,MATH 10B,B02,083740,Staff,28,0,30,2
1650569014483,MATH 18,A01,083743,Staff,1,0,30,29
1650569014483,MATH 18,A02,083744,Staff,26,0,30,4
1650569014483,MATH 18,A03,083745,Staff,22,0,30,8
1650569014483,MATH 18,A04,083746,Staff,26,0,30,4
1650569014483,MATH 18,B01,083748,Staff,0,14,30,30
1650569014483,MATH 18,B02,083749,Staff,0,12,30,30
1650569014483,MATH 18,B03,083750,Staff,0,12,30,30
1650569014483,MATH 18,B04,083751,Staff,0,12,30,30
1650569020508,MATH 20A,A01,083754,Staff,21,0,40,19
1650569026536,MATH 20B,A01,083756,Staff,0,11,30,30
1650569026536,MATH 20B,A02,083757,Staff,0,12,30,30
1650569032576,MATH 20C,A01,083760,Staff,0,16,30,30
1650569032576,MATH 20C,A02,083761,Staff,2,14,30,28
1650569032576,MATH 20C,B01,083762,Staff,12,0,30,18
1650569032576,MATH 20C,B02,083763,Staff,28,0,30,2
1650569038617,MATH 20D,A01,083765,Staff,0,1,30,30
1650569038617,MATH 20D,A02,083766,Staff,7,0,30,23
1650569038617,MATH 20D,A03,083767,Staff,25,0,30,5
1650569044641,MATH 20E,A01,083771,Staff,7,0,30,23
1650569044641,MATH 20E,A02,083772,Staff,17,0,30,13
1650569044641,MATH 20E,B01,083773,Staff,0,0,30,30
1650569044641,MATH 20E,B02,083774,Staff,10,0,30,20
1650569050673,MATH 103A,A01,083777,Staff,0,15,30,30
1650569050673,MATH 103A,A02,083778,Staff,0,14,30,30
1650569050673,MATH 103A,B01,083779,Staff,0,13,30,30
1650569050673,MATH 103A,B02,083780,Staff,0,13,30,30
1650569056709,MATH 105,A01,085443,Staff,0,21,30,30
1650569062748,MATH 109,A01,083213,Anzaldo; Leesa B,0,7,30,30
1650569062748,MATH 109,A02,083214,Anzaldo; Leesa B,0,7,30,30
1650569062748,MATH 109,B01,083215,Anzaldo; Leesa B,0,5,30,30
1650569062748,MATH 109,B02,083216,Anzaldo; Leesa B,0,6,30,30
1650569068778,MATH 142A,A01,083219,Chow; Bennett,0,16,30,30
1650569068778,MATH 142A,A02,083220,Chow; Bennett,0,14,30,30
1650569068778,MATH 142A,B01,083221,Chow; Bennett,0,14,30,30
1650569068778,MATH 142A,B02,083222,Chow; Bennett,0,13,30,30
1650569074816,MATH 193A,A01,083224,Staff,1,6,30,29
1650569074816,MATH 193A,A02,083225,Staff,0,5,30,30
1650569074816,MATH 193A,A03,083781,Staff,0,6,30,30
1650569074816,MATH 193A,A04,083782,Staff,0,7,30,30
1650569080839,MATH 197,001,091859,McAuley; Julian John,9998,0,9999,1
1650569086921,COGS 9,A01,083615,Staff,0,16,60,60
1650569092949,COGS 11,A01,083617,Boyle; Mary E. T.,19,0,40,21
1650569098973,COGS 13,A01,083071,Staff,0,36,40,40
1650569104995,COGS 14A,A01,092681,Staff,0,27,100,100
1650569111031,COGS 14B,A01,083073,Cheng; Tzu-Han,0,12,50,50
1650569117061,COGS 17,A01,092677,Staff,18,0,75,57
1650569123088,COGS 100,A01,083619,Staff,1,26,60,59
1650569129121,COGS 101A,A01,083621,Davis; Joshua Daniel,0,26,60,60
1650569135161,COGS 101B,A01,091572,Staff,1,5,60,59
1650569141186,COGS 101C,A01,083625,Delgado; Tania,15,0,30,15
1650569147211,COGS 107A,A01,083627,Boyle; Mary E. T.,0,12,60,60
1650569153237,COGS 118A,A01,083075,Staff,0,4,60,60
1650569159265,CSE 3,A50,083646,Miranda; Gregory Joseph,20,0,38,18
1650569159265,CSE 3,A51,083647,Miranda; Gregory Joseph,36,0,37,1
1650569165298,CSE 8A,A50,083650,Miranda; Gregory Joseph,0,29,40,40
1650569171325,CSE 11,A01,083080,Cao; Yingjun,0,93,40,40
1650569177349,CSE 12,A01,083652,Staff,0,19,100,100
1650569183372,CSE 15L,A01,083654,Staff,0,1,50,50
1650569183372,CSE 15L,A02,083655,Staff,0,1,50,50
1650569189398,CSE 20,A01,083657,Staff,51,0,80,29
1650569195436,CSE 30,A01,083084,Eldon; John,0,77,40,40
1650569201460,CSE 100,A01,083659,Cao; Yingjun,0,66,50,50
1650569207489,CSE 134B,A01,083661,Powell; Thomas Allan,0,34,65,65
1650569213522,CSE 140,A01,083663,Staff,0,5,75,75
1650569219554,CSE 140L,A01,083088,Eldon; John,0,11,75,75
1650569225578,CSE 175,A01,083665,Kumar; Rakesh,7,0,25,18
1650569231601,CSE 190,A00,092507,Dubnov; Shlomo,10,0,20,10
1650569237627,ECE 45,A01,083139,Staff,1,1,60,59
1650569243649,ECE 65,A50,083695,Staff,1,6,30,29
1650569249682,ECE 109,A01,091882,Touri; Behrouz,33,0,70,37
1650569255709,ECE 180,A00,083140,Abi Samra; Nicholas Camill,21,0,30,9
1650569255709,ECE 180,B00,083141,Abi Samra; Nicholas Camill,0,0,30,30
1650569261733,MATH 10A,A01,083735,Patchell; Gregory David,5,0,30,25
1650569261733,MATH 10A,A02,083736,Patchell; Gregory David,27,0,30,3
1650569261733,MATH 10A,A03,083737,Patchell; Gregory David,24,0,30,6
1650569267760,MATH 10B,A01,083207,Staff,0,9,30,30
1650569267760,MATH 10B,A02,083208,Staff,0,8,30,30
1650569267760,MATH 10B,B01,083739,Staff,11,0,30,19
1650569267760,MATH 10B,B02,083740,Staff,28,0,30,2
1650569273806,MATH 18,A01,083743,Staff,1,0,30,29
1650569273806,MATH 18,A02,083744,Staff,26,0,30,4
1650569273806,MATH 18,A03,083745,Staff,22,0,30,8
1650569273806,MATH 18,A04,083746,Staff,26,0,30,4
1650569273806,MATH 18,B01,083748,Staff,0,14,30,30
1650569273806,MATH 18,B02,083749,Staff,0,12,30,30
1650569273806,MATH 18,B03,083750,Staff,0,12,30,30
1650569273806,MATH 18,B04,083751,Staff,0,12,30,30
1650569279831,MATH 20A,A01,083754,Staff,21,0,40,19
1650569285859,MATH 20B,A01,083756,Staff,0,11,30,30
1650569285859,MATH 20B,A02,083757,Staff,0,12,30,30
1650569291894,MATH 20C,A01,083760,Staff,0,16,30,30
1650569291894,MATH 20C,A02,083761,Staff,2,14,30,28
1650569291894,MATH 20C,B01,083762,Staff,12,0,30,18
1650569291894,MATH 20C,B02,083763,Staff,28,0,30,2
1650569297934,MATH 20D,A01,083765,Staff,0,1,30,30
1650569297934,MATH 20D,A02,083766,Staff,7,0,30,23
1650569297934,MATH 20D,A03,083767,Staff,25,0,30,5
1650569303962,MATH 20E,A01,083771,Staff,7,0,30,23
1650569303962,MATH 20E,A02,083772,Staff,17,0,30,13
1650569303962,MATH 20E,B01,083773,Staff,0,0,30,30
1650569303962,MATH 20E,B02,083774,Staff,10,0,30,20
1650569309986,MATH 103A,A01,083777,Staff,0,15,30,30
1650569309986,MATH 103A,A02,083778,Staff,0,14,30,30
1650569309986,MATH 103A,B01,083779,Staff,0,13,30,30
1650569309986,MATH 103A,B02,083780,Staff,0,13,30,30
1650569316010,MATH 105,A01,085443,Staff,0,21,30,30
1650569322046,MATH 109,A01,083213,Anzaldo; Leesa B,0,7,30,30
1650569322046,MATH 109,A02,083214,Anzaldo; Leesa B,0,7,30,30
1650569322046,MATH 109,B01,083215,Anzaldo; Leesa B,0,5,30,30
1650569322046,MATH 109,B02,083216,Anzaldo; Leesa B,0,6,30,30
1650569328071,MATH 142A,A01,083219,Chow; Bennett,0,16,30,30
1650569328071,MATH 142A,A02,083220,Chow; Bennett,0,14,30,30
1650569328071,MATH 142A,B01,083221,Chow; Bennett,0,14,30,30
1650569328071,MATH 142A,B02,083222,Chow; Bennett,0,13,30,30
1650569334095,MATH 193A,A01,083224,Staff,1,6,30,29
1650569334095,MATH 193A,A02,083225,Staff,0,5,30,30
1650569334095,MATH 193A,A03,083781,Staff,0,6,30,30
1650569334095,MATH 193A,A04,083782,Staff,0,7,30,30
1650569340121,MATH 197,001,091859,McAuley; Julian John,9998,0,9999,1
1650569346180,COGS 9,A01,083615,Staff,1,16,60,59
1650569352209,COGS 11,A01,083617,Boyle; Mary E. T.,19,0,40,21
1650569358231,COGS 13,A01,083071,Staff,0,36,40,40
1650569364253,COGS 14A,A01,092681,Staff,0,27,100,100
1650569370279,COGS 14B,A01,083073,Cheng; Tzu-Han,0,12,50,50
1650569376306,COGS 17,A01,092677,Staff,18,0,75,57
1650569382340,COGS 100,A01,083619,Staff,1,26,60,59
1650569388376,COGS 101A,A01,083621,Davis; Joshua Daniel,0,26,60,60
1650569394401,COGS 101B,A01,091572,Staff,1,5,60,59
1650569400457,COGS 101C,A01,083625,Delgado; Tania,15,0,30,15
1650569406480,COGS 107A,A01,083627,Boyle; Mary E. T.,0,12,60,60
1650569412503,COGS 118A,A01,083075,Staff,0,4,60,60
1650569418528,CSE 3,A50,083646,Miranda; Gregory Joseph,20,0,38,18
1650569418528,CSE 3,A51,083647,Miranda; Gregory Joseph,36,0,37,1
1650569424556,CSE 8A,A50,083650,Miranda; Gregory Joseph,0,29,40,40
1650569430580,CSE 11,A01,083080,Cao; Yingjun,0,93,40,40
1650569436610,CSE 12,A01,083652,Staff,0,19,100,100
1650569442632,CSE 15L,A01,083654,Staff,0,1,50,50
1650569442632,CSE 15L,A02,083655,Staff,0,1,50,50
1650569448663,CSE 20,A01,083657,Staff,51,0,80,29
1650569454686,CSE 30,A01,083084,Eldon; John,0,77,40,40
1650569460724,CSE 100,A01,083659,Cao; Yingjun,0,66,50,50
1650569466746,CSE 134B,A01,083661,Powell; Thomas Allan,0,34,65,65
1650569472769,CSE 140,A01,083663,Staff,0,5,75,75
1650569478795,CSE 140L,A01,083088,Eldon; John,0,11,75,75
1650569484821,CSE 175,A01,083665,Kumar; Rakesh,7,0,25,18
1650569490845,CSE 190,A00,092507,Dubnov; Shlomo,10,0,20,10
1650569496869,ECE 45,A01,083139,Staff,1,1,60,59
1650569502902,ECE 65,A50,083695,Staff,1,6,30,29
1650569508929,ECE 109,A01,091882,Touri; Behrouz,33,0,70,37
1650569514955,ECE 180,A00,083140,Abi Samra; Nicholas Camill,21,0,30,9
1650569514955,ECE 180,B00,083141,Abi Samra; Nicholas Camill,0,0,30,30
1650569520989,MATH 10A,A01,083735,Patchell; Gregory David,5,0,30,25
1650569520989,MATH 10A,A02,083736,Patchell; Gregory David,27,0,30,3
1650569520989,MATH 10A,A03,083737,Patchell; Gregory David,24,0,30,6
1650569527112,MATH 10B,A01,083207,Staff,0,9,30,30
1650569527112,MATH 10B,A02,083208,Staff,0,8,30,30
1650569527112,MATH 10B,B01,083739,Staff,11,0,30,19
1650569527112,MATH 10B,B02,083740,Staff,28,0,30,2
1650569533136,MATH 18,A01,083743,Staff,1,0,30,29
1650569533136,MATH 18,A02,083744,Staff,26,0,30,4
1650569533136,MATH 18,A03,083745,Staff,22,0,30,8
1650569533136,MATH 18,A04,083746,Staff,26,0,30,4
1650569533136,MATH 18,B01,083748,Staff,0,14,30,30
1650569533136,MATH 18,B02,083749,Staff,0,12,30,30
1650569533136,MATH 18,B03,083750,Staff,0,12,30,30
1650569533136,MATH 18,B04,083751,Staff,0,12,30,30
1650569539169,MATH 20A,A01,083754,Staff,21,0,40,19
1650569545200,MATH 20B,A01,083756,Staff,0,11,30,30
1650569545200,MATH 20B,A02,083757,Staff,0,12,30,30
1650569551222,MATH 20C,A01,083760,Staff,0,16,30,30
1650569551222,MATH 20C,A02,083761,Staff,2,14,30,28
1650569551222,MATH 20C,B01,083762,Staff,12,0,30,18
1650569551222,MATH 20C,B02,083763,Staff,28,0,30,2
1650569557258,MATH 20D,A01,083765,Staff,0,1,30,30
1650569557258,MATH 20D,A02,083766,Staff,7,0,30,23
1650569557258,MATH 20D,A03,083767,Staff,25,0,30,5
1650569563285,MATH 20E,A01,083771,Staff,7,0,30,23
1650569563285,MATH 20E,A02,083772,Staff,17,0,30,13
1650569563285,MATH 20E,B01,083773,Staff,0,0,30,30
1650569563285,MATH 20E,B02,083774,Staff,10,0,30,20
1650569569309,MATH 103A,A01,083777,Staff,0,15,30,30
1650569569309,MATH 103A,A02,083778,Staff,0,14,30,30
1650569569309,MATH 103A,B01,083779,Staff,0,13,30,30
1650569569309,MATH 103A,B02,083780,Staff,0,13,30,30
1650569575344,MATH 105,A01,085443,Staff,0,21,30,30
1650569581372,MATH 109,A01,083213,Anzaldo; Leesa B,0,7,30,30
1650569581372,MATH 109,A02,083214,Anzaldo; Leesa B,0,7,30,30
1650569581372,MATH 109,B01,083215,Anzaldo; Leesa B,0,5,30,30
1650569581372,MATH 109,B02,083216,Anzaldo; Leesa B,0,6,30,30
1650569587398,MATH 142A,A01,083219,Chow; Bennett,0,16,30,30
1650569587398,MATH 142A,A02,083220,Chow; Bennett,0,14,30,30
1650569587398,MATH 142A,B01,083221,Chow; Bennett,0,14,30,30
1650569587398,MATH 142A,B02,083222,Chow; Bennett,0,13,30,30
1650569593425,MATH 193A,A01,083224,Staff,1,6,30,29
1650569593425,MATH 193A,A02,083225,Staff,0,5,30,30
1650569593425,MATH 193A,A03,083781,Staff,0,6,30,30
1650569593425,MATH 193A,A04,083782,Staff,0,7,30,30
1650569599474,MATH 197,001,091859,McAuley; Julian John,9998,0,9999,1
1650569605540,COGS 9,A01,083615,Staff,1,16,60,59
1650569611562,COGS 11,A01,083617,Boyle; Mary E. T.,19,0,40,21
1650569617612,COGS 13,A01,083071,Staff,0,36,40,40
1650569623636,COGS 14A,A01,092681,Staff,0,27,100,100
1650569629666,COGS 14B,A01,083073,Cheng; Tzu-Han,0,12,50,50
1650569635702,COGS 17,A01,092677,Staff,18,0,75,57
1650569641726,COGS 100,A01,083619,Staff,1,26,60,59
1650569647773,COGS 101A,A01,083621,Davis; Joshua Daniel,0,26,60,60
1650569653804,COGS 101B,A01,091572,Staff,1,5,60,59
1650569659832,COGS 101C,A01,083625,Delgado; Tania,15,0,30,15
1650569665857,COGS 107A,A01,083627,Boyle; Mary E. T.,0,12,60,60
1650569671883,COGS 118A,A01,083075,Staff,0,4,60,60
1650569677937,CSE 3,A50,083646,Miranda; Gregory Joseph,20,0,38,18
1650569677937,CSE 3,A51,083647,Miranda; Gregory Joseph,36,0,37,1
1650569683966,CSE 8A,A50,083650,Miranda; Gregory Joseph,0,29,40,40
1650569689991,CSE 11,A01,083080,Cao; Yingjun,0,93,40,40
1650569696015,CSE 12,A01,083652,Staff,0,19,100,100
1650569702044,CSE 15L,A01,083654,Staff,0,1,50,50
1650569702044,CSE 15L,A02,083655,Staff,0,1,50,50
1650569708070,CSE 20,A01,083657,Staff,51,0,80,29
1650569714094,CSE 30,A01,083084,Eldon; John,0,77,40,40
1650569720120,CSE 100,A01,083659,Cao; Yingjun,0,66,50,50
1650569726143,CSE 134B,A01,083661,Powell; Thomas Allan,0,34,65,65
1650569732169,CSE 140,A01,083663,Staff,0,5,75,75
1650569738192,CSE 140L,A01,083088,Eldon; John,0,11,75,75
1650569744214,CSE 175,A01,083665,Kumar; Rakesh,7,0,25,18
1650569750238,CSE 190,A00,092507,Dubnov; Shlomo,10,0,20,10
1650569756276,ECE 45,A01,083139,Staff,1,1,60,59
1650569762301,ECE 65,A50,083695,Staff,1,6,30,29
1650569768325,ECE 109,A01,091882,Touri; Behrouz,33,0,70,37
1650569774348,ECE 180,A00,083140,Abi Samra; Nicholas Camill,21,0,30,9
1650569774348,ECE 180,B00,083141,Abi Samra; Nicholas Camill,0,0,30,30
1650569780378,MATH 10A,A01,083735,Patchell; Gregory David,5,0,30,25
1650569780378,MATH 10A,A02,083736,Patchell; Gregory David,27,0,30,3
1650569780378,MATH 10A,A03,083737,Patchell; Gregory David,24,0,30,6
1650569786407,MATH 10B,A01,083207,Staff,0,9,30,30
1650569786407,MATH 10B,A02,083208,Staff,0,8,30,30
1650569786407,MATH 10B,B01,083739,Staff,11,0,30,19
1650569786407,MATH 10B,B02,083740,Staff,28,0,30,2
1650569792434,MATH 18,A01,083743,Staff,1,0,30,29
1650569792434,MATH 18,A02,083744,Staff,26,0,30,4
1650569792434,MATH 18,A03,083745,Staff,22,0,30,8
1650569792434,MATH 18,A04,083746,Staff,26,0,30,4
1650569792434,MATH 18,B01,083748,Staff,0,14,30,30
1650569792434,MATH 18,B02,083749,Staff,0,12,30,30
1650569792434,MATH 18,B03,083750,Staff,0,12,30,30
1650569792434,MATH 18,B04,083751,Staff,0,12,30,30
1650569798479,MATH 20A,A01,083754,Staff,21,0,40,19
1650569804507,MATH 20B,A01,083756,Staff,0,11,30,30
1650569804507,MATH 20B,A02,083757,Staff,0,12,30,30
1650569810533,MATH 20C,A01,083760,Staff,0,16,30,30
1650569810533,MATH 20C,A02,083761,Staff,2,14,30,28
1650569810533,MATH 20C,B01,083762,Staff,12,0,30,18
1650569810533,MATH 20C,B02,083763,Staff,28,0,30,2
1650569816561,MATH 20D,A01,083765,Staff,0,1,30,30
1650569816561,MATH 20D,A02,083766,Staff,7,0,30,23
1650569816561,MATH 20D,A03,083767,Staff,25,0,30,5
1650569822592,MATH 20E,A01,083771,Staff,7,0,30,23
1650569822592,MATH 20E,A02,083772,Staff,17,0,30,13
1650569822592,MATH 20E,B01,083773,Staff,0,0,30,30
1650569822592,MATH 20E,B02,083774,Staff,10,0,30,20
1650569828615,MATH 103A,A01,083777,Staff,0,15,30,30
1650569828615,MATH 103A,A02,083778,Staff,0,14,30,30
1650569828615,MATH 103A,B01,083779,Staff,0,13,30,30
1650569828615,MATH 103A,B02,083780,Staff,0,13,30,30
1650569834642,MATH 105,A01,085443,Staff,0,21,30,30
1650569840671,MATH 109,A01,083213,Anzaldo; Leesa B,0,7,30,30
1650569840671,MATH 109,A02,083214,Anzaldo; Leesa B,0,7,30,30
1650569840671,MATH 109,B01,083215,Anzaldo; Leesa B,0,5,30,30
1650569840671,MATH 109,B02,083216,Anzaldo; Leesa B,0,6,30,30
1650569846711,MATH 142A,A01,083219,Chow; Bennett,0,16,30,30
1650569846711,MATH 142A,A02,083220,Chow; Bennett,0,14,30,30
1650569846711,MATH 142A,B01,083221,Chow; Bennett,0,14,30,30
1650569846711,MATH 142A,B02,083222,Chow; Bennett,0,13,30,30
1650569852744,MATH 193A,A01,083224,Staff,1,6,30,29
1650569852744,MATH 193A,A02,083225,Staff,0,5,30,30
1650569852744,MATH 193A,A03,083781,Staff,0,6,30,30
1650569852744,MATH 193A,A04,083782,Staff,0,7,30,30
1650569858767,MATH 197,001,091859,McAuley; Julian John,9998,0,9999,1
1650569864857,COGS 9,A01,083615,Staff,1,16,60,59
1650569870888,COGS 11,A01,083617,Boyle; Mary E. T.,19,0,40,21
1650569876912,COGS 13,A01,083071,Staff,0,36,40,40
1650569882934,COGS 14A,A01,092681,Staff,0,27,100,100
1650569888965,COGS 14B,A01,083073,Cheng; Tzu-Han,0,12,50,50
1650569894991,COGS 17,A01,092677,Staff,18,0,75,57
1650569901018,COGS 100,A01,083619,Staff,1,26,60,59
1650569907045,COGS 101A,A01,083621,Davis; Joshua Daniel,0,26,60,60
1650569913070,COGS 101B,A01,091572,Staff,1,5,60,59
1650569919097,COGS 101C,A01,083625,Delgado; Tania,15,0,30,15
1650569925121,COGS 107A,A01,083627,Boyle; Mary E. T.,0,12,60,60
1650569931149,COGS 118A,A01,083075,Staff,0,4,60,60
1650569937175,CSE 3,A50,083646,Miranda; Gregory Joseph,20,0,38,18
1650569937175,CSE 3,A51,083647,Miranda; Gregory Joseph,36,0,37,1
1650569943208,CSE 8A,A50,083650,Miranda; Gregory Joseph,0,29,40,40
1650569949238,CSE 11,A01,083080,Cao; Yingjun,0,93,40,40
1650569955262,CSE 12,A01,083652,Staff,0,19,100,100
1650569961289,CSE 15L,A01,083654,Staff,0,1,50,50
1650569961289,CSE 15L,A02,083655,Staff,0,1,50,50
1650569967319,CSE 20,A01,083657,Staff,51,0,80,29
1650569973343,CSE 30,A01,083084,Eldon; John,0,77,40,40
1650569979373,CSE 100,A01,083659,Cao; Yingjun,0,66,50,50
1650569985410,CSE 134B,A01,083661,Powell; Thomas Allan,0,34,65,65
1650569991434,CSE 140,A01,083663,Staff,0,5,75,75
1650569999898,CSE 140L,A01,083088,Eldon; John,0,11,75,75
1650570005921,CSE 175,A01,083665,Kumar; Rakesh,7,0,25,18
1650570018286,CSE 190,A00,092507,Dubnov; Shlomo,10,0,20,10
1650570024660,ECE 45,A01,083139,Staff,1,1,60,59
1650570034273,ECE 65,A50,083695,Staff,1,6,30,29
1650570043223,ECE 109,A01,091882,Touri; Behrouz,33,0,70,37
1650570051151,ECE 180,A00,083140,Abi Samra; Nicholas Camill,21,0,30,9
1650570051151,ECE 180,B00,083141,Abi Samra; Nicholas Camill,0,0,30,30
1650570058446,MATH 10A,A01,083735,Patchell; Gregory David,5,0,30,25
1650570058446,MATH 10A,A02,083736,Patchell; Gregory David,27,0,30,3
1650570058446,MATH 10A,A03,083737,Patchell; Gregory David,24,0,30,6
1650570070048,MATH 10B,A01,083207,Staff,0,9,30,30
1650570070048,MATH 10B,A02,083208,Staff,0,8,30,30
1650570070048,MATH 10B,B01,083739,Staff,11,0,30,19
1650570070048,MATH 10B,B02,083740,Staff,28,0,30,2
1650570089583,MATH 18,A01,083743,Staff,1,0,30,29
1650570089583,MATH 18,A02,083744,Staff,26,0,30,4
1650570089583,MATH 18,A03,083745,Staff,22,0,30,8
1650570089583,MATH 18,A04,083746,Staff,26,0,30,4
1650570089583,MATH 18,B01,083748,Staff,0,14,30,30
1650570089583,MATH 18,B02,083749,Staff,0,12,30,30
1650570089583,MATH 18,B03,083750,Staff,0,12,30,30
1650570089583,MATH 18,B04,083751,Staff,0,12,30,30
1650570111453,MATH 20A,A01,083754,Staff,21,0,40,19
1650570121108,MATH 20B,A01,083756,Staff,0,11,30,30
1650570121108,MATH 20B,A02,083757,Staff,0,12,30,30
1650570127566,MATH 20C,A01,083760,Staff,0,16,30,30
1650570127566,MATH 20C,A02,083761,Staff,2,14,30,28
1650570127566,MATH 20C,B01,083762,Staff,12,0,30,18
1650570127566,MATH 20C,B02,083763,Staff,28,0,30,2
1650570134527,MATH 20D,A01,083765,Staff,0,1,30,30
1650570134527,MATH 20D,A02,083766,Staff,7,0,30,23
1650570134527,MATH 20D,A03,083767,Staff,25,0,30,5
1650570141256,MATH 20E,A01,083771,Staff,7,0,30,23
1650570141256,MATH 20E,A02,083772,Staff,17,0,30,13
1650570141256,MATH 20E,B01,083773,Staff,0,0,30,30
1650570141256,MATH 20E,B02,083774,Staff,10,0,30,20
1650570149190,MATH 103A,A01,083777,Staff,0,15,30,30
1650570149190,MATH 103A,A02,083778,Staff,0,14,30,30
1650570149190,MATH 103A,B01,083779,Staff,0,13,30,30
1650570149190,MATH 103A,B02,083780,Staff,0,13,30,30
1650570158079,MATH 105,A01,085443,Staff,0,21,30,30
1650570165533,MATH 109,A01,083213,Anzaldo; Leesa B,0,7,30,30
1650570165533,MATH 109,A02,083214,Anzaldo; Leesa B,0,7,30,30
1650570165533,MATH 109,B01,083215,Anzaldo; Leesa B,0,5,30,30
1650570165533,MATH 109,B02,083216,Anzaldo; Leesa B,0,6,30,30
1650570173641,MATH 142A,A01,083219,Chow; Bennett,0,16,30,30
1650570173641,MATH 142A,A02,083220,Chow; Bennett,0,14,30,30
1650570173641,MATH 142A,B01,083221,Chow; Bennett,0,14,30,30
1650570173641,MATH 142A,B02,083222,Chow; Bennett,0,13,30,30
1650570180545,MATH 193A,A01,083224,Staff,1,6,30,29
1650570180545,MATH 193A,A02,083225,Staff,0,5,30,30
1650570180545,MATH 193A,A03,083781,Staff,0,6,30,30
1650570180545,MATH 193A,A04,083782,Staff,0,7,30,30
1650570190151,MATH 197,001,091859,McAuley; Julian John,9998,0,9999,1
1650570196292,COGS 9,A01,083615,Staff,1,16,60,59
1650570207271,COGS 11,A01,083617,Boyle; Mary E. T.,19,0,40,21
1650570213297,COGS 13,A01,083071,Staff,0,36,40,40
1650570219798,COGS 14A,A01,092681,Staff,0,27,100,100
1650570225832,COGS 14B,A01,083073,Cheng; Tzu-Han,0,12,50,50
1650570233591,COGS 17,A01,092677,Staff,18,0,75,57
1650570239985,COGS 100,A01,083619,Staff,1,26,60,59
1650570246098,COGS 101A,A01,083621,Davis; Joshua Daniel,0,26,60,60
1650570252244,COGS 101B,A01,091572,Staff,1,5,60,59
1650570258337,COGS 101C,A01,083625,Delgado; Tania,15,0,30,15
1650570266183,COGS 107A,A01,083627,Boyle; Mary E. T.,0,12,60,60
1650570272321,COGS 118A,A01,083075,Staff,0,4,60,60
1650570279958,CSE 3,A50,083646,Miranda; Gregory Joseph,20,0,38,18
1650570279958,CSE 3,A51,083647,Miranda; Gregory Joseph,36,0,37,1
1650570287419,CSE 8A,A50,083650,Miranda; Gregory Joseph,0,29,40,40
1650570293564,CSE 11,A01,083080,Cao; Yingjun,0,93,40,40
1650570299587,CSE 12,A01,083652,Staff,0,19,100,100
1650570305613,CSE 15L,A01,083654,Staff,0,1,50,50
1650570305613,CSE 15L,A02,083655,Staff,0,1,50,50
1650570311636,CSE 20,A01,083657,Staff,51,0,80,29
1650570322620,CSE 30,A01,083084,Eldon; John,0,77,40,40
1650570329423,CSE 100,A01,083659,Cao; Yingjun,0,66,50,50
1650570336638,CSE 134B,A01,083661,Powell; Thomas Allan,0,35,65,65
1650570343164,CSE 140,A01,083663,Staff,0,5,75,75
1650570349192,CSE 140L,A01,083088,Eldon; John,0,11,75,75
1650570355217,CSE 175,A01,083665,Kumar; Rakesh,7,0,25,18
1650570361239,CSE 190,A00,092507,Dubnov; Shlomo,10,0,20,10
1650570367830,ECE 45,A01,083139,Staff,1,1,60,59
1650570373854,ECE 65,A50,083695,Staff,1,6,30,29
1650570384536,ECE 109,A01,091882,Touri; Behrouz,33,0,70,37
1650570390562,ECE 180,A00,083140,Abi Samra; Nicholas Camill,21,0,30,9
1650570390562,ECE 180,B00,083141,Abi Samra; Nicholas Camill,0,0,30,30
1650570397623,MATH 10A,A01,083735,Patchell; Gregory David,5,0,30,25
1650570397623,MATH 10A,A02,083736,Patchell; Gregory David,27,0,30,3
1650570397623,MATH 10A,A03,083737,Patchell; Gregory David,24,0,30,6
1650570404889,MATH 10B,A01,083207,Staff,0,9,30,30
1650570404889,MATH 10B,A02,083208,Staff,0,8,30,30
1650570404889,MATH 10B,B01,083739,Staff,11,0,30,19
1650570404889,MATH 10B,B02,083740,Staff,28,0,30,2
1650570411529,MATH 18,A01,083743,Staff,1,0,30,29
1650570411529,MATH 18,A02,083744,Staff,26,0,30,4
1650570411529,MATH 18,A03,083745,Staff,22,0,30,8
1650570411529,MATH 18,A04,083746,Staff,26,0,30,4
1650570411529,MATH 18,B01,083748,Staff,0,14,30,30
1650570411529,MATH 18,B02,083749,Staff,0,12,30,30
1650570411529,MATH 18,B03,083750,Staff,0,12,30,30
1650570411529,MATH 18,B04,083751,Staff,0,12,30,30
1650570417761,MATH 20A,A01,083754,Staff,21,0,40,19
1650570423783,MATH 20B,A01,083756,Staff,0,11,30,30
1650570423783,MATH 20B,A02,083757,Staff,0,12,30,30
1650570430360,MATH 20C,A01,083760,Staff,0,16,30,30
1650570430360,MATH 20C,A02,083761,Staff,2,14,30,28
1650570430360,MATH 20C,B01,083762,Staff,12,0,30,18
1650570430360,MATH 20C,B02,083763,Staff,28,0,30,2
1650570436387,MATH 20D,A01,083765,Staff,0,1,30,30
1650570436387,MATH 20D,A02,083766,Staff,7,0,30,23
1650570436387,MATH 20D,A03,083767,Staff,25,0,30,5
1650570442823,MATH 20E,A01,083771,Staff,7,0,30,23
1650570442823,MATH 20E,A02,083772,Staff,17,0,30,13
1650570442823,MATH 20E,B01,083773,Staff,0,0,30,30
1650570442823,MATH 20E,B02,083774,Staff,10,0,30,20
1650570448845,MATH 103A,A01,083777,Staff,0,15,30,30
1650570448845,MATH 103A,A02,083778,Staff,0,14,30,30
1650570448845,MATH 103A,B01,083779,Staff,0,13,30,30
1650570448845,MATH 103A,B02,083780,Staff,0,13,30,30
1650570454873,MATH 105,A01,085443,Staff,0,21,30,30
1650570463897,MATH 109,A01,083213,Anzaldo; Leesa B,0,7,30,30
1650570463897,MATH 109,A02,083214,Anzaldo; Leesa B,0,7,30,30
1650570463897,MATH 109,B01,083215,Anzaldo; Leesa B,0,5,30,30
1650570463897,MATH 109,B02,083216,Anzaldo; Leesa B,0,6,30,30
1650570469931,MATH 142A,A01,083219,Chow; Bennett,0,16,30,30
1650570469931,MATH 142A,A02,083220,Chow; Bennett,0,14,30,30
1650570469931,MATH 142A,B01,083221,Chow; Bennett,0,14,30,30
1650570469931,MATH 142A,B02,083222,Chow; Bennett,0,13,30,30
1650570475966,MATH 193A,A01,083224,Staff,1,6,30,29
1650570475966,MATH 193A,A02,083225,Staff,0,5,30,30
1650570475966,MATH 193A,A03,083781,Staff,0,6,30,30
1650570475966,MATH 193A,A04,083782,Staff,0,7,30,30
1650570481988,MATH 197,001,091859,McAuley; Julian John,9998,0,9999,1
1650570488050,COGS 9,A01,083615,Staff,1,16,60,59
1650570494078,COGS 11,A01,083617,Boyle; Mary E. T.,19,0,40,21
1650570500103,COGS 13,A01,083071,Staff,0,36,40,40
1650570506134,COGS 14A,A01,092681,Staff,0,27,100,100
1650570512163,COGS 14B,A01,083073,Cheng; Tzu-Han,0,12,50,50
1650570518186,COGS 17,A01,092677,Staff,18,0,75,57
1650570527585,COGS 100,A01,083619,Staff,1,26,60,59
1650570533618,COGS 101A,A01,083621,Davis; Joshua Daniel,0,26,60,60
1650570541112,COGS 101B,A01,091572,Staff,1,5,60,59
1650570547142,COGS 101C,A01,083625,Delgado; Tania,15,0,30,15
1650570554085,COGS 107A,A01,083627,Boyle; Mary E. T.,0,12,60,60
1650570562271,COGS 118A,A01,083075,Staff,0,4,60,60
1650570568310,CSE 3,A50,083646,Miranda; Gregory Joseph,20,0,38,18
1650570568310,CSE 3,A51,083647,Miranda; Gregory Joseph,36,0,37,1
1650570574336,CSE 8A,A50,083650,Miranda; Gregory Joseph,0,29,40,40
1650570580360,CSE 11,A01,083080,Cao; Yingjun,0,93,40,40
1650570588953,CSE 12,A01,083652,Staff,0,19,100,100
1650570595731,CSE 15L,A01,083654,Staff,0,1,50,50
1650570595731,CSE 15L,A02,083655,Staff,0,1,50,50
1650570603002,CSE 20,A01,083657,Staff,51,0,80,29
1650570609724,CSE 30,A01,083084,Eldon; John,0,77,40,40
1650570615749,CSE 100,A01,083659,Cao; Yingjun,0,66,50,50
1650570626118,CSE 134B,A01,083661,Powell; Thomas Allan,0,35,65,65
1650570633196,CSE 140,A01,083663,Staff,0,5,75,75
1650570639904,CSE 140L,A01,083088,Eldon; John,0,11,75,75
1650570645946,CSE 175,A01,083665,Kumar; Rakesh,7,0,25,18
1650570651971,CSE 190,A00,092507,Dubnov; Shlomo,10,0,20,10
1650570657995,ECE 45,A01,083139,Staff,1,1,60,59
1650570670034,ECE 65,A50,083695,Staff,1,6,30,29
1650570676057,ECE 109,A01,091882,Touri; Behrouz,33,0,70,37
1650570685865,ECE 180,A00,083140,Abi Samra; Nicholas Camill,21,0,30,9
1650570685865,ECE 180,B00,083141,Abi Samra; Nicholas Camill,0,0,30,30
1650570691893,MATH 10A,A01,083735,Patchell; Gregory David,5,0,30,25
1650570691893,MATH 10A,A02,083736,Patchell; Gregory David,27,0,30,3
1650570691893,MATH 10A,A03,083737,Patchell; Gregory David,24,0,30,6
1650570701223,MATH 10B,A01,083207,Staff,0,9,30,30
1650570701223,MATH 10B,A02,083208,Staff,0,8,30,30
1650570701223,MATH 10B,B01,083739,Staff,11,0,30,19
1650570701223,MATH 10B,B02,083740,Staff,28,0,30,2
1650570709379,MATH 18,A01,083743,Staff,1,0,30,29
1650570709379,MATH 18,A02,083744,Staff,26,0,30,4
1650570709379,MATH 18,A03,083745,Staff,22,0,30,8
1650570709379,MATH 18,A04,083746,Staff,26,0,30,4
1650570709379,MATH 18,B01,083748,Staff,0,14,30,30
1650570709379,MATH 18,B02,083749,Staff,0,12,30,30
1650570709379,MATH 18,B03,083750,Staff,0,12,30,30
1650570709379,MATH 18,B04,083751,Staff,0,12,30,30
1650570716909,MATH 20A,A01,083754,Staff,21,0,40,19
1650570727095,MATH 20B,A01,083756,Staff,0,11,30,30
1650570727095,MATH 20B,A02,083757,Staff,0,12,30,30
1650570733118,MATH 20C,A01,083760,Staff,0,16,30,30
1650570733118,MATH 20C,A02,083761,Staff,2,14,30,28
1650570733118,MATH 20C,B01,083762,Staff,12,0,30,18
1650570733118,MATH 20C,B02,083763,Staff,28,0,30,2
1650570741756,MATH 20D,A01,083765,Staff,0,1,30,30
1650570741756,MATH 20D,A02,083766,Staff,7,0,30,23
1650570741756,MATH 20D,A03,083767,Staff,25,0,30,5
1650570747789,MATH 20E,A01,083771,Staff,7,0,30,23
1650570747789,MATH 20E,A02,083772,Staff,17,0,30,13
1650570747789,MATH 20E,B01,083773,Staff,0,0,30,30
1650570747789,MATH 20E,B02,083774,Staff,10,0,30,20
1650570753853,MATH 103A,A01,083777,Staff,0,15,30,30
1650570753853,MATH 103A,A02,083778,Staff,0,14,30,30
1650570753853,MATH 103A,B01,083779,Staff,0,13,30,30
1650570753853,MATH 103A,B02,083780,Staff,0,13,30,30
1650570759906,MATH 105,A01,085443,Staff,0,21,30,30
1650570765942,MATH 109,A01,083213,Anzaldo; Leesa B,0,7,30,30
1650570765942,MATH 109,A02,083214,Anzaldo; Leesa B,0,7,30,30
1650570765942,MATH 109,B01,083215,Anzaldo; Leesa B,0,5,30,30
1650570765942,MATH 109,B02,083216,Anzaldo; Leesa B,0,6,30,30
1650570777967,MATH 142A,A01,083219,Chow; Bennett,0,16,30,30
1650570777967,MATH 142A,A02,083220,Chow; Bennett,0,14,30,30
1650570777967,MATH 142A,B01,083221,Chow; Bennett,0,14,30,30
1650570777967,MATH 142A,B02,083222,Chow; Bennett,0,13,30,30
1650570787992,MATH 193A,A01,083224,Staff,1,6,30,29
1650570787992,MATH 193A,A02,083225,Staff,0,5,30,30
1650570787992,MATH 193A,A03,083781,Staff,0,6,30,30
1650570787992,MATH 193A,A04,083782,Staff,0,7,30,30
1650570794019,MATH 197,001,091859,McAuley; Julian John,9998,0,9999,1
1650570800845,COGS 9,A01,083615,Staff,1,16,60,59
1650570807276,COGS 11,A01,083617,Boyle; Mary E. T.,19,0,40,21
1650570813833,COGS 13,A01,083071,Staff,0,36,40,40
1650570820146,COGS 14A,A01,092681,Staff,0,27,100,100
1650570828899,COGS 14B,A01,083073,Cheng; Tzu-Han,0,12,50,50
1650570837596,COGS 17,A01,092677,Staff,18,0,75,57
1650570843625,COGS 100,A01,083619,Staff,1,26,60,59
1650570849653,COGS 101A,A01,083621,Davis; Joshua Daniel,0,26,60,60
1650570859968,COGS 101B,A01,091572,Staff,1,5,60,59
1650570865997,COGS 101C,A01,083625,Delgado; Tania,15,0,30,15
1650570876003,COGS 107A,A01,083627,Boyle; Mary E. T.,0,12,60,60
1650570882631,COGS 118A,A01,083075,Staff,0,4,60,60
1650570893889,CSE 3,A50,083646,Miranda; Gregory Joseph,20,0,38,18
1650570893889,CSE 3,A51,083647,Miranda; Gregory Joseph,36,0,37,1
1650570903824,CSE 8A,A50,083650,Miranda; Gregory Joseph,0,29,40,40
1650570914647,CSE 11,A01,083080,Cao; Yingjun,0,93,40,40
1650570923631,CSE 12,A01,083652,Staff,0,19,100,100
1650570929671,CSE 15L,A01,083654,Staff,0,1,50,50
1650570929671,CSE 15L,A02,083655,Staff,0,1,50,50
1650570935706,CSE 20,A01,083657,Staff,51,0,80,29
1650570946477,CSE 30,A01,083084,Eldon; John,0,77,40,40
1650570952500,CSE 100,A01,083659,Cao; Yingjun,0,67,50,50
1650570958523,CSE 134B,A01,083661,Powell; Thomas Allan,0,35,65,65
1650570967442,CSE 140,A01,083663,Staff,0,5,75,75
1650570973468,CSE 140L,A01,083088,Eldon; John,0,11,75,75
1650570979493,CSE 175,A01,083665,Kumar; Rakesh,7,0,25,18
1650570990740,CSE 190,A00,092507,Dubnov; Shlomo,10,0,20,10
1650570996767,ECE 45,A01,083139,Staff,1,1,60,59
1650571006318,ECE 65,A50,083695,Staff,1,6,30,29
1650571012342,ECE 109,A01,091882,Touri; Behrouz,33,0,70,37
1650571018365,ECE 180,A00,083140,Abi Samra; Nicholas Camill,21,0,30,9
1650571018365,ECE 180,B00,083141,Abi Samra; Nicholas Camill,0,0,30,30
1650571030852,MATH 10A,A01,083735,Patchell; Gregory David,5,0,30,25
1650571030852,MATH 10A,A02,083736,Patchell; Gregory David,27,0,30,3
1650571030852,MATH 10A,A03,083737,Patchell; Gregory David,24,0,30,6
1650571036880,MATH 10B,A01,083207,Staff,0,9,30,30
1650571036880,MATH 10B,A02,083208,Staff,0,8,30,30
1650571036880,MATH 10B,B01,083739,Staff,11,0,30,19
1650571036880,MATH 10B,B02,083740,Staff,28,0,30,2
1650571042909,MATH 18,A01,083743,Staff,1,0,30,29
1650571042909,MATH 18,A02,083744,Staff,26,0,30,4
1650571042909,MATH 18,A03,083745,Staff,22,0,30,8
1650571042909,MATH 18,A04,083746,Staff,26,0,30,4
1650571042909,MATH 18,B01,083748,Staff,0,14,30,30
1650571042909,MATH 18,B02,083749,Staff,0,12,30,30
1650571042909,MATH 18,B03,083750,Staff,0,12,30,30
1650571042909,MATH 18,B04,083751,Staff,0,12,30,30
1650571048947,MATH 20A,A01,083754,Staff,21,0,40,19
1650571054972,MATH 20B,A01,083756,Staff,0,11,30,30
1650571054972,MATH 20B,A02,083757,Staff,0,12,30,30
1650571064683,MATH 20C,A01,083760,Staff,0,16,30,30
1650571064683,MATH 20C,A02,083761,Staff,2,14,30,28
1650571064683,MATH 20C,B01,083762,Staff,12,0,30,18
1650571064683,MATH 20C,B02,083763,Staff,28,0,30,2
1650571070713,MATH 20D,A01,083765,Staff,0,1,30,30
1650571070713,MATH 20D,A02,083766,Staff,7,0,30,23
1650571070713,MATH 20D,A03,083767,Staff,25,0,30,5
1650571080028,MATH 20E,A01,083771,Staff,7,0,30,23
1650571080028,MATH 20E,A02,083772,Staff,17,0,30,13
1650571080028,MATH 20E,B01,083773,Staff,0,0,30,30
1650571080028,MATH 20E,B02,083774,Staff,10,0,30,20
1650571086374,MATH 103A,A01,083777,Staff,0,15,30,30
1650571086374,MATH 103A,A02,083778,Staff,0,14,30,30
1650571086374,MATH 103A,B01,083779,Staff,0,13,30,30
1650571086374,MATH 103A,B02,083780,Staff,0,13,30,30
1650571092401,MATH 105,A01,085443,Staff,0,21,30,30
1650571102394,MATH 109,A01,083213,Anzaldo; Leesa B,0,7,30,30
1650571102394,MATH 109,A02,083214,Anzaldo; Leesa B,0,7,30,30
1650571102394,MATH 109,B01,083215,Anzaldo; Leesa B,0,5,30,30
1650571102394,MATH 109,B02,083216,Anzaldo; Leesa B,0,6,30,30
1650571108425,MATH 142A,A01,083219,Chow; Bennett,0,16,30,30
1650571108425,MATH 142A,A02,083220,Chow; Bennett,0,14,30,30
1650571108425,MATH 142A,B01,083221,Chow; Bennett,0,14,30,30
1650571108425,MATH 142A,B02,083222,Chow; Bennett,0,13,30,30
1650571114452,MATH 193A,A01,083224,Staff,1,6,30,29
1650571114452,MATH 193A,A02,083225,Staff,0,6,30,30
1650571114452,MATH 193A,A03,083781,Staff,0,6,30,30
1650571114452,MATH 193A,A04,083782,Staff,0,7,30,30
1650571125702,MATH 197,001,091859,McAuley; Julian John,9998,0,9999,1
1650571132673,COGS 9,A01,083615,Staff,1,16,60,59
1650571138696,COGS 11,A01,083617,Boyle; Mary E. T.,19,0,40,21
1650571151074,COGS 13,A01,083071,Staff,0,37,40,40
1650571157097,COGS 14A,A01,092681,Staff,0,27,100,100
1650571167741,COGS 14B,A01,083073,Cheng; Tzu-Han,0,12,50,50
1650571174145,COGS 17,A01,092677,Staff,18,0,75,57
1650571180221,COGS 100,A01,083619,Staff,1,26,60,59
1650571186253,COGS 101A,A01,083621,Davis; Joshua Daniel,0,26,60,60
1650571196756,COGS 101B,A01,091572,Staff,1,5,60,59
1650571207438,COGS 101C,A01,083625,Delgado; Tania,15,0,30,15
1650571213465,COGS 107A,A01,083627,Boyle; Mary E. T.,0,12,60,60
1650571219490,COGS 118A,A01,083075,Staff,0,4,60,60
1650571225762,CSE 3,A50,083646,Miranda; Gregory Joseph,19,0,38,19
1650571225762,CSE 3,A51,083647,Miranda; Gregory Joseph,36,0,37,1
1650571231791,CSE 8A,A50,083650,Miranda; Gregory Joseph,0,29,40,40
1650571241013,CSE 11,A01,083080,Cao; Yingjun,0,93,40,40
1650571250610,CSE 12,A01,083652,Staff,0,19,100,100
1650571256656,CSE 15L,A01,083654,Staff,0,1,50,50
1650571256656,CSE 15L,A02,083655,Staff,0,1,50,50
1650571267838,CSE 20,A01,083657,Staff,51,0,80,29
1650571280042,CSE 30,A01,083084,Eldon; John,0,77,40,40
1650571287151,CSE 100,A01,083659,Cao; Yingjun,0,67,50,50
1650571296693,CSE 134B,A01,083661,Powell; Thomas Allan,0,35,65,65
1650571308831,CSE 140,A01,083663,Staff,0,5,75,75
1650571318366,CSE 140L,A01,083088,Eldon; John,0,11,75,75
1650571325773,CSE 175,A01,083665,Kumar; Rakesh,7,0,25,18
1650571335368,CSE 190,A00,092507,Dubnov; Shlomo,10,0,20,10
1650571346793,ECE 45,A01,083139,Staff,1,1,60,59
1650571352823,ECE 65,A50,083695,Staff,1,6,30,29
1650571362365,ECE 109,A01,091882,Touri; Behrouz,33,0,70,37
1650571372780,ECE 180,A00,083140,Abi Samra; Nicholas Camill,21,0,30,9
1650571372780,ECE 180,B00,083141,Abi Samra; Nicholas Camill,0,0,30,30
1650571381542,MATH 10A,A01,083735,Patchell; Gregory David,5,0,30,25
1650571381542,MATH 10A,A02,083736,Patchell; Gregory David,27,0,30,3
1650571381542,MATH 10A,A03,083737,Patchell; Gregory David,24,0,30,6
1650571391835,MATH 10B,A01,083207,Staff,0,9,30,30
1650571391835,MATH 10B,A02,083208,Staff,0,8,30,30
1650571391835,MATH 10B,B01,083739,Staff,11,0,30,19
1650571391835,MATH 10B,B02,083740,Staff,28,0,30,2
1650571401843,MATH 18,A01,083743,Staff,1,0,30,29
1650571401843,MATH 18,A02,083744,Staff,26,0,30,4
1650571401843,MATH 18,A03,083745,Staff,22,0,30,8
1650571401843,MATH 18,A04,083746,Staff,26,0,30,4
1650571401843,MATH 18,B01,083748,Staff,0,14,30,30
1650571401843,MATH 18,B02,083749,Staff,0,12,30,30
1650571401843,MATH 18,B03,083750,Staff,0,12,30,30
1650571401843,MATH 18,B04,083751,Staff,0,12,30,30
1650571411268,MATH 20A,A01,083754,Staff,21,0,40,19
1650571417294,MATH 20B,A01,083756,Staff,0,11,30,30
1650571417294,MATH 20B,A02,083757,Staff,0,12,30,30
1650571426776,MATH 20C,A01,083760,Staff,0,16,30,30
1650571426776,MATH 20C,A02,083761,Staff,2,14,30,28
1650571426776,MATH 20C,B01,083762,Staff,12,0,30,18
1650571426776,MATH 20C,B02,083763,Staff,28,0,30,2
1650571432803,MATH 20D,A01,083765,Staff,0,1,30,30
1650571432803,MATH 20D,A02,083766,Staff,7,0,30,23
1650571432803,MATH 20D,A03,083767,Staff,25,0,30,5
1650571442364,MATH 20E,A01,083771,Staff,7,0,30,23
1650571442364,MATH 20E,A02,083772,Staff,17,0,30,13
1650571442364,MATH 20E,B01,083773,Staff,0,0,30,30
1650571442364,MATH 20E,B02,083774,Staff,10,0,30,20
1650571452963,MATH 103A,A01,083777,Staff,0,15,30,30
1650571452963,MATH 103A,A02,083778,Staff,0,14,30,30
1650571452963,MATH 103A,B01,083779,Staff,0,13,30,30
1650571452963,MATH 103A,B02,083780,Staff,0,13,30,30
1650571460144,MATH 105,A01,085443,Staff,0,21,30,30
1650571469806,MATH 109,A01,083213,Anzaldo; Leesa B,0,7,30,30
1650571469806,MATH 109,A02,083214,Anzaldo; Leesa B,0,7,30,30
1650571469806,MATH 109,B01,083215,Anzaldo; Leesa B,0,5,30,30
1650571469806,MATH 109,B02,083216,Anzaldo; Leesa B,0,6,30,30
1650571478581,MATH 142A,A01,083219,Chow; Bennett,0,16,30,30
1650571478581,MATH 142A,A02,083220,Chow; Bennett,0,14,30,30
1650571478581,MATH 142A,B01,083221,Chow; Bennett,0,14,30,30
1650571478581,MATH 142A,B02,083222,Chow; Bennett,0,13,30,30
1650571489710,MATH 193A,A01,083224,Staff,1,6,30,29
1650571489710,MATH 193A,A02,083225,Staff,0,6,30,30
1650571489710,MATH 193A,A03,083781,Staff,0,6,30,30
1650571489710,MATH 193A,A04,083782,Staff,0,7,30,30
1650571495923,MATH 197,001,091859,McAuley; Julian John,9998,0,9999,1
1650571505328,COGS 9,A01,083615,Staff,1,16,60,59
1650571511368,COGS 11,A01,083617,Boyle; Mary E. T.,19,0,40,21
1650571517390,COGS 13,A01,083071,Staff,0,37,40,40
1650571527172,COGS 14A,A01,092681,Staff,0,27,100,100
1650571533198,COGS 14B,A01,083073,Cheng; Tzu-Han,0,12,50,50
1650571539222,COGS 17,A01,092677,Staff,18,0,75,57
1650571549602,COGS 100,A01,083619,Staff,1,26,60,59
1650571555623,COGS 101A,A01,083621,Davis; Joshua Daniel,0,26,60,60
1650571565144,COGS 101B,A01,091572,Staff,1,5,60,59
1650571573062,COGS 101C,A01,083625,Delgado; Tania,15,0,30,15
1650571579086,COGS 107A,A01,083627,Boyle; Mary E. T.,0,12,60,60
1650571585110,COGS 118A,A01,083075,Staff,0,4,60,60
1650571591143,CSE 3,A50,083646,Miranda; Gregory Joseph,19,0,38,19
1650571591143,CSE 3,A51,083647,Miranda; Gregory Joseph,36,0,37,1
1650571597166,CSE 8A,A50,083650,Miranda; Gregory Joseph,0,29,40,40
1650571603191,CSE 11,A01,083080,Cao; Yingjun,0,93,40,40
1650571609224,CSE 12,A01,083652,Staff,0,19,100,100
1650571615251,CSE 15L,A01,083654,Staff,0,1,50,50
1650571615251,CSE 15L,A02,083655,Staff,0,1,50,50
1650571621277,CSE 20,A01,083657,Staff,51,0,80,29
1650571627305,CSE 30,A01,083084,Eldon; John,0,77,40,40
1650571633331,CSE 100,A01,083659,Cao; Yingjun,0,66,50,50
1650571639355,CSE 134B,A01,083661,Powell; Thomas Allan,0,35,65,65
1650571645385,CSE 140,A01,083663,Staff,0,6,75,75
1650571651415,CSE 140L,A01,083088,Eldon; John,0,12,75,75
1650571657439,CSE 175,A01,083665,Kumar; Rakesh,7,0,25,18
1650571663470,CSE 190,A00,092507,Dubnov; Shlomo,10,0,20,10
1650571669595,ECE 45,A01,083139,Staff,1,1,60,59
1650571675635,ECE 65,A50,083695,Staff,1,6,30,29
1650571681673,ECE 109,A01,091882,Touri; Behrouz,33,0,70,37
1650571687706,ECE 180,A00,083140,Abi Samra; Nicholas Camill,21,0,30,9
1650571687706,ECE 180,B00,083141,Abi Samra; Nicholas Camill,0,0,30,30
1650571693727,MATH 10A,A01,083735,Patchell; Gregory David,5,0,30,25
1650571693727,MATH 10A,A02,083736,Patchell; Gregory David,27,0,30,3
1650571693727,MATH 10A,A03,083737,Patchell; Gregory David,24,0,30,6
1650571699761,MATH 10B,A01,083207,Staff,0,9,30,30
1650571699761,MATH 10B,A02,083208,Staff,0,8,30,30
1650571699761,MATH 10B,B01,083739,Staff,11,0,30,19
1650571699761,MATH 10B,B02,083740,Staff,28,0,30,2
1650571705791,MATH 18,A01,083743,Staff,1,0,30,29
1650571705791,MATH 18,A02,083744,Staff,26,0,30,4
1650571705791,MATH 18,A03,083745,Staff,22,0,30,8
1650571705791,MATH 18,A04,083746,Staff,26,0,30,4
1650571705791,MATH 18,B01,083748,Staff,0,14,30,30
1650571705791,MATH 18,B02,083749,Staff,0,12,30,30
1650571705791,MATH 18,B03,083750,Staff,0,12,30,30
1650571705791,MATH 18,B04,083751,Staff,0,12,30,30
1650571711815,MATH 20A,A01,083754,Staff,21,0,40,19
1650571717839,MATH 20B,A01,083756,Staff,0,11,30,30
1650571717839,MATH 20B,A02,083757,Staff,0,12,30,30
1650571723889,MATH 20C,A01,083760,Staff,0,16,30,30
1650571723889,MATH 20C,A02,083761,Staff,2,14,30,28
1650571723889,MATH 20C,B01,083762,Staff,12,0,30,18
1650571723889,MATH 20C,B02,083763,Staff,28,0,30,2
1650571729913,MATH 20D,A01,083765,Staff,0,1,30,30
1650571729913,MATH 20D,A02,083766,Staff,7,0,30,23
1650571729913,MATH 20D,A03,083767,Staff,25,0,30,5
1650571735939,MATH 20E,A01,083771,Staff,7,0,30,23
1650571735939,MATH 20E,A02,083772,Staff,17,0,30,13
1650571735939,MATH 20E,B01,083773,Staff,0,0,30,30
1650571735939,MATH 20E,B02,083774,Staff,10,0,30,20
1650571741967,MATH 103A,A01,083777,Staff,0,15,30,30
1650571741967,MATH 103A,A02,083778,Staff,0,14,30,30
1650571741967,MATH 103A,B01,083779,Staff,0,13,30,30
1650571741967,MATH 103A,B02,083780,Staff,0,13,30,30
1650571747995,MATH 105,A01,085443,Staff,0,21,30,30
1650571754020,MATH 109,A01,083213,Anzaldo; Leesa B,0,7,30,30
1650571754020,MATH 109,A02,083214,Anzaldo; Leesa B,0,7,30,30
1650571754020,MATH 109,B01,083215,Anzaldo; Leesa B,0,5,30,30
1650571754020,MATH 109,B02,083216,Anzaldo; Leesa B,0,6,30,30
1650571760044,MATH 142A,A01,083219,Chow; Bennett,0,16,30,30
1650571760044,MATH 142A,A02,083220,Chow; Bennett,0,14,30,30
1650571760044,MATH 142A,B01,083221,Chow; Bennett,0,14,30,30
1650571760044,MATH 142A,B02,083222,Chow; Bennett,0,13,30,30
1650571766068,MATH 193A,A01,083224,Staff,1,6,30,29
1650571766068,MATH 193A,A02,083225,Staff,0,6,30,30
1650571766068,MATH 193A,A03,083781,Staff,0,6,30,30
1650571766068,MATH 193A,A04,083782,Staff,0,7,30,30
1650571772094,MATH 197,001,091859,McAuley; Julian John,9998,0,9999,1
1650571778159,COGS 9,A01,083615,Staff,1,16,60,59
1650571784185,COGS 11,A01,083617,Boyle; Mary E. T.,19,0,40,21
1650571790212,COGS 13,A01,083071,Staff,0,37,40,40
1650571796246,COGS 14A,A01,092681,Staff,0,27,100,100
1650571802271,COGS 14B,A01,083073,Cheng; Tzu-Han,0,12,50,50
1650571808299,COGS 17,A01,092677,Staff,18,0,75,57
1650571814325,COGS 100,A01,083619,Staff,1,26,60,59
1650571820355,COGS 101A,A01,083621,Davis; Joshua Daniel,0,26,60,60
1650571826401,COGS 101B,A01,091572,Staff,1,5,60,59
1650571832424,COGS 101C,A01,083625,Delgado; Tania,15,0,30,15
1650571838452,COGS 107A,A01,083627,Boyle; Mary E. T.,0,12,60,60
1650571844476,COGS 118A,A01,083075,Staff,0,4,60,60
1650571850504,CSE 3,A50,083646,Miranda; Gregory Joseph,19,0,38,19
1650571850504,CSE 3,A51,083647,Miranda; Gregory Joseph,36,0,37,1
1650571856528,CSE 8A,A50,083650,Miranda; Gregory Joseph,0,29,40,40
1650571862551,CSE 11,A01,083080,Cao; Yingjun,0,93,40,40
1650571868577,CSE 12,A01,083652,Staff,0,19,100,100
1650571874604,CSE 15L,A01,083654,Staff,0,1,50,50
1650571874604,CSE 15L,A02,083655,Staff,0,1,50,50
1650571880631,CSE 20,A01,083657,Staff,51,0,80,29
1650571886657,CSE 30,A01,083084,Eldon; John,0,77,40,40
1650571892681,CSE 100,A01,083659,Cao; Yingjun,0,66,50,50
1650571898705,CSE 134B,A01,083661,Powell; Thomas Allan,0,35,65,65
1650571904755,CSE 140,A01,083663,Staff,0,6,75,75
1650571910779,CSE 140L,A01,083088,Eldon; John,0,12,75,75
1650571916806,CSE 175,A01,083665,Kumar; Rakesh,7,0,25,18
1650571922831,CSE 190,A00,092507,Dubnov; Shlomo,10,0,20,10
1650571928855,ECE 45,A01,083139,Staff,1,1,60,59
1650571934883,ECE 65,A50,083695,Staff,1,6,30,29
1650571940906,ECE 109,A01,091882,Touri; Behrouz,33,0,70,37
1650571946937,ECE 180,A00,083140,Abi Samra; Nicholas Camill,21,0,30,9
1650571946937,ECE 180,B00,083141,Abi Samra; Nicholas Camill,0,0,30,30
1650571952962,MATH 10A,A01,083735,Patchell; Gregory David,5,0,30,25
1650571952962,MATH 10A,A02,083736,Patchell; Gregory David,27,0,30,3
1650571952962,MATH 10A,A03,083737,Patchell; Gregory David,24,0,30,6
1650571958988,MATH 10B,A01,083207,Staff,0,9,30,30
1650571958988,MATH 10B,A02,083208,Staff,0,8,30,30
1650571958988,MATH 10B,B01,083739,Staff,11,0,30,19
1650571958988,MATH 10B,B02,083740,Staff,28,0,30,2
1650571965015,MATH 18,A01,083743,Staff,1,0,30,29
1650571965015,MATH 18,A02,083744,Staff,26,0,30,4
1650571965015,MATH 18,A03,083745,Staff,22,0,30,8
1650571965015,MATH 18,A04,083746,Staff,26,0,30,4
1650571965015,MATH 18,B01,083748,Staff,0,14,30,30
1650571965015,MATH 18,B02,083749,Staff,0,12,30,30
1650571965015,MATH 18,B03,083750,Staff,0,12,30,30
1650571965015,MATH 18,B04,083751,Staff,0,12,30,30
1650571971045,MATH 20A,A01,083754,Staff,21,0,40,19
1650571977069,MATH 20B,A01,083756,Staff,0,11,30,30
1650571977069,MATH 20B,A02,083757,Staff,0,12,30,30
1650571983099,MATH 20C,A01,083760,Staff,0,16,30,30
1650571983099,MATH 20C,A02,083761,Staff,2,14,30,28
1650571983099,MATH 20C,B01,083762,Staff,12,0,30,18
1650571983099,MATH 20C,B02,083763,Staff,28,0,30,2
1650571989126,MATH 20D,A01,083765,Staff,0,1,30,30
1650571989126,MATH 20D,A02,083766,Staff,7,0,30,23
1650571989126,MATH 20D,A03,083767,Staff,25,0,30,5
1650571995152,MATH 20E,A01,083771,Staff,7,0,30,23
1650571995152,MATH 20E,A02,083772,Staff,17,0,30,13
1650571995152,MATH 20E,B01,083773,Staff,0,0,30,30
1650571995152,MATH 20E,B02,083774,Staff,10,0,30,20
1650572001184,MATH 103A,A01,083777,Staff,0,15,30,30
1650572001184,MATH 103A,A02,083778,Staff,0,14,30,30
1650572001184,MATH 103A,B01,083779,Staff,0,13,30,30
1650572001184,MATH 103A,B02,083780,Staff,0,13,30,30
1650572007208,MATH 105,A01,085443,Staff,0,21,30,30
1650572013241,MATH 109,A01,083213,Anzaldo; Leesa B,0,7,30,30
1650572013241,MATH 109,A02,083214,Anzaldo; Leesa B,0,7,30,30
1650572013241,MATH 109,B01,083215,Anzaldo; Leesa B,0,5,30,30
1650572013241,MATH 109,B02,083216,Anzaldo; Leesa B,0,6,30,30
1650572019283,MATH 142A,A01,083219,Chow; Bennett,0,16,30,30
1650572019283,MATH 142A,A02,083220,Chow; Bennett,0,14,30,30
1650572019283,MATH 142A,B01,083221,Chow; Bennett,0,14,30,30
1650572019283,MATH 142A,B02,083222,Chow; Bennett,0,13,30,30
1650572025321,MATH 193A,A01,083224,Staff,1,6,30,29
1650572025321,MATH 193A,A02,083225,Staff,0,6,30,30
1650572025321,MATH 193A,A03,083781,Staff,0,6,30,30
1650572025321,MATH 193A,A04,083782,Staff,0,7,30,30
1650572031346,MATH 197,001,091859,McAuley; Julian John,9998,0,9999,1
1650572037412,COGS 9,A01,083615,Staff,1,16,60,59
1650572043439,COGS 11,A01,083617,Boyle; Mary E. T.,19,0,40,21
1650572049464,COGS 13,A01,083071,Staff,0,37,40,40
1650572055500,COGS 14A,A01,092681,Staff,0,27,100,100
1650572061537,COGS 14B,A01,083073,Cheng; Tzu-Han,0,12,50,50
1650572067578,COGS 17,A01,092677,Staff,18,0,75,57
1650572073608,COGS 100,A01,083619,Staff,1,26,60,59
1650572079657,COGS 101A,A01,083621,Davis; Joshua Daniel,0,26,60,60
1650572085680,COGS 101B,A01,091572,Staff,1,5,60,59
1650572091703,COGS 101C,A01,083625,Delgado; Tania,15,0,30,15
1650572097729,COGS 107A,A01,083627,Boyle; Mary E. T.,0,12,60,60
1650572103752,COGS 118A,A01,083075,Staff,0,4,60,60
1650572109776,CSE 3,A50,083646,Miranda; Gregory Joseph,19,0,38,19
1650572109776,CSE 3,A51,083647,Miranda; Gregory Joseph,36,0,37,1
1650572115798,CSE 8A,A50,083650,Miranda; Gregory Joseph,0,29,40,40
1650572121822,CSE 11,A01,083080,Cao; Yingjun,0,93,40,40
1650572127844,CSE 12,A01,083652,Staff,0,19,100,100
1650572133876,CSE 15L,A01,083654,Staff,0,1,50,50
1650572133876,CSE 15L,A02,083655,Staff,0,1,50,50
1650572139900,CSE 20,A01,083657,Staff,51,0,80,29
1650572145930,CSE 30,A01,083084,Eldon; John,0,77,40,40
1650572151960,CSE 100,A01,083659,Cao; Yingjun,0,66,50,50
1650572157988,CSE 134B,A01,083661,Powell; Thomas Allan,0,35,65,65
1650572164012,CSE 140,A01,083663,Staff,0,6,75,75
1650572170040,CSE 140L,A01,083088,Eldon; John,0,12,75,75
1650572176063,CSE 175,A01,083665,Kumar; Rakesh,7,0,25,18
1650572182086,CSE 190,A00,092507,Dubnov; Shlomo,10,0,20,10
1650572188114,ECE 45,A01,083139,Staff,1,1,60,59
1650572194138,ECE 65,A50,083695,Staff,1,6,30,29
1650572200160,ECE 109,A01,091882,Touri; Behrouz,33,0,70,37
1650572206184,ECE 180,A00,083140,Abi Samra; Nicholas Camill,21,0,30,9
1650572206184,ECE 180,B00,083141,Abi Samra; Nicholas Camill,0,0,30,30
1650572212211,MATH 10A,A01,083735,Patchell; Gregory David,5,0,30,25
1650572212211,MATH 10A,A02,083736,Patchell; Gregory David,27,0,30,3
1650572212211,MATH 10A,A03,083737,Patchell; Gregory David,24,0,30,6
1650572218245,MATH 10B,A01,083207,Staff,0,9,30,30
1650572218245,MATH 10B,A02,083208,Staff,0,8,30,30
1650572218245,MATH 10B,B01,083739,Staff,11,0,30,19
1650572218245,MATH 10B,B02,083740,Staff,28,0,30,2
1650572224274,MATH 18,A01,083743,Staff,1,0,30,29
1650572224274,MATH 18,A02,083744,Staff,26,0,30,4
1650572224274,MATH 18,A03,083745,Staff,22,0,30,8
1650572224274,MATH 18,A04,083746,Staff,26,0,30,4
1650572224274,MATH 18,B01,083748,Staff,0,14,30,30
1650572224274,MATH 18,B02,083749,Staff,0,12,30,30
1650572224274,MATH 18,B03,083750,Staff,0,12,30,30
1650572224274,MATH 18,B04,083751,Staff,0,12,30,30
1650572230316,MATH 20A,A01,083754,Staff,21,0,40,19
1650572236344,MATH 20B,A01,083756,Staff,0,11,30,30
1650572236344,MATH 20B,A02,083757,Staff,0,12,30,30
1650572242379,MATH 20C,A01,083760,Staff,0,16,30,30
1650572242379,MATH 20C,A02,083761,Staff,2,14,30,28
1650572242379,MATH 20C,B01,083762,Staff,12,0,30,18
1650572242379,MATH 20C,B02,083763,Staff,28,0,30,2
1650572248411,MATH 20D,A01,083765,Staff,0,1,30,30
1650572248411,MATH 20D,A02,083766,Staff,7,0,30,23
1650572248411,MATH 20D,A03,083767,Staff,25,0,30,5
1650572254442,MATH 20E,A01,083771,Staff,7,0,30,23
1650572254442,MATH 20E,A02,083772,Staff,17,0,30,13
1650572254442,MATH 20E,B01,083773,Staff,0,0,30,30
1650572254442,MATH 20E,B02,083774,Staff,10,0,30,20
1650572260467,MATH 103A,A01,083777,Staff,0,15,30,30
1650572260467,MATH 103A,A02,083778,Staff,0,14,30,30
1650572260467,MATH 103A,B01,083779,Staff,0,13,30,30
1650572260467,MATH 103A,B02,083780,Staff,0,13,30,30
1650572266583,MATH 105,A01,085443,Staff,0,21,30,30
1650572272620,MATH 109,A01,083213,Anzaldo; Leesa B,0,7,30,30
1650572272620,MATH 109,A02,083214,Anzaldo; Leesa B,0,7,30,30
1650572272620,MATH 109,B01,083215,Anzaldo; Leesa B,0,5,30,30
1650572272620,MATH 109,B02,083216,Anzaldo; Leesa B,0,6,30,30
1650572278644,MATH 142A,A01,083219,Chow; Bennett,0,16,30,30
1650572278644,MATH 142A,A02,083220,Chow; Bennett,0,14,30,30
1650572278644,MATH 142A,B01,083221,Chow; Bennett,0,14,30,30
1650572278644,MATH 142A,B02,083222,Chow; Bennett,0,13,30,30
1650572284670,MATH 193A,A01,083224,Staff,1,6,30,29
1650572284670,MATH 193A,A02,083225,Staff,0,6,30,30
1650572284670,MATH 193A,A03,083781,Staff,0,6,30,30
1650572284670,MATH 193A,A04,083782,Staff,0,7,30,30
1650572290694,MATH 197,001,091859,McAuley; Julian John,9998,0,9999,1
1650572296751,COGS 9,A01,083615,Staff,1,16,60,59
1650572302775,COGS 11,A01,083617,Boyle; Mary E. T.,19,0,40,21
1650572308797,COGS 13,A01,083071,Staff,0,37,40,40
1650572314830,COGS 14A,A01,092681,Staff,0,27,100,100
1650572320866,COGS 14B,A01,083073,Cheng; Tzu-Han,0,12,50,50
1650572326891,COGS 17,A01,092677,Staff,18,0,75,57
1650572332914,COGS 100,A01,083619,Staff,1,26,60,59
1650572338941,COGS 101A,A01,083621,Davis; Joshua Daniel,0,26,60,60
1650572344968,COGS 101B,A01,091572,Staff,1,5,60,59
1650572350999,COGS 101C,A01,083625,Delgado; Tania,15,0,30,15
1650572357022,COGS 107A,A01,083627,Boyle; Mary E. T.,0,12,60,60
1650572363046,COGS 118A,A01,083075,Staff,0,4,60,60
1650572369089,CSE 3,A50,083646,Miranda; Gregory Joseph,19,0,38,19
1650572369089,CSE 3,A51,083647,Miranda; Gregory Joseph,36,0,37,1
1650572375133,CSE 8A,A50,083650,Miranda; Gregory Joseph,0,29,40,40
1650572381156,CSE 11,A01,083080,Cao; Yingjun,0,93,40,40
1650572387187,CSE 12,A01,083652,Staff,0,19,100,100
1650572393225,CSE 15L,A01,083654,Staff,0,1,50,50
1650572393225,CSE 15L,A02,083655,Staff,0,1,50,50
1650572399251,CSE 20,A01,083657,Staff,51,0,80,29
1650572405280,CSE 30,A01,083084,Eldon; John,0,77,40,40
1650572411314,CSE 100,A01,083659,Cao; Yingjun,0,66,50,50
1650572417343,CSE 134B,A01,083661,Powell; Thomas Allan,0,35,65,65
1650572423366,CSE 140,A01,083663,Staff,0,7,75,75
1650572429392,CSE 140L,A01,083088,Eldon; John,0,13,75,75
1650572435419,CSE 175,A01,083665,Kumar; Rakesh,7,0,25,18
1650572441445,CSE 190,A00,092507,Dubnov; Shlomo,10,0,20,10
1650572447473,ECE 45,A01,083139,Staff,1,1,60,59
1650572453501,ECE 65,A50,083695,Staff,1,6,30,29
1650572459526,ECE 109,A01,091882,Touri; Behrouz,33,0,70,37
1650572465551,ECE 180,A00,083140,Abi Samra; Nicholas Camill,21,0,30,9
1650572465551,ECE 180,B00,083141,Abi Samra; Nicholas Camill,0,0,30,30
1650572471577,MATH 10A,A01,083735,Patchell; Gregory David,5,0,30,25
1650572471577,MATH 10A,A02,083736,Patchell; Gregory David,27,0,30,3
1650572471577,MATH 10A,A03,083737,Patchell; Gregory David,24,0,30,6
1650572477601,MATH 10B,A01,083207,Staff,0,9,30,30
1650572477601,MATH 10B,A02,083208,Staff,0,8,30,30
1650572477601,MATH 10B,B01,083739,Staff,11,0,30,19
1650572477601,MATH 10B,B02,083740,Staff,28,0,30,2
1650572483638,MATH 18,A01,083743,Staff,1,0,30,29
1650572483638,MATH 18,A02,083744,Staff,26,0,30,4
1650572483638,MATH 18,A03,083745,Staff,22,0,30,8
1650572483638,MATH 18,A04,083746,Staff,26,0,30,4
1650572483638,MATH 18,B01,083748,Staff,0,14,30,30
1650572483638,MATH 18,B02,083749,Staff,0,12,30,30
1650572483638,MATH 18,B03,083750,Staff,0,12,30,30
1650572483638,MATH 18,B04,083751,Staff,0,12,30,30
1650572489666,MATH 20A,A01,083754,Staff,21,0,40,19
1650572495695,MATH 20B,A01,083756,Staff,0,11,30,30
1650572495695,MATH 20B,A02,083757,Staff,0,12,30,30
1650572501720,MATH 20C,A01,083760,Staff,0,16,30,30
1650572501720,MATH 20C,A02,083761,Staff,2,14,30,28
1650572501720,MATH 20C,B01,083762,Staff,12,0,30,18
1650572501720,MATH 20C,B02,083763,Staff,28,0,30,2
1650572507746,MATH 20D,A01,083765,Staff,0,1,30,30
1650572507746,MATH 20D,A02,083766,Staff,7,0,30,23
1650572507746,MATH 20D,A03,083767,Staff,25,0,30,5
1650572513773,MATH 20E,A01,083771,Staff,7,0,30,23
1650572513773,MATH 20E,A02,083772,Staff,18,0,30,12
1650572513773,MATH 20E,B01,083773,Staff,0,0,30,30
1650572513773,MATH 20E,B02,083774,Staff,10,0,30,20
1650572519798,MATH 103A,A01,083777,Staff,0,15,30,30
1650572519798,MATH 103A,A02,083778,Staff,0,14,30,30
1650572519798,MATH 103A,B01,083779,Staff,0,13,30,30
1650572519798,MATH 103A,B02,083780,Staff,0,13,30,30
1650572525830,MATH 105,A01,085443,Staff,0,21,30,30
1650572531853,MATH 109,A01,083213,Anzaldo; Leesa B,0,7,30,30
1650572531853,MATH 109,A02,083214,Anzaldo; Leesa B,0,7,30,30
1650572531853,MATH 109,B01,083215,Anzaldo; Leesa B,0,5,30,30
1650572531853,MATH 109,B02,083216,Anzaldo; Leesa B,0,6,30,30
1650572537877,MATH 142A,A01,083219,Chow; Bennett,0,16,30,30
1650572537877,MATH 142A,A02,083220,Chow; Bennett,0,14,30,30
1650572537877,MATH 142A,B01,083221,Chow; Bennett,0,14,30,30
1650572537877,MATH 142A,B02,083222,Chow; Bennett,0,13,30,30
1650572543901,MATH 193A,A01,083224,Staff,1,6,30,29
1650572543901,MATH 193A,A02,083225,Staff,0,6,30,30
1650572543901,MATH 193A,A03,083781,Staff,0,6,30,30
1650572543901,MATH 193A,A04,083782,Staff,0,7,30,30
1650572549924,MATH 197,001,091859,McAuley; Julian John,9998,0,9999,1
1650572555976,COGS 9,A01,083615,Staff,1,16,60,59
1650572562029,COGS 11,A01,083617,Boyle; Mary E. T.,19,0,40,21
1650572568078,COGS 13,A01,083071,Staff,0,37,40,40
1650572574104,COGS 14A,A01,092681,Staff,0,27,100,100
1650572580135,COGS 14B,A01,083073,Cheng; Tzu-Han,0,12,50,50
1650572586158,COGS 17,A01,092677,Staff,18,0,75,57
1650572592186,COGS 100,A01,083619,Staff,1,26,60,59
1650572598213,COGS 101A,A01,083621,Davis; Joshua Daniel,0,26,60,60
1650572604252,COGS 101B,A01,091572,Staff,1,5,60,59
1650572610275,COGS 101C,A01,083625,Delgado; Tania,15,0,30,15
1650572616311,COGS 107A,A01,083627,Boyle; Mary E. T.,0,12,60,60
1650572622335,COGS 118A,A01,083075,Staff,0,4,60,60
1650572628362,CSE 3,A50,083646,Miranda; Gregory Joseph,19,0,38,19
1650572628362,CSE 3,A51,083647,Miranda; Gregory Joseph,36,0,37,1
1650572634389,CSE 8A,A50,083650,Miranda; Gregory Joseph,0,29,40,40
1650572640430,CSE 11,A01,083080,Cao; Yingjun,0,93,40,40
1650572646455,CSE 12,A01,083652,Staff,0,19,100,100
1650572652477,CSE 15L,A01,083654,Staff,0,1,50,50
1650572652477,CSE 15L,A02,083655,Staff,0,1,50,50
1650572658513,CSE 20,A01,083657,Staff,51,0,80,29
1650572664541,CSE 30,A01,083084,Eldon; John,0,77,40,40
1650572670566,CSE 100,A01,083659,Cao; Yingjun,0,66,50,50
1650572676605,CSE 134B,A01,083661,Powell; Thomas Allan,0,35,65,65
1650572682630,CSE 140,A01,083663,Staff,0,7,75,75
1650572688661,CSE 140L,A01,083088,Eldon; John,0,13,75,75
1650572694686,CSE 175,A01,083665,Kumar; Rakesh,7,0,25,18
1650572700710,CSE 190,A00,092507,Dubnov; Shlomo,10,0,20,10
1650572706732,ECE 45,A01,083139,Staff,1,1,60,59
1650572712768,ECE 65,A50,083695,Staff,1,6,30,29
1650572718802,ECE 109,A01,091882,Touri; Behrouz,33,0,70,37
1650572724831,ECE 180,A00,083140,Abi Samra; Nicholas Camill,21,0,30,9
1650572724831,ECE 180,B00,083141,Abi Samra; Nicholas Camill,0,0,30,30
1650572730862,MATH 10A,A01,083735,Patchell; Gregory David,5,0,30,25
1650572730862,MATH 10A,A02,083736,Patchell; Gregory David,27,0,30,3
1650572730862,MATH 10A,A03,083737,Patchell; Gregory David,24,0,30,6
1650572736889,MATH 10B,A01,083207,Staff,0,9,30,30
1650572736889,MATH 10B,A02,083208,Staff,0,8,30,30
1650572736889,MATH 10B,B01,083739,Staff,11,0,30,19
1650572736889,MATH 10B,B02,083740,Staff,28,0,30,2
1650572742915,MATH 18,A01,083743,Staff,1,0,30,29
1650572742915,MATH 18,A02,083744,Staff,26,0,30,4
1650572742915,MATH 18,A03,083745,Staff,22,0,30,8
1650572742915,MATH 18,A04,083746,Staff,26,0,30,4
1650572742915,MATH 18,B01,083748,Staff,0,14,30,30
1650572742915,MATH 18,B02,083749,Staff,0,12,30,30
1650572742915,MATH 18,B03,083750,Staff,0,12,30,30
1650572742915,MATH 18,B04,083751,Staff,0,12,30,30
1650572748937,MATH 20A,A01,083754,Staff,21,0,40,19
1650572754963,MATH 20B,A01,083756,Staff,0,11,30,30
1650572754963,MATH 20B,A02,083757,Staff,0,12,30,30
1650572761021,MATH 20C,A01,083760,Staff,0,16,30,30
1650572761021,MATH 20C,A02,083761,Staff,2,14,30,28
1650572761021,MATH 20C,B01,083762,Staff,12,0,30,18
1650572761021,MATH 20C,B02,083763,Staff,28,0,30,2
1650572767048,MATH 20D,A01,083765,Staff,0,1,30,30
1650572767048,MATH 20D,A02,083766,Staff,7,0,30,23
1650572767048,MATH 20D,A03,083767,Staff,25,0,30,5
1650572773076,MATH 20E,A01,083771,Staff,7,0,30,23
1650572773076,MATH 20E,A02,083772,Staff,18,0,30,12
1650572773076,MATH 20E,B01,083773,Staff,0,0,30,30
1650572773076,MATH 20E,B02,083774,Staff,10,0,30,20
1650572779100,MATH 103A,A01,083777,Staff,0,15,30,30
1650572779100,MATH 103A,A02,083778,Staff,0,14,30,30
1650572779100,MATH 103A,B01,083779,Staff,0,13,30,30
1650572779100,MATH 103A,B02,083780,Staff,0,13,30,30
1650572785127,MATH 105,A01,085443,Staff,0,21,30,30
1650572791175,MATH 109,A01,083213,Anzaldo; Leesa B,0,7,30,30
1650572791175,MATH 109,A02,083214,Anzaldo; Leesa B,0,7,30,30
1650572791175,MATH 109,B01,083215,Anzaldo; Leesa B,0,5,30,30
1650572791175,MATH 109,B02,083216,Anzaldo; Leesa B,0,6,30,30
1650572797203,MATH 142A,A01,083219,Chow; Bennett,0,16,30,30
1650572797203,MATH 142A,A02,083220,Chow; Bennett,0,14,30,30
1650572797203,MATH 142A,B01,083221,Chow; Bennett,0,14,30,30
1650572797203,MATH 142A,B02,083222,Chow; Bennett,0,13,30,30
1650572803226,MATH 193A,A01,083224,Staff,1,6,30,29
1650572803226,MATH 193A,A02,083225,Staff,0,6,30,30
1650572803226,MATH 193A,A03,083781,Staff,0,6,30,30
1650572803226,MATH 193A,A04,083782,Staff,0,7,30,30
1650572809262,MATH 197,001,091859,McAuley; Julian John,9998,0,9999,1
1650572815318,COGS 9,A01,083615,Staff,1,16,60,59
1650572821372,COGS 11,A01,083617,Boyle; Mary E. T.,19,0,40,21
1650572827396,COGS 13,A01,083071,Staff,0,37,40,40
1650572833420,COGS 14A,A01,092681,Staff,0,27,100,100
1650572839444,COGS 14B,A01,083073,Cheng; Tzu-Han,0,12,50,50
1650572845474,COGS 17,A01,092677,Staff,18,0,75,57
1650572851496,COGS 100,A01,083619,Staff,1,26,60,59
1650572857615,COGS 101A,A01,083621,Davis; Joshua Daniel,0,26,60,60
1650572863642,COGS 101B,A01,091572,Staff,1,5,60,59
1650572869677,COGS 101C,A01,083625,Delgado; Tania,15,0,30,15
1650572875704,COGS 107A,A01,083627,Boyle; Mary E. T.,0,12,60,60
1650572881734,COGS 118A,A01,083075,Staff,0,4,60,60
1650572887757,CSE 3,A50,083646,Miranda; Gregory Joseph,19,0,38,19
1650572887757,CSE 3,A51,083647,Miranda; Gregory Joseph,36,0,37,1
1650572893789,CSE 8A,A50,083650,Miranda; Gregory Joseph,0,29,40,40
1650572899823,CSE 11,A01,083080,Cao; Yingjun,0,93,40,40
1650572905846,CSE 12,A01,083652,Staff,0,19,100,100
1650572911872,CSE 15L,A01,083654,Staff,0,1,50,50
1650572911872,CSE 15L,A02,083655,Staff,0,1,50,50
1650572917899,CSE 20,A01,083657,Staff,51,0,80,29
1650572923929,CSE 30,A01,083084,Eldon; John,0,78,40,40
1650572929956,CSE 100,A01,083659,Cao; Yingjun,0,66,50,50
1650572935983,CSE 134B,A01,083661,Powell; Thomas Allan,0,35,65,65
1650572942015,CSE 140,A01,083663,Staff,0,7,75,75
1650572948046,CSE 140L,A01,083088,Eldon; John,0,13,75,75
1650572954068,CSE 175,A01,083665,Kumar; Rakesh,7,0,25,18
1650572960094,CSE 190,A00,092507,Dubnov; Shlomo,10,0,20,10
1650572966117,ECE 45,A01,083139,Staff,1,1,60,59
1650572972150,ECE 65,A50,083695,Staff,1,6,30,29
1650572978184,ECE 109,A01,091882,Touri; Behrouz,33,0,70,37
1650572984208,ECE 180,A00,083140,Abi Samra; Nicholas Camill,21,0,30,9
1650572984208,ECE 180,B00,083141,Abi Samra; Nicholas Camill,0,0,30,30
1650572990234,MATH 10A,A01,083735,Patchell; Gregory David,5,0,30,25
1650572990234,MATH 10A,A02,083736,Patchell; Gregory David,27,0,30,3
1650572990234,MATH 10A,A03,083737,Patchell; Gregory David,24,0,30,6
1650572996261,MATH 10B,A01,083207,Staff,0,9,30,30
1650572996261,MATH 10B,A02,083208,Staff,0,8,30,30
1650572996261,MATH 10B,B01,083739,Staff,11,0,30,19
1650572996261,MATH 10B,B02,083740,Staff,28,0,30,2
1650573002295,MATH 18,A01,083743,Staff,1,0,30,29
1650573002295,MATH 18,A02,083744,Staff,26,0,30,4
1650573002295,MATH 18,A03,083745,Staff,22,0,30,8
1650573002295,MATH 18,A04,083746,Staff,26,0,30,4
1650573002295,MATH 18,B01,083748,Staff,0,14,30,30
1650573002295,MATH 18,B02,083749,Staff,0,12,30,30
1650573002295,MATH 18,B03,083750,Staff,0,12,30,30
1650573002295,MATH 18,B04,083751,Staff,0,12,30,30
1650573008324,MATH 20A,A01,083754,Staff,21,0,40,19
1650573014350,MATH 20B,A01,083756,Staff,0,11,30,30
1650573014350,MATH 20B,A02,083757,Staff,0,12,30,30
1650573020382,MATH 20C,A01,083760,Staff,0,16,30,30
1650573020382,MATH 20C,A02,083761,Staff,2,14,30,28
1650573020382,MATH 20C,B01,083762,Staff,12,0,30,18
1650573020382,MATH 20C,B02,083763,Staff,28,0,30,2
1650573026409,MATH 20D,A01,083765,Staff,0,1,30,30
1650573026409,MATH 20D,A02,083766,Staff,7,0,30,23
1650573026409,MATH 20D,A03,083767,Staff,25,0,30,5
1650573032445,MATH 20E,A01,083771,Staff,7,0,30,23
1650573032445,MATH 20E,A02,083772,Staff,18,0,30,12
1650573032445,MATH 20E,B01,083773,Staff,0,0,30,30
1650573032445,MATH 20E,B02,083774,Staff,10,0,30,20
1650573038474,MATH 103A,A01,083777,Staff,0,15,30,30
1650573038474,MATH 103A,A02,083778,Staff,0,14,30,30
1650573038474,MATH 103A,B01,083779,Staff,0,13,30,30
1650573038474,MATH 103A,B02,083780,Staff,0,13,30,30
1650573044507,MATH 105,A01,085443,Staff,0,21,30,30
1650573050528,MATH 109,A01,083213,Anzaldo; Leesa B,0,7,30,30
1650573050528,MATH 109,A02,083214,Anzaldo; Leesa B,0,7,30,30
1650573050528,MATH 109,B01,083215,Anzaldo; Leesa B,0,5,30,30
1650573050528,MATH 109,B02,083216,Anzaldo; Leesa B,0,6,30,30
1650573056556,MATH 142A,A01,083219,Chow; Bennett,0,16,30,30
1650573056556,MATH 142A,A02,083220,Chow; Bennett,0,14,30,30
1650573056556,MATH 142A,B01,083221,Chow; Bennett,0,14,30,30
1650573056556,MATH 142A,B02,083222,Chow; Bennett,0,13,30,30
1650573062585,MATH 193A,A01,083224,Staff,1,6,30,29
1650573062585,MATH 193A,A02,083225,Staff,0,6,30,30
1650573062585,MATH 193A,A03,083781,Staff,0,6,30,30
1650573062585,MATH 193A,A04,083782,Staff,0,7,30,30
1650573068610,MATH 197,001,091859,McAuley; Julian John,9998,0,9999,1
1650573074667,COGS 9,A01,083615,Staff,1,16,60,59
1650573080699,COGS 11,A01,083617,Boyle; Mary E. T.,19,0,40,21
1650573086721,COGS 13,A01,083071,Staff,0,37,40,40
1650573092747,COGS 14A,A01,092681,Staff,0,27,100,100
1650573098773,COGS 14B,A01,083073,Cheng; Tzu-Han,0,12,50,50
1650573104795,COGS 17,A01,092677,Staff,18,0,75,57
1650573110818,COGS 100,A01,083619,Staff,1,26,60,59
1650573116843,COGS 101A,A01,083621,Davis; Joshua Daniel,0,26,60,60
1650573122869,COGS 101B,A01,091572,Staff,1,5,60,59
1650573128892,COGS 101C,A01,083625,Delgado; Tania,15,0,30,15
1650573134923,COGS 107A,A01,083627,Boyle; Mary E. T.,0,12,60,60
1650573140946,COGS 118A,A01,083075,Staff,0,4,60,60
1650573146975,CSE 3,A50,083646,Miranda; Gregory Joseph,19,0,38,19
1650573146975,CSE 3,A51,083647,Miranda; Gregory Joseph,36,0,37,1
1650573152998,CSE 8A,A50,083650,Miranda; Gregory Joseph,0,29,40,40
1650573159022,CSE 11,A01,083080,Cao; Yingjun,0,93,40,40
1650573165045,CSE 12,A01,083652,Staff,0,19,100,100
1650573171072,CSE 15L,A01,083654,Staff,0,1,50,50
1650573171072,CSE 15L,A02,083655,Staff,0,1,50,50
1650573177095,CSE 20,A01,083657,Staff,51,0,80,29
1650573183122,CSE 30,A01,083084,Eldon; John,0,78,40,40
1650573189149,CSE 100,A01,083659,Cao; Yingjun,0,66,50,50
1650573195175,CSE 134B,A01,083661,Powell; Thomas Allan,0,35,65,65
1650573201201,CSE 140,A01,083663,Staff,0,7,75,75
1650573207227,CSE 140L,A01,083088,Eldon; John,0,13,75,75
1650573213251,CSE 175,A01,083665,Kumar; Rakesh,7,0,25,18
1650573219285,CSE 190,A00,092507,Dubnov; Shlomo,10,0,20,10
1650573225312,ECE 45,A01,083139,Staff,1,1,60,59
1650573231335,ECE 65,A50,083695,Staff,1,6,30,29
1650573237365,ECE 109,A01,091882,Touri; Behrouz,33,0,70,37
1650573243417,ECE 180,A00,083140,Abi Samra; Nicholas Camill,21,0,30,9
1650573243417,ECE 180,B00,083141,Abi Samra; Nicholas Camill,0,0,30,30
1650573249445,MATH 10A,A01,083735,Patchell; Gregory David,5,0,30,25
1650573249445,MATH 10A,A02,083736,Patchell; Gregory David,27,0,30,3
1650573249445,MATH 10A,A03,083737,Patchell; Gregory David,24,0,30,6
1650573255472,MATH 10B,A01,083207,Staff,0,9,30,30
1650573255472,MATH 10B,A02,083208,Staff,0,8,30,30
1650573255472,MATH 10B,B01,083739,Staff,11,0,30,19
1650573255472,MATH 10B,B02,083740,Staff,28,0,30,2
1650573261496,MATH 18,A01,083743,Staff,1,0,30,29
1650573261496,MATH 18,A02,083744,Staff,26,0,30,4
1650573261496,MATH 18,A03,083745,Staff,22,0,30,8
1650573261496,MATH 18,A04,083746,Staff,26,0,30,4
1650573261496,MATH 18,B01,083748,Staff,0,14,30,30
1650573261496,MATH 18,B02,083749,Staff,0,12,30,30
1650573261496,MATH 18,B03,083750,Staff,0,12,30,30
1650573261496,MATH 18,B04,083751,Staff,0,12,30,30
1650573267529,MATH 20A,A01,083754,Staff,21,0,40,19
1650573273558,MATH 20B,A01,083756,Staff,0,11,30,30
1650573273558,MATH 20B,A02,083757,Staff,0,12,30,30
1650573279580,MATH 20C,A01,083760,Staff,0,16,30,30
1650573279580,MATH 20C,A02,083761,Staff,2,14,30,28
1650573279580,MATH 20C,B01,083762,Staff,12,0,30,18
1650573279580,MATH 20C,B02,083763,Staff,28,0,30,2
1650573285607,MATH 20D,A01,083765,Staff,0,1,30,30
1650573285607,MATH 20D,A02,083766,Staff,7,0,30,23
1650573285607,MATH 20D,A03,083767,Staff,25,0,30,5
1650573291636,MATH 20E,A01,083771,Staff,6,0,30,24
1650573291636,MATH 20E,A02,083772,Staff,18,0,30,12
1650573291636,MATH 20E,B01,083773,Staff,0,0,30,30
1650573291636,MATH 20E,B02,083774,Staff,10,0,30,20
1650573297660,MATH 103A,A01,083777,Staff,0,15,30,30
1650573297660,MATH 103A,A02,083778,Staff,0,14,30,30
1650573297660,MATH 103A,B01,083779,Staff,0,13,30,30
1650573297660,MATH 103A,B02,083780,Staff,0,13,30,30
1650573303689,MATH 105,A01,085443,Staff,0,21,30,30
1650573309728,MATH 109,A01,083213,Anzaldo; Leesa B,0,7,30,30
1650573309728,MATH 109,A02,083214,Anzaldo; Leesa B,0,7,30,30
1650573309728,MATH 109,B01,083215,Anzaldo; Leesa B,0,5,30,30
1650573309728,MATH 109,B02,083216,Anzaldo; Leesa B,0,6,30,30
1650573315760,MATH 142A,A01,083219,Chow; Bennett,0,16,30,30
1650573315760,MATH 142A,A02,083220,Chow; Bennett,0,14,30,30
1650573315760,MATH 142A,B01,083221,Chow; Bennett,0,14,30,30
1650573315760,MATH 142A,B02,083222,Chow; Bennett,0,13,30,30
1650573321794,MATH 193A,A01,083224,Staff,1,6,30,29
1650573321794,MATH 193A,A02,083225,Staff,0,6,30,30
1650573321794,MATH 193A,A03,083781,Staff,0,6,30,30
1650573321794,MATH 193A,A04,083782,Staff,0,7,30,30
1650573327820,MATH 197,001,091859,McAuley; Julian John,9998,0,9999,1
1650573333880,COGS 9,A01,083615,Staff,1,16,60,59
1650573339907,COGS 11,A01,083617,Boyle; Mary E. T.,19,0,40,21
1650573345932,COGS 13,A01,083071,Staff,0,37,40,40
1650573351955,COGS 14A,A01,092681,Staff,0,27,100,100
1650573357988,COGS 14B,A01,083073,Cheng; Tzu-Han,0,12,50,50
1650573364011,COGS 17,A01,092677,Staff,18,0,75,57
1650573370041,COGS 100,A01,083619,Staff,1,26,60,59
1650573376068,COGS 101A,A01,083621,Davis; Joshua Daniel,0,26,60,60
1650573382094,COGS 101B,A01,091572,Staff,1,5,60,59
1650573388118,COGS 101C,A01,083625,Delgado; Tania,15,0,30,15
1650573394147,COGS 107A,A01,083627,Boyle; Mary E. T.,0,12,60,60
1650573400170,COGS 118A,A01,083075,Staff,0,4,60,60
1650573406194,CSE 3,A50,083646,Miranda; Gregory Joseph,19,0,38,19
1650573406194,CSE 3,A51,083647,Miranda; Gregory Joseph,36,0,37,1
1650573412222,CSE 8A,A50,083650,Miranda; Gregory Joseph,0,29,40,40
1650573418245,CSE 11,A01,083080,Cao; Yingjun,0,93,40,40
1650573424278,CSE 12,A01,083652,Staff,0,19,100,100
1650573430306,CSE 15L,A01,083654,Staff,0,1,50,50
1650573430306,CSE 15L,A02,083655,Staff,0,1,50,50
1650573436331,CSE 20,A01,083657,Staff,51,0,80,29
1650573442363,CSE 30,A01,083084,Eldon; John,0,78,40,40
1650573448390,CSE 100,A01,083659,Cao; Yingjun,0,66,50,50
1650573454506,CSE 134B,A01,083661,Powell; Thomas Allan,0,35,65,65
1650573460528,CSE 140,A01,083663,Staff,0,7,75,75
1650573466562,CSE 140L,A01,083088,Eldon; John,0,13,75,75
1650573472598,CSE 175,A01,083665,Kumar; Rakesh,7,0,25,18
1650573478621,CSE 190,A00,092507,Dubnov; Shlomo,10,0,20,10
1650573484643,ECE 45,A01,083139,Staff,1,1,60,59
1650573490685,ECE 65,A50,083695,Staff,1,6,30,29
1650573496718,ECE 109,A01,091882,Touri; Behrouz,33,0,70,37
1650573502742,ECE 180,A00,083140,Abi Samra; Nicholas Camill,21,0,30,9
1650573502742,ECE 180,B00,083141,Abi Samra; Nicholas Camill,0,0,30,30
1650573508766,MATH 10A,A01,083735,Patchell; Gregory David,5,0,30,25
1650573508766,MATH 10A,A02,083736,Patchell; Gregory David,27,0,30,3
1650573508766,MATH 10A,A03,083737,Patchell; Gregory David,24,0,30,6
1650573514795,MATH 10B,A01,083207,Staff,0,9,30,30
1650573514795,MATH 10B,A02,083208,Staff,0,8,30,30
1650573514795,MATH 10B,B01,083739,Staff,11,0,30,19
1650573514795,MATH 10B,B02,083740,Staff,28,0,30,2
1650573520825,MATH 18,A01,083743,Staff,1,0,30,29
1650573520825,MATH 18,A02,083744,Staff,26,0,30,4
1650573520825,MATH 18,A03,083745,Staff,22,0,30,8
1650573520825,MATH 18,A04,083746,Staff,26,0,30,4
1650573520825,MATH 18,B01,083748,Staff,0,14,30,30
1650573520825,MATH 18,B02,083749,Staff,0,12,30,30
1650573520825,MATH 18,B03,083750,Staff,0,12,30,30
1650573520825,MATH 18,B04,083751,Staff,0,12,30,30
1650573526851,MATH 20A,A01,083754,Staff,21,0,40,19
1650573532876,MATH 20B,A01,083756,Staff,0,11,30,30
1650573532876,MATH 20B,A02,083757,Staff,0,12,30,30
1650573538899,MATH 20C,A01,083760,Staff,0,16,30,30
1650573538899,MATH 20C,A02,083761,Staff,2,14,30,28
1650573538899,MATH 20C,B01,083762,Staff,12,0,30,18
1650573538899,MATH 20C,B02,083763,Staff,28,0,30,2
1650573544930,MATH 20D,A01,083765,Staff,0,1,30,30
1650573544930,MATH 20D,A02,083766,Staff,7,0,30,23
1650573544930,MATH 20D,A03,083767,Staff,25,0,30,5
1650573551068,MATH 20E,A01,083771,Staff,7,0,30,23
1650573551068,MATH 20E,A02,083772,Staff,18,0,30,12
1650573551068,MATH 20E,B01,083773,Staff,0,0,30,30
1650573551068,MATH 20E,B02,083774,Staff,9,0,30,21
1650573557093,MATH 103A,A01,083777,Staff,0,15,30,30
1650573557093,MATH 103A,A02,083778,Staff,0,14,30,30
1650573557093,MATH 103A,B01,083779,Staff,0,13,30,30
1650573557093,MATH 103A,B02,083780,Staff,0,13,30,30
1650573563128,MATH 105,A01,085443,Staff,0,21,30,30
1650573569156,MATH 109,A01,083213,Anzaldo; Leesa B,0,7,30,30
1650573569156,MATH 109,A02,083214,Anzaldo; Leesa B,0,7,30,30
1650573569156,MATH 109,B01,083215,Anzaldo; Leesa B,0,5,30,30
1650573569156,MATH 109,B02,083216,Anzaldo; Leesa B,0,6,30,30
1650573575184,MATH 142A,A01,083219,Chow; Bennett,0,16,30,30
1650573575184,MATH 142A,A02,083220,Chow; Bennett,0,14,30,30
1650573575184,MATH 142A,B01,083221,Chow; Bennett,0,14,30,30
1650573575184,MATH 142A,B02,083222,Chow; Bennett,0,13,30,30
1650573581217,MATH 193A,A01,083224,Staff,1,6,30,29
1650573581217,MATH 193A,A02,083225,Staff,0,6,30,30
1650573581217,MATH 193A,A03,083781,Staff,0,6,30,30
1650573581217,MATH 193A,A04,083782,Staff,0,7,30,30
1650573587242,MATH 197,001,091859,McAuley; Julian John,9998,0,9999,1
1650573593307,COGS 9,A01,083615,Staff,1,16,60,59
1650573599340,COGS 11,A01,083617,Boyle; Mary E. T.,18,0,40,22
1650573605373,COGS 13,A01,083071,Staff,0,37,40,40
1650573611397,COGS 14A,A01,092681,Staff,0,27,100,100
1650573617422,COGS 14B,A01,083073,Cheng; Tzu-Han,0,12,50,50
1650573623448,COGS 17,A01,092677,Staff,18,0,75,57
1650573629486,COGS 100,A01,083619,Staff,1,26,60,59
1650573635514,COGS 101A,A01,083621,Davis; Joshua Daniel,0,26,60,60
1650573641541,COGS 101B,A01,091572,Staff,1,5,60,59
1650573647564,COGS 101C,A01,083625,Delgado; Tania,15,0,30,15
1650573653590,COGS 107A,A01,083627,Boyle; Mary E. T.,0,12,60,60
1650573659612,COGS 118A,A01,083075,Staff,0,4,60,60
1650573665634,CSE 3,A50,083646,Miranda; Gregory Joseph,19,0,38,19
1650573665634,CSE 3,A51,083647,Miranda; Gregory Joseph,36,0,37,1
1650573671671,CSE 8A,A50,083650,Miranda; Gregory Joseph,0,29,40,40
1650573677694,CSE 11,A01,083080,Cao; Yingjun,0,93,40,40
1650573683723,CSE 12,A01,083652,Staff,0,19,100,100
1650573689747,CSE 15L,A01,083654,Staff,0,1,50,50
1650573689747,CSE 15L,A02,083655,Staff,0,1,50,50
1650573695782,CSE 20,A01,083657,Staff,51,0,80,29
1650573701809,CSE 30,A01,083084,Eldon; John,0,78,40,40
1650573707835,CSE 100,A01,083659,Cao; Yingjun,0,66,50,50
1650573713857,CSE 134B,A01,083661,Powell; Thomas Allan,0,35,65,65
1650573719900,CSE 140,A01,083663,Staff,0,7,75,75
1650573725933,CSE 140L,A01,083088,Eldon; John,0,13,75,75
1650573731956,CSE 175,A01,083665,Kumar; Rakesh,7,0,25,18
1650573737982,CSE 190,A00,092507,Dubnov; Shlomo,10,0,20,10
1650573744008,ECE 45,A01,083139,Staff,1,2,60,59
1650573750042,ECE 65,A50,083695,Staff,1,6,30,29
1650573756069,ECE 109,A01,091882,Touri; Behrouz,33,0,70,37
1650573762094,ECE 180,A00,083140,Abi Samra; Nicholas Camill,21,0,30,9
1650573762094,ECE 180,B00,083141,Abi Samra; Nicholas Camill,0,0,30,30
1650573768122,MATH 10A,A01,083735,Patchell; Gregory David,5,0,30,25
1650573768122,MATH 10A,A02,083736,Patchell; Gregory David,27,0,30,3
1650573768122,MATH 10A,A03,083737,Patchell; Gregory David,24,0,30,6
1650573774149,MATH 10B,A01,083207,Staff,0,9,30,30
1650573774149,MATH 10B,A02,083208,Staff,0,8,30,30
1650573774149,MATH 10B,B01,083739,Staff,11,0,30,19
1650573774149,MATH 10B,B02,083740,Staff,28,0,30,2
1650573780179,MATH 18,A01,083743,Staff,1,0,30,29
1650573780179,MATH 18,A02,083744,Staff,26,0,30,4
1650573780179,MATH 18,A03,083745,Staff,22,0,30,8
1650573780179,MATH 18,A04,083746,Staff,26,0,30,4
1650573780179,MATH 18,B01,083748,Staff,0,14,30,30
1650573780179,MATH 18,B02,083749,Staff,0,12,30,30
1650573780179,MATH 18,B03,083750,Staff,0,12,30,30
1650573780179,MATH 18,B04,083751,Staff,0,12,30,30
1650573786203,MATH 20A,A01,083754,Staff,21,0,40,19
1650573792240,MATH 20B,A01,083756,Staff,0,11,30,30
1650573792240,MATH 20B,A02,083757,Staff,0,12,30,30
1650573798274,MATH 20C,A01,083760,Staff,0,16,30,30
1650573798274,MATH 20C,A02,083761,Staff,2,14,30,28
1650573798274,MATH 20C,B01,083762,Staff,12,0,30,18
1650573798274,MATH 20C,B02,083763,Staff,28,0,30,2
1650573804303,MATH 20D,A01,083765,Staff,0,1,30,30
1650573804303,MATH 20D,A02,083766,Staff,7,0,30,23
1650573804303,MATH 20D,A03,083767,Staff,25,0,30,5
1650573810327,MATH 20E,A01,083771,Staff,7,0,30,23
1650573810327,MATH 20E,A02,083772,Staff,18,0,30,12
1650573810327,MATH 20E,B01,083773,Staff,0,0,30,30
1650573810327,MATH 20E,B02,083774,Staff,9,0,30,21
1650573816351,MATH 103A,A01,083777,Staff,0,15,30,30
1650573816351,MATH 103A,A02,083778,Staff,0,14,30,30
1650573816351,MATH 103A,B01,083779,Staff,0,13,30,30
1650573816351,MATH 103A,B02,083780,Staff,0,13,30,30
1650573822377,MATH 105,A01,085443,Staff,0,21,30,30
1650573828413,MATH 109,A01,083213,Anzaldo; Leesa B,0,7,30,30
1650573828413,MATH 109,A02,083214,Anzaldo; Leesa B,0,7,30,30
1650573828413,MATH 109,B01,083215,Anzaldo; Leesa B,0,5,30,30
1650573828413,MATH 109,B02,083216,Anzaldo; Leesa B,0,6,30,30
1650573834436,MATH 142A,A01,083219,Chow; Bennett,0,16,30,30
1650573834436,MATH 142A,A02,083220,Chow; Bennett,0,14,30,30
1650573834436,MATH 142A,B01,083221,Chow; Bennett,0,14,30,30
1650573834436,MATH 142A,B02,083222,Chow; Bennett,0,13,30,30
1650573840466,MATH 193A,A01,083224,Staff,1,6,30,29
1650573840466,MATH 193A,A02,083225,Staff,0,6,30,30
1650573840466,MATH 193A,A03,083781,Staff,0,6,30,30
1650573840466,MATH 193A,A04,083782,Staff,0,7,30,30
1650573846504,MATH 197,001,091859,McAuley; Julian John,9998,0,9999,1
1650573852571,COGS 9,A01,083615,Staff,1,16,60,59
1650573858596,COGS 11,A01,083617,Boyle; Mary E. T.,18,0,40,22
1650573864617,COGS 13,A01,083071,Staff,0,37,40,40
1650573870640,COGS 14A,A01,092681,Staff,0,28,100,100
1650573876666,COGS 14B,A01,083073,Cheng; Tzu-Han,0,12,50,50
1650573882693,COGS 17,A01,092677,Staff,18,0,75,57
1650573888725,COGS 100,A01,083619,Staff,1,26,60,59
1650573894749,COGS 101A,A01,083621,Davis; Joshua Daniel,0,26,60,60
1650573900770,COGS 101B,A01,091572,Staff,1,5,60,59
1650573906798,COGS 101C,A01,083625,Delgado; Tania,15,0,30,15
1650573912821,COGS 107A,A01,083627,Boyle; Mary E. T.,0,12,60,60
1650573918843,COGS 118A,A01,083075,Staff,0,4,60,60
1650573924868,CSE 3,A50,083646,Miranda; Gregory Joseph,19,0,38,19
1650573924868,CSE 3,A51,083647,Miranda; Gregory Joseph,36,0,37,1
1650573930895,CSE 8A,A50,083650,Miranda; Gregory Joseph,0,29,40,40
1650573936926,CSE 11,A01,083080,Cao; Yingjun,0,93,40,40
1650573942952,CSE 12,A01,083652,Staff,0,19,100,100
1650573948980,CSE 15L,A01,083654,Staff,0,1,50,50
1650573948980,CSE 15L,A02,083655,Staff,0,1,50,50
1650573955020,CSE 20,A01,083657,Staff,51,0,80,29
1650573961043,CSE 30,A01,083084,Eldon; John,0,78,40,40
1650573967067,CSE 100,A01,083659,Cao; Yingjun,0,66,50,50
1650573973099,CSE 134B,A01,083661,Powell; Thomas Allan,0,35,65,65
1650573979124,CSE 140,A01,083663,Staff,0,7,75,75
1650573985154,CSE 140L,A01,083088,Eldon; John,0,13,75,75
1650573991178,CSE 175,A01,083665,Kumar; Rakesh,7,0,25,18
1650573997213,CSE 190,A00,092507,Dubnov; Shlomo,10,0,20,10
1650574003241,ECE 45,A01,083139,Staff,1,2,60,59
1650574009269,ECE 65,A50,083695,Staff,1,6,30,29
1650574015291,ECE 109,A01,091882,Touri; Behrouz,33,0,70,37
1650574021314,ECE 180,A00,083140,Abi Samra; Nicholas Camill,21,0,30,9
1650574021314,ECE 180,B00,083141,Abi Samra; Nicholas Camill,0,0,30,30
1650574027338,MATH 10A,A01,083735,Patchell; Gregory David,5,0,30,25
1650574027338,MATH 10A,A02,083736,Patchell; Gregory David,27,0,30,3
1650574027338,MATH 10A,A03,083737,Patchell; Gregory David,24,0,30,6
1650574033372,MATH 10B,A01,083207,Staff,0,9,30,30
1650574033372,MATH 10B,A02,083208,Staff,0,8,30,30
1650574033372,MATH 10B,B01,083739,Staff,11,0,30,19
1650574033372,MATH 10B,B02,083740,Staff,28,0,30,2
1650574039402,MATH 18,A01,083743,Staff,1,0,30,29
1650574039402,MATH 18,A02,083744,Staff,26,0,30,4
1650574039402,MATH 18,A03,083745,Staff,22,0,30,8
1650574039402,MATH 18,A04,083746,Staff,26,0,30,4
1650574039402,MATH 18,B01,083748,Staff,0,14,30,30
1650574039402,MATH 18,B02,083749,Staff,0,12,30,30
1650574039402,MATH 18,B03,083750,Staff,0,12,30,30
1650574039402,MATH 18,B04,083751,Staff,0,12,30,30
1650574045436,MATH 20A,A01,083754,Staff,21,0,40,19
1650574051548,MATH 20B,A01,083756,Staff,0,11,30,30
1650574051548,MATH 20B,A02,083757,Staff,0,12,30,30
1650574057572,MATH 20C,A01,083760,Staff,0,16,30,30
1650574057572,MATH 20C,A02,083761,Staff,2,14,30,28
1650574057572,MATH 20C,B01,083762,Staff,12,0,30,18
1650574057572,MATH 20C,B02,083763,Staff,28,0,30,2
1650574063607,MATH 20D,A01,083765,Staff,0,1,30,30
1650574063607,MATH 20D,A02,083766,Staff,7,0,30,23
1650574063607,MATH 20D,A03,083767,Staff,25,0,30,5
1650574069631,MATH 20E,A01,083771,Staff,7,0,30,23
1650574069631,MATH 20E,A02,083772,Staff,18,0,30,12
1650574069631,MATH 20E,B01,083773,Staff,0,0,30,30
1650574069631,MATH 20E,B02,083774,Staff,9,0,30,21
1650574075662,MATH 103A,A01,083777,Staff,0,15,30,30
1650574075662,MATH 103A,A02,083778,Staff,0,14,30,30
1650574075662,MATH 103A,B01,083779,Staff,0,13,30,30
1650574075662,MATH 103A,B02,083780,Staff,0,13,30,30
1650574081696,MATH 105,A01,085443,Staff,0,21,30,30
1650574087728,MATH 109,A01,083213,Anzaldo; Leesa B,0,7,30,30
1650574087728,MATH 109,A02,083214,Anzaldo; Leesa B,0,7,30,30
1650574087728,MATH 109,B01,083215,Anzaldo; Leesa B,0,5,30,30
1650574087728,MATH 109,B02,083216,Anzaldo; Leesa B,0,6,30,30
1650574093752,MATH 142A,A01,083219,Chow; Bennett,0,16,30,30
1650574093752,MATH 142A,A02,083220,Chow; Bennett,0,15,30,30
1650574093752,MATH 142A,B01,083221,Chow; Bennett,0,14,30,30
1650574093752,MATH 142A,B02,083222,Chow; Bennett,0,13,30,30
1650574099775,MATH 193A,A01,083224,Staff,1,6,30,29
1650574099775,MATH 193A,A02,083225,Staff,0,6,30,30
1650574099775,MATH 193A,A03,083781,Staff,0,6,30,30
1650574099775,MATH 193A,A04,083782,Staff,0,7,30,30
1650574105806,MATH 197,001,091859,McAuley; Julian John,9998,0,9999,1
1650574111860,COGS 9,A01,083615,Staff,1,16,60,59
1650574117886,COGS 11,A01,083617,Boyle; Mary E. T.,18,0,40,22
1650574123907,COGS 13,A01,083071,Staff,0,37,40,40
1650574129932,COGS 14A,A01,092681,Staff,0,28,100,100
1650574135958,COGS 14B,A01,083073,Cheng; Tzu-Han,0,12,50,50
1650574141983,COGS 17,A01,092677,Staff,18,0,75,57
1650574148008,COGS 100,A01,083619,Staff,1,26,60,59
1650574154048,COGS 101A,A01,083621,Davis; Joshua Daniel,0,26,60,60
1650574160077,COGS 101B,A01,091572,Staff,1,5,60,59
1650574166101,COGS 101C,A01,083625,Delgado; Tania,15,0,30,15
1650574172127,COGS 107A,A01,083627,Boyle; Mary E. T.,0,12,60,60
1650574178182,COGS 118A,A01,083075,Staff,0,4,60,60
1650574184207,CSE 3,A50,083646,Miranda; Gregory Joseph,19,0,38,19
1650574184207,CSE 3,A51,083647,Miranda; Gregory Joseph,36,0,37,1
1650574190238,CSE 8A,A50,083650,Miranda; Gregory Joseph,0,29,40,40
1650574196267,CSE 11,A01,083080,Cao; Yingjun,0,93,40,40
1650574202290,CSE 12,A01,083652,Staff,0,19,100,100
1650574208321,CSE 15L,A01,083654,Staff,0,1,50,50
1650574208321,CSE 15L,A02,083655,Staff,0,1,50,50
1650574214346,CSE 20,A01,083657,Staff,51,0,80,29
1650574220383,CSE 30,A01,083084,Eldon; John,0,78,40,40
1650574226408,CSE 100,A01,083659,Cao; Yingjun,0,66,50,50
1650574232434,CSE 134B,A01,083661,Powell; Thomas Allan,0,35,65,65
1650574238459,CSE 140,A01,083663,Staff,0,7,75,75
1650574244485,CSE 140L,A01,083088,Eldon; John,0,13,75,75
1650574250511,CSE 175,A01,083665,Kumar; Rakesh,7,0,25,18
1650574256540,CSE 190,A00,092507,Dubnov; Shlomo,10,0,20,10
1650574262571,ECE 45,A01,083139,Staff,1,2,60,59
1650574268601,ECE 65,A50,083695,Staff,1,6,30,29
1650574274623,ECE 109,A01,091882,Touri; Behrouz,33,0,70,37
1650574280650,ECE 180,A00,083140,Abi Samra; Nicholas Camill,21,0,30,9
1650574280650,ECE 180,B00,083141,Abi Samra; Nicholas Camill,0,0,30,30
1650574286684,MATH 10A,A01,083735,Patchell; Gregory David,5,0,30,25
1650574286684,MATH 10A,A02,083736,Patchell; Gregory David,27,0,30,3
1650574286684,MATH 10A,A03,083737,Patchell; Gregory David,24,0,30,6
1650574292715,MATH 10B,A01,083207,Staff,0,9,30,30
1650574292715,MATH 10B,A02,083208,Staff,0,8,30,30
1650574292715,MATH 10B,B01,083739,Staff,11,0,30,19
1650574292715,MATH 10B,B02,083740,Staff,28,0,30,2
1650574298745,MATH 18,A01,083743,Staff,1,0,30,29
1650574298745,MATH 18,A02,083744,Staff,26,0,30,4
1650574298745,MATH 18,A03,083745,Staff,22,0,30,8
1650574298745,MATH 18,A04,083746,Staff,26,0,30,4
1650574298745,MATH 18,B01,083748,Staff,0,14,30,30
1650574298745,MATH 18,B02,083749,Staff,0,12,30,30
1650574298745,MATH 18,B03,083750,Staff,0,12,30,30
1650574298745,MATH 18,B04,083751,Staff,0,12,30,30
1650574304770,MATH 20A,A01,083754,Staff,21,0,40,19
1650574310799,MATH 20B,A01,083756,Staff,0,11,30,30
1650574310799,MATH 20B,A02,083757,Staff,0,12,30,30
1650574316822,MATH 20C,A01,083760,Staff,0,16,30,30
1650574316822,MATH 20C,A02,083761,Staff,2,14,30,28
1650574316822,MATH 20C,B01,083762,Staff,12,0,30,18
1650574316822,MATH 20C,B02,083763,Staff,28,0,30,2
1650574322849,MATH 20D,A01,083765,Staff,0,1,30,30
1650574322849,MATH 20D,A02,083766,Staff,7,0,30,23
1650574322849,MATH 20D,A03,083767,Staff,25,0,30,5
1650574328876,MATH 20E,A01,083771,Staff,7,0,30,23
1650574328876,MATH 20E,A02,083772,Staff,18,0,30,12
1650574328876,MATH 20E,B01,083773,Staff,0,0,30,30
1650574328876,MATH 20E,B02,083774,Staff,9,0,30,21
1650574334899,MATH 103A,A01,083777,Staff,0,15,30,30
1650574334899,MATH 103A,A02,083778,Staff,0,14,30,30
1650574334899,MATH 103A,B01,083779,Staff,0,13,30,30
1650574334899,MATH 103A,B02,083780,Staff,0,13,30,30
1650574340925,MATH 105,A01,085443,Staff,0,21,30,30
1650574346955,MATH 109,A01,083213,Anzaldo; Leesa B,0,7,30,30
1650574346955,MATH 109,A02,083214,Anzaldo; Leesa B,0,7,30,30
1650574346955,MATH 109,B01,083215,Anzaldo; Leesa B,0,5,30,30
1650574346955,MATH 109,B02,083216,Anzaldo; Leesa B,0,6,30,30
1650574352987,MATH 142A,A01,083219,Chow; Bennett,0,16,30,30
1650574352987,MATH 142A,A02,083220,Chow; Bennett,0,15,30,30
1650574352987,MATH 142A,B01,083221,Chow; Bennett,0,14,30,30
1650574352987,MATH 142A,B02,083222,Chow; Bennett,0,13,30,30
1650574359011,MATH 193A,A01,083224,Staff,1,6,30,29
1650574359011,MATH 193A,A02,083225,Staff,0,6,30,30
1650574359011,MATH 193A,A03,083781,Staff,0,6,30,30
1650574359011,MATH 193A,A04,083782,Staff,0,7,30,30
1650574365043,MATH 197,001,091859,McAuley; Julian John,9998,0,9999,1
1650574371092,COGS 9,A01,083615,Staff,1,16,60,59
1650574377124,COGS 11,A01,083617,Boyle; Mary E. T.,18,0,40,22
1650574383146,COGS 13,A01,083071,Staff,0,37,40,40
1650574389179,COGS 14A,A01,092681,Staff,0,28,100,100
1650574395209,COGS 14B,A01,083073,Cheng; Tzu-Han,0,12,50,50
1650574401235,COGS 17,A01,092677,Staff,18,0,75,57
1650574407262,COGS 100,A01,083619,Staff,1,26,60,59
1650574413288,COGS 101A,A01,083621,Davis; Joshua Daniel,0,26,60,60
1650574419315,COGS 101B,A01,091572,Staff,1,5,60,59
1650574425340,COGS 101C,A01,083625,Delgado; Tania,15,0,30,15
1650574431365,COGS 107A,A01,083627,Boyle; Mary E. T.,0,12,60,60
1650574437388,COGS 118A,A01,083075,Staff,0,4,60,60
1650574443411,CSE 3,A50,083646,Miranda; Gregory Joseph,19,0,38,19
1650574443411,CSE 3,A51,083647,Miranda; Gregory Joseph,36,0,37,1
1650574449438,CSE 8A,A50,083650,Miranda; Gregory Joseph,0,29,40,40
1650574455461,CSE 11,A01,083080,Cao; Yingjun,0,93,40,40
1650574461486,CSE 12,A01,083652,Staff,0,19,100,100
1650574467508,CSE 15L,A01,083654,Staff,0,1,50,50
1650574467508,CSE 15L,A02,083655,Staff,0,1,50,50
1650574473531,CSE 20,A01,083657,Staff,51,0,80,29
1650574479553,CSE 30,A01,083084,Eldon; John,0,78,40,40
1650574485576,CSE 100,A01,083659,Cao; Yingjun,0,66,50,50
1650574491611,CSE 134B,A01,083661,Powell; Thomas Allan,0,35,65,65
1650574497633,CSE 140,A01,083663,Staff,0,7,75,75
1650574503662,CSE 140L,A01,083088,Eldon; John,0,13,75,75
1650574509704,CSE 175,A01,083665,Kumar; Rakesh,7,0,25,18
1650574515738,CSE 190,A00,092507,Dubnov; Shlomo,10,0,20,10
1650574521772,ECE 45,A01,083139,Staff,1,2,60,59
1650574527799,ECE 65,A50,083695,Staff,1,6,30,29
1650574533821,ECE 109,A01,091882,Touri; Behrouz,33,0,70,37
1650574539845,ECE 180,A00,083140,Abi Samra; Nicholas Camill,21,0,30,9
1650574539845,ECE 180,B00,083141,Abi Samra; Nicholas Camill,0,0,30,30
1650574545871,MATH 10A,A01,083735,Patchell; Gregory David,5,0,30,25
1650574545871,MATH 10A,A02,083736,Patchell; Gregory David,27,0,30,3
1650574545871,MATH 10A,A03,083737,Patchell; Gregory David,24,0,30,6
1650574551917,MATH 10B,A01,083207,Staff,0,9,30,30
1650574551917,MATH 10B,A02,083208,Staff,0,8,30,30
1650574551917,MATH 10B,B01,083739,Staff,11,0,30,19
1650574551917,MATH 10B,B02,083740,Staff,28,0,30,2
1650574557942,MATH 18,A01,083743,Staff,1,0,30,29
1650574557942,MATH 18,A02,083744,Staff,26,0,30,4
1650574557942,MATH 18,A03,083745,Staff,22,0,30,8
1650574557942,MATH 18,A04,083746,Staff,26,0,30,4
1650574557942,MATH 18,B01,083748,Staff,0,14,30,30
1650574557942,MATH 18,B02,083749,Staff,0,12,30,30
1650574557942,MATH 18,B03,083750,Staff,0,12,30,30
1650574557942,MATH 18,B04,083751,Staff,0,12,30,30
1650574563968,MATH 20A,A01,083754,Staff,21,0,40,19
1650574569991,MATH 20B,A01,083756,Staff,0,11,30,30
1650574569991,MATH 20B,A02,083757,Staff,0,12,30,30
1650574576019,MATH 20C,A01,083760,Staff,0,16,30,30
1650574576019,MATH 20C,A02,083761,Staff,2,14,30,28
1650574576019,MATH 20C,B01,083762,Staff,12,0,30,18
1650574576019,MATH 20C,B02,083763,Staff,28,0,30,2
1650574582049,MATH 20D,A01,083765,Staff,0,1,30,30
1650574582049,MATH 20D,A02,083766,Staff,7,0,30,23
1650574582049,MATH 20D,A03,083767,Staff,25,0,30,5
1650574588075,MATH 20E,A01,083771,Staff,7,0,30,23
1650574588075,MATH 20E,A02,083772,Staff,18,0,30,12
1650574588075,MATH 20E,B01,083773,Staff,0,0,30,30
1650574588075,MATH 20E,B02,083774,Staff,9,0,30,21
1650574594102,MATH 103A,A01,083777,Staff,0,15,30,30
1650574594102,MATH 103A,A02,083778,Staff,0,14,30,30
1650574594102,MATH 103A,B01,083779,Staff,0,13,30,30
1650574594102,MATH 103A,B02,083780,Staff,0,13,30,30
1650574600136,MATH 105,A01,085443,Staff,0,21,30,30
1650574606162,MATH 109,A01,083213,Anzaldo; Leesa B,0,7,30,30
1650574606162,MATH 109,A02,083214,Anzaldo; Leesa B,0,7,30,30
1650574606162,MATH 109,B01,083215,Anzaldo; Leesa B,0,5,30,30
1650574606162,MATH 109,B02,083216,Anzaldo; Leesa B,0,6,30,30
1650574612187,MATH 142A,A01,083219,Chow; Bennett,0,16,30,30
1650574612187,MATH 142A,A02,083220,Chow; Bennett,0,15,30,30
1650574612187,MATH 142A,B01,083221,Chow; Bennett,0,14,30,30
1650574612187,MATH 142A,B02,083222,Chow; Bennett,0,13,30,30
1650574618211,MATH 193A,A01,083224,Staff,1,6,30,29
1650574618211,MATH 193A,A02,083225,Staff,0,6,30,30
1650574618211,MATH 193A,A03,083781,Staff,0,6,30,30
1650574618211,MATH 193A,A04,083782,Staff,0,7,30,30
1650574624248,MATH 197,001,091859,McAuley; Julian John,9998,0,9999,1
1650574630307,COGS 9,A01,083615,Staff,1,16,60,59
1650574636339,COGS 11,A01,083617,Boyle; Mary E. T.,18,0,40,22
1650574642474,COGS 13,A01,083071,Staff,0,37,40,40
1650574648502,COGS 14A,A01,092681,Staff,0,28,100,100
1650574654524,COGS 14B,A01,083073,Cheng; Tzu-Han,0,12,50,50
1650574660548,COGS 17,A01,092677,Staff,18,0,75,57
1650574666574,COGS 100,A01,083619,Staff,1,26,60,59
1650574672598,COGS 101A,A01,083621,Davis; Joshua Daniel,0,26,60,60
1650574678622,COGS 101B,A01,091572,Staff,1,5,60,59
1650574684646,COGS 101C,A01,083625,Delgado; Tania,15,0,30,15
1650574690676,COGS 107A,A01,083627,Boyle; Mary E. T.,0,12,60,60
1650574696702,COGS 118A,A01,083075,Staff,0,4,60,60
1650574702738,CSE 3,A50,083646,Miranda; Gregory Joseph,19,0,38,19
1650574702738,CSE 3,A51,083647,Miranda; Gregory Joseph,36,0,37,1
1650574708762,CSE 8A,A50,083650,Miranda; Gregory Joseph,0,29,40,40
1650574714788,CSE 11,A01,083080,Cao; Yingjun,0,93,40,40
1650574720817,CSE 12,A01,083652,Staff,0,19,100,100
1650574726842,CSE 15L,A01,083654,Staff,0,1,50,50
1650574726842,CSE 15L,A02,083655,Staff,0,1,50,50
1650574732866,CSE 20,A01,083657,Staff,51,0,80,29
1650574738894,CSE 30,A01,083084,Eldon; John,0,78,40,40
1650574744929,CSE 100,A01,083659,Cao; Yingjun,0,66,50,50
1650574750968,CSE 134B,A01,083661,Powell; Thomas Allan,0,35,65,65
1650574756999,CSE 140,A01,083663,Staff,0,7,75,75
1650574763029,CSE 140L,A01,083088,Eldon; John,0,13,75,75
1650574769061,CSE 175,A01,083665,Kumar; Rakesh,7,0,25,18
1650574775084,CSE 190,A00,092507,Dubnov; Shlomo,10,0,20,10
1650574781108,ECE 45,A01,083139,Staff,1,2,60,59
1650574787136,ECE 65,A50,083695,Staff,1,6,30,29
1650574793164,ECE 109,A01,091882,Touri; Behrouz,33,0,70,37
1650574799189,ECE 180,A00,083140,Abi Samra; Nicholas Camill,21,0,30,9
1650574799189,ECE 180,B00,083141,Abi Samra; Nicholas Camill,0,0,30,30
1650574805219,MATH 10A,A01,083735,Patchell; Gregory David,5,0,30,25
1650574805219,MATH 10A,A02,083736,Patchell; Gregory David,27,0,30,3
1650574805219,MATH 10A,A03,083737,Patchell; Gregory David,24,0,30,6
1650574811248,MATH 10B,A01,083207,Staff,0,9,30,30
1650574811248,MATH 10B,A02,083208,Staff,0,8,30,30
1650574811248,MATH 10B,B01,083739,Staff,11,0,30,19
1650574811248,MATH 10B,B02,083740,Staff,28,0,30,2
1650574817278,MATH 18,A01,083743,Staff,1,0,30,29
1650574817278,MATH 18,A02,083744,Staff,26,0,30,4
1650574817278,MATH 18,A03,083745,Staff,22,0,30,8
1650574817278,MATH 18,A04,083746,Staff,26,0,30,4
1650574817278,MATH 18,B01,083748,Staff,0,14,30,30
1650574817278,MATH 18,B02,083749,Staff,0,12,30,30
1650574817278,MATH 18,B03,083750,Staff,0,12,30,30
1650574817278,MATH 18,B04,083751,Staff,0,12,30,30
1650574823325,MATH 20A,A01,083754,Staff,21,0,40,19
1650574829356,MATH 20B,A01,083756,Staff,0,11,30,30
1650574829356,MATH 20B,A02,083757,Staff,0,12,30,30
1650574835399,MATH 20C,A01,083760,Staff,0,16,30,30
1650574835399,MATH 20C,A02,083761,Staff,2,14,30,28
1650574835399,MATH 20C,B01,083762,Staff,12,0,30,18
1650574835399,MATH 20C,B02,083763,Staff,28,0,30,2
1650574841429,MATH 20D,A01,083765,Staff,0,1,30,30
1650574841429,MATH 20D,A02,083766,Staff,7,0,30,23
1650574841429,MATH 20D,A03,083767,Staff,25,0,30,5
1650574847457,MATH 20E,A01,083771,Staff,7,0,30,23
1650574847457,MATH 20E,A02,083772,Staff,18,0,30,12
1650574847457,MATH 20E,B01,083773,Staff,0,0,30,30
1650574847457,MATH 20E,B02,083774,Staff,9,0,30,21
1650574853492,MATH 103A,A01,083777,Staff,0,15,30,30
1650574853492,MATH 103A,A02,083778,Staff,0,14,30,30
1650574853492,MATH 103A,B01,083779,Staff,0,13,30,30
1650574853492,MATH 103A,B02,083780,Staff,0,13,30,30
1650574859520,MATH 105,A01,085443,Staff,0,21,30,30
1650574865549,MATH 109,A01,083213,Anzaldo; Leesa B,0,7,30,30
1650574865549,MATH 109,A02,083214,Anzaldo; Leesa B,0,7,30,30
1650574865549,MATH 109,B01,083215,Anzaldo; Leesa B,0,5,30,30
1650574865549,MATH 109,B02,083216,Anzaldo; Leesa B,0,6,30,30
1650574871581,MATH 142A,A01,083219,Chow; Bennett,0,16,30,30
1650574871581,MATH 142A,A02,083220,Chow; Bennett,0,15,30,30
1650574871581,MATH 142A,B01,083221,Chow; Bennett,0,14,30,30
1650574871581,MATH 142A,B02,083222,Chow; Bennett,0,13,30,30
1650574877610,MATH 193A,A01,083224,Staff,1,6,30,29
1650574877610,MATH 193A,A02,083225,Staff,0,6,30,30
1650574877610,MATH 193A,A03,083781,Staff,0,6,30,30
1650574877610,MATH 193A,A04,083782,Staff,0,7,30,30
1650574883632,MATH 197,001,091859,McAuley; Julian John,9998,0,9999,1
1650574889702,COGS 9,A01,083615,Staff,1,16,60,59
1650574895730,COGS 11,A01,083617,Boyle; Mary E. T.,18,0,40,22
1650574901753,COGS 13,A01,083071,Staff,0,37,40,40
1650574907778,COGS 14A,A01,092681,Staff,0,28,100,100
1650574913801,COGS 14B,A01,083073,Cheng; Tzu-Han,0,12,50,50
1650574919827,COGS 17,A01,092677,Staff,18,0,75,57
1650574925876,COGS 100,A01,083619,Staff,1,26,60,59
1650574931907,COGS 101A,A01,083621,Davis; Joshua Daniel,0,26,60,60
1650574937940,COGS 101B,A01,091572,Staff,1,5,60,59
1650574943967,COGS 101C,A01,083625,Delgado; Tania,15,0,30,15
1650574949996,COGS 107A,A01,083627,Boyle; Mary E. T.,0,12,60,60
1650574956020,COGS 118A,A01,083075,Staff,0,4,60,60
1650574962054,CSE 3,A50,083646,Miranda; Gregory Joseph,19,0,38,19
1650574962054,CSE 3,A51,083647,Miranda; Gregory Joseph,36,0,37,1
1650574968078,CSE 8A,A50,083650,Miranda; Gregory Joseph,0,29,40,40
1650574974106,CSE 11,A01,083080,Cao; Yingjun,0,93,40,40
1650574980148,CSE 12,A01,083652,Staff,0,19,100,100
1650574986191,CSE 15L,A01,083654,Staff,0,1,50,50
1650574986191,CSE 15L,A02,083655,Staff,0,1,50,50
1650574992215,CSE 20,A01,083657,Staff,51,0,80,29
1650574998248,CSE 30,A01,083084,Eldon; John,0,78,40,40
1650575004275,CSE 100,A01,083659,Cao; Yingjun,0,66,50,50
1650575010307,CSE 134B,A01,083661,Powell; Thomas Allan,0,35,65,65
1650575016331,CSE 140,A01,083663,Staff,0,7,75,75
1650575022355,CSE 140L,A01,083088,Eldon; John,0,13,75,75
1650575028391,CSE 175,A01,083665,Kumar; Rakesh,7,0,25,18
1650575034415,CSE 190,A00,092507,Dubnov; Shlomo,10,0,20,10
1650575040437,ECE 45,A01,083139,Staff,1,2,60,59
1650575046465,ECE 65,A50,083695,Staff,1,6,30,29
1650575052491,ECE 109,A01,091882,Touri; Behrouz,33,0,70,37
1650575058514,ECE 180,A00,083140,Abi Samra; Nicholas Camill,21,0,30,9
1650575058514,ECE 180,B00,083141,Abi Samra; Nicholas Camill,0,0,30,30
1650575064545,MATH 10A,A01,083735,Patchell; Gregory David,5,0,30,25
1650575064545,MATH 10A,A02,083736,Patchell; Gregory David,27,0,30,3
1650575064545,MATH 10A,A03,083737,Patchell; Gregory David,24,0,30,6
1650575070570,MATH 10B,A01,083207,Staff,0,9,30,30
1650575070570,MATH 10B,A02,083208,Staff,0,8,30,30
1650575070570,MATH 10B,B01,083739,Staff,11,0,30,19
1650575070570,MATH 10B,B02,083740,Staff,28,0,30,2
1650575076594,MATH 18,A01,083743,Staff,1,0,30,29
1650575076594,MATH 18,A02,083744,Staff,26,0,30,4
1650575076594,MATH 18,A03,083745,Staff,22,0,30,8
1650575076594,MATH 18,A04,083746,Staff,26,0,30,4
1650575076594,MATH 18,B01,083748,Staff,0,14,30,30
1650575076594,MATH 18,B02,083749,Staff,0,12,30,30
1650575076594,MATH 18,B03,083750,Staff,0,12,30,30
1650575076594,MATH 18,B04,083751,Staff,0,12,30,30
1650575082631,MATH 20A,A01,083754,Staff,21,0,40,19
1650575088655,MATH 20B,A01,083756,Staff,0,11,30,30
1650575088655,MATH 20B,A02,083757,Staff,0,12,30,30
1650575094680,MATH 20C,A01,083760,Staff,0,16,30,30
1650575094680,MATH 20C,A02,083761,Staff,2,14,30,28
1650575094680,MATH 20C,B01,083762,Staff,11,0,30,19
1650575094680,MATH 20C,B02,083763,Staff,28,0,30,2
1650575100704,MATH 20D,A01,083765,Staff,0,1,30,30
1650575100704,MATH 20D,A02,083766,Staff,7,0,30,23
1650575100704,MATH 20D,A03,083767,Staff,25,0,30,5
1650575106729,MATH 20E,A01,083771,Staff,7,0,30,23
1650575106729,MATH 20E,A02,083772,Staff,18,0,30,12
1650575106729,MATH 20E,B01,083773,Staff,0,0,30,30
1650575106729,MATH 20E,B02,083774,Staff,9,0,30,21
1650575112779,MATH 103A,A01,083777,Staff,0,15,30,30
1650575112779,MATH 103A,A02,083778,Staff,0,14,30,30
1650575112779,MATH 103A,B01,083779,Staff,0,13,30,30
1650575112779,MATH 103A,B02,083780,Staff,0,13,30,30
1650575118805,MATH 105,A01,085443,Staff,0,21,30,30
1650575124830,MATH 109,A01,083213,Anzaldo; Leesa B,0,7,30,30
1650575124830,MATH 109,A02,083214,Anzaldo; Leesa B,0,7,30,30
1650575124830,MATH 109,B01,083215,Anzaldo; Leesa B,0,5,30,30
1650575124830,MATH 109,B02,083216,Anzaldo; Leesa B,0,6,30,30
1650575130860,MATH 142A,A01,083219,Chow; Bennett,0,16,30,30
1650575130860,MATH 142A,A02,083220,Chow; Bennett,0,15,30,30
1650575130860,MATH 142A,B01,083221,Chow; Bennett,0,14,30,30
1650575130860,MATH 142A,B02,083222,Chow; Bennett,0,13,30,30
1650575136884,MATH 193A,A01,083224,Staff,1,6,30,29
1650575136884,MATH 193A,A02,083225,Staff,0,6,30,30
1650575136884,MATH 193A,A03,083781,Staff,0,6,30,30
1650575136884,MATH 193A,A04,083782,Staff,0,7,30,30
1650575142908,MATH 197,001,091859,McAuley; Julian John,9998,0,9999,1
1650575148966,COGS 9,A01,083615,Staff,1,16,60,59
1650575154989,COGS 11,A01,083617,Boyle; Mary E. T.,18,0,40,22
1650575161014,COGS 13,A01,083071,Staff,0,37,40,40
1650575167038,COGS 14A,A01,092681,Staff,0,28,100,100
1650575173065,COGS 14B,A01,083073,Cheng; Tzu-Han,0,12,50,50
1650575179092,COGS 17,A01,092677,Staff,18,0,75,57
1650575185117,COGS 100,A01,083619,Staff,1,26,60,59
1650575191141,COGS 101A,A01,083621,Davis; Joshua Daniel,0,26,60,60
1650575197171,COGS 101B,A01,091572,Staff,1,5,60,59
1650575203196,COGS 101C,A01,083625,Delgado; Tania,15,0,30,15
1650575209226,COGS 107A,A01,083627,Boyle; Mary E. T.,0,12,60,60
1650575215249,COGS 118A,A01,083075,Staff,0,4,60,60
1650575221291,CSE 3,A50,083646,Miranda; Gregory Joseph,19,0,38,19
1650575221291,CSE 3,A51,083647,Miranda; Gregory Joseph,36,0,37,1
1650575227315,CSE 8A,A50,083650,Miranda; Gregory Joseph,0,29,40,40
1650575233337,CSE 11,A01,083080,Cao; Yingjun,0,93,40,40
1650575239437,CSE 12,A01,083652,Staff,0,19,100,100
1650575245466,CSE 15L,A01,083654,Staff,0,1,50,50
1650575245466,CSE 15L,A02,083655,Staff,0,1,50,50
1650575251493,CSE 20,A01,083657,Staff,51,0,80,29
1650575257515,CSE 30,A01,083084,Eldon; John,0,78,40,40
1650575263542,CSE 100,A01,083659,Cao; Yingjun,0,66,50,50
1650575269566,CSE 134B,A01,083661,Powell; Thomas Allan,0,35,65,65
1650575275597,CSE 140,A01,083663,Staff,0,7,75,75
1650575281631,CSE 140L,A01,083088,Eldon; John,0,13,75,75
1650575287654,CSE 175,A01,083665,Kumar; Rakesh,7,0,25,18
1650575293679,CSE 190,A00,092507,Dubnov; Shlomo,10,0,20,10
1650575299703,ECE 45,A01,083139,Staff,1,2,60,59
1650575305748,ECE 65,A50,083695,Staff,1,6,30,29
1650575311772,ECE 109,A01,091882,Touri; Behrouz,33,0,70,37
1650575317806,ECE 180,A00,083140,Abi Samra; Nicholas Camill,21,0,30,9
1650575317806,ECE 180,B00,083141,Abi Samra; Nicholas Camill,0,0,30,30
1650575323830,MATH 10A,A01,083735,Patchell; Gregory David,5,0,30,25
1650575323830,MATH 10A,A02,083736,Patchell; Gregory David,27,0,30,3
1650575323830,MATH 10A,A03,083737,Patchell; Gregory David,24,0,30,6
1650575329853,MATH 10B,A01,083207,Staff,0,9,30,30
1650575329853,MATH 10B,A02,083208,Staff,0,8,30,30
1650575329853,MATH 10B,B01,083739,Staff,11,0,30,19
1650575329853,MATH 10B,B02,083740,Staff,28,0,30,2
1650575335889,MATH 18,A01,083743,Staff,1,0,30,29
1650575335889,MATH 18,A02,083744,Staff,26,0,30,4
1650575335889,MATH 18,A03,083745,Staff,22,0,30,8
1650575335889,MATH 18,A04,083746,Staff,26,0,30,4
1650575335889,MATH 18,B01,083748,Staff,0,14,30,30
1650575335889,MATH 18,B02,083749,Staff,0,12,30,30
1650575335889,MATH 18,B03,083750,Staff,0,12,30,30
1650575335889,MATH 18,B04,083751,Staff,0,12,30,30
1650575341913,MATH 20A,A01,083754,Staff,21,0,40,19
1650575347939,MATH 20B,A01,083756,Staff,0,11,30,30
1650575347939,MATH 20B,A02,083757,Staff,0,12,30,30
1650575353972,MATH 20C,A01,083760,Staff,0,16,30,30
1650575353972,MATH 20C,A02,083761,Staff,2,14,30,28
1650575353972,MATH 20C,B01,083762,Staff,11,0,30,19
1650575353972,MATH 20C,B02,083763,Staff,28,0,30,2
1650575359996,MATH 20D,A01,083765,Staff,0,1,30,30
1650575359996,MATH 20D,A02,083766,Staff,7,0,30,23
1650575359996,MATH 20D,A03,083767,Staff,25,0,30,5
1650575366020,MATH 20E,A01,083771,Staff,7,0,30,23
1650575366020,MATH 20E,A02,083772,Staff,18,0,30,12
1650575366020,MATH 20E,B01,083773,Staff,0,0,30,30
1650575366020,MATH 20E,B02,083774,Staff,9,0,30,21
1650575372049,MATH 103A,A01,083777,Staff,0,15,30,30
1650575372049,MATH 103A,A02,083778,Staff,0,14,30,30
1650575372049,MATH 103A,B01,083779,Staff,0,13,30,30
1650575372049,MATH 103A,B02,083780,Staff,0,13,30,30
1650575378073,MATH 105,A01,085443,Staff,0,21,30,30
1650575384112,MATH 109,A01,083213,Anzaldo; Leesa B,0,7,30,30
1650575384112,MATH 109,A02,083214,Anzaldo; Leesa B,0,7,30,30
1650575384112,MATH 109,B01,083215,Anzaldo; Leesa B,0,5,30,30
1650575384112,MATH 109,B02,083216,Anzaldo; Leesa B,0,6,30,30
1650575390150,MATH 142A,A01,083219,Chow; Bennett,0,16,30,30
1650575390150,MATH 142A,A02,083220,Chow; Bennett,0,15,30,30
1650575390150,MATH 142A,B01,083221,Chow; Bennett,0,14,30,30
1650575390150,MATH 142A,B02,083222,Chow; Bennett,0,13,30,30
1650575396175,MATH 193A,A01,083224,Staff,1,6,30,29
1650575396175,MATH 193A,A02,083225,Staff,0,6,30,30
1650575396175,MATH 193A,A03,083781,Staff,0,6,30,30
1650575396175,MATH 193A,A04,083782,Staff,0,7,30,30
1650575402206,MATH 197,001,091859,McAuley; Julian John,9998,0,9999,1
1650575408266,COGS 9,A01,083615,Staff,1,16,60,59
1650575414289,COGS 11,A01,083617,Boyle; Mary E. T.,18,0,40,22
1650575420314,COGS 13,A01,083071,Staff,0,37,40,40
1650575426336,COGS 14A,A01,092681,Staff,0,28,100,100
1650575432362,COGS 14B,A01,083073,Cheng; Tzu-Han,0,12,50,50
1650575438390,COGS 17,A01,092677,Staff,18,0,75,57
1650575444424,COGS 100,A01,083619,Staff,1,26,60,59
1650575450450,COGS 101A,A01,083621,Davis; Joshua Daniel,0,26,60,60
1650575456476,COGS 101B,A01,091572,Staff,1,5,60,59
1650575462502,COGS 101C,A01,083625,Delgado; Tania,15,0,30,15
1650575468527,COGS 107A,A01,083627,Boyle; Mary E. T.,0,12,60,60
1650575474552,COGS 118A,A01,083075,Staff,0,4,60,60
1650575480577,CSE 3,A50,083646,Miranda; Gregory Joseph,19,0,38,19
1650575480577,CSE 3,A51,083647,Miranda; Gregory Joseph,36,0,37,1
1650575486609,CSE 8A,A50,083650,Miranda; Gregory Joseph,0,29,40,40
1650575492635,CSE 11,A01,083080,Cao; Yingjun,0,93,40,40
1650575498659,CSE 12,A01,083652,Staff,0,19,100,100
1650575504682,CSE 15L,A01,083654,Staff,0,1,50,50
1650575504682,CSE 15L,A02,083655,Staff,0,1,50,50
1650575510709,CSE 20,A01,083657,Staff,51,0,80,29
1650575516763,CSE 30,A01,083084,Eldon; John,0,78,40,40
1650575522804,CSE 100,A01,083659,Cao; Yingjun,0,66,50,50
1650575528839,CSE 134B,A01,083661,Powell; Thomas Allan,0,35,65,65
1650575534867,CSE 140,A01,083663,Staff,0,7,75,75
1650575540894,CSE 140L,A01,083088,Eldon; John,0,13,75,75
1650575546958,CSE 175,A01,083665,Kumar; Rakesh,7,0,25,18
1650575552981,CSE 190,A00,092507,Dubnov; Shlomo,10,0,20,10
1650575559005,ECE 45,A01,083139,Staff,1,2,60,59
1650575565115,ECE 65,A50,083695,Staff,1,6,30,29
1650575571139,ECE 109,A01,091882,Touri; Behrouz,33,0,70,37
1650575577164,ECE 180,A00,083140,Abi Samra; Nicholas Camill,21,0,30,9
1650575577164,ECE 180,B00,083141,Abi Samra; Nicholas Camill,0,0,30,30
1650575583188,MATH 10A,A01,083735,Patchell; Gregory David,5,0,30,25
1650575583188,MATH 10A,A02,083736,Patchell; Gregory David,27,0,30,3
1650575583188,MATH 10A,A03,083737,Patchell; Gregory David,24,0,30,6
1650575589212,MATH 10B,A01,083207,Staff,0,9,30,30
1650575589212,MATH 10B,A02,083208,Staff,0,8,30,30
1650575589212,MATH 10B,B01,083739,Staff,11,0,30,19
1650575589212,MATH 10B,B02,083740,Staff,28,0,30,2
1650575595238,MATH 18,A01,083743,Staff,1,0,30,29
1650575595238,MATH 18,A02,083744,Staff,26,0,30,4
1650575595238,MATH 18,A03,083745,Staff,22,0,30,8
1650575595238,MATH 18,A04,083746,Staff,26,0,30,4
1650575595238,MATH 18,B01,083748,Staff,0,14,30,30
1650575595238,MATH 18,B02,083749,Staff,0,12,30,30
1650575595238,MATH 18,B03,083750,Staff,0,12,30,30
1650575595238,MATH 18,B04,083751,Staff,0,12,30,30
1650575601265,MATH 20A,A01,083754,Staff,21,0,40,19
1650575607288,MATH 20B,A01,083756,Staff,1,11,30,29
1650575607288,MATH 20B,A02,083757,Staff,0,12,30,30
1650575613316,MATH 20C,A01,083760,Staff,0,16,30,30
1650575613316,MATH 20C,A02,083761,Staff,2,14,30,28
1650575613316,MATH 20C,B01,083762,Staff,11,0,30,19
1650575613316,MATH 20C,B02,083763,Staff,28,0,30,2
1650575619342,MATH 20D,A01,083765,Staff,0,1,30,30
1650575619342,MATH 20D,A02,083766,Staff,7,0,30,23
1650575619342,MATH 20D,A03,083767,Staff,25,0,30,5
1650575625368,MATH 20E,A01,083771,Staff,7,0,30,23
1650575625368,MATH 20E,A02,083772,Staff,18,0,30,12
1650575625368,MATH 20E,B01,083773,Staff,0,0,30,30
1650575625368,MATH 20E,B02,083774,Staff,9,0,30,21
1650575631392,MATH 103A,A01,083777,Staff,0,15,30,30
1650575631392,MATH 103A,A02,083778,Staff,0,14,30,30
1650575631392,MATH 103A,B01,083779,Staff,0,13,30,30
1650575631392,MATH 103A,B02,083780,Staff,0,13,30,30
1650575637423,MATH 105,A01,085443,Staff,0,21,30,30
1650575643447,MATH 109,A01,083213,Anzaldo; Leesa B,0,7,30,30
1650575643447,MATH 109,A02,083214,Anzaldo; Leesa B,0,7,30,30
1650575643447,MATH 109,B01,083215,Anzaldo; Leesa B,0,5,30,30
1650575643447,MATH 109,B02,083216,Anzaldo; Leesa B,0,6,30,30
1650575649484,MATH 142A,A01,083219,Chow; Bennett,0,16,30,30
1650575649484,MATH 142A,A02,083220,Chow; Bennett,0,15,30,30
1650575649484,MATH 142A,B01,083221,Chow; Bennett,0,14,30,30
1650575649484,MATH 142A,B02,083222,Chow; Bennett,0,13,30,30
1650575655506,MATH 193A,A01,083224,Staff,1,6,30,29
1650575655506,MATH 193A,A02,083225,Staff,0,6,30,30
1650575655506,MATH 193A,A03,083781,Staff,0,6,30,30
1650575655506,MATH 193A,A04,083782,Staff,0,7,30,30
1650575661530,MATH 197,001,091859,McAuley; Julian John,9998,0,9999,1
1650575667589,COGS 9,A01,083615,Staff,1,16,60,59
1650575673617,COGS 11,A01,083617,Boyle; Mary E. T.,18,0,40,22
1650575679649,COGS 13,A01,083071,Staff,0,37,40,40
1650575685671,COGS 14A,A01,092681,Staff,0,28,100,100
1650575691701,COGS 14B,A01,083073,Cheng; Tzu-Han,0,12,50,50
1650575697732,COGS 17,A01,092677,Staff,18,0,75,57
1650575703758,COGS 100,A01,083619,Staff,1,26,60,59
1650575709783,COGS 101A,A01,083621,Davis; Joshua Daniel,0,26,60,60
1650575715813,COGS 101B,A01,091572,Staff,1,5,60,59
1650575721839,COGS 101C,A01,083625,Delgado; Tania,15,0,30,15
1650575727862,COGS 107A,A01,083627,Boyle; Mary E. T.,0,12,60,60
1650575733887,COGS 118A,A01,083075,Staff,0,4,60,60
1650575739913,CSE 3,A50,083646,Miranda; Gregory Joseph,19,0,38,19
1650575739913,CSE 3,A51,083647,Miranda; Gregory Joseph,36,0,37,1
1650575745950,CSE 8A,A50,083650,Miranda; Gregory Joseph,0,29,40,40
1650575751977,CSE 11,A01,083080,Cao; Yingjun,0,93,40,40
1650575758001,CSE 12,A01,083652,Staff,0,19,100,100
1650575764036,CSE 15L,A01,083654,Staff,0,1,50,50
1650575764036,CSE 15L,A02,083655,Staff,0,1,50,50
1650575770063,CSE 20,A01,083657,Staff,51,0,80,29
1650575776087,CSE 30,A01,083084,Eldon; John,0,78,40,40
1650575782111,CSE 100,A01,083659,Cao; Yingjun,0,66,50,50
1650575788138,CSE 134B,A01,083661,Powell; Thomas Allan,0,35,65,65
1650575794163,CSE 140,A01,083663,Staff,0,7,75,75
1650575800186,CSE 140L,A01,083088,Eldon; John,0,13,75,75
1650575806209,CSE 175,A01,083665,Kumar; Rakesh,7,0,25,18
1650575812233,CSE 190,A00,092507,Dubnov; Shlomo,10,0,20,10
1650575818256,ECE 45,A01,083139,Staff,1,2,60,59
1650575824283,ECE 65,A50,083695,Staff,1,6,30,29
1650575830310,ECE 109,A01,091882,Touri; Behrouz,33,0,70,37
1650575836423,ECE 180,A00,083140,Abi Samra; Nicholas Camill,21,0,30,9
1650575836423,ECE 180,B00,083141,Abi Samra; Nicholas Camill,0,0,30,30
1650575842446,MATH 10A,A01,083735,Patchell; Gregory David,5,0,30,25
1650575842446,MATH 10A,A02,083736,Patchell; Gregory David,27,0,30,3
1650575842446,MATH 10A,A03,083737,Patchell; Gregory David,24,0,30,6
1650575848478,MATH 10B,A01,083207,Staff,0,9,30,30
1650575848478,MATH 10B,A02,083208,Staff,0,8,30,30
1650575848478,MATH 10B,B01,083739,Staff,11,0,30,19
1650575848478,MATH 10B,B02,083740,Staff,28,0,30,2
1650575854522,MATH 18,A01,083743,Staff,1,0,30,29
1650575854522,MATH 18,A02,083744,Staff,26,0,30,4
1650575854522,MATH 18,A03,083745,Staff,22,0,30,8
1650575854522,MATH 18,A04,083746,Staff,26,0,30,4
1650575854522,MATH 18,B01,083748,Staff,0,14,30,30
1650575854522,MATH 18,B02,083749,Staff,0,12,30,30
1650575854522,MATH 18,B03,083750,Staff,0,12,30,30
1650575854522,MATH 18,B04,083751,Staff,0,12,30,30
1650575860548,MATH 20A,A01,083754,Staff,21,0,40,19
1650575866572,MATH 20B,A01,083756,Staff,1,11,30,29
1650575866572,MATH 20B,A02,083757,Staff,0,12,30,30
1650575872597,MATH 20C,A01,083760,Staff,0,16,30,30
1650575872597,MATH 20C,A02,083761,Staff,2,14,30,28
1650575872597,MATH 20C,B01,083762,Staff,11,0,30,19
1650575872597,MATH 20C,B02,083763,Staff,28,0,30,2
1650575878621,MATH 20D,A01,083765,Staff,0,1,30,30
1650575878621,MATH 20D,A02,083766,Staff,7,0,30,23
1650575878621,MATH 20D,A03,083767,Staff,25,0,30,5
1650575884646,MATH 20E,A01,083771,Staff,7,0,30,23
1650575884646,MATH 20E,A02,083772,Staff,18,0,30,12
1650575884646,MATH 20E,B01,083773,Staff,0,0,30,30
1650575884646,MATH 20E,B02,083774,Staff,9,0,30,21
1650575890686,MATH 103A,A01,083777,Staff,0,15,30,30
1650575890686,MATH 103A,A02,083778,Staff,0,14,30,30
1650575890686,MATH 103A,B01,083779,Staff,0,13,30,30
1650575890686,MATH 103A,B02,083780,Staff,0,13,30,30
1650575896711,MATH 105,A01,085443,Staff,0,21,30,30
1650575902742,MATH 109,A01,083213,Anzaldo; Leesa B,0,7,30,30
1650575902742,MATH 109,A02,083214,Anzaldo; Leesa B,0,7,30,30
1650575902742,MATH 109,B01,083215,Anzaldo; Leesa B,0,5,30,30
1650575902742,MATH 109,B02,083216,Anzaldo; Leesa B,0,6,30,30
1650575908770,MATH 142A,A01,083219,Chow; Bennett,0,16,30,30
1650575908770,MATH 142A,A02,083220,Chow; Bennett,0,15,30,30
1650575908770,MATH 142A,B01,083221,Chow; Bennett,0,14,30,30
1650575908770,MATH 142A,B02,083222,Chow; Bennett,0,13,30,30
1650575914795,MATH 193A,A01,083224,Staff,1,6,30,29
1650575914795,MATH 193A,A02,083225,Staff,0,6,30,30
1650575914795,MATH 193A,A03,083781,Staff,0,6,30,30
1650575914795,MATH 193A,A04,083782,Staff,0,7,30,30
1650575920824,MATH 197,001,091859,McAuley; Julian John,9998,0,9999,1
1650575926878,COGS 9,A01,083615,Staff,1,16,60,59
1650575932902,COGS 11,A01,083617,Boyle; Mary E. T.,18,0,40,22
1650575938926,COGS 13,A01,083071,Staff,0,37,40,40
1650575944957,COGS 14A,A01,092681,Staff,0,29,100,100
1650575950981,COGS 14B,A01,083073,Cheng; Tzu-Han,0,12,50,50
1650575957004,COGS 17,A01,092677,Staff,18,0,75,57
1650575963028,COGS 100,A01,083619,Staff,1,26,60,59
1650575969064,COGS 101A,A01,083621,Davis; Joshua Daniel,0,26,60,60
1650575975087,COGS 101B,A01,091572,Staff,1,5,60,59
1650575981111,COGS 101C,A01,083625,Delgado; Tania,15,0,30,15
1650575987138,COGS 107A,A01,083627,Boyle; Mary E. T.,0,12,60,60
1650575993252,COGS 118A,A01,083075,Staff,0,4,60,60
1650575999276,CSE 3,A50,083646,Miranda; Gregory Joseph,19,0,38,19
1650575999276,CSE 3,A51,083647,Miranda; Gregory Joseph,36,0,37,1
1650576005303,CSE 8A,A50,083650,Miranda; Gregory Joseph,0,29,40,40
1650576011341,CSE 11,A01,083080,Cao; Yingjun,0,93,40,40
1650576017366,CSE 12,A01,083652,Staff,0,19,100,100
1650576023400,CSE 15L,A01,083654,Staff,0,1,50,50
1650576023400,CSE 15L,A02,083655,Staff,0,1,50,50
1650576029424,CSE 20,A01,083657,Staff,51,0,80,29
1650576035454,CSE 30,A01,083084,Eldon; John,0,78,40,40
1650576041481,CSE 100,A01,083659,Cao; Yingjun,0,66,50,50
1650576047504,CSE 134B,A01,083661,Powell; Thomas Allan,0,35,65,65
1650576053527,CSE 140,A01,083663,Staff,0,7,75,75
1650576059554,CSE 140L,A01,083088,Eldon; John,0,13,75,75
1650576065591,CSE 175,A01,083665,Kumar; Rakesh,7,0,25,18
1650576071615,CSE 190,A00,092507,Dubnov; Shlomo,10,0,20,10
1650576077638,ECE 45,A01,083139,Staff,1,2,60,59
1650576083662,ECE 65,A50,083695,Staff,1,6,30,29
1650576089693,ECE 109,A01,091882,Touri; Behrouz,33,0,70,37
1650576095722,ECE 180,A00,083140,Abi Samra; Nicholas Camill,21,0,30,9
1650576095722,ECE 180,B00,083141,Abi Samra; Nicholas Camill,0,0,30,30
1650576101761,MATH 10A,A01,083735,Patchell; Gregory David,5,0,30,25
1650576101761,MATH 10A,A02,083736,Patchell; Gregory David,27,0,30,3
1650576101761,MATH 10A,A03,083737,Patchell; Gregory David,24,0,30,6
1650576107786,MATH 10B,A01,083207,Staff,0,9,30,30
1650576107786,MATH 10B,A02,083208,Staff,0,8,30,30
1650576107786,MATH 10B,B01,083739,Staff,11,0,30,19
1650576107786,MATH 10B,B02,083740,Staff,28,0,30,2
1650576113812,MATH 18,A01,083743,Staff,1,0,30,29
1650576113812,MATH 18,A02,083744,Staff,26,0,30,4
1650576113812,MATH 18,A03,083745,Staff,22,0,30,8
1650576113812,MATH 18,A04,083746,Staff,26,0,30,4
1650576113812,MATH 18,B01,083748,Staff,0,14,30,30
1650576113812,MATH 18,B02,083749,Staff,0,12,30,30
1650576113812,MATH 18,B03,083750,Staff,0,12,30,30
1650576113812,MATH 18,B04,083751,Staff,0,12,30,30
1650576119835,MATH 20A,A01,083754,Staff,21,0,40,19
1650576125863,MATH 20B,A01,083756,Staff,1,11,30,29
1650576125863,MATH 20B,A02,083757,Staff,0,12,30,30
1650576131893,MATH 20C,A01,083760,Staff,0,16,30,30
1650576131893,MATH 20C,A02,083761,Staff,2,14,30,28
1650576131893,MATH 20C,B01,083762,Staff,11,0,30,19
1650576131893,MATH 20C,B02,083763,Staff,28,0,30,2
1650576137915,MATH 20D,A01,083765,Staff,0,1,30,30
1650576137915,MATH 20D,A02,083766,Staff,7,0,30,23
1650576137915,MATH 20D,A03,083767,Staff,25,0,30,5
1650576143942,MATH 20E,A01,083771,Staff,7,0,30,23
1650576143942,MATH 20E,A02,083772,Staff,18,0,30,12
1650576143942,MATH 20E,B01,083773,Staff,0,0,30,30
1650576143942,MATH 20E,B02,083774,Staff,9,0,30,21
1650576149968,MATH 103A,A01,083777,Staff,0,15,30,30
1650576149968,MATH 103A,A02,083778,Staff,0,14,30,30
1650576149968,MATH 103A,B01,083779,Staff,0,13,30,30
1650576149968,MATH 103A,B02,083780,Staff,0,13,30,30
1650576155992,MATH 105,A01,085443,Staff,0,21,30,30
1650576162027,MATH 109,A01,083213,Anzaldo; Leesa B,0,7,30,30
1650576162027,MATH 109,A02,083214,Anzaldo; Leesa B,0,7,30,30
1650576162027,MATH 109,B01,083215,Anzaldo; Leesa B,0,5,30,30
1650576162027,MATH 109,B02,083216,Anzaldo; Leesa B,0,6,30,30
1650576168060,MATH 142A,A01,083219,Chow; Bennett,0,16,30,30
1650576168060,MATH 142A,A02,083220,Chow; Bennett,0,15,30,30
1650576168060,MATH 142A,B01,083221,Chow; Bennett,0,14,30,30
1650576168060,MATH 142A,B02,083222,Chow; Bennett,0,13,30,30
1650576174100,MATH 193A,A01,083224,Staff,1,6,30,29
1650576174100,MATH 193A,A02,083225,Staff,0,6,30,30
1650576174100,MATH 193A,A03,083781,Staff,0,6,30,30
1650576174100,MATH 193A,A04,083782,Staff,0,7,30,30
1650576180125,MATH 197,001,091859,McAuley; Julian John,9998,0,9999,1
1650576186189,COGS 9,A01,083615,Staff,1,16,60,59
1650576192212,COGS 11,A01,083617,Boyle; Mary E. T.,18,0,40,22
1650576198234,COGS 13,A01,083071,Staff,0,37,40,40
1650576204258,COGS 14A,A01,092681,Staff,0,29,100,100
1650576210282,COGS 14B,A01,083073,Cheng; Tzu-Han,0,12,50,50
1650576216309,COGS 17,A01,092677,Staff,18,0,75,57
1650576222330,COGS 100,A01,083619,Staff,1,26,60,59
1650576228358,COGS 101A,A01,083621,Davis; Joshua Daniel,0,26,60,60
1650576234381,COGS 101B,A01,091572,Staff,1,5,60,59
1650576240418,COGS 101C,A01,083625,Delgado; Tania,15,0,30,15
1650576246441,COGS 107A,A01,083627,Boyle; Mary E. T.,0,12,60,60
1650576252473,COGS 118A,A01,083075,Staff,0,4,60,60
1650576258499,CSE 3,A50,083646,Miranda; Gregory Joseph,19,0,38,19
1650576258499,CSE 3,A51,083647,Miranda; Gregory Joseph,36,0,37,1
1650576264521,CSE 8A,A50,083650,Miranda; Gregory Joseph,0,29,40,40
1650576270547,CSE 11,A01,083080,Cao; Yingjun,0,93,40,40
1650576276576,CSE 12,A01,083652,Staff,0,19,100,100
1650576282597,CSE 15L,A01,083654,Staff,0,1,50,50
1650576282597,CSE 15L,A02,083655,Staff,0,1,50,50
1650576288621,CSE 20,A01,083657,Staff,51,0,80,29
1650576294644,CSE 30,A01,083084,Eldon; John,0,78,40,40
1650576300671,CSE 100,A01,083659,Cao; Yingjun,0,66,50,50
1650576306700,CSE 134B,A01,083661,Powell; Thomas Allan,0,35,65,65
1650576312724,CSE 140,A01,083663,Staff,0,7,75,75
1650576318753,CSE 140L,A01,083088,Eldon; John,0,13,75,75
1650576324778,CSE 175,A01,083665,Kumar; Rakesh,7,0,25,18
1650576330813,CSE 190,A00,092507,Dubnov; Shlomo,10,0,20,10
1650576336835,ECE 45,A01,083139,Staff,1,2,60,59
1650576342859,ECE 65,A50,083695,Staff,1,6,30,29
1650576348881,ECE 109,A01,091882,Touri; Behrouz,33,0,70,37
1650576354913,ECE 180,A00,083140,Abi Samra; Nicholas Camill,21,0,30,9
1650576354913,ECE 180,B00,083141,Abi Samra; Nicholas Camill,0,0,30,30
1650576360937,MATH 10A,A01,083735,Patchell; Gregory David,5,0,30,25
1650576360937,MATH 10A,A02,083736,Patchell; Gregory David,27,0,30,3
1650576360937,MATH 10A,A03,083737,Patchell; Gregory David,24,0,30,6
1650576366961,MATH 10B,A01,083207,Staff,0,9,30,30
1650576366961,MATH 10B,A02,083208,Staff,0,8,30,30
1650576366961,MATH 10B,B01,083739,Staff,11,0,30,19
1650576366961,MATH 10B,B02,083740,Staff,28,0,30,2
1650576372997,MATH 18,A01,083743,Staff,1,0,30,29
1650576372997,MATH 18,A02,083744,Staff,26,0,30,4
1650576372997,MATH 18,A03,083745,Staff,22,0,30,8
1650576372997,MATH 18,A04,083746,Staff,26,0,30,4
1650576372997,MATH 18,B01,083748,Staff,0,14,30,30
1650576372997,MATH 18,B02,083749,Staff,0,12,30,30
1650576372997,MATH 18,B03,083750,Staff,0,12,30,30
1650576372997,MATH 18,B04,083751,Staff,0,12,30,30
1650576379020,MATH 20A,A01,083754,Staff,21,0,40,19
1650576385046,MATH 20B,A01,083756,Staff,1,11,30,29
1650576385046,MATH 20B,A02,083757,Staff,0,12,30,30
1650576391074,MATH 20C,A01,083760,Staff,0,16,30,30
1650576391074,MATH 20C,A02,083761,Staff,2,14,30,28
1650576391074,MATH 20C,B01,083762,Staff,11,0,30,19
1650576391074,MATH 20C,B02,083763,Staff,28,0,30,2
1650576397100,MATH 20D,A01,083765,Staff,0,1,30,30
1650576397100,MATH 20D,A02,083766,Staff,7,0,30,23
1650576397100,MATH 20D,A03,083767,Staff,25,0,30,5
1650576403127,MATH 20E,A01,083771,Staff,7,0,30,23
1650576403127,MATH 20E,A02,083772,Staff,18,0,30,12
1650576403127,MATH 20E,B01,083773,Staff,0,0,30,30
1650576403127,MATH 20E,B02,083774,Staff,9,0,30,21
1650576409148,MATH 103A,A01,083777,Staff,0,15,30,30
1650576409148,MATH 103A,A02,083778,Staff,0,14,30,30
1650576409148,MATH 103A,B01,083779,Staff,0,13,30,30
1650576409148,MATH 103A,B02,083780,Staff,0,13,30,30
1650576415171,MATH 105,A01,085443,Staff,0,21,30,30
1650576421216,MATH 109,A01,083213,Anzaldo; Leesa B,0,7,30,30
1650576421216,MATH 109,A02,083214,Anzaldo; Leesa B,0,7,30,30
1650576421216,MATH 109,B01,083215,Anzaldo; Leesa B,0,5,30,30
1650576421216,MATH 109,B02,083216,Anzaldo; Leesa B,0,6,30,30
1650576427244,MATH 142A,A01,083219,Chow; Bennett,0,16,30,30
1650576427244,MATH 142A,A02,083220,Chow; Bennett,0,15,30,30
1650576427244,MATH 142A,B01,083221,Chow; Bennett,0,14,30,30
1650576427244,MATH 142A,B02,083222,Chow; Bennett,0,13,30,30
1650576433358,MATH 193A,A01,083224,Staff,1,6,30,29
1650576433358,MATH 193A,A02,083225,Staff,0,6,30,30
1650576433358,MATH 193A,A03,083781,Staff,0,6,30,30
1650576433358,MATH 193A,A04,083782,Staff,0,7,30,30
1650576439381,MATH 197,001,091859,McAuley; Julian John,9998,0,9999,1
1650576445444,COGS 9,A01,083615,Staff,1,16,60,59
1650576451479,COGS 11,A01,083617,Boyle; Mary E. T.,18,0,40,22
1650576457503,COGS 13,A01,083071,Staff,0,37,40,40
1650576463537,COGS 14A,A01,092681,Staff,0,29,100,100
1650576469572,COGS 14B,A01,083073,Cheng; Tzu-Han,0,12,50,50
1650576475601,COGS 17,A01,092677,Staff,18,0,75,57
1650576481629,COGS 100,A01,083619,Staff,1,26,60,59
1650576487656,COGS 101A,A01,083621,Davis; Joshua Daniel,0,26,60,60
1650576493682,COGS 101B,A01,091572,Staff,1,5,60,59
1650576499710,COGS 101C,A01,083625,Delgado; Tania,15,0,30,15
1650576505734,COGS 107A,A01,083627,Boyle; Mary E. T.,0,12,60,60
1650576511761,COGS 118A,A01,083075,Staff,0,4,60,60
1650576517797,CSE 3,A50,083646,Miranda; Gregory Joseph,19,0,38,19
1650576517797,CSE 3,A51,083647,Miranda; Gregory Joseph,36,0,37,1
1650576523825,CSE 8A,A50,083650,Miranda; Gregory Joseph,0,29,40,40
1650576529853,CSE 11,A01,083080,Cao; Yingjun,0,93,40,40
1650576535876,CSE 12,A01,083652,Staff,0,19,100,100
1650576541908,CSE 15L,A01,083654,Staff,0,1,50,50
1650576541908,CSE 15L,A02,083655,Staff,0,1,50,50
1650576547934,CSE 20,A01,083657,Staff,51,0,80,29
1650576553968,CSE 30,A01,083084,Eldon; John,0,78,40,40
1650576559994,CSE 100,A01,083659,Cao; Yingjun,0,66,50,50
1650576566017,CSE 134B,A01,083661,Powell; Thomas Allan,0,35,65,65
1650576572041,CSE 140,A01,083663,Staff,0,7,75,75
1650576578074,CSE 140L,A01,083088,Eldon; John,0,13,75,75
1650576584101,CSE 175,A01,083665,Kumar; Rakesh,7,0,25,18
1650576590123,CSE 190,A00,092507,Dubnov; Shlomo,10,0,20,10
1650576596146,ECE 45,A01,083139,Staff,1,2,60,59
1650576602171,ECE 65,A50,083695,Staff,1,6,30,29
1650576608197,ECE 109,A01,091882,Touri; Behrouz,33,0,70,37
1650576614224,ECE 180,A00,083140,Abi Samra; Nicholas Camill,21,0,30,9
1650576614224,ECE 180,B00,083141,Abi Samra; Nicholas Camill,0,0,30,30
1650576620252,MATH 10A,A01,083735,Patchell; Gregory David,5,0,30,25
1650576620252,MATH 10A,A02,083736,Patchell; Gregory David,27,0,30,3
1650576620252,MATH 10A,A03,083737,Patchell; Gregory David,24,0,30,6
1650576626289,MATH 10B,A01,083207,Staff,0,9,30,30
1650576626289,MATH 10B,A02,083208,Staff,0,8,30,30
1650576626289,MATH 10B,B01,083739,Staff,11,0,30,19
1650576626289,MATH 10B,B02,083740,Staff,28,0,30,2
1650576632318,MATH 18,A01,083743,Staff,1,0,30,29
1650576632318,MATH 18,A02,083744,Staff,26,0,30,4
1650576632318,MATH 18,A03,083745,Staff,22,0,30,8
1650576632318,MATH 18,A04,083746,Staff,26,0,30,4
1650576632318,MATH 18,B01,083748,Staff,0,14,30,30
1650576632318,MATH 18,B02,083749,Staff,0,12,30,30
1650576632318,MATH 18,B03,083750,Staff,0,12,30,30
1650576632318,MATH 18,B04,083751,Staff,0,12,30,30
1650576638343,MATH 20A,A01,083754,Staff,21,0,40,19
1650576644373,MATH 20B,A01,083756,Staff,1,11,30,29
1650576644373,MATH 20B,A02,083757,Staff,0,12,30,30
1650576650400,MATH 20C,A01,083760,Staff,0,16,30,30
1650576650400,MATH 20C,A02,083761,Staff,2,14,30,28
1650576650400,MATH 20C,B01,083762,Staff,11,0,30,19
1650576650400,MATH 20C,B02,083763,Staff,28,0,30,2
1650576656427,MATH 20D,A01,083765,Staff,0,1,30,30
1650576656427,MATH 20D,A02,083766,Staff,7,0,30,23
1650576656427,MATH 20D,A03,083767,Staff,25,0,30,5
1650576662459,MATH 20E,A01,083771,Staff,7,0,30,23
1650576662459,MATH 20E,A02,083772,Staff,18,0,30,12
1650576662459,MATH 20E,B01,083773,Staff,0,0,30,30
1650576662459,MATH 20E,B02,083774,Staff,9,0,30,21
1650576668484,MATH 103A,A01,083777,Staff,0,15,30,30
1650576668484,MATH 103A,A02,083778,Staff,0,14,30,30
1650576668484,MATH 103A,B01,083779,Staff,0,13,30,30
1650576668484,MATH 103A,B02,083780,Staff,0,13,30,30
1650576674506,MATH 105,A01,085443,Staff,0,21,30,30
1650576680537,MATH 109,A01,083213,Anzaldo; Leesa B,0,7,30,30
1650576680537,MATH 109,A02,083214,Anzaldo; Leesa B,0,7,30,30
1650576680537,MATH 109,B01,083215,Anzaldo; Leesa B,0,5,30,30
1650576680537,MATH 109,B02,083216,Anzaldo; Leesa B,0,6,30,30
1650576686568,MATH 142A,A01,083219,Chow; Bennett,0,16,30,30
1650576686568,MATH 142A,A02,083220,Chow; Bennett,0,15,30,30
1650576686568,MATH 142A,B01,083221,Chow; Bennett,0,14,30,30
1650576686568,MATH 142A,B02,083222,Chow; Bennett,0,13,30,30
1650576692615,MATH 193A,A01,083224,Staff,1,6,30,29
1650576692615,MATH 193A,A02,083225,Staff,0,6,30,30
1650576692615,MATH 193A,A03,083781,Staff,0,6,30,30
1650576692615,MATH 193A,A04,083782,Staff,0,7,30,30
1650576698638,MATH 197,001,091859,McAuley; Julian John,9998,0,9999,1
1650576704691,COGS 9,A01,083615,Staff,1,16,60,59
1650576710713,COGS 11,A01,083617,Boyle; Mary E. T.,18,0,40,22
1650576716760,COGS 13,A01,083071,Staff,0,37,40,40
1650576722788,COGS 14A,A01,092681,Staff,0,29,100,100
1650576728824,COGS 14B,A01,083073,Cheng; Tzu-Han,0,12,50,50
1650576734850,COGS 17,A01,092677,Staff,18,0,75,57
1650576740876,COGS 100,A01,083619,Staff,1,26,60,59
1650576746899,COGS 101A,A01,083621,Davis; Joshua Daniel,0,26,60,60
1650576752921,COGS 101B,A01,091572,Staff,1,5,60,59
1650576758948,COGS 101C,A01,083625,Delgado; Tania,15,0,30,15
1650576764974,COGS 107A,A01,083627,Boyle; Mary E. T.,0,12,60,60
1650576771001,COGS 118A,A01,083075,Staff,0,4,60,60
1650576777049,CSE 3,A50,083646,Miranda; Gregory Joseph,19,0,38,19
1650576777049,CSE 3,A51,083647,Miranda; Gregory Joseph,36,0,37,1
1650576783072,CSE 8A,A50,083650,Miranda; Gregory Joseph,0,29,40,40
1650576789106,CSE 11,A01,083080,Cao; Yingjun,0,93,40,40
1650576795140,CSE 12,A01,083652,Staff,0,19,100,100
1650576801171,CSE 15L,A01,083654,Staff,0,1,50,50
1650576801171,CSE 15L,A02,083655,Staff,0,1,50,50
1650576807209,CSE 20,A01,083657,Staff,51,0,80,29
1650576813246,CSE 30,A01,083084,Eldon; John,0,78,40,40
1650576819269,CSE 100,A01,083659,Cao; Yingjun,0,66,50,50
1650576825292,CSE 134B,A01,083661,Powell; Thomas Allan,0,35,65,65
1650576831320,CSE 140,A01,083663,Staff,0,7,75,75
1650576837343,CSE 140L,A01,083088,Eldon; John,0,13,75,75
1650576843370,CSE 175,A01,083665,Kumar; Rakesh,7,0,25,18
1650576849397,CSE 190,A00,092507,Dubnov; Shlomo,10,0,20,10
1650576855422,ECE 45,A01,083139,Staff,1,2,60,59
1650576861447,ECE 65,A50,083695,Staff,1,6,30,29
1650576867475,ECE 109,A01,091882,Touri; Behrouz,33,0,70,37
1650576873502,ECE 180,A00,083140,Abi Samra; Nicholas Camill,21,0,30,9
1650576873502,ECE 180,B00,083141,Abi Samra; Nicholas Camill,0,0,30,30
1650576879526,MATH 10A,A01,083735,Patchell; Gregory David,5,0,30,25
1650576879526,MATH 10A,A02,083736,Patchell; Gregory David,27,0,30,3
1650576879526,MATH 10A,A03,083737,Patchell; Gregory David,24,0,30,6
1650576885554,MATH 10B,A01,083207,Staff,0,9,30,30
1650576885554,MATH 10B,A02,083208,Staff,0,8,30,30
1650576885554,MATH 10B,B01,083739,Staff,11,0,30,19
1650576885554,MATH 10B,B02,083740,Staff,28,0,30,2
1650576891580,MATH 18,A01,083743,Staff,1,0,30,29
1650576891580,MATH 18,A02,083744,Staff,26,0,30,4
1650576891580,MATH 18,A03,083745,Staff,22,0,30,8
1650576891580,MATH 18,A04,083746,Staff,26,0,30,4
1650576891580,MATH 18,B01,083748,Staff,0,14,30,30
1650576891580,MATH 18,B02,083749,Staff,0,12,30,30
1650576891580,MATH 18,B03,083750,Staff,0,12,30,30
1650576891580,MATH 18,B04,083751,Staff,0,12,30,30
1650576897603,MATH 20A,A01,083754,Staff,21,0,40,19
1650576903629,MATH 20B,A01,083756,Staff,1,11,30,29
1650576903629,MATH 20B,A02,083757,Staff,0,12,30,30
1650576909653,MATH 20C,A01,083760,Staff,0,16,30,30
1650576909653,MATH 20C,A02,083761,Staff,2,14,30,28
1650576909653,MATH 20C,B01,083762,Staff,11,0,30,19
1650576909653,MATH 20C,B02,083763,Staff,28,0,30,2
1650576915689,MATH 20D,A01,083765,Staff,0,1,30,30
1650576915689,MATH 20D,A02,083766,Staff,7,0,30,23
1650576915689,MATH 20D,A03,083767,Staff,25,0,30,5
1650576921712,MATH 20E,A01,083771,Staff,7,0,30,23
1650576921712,MATH 20E,A02,083772,Staff,18,0,30,12
1650576921712,MATH 20E,B01,083773,Staff,0,0,30,30
1650576921712,MATH 20E,B02,083774,Staff,9,0,30,21
1650576927743,MATH 103A,A01,083777,Staff,0,15,30,30
1650576927743,MATH 103A,A02,083778,Staff,0,14,30,30
1650576927743,MATH 103A,B01,083779,Staff,0,13,30,30
1650576927743,MATH 103A,B02,083780,Staff,0,13,30,30
1650576933766,MATH 105,A01,085443,Staff,0,21,30,30
1650576939807,MATH 109,A01,083213,Anzaldo; Leesa B,0,7,30,30
1650576939807,MATH 109,A02,083214,Anzaldo; Leesa B,0,7,30,30
1650576939807,MATH 109,B01,083215,Anzaldo; Leesa B,0,5,30,30
1650576939807,MATH 109,B02,083216,Anzaldo; Leesa B,0,6,30,30
1650576945831,MATH 142A,A01,083219,Chow; Bennett,0,16,30,30
1650576945831,MATH 142A,A02,083220,Chow; Bennett,0,15,30,30
1650576945831,MATH 142A,B01,083221,Chow; Bennett,0,14,30,30
1650576945831,MATH 142A,B02,083222,Chow; Bennett,0,13,30,30
1650576951859,MATH 193A,A01,083224,Staff,1,6,30,29
1650576951859,MATH 193A,A02,083225,Staff,0,6,30,30
1650576951859,MATH 193A,A03,083781,Staff,0,6,30,30
1650576951859,MATH 193A,A04,083782,Staff,0,7,30,30
1650576957887,MATH 197,001,091859,McAuley; Julian John,9998,0,9999,1
1650576963937,COGS 9,A01,083615,Staff,1,16,60,59
1650576969964,COGS 11,A01,083617,Boyle; Mary E. T.,18,0,40,22
1650576975991,COGS 13,A01,083071,Staff,0,37,40,40
1650576982030,COGS 14A,A01,092681,Staff,0,29,100,100
1650576988057,COGS 14B,A01,083073,Cheng; Tzu-Han,0,12,50,50
1650576994083,COGS 17,A01,092677,Staff,18,0,75,57
1650577000106,COGS 100,A01,083619,Staff,1,26,60,59
1650577006128,COGS 101A,A01,083621,Davis; Joshua Daniel,0,26,60,60
1650577012151,COGS 101B,A01,091572,Staff,1,5,60,59
1650577018178,COGS 101C,A01,083625,Delgado; Tania,15,0,30,15
1650577024294,COGS 107A,A01,083627,Boyle; Mary E. T.,0,12,60,60
1650577030317,COGS 118A,A01,083075,Staff,0,4,60,60
1650577036341,CSE 3,A50,083646,Miranda; Gregory Joseph,19,0,38,19
1650577036341,CSE 3,A51,083647,Miranda; Gregory Joseph,36,0,37,1
1650577042365,CSE 8A,A50,083650,Miranda; Gregory Joseph,0,29,40,40
1650577048386,CSE 11,A01,083080,Cao; Yingjun,0,93,40,40
1650577054410,CSE 12,A01,083652,Staff,0,19,100,100
1650577060433,CSE 15L,A01,083654,Staff,0,1,50,50
1650577060433,CSE 15L,A02,083655,Staff,0,1,50,50
1650577066456,CSE 20,A01,083657,Staff,51,0,80,29
1650577072481,CSE 30,A01,083084,Eldon; John,0,78,40,40
1650577078508,CSE 100,A01,083659,Cao; Yingjun,0,66,50,50
1650577084559,CSE 134B,A01,083661,Powell; Thomas Allan,0,35,65,65
1650577090585,CSE 140,A01,083663,Staff,0,7,75,75
1650577096612,CSE 140L,A01,083088,Eldon; John,0,13,75,75
1650577102637,CSE 175,A01,083665,Kumar; Rakesh,7,0,25,18
1650577108663,CSE 190,A00,092507,Dubnov; Shlomo,10,0,20,10
1650577114689,ECE 45,A01,083139,Staff,1,2,60,59
1650577120713,ECE 65,A50,083695,Staff,1,6,30,29
1650577126740,ECE 109,A01,091882,Touri; Behrouz,33,0,70,37
1650577132764,ECE 180,A00,083140,Abi Samra; Nicholas Camill,21,0,30,9
1650577132764,ECE 180,B00,083141,Abi Samra; Nicholas Camill,0,0,30,30
1650577138791,MATH 10A,A01,083735,Patchell; Gregory David,5,0,30,25
1650577138791,MATH 10A,A02,083736,Patchell; Gregory David,27,0,30,3
1650577138791,MATH 10A,A03,083737,Patchell; Gregory David,24,0,30,6
1650577144827,MATH 10B,A01,083207,Staff,0,9,30,30
1650577144827,MATH 10B,A02,083208,Staff,0,8,30,30
1650577144827,MATH 10B,B01,083739,Staff,11,0,30,19
1650577144827,MATH 10B,B02,083740,Staff,28,0,30,2
1650577150857,MATH 18,A01,083743,Staff,1,0,30,29
1650577150857,MATH 18,A02,083744,Staff,26,0,30,4
1650577150857,MATH 18,A03,083745,Staff,22,0,30,8
1650577150857,MATH 18,A04,083746,Staff,26,0,30,4
1650577150857,MATH 18,B01,083748,Staff,0,14,30,30
1650577150857,MATH 18,B02,083749,Staff,0,12,30,30
1650577150857,MATH 18,B03,083750,Staff,0,12,30,30
1650577150857,MATH 18,B04,083751,Staff,0,12,30,30
1650577156884,MATH 20A,A01,083754,Staff,21,0,40,19
1650577162908,MATH 20B,A01,083756,Staff,1,11,30,29
1650577162908,MATH 20B,A02,083757,Staff,0,12,30,30
1650577168935,MATH 20C,A01,083760,Staff,0,16,30,30
1650577168935,MATH 20C,A02,083761,Staff,2,14,30,28
1650577168935,MATH 20C,B01,083762,Staff,11,0,30,19
1650577168935,MATH 20C,B02,083763,Staff,28,0,30,2
1650577174966,MATH 20D,A01,083765,Staff,0,1,30,30
1650577174966,MATH 20D,A02,083766,Staff,7,0,30,23
1650577174966,MATH 20D,A03,083767,Staff,25,0,30,5
1650577181002,MATH 20E,A01,083771,Staff,7,0,30,23
1650577181002,MATH 20E,A02,083772,Staff,18,0,30,12
1650577181002,MATH 20E,B01,083773,Staff,0,0,30,30
1650577181002,MATH 20E,B02,083774,Staff,9,0,30,21
1650577187071,MATH 103A,A01,083777,Staff,0,15,30,30
1650577187071,MATH 103A,A02,083778,Staff,0,14,30,30
1650577187071,MATH 103A,B01,083779,Staff,0,13,30,30
1650577187071,MATH 103A,B02,083780,Staff,0,13,30,30
1650577193095,MATH 105,A01,085443,Staff,0,21,30,30
1650577199127,MATH 109,A01,083213,Anzaldo; Leesa B,0,7,30,30
1650577199127,MATH 109,A02,083214,Anzaldo; Leesa B,0,7,30,30
1650577199127,MATH 109,B01,083215,Anzaldo; Leesa B,0,5,30,30
1650577199127,MATH 109,B02,083216,Anzaldo; Leesa B,0,6,30,30
1650577205151,MATH 142A,A01,083219,Chow; Bennett,0,16,30,30
1650577205151,MATH 142A,A02,083220,Chow; Bennett,0,15,30,30
1650577205151,MATH 142A,B01,083221,Chow; Bennett,0,14,30,30
1650577205151,MATH 142A,B02,083222,Chow; Bennett,0,13,30,30
1650577211178,MATH 193A,A01,083224,Staff,1,6,30,29
1650577211178,MATH 193A,A02,083225,Staff,0,6,30,30
1650577211178,MATH 193A,A03,083781,Staff,0,6,30,30
1650577211178,MATH 193A,A04,083782,Staff,0,7,30,30
1650577217207,MATH 197,001,091859,McAuley; Julian John,9998,0,9999,1
1650577223282,COGS 9,A01,083615,Staff,1,16,60,59
1650577229304,COGS 11,A01,083617,Boyle; Mary E. T.,18,0,40,22
1650577235338,COGS 13,A01,083071,Staff,0,37,40,40
1650577241365,COGS 14A,A01,092681,Staff,0,29,100,100
1650577247390,COGS 14B,A01,083073,Cheng; Tzu-Han,0,12,50,50
1650577253415,COGS 17,A01,092677,Staff,18,0,75,57
1650577259453,COGS 100,A01,083619,Staff,1,26,60,59
1650577265480,COGS 101A,A01,083621,Davis; Joshua Daniel,0,26,60,60
1650577271517,COGS 101B,A01,091572,Staff,1,5,60,59
1650577277540,COGS 101C,A01,083625,Delgado; Tania,15,0,30,15
1650577283566,COGS 107A,A01,083627,Boyle; Mary E. T.,0,12,60,60
1650577289592,COGS 118A,A01,083075,Staff,0,4,60,60
1650577295614,CSE 3,A50,083646,Miranda; Gregory Joseph,19,0,38,19
1650577295614,CSE 3,A51,083647,Miranda; Gregory Joseph,36,0,37,1
1650577301640,CSE 8A,A50,083650,Miranda; Gregory Joseph,0,29,40,40
1650577307671,CSE 11,A01,083080,Cao; Yingjun,0,93,40,40
1650577313705,CSE 12,A01,083652,Staff,0,19,100,100
1650577319728,CSE 15L,A01,083654,Staff,0,1,50,50
1650577319728,CSE 15L,A02,083655,Staff,0,1,50,50
1650577325768,CSE 20,A01,083657,Staff,51,0,80,29
1650577331796,CSE 30,A01,083084,Eldon; John,0,78,40,40
1650577337819,CSE 100,A01,083659,Cao; Yingjun,0,66,50,50
1650577343844,CSE 134B,A01,083661,Powell; Thomas Allan,0,35,65,65
1650577349867,CSE 140,A01,083663,Staff,0,7,75,75
1650577355907,CSE 140L,A01,083088,Eldon; John,0,13,75,75
1650577361931,CSE 175,A01,083665,Kumar; Rakesh,7,0,25,18
1650577367956,CSE 190,A00,092507,Dubnov; Shlomo,10,0,20,10
1650577373981,ECE 45,A01,083139,Staff,1,2,60,59
1650577380008,ECE 65,A50,083695,Staff,1,6,30,29
1650577386042,ECE 109,A01,091882,Touri; Behrouz,33,0,70,37
1650577392065,ECE 180,A00,083140,Abi Samra; Nicholas Camill,21,0,30,9
1650577392065,ECE 180,B00,083141,Abi Samra; Nicholas Camill,0,0,30,30
1650577398089,MATH 10A,A01,083735,Patchell; Gregory David,5,0,30,25
1650577398089,MATH 10A,A02,083736,Patchell; Gregory David,27,0,30,3
1650577398089,MATH 10A,A03,083737,Patchell; Gregory David,24,0,30,6
1650577404114,MATH 10B,A01,083207,Staff,0,9,30,30
1650577404114,MATH 10B,A02,083208,Staff,0,8,30,30
1650577404114,MATH 10B,B01,083739,Staff,11,0,30,19
1650577404114,MATH 10B,B02,083740,Staff,28,0,30,2
1650577410145,MATH 18,A01,083743,Staff,1,0,30,29
1650577410145,MATH 18,A02,083744,Staff,26,0,30,4
1650577410145,MATH 18,A03,083745,Staff,22,0,30,8
1650577410145,MATH 18,A04,083746,Staff,26,0,30,4
1650577410145,MATH 18,B01,083748,Staff,0,14,30,30
1650577410145,MATH 18,B02,083749,Staff,0,12,30,30
1650577410145,MATH 18,B03,083750,Staff,0,12,30,30
1650577410145,MATH 18,B04,083751,Staff,0,12,30,30
1650577416167,MATH 20A,A01,083754,Staff,21,0,40,19
1650577422191,MATH 20B,A01,083756,Staff,1,11,30,29
1650577422191,MATH 20B,A02,083757,Staff,0,12,30,30
1650577428223,MATH 20C,A01,083760,Staff,0,16,30,30
1650577428223,MATH 20C,A02,083761,Staff,2,14,30,28
1650577428223,MATH 20C,B01,083762,Staff,11,0,30,19
1650577428223,MATH 20C,B02,083763,Staff,28,0,30,2
1650577434245,MATH 20D,A01,083765,Staff,0,1,30,30
1650577434245,MATH 20D,A02,083766,Staff,7,0,30,23
1650577434245,MATH 20D,A03,083767,Staff,25,0,30,5
1650577440271,MATH 20E,A01,083771,Staff,7,0,30,23
1650577440271,MATH 20E,A02,083772,Staff,18,0,30,12
1650577440271,MATH 20E,B01,083773,Staff,0,0,30,30
1650577440271,MATH 20E,B02,083774,Staff,9,0,30,21
1650577446301,MATH 103A,A01,083777,Staff,0,15,30,30
1650577446301,MATH 103A,A02,083778,Staff,0,14,30,30
1650577446301,MATH 103A,B01,083779,Staff,0,13,30,30
1650577446301,MATH 103A,B02,083780,Staff,0,13,30,30
1650577452335,MATH 105,A01,085443,Staff,0,21,30,30
1650577458360,MATH 109,A01,083213,Anzaldo; Leesa B,0,7,30,30
1650577458360,MATH 109,A02,083214,Anzaldo; Leesa B,0,7,30,30
1650577458360,MATH 109,B01,083215,Anzaldo; Leesa B,0,5,30,30
1650577458360,MATH 109,B02,083216,Anzaldo; Leesa B,0,6,30,30
1650577464385,MATH 142A,A01,083219,Chow; Bennett,0,16,30,30
1650577464385,MATH 142A,A02,083220,Chow; Bennett,0,15,30,30
1650577464385,MATH 142A,B01,083221,Chow; Bennett,0,14,30,30
1650577464385,MATH 142A,B02,083222,Chow; Bennett,0,13,30,30
1650577470415,MATH 193A,A01,083224,Staff,1,6,30,29
1650577470415,MATH 193A,A02,083225,Staff,0,6,30,30
1650577470415,MATH 193A,A03,083781,Staff,0,6,30,30
1650577470415,MATH 193A,A04,083782,Staff,0,7,30,30
1650577476438,MATH 197,001,091859,McAuley; Julian John,9998,0,9999,1
1650577482498,COGS 9,A01,083615,Staff,1,16,60,59
1650577488520,COGS 11,A01,083617,Boyle; Mary E. T.,18,0,40,22
1650577494542,COGS 13,A01,083071,Staff,0,37,40,40
1650577500570,COGS 14A,A01,092681,Staff,0,29,100,100
1650577506594,COGS 14B,A01,083073,Cheng; Tzu-Han,0,12,50,50
1650577512620,COGS 17,A01,092677,Staff,18,0,75,57
1650577518646,COGS 100,A01,083619,Staff,1,26,60,59
1650577524682,COGS 101A,A01,083621,Davis; Joshua Daniel,0,26,60,60
1650577530703,COGS 101B,A01,091572,Staff,1,5,60,59
1650577536729,COGS 101C,A01,083625,Delgado; Tania,15,0,30,15
1650577542755,COGS 107A,A01,083627,Boyle; Mary E. T.,0,12,60,60
1650577548787,COGS 118A,A01,083075,Staff,0,4,60,60
1650577554815,CSE 3,A50,083646,Miranda; Gregory Joseph,19,0,38,19
1650577554815,CSE 3,A51,083647,Miranda; Gregory Joseph,36,0,37,1
1650577560841,CSE 8A,A50,083650,Miranda; Gregory Joseph,0,29,40,40
1650577566865,CSE 11,A01,083080,Cao; Yingjun,0,93,40,40
1650577572909,CSE 12,A01,083652,Staff,0,19,100,100
1650577578931,CSE 15L,A01,083654,Staff,0,1,50,50
1650577578931,CSE 15L,A02,083655,Staff,0,1,50,50
1650577584973,CSE 20,A01,083657,Staff,51,0,80,29
1650577591004,CSE 30,A01,083084,Eldon; John,0,78,40,40
1650577597026,CSE 100,A01,083659,Cao; Yingjun,0,66,50,50
1650577603050,CSE 134B,A01,083661,Powell; Thomas Allan,0,35,65,65
1650577609082,CSE 140,A01,083663,Staff,0,7,75,75
1650577615115,CSE 140L,A01,083088,Eldon; John,0,13,75,75
1650577621228,CSE 175,A01,083665,Kumar; Rakesh,7,0,25,18
1650577627254,CSE 190,A00,092507,Dubnov; Shlomo,10,0,20,10
1650577633281,ECE 45,A01,083139,Staff,1,2,60,59
1650577639310,ECE 65,A50,083695,Staff,1,6,30,29
1650577645332,ECE 109,A01,091882,Touri; Behrouz,33,0,70,37
1650577651354,ECE 180,A00,083140,Abi Samra; Nicholas Camill,21,0,30,9
1650577651354,ECE 180,B00,083141,Abi Samra; Nicholas Camill,0,0,30,30
1650577657381,MATH 10A,A01,083735,Patchell; Gregory David,5,0,30,25
1650577657381,MATH 10A,A02,083736,Patchell; Gregory David,27,0,30,3
1650577657381,MATH 10A,A03,083737,Patchell; Gregory David,24,0,30,6
1650577663406,MATH 10B,A01,083207,Staff,0,9,30,30
1650577663406,MATH 10B,A02,083208,Staff,0,8,30,30
1650577663406,MATH 10B,B01,083739,Staff,11,0,30,19
1650577663406,MATH 10B,B02,083740,Staff,28,0,30,2
1650577669435,MATH 18,A01,083743,Staff,1,0,30,29
1650577669435,MATH 18,A02,083744,Staff,26,0,30,4
1650577669435,MATH 18,A03,083745,Staff,22,0,30,8
1650577669435,MATH 18,A04,083746,Staff,26,0,30,4
1650577669435,MATH 18,B01,083748,Staff,0,14,30,30
1650577669435,MATH 18,B02,083749,Staff,0,12,30,30
1650577669435,MATH 18,B03,083750,Staff,0,12,30,30
1650577669435,MATH 18,B04,083751,Staff,0,12,30,30
1650577675457,MATH 20A,A01,083754,Staff,21,0,40,19
1650577681484,MATH 20B,A01,083756,Staff,1,11,30,29
1650577681484,MATH 20B,A02,083757,Staff,0,12,30,30
1650577687512,MATH 20C,A01,083760,Staff,0,16,30,30
1650577687512,MATH 20C,A02,083761,Staff,2,14,30,28
1650577687512,MATH 20C,B01,083762,Staff,11,0,30,19
1650577687512,MATH 20C,B02,083763,Staff,28,0,30,2
1650577693561,MATH 20D,A01,083765,Staff,0,1,30,30
1650577693561,MATH 20D,A02,083766,Staff,7,0,30,23
1650577693561,MATH 20D,A03,083767,Staff,25,0,30,5
1650577699586,MATH 20E,A01,083771,Staff,7,0,30,23
1650577699586,MATH 20E,A02,083772,Staff,18,0,30,12
1650577699586,MATH 20E,B01,083773,Staff,0,0,30,30
1650577699586,MATH 20E,B02,083774,Staff,9,0,30,21
1650577705616,MATH 103A,A01,083777,Staff,0,15,30,30
1650577705616,MATH 103A,A02,083778,Staff,0,14,30,30
1650577705616,MATH 103A,B01,083779,Staff,0,13,30,30
1650577705616,MATH 103A,B02,083780,Staff,0,13,30,30
1650577711639,MATH 105,A01,085443,Staff,0,21,30,30
1650577717670,MATH 109,A01,083213,Anzaldo; Leesa B,0,7,30,30
1650577717670,MATH 109,A02,083214,Anzaldo; Leesa B,0,7,30,30
1650577717670,MATH 109,B01,083215,Anzaldo; Leesa B,0,5,30,30
1650577717670,MATH 109,B02,083216,Anzaldo; Leesa B,0,6,30,30
1650577723697,MATH 142A,A01,083219,Chow; Bennett,0,16,30,30
1650577723697,MATH 142A,A02,083220,Chow; Bennett,0,15,30,30
1650577723697,MATH 142A,B01,083221,Chow; Bennett,0,14,30,30
1650577723697,MATH 142A,B02,083222,Chow; Bennett,0,13,30,30
1650577729724,MATH 193A,A01,083224,Staff,1,6,30,29
1650577729724,MATH 193A,A02,083225,Staff,0,6,30,30
1650577729724,MATH 193A,A03,083781,Staff,0,6,30,30
1650577729724,MATH 193A,A04,083782,Staff,0,7,30,30
1650577735752,MATH 197,001,091859,McAuley; Julian John,9998,0,9999,1
1650577741814,COGS 9,A01,083615,Staff,1,16,60,59
1650577747839,COGS 11,A01,083617,Boyle; Mary E. T.,18,0,40,22
1650577753876,COGS 13,A01,083071,Staff,0,37,40,40
1650577759899,COGS 14A,A01,092681,Staff,0,29,100,100
1650577765926,COGS 14B,A01,083073,Cheng; Tzu-Han,0,12,50,50
1650577780225,COGS 17,A01,092677,Staff,18,0,75,57
1650577786254,COGS 100,A01,083619,Staff,1,26,60,59
1650577792281,COGS 101A,A01,083621,Davis; Joshua Daniel,0,26,60,60
1650577798305,COGS 101B,A01,091572,Staff,1,5,60,59
1650577804331,COGS 101C,A01,083625,Delgado; Tania,15,0,30,15
1650577810367,COGS 107A,A01,083627,Boyle; Mary E. T.,0,12,60,60
1650577816406,COGS 118A,A01,083075,Staff,0,4,60,60
1650577822429,CSE 3,A50,083646,Miranda; Gregory Joseph,19,0,38,19
1650577822429,CSE 3,A51,083647,Miranda; Gregory Joseph,36,0,37,1
1650577828457,CSE 8A,A50,083650,Miranda; Gregory Joseph,0,29,40,40
1650577834481,CSE 11,A01,083080,Cao; Yingjun,0,93,40,40
1650577840505,CSE 12,A01,083652,Staff,0,19,100,100
1650577846545,CSE 15L,A01,083654,Staff,0,1,50,50
1650577846545,CSE 15L,A02,083655,Staff,0,1,50,50
1650577852580,CSE 20,A01,083657,Staff,51,0,80,29
1650577858608,CSE 30,A01,083084,Eldon; John,0,78,40,40
1650577864632,CSE 100,A01,083659,Cao; Yingjun,0,66,50,50
1650577870656,CSE 134B,A01,083661,Powell; Thomas Allan,0,35,65,65
1650577876692,CSE 140,A01,083663,Staff,0,7,75,75
1650577882717,CSE 140L,A01,083088,Eldon; John,0,13,75,75
1650577888739,CSE 175,A01,083665,Kumar; Rakesh,7,0,25,18
1650577894763,CSE 190,A00,092507,Dubnov; Shlomo,10,0,20,10
1650577900795,ECE 45,A01,083139,Staff,1,2,60,59
1650577906818,ECE 65,A50,083695,Staff,1,6,30,29
1650577912844,ECE 109,A01,091882,Touri; Behrouz,33,0,70,37
1650577918877,ECE 180,A00,083140,Abi Samra; Nicholas Camill,21,0,30,9
1650577918877,ECE 180,B00,083141,Abi Samra; Nicholas Camill,0,0,30,30
1650577924903,MATH 10A,A01,083735,Patchell; Gregory David,5,0,30,25
1650577924903,MATH 10A,A02,083736,Patchell; Gregory David,27,0,30,3
1650577924903,MATH 10A,A03,083737,Patchell; Gregory David,24,0,30,6
1650577930928,MATH 10B,A01,083207,Staff,0,9,30,30
1650577930928,MATH 10B,A02,083208,Staff,0,8,30,30
1650577930928,MATH 10B,B01,083739,Staff,11,0,30,19
1650577930928,MATH 10B,B02,083740,Staff,28,0,30,2
1650577936955,MATH 18,A01,083743,Staff,1,0,30,29
1650577936955,MATH 18,A02,083744,Staff,26,0,30,4
1650577936955,MATH 18,A03,083745,Staff,22,0,30,8
1650577936955,MATH 18,A04,083746,Staff,26,0,30,4
1650577936955,MATH 18,B01,083748,Staff,0,14,30,30
1650577936955,MATH 18,B02,083749,Staff,0,12,30,30
1650577936955,MATH 18,B03,083750,Staff,0,12,30,30
1650577936955,MATH 18,B04,083751,Staff,0,12,30,30
1650577942978,MATH 20A,A01,083754,Staff,21,0,40,19
1650577949001,MATH 20B,A01,083756,Staff,1,11,30,29
1650577949001,MATH 20B,A02,083757,Staff,0,12,30,30
1650577955047,MATH 20C,A01,083760,Staff,0,16,30,30
1650577955047,MATH 20C,A02,083761,Staff,2,14,30,28
1650577955047,MATH 20C,B01,083762,Staff,11,0,30,19
1650577955047,MATH 20C,B02,083763,Staff,28,0,30,2
1650577961073,MATH 20D,A01,083765,Staff,0,1,30,30
1650577961073,MATH 20D,A02,083766,Staff,7,0,30,23
1650577961073,MATH 20D,A03,083767,Staff,25,0,30,5
1650577967101,MATH 20E,A01,083771,Staff,7,0,30,23
1650577967101,MATH 20E,A02,083772,Staff,18,0,30,12
1650577967101,MATH 20E,B01,083773,Staff,0,0,30,30
1650577967101,MATH 20E,B02,083774,Staff,9,0,30,21
1650577973124,MATH 103A,A01,083777,Staff,0,15,30,30
1650577973124,MATH 103A,A02,083778,Staff,0,14,30,30
1650577973124,MATH 103A,B01,083779,Staff,0,13,30,30
1650577973124,MATH 103A,B02,083780,Staff,0,13,30,30
1650577979148,MATH 105,A01,085443,Staff,0,21,30,30
1650577985176,MATH 109,A01,083213,Anzaldo; Leesa B,0,7,30,30
1650577985176,MATH 109,A02,083214,Anzaldo; Leesa B,0,7,30,30
1650577985176,MATH 109,B01,083215,Anzaldo; Leesa B,0,5,30,30
1650577985176,MATH 109,B02,083216,Anzaldo; Leesa B,0,6,30,30
1650577991201,MATH 142A,A01,083219,Chow; Bennett,0,16,30,30
1650577991201,MATH 142A,A02,083220,Chow; Bennett,0,15,30,30
1650577991201,MATH 142A,B01,083221,Chow; Bennett,0,14,30,30
1650577991201,MATH 142A,B02,083222,Chow; Bennett,0,13,30,30
1650577997239,MATH 193A,A01,083224,Staff,1,6,30,29
1650577997239,MATH 193A,A02,083225,Staff,0,6,30,30
1650577997239,MATH 193A,A03,083781,Staff,0,6,30,30
1650577997239,MATH 193A,A04,083782,Staff,0,7,30,30
1650578003271,MATH 197,001,091859,McAuley; Julian John,9998,0,9999,1
1650578009330,COGS 9,A01,083615,Staff,1,16,60,59
1650578015365,COGS 11,A01,083617,Boyle; Mary E. T.,18,0,40,22
1650578021398,COGS 13,A01,083071,Staff,0,37,40,40
1650578027421,COGS 14A,A01,092681,Staff,0,29,100,100
1650578033445,COGS 14B,A01,083073,Cheng; Tzu-Han,0,12,50,50
1650578039470,COGS 17,A01,092677,Staff,18,0,75,57
1650578045494,COGS 100,A01,083619,Staff,1,26,60,59
1650578051518,COGS 101A,A01,083621,Davis; Joshua Daniel,0,26,60,60
1650578057542,COGS 101B,A01,091572,Staff,1,5,60,59
1650578063575,COGS 101C,A01,083625,Delgado; Tania,15,0,30,15
1650578069609,COGS 107A,A01,083627,Boyle; Mary E. T.,0,12,60,60
1650578075645,COGS 118A,A01,083075,Staff,0,4,60,60
1650578081671,CSE 3,A50,083646,Miranda; Gregory Joseph,19,0,38,19
1650578081671,CSE 3,A51,083647,Miranda; Gregory Joseph,36,0,37,1
1650578087699,CSE 8A,A50,083650,Miranda; Gregory Joseph,0,29,40,40
1650578093722,CSE 11,A01,083080,Cao; Yingjun,0,93,40,40
1650578099746,CSE 12,A01,083652,Staff,0,19,100,100
1650578105772,CSE 15L,A01,083654,Staff,0,1,50,50
1650578105772,CSE 15L,A02,083655,Staff,0,1,50,50
1650578111796,CSE 20,A01,083657,Staff,51,0,80,29
1650578117819,CSE 30,A01,083084,Eldon; John,0,78,40,40
1650578123843,CSE 100,A01,083659,Cao; Yingjun,0,66,50,50
1650578129866,CSE 134B,A01,083661,Powell; Thomas Allan,0,35,65,65
1650578135889,CSE 140,A01,083663,Staff,0,7,75,75
1650578141913,CSE 140L,A01,083088,Eldon; John,0,13,75,75
1650578147944,CSE 175,A01,083665,Kumar; Rakesh,7,0,25,18
1650578153973,CSE 190,A00,092507,Dubnov; Shlomo,10,0,20,10
1650578159996,ECE 45,A01,083139,Staff,1,2,60,59
1650578166024,ECE 65,A50,083695,Staff,1,6,30,29
1650578172047,ECE 109,A01,091882,Touri; Behrouz,33,0,70,37
1650578178074,ECE 180,A00,083140,Abi Samra; Nicholas Camill,21,0,30,9
1650578178074,ECE 180,B00,083141,Abi Samra; Nicholas Camill,0,0,30,30
1650578184110,MATH 10A,A01,083735,Patchell; Gregory David,5,0,30,25
1650578184110,MATH 10A,A02,083736,Patchell; Gregory David,27,0,30,3
1650578184110,MATH 10A,A03,083737,Patchell; Gregory David,24,0,30,6
1650578190135,MATH 10B,A01,083207,Staff,0,9,30,30
1650578190135,MATH 10B,A02,083208,Staff,0,8,30,30
1650578190135,MATH 10B,B01,083739,Staff,11,0,30,19
1650578190135,MATH 10B,B02,083740,Staff,28,0,30,2
1650578196160,MATH 18,A01,083743,Staff,1,0,30,29
1650578196160,MATH 18,A02,083744,Staff,26,0,30,4
1650578196160,MATH 18,A03,083745,Staff,22,0,30,8
1650578196160,MATH 18,A04,083746,Staff,26,0,30,4
1650578196160,MATH 18,B01,083748,Staff,0,14,30,30
1650578196160,MATH 18,B02,083749,Staff,0,12,30,30
1650578196160,MATH 18,B03,083750,Staff,0,12,30,30
1650578196160,MATH 18,B04,083751,Staff,0,12,30,30
1650578202184,MATH 20A,A01,083754,Staff,21,0,40,19
1650578208211,MATH 20B,A01,083756,Staff,1,11,30,29
1650578208211,MATH 20B,A02,083757,Staff,0,12,30,30
1650578214246,MATH 20C,A01,083760,Staff,0,16,30,30
1650578214246,MATH 20C,A02,083761,Staff,2,14,30,28
1650578214246,MATH 20C,B01,083762,Staff,11,0,30,19
1650578214246,MATH 20C,B02,083763,Staff,28,0,30,2
1650578220277,MATH 20D,A01,083765,Staff,0,1,30,30
1650578220277,MATH 20D,A02,083766,Staff,7,0,30,23
1650578220277,MATH 20D,A03,083767,Staff,25,0,30,5
1650578226396,MATH 20E,A01,083771,Staff,7,0,30,23
1650578226396,MATH 20E,A02,083772,Staff,18,0,30,12
1650578226396,MATH 20E,B01,083773,Staff,0,0,30,30
1650578226396,MATH 20E,B02,083774,Staff,9,0,30,21
1650578232424,MATH 103A,A01,083777,Staff,0,15,30,30
1650578232424,MATH 103A,A02,083778,Staff,0,14,30,30
1650578232424,MATH 103A,B01,083779,Staff,0,13,30,30
1650578232424,MATH 103A,B02,083780,Staff,0,13,30,30
1650578238447,MATH 105,A01,085443,Staff,0,21,30,30
1650578244476,MATH 109,A01,083213,Anzaldo; Leesa B,0,7,30,30
1650578244476,MATH 109,A02,083214,Anzaldo; Leesa B,0,7,30,30
1650578244476,MATH 109,B01,083215,Anzaldo; Leesa B,0,5,30,30
1650578244476,MATH 109,B02,083216,Anzaldo; Leesa B,0,6,30,30
1650578250501,MATH 142A,A01,083219,Chow; Bennett,0,16,30,30
1650578250501,MATH 142A,A02,083220,Chow; Bennett,0,15,30,30
1650578250501,MATH 142A,B01,083221,Chow; Bennett,0,14,30,30
1650578250501,MATH 142A,B02,083222,Chow; Bennett,0,13,30,30
1650578256524,MATH 193A,A01,083224,Staff,1,6,30,29
1650578256524,MATH 193A,A02,083225,Staff,0,6,30,30
1650578256524,MATH 193A,A03,083781,Staff,0,6,30,30
1650578256524,MATH 193A,A04,083782,Staff,0,7,30,30
1650578262545,MATH 197,001,091859,McAuley; Julian John,9998,0,9999,1
1650578268619,COGS 9,A01,083615,Staff,1,16,60,59
1650578274645,COGS 11,A01,083617,Boyle; Mary E. T.,18,0,40,22
1650578280677,COGS 13,A01,083071,Staff,0,37,40,40
1650578286699,COGS 14A,A01,092681,Staff,0,29,100,100
1650578292724,COGS 14B,A01,083073,Cheng; Tzu-Han,0,12,50,50
1650578298750,COGS 17,A01,092677,Staff,18,0,75,57
1650578304802,COGS 100,A01,083619,Staff,1,26,60,59
1650578310836,COGS 101A,A01,083621,Davis; Joshua Daniel,0,26,60,60
1650578316871,COGS 101B,A01,091572,Staff,1,5,60,59
1650578322895,COGS 101C,A01,083625,Delgado; Tania,15,0,30,15
1650578328936,COGS 107A,A01,083627,Boyle; Mary E. T.,0,12,60,60
1650578334963,COGS 118A,A01,083075,Staff,0,4,60,60
1650578340997,CSE 3,A50,083646,Miranda; Gregory Joseph,19,0,38,19
1650578340997,CSE 3,A51,083647,Miranda; Gregory Joseph,36,0,37,1
1650578347021,CSE 8A,A50,083650,Miranda; Gregory Joseph,0,29,40,40
1650578353048,CSE 11,A01,083080,Cao; Yingjun,0,93,40,40
1650578359075,CSE 12,A01,083652,Staff,0,19,100,100
1650578365100,CSE 15L,A01,083654,Staff,0,1,50,50
1650578365100,CSE 15L,A02,083655,Staff,0,1,50,50
1650578371124,CSE 20,A01,083657,Staff,51,0,80,29
1650578377160,CSE 30,A01,083084,Eldon; John,0,78,40,40
1650578383190,CSE 100,A01,083659,Cao; Yingjun,0,66,50,50
1650578389226,CSE 134B,A01,083661,Powell; Thomas Allan,0,35,65,65
1650578395260,CSE 140,A01,083663,Staff,0,7,75,75
1650578401293,CSE 140L,A01,083088,Eldon; John,0,13,75,75
1650578407324,CSE 175,A01,083665,Kumar; Rakesh,7,0,25,18
1650578413348,CSE 190,A00,092507,Dubnov; Shlomo,10,0,20,10
1650578419378,ECE 45,A01,083139,Staff,1,2,60,59
1650578425401,ECE 65,A50,083695,Staff,1,6,30,29
1650578431434,ECE 109,A01,091882,Touri; Behrouz,33,0,70,37
1650578437459,ECE 180,A00,083140,Abi Samra; Nicholas Camill,21,0,30,9
1650578437459,ECE 180,B00,083141,Abi Samra; Nicholas Camill,0,0,30,30
1650578443483,MATH 10A,A01,083735,Patchell; Gregory David,5,0,30,25
1650578443483,MATH 10A,A02,083736,Patchell; Gregory David,27,0,30,3
1650578443483,MATH 10A,A03,083737,Patchell; Gregory David,24,0,30,6
1650578449510,MATH 10B,A01,083207,Staff,0,9,30,30
1650578449510,MATH 10B,A02,083208,Staff,0,8,30,30
1650578449510,MATH 10B,B01,083739,Staff,11,0,30,19
1650578449510,MATH 10B,B02,083740,Staff,28,0,30,2
1650578455542,MATH 18,A01,083743,Staff,1,0,30,29
1650578455542,MATH 18,A02,083744,Staff,26,0,30,4
1650578455542,MATH 18,A03,083745,Staff,22,0,30,8
1650578455542,MATH 18,A04,083746,Staff,26,0,30,4
1650578455542,MATH 18,B01,083748,Staff,0,14,30,30
1650578455542,MATH 18,B02,083749,Staff,0,12,30,30
1650578455542,MATH 18,B03,083750,Staff,0,12,30,30
1650578455542,MATH 18,B04,083751,Staff,0,12,30,30
1650578461565,MATH 20A,A01,083754,Staff,21,0,40,19
1650578467593,MATH 20B,A01,083756,Staff,1,11,30,29
1650578467593,MATH 20B,A02,083757,Staff,0,12,30,30
1650578473629,MATH 20C,A01,083760,Staff,0,16,30,30
1650578473629,MATH 20C,A02,083761,Staff,2,14,30,28
1650578473629,MATH 20C,B01,083762,Staff,11,0,30,19
1650578473629,MATH 20C,B02,083763,Staff,28,0,30,2
1650578479661,MATH 20D,A01,083765,Staff,0,1,30,30
1650578479661,MATH 20D,A02,083766,Staff,7,0,30,23
1650578479661,MATH 20D,A03,083767,Staff,25,0,30,5
1650578485688,MATH 20E,A01,083771,Staff,7,0,30,23
1650578485688,MATH 20E,A02,083772,Staff,18,0,30,12
1650578485688,MATH 20E,B01,083773,Staff,0,0,30,30
1650578485688,MATH 20E,B02,083774,Staff,9,0,30,21
1650578491717,MATH 103A,A01,083777,Staff,0,15,30,30
1650578491717,MATH 103A,A02,083778,Staff,0,14,30,30
1650578491717,MATH 103A,B01,083779,Staff,0,13,30,30
1650578491717,MATH 103A,B02,083780,Staff,0,13,30,30
1650578497744,MATH 105,A01,085443,Staff,0,21,30,30
1650578503776,MATH 109,A01,083213,Anzaldo; Leesa B,0,7,30,30
1650578503776,MATH 109,A02,083214,Anzaldo; Leesa B,0,7,30,30
1650578503776,MATH 109,B01,083215,Anzaldo; Leesa B,0,5,30,30
1650578503776,MATH 109,B02,083216,Anzaldo; Leesa B,0,6,30,30
1650578509804,MATH 142A,A01,083219,Chow; Bennett,0,16,30,30
1650578509804,MATH 142A,A02,083220,Chow; Bennett,0,15,30,30
1650578509804,MATH 142A,B01,083221,Chow; Bennett,0,14,30,30
1650578509804,MATH 142A,B02,083222,Chow; Bennett,0,13,30,30
1650578515835,MATH 193A,A01,083224,Staff,1,6,30,29
1650578515835,MATH 193A,A02,083225,Staff,0,6,30,30
1650578515835,MATH 193A,A03,083781,Staff,0,6,30,30
1650578515835,MATH 193A,A04,083782,Staff,0,7,30,30
1650578521881,MATH 197,001,091859,McAuley; Julian John,9998,0,9999,1
1650578527973,COGS 9,A01,083615,Staff,1,16,60,59
1650578534010,COGS 11,A01,083617,Boyle; Mary E. T.,18,0,40,22
1650578540054,COGS 13,A01,083071,Staff,0,37,40,40
1650578546078,COGS 14A,A01,092681,Staff,0,29,100,100
1650578552101,COGS 14B,A01,083073,Cheng; Tzu-Han,0,12,50,50
1650578558128,COGS 17,A01,092677,Staff,18,0,75,57
1650578564167,COGS 100,A01,083619,Staff,1,26,60,59
1650578570190,COGS 101A,A01,083621,Davis; Joshua Daniel,0,26,60,60
1650578576222,COGS 101B,A01,091572,Staff,1,5,60,59
1650578582248,COGS 101C,A01,083625,Delgado; Tania,15,0,30,15
1650578588277,COGS 107A,A01,083627,Boyle; Mary E. T.,0,12,60,60
1650578594301,COGS 118A,A01,083075,Staff,0,4,60,60
1650578600334,CSE 3,A50,083646,Miranda; Gregory Joseph,19,0,38,19
1650578600334,CSE 3,A51,083647,Miranda; Gregory Joseph,36,0,37,1
1650578606370,CSE 8A,A50,083650,Miranda; Gregory Joseph,0,29,40,40
1650578612404,CSE 11,A01,083080,Cao; Yingjun,0,93,40,40
1650578618429,CSE 12,A01,083652,Staff,0,19,100,100
1650578624455,CSE 15L,A01,083654,Staff,0,1,50,50
1650578624455,CSE 15L,A02,083655,Staff,0,1,50,50
1650578630479,CSE 20,A01,083657,Staff,51,0,80,29
1650578636510,CSE 30,A01,083084,Eldon; John,0,78,40,40
1650578642541,CSE 100,A01,083659,Cao; Yingjun,0,66,50,50
1650578648567,CSE 134B,A01,083661,Powell; Thomas Allan,0,35,65,65
1650578654590,CSE 140,A01,083663,Staff,0,7,75,75
1650578660614,CSE 140L,A01,083088,Eldon; John,0,13,75,75
1650578666636,CSE 175,A01,083665,Kumar; Rakesh,7,0,25,18
1650578672660,CSE 190,A00,092507,Dubnov; Shlomo,10,0,20,10
1650578678692,ECE 45,A01,083139,Staff,1,2,60,59
1650578684722,ECE 65,A50,083695,Staff,1,6,30,29
1650578690747,ECE 109,A01,091882,Touri; Behrouz,33,0,70,37
1650578696781,ECE 180,A00,083140,Abi Samra; Nicholas Camill,21,0,30,9
1650578696781,ECE 180,B00,083141,Abi Samra; Nicholas Camill,0,0,30,30
1650578702806,MATH 10A,A01,083735,Patchell; Gregory David,5,0,30,25
1650578702806,MATH 10A,A02,083736,Patchell; Gregory David,27,0,30,3
1650578702806,MATH 10A,A03,083737,Patchell; Gregory David,24,0,30,6
1650578708828,MATH 10B,A01,083207,Staff,0,9,30,30
1650578708828,MATH 10B,A02,083208,Staff,0,8,30,30
1650578708828,MATH 10B,B01,083739,Staff,11,0,30,19
1650578708828,MATH 10B,B02,083740,Staff,28,0,30,2
1650578714859,MATH 18,A01,083743,Staff,1,0,30,29
1650578714859,MATH 18,A02,083744,Staff,26,0,30,4
1650578714859,MATH 18,A03,083745,Staff,22,0,30,8
1650578714859,MATH 18,A04,083746,Staff,26,0,30,4
1650578714859,MATH 18,B01,083748,Staff,0,14,30,30
1650578714859,MATH 18,B02,083749,Staff,0,12,30,30
1650578714859,MATH 18,B03,083750,Staff,0,12,30,30
1650578714859,MATH 18,B04,083751,Staff,0,12,30,30
1650578720885,MATH 20A,A01,083754,Staff,21,0,40,19
1650578726913,MATH 20B,A01,083756,Staff,1,11,30,29
1650578726913,MATH 20B,A02,083757,Staff,0,12,30,30
1650578732943,MATH 20C,A01,083760,Staff,0,16,30,30
1650578732943,MATH 20C,A02,083761,Staff,2,14,30,28
1650578732943,MATH 20C,B01,083762,Staff,11,0,30,19
1650578732943,MATH 20C,B02,083763,Staff,28,0,30,2
1650578738973,MATH 20D,A01,083765,Staff,0,1,30,30
1650578738973,MATH 20D,A02,083766,Staff,7,0,30,23
1650578738973,MATH 20D,A03,083767,Staff,25,0,30,5
1650578745009,MATH 20E,A01,083771,Staff,7,0,30,23
1650578745009,MATH 20E,A02,083772,Staff,18,0,30,12
1650578745009,MATH 20E,B01,083773,Staff,0,0,30,30
1650578745009,MATH 20E,B02,083774,Staff,9,0,30,21
1650578751047,MATH 103A,A01,083777,Staff,0,15,30,30
1650578751047,MATH 103A,A02,083778,Staff,0,14,30,30
1650578751047,MATH 103A,B01,083779,Staff,0,13,30,30
1650578751047,MATH 103A,B02,083780,Staff,0,13,30,30
1650578757071,MATH 105,A01,085443,Staff,0,21,30,30
1650578763099,MATH 109,A01,083213,Anzaldo; Leesa B,0,7,30,30
1650578763099,MATH 109,A02,083214,Anzaldo; Leesa B,0,7,30,30
1650578763099,MATH 109,B01,083215,Anzaldo; Leesa B,0,5,30,30
1650578763099,MATH 109,B02,083216,Anzaldo; Leesa B,0,6,30,30
1650578769128,MATH 142A,A01,083219,Chow; Bennett,0,16,30,30
1650578769128,MATH 142A,A02,083220,Chow; Bennett,0,15,30,30
1650578769128,MATH 142A,B01,083221,Chow; Bennett,0,14,30,30
1650578769128,MATH 142A,B02,083222,Chow; Bennett,0,13,30,30
1650578775152,MATH 193A,A01,083224,Staff,1,6,30,29
1650578775152,MATH 193A,A02,083225,Staff,0,6,30,30
1650578775152,MATH 193A,A03,083781,Staff,0,6,30,30
1650578775152,MATH 193A,A04,083782,Staff,0,7,30,30
1650578781178,MATH 197,001,091859,McAuley; Julian John,9998,0,9999,1
1650578787227,COGS 9,A01,083615,Staff,1,16,60,59
1650578793253,COGS 11,A01,083617,Boyle; Mary E. T.,18,0,40,22
1650578799281,COGS 13,A01,083071,Staff,0,37,40,40
1650578805305,COGS 14A,A01,092681,Staff,0,29,100,100
1650578811328,COGS 14B,A01,083073,Cheng; Tzu-Han,0,12,50,50
1650578817433,COGS 17,A01,092677,Staff,18,0,75,57
1650578823466,COGS 100,A01,083619,Staff,1,26,60,59
1650578829488,COGS 101A,A01,083621,Davis; Joshua Daniel,0,26,60,60
1650578835521,COGS 101B,A01,091572,Staff,1,5,60,59
1650578841545,COGS 101C,A01,083625,Delgado; Tania,15,0,30,15
1650578847574,COGS 107A,A01,083627,Boyle; Mary E. T.,0,12,60,60
1650578853599,COGS 118A,A01,083075,Staff,0,4,60,60
1650578859624,CSE 3,A50,083646,Miranda; Gregory Joseph,19,0,38,19
1650578859624,CSE 3,A51,083647,Miranda; Gregory Joseph,36,0,37,1
1650578865647,CSE 8A,A50,083650,Miranda; Gregory Joseph,0,29,40,40
1650578871669,CSE 11,A01,083080,Cao; Yingjun,0,93,40,40
1650578877690,CSE 12,A01,083652,Staff,0,19,100,100
1650578883716,CSE 15L,A01,083654,Staff,0,1,50,50
1650578883716,CSE 15L,A02,083655,Staff,0,1,50,50
1650578889744,CSE 20,A01,083657,Staff,51,0,80,29
1650578895775,CSE 30,A01,083084,Eldon; John,0,78,40,40
1650578901798,CSE 100,A01,083659,Cao; Yingjun,0,66,50,50
1650578907822,CSE 134B,A01,083661,Powell; Thomas Allan,0,35,65,65
1650578913846,CSE 140,A01,083663,Staff,0,7,75,75
1650578919870,CSE 140L,A01,083088,Eldon; John,0,13,75,75
1650578925893,CSE 175,A01,083665,Kumar; Rakesh,7,0,25,18
1650578931923,CSE 190,A00,092507,Dubnov; Shlomo,10,0,20,10
1650578937948,ECE 45,A01,083139,Staff,1,2,60,59
1650578943973,ECE 65,A50,083695,Staff,1,6,30,29
1650578950010,ECE 109,A01,091882,Touri; Behrouz,33,0,70,37
1650578956039,ECE 180,A00,083140,Abi Samra; Nicholas Camill,21,0,30,9
1650578956039,ECE 180,B00,083141,Abi Samra; Nicholas Camill,0,0,30,30
1650578962075,MATH 10A,A01,083735,Patchell; Gregory David,5,0,30,25
1650578962075,MATH 10A,A02,083736,Patchell; Gregory David,27,0,30,3
1650578962075,MATH 10A,A03,083737,Patchell; Gregory David,24,0,30,6
1650578968102,MATH 10B,A01,083207,Staff,0,9,30,30
1650578968102,MATH 10B,A02,083208,Staff,0,8,30,30
1650578968102,MATH 10B,B01,083739,Staff,11,0,30,19
1650578968102,MATH 10B,B02,083740,Staff,28,0,30,2
1650578974125,MATH 18,A01,083743,Staff,1,0,30,29
1650578974125,MATH 18,A02,083744,Staff,26,0,30,4
1650578974125,MATH 18,A03,083745,Staff,22,0,30,8
1650578974125,MATH 18,A04,083746,Staff,26,0,30,4
1650578974125,MATH 18,B01,083748,Staff,0,14,30,30
1650578974125,MATH 18,B02,083749,Staff,0,12,30,30
1650578974125,MATH 18,B03,083750,Staff,0,12,30,30
1650578974125,MATH 18,B04,083751,Staff,0,12,30,30
1650578980150,MATH 20A,A01,083754,Staff,21,0,40,19
1650578986177,MATH 20B,A01,083756,Staff,1,11,30,29
1650578986177,MATH 20B,A02,083757,Staff,0,12,30,30
1650578992204,MATH 20C,A01,083760,Staff,0,16,30,30
1650578992204,MATH 20C,A02,083761,Staff,2,14,30,28
1650578992204,MATH 20C,B01,083762,Staff,11,0,30,19
1650578992204,MATH 20C,B02,083763,Staff,28,0,30,2
1650578998231,MATH 20D,A01,083765,Staff,0,1,30,30
1650578998231,MATH 20D,A02,083766,Staff,7,0,30,23
1650578998231,MATH 20D,A03,083767,Staff,25,0,30,5
1650579004258,MATH 20E,A01,083771,Staff,7,0,30,23
1650579004258,MATH 20E,A02,083772,Staff,18,0,30,12
1650579004258,MATH 20E,B01,083773,Staff,0,0,30,30
1650579004258,MATH 20E,B02,083774,Staff,9,0,30,21
1650579010290,MATH 103A,A01,083777,Staff,0,15,30,30
1650579010290,MATH 103A,A02,083778,Staff,0,14,30,30
1650579010290,MATH 103A,B01,083779,Staff,0,13,30,30
1650579010290,MATH 103A,B02,083780,Staff,0,13,30,30
1650579016329,MATH 105,A01,085443,Staff,0,21,30,30
1650579022351,MATH 109,A01,083213,Anzaldo; Leesa B,0,7,30,30
1650579022351,MATH 109,A02,083214,Anzaldo; Leesa B,0,7,30,30
1650579022351,MATH 109,B01,083215,Anzaldo; Leesa B,0,5,30,30
1650579022351,MATH 109,B02,083216,Anzaldo; Leesa B,0,6,30,30
1650579028376,MATH 142A,A01,083219,Chow; Bennett,0,16,30,30
1650579028376,MATH 142A,A02,083220,Chow; Bennett,0,15,30,30
1650579028376,MATH 142A,B01,083221,Chow; Bennett,0,14,30,30
1650579028376,MATH 142A,B02,083222,Chow; Bennett,0,13,30,30
1650579034407,MATH 193A,A01,083224,Staff,1,6,30,29
1650579034407,MATH 193A,A02,083225,Staff,0,6,30,30
1650579034407,MATH 193A,A03,083781,Staff,0,6,30,30
1650579034407,MATH 193A,A04,083782,Staff,0,7,30,30
1650579040434,MATH 197,001,091859,McAuley; Julian John,9998,0,9999,1
1650579046513,COGS 9,A01,083615,Staff,1,17,60,59
1650579052542,COGS 11,A01,083617,Boyle; Mary E. T.,18,0,40,22
1650579058568,COGS 13,A01,083071,Staff,0,37,40,40
1650579064590,COGS 14A,A01,092681,Staff,0,29,100,100
1650579070615,COGS 14B,A01,083073,Cheng; Tzu-Han,0,12,50,50
1650579076642,COGS 17,A01,092677,Staff,18,0,75,57
1650579082665,COGS 100,A01,083619,Staff,1,26,60,59
1650579088698,COGS 101A,A01,083621,Davis; Joshua Daniel,0,26,60,60
1650579094725,COGS 101B,A01,091572,Staff,1,5,60,59
1650579100759,COGS 101C,A01,083625,Delgado; Tania,15,0,30,15
1650579106786,COGS 107A,A01,083627,Boyle; Mary E. T.,0,12,60,60
1650579112809,COGS 118A,A01,083075,Staff,0,4,60,60
1650579118833,CSE 3,A50,083646,Miranda; Gregory Joseph,19,0,38,19
1650579118833,CSE 3,A51,083647,Miranda; Gregory Joseph,36,0,37,1
1650579124862,CSE 8A,A50,083650,Miranda; Gregory Joseph,0,29,40,40
1650579130888,CSE 11,A01,083080,Cao; Yingjun,0,93,40,40
1650579136912,CSE 12,A01,083652,Staff,0,19,100,100
1650579142938,CSE 15L,A01,083654,Staff,0,1,50,50
1650579142938,CSE 15L,A02,083655,Staff,0,1,50,50
1650579148964,CSE 20,A01,083657,Staff,51,0,80,29
1650579154988,CSE 30,A01,083084,Eldon; John,0,78,40,40
1650579161031,CSE 100,A01,083659,Cao; Yingjun,0,66,50,50
1650579167057,CSE 134B,A01,083661,Powell; Thomas Allan,0,35,65,65
1650579173081,CSE 140,A01,083663,Staff,1,7,75,74
1650579179106,CSE 140L,A01,083088,Eldon; John,1,13,75,74
1650579185133,CSE 175,A01,083665,Kumar; Rakesh,7,0,25,18
1650579191156,CSE 190,A00,092507,Dubnov; Shlomo,10,0,20,10
1650579197186,ECE 45,A01,083139,Staff,1,2,60,59
1650579203210,ECE 65,A50,083695,Staff,1,6,30,29
1650579209242,ECE 109,A01,091882,Touri; Behrouz,33,0,70,37
1650579215265,ECE 180,A00,083140,Abi Samra; Nicholas Camill,21,0,30,9
1650579215265,ECE 180,B00,083141,Abi Samra; Nicholas Camill,0,0,30,30
1650579221293,MATH 10A,A01,083735,Patchell; Gregory David,5,0,30,25
1650579221293,MATH 10A,A02,083736,Patchell; Gregory David,27,0,30,3
1650579221293,MATH 10A,A03,083737,Patchell; Gregory David,24,0,30,6
1650579227325,MATH 10B,A01,083207,Staff,0,9,30,30
1650579227325,MATH 10B,A02,083208,Staff,0,8,30,30
1650579227325,MATH 10B,B01,083739,Staff,11,0,30,19
1650579227325,MATH 10B,B02,083740,Staff,28,0,30,2
1650579233354,MATH 18,A01,083743,Staff,1,0,30,29
1650579233354,MATH 18,A02,083744,Staff,26,0,30,4
1650579233354,MATH 18,A03,083745,Staff,22,0,30,8
1650579233354,MATH 18,A04,083746,Staff,26,0,30,4
1650579233354,MATH 18,B01,083748,Staff,0,14,30,30
1650579233354,MATH 18,B02,083749,Staff,0,12,30,30
1650579233354,MATH 18,B03,083750,Staff,0,12,30,30
1650579233354,MATH 18,B04,083751,Staff,0,12,30,30
1650579239378,MATH 20A,A01,083754,Staff,21,0,40,19
1650579245402,MATH 20B,A01,083756,Staff,1,11,30,29
1650579245402,MATH 20B,A02,083757,Staff,0,12,30,30
1650579251424,MATH 20C,A01,083760,Staff,0,16,30,30
1650579251424,MATH 20C,A02,083761,Staff,2,14,30,28
1650579251424,MATH 20C,B01,083762,Staff,11,0,30,19
1650579251424,MATH 20C,B02,083763,Staff,28,0,30,2
1650579257452,MATH 20D,A01,083765,Staff,0,1,30,30
1650579257452,MATH 20D,A02,083766,Staff,7,0,30,23
1650579257452,MATH 20D,A03,083767,Staff,25,0,30,5
1650579263477,MATH 20E,A01,083771,Staff,7,0,30,23
1650579263477,MATH 20E,A02,083772,Staff,18,0,30,12
1650579263477,MATH 20E,B01,083773,Staff,0,0,30,30
1650579263477,MATH 20E,B02,083774,Staff,9,0,30,21
1650579269509,MATH 103A,A01,083777,Staff,0,15,30,30
1650579269509,MATH 103A,A02,083778,Staff,0,14,30,30
1650579269509,MATH 103A,B01,083779,Staff,0,13,30,30
1650579269509,MATH 103A,B02,083780,Staff,0,13,30,30
1650579275532,MATH 105,A01,085443,Staff,0,21,30,30
1650579281556,MATH 109,A01,083213,Anzaldo; Leesa B,0,7,30,30
1650579281556,MATH 109,A02,083214,Anzaldo; Leesa B,0,7,30,30
1650579281556,MATH 109,B01,083215,Anzaldo; Leesa B,0,5,30,30
1650579281556,MATH 109,B02,083216,Anzaldo; Leesa B,0,6,30,30
1650579287581,MATH 142A,A01,083219,Chow; Bennett,0,16,30,30
1650579287581,MATH 142A,A02,083220,Chow; Bennett,0,15,30,30
1650579287581,MATH 142A,B01,083221,Chow; Bennett,0,14,30,30
1650579287581,MATH 142A,B02,083222,Chow; Bennett,0,13,30,30
1650579293614,MATH 193A,A01,083224,Staff,1,6,30,29
1650579293614,MATH 193A,A02,083225,Staff,0,6,30,30
1650579293614,MATH 193A,A03,083781,Staff,0,6,30,30
1650579293614,MATH 193A,A04,083782,Staff,0,7,30,30
1650579299638,MATH 197,001,091859,McAuley; Julian John,9998,0,9999,1
1650579305697,COGS 9,A01,083615,Staff,1,17,60,59
1650579311731,COGS 11,A01,083617,Boyle; Mary E. T.,18,0,40,22
1650579317757,COGS 13,A01,083071,Staff,0,37,40,40
1650579323781,COGS 14A,A01,092681,Staff,0,29,100,100
1650579329806,COGS 14B,A01,083073,Cheng; Tzu-Han,0,13,50,50
1650579335838,COGS 17,A01,092677,Staff,18,0,75,57
1650579341869,COGS 100,A01,083619,Staff,1,26,60,59
1650579347898,COGS 101A,A01,083621,Davis; Joshua Daniel,0,26,60,60
1650579353928,COGS 101B,A01,091572,Staff,1,5,60,59
1650579359980,COGS 101C,A01,083625,Delgado; Tania,15,0,30,15
1650579366004,COGS 107A,A01,083627,Boyle; Mary E. T.,0,12,60,60
1650579372028,COGS 118A,A01,083075,Staff,0,4,60,60
1650579378052,CSE 3,A50,083646,Miranda; Gregory Joseph,19,0,38,19
1650579378052,CSE 3,A51,083647,Miranda; Gregory Joseph,36,0,37,1
1650579384079,CSE 8A,A50,083650,Miranda; Gregory Joseph,0,29,40,40
1650579390108,CSE 11,A01,083080,Cao; Yingjun,0,93,40,40
1650579396132,CSE 12,A01,083652,Staff,0,19,100,100
1650579402160,CSE 15L,A01,083654,Staff,0,1,50,50
1650579402160,CSE 15L,A02,083655,Staff,0,1,50,50
1650579408195,CSE 20,A01,083657,Staff,51,0,80,29
1650579414309,CSE 30,A01,083084,Eldon; John,0,78,40,40
1650579420336,CSE 100,A01,083659,Cao; Yingjun,0,66,50,50
1650579426372,CSE 134B,A01,083661,Powell; Thomas Allan,0,35,65,65
1650579432396,CSE 140,A01,083663,Staff,1,7,75,74
1650579438422,CSE 140L,A01,083088,Eldon; John,1,13,75,74
1650579444448,CSE 175,A01,083665,Kumar; Rakesh,7,0,25,18
1650579450471,CSE 190,A00,092507,Dubnov; Shlomo,10,0,20,10
1650579456496,ECE 45,A01,083139,Staff,1,2,60,59
1650579462519,ECE 65,A50,083695,Staff,1,6,30,29
1650579468542,ECE 109,A01,091882,Touri; Behrouz,33,0,70,37
1650579474569,ECE 180,A00,083140,Abi Samra; Nicholas Camill,21,0,30,9
1650579474569,ECE 180,B00,083141,Abi Samra; Nicholas Camill,0,0,30,30
1650579480598,MATH 10A,A01,083735,Patchell; Gregory David,5,0,30,25
1650579480598,MATH 10A,A02,083736,Patchell; Gregory David,27,0,30,3
1650579480598,MATH 10A,A03,083737,Patchell; Gregory David,24,0,30,6
1650579486635,MATH 10B,A01,083207,Staff,0,9,30,30
1650579486635,MATH 10B,A02,083208,Staff,0,8,30,30
1650579486635,MATH 10B,B01,083739,Staff,11,0,30,19
1650579486635,MATH 10B,B02,083740,Staff,28,0,30,2
1650579492660,MATH 18,A01,083743,Staff,1,0,30,29
1650579492660,MATH 18,A02,083744,Staff,26,0,30,4
1650579492660,MATH 18,A03,083745,Staff,22,0,30,8
1650579492660,MATH 18,A04,083746,Staff,26,0,30,4
1650579492660,MATH 18,B01,083748,Staff,0,14,30,30
1650579492660,MATH 18,B02,083749,Staff,0,12,30,30
1650579492660,MATH 18,B03,083750,Staff,0,12,30,30
1650579492660,MATH 18,B04,083751,Staff,0,12,30,30
1650579498691,MATH 20A,A01,083754,Staff,21,0,40,19
1650579504726,MATH 20B,A01,083756,Staff,1,11,30,29
1650579504726,MATH 20B,A02,083757,Staff,0,12,30,30
1650579510753,MATH 20C,A01,083760,Staff,0,16,30,30
1650579510753,MATH 20C,A02,083761,Staff,2,14,30,28
1650579510753,MATH 20C,B01,083762,Staff,11,0,30,19
1650579510753,MATH 20C,B02,083763,Staff,28,0,30,2
1650579516780,MATH 20D,A01,083765,Staff,0,1,30,30
1650579516780,MATH 20D,A02,083766,Staff,7,0,30,23
1650579516780,MATH 20D,A03,083767,Staff,25,0,30,5
1650579522803,MATH 20E,A01,083771,Staff,6,0,30,24
1650579522803,MATH 20E,A02,083772,Staff,18,0,30,12
1650579522803,MATH 20E,B01,083773,Staff,0,0,30,30
1650579522803,MATH 20E,B02,083774,Staff,9,0,30,21
1650579528830,MATH 103A,A01,083777,Staff,0,15,30,30
1650579528830,MATH 103A,A02,083778,Staff,0,14,30,30
1650579528830,MATH 103A,B01,083779,Staff,0,13,30,30
1650579528830,MATH 103A,B02,083780,Staff,0,13,30,30
1650579534864,MATH 105,A01,085443,Staff,0,21,30,30
1650579540892,MATH 109,A01,083213,Anzaldo; Leesa B,0,7,30,30
1650579540892,MATH 109,A02,083214,Anzaldo; Leesa B,0,7,30,30
1650579540892,MATH 109,B01,083215,Anzaldo; Leesa B,0,5,30,30
1650579540892,MATH 109,B02,083216,Anzaldo; Leesa B,0,6,30,30
1650579546928,MATH 142A,A01,083219,Chow; Bennett,0,16,30,30
1650579546928,MATH 142A,A02,083220,Chow; Bennett,0,15,30,30
1650579546928,MATH 142A,B01,083221,Chow; Bennett,0,14,30,30
1650579546928,MATH 142A,B02,083222,Chow; Bennett,0,13,30,30
1650579552951,MATH 193A,A01,083224,Staff,1,6,30,29
1650579552951,MATH 193A,A02,083225,Staff,0,6,30,30
1650579552951,MATH 193A,A03,083781,Staff,0,6,30,30
1650579552951,MATH 193A,A04,083782,Staff,0,7,30,30
1650579558985,MATH 197,001,091859,McAuley; Julian John,9998,0,9999,1
1650579565051,COGS 9,A01,083615,Staff,1,17,60,59
1650579571077,COGS 11,A01,083617,Boyle; Mary E. T.,18,0,40,22
1650579577102,COGS 13,A01,083071,Staff,0,37,40,40
1650579583138,COGS 14A,A01,092681,Staff,0,29,100,100
1650579589162,COGS 14B,A01,083073,Cheng; Tzu-Han,0,13,50,50
1650579595198,COGS 17,A01,092677,Staff,18,0,75,57
1650579601229,COGS 100,A01,083619,Staff,1,26,60,59
1650579607252,COGS 101A,A01,083621,Davis; Joshua Daniel,0,26,60,60
1650579613275,COGS 101B,A01,091572,Staff,1,5,60,59
1650579619308,COGS 101C,A01,083625,Delgado; Tania,15,0,30,15
1650579625346,COGS 107A,A01,083627,Boyle; Mary E. T.,0,12,60,60
1650579631368,COGS 118A,A01,083075,Staff,0,4,60,60
1650579637396,CSE 3,A50,083646,Miranda; Gregory Joseph,19,0,38,19
1650579637396,CSE 3,A51,083647,Miranda; Gregory Joseph,36,0,37,1
1650579643420,CSE 8A,A50,083650,Miranda; Gregory Joseph,0,29,40,40
1650579649443,CSE 11,A01,083080,Cao; Yingjun,0,94,40,40
1650579655473,CSE 12,A01,083652,Staff,0,19,100,100
1650579661506,CSE 15L,A01,083654,Staff,0,1,50,50
1650579661506,CSE 15L,A02,083655,Staff,0,1,50,50
1650579667536,CSE 20,A01,083657,Staff,51,0,80,29
1650579673576,CSE 30,A01,083084,Eldon; John,0,78,40,40
1650579679607,CSE 100,A01,083659,Cao; Yingjun,0,66,50,50
1650579685637,CSE 134B,A01,083661,Powell; Thomas Allan,0,35,65,65
1650579691662,CSE 140,A01,083663,Staff,1,7,75,74
1650579697686,CSE 140L,A01,083088,Eldon; John,1,13,75,74
1650579703718,CSE 175,A01,083665,Kumar; Rakesh,7,0,25,18
1650579709743,CSE 190,A00,092507,Dubnov; Shlomo,10,0,20,10
1650579715773,ECE 45,A01,083139,Staff,1,2,60,59
1650579721795,ECE 65,A50,083695,Staff,1,6,30,29
1650579727825,ECE 109,A01,091882,Touri; Behrouz,33,0,70,37
1650579733864,ECE 180,A00,083140,Abi Samra; Nicholas Camill,21,0,30,9
1650579733864,ECE 180,B00,083141,Abi Samra; Nicholas Camill,0,0,30,30
1650579739889,MATH 10A,A01,083735,Patchell; Gregory David,5,0,30,25
1650579739889,MATH 10A,A02,083736,Patchell; Gregory David,27,0,30,3
1650579739889,MATH 10A,A03,083737,Patchell; Gregory David,24,0,30,6
1650579745917,MATH 10B,A01,083207,Staff,0,9,30,30
1650579745917,MATH 10B,A02,083208,Staff,0,8,30,30
1650579745917,MATH 10B,B01,083739,Staff,11,0,30,19
1650579745917,MATH 10B,B02,083740,Staff,28,0,30,2
1650579751943,MATH 18,A01,083743,Staff,1,0,30,29
1650579751943,MATH 18,A02,083744,Staff,26,0,30,4
1650579751943,MATH 18,A03,083745,Staff,22,0,30,8
1650579751943,MATH 18,A04,083746,Staff,26,0,30,4
1650579751943,MATH 18,B01,083748,Staff,0,14,30,30
1650579751943,MATH 18,B02,083749,Staff,0,12,30,30
1650579751943,MATH 18,B03,083750,Staff,0,12,30,30
1650579751943,MATH 18,B04,083751,Staff,0,12,30,30
1650579757969,MATH 20A,A01,083754,Staff,21,0,40,19
1650579763996,MATH 20B,A01,083756,Staff,1,11,30,29
1650579763996,MATH 20B,A02,083757,Staff,0,12,30,30
1650579770019,MATH 20C,A01,083760,Staff,0,16,30,30
1650579770019,MATH 20C,A02,083761,Staff,2,14,30,28
1650579770019,MATH 20C,B01,083762,Staff,11,0,30,19
1650579770019,MATH 20C,B02,083763,Staff,28,0,30,2
1650579776042,MATH 20D,A01,083765,Staff,0,1,30,30
1650579776042,MATH 20D,A02,083766,Staff,7,0,30,23
1650579776042,MATH 20D,A03,083767,Staff,25,0,30,5
1650579782071,MATH 20E,A01,083771,Staff,6,0,30,24
1650579782071,MATH 20E,A02,083772,Staff,18,0,30,12
1650579782071,MATH 20E,B01,083773,Staff,0,0,30,30
1650579782071,MATH 20E,B02,083774,Staff,9,0,30,21
1650579788099,MATH 103A,A01,083777,Staff,0,15,30,30
1650579788099,MATH 103A,A02,083778,Staff,0,14,30,30
1650579788099,MATH 103A,B01,083779,Staff,0,13,30,30
1650579788099,MATH 103A,B02,083780,Staff,0,13,30,30
1650579794120,MATH 105,A01,085443,Staff,0,21,30,30
1650579800151,MATH 109,A01,083213,Anzaldo; Leesa B,0,7,30,30
1650579800151,MATH 109,A02,083214,Anzaldo; Leesa B,0,7,30,30
1650579800151,MATH 109,B01,083215,Anzaldo; Leesa B,0,5,30,30
1650579800151,MATH 109,B02,083216,Anzaldo; Leesa B,0,6,30,30
1650579806181,MATH 142A,A01,083219,Chow; Bennett,0,16,30,30
1650579806181,MATH 142A,A02,083220,Chow; Bennett,0,15,30,30
1650579806181,MATH 142A,B01,083221,Chow; Bennett,0,14,30,30
1650579806181,MATH 142A,B02,083222,Chow; Bennett,0,13,30,30
1650579812223,MATH 193A,A01,083224,Staff,1,6,30,29
1650579812223,MATH 193A,A02,083225,Staff,0,6,30,30
1650579812223,MATH 193A,A03,083781,Staff,0,6,30,30
1650579812223,MATH 193A,A04,083782,Staff,0,7,30,30
1650579818266,MATH 197,001,091859,McAuley; Julian John,9998,0,9999,1
1650579824337,COGS 9,A01,083615,Staff,1,17,60,59
1650579830363,COGS 11,A01,083617,Boyle; Mary E. T.,18,0,40,22
1650579836387,COGS 13,A01,083071,Staff,0,37,40,40
1650579842421,COGS 14A,A01,092681,Staff,0,29,100,100
1650579848447,COGS 14B,A01,083073,Cheng; Tzu-Han,0,13,50,50
1650579854473,COGS 17,A01,092677,Staff,18,0,75,57
1650579860495,COGS 100,A01,083619,Staff,1,26,60,59
1650579866521,COGS 101A,A01,083621,Davis; Joshua Daniel,0,26,60,60
1650579872547,COGS 101B,A01,091572,Staff,1,5,60,59
1650579878573,COGS 101C,A01,083625,Delgado; Tania,15,0,30,15
1650579884596,COGS 107A,A01,083627,Boyle; Mary E. T.,0,12,60,60
1650579890619,COGS 118A,A01,083075,Staff,0,4,60,60
1650579896649,CSE 3,A50,083646,Miranda; Gregory Joseph,19,0,38,19
1650579896649,CSE 3,A51,083647,Miranda; Gregory Joseph,36,0,37,1
1650579902685,CSE 8A,A50,083650,Miranda; Gregory Joseph,0,29,40,40
1650579908710,CSE 11,A01,083080,Cao; Yingjun,0,94,40,40
1650579914733,CSE 12,A01,083652,Staff,0,19,100,100
1650579920758,CSE 15L,A01,083654,Staff,0,1,50,50
1650579920758,CSE 15L,A02,083655,Staff,0,1,50,50
1650579926787,CSE 20,A01,083657,Staff,51,0,80,29
1650579932812,CSE 30,A01,083084,Eldon; John,0,78,40,40
1650579938845,CSE 100,A01,083659,Cao; Yingjun,0,66,50,50
1650579944873,CSE 134B,A01,083661,Powell; Thomas Allan,0,35,65,65
1650579950901,CSE 140,A01,083663,Staff,1,7,75,74
1650579956933,CSE 140L,A01,083088,Eldon; John,1,13,75,74
1650579962956,CSE 175,A01,083665,Kumar; Rakesh,7,0,25,18
1650579968985,CSE 190,A00,092507,Dubnov; Shlomo,10,0,20,10
1650579975015,ECE 45,A01,083139,Staff,1,2,60,59
1650579981046,ECE 65,A50,083695,Staff,1,6,30,29
1650579987073,ECE 109,A01,091882,Touri; Behrouz,33,0,70,37
1650579993101,ECE 180,A00,083140,Abi Samra; Nicholas Camill,21,0,30,9
1650579993101,ECE 180,B00,083141,Abi Samra; Nicholas Camill,0,0,30,30
1650579999144,MATH 10A,A01,083735,Patchell; Gregory David,5,0,30,25
1650579999144,MATH 10A,A02,083736,Patchell; Gregory David,27,0,30,3
1650579999144,MATH 10A,A03,083737,Patchell; Gregory David,24,0,30,6
1650580005172,MATH 10B,A01,083207,Staff,0,9,30,30
1650580005172,MATH 10B,A02,083208,Staff,0,8,30,30
1650580005172,MATH 10B,B01,083739,Staff,11,0,30,19
1650580005172,MATH 10B,B02,083740,Staff,28,0,30,2
1650580011287,MATH 18,A01,083743,Staff,1,0,30,29
1650580011287,MATH 18,A02,083744,Staff,26,0,30,4
1650580011287,MATH 18,A03,083745,Staff,22,0,30,8
1650580011287,MATH 18,A04,083746,Staff,26,0,30,4
1650580011287,MATH 18,B01,083748,Staff,0,14,30,30
1650580011287,MATH 18,B02,083749,Staff,0,12,30,30
1650580011287,MATH 18,B03,083750,Staff,0,12,30,30
1650580011287,MATH 18,B04,083751,Staff,0,12,30,30
1650580017318,MATH 20A,A01,083754,Staff,21,0,40,19
1650580023344,MATH 20B,A01,083756,Staff,1,11,30,29
1650580023344,MATH 20B,A02,083757,Staff,0,12,30,30
1650580029368,MATH 20C,A01,083760,Staff,0,16,30,30
1650580029368,MATH 20C,A02,083761,Staff,2,14,30,28
1650580029368,MATH 20C,B01,083762,Staff,11,0,30,19
1650580029368,MATH 20C,B02,083763,Staff,28,0,30,2
1650580035392,MATH 20D,A01,083765,Staff,0,1,30,30
1650580035392,MATH 20D,A02,083766,Staff,7,0,30,23
1650580035392,MATH 20D,A03,083767,Staff,25,0,30,5
1650580041417,MATH 20E,A01,083771,Staff,6,0,30,24
1650580041417,MATH 20E,A02,083772,Staff,18,0,30,12
1650580041417,MATH 20E,B01,083773,Staff,0,0,30,30
1650580041417,MATH 20E,B02,083774,Staff,9,0,30,21
1650580047443,MATH 103A,A01,083777,Staff,0,15,30,30
1650580047443,MATH 103A,A02,083778,Staff,0,14,30,30
1650580047443,MATH 103A,B01,083779,Staff,0,13,30,30
1650580047443,MATH 103A,B02,083780,Staff,0,13,30,30
1650580053473,MATH 105,A01,085443,Staff,0,21,30,30
1650580059502,MATH 109,A01,083213,Anzaldo; Leesa B,0,7,30,30
1650580059502,MATH 109,A02,083214,Anzaldo; Leesa B,0,7,30,30
1650580059502,MATH 109,B01,083215,Anzaldo; Leesa B,0,5,30,30
1650580059502,MATH 109,B02,083216,Anzaldo; Leesa B,0,6,30,30
1650580065530,MATH 142A,A01,083219,Chow; Bennett,0,16,30,30
1650580065530,MATH 142A,A02,083220,Chow; Bennett,0,15,30,30
1650580065530,MATH 142A,B01,083221,Chow; Bennett,0,14,30,30
1650580065530,MATH 142A,B02,083222,Chow; Bennett,0,13,30,30
1650580071564,MATH 193A,A01,083224,Staff,1,6,30,29
1650580071564,MATH 193A,A02,083225,Staff,0,6,30,30
1650580071564,MATH 193A,A03,083781,Staff,0,6,30,30
1650580071564,MATH 193A,A04,083782,Staff,0,7,30,30
1650580077590,MATH 197,001,091859,McAuley; Julian John,9998,0,9999,1
1650580083663,COGS 9,A01,083615,Staff,1,17,60,59
1650580089709,COGS 11,A01,083617,Boyle; Mary E. T.,18,0,40,22
1650580095740,COGS 13,A01,083071,Staff,0,37,40,40
1650580101765,COGS 14A,A01,092681,Staff,0,29,100,100
1650580107802,COGS 14B,A01,083073,Cheng; Tzu-Han,0,13,50,50
1650580113838,COGS 17,A01,092677,Staff,18,0,75,57
1650580119868,COGS 100,A01,083619,Staff,1,26,60,59
1650580125907,COGS 101A,A01,083621,Davis; Joshua Daniel,0,26,60,60
1650580131933,COGS 101B,A01,091572,Staff,1,5,60,59
1650580137967,COGS 101C,A01,083625,Delgado; Tania,15,0,30,15
1650580143994,COGS 107A,A01,083627,Boyle; Mary E. T.,0,12,60,60
1650580150021,COGS 118A,A01,083075,Staff,0,4,60,60
1650580156063,CSE 3,A50,083646,Miranda; Gregory Joseph,19,0,38,19
1650580156063,CSE 3,A51,083647,Miranda; Gregory Joseph,36,0,37,1
1650580162092,CSE 8A,A50,083650,Miranda; Gregory Joseph,0,29,40,40
1650580168115,CSE 11,A01,083080,Cao; Yingjun,0,94,40,40
1650580174139,CSE 12,A01,083652,Staff,0,19,100,100
1650580180165,CSE 15L,A01,083654,Staff,0,1,50,50
1650580180165,CSE 15L,A02,083655,Staff,0,1,50,50
1650580186187,CSE 20,A01,083657,Staff,51,0,80,29
1650580192217,CSE 30,A01,083084,Eldon; John,0,78,40,40
1650580198239,CSE 100,A01,083659,Cao; Yingjun,0,66,50,50
1650580204273,CSE 134B,A01,083661,Powell; Thomas Allan,0,35,65,65
1650580210297,CSE 140,A01,083663,Staff,1,7,75,74
1650580216329,CSE 140L,A01,083088,Eldon; John,1,13,75,74
1650580222353,CSE 175,A01,083665,Kumar; Rakesh,7,0,25,18
1650580228377,CSE 190,A00,092507,Dubnov; Shlomo,10,0,20,10
1650580234403,ECE 45,A01,083139,Staff,1,2,60,59
1650580240435,ECE 65,A50,083695,Staff,1,6,30,29
1650580246464,ECE 109,A01,091882,Touri; Behrouz,33,0,70,37
1650580252488,ECE 180,A00,083140,Abi Samra; Nicholas Camill,21,0,30,9
1650580252488,ECE 180,B00,083141,Abi Samra; Nicholas Camill,0,0,30,30
1650580258513,MATH 10A,A01,083735,Patchell; Gregory David,5,0,30,25
1650580258513,MATH 10A,A02,083736,Patchell; Gregory David,27,0,30,3
1650580258513,MATH 10A,A03,083737,Patchell; Gregory David,24,0,30,6
1650580264540,MATH 10B,A01,083207,Staff,0,9,30,30
1650580264540,MATH 10B,A02,083208,Staff,0,8,30,30
1650580264540,MATH 10B,B01,083739,Staff,11,0,30,19
1650580264540,MATH 10B,B02,083740,Staff,28,0,30,2
1650580270569,MATH 18,A01,083743,Staff,1,0,30,29
1650580270569,MATH 18,A02,083744,Staff,26,0,30,4
1650580270569,MATH 18,A03,083745,Staff,22,0,30,8
1650580270569,MATH 18,A04,083746,Staff,26,0,30,4
1650580270569,MATH 18,B01,083748,Staff,0,14,30,30
1650580270569,MATH 18,B02,083749,Staff,0,12,30,30
1650580270569,MATH 18,B03,083750,Staff,0,12,30,30
1650580270569,MATH 18,B04,083751,Staff,0,12,30,30
1650580276594,MATH 20A,A01,083754,Staff,21,0,40,19
1650580282629,MATH 20B,A01,083756,Staff,1,11,30,29
1650580282629,MATH 20B,A02,083757,Staff,0,12,30,30
1650580288652,MATH 20C,A01,083760,Staff,0,16,30,30
1650580288652,MATH 20C,A02,083761,Staff,2,14,30,28
1650580288652,MATH 20C,B01,083762,Staff,11,0,30,19
1650580288652,MATH 20C,B02,083763,Staff,28,0,30,2
1650580294676,MATH 20D,A01,083765,Staff,0,1,30,30
1650580294676,MATH 20D,A02,083766,Staff,7,0,30,23
1650580294676,MATH 20D,A03,083767,Staff,25,0,30,5
1650580300701,MATH 20E,A01,083771,Staff,6,0,30,24
1650580300701,MATH 20E,A02,083772,Staff,18,0,30,12
1650580300701,MATH 20E,B01,083773,Staff,0,0,30,30
1650580300701,MATH 20E,B02,083774,Staff,9,0,30,21
1650580306726,MATH 103A,A01,083777,Staff,0,15,30,30
1650580306726,MATH 103A,A02,083778,Staff,0,14,30,30
1650580306726,MATH 103A,B01,083779,Staff,0,13,30,30
1650580306726,MATH 103A,B02,083780,Staff,0,13,30,30
1650580312750,MATH 105,A01,085443,Staff,0,21,30,30
1650580318780,MATH 109,A01,083213,Anzaldo; Leesa B,0,7,30,30
1650580318780,MATH 109,A02,083214,Anzaldo; Leesa B,0,7,30,30
1650580318780,MATH 109,B01,083215,Anzaldo; Leesa B,0,5,30,30
1650580318780,MATH 109,B02,083216,Anzaldo; Leesa B,0,6,30,30
1650580324809,MATH 142A,A01,083219,Chow; Bennett,0,16,30,30
1650580324809,MATH 142A,A02,083220,Chow; Bennett,0,15,30,30
1650580324809,MATH 142A,B01,083221,Chow; Bennett,0,14,30,30
1650580324809,MATH 142A,B02,083222,Chow; Bennett,0,13,30,30
1650580330837,MATH 193A,A01,083224,Staff,1,6,30,29
1650580330837,MATH 193A,A02,083225,Staff,0,6,30,30
1650580330837,MATH 193A,A03,083781,Staff,0,6,30,30
1650580330837,MATH 193A,A04,083782,Staff,0,7,30,30
1650580336859,MATH 197,001,091859,McAuley; Julian John,9998,0,9999,1
1650580342913,COGS 9,A01,083615,Staff,1,17,60,59
1650580348941,COGS 11,A01,083617,Boyle; Mary E. T.,18,0,40,22
1650580354968,COGS 13,A01,083071,Staff,0,37,40,40
1650580360992,COGS 14A,A01,092681,Staff,0,29,100,100
1650580367023,COGS 14B,A01,083073,Cheng; Tzu-Han,0,13,50,50
1650580373047,COGS 17,A01,092677,Staff,18,0,75,57
1650580379073,COGS 100,A01,083619,Staff,1,26,60,59
1650580385103,COGS 101A,A01,083621,Davis; Joshua Daniel,0,26,60,60
1650580391126,COGS 101B,A01,091572,Staff,1,5,60,59
1650580397155,COGS 101C,A01,083625,Delgado; Tania,15,0,30,15
1650580403183,COGS 107A,A01,083627,Boyle; Mary E. T.,0,12,60,60
1650580409214,COGS 118A,A01,083075,Staff,0,4,60,60
1650580415239,CSE 3,A50,083646,Miranda; Gregory Joseph,19,0,38,19
1650580415239,CSE 3,A51,083647,Miranda; Gregory Joseph,36,0,37,1
1650580421269,CSE 8A,A50,083650,Miranda; Gregory Joseph,0,29,40,40
1650580427292,CSE 11,A01,083080,Cao; Yingjun,0,94,40,40
1650580433315,CSE 12,A01,083652,Staff,0,19,100,100
1650580439340,CSE 15L,A01,083654,Staff,0,1,50,50
1650580439340,CSE 15L,A02,083655,Staff,0,1,50,50
1650580445363,CSE 20,A01,083657,Staff,52,0,80,28
1650580451386,CSE 30,A01,083084,Eldon; John,0,78,40,40
1650580457413,CSE 100,A01,083659,Cao; Yingjun,0,66,50,50
1650580463446,CSE 134B,A01,083661,Powell; Thomas Allan,0,35,65,65
1650580469470,CSE 140,A01,083663,Staff,1,7,75,74
1650580475492,CSE 140L,A01,083088,Eldon; John,1,13,75,74
1650580481519,CSE 175,A01,083665,Kumar; Rakesh,7,0,25,18
1650580487548,CSE 190,A00,092507,Dubnov; Shlomo,10,0,20,10
1650580493585,ECE 45,A01,083139,Staff,1,2,60,59
1650580499621,ECE 65,A50,083695,Staff,1,6,30,29
1650580505645,ECE 109,A01,091882,Touri; Behrouz,33,0,70,37
1650580511672,ECE 180,A00,083140,Abi Samra; Nicholas Camill,21,0,30,9
1650580511672,ECE 180,B00,083141,Abi Samra; Nicholas Camill,0,0,30,30
1650580517707,MATH 10A,A01,083735,Patchell; Gregory David,5,0,30,25
1650580517707,MATH 10A,A02,083736,Patchell; Gregory David,27,0,30,3
1650580517707,MATH 10A,A03,083737,Patchell; Gregory David,24,0,30,6
1650580523731,MATH 10B,A01,083207,Staff,0,9,30,30
1650580523731,MATH 10B,A02,083208,Staff,0,8,30,30
1650580523731,MATH 10B,B01,083739,Staff,11,0,30,19
1650580523731,MATH 10B,B02,083740,Staff,28,0,30,2
1650580529765,MATH 18,A01,083743,Staff,1,0,30,29
1650580529765,MATH 18,A02,083744,Staff,26,0,30,4
1650580529765,MATH 18,A03,083745,Staff,22,0,30,8
1650580529765,MATH 18,A04,083746,Staff,26,0,30,4
1650580529765,MATH 18,B01,083748,Staff,0,14,30,30
1650580529765,MATH 18,B02,083749,Staff,0,12,30,30
1650580529765,MATH 18,B03,083750,Staff,0,12,30,30
1650580529765,MATH 18,B04,083751,Staff,0,12,30,30
1650580535801,MATH 20A,A01,083754,Staff,21,0,40,19
1650580541827,MATH 20B,A01,083756,Staff,1,11,30,29
1650580541827,MATH 20B,A02,083757,Staff,0,12,30,30
1650580547851,MATH 20C,A01,083760,Staff,0,16,30,30
1650580547851,MATH 20C,A02,083761,Staff,2,14,30,28
1650580547851,MATH 20C,B01,083762,Staff,11,0,30,19
1650580547851,MATH 20C,B02,083763,Staff,28,0,30,2
1650580553874,MATH 20D,A01,083765,Staff,0,1,30,30
1650580553874,MATH 20D,A02,083766,Staff,7,0,30,23
1650580553874,MATH 20D,A03,083767,Staff,25,0,30,5
1650580559907,MATH 20E,A01,083771,Staff,6,0,30,24
1650580559907,MATH 20E,A02,083772,Staff,18,0,30,12
1650580559907,MATH 20E,B01,083773,Staff,0,0,30,30
1650580559907,MATH 20E,B02,083774,Staff,9,0,30,21
1650580565930,MATH 103A,A01,083777,Staff,0,15,30,30
1650580565930,MATH 103A,A02,083778,Staff,0,14,30,30
1650580565930,MATH 103A,B01,083779,Staff,0,13,30,30
1650580565930,MATH 103A,B02,083780,Staff,0,13,30,30
1650580571963,MATH 105,A01,085443,Staff,0,21,30,30
1650580577985,MATH 109,A01,083213,Anzaldo; Leesa B,0,7,30,30
1650580577985,MATH 109,A02,083214,Anzaldo; Leesa B,0,7,30,30
1650580577985,MATH 109,B01,083215,Anzaldo; Leesa B,0,5,30,30
1650580577985,MATH 109,B02,083216,Anzaldo; Leesa B,0,6,30,30
1650580584014,MATH 142A,A01,083219,Chow; Bennett,0,16,30,30
1650580584014,MATH 142A,A02,083220,Chow; Bennett,0,15,30,30
1650580584014,MATH 142A,B01,083221,Chow; Bennett,0,14,30,30
1650580584014,MATH 142A,B02,083222,Chow; Bennett,0,13,30,30
1650580590040,MATH 193A,A01,083224,Staff,1,6,30,29
1650580590040,MATH 193A,A02,083225,Staff,0,6,30,30
1650580590040,MATH 193A,A03,083781,Staff,0,6,30,30
1650580590040,MATH 193A,A04,083782,Staff,0,7,30,30
1650580596064,MATH 197,001,091859,McAuley; Julian John,9998,0,9999,1
1650580602207,COGS 9,A01,083615,Staff,1,17,60,59
1650580608241,COGS 11,A01,083617,Boyle; Mary E. T.,18,0,40,22
1650580614267,COGS 13,A01,083071,Staff,0,37,40,40
1650580620313,COGS 14A,A01,092681,Staff,0,29,100,100
1650580626344,COGS 14B,A01,083073,Cheng; Tzu-Han,0,13,50,50
1650580632378,COGS 17,A01,092677,Staff,18,0,75,57
1650580638406,COGS 100,A01,083619,Staff,1,26,60,59
1650580644434,COGS 101A,A01,083621,Davis; Joshua Daniel,0,26,60,60
1650580650477,COGS 101B,A01,091572,Staff,1,5,60,59
1650580656526,COGS 101C,A01,083625,Delgado; Tania,15,0,30,15
1650580662554,COGS 107A,A01,083627,Boyle; Mary E. T.,0,12,60,60
1650580668653,COGS 118A,A01,083075,Staff,0,4,60,60
1650580674678,CSE 3,A50,083646,Miranda; Gregory Joseph,19,0,38,19
1650580674678,CSE 3,A51,083647,Miranda; Gregory Joseph,36,0,37,1
1650580680703,CSE 8A,A50,083650,Miranda; Gregory Joseph,0,29,40,40
1650580686740,CSE 11,A01,083080,Cao; Yingjun,0,94,40,40
1650580692765,CSE 12,A01,083652,Staff,0,19,100,100
1650580698794,CSE 15L,A01,083654,Staff,0,1,50,50
1650580698794,CSE 15L,A02,083655,Staff,0,1,50,50
1650580704818,CSE 20,A01,083657,Staff,52,0,80,28
1650580710858,CSE 30,A01,083084,Eldon; John,0,78,40,40
1650580716893,CSE 100,A01,083659,Cao; Yingjun,0,66,50,50
1650580722915,CSE 134B,A01,083661,Powell; Thomas Allan,0,35,65,65
1650580728941,CSE 140,A01,083663,Staff,1,7,75,74
1650580734965,CSE 140L,A01,083088,Eldon; John,1,13,75,74
1650580740992,CSE 175,A01,083665,Kumar; Rakesh,7,0,25,18
1650580747016,CSE 190,A00,092507,Dubnov; Shlomo,10,0,20,10
1650580753053,ECE 45,A01,083139,Staff,1,2,60,59
1650580759077,ECE 65,A50,083695,Staff,1,6,30,29
1650580765104,ECE 109,A01,091882,Touri; Behrouz,33,0,70,37
1650580771135,ECE 180,A00,083140,Abi Samra; Nicholas Camill,21,0,30,9
1650580771135,ECE 180,B00,083141,Abi Samra; Nicholas Camill,0,0,30,30
1650580777158,MATH 10A,A01,083735,Patchell; Gregory David,5,0,30,25
1650580777158,MATH 10A,A02,083736,Patchell; Gregory David,27,0,30,3
1650580777158,MATH 10A,A03,083737,Patchell; Gregory David,24,0,30,6
1650580783194,MATH 10B,A01,083207,Staff,0,9,30,30
1650580783194,MATH 10B,A02,083208,Staff,0,8,30,30
1650580783194,MATH 10B,B01,083739,Staff,11,0,30,19
1650580783194,MATH 10B,B02,083740,Staff,28,0,30,2
1650580789220,MATH 18,A01,083743,Staff,1,0,30,29
1650580789220,MATH 18,A02,083744,Staff,26,0,30,4
1650580789220,MATH 18,A03,083745,Staff,22,0,30,8
1650580789220,MATH 18,A04,083746,Staff,26,0,30,4
1650580789220,MATH 18,B01,083748,Staff,0,14,30,30
1650580789220,MATH 18,B02,083749,Staff,0,12,30,30
1650580789220,MATH 18,B03,083750,Staff,0,12,30,30
1650580789220,MATH 18,B04,083751,Staff,0,12,30,30
1650580795247,MATH 20A,A01,083754,Staff,21,0,40,19
1650580801271,MATH 20B,A01,083756,Staff,1,11,30,29
1650580801271,MATH 20B,A02,083757,Staff,0,12,30,30
1650580807310,MATH 20C,A01,083760,Staff,0,16,30,30
1650580807310,MATH 20C,A02,083761,Staff,2,14,30,28
1650580807310,MATH 20C,B01,083762,Staff,11,0,30,19
1650580807310,MATH 20C,B02,083763,Staff,28,0,30,2
1650580813338,MATH 20D,A01,083765,Staff,0,1,30,30
1650580813338,MATH 20D,A02,083766,Staff,7,0,30,23
1650580813338,MATH 20D,A03,083767,Staff,25,0,30,5
1650580819363,MATH 20E,A01,083771,Staff,6,0,30,24
1650580819363,MATH 20E,A02,083772,Staff,18,0,30,12
1650580819363,MATH 20E,B01,083773,Staff,0,0,30,30
1650580819363,MATH 20E,B02,083774,Staff,9,0,30,21
1650580825388,MATH 103A,A01,083777,Staff,0,15,30,30
1650580825388,MATH 103A,A02,083778,Staff,0,14,30,30
1650580825388,MATH 103A,B01,083779,Staff,0,13,30,30
1650580825388,MATH 103A,B02,083780,Staff,0,13,30,30
1650580831413,MATH 105,A01,085443,Staff,0,21,30,30
1650580837449,MATH 109,A01,083213,Anzaldo; Leesa B,0,7,30,30
1650580837449,MATH 109,A02,083214,Anzaldo; Leesa B,0,7,30,30
1650580837449,MATH 109,B01,083215,Anzaldo; Leesa B,0,5,30,30
1650580837449,MATH 109,B02,083216,Anzaldo; Leesa B,0,6,30,30
1650580843478,MATH 142A,A01,083219,Chow; Bennett,0,16,30,30
1650580843478,MATH 142A,A02,083220,Chow; Bennett,0,15,30,30
1650580843478,MATH 142A,B01,083221,Chow; Bennett,0,14,30,30
1650580843478,MATH 142A,B02,083222,Chow; Bennett,0,13,30,30
1650580849513,MATH 193A,A01,083224,Staff,1,6,30,29
1650580849513,MATH 193A,A02,083225,Staff,0,6,30,30
1650580849513,MATH 193A,A03,083781,Staff,0,6,30,30
1650580849513,MATH 193A,A04,083782,Staff,0,7,30,30
1650580855536,MATH 197,001,091859,McAuley; Julian John,9998,0,9999,1
1650580861590,COGS 9,A01,083615,Staff,1,17,60,59
1650580867625,COGS 11,A01,083617,Boyle; Mary E. T.,18,0,40,22
1650580873652,COGS 13,A01,083071,Staff,0,37,40,40
1650580879686,COGS 14A,A01,092681,Staff,0,29,100,100
1650580885714,COGS 14B,A01,083073,Cheng; Tzu-Han,0,13,50,50
1650580891748,COGS 17,A01,092677,Staff,18,0,75,57
1650580897776,COGS 100,A01,083619,Staff,1,26,60,59
1650580903800,COGS 101A,A01,083621,Davis; Joshua Daniel,0,26,60,60
1650580909826,COGS 101B,A01,091572,Staff,1,5,60,59
1650580915857,COGS 101C,A01,083625,Delgado; Tania,15,0,30,15
1650580921897,COGS 107A,A01,083627,Boyle; Mary E. T.,0,12,60,60
1650580927922,COGS 118A,A01,083075,Staff,0,4,60,60
1650580933947,CSE 3,A50,083646,Miranda; Gregory Joseph,19,0,38,19
1650580933947,CSE 3,A51,083647,Miranda; Gregory Joseph,36,0,37,1
1650580939970,CSE 8A,A50,083650,Miranda; Gregory Joseph,0,29,40,40
1650580945994,CSE 11,A01,083080,Cao; Yingjun,0,94,40,40
1650580952017,CSE 12,A01,083652,Staff,0,19,100,100
1650580958049,CSE 15L,A01,083654,Staff,0,1,50,50
1650580958049,CSE 15L,A02,083655,Staff,0,1,50,50
1650580964073,CSE 20,A01,083657,Staff,52,0,80,28
1650580970109,CSE 30,A01,083084,Eldon; John,0,78,40,40
1650580976134,CSE 100,A01,083659,Cao; Yingjun,0,66,50,50
1650580982156,CSE 134B,A01,083661,Powell; Thomas Allan,0,35,65,65
1650580988182,CSE 140,A01,083663,Staff,1,7,75,74
1650580994208,CSE 140L,A01,083088,Eldon; John,1,13,75,74
1650581000231,CSE 175,A01,083665,Kumar; Rakesh,7,0,25,18
1650581006261,CSE 190,A00,092507,Dubnov; Shlomo,10,0,20,10
1650581012294,ECE 45,A01,083139,Staff,1,2,60,59
1650581018317,ECE 65,A50,083695,Staff,1,6,30,29
1650581024342,ECE 109,A01,091882,Touri; Behrouz,33,0,70,37
1650581030367,ECE 180,A00,083140,Abi Samra; Nicholas Camill,21,0,30,9
1650581030367,ECE 180,B00,083141,Abi Samra; Nicholas Camill,0,0,30,30
1650581036397,MATH 10A,A01,083735,Patchell; Gregory David,5,0,30,25
1650581036397,MATH 10A,A02,083736,Patchell; Gregory David,27,0,30,3
1650581036397,MATH 10A,A03,083737,Patchell; Gregory David,24,0,30,6
1650581042423,MATH 10B,A01,083207,Staff,0,9,30,30
1650581042423,MATH 10B,A02,083208,Staff,0,8,30,30
1650581042423,MATH 10B,B01,083739,Staff,11,0,30,19
1650581042423,MATH 10B,B02,083740,Staff,28,0,30,2
1650581048448,MATH 18,A01,083743,Staff,0,0,30,30
1650581048448,MATH 18,A02,083744,Staff,26,0,30,4
1650581048448,MATH 18,A03,083745,Staff,22,0,30,8
1650581048448,MATH 18,A04,083746,Staff,26,0,30,4
1650581048448,MATH 18,B01,083748,Staff,0,14,30,30
1650581048448,MATH 18,B02,083749,Staff,0,12,30,30
1650581048448,MATH 18,B03,083750,Staff,0,12,30,30
1650581048448,MATH 18,B04,083751,Staff,0,12,30,30
1650581054472,MATH 20A,A01,083754,Staff,21,0,40,19
1650581060496,MATH 20B,A01,083756,Staff,1,11,30,29
1650581060496,MATH 20B,A02,083757,Staff,0,12,30,30
1650581066537,MATH 20C,A01,083760,Staff,0,16,30,30
1650581066537,MATH 20C,A02,083761,Staff,2,14,30,28
1650581066537,MATH 20C,B01,083762,Staff,11,0,30,19
1650581066537,MATH 20C,B02,083763,Staff,28,0,30,2
1650581072562,MATH 20D,A01,083765,Staff,0,1,30,30
1650581072562,MATH 20D,A02,083766,Staff,8,0,30,22
1650581072562,MATH 20D,A03,083767,Staff,25,0,30,5
1650581078588,MATH 20E,A01,083771,Staff,6,0,30,24
1650581078588,MATH 20E,A02,083772,Staff,18,0,30,12
1650581078588,MATH 20E,B01,083773,Staff,0,0,30,30
1650581078588,MATH 20E,B02,083774,Staff,9,0,30,21
1650581084612,MATH 103A,A01,083777,Staff,0,15,30,30
1650581084612,MATH 103A,A02,083778,Staff,0,14,30,30
1650581084612,MATH 103A,B01,083779,Staff,0,13,30,30
1650581084612,MATH 103A,B02,083780,Staff,0,13,30,30
1650581090639,MATH 105,A01,085443,Staff,0,21,30,30
1650581096662,MATH 109,A01,083213,Anzaldo; Leesa B,0,7,30,30
1650581096662,MATH 109,A02,083214,Anzaldo; Leesa B,0,7,30,30
1650581096662,MATH 109,B01,083215,Anzaldo; Leesa B,0,5,30,30
1650581096662,MATH 109,B02,083216,Anzaldo; Leesa B,0,6,30,30
1650581102690,MATH 142A,A01,083219,Chow; Bennett,0,16,30,30
1650581102690,MATH 142A,A02,083220,Chow; Bennett,0,15,30,30
1650581102690,MATH 142A,B01,083221,Chow; Bennett,0,14,30,30
1650581102690,MATH 142A,B02,083222,Chow; Bennett,0,13,30,30
1650581108717,MATH 193A,A01,083224,Staff,1,6,30,29
1650581108717,MATH 193A,A02,083225,Staff,0,6,30,30
1650581108717,MATH 193A,A03,083781,Staff,0,6,30,30
1650581108717,MATH 193A,A04,083782,Staff,0,7,30,30
1650581114744,MATH 197,001,091859,McAuley; Julian John,9998,0,9999,1
1650581120797,COGS 9,A01,083615,Staff,1,17,60,59
1650581126820,COGS 11,A01,083617,Boyle; Mary E. T.,18,0,40,22
1650581132854,COGS 13,A01,083071,Staff,0,37,40,40
1650581138877,COGS 14A,A01,092681,Staff,0,29,100,100
1650581144905,COGS 14B,A01,083073,Cheng; Tzu-Han,0,13,50,50
1650581150934,COGS 17,A01,092677,Staff,18,0,75,57
1650581156959,COGS 100,A01,083619,Staff,1,26,60,59
1650581162983,COGS 101A,A01,083621,Davis; Joshua Daniel,0,26,60,60
1650581169010,COGS 101B,A01,091572,Staff,1,5,60,59
1650581175034,COGS 101C,A01,083625,Delgado; Tania,15,0,30,15
1650581181059,COGS 107A,A01,083627,Boyle; Mary E. T.,0,12,60,60
1650581187090,COGS 118A,A01,083075,Staff,0,4,60,60
1650581193125,CSE 3,A50,083646,Miranda; Gregory Joseph,19,0,38,19
1650581193125,CSE 3,A51,083647,Miranda; Gregory Joseph,36,0,37,1
1650581199257,CSE 8A,A50,083650,Miranda; Gregory Joseph,0,29,40,40
1650581205279,CSE 11,A01,083080,Cao; Yingjun,0,94,40,40
1650581211302,CSE 12,A01,083652,Staff,0,19,100,100
1650581217333,CSE 15L,A01,083654,Staff,0,1,50,50
1650581217333,CSE 15L,A02,083655,Staff,0,1,50,50
1650581223359,CSE 20,A01,083657,Staff,52,0,80,28
1650581229384,CSE 30,A01,083084,Eldon; John,0,78,40,40
1650581235407,CSE 100,A01,083659,Cao; Yingjun,0,66,50,50
1650581241442,CSE 134B,A01,083661,Powell; Thomas Allan,0,35,65,65
1650581247464,CSE 140,A01,083663,Staff,1,7,75,74
1650581253487,CSE 140L,A01,083088,Eldon; John,1,13,75,74
1650581259512,CSE 175,A01,083665,Kumar; Rakesh,7,0,25,18
1650581265543,CSE 190,A00,092507,Dubnov; Shlomo,10,0,20,10
1650581271565,ECE 45,A01,083139,Staff,1,2,60,59
1650581277589,ECE 65,A50,083695,Staff,1,6,30,29
1650581283617,ECE 109,A01,091882,Touri; Behrouz,33,0,70,37
1650581289638,ECE 180,A00,083140,Abi Samra; Nicholas Camill,21,0,30,9
1650581289638,ECE 180,B00,083141,Abi Samra; Nicholas Camill,0,0,30,30
1650581295665,MATH 10A,A01,083735,Patchell; Gregory David,5,0,30,25
1650581295665,MATH 10A,A02,083736,Patchell; Gregory David,27,0,30,3
1650581295665,MATH 10A,A03,083737,Patchell; Gregory David,24,0,30,6
1650581301687,MATH 10B,A01,083207,Staff,0,9,30,30
1650581301687,MATH 10B,A02,083208,Staff,0,8,30,30
1650581301687,MATH 10B,B01,083739,Staff,11,0,30,19
1650581301687,MATH 10B,B02,083740,Staff,28,0,30,2
1650581307721,MATH 18,A01,083743,Staff,0,0,30,30
1650581307721,MATH 18,A02,083744,Staff,26,0,30,4
1650581307721,MATH 18,A03,083745,Staff,22,0,30,8
1650581307721,MATH 18,A04,083746,Staff,26,0,30,4
1650581307721,MATH 18,B01,083748,Staff,0,14,30,30
1650581307721,MATH 18,B02,083749,Staff,0,12,30,30
1650581307721,MATH 18,B03,083750,Staff,0,12,30,30
1650581307721,MATH 18,B04,083751,Staff,0,12,30,30
1650581313744,MATH 20A,A01,083754,Staff,21,0,40,19
1650581319767,MATH 20B,A01,083756,Staff,1,11,30,29
1650581319767,MATH 20B,A02,083757,Staff,0,12,30,30
1650581325793,MATH 20C,A01,083760,Staff,0,16,30,30
1650581325793,MATH 20C,A02,083761,Staff,2,14,30,28
1650581325793,MATH 20C,B01,083762,Staff,11,0,30,19
1650581325793,MATH 20C,B02,083763,Staff,28,0,30,2
1650581331823,MATH 20D,A01,083765,Staff,0,1,30,30
1650581331823,MATH 20D,A02,083766,Staff,8,0,30,22
1650581331823,MATH 20D,A03,083767,Staff,25,0,30,5
1650581337850,MATH 20E,A01,083771,Staff,6,0,30,24
1650581337850,MATH 20E,A02,083772,Staff,18,0,30,12
1650581337850,MATH 20E,B01,083773,Staff,0,0,30,30
1650581337850,MATH 20E,B02,083774,Staff,9,0,30,21
1650581343879,MATH 103A,A01,083777,Staff,0,15,30,30
1650581343879,MATH 103A,A02,083778,Staff,0,14,30,30
1650581343879,MATH 103A,B01,083779,Staff,0,13,30,30
1650581343879,MATH 103A,B02,083780,Staff,0,13,30,30
1650581349906,MATH 105,A01,085443,Staff,0,21,30,30
1650581355939,MATH 109,A01,083213,Anzaldo; Leesa B,0,7,30,30
1650581355939,MATH 109,A02,083214,Anzaldo; Leesa B,0,7,30,30
1650581355939,MATH 109,B01,083215,Anzaldo; Leesa B,0,5,30,30
1650581355939,MATH 109,B02,083216,Anzaldo; Leesa B,0,6,30,30
1650581361963,MATH 142A,A01,083219,Chow; Bennett,0,16,30,30
1650581361963,MATH 142A,A02,083220,Chow; Bennett,0,15,30,30
1650581361963,MATH 142A,B01,083221,Chow; Bennett,0,14,30,30
1650581361963,MATH 142A,B02,083222,Chow; Bennett,0,13,30,30
1650581367986,MATH 193A,A01,083224,Staff,1,6,30,29
1650581367986,MATH 193A,A02,083225,Staff,0,6,30,30
1650581367986,MATH 193A,A03,083781,Staff,0,6,30,30
1650581367986,MATH 193A,A04,083782,Staff,0,7,30,30
1650581374017,MATH 197,001,091859,McAuley; Julian John,9998,0,9999,1
1650581380086,COGS 9,A01,083615,Staff,1,17,60,59
1650581386109,COGS 11,A01,083617,Boyle; Mary E. T.,18,0,40,22
1650581392134,COGS 13,A01,083071,Staff,0,37,40,40
1650581398157,COGS 14A,A01,092681,Staff,0,29,100,100
1650581404182,COGS 14B,A01,083073,Cheng; Tzu-Han,0,13,50,50
1650581410207,COGS 17,A01,092677,Staff,18,0,75,57
1650581416233,COGS 100,A01,083619,Staff,1,26,60,59
1650581422258,COGS 101A,A01,083621,Davis; Joshua Daniel,0,26,60,60
1650581428292,COGS 101B,A01,091572,Staff,1,5,60,59
1650581434317,COGS 101C,A01,083625,Delgado; Tania,15,0,30,15
1650581440346,COGS 107A,A01,083627,Boyle; Mary E. T.,0,12,60,60
1650581446373,COGS 118A,A01,083075,Staff,0,4,60,60
1650581452400,CSE 3,A50,083646,Miranda; Gregory Joseph,19,0,38,19
1650581452400,CSE 3,A51,083647,Miranda; Gregory Joseph,36,0,37,1
1650581458424,CSE 8A,A50,083650,Miranda; Gregory Joseph,0,29,40,40
1650581464466,CSE 11,A01,083080,Cao; Yingjun,0,94,40,40
1650581470491,CSE 12,A01,083652,Staff,0,19,100,100
1650581476517,CSE 15L,A01,083654,Staff,0,1,50,50
1650581476517,CSE 15L,A02,083655,Staff,0,1,50,50
1650581482544,CSE 20,A01,083657,Staff,52,0,80,28
1650581488571,CSE 30,A01,083084,Eldon; John,0,78,40,40
1650581494596,CSE 100,A01,083659,Cao; Yingjun,0,66,50,50
1650581500621,CSE 134B,A01,083661,Powell; Thomas Allan,0,35,65,65
1650581506647,CSE 140,A01,083663,Staff,1,7,75,74
1650581512672,CSE 140L,A01,083088,Eldon; John,1,13,75,74
1650581518696,CSE 175,A01,083665,Kumar; Rakesh,7,0,25,18
1650581524722,CSE 190,A00,092507,Dubnov; Shlomo,10,0,20,10
1650581530749,ECE 45,A01,083139,Staff,1,2,60,59
1650581536872,ECE 65,A50,083695,Staff,1,6,30,29
1650581542898,ECE 109,A01,091882,Touri; Behrouz,33,0,70,37
1650581548929,ECE 180,A00,083140,Abi Samra; Nicholas Camill,21,0,30,9
1650581548929,ECE 180,B00,083141,Abi Samra; Nicholas Camill,0,0,30,30
1650581554954,MATH 10A,A01,083735,Patchell; Gregory David,5,0,30,25
1650581554954,MATH 10A,A02,083736,Patchell; Gregory David,27,0,30,3
1650581554954,MATH 10A,A03,083737,Patchell; Gregory David,24,0,30,6
1650581560978,MATH 10B,A01,083207,Staff,0,9,30,30
1650581560978,MATH 10B,A02,083208,Staff,0,8,30,30
1650581560978,MATH 10B,B01,083739,Staff,11,0,30,19
1650581560978,MATH 10B,B02,083740,Staff,28,0,30,2
1650581567002,MATH 18,A01,083743,Staff,0,0,30,30
1650581567002,MATH 18,A02,083744,Staff,26,0,30,4
1650581567002,MATH 18,A03,083745,Staff,22,0,30,8
1650581567002,MATH 18,A04,083746,Staff,26,0,30,4
1650581567002,MATH 18,B01,083748,Staff,0,14,30,30
1650581567002,MATH 18,B02,083749,Staff,0,12,30,30
1650581567002,MATH 18,B03,083750,Staff,0,12,30,30
1650581567002,MATH 18,B04,083751,Staff,0,12,30,30
1650581573030,MATH 20A,A01,083754,Staff,21,0,40,19
1650581579079,MATH 20B,A01,083756,Staff,1,11,30,29
1650581579079,MATH 20B,A02,083757,Staff,0,12,30,30
1650581585106,MATH 20C,A01,083760,Staff,0,16,30,30
1650581585106,MATH 20C,A02,083761,Staff,2,14,30,28
1650581585106,MATH 20C,B01,083762,Staff,11,0,30,19
1650581585106,MATH 20C,B02,083763,Staff,28,0,30,2
1650581591133,MATH 20D,A01,083765,Staff,0,1,30,30
1650581591133,MATH 20D,A02,083766,Staff,8,0,30,22
1650581591133,MATH 20D,A03,083767,Staff,25,0,30,5
1650581597162,MATH 20E,A01,083771,Staff,6,0,30,24
1650581597162,MATH 20E,A02,083772,Staff,18,0,30,12
1650581597162,MATH 20E,B01,083773,Staff,0,0,30,30
1650581597162,MATH 20E,B02,083774,Staff,9,0,30,21
1650581603192,MATH 103A,A01,083777,Staff,0,15,30,30
1650581603192,MATH 103A,A02,083778,Staff,0,14,30,30
1650581603192,MATH 103A,B01,083779,Staff,0,13,30,30
1650581603192,MATH 103A,B02,083780,Staff,0,13,30,30
1650581609221,MATH 105,A01,085443,Staff,0,21,30,30
1650581615245,MATH 109,A01,083213,Anzaldo; Leesa B,0,7,30,30
1650581615245,MATH 109,A02,083214,Anzaldo; Leesa B,0,7,30,30
1650581615245,MATH 109,B01,083215,Anzaldo; Leesa B,0,5,30,30
1650581615245,MATH 109,B02,083216,Anzaldo; Leesa B,0,6,30,30
1650581621281,MATH 142A,A01,083219,Chow; Bennett,0,16,30,30
1650581621281,MATH 142A,A02,083220,Chow; Bennett,0,15,30,30
1650581621281,MATH 142A,B01,083221,Chow; Bennett,0,14,30,30
1650581621281,MATH 142A,B02,083222,Chow; Bennett,0,13,30,30
1650581627305,MATH 193A,A01,083224,Staff,1,6,30,29
1650581627305,MATH 193A,A02,083225,Staff,0,6,30,30
1650581627305,MATH 193A,A03,083781,Staff,0,6,30,30
1650581627305,MATH 193A,A04,083782,Staff,0,7,30,30
1650581633330,MATH 197,001,091859,McAuley; Julian John,9998,0,9999,1
1650581639383,COGS 9,A01,083615,Staff,1,17,60,59
1650581645406,COGS 11,A01,083617,Boyle; Mary E. T.,18,0,40,22
1650581651429,COGS 13,A01,083071,Staff,0,37,40,40
1650581657455,COGS 14A,A01,092681,Staff,0,29,100,100
1650581663495,COGS 14B,A01,083073,Cheng; Tzu-Han,0,13,50,50
1650581669522,COGS 17,A01,092677,Staff,18,0,75,57
1650581675547,COGS 100,A01,083619,Staff,1,26,60,59
1650581681571,COGS 101A,A01,083621,Davis; Joshua Daniel,0,26,60,60
1650581687611,COGS 101B,A01,091572,Staff,1,5,60,59
1650581693638,COGS 101C,A01,083625,Delgado; Tania,15,0,30,15
1650581699664,COGS 107A,A01,083627,Boyle; Mary E. T.,0,12,60,60
1650581705698,COGS 118A,A01,083075,Staff,0,4,60,60
1650581711721,CSE 3,A50,083646,Miranda; Gregory Joseph,19,0,38,19
1650581711721,CSE 3,A51,083647,Miranda; Gregory Joseph,36,0,37,1
1650581717747,CSE 8A,A50,083650,Miranda; Gregory Joseph,0,30,40,40
1650581723775,CSE 11,A01,083080,Cao; Yingjun,0,94,40,40
1650581729806,CSE 12,A01,083652,Staff,0,19,100,100
1650581735844,CSE 15L,A01,083654,Staff,0,1,50,50
1650581735844,CSE 15L,A02,083655,Staff,0,1,50,50
1650581741875,CSE 20,A01,083657,Staff,52,0,80,28
1650581747901,CSE 30,A01,083084,Eldon; John,0,78,40,40
1650581753928,CSE 100,A01,083659,Cao; Yingjun,0,66,50,50
1650581759952,CSE 134B,A01,083661,Powell; Thomas Allan,0,35,65,65
1650581765983,CSE 140,A01,083663,Staff,1,7,75,74
1650581772008,CSE 140L,A01,083088,Eldon; John,1,13,75,74
1650581778037,CSE 175,A01,083665,Kumar; Rakesh,7,0,25,18
1650581784064,CSE 190,A00,092507,Dubnov; Shlomo,10,0,20,10
1650581790095,ECE 45,A01,083139,Staff,1,2,60,59
1650581796221,ECE 65,A50,083695,Staff,1,6,30,29
1650581802244,ECE 109,A01,091882,Touri; Behrouz,33,0,70,37
1650581808284,ECE 180,A00,083140,Abi Samra; Nicholas Camill,21,0,30,9
1650581808284,ECE 180,B00,083141,Abi Samra; Nicholas Camill,0,0,30,30
1650581814313,MATH 10A,A01,083735,Patchell; Gregory David,4,0,30,26
1650581814313,MATH 10A,A02,083736,Patchell; Gregory David,27,0,30,3
1650581814313,MATH 10A,A03,083737,Patchell; Gregory David,24,0,30,6
1650581820341,MATH 10B,A01,083207,Staff,0,9,30,30
1650581820341,MATH 10B,A02,083208,Staff,0,8,30,30
1650581820341,MATH 10B,B01,083739,Staff,11,0,30,19
1650581820341,MATH 10B,B02,083740,Staff,28,0,30,2
1650581826374,MATH 18,A01,083743,Staff,0,0,30,30
1650581826374,MATH 18,A02,083744,Staff,26,0,30,4
1650581826374,MATH 18,A03,083745,Staff,22,0,30,8
1650581826374,MATH 18,A04,083746,Staff,26,0,30,4
1650581826374,MATH 18,B01,083748,Staff,0,14,30,30
1650581826374,MATH 18,B02,083749,Staff,0,12,30,30
1650581826374,MATH 18,B03,083750,Staff,0,12,30,30
1650581826374,MATH 18,B04,083751,Staff,0,12,30,30
1650581832401,MATH 20A,A01,083754,Staff,21,0,40,19
1650581838424,MATH 20B,A01,083756,Staff,1,11,30,29
1650581838424,MATH 20B,A02,083757,Staff,0,12,30,30
1650581844455,MATH 20C,A01,083760,Staff,0,16,30,30
1650581844455,MATH 20C,A02,083761,Staff,2,14,30,28
1650581844455,MATH 20C,B01,083762,Staff,11,0,30,19
1650581844455,MATH 20C,B02,083763,Staff,28,0,30,2
1650581850481,MATH 20D,A01,083765,Staff,0,1,30,30
1650581850481,MATH 20D,A02,083766,Staff,8,0,30,22
1650581850481,MATH 20D,A03,083767,Staff,25,0,30,5
1650581856516,MATH 20E,A01,083771,Staff,6,0,30,24
1650581856516,MATH 20E,A02,083772,Staff,18,0,30,12
1650581856516,MATH 20E,B01,083773,Staff,0,0,30,30
1650581856516,MATH 20E,B02,083774,Staff,9,0,30,21
1650581862543,MATH 103A,A01,083777,Staff,0,15,30,30
1650581862543,MATH 103A,A02,083778,Staff,0,14,30,30
1650581862543,MATH 103A,B01,083779,Staff,0,13,30,30
1650581862543,MATH 103A,B02,083780,Staff,0,13,30,30
1650581868566,MATH 105,A01,085443,Staff,0,21,30,30
1650581874592,MATH 109,A01,083213,Anzaldo; Leesa B,0,7,30,30
1650581874592,MATH 109,A02,083214,Anzaldo; Leesa B,0,7,30,30
1650581874592,MATH 109,B01,083215,Anzaldo; Leesa B,0,5,30,30
1650581874592,MATH 109,B02,083216,Anzaldo; Leesa B,0,6,30,30
1650581880624,MATH 142A,A01,083219,Chow; Bennett,0,16,30,30
1650581880624,MATH 142A,A02,083220,Chow; Bennett,0,15,30,30
1650581880624,MATH 142A,B01,083221,Chow; Bennett,0,14,30,30
1650581880624,MATH 142A,B02,083222,Chow; Bennett,0,13,30,30
1650581886659,MATH 193A,A01,083224,Staff,1,6,30,29
1650581886659,MATH 193A,A02,083225,Staff,0,6,30,30
1650581886659,MATH 193A,A03,083781,Staff,0,6,30,30
1650581886659,MATH 193A,A04,083782,Staff,0,7,30,30
1650581892680,MATH 197,001,091859,McAuley; Julian John,9998,0,9999,1
1650581898737,COGS 9,A01,083615,Staff,1,17,60,59
1650581904762,COGS 11,A01,083617,Boyle; Mary E. T.,18,0,40,22
1650581910785,COGS 13,A01,083071,Staff,0,37,40,40
1650581916809,COGS 14A,A01,092681,Staff,0,29,100,100
1650581922841,COGS 14B,A01,083073,Cheng; Tzu-Han,0,13,50,50
1650581928877,COGS 17,A01,092677,Staff,18,0,75,57
1650581934910,COGS 100,A01,083619,Staff,1,26,60,59
1650581940944,COGS 101A,A01,083621,Davis; Joshua Daniel,0,26,60,60
1650581946977,COGS 101B,A01,091572,Staff,1,5,60,59
1650581953001,COGS 101C,A01,083625,Delgado; Tania,15,0,30,15
1650581959023,COGS 107A,A01,083627,Boyle; Mary E. T.,0,12,60,60
1650581965047,COGS 118A,A01,083075,Staff,0,4,60,60
1650581971071,CSE 3,A50,083646,Miranda; Gregory Joseph,19,0,38,19
1650581971071,CSE 3,A51,083647,Miranda; Gregory Joseph,36,0,37,1
1650581977098,CSE 8A,A50,083650,Miranda; Gregory Joseph,0,30,40,40
1650581983122,CSE 11,A01,083080,Cao; Yingjun,0,94,40,40
1650581989149,CSE 12,A01,083652,Staff,0,19,100,100
1650581995175,CSE 15L,A01,083654,Staff,0,1,50,50
1650581995175,CSE 15L,A02,083655,Staff,0,1,50,50
1650582001205,CSE 20,A01,083657,Staff,52,0,80,28
1650582007240,CSE 30,A01,083084,Eldon; John,0,78,40,40
1650582013284,CSE 100,A01,083659,Cao; Yingjun,0,66,50,50
1650582019315,CSE 134B,A01,083661,Powell; Thomas Allan,0,35,65,65
1650582025347,CSE 140,A01,083663,Staff,1,7,75,74
1650582031374,CSE 140L,A01,083088,Eldon; John,1,13,75,74
1650582037401,CSE 175,A01,083665,Kumar; Rakesh,7,0,25,18
1650582043429,CSE 190,A00,092507,Dubnov; Shlomo,10,0,20,10
1650582049462,ECE 45,A01,083139,Staff,1,2,60,59
1650582055490,ECE 65,A50,083695,Staff,1,6,30,29
1650582061514,ECE 109,A01,091882,Touri; Behrouz,33,0,70,37
1650582067548,ECE 180,A00,083140,Abi Samra; Nicholas Camill,21,0,30,9
1650582067548,ECE 180,B00,083141,Abi Samra; Nicholas Camill,0,0,30,30
1650582073574,MATH 10A,A01,083735,Patchell; Gregory David,4,0,30,26
1650582073574,MATH 10A,A02,083736,Patchell; Gregory David,27,0,30,3
1650582073574,MATH 10A,A03,083737,Patchell; Gregory David,24,0,30,6
1650582079598,MATH 10B,A01,083207,Staff,0,9,30,30
1650582079598,MATH 10B,A02,083208,Staff,0,8,30,30
1650582079598,MATH 10B,B01,083739,Staff,11,0,30,19
1650582079598,MATH 10B,B02,083740,Staff,28,0,30,2
1650582085627,MATH 18,A01,083743,Staff,0,0,30,30
1650582085627,MATH 18,A02,083744,Staff,26,0,30,4
1650582085627,MATH 18,A03,083745,Staff,22,0,30,8
1650582085627,MATH 18,A04,083746,Staff,26,0,30,4
1650582085627,MATH 18,B01,083748,Staff,0,14,30,30
1650582085627,MATH 18,B02,083749,Staff,0,12,30,30
1650582085627,MATH 18,B03,083750,Staff,0,12,30,30
1650582085627,MATH 18,B04,083751,Staff,0,12,30,30
1650582091650,MATH 20A,A01,083754,Staff,21,0,40,19
1650582097674,MATH 20B,A01,083756,Staff,1,11,30,29
1650582097674,MATH 20B,A02,083757,Staff,0,12,30,30
1650582103703,MATH 20C,A01,083760,Staff,0,16,30,30
1650582103703,MATH 20C,A02,083761,Staff,2,14,30,28
1650582103703,MATH 20C,B01,083762,Staff,11,0,30,19
1650582103703,MATH 20C,B02,083763,Staff,28,0,30,2
1650582109727,MATH 20D,A01,083765,Staff,0,1,30,30
1650582109727,MATH 20D,A02,083766,Staff,8,0,30,22
1650582109727,MATH 20D,A03,083767,Staff,25,0,30,5
1650582115757,MATH 20E,A01,083771,Staff,6,0,30,24
1650582115757,MATH 20E,A02,083772,Staff,18,0,30,12
1650582115757,MATH 20E,B01,083773,Staff,0,0,30,30
1650582115757,MATH 20E,B02,083774,Staff,9,0,30,21
1650582121786,MATH 103A,A01,083777,Staff,0,15,30,30
1650582121786,MATH 103A,A02,083778,Staff,0,14,30,30
1650582121786,MATH 103A,B01,083779,Staff,0,13,30,30
1650582121786,MATH 103A,B02,083780,Staff,0,13,30,30
1650582127833,MATH 105,A01,085443,Staff,0,21,30,30
1650582133856,MATH 109,A01,083213,Anzaldo; Leesa B,0,7,30,30
1650582133856,MATH 109,A02,083214,Anzaldo; Leesa B,0,7,30,30
1650582133856,MATH 109,B01,083215,Anzaldo; Leesa B,0,5,30,30
1650582133856,MATH 109,B02,083216,Anzaldo; Leesa B,0,6,30,30
1650582139879,MATH 142A,A01,083219,Chow; Bennett,0,16,30,30
1650582139879,MATH 142A,A02,083220,Chow; Bennett,0,15,30,30
1650582139879,MATH 142A,B01,083221,Chow; Bennett,0,14,30,30
1650582139879,MATH 142A,B02,083222,Chow; Bennett,0,13,30,30
1650582145903,MATH 193A,A01,083224,Staff,1,6,30,29
1650582145903,MATH 193A,A02,083225,Staff,0,6,30,30
1650582145903,MATH 193A,A03,083781,Staff,0,6,30,30
1650582145903,MATH 193A,A04,083782,Staff,0,7,30,30
1650582151927,MATH 197,001,091859,McAuley; Julian John,9998,0,9999,1
1650582157985,COGS 9,A01,083615,Staff,1,17,60,59
1650582164009,COGS 11,A01,083617,Boyle; Mary E. T.,18,0,40,22
1650582170035,COGS 13,A01,083071,Staff,0,37,40,40
1650582176058,COGS 14A,A01,092681,Staff,0,29,100,100
1650582182090,COGS 14B,A01,083073,Cheng; Tzu-Han,0,13,50,50
1650582188131,COGS 17,A01,092677,Staff,18,0,75,57
1650582194157,COGS 100,A01,083619,Staff,1,26,60,59
1650582200185,COGS 101A,A01,083621,Davis; Joshua Daniel,0,26,60,60
1650582206211,COGS 101B,A01,091572,Staff,1,5,60,59
1650582212238,COGS 101C,A01,083625,Delgado; Tania,15,0,30,15
1650582218264,COGS 107A,A01,083627,Boyle; Mary E. T.,0,12,60,60
1650582224292,COGS 118A,A01,083075,Staff,0,4,60,60
1650582230316,CSE 3,A50,083646,Miranda; Gregory Joseph,19,0,38,19
1650582230316,CSE 3,A51,083647,Miranda; Gregory Joseph,36,0,37,1
1650582236344,CSE 8A,A50,083650,Miranda; Gregory Joseph,0,30,40,40
1650582242368,CSE 11,A01,083080,Cao; Yingjun,0,94,40,40
1650582248394,CSE 12,A01,083652,Staff,0,19,100,100
1650582254427,CSE 15L,A01,083654,Staff,0,1,50,50
1650582254427,CSE 15L,A02,083655,Staff,0,1,50,50
1650582260458,CSE 20,A01,083657,Staff,52,0,80,28
1650582266489,CSE 30,A01,083084,Eldon; John,0,78,40,40
1650582272513,CSE 100,A01,083659,Cao; Yingjun,0,66,50,50
1650582278547,CSE 134B,A01,083661,Powell; Thomas Allan,0,35,65,65
1650582284585,CSE 140,A01,083663,Staff,1,7,75,74
1650582290629,CSE 140L,A01,083088,Eldon; John,1,13,75,74
1650582296655,CSE 175,A01,083665,Kumar; Rakesh,7,0,25,18
1650582302679,CSE 190,A00,092507,Dubnov; Shlomo,10,0,20,10
1650582308704,ECE 45,A01,083139,Staff,1,2,60,59
1650582314731,ECE 65,A50,083695,Staff,1,6,30,29
1650582320758,ECE 109,A01,091882,Touri; Behrouz,33,0,70,37
1650582326789,ECE 180,A00,083140,Abi Samra; Nicholas Camill,21,0,30,9
1650582326789,ECE 180,B00,083141,Abi Samra; Nicholas Camill,0,0,30,30
1650582332816,MATH 10A,A01,083735,Patchell; Gregory David,4,0,30,26
1650582332816,MATH 10A,A02,083736,Patchell; Gregory David,27,0,30,3
1650582332816,MATH 10A,A03,083737,Patchell; Gregory David,24,0,30,6
1650582338843,MATH 10B,A01,083207,Staff,0,9,30,30
1650582338843,MATH 10B,A02,083208,Staff,0,8,30,30
1650582338843,MATH 10B,B01,083739,Staff,11,0,30,19
1650582338843,MATH 10B,B02,083740,Staff,28,0,30,2
1650582344870,MATH 18,A01,083743,Staff,0,0,30,30
1650582344870,MATH 18,A02,083744,Staff,26,0,30,4
1650582344870,MATH 18,A03,083745,Staff,22,0,30,8
1650582344870,MATH 18,A04,083746,Staff,26,0,30,4
1650582344870,MATH 18,B01,083748,Staff,0,14,30,30
1650582344870,MATH 18,B02,083749,Staff,0,12,30,30
1650582344870,MATH 18,B03,083750,Staff,0,12,30,30
1650582344870,MATH 18,B04,083751,Staff,0,12,30,30
1650582350915,MATH 20A,A01,083754,Staff,21,0,40,19
1650582356950,MATH 20B,A01,083756,Staff,1,11,30,29
1650582356950,MATH 20B,A02,083757,Staff,0,12,30,30
1650582362973,MATH 20C,A01,083760,Staff,0,16,30,30
1650582362973,MATH 20C,A02,083761,Staff,2,14,30,28
1650582362973,MATH 20C,B01,083762,Staff,11,0,30,19
1650582362973,MATH 20C,B02,083763,Staff,28,0,30,2
1650582369000,MATH 20D,A01,083765,Staff,0,1,30,30
1650582369000,MATH 20D,A02,083766,Staff,8,0,30,22
1650582369000,MATH 20D,A03,083767,Staff,25,0,30,5
1650582375024,MATH 20E,A01,083771,Staff,6,0,30,24
1650582375024,MATH 20E,A02,083772,Staff,18,0,30,12
1650582375024,MATH 20E,B01,083773,Staff,0,0,30,30
1650582375024,MATH 20E,B02,083774,Staff,9,0,30,21
1650582381053,MATH 103A,A01,083777,Staff,0,15,30,30
1650582381053,MATH 103A,A02,083778,Staff,0,14,30,30
1650582381053,MATH 103A,B01,083779,Staff,0,13,30,30
1650582381053,MATH 103A,B02,083780,Staff,0,13,30,30
1650582387093,MATH 105,A01,085443,Staff,0,21,30,30
1650582393218,MATH 109,A01,083213,Anzaldo; Leesa B,0,7,30,30
1650582393218,MATH 109,A02,083214,Anzaldo; Leesa B,0,7,30,30
1650582393218,MATH 109,B01,083215,Anzaldo; Leesa B,0,5,30,30
1650582393218,MATH 109,B02,083216,Anzaldo; Leesa B,0,6,30,30
1650582399255,MATH 142A,A01,083219,Chow; Bennett,0,16,30,30
1650582399255,MATH 142A,A02,083220,Chow; Bennett,0,15,30,30
1650582399255,MATH 142A,B01,083221,Chow; Bennett,0,14,30,30
1650582399255,MATH 142A,B02,083222,Chow; Bennett,0,13,30,30
1650582405294,MATH 193A,A01,083224,Staff,1,6,30,29
1650582405294,MATH 193A,A02,083225,Staff,0,6,30,30
1650582405294,MATH 193A,A03,083781,Staff,0,6,30,30
1650582405294,MATH 193A,A04,083782,Staff,0,7,30,30
1650582411317,MATH 197,001,091859,McAuley; Julian John,9998,0,9999,1
1650582417368,COGS 9,A01,083615,Staff,1,17,60,59
1650582423391,COGS 11,A01,083617,Boyle; Mary E. T.,18,0,40,22
1650582429421,COGS 13,A01,083071,Staff,0,37,40,40
1650582435445,COGS 14A,A01,092681,Staff,0,29,100,100
1650582441469,COGS 14B,A01,083073,Cheng; Tzu-Han,0,13,50,50
1650582447495,COGS 17,A01,092677,Staff,18,0,75,57
1650582453522,COGS 100,A01,083619,Staff,1,26,60,59
1650582459549,COGS 101A,A01,083621,Davis; Joshua Daniel,0,26,60,60
1650582465573,COGS 101B,A01,091572,Staff,1,5,60,59
1650582471603,COGS 101C,A01,083625,Delgado; Tania,15,0,30,15
1650582477629,COGS 107A,A01,083627,Boyle; Mary E. T.,0,12,60,60
1650582483655,COGS 118A,A01,083075,Staff,0,4,60,60
1650582489678,CSE 3,A50,083646,Miranda; Gregory Joseph,19,0,38,19
1650582489678,CSE 3,A51,083647,Miranda; Gregory Joseph,36,0,37,1
1650582495704,CSE 8A,A50,083650,Miranda; Gregory Joseph,0,30,40,40
1650582501734,CSE 11,A01,083080,Cao; Yingjun,0,94,40,40
1650582507758,CSE 12,A01,083652,Staff,0,19,100,100
1650582513792,CSE 15L,A01,083654,Staff,0,1,50,50
1650582513792,CSE 15L,A02,083655,Staff,0,1,50,50
1650582519818,CSE 20,A01,083657,Staff,52,0,80,28
1650582525842,CSE 30,A01,083084,Eldon; John,0,78,40,40
1650582531867,CSE 100,A01,083659,Cao; Yingjun,0,66,50,50
1650582537893,CSE 134B,A01,083661,Powell; Thomas Allan,0,35,65,65
1650582543926,CSE 140,A01,083663,Staff,1,7,75,74
1650582549959,CSE 140L,A01,083088,Eldon; John,1,13,75,74
1650582555982,CSE 175,A01,083665,Kumar; Rakesh,7,0,25,18
1650582562005,CSE 190,A00,092507,Dubnov; Shlomo,10,0,20,10
1650582568029,ECE 45,A01,083139,Staff,1,2,60,59
1650582574052,ECE 65,A50,083695,Staff,1,6,30,29
1650582580080,ECE 109,A01,091882,Touri; Behrouz,33,0,70,37
1650582586112,ECE 180,A00,083140,Abi Samra; Nicholas Camill,21,0,30,9
1650582586112,ECE 180,B00,083141,Abi Samra; Nicholas Camill,0,0,30,30
1650582592140,MATH 10A,A01,083735,Patchell; Gregory David,4,0,30,26
1650582592140,MATH 10A,A02,083736,Patchell; Gregory David,27,0,30,3
1650582592140,MATH 10A,A03,083737,Patchell; Gregory David,24,0,30,6
1650582598168,MATH 10B,A01,083207,Staff,0,9,30,30
1650582598168,MATH 10B,A02,083208,Staff,0,8,30,30
1650582598168,MATH 10B,B01,083739,Staff,11,0,30,19
1650582598168,MATH 10B,B02,083740,Staff,28,0,30,2
1650582604194,MATH 18,A01,083743,Staff,0,0,30,30
1650582604194,MATH 18,A02,083744,Staff,26,0,30,4
1650582604194,MATH 18,A03,083745,Staff,22,0,30,8
1650582604194,MATH 18,A04,083746,Staff,26,0,30,4
1650582604194,MATH 18,B01,083748,Staff,0,14,30,30
1650582604194,MATH 18,B02,083749,Staff,0,12,30,30
1650582604194,MATH 18,B03,083750,Staff,0,12,30,30
1650582604194,MATH 18,B04,083751,Staff,0,12,30,30
1650582610218,MATH 20A,A01,083754,Staff,21,0,40,19
1650582616242,MATH 20B,A01,083756,Staff,1,11,30,29
1650582616242,MATH 20B,A02,083757,Staff,0,12,30,30
1650582622272,MATH 20C,A01,083760,Staff,0,16,30,30
1650582622272,MATH 20C,A02,083761,Staff,2,14,30,28
1650582622272,MATH 20C,B01,083762,Staff,11,0,30,19
1650582622272,MATH 20C,B02,083763,Staff,28,0,30,2
1650582628298,MATH 20D,A01,083765,Staff,0,1,30,30
1650582628298,MATH 20D,A02,083766,Staff,8,0,30,22
1650582628298,MATH 20D,A03,083767,Staff,25,0,30,5
1650582634322,MATH 20E,A01,083771,Staff,6,0,30,24
1650582634322,MATH 20E,A02,083772,Staff,18,0,30,12
1650582634322,MATH 20E,B01,083773,Staff,0,0,30,30
1650582634322,MATH 20E,B02,083774,Staff,9,0,30,21
1650582640347,MATH 103A,A01,083777,Staff,0,15,30,30
1650582640347,MATH 103A,A02,083778,Staff,0,14,30,30
1650582640347,MATH 103A,B01,083779,Staff,0,13,30,30
1650582640347,MATH 103A,B02,083780,Staff,0,13,30,30
1650582646370,MATH 105,A01,085443,Staff,0,21,30,30
1650582652398,MATH 109,A01,083213,Anzaldo; Leesa B,0,7,30,30
1650582652398,MATH 109,A02,083214,Anzaldo; Leesa B,0,7,30,30
1650582652398,MATH 109,B01,083215,Anzaldo; Leesa B,0,5,30,30
1650582652398,MATH 109,B02,083216,Anzaldo; Leesa B,0,6,30,30
1650582658422,MATH 142A,A01,083219,Chow; Bennett,0,16,30,30
1650582658422,MATH 142A,A02,083220,Chow; Bennett,0,15,30,30
1650582658422,MATH 142A,B01,083221,Chow; Bennett,0,14,30,30
1650582658422,MATH 142A,B02,083222,Chow; Bennett,0,13,30,30
1650582664451,MATH 193A,A01,083224,Staff,1,6,30,29
1650582664451,MATH 193A,A02,083225,Staff,0,6,30,30
1650582664451,MATH 193A,A03,083781,Staff,0,6,30,30
1650582664451,MATH 193A,A04,083782,Staff,0,7,30,30
1650582670481,MATH 197,001,091859,McAuley; Julian John,9998,0,9999,1
1650582676532,COGS 9,A01,083615,Staff,1,17,60,59
1650582682558,COGS 11,A01,083617,Boyle; Mary E. T.,18,0,40,22
1650582688585,COGS 13,A01,083071,Staff,0,37,40,40
1650582694619,COGS 14A,A01,092681,Staff,0,29,100,100
1650582700645,COGS 14B,A01,083073,Cheng; Tzu-Han,0,13,50,50
1650582706669,COGS 17,A01,092677,Staff,18,0,75,57
1650582712692,COGS 100,A01,083619,Staff,1,26,60,59
1650582718721,COGS 101A,A01,083621,Davis; Joshua Daniel,0,26,60,60
1650582724754,COGS 101B,A01,091572,Staff,1,5,60,59
1650582730783,COGS 101C,A01,083625,Delgado; Tania,15,0,30,15
1650582736814,COGS 107A,A01,083627,Boyle; Mary E. T.,0,12,60,60
1650582742850,COGS 118A,A01,083075,Staff,0,4,60,60
1650582748883,CSE 3,A50,083646,Miranda; Gregory Joseph,19,0,38,19
1650582748883,CSE 3,A51,083647,Miranda; Gregory Joseph,36,0,37,1
1650582754907,CSE 8A,A50,083650,Miranda; Gregory Joseph,0,30,40,40
1650582760932,CSE 11,A01,083080,Cao; Yingjun,0,94,40,40
1650582766966,CSE 12,A01,083652,Staff,0,19,100,100
1650582772990,CSE 15L,A01,083654,Staff,0,1,50,50
1650582772990,CSE 15L,A02,083655,Staff,0,1,50,50
1650582779022,CSE 20,A01,083657,Staff,52,0,80,28
1650582785046,CSE 30,A01,083084,Eldon; John,0,78,40,40
1650582791069,CSE 100,A01,083659,Cao; Yingjun,0,66,50,50
1650582797092,CSE 134B,A01,083661,Powell; Thomas Allan,0,35,65,65
1650582803119,CSE 140,A01,083663,Staff,1,7,75,74
1650582809142,CSE 140L,A01,083088,Eldon; John,1,13,75,74
1650582815175,CSE 175,A01,083665,Kumar; Rakesh,7,0,25,18
1650582821218,CSE 190,A00,092507,Dubnov; Shlomo,10,0,20,10
1650582827246,ECE 45,A01,083139,Staff,1,2,60,59
1650582833273,ECE 65,A50,083695,Staff,1,6,30,29
1650582839311,ECE 109,A01,091882,Touri; Behrouz,33,0,70,37
1650582845338,ECE 180,A00,083140,Abi Samra; Nicholas Camill,21,0,30,9
1650582845338,ECE 180,B00,083141,Abi Samra; Nicholas Camill,0,0,30,30
1650582851362,MATH 10A,A01,083735,Patchell; Gregory David,4,0,30,26
1650582851362,MATH 10A,A02,083736,Patchell; Gregory David,27,0,30,3
1650582851362,MATH 10A,A03,083737,Patchell; Gregory David,24,0,30,6
1650582857396,MATH 10B,A01,083207,Staff,0,9,30,30
1650582857396,MATH 10B,A02,083208,Staff,0,8,30,30
1650582857396,MATH 10B,B01,083739,Staff,11,0,30,19
1650582857396,MATH 10B,B02,083740,Staff,28,0,30,2
1650582863428,MATH 18,A01,083743,Staff,0,0,30,30
1650582863428,MATH 18,A02,083744,Staff,26,0,30,4
1650582863428,MATH 18,A03,083745,Staff,22,0,30,8
1650582863428,MATH 18,A04,083746,Staff,26,0,30,4
1650582863428,MATH 18,B01,083748,Staff,0,14,30,30
1650582863428,MATH 18,B02,083749,Staff,0,12,30,30
1650582863428,MATH 18,B03,083750,Staff,0,12,30,30
1650582863428,MATH 18,B04,083751,Staff,0,12,30,30
1650582869454,MATH 20A,A01,083754,Staff,21,0,40,19
1650582875477,MATH 20B,A01,083756,Staff,1,11,30,29
1650582875477,MATH 20B,A02,083757,Staff,0,12,30,30
1650582881504,MATH 20C,A01,083760,Staff,0,16,30,30
1650582881504,MATH 20C,A02,083761,Staff,2,14,30,28
1650582881504,MATH 20C,B01,083762,Staff,11,0,30,19
1650582881504,MATH 20C,B02,083763,Staff,28,0,30,2
1650582887537,MATH 20D,A01,083765,Staff,0,1,30,30
1650582887537,MATH 20D,A02,083766,Staff,8,0,30,22
1650582887537,MATH 20D,A03,083767,Staff,25,0,30,5
1650582893561,MATH 20E,A01,083771,Staff,6,0,30,24
1650582893561,MATH 20E,A02,083772,Staff,18,0,30,12
1650582893561,MATH 20E,B01,083773,Staff,0,0,30,30
1650582893561,MATH 20E,B02,083774,Staff,9,0,30,21
1650582899595,MATH 103A,A01,083777,Staff,0,15,30,30
1650582899595,MATH 103A,A02,083778,Staff,0,14,30,30
1650582899595,MATH 103A,B01,083779,Staff,0,13,30,30
1650582899595,MATH 103A,B02,083780,Staff,0,13,30,30
1650582905619,MATH 105,A01,085443,Staff,0,21,30,30
1650582911642,MATH 109,A01,083213,Anzaldo; Leesa B,0,7,30,30
1650582911642,MATH 109,A02,083214,Anzaldo; Leesa B,0,7,30,30
1650582911642,MATH 109,B01,083215,Anzaldo; Leesa B,0,5,30,30
1650582911642,MATH 109,B02,083216,Anzaldo; Leesa B,0,6,30,30
1650582917666,MATH 142A,A01,083219,Chow; Bennett,0,16,30,30
1650582917666,MATH 142A,A02,083220,Chow; Bennett,0,15,30,30
1650582917666,MATH 142A,B01,083221,Chow; Bennett,0,14,30,30
1650582917666,MATH 142A,B02,083222,Chow; Bennett,0,13,30,30
1650582923694,MATH 193A,A01,083224,Staff,1,6,30,29
1650582923694,MATH 193A,A02,083225,Staff,0,6,30,30
1650582923694,MATH 193A,A03,083781,Staff,0,6,30,30
1650582923694,MATH 193A,A04,083782,Staff,0,7,30,30
1650582929719,MATH 197,001,091859,McAuley; Julian John,9998,0,9999,1
1650582935785,COGS 9,A01,083615,Staff,1,17,60,59
1650582941808,COGS 11,A01,083617,Boyle; Mary E. T.,18,0,40,22
1650582947838,COGS 13,A01,083071,Staff,0,37,40,40
1650582953861,COGS 14A,A01,092681,Staff,0,29,100,100
1650582959896,COGS 14B,A01,083073,Cheng; Tzu-Han,0,13,50,50
1650582965933,COGS 17,A01,092677,Staff,17,0,75,58
1650582971963,COGS 100,A01,083619,Staff,1,26,60,59
1650582977990,COGS 101A,A01,083621,Davis; Joshua Daniel,0,26,60,60
1650582984121,COGS 101B,A01,091572,Staff,1,5,60,59
1650582990144,COGS 101C,A01,083625,Delgado; Tania,15,0,30,15
1650582996168,COGS 107A,A01,083627,Boyle; Mary E. T.,0,12,60,60
1650583002193,COGS 118A,A01,083075,Staff,0,4,60,60
1650583008236,CSE 3,A50,083646,Miranda; Gregory Joseph,19,0,38,19
1650583008236,CSE 3,A51,083647,Miranda; Gregory Joseph,36,0,37,1
1650583014259,CSE 8A,A50,083650,Miranda; Gregory Joseph,0,30,40,40
1650583020288,CSE 11,A01,083080,Cao; Yingjun,0,94,40,40
1650583026321,CSE 12,A01,083652,Staff,0,19,100,100
1650583032346,CSE 15L,A01,083654,Staff,0,1,50,50
1650583032346,CSE 15L,A02,083655,Staff,0,1,50,50
1650583038370,CSE 20,A01,083657,Staff,52,0,80,28
1650583044397,CSE 30,A01,083084,Eldon; John,0,78,40,40
1650583050424,CSE 100,A01,083659,Cao; Yingjun,0,66,50,50
1650583056456,CSE 134B,A01,083661,Powell; Thomas Allan,0,35,65,65
1650583062481,CSE 140,A01,083663,Staff,1,7,75,74
1650583068507,CSE 140L,A01,083088,Eldon; John,1,13,75,74
1650583074537,CSE 175,A01,083665,Kumar; Rakesh,7,0,25,18
1650583080566,CSE 190,A00,092507,Dubnov; Shlomo,10,0,20,10
1650583086590,ECE 45,A01,083139,Staff,1,2,60,59
1650583092615,ECE 65,A50,083695,Staff,1,6,30,29
1650583098641,ECE 109,A01,091882,Touri; Behrouz,33,0,70,37
1650583104673,ECE 180,A00,083140,Abi Samra; Nicholas Camill,21,0,30,9
1650583104673,ECE 180,B00,083141,Abi Samra; Nicholas Camill,0,0,30,30
1650583110699,MATH 10A,A01,083735,Patchell; Gregory David,4,0,30,26
1650583110699,MATH 10A,A02,083736,Patchell; Gregory David,27,0,30,3
1650583110699,MATH 10A,A03,083737,Patchell; Gregory David,24,0,30,6
1650583116734,MATH 10B,A01,083207,Staff,0,9,30,30
1650583116734,MATH 10B,A02,083208,Staff,0,8,30,30
1650583116734,MATH 10B,B01,083739,Staff,11,0,30,19
1650583116734,MATH 10B,B02,083740,Staff,28,0,30,2
1650583122762,MATH 18,A01,083743,Staff,0,0,30,30
1650583122762,MATH 18,A02,083744,Staff,26,0,30,4
1650583122762,MATH 18,A03,083745,Staff,22,0,30,8
1650583122762,MATH 18,A04,083746,Staff,26,0,30,4
1650583122762,MATH 18,B01,083748,Staff,0,14,30,30
1650583122762,MATH 18,B02,083749,Staff,0,12,30,30
1650583122762,MATH 18,B03,083750,Staff,0,12,30,30
1650583122762,MATH 18,B04,083751,Staff,0,12,30,30
1650583128792,MATH 20A,A01,083754,Staff,21,0,40,19
1650583134816,MATH 20B,A01,083756,Staff,1,11,30,29
1650583134816,MATH 20B,A02,083757,Staff,0,12,30,30
1650583140838,MATH 20C,A01,083760,Staff,0,16,30,30
1650583140838,MATH 20C,A02,083761,Staff,2,14,30,28
1650583140838,MATH 20C,B01,083762,Staff,11,0,30,19
1650583140838,MATH 20C,B02,083763,Staff,28,0,30,2
1650583146861,MATH 20D,A01,083765,Staff,0,1,30,30
1650583146861,MATH 20D,A02,083766,Staff,8,0,30,22
1650583146861,MATH 20D,A03,083767,Staff,25,0,30,5
1650583152895,MATH 20E,A01,083771,Staff,6,0,30,24
1650583152895,MATH 20E,A02,083772,Staff,18,0,30,12
1650583152895,MATH 20E,B01,083773,Staff,0,0,30,30
1650583152895,MATH 20E,B02,083774,Staff,9,0,30,21
1650583158930,MATH 103A,A01,083777,Staff,0,15,30,30
1650583158930,MATH 103A,A02,083778,Staff,0,14,30,30
1650583158930,MATH 103A,B01,083779,Staff,0,13,30,30
1650583158930,MATH 103A,B02,083780,Staff,0,13,30,30
1650583164964,MATH 105,A01,085443,Staff,0,21,30,30
1650583170988,MATH 109,A01,083213,Anzaldo; Leesa B,0,7,30,30
1650583170988,MATH 109,A02,083214,Anzaldo; Leesa B,0,7,30,30
1650583170988,MATH 109,B01,083215,Anzaldo; Leesa B,0,5,30,30
1650583170988,MATH 109,B02,083216,Anzaldo; Leesa B,0,6,30,30
1650583177017,MATH 142A,A01,083219,Chow; Bennett,0,16,30,30
1650583177017,MATH 142A,A02,083220,Chow; Bennett,0,15,30,30
1650583177017,MATH 142A,B01,083221,Chow; Bennett,0,14,30,30
1650583177017,MATH 142A,B02,083222,Chow; Bennett,0,13,30,30
1650583183045,MATH 193A,A01,083224,Staff,1,6,30,29
1650583183045,MATH 193A,A02,083225,Staff,0,6,30,30
1650583183045,MATH 193A,A03,083781,Staff,0,6,30,30
1650583183045,MATH 193A,A04,083782,Staff,0,7,30,30
1650583189069,MATH 197,001,091859,McAuley; Julian John,9998,0,9999,1
1650583195122,COGS 9,A01,083615,Staff,1,17,60,59
1650583201146,COGS 11,A01,083617,Boyle; Mary E. T.,18,0,40,22
1650583207176,COGS 13,A01,083071,Staff,0,37,40,40
1650583213202,COGS 14A,A01,092681,Staff,0,29,100,100
1650583219234,COGS 14B,A01,083073,Cheng; Tzu-Han,0,13,50,50
1650583225271,COGS 17,A01,092677,Staff,17,0,75,58
1650583231294,COGS 100,A01,083619,Staff,1,26,60,59
1650583237320,COGS 101A,A01,083621,Davis; Joshua Daniel,0,26,60,60
1650583243344,COGS 101B,A01,091572,Staff,1,5,60,59
1650583249368,COGS 101C,A01,083625,Delgado; Tania,15,0,30,15
1650583255394,COGS 107A,A01,083627,Boyle; Mary E. T.,0,12,60,60
1650583261418,COGS 118A,A01,083075,Staff,0,4,60,60
1650583267446,CSE 3,A50,083646,Miranda; Gregory Joseph,19,0,38,19
1650583267446,CSE 3,A51,083647,Miranda; Gregory Joseph,36,0,37,1
1650583273481,CSE 8A,A50,083650,Miranda; Gregory Joseph,0,30,40,40
1650583279511,CSE 11,A01,083080,Cao; Yingjun,0,94,40,40
1650583285543,CSE 12,A01,083652,Staff,0,19,100,100
1650583291577,CSE 15L,A01,083654,Staff,0,1,50,50
1650583291577,CSE 15L,A02,083655,Staff,0,1,50,50
1650583297603,CSE 20,A01,083657,Staff,52,0,80,28
1650583303628,CSE 30,A01,083084,Eldon; John,0,78,40,40
1650583309651,CSE 100,A01,083659,Cao; Yingjun,0,66,50,50
1650583315673,CSE 134B,A01,083661,Powell; Thomas Allan,0,35,65,65
1650583321700,CSE 140,A01,083663,Staff,1,7,75,74
1650583327735,CSE 140L,A01,083088,Eldon; John,1,13,75,74
1650583333759,CSE 175,A01,083665,Kumar; Rakesh,7,0,25,18
1650583339783,CSE 190,A00,092507,Dubnov; Shlomo,10,0,20,10
1650583345806,ECE 45,A01,083139,Staff,1,2,60,59
1650583351832,ECE 65,A50,083695,Staff,1,6,30,29
1650583357857,ECE 109,A01,091882,Touri; Behrouz,33,0,70,37
1650583363886,ECE 180,A00,083140,Abi Samra; Nicholas Camill,21,0,30,9
1650583363886,ECE 180,B00,083141,Abi Samra; Nicholas Camill,0,0,30,30
1650583369909,MATH 10A,A01,083735,Patchell; Gregory David,4,0,30,26
1650583369909,MATH 10A,A02,083736,Patchell; Gregory David,27,0,30,3
1650583369909,MATH 10A,A03,083737,Patchell; Gregory David,24,0,30,6
1650583375938,MATH 10B,A01,083207,Staff,0,9,30,30
1650583375938,MATH 10B,A02,083208,Staff,0,8,30,30
1650583375938,MATH 10B,B01,083739,Staff,11,0,30,19
1650583375938,MATH 10B,B02,083740,Staff,28,0,30,2
1650583381974,MATH 18,A01,083743,Staff,0,0,30,30
1650583381974,MATH 18,A02,083744,Staff,26,0,30,4
1650583381974,MATH 18,A03,083745,Staff,22,0,30,8
1650583381974,MATH 18,A04,083746,Staff,26,0,30,4
1650583381974,MATH 18,B01,083748,Staff,0,14,30,30
1650583381974,MATH 18,B02,083749,Staff,0,12,30,30
1650583381974,MATH 18,B03,083750,Staff,0,12,30,30
1650583381974,MATH 18,B04,083751,Staff,0,12,30,30
1650583388009,MATH 20A,A01,083754,Staff,21,0,40,19
1650583394040,MATH 20B,A01,083756,Staff,1,11,30,29
1650583394040,MATH 20B,A02,083757,Staff,0,12,30,30
1650583400072,MATH 20C,A01,083760,Staff,0,16,30,30
1650583400072,MATH 20C,A02,083761,Staff,2,14,30,28
1650583400072,MATH 20C,B01,083762,Staff,11,0,30,19
1650583400072,MATH 20C,B02,083763,Staff,28,0,30,2
1650583406109,MATH 20D,A01,083765,Staff,0,1,30,30
1650583406109,MATH 20D,A02,083766,Staff,8,0,30,22
1650583406109,MATH 20D,A03,083767,Staff,25,0,30,5
1650583412132,MATH 20E,A01,083771,Staff,6,0,30,24
1650583412132,MATH 20E,A02,083772,Staff,18,0,30,12
1650583412132,MATH 20E,B01,083773,Staff,0,0,30,30
1650583412132,MATH 20E,B02,083774,Staff,9,0,30,21
1650583418159,MATH 103A,A01,083777,Staff,0,15,30,30
1650583418159,MATH 103A,A02,083778,Staff,0,14,30,30
1650583418159,MATH 103A,B01,083779,Staff,0,13,30,30
1650583418159,MATH 103A,B02,083780,Staff,0,13,30,30
1650583424185,MATH 105,A01,085443,Staff,0,21,30,30
1650583430213,MATH 109,A01,083213,Anzaldo; Leesa B,0,7,30,30
1650583430213,MATH 109,A02,083214,Anzaldo; Leesa B,0,7,30,30
1650583430213,MATH 109,B01,083215,Anzaldo; Leesa B,0,5,30,30
1650583430213,MATH 109,B02,083216,Anzaldo; Leesa B,0,6,30,30
1650583436239,MATH 142A,A01,083219,Chow; Bennett,0,16,30,30
1650583436239,MATH 142A,A02,083220,Chow; Bennett,0,15,30,30
1650583436239,MATH 142A,B01,083221,Chow; Bennett,0,14,30,30
1650583436239,MATH 142A,B02,083222,Chow; Bennett,0,13,30,30
1650583442263,MATH 193A,A01,083224,Staff,1,6,30,29
1650583442263,MATH 193A,A02,083225,Staff,0,6,30,30
1650583442263,MATH 193A,A03,083781,Staff,0,6,30,30
1650583442263,MATH 193A,A04,083782,Staff,0,7,30,30
1650583448287,MATH 197,001,091859,McAuley; Julian John,9998,0,9999,1
1650583454348,COGS 9,A01,083615,Staff,1,17,60,59
1650583460378,COGS 11,A01,083617,Boyle; Mary E. T.,18,0,40,22
1650583466422,COGS 13,A01,083071,Staff,0,37,40,40
1650583472446,COGS 14A,A01,092681,Staff,0,29,100,100
1650583478468,COGS 14B,A01,083073,Cheng; Tzu-Han,0,13,50,50
1650583484505,COGS 17,A01,092677,Staff,17,0,75,58
1650583490539,COGS 100,A01,083619,Staff,1,26,60,59
1650583496566,COGS 101A,A01,083621,Davis; Joshua Daniel,0,26,60,60
1650583502593,COGS 101B,A01,091572,Staff,1,5,60,59
1650583508617,COGS 101C,A01,083625,Delgado; Tania,15,0,30,15
1650583514646,COGS 107A,A01,083627,Boyle; Mary E. T.,0,13,60,60
1650583520672,COGS 118A,A01,083075,Staff,0,4,60,60
1650583526697,CSE 3,A50,083646,Miranda; Gregory Joseph,19,0,38,19
1650583526697,CSE 3,A51,083647,Miranda; Gregory Joseph,36,0,37,1
1650583532721,CSE 8A,A50,083650,Miranda; Gregory Joseph,0,30,40,40
1650583538756,CSE 11,A01,083080,Cao; Yingjun,0,94,40,40
1650583544780,CSE 12,A01,083652,Staff,0,19,100,100
1650583550808,CSE 15L,A01,083654,Staff,0,1,50,50
1650583550808,CSE 15L,A02,083655,Staff,0,1,50,50
1650583556838,CSE 20,A01,083657,Staff,52,0,80,28
1650583562861,CSE 30,A01,083084,Eldon; John,0,78,40,40
1650583568888,CSE 100,A01,083659,Cao; Yingjun,0,66,50,50
1650583574913,CSE 134B,A01,083661,Powell; Thomas Allan,0,35,65,65
1650583581023,CSE 140,A01,083663,Staff,1,7,75,74
1650583587046,CSE 140L,A01,083088,Eldon; John,1,13,75,74
1650583593070,CSE 175,A01,083665,Kumar; Rakesh,7,0,25,18
1650583599099,CSE 190,A00,092507,Dubnov; Shlomo,10,0,20,10
1650583605124,ECE 45,A01,083139,Staff,1,2,60,59
1650583611148,ECE 65,A50,083695,Staff,1,6,30,29
1650583617174,ECE 109,A01,091882,Touri; Behrouz,33,0,70,37
1650583623200,ECE 180,A00,083140,Abi Samra; Nicholas Camill,21,0,30,9
1650583623200,ECE 180,B00,083141,Abi Samra; Nicholas Camill,0,0,30,30
1650583629224,MATH 10A,A01,083735,Patchell; Gregory David,4,0,30,26
1650583629224,MATH 10A,A02,083736,Patchell; Gregory David,27,0,30,3
1650583629224,MATH 10A,A03,083737,Patchell; Gregory David,24,0,30,6
1650583635248,MATH 10B,A01,083207,Staff,0,9,30,30
1650583635248,MATH 10B,A02,083208,Staff,0,8,30,30
1650583635248,MATH 10B,B01,083739,Staff,11,0,30,19
1650583635248,MATH 10B,B02,083740,Staff,28,0,30,2
1650583641273,MATH 18,A01,083743,Staff,0,0,30,30
1650583641273,MATH 18,A02,083744,Staff,26,0,30,4
1650583641273,MATH 18,A03,083745,Staff,22,0,30,8
1650583641273,MATH 18,A04,083746,Staff,26,0,30,4
1650583641273,MATH 18,B01,083748,Staff,0,14,30,30
1650583641273,MATH 18,B02,083749,Staff,0,12,30,30
1650583641273,MATH 18,B03,083750,Staff,0,12,30,30
1650583641273,MATH 18,B04,083751,Staff,0,12,30,30
1650583647297,MATH 20A,A01,083754,Staff,21,0,40,19
1650583653321,MATH 20B,A01,083756,Staff,1,11,30,29
1650583653321,MATH 20B,A02,083757,Staff,0,12,30,30
1650583659360,MATH 20C,A01,083760,Staff,0,16,30,30
1650583659360,MATH 20C,A02,083761,Staff,2,14,30,28
1650583659360,MATH 20C,B01,083762,Staff,11,0,30,19
1650583659360,MATH 20C,B02,083763,Staff,28,0,30,2
1650583665386,MATH 20D,A01,083765,Staff,0,1,30,30
1650583665386,MATH 20D,A02,083766,Staff,8,0,30,22
1650583665386,MATH 20D,A03,083767,Staff,25,0,30,5
1650583671413,MATH 20E,A01,083771,Staff,6,0,30,24
1650583671413,MATH 20E,A02,083772,Staff,18,0,30,12
1650583671413,MATH 20E,B01,083773,Staff,0,0,30,30
1650583671413,MATH 20E,B02,083774,Staff,9,0,30,21
1650583677437,MATH 103A,A01,083777,Staff,0,15,30,30
1650583677437,MATH 103A,A02,083778,Staff,0,14,30,30
1650583677437,MATH 103A,B01,083779,Staff,0,13,30,30
1650583677437,MATH 103A,B02,083780,Staff,0,13,30,30
1650583683462,MATH 105,A01,085443,Staff,0,21,30,30
1650583689498,MATH 109,A01,083213,Anzaldo; Leesa B,0,7,30,30
1650583689498,MATH 109,A02,083214,Anzaldo; Leesa B,0,7,30,30
1650583689498,MATH 109,B01,083215,Anzaldo; Leesa B,0,5,30,30
1650583689498,MATH 109,B02,083216,Anzaldo; Leesa B,0,6,30,30
1650583695527,MATH 142A,A01,083219,Chow; Bennett,0,16,30,30
1650583695527,MATH 142A,A02,083220,Chow; Bennett,0,15,30,30
1650583695527,MATH 142A,B01,083221,Chow; Bennett,0,14,30,30
1650583695527,MATH 142A,B02,083222,Chow; Bennett,0,13,30,30
1650583701569,MATH 193A,A01,083224,Staff,1,6,30,29
1650583701569,MATH 193A,A02,083225,Staff,0,6,30,30
1650583701569,MATH 193A,A03,083781,Staff,0,6,30,30
1650583701569,MATH 193A,A04,083782,Staff,0,7,30,30
1650583707594,MATH 197,001,091859,McAuley; Julian John,9998,0,9999,1
1650583713658,COGS 9,A01,083615,Staff,1,17,60,59
1650583719691,COGS 11,A01,083617,Boyle; Mary E. T.,18,0,40,22
1650583725720,COGS 13,A01,083071,Staff,0,37,40,40
1650583731743,COGS 14A,A01,092681,Staff,0,29,100,100
1650583737775,COGS 14B,A01,083073,Cheng; Tzu-Han,0,13,50,50
1650583743800,COGS 17,A01,092677,Staff,17,0,75,58
1650583749829,COGS 100,A01,083619,Staff,1,26,60,59
1650583755865,COGS 101A,A01,083621,Davis; Joshua Daniel,0,26,60,60
1650583761892,COGS 101B,A01,091572,Staff,1,5,60,59
1650583767915,COGS 101C,A01,083625,Delgado; Tania,15,0,30,15
1650583773941,COGS 107A,A01,083627,Boyle; Mary E. T.,0,13,60,60
1650583779966,COGS 118A,A01,083075,Staff,0,4,60,60
1650583785990,CSE 3,A50,083646,Miranda; Gregory Joseph,19,0,38,19
1650583785990,CSE 3,A51,083647,Miranda; Gregory Joseph,36,0,37,1
1650583792015,CSE 8A,A50,083650,Miranda; Gregory Joseph,0,30,40,40
1650583798049,CSE 11,A01,083080,Cao; Yingjun,0,94,40,40
1650583804076,CSE 12,A01,083652,Staff,0,19,100,100
1650583810105,CSE 15L,A01,083654,Staff,0,1,50,50
1650583810105,CSE 15L,A02,083655,Staff,0,1,50,50
1650583816132,CSE 20,A01,083657,Staff,52,0,80,28
1650583822165,CSE 30,A01,083084,Eldon; John,0,78,40,40
1650583828190,CSE 100,A01,083659,Cao; Yingjun,0,66,50,50
1650583834217,CSE 134B,A01,083661,Powell; Thomas Allan,0,35,65,65
1650583840243,CSE 140,A01,083663,Staff,1,7,75,74
1650583846268,CSE 140L,A01,083088,Eldon; John,1,13,75,74
1650583852291,CSE 175,A01,083665,Kumar; Rakesh,7,0,25,18
1650583858338,CSE 190,A00,092507,Dubnov; Shlomo,10,0,20,10
1650583864361,ECE 45,A01,083139,Staff,1,2,60,59
1650583870393,ECE 65,A50,083695,Staff,1,6,30,29
1650583876420,ECE 109,A01,091882,Touri; Behrouz,33,0,70,37
1650583882444,ECE 180,A00,083140,Abi Samra; Nicholas Camill,21,0,30,9
1650583882444,ECE 180,B00,083141,Abi Samra; Nicholas Camill,0,0,30,30
1650583888469,MATH 10A,A01,083735,Patchell; Gregory David,4,0,30,26
1650583888469,MATH 10A,A02,083736,Patchell; Gregory David,27,0,30,3
1650583888469,MATH 10A,A03,083737,Patchell; Gregory David,24,0,30,6
1650583894491,MATH 10B,A01,083207,Staff,0,9,30,30
1650583894491,MATH 10B,A02,083208,Staff,0,8,30,30
1650583894491,MATH 10B,B01,083739,Staff,11,0,30,19
1650583894491,MATH 10B,B02,083740,Staff,28,0,30,2
1650583900527,MATH 18,A01,083743,Staff,0,0,30,30
1650583900527,MATH 18,A02,083744,Staff,26,0,30,4
1650583900527,MATH 18,A03,083745,Staff,22,0,30,8
1650583900527,MATH 18,A04,083746,Staff,26,0,30,4
1650583900527,MATH 18,B01,083748,Staff,0,14,30,30
1650583900527,MATH 18,B02,083749,Staff,0,12,30,30
1650583900527,MATH 18,B03,083750,Staff,0,12,30,30
1650583900527,MATH 18,B04,083751,Staff,0,12,30,30
1650583906554,MATH 20A,A01,083754,Staff,21,0,40,19
1650583912583,MATH 20B,A01,083756,Staff,1,11,30,29
1650583912583,MATH 20B,A02,083757,Staff,0,12,30,30
1650583918611,MATH 20C,A01,083760,Staff,0,16,30,30
1650583918611,MATH 20C,A02,083761,Staff,2,14,30,28
1650583918611,MATH 20C,B01,083762,Staff,11,0,30,19
1650583918611,MATH 20C,B02,083763,Staff,28,0,30,2
1650583924636,MATH 20D,A01,083765,Staff,0,1,30,30
1650583924636,MATH 20D,A02,083766,Staff,8,0,30,22
1650583924636,MATH 20D,A03,083767,Staff,25,0,30,5
1650583930661,MATH 20E,A01,083771,Staff,6,0,30,24
1650583930661,MATH 20E,A02,083772,Staff,18,0,30,12
1650583930661,MATH 20E,B01,083773,Staff,0,0,30,30
1650583930661,MATH 20E,B02,083774,Staff,9,0,30,21
1650583936690,MATH 103A,A01,083777,Staff,0,15,30,30
1650583936690,MATH 103A,A02,083778,Staff,0,14,30,30
1650583936690,MATH 103A,B01,083779,Staff,0,13,30,30
1650583936690,MATH 103A,B02,083780,Staff,0,13,30,30
1650583942720,MATH 105,A01,085443,Staff,0,21,30,30
1650583948748,MATH 109,A01,083213,Anzaldo; Leesa B,0,7,30,30
1650583948748,MATH 109,A02,083214,Anzaldo; Leesa B,0,7,30,30
1650583948748,MATH 109,B01,083215,Anzaldo; Leesa B,0,5,30,30
1650583948748,MATH 109,B02,083216,Anzaldo; Leesa B,0,6,30,30
1650583954792,MATH 142A,A01,083219,Chow; Bennett,0,16,30,30
1650583954792,MATH 142A,A02,083220,Chow; Bennett,0,15,30,30
1650583954792,MATH 142A,B01,083221,Chow; Bennett,0,14,30,30
1650583954792,MATH 142A,B02,083222,Chow; Bennett,0,13,30,30
1650583960815,MATH 193A,A01,083224,Staff,1,6,30,29
1650583960815,MATH 193A,A02,083225,Staff,0,6,30,30
1650583960815,MATH 193A,A03,083781,Staff,0,6,30,30
1650583960815,MATH 193A,A04,083782,Staff,0,7,30,30
1650583966839,MATH 197,001,091859,McAuley; Julian John,9998,0,9999,1
1650583972898,COGS 9,A01,083615,Staff,1,17,60,59
1650583978925,COGS 11,A01,083617,Boyle; Mary E. T.,18,0,40,22
1650583984948,COGS 13,A01,083071,Staff,0,37,40,40
1650583990975,COGS 14A,A01,092681,Staff,0,29,100,100
1650583997006,COGS 14B,A01,083073,Cheng; Tzu-Han,0,13,50,50
1650584003044,COGS 17,A01,092677,Staff,17,0,75,58
1650584009070,COGS 100,A01,083619,Staff,1,26,60,59
1650584015103,COGS 101A,A01,083621,Davis; Joshua Daniel,0,26,60,60
1650584021130,COGS 101B,A01,091572,Staff,1,5,60,59
1650584027154,COGS 101C,A01,083625,Delgado; Tania,15,0,30,15
1650584033178,COGS 107A,A01,083627,Boyle; Mary E. T.,0,13,60,60
1650584039210,COGS 118A,A01,083075,Staff,0,4,60,60
1650584045236,CSE 3,A50,083646,Miranda; Gregory Joseph,19,0,38,19
1650584045236,CSE 3,A51,083647,Miranda; Gregory Joseph,36,0,37,1
1650584051264,CSE 8A,A50,083650,Miranda; Gregory Joseph,0,30,40,40
1650584057291,CSE 11,A01,083080,Cao; Yingjun,0,94,40,40
1650584063318,CSE 12,A01,083652,Staff,0,19,100,100
1650584069341,CSE 15L,A01,083654,Staff,0,1,50,50
1650584069341,CSE 15L,A02,083655,Staff,0,1,50,50
1650584075365,CSE 20,A01,083657,Staff,52,0,80,28
1650584081389,CSE 30,A01,083084,Eldon; John,0,78,40,40
1650584093200,CSE 100,A01,083659,Cao; Yingjun,0,66,50,50
1650584099226,CSE 134B,A01,083661,Powell; Thomas Allan,0,35,65,65
1650584105271,CSE 140,A01,083663,Staff,1,7,75,74
1650584111302,CSE 140L,A01,083088,Eldon; John,1,13,75,74
1650584117325,CSE 175,A01,083665,Kumar; Rakesh,7,0,25,18
1650584123348,CSE 190,A00,092507,Dubnov; Shlomo,10,0,20,10
1650584129374,ECE 45,A01,083139,Staff,1,2,60,59
1650584135402,ECE 65,A50,083695,Staff,1,6,30,29
1650584141438,ECE 109,A01,091882,Touri; Behrouz,33,0,70,37
1650584147462,ECE 180,A00,083140,Abi Samra; Nicholas Camill,21,0,30,9
1650584147462,ECE 180,B00,083141,Abi Samra; Nicholas Camill,0,0,30,30
1650584153486,MATH 10A,A01,083735,Patchell; Gregory David,4,0,30,26
1650584153486,MATH 10A,A02,083736,Patchell; Gregory David,27,0,30,3
1650584153486,MATH 10A,A03,083737,Patchell; Gregory David,24,0,30,6
1650584159511,MATH 10B,A01,083207,Staff,0,9,30,30
1650584159511,MATH 10B,A02,083208,Staff,0,8,30,30
1650584159511,MATH 10B,B01,083739,Staff,11,0,30,19
1650584159511,MATH 10B,B02,083740,Staff,28,0,30,2
1650584165546,MATH 18,A01,083743,Staff,0,0,30,30
1650584165546,MATH 18,A02,083744,Staff,26,0,30,4
1650584165546,MATH 18,A03,083745,Staff,22,0,30,8
1650584165546,MATH 18,A04,083746,Staff,26,0,30,4
1650584165546,MATH 18,B01,083748,Staff,0,14,30,30
1650584165546,MATH 18,B02,083749,Staff,0,12,30,30
1650584165546,MATH 18,B03,083750,Staff,0,12,30,30
1650584165546,MATH 18,B04,083751,Staff,0,12,30,30
1650584171573,MATH 20A,A01,083754,Staff,21,0,40,19
1650584177596,MATH 20B,A01,083756,Staff,1,11,30,29
1650584177596,MATH 20B,A02,083757,Staff,0,12,30,30
1650584183709,MATH 20C,A01,083760,Staff,0,16,30,30
1650584183709,MATH 20C,A02,083761,Staff,2,14,30,28
1650584183709,MATH 20C,B01,083762,Staff,11,0,30,19
1650584183709,MATH 20C,B02,083763,Staff,28,0,30,2
1650584189734,MATH 20D,A01,083765,Staff,0,1,30,30
1650584189734,MATH 20D,A02,083766,Staff,8,0,30,22
1650584189734,MATH 20D,A03,083767,Staff,25,0,30,5
1650584195758,MATH 20E,A01,083771,Staff,6,0,30,24
1650584195758,MATH 20E,A02,083772,Staff,18,0,30,12
1650584195758,MATH 20E,B01,083773,Staff,0,0,30,30
1650584195758,MATH 20E,B02,083774,Staff,9,0,30,21
1650584201783,MATH 103A,A01,083777,Staff,0,15,30,30
1650584201783,MATH 103A,A02,083778,Staff,0,14,30,30
1650584201783,MATH 103A,B01,083779,Staff,0,13,30,30
1650584201783,MATH 103A,B02,083780,Staff,0,13,30,30
1650584207808,MATH 105,A01,085443,Staff,0,21,30,30
1650584213846,MATH 109,A01,083213,Anzaldo; Leesa B,0,7,30,30
1650584213846,MATH 109,A02,083214,Anzaldo; Leesa B,0,7,30,30
1650584213846,MATH 109,B01,083215,Anzaldo; Leesa B,0,5,30,30
1650584213846,MATH 109,B02,083216,Anzaldo; Leesa B,0,6,30,30
1650584219873,MATH 142A,A01,083219,Chow; Bennett,0,16,30,30
1650584219873,MATH 142A,A02,083220,Chow; Bennett,0,15,30,30
1650584219873,MATH 142A,B01,083221,Chow; Bennett,0,14,30,30
1650584219873,MATH 142A,B02,083222,Chow; Bennett,0,13,30,30
1650584225908,MATH 193A,A01,083224,Staff,1,6,30,29
1650584225908,MATH 193A,A02,083225,Staff,0,6,30,30
1650584225908,MATH 193A,A03,083781,Staff,0,6,30,30
1650584225908,MATH 193A,A04,083782,Staff,0,7,30,30
1650584231931,MATH 197,001,091859,McAuley; Julian John,9998,0,9999,1
1650584238008,COGS 9,A01,083615,Staff,1,17,60,59
1650584244032,COGS 11,A01,083617,Boyle; Mary E. T.,18,0,40,22
1650584250060,COGS 13,A01,083071,Staff,0,37,40,40
1650584256086,COGS 14A,A01,092681,Staff,0,29,100,100
1650584262131,COGS 14B,A01,083073,Cheng; Tzu-Han,0,13,50,50
1650584268157,COGS 17,A01,092677,Staff,17,0,75,58
1650584274180,COGS 100,A01,083619,Staff,1,26,60,59
1650584280207,COGS 101A,A01,083621,Davis; Joshua Daniel,0,26,60,60
1650584286231,COGS 101B,A01,091572,Staff,1,5,60,59
1650584292258,COGS 101C,A01,083625,Delgado; Tania,15,0,30,15
1650584298283,COGS 107A,A01,083627,Boyle; Mary E. T.,0,13,60,60
1650584304318,COGS 118A,A01,083075,Staff,0,4,60,60
1650584310346,CSE 3,A50,083646,Miranda; Gregory Joseph,19,0,38,19
1650584310346,CSE 3,A51,083647,Miranda; Gregory Joseph,36,0,37,1
1650584316372,CSE 8A,A50,083650,Miranda; Gregory Joseph,0,30,40,40
1650584322396,CSE 11,A01,083080,Cao; Yingjun,0,94,40,40
1650584328420,CSE 12,A01,083652,Staff,0,19,100,100
1650584334445,CSE 15L,A01,083654,Staff,0,1,50,50
1650584334445,CSE 15L,A02,083655,Staff,0,1,50,50
1650584340467,CSE 20,A01,083657,Staff,52,0,80,28
1650584346492,CSE 30,A01,083084,Eldon; John,0,78,40,40
1650584352516,CSE 100,A01,083659,Cao; Yingjun,0,66,50,50
1650584358554,CSE 134B,A01,083661,Powell; Thomas Allan,0,35,65,65
1650584364577,CSE 140,A01,083663,Staff,1,7,75,74
1650584370603,CSE 140L,A01,083088,Eldon; John,1,13,75,74
1650584376634,CSE 175,A01,083665,Kumar; Rakesh,7,0,25,18
1650584382666,CSE 190,A00,092507,Dubnov; Shlomo,10,0,20,10
1650584388689,ECE 45,A01,083139,Staff,1,2,60,59
1650584394723,ECE 65,A50,083695,Staff,1,6,30,29
1650584400760,ECE 109,A01,091882,Touri; Behrouz,33,0,70,37
1650584406789,ECE 180,A00,083140,Abi Samra; Nicholas Camill,21,0,30,9
1650584406789,ECE 180,B00,083141,Abi Samra; Nicholas Camill,0,0,30,30
1650584412812,MATH 10A,A01,083735,Patchell; Gregory David,4,0,30,26
1650584412812,MATH 10A,A02,083736,Patchell; Gregory David,27,0,30,3
1650584412812,MATH 10A,A03,083737,Patchell; Gregory David,24,0,30,6
1650584418836,MATH 10B,A01,083207,Staff,0,9,30,30
1650584418836,MATH 10B,A02,083208,Staff,0,8,30,30
1650584418836,MATH 10B,B01,083739,Staff,11,0,30,19
1650584418836,MATH 10B,B02,083740,Staff,28,0,30,2
1650584424868,MATH 18,A01,083743,Staff,0,0,30,30
1650584424868,MATH 18,A02,083744,Staff,26,0,30,4
1650584424868,MATH 18,A03,083745,Staff,22,0,30,8
1650584424868,MATH 18,A04,083746,Staff,26,0,30,4
1650584424868,MATH 18,B01,083748,Staff,0,14,30,30
1650584424868,MATH 18,B02,083749,Staff,0,12,30,30
1650584424868,MATH 18,B03,083750,Staff,0,12,30,30
1650584424868,MATH 18,B04,083751,Staff,0,12,30,30
1650584430895,MATH 20A,A01,083754,Staff,21,0,40,19
1650584436930,MATH 20B,A01,083756,Staff,1,11,30,29
1650584436930,MATH 20B,A02,083757,Staff,0,12,30,30
1650584442954,MATH 20C,A01,083760,Staff,0,16,30,30
1650584442954,MATH 20C,A02,083761,Staff,2,14,30,28
1650584442954,MATH 20C,B01,083762,Staff,11,0,30,19
1650584442954,MATH 20C,B02,083763,Staff,28,0,30,2
1650584448981,MATH 20D,A01,083765,Staff,0,1,30,30
1650584448981,MATH 20D,A02,083766,Staff,8,0,30,22
1650584448981,MATH 20D,A03,083767,Staff,25,0,30,5
1650584455009,MATH 20E,A01,083771,Staff,6,0,30,24
1650584455009,MATH 20E,A02,083772,Staff,18,0,30,12
1650584455009,MATH 20E,B01,083773,Staff,0,0,30,30
1650584455009,MATH 20E,B02,083774,Staff,9,0,30,21
1650584461048,MATH 103A,A01,083777,Staff,0,15,30,30
1650584461048,MATH 103A,A02,083778,Staff,0,14,30,30
1650584461048,MATH 103A,B01,083779,Staff,0,13,30,30
1650584461048,MATH 103A,B02,083780,Staff,0,13,30,30
1650584467072,MATH 105,A01,085443,Staff,0,21,30,30
1650584473097,MATH 109,A01,083213,Anzaldo; Leesa B,0,7,30,30
1650584473097,MATH 109,A02,083214,Anzaldo; Leesa B,0,7,30,30
1650584473097,MATH 109,B01,083215,Anzaldo; Leesa B,0,5,30,30
1650584473097,MATH 109,B02,083216,Anzaldo; Leesa B,0,6,30,30
1650584479125,MATH 142A,A01,083219,Chow; Bennett,0,16,30,30
1650584479125,MATH 142A,A02,083220,Chow; Bennett,0,15,30,30
1650584479125,MATH 142A,B01,083221,Chow; Bennett,0,14,30,30
1650584479125,MATH 142A,B02,083222,Chow; Bennett,0,13,30,30
1650584485148,MATH 193A,A01,083224,Staff,1,6,30,29
1650584485148,MATH 193A,A02,083225,Staff,0,6,30,30
1650584485148,MATH 193A,A03,083781,Staff,0,6,30,30
1650584485148,MATH 193A,A04,083782,Staff,0,7,30,30
1650584491173,MATH 197,001,091859,McAuley; Julian John,9998,0,9999,1
1650584497250,COGS 9,A01,083615,Staff,1,17,60,59
1650584503281,COGS 11,A01,083617,Boyle; Mary E. T.,18,0,40,22
1650584509318,COGS 13,A01,083071,Staff,0,37,40,40
1650584515345,COGS 14A,A01,092681,Staff,0,29,100,100
1650584521368,COGS 14B,A01,083073,Cheng; Tzu-Han,0,13,50,50
1650584527398,COGS 17,A01,092677,Staff,16,0,75,59
1650584533438,COGS 100,A01,083619,Staff,1,26,60,59
1650584539463,COGS 101A,A01,083621,Davis; Joshua Daniel,0,26,60,60
1650584545496,COGS 101B,A01,091572,Staff,1,5,60,59
1650584551524,COGS 101C,A01,083625,Delgado; Tania,15,0,30,15
1650584557549,COGS 107A,A01,083627,Boyle; Mary E. T.,0,13,60,60
1650584563573,COGS 118A,A01,083075,Staff,0,4,60,60
1650584569599,CSE 3,A50,083646,Miranda; Gregory Joseph,19,0,38,19
1650584569599,CSE 3,A51,083647,Miranda; Gregory Joseph,36,0,37,1
1650584575632,CSE 8A,A50,083650,Miranda; Gregory Joseph,0,30,40,40
1650584581655,CSE 11,A01,083080,Cao; Yingjun,0,94,40,40
1650584587688,CSE 12,A01,083652,Staff,0,19,100,100
1650584593717,CSE 15L,A01,083654,Staff,0,1,50,50
1650584593717,CSE 15L,A02,083655,Staff,0,1,50,50
1650584599770,CSE 20,A01,083657,Staff,52,0,80,28
1650584605793,CSE 30,A01,083084,Eldon; John,0,78,40,40
1650584611829,CSE 100,A01,083659,Cao; Yingjun,0,66,50,50
1650584617853,CSE 134B,A01,083661,Powell; Thomas Allan,0,35,65,65
1650584623876,CSE 140,A01,083663,Staff,1,7,75,74
1650584629902,CSE 140L,A01,083088,Eldon; John,1,13,75,74
1650584635929,CSE 175,A01,083665,Kumar; Rakesh,7,0,25,18
1650584641959,CSE 190,A00,092507,Dubnov; Shlomo,10,0,20,10
1650584647988,ECE 45,A01,083139,Staff,1,2,60,59
1650584654013,ECE 65,A50,083695,Staff,1,6,30,29
1650584660040,ECE 109,A01,091882,Touri; Behrouz,33,0,70,37
1650584666066,ECE 180,A00,083140,Abi Samra; Nicholas Camill,21,0,30,9
1650584666066,ECE 180,B00,083141,Abi Samra; Nicholas Camill,0,0,30,30
1650584672093,MATH 10A,A01,083735,Patchell; Gregory David,4,0,30,26
1650584672093,MATH 10A,A02,083736,Patchell; Gregory David,27,0,30,3
1650584672093,MATH 10A,A03,083737,Patchell; Gregory David,24,0,30,6
1650584678122,MATH 10B,A01,083207,Staff,0,9,30,30
1650584678122,MATH 10B,A02,083208,Staff,0,8,30,30
1650584678122,MATH 10B,B01,083739,Staff,11,0,30,19
1650584678122,MATH 10B,B02,083740,Staff,28,0,30,2
1650584684148,MATH 18,A01,083743,Staff,0,0,30,30
1650584684148,MATH 18,A02,083744,Staff,26,0,30,4
1650584684148,MATH 18,A03,083745,Staff,22,0,30,8
1650584684148,MATH 18,A04,083746,Staff,26,0,30,4
1650584684148,MATH 18,B01,083748,Staff,0,14,30,30
1650584684148,MATH 18,B02,083749,Staff,0,12,30,30
1650584684148,MATH 18,B03,083750,Staff,0,12,30,30
1650584684148,MATH 18,B04,083751,Staff,0,12,30,30
1650584690172,MATH 20A,A01,083754,Staff,21,0,40,19
1650584696199,MATH 20B,A01,083756,Staff,1,11,30,29
1650584696199,MATH 20B,A02,083757,Staff,0,12,30,30
1650584702227,MATH 20C,A01,083760,Staff,0,16,30,30
1650584702227,MATH 20C,A02,083761,Staff,2,14,30,28
1650584702227,MATH 20C,B01,083762,Staff,11,0,30,19
1650584702227,MATH 20C,B02,083763,Staff,28,0,30,2
1650584708251,MATH 20D,A01,083765,Staff,0,1,30,30
1650584708251,MATH 20D,A02,083766,Staff,8,0,30,22
1650584708251,MATH 20D,A03,083767,Staff,25,0,30,5
1650584714276,MATH 20E,A01,083771,Staff,6,0,30,24
1650584714276,MATH 20E,A02,083772,Staff,18,0,30,12
1650584714276,MATH 20E,B01,083773,Staff,0,0,30,30
1650584714276,MATH 20E,B02,083774,Staff,9,0,30,21
1650584720303,MATH 103A,A01,083777,Staff,0,15,30,30
1650584720303,MATH 103A,A02,083778,Staff,0,14,30,30
1650584720303,MATH 103A,B01,083779,Staff,0,13,30,30
1650584720303,MATH 103A,B02,083780,Staff,0,13,30,30
1650584726326,MATH 105,A01,085443,Staff,0,21,30,30
1650584732349,MATH 109,A01,083213,Anzaldo; Leesa B,0,7,30,30
1650584732349,MATH 109,A02,083214,Anzaldo; Leesa B,0,7,30,30
1650584732349,MATH 109,B01,083215,Anzaldo; Leesa B,0,5,30,30
1650584732349,MATH 109,B02,083216,Anzaldo; Leesa B,0,6,30,30
1650584738378,MATH 142A,A01,083219,Chow; Bennett,0,16,30,30
1650584738378,MATH 142A,A02,083220,Chow; Bennett,0,15,30,30
1650584738378,MATH 142A,B01,083221,Chow; Bennett,0,14,30,30
1650584738378,MATH 142A,B02,083222,Chow; Bennett,0,13,30,30
1650584744409,MATH 193A,A01,083224,Staff,1,6,30,29
1650584744409,MATH 193A,A02,083225,Staff,0,6,30,30
1650584744409,MATH 193A,A03,083781,Staff,0,6,30,30
1650584744409,MATH 193A,A04,083782,Staff,0,7,30,30
1650584750445,MATH 197,001,091859,McAuley; Julian John,9998,0,9999,1
1650584756498,COGS 9,A01,083615,Staff,1,17,60,59
1650584762523,COGS 11,A01,083617,Boyle; Mary E. T.,18,0,40,22
1650584768550,COGS 13,A01,083071,Staff,0,37,40,40
1650584774665,COGS 14A,A01,092681,Staff,0,29,100,100
1650584780696,COGS 14B,A01,083073,Cheng; Tzu-Han,0,13,50,50
1650584786722,COGS 17,A01,092677,Staff,16,0,75,59
1650584792746,COGS 100,A01,083619,Staff,1,26,60,59
1650584798772,COGS 101A,A01,083621,Davis; Joshua Daniel,0,26,60,60
1650584804795,COGS 101B,A01,091572,Staff,1,5,60,59
1650584810841,COGS 101C,A01,083625,Delgado; Tania,15,0,30,15
1650584816869,COGS 107A,A01,083627,Boyle; Mary E. T.,0,13,60,60
1650584822896,COGS 118A,A01,083075,Staff,0,4,60,60
1650584828930,CSE 3,A50,083646,Miranda; Gregory Joseph,19,0,38,19
1650584828930,CSE 3,A51,083647,Miranda; Gregory Joseph,36,0,37,1
1650584834957,CSE 8A,A50,083650,Miranda; Gregory Joseph,0,30,40,40
1650584840983,CSE 11,A01,083080,Cao; Yingjun,0,94,40,40
1650584847012,CSE 12,A01,083652,Staff,0,19,100,100
1650584853037,CSE 15L,A01,083654,Staff,0,1,50,50
1650584853037,CSE 15L,A02,083655,Staff,0,1,50,50
1650584859111,CSE 20,A01,083657,Staff,52,0,80,28
1650584865136,CSE 30,A01,083084,Eldon; John,0,78,40,40
1650584871168,CSE 100,A01,083659,Cao; Yingjun,0,66,50,50
1650584877194,CSE 134B,A01,083661,Powell; Thomas Allan,0,35,65,65
1650584883222,CSE 140,A01,083663,Staff,1,7,75,74
1650584889251,CSE 140L,A01,083088,Eldon; John,1,13,75,74
1650584895277,CSE 175,A01,083665,Kumar; Rakesh,7,0,25,18
1650584901303,CSE 190,A00,092507,Dubnov; Shlomo,11,0,20,9
1650584907327,ECE 45,A01,083139,Staff,1,2,60,59
1650584913351,ECE 65,A50,083695,Staff,1,6,30,29
1650584919376,ECE 109,A01,091882,Touri; Behrouz,33,0,70,37
1650584925400,ECE 180,A00,083140,Abi Samra; Nicholas Camill,21,0,30,9
1650584925400,ECE 180,B00,083141,Abi Samra; Nicholas Camill,0,0,30,30
1650584931423,MATH 10A,A01,083735,Patchell; Gregory David,4,0,30,26
1650584931423,MATH 10A,A02,083736,Patchell; Gregory David,27,0,30,3
1650584931423,MATH 10A,A03,083737,Patchell; Gregory David,24,0,30,6
1650584937457,MATH 10B,A01,083207,Staff,0,9,30,30
1650584937457,MATH 10B,A02,083208,Staff,0,8,30,30
1650584937457,MATH 10B,B01,083739,Staff,11,0,30,19
1650584937457,MATH 10B,B02,083740,Staff,28,0,30,2
1650584943493,MATH 18,A01,083743,Staff,0,0,30,30
1650584943493,MATH 18,A02,083744,Staff,26,0,30,4
1650584943493,MATH 18,A03,083745,Staff,22,0,30,8
1650584943493,MATH 18,A04,083746,Staff,26,0,30,4
1650584943493,MATH 18,B01,083748,Staff,0,14,30,30
1650584943493,MATH 18,B02,083749,Staff,0,12,30,30
1650584943493,MATH 18,B03,083750,Staff,0,12,30,30
1650584943493,MATH 18,B04,083751,Staff,0,12,30,30
1650584949535,MATH 20A,A01,083754,Staff,21,0,40,19
1650584955560,MATH 20B,A01,083756,Staff,1,11,30,29
1650584955560,MATH 20B,A02,083757,Staff,0,12,30,30
1650584961584,MATH 20C,A01,083760,Staff,0,16,30,30
1650584961584,MATH 20C,A02,083761,Staff,2,14,30,28
1650584961584,MATH 20C,B01,083762,Staff,11,0,30,19
1650584961584,MATH 20C,B02,083763,Staff,28,0,30,2
1650584967607,MATH 20D,A01,083765,Staff,0,1,30,30
1650584967607,MATH 20D,A02,083766,Staff,8,0,30,22
1650584967607,MATH 20D,A03,083767,Staff,25,0,30,5
1650584973634,MATH 20E,A01,083771,Staff,6,0,30,24
1650584973634,MATH 20E,A02,083772,Staff,18,0,30,12
1650584973634,MATH 20E,B01,083773,Staff,0,0,30,30
1650584973634,MATH 20E,B02,083774,Staff,9,0,30,21
1650584979657,MATH 103A,A01,083777,Staff,0,15,30,30
1650584979657,MATH 103A,A02,083778,Staff,0,14,30,30
1650584979657,MATH 103A,B01,083779,Staff,0,13,30,30
1650584979657,MATH 103A,B02,083780,Staff,0,13,30,30
1650584985679,MATH 105,A01,085443,Staff,0,21,30,30
1650584991704,MATH 109,A01,083213,Anzaldo; Leesa B,0,7,30,30
1650584991704,MATH 109,A02,083214,Anzaldo; Leesa B,0,7,30,30
1650584991704,MATH 109,B01,083215,Anzaldo; Leesa B,0,5,30,30
1650584991704,MATH 109,B02,083216,Anzaldo; Leesa B,0,6,30,30
1650584997729,MATH 142A,A01,083219,Chow; Bennett,0,16,30,30
1650584997729,MATH 142A,A02,083220,Chow; Bennett,0,15,30,30
1650584997729,MATH 142A,B01,083221,Chow; Bennett,0,14,30,30
1650584997729,MATH 142A,B02,083222,Chow; Bennett,0,13,30,30
1650585003755,MATH 193A,A01,083224,Staff,1,6,30,29
1650585003755,MATH 193A,A02,083225,Staff,0,6,30,30
1650585003755,MATH 193A,A03,083781,Staff,0,6,30,30
1650585003755,MATH 193A,A04,083782,Staff,0,7,30,30
1650585009779,MATH 197,001,091859,McAuley; Julian John,9998,0,9999,1
1650585015828,COGS 9,A01,083615,Staff,1,17,60,59
1650585021864,COGS 11,A01,083617,Boyle; Mary E. T.,18,0,40,22
1650585027892,COGS 13,A01,083071,Staff,0,37,40,40
1650585033917,COGS 14A,A01,092681,Staff,0,29,100,100
1650585039944,COGS 14B,A01,083073,Cheng; Tzu-Han,0,13,50,50
1650585045974,COGS 17,A01,092677,Staff,17,0,75,58
1650585052012,COGS 100,A01,083619,Staff,1,26,60,59
1650585058040,COGS 101A,A01,083621,Davis; Joshua Daniel,0,26,60,60
1650585064063,COGS 101B,A01,091572,Staff,1,5,60,59
1650585070092,COGS 101C,A01,083625,Delgado; Tania,15,0,30,15
1650585076120,COGS 107A,A01,083627,Boyle; Mary E. T.,0,13,60,60
1650585082162,COGS 118A,A01,083075,Staff,0,4,60,60
1650585088186,CSE 3,A50,083646,Miranda; Gregory Joseph,19,0,38,19
1650585088186,CSE 3,A51,083647,Miranda; Gregory Joseph,36,0,37,1
1650585094212,CSE 8A,A50,083650,Miranda; Gregory Joseph,0,30,40,40
1650585100239,CSE 11,A01,083080,Cao; Yingjun,0,94,40,40
1650585106263,CSE 12,A01,083652,Staff,0,19,100,100
1650585112295,CSE 15L,A01,083654,Staff,0,1,50,50
1650585112295,CSE 15L,A02,083655,Staff,0,1,50,50
1650585118318,CSE 20,A01,083657,Staff,52,0,80,28
1650585124346,CSE 30,A01,083084,Eldon; John,0,78,40,40
1650585130380,CSE 100,A01,083659,Cao; Yingjun,0,66,50,50
1650585136405,CSE 134B,A01,083661,Powell; Thomas Allan,0,35,65,65
1650585142431,CSE 140,A01,083663,Staff,1,7,75,74
1650585148473,CSE 140L,A01,083088,Eldon; John,1,13,75,74
1650585154499,CSE 175,A01,083665,Kumar; Rakesh,7,0,25,18
1650585160525,CSE 190,A00,092507,Dubnov; Shlomo,11,0,20,9
1650585166556,ECE 45,A01,083139,Staff,1,2,60,59
1650585172591,ECE 65,A50,083695,Staff,1,6,30,29
1650585178616,ECE 109,A01,091882,Touri; Behrouz,33,0,70,37
1650585184643,ECE 180,A00,083140,Abi Samra; Nicholas Camill,21,0,30,9
1650585184643,ECE 180,B00,083141,Abi Samra; Nicholas Camill,0,0,30,30
1650585190670,MATH 10A,A01,083735,Patchell; Gregory David,4,0,30,26
1650585190670,MATH 10A,A02,083736,Patchell; Gregory David,27,0,30,3
1650585190670,MATH 10A,A03,083737,Patchell; Gregory David,24,0,30,6
1650585196699,MATH 10B,A01,083207,Staff,0,9,30,30
1650585196699,MATH 10B,A02,083208,Staff,0,8,30,30
1650585196699,MATH 10B,B01,083739,Staff,11,0,30,19
1650585196699,MATH 10B,B02,083740,Staff,28,0,30,2
1650585202725,MATH 18,A01,083743,Staff,0,0,30,30
1650585202725,MATH 18,A02,083744,Staff,26,0,30,4
1650585202725,MATH 18,A03,083745,Staff,22,0,30,8
1650585202725,MATH 18,A04,083746,Staff,26,0,30,4
1650585202725,MATH 18,B01,083748,Staff,0,14,30,30
1650585202725,MATH 18,B02,083749,Staff,0,12,30,30
1650585202725,MATH 18,B03,083750,Staff,0,12,30,30
1650585202725,MATH 18,B04,083751,Staff,0,12,30,30
1650585208761,MATH 20A,A01,083754,Staff,21,0,40,19
1650585214793,MATH 20B,A01,083756,Staff,1,11,30,29
1650585214793,MATH 20B,A02,083757,Staff,0,12,30,30
1650585220822,MATH 20C,A01,083760,Staff,0,16,30,30
1650585220822,MATH 20C,A02,083761,Staff,2,14,30,28
1650585220822,MATH 20C,B01,083762,Staff,11,0,30,19
1650585220822,MATH 20C,B02,083763,Staff,28,0,30,2
1650585226850,MATH 20D,A01,083765,Staff,0,1,30,30
1650585226850,MATH 20D,A02,083766,Staff,8,0,30,22
1650585226850,MATH 20D,A03,083767,Staff,25,0,30,5
1650585232885,MATH 20E,A01,083771,Staff,6,0,30,24
1650585232885,MATH 20E,A02,083772,Staff,18,0,30,12
1650585232885,MATH 20E,B01,083773,Staff,0,0,30,30
1650585232885,MATH 20E,B02,083774,Staff,9,0,30,21
1650585238912,MATH 103A,A01,083777,Staff,0,15,30,30
1650585238912,MATH 103A,A02,083778,Staff,0,14,30,30
1650585238912,MATH 103A,B01,083779,Staff,0,13,30,30
1650585238912,MATH 103A,B02,083780,Staff,0,13,30,30
1650585244939,MATH 105,A01,085443,Staff,0,21,30,30
1650585250972,MATH 109,A01,083213,Anzaldo; Leesa B,0,7,30,30
1650585250972,MATH 109,A02,083214,Anzaldo; Leesa B,0,7,30,30
1650585250972,MATH 109,B01,083215,Anzaldo; Leesa B,0,5,30,30
1650585250972,MATH 109,B02,083216,Anzaldo; Leesa B,0,6,30,30
1650585257003,MATH 142A,A01,083219,Chow; Bennett,0,16,30,30
1650585257003,MATH 142A,A02,083220,Chow; Bennett,0,15,30,30
1650585257003,MATH 142A,B01,083221,Chow; Bennett,0,14,30,30
1650585257003,MATH 142A,B02,083222,Chow; Bennett,0,13,30,30
1650585263040,MATH 193A,A01,083224,Staff,1,6,30,29
1650585263040,MATH 193A,A02,083225,Staff,0,6,30,30
1650585263040,MATH 193A,A03,083781,Staff,0,6,30,30
1650585263040,MATH 193A,A04,083782,Staff,0,7,30,30
1650585269069,MATH 197,001,091859,McAuley; Julian John,9998,0,9999,1
1650585275121,COGS 9,A01,083615,Staff,1,17,60,59
1650585281146,COGS 11,A01,083617,Boyle; Mary E. T.,18,0,40,22
1650585287170,COGS 13,A01,083071,Staff,0,37,40,40
1650585293205,COGS 14A,A01,092681,Staff,0,29,100,100
1650585299233,COGS 14B,A01,083073,Cheng; Tzu-Han,0,13,50,50
1650585305262,COGS 17,A01,092677,Staff,17,0,75,58
1650585311285,COGS 100,A01,083619,Staff,1,26,60,59
1650585317325,COGS 101A,A01,083621,Davis; Joshua Daniel,0,26,60,60
1650585323350,COGS 101B,A01,091572,Staff,1,5,60,59
1650585329375,COGS 101C,A01,083625,Delgado; Tania,15,0,30,15
1650585335409,COGS 107A,A01,083627,Boyle; Mary E. T.,0,13,60,60
1650585341435,COGS 118A,A01,083075,Staff,0,4,60,60
1650585347462,CSE 3,A50,083646,Miranda; Gregory Joseph,19,0,38,19
1650585347462,CSE 3,A51,083647,Miranda; Gregory Joseph,36,0,37,1
1650585353488,CSE 8A,A50,083650,Miranda; Gregory Joseph,0,30,40,40
1650585359511,CSE 11,A01,083080,Cao; Yingjun,0,94,40,40
1650585365535,CSE 12,A01,083652,Staff,0,19,100,100
1650585371654,CSE 15L,A01,083654,Staff,0,1,50,50
1650585371654,CSE 15L,A02,083655,Staff,0,1,50,50
1650585377678,CSE 20,A01,083657,Staff,52,0,80,28
1650585383711,CSE 30,A01,083084,Eldon; John,0,78,40,40
1650585389738,CSE 100,A01,083659,Cao; Yingjun,0,66,50,50
1650585395760,CSE 134B,A01,083661,Powell; Thomas Allan,0,35,65,65
1650585401791,CSE 140,A01,083663,Staff,1,7,75,74
1650585407820,CSE 140L,A01,083088,Eldon; John,1,13,75,74
1650585413846,CSE 175,A01,083665,Kumar; Rakesh,7,0,25,18
1650585419870,CSE 190,A00,092507,Dubnov; Shlomo,11,0,20,9
1650585425898,ECE 45,A01,083139,Staff,1,2,60,59
1650585431922,ECE 65,A50,083695,Staff,1,6,30,29
1650585437947,ECE 109,A01,091882,Touri; Behrouz,33,0,70,37
1650585443971,ECE 180,A00,083140,Abi Samra; Nicholas Camill,21,0,30,9
1650585443971,ECE 180,B00,083141,Abi Samra; Nicholas Camill,0,0,30,30
1650585450007,MATH 10A,A01,083735,Patchell; Gregory David,4,0,30,26
1650585450007,MATH 10A,A02,083736,Patchell; Gregory David,27,0,30,3
1650585450007,MATH 10A,A03,083737,Patchell; Gregory David,24,0,30,6
1650585456039,MATH 10B,A01,083207,Staff,0,9,30,30
1650585456039,MATH 10B,A02,083208,Staff,0,8,30,30
1650585456039,MATH 10B,B01,083739,Staff,11,0,30,19
1650585456039,MATH 10B,B02,083740,Staff,28,0,30,2
1650585462071,MATH 18,A01,083743,Staff,0,0,30,30
1650585462071,MATH 18,A02,083744,Staff,25,0,30,5
1650585462071,MATH 18,A03,083745,Staff,22,0,30,8
1650585462071,MATH 18,A04,083746,Staff,26,0,30,4
1650585462071,MATH 18,B01,083748,Staff,0,14,30,30
1650585462071,MATH 18,B02,083749,Staff,0,11,30,30
1650585462071,MATH 18,B03,083750,Staff,0,12,30,30
1650585462071,MATH 18,B04,083751,Staff,0,12,30,30
1650585468095,MATH 20A,A01,083754,Staff,21,0,40,19
1650585474126,MATH 20B,A01,083756,Staff,1,11,30,29
1650585474126,MATH 20B,A02,083757,Staff,0,12,30,30
1650585480150,MATH 20C,A01,083760,Staff,0,16,30,30
1650585480150,MATH 20C,A02,083761,Staff,2,14,30,28
1650585480150,MATH 20C,B01,083762,Staff,11,0,30,19
1650585480150,MATH 20C,B02,083763,Staff,28,0,30,2
1650585486190,MATH 20D,A01,083765,Staff,1,1,30,29
1650585486190,MATH 20D,A02,083766,Staff,8,0,30,22
1650585486190,MATH 20D,A03,083767,Staff,25,0,30,5
1650585492217,MATH 20E,A01,083771,Staff,6,0,30,24
1650585492217,MATH 20E,A02,083772,Staff,18,0,30,12
1650585492217,MATH 20E,B01,083773,Staff,0,0,30,30
1650585492217,MATH 20E,B02,083774,Staff,9,0,30,21
1650585498245,MATH 103A,A01,083777,Staff,0,15,30,30
1650585498245,MATH 103A,A02,083778,Staff,0,14,30,30
1650585498245,MATH 103A,B01,083779,Staff,0,13,30,30
1650585498245,MATH 103A,B02,083780,Staff,0,13,30,30
1650585504279,MATH 105,A01,085443,Staff,0,21,30,30
1650585510302,MATH 109,A01,083213,Anzaldo; Leesa B,0,7,30,30
1650585510302,MATH 109,A02,083214,Anzaldo; Leesa B,0,7,30,30
1650585510302,MATH 109,B01,083215,Anzaldo; Leesa B,0,5,30,30
1650585510302,MATH 109,B02,083216,Anzaldo; Leesa B,0,6,30,30
1650585516329,MATH 142A,A01,083219,Chow; Bennett,0,16,30,30
1650585516329,MATH 142A,A02,083220,Chow; Bennett,0,15,30,30
1650585516329,MATH 142A,B01,083221,Chow; Bennett,0,14,30,30
1650585516329,MATH 142A,B02,083222,Chow; Bennett,0,13,30,30
1650585522360,MATH 193A,A01,083224,Staff,1,6,30,29
1650585522360,MATH 193A,A02,083225,Staff,0,6,30,30
1650585522360,MATH 193A,A03,083781,Staff,0,6,30,30
1650585522360,MATH 193A,A04,083782,Staff,0,7,30,30
1650585528392,MATH 197,001,091859,McAuley; Julian John,9998,0,9999,1
1650585534443,COGS 9,A01,083615,Staff,1,17,60,59
1650585540466,COGS 11,A01,083617,Boyle; Mary E. T.,18,0,40,22
1650585546492,COGS 13,A01,083071,Staff,0,37,40,40
1650585552518,COGS 14A,A01,092681,Staff,0,29,100,100
1650585558540,COGS 14B,A01,083073,Cheng; Tzu-Han,0,13,50,50
1650585564571,COGS 17,A01,092677,Staff,17,0,75,58
1650585570594,COGS 100,A01,083619,Staff,1,26,60,59
1650585576624,COGS 101A,A01,083621,Davis; Joshua Daniel,0,26,60,60
1650585582654,COGS 101B,A01,091572,Staff,1,5,60,59
1650585588679,COGS 101C,A01,083625,Delgado; Tania,15,0,30,15
1650585594708,COGS 107A,A01,083627,Boyle; Mary E. T.,0,13,60,60
1650585600732,COGS 118A,A01,083075,Staff,0,4,60,60
1650585606764,CSE 3,A50,083646,Miranda; Gregory Joseph,19,0,38,19
1650585606764,CSE 3,A51,083647,Miranda; Gregory Joseph,36,0,37,1
1650585612806,CSE 8A,A50,083650,Miranda; Gregory Joseph,0,30,40,40
1650585618834,CSE 11,A01,083080,Cao; Yingjun,0,94,40,40
1650585624857,CSE 12,A01,083652,Staff,0,20,100,100
1650585630885,CSE 15L,A01,083654,Staff,0,1,50,50
1650585630885,CSE 15L,A02,083655,Staff,0,1,50,50
1650585636908,CSE 20,A01,083657,Staff,52,0,80,28
1650585642931,CSE 30,A01,083084,Eldon; John,0,78,40,40
1650585648954,CSE 100,A01,083659,Cao; Yingjun,0,66,50,50
1650585654977,CSE 134B,A01,083661,Powell; Thomas Allan,0,35,65,65
1650585661003,CSE 140,A01,083663,Staff,1,7,75,74
1650585667028,CSE 140L,A01,083088,Eldon; John,1,13,75,74
1650585673058,CSE 175,A01,083665,Kumar; Rakesh,7,0,25,18
1650585679088,CSE 190,A00,092507,Dubnov; Shlomo,11,0,20,9
1650585685131,ECE 45,A01,083139,Staff,1,2,60,59
1650585691160,ECE 65,A50,083695,Staff,1,6,30,29
1650585697185,ECE 109,A01,091882,Touri; Behrouz,33,0,70,37
1650585703208,ECE 180,A00,083140,Abi Samra; Nicholas Camill,21,0,30,9
1650585703208,ECE 180,B00,083141,Abi Samra; Nicholas Camill,0,0,30,30
1650585709236,MATH 10A,A01,083735,Patchell; Gregory David,4,0,30,26
1650585709236,MATH 10A,A02,083736,Patchell; Gregory David,27,0,30,3
1650585709236,MATH 10A,A03,083737,Patchell; Gregory David,24,0,30,6
1650585715261,MATH 10B,A01,083207,Staff,0,9,30,30
1650585715261,MATH 10B,A02,083208,Staff,0,8,30,30
1650585715261,MATH 10B,B01,083739,Staff,11,0,30,19
1650585715261,MATH 10B,B02,083740,Staff,28,0,30,2
1650585721314,MATH 18,A01,083743,Staff,0,0,30,30
1650585721314,MATH 18,A02,083744,Staff,24,0,30,6
1650585721314,MATH 18,A03,083745,Staff,22,0,30,8
1650585721314,MATH 18,A04,083746,Staff,26,0,30,4
1650585721314,MATH 18,B01,083748,Staff,0,14,30,30
1650585721314,MATH 18,B02,083749,Staff,1,11,30,29
1650585721314,MATH 18,B03,083750,Staff,0,12,30,30
1650585721314,MATH 18,B04,083751,Staff,0,12,30,30
1650585727348,MATH 20A,A01,083754,Staff,21,0,40,19
1650585733377,MATH 20B,A01,083756,Staff,1,11,30,29
1650585733377,MATH 20B,A02,083757,Staff,0,12,30,30
1650585739408,MATH 20C,A01,083760,Staff,0,16,30,30
1650585739408,MATH 20C,A02,083761,Staff,2,14,30,28
1650585739408,MATH 20C,B01,083762,Staff,11,0,30,19
1650585739408,MATH 20C,B02,083763,Staff,28,0,30,2
1650585745435,MATH 20D,A01,083765,Staff,1,1,30,29
1650585745435,MATH 20D,A02,083766,Staff,8,0,30,22
1650585745435,MATH 20D,A03,083767,Staff,25,0,30,5
1650585751462,MATH 20E,A01,083771,Staff,6,0,30,24
1650585751462,MATH 20E,A02,083772,Staff,18,0,30,12
1650585751462,MATH 20E,B01,083773,Staff,0,0,30,30
1650585751462,MATH 20E,B02,083774,Staff,9,0,30,21
1650585757488,MATH 103A,A01,083777,Staff,0,15,30,30
1650585757488,MATH 103A,A02,083778,Staff,0,14,30,30
1650585757488,MATH 103A,B01,083779,Staff,0,13,30,30
1650585757488,MATH 103A,B02,083780,Staff,0,13,30,30
1650585763515,MATH 105,A01,085443,Staff,0,21,30,30
1650585769551,MATH 109,A01,083213,Anzaldo; Leesa B,0,7,30,30
1650585769551,MATH 109,A02,083214,Anzaldo; Leesa B,0,7,30,30
1650585769551,MATH 109,B01,083215,Anzaldo; Leesa B,0,5,30,30
1650585769551,MATH 109,B02,083216,Anzaldo; Leesa B,0,6,30,30
1650585775576,MATH 142A,A01,083219,Chow; Bennett,0,16,30,30
1650585775576,MATH 142A,A02,083220,Chow; Bennett,0,15,30,30
1650585775576,MATH 142A,B01,083221,Chow; Bennett,0,14,30,30
1650585775576,MATH 142A,B02,083222,Chow; Bennett,0,13,30,30
1650585781602,MATH 193A,A01,083224,Staff,1,6,30,29
1650585781602,MATH 193A,A02,083225,Staff,0,6,30,30
1650585781602,MATH 193A,A03,083781,Staff,0,6,30,30
1650585781602,MATH 193A,A04,083782,Staff,0,7,30,30
1650585787627,MATH 197,001,091859,McAuley; Julian John,9998,0,9999,1
1650585793698,COGS 9,A01,083615,Staff,1,17,60,59
1650585799723,COGS 11,A01,083617,Boyle; Mary E. T.,18,0,40,22
1650585805752,COGS 13,A01,083071,Staff,0,37,40,40
1650585811787,COGS 14A,A01,092681,Staff,0,29,100,100
1650585817811,COGS 14B,A01,083073,Cheng; Tzu-Han,0,13,50,50
1650585823835,COGS 17,A01,092677,Staff,17,0,75,58
1650585829860,COGS 100,A01,083619,Staff,1,26,60,59
1650585835889,COGS 101A,A01,083621,Davis; Joshua Daniel,0,26,60,60
1650585841924,COGS 101B,A01,091572,Staff,1,5,60,59
1650585847949,COGS 101C,A01,083625,Delgado; Tania,15,0,30,15
1650585853972,COGS 107A,A01,083627,Boyle; Mary E. T.,0,13,60,60
1650585860005,COGS 118A,A01,083075,Staff,0,4,60,60
1650585866032,CSE 3,A50,083646,Miranda; Gregory Joseph,19,0,38,19
1650585866032,CSE 3,A51,083647,Miranda; Gregory Joseph,36,0,37,1
1650585872061,CSE 8A,A50,083650,Miranda; Gregory Joseph,0,30,40,40
1650585878086,CSE 11,A01,083080,Cao; Yingjun,0,94,40,40
1650585884129,CSE 12,A01,083652,Staff,0,20,100,100
1650585890153,CSE 15L,A01,083654,Staff,0,1,50,50
1650585890153,CSE 15L,A02,083655,Staff,0,1,50,50
1650585896183,CSE 20,A01,083657,Staff,52,0,80,28
1650585902212,CSE 30,A01,083084,Eldon; John,0,78,40,40
1650585908236,CSE 100,A01,083659,Cao; Yingjun,0,66,50,50
1650585914263,CSE 134B,A01,083661,Powell; Thomas Allan,0,35,65,65
1650585920306,CSE 140,A01,083663,Staff,1,7,75,74
1650585926332,CSE 140L,A01,083088,Eldon; John,1,13,75,74
1650585932370,CSE 175,A01,083665,Kumar; Rakesh,7,0,25,18
1650585938394,CSE 190,A00,092507,Dubnov; Shlomo,11,0,20,9
1650585944421,ECE 45,A01,083139,Staff,1,2,60,59
1650585950452,ECE 65,A50,083695,Staff,1,6,30,29
1650585956481,ECE 109,A01,091882,Touri; Behrouz,33,0,70,37
1650585962515,ECE 180,A00,083140,Abi Samra; Nicholas Camill,21,0,30,9
1650585962515,ECE 180,B00,083141,Abi Samra; Nicholas Camill,0,0,30,30
1650585968633,MATH 10A,A01,083735,Patchell; Gregory David,4,0,30,26
1650585968633,MATH 10A,A02,083736,Patchell; Gregory David,27,0,30,3
1650585968633,MATH 10A,A03,083737,Patchell; Gregory David,24,0,30,6
1650585974659,MATH 10B,A01,083207,Staff,0,9,30,30
1650585974659,MATH 10B,A02,083208,Staff,0,8,30,30
1650585974659,MATH 10B,B01,083739,Staff,11,0,30,19
1650585974659,MATH 10B,B02,083740,Staff,28,0,30,2
1650585980695,MATH 18,A01,083743,Staff,0,0,30,30
1650585980695,MATH 18,A02,083744,Staff,24,0,30,6
1650585980695,MATH 18,A03,083745,Staff,22,0,30,8
1650585980695,MATH 18,A04,083746,Staff,26,0,30,4
1650585980695,MATH 18,B01,083748,Staff,0,14,30,30
1650585980695,MATH 18,B02,083749,Staff,1,11,30,29
1650585980695,MATH 18,B03,083750,Staff,0,12,30,30
1650585980695,MATH 18,B04,083751,Staff,0,12,30,30
1650585986721,MATH 20A,A01,083754,Staff,21,0,40,19
1650585992745,MATH 20B,A01,083756,Staff,1,11,30,29
1650585992745,MATH 20B,A02,083757,Staff,0,12,30,30
1650585998778,MATH 20C,A01,083760,Staff,0,16,30,30
1650585998778,MATH 20C,A02,083761,Staff,2,14,30,28
1650585998778,MATH 20C,B01,083762,Staff,11,0,30,19
1650585998778,MATH 20C,B02,083763,Staff,28,0,30,2
1650586004805,MATH 20D,A01,083765,Staff,1,1,30,29
1650586004805,MATH 20D,A02,083766,Staff,8,0,30,22
1650586004805,MATH 20D,A03,083767,Staff,25,0,30,5
1650586010834,MATH 20E,A01,083771,Staff,6,0,30,24
1650586010834,MATH 20E,A02,083772,Staff,18,0,30,12
1650586010834,MATH 20E,B01,083773,Staff,0,0,30,30
1650586010834,MATH 20E,B02,083774,Staff,9,0,30,21
1650586016859,MATH 103A,A01,083777,Staff,0,15,30,30
1650586016859,MATH 103A,A02,083778,Staff,0,14,30,30
1650586016859,MATH 103A,B01,083779,Staff,0,13,30,30
1650586016859,MATH 103A,B02,083780,Staff,0,13,30,30
1650586022884,MATH 105,A01,085443,Staff,0,21,30,30
1650586028917,MATH 109,A01,083213,Anzaldo; Leesa B,0,7,30,30
1650586028917,MATH 109,A02,083214,Anzaldo; Leesa B,0,7,30,30
1650586028917,MATH 109,B01,083215,Anzaldo; Leesa B,0,5,30,30
1650586028917,MATH 109,B02,083216,Anzaldo; Leesa B,1,6,30,29
1650586034962,MATH 142A,A01,083219,Chow; Bennett,0,16,30,30
1650586034962,MATH 142A,A02,083220,Chow; Bennett,0,15,30,30
1650586034962,MATH 142A,B01,083221,Chow; Bennett,0,14,30,30
1650586034962,MATH 142A,B02,083222,Chow; Bennett,0,13,30,30
1650586040997,MATH 193A,A01,083224,Staff,1,6,30,29
1650586040997,MATH 193A,A02,083225,Staff,0,6,30,30
1650586040997,MATH 193A,A03,083781,Staff,0,6,30,30
1650586040997,MATH 193A,A04,083782,Staff,0,7,30,30
1650586047023,MATH 197,001,091859,McAuley; Julian John,9998,0,9999,1
1650586053085,COGS 9,A01,083615,Staff,1,17,60,59
1650586059114,COGS 11,A01,083617,Boyle; Mary E. T.,18,0,40,22
1650586065138,COGS 13,A01,083071,Staff,0,37,40,40
1650586071165,COGS 14A,A01,092681,Staff,0,29,100,100
1650586077195,COGS 14B,A01,083073,Cheng; Tzu-Han,0,13,50,50
1650586083219,COGS 17,A01,092677,Staff,17,0,75,58
1650586089253,COGS 100,A01,083619,Staff,1,26,60,59
1650586095285,COGS 101A,A01,083621,Davis; Joshua Daniel,0,26,60,60
1650586101318,COGS 101B,A01,091572,Staff,1,5,60,59
1650586107352,COGS 101C,A01,083625,Delgado; Tania,15,0,30,15
1650586113376,COGS 107A,A01,083627,Boyle; Mary E. T.,0,13,60,60
1650586119400,COGS 118A,A01,083075,Staff,0,4,60,60
1650586125425,CSE 3,A50,083646,Miranda; Gregory Joseph,19,0,38,19
1650586125425,CSE 3,A51,083647,Miranda; Gregory Joseph,36,0,37,1
1650586131455,CSE 8A,A50,083650,Miranda; Gregory Joseph,0,30,40,40
1650586137478,CSE 11,A01,083080,Cao; Yingjun,0,95,40,40
1650586143507,CSE 12,A01,083652,Staff,0,20,100,100
1650586149537,CSE 15L,A01,083654,Staff,0,1,50,50
1650586149537,CSE 15L,A02,083655,Staff,0,1,50,50
1650586155561,CSE 20,A01,083657,Staff,52,0,80,28
1650586161594,CSE 30,A01,083084,Eldon; John,0,78,40,40
1650586167618,CSE 100,A01,083659,Cao; Yingjun,0,66,50,50
1650586173646,CSE 134B,A01,083661,Powell; Thomas Allan,0,35,65,65
1650586179675,CSE 140,A01,083663,Staff,1,7,75,74
1650586185705,CSE 140L,A01,083088,Eldon; John,1,13,75,74
1650586191729,CSE 175,A01,083665,Kumar; Rakesh,7,0,25,18
1650586197755,CSE 190,A00,092507,Dubnov; Shlomo,11,0,20,9
1650586203788,ECE 45,A01,083139,Staff,1,2,60,59
1650586209812,ECE 65,A50,083695,Staff,1,6,30,29
1650586215840,ECE 109,A01,091882,Touri; Behrouz,33,0,70,37
1650586221868,ECE 180,A00,083140,Abi Samra; Nicholas Camill,21,0,30,9
1650586221868,ECE 180,B00,083141,Abi Samra; Nicholas Camill,0,0,30,30
1650586227894,MATH 10A,A01,083735,Patchell; Gregory David,4,0,30,26
1650586227894,MATH 10A,A02,083736,Patchell; Gregory David,27,0,30,3
1650586227894,MATH 10A,A03,083737,Patchell; Gregory David,24,0,30,6
1650586233918,MATH 10B,A01,083207,Staff,0,9,30,30
1650586233918,MATH 10B,A02,083208,Staff,0,8,30,30
1650586233918,MATH 10B,B01,083739,Staff,11,0,30,19
1650586233918,MATH 10B,B02,083740,Staff,28,0,30,2
1650586239951,MATH 18,A01,083743,Staff,0,0,30,30
1650586239951,MATH 18,A02,083744,Staff,24,0,30,6
1650586239951,MATH 18,A03,083745,Staff,22,0,30,8
1650586239951,MATH 18,A04,083746,Staff,26,0,30,4
1650586239951,MATH 18,B01,083748,Staff,0,14,30,30
1650586239951,MATH 18,B02,083749,Staff,1,11,30,29
1650586239951,MATH 18,B03,083750,Staff,0,12,30,30
1650586239951,MATH 18,B04,083751,Staff,0,12,30,30
1650586245984,MATH 20A,A01,083754,Staff,21,0,40,19
1650586252016,MATH 20B,A01,083756,Staff,1,11,30,29
1650586252016,MATH 20B,A02,083757,Staff,0,12,30,30
1650586258046,MATH 20C,A01,083760,Staff,0,16,30,30
1650586258046,MATH 20C,A02,083761,Staff,2,14,30,28
1650586258046,MATH 20C,B01,083762,Staff,11,0,30,19
1650586258046,MATH 20C,B02,083763,Staff,28,0,30,2
1650586264070,MATH 20D,A01,083765,Staff,1,1,30,29
1650586264070,MATH 20D,A02,083766,Staff,8,0,30,22
1650586264070,MATH 20D,A03,083767,Staff,25,0,30,5
1650586270107,MATH 20E,A01,083771,Staff,6,0,30,24
1650586270107,MATH 20E,A02,083772,Staff,18,0,30,12
1650586270107,MATH 20E,B01,083773,Staff,0,0,30,30
1650586270107,MATH 20E,B02,083774,Staff,9,0,30,21
1650586276133,MATH 103A,A01,083777,Staff,0,15,30,30
1650586276133,MATH 103A,A02,083778,Staff,0,14,30,30
1650586276133,MATH 103A,B01,083779,Staff,0,13,30,30
1650586276133,MATH 103A,B02,083780,Staff,0,13,30,30
1650586282173,MATH 105,A01,085443,Staff,0,21,30,30
1650586288202,MATH 109,A01,083213,Anzaldo; Leesa B,0,7,30,30
1650586288202,MATH 109,A02,083214,Anzaldo; Leesa B,0,7,30,30
1650586288202,MATH 109,B01,083215,Anzaldo; Leesa B,0,5,30,30
1650586288202,MATH 109,B02,083216,Anzaldo; Leesa B,1,6,30,29
1650586294227,MATH 142A,A01,083219,Chow; Bennett,0,16,30,30
1650586294227,MATH 142A,A02,083220,Chow; Bennett,0,15,30,30
1650586294227,MATH 142A,B01,083221,Chow; Bennett,0,14,30,30
1650586294227,MATH 142A,B02,083222,Chow; Bennett,0,13,30,30
1650586300251,MATH 193A,A01,083224,Staff,1,6,30,29
1650586300251,MATH 193A,A02,083225,Staff,0,6,30,30
1650586300251,MATH 193A,A03,083781,Staff,0,6,30,30
1650586300251,MATH 193A,A04,083782,Staff,0,7,30,30
1650586306283,MATH 197,001,091859,McAuley; Julian John,9998,0,9999,1
1650586312339,COGS 9,A01,083615,Staff,1,17,60,59
1650586318364,COGS 11,A01,083617,Boyle; Mary E. T.,18,0,40,22
1650586324389,COGS 13,A01,083071,Staff,0,37,40,40
1650586330416,COGS 14A,A01,092681,Staff,0,29,100,100
1650586336454,COGS 14B,A01,083073,Cheng; Tzu-Han,0,13,50,50
1650586342479,COGS 17,A01,092677,Staff,17,0,75,58
1650586348506,COGS 100,A01,083619,Staff,1,26,60,59
1650586354531,COGS 101A,A01,083621,Davis; Joshua Daniel,0,26,60,60
1650586360564,COGS 101B,A01,091572,Staff,1,5,60,59
1650586366593,COGS 101C,A01,083625,Delgado; Tania,15,0,30,15
1650586372618,COGS 107A,A01,083627,Boyle; Mary E. T.,0,13,60,60
1650586378645,COGS 118A,A01,083075,Staff,0,4,60,60
1650586384684,CSE 3,A50,083646,Miranda; Gregory Joseph,19,0,38,19
1650586384684,CSE 3,A51,083647,Miranda; Gregory Joseph,36,0,37,1
1650586390708,CSE 8A,A50,083650,Miranda; Gregory Joseph,0,30,40,40
1650586396733,CSE 11,A01,083080,Cao; Yingjun,0,95,40,40
1650586402767,CSE 12,A01,083652,Staff,0,20,100,100
1650586408790,CSE 15L,A01,083654,Staff,0,1,50,50
1650586408790,CSE 15L,A02,083655,Staff,0,1,50,50
1650586414814,CSE 20,A01,083657,Staff,52,0,80,28
1650586420844,CSE 30,A01,083084,Eldon; John,0,78,40,40
1650586426879,CSE 100,A01,083659,Cao; Yingjun,0,66,50,50
1650586432902,CSE 134B,A01,083661,Powell; Thomas Allan,0,35,65,65
1650586438928,CSE 140,A01,083663,Staff,1,7,75,74
1650586444955,CSE 140L,A01,083088,Eldon; John,1,13,75,74
1650586450981,CSE 175,A01,083665,Kumar; Rakesh,7,0,25,18
1650586457006,CSE 190,A00,092507,Dubnov; Shlomo,11,0,20,9
1650586463031,ECE 45,A01,083139,Staff,1,2,60,59
1650586469057,ECE 65,A50,083695,Staff,1,6,30,29
1650586475089,ECE 109,A01,091882,Touri; Behrouz,33,0,70,37
1650586481115,ECE 180,A00,083140,Abi Samra; Nicholas Camill,21,0,30,9
1650586481115,ECE 180,B00,083141,Abi Samra; Nicholas Camill,0,0,30,30
1650586487143,MATH 10A,A01,083735,Patchell; Gregory David,4,0,30,26
1650586487143,MATH 10A,A02,083736,Patchell; Gregory David,27,0,30,3
1650586487143,MATH 10A,A03,083737,Patchell; Gregory David,24,0,30,6
1650586493170,MATH 10B,A01,083207,Staff,0,9,30,30
1650586493170,MATH 10B,A02,083208,Staff,0,8,30,30
1650586493170,MATH 10B,B01,083739,Staff,11,0,30,19
1650586493170,MATH 10B,B02,083740,Staff,28,0,30,2
1650586499197,MATH 18,A01,083743,Staff,0,0,30,30
1650586499197,MATH 18,A02,083744,Staff,24,0,30,6
1650586499197,MATH 18,A03,083745,Staff,22,0,30,8
1650586499197,MATH 18,A04,083746,Staff,26,0,30,4
1650586499197,MATH 18,B01,083748,Staff,0,14,30,30
1650586499197,MATH 18,B02,083749,Staff,1,11,30,29
1650586499197,MATH 18,B03,083750,Staff,0,12,30,30
1650586499197,MATH 18,B04,083751,Staff,0,12,30,30
1650586505232,MATH 20A,A01,083754,Staff,21,0,40,19
1650586511269,MATH 20B,A01,083756,Staff,1,11,30,29
1650586511269,MATH 20B,A02,083757,Staff,0,12,30,30
1650586517294,MATH 20C,A01,083760,Staff,0,16,30,30
1650586517294,MATH 20C,A02,083761,Staff,2,14,30,28
1650586517294,MATH 20C,B01,083762,Staff,11,0,30,19
1650586517294,MATH 20C,B02,083763,Staff,28,0,30,2
1650586523325,MATH 20D,A01,083765,Staff,1,1,30,29
1650586523325,MATH 20D,A02,083766,Staff,8,0,30,22
1650586523325,MATH 20D,A03,083767,Staff,25,0,30,5
1650586529348,MATH 20E,A01,083771,Staff,6,0,30,24
1650586529348,MATH 20E,A02,083772,Staff,18,0,30,12
1650586529348,MATH 20E,B01,083773,Staff,0,0,30,30
1650586529348,MATH 20E,B02,083774,Staff,9,0,30,21
1650586535374,MATH 103A,A01,083777,Staff,0,15,30,30
1650586535374,MATH 103A,A02,083778,Staff,0,14,30,30
1650586535374,MATH 103A,B01,083779,Staff,0,13,30,30
1650586535374,MATH 103A,B02,083780,Staff,0,13,30,30
1650586541400,MATH 105,A01,085443,Staff,0,21,30,30
1650586547425,MATH 109,A01,083213,Anzaldo; Leesa B,0,7,30,30
1650586547425,MATH 109,A02,083214,Anzaldo; Leesa B,0,7,30,30
1650586547425,MATH 109,B01,083215,Anzaldo; Leesa B,0,5,30,30
1650586547425,MATH 109,B02,083216,Anzaldo; Leesa B,1,6,30,29
1650586553454,MATH 142A,A01,083219,Chow; Bennett,0,16,30,30
1650586553454,MATH 142A,A02,083220,Chow; Bennett,0,15,30,30
1650586553454,MATH 142A,B01,083221,Chow; Bennett,0,14,30,30
1650586553454,MATH 142A,B02,083222,Chow; Bennett,0,13,30,30
1650586559481,MATH 193A,A01,083224,Staff,1,6,30,29
1650586559481,MATH 193A,A02,083225,Staff,0,6,30,30
1650586559481,MATH 193A,A03,083781,Staff,0,6,30,30
1650586559481,MATH 193A,A04,083782,Staff,0,7,30,30
1650586565643,MATH 197,001,091859,McAuley; Julian John,9998,0,9999,1
1650586571698,COGS 9,A01,083615,Staff,1,17,60,59
1650586577725,COGS 11,A01,083617,Boyle; Mary E. T.,18,0,40,22
1650586583748,COGS 13,A01,083071,Staff,0,37,40,40
1650586589781,COGS 14A,A01,092681,Staff,0,29,100,100
1650586595805,COGS 14B,A01,083073,Cheng; Tzu-Han,0,13,50,50
1650586601830,COGS 17,A01,092677,Staff,17,0,75,58
1650586607857,COGS 100,A01,083619,Staff,1,26,60,59
1650586613884,COGS 101A,A01,083621,Davis; Joshua Daniel,0,26,60,60
1650586619909,COGS 101B,A01,091572,Staff,1,5,60,59
1650586625930,COGS 101C,A01,083625,Delgado; Tania,15,0,30,15
1650586631954,COGS 107A,A01,083627,Boyle; Mary E. T.,0,13,60,60
1650586637977,COGS 118A,A01,083075,Staff,0,4,60,60
1650586644002,CSE 3,A50,083646,Miranda; Gregory Joseph,19,0,38,19
1650586644002,CSE 3,A51,083647,Miranda; Gregory Joseph,36,0,37,1
1650586650035,CSE 8A,A50,083650,Miranda; Gregory Joseph,0,30,40,40
1650586656063,CSE 11,A01,083080,Cao; Yingjun,0,95,40,40
1650586662089,CSE 12,A01,083652,Staff,0,20,100,100
1650586668114,CSE 15L,A01,083654,Staff,0,1,50,50
1650586668114,CSE 15L,A02,083655,Staff,0,1,50,50
1650586674139,CSE 20,A01,083657,Staff,52,0,80,28
1650586680170,CSE 30,A01,083084,Eldon; John,0,78,40,40
1650586686192,CSE 100,A01,083659,Cao; Yingjun,0,66,50,50
1650586692215,CSE 134B,A01,083661,Powell; Thomas Allan,0,35,65,65
1650586698242,CSE 140,A01,083663,Staff,1,7,75,74
1650586704265,CSE 140L,A01,083088,Eldon; John,1,13,75,74
1650586710289,CSE 175,A01,083665,Kumar; Rakesh,7,0,25,18
1650586716316,CSE 190,A00,092507,Dubnov; Shlomo,11,0,20,9
1650586722344,ECE 45,A01,083139,Staff,1,2,60,59
1650586728367,ECE 65,A50,083695,Staff,1,6,30,29
1650586734393,ECE 109,A01,091882,Touri; Behrouz,33,0,70,37
1650586740420,ECE 180,A00,083140,Abi Samra; Nicholas Camill,21,0,30,9
1650586740420,ECE 180,B00,083141,Abi Samra; Nicholas Camill,0,0,30,30
1650586746443,MATH 10A,A01,083735,Patchell; Gregory David,4,0,30,26
1650586746443,MATH 10A,A02,083736,Patchell; Gregory David,27,0,30,3
1650586746443,MATH 10A,A03,083737,Patchell; Gregory David,24,0,30,6
1650586752466,MATH 10B,A01,083207,Staff,0,9,30,30
1650586752466,MATH 10B,A02,083208,Staff,0,8,30,30
1650586752466,MATH 10B,B01,083739,Staff,11,0,30,19
1650586752466,MATH 10B,B02,083740,Staff,28,0,30,2
1650586758501,MATH 18,A01,083743,Staff,0,0,30,30
1650586758501,MATH 18,A02,083744,Staff,24,0,30,6
1650586758501,MATH 18,A03,083745,Staff,22,0,30,8
1650586758501,MATH 18,A04,083746,Staff,26,0,30,4
1650586758501,MATH 18,B01,083748,Staff,0,14,30,30
1650586758501,MATH 18,B02,083749,Staff,1,11,30,29
1650586758501,MATH 18,B03,083750,Staff,0,12,30,30
1650586758501,MATH 18,B04,083751,Staff,0,12,30,30
1650586764525,MATH 20A,A01,083754,Staff,21,0,40,19
1650586770551,MATH 20B,A01,083756,Staff,1,11,30,29
1650586770551,MATH 20B,A02,083757,Staff,0,12,30,30
1650586776576,MATH 20C,A01,083760,Staff,0,16,30,30
1650586776576,MATH 20C,A02,083761,Staff,2,14,30,28
1650586776576,MATH 20C,B01,083762,Staff,11,0,30,19
1650586776576,MATH 20C,B02,083763,Staff,28,0,30,2
1650586782598,MATH 20D,A01,083765,Staff,1,1,30,29
1650586782598,MATH 20D,A02,083766,Staff,8,0,30,22
1650586782598,MATH 20D,A03,083767,Staff,25,0,30,5
1650586788622,MATH 20E,A01,083771,Staff,6,0,30,24
1650586788622,MATH 20E,A02,083772,Staff,18,0,30,12
1650586788622,MATH 20E,B01,083773,Staff,0,0,30,30
1650586788622,MATH 20E,B02,083774,Staff,9,0,30,21
1650586794645,MATH 103A,A01,083777,Staff,0,15,30,30
1650586794645,MATH 103A,A02,083778,Staff,0,14,30,30
1650586794645,MATH 103A,B01,083779,Staff,0,13,30,30
1650586794645,MATH 103A,B02,083780,Staff,0,13,30,30
1650586800672,MATH 105,A01,085443,Staff,0,21,30,30
1650586806702,MATH 109,A01,083213,Anzaldo; Leesa B,0,7,30,30
1650586806702,MATH 109,A02,083214,Anzaldo; Leesa B,0,7,30,30
1650586806702,MATH 109,B01,083215,Anzaldo; Leesa B,0,5,30,30
1650586806702,MATH 109,B02,083216,Anzaldo; Leesa B,1,6,30,29
1650586812726,MATH 142A,A01,083219,Chow; Bennett,0,16,30,30
1650586812726,MATH 142A,A02,083220,Chow; Bennett,0,15,30,30
1650586812726,MATH 142A,B01,083221,Chow; Bennett,0,14,30,30
1650586812726,MATH 142A,B02,083222,Chow; Bennett,0,13,30,30
1650586818750,MATH 193A,A01,083224,Staff,1,6,30,29
1650586818750,MATH 193A,A02,083225,Staff,0,6,30,30
1650586818750,MATH 193A,A03,083781,Staff,0,6,30,30
1650586818750,MATH 193A,A04,083782,Staff,0,7,30,30
1650586824775,MATH 197,001,091859,McAuley; Julian John,9998,0,9999,1
1650586830827,COGS 9,A01,083615,Staff,1,17,60,59
1650586836852,COGS 11,A01,083617,Boyle; Mary E. T.,18,0,40,22
1650586842878,COGS 13,A01,083071,Staff,0,37,40,40
1650586848902,COGS 14A,A01,092681,Staff,0,29,100,100
1650586854928,COGS 14B,A01,083073,Cheng; Tzu-Han,0,13,50,50
1650586860954,COGS 17,A01,092677,Staff,17,0,75,58
1650586866976,COGS 100,A01,083619,Staff,1,26,60,59
1650586873001,COGS 101A,A01,083621,Davis; Joshua Daniel,0,26,60,60
1650586879026,COGS 101B,A01,091572,Staff,1,5,60,59
1650586885050,COGS 101C,A01,083625,Delgado; Tania,15,0,30,15
1650586891091,COGS 107A,A01,083627,Boyle; Mary E. T.,0,13,60,60
1650586897114,COGS 118A,A01,083075,Staff,0,4,60,60
1650586903147,CSE 3,A50,083646,Miranda; Gregory Joseph,19,0,38,19
1650586903147,CSE 3,A51,083647,Miranda; Gregory Joseph,36,0,37,1
1650586909174,CSE 8A,A50,083650,Miranda; Gregory Joseph,0,30,40,40
1650586915199,CSE 11,A01,083080,Cao; Yingjun,0,95,40,40
1650586921231,CSE 12,A01,083652,Staff,0,20,100,100
1650586927259,CSE 15L,A01,083654,Staff,0,1,50,50
1650586927259,CSE 15L,A02,083655,Staff,0,1,50,50
1650586933295,CSE 20,A01,083657,Staff,52,0,80,28
1650586939332,CSE 30,A01,083084,Eldon; John,0,78,40,40
1650586945355,CSE 100,A01,083659,Cao; Yingjun,0,66,50,50
1650586951378,CSE 134B,A01,083661,Powell; Thomas Allan,0,35,65,65
1650586957408,CSE 140,A01,083663,Staff,1,7,75,74
1650586963434,CSE 140L,A01,083088,Eldon; John,1,13,75,74
1650586969457,CSE 175,A01,083665,Kumar; Rakesh,7,0,25,18
1650586975480,CSE 190,A00,092507,Dubnov; Shlomo,11,0,20,9
1650586981507,ECE 45,A01,083139,Staff,1,2,60,59
1650586987539,ECE 65,A50,083695,Staff,1,6,30,29
1650586993566,ECE 109,A01,091882,Touri; Behrouz,33,0,70,37
1650586999592,ECE 180,A00,083140,Abi Samra; Nicholas Camill,21,0,30,9
1650586999592,ECE 180,B00,083141,Abi Samra; Nicholas Camill,0,0,30,30
1650587005620,MATH 10A,A01,083735,Patchell; Gregory David,4,0,30,26
1650587005620,MATH 10A,A02,083736,Patchell; Gregory David,27,0,30,3
1650587005620,MATH 10A,A03,083737,Patchell; Gregory David,24,0,30,6
1650587011643,MATH 10B,A01,083207,Staff,0,9,30,30
1650587011643,MATH 10B,A02,083208,Staff,0,8,30,30
1650587011643,MATH 10B,B01,083739,Staff,11,0,30,19
1650587011643,MATH 10B,B02,083740,Staff,28,0,30,2
1650587017675,MATH 18,A01,083743,Staff,0,0,30,30
1650587017675,MATH 18,A02,083744,Staff,24,0,30,6
1650587017675,MATH 18,A03,083745,Staff,22,0,30,8
1650587017675,MATH 18,A04,083746,Staff,26,0,30,4
1650587017675,MATH 18,B01,083748,Staff,0,14,30,30
1650587017675,MATH 18,B02,083749,Staff,1,11,30,29
1650587017675,MATH 18,B03,083750,Staff,0,12,30,30
1650587017675,MATH 18,B04,083751,Staff,0,12,30,30
1650587023697,MATH 20A,A01,083754,Staff,21,0,40,19
1650587029733,MATH 20B,A01,083756,Staff,1,12,30,29
1650587029733,MATH 20B,A02,083757,Staff,0,12,30,30
1650587035760,MATH 20C,A01,083760,Staff,0,16,30,30
1650587035760,MATH 20C,A02,083761,Staff,2,14,30,28
1650587035760,MATH 20C,B01,083762,Staff,11,0,30,19
1650587035760,MATH 20C,B02,083763,Staff,28,0,30,2
1650587041786,MATH 20D,A01,083765,Staff,1,1,30,29
1650587041786,MATH 20D,A02,083766,Staff,8,0,30,22
1650587041786,MATH 20D,A03,083767,Staff,25,0,30,5
1650587047810,MATH 20E,A01,083771,Staff,6,0,30,24
1650587047810,MATH 20E,A02,083772,Staff,18,0,30,12
1650587047810,MATH 20E,B01,083773,Staff,0,0,30,30
1650587047810,MATH 20E,B02,083774,Staff,9,0,30,21
1650587053844,MATH 103A,A01,083777,Staff,0,15,30,30
1650587053844,MATH 103A,A02,083778,Staff,0,14,30,30
1650587053844,MATH 103A,B01,083779,Staff,0,13,30,30
1650587053844,MATH 103A,B02,083780,Staff,0,13,30,30
1650587059867,MATH 105,A01,085443,Staff,0,21,30,30
1650587065898,MATH 109,A01,083213,Anzaldo; Leesa B,0,7,30,30
1650587065898,MATH 109,A02,083214,Anzaldo; Leesa B,0,7,30,30
1650587065898,MATH 109,B01,083215,Anzaldo; Leesa B,0,5,30,30
1650587065898,MATH 109,B02,083216,Anzaldo; Leesa B,1,6,30,29
1650587071923,MATH 142A,A01,083219,Chow; Bennett,0,16,30,30
1650587071923,MATH 142A,A02,083220,Chow; Bennett,0,15,30,30
1650587071923,MATH 142A,B01,083221,Chow; Bennett,0,14,30,30
1650587071923,MATH 142A,B02,083222,Chow; Bennett,0,13,30,30
1650587077951,MATH 193A,A01,083224,Staff,1,6,30,29
1650587077951,MATH 193A,A02,083225,Staff,0,6,30,30
1650587077951,MATH 193A,A03,083781,Staff,0,6,30,30
1650587077951,MATH 193A,A04,083782,Staff,0,7,30,30
1650587083974,MATH 197,001,091859,McAuley; Julian John,9998,0,9999,1
1650587090038,COGS 9,A01,083615,Staff,1,17,60,59
1650587096068,COGS 11,A01,083617,Boyle; Mary E. T.,18,0,40,22
1650587102096,COGS 13,A01,083071,Staff,0,37,40,40
1650587108120,COGS 14A,A01,092681,Staff,0,29,100,100
1650587114142,COGS 14B,A01,083073,Cheng; Tzu-Han,0,13,50,50
1650587120174,COGS 17,A01,092677,Staff,17,0,75,58
1650587126207,COGS 100,A01,083619,Staff,1,26,60,59
1650587132231,COGS 101A,A01,083621,Davis; Joshua Daniel,0,26,60,60
1650587138259,COGS 101B,A01,091572,Staff,1,5,60,59
1650587144283,COGS 101C,A01,083625,Delgado; Tania,15,0,30,15
1650587150308,COGS 107A,A01,083627,Boyle; Mary E. T.,0,13,60,60
1650587156434,COGS 118A,A01,083075,Staff,0,4,60,60
1650587162464,CSE 3,A50,083646,Miranda; Gregory Joseph,19,0,38,19
1650587162464,CSE 3,A51,083647,Miranda; Gregory Joseph,36,0,37,1
1650587168488,CSE 8A,A50,083650,Miranda; Gregory Joseph,0,30,40,40
1650587174511,CSE 11,A01,083080,Cao; Yingjun,0,96,40,40
1650587180541,CSE 12,A01,083652,Staff,0,20,100,100
1650587186565,CSE 15L,A01,083654,Staff,0,1,50,50
1650587186565,CSE 15L,A02,083655,Staff,0,1,50,50
1650587192598,CSE 20,A01,083657,Staff,51,0,80,29
1650587198626,CSE 30,A01,083084,Eldon; John,0,78,40,40
1650587204650,CSE 100,A01,083659,Cao; Yingjun,0,66,50,50
1650587210674,CSE 134B,A01,083661,Powell; Thomas Allan,0,35,65,65
1650587216701,CSE 140,A01,083663,Staff,1,7,75,74
1650587222728,CSE 140L,A01,083088,Eldon; John,1,13,75,74
1650587228752,CSE 175,A01,083665,Kumar; Rakesh,7,0,25,18
1650587234779,CSE 190,A00,092507,Dubnov; Shlomo,11,0,20,9
1650587240806,ECE 45,A01,083139,Staff,1,2,60,59
1650587246832,ECE 65,A50,083695,Staff,1,6,30,29
1650587252857,ECE 109,A01,091882,Touri; Behrouz,33,0,70,37
1650587258885,ECE 180,A00,083140,Abi Samra; Nicholas Camill,21,0,30,9
1650587258885,ECE 180,B00,083141,Abi Samra; Nicholas Camill,0,0,30,30
1650587264910,MATH 10A,A01,083735,Patchell; Gregory David,4,0,30,26
1650587264910,MATH 10A,A02,083736,Patchell; Gregory David,27,0,30,3
1650587264910,MATH 10A,A03,083737,Patchell; Gregory David,24,0,30,6
1650587270936,MATH 10B,A01,083207,Staff,0,9,30,30
1650587270936,MATH 10B,A02,083208,Staff,0,8,30,30
1650587270936,MATH 10B,B01,083739,Staff,11,0,30,19
1650587270936,MATH 10B,B02,083740,Staff,28,0,30,2
1650587276963,MATH 18,A01,083743,Staff,0,0,30,30
1650587276963,MATH 18,A02,083744,Staff,24,0,30,6
1650587276963,MATH 18,A03,083745,Staff,22,0,30,8
1650587276963,MATH 18,A04,083746,Staff,26,0,30,4
1650587276963,MATH 18,B01,083748,Staff,0,14,30,30
1650587276963,MATH 18,B02,083749,Staff,1,11,30,29
1650587276963,MATH 18,B03,083750,Staff,0,12,30,30
1650587276963,MATH 18,B04,083751,Staff,0,12,30,30
1650587282991,MATH 20A,A01,083754,Staff,21,0,40,19
1650587289015,MATH 20B,A01,083756,Staff,1,12,30,29
1650587289015,MATH 20B,A02,083757,Staff,0,12,30,30
1650587295049,MATH 20C,A01,083760,Staff,0,16,30,30
1650587295049,MATH 20C,A02,083761,Staff,2,14,30,28
1650587295049,MATH 20C,B01,083762,Staff,11,0,30,19
1650587295049,MATH 20C,B02,083763,Staff,28,0,30,2
1650587301075,MATH 20D,A01,083765,Staff,1,1,30,29
1650587301075,MATH 20D,A02,083766,Staff,8,0,30,22
1650587301075,MATH 20D,A03,083767,Staff,25,0,30,5
1650587307100,MATH 20E,A01,083771,Staff,6,0,30,24
1650587307100,MATH 20E,A02,083772,Staff,18,0,30,12
1650587307100,MATH 20E,B01,083773,Staff,0,0,30,30
1650587307100,MATH 20E,B02,083774,Staff,9,0,30,21
1650587313130,MATH 103A,A01,083777,Staff,0,15,30,30
1650587313130,MATH 103A,A02,083778,Staff,0,14,30,30
1650587313130,MATH 103A,B01,083779,Staff,0,13,30,30
1650587313130,MATH 103A,B02,083780,Staff,0,13,30,30
1650587319151,MATH 105,A01,085443,Staff,0,21,30,30
1650587325178,MATH 109,A01,083213,Anzaldo; Leesa B,0,7,30,30
1650587325178,MATH 109,A02,083214,Anzaldo; Leesa B,0,7,30,30
1650587325178,MATH 109,B01,083215,Anzaldo; Leesa B,0,5,30,30
1650587325178,MATH 109,B02,083216,Anzaldo; Leesa B,1,6,30,29
1650587331202,MATH 142A,A01,083219,Chow; Bennett,0,16,30,30
1650587331202,MATH 142A,A02,083220,Chow; Bennett,0,15,30,30
1650587331202,MATH 142A,B01,083221,Chow; Bennett,0,14,30,30
1650587331202,MATH 142A,B02,083222,Chow; Bennett,0,13,30,30
1650587337226,MATH 193A,A01,083224,Staff,1,6,30,29
1650587337226,MATH 193A,A02,083225,Staff,0,6,30,30
1650587337226,MATH 193A,A03,083781,Staff,0,6,30,30
1650587337226,MATH 193A,A04,083782,Staff,0,7,30,30
1650587343256,MATH 197,001,091859,McAuley; Julian John,9998,0,9999,1
1650587349304,COGS 9,A01,083615,Staff,1,17,60,59
1650587355332,COGS 11,A01,083617,Boyle; Mary E. T.,18,0,40,22
1650587361356,COGS 13,A01,083071,Staff,0,37,40,40
1650587367383,COGS 14A,A01,092681,Staff,0,29,100,100
1650587373407,COGS 14B,A01,083073,Cheng; Tzu-Han,0,13,50,50
1650587379430,COGS 17,A01,092677,Staff,17,0,75,58
1650587385457,COGS 100,A01,083619,Staff,1,26,60,59
1650587391485,COGS 101A,A01,083621,Davis; Joshua Daniel,0,26,60,60
1650587397508,COGS 101B,A01,091572,Staff,1,5,60,59
1650587403533,COGS 101C,A01,083625,Delgado; Tania,15,0,30,15
1650587409558,COGS 107A,A01,083627,Boyle; Mary E. T.,0,13,60,60
1650587415583,COGS 118A,A01,083075,Staff,0,4,60,60
1650587421607,CSE 3,A50,083646,Miranda; Gregory Joseph,19,0,38,19
1650587421607,CSE 3,A51,083647,Miranda; Gregory Joseph,36,0,37,1
1650587427640,CSE 8A,A50,083650,Miranda; Gregory Joseph,0,30,40,40
1650587433665,CSE 11,A01,083080,Cao; Yingjun,0,96,40,40
1650587439691,CSE 12,A01,083652,Staff,0,20,100,100
1650587445723,CSE 15L,A01,083654,Staff,0,1,50,50
1650587445723,CSE 15L,A02,083655,Staff,0,1,50,50
1650587451772,CSE 20,A01,083657,Staff,51,0,80,29
1650587457799,CSE 30,A01,083084,Eldon; John,0,78,40,40
1650587463827,CSE 100,A01,083659,Cao; Yingjun,0,66,50,50
1650587469851,CSE 134B,A01,083661,Powell; Thomas Allan,0,35,65,65
1650587475876,CSE 140,A01,083663,Staff,1,7,75,74
1650587481903,CSE 140L,A01,083088,Eldon; John,1,13,75,74
1650587487930,CSE 175,A01,083665,Kumar; Rakesh,7,0,25,18
1650587493955,CSE 190,A00,092507,Dubnov; Shlomo,11,0,20,9
1650587499993,ECE 45,A01,083139,Staff,1,2,60,59
1650587506016,ECE 65,A50,083695,Staff,1,6,30,29
1650587512039,ECE 109,A01,091882,Touri; Behrouz,33,0,70,37
1650587518068,ECE 180,A00,083140,Abi Samra; Nicholas Camill,21,0,30,9
1650587518068,ECE 180,B00,083141,Abi Samra; Nicholas Camill,0,0,30,30
1650587524094,MATH 10A,A01,083735,Patchell; Gregory David,4,0,30,26
1650587524094,MATH 10A,A02,083736,Patchell; Gregory David,27,0,30,3
1650587524094,MATH 10A,A03,083737,Patchell; Gregory David,24,0,30,6
1650587530122,MATH 10B,A01,083207,Staff,0,9,30,30
1650587530122,MATH 10B,A02,083208,Staff,0,8,30,30
1650587530122,MATH 10B,B01,083739,Staff,11,0,30,19
1650587530122,MATH 10B,B02,083740,Staff,28,0,30,2
1650587536148,MATH 18,A01,083743,Staff,0,0,30,30
1650587536148,MATH 18,A02,083744,Staff,24,0,30,6
1650587536148,MATH 18,A03,083745,Staff,22,0,30,8
1650587536148,MATH 18,A04,083746,Staff,26,0,30,4
1650587536148,MATH 18,B01,083748,Staff,0,14,30,30
1650587536148,MATH 18,B02,083749,Staff,1,11,30,29
1650587536148,MATH 18,B03,083750,Staff,0,12,30,30
1650587536148,MATH 18,B04,083751,Staff,0,12,30,30
1650587542175,MATH 20A,A01,083754,Staff,21,0,40,19
1650587548198,MATH 20B,A01,083756,Staff,1,12,30,29
1650587548198,MATH 20B,A02,083757,Staff,0,12,30,30
1650587554225,MATH 20C,A01,083760,Staff,0,16,30,30
1650587554225,MATH 20C,A02,083761,Staff,2,14,30,28
1650587554225,MATH 20C,B01,083762,Staff,11,0,30,19
1650587554225,MATH 20C,B02,083763,Staff,28,0,30,2
1650587560250,MATH 20D,A01,083765,Staff,1,1,30,29
1650587560250,MATH 20D,A02,083766,Staff,8,0,30,22
1650587560250,MATH 20D,A03,083767,Staff,25,0,30,5
1650587566274,MATH 20E,A01,083771,Staff,6,0,30,24
1650587566274,MATH 20E,A02,083772,Staff,18,0,30,12
1650587566274,MATH 20E,B01,083773,Staff,0,0,30,30
1650587566274,MATH 20E,B02,083774,Staff,9,0,30,21
1650587572303,MATH 103A,A01,083777,Staff,0,15,30,30
1650587572303,MATH 103A,A02,083778,Staff,0,14,30,30
1650587572303,MATH 103A,B01,083779,Staff,0,13,30,30
1650587572303,MATH 103A,B02,083780,Staff,0,14,30,30
1650587578324,MATH 105,A01,085443,Staff,0,21,30,30
1650587584351,MATH 109,A01,083213,Anzaldo; Leesa B,0,7,30,30
1650587584351,MATH 109,A02,083214,Anzaldo; Leesa B,0,7,30,30
1650587584351,MATH 109,B01,083215,Anzaldo; Leesa B,0,5,30,30
1650587584351,MATH 109,B02,083216,Anzaldo; Leesa B,1,6,30,29
1650587590387,MATH 142A,A01,083219,Chow; Bennett,0,16,30,30
1650587590387,MATH 142A,A02,083220,Chow; Bennett,0,15,30,30
1650587590387,MATH 142A,B01,083221,Chow; Bennett,0,14,30,30
1650587590387,MATH 142A,B02,083222,Chow; Bennett,0,13,30,30
1650587596414,MATH 193A,A01,083224,Staff,1,6,30,29
1650587596414,MATH 193A,A02,083225,Staff,0,6,30,30
1650587596414,MATH 193A,A03,083781,Staff,0,6,30,30
1650587596414,MATH 193A,A04,083782,Staff,0,7,30,30
1650587602440,MATH 197,001,091859,McAuley; Julian John,9998,0,9999,1
1650587608492,COGS 9,A01,083615,Staff,1,17,60,59
1650587614525,COGS 11,A01,083617,Boyle; Mary E. T.,18,0,40,22
1650587620557,COGS 13,A01,083071,Staff,0,37,40,40
1650587626581,COGS 14A,A01,092681,Staff,0,29,100,100
1650587632605,COGS 14B,A01,083073,Cheng; Tzu-Han,0,13,50,50
1650587638627,COGS 17,A01,092677,Staff,17,0,75,58
1650587644650,COGS 100,A01,083619,Staff,1,26,60,59
1650587650690,COGS 101A,A01,083621,Davis; Joshua Daniel,0,26,60,60
1650587656713,COGS 101B,A01,091572,Staff,1,5,60,59
1650587662747,COGS 101C,A01,083625,Delgado; Tania,15,0,30,15
1650587668779,COGS 107A,A01,083627,Boyle; Mary E. T.,0,13,60,60
1650587674803,COGS 118A,A01,083075,Staff,0,4,60,60
1650587680831,CSE 3,A50,083646,Miranda; Gregory Joseph,19,0,38,19
1650587680831,CSE 3,A51,083647,Miranda; Gregory Joseph,36,0,37,1
1650587686854,CSE 8A,A50,083650,Miranda; Gregory Joseph,0,30,40,40
1650587692881,CSE 11,A01,083080,Cao; Yingjun,0,96,40,40
1650587698905,CSE 12,A01,083652,Staff,0,20,100,100
1650587704939,CSE 15L,A01,083654,Staff,0,1,50,50
1650587704939,CSE 15L,A02,083655,Staff,0,1,50,50
1650587710961,CSE 20,A01,083657,Staff,51,0,80,29
1650587716983,CSE 30,A01,083084,Eldon; John,0,78,40,40
1650587723009,CSE 100,A01,083659,Cao; Yingjun,0,66,50,50
1650587729036,CSE 134B,A01,083661,Powell; Thomas Allan,0,35,65,65
1650587735060,CSE 140,A01,083663,Staff,1,7,75,74
1650587741089,CSE 140L,A01,083088,Eldon; John,1,13,75,74
1650587747116,CSE 175,A01,083665,Kumar; Rakesh,7,0,25,18
1650587753251,CSE 190,A00,092507,Dubnov; Shlomo,11,0,20,9
1650587759292,ECE 45,A01,083139,Staff,1,2,60,59
1650587765315,ECE 65,A50,083695,Staff,1,6,30,29
1650587771348,ECE 109,A01,091882,Touri; Behrouz,33,0,70,37
1650587777372,ECE 180,A00,083140,Abi Samra; Nicholas Camill,21,0,30,9
1650587777372,ECE 180,B00,083141,Abi Samra; Nicholas Camill,0,0,30,30
1650587783398,MATH 10A,A01,083735,Patchell; Gregory David,4,0,30,26
1650587783398,MATH 10A,A02,083736,Patchell; Gregory David,27,0,30,3
1650587783398,MATH 10A,A03,083737,Patchell; Gregory David,24,0,30,6
1650587789425,MATH 10B,A01,083207,Staff,0,9,30,30
1650587789425,MATH 10B,A02,083208,Staff,0,8,30,30
1650587789425,MATH 10B,B01,083739,Staff,11,0,30,19
1650587789425,MATH 10B,B02,083740,Staff,28,0,30,2
1650587795450,MATH 18,A01,083743,Staff,0,0,30,30
1650587795450,MATH 18,A02,083744,Staff,24,0,30,6
1650587795450,MATH 18,A03,083745,Staff,22,0,30,8
1650587795450,MATH 18,A04,083746,Staff,26,0,30,4
1650587795450,MATH 18,B01,083748,Staff,0,14,30,30
1650587795450,MATH 18,B02,083749,Staff,1,11,30,29
1650587795450,MATH 18,B03,083750,Staff,0,12,30,30
1650587795450,MATH 18,B04,083751,Staff,0,12,30,30
1650587801483,MATH 20A,A01,083754,Staff,21,0,40,19
1650587807514,MATH 20B,A01,083756,Staff,1,12,30,29
1650587807514,MATH 20B,A02,083757,Staff,0,12,30,30
1650587813539,MATH 20C,A01,083760,Staff,0,16,30,30
1650587813539,MATH 20C,A02,083761,Staff,2,14,30,28
1650587813539,MATH 20C,B01,083762,Staff,11,0,30,19
1650587813539,MATH 20C,B02,083763,Staff,28,0,30,2
1650587819563,MATH 20D,A01,083765,Staff,1,1,30,29
1650587819563,MATH 20D,A02,083766,Staff,8,0,30,22
1650587819563,MATH 20D,A03,083767,Staff,25,0,30,5
1650587825588,MATH 20E,A01,083771,Staff,6,0,30,24
1650587825588,MATH 20E,A02,083772,Staff,18,0,30,12
1650587825588,MATH 20E,B01,083773,Staff,0,0,30,30
1650587825588,MATH 20E,B02,083774,Staff,9,0,30,21
1650587831622,MATH 103A,A01,083777,Staff,0,15,30,30
1650587831622,MATH 103A,A02,083778,Staff,0,14,30,30
1650587831622,MATH 103A,B01,083779,Staff,0,13,30,30
1650587831622,MATH 103A,B02,083780,Staff,0,14,30,30
1650587837649,MATH 105,A01,085443,Staff,0,21,30,30
1650587843683,MATH 109,A01,083213,Anzaldo; Leesa B,0,7,30,30
1650587843683,MATH 109,A02,083214,Anzaldo; Leesa B,0,7,30,30
1650587843683,MATH 109,B01,083215,Anzaldo; Leesa B,0,5,30,30
1650587843683,MATH 109,B02,083216,Anzaldo; Leesa B,1,6,30,29
1650587849712,MATH 142A,A01,083219,Chow; Bennett,0,16,30,30
1650587849712,MATH 142A,A02,083220,Chow; Bennett,0,15,30,30
1650587849712,MATH 142A,B01,083221,Chow; Bennett,0,14,30,30
1650587849712,MATH 142A,B02,083222,Chow; Bennett,0,13,30,30
1650587855735,MATH 193A,A01,083224,Staff,1,6,30,29
1650587855735,MATH 193A,A02,083225,Staff,0,6,30,30
1650587855735,MATH 193A,A03,083781,Staff,0,6,30,30
1650587855735,MATH 193A,A04,083782,Staff,0,7,30,30
1650587861760,MATH 197,001,091859,McAuley; Julian John,9998,0,9999,1
1650587867829,COGS 9,A01,083615,Staff,1,17,60,59
1650587873853,COGS 11,A01,083617,Boyle; Mary E. T.,18,0,40,22
1650587879877,COGS 13,A01,083071,Staff,0,37,40,40
1650587885902,COGS 14A,A01,092681,Staff,0,29,100,100
1650587891933,COGS 14B,A01,083073,Cheng; Tzu-Han,0,13,50,50
1650587897957,COGS 17,A01,092677,Staff,17,0,75,58
1650587903981,COGS 100,A01,083619,Staff,1,26,60,59
1650587910005,COGS 101A,A01,083621,Davis; Joshua Daniel,0,26,60,60
1650587916034,COGS 101B,A01,091572,Staff,1,5,60,59
1650587922057,COGS 101C,A01,083625,Delgado; Tania,15,0,30,15
1650587928088,COGS 107A,A01,083627,Boyle; Mary E. T.,0,13,60,60
1650587934112,COGS 118A,A01,083075,Staff,0,4,60,60
1650587940138,CSE 3,A50,083646,Miranda; Gregory Joseph,19,0,38,19
1650587940138,CSE 3,A51,083647,Miranda; Gregory Joseph,36,0,37,1
1650587946173,CSE 8A,A50,083650,Miranda; Gregory Joseph,0,30,40,40
1650587952196,CSE 11,A01,083080,Cao; Yingjun,0,96,40,40
1650587958219,CSE 12,A01,083652,Staff,0,20,100,100
1650587964245,CSE 15L,A01,083654,Staff,0,1,50,50
1650587964245,CSE 15L,A02,083655,Staff,0,1,50,50
1650587970280,CSE 20,A01,083657,Staff,51,0,80,29
1650587976303,CSE 30,A01,083084,Eldon; John,0,78,40,40
1650587982326,CSE 100,A01,083659,Cao; Yingjun,0,66,50,50
1650587988370,CSE 134B,A01,083661,Powell; Thomas Allan,0,35,65,65
1650587994395,CSE 140,A01,083663,Staff,1,7,75,74
1650588000425,CSE 140L,A01,083088,Eldon; John,1,13,75,74
1650588006447,CSE 175,A01,083665,Kumar; Rakesh,7,0,25,18
1650588012472,CSE 190,A00,092507,Dubnov; Shlomo,11,0,20,9
1650588018498,ECE 45,A01,083139,Staff,1,2,60,59
1650588024523,ECE 65,A50,083695,Staff,1,6,30,29
1650588030545,ECE 109,A01,091882,Touri; Behrouz,33,0,70,37
1650588036570,ECE 180,A00,083140,Abi Samra; Nicholas Camill,21,0,30,9
1650588036570,ECE 180,B00,083141,Abi Samra; Nicholas Camill,0,0,30,30
1650588042596,MATH 10A,A01,083735,Patchell; Gregory David,4,0,30,26
1650588042596,MATH 10A,A02,083736,Patchell; Gregory David,27,0,30,3
1650588042596,MATH 10A,A03,083737,Patchell; Gregory David,24,0,30,6
1650588048632,MATH 10B,A01,083207,Staff,0,9,30,30
1650588048632,MATH 10B,A02,083208,Staff,0,8,30,30
1650588048632,MATH 10B,B01,083739,Staff,11,0,30,19
1650588048632,MATH 10B,B02,083740,Staff,28,0,30,2
1650588054671,MATH 18,A01,083743,Staff,0,0,30,30
1650588054671,MATH 18,A02,083744,Staff,24,0,30,6
1650588054671,MATH 18,A03,083745,Staff,22,0,30,8
1650588054671,MATH 18,A04,083746,Staff,26,0,30,4
1650588054671,MATH 18,B01,083748,Staff,0,14,30,30
1650588054671,MATH 18,B02,083749,Staff,1,11,30,29
1650588054671,MATH 18,B03,083750,Staff,0,12,30,30
1650588054671,MATH 18,B04,083751,Staff,0,12,30,30
1650588060695,MATH 20A,A01,083754,Staff,21,0,40,19
1650588066725,MATH 20B,A01,083756,Staff,1,12,30,29
1650588066725,MATH 20B,A02,083757,Staff,0,12,30,30
1650588072749,MATH 20C,A01,083760,Staff,0,16,30,30
1650588072749,MATH 20C,A02,083761,Staff,2,14,30,28
1650588072749,MATH 20C,B01,083762,Staff,11,0,30,19
1650588072749,MATH 20C,B02,083763,Staff,28,0,30,2
1650588078776,MATH 20D,A01,083765,Staff,1,1,30,29
1650588078776,MATH 20D,A02,083766,Staff,8,0,30,22
1650588078776,MATH 20D,A03,083767,Staff,25,0,30,5
1650588084802,MATH 20E,A01,083771,Staff,6,0,30,24
1650588084802,MATH 20E,A02,083772,Staff,18,0,30,12
1650588084802,MATH 20E,B01,083773,Staff,0,0,30,30
1650588084802,MATH 20E,B02,083774,Staff,9,0,30,21
1650588090827,MATH 103A,A01,083777,Staff,0,15,30,30
1650588090827,MATH 103A,A02,083778,Staff,0,14,30,30
1650588090827,MATH 103A,B01,083779,Staff,0,13,30,30
1650588090827,MATH 103A,B02,083780,Staff,0,14,30,30
1650588096862,MATH 105,A01,085443,Staff,0,21,30,30
1650588102887,MATH 109,A01,083213,Anzaldo; Leesa B,0,7,30,30
1650588102887,MATH 109,A02,083214,Anzaldo; Leesa B,0,7,30,30
1650588102887,MATH 109,B01,083215,Anzaldo; Leesa B,0,5,30,30
1650588102887,MATH 109,B02,083216,Anzaldo; Leesa B,1,6,30,29
1650588108912,MATH 142A,A01,083219,Chow; Bennett,0,16,30,30
1650588108912,MATH 142A,A02,083220,Chow; Bennett,0,15,30,30
1650588108912,MATH 142A,B01,083221,Chow; Bennett,0,14,30,30
1650588108912,MATH 142A,B02,083222,Chow; Bennett,0,13,30,30
1650588114935,MATH 193A,A01,083224,Staff,1,6,30,29
1650588114935,MATH 193A,A02,083225,Staff,0,6,30,30
1650588114935,MATH 193A,A03,083781,Staff,0,6,30,30
1650588114935,MATH 193A,A04,083782,Staff,0,7,30,30
1650588120960,MATH 197,001,091859,McAuley; Julian John,9998,0,9999,1
1650588127020,COGS 9,A01,083615,Staff,1,17,60,59
1650588133048,COGS 11,A01,083617,Boyle; Mary E. T.,18,0,40,22
1650588139072,COGS 13,A01,083071,Staff,0,37,40,40
1650588145096,COGS 14A,A01,092681,Staff,0,29,100,100
1650588151120,COGS 14B,A01,083073,Cheng; Tzu-Han,0,13,50,50
1650588157159,COGS 17,A01,092677,Staff,17,0,75,58
1650588163183,COGS 100,A01,083619,Staff,1,26,60,59
1650588169206,COGS 101A,A01,083621,Davis; Joshua Daniel,0,26,60,60
1650588175238,COGS 101B,A01,091572,Staff,1,5,60,59
1650588181264,COGS 101C,A01,083625,Delgado; Tania,15,0,30,15
1650588187296,COGS 107A,A01,083627,Boyle; Mary E. T.,0,13,60,60
1650588193334,COGS 118A,A01,083075,Staff,0,4,60,60
1650588199362,CSE 3,A50,083646,Miranda; Gregory Joseph,19,0,38,19
1650588199362,CSE 3,A51,083647,Miranda; Gregory Joseph,36,0,37,1
1650588205389,CSE 8A,A50,083650,Miranda; Gregory Joseph,0,30,40,40
1650588211412,CSE 11,A01,083080,Cao; Yingjun,0,95,40,40
1650588217435,CSE 12,A01,083652,Staff,0,20,100,100
1650588223459,CSE 15L,A01,083654,Staff,0,1,50,50
1650588223459,CSE 15L,A02,083655,Staff,0,1,50,50
1650588229484,CSE 20,A01,083657,Staff,51,0,80,29
1650588235509,CSE 30,A01,083084,Eldon; John,0,78,40,40
1650588241534,CSE 100,A01,083659,Cao; Yingjun,0,66,50,50
1650588247562,CSE 134B,A01,083661,Powell; Thomas Allan,0,35,65,65
1650588253585,CSE 140,A01,083663,Staff,1,7,75,74
1650588259615,CSE 140L,A01,083088,Eldon; John,1,13,75,74
1650588265643,CSE 175,A01,083665,Kumar; Rakesh,7,0,25,18
1650588271673,CSE 190,A00,092507,Dubnov; Shlomo,11,0,20,9
1650588277698,ECE 45,A01,083139,Staff,1,2,60,59
1650588283722,ECE 65,A50,083695,Staff,1,6,30,29
1650588289746,ECE 109,A01,091882,Touri; Behrouz,33,0,70,37
1650588295770,ECE 180,A00,083140,Abi Samra; Nicholas Camill,21,0,30,9
1650588295770,ECE 180,B00,083141,Abi Samra; Nicholas Camill,0,0,30,30
1650588301794,MATH 10A,A01,083735,Patchell; Gregory David,4,0,30,26
1650588301794,MATH 10A,A02,083736,Patchell; Gregory David,27,0,30,3
1650588301794,MATH 10A,A03,083737,Patchell; Gregory David,24,0,30,6
1650588307824,MATH 10B,A01,083207,Staff,0,9,30,30
1650588307824,MATH 10B,A02,083208,Staff,0,8,30,30
1650588307824,MATH 10B,B01,083739,Staff,11,0,30,19
1650588307824,MATH 10B,B02,083740,Staff,28,0,30,2
1650588313848,MATH 18,A01,083743,Staff,0,0,30,30
1650588313848,MATH 18,A02,083744,Staff,24,0,30,6
1650588313848,MATH 18,A03,083745,Staff,21,0,30,9
1650588313848,MATH 18,A04,083746,Staff,26,0,30,4
1650588313848,MATH 18,B01,083748,Staff,0,14,30,30
1650588313848,MATH 18,B02,083749,Staff,1,11,30,29
1650588313848,MATH 18,B03,083750,Staff,0,12,30,30
1650588313848,MATH 18,B04,083751,Staff,0,12,30,30
1650588319872,MATH 20A,A01,083754,Staff,21,0,40,19
1650588325897,MATH 20B,A01,083756,Staff,1,12,30,29
1650588325897,MATH 20B,A02,083757,Staff,0,12,30,30
1650588331928,MATH 20C,A01,083760,Staff,0,16,30,30
1650588331928,MATH 20C,A02,083761,Staff,2,14,30,28
1650588331928,MATH 20C,B01,083762,Staff,11,0,30,19
1650588331928,MATH 20C,B02,083763,Staff,28,0,30,2
1650588337953,MATH 20D,A01,083765,Staff,1,1,30,29
1650588337953,MATH 20D,A02,083766,Staff,8,0,30,22
1650588337953,MATH 20D,A03,083767,Staff,25,0,30,5
1650588343980,MATH 20E,A01,083771,Staff,6,0,30,24
1650588343980,MATH 20E,A02,083772,Staff,18,0,30,12
1650588343980,MATH 20E,B01,083773,Staff,0,0,30,30
1650588343980,MATH 20E,B02,083774,Staff,9,0,30,21
1650588350094,MATH 103A,A01,083777,Staff,0,15,30,30
1650588350094,MATH 103A,A02,083778,Staff,0,14,30,30
1650588350094,MATH 103A,B01,083779,Staff,0,13,30,30
1650588350094,MATH 103A,B02,083780,Staff,0,14,30,30
1650588356121,MATH 105,A01,085443,Staff,0,21,30,30
1650588362148,MATH 109,A01,083213,Anzaldo; Leesa B,0,7,30,30
1650588362148,MATH 109,A02,083214,Anzaldo; Leesa B,0,7,30,30
1650588362148,MATH 109,B01,083215,Anzaldo; Leesa B,0,5,30,30
1650588362148,MATH 109,B02,083216,Anzaldo; Leesa B,1,6,30,29
1650588368172,MATH 142A,A01,083219,Chow; Bennett,0,16,30,30
1650588368172,MATH 142A,A02,083220,Chow; Bennett,0,15,30,30
1650588368172,MATH 142A,B01,083221,Chow; Bennett,0,14,30,30
1650588368172,MATH 142A,B02,083222,Chow; Bennett,0,13,30,30
1650588374196,MATH 193A,A01,083224,Staff,1,6,30,29
1650588374196,MATH 193A,A02,083225,Staff,0,6,30,30
1650588374196,MATH 193A,A03,083781,Staff,0,6,30,30
1650588374196,MATH 193A,A04,083782,Staff,0,7,30,30
1650588380222,MATH 197,001,091859,McAuley; Julian John,9998,0,9999,1
1650588386274,COGS 9,A01,083615,Staff,1,17,60,59
1650588392299,COGS 11,A01,083617,Boyle; Mary E. T.,18,0,40,22
1650588398328,COGS 13,A01,083071,Staff,0,37,40,40
1650588404353,COGS 14A,A01,092681,Staff,0,29,100,100
1650588410376,COGS 14B,A01,083073,Cheng; Tzu-Han,0,13,50,50
1650588416403,COGS 17,A01,092677,Staff,17,0,75,58
1650588422436,COGS 100,A01,083619,Staff,1,26,60,59
1650588428460,COGS 101A,A01,083621,Davis; Joshua Daniel,0,26,60,60
1650588434487,COGS 101B,A01,091572,Staff,1,5,60,59
1650588440513,COGS 101C,A01,083625,Delgado; Tania,15,0,30,15
1650588446541,COGS 107A,A01,083627,Boyle; Mary E. T.,0,13,60,60
1650588452565,COGS 118A,A01,083075,Staff,0,4,60,60
1650588458588,CSE 3,A50,083646,Miranda; Gregory Joseph,19,0,38,19
1650588458588,CSE 3,A51,083647,Miranda; Gregory Joseph,36,0,37,1
1650588464619,CSE 8A,A50,083650,Miranda; Gregory Joseph,0,30,40,40
1650588470647,CSE 11,A01,083080,Cao; Yingjun,0,95,40,40
1650588476674,CSE 12,A01,083652,Staff,0,20,100,100
1650588482704,CSE 15L,A01,083654,Staff,0,1,50,50
1650588482704,CSE 15L,A02,083655,Staff,0,1,50,50
1650588488729,CSE 20,A01,083657,Staff,51,0,80,29
1650588494757,CSE 30,A01,083084,Eldon; John,0,78,40,40
1650588500780,CSE 100,A01,083659,Cao; Yingjun,0,66,50,50
1650588506808,CSE 134B,A01,083661,Powell; Thomas Allan,0,35,65,65
1650588512841,CSE 140,A01,083663,Staff,1,7,75,74
1650588518864,CSE 140L,A01,083088,Eldon; John,1,13,75,74
1650588524886,CSE 175,A01,083665,Kumar; Rakesh,7,0,25,18
1650588530913,CSE 190,A00,092507,Dubnov; Shlomo,11,0,20,9
1650588536939,ECE 45,A01,083139,Staff,1,2,60,59
1650588542980,ECE 65,A50,083695,Staff,1,6,30,29
1650588549006,ECE 109,A01,091882,Touri; Behrouz,33,0,70,37
1650588555031,ECE 180,A00,083140,Abi Samra; Nicholas Camill,21,0,30,9
1650588555031,ECE 180,B00,083141,Abi Samra; Nicholas Camill,0,0,30,30
1650588561054,MATH 10A,A01,083735,Patchell; Gregory David,4,0,30,26
1650588561054,MATH 10A,A02,083736,Patchell; Gregory David,27,0,30,3
1650588561054,MATH 10A,A03,083737,Patchell; Gregory David,24,0,30,6
1650588567077,MATH 10B,A01,083207,Staff,0,9,30,30
1650588567077,MATH 10B,A02,083208,Staff,0,8,30,30
1650588567077,MATH 10B,B01,083739,Staff,11,0,30,19
1650588567077,MATH 10B,B02,083740,Staff,28,0,30,2
1650588573105,MATH 18,A01,083743,Staff,0,0,30,30
1650588573105,MATH 18,A02,083744,Staff,24,0,30,6
1650588573105,MATH 18,A03,083745,Staff,21,0,30,9
1650588573105,MATH 18,A04,083746,Staff,26,0,30,4
1650588573105,MATH 18,B01,083748,Staff,0,14,30,30
1650588573105,MATH 18,B02,083749,Staff,1,11,30,29
1650588573105,MATH 18,B03,083750,Staff,0,12,30,30
1650588573105,MATH 18,B04,083751,Staff,0,12,30,30
1650588579128,MATH 20A,A01,083754,Staff,21,0,40,19
1650588585153,MATH 20B,A01,083756,Staff,1,12,30,29
1650588585153,MATH 20B,A02,083757,Staff,0,12,30,30
1650588591179,MATH 20C,A01,083760,Staff,0,16,30,30
1650588591179,MATH 20C,A02,083761,Staff,2,14,30,28
1650588591179,MATH 20C,B01,083762,Staff,11,0,30,19
1650588591179,MATH 20C,B02,083763,Staff,28,0,30,2
1650588597203,MATH 20D,A01,083765,Staff,1,1,30,29
1650588597203,MATH 20D,A02,083766,Staff,8,0,30,22
1650588597203,MATH 20D,A03,083767,Staff,25,0,30,5
1650588603237,MATH 20E,A01,083771,Staff,6,0,30,24
1650588603237,MATH 20E,A02,083772,Staff,18,0,30,12
1650588603237,MATH 20E,B01,083773,Staff,0,0,30,30
1650588603237,MATH 20E,B02,083774,Staff,9,0,30,21
1650588609266,MATH 103A,A01,083777,Staff,0,15,30,30
1650588609266,MATH 103A,A02,083778,Staff,0,14,30,30
1650588609266,MATH 103A,B01,083779,Staff,0,13,30,30
1650588609266,MATH 103A,B02,083780,Staff,0,14,30,30
1650588615290,MATH 105,A01,085443,Staff,0,21,30,30
1650588621312,MATH 109,A01,083213,Anzaldo; Leesa B,0,7,30,30
1650588621312,MATH 109,A02,083214,Anzaldo; Leesa B,0,7,30,30
1650588621312,MATH 109,B01,083215,Anzaldo; Leesa B,0,5,30,30
1650588621312,MATH 109,B02,083216,Anzaldo; Leesa B,1,6,30,29
1650588627342,MATH 142A,A01,083219,Chow; Bennett,0,16,30,30
1650588627342,MATH 142A,A02,083220,Chow; Bennett,0,15,30,30
1650588627342,MATH 142A,B01,083221,Chow; Bennett,0,14,30,30
1650588627342,MATH 142A,B02,083222,Chow; Bennett,0,13,30,30
1650588633371,MATH 193A,A01,083224,Staff,1,6,30,29
1650588633371,MATH 193A,A02,083225,Staff,0,6,30,30
1650588633371,MATH 193A,A03,083781,Staff,0,6,30,30
1650588633371,MATH 193A,A04,083782,Staff,0,7,30,30
1650588639395,MATH 197,001,091859,McAuley; Julian John,9998,0,9999,1
1650588645450,COGS 9,A01,083615,Staff,1,17,60,59
1650588651477,COGS 11,A01,083617,Boyle; Mary E. T.,18,0,40,22
1650588657507,COGS 13,A01,083071,Staff,0,37,40,40
1650588663530,COGS 14A,A01,092681,Staff,0,29,100,100
1650588669554,COGS 14B,A01,083073,Cheng; Tzu-Han,0,13,50,50
1650588675576,COGS 17,A01,092677,Staff,17,0,75,58
1650588681602,COGS 100,A01,083619,Staff,1,26,60,59
1650588687624,COGS 101A,A01,083621,Davis; Joshua Daniel,0,26,60,60
1650588693647,COGS 101B,A01,091572,Staff,1,5,60,59
1650588699671,COGS 101C,A01,083625,Delgado; Tania,15,0,30,15
1650588705700,COGS 107A,A01,083627,Boyle; Mary E. T.,0,13,60,60
1650588711723,COGS 118A,A01,083075,Staff,0,4,60,60
1650588717754,CSE 3,A50,083646,Miranda; Gregory Joseph,19,0,38,19
1650588717754,CSE 3,A51,083647,Miranda; Gregory Joseph,36,0,37,1
1650588723785,CSE 8A,A50,083650,Miranda; Gregory Joseph,0,30,40,40
1650588729816,CSE 11,A01,083080,Cao; Yingjun,0,95,40,40
1650588735838,CSE 12,A01,083652,Staff,0,20,100,100
1650588741862,CSE 15L,A01,083654,Staff,0,1,50,50
1650588741862,CSE 15L,A02,083655,Staff,0,1,50,50
1650588747886,CSE 20,A01,083657,Staff,51,0,80,29
1650588753917,CSE 30,A01,083084,Eldon; John,0,78,40,40
1650588759941,CSE 100,A01,083659,Cao; Yingjun,0,66,50,50
1650588765965,CSE 134B,A01,083661,Powell; Thomas Allan,0,35,65,65
1650588771997,CSE 140,A01,083663,Staff,1,8,75,74
1650588778026,CSE 140L,A01,083088,Eldon; John,1,14,75,74
1650588784052,CSE 175,A01,083665,Kumar; Rakesh,7,0,25,18
1650588790077,CSE 190,A00,092507,Dubnov; Shlomo,11,0,20,9
1650588796101,ECE 45,A01,083139,Staff,1,2,60,59
1650588802125,ECE 65,A50,083695,Staff,1,6,30,29
1650588808151,ECE 109,A01,091882,Touri; Behrouz,33,0,70,37
1650588814187,ECE 180,A00,083140,Abi Samra; Nicholas Camill,21,0,30,9
1650588814187,ECE 180,B00,083141,Abi Samra; Nicholas Camill,0,0,30,30
1650588820211,MATH 10A,A01,083735,Patchell; Gregory David,4,0,30,26
1650588820211,MATH 10A,A02,083736,Patchell; Gregory David,27,0,30,3
1650588820211,MATH 10A,A03,083737,Patchell; Gregory David,24,0,30,6
1650588826239,MATH 10B,A01,083207,Staff,0,9,30,30
1650588826239,MATH 10B,A02,083208,Staff,0,8,30,30
1650588826239,MATH 10B,B01,083739,Staff,11,0,30,19
1650588826239,MATH 10B,B02,083740,Staff,28,0,30,2
1650588832269,MATH 18,A01,083743,Staff,0,0,30,30
1650588832269,MATH 18,A02,083744,Staff,24,0,30,6
1650588832269,MATH 18,A03,083745,Staff,21,0,30,9
1650588832269,MATH 18,A04,083746,Staff,26,0,30,4
1650588832269,MATH 18,B01,083748,Staff,0,14,30,30
1650588832269,MATH 18,B02,083749,Staff,1,11,30,29
1650588832269,MATH 18,B03,083750,Staff,0,12,30,30
1650588832269,MATH 18,B04,083751,Staff,0,12,30,30
1650588838304,MATH 20A,A01,083754,Staff,21,0,40,19
1650588844330,MATH 20B,A01,083756,Staff,1,12,30,29
1650588844330,MATH 20B,A02,083757,Staff,0,12,30,30
1650588850357,MATH 20C,A01,083760,Staff,0,16,30,30
1650588850357,MATH 20C,A02,083761,Staff,2,14,30,28
1650588850357,MATH 20C,B01,083762,Staff,11,0,30,19
1650588850357,MATH 20C,B02,083763,Staff,28,0,30,2
1650588856385,MATH 20D,A01,083765,Staff,1,1,30,29
1650588856385,MATH 20D,A02,083766,Staff,8,0,30,22
1650588856385,MATH 20D,A03,083767,Staff,25,0,30,5
1650588862413,MATH 20E,A01,083771,Staff,6,0,30,24
1650588862413,MATH 20E,A02,083772,Staff,18,0,30,12
1650588862413,MATH 20E,B01,083773,Staff,0,0,30,30
1650588862413,MATH 20E,B02,083774,Staff,9,0,30,21
1650588868436,MATH 103A,A01,083777,Staff,0,15,30,30
1650588868436,MATH 103A,A02,083778,Staff,0,14,30,30
1650588868436,MATH 103A,B01,083779,Staff,0,13,30,30
1650588868436,MATH 103A,B02,083780,Staff,0,14,30,30
1650588874469,MATH 105,A01,085443,Staff,0,21,30,30
1650588880503,MATH 109,A01,083213,Anzaldo; Leesa B,0,7,30,30
1650588880503,MATH 109,A02,083214,Anzaldo; Leesa B,0,7,30,30
1650588880503,MATH 109,B01,083215,Anzaldo; Leesa B,0,5,30,30
1650588880503,MATH 109,B02,083216,Anzaldo; Leesa B,1,6,30,29
1650588886525,MATH 142A,A01,083219,Chow; Bennett,0,16,30,30
1650588886525,MATH 142A,A02,083220,Chow; Bennett,0,15,30,30
1650588886525,MATH 142A,B01,083221,Chow; Bennett,0,14,30,30
1650588886525,MATH 142A,B02,083222,Chow; Bennett,0,13,30,30
1650588892552,MATH 193A,A01,083224,Staff,1,6,30,29
1650588892552,MATH 193A,A02,083225,Staff,0,6,30,30
1650588892552,MATH 193A,A03,083781,Staff,0,6,30,30
1650588892552,MATH 193A,A04,083782,Staff,0,7,30,30
1650588898578,MATH 197,001,091859,McAuley; Julian John,9998,0,9999,1
1650588904641,COGS 9,A01,083615,Staff,1,17,60,59
1650588910664,COGS 11,A01,083617,Boyle; Mary E. T.,18,0,40,22
1650588916689,COGS 13,A01,083071,Staff,0,37,40,40
1650588922732,COGS 14A,A01,092681,Staff,0,29,100,100
1650588928755,COGS 14B,A01,083073,Cheng; Tzu-Han,0,13,50,50
1650588934779,COGS 17,A01,092677,Staff,17,0,75,58
1650588940896,COGS 100,A01,083619,Staff,1,26,60,59
1650588946920,COGS 101A,A01,083621,Davis; Joshua Daniel,0,26,60,60
1650588952942,COGS 101B,A01,091572,Staff,1,5,60,59
1650588958965,COGS 101C,A01,083625,Delgado; Tania,15,0,30,15
1650588964996,COGS 107A,A01,083627,Boyle; Mary E. T.,0,13,60,60
1650588971022,COGS 118A,A01,083075,Staff,0,4,60,60
1650588977056,CSE 3,A50,083646,Miranda; Gregory Joseph,19,0,38,19
1650588977056,CSE 3,A51,083647,Miranda; Gregory Joseph,36,0,37,1
1650588983084,CSE 8A,A50,083650,Miranda; Gregory Joseph,0,30,40,40
1650588989111,CSE 11,A01,083080,Cao; Yingjun,0,95,40,40
1650588995142,CSE 12,A01,083652,Staff,0,20,100,100
1650589001170,CSE 15L,A01,083654,Staff,0,1,50,50
1650589001170,CSE 15L,A02,083655,Staff,0,1,50,50
1650589007195,CSE 20,A01,083657,Staff,51,0,80,29
1650589013219,CSE 30,A01,083084,Eldon; John,0,78,40,40
1650589019246,CSE 100,A01,083659,Cao; Yingjun,0,66,50,50
1650589025277,CSE 134B,A01,083661,Powell; Thomas Allan,0,35,65,65
1650589031300,CSE 140,A01,083663,Staff,1,8,75,74
1650589037335,CSE 140L,A01,083088,Eldon; John,1,14,75,74
1650589043358,CSE 175,A01,083665,Kumar; Rakesh,7,0,25,18
1650589049382,CSE 190,A00,092507,Dubnov; Shlomo,11,0,20,9
1650589055404,ECE 45,A01,083139,Staff,1,2,60,59
1650589061427,ECE 65,A50,083695,Staff,1,6,30,29
1650589067451,ECE 109,A01,091882,Touri; Behrouz,33,0,70,37
1650589073479,ECE 180,A00,083140,Abi Samra; Nicholas Camill,21,0,30,9
1650589073479,ECE 180,B00,083141,Abi Samra; Nicholas Camill,0,0,30,30
1650589079502,MATH 10A,A01,083735,Patchell; Gregory David,4,0,30,26
1650589079502,MATH 10A,A02,083736,Patchell; Gregory David,27,0,30,3
1650589079502,MATH 10A,A03,083737,Patchell; Gregory David,24,0,30,6
1650589085525,MATH 10B,A01,083207,Staff,0,9,30,30
1650589085525,MATH 10B,A02,083208,Staff,0,8,30,30
1650589085525,MATH 10B,B01,083739,Staff,11,0,30,19
1650589085525,MATH 10B,B02,083740,Staff,28,0,30,2
1650589091551,MATH 18,A01,083743,Staff,0,0,30,30
1650589091551,MATH 18,A02,083744,Staff,24,0,30,6
1650589091551,MATH 18,A03,083745,Staff,21,0,30,9
1650589091551,MATH 18,A04,083746,Staff,26,0,30,4
1650589091551,MATH 18,B01,083748,Staff,0,14,30,30
1650589091551,MATH 18,B02,083749,Staff,1,11,30,29
1650589091551,MATH 18,B03,083750,Staff,0,12,30,30
1650589091551,MATH 18,B04,083751,Staff,0,12,30,30
1650589097576,MATH 20A,A01,083754,Staff,21,0,40,19
1650589103602,MATH 20B,A01,083756,Staff,1,12,30,29
1650589103602,MATH 20B,A02,083757,Staff,0,12,30,30
1650589109626,MATH 20C,A01,083760,Staff,0,16,30,30
1650589109626,MATH 20C,A02,083761,Staff,2,14,30,28
1650589109626,MATH 20C,B01,083762,Staff,11,0,30,19
1650589109626,MATH 20C,B02,083763,Staff,28,0,30,2
1650589115653,MATH 20D,A01,083765,Staff,1,1,30,29
1650589115653,MATH 20D,A02,083766,Staff,8,0,30,22
1650589115653,MATH 20D,A03,083767,Staff,25,0,30,5
1650589121682,MATH 20E,A01,083771,Staff,6,0,30,24
1650589121682,MATH 20E,A02,083772,Staff,18,0,30,12
1650589121682,MATH 20E,B01,083773,Staff,0,0,30,30
1650589121682,MATH 20E,B02,083774,Staff,9,0,30,21
1650589127706,MATH 103A,A01,083777,Staff,0,15,30,30
1650589127706,MATH 103A,A02,083778,Staff,0,14,30,30
1650589127706,MATH 103A,B01,083779,Staff,0,13,30,30
1650589127706,MATH 103A,B02,083780,Staff,0,14,30,30
1650589133730,MATH 105,A01,085443,Staff,0,21,30,30
1650589139753,MATH 109,A01,083213,Anzaldo; Leesa B,0,7,30,30
1650589139753,MATH 109,A02,083214,Anzaldo; Leesa B,0,7,30,30
1650589139753,MATH 109,B01,083215,Anzaldo; Leesa B,0,5,30,30
1650589139753,MATH 109,B02,083216,Anzaldo; Leesa B,1,6,30,29
1650589145779,MATH 142A,A01,083219,Chow; Bennett,0,16,30,30
1650589145779,MATH 142A,A02,083220,Chow; Bennett,0,15,30,30
1650589145779,MATH 142A,B01,083221,Chow; Bennett,0,14,30,30
1650589145779,MATH 142A,B02,083222,Chow; Bennett,0,13,30,30
1650589151803,MATH 193A,A01,083224,Staff,1,6,30,29
1650589151803,MATH 193A,A02,083225,Staff,0,6,30,30
1650589151803,MATH 193A,A03,083781,Staff,0,6,30,30
1650589151803,MATH 193A,A04,083782,Staff,0,7,30,30
1650589157837,MATH 197,001,091859,McAuley; Julian John,9998,0,9999,1
1650589163890,COGS 9,A01,083615,Staff,1,17,60,59
1650589169924,COGS 11,A01,083617,Boyle; Mary E. T.,18,0,40,22
1650589175948,COGS 13,A01,083071,Staff,0,37,40,40
1650589181974,COGS 14A,A01,092681,Staff,0,29,100,100
1650589187998,COGS 14B,A01,083073,Cheng; Tzu-Han,0,13,50,50
1650589194037,COGS 17,A01,092677,Staff,17,0,75,58
1650589200063,COGS 100,A01,083619,Staff,1,26,60,59
1650589206089,COGS 101A,A01,083621,Davis; Joshua Daniel,0,26,60,60
1650589212118,COGS 101B,A01,091572,Staff,1,5,60,59
1650589218140,COGS 101C,A01,083625,Delgado; Tania,15,0,30,15
1650589224167,COGS 107A,A01,083627,Boyle; Mary E. T.,0,13,60,60
1650589230193,COGS 118A,A01,083075,Staff,0,4,60,60
1650589236229,CSE 3,A50,083646,Miranda; Gregory Joseph,19,0,38,19
1650589236229,CSE 3,A51,083647,Miranda; Gregory Joseph,36,0,37,1
1650589242256,CSE 8A,A50,083650,Miranda; Gregory Joseph,0,30,40,40
1650589248287,CSE 11,A01,083080,Cao; Yingjun,0,95,40,40
1650589254311,CSE 12,A01,083652,Staff,0,20,100,100
1650589260338,CSE 15L,A01,083654,Staff,0,1,50,50
1650589260338,CSE 15L,A02,083655,Staff,0,1,50,50
1650589266367,CSE 20,A01,083657,Staff,51,0,80,29
1650589272396,CSE 30,A01,083084,Eldon; John,0,78,40,40
1650589278423,CSE 100,A01,083659,Cao; Yingjun,0,66,50,50
1650589284448,CSE 134B,A01,083661,Powell; Thomas Allan,0,35,65,65
1650589290470,CSE 140,A01,083663,Staff,1,8,75,74
1650589296495,CSE 140L,A01,083088,Eldon; John,1,14,75,74
1650589302528,CSE 175,A01,083665,Kumar; Rakesh,7,0,25,18
1650589308560,CSE 190,A00,092507,Dubnov; Shlomo,11,0,20,9
1650589314590,ECE 45,A01,083139,Staff,1,2,60,59
1650589320627,ECE 65,A50,083695,Staff,1,6,30,29
1650589326652,ECE 109,A01,091882,Touri; Behrouz,33,0,70,37
1650589332683,ECE 180,A00,083140,Abi Samra; Nicholas Camill,21,0,30,9
1650589332683,ECE 180,B00,083141,Abi Samra; Nicholas Camill,0,0,30,30
1650589338708,MATH 10A,A01,083735,Patchell; Gregory David,4,0,30,26
1650589338708,MATH 10A,A02,083736,Patchell; Gregory David,27,0,30,3
1650589338708,MATH 10A,A03,083737,Patchell; Gregory David,24,0,30,6
1650589344730,MATH 10B,A01,083207,Staff,0,9,30,30
1650589344730,MATH 10B,A02,083208,Staff,0,8,30,30
1650589344730,MATH 10B,B01,083739,Staff,11,0,30,19
1650589344730,MATH 10B,B02,083740,Staff,28,0,30,2
1650589350766,MATH 18,A01,083743,Staff,0,0,30,30
1650589350766,MATH 18,A02,083744,Staff,24,0,30,6
1650589350766,MATH 18,A03,083745,Staff,21,0,30,9
1650589350766,MATH 18,A04,083746,Staff,26,0,30,4
1650589350766,MATH 18,B01,083748,Staff,0,14,30,30
1650589350766,MATH 18,B02,083749,Staff,1,11,30,29
1650589350766,MATH 18,B03,083750,Staff,0,12,30,30
1650589350766,MATH 18,B04,083751,Staff,0,12,30,30
1650589356789,MATH 20A,A01,083754,Staff,21,0,40,19
1650589362821,MATH 20B,A01,083756,Staff,1,12,30,29
1650589362821,MATH 20B,A02,083757,Staff,0,12,30,30
1650589368860,MATH 20C,A01,083760,Staff,0,16,30,30
1650589368860,MATH 20C,A02,083761,Staff,2,14,30,28
1650589368860,MATH 20C,B01,083762,Staff,11,0,30,19
1650589368860,MATH 20C,B02,083763,Staff,28,0,30,2
1650589374888,MATH 20D,A01,083765,Staff,1,1,30,29
1650589374888,MATH 20D,A02,083766,Staff,8,0,30,22
1650589374888,MATH 20D,A03,083767,Staff,25,0,30,5
1650589380911,MATH 20E,A01,083771,Staff,6,0,30,24
1650589380911,MATH 20E,A02,083772,Staff,18,0,30,12
1650589380911,MATH 20E,B01,083773,Staff,0,0,30,30
1650589380911,MATH 20E,B02,083774,Staff,9,0,30,21
1650589386938,MATH 103A,A01,083777,Staff,0,15,30,30
1650589386938,MATH 103A,A02,083778,Staff,0,14,30,30
1650589386938,MATH 103A,B01,083779,Staff,0,13,30,30
1650589386938,MATH 103A,B02,083780,Staff,0,14,30,30
1650589392961,MATH 105,A01,085443,Staff,0,21,30,30
1650589398984,MATH 109,A01,083213,Anzaldo; Leesa B,0,7,30,30
1650589398984,MATH 109,A02,083214,Anzaldo; Leesa B,0,7,30,30
1650589398984,MATH 109,B01,083215,Anzaldo; Leesa B,0,5,30,30
1650589398984,MATH 109,B02,083216,Anzaldo; Leesa B,1,6,30,29
1650589405010,MATH 142A,A01,083219,Chow; Bennett,0,16,30,30
1650589405010,MATH 142A,A02,083220,Chow; Bennett,0,15,30,30
1650589405010,MATH 142A,B01,083221,Chow; Bennett,0,14,30,30
1650589405010,MATH 142A,B02,083222,Chow; Bennett,0,13,30,30
1650589411034,MATH 193A,A01,083224,Staff,1,6,30,29
1650589411034,MATH 193A,A02,083225,Staff,0,6,30,30
1650589411034,MATH 193A,A03,083781,Staff,0,6,30,30
1650589411034,MATH 193A,A04,083782,Staff,0,7,30,30
1650589417058,MATH 197,001,091859,McAuley; Julian John,9998,0,9999,1
1650589423107,COGS 9,A01,083615,Staff,1,17,60,59
1650589429132,COGS 11,A01,083617,Boyle; Mary E. T.,18,0,40,22
1650589435155,COGS 13,A01,083071,Staff,0,37,40,40
1650589441178,COGS 14A,A01,092681,Staff,0,29,100,100
1650589447202,COGS 14B,A01,083073,Cheng; Tzu-Han,0,13,50,50
1650589453237,COGS 17,A01,092677,Staff,17,0,75,58
1650589459265,COGS 100,A01,083619,Staff,1,26,60,59
1650589465292,COGS 101A,A01,083621,Davis; Joshua Daniel,0,26,60,60
1650589471320,COGS 101B,A01,091572,Staff,1,5,60,59
1650589477347,COGS 101C,A01,083625,Delgado; Tania,15,0,30,15
1650589483376,COGS 107A,A01,083627,Boyle; Mary E. T.,0,13,60,60
1650589489408,COGS 118A,A01,083075,Staff,0,4,60,60
1650589495432,CSE 3,A50,083646,Miranda; Gregory Joseph,19,0,38,19
1650589495432,CSE 3,A51,083647,Miranda; Gregory Joseph,36,0,37,1
1650589501460,CSE 8A,A50,083650,Miranda; Gregory Joseph,0,30,40,40
1650589507493,CSE 11,A01,083080,Cao; Yingjun,0,95,40,40
1650589513521,CSE 12,A01,083652,Staff,0,20,100,100
1650589519545,CSE 15L,A01,083654,Staff,0,1,50,50
1650589519545,CSE 15L,A02,083655,Staff,0,1,50,50
1650589525566,CSE 20,A01,083657,Staff,51,0,80,29
1650589531601,CSE 30,A01,083084,Eldon; John,0,78,40,40
1650589537728,CSE 100,A01,083659,Cao; Yingjun,0,66,50,50
1650589543755,CSE 134B,A01,083661,Powell; Thomas Allan,0,35,65,65
1650589549785,CSE 140,A01,083663,Staff,1,8,75,74
1650589555809,CSE 140L,A01,083088,Eldon; John,1,14,75,74
1650589561837,CSE 175,A01,083665,Kumar; Rakesh,7,0,25,18
1650589567861,CSE 190,A00,092507,Dubnov; Shlomo,11,0,20,9
1650589573889,ECE 45,A01,083139,Staff,1,2,60,59
1650589579916,ECE 65,A50,083695,Staff,1,6,30,29
1650589585942,ECE 109,A01,091882,Touri; Behrouz,33,0,70,37
1650589591969,ECE 180,A00,083140,Abi Samra; Nicholas Camill,21,0,30,9
1650589591969,ECE 180,B00,083141,Abi Samra; Nicholas Camill,0,0,30,30
1650589598003,MATH 10A,A01,083735,Patchell; Gregory David,4,0,30,26
1650589598003,MATH 10A,A02,083736,Patchell; Gregory David,27,0,30,3
1650589598003,MATH 10A,A03,083737,Patchell; Gregory David,24,0,30,6
1650589604028,MATH 10B,A01,083207,Staff,0,9,30,30
1650589604028,MATH 10B,A02,083208,Staff,0,8,30,30
1650589604028,MATH 10B,B01,083739,Staff,11,0,30,19
1650589604028,MATH 10B,B02,083740,Staff,28,0,30,2
1650589610059,MATH 18,A01,083743,Staff,0,0,30,30
1650589610059,MATH 18,A02,083744,Staff,24,0,30,6
1650589610059,MATH 18,A03,083745,Staff,21,0,30,9
1650589610059,MATH 18,A04,083746,Staff,26,0,30,4
1650589610059,MATH 18,B01,083748,Staff,0,14,30,30
1650589610059,MATH 18,B02,083749,Staff,1,11,30,29
1650589610059,MATH 18,B03,083750,Staff,0,12,30,30
1650589610059,MATH 18,B04,083751,Staff,0,12,30,30
1650589616085,MATH 20A,A01,083754,Staff,21,0,40,19
1650589622114,MATH 20B,A01,083756,Staff,1,12,30,29
1650589622114,MATH 20B,A02,083757,Staff,0,12,30,30
1650589628158,MATH 20C,A01,083760,Staff,0,16,30,30
1650589628158,MATH 20C,A02,083761,Staff,2,14,30,28
1650589628158,MATH 20C,B01,083762,Staff,11,0,30,19
1650589628158,MATH 20C,B02,083763,Staff,28,0,30,2
1650589634187,MATH 20D,A01,083765,Staff,1,1,30,29
1650589634187,MATH 20D,A02,083766,Staff,8,0,30,22
1650589634187,MATH 20D,A03,083767,Staff,25,0,30,5
1650589640213,MATH 20E,A01,083771,Staff,6,0,30,24
1650589640213,MATH 20E,A02,083772,Staff,18,0,30,12
1650589640213,MATH 20E,B01,083773,Staff,0,0,30,30
1650589640213,MATH 20E,B02,083774,Staff,9,0,30,21
1650589646238,MATH 103A,A01,083777,Staff,0,15,30,30
1650589646238,MATH 103A,A02,083778,Staff,0,14,30,30
1650589646238,MATH 103A,B01,083779,Staff,0,13,30,30
1650589646238,MATH 103A,B02,083780,Staff,0,14,30,30
1650589652265,MATH 105,A01,085443,Staff,0,21,30,30
1650589658289,MATH 109,A01,083213,Anzaldo; Leesa B,0,7,30,30
1650589658289,MATH 109,A02,083214,Anzaldo; Leesa B,0,7,30,30
1650589658289,MATH 109,B01,083215,Anzaldo; Leesa B,0,5,30,30
1650589658289,MATH 109,B02,083216,Anzaldo; Leesa B,1,6,30,29
1650589664313,MATH 142A,A01,083219,Chow; Bennett,0,16,30,30
1650589664313,MATH 142A,A02,083220,Chow; Bennett,0,15,30,30
1650589664313,MATH 142A,B01,083221,Chow; Bennett,0,14,30,30
1650589664313,MATH 142A,B02,083222,Chow; Bennett,0,13,30,30
1650589670337,MATH 193A,A01,083224,Staff,1,6,30,29
1650589670337,MATH 193A,A02,083225,Staff,0,6,30,30
1650589670337,MATH 193A,A03,083781,Staff,0,6,30,30
1650589670337,MATH 193A,A04,083782,Staff,0,7,30,30
1650589676367,MATH 197,001,091859,McAuley; Julian John,9998,0,9999,1
1650589682434,COGS 9,A01,083615,Staff,1,17,60,59
1650589688458,COGS 11,A01,083617,Boyle; Mary E. T.,18,0,40,22
1650589694481,COGS 13,A01,083071,Staff,0,37,40,40
1650589700505,COGS 14A,A01,092681,Staff,0,29,100,100
1650589706529,COGS 14B,A01,083073,Cheng; Tzu-Han,0,13,50,50
1650589712556,COGS 17,A01,092677,Staff,17,0,75,58
1650589718584,COGS 100,A01,083619,Staff,1,26,60,59
1650589724611,COGS 101A,A01,083621,Davis; Joshua Daniel,0,26,60,60
1650589730641,COGS 101B,A01,091572,Staff,1,5,60,59
1650589736668,COGS 101C,A01,083625,Delgado; Tania,15,0,30,15
1650589742690,COGS 107A,A01,083627,Boyle; Mary E. T.,0,13,60,60
1650589748717,COGS 118A,A01,083075,Staff,0,4,60,60
1650589754742,CSE 3,A50,083646,Miranda; Gregory Joseph,19,0,38,19
1650589754742,CSE 3,A51,083647,Miranda; Gregory Joseph,36,0,37,1
1650589760774,CSE 8A,A50,083650,Miranda; Gregory Joseph,0,30,40,40
1650589766799,CSE 11,A01,083080,Cao; Yingjun,0,95,40,40
1650589772825,CSE 12,A01,083652,Staff,0,20,100,100
1650589778852,CSE 15L,A01,083654,Staff,0,1,50,50
1650589778852,CSE 15L,A02,083655,Staff,0,1,50,50
1650589784878,CSE 20,A01,083657,Staff,51,0,80,29
1650589790905,CSE 30,A01,083084,Eldon; John,0,78,40,40
1650589796929,CSE 100,A01,083659,Cao; Yingjun,0,66,50,50
1650589802961,CSE 134B,A01,083661,Powell; Thomas Allan,0,35,65,65
1650589808989,CSE 140,A01,083663,Staff,1,8,75,74
1650589815015,CSE 140L,A01,083088,Eldon; John,1,14,75,74
1650589821041,CSE 175,A01,083665,Kumar; Rakesh,7,0,25,18
1650589827064,CSE 190,A00,092507,Dubnov; Shlomo,11,0,20,9
1650589833088,ECE 45,A01,083139,Staff,1,2,60,59
1650589839115,ECE 65,A50,083695,Staff,1,6,30,29
1650589845141,ECE 109,A01,091882,Touri; Behrouz,33,0,70,37
1650589851175,ECE 180,A00,083140,Abi Samra; Nicholas Camill,21,0,30,9
1650589851175,ECE 180,B00,083141,Abi Samra; Nicholas Camill,0,0,30,30
1650589857199,MATH 10A,A01,083735,Patchell; Gregory David,4,0,30,26
1650589857199,MATH 10A,A02,083736,Patchell; Gregory David,27,0,30,3
1650589857199,MATH 10A,A03,083737,Patchell; Gregory David,24,0,30,6
1650589863234,MATH 10B,A01,083207,Staff,0,9,30,30
1650589863234,MATH 10B,A02,083208,Staff,0,8,30,30
1650589863234,MATH 10B,B01,083739,Staff,11,0,30,19
1650589863234,MATH 10B,B02,083740,Staff,28,0,30,2
1650589869271,MATH 18,A01,083743,Staff,0,0,30,30
1650589869271,MATH 18,A02,083744,Staff,24,0,30,6
1650589869271,MATH 18,A03,083745,Staff,21,0,30,9
1650589869271,MATH 18,A04,083746,Staff,26,0,30,4
1650589869271,MATH 18,B01,083748,Staff,0,14,30,30
1650589869271,MATH 18,B02,083749,Staff,1,11,30,29
1650589869271,MATH 18,B03,083750,Staff,0,12,30,30
1650589869271,MATH 18,B04,083751,Staff,0,12,30,30
1650589875297,MATH 20A,A01,083754,Staff,21,0,40,19
1650589881324,MATH 20B,A01,083756,Staff,1,12,30,29
1650589881324,MATH 20B,A02,083757,Staff,0,12,30,30
1650589887352,MATH 20C,A01,083760,Staff,0,16,30,30
1650589887352,MATH 20C,A02,083761,Staff,2,14,30,28
1650589887352,MATH 20C,B01,083762,Staff,11,0,30,19
1650589887352,MATH 20C,B02,083763,Staff,28,0,30,2
1650589893380,MATH 20D,A01,083765,Staff,1,1,30,29
1650589893380,MATH 20D,A02,083766,Staff,8,0,30,22
1650589893380,MATH 20D,A03,083767,Staff,25,0,30,5
1650589899405,MATH 20E,A01,083771,Staff,6,0,30,24
1650589899405,MATH 20E,A02,083772,Staff,18,0,30,12
1650589899405,MATH 20E,B01,083773,Staff,0,0,30,30
1650589899405,MATH 20E,B02,083774,Staff,9,0,30,21
1650589905429,MATH 103A,A01,083777,Staff,0,15,30,30
1650589905429,MATH 103A,A02,083778,Staff,0,14,30,30
1650589905429,MATH 103A,B01,083779,Staff,0,13,30,30
1650589905429,MATH 103A,B02,083780,Staff,0,14,30,30
1650589911453,MATH 105,A01,085443,Staff,0,21,30,30
1650589917481,MATH 109,A01,083213,Anzaldo; Leesa B,0,7,30,30
1650589917481,MATH 109,A02,083214,Anzaldo; Leesa B,0,7,30,30
1650589917481,MATH 109,B01,083215,Anzaldo; Leesa B,0,5,30,30
1650589917481,MATH 109,B02,083216,Anzaldo; Leesa B,1,6,30,29
1650589923505,MATH 142A,A01,083219,Chow; Bennett,0,16,30,30
1650589923505,MATH 142A,A02,083220,Chow; Bennett,0,15,30,30
1650589923505,MATH 142A,B01,083221,Chow; Bennett,0,14,30,30
1650589923505,MATH 142A,B02,083222,Chow; Bennett,0,13,30,30
1650589929527,MATH 193A,A01,083224,Staff,1,6,30,29
1650589929527,MATH 193A,A02,083225,Staff,0,6,30,30
1650589929527,MATH 193A,A03,083781,Staff,0,6,30,30
1650589929527,MATH 193A,A04,083782,Staff,0,7,30,30
1650589935555,MATH 197,001,091859,McAuley; Julian John,9998,0,9999,1
1650589941615,COGS 9,A01,083615,Staff,1,17,60,59
1650589947647,COGS 11,A01,083617,Boyle; Mary E. T.,18,0,40,22
1650589953680,COGS 13,A01,083071,Staff,0,37,40,40
1650589959737,COGS 14A,A01,092681,Staff,0,29,100,100
1650589965760,COGS 14B,A01,083073,Cheng; Tzu-Han,0,13,50,50
1650589971783,COGS 17,A01,092677,Staff,17,0,75,58
1650589977810,COGS 100,A01,083619,Staff,1,26,60,59
1650589983833,COGS 101A,A01,083621,Davis; Joshua Daniel,0,26,60,60
1650589989861,COGS 101B,A01,091572,Staff,1,5,60,59
1650589995888,COGS 101C,A01,083625,Delgado; Tania,15,0,30,15
1650590001915,COGS 107A,A01,083627,Boyle; Mary E. T.,0,13,60,60
1650590007944,COGS 118A,A01,083075,Staff,0,4,60,60
1650590013976,CSE 3,A50,083646,Miranda; Gregory Joseph,19,0,38,19
1650590013976,CSE 3,A51,083647,Miranda; Gregory Joseph,36,0,37,1
1650590020023,CSE 8A,A50,083650,Miranda; Gregory Joseph,0,30,40,40
1650590026047,CSE 11,A01,083080,Cao; Yingjun,0,95,40,40
1650590032077,CSE 12,A01,083652,Staff,0,20,100,100
1650590038105,CSE 15L,A01,083654,Staff,0,1,50,50
1650590038105,CSE 15L,A02,083655,Staff,0,1,50,50
1650590044134,CSE 20,A01,083657,Staff,51,0,80,29
1650590050157,CSE 30,A01,083084,Eldon; John,0,78,40,40
1650590056180,CSE 100,A01,083659,Cao; Yingjun,0,66,50,50
1650590062207,CSE 134B,A01,083661,Powell; Thomas Allan,0,35,65,65
1650590068242,CSE 140,A01,083663,Staff,1,8,75,74
1650590074268,CSE 140L,A01,083088,Eldon; John,1,14,75,74
1650590080292,CSE 175,A01,083665,Kumar; Rakesh,7,0,25,18
1650590086319,CSE 190,A00,092507,Dubnov; Shlomo,11,0,20,9
1650590092345,ECE 45,A01,083139,Staff,1,2,60,59
1650590098369,ECE 65,A50,083695,Staff,1,6,30,29
1650590104392,ECE 109,A01,091882,Touri; Behrouz,33,0,70,37
1650590110425,ECE 180,A00,083140,Abi Samra; Nicholas Camill,21,0,30,9
1650590110425,ECE 180,B00,083141,Abi Samra; Nicholas Camill,0,0,30,30
1650590116448,MATH 10A,A01,083735,Patchell; Gregory David,4,0,30,26
1650590116448,MATH 10A,A02,083736,Patchell; Gregory David,27,0,30,3
1650590116448,MATH 10A,A03,083737,Patchell; Gregory David,24,0,30,6
1650590122475,MATH 10B,A01,083207,Staff,0,9,30,30
1650590122475,MATH 10B,A02,083208,Staff,0,8,30,30
1650590122475,MATH 10B,B01,083739,Staff,11,0,30,19
1650590122475,MATH 10B,B02,083740,Staff,28,0,30,2
1650590128504,MATH 18,A01,083743,Staff,0,0,30,30
1650590128504,MATH 18,A02,083744,Staff,24,0,30,6
1650590128504,MATH 18,A03,083745,Staff,21,0,30,9
1650590128504,MATH 18,A04,083746,Staff,26,0,30,4
1650590128504,MATH 18,B01,083748,Staff,0,14,30,30
1650590128504,MATH 18,B02,083749,Staff,1,11,30,29
1650590128504,MATH 18,B03,083750,Staff,0,12,30,30
1650590128504,MATH 18,B04,083751,Staff,0,12,30,30
1650590134628,MATH 20A,A01,083754,Staff,21,0,40,19
1650590140661,MATH 20B,A01,083756,Staff,1,12,30,29
1650590140661,MATH 20B,A02,083757,Staff,0,12,30,30
1650590146688,MATH 20C,A01,083760,Staff,0,16,30,30
1650590146688,MATH 20C,A02,083761,Staff,2,14,30,28
1650590146688,MATH 20C,B01,083762,Staff,11,0,30,19
1650590146688,MATH 20C,B02,083763,Staff,28,0,30,2
1650590152712,MATH 20D,A01,083765,Staff,1,1,30,29
1650590152712,MATH 20D,A02,083766,Staff,8,0,30,22
1650590152712,MATH 20D,A03,083767,Staff,25,0,30,5
1650590158735,MATH 20E,A01,083771,Staff,6,0,30,24
1650590158735,MATH 20E,A02,083772,Staff,18,0,30,12
1650590158735,MATH 20E,B01,083773,Staff,0,0,30,30
1650590158735,MATH 20E,B02,083774,Staff,9,0,30,21
1650590164760,MATH 103A,A01,083777,Staff,0,15,30,30
1650590164760,MATH 103A,A02,083778,Staff,0,14,30,30
1650590164760,MATH 103A,B01,083779,Staff,0,13,30,30
1650590164760,MATH 103A,B02,083780,Staff,0,14,30,30
1650590170785,MATH 105,A01,085443,Staff,0,21,30,30
1650590176815,MATH 109,A01,083213,Anzaldo; Leesa B,0,7,30,30
1650590176815,MATH 109,A02,083214,Anzaldo; Leesa B,0,7,30,30
1650590176815,MATH 109,B01,083215,Anzaldo; Leesa B,0,5,30,30
1650590176815,MATH 109,B02,083216,Anzaldo; Leesa B,1,6,30,29
1650590182843,MATH 142A,A01,083219,Chow; Bennett,0,16,30,30
1650590182843,MATH 142A,A02,083220,Chow; Bennett,0,15,30,30
1650590182843,MATH 142A,B01,083221,Chow; Bennett,0,14,30,30
1650590182843,MATH 142A,B02,083222,Chow; Bennett,0,13,30,30
1650590188867,MATH 193A,A01,083224,Staff,1,6,30,29
1650590188867,MATH 193A,A02,083225,Staff,0,6,30,30
1650590188867,MATH 193A,A03,083781,Staff,0,6,30,30
1650590188867,MATH 193A,A04,083782,Staff,0,7,30,30
1650590194892,MATH 197,001,091859,McAuley; Julian John,9998,0,9999,1
1650590200944,COGS 9,A01,083615,Staff,1,17,60,59
1650590206970,COGS 11,A01,083617,Boyle; Mary E. T.,18,0,40,22
1650590213008,COGS 13,A01,083071,Staff,0,37,40,40
1650590219053,COGS 14A,A01,092681,Staff,0,29,100,100
1650590225078,COGS 14B,A01,083073,Cheng; Tzu-Han,0,13,50,50
1650590231102,COGS 17,A01,092677,Staff,17,0,75,58
1650590237130,COGS 100,A01,083619,Staff,1,26,60,59
1650590243155,COGS 101A,A01,083621,Davis; Joshua Daniel,0,26,60,60
1650590249180,COGS 101B,A01,091572,Staff,1,5,60,59
1650590255211,COGS 101C,A01,083625,Delgado; Tania,15,0,30,15
1650590261249,COGS 107A,A01,083627,Boyle; Mary E. T.,0,13,60,60
1650590267291,COGS 118A,A01,083075,Staff,0,4,60,60
1650590273314,CSE 3,A50,083646,Miranda; Gregory Joseph,19,0,38,19
1650590273314,CSE 3,A51,083647,Miranda; Gregory Joseph,36,0,37,1
1650590279349,CSE 8A,A50,083650,Miranda; Gregory Joseph,0,30,40,40
1650590285379,CSE 11,A01,083080,Cao; Yingjun,0,95,40,40
1650590291404,CSE 12,A01,083652,Staff,0,20,100,100
1650590297434,CSE 15L,A01,083654,Staff,0,1,50,50
1650590297434,CSE 15L,A02,083655,Staff,0,1,50,50
1650590303458,CSE 20,A01,083657,Staff,51,0,80,29
1650590309483,CSE 30,A01,083084,Eldon; John,0,78,40,40
1650590315507,CSE 100,A01,083659,Cao; Yingjun,0,66,50,50
1650590321532,CSE 134B,A01,083661,Powell; Thomas Allan,0,35,65,65
1650590327554,CSE 140,A01,083663,Staff,1,8,75,74
1650590333576,CSE 140L,A01,083088,Eldon; John,1,14,75,74
1650590339600,CSE 175,A01,083665,Kumar; Rakesh,7,0,25,18
1650590345637,CSE 190,A00,092507,Dubnov; Shlomo,11,0,20,9
1650590351673,ECE 45,A01,083139,Staff,1,2,60,59
1650590357702,ECE 65,A50,083695,Staff,1,6,30,29
1650590363729,ECE 109,A01,091882,Touri; Behrouz,33,0,70,37
1650590369753,ECE 180,A00,083140,Abi Samra; Nicholas Camill,21,0,30,9
1650590369753,ECE 180,B00,083141,Abi Samra; Nicholas Camill,0,0,30,30
1650590375775,MATH 10A,A01,083735,Patchell; Gregory David,4,0,30,26
1650590375775,MATH 10A,A02,083736,Patchell; Gregory David,27,0,30,3
1650590375775,MATH 10A,A03,083737,Patchell; Gregory David,24,0,30,6
1650590381801,MATH 10B,A01,083207,Staff,0,9,30,30
1650590381801,MATH 10B,A02,083208,Staff,0,8,30,30
1650590381801,MATH 10B,B01,083739,Staff,11,0,30,19
1650590381801,MATH 10B,B02,083740,Staff,28,0,30,2
1650590387836,MATH 18,A01,083743,Staff,0,0,30,30
1650590387836,MATH 18,A02,083744,Staff,24,0,30,6
1650590387836,MATH 18,A03,083745,Staff,21,0,30,9
1650590387836,MATH 18,A04,083746,Staff,26,0,30,4
1650590387836,MATH 18,B01,083748,Staff,0,14,30,30
1650590387836,MATH 18,B02,083749,Staff,1,11,30,29
1650590387836,MATH 18,B03,083750,Staff,0,12,30,30
1650590387836,MATH 18,B04,083751,Staff,0,12,30,30
1650590393862,MATH 20A,A01,083754,Staff,21,0,40,19
1650590399888,MATH 20B,A01,083756,Staff,1,12,30,29
1650590399888,MATH 20B,A02,083757,Staff,0,12,30,30
1650590405916,MATH 20C,A01,083760,Staff,0,16,30,30
1650590405916,MATH 20C,A02,083761,Staff,2,14,30,28
1650590405916,MATH 20C,B01,083762,Staff,11,0,30,19
1650590405916,MATH 20C,B02,083763,Staff,28,0,30,2
1650590411953,MATH 20D,A01,083765,Staff,1,1,30,29
1650590411953,MATH 20D,A02,083766,Staff,8,0,30,22
1650590411953,MATH 20D,A03,083767,Staff,25,0,30,5
1650590417981,MATH 20E,A01,083771,Staff,6,0,30,24
1650590417981,MATH 20E,A02,083772,Staff,18,0,30,12
1650590417981,MATH 20E,B01,083773,Staff,0,0,30,30
1650590417981,MATH 20E,B02,083774,Staff,9,0,30,21
1650590424009,MATH 103A,A01,083777,Staff,0,15,30,30
1650590424009,MATH 103A,A02,083778,Staff,0,14,30,30
1650590424009,MATH 103A,B01,083779,Staff,0,13,30,30
1650590424009,MATH 103A,B02,083780,Staff,0,14,30,30
1650590430037,MATH 105,A01,085443,Staff,0,21,30,30
1650590436061,MATH 109,A01,083213,Anzaldo; Leesa B,0,7,30,30
1650590436061,MATH 109,A02,083214,Anzaldo; Leesa B,0,7,30,30
1650590436061,MATH 109,B01,083215,Anzaldo; Leesa B,0,5,30,30
1650590436061,MATH 109,B02,083216,Anzaldo; Leesa B,1,6,30,29
1650590442089,MATH 142A,A01,083219,Chow; Bennett,0,16,30,30
1650590442089,MATH 142A,A02,083220,Chow; Bennett,0,15,30,30
1650590442089,MATH 142A,B01,083221,Chow; Bennett,0,14,30,30
1650590442089,MATH 142A,B02,083222,Chow; Bennett,0,13,30,30
1650590448114,MATH 193A,A01,083224,Staff,1,6,30,29
1650590448114,MATH 193A,A02,083225,Staff,0,6,30,30
1650590448114,MATH 193A,A03,083781,Staff,0,6,30,30
1650590448114,MATH 193A,A04,083782,Staff,0,7,30,30
1650590454140,MATH 197,001,091859,McAuley; Julian John,9998,0,9999,1
1650590460199,COGS 9,A01,083615,Staff,1,17,60,59
1650590466233,COGS 11,A01,083617,Boyle; Mary E. T.,18,0,40,22
1650590472266,COGS 13,A01,083071,Staff,0,37,40,40
1650590478290,COGS 14A,A01,092681,Staff,0,29,100,100
1650590484322,COGS 14B,A01,083073,Cheng; Tzu-Han,0,13,50,50
1650590490346,COGS 17,A01,092677,Staff,17,0,75,58
1650590496378,COGS 100,A01,083619,Staff,1,26,60,59
1650590502406,COGS 101A,A01,083621,Davis; Joshua Daniel,0,26,60,60
1650590508428,COGS 101B,A01,091572,Staff,1,5,60,59
1650590514453,COGS 101C,A01,083625,Delgado; Tania,15,0,30,15
1650590520477,COGS 107A,A01,083627,Boyle; Mary E. T.,0,13,60,60
1650590526501,COGS 118A,A01,083075,Staff,0,4,60,60
1650590532525,CSE 3,A50,083646,Miranda; Gregory Joseph,19,0,38,19
1650590532525,CSE 3,A51,083647,Miranda; Gregory Joseph,36,0,37,1
1650590538550,CSE 8A,A50,083650,Miranda; Gregory Joseph,0,30,40,40
1650590544572,CSE 11,A01,083080,Cao; Yingjun,0,95,40,40
1650590550594,CSE 12,A01,083652,Staff,0,20,100,100
1650590556618,CSE 15L,A01,083654,Staff,0,1,50,50
1650590556618,CSE 15L,A02,083655,Staff,0,1,50,50
1650590562653,CSE 20,A01,083657,Staff,51,0,80,29
1650590568686,CSE 30,A01,083084,Eldon; John,0,78,40,40
1650590574711,CSE 100,A01,083659,Cao; Yingjun,0,66,50,50
1650590580736,CSE 134B,A01,083661,Powell; Thomas Allan,0,35,65,65
1650590586769,CSE 140,A01,083663,Staff,1,8,75,74
1650590592814,CSE 140L,A01,083088,Eldon; John,1,14,75,74
1650590598838,CSE 175,A01,083665,Kumar; Rakesh,7,0,25,18
1650590604862,CSE 190,A00,092507,Dubnov; Shlomo,11,0,20,9
1650590610899,ECE 45,A01,083139,Staff,1,2,60,59
1650590616929,ECE 65,A50,083695,Staff,1,6,30,29
1650590622964,ECE 109,A01,091882,Touri; Behrouz,33,0,70,37
1650590628990,ECE 180,A00,083140,Abi Samra; Nicholas Camill,21,0,30,9
1650590628990,ECE 180,B00,083141,Abi Samra; Nicholas Camill,0,0,30,30
1650590646177,MATH 10A,A01,083735,Patchell; Gregory David,4,0,30,26
1650590646177,MATH 10A,A02,083736,Patchell; Gregory David,27,0,30,3
1650590646177,MATH 10A,A03,083737,Patchell; Gregory David,24,0,30,6
1650590652206,MATH 10B,A01,083207,Staff,0,9,30,30
1650590652206,MATH 10B,A02,083208,Staff,0,8,30,30
1650590652206,MATH 10B,B01,083739,Staff,11,0,30,19
1650590652206,MATH 10B,B02,083740,Staff,28,0,30,2
1650590658234,MATH 18,A01,083743,Staff,0,0,30,30
1650590658234,MATH 18,A02,083744,Staff,24,0,30,6
1650590658234,MATH 18,A03,083745,Staff,21,0,30,9
1650590658234,MATH 18,A04,083746,Staff,26,0,30,4
1650590658234,MATH 18,B01,083748,Staff,0,14,30,30
1650590658234,MATH 18,B02,083749,Staff,1,11,30,29
1650590658234,MATH 18,B03,083750,Staff,0,12,30,30
1650590658234,MATH 18,B04,083751,Staff,0,12,30,30
1650590664258,MATH 20A,A01,083754,Staff,21,0,40,19
1650590670281,MATH 20B,A01,083756,Staff,1,12,30,29
1650590670281,MATH 20B,A02,083757,Staff,0,12,30,30
1650590676304,MATH 20C,A01,083760,Staff,0,16,30,30
1650590676304,MATH 20C,A02,083761,Staff,2,14,30,28
1650590676304,MATH 20C,B01,083762,Staff,11,0,30,19
1650590676304,MATH 20C,B02,083763,Staff,28,0,30,2
1650590682328,MATH 20D,A01,083765,Staff,1,1,30,29
1650590682328,MATH 20D,A02,083766,Staff,8,0,30,22
1650590682328,MATH 20D,A03,083767,Staff,25,0,30,5
1650590688352,MATH 20E,A01,083771,Staff,6,0,30,24
1650590688352,MATH 20E,A02,083772,Staff,18,0,30,12
1650590688352,MATH 20E,B01,083773,Staff,0,0,30,30
1650590688352,MATH 20E,B02,083774,Staff,9,0,30,21
1650590694379,MATH 103A,A01,083777,Staff,0,15,30,30
1650590694379,MATH 103A,A02,083778,Staff,0,14,30,30
1650590694379,MATH 103A,B01,083779,Staff,0,13,30,30
1650590694379,MATH 103A,B02,083780,Staff,0,14,30,30
1650590700403,MATH 105,A01,085443,Staff,0,21,30,30
1650590706430,MATH 109,A01,083213,Anzaldo; Leesa B,0,7,30,30
1650590706430,MATH 109,A02,083214,Anzaldo; Leesa B,0,7,30,30
1650590706430,MATH 109,B01,083215,Anzaldo; Leesa B,0,5,30,30
1650590706430,MATH 109,B02,083216,Anzaldo; Leesa B,1,6,30,29
1650590712457,MATH 142A,A01,083219,Chow; Bennett,0,16,30,30
1650590712457,MATH 142A,A02,083220,Chow; Bennett,0,15,30,30
1650590712457,MATH 142A,B01,083221,Chow; Bennett,0,14,30,30
1650590712457,MATH 142A,B02,083222,Chow; Bennett,0,13,30,30
1650590718479,MATH 193A,A01,083224,Staff,1,6,30,29
1650590718479,MATH 193A,A02,083225,Staff,0,6,30,30
1650590718479,MATH 193A,A03,083781,Staff,0,6,30,30
1650590718479,MATH 193A,A04,083782,Staff,0,7,30,30
1650590724506,MATH 197,001,091859,McAuley; Julian John,9998,0,9999,1
1650590730564,COGS 9,A01,083615,Staff,1,17,60,59
1650590736679,COGS 11,A01,083617,Boyle; Mary E. T.,18,0,40,22
1650590742705,COGS 13,A01,083071,Staff,0,37,40,40
1650590748729,COGS 14A,A01,092681,Staff,0,29,100,100
1650590754755,COGS 14B,A01,083073,Cheng; Tzu-Han,0,13,50,50
1650590760779,COGS 17,A01,092677,Staff,17,0,75,58
1650590766804,COGS 100,A01,083619,Staff,1,26,60,59
1650590772837,COGS 101A,A01,083621,Davis; Joshua Daniel,0,26,60,60
1650590778859,COGS 101B,A01,091572,Staff,1,5,60,59
1650590784883,COGS 101C,A01,083625,Delgado; Tania,15,0,30,15
1650590790911,COGS 107A,A01,083627,Boyle; Mary E. T.,0,13,60,60
1650590796938,COGS 118A,A01,083075,Staff,0,4,60,60
1650590802962,CSE 3,A50,083646,Miranda; Gregory Joseph,19,0,38,19
1650590802962,CSE 3,A51,083647,Miranda; Gregory Joseph,36,0,37,1
1650590808989,CSE 8A,A50,083650,Miranda; Gregory Joseph,0,30,40,40
1650590815015,CSE 11,A01,083080,Cao; Yingjun,0,95,40,40
1650590821040,CSE 12,A01,083652,Staff,0,21,100,100
1650590827064,CSE 15L,A01,083654,Staff,0,2,50,50
1650590827064,CSE 15L,A02,083655,Staff,0,1,50,50
1650590833088,CSE 20,A01,083657,Staff,51,0,80,29
1650590839112,CSE 30,A01,083084,Eldon; John,0,78,40,40
1650590845135,CSE 100,A01,083659,Cao; Yingjun,0,66,50,50
1650590851160,CSE 134B,A01,083661,Powell; Thomas Allan,0,35,65,65
1650590857185,CSE 140,A01,083663,Staff,1,8,75,74
1650590863211,CSE 140L,A01,083088,Eldon; John,1,14,75,74
1650590869234,CSE 175,A01,083665,Kumar; Rakesh,7,0,25,18
1650590875264,CSE 190,A00,092507,Dubnov; Shlomo,11,0,20,9
1650590881288,ECE 45,A01,083139,Staff,1,2,60,59
1650590887315,ECE 65,A50,083695,Staff,1,6,30,29
1650590893339,ECE 109,A01,091882,Touri; Behrouz,33,0,70,37
1650590899366,ECE 180,A00,083140,Abi Samra; Nicholas Camill,21,0,30,9
1650590899366,ECE 180,B00,083141,Abi Samra; Nicholas Camill,0,0,30,30
1650590905393,MATH 10A,A01,083735,Patchell; Gregory David,4,0,30,26
1650590905393,MATH 10A,A02,083736,Patchell; Gregory David,27,0,30,3
1650590905393,MATH 10A,A03,083737,Patchell; Gregory David,24,0,30,6
1650590911420,MATH 10B,A01,083207,Staff,0,9,30,30
1650590911420,MATH 10B,A02,083208,Staff,0,8,30,30
1650590911420,MATH 10B,B01,083739,Staff,11,0,30,19
1650590911420,MATH 10B,B02,083740,Staff,28,0,30,2
1650590917450,MATH 18,A01,083743,Staff,0,0,30,30
1650590917450,MATH 18,A02,083744,Staff,24,0,30,6
1650590917450,MATH 18,A03,083745,Staff,21,0,30,9
1650590917450,MATH 18,A04,083746,Staff,26,0,30,4
1650590917450,MATH 18,B01,083748,Staff,0,14,30,30
1650590917450,MATH 18,B02,083749,Staff,1,11,30,29
1650590917450,MATH 18,B03,083750,Staff,0,12,30,30
1650590917450,MATH 18,B04,083751,Staff,0,12,30,30
1650590923477,MATH 20A,A01,083754,Staff,21,0,40,19
1650590929512,MATH 20B,A01,083756,Staff,1,12,30,29
1650590929512,MATH 20B,A02,083757,Staff,0,12,30,30
1650590935563,MATH 20C,A01,083760,Staff,0,16,30,30
1650590935563,MATH 20C,A02,083761,Staff,2,14,30,28
1650590935563,MATH 20C,B01,083762,Staff,11,0,30,19
1650590935563,MATH 20C,B02,083763,Staff,28,0,30,2
1650590941590,MATH 20D,A01,083765,Staff,1,1,30,29
1650590941590,MATH 20D,A02,083766,Staff,8,0,30,22
1650590941590,MATH 20D,A03,083767,Staff,25,0,30,5
1650590947614,MATH 20E,A01,083771,Staff,6,0,30,24
1650590947614,MATH 20E,A02,083772,Staff,18,0,30,12
1650590947614,MATH 20E,B01,083773,Staff,0,0,30,30
1650590947614,MATH 20E,B02,083774,Staff,9,0,30,21
1650590953647,MATH 103A,A01,083777,Staff,0,15,30,30
1650590953647,MATH 103A,A02,083778,Staff,0,14,30,30
1650590953647,MATH 103A,B01,083779,Staff,0,13,30,30
1650590953647,MATH 103A,B02,083780,Staff,0,14,30,30
1650590959676,MATH 105,A01,085443,Staff,0,21,30,30
1650590965700,MATH 109,A01,083213,Anzaldo; Leesa B,0,7,30,30
1650590965700,MATH 109,A02,083214,Anzaldo; Leesa B,0,7,30,30
1650590965700,MATH 109,B01,083215,Anzaldo; Leesa B,0,5,30,30
1650590965700,MATH 109,B02,083216,Anzaldo; Leesa B,1,6,30,29
1650590971722,MATH 142A,A01,083219,Chow; Bennett,0,16,30,30
1650590971722,MATH 142A,A02,083220,Chow; Bennett,0,15,30,30
1650590971722,MATH 142A,B01,083221,Chow; Bennett,0,14,30,30
1650590971722,MATH 142A,B02,083222,Chow; Bennett,0,13,30,30
1650590977749,MATH 193A,A01,083224,Staff,1,6,30,29
1650590977749,MATH 193A,A02,083225,Staff,0,6,30,30
1650590977749,MATH 193A,A03,083781,Staff,0,6,30,30
1650590977749,MATH 193A,A04,083782,Staff,0,7,30,30
1650590983800,MATH 197,001,091859,McAuley; Julian John,9998,0,9999,1
1650590989857,COGS 9,A01,083615,Staff,1,16,60,59
1650590995881,COGS 11,A01,083617,Boyle; Mary E. T.,18,0,40,22
1650591001904,COGS 13,A01,083071,Staff,0,37,40,40
1650591007928,COGS 14A,A01,092681,Staff,0,29,100,100
1650591013951,COGS 14B,A01,083073,Cheng; Tzu-Han,0,13,50,50
1650591019978,COGS 17,A01,092677,Staff,17,0,75,58
1650591026011,COGS 100,A01,083619,Staff,1,26,60,59
1650591032036,COGS 101A,A01,083621,Davis; Joshua Daniel,0,26,60,60
1650591038059,COGS 101B,A01,091572,Staff,1,5,60,59
1650591044085,COGS 101C,A01,083625,Delgado; Tania,15,0,30,15
1650591050113,COGS 107A,A01,083627,Boyle; Mary E. T.,0,13,60,60
1650591056138,COGS 118A,A01,083075,Staff,0,4,60,60
1650591062169,CSE 3,A50,083646,Miranda; Gregory Joseph,19,0,38,19
1650591062169,CSE 3,A51,083647,Miranda; Gregory Joseph,36,0,37,1
1650591068192,CSE 8A,A50,083650,Miranda; Gregory Joseph,0,30,40,40
1650591074212,CSE 11,A01,083080,Cao; Yingjun,0,95,40,40
1650591080241,CSE 12,A01,083652,Staff,0,21,100,100
1650591086265,CSE 15L,A01,083654,Staff,0,2,50,50
1650591086265,CSE 15L,A02,083655,Staff,0,1,50,50
1650591092288,CSE 20,A01,083657,Staff,51,0,80,29
1650591098314,CSE 30,A01,083084,Eldon; John,0,78,40,40
1650591104341,CSE 100,A01,083659,Cao; Yingjun,0,66,50,50
1650591110368,CSE 134B,A01,083661,Powell; Thomas Allan,0,35,65,65
1650591116399,CSE 140,A01,083663,Staff,1,8,75,74
1650591122424,CSE 140L,A01,083088,Eldon; John,1,14,75,74
1650591128445,CSE 175,A01,083665,Kumar; Rakesh,7,0,25,18
1650591134468,CSE 190,A00,092507,Dubnov; Shlomo,11,0,20,9
1650591140491,ECE 45,A01,083139,Staff,1,2,60,59
1650591146521,ECE 65,A50,083695,Staff,1,6,30,29
1650591152547,ECE 109,A01,091882,Touri; Behrouz,33,0,70,37
1650591158586,ECE 180,A00,083140,Abi Samra; Nicholas Camill,21,0,30,9
1650591158586,ECE 180,B00,083141,Abi Samra; Nicholas Camill,0,0,30,30
1650591164613,MATH 10A,A01,083735,Patchell; Gregory David,4,0,30,26
1650591164613,MATH 10A,A02,083736,Patchell; Gregory David,27,0,30,3
1650591164613,MATH 10A,A03,083737,Patchell; Gregory David,24,0,30,6
1650591170640,MATH 10B,A01,083207,Staff,0,9,30,30
1650591170640,MATH 10B,A02,083208,Staff,0,8,30,30
1650591170640,MATH 10B,B01,083739,Staff,11,0,30,19
1650591170640,MATH 10B,B02,083740,Staff,28,0,30,2
1650591176665,MATH 18,A01,083743,Staff,0,0,30,30
1650591176665,MATH 18,A02,083744,Staff,24,0,30,6
1650591176665,MATH 18,A03,083745,Staff,21,0,30,9
1650591176665,MATH 18,A04,083746,Staff,26,0,30,4
1650591176665,MATH 18,B01,083748,Staff,0,14,30,30
1650591176665,MATH 18,B02,083749,Staff,1,11,30,29
1650591176665,MATH 18,B03,083750,Staff,0,12,30,30
1650591176665,MATH 18,B04,083751,Staff,0,12,30,30
1650591182691,MATH 20A,A01,083754,Staff,21,0,40,19
1650591188718,MATH 20B,A01,083756,Staff,1,12,30,29
1650591188718,MATH 20B,A02,083757,Staff,0,12,30,30
1650591194756,MATH 20C,A01,083760,Staff,0,16,30,30
1650591194756,MATH 20C,A02,083761,Staff,2,14,30,28
1650591194756,MATH 20C,B01,083762,Staff,11,0,30,19
1650591194756,MATH 20C,B02,083763,Staff,28,0,30,2
1650591200789,MATH 20D,A01,083765,Staff,1,1,30,29
1650591200789,MATH 20D,A02,083766,Staff,8,0,30,22
1650591200789,MATH 20D,A03,083767,Staff,25,0,30,5
1650591206813,MATH 20E,A01,083771,Staff,6,0,30,24
1650591206813,MATH 20E,A02,083772,Staff,18,0,30,12
1650591206813,MATH 20E,B01,083773,Staff,0,0,30,30
1650591206813,MATH 20E,B02,083774,Staff,9,0,30,21
1650591212842,MATH 103A,A01,083777,Staff,0,15,30,30
1650591212842,MATH 103A,A02,083778,Staff,0,14,30,30
1650591212842,MATH 103A,B01,083779,Staff,0,13,30,30
1650591212842,MATH 103A,B02,083780,Staff,0,14,30,30
1650591218869,MATH 105,A01,085443,Staff,0,21,30,30
1650591224893,MATH 109,A01,083213,Anzaldo; Leesa B,0,7,30,30
1650591224893,MATH 109,A02,083214,Anzaldo; Leesa B,0,7,30,30
1650591224893,MATH 109,B01,083215,Anzaldo; Leesa B,0,5,30,30
1650591224893,MATH 109,B02,083216,Anzaldo; Leesa B,1,6,30,29
1650591230918,MATH 142A,A01,083219,Chow; Bennett,0,16,30,30
1650591230918,MATH 142A,A02,083220,Chow; Bennett,0,15,30,30
1650591230918,MATH 142A,B01,083221,Chow; Bennett,0,14,30,30
1650591230918,MATH 142A,B02,083222,Chow; Bennett,0,13,30,30
1650591236942,MATH 193A,A01,083224,Staff,1,6,30,29
1650591236942,MATH 193A,A02,083225,Staff,0,6,30,30
1650591236942,MATH 193A,A03,083781,Staff,0,6,30,30
1650591236942,MATH 193A,A04,083782,Staff,0,7,30,30
1650591242966,MATH 197,001,091859,McAuley; Julian John,9998,0,9999,1
1650591249017,COGS 9,A01,083615,Staff,1,16,60,59
1650591255040,COGS 11,A01,083617,Boyle; Mary E. T.,18,0,40,22
1650591261065,COGS 13,A01,083071,Staff,0,37,40,40
1650591267100,COGS 14A,A01,092681,Staff,0,29,100,100
1650591273127,COGS 14B,A01,083073,Cheng; Tzu-Han,0,13,50,50
1650591279151,COGS 17,A01,092677,Staff,17,0,75,58
1650591285174,COGS 100,A01,083619,Staff,1,26,60,59
1650591291198,COGS 101A,A01,083621,Davis; Joshua Daniel,0,26,60,60
1650591297224,COGS 101B,A01,091572,Staff,1,5,60,59
1650591303260,COGS 101C,A01,083625,Delgado; Tania,15,0,30,15
1650591309289,COGS 107A,A01,083627,Boyle; Mary E. T.,0,14,60,60
1650591315311,COGS 118A,A01,083075,Staff,0,4,60,60
1650591321339,CSE 3,A50,083646,Miranda; Gregory Joseph,19,0,38,19
1650591321339,CSE 3,A51,083647,Miranda; Gregory Joseph,36,0,37,1
1650591327367,CSE 8A,A50,083650,Miranda; Gregory Joseph,0,30,40,40
1650591333479,CSE 11,A01,083080,Cao; Yingjun,0,95,40,40
1650591339505,CSE 12,A01,083652,Staff,0,21,100,100
1650591345527,CSE 15L,A01,083654,Staff,0,2,50,50
1650591345527,CSE 15L,A02,083655,Staff,0,1,50,50
1650591351562,CSE 20,A01,083657,Staff,51,0,80,29
1650591357584,CSE 30,A01,083084,Eldon; John,0,78,40,40
1650591363613,CSE 100,A01,083659,Cao; Yingjun,0,66,50,50
1650591369636,CSE 134B,A01,083661,Powell; Thomas Allan,0,35,65,65
1650591375658,CSE 140,A01,083663,Staff,1,8,75,74
1650591381682,CSE 140L,A01,083088,Eldon; John,1,14,75,74
1650591387705,CSE 175,A01,083665,Kumar; Rakesh,7,0,25,18
1650591393729,CSE 190,A00,092507,Dubnov; Shlomo,11,0,20,9
1650591399760,ECE 45,A01,083139,Staff,1,2,60,59
1650591405785,ECE 65,A50,083695,Staff,1,6,30,29
1650591411811,ECE 109,A01,091882,Touri; Behrouz,33,0,70,37
1650591417844,ECE 180,A00,083140,Abi Samra; Nicholas Camill,21,0,30,9
1650591417844,ECE 180,B00,083141,Abi Samra; Nicholas Camill,0,0,30,30
1650591423873,MATH 10A,A01,083735,Patchell; Gregory David,4,0,30,26
1650591423873,MATH 10A,A02,083736,Patchell; Gregory David,27,0,30,3
1650591423873,MATH 10A,A03,083737,Patchell; Gregory David,24,0,30,6
1650591429897,MATH 10B,A01,083207,Staff,0,9,30,30
1650591429897,MATH 10B,A02,083208,Staff,0,8,30,30
1650591429897,MATH 10B,B01,083739,Staff,11,0,30,19
1650591429897,MATH 10B,B02,083740,Staff,28,0,30,2
1650591435930,MATH 18,A01,083743,Staff,0,0,30,30
1650591435930,MATH 18,A02,083744,Staff,24,0,30,6
1650591435930,MATH 18,A03,083745,Staff,21,0,30,9
1650591435930,MATH 18,A04,083746,Staff,26,0,30,4
1650591435930,MATH 18,B01,083748,Staff,0,14,30,30
1650591435930,MATH 18,B02,083749,Staff,1,11,30,29
1650591435930,MATH 18,B03,083750,Staff,0,12,30,30
1650591435930,MATH 18,B04,083751,Staff,0,12,30,30
1650591441956,MATH 20A,A01,083754,Staff,21,0,40,19
1650591447982,MATH 20B,A01,083756,Staff,1,12,30,29
1650591447982,MATH 20B,A02,083757,Staff,0,12,30,30
1650591454005,MATH 20C,A01,083760,Staff,0,16,30,30
1650591454005,MATH 20C,A02,083761,Staff,2,14,30,28
1650591454005,MATH 20C,B01,083762,Staff,11,0,30,19
1650591454005,MATH 20C,B02,083763,Staff,28,0,30,2
1650591460036,MATH 20D,A01,083765,Staff,1,1,30,29
1650591460036,MATH 20D,A02,083766,Staff,8,0,30,22
1650591460036,MATH 20D,A03,083767,Staff,25,0,30,5
1650591466064,MATH 20E,A01,083771,Staff,5,0,30,25
1650591466064,MATH 20E,A02,083772,Staff,18,0,30,12
1650591466064,MATH 20E,B01,083773,Staff,0,0,30,30
1650591466064,MATH 20E,B02,083774,Staff,9,0,30,21
1650591472091,MATH 103A,A01,083777,Staff,0,15,30,30
1650591472091,MATH 103A,A02,083778,Staff,0,14,30,30
1650591472091,MATH 103A,B01,083779,Staff,0,13,30,30
1650591472091,MATH 103A,B02,083780,Staff,0,14,30,30
1650591478129,MATH 105,A01,085443,Staff,0,21,30,30
1650591484167,MATH 109,A01,083213,Anzaldo; Leesa B,0,7,30,30
1650591484167,MATH 109,A02,083214,Anzaldo; Leesa B,0,7,30,30
1650591484167,MATH 109,B01,083215,Anzaldo; Leesa B,0,5,30,30
1650591484167,MATH 109,B02,083216,Anzaldo; Leesa B,1,6,30,29
1650591490190,MATH 142A,A01,083219,Chow; Bennett,0,16,30,30
1650591490190,MATH 142A,A02,083220,Chow; Bennett,0,15,30,30
1650591490190,MATH 142A,B01,083221,Chow; Bennett,0,14,30,30
1650591490190,MATH 142A,B02,083222,Chow; Bennett,0,13,30,30
1650591496225,MATH 193A,A01,083224,Staff,1,6,30,29
1650591496225,MATH 193A,A02,083225,Staff,0,6,30,30
1650591496225,MATH 193A,A03,083781,Staff,0,6,30,30
1650591496225,MATH 193A,A04,083782,Staff,0,7,30,30
1650591502260,MATH 197,001,091859,McAuley; Julian John,9998,0,9999,1
1650591508318,COGS 9,A01,083615,Staff,1,16,60,59
1650591514342,COGS 11,A01,083617,Boyle; Mary E. T.,18,0,40,22
1650591520367,COGS 13,A01,083071,Staff,0,37,40,40
1650591526394,COGS 14A,A01,092681,Staff,0,29,100,100
1650591532416,COGS 14B,A01,083073,Cheng; Tzu-Han,0,13,50,50
1650591538442,COGS 17,A01,092677,Staff,17,0,75,58
1650591544468,COGS 100,A01,083619,Staff,1,26,60,59
1650591550491,COGS 101A,A01,083621,Davis; Joshua Daniel,0,26,60,60
1650591556515,COGS 101B,A01,091572,Staff,1,5,60,59
1650591562555,COGS 101C,A01,083625,Delgado; Tania,15,0,30,15
1650591568581,COGS 107A,A01,083627,Boyle; Mary E. T.,0,14,60,60
1650591574608,COGS 118A,A01,083075,Staff,0,4,60,60
1650591580636,CSE 3,A50,083646,Miranda; Gregory Joseph,19,0,38,19
1650591580636,CSE 3,A51,083647,Miranda; Gregory Joseph,36,0,37,1
1650591586660,CSE 8A,A50,083650,Miranda; Gregory Joseph,0,30,40,40
1650591592684,CSE 11,A01,083080,Cao; Yingjun,0,95,40,40
1650591598710,CSE 12,A01,083652,Staff,0,21,100,100
1650591604747,CSE 15L,A01,083654,Staff,0,2,50,50
1650591604747,CSE 15L,A02,083655,Staff,0,1,50,50
1650591610771,CSE 20,A01,083657,Staff,51,0,80,29
1650591616794,CSE 30,A01,083084,Eldon; John,0,78,40,40
1650591622827,CSE 100,A01,083659,Cao; Yingjun,0,66,50,50
1650591628859,CSE 134B,A01,083661,Powell; Thomas Allan,0,35,65,65
1650591634885,CSE 140,A01,083663,Staff,1,8,75,74
1650591640915,CSE 140L,A01,083088,Eldon; John,1,14,75,74
1650591646940,CSE 175,A01,083665,Kumar; Rakesh,7,0,25,18
1650591652969,CSE 190,A00,092507,Dubnov; Shlomo,11,0,20,9
1650591658993,ECE 45,A01,083139,Staff,1,2,60,59
1650591665016,ECE 65,A50,083695,Staff,1,6,30,29
1650591671045,ECE 109,A01,091882,Touri; Behrouz,33,0,70,37
1650591677074,ECE 180,A00,083140,Abi Samra; Nicholas Camill,21,0,30,9
1650591677074,ECE 180,B00,083141,Abi Samra; Nicholas Camill,0,0,30,30
1650591683102,MATH 10A,A01,083735,Patchell; Gregory David,4,0,30,26
1650591683102,MATH 10A,A02,083736,Patchell; Gregory David,27,0,30,3
1650591683102,MATH 10A,A03,083737,Patchell; Gregory David,24,0,30,6
1650591689143,MATH 10B,A01,083207,Staff,0,9,30,30
1650591689143,MATH 10B,A02,083208,Staff,0,8,30,30
1650591689143,MATH 10B,B01,083739,Staff,11,0,30,19
1650591689143,MATH 10B,B02,083740,Staff,28,0,30,2
1650591695168,MATH 18,A01,083743,Staff,0,0,30,30
1650591695168,MATH 18,A02,083744,Staff,24,0,30,6
1650591695168,MATH 18,A03,083745,Staff,21,0,30,9
1650591695168,MATH 18,A04,083746,Staff,26,0,30,4
1650591695168,MATH 18,B01,083748,Staff,0,14,30,30
1650591695168,MATH 18,B02,083749,Staff,1,11,30,29
1650591695168,MATH 18,B03,083750,Staff,0,12,30,30
1650591695168,MATH 18,B04,083751,Staff,0,12,30,30
1650591701193,MATH 20A,A01,083754,Staff,21,0,40,19
1650591707217,MATH 20B,A01,083756,Staff,1,12,30,29
1650591707217,MATH 20B,A02,083757,Staff,0,12,30,30
1650591713241,MATH 20C,A01,083760,Staff,0,16,30,30
1650591713241,MATH 20C,A02,083761,Staff,2,14,30,28
1650591713241,MATH 20C,B01,083762,Staff,11,0,30,19
1650591713241,MATH 20C,B02,083763,Staff,28,0,30,2
1650591719266,MATH 20D,A01,083765,Staff,1,1,30,29
1650591719266,MATH 20D,A02,083766,Staff,8,0,30,22
1650591719266,MATH 20D,A03,083767,Staff,25,0,30,5
1650591725299,MATH 20E,A01,083771,Staff,5,0,30,25
1650591725299,MATH 20E,A02,083772,Staff,18,0,30,12
1650591725299,MATH 20E,B01,083773,Staff,0,0,30,30
1650591725299,MATH 20E,B02,083774,Staff,9,0,30,21
1650591731330,MATH 103A,A01,083777,Staff,0,15,30,30
1650591731330,MATH 103A,A02,083778,Staff,0,14,30,30
1650591731330,MATH 103A,B01,083779,Staff,0,13,30,30
1650591731330,MATH 103A,B02,083780,Staff,0,14,30,30
1650591737354,MATH 105,A01,085443,Staff,0,21,30,30
1650591743382,MATH 109,A01,083213,Anzaldo; Leesa B,0,7,30,30
1650591743382,MATH 109,A02,083214,Anzaldo; Leesa B,0,7,30,30
1650591743382,MATH 109,B01,083215,Anzaldo; Leesa B,0,5,30,30
1650591743382,MATH 109,B02,083216,Anzaldo; Leesa B,1,6,30,29
1650591749411,MATH 142A,A01,083219,Chow; Bennett,0,16,30,30
1650591749411,MATH 142A,A02,083220,Chow; Bennett,0,15,30,30
1650591749411,MATH 142A,B01,083221,Chow; Bennett,0,14,30,30
1650591749411,MATH 142A,B02,083222,Chow; Bennett,0,13,30,30
1650591755435,MATH 193A,A01,083224,Staff,1,6,30,29
1650591755435,MATH 193A,A02,083225,Staff,0,6,30,30
1650591755435,MATH 193A,A03,083781,Staff,0,6,30,30
1650591755435,MATH 193A,A04,083782,Staff,0,7,30,30
1650591761467,MATH 197,001,091859,McAuley; Julian John,9998,0,9999,1
1650591767523,COGS 9,A01,083615,Staff,1,16,60,59
1650591773550,COGS 11,A01,083617,Boyle; Mary E. T.,18,0,40,22
1650591779577,COGS 13,A01,083071,Staff,0,37,40,40
1650591785601,COGS 14A,A01,092681,Staff,0,29,100,100
1650591791625,COGS 14B,A01,083073,Cheng; Tzu-Han,0,13,50,50
1650591797648,COGS 17,A01,092677,Staff,17,0,75,58
1650591803674,COGS 100,A01,083619,Staff,1,26,60,59
1650591809698,COGS 101A,A01,083621,Davis; Joshua Daniel,0,26,60,60
1650591815724,COGS 101B,A01,091572,Staff,1,5,60,59
1650591821752,COGS 101C,A01,083625,Delgado; Tania,15,0,30,15
1650591827784,COGS 107A,A01,083627,Boyle; Mary E. T.,0,14,60,60
1650591833812,COGS 118A,A01,083075,Staff,0,4,60,60
1650591839844,CSE 3,A50,083646,Miranda; Gregory Joseph,19,0,38,19
1650591839844,CSE 3,A51,083647,Miranda; Gregory Joseph,36,0,37,1
1650591845871,CSE 8A,A50,083650,Miranda; Gregory Joseph,0,30,40,40
1650591851902,CSE 11,A01,083080,Cao; Yingjun,0,95,40,40
1650591857932,CSE 12,A01,083652,Staff,0,21,100,100
1650591863962,CSE 15L,A01,083654,Staff,0,2,50,50
1650591863962,CSE 15L,A02,083655,Staff,0,1,50,50
1650591869987,CSE 20,A01,083657,Staff,51,0,80,29
1650591876025,CSE 30,A01,083084,Eldon; John,0,78,40,40
1650591882047,CSE 100,A01,083659,Cao; Yingjun,0,66,50,50
1650591888078,CSE 134B,A01,083661,Powell; Thomas Allan,0,35,65,65
1650591894112,CSE 140,A01,083663,Staff,1,8,75,74
1650591900139,CSE 140L,A01,083088,Eldon; John,1,14,75,74
1650591906162,CSE 175,A01,083665,Kumar; Rakesh,7,0,25,18
1650591912185,CSE 190,A00,092507,Dubnov; Shlomo,11,0,20,9
1650591918206,ECE 45,A01,083139,Staff,1,2,60,59
1650591924235,ECE 65,A50,083695,Staff,1,6,30,29
1650591930350,ECE 109,A01,091882,Touri; Behrouz,33,0,70,37
1650591936374,ECE 180,A00,083140,Abi Samra; Nicholas Camill,21,0,30,9
1650591936374,ECE 180,B00,083141,Abi Samra; Nicholas Camill,0,0,30,30
1650591942402,MATH 10A,A01,083735,Patchell; Gregory David,4,0,30,26
1650591942402,MATH 10A,A02,083736,Patchell; Gregory David,27,0,30,3
1650591942402,MATH 10A,A03,083737,Patchell; Gregory David,24,0,30,6
1650591948432,MATH 10B,A01,083207,Staff,0,9,30,30
1650591948432,MATH 10B,A02,083208,Staff,0,8,30,30
1650591948432,MATH 10B,B01,083739,Staff,11,0,30,19
1650591948432,MATH 10B,B02,083740,Staff,28,0,30,2
1650591954455,MATH 18,A01,083743,Staff,0,0,30,30
1650591954455,MATH 18,A02,083744,Staff,24,0,30,6
1650591954455,MATH 18,A03,083745,Staff,21,0,30,9
1650591954455,MATH 18,A04,083746,Staff,26,0,30,4
1650591954455,MATH 18,B01,083748,Staff,0,14,30,30
1650591954455,MATH 18,B02,083749,Staff,1,11,30,29
1650591954455,MATH 18,B03,083750,Staff,0,12,30,30
1650591954455,MATH 18,B04,083751,Staff,0,12,30,30
1650591960477,MATH 20A,A01,083754,Staff,21,0,40,19
1650591966502,MATH 20B,A01,083756,Staff,1,12,30,29
1650591966502,MATH 20B,A02,083757,Staff,0,12,30,30
1650591972526,MATH 20C,A01,083760,Staff,0,16,30,30
1650591972526,MATH 20C,A02,083761,Staff,2,14,30,28
1650591972526,MATH 20C,B01,083762,Staff,11,0,30,19
1650591972526,MATH 20C,B02,083763,Staff,28,0,30,2
1650591978549,MATH 20D,A01,083765,Staff,1,1,30,29
1650591978549,MATH 20D,A02,083766,Staff,8,0,30,22
1650591978549,MATH 20D,A03,083767,Staff,25,0,30,5
1650591984574,MATH 20E,A01,083771,Staff,5,0,30,25
1650591984574,MATH 20E,A02,083772,Staff,18,0,30,12
1650591984574,MATH 20E,B01,083773,Staff,0,0,30,30
1650591984574,MATH 20E,B02,083774,Staff,9,0,30,21
1650591990603,MATH 103A,A01,083777,Staff,0,15,30,30
1650591990603,MATH 103A,A02,083778,Staff,0,14,30,30
1650591990603,MATH 103A,B01,083779,Staff,0,13,30,30
1650591990603,MATH 103A,B02,083780,Staff,0,14,30,30
1650591996628,MATH 105,A01,085443,Staff,0,21,30,30
1650592002651,MATH 109,A01,083213,Anzaldo; Leesa B,1,7,30,29
1650592002651,MATH 109,A02,083214,Anzaldo; Leesa B,0,7,30,30
1650592002651,MATH 109,B01,083215,Anzaldo; Leesa B,0,5,30,30
1650592002651,MATH 109,B02,083216,Anzaldo; Leesa B,1,6,30,29
1650592008673,MATH 142A,A01,083219,Chow; Bennett,0,16,30,30
1650592008673,MATH 142A,A02,083220,Chow; Bennett,0,15,30,30
1650592008673,MATH 142A,B01,083221,Chow; Bennett,0,14,30,30
1650592008673,MATH 142A,B02,083222,Chow; Bennett,0,13,30,30
1650592014706,MATH 193A,A01,083224,Staff,1,6,30,29
1650592014706,MATH 193A,A02,083225,Staff,0,6,30,30
1650592014706,MATH 193A,A03,083781,Staff,0,6,30,30
1650592014706,MATH 193A,A04,083782,Staff,0,7,30,30
1650592020730,MATH 197,001,091859,McAuley; Julian John,9998,0,9999,1
1650592026780,COGS 9,A01,083615,Staff,1,16,60,59
1650592032805,COGS 11,A01,083617,Boyle; Mary E. T.,18,0,40,22
1650592038830,COGS 13,A01,083071,Staff,0,37,40,40
1650592044875,COGS 14A,A01,092681,Staff,0,29,100,100
1650592050898,COGS 14B,A01,083073,Cheng; Tzu-Han,0,13,50,50
1650592056927,COGS 17,A01,092677,Staff,17,0,75,58
1650592062951,COGS 100,A01,083619,Staff,1,26,60,59
1650592068974,COGS 101A,A01,083621,Davis; Joshua Daniel,0,26,60,60
1650592074996,COGS 101B,A01,091572,Staff,1,5,60,59
1650592081024,COGS 101C,A01,083625,Delgado; Tania,15,0,30,15
1650592087047,COGS 107A,A01,083627,Boyle; Mary E. T.,0,14,60,60
1650592093075,COGS 118A,A01,083075,Staff,0,4,60,60
1650592099103,CSE 3,A50,083646,Miranda; Gregory Joseph,19,0,38,19
1650592099103,CSE 3,A51,083647,Miranda; Gregory Joseph,36,0,37,1
1650592105138,CSE 8A,A50,083650,Miranda; Gregory Joseph,0,30,40,40
1650592111163,CSE 11,A01,083080,Cao; Yingjun,0,95,40,40
1650592117187,CSE 12,A01,083652,Staff,0,20,100,100
1650592123220,CSE 15L,A01,083654,Staff,0,2,50,50
1650592123220,CSE 15L,A02,083655,Staff,0,1,50,50
1650592129242,CSE 20,A01,083657,Staff,51,0,80,29
1650592135271,CSE 30,A01,083084,Eldon; John,0,78,40,40
1650592141297,CSE 100,A01,083659,Cao; Yingjun,0,66,50,50
1650592147326,CSE 134B,A01,083661,Powell; Thomas Allan,0,35,65,65
1650592153351,CSE 140,A01,083663,Staff,1,8,75,74
1650592159382,CSE 140L,A01,083088,Eldon; John,1,14,75,74
1650592165409,CSE 175,A01,083665,Kumar; Rakesh,7,0,25,18
1650592171434,CSE 190,A00,092507,Dubnov; Shlomo,11,0,20,9
1650592177457,ECE 45,A01,083139,Staff,1,2,60,59
1650592183486,ECE 65,A50,083695,Staff,1,6,30,29
1650592189511,ECE 109,A01,091882,Touri; Behrouz,33,0,70,37
1650592195549,ECE 180,A00,083140,Abi Samra; Nicholas Camill,21,0,30,9
1650592195549,ECE 180,B00,083141,Abi Samra; Nicholas Camill,0,0,30,30
1650592201572,MATH 10A,A01,083735,Patchell; Gregory David,4,0,30,26
1650592201572,MATH 10A,A02,083736,Patchell; Gregory David,27,0,30,3
1650592201572,MATH 10A,A03,083737,Patchell; Gregory David,24,0,30,6
1650592207611,MATH 10B,A01,083207,Staff,0,9,30,30
1650592207611,MATH 10B,A02,083208,Staff,0,8,30,30
1650592207611,MATH 10B,B01,083739,Staff,11,0,30,19
1650592207611,MATH 10B,B02,083740,Staff,28,0,30,2
1650592213635,MATH 18,A01,083743,Staff,0,0,30,30
1650592213635,MATH 18,A02,083744,Staff,24,0,30,6
1650592213635,MATH 18,A03,083745,Staff,21,0,30,9
1650592213635,MATH 18,A04,083746,Staff,26,0,30,4
1650592213635,MATH 18,B01,083748,Staff,0,14,30,30
1650592213635,MATH 18,B02,083749,Staff,1,11,30,29
1650592213635,MATH 18,B03,083750,Staff,0,12,30,30
1650592213635,MATH 18,B04,083751,Staff,0,12,30,30
1650592219657,MATH 20A,A01,083754,Staff,21,0,40,19
1650592225685,MATH 20B,A01,083756,Staff,1,12,30,29
1650592225685,MATH 20B,A02,083757,Staff,0,12,30,30
1650592231708,MATH 20C,A01,083760,Staff,0,16,30,30
1650592231708,MATH 20C,A02,083761,Staff,2,14,30,28
1650592231708,MATH 20C,B01,083762,Staff,11,0,30,19
1650592231708,MATH 20C,B02,083763,Staff,28,0,30,2
1650592237732,MATH 20D,A01,083765,Staff,1,1,30,29
1650592237732,MATH 20D,A02,083766,Staff,8,0,30,22
1650592237732,MATH 20D,A03,083767,Staff,25,0,30,5
1650592243757,MATH 20E,A01,083771,Staff,5,0,30,25
1650592243757,MATH 20E,A02,083772,Staff,18,0,30,12
1650592243757,MATH 20E,B01,083773,Staff,0,0,30,30
1650592243757,MATH 20E,B02,083774,Staff,9,0,30,21
1650592249785,MATH 103A,A01,083777,Staff,0,15,30,30
1650592249785,MATH 103A,A02,083778,Staff,0,14,30,30
1650592249785,MATH 103A,B01,083779,Staff,0,13,30,30
1650592249785,MATH 103A,B02,083780,Staff,0,14,30,30
1650592255809,MATH 105,A01,085443,Staff,0,21,30,30
1650592261832,MATH 109,A01,083213,Anzaldo; Leesa B,1,7,30,29
1650592261832,MATH 109,A02,083214,Anzaldo; Leesa B,0,7,30,30
1650592261832,MATH 109,B01,083215,Anzaldo; Leesa B,0,5,30,30
1650592261832,MATH 109,B02,083216,Anzaldo; Leesa B,1,6,30,29
1650592267853,MATH 142A,A01,083219,Chow; Bennett,0,16,30,30
1650592267853,MATH 142A,A02,083220,Chow; Bennett,0,15,30,30
1650592267853,MATH 142A,B01,083221,Chow; Bennett,0,14,30,30
1650592267853,MATH 142A,B02,083222,Chow; Bennett,0,13,30,30
1650592273891,MATH 193A,A01,083224,Staff,1,6,30,29
1650592273891,MATH 193A,A02,083225,Staff,0,6,30,30
1650592273891,MATH 193A,A03,083781,Staff,0,6,30,30
1650592273891,MATH 193A,A04,083782,Staff,0,7,30,30
1650592279921,MATH 197,001,091859,McAuley; Julian John,9998,0,9999,1
1650592285975,COGS 9,A01,083615,Staff,1,16,60,59
1650592292001,COGS 11,A01,083617,Boyle; Mary E. T.,18,0,40,22
1650592298036,COGS 13,A01,083071,Staff,0,37,40,40
1650592304060,COGS 14A,A01,092681,Staff,0,29,100,100
1650592310103,COGS 14B,A01,083073,Cheng; Tzu-Han,0,13,50,50
1650592316125,COGS 17,A01,092677,Staff,17,0,75,58
1650592322151,COGS 100,A01,083619,Staff,1,26,60,59
1650592328184,COGS 101A,A01,083621,Davis; Joshua Daniel,0,26,60,60
1650592334210,COGS 101B,A01,091572,Staff,1,5,60,59
1650592340237,COGS 101C,A01,083625,Delgado; Tania,15,0,30,15
1650592346270,COGS 107A,A01,083627,Boyle; Mary E. T.,0,14,60,60
1650592352295,COGS 118A,A01,083075,Staff,0,4,60,60
1650592358319,CSE 3,A50,083646,Miranda; Gregory Joseph,19,0,38,19
1650592358319,CSE 3,A51,083647,Miranda; Gregory Joseph,36,0,37,1
1650592364347,CSE 8A,A50,083650,Miranda; Gregory Joseph,0,30,40,40
1650592370370,CSE 11,A01,083080,Cao; Yingjun,0,96,40,40
1650592376399,CSE 12,A01,083652,Staff,0,20,100,100
1650592382422,CSE 15L,A01,083654,Staff,0,2,50,50
1650592382422,CSE 15L,A02,083655,Staff,0,1,50,50
1650592388454,CSE 20,A01,083657,Staff,51,0,80,29
1650592394477,CSE 30,A01,083084,Eldon; John,0,78,40,40
1650592400502,CSE 100,A01,083659,Cao; Yingjun,0,66,50,50
1650592406527,CSE 134B,A01,083661,Powell; Thomas Allan,0,35,65,65
1650592412548,CSE 140,A01,083663,Staff,1,8,75,74
1650592418585,CSE 140L,A01,083088,Eldon; John,1,14,75,74
1650592424610,CSE 175,A01,083665,Kumar; Rakesh,7,0,25,18
1650592430644,CSE 190,A00,092507,Dubnov; Shlomo,11,0,20,9
1650592436670,ECE 45,A01,083139,Staff,1,2,60,59
1650592442705,ECE 65,A50,083695,Staff,1,6,30,29
1650592448729,ECE 109,A01,091882,Touri; Behrouz,33,0,70,37
1650592454793,ECE 180,A00,083140,Abi Samra; Nicholas Camill,21,0,30,9
1650592454793,ECE 180,B00,083141,Abi Samra; Nicholas Camill,0,0,30,30
1650592460821,MATH 10A,A01,083735,Patchell; Gregory David,4,0,30,26
1650592460821,MATH 10A,A02,083736,Patchell; Gregory David,27,0,30,3
1650592460821,MATH 10A,A03,083737,Patchell; Gregory David,24,0,30,6
1650592466846,MATH 10B,A01,083207,Staff,0,9,30,30
1650592466846,MATH 10B,A02,083208,Staff,0,8,30,30
1650592466846,MATH 10B,B01,083739,Staff,11,0,30,19
1650592466846,MATH 10B,B02,083740,Staff,28,0,30,2
1650592472873,MATH 18,A01,083743,Staff,0,0,30,30
1650592472873,MATH 18,A02,083744,Staff,24,0,30,6
1650592472873,MATH 18,A03,083745,Staff,21,0,30,9
1650592472873,MATH 18,A04,083746,Staff,26,0,30,4
1650592472873,MATH 18,B01,083748,Staff,0,15,30,30
1650592472873,MATH 18,B02,083749,Staff,1,11,30,29
1650592472873,MATH 18,B03,083750,Staff,0,12,30,30
1650592472873,MATH 18,B04,083751,Staff,0,12,30,30
1650592478896,MATH 20A,A01,083754,Staff,21,0,40,19
1650592484920,MATH 20B,A01,083756,Staff,1,12,30,29
1650592484920,MATH 20B,A02,083757,Staff,0,12,30,30
1650592490947,MATH 20C,A01,083760,Staff,0,16,30,30
1650592490947,MATH 20C,A02,083761,Staff,2,14,30,28
1650592490947,MATH 20C,B01,083762,Staff,11,0,30,19
1650592490947,MATH 20C,B02,083763,Staff,28,0,30,2
1650592496972,MATH 20D,A01,083765,Staff,1,1,30,29
1650592496972,MATH 20D,A02,083766,Staff,8,0,30,22
1650592496972,MATH 20D,A03,083767,Staff,25,0,30,5
1650592502997,MATH 20E,A01,083771,Staff,5,0,30,25
1650592502997,MATH 20E,A02,083772,Staff,18,0,30,12
1650592502997,MATH 20E,B01,083773,Staff,0,0,30,30
1650592502997,MATH 20E,B02,083774,Staff,9,0,30,21
1650592509026,MATH 103A,A01,083777,Staff,0,15,30,30
1650592509026,MATH 103A,A02,083778,Staff,0,14,30,30
1650592509026,MATH 103A,B01,083779,Staff,0,13,30,30
1650592509026,MATH 103A,B02,083780,Staff,0,14,30,30
1650592515062,MATH 105,A01,085443,Staff,0,21,30,30
1650592521091,MATH 109,A01,083213,Anzaldo; Leesa B,1,7,30,29
1650592521091,MATH 109,A02,083214,Anzaldo; Leesa B,0,7,30,30
1650592521091,MATH 109,B01,083215,Anzaldo; Leesa B,0,5,30,30
1650592521091,MATH 109,B02,083216,Anzaldo; Leesa B,1,6,30,29
1650592527213,MATH 142A,A01,083219,Chow; Bennett,0,16,30,30
1650592527213,MATH 142A,A02,083220,Chow; Bennett,0,15,30,30
1650592527213,MATH 142A,B01,083221,Chow; Bennett,0,14,30,30
1650592527213,MATH 142A,B02,083222,Chow; Bennett,0,13,30,30
1650592533239,MATH 193A,A01,083224,Staff,1,6,30,29
1650592533239,MATH 193A,A02,083225,Staff,0,6,30,30
1650592533239,MATH 193A,A03,083781,Staff,0,6,30,30
1650592533239,MATH 193A,A04,083782,Staff,0,7,30,30
1650592539261,MATH 197,001,091859,McAuley; Julian John,9998,0,9999,1
1650592545314,COGS 9,A01,083615,Staff,1,16,60,59
1650592551340,COGS 11,A01,083617,Boyle; Mary E. T.,18,0,40,22
1650592557370,COGS 13,A01,083071,Staff,0,37,40,40
1650592563397,COGS 14A,A01,092681,Staff,0,29,100,100
1650592569421,COGS 14B,A01,083073,Cheng; Tzu-Han,0,13,50,50
1650592575443,COGS 17,A01,092677,Staff,17,0,75,58
1650592581477,COGS 100,A01,083619,Staff,1,26,60,59
1650592587499,COGS 101A,A01,083621,Davis; Joshua Daniel,0,26,60,60
1650592593530,COGS 101B,A01,091572,Staff,1,5,60,59
1650592599552,COGS 101C,A01,083625,Delgado; Tania,15,0,30,15
1650592605579,COGS 107A,A01,083627,Boyle; Mary E. T.,0,14,60,60
1650592611601,COGS 118A,A01,083075,Staff,0,4,60,60
1650592617629,CSE 3,A50,083646,Miranda; Gregory Joseph,19,0,38,19
1650592617629,CSE 3,A51,083647,Miranda; Gregory Joseph,36,0,37,1
1650592623663,CSE 8A,A50,083650,Miranda; Gregory Joseph,0,30,40,40
1650592629694,CSE 11,A01,083080,Cao; Yingjun,0,96,40,40
1650592635720,CSE 12,A01,083652,Staff,0,20,100,100
1650592641742,CSE 15L,A01,083654,Staff,0,2,50,50
1650592641742,CSE 15L,A02,083655,Staff,0,1,50,50
1650592647767,CSE 20,A01,083657,Staff,51,0,80,29
1650592653789,CSE 30,A01,083084,Eldon; John,0,78,40,40
1650592659815,CSE 100,A01,083659,Cao; Yingjun,0,66,50,50
1650592665841,CSE 134B,A01,083661,Powell; Thomas Allan,0,35,65,65
1650592671873,CSE 140,A01,083663,Staff,1,8,75,74
1650592677901,CSE 140L,A01,083088,Eldon; John,1,14,75,74
1650592683925,CSE 175,A01,083665,Kumar; Rakesh,7,0,25,18
1650592689949,CSE 190,A00,092507,Dubnov; Shlomo,11,0,20,9
1650592695972,ECE 45,A01,083139,Staff,1,2,60,59
1650592702003,ECE 65,A50,083695,Staff,1,6,30,29
1650592708028,ECE 109,A01,091882,Touri; Behrouz,33,0,70,37
1650592714058,ECE 180,A00,083140,Abi Samra; Nicholas Camill,21,0,30,9
1650592714058,ECE 180,B00,083141,Abi Samra; Nicholas Camill,0,0,30,30
1650592720093,MATH 10A,A01,083735,Patchell; Gregory David,4,0,30,26
1650592720093,MATH 10A,A02,083736,Patchell; Gregory David,27,0,30,3
1650592720093,MATH 10A,A03,083737,Patchell; Gregory David,24,0,30,6
1650592726121,MATH 10B,A01,083207,Staff,0,9,30,30
1650592726121,MATH 10B,A02,083208,Staff,0,8,30,30
1650592726121,MATH 10B,B01,083739,Staff,11,0,30,19
1650592726121,MATH 10B,B02,083740,Staff,28,0,30,2
1650592732154,MATH 18,A01,083743,Staff,0,0,30,30
1650592732154,MATH 18,A02,083744,Staff,24,0,30,6
1650592732154,MATH 18,A03,083745,Staff,21,0,30,9
1650592732154,MATH 18,A04,083746,Staff,26,0,30,4
1650592732154,MATH 18,B01,083748,Staff,0,15,30,30
1650592732154,MATH 18,B02,083749,Staff,1,11,30,29
1650592732154,MATH 18,B03,083750,Staff,0,12,30,30
1650592732154,MATH 18,B04,083751,Staff,0,12,30,30
1650592738195,MATH 20A,A01,083754,Staff,21,0,40,19
1650592744219,MATH 20B,A01,083756,Staff,1,12,30,29
1650592744219,MATH 20B,A02,083757,Staff,0,12,30,30
1650592750243,MATH 20C,A01,083760,Staff,0,16,30,30
1650592750243,MATH 20C,A02,083761,Staff,2,14,30,28
1650592750243,MATH 20C,B01,083762,Staff,11,0,30,19
1650592750243,MATH 20C,B02,083763,Staff,28,0,30,2
1650592756278,MATH 20D,A01,083765,Staff,1,1,30,29
1650592756278,MATH 20D,A02,083766,Staff,8,0,30,22
1650592756278,MATH 20D,A03,083767,Staff,25,0,30,5
1650592762311,MATH 20E,A01,083771,Staff,5,0,30,25
1650592762311,MATH 20E,A02,083772,Staff,18,0,30,12
1650592762311,MATH 20E,B01,083773,Staff,0,0,30,30
1650592762311,MATH 20E,B02,083774,Staff,9,0,30,21
1650592768337,MATH 103A,A01,083777,Staff,0,15,30,30
1650592768337,MATH 103A,A02,083778,Staff,0,14,30,30
1650592768337,MATH 103A,B01,083779,Staff,0,13,30,30
1650592768337,MATH 103A,B02,083780,Staff,0,14,30,30
1650592774359,MATH 105,A01,085443,Staff,0,21,30,30
1650592780383,MATH 109,A01,083213,Anzaldo; Leesa B,1,7,30,29
1650592780383,MATH 109,A02,083214,Anzaldo; Leesa B,0,7,30,30
1650592780383,MATH 109,B01,083215,Anzaldo; Leesa B,0,5,30,30
1650592780383,MATH 109,B02,083216,Anzaldo; Leesa B,1,6,30,29
1650592786418,MATH 142A,A01,083219,Chow; Bennett,0,16,30,30
1650592786418,MATH 142A,A02,083220,Chow; Bennett,0,15,30,30
1650592786418,MATH 142A,B01,083221,Chow; Bennett,0,14,30,30
1650592786418,MATH 142A,B02,083222,Chow; Bennett,0,13,30,30
1650592792444,MATH 193A,A01,083224,Staff,1,6,30,29
1650592792444,MATH 193A,A02,083225,Staff,0,6,30,30
1650592792444,MATH 193A,A03,083781,Staff,0,6,30,30
1650592792444,MATH 193A,A04,083782,Staff,0,7,30,30
1650592798489,MATH 197,001,091859,McAuley; Julian John,9998,0,9999,1
1650592804556,COGS 9,A01,083615,Staff,1,16,60,59
1650592810605,COGS 11,A01,083617,Boyle; Mary E. T.,18,0,40,22
1650592816635,COGS 13,A01,083071,Staff,0,37,40,40
1650592822671,COGS 14A,A01,092681,Staff,0,29,100,100
1650592828697,COGS 14B,A01,083073,Cheng; Tzu-Han,0,13,50,50
1650592834736,COGS 17,A01,092677,Staff,17,0,75,58
1650592840760,COGS 100,A01,083619,Staff,1,26,60,59
1650592846790,COGS 101A,A01,083621,Davis; Joshua Daniel,0,26,60,60
1650592852822,COGS 101B,A01,091572,Staff,1,5,60,59
1650592858846,COGS 101C,A01,083625,Delgado; Tania,15,0,30,15
1650592864869,COGS 107A,A01,083627,Boyle; Mary E. T.,0,14,60,60
1650592870901,COGS 118A,A01,083075,Staff,0,4,60,60
1650592876934,CSE 3,A50,083646,Miranda; Gregory Joseph,19,0,38,19
1650592876934,CSE 3,A51,083647,Miranda; Gregory Joseph,36,0,37,1
1650592882967,CSE 8A,A50,083650,Miranda; Gregory Joseph,0,30,40,40
1650592888990,CSE 11,A01,083080,Cao; Yingjun,0,96,40,40
1650592895014,CSE 12,A01,083652,Staff,0,20,100,100
1650592901044,CSE 15L,A01,083654,Staff,0,2,50,50
1650592901044,CSE 15L,A02,083655,Staff,0,1,50,50
1650592907081,CSE 20,A01,083657,Staff,51,0,80,29
1650592913104,CSE 30,A01,083084,Eldon; John,0,78,40,40
1650592919137,CSE 100,A01,083659,Cao; Yingjun,0,66,50,50
1650592925172,CSE 134B,A01,083661,Powell; Thomas Allan,0,35,65,65
1650592931202,CSE 140,A01,083663,Staff,1,8,75,74
1650592937228,CSE 140L,A01,083088,Eldon; John,1,14,75,74
1650592943254,CSE 175,A01,083665,Kumar; Rakesh,7,0,25,18
1650592949279,CSE 190,A00,092507,Dubnov; Shlomo,11,0,20,9
1650592955303,ECE 45,A01,083139,Staff,1,2,60,59
1650592961330,ECE 65,A50,083695,Staff,1,6,30,29
1650592967353,ECE 109,A01,091882,Touri; Behrouz,33,0,70,37
1650592973380,ECE 180,A00,083140,Abi Samra; Nicholas Camill,21,0,30,9
1650592973380,ECE 180,B00,083141,Abi Samra; Nicholas Camill,0,0,30,30
1650592979404,MATH 10A,A01,083735,Patchell; Gregory David,4,0,30,26
1650592979404,MATH 10A,A02,083736,Patchell; Gregory David,27,0,30,3
1650592979404,MATH 10A,A03,083737,Patchell; Gregory David,24,0,30,6
1650592985428,MATH 10B,A01,083207,Staff,0,9,30,30
1650592985428,MATH 10B,A02,083208,Staff,0,8,30,30
1650592985428,MATH 10B,B01,083739,Staff,11,0,30,19
1650592985428,MATH 10B,B02,083740,Staff,28,0,30,2
1650592991460,MATH 18,A01,083743,Staff,0,0,30,30
1650592991460,MATH 18,A02,083744,Staff,24,0,30,6
1650592991460,MATH 18,A03,083745,Staff,21,0,30,9
1650592991460,MATH 18,A04,083746,Staff,26,0,30,4
1650592991460,MATH 18,B01,083748,Staff,0,15,30,30
1650592991460,MATH 18,B02,083749,Staff,1,11,30,29
1650592991460,MATH 18,B03,083750,Staff,0,12,30,30
1650592991460,MATH 18,B04,083751,Staff,0,12,30,30
1650592997483,MATH 20A,A01,083754,Staff,21,0,40,19
1650593003507,MATH 20B,A01,083756,Staff,1,12,30,29
1650593003507,MATH 20B,A02,083757,Staff,0,12,30,30
1650593009531,MATH 20C,A01,083760,Staff,0,16,30,30
1650593009531,MATH 20C,A02,083761,Staff,2,14,30,28
1650593009531,MATH 20C,B01,083762,Staff,11,0,30,19
1650593009531,MATH 20C,B02,083763,Staff,28,0,30,2
1650593015557,MATH 20D,A01,083765,Staff,1,1,30,29
1650593015557,MATH 20D,A02,083766,Staff,8,0,30,22
1650593015557,MATH 20D,A03,083767,Staff,25,0,30,5
1650593021581,MATH 20E,A01,083771,Staff,5,0,30,25
1650593021581,MATH 20E,A02,083772,Staff,18,0,30,12
1650593021581,MATH 20E,B01,083773,Staff,0,0,30,30
1650593021581,MATH 20E,B02,083774,Staff,9,0,30,21
1650593027608,MATH 103A,A01,083777,Staff,0,15,30,30
1650593027608,MATH 103A,A02,083778,Staff,0,14,30,30
1650593027608,MATH 103A,B01,083779,Staff,0,13,30,30
1650593027608,MATH 103A,B02,083780,Staff,0,14,30,30
1650593033631,MATH 105,A01,085443,Staff,0,21,30,30
1650593039659,MATH 109,A01,083213,Anzaldo; Leesa B,1,7,30,29
1650593039659,MATH 109,A02,083214,Anzaldo; Leesa B,0,7,30,30
1650593039659,MATH 109,B01,083215,Anzaldo; Leesa B,0,5,30,30
1650593039659,MATH 109,B02,083216,Anzaldo; Leesa B,1,6,30,29
1650593045687,MATH 142A,A01,083219,Chow; Bennett,0,16,30,30
1650593045687,MATH 142A,A02,083220,Chow; Bennett,0,15,30,30
1650593045687,MATH 142A,B01,083221,Chow; Bennett,0,14,30,30
1650593045687,MATH 142A,B02,083222,Chow; Bennett,0,13,30,30
1650593051715,MATH 193A,A01,083224,Staff,1,6,30,29
1650593051715,MATH 193A,A02,083225,Staff,0,6,30,30
1650593051715,MATH 193A,A03,083781,Staff,0,6,30,30
1650593051715,MATH 193A,A04,083782,Staff,0,7,30,30
1650593057739,MATH 197,001,091859,McAuley; Julian John,9998,0,9999,1
1650593063803,COGS 9,A01,083615,Staff,1,16,60,59
1650593069825,COGS 11,A01,083617,Boyle; Mary E. T.,18,0,40,22
1650593075849,COGS 13,A01,083071,Staff,0,37,40,40
1650593081873,COGS 14A,A01,092681,Staff,0,29,100,100
1650593087896,COGS 14B,A01,083073,Cheng; Tzu-Han,0,13,50,50
1650593093926,COGS 17,A01,092677,Staff,17,0,75,58
1650593099950,COGS 100,A01,083619,Staff,1,26,60,59
1650593105973,COGS 101A,A01,083621,Davis; Joshua Daniel,0,26,60,60
1650593111996,COGS 101B,A01,091572,Staff,1,5,60,59
1650593118109,COGS 101C,A01,083625,Delgado; Tania,15,0,30,15
1650593124140,COGS 107A,A01,083627,Boyle; Mary E. T.,0,14,60,60
1650593130168,COGS 118A,A01,083075,Staff,0,4,60,60
1650593136192,CSE 3,A50,083646,Miranda; Gregory Joseph,19,0,38,19
1650593136192,CSE 3,A51,083647,Miranda; Gregory Joseph,36,0,37,1
1650593142219,CSE 8A,A50,083650,Miranda; Gregory Joseph,0,30,40,40
1650593148243,CSE 11,A01,083080,Cao; Yingjun,0,96,40,40
1650593154277,CSE 12,A01,083652,Staff,0,20,100,100
1650593160300,CSE 15L,A01,083654,Staff,0,2,50,50
1650593160300,CSE 15L,A02,083655,Staff,0,1,50,50
1650593166325,CSE 20,A01,083657,Staff,51,0,80,29
1650593172349,CSE 30,A01,083084,Eldon; John,0,78,40,40
1650593178372,CSE 100,A01,083659,Cao; Yingjun,0,66,50,50
1650593184395,CSE 134B,A01,083661,Powell; Thomas Allan,0,35,65,65
1650593190417,CSE 140,A01,083663,Staff,1,8,75,74
1650593196449,CSE 140L,A01,083088,Eldon; John,1,14,75,74
1650593202471,CSE 175,A01,083665,Kumar; Rakesh,7,0,25,18
1650593208494,CSE 190,A00,092507,Dubnov; Shlomo,11,0,20,9
1650593214516,ECE 45,A01,083139,Staff,1,2,60,59
1650593220548,ECE 65,A50,083695,Staff,1,6,30,29
1650593226574,ECE 109,A01,091882,Touri; Behrouz,33,0,70,37
1650593232599,ECE 180,A00,083140,Abi Samra; Nicholas Camill,21,0,30,9
1650593232599,ECE 180,B00,083141,Abi Samra; Nicholas Camill,0,0,30,30
1650593238622,MATH 10A,A01,083735,Patchell; Gregory David,4,0,30,26
1650593238622,MATH 10A,A02,083736,Patchell; Gregory David,27,0,30,3
1650593238622,MATH 10A,A03,083737,Patchell; Gregory David,24,0,30,6
1650593244671,MATH 10B,A01,083207,Staff,0,9,30,30
1650593244671,MATH 10B,A02,083208,Staff,0,8,30,30
1650593244671,MATH 10B,B01,083739,Staff,11,0,30,19
1650593244671,MATH 10B,B02,083740,Staff,28,0,30,2
1650593250701,MATH 18,A01,083743,Staff,0,0,30,30
1650593250701,MATH 18,A02,083744,Staff,24,0,30,6
1650593250701,MATH 18,A03,083745,Staff,21,0,30,9
1650593250701,MATH 18,A04,083746,Staff,26,0,30,4
1650593250701,MATH 18,B01,083748,Staff,0,15,30,30
1650593250701,MATH 18,B02,083749,Staff,1,11,30,29
1650593250701,MATH 18,B03,083750,Staff,0,12,30,30
1650593250701,MATH 18,B04,083751,Staff,0,12,30,30
1650593256731,MATH 20A,A01,083754,Staff,21,0,40,19
1650593262753,MATH 20B,A01,083756,Staff,1,12,30,29
1650593262753,MATH 20B,A02,083757,Staff,0,12,30,30
1650593268777,MATH 20C,A01,083760,Staff,0,16,30,30
1650593268777,MATH 20C,A02,083761,Staff,2,14,30,28
1650593268777,MATH 20C,B01,083762,Staff,11,0,30,19
1650593268777,MATH 20C,B02,083763,Staff,28,0,30,2
1650593274812,MATH 20D,A01,083765,Staff,1,1,30,29
1650593274812,MATH 20D,A02,083766,Staff,8,0,30,22
1650593274812,MATH 20D,A03,083767,Staff,25,0,30,5
1650593280836,MATH 20E,A01,083771,Staff,5,0,30,25
1650593280836,MATH 20E,A02,083772,Staff,18,0,30,12
1650593280836,MATH 20E,B01,083773,Staff,0,0,30,30
1650593280836,MATH 20E,B02,083774,Staff,9,0,30,21
1650593286861,MATH 103A,A01,083777,Staff,0,15,30,30
1650593286861,MATH 103A,A02,083778,Staff,0,14,30,30
1650593286861,MATH 103A,B01,083779,Staff,0,13,30,30
1650593286861,MATH 103A,B02,083780,Staff,0,14,30,30
1650593292885,MATH 105,A01,085443,Staff,0,21,30,30
1650593298908,MATH 109,A01,083213,Anzaldo; Leesa B,1,7,30,29
1650593298908,MATH 109,A02,083214,Anzaldo; Leesa B,0,7,30,30
1650593298908,MATH 109,B01,083215,Anzaldo; Leesa B,0,5,30,30
1650593298908,MATH 109,B02,083216,Anzaldo; Leesa B,1,6,30,29
1650593304938,MATH 142A,A01,083219,Chow; Bennett,0,16,30,30
1650593304938,MATH 142A,A02,083220,Chow; Bennett,0,15,30,30
1650593304938,MATH 142A,B01,083221,Chow; Bennett,0,14,30,30
1650593304938,MATH 142A,B02,083222,Chow; Bennett,0,13,30,30
1650593310962,MATH 193A,A01,083224,Staff,1,6,30,29
1650593310962,MATH 193A,A02,083225,Staff,0,6,30,30
1650593310962,MATH 193A,A03,083781,Staff,0,6,30,30
1650593310962,MATH 193A,A04,083782,Staff,0,7,30,30
1650593316985,MATH 197,001,091859,McAuley; Julian John,9998,0,9999,1
1650593323075,COGS 9,A01,083615,Staff,1,16,60,59
1650593329101,COGS 11,A01,083617,Boyle; Mary E. T.,18,0,40,22
1650593335128,COGS 13,A01,083071,Staff,0,37,40,40
1650593341155,COGS 14A,A01,092681,Staff,0,29,100,100
1650593347180,COGS 14B,A01,083073,Cheng; Tzu-Han,0,13,50,50
1650593353204,COGS 17,A01,092677,Staff,17,0,75,58
1650593359227,COGS 100,A01,083619,Staff,1,26,60,59
1650593365254,COGS 101A,A01,083621,Davis; Joshua Daniel,0,26,60,60
1650593371285,COGS 101B,A01,091572,Staff,1,5,60,59
1650593377308,COGS 101C,A01,083625,Delgado; Tania,15,0,30,15
1650593383332,COGS 107A,A01,083627,Boyle; Mary E. T.,0,14,60,60
1650593389365,COGS 118A,A01,083075,Staff,0,4,60,60
1650593395393,CSE 3,A50,083646,Miranda; Gregory Joseph,19,0,38,19
1650593395393,CSE 3,A51,083647,Miranda; Gregory Joseph,36,0,37,1
1650593401419,CSE 8A,A50,083650,Miranda; Gregory Joseph,0,30,40,40
1650593407445,CSE 11,A01,083080,Cao; Yingjun,0,96,40,40
1650593413467,CSE 12,A01,083652,Staff,0,20,100,100
1650593419490,CSE 15L,A01,083654,Staff,0,2,50,50
1650593419490,CSE 15L,A02,083655,Staff,0,1,50,50
1650593425514,CSE 20,A01,083657,Staff,51,0,80,29
1650593431541,CSE 30,A01,083084,Eldon; John,0,78,40,40
1650593437563,CSE 100,A01,083659,Cao; Yingjun,0,66,50,50
1650593443587,CSE 134B,A01,083661,Powell; Thomas Allan,0,35,65,65
1650593449623,CSE 140,A01,083663,Staff,1,8,75,74
1650593455646,CSE 140L,A01,083088,Eldon; John,1,14,75,74
1650593461680,CSE 175,A01,083665,Kumar; Rakesh,7,0,25,18
1650593467706,CSE 190,A00,092507,Dubnov; Shlomo,11,0,20,9
1650593473732,ECE 45,A01,083139,Staff,1,2,60,59
1650593479761,ECE 65,A50,083695,Staff,1,6,30,29
1650593485789,ECE 109,A01,091882,Touri; Behrouz,33,0,70,37
1650593491813,ECE 180,A00,083140,Abi Samra; Nicholas Camill,21,0,30,9
1650593491813,ECE 180,B00,083141,Abi Samra; Nicholas Camill,0,0,30,30
1650593497841,MATH 10A,A01,083735,Patchell; Gregory David,4,0,30,26
1650593497841,MATH 10A,A02,083736,Patchell; Gregory David,27,0,30,3
1650593497841,MATH 10A,A03,083737,Patchell; Gregory David,24,0,30,6
1650593503864,MATH 10B,A01,083207,Staff,0,9,30,30
1650593503864,MATH 10B,A02,083208,Staff,0,8,30,30
1650593503864,MATH 10B,B01,083739,Staff,11,0,30,19
1650593503864,MATH 10B,B02,083740,Staff,28,0,30,2
1650593509889,MATH 18,A01,083743,Staff,0,0,30,30
1650593509889,MATH 18,A02,083744,Staff,24,0,30,6
1650593509889,MATH 18,A03,083745,Staff,21,0,30,9
1650593509889,MATH 18,A04,083746,Staff,26,0,30,4
1650593509889,MATH 18,B01,083748,Staff,0,15,30,30
1650593509889,MATH 18,B02,083749,Staff,1,11,30,29
1650593509889,MATH 18,B03,083750,Staff,0,12,30,30
1650593509889,MATH 18,B04,083751,Staff,0,12,30,30
1650593515913,MATH 20A,A01,083754,Staff,21,0,40,19
1650593521946,MATH 20B,A01,083756,Staff,1,12,30,29
1650593521946,MATH 20B,A02,083757,Staff,0,12,30,30
1650593527971,MATH 20C,A01,083760,Staff,0,16,30,30
1650593527971,MATH 20C,A02,083761,Staff,2,14,30,28
1650593527971,MATH 20C,B01,083762,Staff,11,0,30,19
1650593527971,MATH 20C,B02,083763,Staff,28,0,30,2
1650593534000,MATH 20D,A01,083765,Staff,1,1,30,29
1650593534000,MATH 20D,A02,083766,Staff,8,0,30,22
1650593534000,MATH 20D,A03,083767,Staff,25,0,30,5
1650593540024,MATH 20E,A01,083771,Staff,5,0,30,25
1650593540024,MATH 20E,A02,083772,Staff,18,0,30,12
1650593540024,MATH 20E,B01,083773,Staff,0,0,30,30
1650593540024,MATH 20E,B02,083774,Staff,9,0,30,21
1650593546049,MATH 103A,A01,083777,Staff,0,15,30,30
1650593546049,MATH 103A,A02,083778,Staff,0,14,30,30
1650593546049,MATH 103A,B01,083779,Staff,0,13,30,30
1650593546049,MATH 103A,B02,083780,Staff,0,14,30,30
1650593552079,MATH 105,A01,085443,Staff,0,21,30,30
1650593558136,MATH 109,A01,083213,Anzaldo; Leesa B,1,7,30,29
1650593558136,MATH 109,A02,083214,Anzaldo; Leesa B,0,7,30,30
1650593558136,MATH 109,B01,083215,Anzaldo; Leesa B,0,5,30,30
1650593558136,MATH 109,B02,083216,Anzaldo; Leesa B,1,6,30,29
1650593564177,MATH 142A,A01,083219,Chow; Bennett,0,16,30,30
1650593564177,MATH 142A,A02,083220,Chow; Bennett,0,15,30,30
1650593564177,MATH 142A,B01,083221,Chow; Bennett,0,14,30,30
1650593564177,MATH 142A,B02,083222,Chow; Bennett,0,13,30,30
1650593570214,MATH 193A,A01,083224,Staff,1,6,30,29
1650593570214,MATH 193A,A02,083225,Staff,0,6,30,30
1650593570214,MATH 193A,A03,083781,Staff,0,6,30,30
1650593570214,MATH 193A,A04,083782,Staff,0,7,30,30
1650593576237,MATH 197,001,091859,McAuley; Julian John,9998,0,9999,1
1650593582300,COGS 9,A01,083615,Staff,1,16,60,59
1650593588323,COGS 11,A01,083617,Boyle; Mary E. T.,18,0,40,22
1650593594347,COGS 13,A01,083071,Staff,0,37,40,40
1650593600378,COGS 14A,A01,092681,Staff,0,29,100,100
1650593606405,COGS 14B,A01,083073,Cheng; Tzu-Han,0,13,50,50
1650593612433,COGS 17,A01,092677,Staff,17,0,75,58
1650593618460,COGS 100,A01,083619,Staff,1,26,60,59
1650593624489,COGS 101A,A01,083621,Davis; Joshua Daniel,0,26,60,60
1650593630522,COGS 101B,A01,091572,Staff,1,5,60,59
1650593636546,COGS 101C,A01,083625,Delgado; Tania,15,0,30,15
1650593642572,COGS 107A,A01,083627,Boyle; Mary E. T.,0,14,60,60
1650593648600,COGS 118A,A01,083075,Staff,0,4,60,60
1650593654626,CSE 3,A50,083646,Miranda; Gregory Joseph,19,0,38,19
1650593654626,CSE 3,A51,083647,Miranda; Gregory Joseph,36,0,37,1
1650593660654,CSE 8A,A50,083650,Miranda; Gregory Joseph,0,30,40,40
1650593666678,CSE 11,A01,083080,Cao; Yingjun,0,96,40,40
1650593672702,CSE 12,A01,083652,Staff,0,20,100,100
1650593678727,CSE 15L,A01,083654,Staff,0,2,50,50
1650593678727,CSE 15L,A02,083655,Staff,0,1,50,50
1650593684763,CSE 20,A01,083657,Staff,51,0,80,29
1650593690787,CSE 30,A01,083084,Eldon; John,0,78,40,40
1650593696811,CSE 100,A01,083659,Cao; Yingjun,0,66,50,50
1650593702836,CSE 134B,A01,083661,Powell; Thomas Allan,0,35,65,65
1650593708871,CSE 140,A01,083663,Staff,1,8,75,74
1650593714982,CSE 140L,A01,083088,Eldon; John,1,14,75,74
1650593721012,CSE 175,A01,083665,Kumar; Rakesh,7,0,25,18
1650593727041,CSE 190,A00,092507,Dubnov; Shlomo,11,0,20,9
1650593733067,ECE 45,A01,083139,Staff,1,2,60,59
1650593739095,ECE 65,A50,083695,Staff,1,6,30,29
1650593745120,ECE 109,A01,091882,Touri; Behrouz,33,0,70,37
1650593751147,ECE 180,A00,083140,Abi Samra; Nicholas Camill,21,0,30,9
1650593751147,ECE 180,B00,083141,Abi Samra; Nicholas Camill,0,0,30,30
1650593757181,MATH 10A,A01,083735,Patchell; Gregory David,4,0,30,26
1650593757181,MATH 10A,A02,083736,Patchell; Gregory David,27,0,30,3
1650593757181,MATH 10A,A03,083737,Patchell; Gregory David,24,0,30,6
1650593763205,MATH 10B,A01,083207,Staff,0,9,30,30
1650593763205,MATH 10B,A02,083208,Staff,0,8,30,30
1650593763205,MATH 10B,B01,083739,Staff,11,0,30,19
1650593763205,MATH 10B,B02,083740,Staff,28,0,30,2
1650593769238,MATH 18,A01,083743,Staff,0,0,30,30
1650593769238,MATH 18,A02,083744,Staff,24,0,30,6
1650593769238,MATH 18,A03,083745,Staff,21,0,30,9
1650593769238,MATH 18,A04,083746,Staff,26,0,30,4
1650593769238,MATH 18,B01,083748,Staff,0,15,30,30
1650593769238,MATH 18,B02,083749,Staff,1,11,30,29
1650593769238,MATH 18,B03,083750,Staff,0,12,30,30
1650593769238,MATH 18,B04,083751,Staff,0,12,30,30
1650593775265,MATH 20A,A01,083754,Staff,21,0,40,19
1650593781291,MATH 20B,A01,083756,Staff,1,12,30,29
1650593781291,MATH 20B,A02,083757,Staff,0,12,30,30
1650593787319,MATH 20C,A01,083760,Staff,0,16,30,30
1650593787319,MATH 20C,A02,083761,Staff,2,14,30,28
1650593787319,MATH 20C,B01,083762,Staff,11,0,30,19
1650593787319,MATH 20C,B02,083763,Staff,28,0,30,2
1650593793346,MATH 20D,A01,083765,Staff,1,1,30,29
1650593793346,MATH 20D,A02,083766,Staff,8,0,30,22
1650593793346,MATH 20D,A03,083767,Staff,25,0,30,5
1650593799372,MATH 20E,A01,083771,Staff,5,0,30,25
1650593799372,MATH 20E,A02,083772,Staff,18,0,30,12
1650593799372,MATH 20E,B01,083773,Staff,0,0,30,30
1650593799372,MATH 20E,B02,083774,Staff,9,0,30,21
1650593805401,MATH 103A,A01,083777,Staff,0,15,30,30
1650593805401,MATH 103A,A02,083778,Staff,0,14,30,30
1650593805401,MATH 103A,B01,083779,Staff,0,13,30,30
1650593805401,MATH 103A,B02,083780,Staff,0,14,30,30
1650593811435,MATH 105,A01,085443,Staff,0,21,30,30
1650593817471,MATH 109,A01,083213,Anzaldo; Leesa B,1,7,30,29
1650593817471,MATH 109,A02,083214,Anzaldo; Leesa B,0,7,30,30
1650593817471,MATH 109,B01,083215,Anzaldo; Leesa B,0,5,30,30
1650593817471,MATH 109,B02,083216,Anzaldo; Leesa B,1,6,30,29
1650593823497,MATH 142A,A01,083219,Chow; Bennett,0,16,30,30
1650593823497,MATH 142A,A02,083220,Chow; Bennett,0,15,30,30
1650593823497,MATH 142A,B01,083221,Chow; Bennett,0,14,30,30
1650593823497,MATH 142A,B02,083222,Chow; Bennett,0,13,30,30
1650593829523,MATH 193A,A01,083224,Staff,1,6,30,29
1650593829523,MATH 193A,A02,083225,Staff,0,6,30,30
1650593829523,MATH 193A,A03,083781,Staff,0,6,30,30
1650593829523,MATH 193A,A04,083782,Staff,0,7,30,30
1650593835549,MATH 197,001,091859,McAuley; Julian John,9998,0,9999,1
1650593841618,COGS 9,A01,083615,Staff,1,16,60,59
1650593847644,COGS 11,A01,083617,Boyle; Mary E. T.,18,0,40,22
1650593853668,COGS 13,A01,083071,Staff,0,37,40,40
1650593859697,COGS 14A,A01,092681,Staff,0,29,100,100
1650593865723,COGS 14B,A01,083073,Cheng; Tzu-Han,0,13,50,50
1650593871745,COGS 17,A01,092677,Staff,17,0,75,58
1650593877769,COGS 100,A01,083619,Staff,1,26,60,59
1650593883794,COGS 101A,A01,083621,Davis; Joshua Daniel,0,26,60,60
1650593889834,COGS 101B,A01,091572,Staff,1,5,60,59
1650593895861,COGS 101C,A01,083625,Delgado; Tania,15,0,30,15
1650593901889,COGS 107A,A01,083627,Boyle; Mary E. T.,0,14,60,60
1650593907917,COGS 118A,A01,083075,Staff,0,4,60,60
1650593913944,CSE 3,A50,083646,Miranda; Gregory Joseph,19,0,38,19
1650593913944,CSE 3,A51,083647,Miranda; Gregory Joseph,36,0,37,1
1650593919969,CSE 8A,A50,083650,Miranda; Gregory Joseph,0,30,40,40
1650593925998,CSE 11,A01,083080,Cao; Yingjun,0,96,40,40
1650593932022,CSE 12,A01,083652,Staff,0,20,100,100
1650593938048,CSE 15L,A01,083654,Staff,0,2,50,50
1650593938048,CSE 15L,A02,083655,Staff,0,1,50,50
1650593944083,CSE 20,A01,083657,Staff,51,0,80,29
1650593950109,CSE 30,A01,083084,Eldon; John,0,78,40,40
1650593956134,CSE 100,A01,083659,Cao; Yingjun,0,66,50,50
1650593962157,CSE 134B,A01,083661,Powell; Thomas Allan,0,35,65,65
1650593968180,CSE 140,A01,083663,Staff,1,8,75,74
1650593974203,CSE 140L,A01,083088,Eldon; John,1,14,75,74
1650593980226,CSE 175,A01,083665,Kumar; Rakesh,7,0,25,18
1650593986250,CSE 190,A00,092507,Dubnov; Shlomo,11,0,20,9
1650593992276,ECE 45,A01,083139,Staff,1,2,60,59
1650593998305,ECE 65,A50,083695,Staff,1,6,30,29
1650594004330,ECE 109,A01,091882,Touri; Behrouz,33,0,70,37
1650594010357,ECE 180,A00,083140,Abi Samra; Nicholas Camill,21,0,30,9
1650594010357,ECE 180,B00,083141,Abi Samra; Nicholas Camill,0,0,30,30
1650594016389,MATH 10A,A01,083735,Patchell; Gregory David,4,0,30,26
1650594016389,MATH 10A,A02,083736,Patchell; Gregory David,27,0,30,3
1650594016389,MATH 10A,A03,083737,Patchell; Gregory David,24,0,30,6
1650594022412,MATH 10B,A01,083207,Staff,0,9,30,30
1650594022412,MATH 10B,A02,083208,Staff,0,8,30,30
1650594022412,MATH 10B,B01,083739,Staff,11,0,30,19
1650594022412,MATH 10B,B02,083740,Staff,28,0,30,2
1650594028440,MATH 18,A01,083743,Staff,0,0,30,30
1650594028440,MATH 18,A02,083744,Staff,24,0,30,6
1650594028440,MATH 18,A03,083745,Staff,21,0,30,9
1650594028440,MATH 18,A04,083746,Staff,26,0,30,4
1650594028440,MATH 18,B01,083748,Staff,0,15,30,30
1650594028440,MATH 18,B02,083749,Staff,1,11,30,29
1650594028440,MATH 18,B03,083750,Staff,0,12,30,30
1650594028440,MATH 18,B04,083751,Staff,0,12,30,30
1650594034473,MATH 20A,A01,083754,Staff,21,0,40,19
1650594040500,MATH 20B,A01,083756,Staff,1,12,30,29
1650594040500,MATH 20B,A02,083757,Staff,0,12,30,30
1650594046528,MATH 20C,A01,083760,Staff,0,16,30,30
1650594046528,MATH 20C,A02,083761,Staff,2,14,30,28
1650594046528,MATH 20C,B01,083762,Staff,11,0,30,19
1650594046528,MATH 20C,B02,083763,Staff,28,0,30,2
1650594052556,MATH 20D,A01,083765,Staff,1,1,30,29
1650594052556,MATH 20D,A02,083766,Staff,8,0,30,22
1650594052556,MATH 20D,A03,083767,Staff,25,0,30,5
1650594058581,MATH 20E,A01,083771,Staff,5,0,30,25
1650594058581,MATH 20E,A02,083772,Staff,18,0,30,12
1650594058581,MATH 20E,B01,083773,Staff,0,0,30,30
1650594058581,MATH 20E,B02,083774,Staff,9,0,30,21
1650594064609,MATH 103A,A01,083777,Staff,0,15,30,30
1650594064609,MATH 103A,A02,083778,Staff,0,14,30,30
1650594064609,MATH 103A,B01,083779,Staff,0,13,30,30
1650594064609,MATH 103A,B02,083780,Staff,0,14,30,30
1650594070634,MATH 105,A01,085443,Staff,0,21,30,30
1650594076659,MATH 109,A01,083213,Anzaldo; Leesa B,1,7,30,29
1650594076659,MATH 109,A02,083214,Anzaldo; Leesa B,0,7,30,30
1650594076659,MATH 109,B01,083215,Anzaldo; Leesa B,0,5,30,30
1650594076659,MATH 109,B02,083216,Anzaldo; Leesa B,1,6,30,29
1650594082686,MATH 142A,A01,083219,Chow; Bennett,0,16,30,30
1650594082686,MATH 142A,A02,083220,Chow; Bennett,0,15,30,30
1650594082686,MATH 142A,B01,083221,Chow; Bennett,0,14,30,30
1650594082686,MATH 142A,B02,083222,Chow; Bennett,0,13,30,30
1650594088711,MATH 193A,A01,083224,Staff,1,6,30,29
1650594088711,MATH 193A,A02,083225,Staff,0,6,30,30
1650594088711,MATH 193A,A03,083781,Staff,0,6,30,30
1650594088711,MATH 193A,A04,083782,Staff,0,7,30,30
1650594094744,MATH 197,001,091859,McAuley; Julian John,9998,0,9999,1
1650594100797,COGS 9,A01,083615,Staff,1,16,60,59
1650594106826,COGS 11,A01,083617,Boyle; Mary E. T.,18,0,40,22
1650594112854,COGS 13,A01,083071,Staff,0,37,40,40
1650594118881,COGS 14A,A01,092681,Staff,0,29,100,100
1650594124905,COGS 14B,A01,083073,Cheng; Tzu-Han,0,13,50,50
1650594130941,COGS 17,A01,092677,Staff,17,0,75,58
1650594136968,COGS 100,A01,083619,Staff,1,26,60,59
1650594142995,COGS 101A,A01,083621,Davis; Joshua Daniel,0,26,60,60
1650594149020,COGS 101B,A01,091572,Staff,1,5,60,59
1650594155050,COGS 101C,A01,083625,Delgado; Tania,15,0,30,15
1650594161074,COGS 107A,A01,083627,Boyle; Mary E. T.,0,14,60,60
1650594167098,COGS 118A,A01,083075,Staff,0,4,60,60
1650594173125,CSE 3,A50,083646,Miranda; Gregory Joseph,19,0,38,19
1650594173125,CSE 3,A51,083647,Miranda; Gregory Joseph,36,0,37,1
1650594179157,CSE 8A,A50,083650,Miranda; Gregory Joseph,0,30,40,40
1650594185180,CSE 11,A01,083080,Cao; Yingjun,0,96,40,40
1650594191204,CSE 12,A01,083652,Staff,0,20,100,100
1650594197250,CSE 15L,A01,083654,Staff,0,2,50,50
1650594197250,CSE 15L,A02,083655,Staff,0,1,50,50
1650594203276,CSE 20,A01,083657,Staff,51,0,80,29
1650594209301,CSE 30,A01,083084,Eldon; John,0,78,40,40
1650594215338,CSE 100,A01,083659,Cao; Yingjun,0,66,50,50
1650594221364,CSE 134B,A01,083661,Powell; Thomas Allan,0,35,65,65
1650594227384,CSE 140,A01,083663,Staff,1,8,75,74
1650594233411,CSE 140L,A01,083088,Eldon; John,1,14,75,74
1650594239446,CSE 175,A01,083665,Kumar; Rakesh,7,0,25,18
1650594245469,CSE 190,A00,092507,Dubnov; Shlomo,11,0,20,9
1650594251500,ECE 45,A01,083139,Staff,1,2,60,59
1650594257530,ECE 65,A50,083695,Staff,1,6,30,29
1650594263555,ECE 109,A01,091882,Touri; Behrouz,33,0,70,37
1650594269597,ECE 180,A00,083140,Abi Samra; Nicholas Camill,21,0,30,9
1650594269597,ECE 180,B00,083141,Abi Samra; Nicholas Camill,0,0,30,30
1650594275620,MATH 10A,A01,083735,Patchell; Gregory David,4,0,30,26
1650594275620,MATH 10A,A02,083736,Patchell; Gregory David,27,0,30,3
1650594275620,MATH 10A,A03,083737,Patchell; Gregory David,24,0,30,6
1650594281646,MATH 10B,A01,083207,Staff,0,9,30,30
1650594281646,MATH 10B,A02,083208,Staff,0,8,30,30
1650594281646,MATH 10B,B01,083739,Staff,11,0,30,19
1650594281646,MATH 10B,B02,083740,Staff,28,0,30,2
1650594287672,MATH 18,A01,083743,Staff,0,0,30,30
1650594287672,MATH 18,A02,083744,Staff,24,0,30,6
1650594287672,MATH 18,A03,083745,Staff,21,0,30,9
1650594287672,MATH 18,A04,083746,Staff,26,0,30,4
1650594287672,MATH 18,B01,083748,Staff,0,15,30,30
1650594287672,MATH 18,B02,083749,Staff,1,11,30,29
1650594287672,MATH 18,B03,083750,Staff,0,12,30,30
1650594287672,MATH 18,B04,083751,Staff,0,12,30,30
1650594293698,MATH 20A,A01,083754,Staff,21,0,40,19
1650594299722,MATH 20B,A01,083756,Staff,1,12,30,29
1650594299722,MATH 20B,A02,083757,Staff,0,12,30,30
1650594305750,MATH 20C,A01,083760,Staff,0,16,30,30
1650594305750,MATH 20C,A02,083761,Staff,2,14,30,28
1650594305750,MATH 20C,B01,083762,Staff,11,0,30,19
1650594305750,MATH 20C,B02,083763,Staff,28,0,30,2
1650594311869,MATH 20D,A01,083765,Staff,1,1,30,29
1650594311869,MATH 20D,A02,083766,Staff,8,0,30,22
1650594311869,MATH 20D,A03,083767,Staff,25,0,30,5
1650594317894,MATH 20E,A01,083771,Staff,5,0,30,25
1650594317894,MATH 20E,A02,083772,Staff,18,0,30,12
1650594317894,MATH 20E,B01,083773,Staff,0,0,30,30
1650594317894,MATH 20E,B02,083774,Staff,9,0,30,21
1650594323927,MATH 103A,A01,083777,Staff,0,15,30,30
1650594323927,MATH 103A,A02,083778,Staff,0,14,30,30
1650594323927,MATH 103A,B01,083779,Staff,0,13,30,30
1650594323927,MATH 103A,B02,083780,Staff,0,14,30,30
1650594329964,MATH 105,A01,085443,Staff,0,21,30,30
1650594335988,MATH 109,A01,083213,Anzaldo; Leesa B,1,7,30,29
1650594335988,MATH 109,A02,083214,Anzaldo; Leesa B,0,7,30,30
1650594335988,MATH 109,B01,083215,Anzaldo; Leesa B,0,5,30,30
1650594335988,MATH 109,B02,083216,Anzaldo; Leesa B,1,6,30,29
1650594342013,MATH 142A,A01,083219,Chow; Bennett,0,16,30,30
1650594342013,MATH 142A,A02,083220,Chow; Bennett,0,15,30,30
1650594342013,MATH 142A,B01,083221,Chow; Bennett,0,14,30,30
1650594342013,MATH 142A,B02,083222,Chow; Bennett,0,13,30,30
1650594348037,MATH 193A,A01,083224,Staff,1,6,30,29
1650594348037,MATH 193A,A02,083225,Staff,0,6,30,30
1650594348037,MATH 193A,A03,083781,Staff,0,6,30,30
1650594348037,MATH 193A,A04,083782,Staff,0,7,30,30
1650594354066,MATH 197,001,091859,McAuley; Julian John,9998,0,9999,1
1650594360117,COGS 9,A01,083615,Staff,1,16,60,59
1650594366143,COGS 11,A01,083617,Boyle; Mary E. T.,18,0,40,22
1650594372166,COGS 13,A01,083071,Staff,0,37,40,40
1650594378200,COGS 14A,A01,092681,Staff,0,29,100,100
1650594384224,COGS 14B,A01,083073,Cheng; Tzu-Han,0,13,50,50
1650594390249,COGS 17,A01,092677,Staff,17,0,75,58
1650594396275,COGS 100,A01,083619,Staff,1,26,60,59
1650594402298,COGS 101A,A01,083621,Davis; Joshua Daniel,0,26,60,60
1650594408322,COGS 101B,A01,091572,Staff,1,5,60,59
1650594414357,COGS 101C,A01,083625,Delgado; Tania,15,0,30,15
1650594420381,COGS 107A,A01,083627,Boyle; Mary E. T.,0,14,60,60
1650594426407,COGS 118A,A01,083075,Staff,0,4,60,60
1650594432433,CSE 3,A50,083646,Miranda; Gregory Joseph,19,0,38,19
1650594432433,CSE 3,A51,083647,Miranda; Gregory Joseph,36,0,37,1
1650594438456,CSE 8A,A50,083650,Miranda; Gregory Joseph,0,30,40,40
1650594444479,CSE 11,A01,083080,Cao; Yingjun,0,96,40,40
1650594450505,CSE 12,A01,083652,Staff,0,20,100,100
1650594456531,CSE 15L,A01,083654,Staff,0,2,50,50
1650594456531,CSE 15L,A02,083655,Staff,0,1,50,50
1650594462558,CSE 20,A01,083657,Staff,51,0,80,29
1650594468580,CSE 30,A01,083084,Eldon; John,0,78,40,40
1650594474604,CSE 100,A01,083659,Cao; Yingjun,0,67,50,50
1650594480631,CSE 134B,A01,083661,Powell; Thomas Allan,0,35,65,65
1650594486656,CSE 140,A01,083663,Staff,1,8,75,74
1650594492686,CSE 140L,A01,083088,Eldon; John,1,14,75,74
1650594498712,CSE 175,A01,083665,Kumar; Rakesh,7,0,25,18
1650594504744,CSE 190,A00,092507,Dubnov; Shlomo,11,0,20,9
1650594510776,ECE 45,A01,083139,Staff,1,2,60,59
1650594516799,ECE 65,A50,083695,Staff,1,6,30,29
1650594522823,ECE 109,A01,091882,Touri; Behrouz,33,0,70,37
1650594528854,ECE 180,A00,083140,Abi Samra; Nicholas Camill,21,0,30,9
1650594528854,ECE 180,B00,083141,Abi Samra; Nicholas Camill,0,0,30,30
1650594534886,MATH 10A,A01,083735,Patchell; Gregory David,4,0,30,26
1650594534886,MATH 10A,A02,083736,Patchell; Gregory David,27,0,30,3
1650594534886,MATH 10A,A03,083737,Patchell; Gregory David,24,0,30,6
1650594540915,MATH 10B,A01,083207,Staff,0,9,30,30
1650594540915,MATH 10B,A02,083208,Staff,0,8,30,30
1650594540915,MATH 10B,B01,083739,Staff,11,0,30,19
1650594540915,MATH 10B,B02,083740,Staff,28,0,30,2
1650594546943,MATH 18,A01,083743,Staff,0,0,30,30
1650594546943,MATH 18,A02,083744,Staff,24,0,30,6
1650594546943,MATH 18,A03,083745,Staff,21,0,30,9
1650594546943,MATH 18,A04,083746,Staff,26,0,30,4
1650594546943,MATH 18,B01,083748,Staff,0,15,30,30
1650594546943,MATH 18,B02,083749,Staff,1,11,30,29
1650594546943,MATH 18,B03,083750,Staff,0,12,30,30
1650594546943,MATH 18,B04,083751,Staff,0,12,30,30
1650594552969,MATH 20A,A01,083754,Staff,21,0,40,19
1650594559011,MATH 20B,A01,083756,Staff,1,12,30,29
1650594559011,MATH 20B,A02,083757,Staff,0,12,30,30
1650594565036,MATH 20C,A01,083760,Staff,0,16,30,30
1650594565036,MATH 20C,A02,083761,Staff,2,14,30,28
1650594565036,MATH 20C,B01,083762,Staff,11,0,30,19
1650594565036,MATH 20C,B02,083763,Staff,28,0,30,2
1650594571062,MATH 20D,A01,083765,Staff,1,1,30,29
1650594571062,MATH 20D,A02,083766,Staff,8,0,30,22
1650594571062,MATH 20D,A03,083767,Staff,25,0,30,5
1650594577085,MATH 20E,A01,083771,Staff,5,0,30,25
1650594577085,MATH 20E,A02,083772,Staff,18,0,30,12
1650594577085,MATH 20E,B01,083773,Staff,0,0,30,30
1650594577085,MATH 20E,B02,083774,Staff,9,0,30,21
1650594583114,MATH 103A,A01,083777,Staff,0,15,30,30
1650594583114,MATH 103A,A02,083778,Staff,0,14,30,30
1650594583114,MATH 103A,B01,083779,Staff,0,14,30,30
1650594583114,MATH 103A,B02,083780,Staff,0,14,30,30
1650594589140,MATH 105,A01,085443,Staff,0,21,30,30
1650594595164,MATH 109,A01,083213,Anzaldo; Leesa B,1,7,30,29
1650594595164,MATH 109,A02,083214,Anzaldo; Leesa B,0,7,30,30
1650594595164,MATH 109,B01,083215,Anzaldo; Leesa B,0,5,30,30
1650594595164,MATH 109,B02,083216,Anzaldo; Leesa B,1,6,30,29
1650594601193,MATH 142A,A01,083219,Chow; Bennett,0,16,30,30
1650594601193,MATH 142A,A02,083220,Chow; Bennett,0,15,30,30
1650594601193,MATH 142A,B01,083221,Chow; Bennett,0,14,30,30
1650594601193,MATH 142A,B02,083222,Chow; Bennett,0,13,30,30
1650594607218,MATH 193A,A01,083224,Staff,1,6,30,29
1650594607218,MATH 193A,A02,083225,Staff,0,6,30,30
1650594607218,MATH 193A,A03,083781,Staff,0,6,30,30
1650594607218,MATH 193A,A04,083782,Staff,0,7,30,30
1650594613242,MATH 197,001,091859,McAuley; Julian John,9998,0,9999,1
1650594619305,COGS 9,A01,083615,Staff,1,16,60,59
1650594625331,COGS 11,A01,083617,Boyle; Mary E. T.,18,0,40,22
1650594631361,COGS 13,A01,083071,Staff,0,37,40,40
1650594637387,COGS 14A,A01,092681,Staff,0,29,100,100
1650594643416,COGS 14B,A01,083073,Cheng; Tzu-Han,0,13,50,50
1650594649452,COGS 17,A01,092677,Staff,17,0,75,58
1650594655489,COGS 100,A01,083619,Staff,1,26,60,59
1650594661516,COGS 101A,A01,083621,Davis; Joshua Daniel,0,26,60,60
1650594667539,COGS 101B,A01,091572,Staff,1,5,60,59
1650594673568,COGS 101C,A01,083625,Delgado; Tania,15,0,30,15
1650594679592,COGS 107A,A01,083627,Boyle; Mary E. T.,0,14,60,60
1650594685615,COGS 118A,A01,083075,Staff,0,4,60,60
1650594691639,CSE 3,A50,083646,Miranda; Gregory Joseph,19,0,38,19
1650594691639,CSE 3,A51,083647,Miranda; Gregory Joseph,36,0,37,1
1650594697666,CSE 8A,A50,083650,Miranda; Gregory Joseph,0,30,40,40
1650594703695,CSE 11,A01,083080,Cao; Yingjun,0,96,40,40
1650594709720,CSE 12,A01,083652,Staff,0,20,100,100
1650594715745,CSE 15L,A01,083654,Staff,0,2,50,50
1650594715745,CSE 15L,A02,083655,Staff,0,1,50,50
1650594721769,CSE 20,A01,083657,Staff,51,0,80,29
1650594727810,CSE 30,A01,083084,Eldon; John,0,78,40,40
1650594733837,CSE 100,A01,083659,Cao; Yingjun,0,67,50,50
1650594739860,CSE 134B,A01,083661,Powell; Thomas Allan,0,35,65,65
1650594745883,CSE 140,A01,083663,Staff,1,8,75,74
1650594751909,CSE 140L,A01,083088,Eldon; John,1,14,75,74
1650594757933,CSE 175,A01,083665,Kumar; Rakesh,7,0,25,18
1650594763957,CSE 190,A00,092507,Dubnov; Shlomo,11,0,20,9
1650594769980,ECE 45,A01,083139,Staff,1,2,60,59
1650594776009,ECE 65,A50,083695,Staff,1,6,30,29
1650594782032,ECE 109,A01,091882,Touri; Behrouz,33,0,70,37
1650594788057,ECE 180,A00,083140,Abi Samra; Nicholas Camill,21,0,30,9
1650594788057,ECE 180,B00,083141,Abi Samra; Nicholas Camill,0,0,30,30
1650594794083,MATH 10A,A01,083735,Patchell; Gregory David,4,0,30,26
1650594794083,MATH 10A,A02,083736,Patchell; Gregory David,27,0,30,3
1650594794083,MATH 10A,A03,083737,Patchell; Gregory David,24,0,30,6
1650594800114,MATH 10B,A01,083207,Staff,0,9,30,30
1650594800114,MATH 10B,A02,083208,Staff,0,8,30,30
1650594800114,MATH 10B,B01,083739,Staff,11,0,30,19
1650594800114,MATH 10B,B02,083740,Staff,28,0,30,2
1650594806144,MATH 18,A01,083743,Staff,0,0,30,30
1650594806144,MATH 18,A02,083744,Staff,24,0,30,6
1650594806144,MATH 18,A03,083745,Staff,21,0,30,9
1650594806144,MATH 18,A04,083746,Staff,26,0,30,4
1650594806144,MATH 18,B01,083748,Staff,0,15,30,30
1650594806144,MATH 18,B02,083749,Staff,1,11,30,29
1650594806144,MATH 18,B03,083750,Staff,0,12,30,30
1650594806144,MATH 18,B04,083751,Staff,0,12,30,30
1650594812181,MATH 20A,A01,083754,Staff,21,0,40,19
1650594818208,MATH 20B,A01,083756,Staff,1,12,30,29
1650594818208,MATH 20B,A02,083757,Staff,0,12,30,30
1650594824236,MATH 20C,A01,083760,Staff,0,16,30,30
1650594824236,MATH 20C,A02,083761,Staff,2,14,30,28
1650594824236,MATH 20C,B01,083762,Staff,11,0,30,19
1650594824236,MATH 20C,B02,083763,Staff,28,0,30,2
1650594830262,MATH 20D,A01,083765,Staff,1,1,30,29
1650594830262,MATH 20D,A02,083766,Staff,8,0,30,22
1650594830262,MATH 20D,A03,083767,Staff,25,0,30,5
1650594836290,MATH 20E,A01,083771,Staff,5,0,30,25
1650594836290,MATH 20E,A02,083772,Staff,18,0,30,12
1650594836290,MATH 20E,B01,083773,Staff,0,0,30,30
1650594836290,MATH 20E,B02,083774,Staff,9,0,30,21
1650594842314,MATH 103A,A01,083777,Staff,0,15,30,30
1650594842314,MATH 103A,A02,083778,Staff,0,14,30,30
1650594842314,MATH 103A,B01,083779,Staff,0,14,30,30
1650594842314,MATH 103A,B02,083780,Staff,0,14,30,30
1650594848338,MATH 105,A01,085443,Staff,0,21,30,30
1650594854374,MATH 109,A01,083213,Anzaldo; Leesa B,1,7,30,29
1650594854374,MATH 109,A02,083214,Anzaldo; Leesa B,0,7,30,30
1650594854374,MATH 109,B01,083215,Anzaldo; Leesa B,0,5,30,30
1650594854374,MATH 109,B02,083216,Anzaldo; Leesa B,1,6,30,29
1650594860398,MATH 142A,A01,083219,Chow; Bennett,0,16,30,30
1650594860398,MATH 142A,A02,083220,Chow; Bennett,0,15,30,30
1650594860398,MATH 142A,B01,083221,Chow; Bennett,0,14,30,30
1650594860398,MATH 142A,B02,083222,Chow; Bennett,0,13,30,30
1650594866423,MATH 193A,A01,083224,Staff,1,6,30,29
1650594866423,MATH 193A,A02,083225,Staff,0,6,30,30
1650594866423,MATH 193A,A03,083781,Staff,0,6,30,30
1650594866423,MATH 193A,A04,083782,Staff,0,7,30,30
1650594872453,MATH 197,001,091859,McAuley; Julian John,9998,0,9999,1
1650594878519,COGS 9,A01,083615,Staff,1,16,60,59
1650594884552,COGS 11,A01,083617,Boyle; Mary E. T.,18,0,40,22
1650594890582,COGS 13,A01,083071,Staff,0,37,40,40
1650594896605,COGS 14A,A01,092681,Staff,0,29,100,100
1650594902736,COGS 14B,A01,083073,Cheng; Tzu-Han,0,13,50,50
1650594908764,COGS 17,A01,092677,Staff,17,0,75,58
1650594914797,COGS 100,A01,083619,Staff,1,26,60,59
1650594920825,COGS 101A,A01,083621,Davis; Joshua Daniel,0,26,60,60
1650594926851,COGS 101B,A01,091572,Staff,1,5,60,59
1650594932871,COGS 101C,A01,083625,Delgado; Tania,15,0,30,15
1650594938895,COGS 107A,A01,083627,Boyle; Mary E. T.,0,14,60,60
1650594944919,COGS 118A,A01,083075,Staff,0,4,60,60
1650594950957,CSE 3,A50,083646,Miranda; Gregory Joseph,19,0,38,19
1650594950957,CSE 3,A51,083647,Miranda; Gregory Joseph,36,0,37,1
1650594956982,CSE 8A,A50,083650,Miranda; Gregory Joseph,0,30,40,40
1650594963009,CSE 11,A01,083080,Cao; Yingjun,0,96,40,40
1650594969039,CSE 12,A01,083652,Staff,0,20,100,100
1650594975062,CSE 15L,A01,083654,Staff,0,2,50,50
1650594975062,CSE 15L,A02,083655,Staff,0,1,50,50
1650594981085,CSE 20,A01,083657,Staff,51,0,80,29
1650594987107,CSE 30,A01,083084,Eldon; John,0,78,40,40
1650594993140,CSE 100,A01,083659,Cao; Yingjun,0,67,50,50
1650594999164,CSE 134B,A01,083661,Powell; Thomas Allan,0,35,65,65
1650595005187,CSE 140,A01,083663,Staff,1,8,75,74
1650595011217,CSE 140L,A01,083088,Eldon; John,1,14,75,74
1650595017238,CSE 175,A01,083665,Kumar; Rakesh,7,0,25,18
1650595023265,CSE 190,A00,092507,Dubnov; Shlomo,11,0,20,9
1650595029289,ECE 45,A01,083139,Staff,1,2,60,59
1650595035311,ECE 65,A50,083695,Staff,1,6,30,29
1650595041335,ECE 109,A01,091882,Touri; Behrouz,33,0,70,37
1650595047361,ECE 180,A00,083140,Abi Samra; Nicholas Camill,21,0,30,9
1650595047361,ECE 180,B00,083141,Abi Samra; Nicholas Camill,0,0,30,30
1650595053389,MATH 10A,A01,083735,Patchell; Gregory David,4,0,30,26
1650595053389,MATH 10A,A02,083736,Patchell; Gregory David,27,0,30,3
1650595053389,MATH 10A,A03,083737,Patchell; Gregory David,24,0,30,6
1650595059417,MATH 10B,A01,083207,Staff,0,9,30,30
1650595059417,MATH 10B,A02,083208,Staff,0,8,30,30
1650595059417,MATH 10B,B01,083739,Staff,11,0,30,19
1650595059417,MATH 10B,B02,083740,Staff,28,0,30,2
1650595065445,MATH 18,A01,083743,Staff,0,0,30,30
1650595065445,MATH 18,A02,083744,Staff,24,0,30,6
1650595065445,MATH 18,A03,083745,Staff,21,0,30,9
1650595065445,MATH 18,A04,083746,Staff,26,0,30,4
1650595065445,MATH 18,B01,083748,Staff,0,15,30,30
1650595065445,MATH 18,B02,083749,Staff,1,11,30,29
1650595065445,MATH 18,B03,083750,Staff,0,12,30,30
1650595065445,MATH 18,B04,083751,Staff,0,12,30,30
1650595071470,MATH 20A,A01,083754,Staff,21,0,40,19
1650595077492,MATH 20B,A01,083756,Staff,1,12,30,29
1650595077492,MATH 20B,A02,083757,Staff,0,12,30,30
1650595083518,MATH 20C,A01,083760,Staff,0,16,30,30
1650595083518,MATH 20C,A02,083761,Staff,2,14,30,28
1650595083518,MATH 20C,B01,083762,Staff,11,0,30,19
1650595083518,MATH 20C,B02,083763,Staff,28,0,30,2
1650595089542,MATH 20D,A01,083765,Staff,1,1,30,29
1650595089542,MATH 20D,A02,083766,Staff,8,0,30,22
1650595089542,MATH 20D,A03,083767,Staff,25,0,30,5
1650595095564,MATH 20E,A01,083771,Staff,5,0,30,25
1650595095564,MATH 20E,A02,083772,Staff,18,0,30,12
1650595095564,MATH 20E,B01,083773,Staff,0,0,30,30
1650595095564,MATH 20E,B02,083774,Staff,9,0,30,21
1650595101592,MATH 103A,A01,083777,Staff,0,15,30,30
1650595101592,MATH 103A,A02,083778,Staff,0,14,30,30
1650595101592,MATH 103A,B01,083779,Staff,0,14,30,30
1650595101592,MATH 103A,B02,083780,Staff,0,14,30,30
1650595107617,MATH 105,A01,085443,Staff,0,21,30,30
1650595113644,MATH 109,A01,083213,Anzaldo; Leesa B,1,7,30,29
1650595113644,MATH 109,A02,083214,Anzaldo; Leesa B,0,7,30,30
1650595113644,MATH 109,B01,083215,Anzaldo; Leesa B,0,5,30,30
1650595113644,MATH 109,B02,083216,Anzaldo; Leesa B,1,6,30,29
1650595119670,MATH 142A,A01,083219,Chow; Bennett,0,16,30,30
1650595119670,MATH 142A,A02,083220,Chow; Bennett,0,15,30,30
1650595119670,MATH 142A,B01,083221,Chow; Bennett,0,14,30,30
1650595119670,MATH 142A,B02,083222,Chow; Bennett,0,13,30,30
1650595125698,MATH 193A,A01,083224,Staff,1,6,30,29
1650595125698,MATH 193A,A02,083225,Staff,0,6,30,30
1650595125698,MATH 193A,A03,083781,Staff,0,6,30,30
1650595125698,MATH 193A,A04,083782,Staff,0,7,30,30
1650595131721,MATH 197,001,091859,McAuley; Julian John,9998,0,9999,1
1650595137778,COGS 9,A01,083615,Staff,1,16,60,59
1650595143807,COGS 11,A01,083617,Boyle; Mary E. T.,18,0,40,22
1650595149832,COGS 13,A01,083071,Staff,0,37,40,40
1650595155854,COGS 14A,A01,092681,Staff,0,29,100,100
1650595161881,COGS 14B,A01,083073,Cheng; Tzu-Han,0,13,50,50
1650595167908,COGS 17,A01,092677,Staff,16,0,75,59
1650595173938,COGS 100,A01,083619,Staff,1,26,60,59
1650595179965,COGS 101A,A01,083621,Davis; Joshua Daniel,0,26,60,60
1650595185990,COGS 101B,A01,091572,Staff,1,5,60,59
1650595192016,COGS 101C,A01,083625,Delgado; Tania,15,0,30,15
1650595198051,COGS 107A,A01,083627,Boyle; Mary E. T.,0,14,60,60
1650595204079,COGS 118A,A01,083075,Staff,0,4,60,60
1650595210107,CSE 3,A50,083646,Miranda; Gregory Joseph,19,0,38,19
1650595210107,CSE 3,A51,083647,Miranda; Gregory Joseph,36,0,37,1
1650595216131,CSE 8A,A50,083650,Miranda; Gregory Joseph,0,30,40,40
1650595222157,CSE 11,A01,083080,Cao; Yingjun,0,96,40,40
1650595228183,CSE 12,A01,083652,Staff,0,20,100,100
1650595234207,CSE 15L,A01,083654,Staff,0,2,50,50
1650595234207,CSE 15L,A02,083655,Staff,0,1,50,50
1650595240233,CSE 20,A01,083657,Staff,51,0,80,29
1650595246255,CSE 30,A01,083084,Eldon; John,0,78,40,40
1650595252280,CSE 100,A01,083659,Cao; Yingjun,0,67,50,50
1650595258304,CSE 134B,A01,083661,Powell; Thomas Allan,0,35,65,65
1650595264328,CSE 140,A01,083663,Staff,1,8,75,74
1650595279524,CSE 140L,A01,083088,Eldon; John,1,14,75,74
1650595285549,CSE 175,A01,083665,Kumar; Rakesh,7,0,25,18
1650595291571,CSE 190,A00,092507,Dubnov; Shlomo,11,0,20,9
1650595297603,ECE 45,A01,083139,Staff,1,2,60,59
1650595303627,ECE 65,A50,083695,Staff,1,6,30,29
1650595309649,ECE 109,A01,091882,Touri; Behrouz,33,0,70,37
1650595315679,ECE 180,A00,083140,Abi Samra; Nicholas Camill,21,0,30,9
1650595315679,ECE 180,B00,083141,Abi Samra; Nicholas Camill,0,0,30,30
1650595321712,MATH 10A,A01,083735,Patchell; Gregory David,4,0,30,26
1650595321712,MATH 10A,A02,083736,Patchell; Gregory David,27,0,30,3
1650595321712,MATH 10A,A03,083737,Patchell; Gregory David,24,0,30,6
1650595327750,MATH 10B,A01,083207,Staff,0,9,30,30
1650595327750,MATH 10B,A02,083208,Staff,0,8,30,30
1650595327750,MATH 10B,B01,083739,Staff,11,0,30,19
1650595327750,MATH 10B,B02,083740,Staff,28,0,30,2
1650595333781,MATH 18,A01,083743,Staff,0,0,30,30
1650595333781,MATH 18,A02,083744,Staff,24,0,30,6
1650595333781,MATH 18,A03,083745,Staff,21,0,30,9
1650595333781,MATH 18,A04,083746,Staff,26,0,30,4
1650595333781,MATH 18,B01,083748,Staff,0,15,30,30
1650595333781,MATH 18,B02,083749,Staff,1,11,30,29
1650595333781,MATH 18,B03,083750,Staff,0,12,30,30
1650595333781,MATH 18,B04,083751,Staff,0,12,30,30
1650595339805,MATH 20A,A01,083754,Staff,21,0,40,19
1650595345832,MATH 20B,A01,083756,Staff,1,12,30,29
1650595345832,MATH 20B,A02,083757,Staff,0,12,30,30
1650595351859,MATH 20C,A01,083760,Staff,0,16,30,30
1650595351859,MATH 20C,A02,083761,Staff,2,14,30,28
1650595351859,MATH 20C,B01,083762,Staff,11,0,30,19
1650595351859,MATH 20C,B02,083763,Staff,28,0,30,2
1650595357885,MATH 20D,A01,083765,Staff,1,1,30,29
1650595357885,MATH 20D,A02,083766,Staff,8,0,30,22
1650595357885,MATH 20D,A03,083767,Staff,25,0,30,5
1650595363910,MATH 20E,A01,083771,Staff,5,0,30,25
1650595363910,MATH 20E,A02,083772,Staff,18,0,30,12
1650595363910,MATH 20E,B01,083773,Staff,0,0,30,30
1650595363910,MATH 20E,B02,083774,Staff,9,0,30,21
1650595369934,MATH 103A,A01,083777,Staff,0,15,30,30
1650595369934,MATH 103A,A02,083778,Staff,0,14,30,30
1650595369934,MATH 103A,B01,083779,Staff,0,14,30,30
1650595369934,MATH 103A,B02,083780,Staff,0,14,30,30
1650595375957,MATH 105,A01,085443,Staff,0,21,30,30
1650595381988,MATH 109,A01,083213,Anzaldo; Leesa B,1,7,30,29
1650595381988,MATH 109,A02,083214,Anzaldo; Leesa B,0,7,30,30
1650595381988,MATH 109,B01,083215,Anzaldo; Leesa B,0,5,30,30
1650595381988,MATH 109,B02,083216,Anzaldo; Leesa B,1,6,30,29
1650595388016,MATH 142A,A01,083219,Chow; Bennett,0,16,30,30
1650595388016,MATH 142A,A02,083220,Chow; Bennett,0,15,30,30
1650595388016,MATH 142A,B01,083221,Chow; Bennett,0,14,30,30
1650595388016,MATH 142A,B02,083222,Chow; Bennett,0,13,30,30
1650595394043,MATH 193A,A01,083224,Staff,1,6,30,29
1650595394043,MATH 193A,A02,083225,Staff,0,6,30,30
1650595394043,MATH 193A,A03,083781,Staff,0,6,30,30
1650595394043,MATH 193A,A04,083782,Staff,0,7,30,30
1650595400066,MATH 197,001,091859,McAuley; Julian John,9998,0,9999,1
1650595406131,COGS 9,A01,083615,Staff,1,16,60,59
1650595412155,COGS 11,A01,083617,Boyle; Mary E. T.,18,0,40,22
1650595418178,COGS 13,A01,083071,Staff,0,37,40,40
1650595424201,COGS 14A,A01,092681,Staff,0,29,100,100
1650595430227,COGS 14B,A01,083073,Cheng; Tzu-Han,0,13,50,50
1650595436250,COGS 17,A01,092677,Staff,16,0,75,59
1650595442272,COGS 100,A01,083619,Staff,1,26,60,59
1650595448296,COGS 101A,A01,083621,Davis; Joshua Daniel,0,26,60,60
1650595454319,COGS 101B,A01,091572,Staff,1,5,60,59
1650595460351,COGS 101C,A01,083625,Delgado; Tania,15,0,30,15
1650595466376,COGS 107A,A01,083627,Boyle; Mary E. T.,0,14,60,60
1650595472403,COGS 118A,A01,083075,Staff,0,4,60,60
1650595478427,CSE 3,A50,083646,Miranda; Gregory Joseph,19,0,38,19
1650595478427,CSE 3,A51,083647,Miranda; Gregory Joseph,36,0,37,1
1650595484451,CSE 8A,A50,083650,Miranda; Gregory Joseph,0,30,40,40
1650595490485,CSE 11,A01,083080,Cao; Yingjun,0,96,40,40
1650595496508,CSE 12,A01,083652,Staff,0,20,100,100
1650595502531,CSE 15L,A01,083654,Staff,0,2,50,50
1650595502531,CSE 15L,A02,083655,Staff,0,1,50,50
1650595508654,CSE 20,A01,083657,Staff,51,0,80,29
1650595514678,CSE 30,A01,083084,Eldon; John,0,78,40,40
1650595520713,CSE 100,A01,083659,Cao; Yingjun,0,67,50,50
1650595526737,CSE 134B,A01,083661,Powell; Thomas Allan,0,35,65,65
1650595532763,CSE 140,A01,083663,Staff,1,8,75,74
1650595538801,CSE 140L,A01,083088,Eldon; John,1,14,75,74
1650595544827,CSE 175,A01,083665,Kumar; Rakesh,7,0,25,18
1650595550858,CSE 190,A00,092507,Dubnov; Shlomo,11,0,20,9
1650595556883,ECE 45,A01,083139,Staff,1,2,60,59
1650595562906,ECE 65,A50,083695,Staff,1,6,30,29
1650595568930,ECE 109,A01,091882,Touri; Behrouz,33,0,70,37
1650595574956,ECE 180,A00,083140,Abi Samra; Nicholas Camill,21,0,30,9
1650595574956,ECE 180,B00,083141,Abi Samra; Nicholas Camill,0,0,30,30
1650595580991,MATH 10A,A01,083735,Patchell; Gregory David,4,0,30,26
1650595580991,MATH 10A,A02,083736,Patchell; Gregory David,27,0,30,3
1650595580991,MATH 10A,A03,083737,Patchell; Gregory David,24,0,30,6
1650595587021,MATH 10B,A01,083207,Staff,0,9,30,30
1650595587021,MATH 10B,A02,083208,Staff,0,8,30,30
1650595587021,MATH 10B,B01,083739,Staff,11,0,30,19
1650595587021,MATH 10B,B02,083740,Staff,28,0,30,2
1650595593045,MATH 18,A01,083743,Staff,0,0,30,30
1650595593045,MATH 18,A02,083744,Staff,24,0,30,6
1650595593045,MATH 18,A03,083745,Staff,21,0,30,9
1650595593045,MATH 18,A04,083746,Staff,26,0,30,4
1650595593045,MATH 18,B01,083748,Staff,0,15,30,30
1650595593045,MATH 18,B02,083749,Staff,1,11,30,29
1650595593045,MATH 18,B03,083750,Staff,0,12,30,30
1650595593045,MATH 18,B04,083751,Staff,0,12,30,30
1650595599083,MATH 20A,A01,083754,Staff,21,0,40,19
1650595605109,MATH 20B,A01,083756,Staff,1,12,30,29
1650595605109,MATH 20B,A02,083757,Staff,0,12,30,30
1650595611138,MATH 20C,A01,083760,Staff,0,16,30,30
1650595611138,MATH 20C,A02,083761,Staff,2,14,30,28
1650595611138,MATH 20C,B01,083762,Staff,11,0,30,19
1650595611138,MATH 20C,B02,083763,Staff,28,0,30,2
1650595617164,MATH 20D,A01,083765,Staff,1,1,30,29
1650595617164,MATH 20D,A02,083766,Staff,8,0,30,22
1650595617164,MATH 20D,A03,083767,Staff,25,0,30,5
1650595623188,MATH 20E,A01,083771,Staff,5,0,30,25
1650595623188,MATH 20E,A02,083772,Staff,18,0,30,12
1650595623188,MATH 20E,B01,083773,Staff,0,0,30,30
1650595623188,MATH 20E,B02,083774,Staff,9,0,30,21
1650595629224,MATH 103A,A01,083777,Staff,0,15,30,30
1650595629224,MATH 103A,A02,083778,Staff,0,14,30,30
1650595629224,MATH 103A,B01,083779,Staff,0,14,30,30
1650595629224,MATH 103A,B02,083780,Staff,0,14,30,30
1650595635249,MATH 105,A01,085443,Staff,0,21,30,30
1650595641284,MATH 109,A01,083213,Anzaldo; Leesa B,1,7,30,29
1650595641284,MATH 109,A02,083214,Anzaldo; Leesa B,0,7,30,30
1650595641284,MATH 109,B01,083215,Anzaldo; Leesa B,0,5,30,30
1650595641284,MATH 109,B02,083216,Anzaldo; Leesa B,1,6,30,29
1650595647309,MATH 142A,A01,083219,Chow; Bennett,0,16,30,30
1650595647309,MATH 142A,A02,083220,Chow; Bennett,0,15,30,30
1650595647309,MATH 142A,B01,083221,Chow; Bennett,0,14,30,30
1650595647309,MATH 142A,B02,083222,Chow; Bennett,0,13,30,30
1650595653334,MATH 193A,A01,083224,Staff,1,6,30,29
1650595653334,MATH 193A,A02,083225,Staff,0,6,30,30
1650595653334,MATH 193A,A03,083781,Staff,0,6,30,30
1650595653334,MATH 193A,A04,083782,Staff,0,7,30,30
1650595659356,MATH 197,001,091859,McAuley; Julian John,9998,0,9999,1
1650595665415,COGS 9,A01,083615,Staff,1,16,60,59
1650595671439,COGS 11,A01,083617,Boyle; Mary E. T.,18,0,40,22
1650595677464,COGS 13,A01,083071,Staff,0,37,40,40
1650595683489,COGS 14A,A01,092681,Staff,0,29,100,100
1650595689514,COGS 14B,A01,083073,Cheng; Tzu-Han,0,13,50,50
1650595695539,COGS 17,A01,092677,Staff,16,0,75,59
1650595701564,COGS 100,A01,083619,Staff,1,26,60,59
1650595707586,COGS 101A,A01,083621,Davis; Joshua Daniel,0,26,60,60
1650595713610,COGS 101B,A01,091572,Staff,1,5,60,59
1650595719632,COGS 101C,A01,083625,Delgado; Tania,15,0,30,15
1650595725656,COGS 107A,A01,083627,Boyle; Mary E. T.,0,14,60,60
1650595731742,COGS 118A,A01,083075,Staff,0,4,60,60
1650595737767,CSE 3,A50,083646,Miranda; Gregory Joseph,19,0,38,19
1650595737767,CSE 3,A51,083647,Miranda; Gregory Joseph,36,0,37,1
1650595743794,CSE 8A,A50,083650,Miranda; Gregory Joseph,0,30,40,40
1650595749816,CSE 11,A01,083080,Cao; Yingjun,0,96,40,40
1650595755847,CSE 12,A01,083652,Staff,0,20,100,100
1650595761874,CSE 15L,A01,083654,Staff,0,2,50,50
1650595761874,CSE 15L,A02,083655,Staff,0,1,50,50
1650595767897,CSE 20,A01,083657,Staff,51,0,80,29
1650595773924,CSE 30,A01,083084,Eldon; John,0,78,40,40
1650595779951,CSE 100,A01,083659,Cao; Yingjun,0,67,50,50
1650595785978,CSE 134B,A01,083661,Powell; Thomas Allan,0,35,65,65
1650595792017,CSE 140,A01,083663,Staff,1,8,75,74
1650595798051,CSE 140L,A01,083088,Eldon; John,1,14,75,74
1650595804075,CSE 175,A01,083665,Kumar; Rakesh,7,0,25,18
1650595810100,CSE 190,A00,092507,Dubnov; Shlomo,11,0,20,9
1650595816123,ECE 45,A01,083139,Staff,1,2,60,59
1650595822150,ECE 65,A50,083695,Staff,1,6,30,29
1650595828173,ECE 109,A01,091882,Touri; Behrouz,33,0,70,37
1650595834196,ECE 180,A00,083140,Abi Samra; Nicholas Camill,21,0,30,9
1650595834196,ECE 180,B00,083141,Abi Samra; Nicholas Camill,0,0,30,30
1650595840221,MATH 10A,A01,083735,Patchell; Gregory David,4,0,30,26
1650595840221,MATH 10A,A02,083736,Patchell; Gregory David,27,0,30,3
1650595840221,MATH 10A,A03,083737,Patchell; Gregory David,24,0,30,6
1650595846245,MATH 10B,A01,083207,Staff,0,9,30,30
1650595846245,MATH 10B,A02,083208,Staff,0,8,30,30
1650595846245,MATH 10B,B01,083739,Staff,11,0,30,19
1650595846245,MATH 10B,B02,083740,Staff,28,0,30,2
1650595852275,MATH 18,A01,083743,Staff,0,0,30,30
1650595852275,MATH 18,A02,083744,Staff,23,0,30,7
1650595852275,MATH 18,A03,083745,Staff,21,0,30,9
1650595852275,MATH 18,A04,083746,Staff,26,0,30,4
1650595852275,MATH 18,B01,083748,Staff,0,15,30,30
1650595852275,MATH 18,B02,083749,Staff,1,11,30,29
1650595852275,MATH 18,B03,083750,Staff,0,12,30,30
1650595852275,MATH 18,B04,083751,Staff,0,12,30,30
1650595858301,MATH 20A,A01,083754,Staff,21,0,40,19
1650595864329,MATH 20B,A01,083756,Staff,1,12,30,29
1650595864329,MATH 20B,A02,083757,Staff,0,12,30,30
1650595870357,MATH 20C,A01,083760,Staff,0,16,30,30
1650595870357,MATH 20C,A02,083761,Staff,2,14,30,28
1650595870357,MATH 20C,B01,083762,Staff,11,0,30,19
1650595870357,MATH 20C,B02,083763,Staff,28,0,30,2
1650595876381,MATH 20D,A01,083765,Staff,1,1,30,29
1650595876381,MATH 20D,A02,083766,Staff,8,0,30,22
1650595876381,MATH 20D,A03,083767,Staff,25,0,30,5
1650595882405,MATH 20E,A01,083771,Staff,5,0,30,25
1650595882405,MATH 20E,A02,083772,Staff,18,0,30,12
1650595882405,MATH 20E,B01,083773,Staff,0,0,30,30
1650595882405,MATH 20E,B02,083774,Staff,9,0,30,21
1650595888433,MATH 103A,A01,083777,Staff,0,15,30,30
1650595888433,MATH 103A,A02,083778,Staff,0,14,30,30
1650595888433,MATH 103A,B01,083779,Staff,0,14,30,30
1650595888433,MATH 103A,B02,083780,Staff,0,14,30,30
1650595894459,MATH 105,A01,085443,Staff,0,21,30,30
1650595900483,MATH 109,A01,083213,Anzaldo; Leesa B,1,7,30,29
1650595900483,MATH 109,A02,083214,Anzaldo; Leesa B,0,7,30,30
1650595900483,MATH 109,B01,083215,Anzaldo; Leesa B,0,5,30,30
1650595900483,MATH 109,B02,083216,Anzaldo; Leesa B,1,6,30,29
1650595906513,MATH 142A,A01,083219,Chow; Bennett,0,16,30,30
1650595906513,MATH 142A,A02,083220,Chow; Bennett,0,15,30,30
1650595906513,MATH 142A,B01,083221,Chow; Bennett,0,14,30,30
1650595906513,MATH 142A,B02,083222,Chow; Bennett,0,13,30,30
1650595912540,MATH 193A,A01,083224,Staff,1,6,30,29
1650595912540,MATH 193A,A02,083225,Staff,0,6,30,30
1650595912540,MATH 193A,A03,083781,Staff,0,6,30,30
1650595912540,MATH 193A,A04,083782,Staff,0,7,30,30
1650595918563,MATH 197,001,091859,McAuley; Julian John,9998,0,9999,1
1650595924620,COGS 9,A01,083615,Staff,1,16,60,59
1650595930643,COGS 11,A01,083617,Boyle; Mary E. T.,18,0,40,22
1650595936670,COGS 13,A01,083071,Staff,0,37,40,40
1650595942699,COGS 14A,A01,092681,Staff,0,29,100,100
1650595948730,COGS 14B,A01,083073,Cheng; Tzu-Han,0,13,50,50
1650595954754,COGS 17,A01,092677,Staff,16,0,75,59
1650595960780,COGS 100,A01,083619,Staff,1,26,60,59
1650595966805,COGS 101A,A01,083621,Davis; Joshua Daniel,0,26,60,60
1650595972840,COGS 101B,A01,091572,Staff,1,5,60,59
1650595978864,COGS 101C,A01,083625,Delgado; Tania,15,0,30,15
1650595984885,COGS 107A,A01,083627,Boyle; Mary E. T.,0,14,60,60
1650595990913,COGS 118A,A01,083075,Staff,0,4,60,60
1650595996946,CSE 3,A50,083646,Miranda; Gregory Joseph,19,0,38,19
1650595996946,CSE 3,A51,083647,Miranda; Gregory Joseph,36,0,37,1
1650596002970,CSE 8A,A50,083650,Miranda; Gregory Joseph,0,30,40,40
1650596008994,CSE 11,A01,083080,Cao; Yingjun,0,96,40,40
1650596015020,CSE 12,A01,083652,Staff,0,20,100,100
1650596021046,CSE 15L,A01,083654,Staff,0,2,50,50
1650596021046,CSE 15L,A02,083655,Staff,0,1,50,50
1650596027081,CSE 20,A01,083657,Staff,51,0,80,29
1650596033105,CSE 30,A01,083084,Eldon; John,0,78,40,40
1650596039127,CSE 100,A01,083659,Cao; Yingjun,0,67,50,50
1650596045164,CSE 134B,A01,083661,Powell; Thomas Allan,0,35,65,65
1650596051192,CSE 140,A01,083663,Staff,1,8,75,74
1650596057216,CSE 140L,A01,083088,Eldon; John,1,14,75,74
1650596063240,CSE 175,A01,083665,Kumar; Rakesh,7,0,25,18
1650596069264,CSE 190,A00,092507,Dubnov; Shlomo,11,0,20,9
1650596075288,ECE 45,A01,083139,Staff,1,2,60,59
1650596081311,ECE 65,A50,083695,Staff,1,6,30,29
1650596087341,ECE 109,A01,091882,Touri; Behrouz,33,0,70,37
1650596093369,ECE 180,A00,083140,Abi Samra; Nicholas Camill,21,0,30,9
1650596093369,ECE 180,B00,083141,Abi Samra; Nicholas Camill,0,0,30,30
1650596099394,MATH 10A,A01,083735,Patchell; Gregory David,4,0,30,26
1650596099394,MATH 10A,A02,083736,Patchell; Gregory David,27,0,30,3
1650596099394,MATH 10A,A03,083737,Patchell; Gregory David,24,0,30,6
1650596105500,MATH 10B,A01,083207,Staff,0,9,30,30
1650596105500,MATH 10B,A02,083208,Staff,0,8,30,30
1650596105500,MATH 10B,B01,083739,Staff,11,0,30,19
1650596105500,MATH 10B,B02,083740,Staff,28,0,30,2
1650596111529,MATH 18,A01,083743,Staff,0,0,30,30
1650596111529,MATH 18,A02,083744,Staff,23,0,30,7
1650596111529,MATH 18,A03,083745,Staff,21,0,30,9
1650596111529,MATH 18,A04,083746,Staff,26,0,30,4
1650596111529,MATH 18,B01,083748,Staff,0,15,30,30
1650596111529,MATH 18,B02,083749,Staff,1,11,30,29
1650596111529,MATH 18,B03,083750,Staff,0,12,30,30
1650596111529,MATH 18,B04,083751,Staff,0,12,30,30
1650596117564,MATH 20A,A01,083754,Staff,21,0,40,19
1650596123589,MATH 20B,A01,083756,Staff,1,12,30,29
1650596123589,MATH 20B,A02,083757,Staff,0,12,30,30
1650596129636,MATH 20C,A01,083760,Staff,0,16,30,30
1650596129636,MATH 20C,A02,083761,Staff,2,14,30,28
1650596129636,MATH 20C,B01,083762,Staff,11,0,30,19
1650596129636,MATH 20C,B02,083763,Staff,28,0,30,2
1650596135660,MATH 20D,A01,083765,Staff,1,1,30,29
1650596135660,MATH 20D,A02,083766,Staff,8,0,30,22
1650596135660,MATH 20D,A03,083767,Staff,25,0,30,5
1650596141684,MATH 20E,A01,083771,Staff,5,0,30,25
1650596141684,MATH 20E,A02,083772,Staff,18,0,30,12
1650596141684,MATH 20E,B01,083773,Staff,0,0,30,30
1650596141684,MATH 20E,B02,083774,Staff,9,0,30,21
1650596147716,MATH 103A,A01,083777,Staff,0,15,30,30
1650596147716,MATH 103A,A02,083778,Staff,0,14,30,30
1650596147716,MATH 103A,B01,083779,Staff,0,14,30,30
1650596147716,MATH 103A,B02,083780,Staff,0,14,30,30
1650596153741,MATH 105,A01,085443,Staff,0,21,30,30
1650596159780,MATH 109,A01,083213,Anzaldo; Leesa B,1,7,30,29
1650596159780,MATH 109,A02,083214,Anzaldo; Leesa B,0,7,30,30
1650596159780,MATH 109,B01,083215,Anzaldo; Leesa B,0,5,30,30
1650596159780,MATH 109,B02,083216,Anzaldo; Leesa B,1,6,30,29
1650596165808,MATH 142A,A01,083219,Chow; Bennett,0,16,30,30
1650596165808,MATH 142A,A02,083220,Chow; Bennett,0,15,30,30
1650596165808,MATH 142A,B01,083221,Chow; Bennett,0,14,30,30
1650596165808,MATH 142A,B02,083222,Chow; Bennett,0,13,30,30
1650596171836,MATH 193A,A01,083224,Staff,1,6,30,29
1650596171836,MATH 193A,A02,083225,Staff,0,6,30,30
1650596171836,MATH 193A,A03,083781,Staff,0,6,30,30
1650596171836,MATH 193A,A04,083782,Staff,0,7,30,30
1650596177859,MATH 197,001,091859,McAuley; Julian John,9998,0,9999,1
1650596183918,COGS 9,A01,083615,Staff,1,16,60,59
1650596189944,COGS 11,A01,083617,Boyle; Mary E. T.,18,0,40,22
1650596195977,COGS 13,A01,083071,Staff,0,37,40,40
1650596202000,COGS 14A,A01,092681,Staff,0,29,100,100
1650596208036,COGS 14B,A01,083073,Cheng; Tzu-Han,0,13,50,50
1650596214062,COGS 17,A01,092677,Staff,16,0,75,59
1650596220085,COGS 100,A01,083619,Staff,1,26,60,59
1650596226108,COGS 101A,A01,083621,Davis; Joshua Daniel,0,26,60,60
1650596232132,COGS 101B,A01,091572,Staff,1,5,60,59
1650596238153,COGS 101C,A01,083625,Delgado; Tania,15,0,30,15
1650596244179,COGS 107A,A01,083627,Boyle; Mary E. T.,0,14,60,60
1650596250203,COGS 118A,A01,083075,Staff,0,4,60,60
1650596256227,CSE 3,A50,083646,Miranda; Gregory Joseph,19,0,38,19
1650596256227,CSE 3,A51,083647,Miranda; Gregory Joseph,36,0,37,1
1650596262256,CSE 8A,A50,083650,Miranda; Gregory Joseph,0,30,40,40
1650596268283,CSE 11,A01,083080,Cao; Yingjun,0,96,40,40
1650596274309,CSE 12,A01,083652,Staff,0,20,100,100
1650596280333,CSE 15L,A01,083654,Staff,0,2,50,50
1650596280333,CSE 15L,A02,083655,Staff,0,1,50,50
1650596286369,CSE 20,A01,083657,Staff,51,0,80,29
1650596292395,CSE 30,A01,083084,Eldon; John,0,78,40,40
1650596298419,CSE 100,A01,083659,Cao; Yingjun,0,67,50,50
1650596304441,CSE 134B,A01,083661,Powell; Thomas Allan,0,35,65,65
1650596310467,CSE 140,A01,083663,Staff,1,8,75,74
1650596316490,CSE 140L,A01,083088,Eldon; John,1,14,75,74
1650596322514,CSE 175,A01,083665,Kumar; Rakesh,7,0,25,18
1650596328538,CSE 190,A00,092507,Dubnov; Shlomo,11,0,20,9
1650596334573,ECE 45,A01,083139,Staff,1,2,60,59
1650596340596,ECE 65,A50,083695,Staff,1,6,30,29
1650596346637,ECE 109,A01,091882,Touri; Behrouz,33,0,70,37
1650596352661,ECE 180,A00,083140,Abi Samra; Nicholas Camill,21,0,30,9
1650596352661,ECE 180,B00,083141,Abi Samra; Nicholas Camill,0,0,30,30
1650596358686,MATH 10A,A01,083735,Patchell; Gregory David,4,0,30,26
1650596358686,MATH 10A,A02,083736,Patchell; Gregory David,27,0,30,3
1650596358686,MATH 10A,A03,083737,Patchell; Gregory David,24,0,30,6
1650596364714,MATH 10B,A01,083207,Staff,0,9,30,30
1650596364714,MATH 10B,A02,083208,Staff,0,8,30,30
1650596364714,MATH 10B,B01,083739,Staff,11,0,30,19
1650596364714,MATH 10B,B02,083740,Staff,28,0,30,2
1650596370738,MATH 18,A01,083743,Staff,0,0,30,30
1650596370738,MATH 18,A02,083744,Staff,23,0,30,7
1650596370738,MATH 18,A03,083745,Staff,21,0,30,9
1650596370738,MATH 18,A04,083746,Staff,26,0,30,4
1650596370738,MATH 18,B01,083748,Staff,0,15,30,30
1650596370738,MATH 18,B02,083749,Staff,1,11,30,29
1650596370738,MATH 18,B03,083750,Staff,0,12,30,30
1650596370738,MATH 18,B04,083751,Staff,0,12,30,30
1650596376765,MATH 20A,A01,083754,Staff,20,0,40,20
1650596382789,MATH 20B,A01,083756,Staff,1,12,30,29
1650596382789,MATH 20B,A02,083757,Staff,0,12,30,30
1650596388812,MATH 20C,A01,083760,Staff,0,16,30,30
1650596388812,MATH 20C,A02,083761,Staff,2,14,30,28
1650596388812,MATH 20C,B01,083762,Staff,11,0,30,19
1650596388812,MATH 20C,B02,083763,Staff,28,0,30,2
1650596394835,MATH 20D,A01,083765,Staff,1,1,30,29
1650596394835,MATH 20D,A02,083766,Staff,8,0,30,22
1650596394835,MATH 20D,A03,083767,Staff,25,0,30,5
1650596400858,MATH 20E,A01,083771,Staff,5,0,30,25
1650596400858,MATH 20E,A02,083772,Staff,18,0,30,12
1650596400858,MATH 20E,B01,083773,Staff,0,0,30,30
1650596400858,MATH 20E,B02,083774,Staff,9,0,30,21
1650596406886,MATH 103A,A01,083777,Staff,0,15,30,30
1650596406886,MATH 103A,A02,083778,Staff,0,14,30,30
1650596406886,MATH 103A,B01,083779,Staff,0,14,30,30
1650596406886,MATH 103A,B02,083780,Staff,0,14,30,30
1650596412910,MATH 105,A01,085443,Staff,0,21,30,30
1650596418942,MATH 109,A01,083213,Anzaldo; Leesa B,1,7,30,29
1650596418942,MATH 109,A02,083214,Anzaldo; Leesa B,0,7,30,30
1650596418942,MATH 109,B01,083215,Anzaldo; Leesa B,0,5,30,30
1650596418942,MATH 109,B02,083216,Anzaldo; Leesa B,1,6,30,29
1650596424966,MATH 142A,A01,083219,Chow; Bennett,0,16,30,30
1650596424966,MATH 142A,A02,083220,Chow; Bennett,0,15,30,30
1650596424966,MATH 142A,B01,083221,Chow; Bennett,0,14,30,30
1650596424966,MATH 142A,B02,083222,Chow; Bennett,0,13,30,30
1650596431001,MATH 193A,A01,083224,Staff,1,6,30,29
1650596431001,MATH 193A,A02,083225,Staff,0,6,30,30
1650596431001,MATH 193A,A03,083781,Staff,0,6,30,30
1650596431001,MATH 193A,A04,083782,Staff,0,7,30,30
1650596437027,MATH 197,001,091859,McAuley; Julian John,9998,0,9999,1
1650596443083,COGS 9,A01,083615,Staff,1,16,60,59
1650596449106,COGS 11,A01,083617,Boyle; Mary E. T.,18,0,40,22
1650596455132,COGS 13,A01,083071,Staff,0,37,40,40
1650596461157,COGS 14A,A01,092681,Staff,0,29,100,100
1650596467181,COGS 14B,A01,083073,Cheng; Tzu-Han,0,13,50,50
1650596473204,COGS 17,A01,092677,Staff,16,0,75,59
1650596479230,COGS 100,A01,083619,Staff,1,26,60,59
1650596485264,COGS 101A,A01,083621,Davis; Joshua Daniel,0,26,60,60
1650596491290,COGS 101B,A01,091572,Staff,1,5,60,59
1650596497313,COGS 101C,A01,083625,Delgado; Tania,15,0,30,15
1650596503349,COGS 107A,A01,083627,Boyle; Mary E. T.,0,14,60,60
1650596509376,COGS 118A,A01,083075,Staff,0,4,60,60
1650596515403,CSE 3,A50,083646,Miranda; Gregory Joseph,19,0,38,19
1650596515403,CSE 3,A51,083647,Miranda; Gregory Joseph,36,0,37,1
1650596521431,CSE 8A,A50,083650,Miranda; Gregory Joseph,0,30,40,40
1650596527456,CSE 11,A01,083080,Cao; Yingjun,0,96,40,40
1650596533496,CSE 12,A01,083652,Staff,0,20,100,100
1650596539523,CSE 15L,A01,083654,Staff,0,2,50,50
1650596539523,CSE 15L,A02,083655,Staff,0,1,50,50
1650596545550,CSE 20,A01,083657,Staff,51,0,80,29
1650596551584,CSE 30,A01,083084,Eldon; John,0,78,40,40
1650596557606,CSE 100,A01,083659,Cao; Yingjun,0,67,50,50
1650596563629,CSE 134B,A01,083661,Powell; Thomas Allan,0,35,65,65
1650596569651,CSE 140,A01,083663,Staff,1,8,75,74
1650596575675,CSE 140L,A01,083088,Eldon; John,1,14,75,74
1650596581700,CSE 175,A01,083665,Kumar; Rakesh,7,0,25,18
1650596587732,CSE 190,A00,092507,Dubnov; Shlomo,11,0,20,9
1650596593755,ECE 45,A01,083139,Staff,1,2,60,59
1650596599781,ECE 65,A50,083695,Staff,1,6,30,29
1650596605804,ECE 109,A01,091882,Touri; Behrouz,33,0,70,37
1650596611826,ECE 180,A00,083140,Abi Samra; Nicholas Camill,21,0,30,9
1650596611826,ECE 180,B00,083141,Abi Samra; Nicholas Camill,0,0,30,30
1650596617849,MATH 10A,A01,083735,Patchell; Gregory David,4,0,30,26
1650596617849,MATH 10A,A02,083736,Patchell; Gregory David,27,0,30,3
1650596617849,MATH 10A,A03,083737,Patchell; Gregory David,24,0,30,6
1650596623873,MATH 10B,A01,083207,Staff,0,9,30,30
1650596623873,MATH 10B,A02,083208,Staff,0,8,30,30
1650596623873,MATH 10B,B01,083739,Staff,11,0,30,19
1650596623873,MATH 10B,B02,083740,Staff,28,0,30,2
1650596629905,MATH 18,A01,083743,Staff,0,0,30,30
1650596629905,MATH 18,A02,083744,Staff,23,0,30,7
1650596629905,MATH 18,A03,083745,Staff,21,0,30,9
1650596629905,MATH 18,A04,083746,Staff,26,0,30,4
1650596629905,MATH 18,B01,083748,Staff,0,15,30,30
1650596629905,MATH 18,B02,083749,Staff,1,11,30,29
1650596629905,MATH 18,B03,083750,Staff,0,12,30,30
1650596629905,MATH 18,B04,083751,Staff,0,12,30,30
1650596635928,MATH 20A,A01,083754,Staff,19,0,40,21
1650596641954,MATH 20B,A01,083756,Staff,1,12,30,29
1650596641954,MATH 20B,A02,083757,Staff,0,12,30,30
1650596647983,MATH 20C,A01,083760,Staff,0,16,30,30
1650596647983,MATH 20C,A02,083761,Staff,2,14,30,28
1650596647983,MATH 20C,B01,083762,Staff,11,0,30,19
1650596647983,MATH 20C,B02,083763,Staff,28,0,30,2
1650596654010,MATH 20D,A01,083765,Staff,1,1,30,29
1650596654010,MATH 20D,A02,083766,Staff,8,0,30,22
1650596654010,MATH 20D,A03,083767,Staff,25,0,30,5
1650596660035,MATH 20E,A01,083771,Staff,5,0,30,25
1650596660035,MATH 20E,A02,083772,Staff,18,0,30,12
1650596660035,MATH 20E,B01,083773,Staff,0,0,30,30
1650596660035,MATH 20E,B02,083774,Staff,9,0,30,21
1650596666059,MATH 103A,A01,083777,Staff,0,15,30,30
1650596666059,MATH 103A,A02,083778,Staff,0,14,30,30
1650596666059,MATH 103A,B01,083779,Staff,0,14,30,30
1650596666059,MATH 103A,B02,083780,Staff,0,14,30,30
1650596672082,MATH 105,A01,085443,Staff,0,21,30,30
1650596678110,MATH 109,A01,083213,Anzaldo; Leesa B,1,7,30,29
1650596678110,MATH 109,A02,083214,Anzaldo; Leesa B,0,7,30,30
1650596678110,MATH 109,B01,083215,Anzaldo; Leesa B,0,5,30,30
1650596678110,MATH 109,B02,083216,Anzaldo; Leesa B,1,6,30,29
1650596684136,MATH 142A,A01,083219,Chow; Bennett,0,16,30,30
1650596684136,MATH 142A,A02,083220,Chow; Bennett,0,15,30,30
1650596684136,MATH 142A,B01,083221,Chow; Bennett,0,14,30,30
1650596684136,MATH 142A,B02,083222,Chow; Bennett,0,13,30,30
1650596690160,MATH 193A,A01,083224,Staff,1,6,30,29
1650596690160,MATH 193A,A02,083225,Staff,0,6,30,30
1650596690160,MATH 193A,A03,083781,Staff,0,6,30,30
1650596690160,MATH 193A,A04,083782,Staff,0,7,30,30
1650596696183,MATH 197,001,091859,McAuley; Julian John,9998,0,9999,1
1650596702338,COGS 9,A01,083615,Staff,1,16,60,59
1650596708366,COGS 11,A01,083617,Boyle; Mary E. T.,18,0,40,22
1650596714394,COGS 13,A01,083071,Staff,0,37,40,40
1650596720423,COGS 14A,A01,092681,Staff,0,29,100,100
1650596726453,COGS 14B,A01,083073,Cheng; Tzu-Han,0,13,50,50
1650596732479,COGS 17,A01,092677,Staff,16,0,75,59
1650596738503,COGS 100,A01,083619,Staff,1,26,60,59
1650596744527,COGS 101A,A01,083621,Davis; Joshua Daniel,0,26,60,60
1650596750562,COGS 101B,A01,091572,Staff,1,5,60,59
1650596756584,COGS 101C,A01,083625,Delgado; Tania,15,0,30,15
1650596762607,COGS 107A,A01,083627,Boyle; Mary E. T.,0,14,60,60
1650596768629,COGS 118A,A01,083075,Staff,0,4,60,60
1650596774653,CSE 3,A50,083646,Miranda; Gregory Joseph,19,0,38,19
1650596774653,CSE 3,A51,083647,Miranda; Gregory Joseph,36,0,37,1
1650596780677,CSE 8A,A50,083650,Miranda; Gregory Joseph,0,30,40,40
1650596786704,CSE 11,A01,083080,Cao; Yingjun,0,96,40,40
1650596792728,CSE 12,A01,083652,Staff,0,20,100,100
1650596798751,CSE 15L,A01,083654,Staff,0,2,50,50
1650596798751,CSE 15L,A02,083655,Staff,0,1,50,50
1650596804774,CSE 20,A01,083657,Staff,51,0,80,29
1650596810802,CSE 30,A01,083084,Eldon; John,0,78,40,40
1650596816830,CSE 100,A01,083659,Cao; Yingjun,0,67,50,50
1650596822857,CSE 134B,A01,083661,Powell; Thomas Allan,0,35,65,65
1650596828893,CSE 140,A01,083663,Staff,1,8,75,74
1650596834915,CSE 140L,A01,083088,Eldon; John,1,14,75,74
1650596840954,CSE 175,A01,083665,Kumar; Rakesh,7,0,25,18
1650596846983,CSE 190,A00,092507,Dubnov; Shlomo,11,0,20,9
1650596853010,ECE 45,A01,083139,Staff,1,2,60,59
1650596859033,ECE 65,A50,083695,Staff,1,6,30,29
1650596865060,ECE 109,A01,091882,Touri; Behrouz,33,0,70,37
1650596871083,ECE 180,A00,083140,Abi Samra; Nicholas Camill,21,0,30,9
1650596871083,ECE 180,B00,083141,Abi Samra; Nicholas Camill,0,0,30,30
1650596877110,MATH 10A,A01,083735,Patchell; Gregory David,4,0,30,26
1650596877110,MATH 10A,A02,083736,Patchell; Gregory David,27,0,30,3
1650596877110,MATH 10A,A03,083737,Patchell; Gregory David,24,0,30,6
1650596883138,MATH 10B,A01,083207,Staff,0,9,30,30
1650596883138,MATH 10B,A02,083208,Staff,0,8,30,30
1650596883138,MATH 10B,B01,083739,Staff,11,0,30,19
1650596883138,MATH 10B,B02,083740,Staff,28,0,30,2
1650596889162,MATH 18,A01,083743,Staff,0,0,30,30
1650596889162,MATH 18,A02,083744,Staff,23,0,30,7
1650596889162,MATH 18,A03,083745,Staff,21,0,30,9
1650596889162,MATH 18,A04,083746,Staff,26,0,30,4
1650596889162,MATH 18,B01,083748,Staff,0,15,30,30
1650596889162,MATH 18,B02,083749,Staff,1,11,30,29
1650596889162,MATH 18,B03,083750,Staff,0,12,30,30
1650596889162,MATH 18,B04,083751,Staff,0,12,30,30
1650596895186,MATH 20A,A01,083754,Staff,19,0,40,21
1650596901210,MATH 20B,A01,083756,Staff,1,12,30,29
1650596901210,MATH 20B,A02,083757,Staff,0,12,30,30
1650596907247,MATH 20C,A01,083760,Staff,0,16,30,30
1650596907247,MATH 20C,A02,083761,Staff,2,14,30,28
1650596907247,MATH 20C,B01,083762,Staff,11,0,30,19
1650596907247,MATH 20C,B02,083763,Staff,28,0,30,2
1650596913271,MATH 20D,A01,083765,Staff,1,1,30,29
1650596913271,MATH 20D,A02,083766,Staff,8,0,30,22
1650596913271,MATH 20D,A03,083767,Staff,25,0,30,5
1650596919295,MATH 20E,A01,083771,Staff,5,0,30,25
1650596919295,MATH 20E,A02,083772,Staff,18,0,30,12
1650596919295,MATH 20E,B01,083773,Staff,0,0,30,30
1650596919295,MATH 20E,B02,083774,Staff,9,0,30,21
1650596925326,MATH 103A,A01,083777,Staff,0,15,30,30
1650596925326,MATH 103A,A02,083778,Staff,0,14,30,30
1650596925326,MATH 103A,B01,083779,Staff,0,14,30,30
1650596925326,MATH 103A,B02,083780,Staff,0,14,30,30
1650596931353,MATH 105,A01,085443,Staff,0,21,30,30
1650596937383,MATH 109,A01,083213,Anzaldo; Leesa B,1,7,30,29
1650596937383,MATH 109,A02,083214,Anzaldo; Leesa B,0,7,30,30
1650596937383,MATH 109,B01,083215,Anzaldo; Leesa B,0,5,30,30
1650596937383,MATH 109,B02,083216,Anzaldo; Leesa B,1,6,30,29
1650596943408,MATH 142A,A01,083219,Chow; Bennett,0,16,30,30
1650596943408,MATH 142A,A02,083220,Chow; Bennett,0,15,30,30
1650596943408,MATH 142A,B01,083221,Chow; Bennett,0,14,30,30
1650596943408,MATH 142A,B02,083222,Chow; Bennett,0,13,30,30
1650596949432,MATH 193A,A01,083224,Staff,1,6,30,29
1650596949432,MATH 193A,A02,083225,Staff,0,6,30,30
1650596949432,MATH 193A,A03,083781,Staff,0,6,30,30
1650596949432,MATH 193A,A04,083782,Staff,0,7,30,30
1650596955456,MATH 197,001,091859,McAuley; Julian John,9998,0,9999,1
1650596961502,COGS 9,A01,083615,Staff,1,16,60,59
1650596967529,COGS 11,A01,083617,Boyle; Mary E. T.,18,0,40,22
1650596973563,COGS 13,A01,083071,Staff,0,37,40,40
1650596979588,COGS 14A,A01,092681,Staff,0,29,100,100
1650596985609,COGS 14B,A01,083073,Cheng; Tzu-Han,0,13,50,50
1650596991634,COGS 17,A01,092677,Staff,16,0,75,59
1650596997660,COGS 100,A01,083619,Staff,1,26,60,59
1650597003687,COGS 101A,A01,083621,Davis; Joshua Daniel,0,26,60,60
1650597009715,COGS 101B,A01,091572,Staff,1,5,60,59
1650597015737,COGS 101C,A01,083625,Delgado; Tania,15,0,30,15
1650597021759,COGS 107A,A01,083627,Boyle; Mary E. T.,0,14,60,60
1650597027782,COGS 118A,A01,083075,Staff,0,4,60,60
1650597033807,CSE 3,A50,083646,Miranda; Gregory Joseph,19,0,38,19
1650597033807,CSE 3,A51,083647,Miranda; Gregory Joseph,36,0,37,1
1650597039830,CSE 8A,A50,083650,Miranda; Gregory Joseph,0,30,40,40
1650597045853,CSE 11,A01,083080,Cao; Yingjun,0,96,40,40
1650597051880,CSE 12,A01,083652,Staff,0,20,100,100
1650597057919,CSE 15L,A01,083654,Staff,0,2,50,50
1650597057919,CSE 15L,A02,083655,Staff,0,1,50,50
1650597063954,CSE 20,A01,083657,Staff,51,0,80,29
1650597069978,CSE 30,A01,083084,Eldon; John,0,78,40,40
1650597076002,CSE 100,A01,083659,Cao; Yingjun,0,67,50,50
1650597082034,CSE 134B,A01,083661,Powell; Thomas Allan,0,35,65,65
1650597088058,CSE 140,A01,083663,Staff,1,8,75,74
1650597094082,CSE 140L,A01,083088,Eldon; John,1,14,75,74
1650597100106,CSE 175,A01,083665,Kumar; Rakesh,7,0,25,18
1650597106130,CSE 190,A00,092507,Dubnov; Shlomo,11,0,20,9
1650597112160,ECE 45,A01,083139,Staff,1,2,60,59
1650597118199,ECE 65,A50,083695,Staff,1,6,30,29
1650597124224,ECE 109,A01,091882,Touri; Behrouz,33,0,70,37
1650597130248,ECE 180,A00,083140,Abi Samra; Nicholas Camill,21,0,30,9
1650597130248,ECE 180,B00,083141,Abi Samra; Nicholas Camill,0,0,30,30
1650597136280,MATH 10A,A01,083735,Patchell; Gregory David,4,0,30,26
1650597136280,MATH 10A,A02,083736,Patchell; Gregory David,27,0,30,3
1650597136280,MATH 10A,A03,083737,Patchell; Gregory David,24,0,30,6
1650597142304,MATH 10B,A01,083207,Staff,0,9,30,30
1650597142304,MATH 10B,A02,083208,Staff,0,8,30,30
1650597142304,MATH 10B,B01,083739,Staff,11,0,30,19
1650597142304,MATH 10B,B02,083740,Staff,28,0,30,2
1650597148331,MATH 18,A01,083743,Staff,0,0,30,30
1650597148331,MATH 18,A02,083744,Staff,23,0,30,7
1650597148331,MATH 18,A03,083745,Staff,21,0,30,9
1650597148331,MATH 18,A04,083746,Staff,26,0,30,4
1650597148331,MATH 18,B01,083748,Staff,0,15,30,30
1650597148331,MATH 18,B02,083749,Staff,1,11,30,29
1650597148331,MATH 18,B03,083750,Staff,0,12,30,30
1650597148331,MATH 18,B04,083751,Staff,0,12,30,30
1650597154354,MATH 20A,A01,083754,Staff,19,0,40,21
1650597160381,MATH 20B,A01,083756,Staff,1,12,30,29
1650597160381,MATH 20B,A02,083757,Staff,0,12,30,30
1650597166408,MATH 20C,A01,083760,Staff,0,16,30,30
1650597166408,MATH 20C,A02,083761,Staff,2,14,30,28
1650597166408,MATH 20C,B01,083762,Staff,11,0,30,19
1650597166408,MATH 20C,B02,083763,Staff,28,0,30,2
1650597172440,MATH 20D,A01,083765,Staff,1,1,30,29
1650597172440,MATH 20D,A02,083766,Staff,8,0,30,22
1650597172440,MATH 20D,A03,083767,Staff,25,0,30,5
1650597178465,MATH 20E,A01,083771,Staff,5,0,30,25
1650597178465,MATH 20E,A02,083772,Staff,18,0,30,12
1650597178465,MATH 20E,B01,083773,Staff,0,0,30,30
1650597178465,MATH 20E,B02,083774,Staff,9,0,30,21
1650597184492,MATH 103A,A01,083777,Staff,0,15,30,30
1650597184492,MATH 103A,A02,083778,Staff,0,14,30,30
1650597184492,MATH 103A,B01,083779,Staff,0,14,30,30
1650597184492,MATH 103A,B02,083780,Staff,0,14,30,30
1650597190518,MATH 105,A01,085443,Staff,0,21,30,30
1650597196551,MATH 109,A01,083213,Anzaldo; Leesa B,1,7,30,29
1650597196551,MATH 109,A02,083214,Anzaldo; Leesa B,0,7,30,30
1650597196551,MATH 109,B01,083215,Anzaldo; Leesa B,0,5,30,30
1650597196551,MATH 109,B02,083216,Anzaldo; Leesa B,1,6,30,29
1650597202582,MATH 142A,A01,083219,Chow; Bennett,0,16,30,30
1650597202582,MATH 142A,A02,083220,Chow; Bennett,0,15,30,30
1650597202582,MATH 142A,B01,083221,Chow; Bennett,0,14,30,30
1650597202582,MATH 142A,B02,083222,Chow; Bennett,0,13,30,30
1650597208604,MATH 193A,A01,083224,Staff,1,6,30,29
1650597208604,MATH 193A,A02,083225,Staff,0,6,30,30
1650597208604,MATH 193A,A03,083781,Staff,0,6,30,30
1650597208604,MATH 193A,A04,083782,Staff,0,7,30,30
1650597214626,MATH 197,001,091859,McAuley; Julian John,9998,0,9999,1
1650597220674,COGS 9,A01,083615,Staff,1,16,60,59
1650597226709,COGS 11,A01,083617,Boyle; Mary E. T.,18,0,40,22
1650597232737,COGS 13,A01,083071,Staff,0,37,40,40
1650597238760,COGS 14A,A01,092681,Staff,0,29,100,100
1650597244790,COGS 14B,A01,083073,Cheng; Tzu-Han,0,13,50,50
1650597250816,COGS 17,A01,092677,Staff,16,0,75,59
1650597256846,COGS 100,A01,083619,Staff,1,26,60,59
1650597262875,COGS 101A,A01,083621,Davis; Joshua Daniel,0,26,60,60
1650597268900,COGS 101B,A01,091572,Staff,1,5,60,59
1650597274923,COGS 101C,A01,083625,Delgado; Tania,15,0,30,15
1650597280950,COGS 107A,A01,083627,Boyle; Mary E. T.,0,14,60,60
1650597286973,COGS 118A,A01,083075,Staff,0,4,60,60
1650597293097,CSE 3,A50,083646,Miranda; Gregory Joseph,19,0,38,19
1650597293097,CSE 3,A51,083647,Miranda; Gregory Joseph,36,0,37,1
1650597299127,CSE 8A,A50,083650,Miranda; Gregory Joseph,0,30,40,40
1650597305153,CSE 11,A01,083080,Cao; Yingjun,0,96,40,40
1650597311175,CSE 12,A01,083652,Staff,0,20,100,100
1650597317199,CSE 15L,A01,083654,Staff,0,2,50,50
1650597317199,CSE 15L,A02,083655,Staff,0,1,50,50
1650597323226,CSE 20,A01,083657,Staff,51,0,80,29
1650597329254,CSE 30,A01,083084,Eldon; John,0,78,40,40
1650597335276,CSE 100,A01,083659,Cao; Yingjun,0,67,50,50
1650597341298,CSE 134B,A01,083661,Powell; Thomas Allan,0,35,65,65
1650597347322,CSE 140,A01,083663,Staff,1,8,75,74
1650597353345,CSE 140L,A01,083088,Eldon; John,1,14,75,74
1650597359370,CSE 175,A01,083665,Kumar; Rakesh,7,0,25,18
1650597365406,CSE 190,A00,092507,Dubnov; Shlomo,11,0,20,9
1650597371439,ECE 45,A01,083139,Staff,1,2,60,59
1650597377469,ECE 65,A50,083695,Staff,1,6,30,29
1650597383506,ECE 109,A01,091882,Touri; Behrouz,33,0,70,37
1650597389529,ECE 180,A00,083140,Abi Samra; Nicholas Camill,21,0,30,9
1650597389529,ECE 180,B00,083141,Abi Samra; Nicholas Camill,0,0,30,30
1650597395556,MATH 10A,A01,083735,Patchell; Gregory David,4,0,30,26
1650597395556,MATH 10A,A02,083736,Patchell; Gregory David,27,0,30,3
1650597395556,MATH 10A,A03,083737,Patchell; Gregory David,24,0,30,6
1650597401579,MATH 10B,A01,083207,Staff,0,9,30,30
1650597401579,MATH 10B,A02,083208,Staff,0,8,30,30
1650597401579,MATH 10B,B01,083739,Staff,11,0,30,19
1650597401579,MATH 10B,B02,083740,Staff,28,0,30,2
1650597407609,MATH 18,A01,083743,Staff,0,0,30,30
1650597407609,MATH 18,A02,083744,Staff,23,0,30,7
1650597407609,MATH 18,A03,083745,Staff,21,0,30,9
1650597407609,MATH 18,A04,083746,Staff,26,0,30,4
1650597407609,MATH 18,B01,083748,Staff,0,15,30,30
1650597407609,MATH 18,B02,083749,Staff,1,11,30,29
1650597407609,MATH 18,B03,083750,Staff,0,12,30,30
1650597407609,MATH 18,B04,083751,Staff,0,12,30,30
1650597413635,MATH 20A,A01,083754,Staff,19,0,40,21
1650597419659,MATH 20B,A01,083756,Staff,1,12,30,29
1650597419659,MATH 20B,A02,083757,Staff,0,12,30,30
1650597425683,MATH 20C,A01,083760,Staff,0,16,30,30
1650597425683,MATH 20C,A02,083761,Staff,2,14,30,28
1650597425683,MATH 20C,B01,083762,Staff,11,0,30,19
1650597425683,MATH 20C,B02,083763,Staff,28,0,30,2
1650597431722,MATH 20D,A01,083765,Staff,1,1,30,29
1650597431722,MATH 20D,A02,083766,Staff,8,0,30,22
1650597431722,MATH 20D,A03,083767,Staff,25,0,30,5
1650597437756,MATH 20E,A01,083771,Staff,5,0,30,25
1650597437756,MATH 20E,A02,083772,Staff,18,0,30,12
1650597437756,MATH 20E,B01,083773,Staff,0,0,30,30
1650597437756,MATH 20E,B02,083774,Staff,9,0,30,21
1650597443798,MATH 103A,A01,083777,Staff,0,15,30,30
1650597443798,MATH 103A,A02,083778,Staff,0,14,30,30
1650597443798,MATH 103A,B01,083779,Staff,0,14,30,30
1650597443798,MATH 103A,B02,083780,Staff,0,14,30,30
1650597449829,MATH 105,A01,085443,Staff,0,21,30,30
1650597455851,MATH 109,A01,083213,Anzaldo; Leesa B,1,7,30,29
1650597455851,MATH 109,A02,083214,Anzaldo; Leesa B,0,7,30,30
1650597455851,MATH 109,B01,083215,Anzaldo; Leesa B,0,5,30,30
1650597455851,MATH 109,B02,083216,Anzaldo; Leesa B,1,6,30,29
1650597461875,MATH 142A,A01,083219,Chow; Bennett,0,16,30,30
1650597461875,MATH 142A,A02,083220,Chow; Bennett,0,15,30,30
1650597461875,MATH 142A,B01,083221,Chow; Bennett,0,14,30,30
1650597461875,MATH 142A,B02,083222,Chow; Bennett,0,13,30,30
1650597467899,MATH 193A,A01,083224,Staff,1,6,30,29
1650597467899,MATH 193A,A02,083225,Staff,0,6,30,30
1650597467899,MATH 193A,A03,083781,Staff,0,6,30,30
1650597467899,MATH 193A,A04,083782,Staff,0,7,30,30
1650597473923,MATH 197,001,091859,McAuley; Julian John,9998,0,9999,1
1650597479974,COGS 9,A01,083615,Staff,1,16,60,59
1650597485998,COGS 11,A01,083617,Boyle; Mary E. T.,18,0,40,22
1650597492028,COGS 13,A01,083071,Staff,0,37,40,40
1650597498051,COGS 14A,A01,092681,Staff,0,29,100,100
1650597504077,COGS 14B,A01,083073,Cheng; Tzu-Han,0,13,50,50
1650597510101,COGS 17,A01,092677,Staff,16,0,75,59
1650597516124,COGS 100,A01,083619,Staff,1,26,60,59
1650597522152,COGS 101A,A01,083621,Davis; Joshua Daniel,0,26,60,60
1650597528175,COGS 101B,A01,091572,Staff,1,5,60,59
1650597534206,COGS 101C,A01,083625,Delgado; Tania,15,0,30,15
1650597540229,COGS 107A,A01,083627,Boyle; Mary E. T.,0,14,60,60
1650597546254,COGS 118A,A01,083075,Staff,0,4,60,60
1650597552280,CSE 3,A50,083646,Miranda; Gregory Joseph,19,0,38,19
1650597552280,CSE 3,A51,083647,Miranda; Gregory Joseph,36,0,37,1
1650597558304,CSE 8A,A50,083650,Miranda; Gregory Joseph,0,30,40,40
1650597564327,CSE 11,A01,083080,Cao; Yingjun,0,96,40,40
1650597570355,CSE 12,A01,083652,Staff,0,20,100,100
1650597576377,CSE 15L,A01,083654,Staff,0,2,50,50
1650597576377,CSE 15L,A02,083655,Staff,0,1,50,50
1650597582401,CSE 20,A01,083657,Staff,51,0,80,29
1650597588427,CSE 30,A01,083084,Eldon; John,0,78,40,40
1650597594453,CSE 100,A01,083659,Cao; Yingjun,0,68,50,50
1650597600476,CSE 134B,A01,083661,Powell; Thomas Allan,0,35,65,65
1650597606500,CSE 140,A01,083663,Staff,1,9,75,74
1650597612523,CSE 140L,A01,083088,Eldon; John,1,15,75,74
1650597618547,CSE 175,A01,083665,Kumar; Rakesh,7,0,25,18
1650597624568,CSE 190,A00,092507,Dubnov; Shlomo,11,0,20,9
1650597630592,ECE 45,A01,083139,Staff,1,2,60,59
1650597636616,ECE 65,A50,083695,Staff,1,6,30,29
1650597642637,ECE 109,A01,091882,Touri; Behrouz,33,0,70,37
1650597648662,ECE 180,A00,083140,Abi Samra; Nicholas Camill,21,0,30,9
1650597648662,ECE 180,B00,083141,Abi Samra; Nicholas Camill,0,0,30,30
1650597654689,MATH 10A,A01,083735,Patchell; Gregory David,4,0,30,26
1650597654689,MATH 10A,A02,083736,Patchell; Gregory David,27,0,30,3
1650597654689,MATH 10A,A03,083737,Patchell; Gregory David,24,0,30,6
1650597660713,MATH 10B,A01,083207,Staff,0,9,30,30
1650597660713,MATH 10B,A02,083208,Staff,0,8,30,30
1650597660713,MATH 10B,B01,083739,Staff,11,0,30,19
1650597660713,MATH 10B,B02,083740,Staff,28,0,30,2
1650597666749,MATH 18,A01,083743,Staff,0,0,30,30
1650597666749,MATH 18,A02,083744,Staff,23,0,30,7
1650597666749,MATH 18,A03,083745,Staff,21,0,30,9
1650597666749,MATH 18,A04,083746,Staff,26,0,30,4
1650597666749,MATH 18,B01,083748,Staff,0,15,30,30
1650597666749,MATH 18,B02,083749,Staff,1,11,30,29
1650597666749,MATH 18,B03,083750,Staff,0,12,30,30
1650597666749,MATH 18,B04,083751,Staff,0,12,30,30
1650597672779,MATH 20A,A01,083754,Staff,19,0,40,21
1650597678801,MATH 20B,A01,083756,Staff,1,12,30,29
1650597678801,MATH 20B,A02,083757,Staff,0,12,30,30
1650597684828,MATH 20C,A01,083760,Staff,0,16,30,30
1650597684828,MATH 20C,A02,083761,Staff,2,14,30,28
1650597684828,MATH 20C,B01,083762,Staff,11,0,30,19
1650597684828,MATH 20C,B02,083763,Staff,28,0,30,2
1650597690850,MATH 20D,A01,083765,Staff,1,1,30,29
1650597690850,MATH 20D,A02,083766,Staff,8,0,30,22
1650597690850,MATH 20D,A03,083767,Staff,25,0,30,5
1650597696874,MATH 20E,A01,083771,Staff,5,0,30,25
1650597696874,MATH 20E,A02,083772,Staff,18,0,30,12
1650597696874,MATH 20E,B01,083773,Staff,0,0,30,30
1650597696874,MATH 20E,B02,083774,Staff,9,0,30,21
1650597702902,MATH 103A,A01,083777,Staff,0,15,30,30
1650597702902,MATH 103A,A02,083778,Staff,0,14,30,30
1650597702902,MATH 103A,B01,083779,Staff,0,14,30,30
1650597702902,MATH 103A,B02,083780,Staff,0,14,30,30
1650597708925,MATH 105,A01,085443,Staff,0,21,30,30
1650597714948,MATH 109,A01,083213,Anzaldo; Leesa B,1,7,30,29
1650597714948,MATH 109,A02,083214,Anzaldo; Leesa B,0,7,30,30
1650597714948,MATH 109,B01,083215,Anzaldo; Leesa B,0,5,30,30
1650597714948,MATH 109,B02,083216,Anzaldo; Leesa B,1,6,30,29
1650597720975,MATH 142A,A01,083219,Chow; Bennett,0,16,30,30
1650597720975,MATH 142A,A02,083220,Chow; Bennett,0,15,30,30
1650597720975,MATH 142A,B01,083221,Chow; Bennett,0,14,30,30
1650597720975,MATH 142A,B02,083222,Chow; Bennett,0,13,30,30
1650597727007,MATH 193A,A01,083224,Staff,1,6,30,29
1650597727007,MATH 193A,A02,083225,Staff,0,6,30,30
1650597727007,MATH 193A,A03,083781,Staff,0,6,30,30
1650597727007,MATH 193A,A04,083782,Staff,0,7,30,30
1650597733031,MATH 197,001,091859,McAuley; Julian John,9998,0,9999,1
1650597739094,COGS 9,A01,083615,Staff,1,16,60,59
1650597745119,COGS 11,A01,083617,Boyle; Mary E. T.,18,0,40,22
1650597751143,COGS 13,A01,083071,Staff,0,37,40,40
1650597757166,COGS 14A,A01,092681,Staff,0,29,100,100
1650597763192,COGS 14B,A01,083073,Cheng; Tzu-Han,0,13,50,50
1650597769216,COGS 17,A01,092677,Staff,16,0,75,59
1650597775239,COGS 100,A01,083619,Staff,1,26,60,59
1650597781266,COGS 101A,A01,083621,Davis; Joshua Daniel,0,26,60,60
1650597787297,COGS 101B,A01,091572,Staff,1,5,60,59
1650597793336,COGS 101C,A01,083625,Delgado; Tania,15,0,30,15
1650597799358,COGS 107A,A01,083627,Boyle; Mary E. T.,0,14,60,60
1650597805385,COGS 118A,A01,083075,Staff,0,4,60,60
1650597811408,CSE 3,A50,083646,Miranda; Gregory Joseph,19,0,38,19
1650597811408,CSE 3,A51,083647,Miranda; Gregory Joseph,36,0,37,1
1650597817434,CSE 8A,A50,083650,Miranda; Gregory Joseph,0,30,40,40
1650597823456,CSE 11,A01,083080,Cao; Yingjun,0,96,40,40
1650597829480,CSE 12,A01,083652,Staff,0,20,100,100
1650597835507,CSE 15L,A01,083654,Staff,0,2,50,50
1650597835507,CSE 15L,A02,083655,Staff,0,1,50,50
1650597841529,CSE 20,A01,083657,Staff,51,0,80,29
1650597847552,CSE 30,A01,083084,Eldon; John,0,78,40,40
1650597853578,CSE 100,A01,083659,Cao; Yingjun,0,68,50,50
1650597859602,CSE 134B,A01,083661,Powell; Thomas Allan,0,35,65,65
1650597865633,CSE 140,A01,083663,Staff,1,9,75,74
1650597871660,CSE 140L,A01,083088,Eldon; John,1,15,75,74
1650597877682,CSE 175,A01,083665,Kumar; Rakesh,7,0,25,18
1650597883709,CSE 190,A00,092507,Dubnov; Shlomo,11,0,20,9
1650597889830,ECE 45,A01,083139,Staff,1,2,60,59
1650597895853,ECE 65,A50,083695,Staff,1,6,30,29
1650597901876,ECE 109,A01,091882,Touri; Behrouz,33,0,70,37
1650597907902,ECE 180,A00,083140,Abi Samra; Nicholas Camill,21,0,30,9
1650597907902,ECE 180,B00,083141,Abi Samra; Nicholas Camill,0,0,30,30
1650597913947,MATH 10A,A01,083735,Patchell; Gregory David,4,0,30,26
1650597913947,MATH 10A,A02,083736,Patchell; Gregory David,27,0,30,3
1650597913947,MATH 10A,A03,083737,Patchell; Gregory David,24,0,30,6
1650597919974,MATH 10B,A01,083207,Staff,0,9,30,30
1650597919974,MATH 10B,A02,083208,Staff,0,8,30,30
1650597919974,MATH 10B,B01,083739,Staff,11,0,30,19
1650597919974,MATH 10B,B02,083740,Staff,28,0,30,2
1650597925997,MATH 18,A01,083743,Staff,0,0,30,30
1650597925997,MATH 18,A02,083744,Staff,23,0,30,7
1650597925997,MATH 18,A03,083745,Staff,21,0,30,9
1650597925997,MATH 18,A04,083746,Staff,26,0,30,4
1650597925997,MATH 18,B01,083748,Staff,0,15,30,30
1650597925997,MATH 18,B02,083749,Staff,1,11,30,29
1650597925997,MATH 18,B03,083750,Staff,0,12,30,30
1650597925997,MATH 18,B04,083751,Staff,0,12,30,30
1650597932020,MATH 20A,A01,083754,Staff,19,0,40,21
1650597938042,MATH 20B,A01,083756,Staff,1,12,30,29
1650597938042,MATH 20B,A02,083757,Staff,0,12,30,30
1650597944066,MATH 20C,A01,083760,Staff,0,16,30,30
1650597944066,MATH 20C,A02,083761,Staff,2,14,30,28
1650597944066,MATH 20C,B01,083762,Staff,11,0,30,19
1650597944066,MATH 20C,B02,083763,Staff,28,0,30,2
1650597950089,MATH 20D,A01,083765,Staff,1,1,30,29
1650597950089,MATH 20D,A02,083766,Staff,8,0,30,22
1650597950089,MATH 20D,A03,083767,Staff,25,0,30,5
1650597956113,MATH 20E,A01,083771,Staff,5,0,30,25
1650597956113,MATH 20E,A02,083772,Staff,18,0,30,12
1650597956113,MATH 20E,B01,083773,Staff,0,0,30,30
1650597956113,MATH 20E,B02,083774,Staff,9,0,30,21
1650597962136,MATH 103A,A01,083777,Staff,0,15,30,30
1650597962136,MATH 103A,A02,083778,Staff,0,14,30,30
1650597962136,MATH 103A,B01,083779,Staff,0,14,30,30
1650597962136,MATH 103A,B02,083780,Staff,0,14,30,30
1650597968159,MATH 105,A01,085443,Staff,0,21,30,30
1650597974184,MATH 109,A01,083213,Anzaldo; Leesa B,1,7,30,29
1650597974184,MATH 109,A02,083214,Anzaldo; Leesa B,0,7,30,30
1650597974184,MATH 109,B01,083215,Anzaldo; Leesa B,0,5,30,30
1650597974184,MATH 109,B02,083216,Anzaldo; Leesa B,1,6,30,29
1650597980208,MATH 142A,A01,083219,Chow; Bennett,0,16,30,30
1650597980208,MATH 142A,A02,083220,Chow; Bennett,0,15,30,30
1650597980208,MATH 142A,B01,083221,Chow; Bennett,0,14,30,30
1650597980208,MATH 142A,B02,083222,Chow; Bennett,0,13,30,30
1650597986239,MATH 193A,A01,083224,Staff,1,6,30,29
1650597986239,MATH 193A,A02,083225,Staff,0,6,30,30
1650597986239,MATH 193A,A03,083781,Staff,0,6,30,30
1650597986239,MATH 193A,A04,083782,Staff,0,7,30,30
1650597992262,MATH 197,001,091859,McAuley; Julian John,9998,0,9999,1
1650597998317,COGS 9,A01,083615,Staff,1,16,60,59
1650598004341,COGS 11,A01,083617,Boyle; Mary E. T.,18,0,40,22
1650598010367,COGS 13,A01,083071,Staff,0,37,40,40
1650598016391,COGS 14A,A01,092681,Staff,0,29,100,100
1650598022428,COGS 14B,A01,083073,Cheng; Tzu-Han,0,13,50,50
1650598028462,COGS 17,A01,092677,Staff,16,0,75,59
1650598034491,COGS 100,A01,083619,Staff,1,26,60,59
1650598040526,COGS 101A,A01,083621,Davis; Joshua Daniel,0,26,60,60
1650598046555,COGS 101B,A01,091572,Staff,1,5,60,59
1650598052578,COGS 101C,A01,083625,Delgado; Tania,15,0,30,15
1650598058604,COGS 107A,A01,083627,Boyle; Mary E. T.,0,14,60,60
1650598064640,COGS 118A,A01,083075,Staff,0,4,60,60
1650598070678,CSE 3,A50,083646,Miranda; Gregory Joseph,19,0,38,19
1650598070678,CSE 3,A51,083647,Miranda; Gregory Joseph,36,0,37,1
1650598076703,CSE 8A,A50,083650,Miranda; Gregory Joseph,0,30,40,40
1650598082725,CSE 11,A01,083080,Cao; Yingjun,0,95,40,40
1650598088748,CSE 12,A01,083652,Staff,0,20,100,100
1650598094773,CSE 15L,A01,083654,Staff,0,2,50,50
1650598094773,CSE 15L,A02,083655,Staff,0,1,50,50
1650598100797,CSE 20,A01,083657,Staff,51,0,80,29
1650598106826,CSE 30,A01,083084,Eldon; John,0,78,40,40
1650598112859,CSE 100,A01,083659,Cao; Yingjun,0,68,50,50
1650598118885,CSE 134B,A01,083661,Powell; Thomas Allan,0,35,65,65
1650598124907,CSE 140,A01,083663,Staff,1,9,75,74
1650598130930,CSE 140L,A01,083088,Eldon; John,1,15,75,74
1650598136960,CSE 175,A01,083665,Kumar; Rakesh,7,0,25,18
1650598142984,CSE 190,A00,092507,Dubnov; Shlomo,11,0,20,9
1650598149008,ECE 45,A01,083139,Staff,1,2,60,59
1650598155031,ECE 65,A50,083695,Staff,1,6,30,29
1650598161060,ECE 109,A01,091882,Touri; Behrouz,33,0,70,37
1650598167086,ECE 180,A00,083140,Abi Samra; Nicholas Camill,21,0,30,9
1650598167086,ECE 180,B00,083141,Abi Samra; Nicholas Camill,0,0,30,30
1650598173121,MATH 10A,A01,083735,Patchell; Gregory David,4,0,30,26
1650598173121,MATH 10A,A02,083736,Patchell; Gregory David,27,0,30,3
1650598173121,MATH 10A,A03,083737,Patchell; Gregory David,24,0,30,6
1650598179212,MATH 10B,A01,083207,Staff,0,9,30,30
1650598179212,MATH 10B,A02,083208,Staff,0,8,30,30
1650598179212,MATH 10B,B01,083739,Staff,11,0,30,19
1650598179212,MATH 10B,B02,083740,Staff,28,0,30,2
1650598185238,MATH 18,A01,083743,Staff,0,0,30,30
1650598185238,MATH 18,A02,083744,Staff,23,0,30,7
1650598185238,MATH 18,A03,083745,Staff,21,0,30,9
1650598185238,MATH 18,A04,083746,Staff,26,0,30,4
1650598185238,MATH 18,B01,083748,Staff,0,15,30,30
1650598185238,MATH 18,B02,083749,Staff,1,11,30,29
1650598185238,MATH 18,B03,083750,Staff,0,12,30,30
1650598185238,MATH 18,B04,083751,Staff,0,12,30,30
1650598191264,MATH 20A,A01,083754,Staff,19,0,40,21
1650598197290,MATH 20B,A01,083756,Staff,1,12,30,29
1650598197290,MATH 20B,A02,083757,Staff,0,12,30,30
1650598203314,MATH 20C,A01,083760,Staff,0,16,30,30
1650598203314,MATH 20C,A02,083761,Staff,2,14,30,28
1650598203314,MATH 20C,B01,083762,Staff,11,0,30,19
1650598203314,MATH 20C,B02,083763,Staff,28,0,30,2
1650598209355,MATH 20D,A01,083765,Staff,1,1,30,29
1650598209355,MATH 20D,A02,083766,Staff,8,0,30,22
1650598209355,MATH 20D,A03,083767,Staff,25,0,30,5
1650598215388,MATH 20E,A01,083771,Staff,5,0,30,25
1650598215388,MATH 20E,A02,083772,Staff,18,0,30,12
1650598215388,MATH 20E,B01,083773,Staff,0,0,30,30
1650598215388,MATH 20E,B02,083774,Staff,9,0,30,21
1650598221417,MATH 103A,A01,083777,Staff,0,15,30,30
1650598221417,MATH 103A,A02,083778,Staff,0,14,30,30
1650598221417,MATH 103A,B01,083779,Staff,0,14,30,30
1650598221417,MATH 103A,B02,083780,Staff,0,14,30,30
1650598227441,MATH 105,A01,085443,Staff,0,21,30,30
1650598233465,MATH 109,A01,083213,Anzaldo; Leesa B,1,7,30,29
1650598233465,MATH 109,A02,083214,Anzaldo; Leesa B,0,7,30,30
1650598233465,MATH 109,B01,083215,Anzaldo; Leesa B,0,5,30,30
1650598233465,MATH 109,B02,083216,Anzaldo; Leesa B,1,6,30,29
1650598239488,MATH 142A,A01,083219,Chow; Bennett,0,16,30,30
1650598239488,MATH 142A,A02,083220,Chow; Bennett,0,15,30,30
1650598239488,MATH 142A,B01,083221,Chow; Bennett,0,14,30,30
1650598239488,MATH 142A,B02,083222,Chow; Bennett,0,13,30,30
1650598245511,MATH 193A,A01,083224,Staff,1,6,30,29
1650598245511,MATH 193A,A02,083225,Staff,0,6,30,30
1650598245511,MATH 193A,A03,083781,Staff,0,6,30,30
1650598245511,MATH 193A,A04,083782,Staff,0,7,30,30
1650598251535,MATH 197,001,091859,McAuley; Julian John,9998,0,9999,1
1650598257595,COGS 9,A01,083615,Staff,1,16,60,59
1650598263620,COGS 11,A01,083617,Boyle; Mary E. T.,18,0,40,22
1650598269643,COGS 13,A01,083071,Staff,0,37,40,40
1650598275667,COGS 14A,A01,092681,Staff,0,29,100,100
1650598281705,COGS 14B,A01,083073,Cheng; Tzu-Han,0,13,50,50
1650598287729,COGS 17,A01,092677,Staff,16,0,75,59
1650598293752,COGS 100,A01,083619,Staff,1,26,60,59
1650598299778,COGS 101A,A01,083621,Davis; Joshua Daniel,0,26,60,60
1650598305814,COGS 101B,A01,091572,Staff,1,5,60,59
1650598311838,COGS 101C,A01,083625,Delgado; Tania,15,0,30,15
1650598317869,COGS 107A,A01,083627,Boyle; Mary E. T.,0,14,60,60
1650598323893,COGS 118A,A01,083075,Staff,0,4,60,60
1650598329916,CSE 3,A50,083646,Miranda; Gregory Joseph,19,0,38,19
1650598329916,CSE 3,A51,083647,Miranda; Gregory Joseph,36,0,37,1
1650598335942,CSE 8A,A50,083650,Miranda; Gregory Joseph,0,30,40,40
1650598341970,CSE 11,A01,083080,Cao; Yingjun,0,95,40,40
1650598347997,CSE 12,A01,083652,Staff,0,20,100,100
1650598354021,CSE 15L,A01,083654,Staff,0,2,50,50
1650598354021,CSE 15L,A02,083655,Staff,0,1,50,50
1650598360044,CSE 20,A01,083657,Staff,51,0,80,29
1650598366068,CSE 30,A01,083084,Eldon; John,0,78,40,40
1650598372092,CSE 100,A01,083659,Cao; Yingjun,0,68,50,50
1650598378115,CSE 134B,A01,083661,Powell; Thomas Allan,0,35,65,65
1650598384145,CSE 140,A01,083663,Staff,1,9,75,74
1650598390168,CSE 140L,A01,083088,Eldon; John,1,15,75,74
1650598396195,CSE 175,A01,083665,Kumar; Rakesh,7,0,25,18
1650598402218,CSE 190,A00,092507,Dubnov; Shlomo,11,0,20,9
1650598408243,ECE 45,A01,083139,Staff,1,2,60,59
1650598414267,ECE 65,A50,083695,Staff,1,6,30,29
1650598420291,ECE 109,A01,091882,Touri; Behrouz,33,0,70,37
1650598426318,ECE 180,A00,083140,Abi Samra; Nicholas Camill,21,0,30,9
1650598426318,ECE 180,B00,083141,Abi Samra; Nicholas Camill,0,0,30,30
1650598432340,MATH 10A,A01,083735,Patchell; Gregory David,4,0,30,26
1650598432340,MATH 10A,A02,083736,Patchell; Gregory David,27,0,30,3
1650598432340,MATH 10A,A03,083737,Patchell; Gregory David,24,0,30,6
1650598438373,MATH 10B,A01,083207,Staff,0,9,30,30
1650598438373,MATH 10B,A02,083208,Staff,0,8,30,30
1650598438373,MATH 10B,B01,083739,Staff,11,0,30,19
1650598438373,MATH 10B,B02,083740,Staff,28,0,30,2
1650598444399,MATH 18,A01,083743,Staff,0,0,30,30
1650598444399,MATH 18,A02,083744,Staff,23,0,30,7
1650598444399,MATH 18,A03,083745,Staff,21,0,30,9
1650598444399,MATH 18,A04,083746,Staff,26,0,30,4
1650598444399,MATH 18,B01,083748,Staff,0,15,30,30
1650598444399,MATH 18,B02,083749,Staff,1,11,30,29
1650598444399,MATH 18,B03,083750,Staff,0,12,30,30
1650598444399,MATH 18,B04,083751,Staff,0,12,30,30
1650598450424,MATH 20A,A01,083754,Staff,19,0,40,21
1650598456446,MATH 20B,A01,083756,Staff,1,12,30,29
1650598456446,MATH 20B,A02,083757,Staff,0,12,30,30
1650598462481,MATH 20C,A01,083760,Staff,0,16,30,30
1650598462481,MATH 20C,A02,083761,Staff,2,14,30,28
1650598462481,MATH 20C,B01,083762,Staff,11,0,30,19
1650598462481,MATH 20C,B02,083763,Staff,28,0,30,2
1650598468513,MATH 20D,A01,083765,Staff,1,1,30,29
1650598468513,MATH 20D,A02,083766,Staff,8,0,30,22
1650598468513,MATH 20D,A03,083767,Staff,25,0,30,5
1650598474536,MATH 20E,A01,083771,Staff,4,0,30,26
1650598474536,MATH 20E,A02,083772,Staff,18,0,30,12
1650598474536,MATH 20E,B01,083773,Staff,0,0,30,30
1650598474536,MATH 20E,B02,083774,Staff,9,0,30,21
1650598480563,MATH 103A,A01,083777,Staff,0,15,30,30
1650598480563,MATH 103A,A02,083778,Staff,0,14,30,30
1650598480563,MATH 103A,B01,083779,Staff,0,14,30,30
1650598480563,MATH 103A,B02,083780,Staff,0,14,30,30
1650598486678,MATH 105,A01,085443,Staff,0,21,30,30
1650598492704,MATH 109,A01,083213,Anzaldo; Leesa B,1,7,30,29
1650598492704,MATH 109,A02,083214,Anzaldo; Leesa B,0,7,30,30
1650598492704,MATH 109,B01,083215,Anzaldo; Leesa B,0,5,30,30
1650598492704,MATH 109,B02,083216,Anzaldo; Leesa B,1,6,30,29
1650598498728,MATH 142A,A01,083219,Chow; Bennett,0,16,30,30
1650598498728,MATH 142A,A02,083220,Chow; Bennett,0,15,30,30
1650598498728,MATH 142A,B01,083221,Chow; Bennett,0,14,30,30
1650598498728,MATH 142A,B02,083222,Chow; Bennett,0,13,30,30
1650598504755,MATH 193A,A01,083224,Staff,1,6,30,29
1650598504755,MATH 193A,A02,083225,Staff,0,6,30,30
1650598504755,MATH 193A,A03,083781,Staff,0,6,30,30
1650598504755,MATH 193A,A04,083782,Staff,0,7,30,30
1650598510778,MATH 197,001,091859,McAuley; Julian John,9998,0,9999,1
1650598516838,COGS 9,A01,083615,Staff,1,16,60,59
1650598522865,COGS 11,A01,083617,Boyle; Mary E. T.,18,0,40,22
1650598528889,COGS 13,A01,083071,Staff,0,37,40,40
1650598534912,COGS 14A,A01,092681,Staff,0,29,100,100
1650598540935,COGS 14B,A01,083073,Cheng; Tzu-Han,0,13,50,50
1650598546958,COGS 17,A01,092677,Staff,16,0,75,59
1650598552989,COGS 100,A01,083619,Staff,1,26,60,59
1650598559013,COGS 101A,A01,083621,Davis; Joshua Daniel,0,26,60,60
1650598565037,COGS 101B,A01,091572,Staff,1,5,60,59
1650598571078,COGS 101C,A01,083625,Delgado; Tania,15,0,30,15
1650598577117,COGS 107A,A01,083627,Boyle; Mary E. T.,0,14,60,60
1650598583158,COGS 118A,A01,083075,Staff,0,4,60,60
1650598589183,CSE 3,A50,083646,Miranda; Gregory Joseph,19,0,38,19
1650598589183,CSE 3,A51,083647,Miranda; Gregory Joseph,36,0,37,1
1650598595211,CSE 8A,A50,083650,Miranda; Gregory Joseph,0,30,40,40
1650598601235,CSE 11,A01,083080,Cao; Yingjun,0,95,40,40
1650598607262,CSE 12,A01,083652,Staff,0,20,100,100
1650598613285,CSE 15L,A01,083654,Staff,0,2,50,50
1650598613285,CSE 15L,A02,083655,Staff,0,1,50,50
1650598619314,CSE 20,A01,083657,Staff,51,0,80,29
1650598625338,CSE 30,A01,083084,Eldon; John,0,78,40,40
1650598631377,CSE 100,A01,083659,Cao; Yingjun,0,68,50,50
1650598637403,CSE 134B,A01,083661,Powell; Thomas Allan,0,35,65,65
1650598643434,CSE 140,A01,083663,Staff,1,9,75,74
1650598649461,CSE 140L,A01,083088,Eldon; John,1,15,75,74
1650598655488,CSE 175,A01,083665,Kumar; Rakesh,7,0,25,18
1650598661511,CSE 190,A00,092507,Dubnov; Shlomo,11,0,20,9
1650598667540,ECE 45,A01,083139,Staff,1,2,60,59
1650598673565,ECE 65,A50,083695,Staff,1,6,30,29
1650598679588,ECE 109,A01,091882,Touri; Behrouz,33,0,70,37
1650598685611,ECE 180,A00,083140,Abi Samra; Nicholas Camill,21,0,30,9
1650598685611,ECE 180,B00,083141,Abi Samra; Nicholas Camill,0,0,30,30
1650598691642,MATH 10A,A01,083735,Patchell; Gregory David,4,0,30,26
1650598691642,MATH 10A,A02,083736,Patchell; Gregory David,27,0,30,3
1650598691642,MATH 10A,A03,083737,Patchell; Gregory David,24,0,30,6
1650598697673,MATH 10B,A01,083207,Staff,0,9,30,30
1650598697673,MATH 10B,A02,083208,Staff,0,8,30,30
1650598697673,MATH 10B,B01,083739,Staff,11,0,30,19
1650598697673,MATH 10B,B02,083740,Staff,28,0,30,2
1650598703704,MATH 18,A01,083743,Staff,0,0,30,30
1650598703704,MATH 18,A02,083744,Staff,23,0,30,7
1650598703704,MATH 18,A03,083745,Staff,21,0,30,9
1650598703704,MATH 18,A04,083746,Staff,26,0,30,4
1650598703704,MATH 18,B01,083748,Staff,0,15,30,30
1650598703704,MATH 18,B02,083749,Staff,1,11,30,29
1650598703704,MATH 18,B03,083750,Staff,0,12,30,30
1650598703704,MATH 18,B04,083751,Staff,0,12,30,30
1650598709734,MATH 20A,A01,083754,Staff,19,0,40,21
1650598715759,MATH 20B,A01,083756,Staff,1,12,30,29
1650598715759,MATH 20B,A02,083757,Staff,0,12,30,30
1650598721784,MATH 20C,A01,083760,Staff,0,16,30,30
1650598721784,MATH 20C,A02,083761,Staff,2,14,30,28
1650598721784,MATH 20C,B01,083762,Staff,11,0,30,19
1650598721784,MATH 20C,B02,083763,Staff,28,0,30,2
1650598727808,MATH 20D,A01,083765,Staff,1,1,30,29
1650598727808,MATH 20D,A02,083766,Staff,8,0,30,22
1650598727808,MATH 20D,A03,083767,Staff,25,0,30,5
1650598733834,MATH 20E,A01,083771,Staff,4,0,30,26
1650598733834,MATH 20E,A02,083772,Staff,18,0,30,12
1650598733834,MATH 20E,B01,083773,Staff,0,0,30,30
1650598733834,MATH 20E,B02,083774,Staff,9,0,30,21
1650598739856,MATH 103A,A01,083777,Staff,0,15,30,30
1650598739856,MATH 103A,A02,083778,Staff,0,14,30,30
1650598739856,MATH 103A,B01,083779,Staff,0,14,30,30
1650598739856,MATH 103A,B02,083780,Staff,0,14,30,30
1650598745883,MATH 105,A01,085443,Staff,0,21,30,30
1650598751908,MATH 109,A01,083213,Anzaldo; Leesa B,1,7,30,29
1650598751908,MATH 109,A02,083214,Anzaldo; Leesa B,0,7,30,30
1650598751908,MATH 109,B01,083215,Anzaldo; Leesa B,0,5,30,30
1650598751908,MATH 109,B02,083216,Anzaldo; Leesa B,1,6,30,29
1650598757930,MATH 142A,A01,083219,Chow; Bennett,0,16,30,30
1650598757930,MATH 142A,A02,083220,Chow; Bennett,0,15,30,30
1650598757930,MATH 142A,B01,083221,Chow; Bennett,0,14,30,30
1650598757930,MATH 142A,B02,083222,Chow; Bennett,0,13,30,30
1650598763966,MATH 193A,A01,083224,Staff,1,6,30,29
1650598763966,MATH 193A,A02,083225,Staff,0,6,30,30
1650598763966,MATH 193A,A03,083781,Staff,0,6,30,30
1650598763966,MATH 193A,A04,083782,Staff,0,7,30,30
1650598769989,MATH 197,001,091859,McAuley; Julian John,9998,0,9999,1
1650598776074,COGS 9,A01,083615,Staff,1,16,60,59
1650598782098,COGS 11,A01,083617,Boyle; Mary E. T.,18,0,40,22
1650598788121,COGS 13,A01,083071,Staff,0,37,40,40
1650598794152,COGS 14A,A01,092681,Staff,0,29,100,100
1650598800176,COGS 14B,A01,083073,Cheng; Tzu-Han,0,13,50,50
1650598806211,COGS 17,A01,092677,Staff,16,0,75,59
1650598812242,COGS 100,A01,083619,Staff,1,26,60,59
1650598818264,COGS 101A,A01,083621,Davis; Joshua Daniel,0,26,60,60
1650598824290,COGS 101B,A01,091572,Staff,1,5,60,59
1650598830313,COGS 101C,A01,083625,Delgado; Tania,15,0,30,15
1650598836337,COGS 107A,A01,083627,Boyle; Mary E. T.,0,14,60,60
1650598842369,COGS 118A,A01,083075,Staff,0,4,60,60
1650598848396,CSE 3,A50,083646,Miranda; Gregory Joseph,19,0,38,19
1650598848396,CSE 3,A51,083647,Miranda; Gregory Joseph,36,0,37,1
1650598854419,CSE 8A,A50,083650,Miranda; Gregory Joseph,0,30,40,40
1650598860455,CSE 11,A01,083080,Cao; Yingjun,0,95,40,40
1650598866477,CSE 12,A01,083652,Staff,0,20,100,100
1650598872504,CSE 15L,A01,083654,Staff,0,2,50,50
1650598872504,CSE 15L,A02,083655,Staff,0,1,50,50
1650598878526,CSE 20,A01,083657,Staff,51,0,80,29
1650598884554,CSE 30,A01,083084,Eldon; John,0,78,40,40
1650598890581,CSE 100,A01,083659,Cao; Yingjun,0,68,50,50
1650598896608,CSE 134B,A01,083661,Powell; Thomas Allan,0,35,65,65
1650598902629,CSE 140,A01,083663,Staff,1,9,75,74
1650598908654,CSE 140L,A01,083088,Eldon; John,1,15,75,74
1650598914676,CSE 175,A01,083665,Kumar; Rakesh,7,0,25,18
1650598920705,CSE 190,A00,092507,Dubnov; Shlomo,11,0,20,9
1650598926728,ECE 45,A01,083139,Staff,1,2,60,59
1650598932754,ECE 65,A50,083695,Staff,1,6,30,29
1650598938780,ECE 109,A01,091882,Touri; Behrouz,33,0,70,37
1650598944804,ECE 180,A00,083140,Abi Samra; Nicholas Camill,21,0,30,9
1650598944804,ECE 180,B00,083141,Abi Samra; Nicholas Camill,0,0,30,30
1650598950834,MATH 10A,A01,083735,Patchell; Gregory David,4,0,30,26
1650598950834,MATH 10A,A02,083736,Patchell; Gregory David,27,0,30,3
1650598950834,MATH 10A,A03,083737,Patchell; Gregory David,24,0,30,6
1650598956861,MATH 10B,A01,083207,Staff,0,9,30,30
1650598956861,MATH 10B,A02,083208,Staff,0,8,30,30
1650598956861,MATH 10B,B01,083739,Staff,11,0,30,19
1650598956861,MATH 10B,B02,083740,Staff,28,0,30,2
1650598962901,MATH 18,A01,083743,Staff,0,0,30,30
1650598962901,MATH 18,A02,083744,Staff,23,0,30,7
1650598962901,MATH 18,A03,083745,Staff,21,0,30,9
1650598962901,MATH 18,A04,083746,Staff,26,0,30,4
1650598962901,MATH 18,B01,083748,Staff,0,15,30,30
1650598962901,MATH 18,B02,083749,Staff,1,11,30,29
1650598962901,MATH 18,B03,083750,Staff,0,12,30,30
1650598962901,MATH 18,B04,083751,Staff,0,12,30,30
1650598968926,MATH 20A,A01,083754,Staff,19,0,40,21
1650598974955,MATH 20B,A01,083756,Staff,1,12,30,29
1650598974955,MATH 20B,A02,083757,Staff,0,12,30,30
1650598980978,MATH 20C,A01,083760,Staff,0,16,30,30
1650598980978,MATH 20C,A02,083761,Staff,2,14,30,28
1650598980978,MATH 20C,B01,083762,Staff,11,0,30,19
1650598980978,MATH 20C,B02,083763,Staff,28,0,30,2
1650598987010,MATH 20D,A01,083765,Staff,1,1,30,29
1650598987010,MATH 20D,A02,083766,Staff,8,0,30,22
1650598987010,MATH 20D,A03,083767,Staff,25,0,30,5
1650598993038,MATH 20E,A01,083771,Staff,4,0,30,26
1650598993038,MATH 20E,A02,083772,Staff,18,0,30,12
1650598993038,MATH 20E,B01,083773,Staff,0,0,30,30
1650598993038,MATH 20E,B02,083774,Staff,9,0,30,21
1650598999072,MATH 103A,A01,083777,Staff,0,15,30,30
1650598999072,MATH 103A,A02,083778,Staff,0,14,30,30
1650598999072,MATH 103A,B01,083779,Staff,0,14,30,30
1650598999072,MATH 103A,B02,083780,Staff,0,14,30,30
1650599005098,MATH 105,A01,085443,Staff,0,21,30,30
1650599011129,MATH 109,A01,083213,Anzaldo; Leesa B,1,7,30,29
1650599011129,MATH 109,A02,083214,Anzaldo; Leesa B,0,7,30,30
1650599011129,MATH 109,B01,083215,Anzaldo; Leesa B,0,5,30,30
1650599011129,MATH 109,B02,083216,Anzaldo; Leesa B,1,6,30,29
1650599017157,MATH 142A,A01,083219,Chow; Bennett,0,16,30,30
1650599017157,MATH 142A,A02,083220,Chow; Bennett,0,15,30,30
1650599017157,MATH 142A,B01,083221,Chow; Bennett,0,14,30,30
1650599017157,MATH 142A,B02,083222,Chow; Bennett,0,13,30,30
1650599023181,MATH 193A,A01,083224,Staff,1,6,30,29
1650599023181,MATH 193A,A02,083225,Staff,0,6,30,30
1650599023181,MATH 193A,A03,083781,Staff,0,6,30,30
1650599023181,MATH 193A,A04,083782,Staff,0,7,30,30
1650599029209,MATH 197,001,091859,McAuley; Julian John,9998,0,9999,1
1650599035273,COGS 9,A01,083615,Staff,1,16,60,59
1650599041297,COGS 11,A01,083617,Boyle; Mary E. T.,18,0,40,22
1650599047324,COGS 13,A01,083071,Staff,0,37,40,40
1650599053348,COGS 14A,A01,092681,Staff,0,29,100,100
1650599059374,COGS 14B,A01,083073,Cheng; Tzu-Han,0,13,50,50
1650599065397,COGS 17,A01,092677,Staff,16,0,75,59
1650599071421,COGS 100,A01,083619,Staff,1,27,60,59
1650599077532,COGS 101A,A01,083621,Davis; Joshua Daniel,0,26,60,60
1650599083555,COGS 101B,A01,091572,Staff,1,5,60,59
1650599089579,COGS 101C,A01,083625,Delgado; Tania,15,0,30,15
1650599095604,COGS 107A,A01,083627,Boyle; Mary E. T.,0,14,60,60
1650599101628,COGS 118A,A01,083075,Staff,0,4,60,60
1650599107655,CSE 3,A50,083646,Miranda; Gregory Joseph,19,0,38,19
1650599107655,CSE 3,A51,083647,Miranda; Gregory Joseph,36,0,37,1
1650599113678,CSE 8A,A50,083650,Miranda; Gregory Joseph,0,30,40,40
1650599119704,CSE 11,A01,083080,Cao; Yingjun,0,95,40,40
1650599125728,CSE 12,A01,083652,Staff,0,20,100,100
1650599131752,CSE 15L,A01,083654,Staff,0,2,50,50
1650599131752,CSE 15L,A02,083655,Staff,0,1,50,50
1650599137779,CSE 20,A01,083657,Staff,51,0,80,29
1650599143803,CSE 30,A01,083084,Eldon; John,0,78,40,40
1650599149830,CSE 100,A01,083659,Cao; Yingjun,0,68,50,50
1650599155857,CSE 134B,A01,083661,Powell; Thomas Allan,0,35,65,65
1650599161881,CSE 140,A01,083663,Staff,1,9,75,74
1650599167920,CSE 140L,A01,083088,Eldon; John,1,15,75,74
1650599173950,CSE 175,A01,083665,Kumar; Rakesh,7,0,25,18
1650599179973,CSE 190,A00,092507,Dubnov; Shlomo,11,0,20,9
1650599185999,ECE 45,A01,083139,Staff,1,2,60,59
1650599192025,ECE 65,A50,083695,Staff,1,6,30,29
1650599198051,ECE 109,A01,091882,Touri; Behrouz,33,0,70,37
1650599204080,ECE 180,A00,083140,Abi Samra; Nicholas Camill,21,0,30,9
1650599204080,ECE 180,B00,083141,Abi Samra; Nicholas Camill,0,0,30,30
1650599210113,MATH 10A,A01,083735,Patchell; Gregory David,4,0,30,26
1650599210113,MATH 10A,A02,083736,Patchell; Gregory David,27,0,30,3
1650599210113,MATH 10A,A03,083737,Patchell; Gregory David,24,0,30,6
1650599216136,MATH 10B,A01,083207,Staff,1,9,30,29
1650599216136,MATH 10B,A02,083208,Staff,0,8,30,30
1650599216136,MATH 10B,B01,083739,Staff,11,0,30,19
1650599216136,MATH 10B,B02,083740,Staff,28,0,30,2
1650599222161,MATH 18,A01,083743,Staff,0,0,30,30
1650599222161,MATH 18,A02,083744,Staff,23,0,30,7
1650599222161,MATH 18,A03,083745,Staff,21,0,30,9
1650599222161,MATH 18,A04,083746,Staff,26,0,30,4
1650599222161,MATH 18,B01,083748,Staff,0,15,30,30
1650599222161,MATH 18,B02,083749,Staff,1,11,30,29
1650599222161,MATH 18,B03,083750,Staff,0,12,30,30
1650599222161,MATH 18,B04,083751,Staff,0,12,30,30
1650599228182,MATH 20A,A01,083754,Staff,19,0,40,21
1650599234212,MATH 20B,A01,083756,Staff,1,12,30,29
1650599234212,MATH 20B,A02,083757,Staff,0,12,30,30
1650599240237,MATH 20C,A01,083760,Staff,0,16,30,30
1650599240237,MATH 20C,A02,083761,Staff,2,14,30,28
1650599240237,MATH 20C,B01,083762,Staff,11,0,30,19
1650599240237,MATH 20C,B02,083763,Staff,28,0,30,2
1650599246260,MATH 20D,A01,083765,Staff,1,1,30,29
1650599246260,MATH 20D,A02,083766,Staff,8,0,30,22
1650599246260,MATH 20D,A03,083767,Staff,25,0,30,5
1650599252288,MATH 20E,A01,083771,Staff,4,0,30,26
1650599252288,MATH 20E,A02,083772,Staff,18,0,30,12
1650599252288,MATH 20E,B01,083773,Staff,0,0,30,30
1650599252288,MATH 20E,B02,083774,Staff,9,0,30,21
1650599258316,MATH 103A,A01,083777,Staff,0,15,30,30
1650599258316,MATH 103A,A02,083778,Staff,0,14,30,30
1650599258316,MATH 103A,B01,083779,Staff,0,14,30,30
1650599258316,MATH 103A,B02,083780,Staff,0,14,30,30
1650599264340,MATH 105,A01,085443,Staff,0,21,30,30
1650599270367,MATH 109,A01,083213,Anzaldo; Leesa B,1,7,30,29
1650599270367,MATH 109,A02,083214,Anzaldo; Leesa B,0,7,30,30
1650599270367,MATH 109,B01,083215,Anzaldo; Leesa B,0,5,30,30
1650599270367,MATH 109,B02,083216,Anzaldo; Leesa B,1,6,30,29
1650599276395,MATH 142A,A01,083219,Chow; Bennett,0,16,30,30
1650599276395,MATH 142A,A02,083220,Chow; Bennett,0,15,30,30
1650599276395,MATH 142A,B01,083221,Chow; Bennett,0,14,30,30
1650599276395,MATH 142A,B02,083222,Chow; Bennett,0,13,30,30
1650599282433,MATH 193A,A01,083224,Staff,1,6,30,29
1650599282433,MATH 193A,A02,083225,Staff,0,6,30,30
1650599282433,MATH 193A,A03,083781,Staff,0,6,30,30
1650599282433,MATH 193A,A04,083782,Staff,0,7,30,30
1650599288456,MATH 197,001,091859,McAuley; Julian John,9998,0,9999,1
1650599294521,COGS 9,A01,083615,Staff,1,16,60,59
1650599300548,COGS 11,A01,083617,Boyle; Mary E. T.,18,0,40,22
1650599306574,COGS 13,A01,083071,Staff,0,37,40,40
1650599312600,COGS 14A,A01,092681,Staff,0,29,100,100
1650599318635,COGS 14B,A01,083073,Cheng; Tzu-Han,0,13,50,50
1650599324665,COGS 17,A01,092677,Staff,16,0,75,59
1650599330689,COGS 100,A01,083619,Staff,1,26,60,59
1650599336721,COGS 101A,A01,083621,Davis; Joshua Daniel,0,26,60,60
1650599342746,COGS 101B,A01,091572,Staff,1,5,60,59
1650599348769,COGS 101C,A01,083625,Delgado; Tania,15,0,30,15
1650599354794,COGS 107A,A01,083627,Boyle; Mary E. T.,0,15,60,60
1650599360820,COGS 118A,A01,083075,Staff,0,4,60,60
1650599366848,CSE 3,A50,083646,Miranda; Gregory Joseph,19,0,38,19
1650599366848,CSE 3,A51,083647,Miranda; Gregory Joseph,36,0,37,1
1650599372879,CSE 8A,A50,083650,Miranda; Gregory Joseph,0,30,40,40
1650599378904,CSE 11,A01,083080,Cao; Yingjun,0,95,40,40
1650599384934,CSE 12,A01,083652,Staff,0,20,100,100
1650599390957,CSE 15L,A01,083654,Staff,0,2,50,50
1650599390957,CSE 15L,A02,083655,Staff,0,1,50,50
1650599396985,CSE 20,A01,083657,Staff,51,0,80,29
1650599403017,CSE 30,A01,083084,Eldon; John,0,78,40,40
1650599409041,CSE 100,A01,083659,Cao; Yingjun,0,68,50,50
1650599415063,CSE 134B,A01,083661,Powell; Thomas Allan,0,35,65,65
1650599421097,CSE 140,A01,083663,Staff,1,9,75,74
1650599427122,CSE 140L,A01,083088,Eldon; John,1,15,75,74
1650599433150,CSE 175,A01,083665,Kumar; Rakesh,7,0,25,18
1650599439176,CSE 190,A00,092507,Dubnov; Shlomo,11,0,20,9
1650599445208,ECE 45,A01,083139,Staff,1,2,60,59
1650599451232,ECE 65,A50,083695,Staff,1,6,30,29
1650599457256,ECE 109,A01,091882,Touri; Behrouz,33,0,70,37
1650599463280,ECE 180,A00,083140,Abi Samra; Nicholas Camill,21,0,30,9
1650599463280,ECE 180,B00,083141,Abi Samra; Nicholas Camill,0,0,30,30
1650599469308,MATH 10A,A01,083735,Patchell; Gregory David,4,0,30,26
1650599469308,MATH 10A,A02,083736,Patchell; Gregory David,27,0,30,3
1650599469308,MATH 10A,A03,083737,Patchell; Gregory David,24,0,30,6
1650599475332,MATH 10B,A01,083207,Staff,1,9,30,29
1650599475332,MATH 10B,A02,083208,Staff,0,8,30,30
1650599475332,MATH 10B,B01,083739,Staff,11,0,30,19
1650599475332,MATH 10B,B02,083740,Staff,28,0,30,2
1650599481361,MATH 18,A01,083743,Staff,0,0,30,30
1650599481361,MATH 18,A02,083744,Staff,23,0,30,7
1650599481361,MATH 18,A03,083745,Staff,21,0,30,9
1650599481361,MATH 18,A04,083746,Staff,26,0,30,4
1650599481361,MATH 18,B01,083748,Staff,0,15,30,30
1650599481361,MATH 18,B02,083749,Staff,1,11,30,29
1650599481361,MATH 18,B03,083750,Staff,0,12,30,30
1650599481361,MATH 18,B04,083751,Staff,0,12,30,30
1650599487392,MATH 20A,A01,083754,Staff,19,0,40,21
1650599493428,MATH 20B,A01,083756,Staff,1,12,30,29
1650599493428,MATH 20B,A02,083757,Staff,0,12,30,30
1650599499452,MATH 20C,A01,083760,Staff,0,16,30,30
1650599499452,MATH 20C,A02,083761,Staff,2,14,30,28
1650599499452,MATH 20C,B01,083762,Staff,11,0,30,19
1650599499452,MATH 20C,B02,083763,Staff,28,0,30,2
1650599505489,MATH 20D,A01,083765,Staff,1,1,30,29
1650599505489,MATH 20D,A02,083766,Staff,8,0,30,22
1650599505489,MATH 20D,A03,083767,Staff,25,0,30,5
1650599511516,MATH 20E,A01,083771,Staff,4,0,30,26
1650599511516,MATH 20E,A02,083772,Staff,18,0,30,12
1650599511516,MATH 20E,B01,083773,Staff,0,0,30,30
1650599511516,MATH 20E,B02,083774,Staff,9,0,30,21
1650599517546,MATH 103A,A01,083777,Staff,0,15,30,30
1650599517546,MATH 103A,A02,083778,Staff,0,14,30,30
1650599517546,MATH 103A,B01,083779,Staff,0,14,30,30
1650599517546,MATH 103A,B02,083780,Staff,0,14,30,30
1650599523570,MATH 105,A01,085443,Staff,0,21,30,30
1650599529598,MATH 109,A01,083213,Anzaldo; Leesa B,1,7,30,29
1650599529598,MATH 109,A02,083214,Anzaldo; Leesa B,0,7,30,30
1650599529598,MATH 109,B01,083215,Anzaldo; Leesa B,0,5,30,30
1650599529598,MATH 109,B02,083216,Anzaldo; Leesa B,1,6,30,29
1650599535624,MATH 142A,A01,083219,Chow; Bennett,0,16,30,30
1650599535624,MATH 142A,A02,083220,Chow; Bennett,0,15,30,30
1650599535624,MATH 142A,B01,083221,Chow; Bennett,0,14,30,30
1650599535624,MATH 142A,B02,083222,Chow; Bennett,0,13,30,30
1650599541651,MATH 193A,A01,083224,Staff,1,6,30,29
1650599541651,MATH 193A,A02,083225,Staff,0,6,30,30
1650599541651,MATH 193A,A03,083781,Staff,0,6,30,30
1650599541651,MATH 193A,A04,083782,Staff,0,7,30,30
1650599547674,MATH 197,001,091859,McAuley; Julian John,9998,0,9999,1
1650599553723,COGS 9,A01,083615,Staff,1,16,60,59
1650599559749,COGS 11,A01,083617,Boyle; Mary E. T.,18,0,40,22
1650599565776,COGS 13,A01,083071,Staff,0,37,40,40
1650599571804,COGS 14A,A01,092681,Staff,0,29,100,100
1650599577854,COGS 14B,A01,083073,Cheng; Tzu-Han,0,13,50,50
1650599583876,COGS 17,A01,092677,Staff,16,0,75,59
1650599589900,COGS 100,A01,083619,Staff,1,26,60,59
1650599595928,COGS 101A,A01,083621,Davis; Joshua Daniel,0,26,60,60
1650599601949,COGS 101B,A01,091572,Staff,1,5,60,59
1650599607973,COGS 101C,A01,083625,Delgado; Tania,15,0,30,15
1650599614002,COGS 107A,A01,083627,Boyle; Mary E. T.,0,15,60,60
1650599620026,COGS 118A,A01,083075,Staff,0,4,60,60
1650599626047,CSE 3,A50,083646,Miranda; Gregory Joseph,19,0,38,19
1650599626047,CSE 3,A51,083647,Miranda; Gregory Joseph,36,0,37,1
1650599632071,CSE 8A,A50,083650,Miranda; Gregory Joseph,0,30,40,40
1650599638100,CSE 11,A01,083080,Cao; Yingjun,0,95,40,40
1650599644122,CSE 12,A01,083652,Staff,0,20,100,100
1650599650145,CSE 15L,A01,083654,Staff,0,2,50,50
1650599650145,CSE 15L,A02,083655,Staff,0,1,50,50
1650599656172,CSE 20,A01,083657,Staff,51,0,80,29
1650599671814,CSE 30,A01,083084,Eldon; John,0,78,40,40
1650599677847,CSE 100,A01,083659,Cao; Yingjun,0,68,50,50
1650599683965,CSE 134B,A01,083661,Powell; Thomas Allan,0,35,65,65
1650599689992,CSE 140,A01,083663,Staff,1,9,75,74
1650599696015,CSE 140L,A01,083088,Eldon; John,1,15,75,74
1650599702038,CSE 175,A01,083665,Kumar; Rakesh,7,0,25,18
1650599708062,CSE 190,A00,092507,Dubnov; Shlomo,11,0,20,9
1650599714097,ECE 45,A01,083139,Staff,1,2,60,59
1650599720134,ECE 65,A50,083695,Staff,1,6,30,29
1650599726158,ECE 109,A01,091882,Touri; Behrouz,33,0,70,37
1650599732193,ECE 180,A00,083140,Abi Samra; Nicholas Camill,21,0,30,9
1650599732193,ECE 180,B00,083141,Abi Samra; Nicholas Camill,0,0,30,30
1650599738220,MATH 10A,A01,083735,Patchell; Gregory David,4,0,30,26
1650599738220,MATH 10A,A02,083736,Patchell; Gregory David,27,0,30,3
1650599738220,MATH 10A,A03,083737,Patchell; Gregory David,24,0,30,6
1650599744243,MATH 10B,A01,083207,Staff,1,9,30,29
1650599744243,MATH 10B,A02,083208,Staff,0,8,30,30
1650599744243,MATH 10B,B01,083739,Staff,11,0,30,19
1650599744243,MATH 10B,B02,083740,Staff,28,0,30,2
1650599750268,MATH 18,A01,083743,Staff,0,0,30,30
1650599750268,MATH 18,A02,083744,Staff,23,0,30,7
1650599750268,MATH 18,A03,083745,Staff,21,0,30,9
1650599750268,MATH 18,A04,083746,Staff,26,0,30,4
1650599750268,MATH 18,B01,083748,Staff,0,15,30,30
1650599750268,MATH 18,B02,083749,Staff,1,11,30,29
1650599750268,MATH 18,B03,083750,Staff,0,12,30,30
1650599750268,MATH 18,B04,083751,Staff,0,12,30,30
1650599756293,MATH 20A,A01,083754,Staff,19,0,40,21
1650599762322,MATH 20B,A01,083756,Staff,1,12,30,29
1650599762322,MATH 20B,A02,083757,Staff,0,12,30,30
1650599768347,MATH 20C,A01,083760,Staff,0,16,30,30
1650599768347,MATH 20C,A02,083761,Staff,2,14,30,28
1650599768347,MATH 20C,B01,083762,Staff,11,0,30,19
1650599768347,MATH 20C,B02,083763,Staff,28,0,30,2
1650599774370,MATH 20D,A01,083765,Staff,1,1,30,29
1650599774370,MATH 20D,A02,083766,Staff,8,0,30,22
1650599774370,MATH 20D,A03,083767,Staff,25,0,30,5
1650599780394,MATH 20E,A01,083771,Staff,4,0,30,26
1650599780394,MATH 20E,A02,083772,Staff,18,0,30,12
1650599780394,MATH 20E,B01,083773,Staff,0,0,30,30
1650599780394,MATH 20E,B02,083774,Staff,9,0,30,21
1650599786422,MATH 103A,A01,083777,Staff,0,15,30,30
1650599786422,MATH 103A,A02,083778,Staff,0,14,30,30
1650599786422,MATH 103A,B01,083779,Staff,0,14,30,30
1650599786422,MATH 103A,B02,083780,Staff,0,14,30,30
1650599792461,MATH 105,A01,085443,Staff,0,21,30,30
1650599798488,MATH 109,A01,083213,Anzaldo; Leesa B,1,7,30,29
1650599798488,MATH 109,A02,083214,Anzaldo; Leesa B,0,7,30,30
1650599798488,MATH 109,B01,083215,Anzaldo; Leesa B,0,5,30,30
1650599798488,MATH 109,B02,083216,Anzaldo; Leesa B,1,6,30,29
1650599804513,MATH 142A,A01,083219,Chow; Bennett,0,16,30,30
1650599804513,MATH 142A,A02,083220,Chow; Bennett,0,15,30,30
1650599804513,MATH 142A,B01,083221,Chow; Bennett,0,14,30,30
1650599804513,MATH 142A,B02,083222,Chow; Bennett,0,13,30,30
1650599810540,MATH 193A,A01,083224,Staff,1,6,30,29
1650599810540,MATH 193A,A02,083225,Staff,0,6,30,30
1650599810540,MATH 193A,A03,083781,Staff,0,6,30,30
1650599810540,MATH 193A,A04,083782,Staff,0,7,30,30
1650599816565,MATH 197,001,091859,McAuley; Julian John,9998,0,9999,1
1650599822615,COGS 9,A01,083615,Staff,1,16,60,59
1650599828638,COGS 11,A01,083617,Boyle; Mary E. T.,18,0,40,22
1650599834663,COGS 13,A01,083071,Staff,0,37,40,40
1650599840688,COGS 14A,A01,092681,Staff,0,29,100,100
1650599846712,COGS 14B,A01,083073,Cheng; Tzu-Han,0,13,50,50
1650599852737,COGS 17,A01,092677,Staff,16,0,75,59
1650599858760,COGS 100,A01,083619,Staff,1,26,60,59
1650599864788,COGS 101A,A01,083621,Davis; Joshua Daniel,0,26,60,60
1650599870810,COGS 101B,A01,091572,Staff,1,5,60,59
1650599876836,COGS 101C,A01,083625,Delgado; Tania,15,0,30,15
1650599882870,COGS 107A,A01,083627,Boyle; Mary E. T.,0,15,60,60
1650599888895,COGS 118A,A01,083075,Staff,0,4,60,60
1650599894923,CSE 3,A50,083646,Miranda; Gregory Joseph,19,0,38,19
1650599894923,CSE 3,A51,083647,Miranda; Gregory Joseph,36,0,37,1
1650599900951,CSE 8A,A50,083650,Miranda; Gregory Joseph,0,30,40,40
1650599906975,CSE 11,A01,083080,Cao; Yingjun,0,95,40,40
1650599912998,CSE 12,A01,083652,Staff,0,20,100,100
1650599919020,CSE 15L,A01,083654,Staff,0,2,50,50
1650599919020,CSE 15L,A02,083655,Staff,0,1,50,50
1650599925050,CSE 20,A01,083657,Staff,51,0,80,29
1650599931076,CSE 30,A01,083084,Eldon; John,0,78,40,40
1650599937103,CSE 100,A01,083659,Cao; Yingjun,0,68,50,50
1650599943129,CSE 134B,A01,083661,Powell; Thomas Allan,0,35,65,65
1650599949154,CSE 140,A01,083663,Staff,1,9,75,74
1650599955181,CSE 140L,A01,083088,Eldon; John,1,15,75,74
1650599961203,CSE 175,A01,083665,Kumar; Rakesh,7,0,25,18
1650599967225,CSE 190,A00,092507,Dubnov; Shlomo,11,0,20,9
1650599973249,ECE 45,A01,083139,Staff,1,2,60,59
1650599979272,ECE 65,A50,083695,Staff,1,6,30,29
1650599985296,ECE 109,A01,091882,Touri; Behrouz,33,0,70,37
1650599991325,ECE 180,A00,083140,Abi Samra; Nicholas Camill,21,0,30,9
1650599991325,ECE 180,B00,083141,Abi Samra; Nicholas Camill,0,0,30,30
1650599997348,MATH 10A,A01,083735,Patchell; Gregory David,4,0,30,26
1650599997348,MATH 10A,A02,083736,Patchell; Gregory David,27,0,30,3
1650599997348,MATH 10A,A03,083737,Patchell; Gregory David,24,0,30,6
1650600003373,MATH 10B,A01,083207,Staff,1,9,30,29
1650600003373,MATH 10B,A02,083208,Staff,0,8,30,30
1650600003373,MATH 10B,B01,083739,Staff,11,0,30,19
1650600003373,MATH 10B,B02,083740,Staff,28,0,30,2
1650600009402,MATH 18,A01,083743,Staff,0,0,30,30
1650600009402,MATH 18,A02,083744,Staff,23,0,30,7
1650600009402,MATH 18,A03,083745,Staff,21,0,30,9
1650600009402,MATH 18,A04,083746,Staff,26,0,30,4
1650600009402,MATH 18,B01,083748,Staff,0,15,30,30
1650600009402,MATH 18,B02,083749,Staff,1,11,30,29
1650600009402,MATH 18,B03,083750,Staff,0,12,30,30
1650600009402,MATH 18,B04,083751,Staff,0,12,30,30
1650600015429,MATH 20A,A01,083754,Staff,19,0,40,21
1650600021455,MATH 20B,A01,083756,Staff,1,12,30,29
1650600021455,MATH 20B,A02,083757,Staff,0,12,30,30
1650600027479,MATH 20C,A01,083760,Staff,0,16,30,30
1650600027479,MATH 20C,A02,083761,Staff,2,14,30,28
1650600027479,MATH 20C,B01,083762,Staff,11,0,30,19
1650600027479,MATH 20C,B02,083763,Staff,28,0,30,2
1650600033503,MATH 20D,A01,083765,Staff,1,1,30,29
1650600033503,MATH 20D,A02,083766,Staff,8,0,30,22
1650600033503,MATH 20D,A03,083767,Staff,25,0,30,5
1650600039529,MATH 20E,A01,083771,Staff,4,0,30,26
1650600039529,MATH 20E,A02,083772,Staff,18,0,30,12
1650600039529,MATH 20E,B01,083773,Staff,0,0,30,30
1650600039529,MATH 20E,B02,083774,Staff,9,0,30,21
1650600045553,MATH 103A,A01,083777,Staff,0,15,30,30
1650600045553,MATH 103A,A02,083778,Staff,0,14,30,30
1650600045553,MATH 103A,B01,083779,Staff,0,14,30,30
1650600045553,MATH 103A,B02,083780,Staff,0,14,30,30
1650600051577,MATH 105,A01,085443,Staff,0,21,30,30
1650600057600,MATH 109,A01,083213,Anzaldo; Leesa B,1,7,30,29
1650600057600,MATH 109,A02,083214,Anzaldo; Leesa B,0,7,30,30
1650600057600,MATH 109,B01,083215,Anzaldo; Leesa B,0,5,30,30
1650600057600,MATH 109,B02,083216,Anzaldo; Leesa B,1,6,30,29
1650600063629,MATH 142A,A01,083219,Chow; Bennett,0,16,30,30
1650600063629,MATH 142A,A02,083220,Chow; Bennett,0,15,30,30
1650600063629,MATH 142A,B01,083221,Chow; Bennett,0,14,30,30
1650600063629,MATH 142A,B02,083222,Chow; Bennett,0,13,30,30
1650600069652,MATH 193A,A01,083224,Staff,1,6,30,29
1650600069652,MATH 193A,A02,083225,Staff,0,6,30,30
1650600069652,MATH 193A,A03,083781,Staff,0,6,30,30
1650600069652,MATH 193A,A04,083782,Staff,0,7,30,30
1650600075679,MATH 197,001,091859,McAuley; Julian John,9998,0,9999,1
1650600081746,COGS 9,A01,083615,Staff,1,16,60,59
1650600087770,COGS 11,A01,083617,Boyle; Mary E. T.,18,0,40,22
1650600093794,COGS 13,A01,083071,Staff,0,37,40,40
1650600099826,COGS 14A,A01,092681,Staff,0,29,100,100
1650600105848,COGS 14B,A01,083073,Cheng; Tzu-Han,0,13,50,50
1650600111872,COGS 17,A01,092677,Staff,16,0,75,59
1650600117899,COGS 100,A01,083619,Staff,1,26,60,59
1650600123925,COGS 101A,A01,083621,Davis; Joshua Daniel,0,26,60,60
1650600129948,COGS 101B,A01,091572,Staff,1,5,60,59
1650600135972,COGS 101C,A01,083625,Delgado; Tania,15,0,30,15
1650600141996,COGS 107A,A01,083627,Boyle; Mary E. T.,0,15,60,60
1650600148020,COGS 118A,A01,083075,Staff,0,4,60,60
1650600154044,CSE 3,A50,083646,Miranda; Gregory Joseph,19,0,38,19
1650600154044,CSE 3,A51,083647,Miranda; Gregory Joseph,36,0,37,1
1650600160073,CSE 8A,A50,083650,Miranda; Gregory Joseph,0,30,40,40
1650600166095,CSE 11,A01,083080,Cao; Yingjun,0,95,40,40
1650600172121,CSE 12,A01,083652,Staff,0,20,100,100
1650600178144,CSE 15L,A01,083654,Staff,0,2,50,50
1650600178144,CSE 15L,A02,083655,Staff,0,1,50,50
1650600184176,CSE 20,A01,083657,Staff,51,0,80,29
1650600190203,CSE 30,A01,083084,Eldon; John,0,78,40,40
1650600196229,CSE 100,A01,083659,Cao; Yingjun,0,68,50,50
1650600202253,CSE 134B,A01,083661,Powell; Thomas Allan,0,35,65,65
1650600208276,CSE 140,A01,083663,Staff,1,9,75,74
1650600214299,CSE 140L,A01,083088,Eldon; John,1,15,75,74
1650600220322,CSE 175,A01,083665,Kumar; Rakesh,7,0,25,18
1650600226346,CSE 190,A00,092507,Dubnov; Shlomo,11,0,20,9
1650600232379,ECE 45,A01,083139,Staff,1,2,60,59
1650600238406,ECE 65,A50,083695,Staff,1,6,30,29
1650600244430,ECE 109,A01,091882,Touri; Behrouz,33,0,70,37
1650600250458,ECE 180,A00,083140,Abi Samra; Nicholas Camill,21,0,30,9
1650600250458,ECE 180,B00,083141,Abi Samra; Nicholas Camill,0,0,30,30
1650600256486,MATH 10A,A01,083735,Patchell; Gregory David,4,0,30,26
1650600256486,MATH 10A,A02,083736,Patchell; Gregory David,27,0,30,3
1650600256486,MATH 10A,A03,083737,Patchell; Gregory David,24,0,30,6
1650600262511,MATH 10B,A01,083207,Staff,1,9,30,29
1650600262511,MATH 10B,A02,083208,Staff,0,8,30,30
1650600262511,MATH 10B,B01,083739,Staff,11,0,30,19
1650600262511,MATH 10B,B02,083740,Staff,28,0,30,2
1650600268538,MATH 18,A01,083743,Staff,0,0,30,30
1650600268538,MATH 18,A02,083744,Staff,23,0,30,7
1650600268538,MATH 18,A03,083745,Staff,21,0,30,9
1650600268538,MATH 18,A04,083746,Staff,26,0,30,4
1650600268538,MATH 18,B01,083748,Staff,0,15,30,30
1650600268538,MATH 18,B02,083749,Staff,1,11,30,29
1650600268538,MATH 18,B03,083750,Staff,0,12,30,30
1650600268538,MATH 18,B04,083751,Staff,0,12,30,30
1650600274566,MATH 20A,A01,083754,Staff,19,0,40,21
1650600280662,MATH 20B,A01,083756,Staff,1,12,30,29
1650600280662,MATH 20B,A02,083757,Staff,0,12,30,30
1650600286690,MATH 20C,A01,083760,Staff,0,16,30,30
1650600286690,MATH 20C,A02,083761,Staff,2,14,30,28
1650600286690,MATH 20C,B01,083762,Staff,11,0,30,19
1650600286690,MATH 20C,B02,083763,Staff,28,0,30,2
1650600292714,MATH 20D,A01,083765,Staff,1,1,30,29
1650600292714,MATH 20D,A02,083766,Staff,8,0,30,22
1650600292714,MATH 20D,A03,083767,Staff,25,0,30,5
1650600298741,MATH 20E,A01,083771,Staff,4,0,30,26
1650600298741,MATH 20E,A02,083772,Staff,18,0,30,12
1650600298741,MATH 20E,B01,083773,Staff,0,0,30,30
1650600298741,MATH 20E,B02,083774,Staff,9,0,30,21
1650600304771,MATH 103A,A01,083777,Staff,0,15,30,30
1650600304771,MATH 103A,A02,083778,Staff,0,14,30,30
1650600304771,MATH 103A,B01,083779,Staff,0,14,30,30
1650600304771,MATH 103A,B02,083780,Staff,0,14,30,30
1650600310794,MATH 105,A01,085443,Staff,0,21,30,30
1650600316824,MATH 109,A01,083213,Anzaldo; Leesa B,1,7,30,29
1650600316824,MATH 109,A02,083214,Anzaldo; Leesa B,0,7,30,30
1650600316824,MATH 109,B01,083215,Anzaldo; Leesa B,0,5,30,30
1650600316824,MATH 109,B02,083216,Anzaldo; Leesa B,1,6,30,29
1650600322849,MATH 142A,A01,083219,Chow; Bennett,0,16,30,30
1650600322849,MATH 142A,A02,083220,Chow; Bennett,0,15,30,30
1650600322849,MATH 142A,B01,083221,Chow; Bennett,0,14,30,30
1650600322849,MATH 142A,B02,083222,Chow; Bennett,0,13,30,30
1650600328873,MATH 193A,A01,083224,Staff,1,6,30,29
1650600328873,MATH 193A,A02,083225,Staff,0,6,30,30
1650600328873,MATH 193A,A03,083781,Staff,0,6,30,30
1650600328873,MATH 193A,A04,083782,Staff,0,7,30,30
1650600334896,MATH 197,001,091859,McAuley; Julian John,9998,0,9999,1
1650600340954,COGS 9,A01,083615,Staff,1,16,60,59
1650600346984,COGS 11,A01,083617,Boyle; Mary E. T.,18,0,40,22
1650600353008,COGS 13,A01,083071,Staff,0,37,40,40
1650600359034,COGS 14A,A01,092681,Staff,0,29,100,100
1650600365058,COGS 14B,A01,083073,Cheng; Tzu-Han,0,13,50,50
1650600371083,COGS 17,A01,092677,Staff,16,0,75,59
1650600377111,COGS 100,A01,083619,Staff,1,26,60,59
1650600383135,COGS 101A,A01,083621,Davis; Joshua Daniel,0,26,60,60
1650600389158,COGS 101B,A01,091572,Staff,1,5,60,59
1650600395194,COGS 101C,A01,083625,Delgado; Tania,15,0,30,15
1650600401218,COGS 107A,A01,083627,Boyle; Mary E. T.,0,15,60,60
1650600407244,COGS 118A,A01,083075,Staff,0,4,60,60
1650600413267,CSE 3,A50,083646,Miranda; Gregory Joseph,19,0,38,19
1650600413267,CSE 3,A51,083647,Miranda; Gregory Joseph,36,0,37,1
1650600419296,CSE 8A,A50,083650,Miranda; Gregory Joseph,0,30,40,40
1650600425320,CSE 11,A01,083080,Cao; Yingjun,0,95,40,40
1650600431342,CSE 12,A01,083652,Staff,0,20,100,100
1650600437366,CSE 15L,A01,083654,Staff,0,2,50,50
1650600437366,CSE 15L,A02,083655,Staff,0,1,50,50
1650600443393,CSE 20,A01,083657,Staff,51,0,80,29
1650600449420,CSE 30,A01,083084,Eldon; John,0,78,40,40
1650600455444,CSE 100,A01,083659,Cao; Yingjun,0,68,50,50
1650600461468,CSE 134B,A01,083661,Powell; Thomas Allan,0,35,65,65
1650600467492,CSE 140,A01,083663,Staff,1,9,75,74
1650600473523,CSE 140L,A01,083088,Eldon; John,1,15,75,74
1650600479546,CSE 175,A01,083665,Kumar; Rakesh,7,0,25,18
1650600485571,CSE 190,A00,092507,Dubnov; Shlomo,11,0,20,9
1650600491617,ECE 45,A01,083139,Staff,1,2,60,59
1650600497639,ECE 65,A50,083695,Staff,1,6,30,29
1650600503672,ECE 109,A01,091882,Touri; Behrouz,33,0,70,37
1650600509694,ECE 180,A00,083140,Abi Samra; Nicholas Camill,21,0,30,9
1650600509694,ECE 180,B00,083141,Abi Samra; Nicholas Camill,0,0,30,30
1650600515722,MATH 10A,A01,083735,Patchell; Gregory David,4,0,30,26
1650600515722,MATH 10A,A02,083736,Patchell; Gregory David,27,0,30,3
1650600515722,MATH 10A,A03,083737,Patchell; Gregory David,24,0,30,6
1650600521746,MATH 10B,A01,083207,Staff,1,9,30,29
1650600521746,MATH 10B,A02,083208,Staff,0,8,30,30
1650600521746,MATH 10B,B01,083739,Staff,11,0,30,19
1650600521746,MATH 10B,B02,083740,Staff,28,0,30,2
1650600527772,MATH 18,A01,083743,Staff,0,0,30,30
1650600527772,MATH 18,A02,083744,Staff,23,0,30,7
1650600527772,MATH 18,A03,083745,Staff,21,0,30,9
1650600527772,MATH 18,A04,083746,Staff,26,0,30,4
1650600527772,MATH 18,B01,083748,Staff,0,15,30,30
1650600527772,MATH 18,B02,083749,Staff,1,11,30,29
1650600527772,MATH 18,B03,083750,Staff,0,12,30,30
1650600527772,MATH 18,B04,083751,Staff,0,12,30,30
1650600533797,MATH 20A,A01,083754,Staff,19,0,40,21
1650600539821,MATH 20B,A01,083756,Staff,1,12,30,29
1650600539821,MATH 20B,A02,083757,Staff,0,12,30,30
1650600545845,MATH 20C,A01,083760,Staff,0,16,30,30
1650600545845,MATH 20C,A02,083761,Staff,2,14,30,28
1650600545845,MATH 20C,B01,083762,Staff,11,0,30,19
1650600545845,MATH 20C,B02,083763,Staff,28,0,30,2
1650600551877,MATH 20D,A01,083765,Staff,1,1,30,29
1650600551877,MATH 20D,A02,083766,Staff,8,0,30,22
1650600551877,MATH 20D,A03,083767,Staff,25,0,30,5
1650600557913,MATH 20E,A01,083771,Staff,4,0,30,26
1650600557913,MATH 20E,A02,083772,Staff,18,0,30,12
1650600557913,MATH 20E,B01,083773,Staff,0,0,30,30
1650600557913,MATH 20E,B02,083774,Staff,9,0,30,21
1650600563938,MATH 103A,A01,083777,Staff,0,15,30,30
1650600563938,MATH 103A,A02,083778,Staff,0,14,30,30
1650600563938,MATH 103A,B01,083779,Staff,0,14,30,30
1650600563938,MATH 103A,B02,083780,Staff,0,14,30,30
1650600569961,MATH 105,A01,085443,Staff,0,21,30,30
1650600575985,MATH 109,A01,083213,Anzaldo; Leesa B,1,7,30,29
1650600575985,MATH 109,A02,083214,Anzaldo; Leesa B,0,7,30,30
1650600575985,MATH 109,B01,083215,Anzaldo; Leesa B,0,5,30,30
1650600575985,MATH 109,B02,083216,Anzaldo; Leesa B,1,6,30,29
1650600582015,MATH 142A,A01,083219,Chow; Bennett,0,16,30,30
1650600582015,MATH 142A,A02,083220,Chow; Bennett,0,15,30,30
1650600582015,MATH 142A,B01,083221,Chow; Bennett,0,14,30,30
1650600582015,MATH 142A,B02,083222,Chow; Bennett,0,13,30,30
1650600588053,MATH 193A,A01,083224,Staff,1,6,30,29
1650600588053,MATH 193A,A02,083225,Staff,0,6,30,30
1650600588053,MATH 193A,A03,083781,Staff,0,6,30,30
1650600588053,MATH 193A,A04,083782,Staff,0,7,30,30
1650600594074,MATH 197,001,091859,McAuley; Julian John,9998,0,9999,1
1650600600141,COGS 9,A01,083615,Staff,1,16,60,59
1650600606172,COGS 11,A01,083617,Boyle; Mary E. T.,18,0,40,22
1650600612194,COGS 13,A01,083071,Staff,0,37,40,40
1650600618216,COGS 14A,A01,092681,Staff,0,29,100,100
1650600624238,COGS 14B,A01,083073,Cheng; Tzu-Han,0,13,50,50
1650600630265,COGS 17,A01,092677,Staff,16,0,75,59
1650600636289,COGS 100,A01,083619,Staff,1,26,60,59
1650600642315,COGS 101A,A01,083621,Davis; Joshua Daniel,0,26,60,60
1650600648337,COGS 101B,A01,091572,Staff,1,5,60,59
1650600654360,COGS 101C,A01,083625,Delgado; Tania,15,0,30,15
1650600660399,COGS 107A,A01,083627,Boyle; Mary E. T.,0,15,60,60
1650600666422,COGS 118A,A01,083075,Staff,0,4,60,60
1650600672447,CSE 3,A50,083646,Miranda; Gregory Joseph,19,0,38,19
1650600672447,CSE 3,A51,083647,Miranda; Gregory Joseph,36,0,37,1
1650600678471,CSE 8A,A50,083650,Miranda; Gregory Joseph,0,30,40,40
1650600684494,CSE 11,A01,083080,Cao; Yingjun,0,95,40,40
1650600690520,CSE 12,A01,083652,Staff,0,20,100,100
1650600696546,CSE 15L,A01,083654,Staff,0,2,50,50
1650600696546,CSE 15L,A02,083655,Staff,0,1,50,50
1650600702573,CSE 20,A01,083657,Staff,51,0,80,29
1650600708596,CSE 30,A01,083084,Eldon; John,0,78,40,40
1650600714622,CSE 100,A01,083659,Cao; Yingjun,0,68,50,50
1650600720649,CSE 134B,A01,083661,Powell; Thomas Allan,0,35,65,65
1650600726672,CSE 140,A01,083663,Staff,1,9,75,74
1650600732706,CSE 140L,A01,083088,Eldon; John,1,15,75,74
1650600738729,CSE 175,A01,083665,Kumar; Rakesh,7,0,25,18
1650600744763,CSE 190,A00,092507,Dubnov; Shlomo,11,0,20,9
1650600750787,ECE 45,A01,083139,Staff,1,2,60,59
1650600756816,ECE 65,A50,083695,Staff,1,6,30,29
1650600762841,ECE 109,A01,091882,Touri; Behrouz,33,0,70,37
1650600768863,ECE 180,A00,083140,Abi Samra; Nicholas Camill,21,0,30,9
1650600768863,ECE 180,B00,083141,Abi Samra; Nicholas Camill,0,0,30,30
1650600774890,MATH 10A,A01,083735,Patchell; Gregory David,4,0,30,26
1650600774890,MATH 10A,A02,083736,Patchell; Gregory David,27,0,30,3
1650600774890,MATH 10A,A03,083737,Patchell; Gregory David,24,0,30,6
1650600780920,MATH 10B,A01,083207,Staff,1,9,30,29
1650600780920,MATH 10B,A02,083208,Staff,0,8,30,30
1650600780920,MATH 10B,B01,083739,Staff,11,0,30,19
1650600780920,MATH 10B,B02,083740,Staff,28,0,30,2
1650600786947,MATH 18,A01,083743,Staff,0,0,30,30
1650600786947,MATH 18,A02,083744,Staff,23,0,30,7
1650600786947,MATH 18,A03,083745,Staff,21,0,30,9
1650600786947,MATH 18,A04,083746,Staff,26,0,30,4
1650600786947,MATH 18,B01,083748,Staff,0,15,30,30
1650600786947,MATH 18,B02,083749,Staff,1,11,30,29
1650600786947,MATH 18,B03,083750,Staff,0,12,30,30
1650600786947,MATH 18,B04,083751,Staff,0,12,30,30
1650600792973,MATH 20A,A01,083754,Staff,19,0,40,21
1650600799011,MATH 20B,A01,083756,Staff,1,12,30,29
1650600799011,MATH 20B,A02,083757,Staff,0,12,30,30
1650600805035,MATH 20C,A01,083760,Staff,0,16,30,30
1650600805035,MATH 20C,A02,083761,Staff,2,14,30,28
1650600805035,MATH 20C,B01,083762,Staff,11,0,30,19
1650600805035,MATH 20C,B02,083763,Staff,28,0,30,2
1650600811058,MATH 20D,A01,083765,Staff,1,1,30,29
1650600811058,MATH 20D,A02,083766,Staff,8,0,30,22
1650600811058,MATH 20D,A03,083767,Staff,25,0,30,5
1650600817086,MATH 20E,A01,083771,Staff,4,0,30,26
1650600817086,MATH 20E,A02,083772,Staff,18,0,30,12
1650600817086,MATH 20E,B01,083773,Staff,0,0,30,30
1650600817086,MATH 20E,B02,083774,Staff,9,0,30,21
1650600823111,MATH 103A,A01,083777,Staff,0,15,30,30
1650600823111,MATH 103A,A02,083778,Staff,0,14,30,30
1650600823111,MATH 103A,B01,083779,Staff,0,14,30,30
1650600823111,MATH 103A,B02,083780,Staff,0,14,30,30
1650600829134,MATH 105,A01,085443,Staff,0,21,30,30
1650600835160,MATH 109,A01,083213,Anzaldo; Leesa B,1,7,30,29
1650600835160,MATH 109,A02,083214,Anzaldo; Leesa B,0,7,30,30
1650600835160,MATH 109,B01,083215,Anzaldo; Leesa B,0,5,30,30
1650600835160,MATH 109,B02,083216,Anzaldo; Leesa B,1,6,30,29
1650600841183,MATH 142A,A01,083219,Chow; Bennett,0,16,30,30
1650600841183,MATH 142A,A02,083220,Chow; Bennett,0,15,30,30
1650600841183,MATH 142A,B01,083221,Chow; Bennett,0,14,30,30
1650600841183,MATH 142A,B02,083222,Chow; Bennett,0,13,30,30
1650600847210,MATH 193A,A01,083224,Staff,1,6,30,29
1650600847210,MATH 193A,A02,083225,Staff,0,6,30,30
1650600847210,MATH 193A,A03,083781,Staff,0,6,30,30
1650600847210,MATH 193A,A04,083782,Staff,0,7,30,30
1650600853235,MATH 197,001,091859,McAuley; Julian John,9998,0,9999,1
1650600859293,COGS 9,A01,083615,Staff,1,16,60,59
1650600865317,COGS 11,A01,083617,Boyle; Mary E. T.,18,0,40,22
1650600871428,COGS 13,A01,083071,Staff,0,37,40,40
1650600877449,COGS 14A,A01,092681,Staff,0,29,100,100
1650600883473,COGS 14B,A01,083073,Cheng; Tzu-Han,0,13,50,50
1650600889498,COGS 17,A01,092677,Staff,16,0,75,59
1650600895522,COGS 100,A01,083619,Staff,1,26,60,59
1650600901549,COGS 101A,A01,083621,Davis; Joshua Daniel,0,26,60,60
1650600907571,COGS 101B,A01,091572,Staff,1,5,60,59
1650600913604,COGS 101C,A01,083625,Delgado; Tania,15,0,30,15
1650600919628,COGS 107A,A01,083627,Boyle; Mary E. T.,0,15,60,60
1650600925661,COGS 118A,A01,083075,Staff,0,4,60,60
1650600931685,CSE 3,A50,083646,Miranda; Gregory Joseph,19,0,38,19
1650600931685,CSE 3,A51,083647,Miranda; Gregory Joseph,36,0,37,1
1650600937710,CSE 8A,A50,083650,Miranda; Gregory Joseph,0,30,40,40
1650600943737,CSE 11,A01,083080,Cao; Yingjun,0,95,40,40
1650600949760,CSE 12,A01,083652,Staff,0,20,100,100
1650600955784,CSE 15L,A01,083654,Staff,0,2,50,50
1650600955784,CSE 15L,A02,083655,Staff,0,1,50,50
1650600961808,CSE 20,A01,083657,Staff,51,0,80,29
1650600967834,CSE 30,A01,083084,Eldon; John,0,78,40,40
1650600973861,CSE 100,A01,083659,Cao; Yingjun,0,68,50,50
1650600979890,CSE 134B,A01,083661,Powell; Thomas Allan,0,35,65,65
1650600985916,CSE 140,A01,083663,Staff,1,9,75,74
1650600991941,CSE 140L,A01,083088,Eldon; John,1,15,75,74
1650600997965,CSE 175,A01,083665,Kumar; Rakesh,7,0,25,18
1650601003994,CSE 190,A00,092507,Dubnov; Shlomo,11,0,20,9
1650601010020,ECE 45,A01,083139,Staff,1,2,60,59
1650601016043,ECE 65,A50,083695,Staff,1,6,30,29
1650601022070,ECE 109,A01,091882,Touri; Behrouz,33,0,70,37
1650601028101,ECE 180,A00,083140,Abi Samra; Nicholas Camill,21,0,30,9
1650601028101,ECE 180,B00,083141,Abi Samra; Nicholas Camill,0,0,30,30
1650601034124,MATH 10A,A01,083735,Patchell; Gregory David,4,0,30,26
1650601034124,MATH 10A,A02,083736,Patchell; Gregory David,27,0,30,3
1650601034124,MATH 10A,A03,083737,Patchell; Gregory David,24,0,30,6
1650601040149,MATH 10B,A01,083207,Staff,1,9,30,29
1650601040149,MATH 10B,A02,083208,Staff,0,8,30,30
1650601040149,MATH 10B,B01,083739,Staff,11,0,30,19
1650601040149,MATH 10B,B02,083740,Staff,28,0,30,2
1650601046186,MATH 18,A01,083743,Staff,0,0,30,30
1650601046186,MATH 18,A02,083744,Staff,23,0,30,7
1650601046186,MATH 18,A03,083745,Staff,21,0,30,9
1650601046186,MATH 18,A04,083746,Staff,26,0,30,4
1650601046186,MATH 18,B01,083748,Staff,0,15,30,30
1650601046186,MATH 18,B02,083749,Staff,1,11,30,29
1650601046186,MATH 18,B03,083750,Staff,0,12,30,30
1650601046186,MATH 18,B04,083751,Staff,0,12,30,30
1650601052210,MATH 20A,A01,083754,Staff,19,0,40,21
1650601058236,MATH 20B,A01,083756,Staff,1,12,30,29
1650601058236,MATH 20B,A02,083757,Staff,0,12,30,30
1650601064261,MATH 20C,A01,083760,Staff,0,16,30,30
1650601064261,MATH 20C,A02,083761,Staff,2,14,30,28
1650601064261,MATH 20C,B01,083762,Staff,11,0,30,19
1650601064261,MATH 20C,B02,083763,Staff,28,0,30,2
1650601070296,MATH 20D,A01,083765,Staff,1,1,30,29
1650601070296,MATH 20D,A02,083766,Staff,8,0,30,22
1650601070296,MATH 20D,A03,083767,Staff,24,0,30,6
1650601076324,MATH 20E,A01,083771,Staff,3,0,30,27
1650601076324,MATH 20E,A02,083772,Staff,18,0,30,12
1650601076324,MATH 20E,B01,083773,Staff,0,0,30,30
1650601076324,MATH 20E,B02,083774,Staff,9,0,30,21
1650601082353,MATH 103A,A01,083777,Staff,0,15,30,30
1650601082353,MATH 103A,A02,083778,Staff,0,14,30,30
1650601082353,MATH 103A,B01,083779,Staff,0,14,30,30
1650601082353,MATH 103A,B02,083780,Staff,0,14,30,30
1650601088377,MATH 105,A01,085443,Staff,0,21,30,30
1650601094403,MATH 109,A01,083213,Anzaldo; Leesa B,1,7,30,29
1650601094403,MATH 109,A02,083214,Anzaldo; Leesa B,0,7,30,30
1650601094403,MATH 109,B01,083215,Anzaldo; Leesa B,0,5,30,30
1650601094403,MATH 109,B02,083216,Anzaldo; Leesa B,1,6,30,29
1650601100436,MATH 142A,A01,083219,Chow; Bennett,0,16,30,30
1650601100436,MATH 142A,A02,083220,Chow; Bennett,0,15,30,30
1650601100436,MATH 142A,B01,083221,Chow; Bennett,0,14,30,30
1650601100436,MATH 142A,B02,083222,Chow; Bennett,0,13,30,30
1650601106460,MATH 193A,A01,083224,Staff,1,6,30,29
1650601106460,MATH 193A,A02,083225,Staff,0,6,30,30
1650601106460,MATH 193A,A03,083781,Staff,0,6,30,30
1650601106460,MATH 193A,A04,083782,Staff,0,7,30,30
1650601112491,MATH 197,001,091859,McAuley; Julian John,9998,0,9999,1
1650601118545,COGS 9,A01,083615,Staff,1,16,60,59
1650601124576,COGS 11,A01,083617,Boyle; Mary E. T.,18,0,40,22
1650601130602,COGS 13,A01,083071,Staff,0,37,40,40
1650601136626,COGS 14A,A01,092681,Staff,0,29,100,100
1650601142651,COGS 14B,A01,083073,Cheng; Tzu-Han,0,13,50,50
1650601148680,COGS 17,A01,092677,Staff,16,0,75,59
1650601154718,COGS 100,A01,083619,Staff,1,26,60,59
1650601160747,COGS 101A,A01,083621,Davis; Joshua Daniel,0,26,60,60
1650601166773,COGS 101B,A01,091572,Staff,1,5,60,59
1650601172795,COGS 101C,A01,083625,Delgado; Tania,15,0,30,15
1650601178818,COGS 107A,A01,083627,Boyle; Mary E. T.,0,15,60,60
1650601184846,COGS 118A,A01,083075,Staff,0,4,60,60
1650601190877,CSE 3,A50,083646,Miranda; Gregory Joseph,19,0,38,19
1650601190877,CSE 3,A51,083647,Miranda; Gregory Joseph,36,0,37,1
1650601196899,CSE 8A,A50,083650,Miranda; Gregory Joseph,0,30,40,40
1650601202931,CSE 11,A01,083080,Cao; Yingjun,0,95,40,40
1650601208975,CSE 12,A01,083652,Staff,0,20,100,100
1650601214998,CSE 15L,A01,083654,Staff,0,2,50,50
1650601214998,CSE 15L,A02,083655,Staff,0,1,50,50
1650601221024,CSE 20,A01,083657,Staff,51,0,80,29
1650601227051,CSE 30,A01,083084,Eldon; John,0,78,40,40
1650601233096,CSE 100,A01,083659,Cao; Yingjun,0,68,50,50
1650601239124,CSE 134B,A01,083661,Powell; Thomas Allan,0,35,65,65
1650601245148,CSE 140,A01,083663,Staff,1,9,75,74
1650601251170,CSE 140L,A01,083088,Eldon; John,1,15,75,74
1650601257194,CSE 175,A01,083665,Kumar; Rakesh,7,0,25,18
1650601263228,CSE 190,A00,092507,Dubnov; Shlomo,11,0,20,9
1650601269254,ECE 45,A01,083139,Staff,1,2,60,59
1650601275277,ECE 65,A50,083695,Staff,1,6,30,29
1650601281300,ECE 109,A01,091882,Touri; Behrouz,33,0,70,37
1650601287325,ECE 180,A00,083140,Abi Samra; Nicholas Camill,21,0,30,9
1650601287325,ECE 180,B00,083141,Abi Samra; Nicholas Camill,0,0,30,30
1650601293349,MATH 10A,A01,083735,Patchell; Gregory David,4,0,30,26
1650601293349,MATH 10A,A02,083736,Patchell; Gregory David,27,0,30,3
1650601293349,MATH 10A,A03,083737,Patchell; Gregory David,24,0,30,6
1650601299380,MATH 10B,A01,083207,Staff,1,9,30,29
1650601299380,MATH 10B,A02,083208,Staff,0,8,30,30
1650601299380,MATH 10B,B01,083739,Staff,11,0,30,19
1650601299380,MATH 10B,B02,083740,Staff,28,0,30,2
1650601305406,MATH 18,A01,083743,Staff,0,0,30,30
1650601305406,MATH 18,A02,083744,Staff,23,0,30,7
1650601305406,MATH 18,A03,083745,Staff,21,0,30,9
1650601305406,MATH 18,A04,083746,Staff,26,0,30,4
1650601305406,MATH 18,B01,083748,Staff,0,15,30,30
1650601305406,MATH 18,B02,083749,Staff,1,11,30,29
1650601305406,MATH 18,B03,083750,Staff,0,12,30,30
1650601305406,MATH 18,B04,083751,Staff,0,12,30,30
1650601311433,MATH 20A,A01,083754,Staff,19,0,40,21
1650601317456,MATH 20B,A01,083756,Staff,1,12,30,29
1650601317456,MATH 20B,A02,083757,Staff,0,12,30,30
1650601323481,MATH 20C,A01,083760,Staff,0,16,30,30
1650601323481,MATH 20C,A02,083761,Staff,2,14,30,28
1650601323481,MATH 20C,B01,083762,Staff,11,0,30,19
1650601323481,MATH 20C,B02,083763,Staff,28,0,30,2
1650601329505,MATH 20D,A01,083765,Staff,1,1,30,29
1650601329505,MATH 20D,A02,083766,Staff,8,0,30,22
1650601329505,MATH 20D,A03,083767,Staff,24,0,30,6
1650601335532,MATH 20E,A01,083771,Staff,3,0,30,27
1650601335532,MATH 20E,A02,083772,Staff,18,0,30,12
1650601335532,MATH 20E,B01,083773,Staff,0,0,30,30
1650601335532,MATH 20E,B02,083774,Staff,9,0,30,21
1650601341563,MATH 103A,A01,083777,Staff,0,15,30,30
1650601341563,MATH 103A,A02,083778,Staff,0,14,30,30
1650601341563,MATH 103A,B01,083779,Staff,0,14,30,30
1650601341563,MATH 103A,B02,083780,Staff,0,14,30,30
1650601347591,MATH 105,A01,085443,Staff,0,21,30,30
1650601353615,MATH 109,A01,083213,Anzaldo; Leesa B,1,7,30,29
1650601353615,MATH 109,A02,083214,Anzaldo; Leesa B,0,7,30,30
1650601353615,MATH 109,B01,083215,Anzaldo; Leesa B,0,5,30,30
1650601353615,MATH 109,B02,083216,Anzaldo; Leesa B,1,6,30,29
1650601359640,MATH 142A,A01,083219,Chow; Bennett,0,16,30,30
1650601359640,MATH 142A,A02,083220,Chow; Bennett,0,15,30,30
1650601359640,MATH 142A,B01,083221,Chow; Bennett,0,14,30,30
1650601359640,MATH 142A,B02,083222,Chow; Bennett,0,13,30,30
1650601365665,MATH 193A,A01,083224,Staff,1,6,30,29
1650601365665,MATH 193A,A02,083225,Staff,0,6,30,30
1650601365665,MATH 193A,A03,083781,Staff,0,6,30,30
1650601365665,MATH 193A,A04,083782,Staff,0,7,30,30
1650601371701,MATH 197,001,091859,McAuley; Julian John,9998,0,9999,1
1650601377757,COGS 9,A01,083615,Staff,1,16,60,59
1650601383780,COGS 11,A01,083617,Boyle; Mary E. T.,18,0,40,22
1650601389809,COGS 13,A01,083071,Staff,0,37,40,40
1650601395832,COGS 14A,A01,092681,Staff,0,29,100,100
1650601401865,COGS 14B,A01,083073,Cheng; Tzu-Han,0,13,50,50
1650601407891,COGS 17,A01,092677,Staff,16,0,75,59
1650601413922,COGS 100,A01,083619,Staff,1,26,60,59
1650601419945,COGS 101A,A01,083621,Davis; Joshua Daniel,0,26,60,60
1650601425975,COGS 101B,A01,091572,Staff,1,5,60,59
1650601432000,COGS 101C,A01,083625,Delgado; Tania,15,0,30,15
1650601438026,COGS 107A,A01,083627,Boyle; Mary E. T.,0,15,60,60
1650601444050,COGS 118A,A01,083075,Staff,0,4,60,60
1650601450073,CSE 3,A50,083646,Miranda; Gregory Joseph,19,0,38,19
1650601450073,CSE 3,A51,083647,Miranda; Gregory Joseph,36,0,37,1
1650601456097,CSE 8A,A50,083650,Miranda; Gregory Joseph,0,30,40,40
1650601462121,CSE 11,A01,083080,Cao; Yingjun,0,95,40,40
1650601468217,CSE 12,A01,083652,Staff,0,20,100,100
1650601474243,CSE 15L,A01,083654,Staff,0,2,50,50
1650601474243,CSE 15L,A02,083655,Staff,0,1,50,50
1650601480271,CSE 20,A01,083657,Staff,51,0,80,29
1650601486295,CSE 30,A01,083084,Eldon; John,0,78,40,40
1650601492319,CSE 100,A01,083659,Cao; Yingjun,0,68,50,50
1650601498347,CSE 134B,A01,083661,Powell; Thomas Allan,0,35,65,65
1650601504372,CSE 140,A01,083663,Staff,1,9,75,74
1650601510397,CSE 140L,A01,083088,Eldon; John,1,15,75,74
1650601516421,CSE 175,A01,083665,Kumar; Rakesh,7,0,25,18
1650601522445,CSE 190,A00,092507,Dubnov; Shlomo,11,0,20,9
1650601528470,ECE 45,A01,083139,Staff,1,2,60,59
1650601534498,ECE 65,A50,083695,Staff,1,6,30,29
1650601540521,ECE 109,A01,091882,Touri; Behrouz,33,0,70,37
1650601546544,ECE 180,A00,083140,Abi Samra; Nicholas Camill,21,0,30,9
1650601546544,ECE 180,B00,083141,Abi Samra; Nicholas Camill,0,0,30,30
1650601552568,MATH 10A,A01,083735,Patchell; Gregory David,4,0,30,26
1650601552568,MATH 10A,A02,083736,Patchell; Gregory David,27,0,30,3
1650601552568,MATH 10A,A03,083737,Patchell; Gregory David,24,0,30,6
1650601558595,MATH 10B,A01,083207,Staff,1,9,30,29
1650601558595,MATH 10B,A02,083208,Staff,0,8,30,30
1650601558595,MATH 10B,B01,083739,Staff,11,0,30,19
1650601558595,MATH 10B,B02,083740,Staff,28,0,30,2
1650601564625,MATH 18,A01,083743,Staff,0,0,30,30
1650601564625,MATH 18,A02,083744,Staff,23,0,30,7
1650601564625,MATH 18,A03,083745,Staff,21,0,30,9
1650601564625,MATH 18,A04,083746,Staff,26,0,30,4
1650601564625,MATH 18,B01,083748,Staff,0,15,30,30
1650601564625,MATH 18,B02,083749,Staff,1,11,30,29
1650601564625,MATH 18,B03,083750,Staff,0,12,30,30
1650601564625,MATH 18,B04,083751,Staff,0,12,30,30
1650601570649,MATH 20A,A01,083754,Staff,19,0,40,21
1650601576676,MATH 20B,A01,083756,Staff,1,12,30,29
1650601576676,MATH 20B,A02,083757,Staff,0,12,30,30
1650601582702,MATH 20C,A01,083760,Staff,0,16,30,30
1650601582702,MATH 20C,A02,083761,Staff,2,14,30,28
1650601582702,MATH 20C,B01,083762,Staff,11,0,30,19
1650601582702,MATH 20C,B02,083763,Staff,28,0,30,2
1650601588727,MATH 20D,A01,083765,Staff,1,1,30,29
1650601588727,MATH 20D,A02,083766,Staff,8,0,30,22
1650601588727,MATH 20D,A03,083767,Staff,24,0,30,6
1650601594763,MATH 20E,A01,083771,Staff,3,0,30,27
1650601594763,MATH 20E,A02,083772,Staff,18,0,30,12
1650601594763,MATH 20E,B01,083773,Staff,0,0,30,30
1650601594763,MATH 20E,B02,083774,Staff,9,0,30,21
1650601600809,MATH 103A,A01,083777,Staff,0,15,30,30
1650601600809,MATH 103A,A02,083778,Staff,0,14,30,30
1650601600809,MATH 103A,B01,083779,Staff,0,14,30,30
1650601600809,MATH 103A,B02,083780,Staff,0,14,30,30
1650601606842,MATH 105,A01,085443,Staff,0,21,30,30
1650601612870,MATH 109,A01,083213,Anzaldo; Leesa B,1,7,30,29
1650601612870,MATH 109,A02,083214,Anzaldo; Leesa B,0,7,30,30
1650601612870,MATH 109,B01,083215,Anzaldo; Leesa B,0,5,30,30
1650601612870,MATH 109,B02,083216,Anzaldo; Leesa B,1,6,30,29
1650601618893,MATH 142A,A01,083219,Chow; Bennett,0,16,30,30
1650601618893,MATH 142A,A02,083220,Chow; Bennett,0,15,30,30
1650601618893,MATH 142A,B01,083221,Chow; Bennett,0,14,30,30
1650601618893,MATH 142A,B02,083222,Chow; Bennett,0,13,30,30
1650601624921,MATH 193A,A01,083224,Staff,1,6,30,29
1650601624921,MATH 193A,A02,083225,Staff,0,6,30,30
1650601624921,MATH 193A,A03,083781,Staff,0,6,30,30
1650601624921,MATH 193A,A04,083782,Staff,0,7,30,30
1650601630943,MATH 197,001,091859,McAuley; Julian John,9998,0,9999,1
1650601636994,COGS 9,A01,083615,Staff,1,16,60,59
1650601643017,COGS 11,A01,083617,Boyle; Mary E. T.,18,0,40,22
1650601649048,COGS 13,A01,083071,Staff,0,37,40,40
1650601655072,COGS 14A,A01,092681,Staff,0,29,100,100
1650601661096,COGS 14B,A01,083073,Cheng; Tzu-Han,0,13,50,50
1650601667128,COGS 17,A01,092677,Staff,15,0,75,60
1650601673152,COGS 100,A01,083619,Staff,1,26,60,59
1650601679188,COGS 101A,A01,083621,Davis; Joshua Daniel,0,26,60,60
1650601685224,COGS 101B,A01,091572,Staff,1,5,60,59
1650601691249,COGS 101C,A01,083625,Delgado; Tania,15,0,30,15
1650601697281,COGS 107A,A01,083627,Boyle; Mary E. T.,0,15,60,60
1650601703305,COGS 118A,A01,083075,Staff,0,4,60,60
1650601709329,CSE 3,A50,083646,Miranda; Gregory Joseph,19,0,38,19
1650601709329,CSE 3,A51,083647,Miranda; Gregory Joseph,36,0,37,1
1650601715371,CSE 8A,A50,083650,Miranda; Gregory Joseph,0,30,40,40
1650601721403,CSE 11,A01,083080,Cao; Yingjun,0,95,40,40
1650601727427,CSE 12,A01,083652,Staff,0,20,100,100
1650601733452,CSE 15L,A01,083654,Staff,0,2,50,50
1650601733452,CSE 15L,A02,083655,Staff,0,1,50,50
1650601739475,CSE 20,A01,083657,Staff,51,0,80,29
1650601745506,CSE 30,A01,083084,Eldon; John,0,78,40,40
1650601751533,CSE 100,A01,083659,Cao; Yingjun,0,68,50,50
1650601757582,CSE 134B,A01,083661,Powell; Thomas Allan,0,35,65,65
1650601763607,CSE 140,A01,083663,Staff,1,9,75,74
1650601769635,CSE 140L,A01,083088,Eldon; John,1,15,75,74
1650601775661,CSE 175,A01,083665,Kumar; Rakesh,7,0,25,18
1650601781688,CSE 190,A00,092507,Dubnov; Shlomo,11,0,20,9
1650601787712,ECE 45,A01,083139,Staff,1,2,60,59
1650601793738,ECE 65,A50,083695,Staff,1,6,30,29
1650601799769,ECE 109,A01,091882,Touri; Behrouz,33,0,70,37
1650601805794,ECE 180,A00,083140,Abi Samra; Nicholas Camill,21,0,30,9
1650601805794,ECE 180,B00,083141,Abi Samra; Nicholas Camill,0,0,30,30
1650601811817,MATH 10A,A01,083735,Patchell; Gregory David,4,0,30,26
1650601811817,MATH 10A,A02,083736,Patchell; Gregory David,27,0,30,3
1650601811817,MATH 10A,A03,083737,Patchell; Gregory David,24,0,30,6
1650601817852,MATH 10B,A01,083207,Staff,1,9,30,29
1650601817852,MATH 10B,A02,083208,Staff,0,8,30,30
1650601817852,MATH 10B,B01,083739,Staff,11,0,30,19
1650601817852,MATH 10B,B02,083740,Staff,28,0,30,2
1650601823895,MATH 18,A01,083743,Staff,0,0,30,30
1650601823895,MATH 18,A02,083744,Staff,23,0,30,7
1650601823895,MATH 18,A03,083745,Staff,21,0,30,9
1650601823895,MATH 18,A04,083746,Staff,26,0,30,4
1650601823895,MATH 18,B01,083748,Staff,0,15,30,30
1650601823895,MATH 18,B02,083749,Staff,1,11,30,29
1650601823895,MATH 18,B03,083750,Staff,0,12,30,30
1650601823895,MATH 18,B04,083751,Staff,0,12,30,30
1650601829919,MATH 20A,A01,083754,Staff,19,0,40,21
1650601835951,MATH 20B,A01,083756,Staff,1,12,30,29
1650601835951,MATH 20B,A02,083757,Staff,0,12,30,30
1650601841984,MATH 20C,A01,083760,Staff,0,16,30,30
1650601841984,MATH 20C,A02,083761,Staff,2,14,30,28
1650601841984,MATH 20C,B01,083762,Staff,11,0,30,19
1650601841984,MATH 20C,B02,083763,Staff,28,0,30,2
1650601848019,MATH 20D,A01,083765,Staff,1,1,30,29
1650601848019,MATH 20D,A02,083766,Staff,7,0,30,23
1650601848019,MATH 20D,A03,083767,Staff,24,0,30,6
1650601854046,MATH 20E,A01,083771,Staff,3,0,30,27
1650601854046,MATH 20E,A02,083772,Staff,18,0,30,12
1650601854046,MATH 20E,B01,083773,Staff,0,0,30,30
1650601854046,MATH 20E,B02,083774,Staff,9,0,30,21
1650601860071,MATH 103A,A01,083777,Staff,0,15,30,30
1650601860071,MATH 103A,A02,083778,Staff,0,14,30,30
1650601860071,MATH 103A,B01,083779,Staff,0,14,30,30
1650601860071,MATH 103A,B02,083780,Staff,0,14,30,30
1650601866095,MATH 105,A01,085443,Staff,0,21,30,30
1650601872122,MATH 109,A01,083213,Anzaldo; Leesa B,1,7,30,29
1650601872122,MATH 109,A02,083214,Anzaldo; Leesa B,0,7,30,30
1650601872122,MATH 109,B01,083215,Anzaldo; Leesa B,0,5,30,30
1650601872122,MATH 109,B02,083216,Anzaldo; Leesa B,1,6,30,29
1650601878156,MATH 142A,A01,083219,Chow; Bennett,0,16,30,30
1650601878156,MATH 142A,A02,083220,Chow; Bennett,0,15,30,30
1650601878156,MATH 142A,B01,083221,Chow; Bennett,0,14,30,30
1650601878156,MATH 142A,B02,083222,Chow; Bennett,0,13,30,30
1650601884192,MATH 193A,A01,083224,Staff,1,6,30,29
1650601884192,MATH 193A,A02,083225,Staff,0,6,30,30
1650601884192,MATH 193A,A03,083781,Staff,0,6,30,30
1650601884192,MATH 193A,A04,083782,Staff,0,7,30,30
1650601890217,MATH 197,001,091859,McAuley; Julian John,9998,0,9999,1
1650601896267,COGS 9,A01,083615,Staff,1,16,60,59
1650601902293,COGS 11,A01,083617,Boyle; Mary E. T.,18,0,40,22
1650601908321,COGS 13,A01,083071,Staff,0,37,40,40
1650601914348,COGS 14A,A01,092681,Staff,0,29,100,100
1650601920371,COGS 14B,A01,083073,Cheng; Tzu-Han,0,13,50,50
1650601926405,COGS 17,A01,092677,Staff,15,0,75,60
1650601932427,COGS 100,A01,083619,Staff,1,26,60,59
1650601938456,COGS 101A,A01,083621,Davis; Joshua Daniel,0,26,60,60
1650601944479,COGS 101B,A01,091572,Staff,1,5,60,59
1650601950505,COGS 101C,A01,083625,Delgado; Tania,15,0,30,15
1650601956532,COGS 107A,A01,083627,Boyle; Mary E. T.,0,15,60,60
1650601962561,COGS 118A,A01,083075,Staff,0,4,60,60
1650601968590,CSE 3,A50,083646,Miranda; Gregory Joseph,19,0,38,19
1650601968590,CSE 3,A51,083647,Miranda; Gregory Joseph,36,0,37,1
1650601974619,CSE 8A,A50,083650,Miranda; Gregory Joseph,0,30,40,40
1650601980659,CSE 11,A01,083080,Cao; Yingjun,0,95,40,40
1650601986683,CSE 12,A01,083652,Staff,0,20,100,100
1650601992711,CSE 15L,A01,083654,Staff,0,2,50,50
1650601992711,CSE 15L,A02,083655,Staff,0,1,50,50
1650601998734,CSE 20,A01,083657,Staff,51,0,80,29
1650602004760,CSE 30,A01,083084,Eldon; John,0,78,40,40
1650602010784,CSE 100,A01,083659,Cao; Yingjun,0,68,50,50
1650602016810,CSE 134B,A01,083661,Powell; Thomas Allan,0,35,65,65
1650602022835,CSE 140,A01,083663,Staff,1,9,75,74
1650602028870,CSE 140L,A01,083088,Eldon; John,1,15,75,74
1650602034897,CSE 175,A01,083665,Kumar; Rakesh,7,0,25,18
1650602040922,CSE 190,A00,092507,Dubnov; Shlomo,11,0,20,9
1650602046957,ECE 45,A01,083139,Staff,1,2,60,59
1650602052980,ECE 65,A50,083695,Staff,1,6,30,29
1650602059004,ECE 109,A01,091882,Touri; Behrouz,33,0,70,37
1650602065119,ECE 180,A00,083140,Abi Samra; Nicholas Camill,21,0,30,9
1650602065119,ECE 180,B00,083141,Abi Samra; Nicholas Camill,0,0,30,30
1650602071144,MATH 10A,A01,083735,Patchell; Gregory David,4,0,30,26
1650602071144,MATH 10A,A02,083736,Patchell; Gregory David,27,0,30,3
1650602071144,MATH 10A,A03,083737,Patchell; Gregory David,24,0,30,6
1650602077170,MATH 10B,A01,083207,Staff,1,9,30,29
1650602077170,MATH 10B,A02,083208,Staff,0,8,30,30
1650602077170,MATH 10B,B01,083739,Staff,11,0,30,19
1650602077170,MATH 10B,B02,083740,Staff,28,0,30,2
1650602083198,MATH 18,A01,083743,Staff,0,0,30,30
1650602083198,MATH 18,A02,083744,Staff,23,0,30,7
1650602083198,MATH 18,A03,083745,Staff,21,0,30,9
1650602083198,MATH 18,A04,083746,Staff,26,0,30,4
1650602083198,MATH 18,B01,083748,Staff,0,15,30,30
1650602083198,MATH 18,B02,083749,Staff,1,11,30,29
1650602083198,MATH 18,B03,083750,Staff,0,12,30,30
1650602083198,MATH 18,B04,083751,Staff,0,12,30,30
1650602089225,MATH 20A,A01,083754,Staff,19,0,40,21
1650602095250,MATH 20B,A01,083756,Staff,1,12,30,29
1650602095250,MATH 20B,A02,083757,Staff,0,12,30,30
1650602101286,MATH 20C,A01,083760,Staff,0,16,30,30
1650602101286,MATH 20C,A02,083761,Staff,2,14,30,28
1650602101286,MATH 20C,B01,083762,Staff,11,0,30,19
1650602101286,MATH 20C,B02,083763,Staff,28,0,30,2
1650602107314,MATH 20D,A01,083765,Staff,1,1,30,29
1650602107314,MATH 20D,A02,083766,Staff,7,0,30,23
1650602107314,MATH 20D,A03,083767,Staff,24,0,30,6
1650602113339,MATH 20E,A01,083771,Staff,3,0,30,27
1650602113339,MATH 20E,A02,083772,Staff,18,0,30,12
1650602113339,MATH 20E,B01,083773,Staff,0,0,30,30
1650602113339,MATH 20E,B02,083774,Staff,9,0,30,21
1650602119364,MATH 103A,A01,083777,Staff,0,15,30,30
1650602119364,MATH 103A,A02,083778,Staff,0,14,30,30
1650602119364,MATH 103A,B01,083779,Staff,0,14,30,30
1650602119364,MATH 103A,B02,083780,Staff,0,14,30,30
1650602125393,MATH 105,A01,085443,Staff,0,21,30,30
1650602131417,MATH 109,A01,083213,Anzaldo; Leesa B,1,7,30,29
1650602131417,MATH 109,A02,083214,Anzaldo; Leesa B,0,7,30,30
1650602131417,MATH 109,B01,083215,Anzaldo; Leesa B,0,5,30,30
1650602131417,MATH 109,B02,083216,Anzaldo; Leesa B,1,6,30,29
1650602137458,MATH 142A,A01,083219,Chow; Bennett,0,16,30,30
1650602137458,MATH 142A,A02,083220,Chow; Bennett,0,15,30,30
1650602137458,MATH 142A,B01,083221,Chow; Bennett,0,14,30,30
1650602137458,MATH 142A,B02,083222,Chow; Bennett,0,13,30,30
1650602143483,MATH 193A,A01,083224,Staff,1,6,30,29
1650602143483,MATH 193A,A02,083225,Staff,0,6,30,30
1650602143483,MATH 193A,A03,083781,Staff,0,6,30,30
1650602143483,MATH 193A,A04,083782,Staff,0,7,30,30
1650602149510,MATH 197,001,091859,McAuley; Julian John,9998,0,9999,1
1650602155568,COGS 9,A01,083615,Staff,1,16,60,59
1650602161592,COGS 11,A01,083617,Boyle; Mary E. T.,18,0,40,22
1650602167618,COGS 13,A01,083071,Staff,0,37,40,40
1650602173641,COGS 14A,A01,092681,Staff,0,29,100,100
1650602179669,COGS 14B,A01,083073,Cheng; Tzu-Han,0,13,50,50
1650602185694,COGS 17,A01,092677,Staff,15,0,75,60
1650602191734,COGS 100,A01,083619,Staff,1,26,60,59
1650602197760,COGS 101A,A01,083621,Davis; Joshua Daniel,0,26,60,60
1650602203801,COGS 101B,A01,091572,Staff,1,5,60,59
1650602209829,COGS 101C,A01,083625,Delgado; Tania,15,0,30,15
1650602215856,COGS 107A,A01,083627,Boyle; Mary E. T.,0,15,60,60
1650602221883,COGS 118A,A01,083075,Staff,0,4,60,60
1650602227910,CSE 3,A50,083646,Miranda; Gregory Joseph,19,0,38,19
1650602227910,CSE 3,A51,083647,Miranda; Gregory Joseph,36,0,37,1
1650602233933,CSE 8A,A50,083650,Miranda; Gregory Joseph,0,30,40,40
1650602239961,CSE 11,A01,083080,Cao; Yingjun,0,95,40,40
1650602245983,CSE 12,A01,083652,Staff,0,20,100,100
1650602252011,CSE 15L,A01,083654,Staff,0,2,50,50
1650602252011,CSE 15L,A02,083655,Staff,0,1,50,50
1650602258042,CSE 20,A01,083657,Staff,51,0,80,29
1650602264067,CSE 30,A01,083084,Eldon; John,0,78,40,40
1650602270098,CSE 100,A01,083659,Cao; Yingjun,0,68,50,50
1650602276141,CSE 134B,A01,083661,Powell; Thomas Allan,0,35,65,65
1650602282178,CSE 140,A01,083663,Staff,1,9,75,74
1650602288211,CSE 140L,A01,083088,Eldon; John,1,15,75,74
1650602294237,CSE 175,A01,083665,Kumar; Rakesh,7,0,25,18
1650602300261,CSE 190,A00,092507,Dubnov; Shlomo,11,0,20,9
1650602306288,ECE 45,A01,083139,Staff,1,2,60,59
1650602312313,ECE 65,A50,083695,Staff,1,6,30,29
1650602318347,ECE 109,A01,091882,Touri; Behrouz,33,0,70,37
1650602324376,ECE 180,A00,083140,Abi Samra; Nicholas Camill,21,0,30,9
1650602324376,ECE 180,B00,083141,Abi Samra; Nicholas Camill,0,0,30,30
1650602330401,MATH 10A,A01,083735,Patchell; Gregory David,4,0,30,26
1650602330401,MATH 10A,A02,083736,Patchell; Gregory David,27,0,30,3
1650602330401,MATH 10A,A03,083737,Patchell; Gregory David,24,0,30,6
1650602336426,MATH 10B,A01,083207,Staff,1,9,30,29
1650602336426,MATH 10B,A02,083208,Staff,0,8,30,30
1650602336426,MATH 10B,B01,083739,Staff,11,0,30,19
1650602336426,MATH 10B,B02,083740,Staff,28,0,30,2
1650602342455,MATH 18,A01,083743,Staff,0,0,30,30
1650602342455,MATH 18,A02,083744,Staff,23,0,30,7
1650602342455,MATH 18,A03,083745,Staff,21,0,30,9
1650602342455,MATH 18,A04,083746,Staff,26,0,30,4
1650602342455,MATH 18,B01,083748,Staff,0,15,30,30
1650602342455,MATH 18,B02,083749,Staff,1,11,30,29
1650602342455,MATH 18,B03,083750,Staff,0,12,30,30
1650602342455,MATH 18,B04,083751,Staff,0,12,30,30
1650602348488,MATH 20A,A01,083754,Staff,19,0,40,21
1650602354523,MATH 20B,A01,083756,Staff,1,12,30,29
1650602354523,MATH 20B,A02,083757,Staff,0,12,30,30
1650602360551,MATH 20C,A01,083760,Staff,0,16,30,30
1650602360551,MATH 20C,A02,083761,Staff,2,14,30,28
1650602360551,MATH 20C,B01,083762,Staff,11,0,30,19
1650602360551,MATH 20C,B02,083763,Staff,28,0,30,2
1650602366578,MATH 20D,A01,083765,Staff,1,1,30,29
1650602366578,MATH 20D,A02,083766,Staff,7,0,30,23
1650602366578,MATH 20D,A03,083767,Staff,24,0,30,6
1650602372605,MATH 20E,A01,083771,Staff,3,0,30,27
1650602372605,MATH 20E,A02,083772,Staff,18,0,30,12
1650602372605,MATH 20E,B01,083773,Staff,0,0,30,30
1650602372605,MATH 20E,B02,083774,Staff,9,0,30,21
1650602378633,MATH 103A,A01,083777,Staff,0,15,30,30
1650602378633,MATH 103A,A02,083778,Staff,0,14,30,30
1650602378633,MATH 103A,B01,083779,Staff,0,14,30,30
1650602378633,MATH 103A,B02,083780,Staff,0,14,30,30
1650602384657,MATH 105,A01,085443,Staff,0,21,30,30
1650602390686,MATH 109,A01,083213,Anzaldo; Leesa B,1,7,30,29
1650602390686,MATH 109,A02,083214,Anzaldo; Leesa B,0,7,30,30
1650602390686,MATH 109,B01,083215,Anzaldo; Leesa B,0,5,30,30
1650602390686,MATH 109,B02,083216,Anzaldo; Leesa B,1,6,30,29
1650602396721,MATH 142A,A01,083219,Chow; Bennett,0,16,30,30
1650602396721,MATH 142A,A02,083220,Chow; Bennett,0,15,30,30
1650602396721,MATH 142A,B01,083221,Chow; Bennett,0,14,30,30
1650602396721,MATH 142A,B02,083222,Chow; Bennett,0,13,30,30
1650602402749,MATH 193A,A01,083224,Staff,1,6,30,29
1650602402749,MATH 193A,A02,083225,Staff,0,6,30,30
1650602402749,MATH 193A,A03,083781,Staff,0,6,30,30
1650602402749,MATH 193A,A04,083782,Staff,0,7,30,30
1650602408775,MATH 197,001,091859,McAuley; Julian John,9998,0,9999,1
1650602414836,COGS 9,A01,083615,Staff,1,16,60,59
1650602420863,COGS 11,A01,083617,Boyle; Mary E. T.,18,0,40,22
1650602426887,COGS 13,A01,083071,Staff,0,37,40,40
1650602432911,COGS 14A,A01,092681,Staff,0,29,100,100
1650602438935,COGS 14B,A01,083073,Cheng; Tzu-Han,0,13,50,50
1650602444958,COGS 17,A01,092677,Staff,15,0,75,60
1650602450985,COGS 100,A01,083619,Staff,1,26,60,59
1650602457012,COGS 101A,A01,083621,Davis; Joshua Daniel,0,26,60,60
1650602463060,COGS 101B,A01,091572,Staff,1,5,60,59
1650602469098,COGS 101C,A01,083625,Delgado; Tania,15,0,30,15
1650602475122,COGS 107A,A01,083627,Boyle; Mary E. T.,0,15,60,60
1650602481151,COGS 118A,A01,083075,Staff,0,4,60,60
1650602487179,CSE 3,A50,083646,Miranda; Gregory Joseph,19,0,38,19
1650602487179,CSE 3,A51,083647,Miranda; Gregory Joseph,36,0,37,1
1650602493203,CSE 8A,A50,083650,Miranda; Gregory Joseph,0,30,40,40
1650602499225,CSE 11,A01,083080,Cao; Yingjun,0,95,40,40
1650602505258,CSE 12,A01,083652,Staff,0,20,100,100
1650602511284,CSE 15L,A01,083654,Staff,0,2,50,50
1650602511284,CSE 15L,A02,083655,Staff,0,1,50,50
1650602517306,CSE 20,A01,083657,Staff,51,0,80,29
1650602523337,CSE 30,A01,083084,Eldon; John,0,78,40,40
1650602529370,CSE 100,A01,083659,Cao; Yingjun,0,68,50,50
1650602535394,CSE 134B,A01,083661,Powell; Thomas Allan,0,35,65,65
1650602541421,CSE 140,A01,083663,Staff,1,9,75,74
1650602547446,CSE 140L,A01,083088,Eldon; John,1,15,75,74
1650602553469,CSE 175,A01,083665,Kumar; Rakesh,7,0,25,18
1650602559497,CSE 190,A00,092507,Dubnov; Shlomo,11,0,20,9
1650602565519,ECE 45,A01,083139,Staff,1,2,60,59
1650602571541,ECE 65,A50,083695,Staff,1,6,30,29
1650602577563,ECE 109,A01,091882,Touri; Behrouz,33,0,70,37
1650602583586,ECE 180,A00,083140,Abi Samra; Nicholas Camill,21,0,30,9
1650602583586,ECE 180,B00,083141,Abi Samra; Nicholas Camill,0,0,30,30
1650602589613,MATH 10A,A01,083735,Patchell; Gregory David,4,0,30,26
1650602589613,MATH 10A,A02,083736,Patchell; Gregory David,27,0,30,3
1650602589613,MATH 10A,A03,083737,Patchell; Gregory David,24,0,30,6
1650602595636,MATH 10B,A01,083207,Staff,1,9,30,29
1650602595636,MATH 10B,A02,083208,Staff,0,8,30,30
1650602595636,MATH 10B,B01,083739,Staff,11,0,30,19
1650602595636,MATH 10B,B02,083740,Staff,28,0,30,2
1650602601666,MATH 18,A01,083743,Staff,0,0,30,30
1650602601666,MATH 18,A02,083744,Staff,23,0,30,7
1650602601666,MATH 18,A03,083745,Staff,21,0,30,9
1650602601666,MATH 18,A04,083746,Staff,26,0,30,4
1650602601666,MATH 18,B01,083748,Staff,0,15,30,30
1650602601666,MATH 18,B02,083749,Staff,1,11,30,29
1650602601666,MATH 18,B03,083750,Staff,0,12,30,30
1650602601666,MATH 18,B04,083751,Staff,0,12,30,30
1650602607688,MATH 20A,A01,083754,Staff,19,0,40,21
1650602613720,MATH 20B,A01,083756,Staff,1,12,30,29
1650602613720,MATH 20B,A02,083757,Staff,0,12,30,30
1650602619747,MATH 20C,A01,083760,Staff,0,16,30,30
1650602619747,MATH 20C,A02,083761,Staff,2,14,30,28
1650602619747,MATH 20C,B01,083762,Staff,11,0,30,19
1650602619747,MATH 20C,B02,083763,Staff,28,0,30,2
1650602625769,MATH 20D,A01,083765,Staff,1,1,30,29
1650602625769,MATH 20D,A02,083766,Staff,7,0,30,23
1650602625769,MATH 20D,A03,083767,Staff,24,0,30,6
1650602631796,MATH 20E,A01,083771,Staff,3,0,30,27
1650602631796,MATH 20E,A02,083772,Staff,18,0,30,12
1650602631796,MATH 20E,B01,083773,Staff,0,0,30,30
1650602631796,MATH 20E,B02,083774,Staff,9,0,30,21
1650602637830,MATH 103A,A01,083777,Staff,0,15,30,30
1650602637830,MATH 103A,A02,083778,Staff,0,14,30,30
1650602637830,MATH 103A,B01,083779,Staff,0,14,30,30
1650602637830,MATH 103A,B02,083780,Staff,0,14,30,30
1650602643858,MATH 105,A01,085443,Staff,0,21,30,30
1650602649882,MATH 109,A01,083213,Anzaldo; Leesa B,1,7,30,29
1650602649882,MATH 109,A02,083214,Anzaldo; Leesa B,0,7,30,30
1650602649882,MATH 109,B01,083215,Anzaldo; Leesa B,0,5,30,30
1650602649882,MATH 109,B02,083216,Anzaldo; Leesa B,1,6,30,29
1650602655910,MATH 142A,A01,083219,Chow; Bennett,0,16,30,30
1650602655910,MATH 142A,A02,083220,Chow; Bennett,0,15,30,30
1650602655910,MATH 142A,B01,083221,Chow; Bennett,0,14,30,30
1650602655910,MATH 142A,B02,083222,Chow; Bennett,0,13,30,30
1650602662040,MATH 193A,A01,083224,Staff,1,6,30,29
1650602662040,MATH 193A,A02,083225,Staff,0,6,30,30
1650602662040,MATH 193A,A03,083781,Staff,0,6,30,30
1650602662040,MATH 193A,A04,083782,Staff,0,7,30,30
1650602668071,MATH 197,001,091859,McAuley; Julian John,9998,0,9999,1
1650602674126,COGS 9,A01,083615,Staff,1,16,60,59
1650602680161,COGS 11,A01,083617,Boyle; Mary E. T.,18,0,40,22
1650602686184,COGS 13,A01,083071,Staff,0,37,40,40
1650602692207,COGS 14A,A01,092681,Staff,0,29,100,100
1650602698230,COGS 14B,A01,083073,Cheng; Tzu-Han,0,13,50,50
1650602704274,COGS 17,A01,092677,Staff,15,0,75,60
1650602710298,COGS 100,A01,083619,Staff,1,26,60,59
1650602716322,COGS 101A,A01,083621,Davis; Joshua Daniel,0,26,60,60
1650602722362,COGS 101B,A01,091572,Staff,1,5,60,59
1650602728400,COGS 101C,A01,083625,Delgado; Tania,15,0,30,15
1650602734432,COGS 107A,A01,083627,Boyle; Mary E. T.,0,15,60,60
1650602740455,COGS 118A,A01,083075,Staff,0,4,60,60
1650602746480,CSE 3,A50,083646,Miranda; Gregory Joseph,19,0,38,19
1650602746480,CSE 3,A51,083647,Miranda; Gregory Joseph,36,0,37,1
1650602752504,CSE 8A,A50,083650,Miranda; Gregory Joseph,0,30,40,40
1650602758541,CSE 11,A01,083080,Cao; Yingjun,0,95,40,40
1650602764570,CSE 12,A01,083652,Staff,0,20,100,100
1650602770605,CSE 15L,A01,083654,Staff,0,2,50,50
1650602770605,CSE 15L,A02,083655,Staff,0,1,50,50
1650602776633,CSE 20,A01,083657,Staff,51,0,80,29
1650602782657,CSE 30,A01,083084,Eldon; John,0,78,40,40
1650602788682,CSE 100,A01,083659,Cao; Yingjun,0,68,50,50
1650602794712,CSE 134B,A01,083661,Powell; Thomas Allan,0,35,65,65
1650602800749,CSE 140,A01,083663,Staff,1,9,75,74
1650602806772,CSE 140L,A01,083088,Eldon; John,1,15,75,74
1650602812798,CSE 175,A01,083665,Kumar; Rakesh,7,0,25,18
1650602818820,CSE 190,A00,092507,Dubnov; Shlomo,11,0,20,9
1650602824842,ECE 45,A01,083139,Staff,1,2,60,59
1650602830869,ECE 65,A50,083695,Staff,1,6,30,29
1650602836893,ECE 109,A01,091882,Touri; Behrouz,33,0,70,37
1650602842918,ECE 180,A00,083140,Abi Samra; Nicholas Camill,21,0,30,9
1650602842918,ECE 180,B00,083141,Abi Samra; Nicholas Camill,0,0,30,30
1650602848941,MATH 10A,A01,083735,Patchell; Gregory David,4,0,30,26
1650602848941,MATH 10A,A02,083736,Patchell; Gregory David,27,0,30,3
1650602848941,MATH 10A,A03,083737,Patchell; Gregory David,24,0,30,6
1650602854989,MATH 10B,A01,083207,Staff,1,9,30,29
1650602854989,MATH 10B,A02,083208,Staff,0,8,30,30
1650602854989,MATH 10B,B01,083739,Staff,11,0,30,19
1650602854989,MATH 10B,B02,083740,Staff,28,0,30,2
1650602861018,MATH 18,A01,083743,Staff,0,0,30,30
1650602861018,MATH 18,A02,083744,Staff,23,0,30,7
1650602861018,MATH 18,A03,083745,Staff,21,0,30,9
1650602861018,MATH 18,A04,083746,Staff,26,0,30,4
1650602861018,MATH 18,B01,083748,Staff,0,15,30,30
1650602861018,MATH 18,B02,083749,Staff,1,11,30,29
1650602861018,MATH 18,B03,083750,Staff,0,12,30,30
1650602861018,MATH 18,B04,083751,Staff,0,12,30,30
1650602867040,MATH 20A,A01,083754,Staff,19,0,40,21
1650602873065,MATH 20B,A01,083756,Staff,1,12,30,29
1650602873065,MATH 20B,A02,083757,Staff,0,12,30,30
1650602879089,MATH 20C,A01,083760,Staff,0,16,30,30
1650602879089,MATH 20C,A02,083761,Staff,2,14,30,28
1650602879089,MATH 20C,B01,083762,Staff,11,0,30,19
1650602879089,MATH 20C,B02,083763,Staff,28,0,30,2
1650602885118,MATH 20D,A01,083765,Staff,1,1,30,29
1650602885118,MATH 20D,A02,083766,Staff,7,0,30,23
1650602885118,MATH 20D,A03,083767,Staff,24,0,30,6
1650602891143,MATH 20E,A01,083771,Staff,3,0,30,27
1650602891143,MATH 20E,A02,083772,Staff,17,0,30,13
1650602891143,MATH 20E,B01,083773,Staff,0,0,30,30
1650602891143,MATH 20E,B02,083774,Staff,9,0,30,21
1650602897189,MATH 103A,A01,083777,Staff,0,15,30,30
1650602897189,MATH 103A,A02,083778,Staff,0,14,30,30
1650602897189,MATH 103A,B01,083779,Staff,0,14,30,30
1650602897189,MATH 103A,B02,083780,Staff,0,14,30,30
1650602903217,MATH 105,A01,085443,Staff,0,21,30,30
1650602909241,MATH 109,A01,083213,Anzaldo; Leesa B,1,7,30,29
1650602909241,MATH 109,A02,083214,Anzaldo; Leesa B,0,7,30,30
1650602909241,MATH 109,B01,083215,Anzaldo; Leesa B,0,5,30,30
1650602909241,MATH 109,B02,083216,Anzaldo; Leesa B,1,6,30,29
1650602915268,MATH 142A,A01,083219,Chow; Bennett,0,16,30,30
1650602915268,MATH 142A,A02,083220,Chow; Bennett,0,15,30,30
1650602915268,MATH 142A,B01,083221,Chow; Bennett,0,14,30,30
1650602915268,MATH 142A,B02,083222,Chow; Bennett,0,13,30,30
1650602921296,MATH 193A,A01,083224,Staff,1,6,30,29
1650602921296,MATH 193A,A02,083225,Staff,0,6,30,30
1650602921296,MATH 193A,A03,083781,Staff,0,6,30,30
1650602921296,MATH 193A,A04,083782,Staff,0,7,30,30
1650602927320,MATH 197,001,091859,McAuley; Julian John,9998,0,9999,1
1650602933371,COGS 9,A01,083615,Staff,1,15,60,59
1650602939395,COGS 11,A01,083617,Boyle; Mary E. T.,18,0,40,22
1650602945426,COGS 13,A01,083071,Staff,0,37,40,40
1650602951451,COGS 14A,A01,092681,Staff,0,29,100,100
1650602957486,COGS 14B,A01,083073,Cheng; Tzu-Han,0,13,50,50
1650602963512,COGS 17,A01,092677,Staff,16,0,75,59
1650602969536,COGS 100,A01,083619,Staff,1,26,60,59
1650602975563,COGS 101A,A01,083621,Davis; Joshua Daniel,0,26,60,60
1650602981593,COGS 101B,A01,091572,Staff,1,5,60,59
1650602987617,COGS 101C,A01,083625,Delgado; Tania,15,0,30,15
1650602993641,COGS 107A,A01,083627,Boyle; Mary E. T.,0,15,60,60
1650602999675,COGS 118A,A01,083075,Staff,0,4,60,60
1650603005699,CSE 3,A50,083646,Miranda; Gregory Joseph,19,0,38,19
1650603005699,CSE 3,A51,083647,Miranda; Gregory Joseph,36,0,37,1
1650603011726,CSE 8A,A50,083650,Miranda; Gregory Joseph,0,30,40,40
1650603017749,CSE 11,A01,083080,Cao; Yingjun,0,95,40,40
1650603023775,CSE 12,A01,083652,Staff,0,20,100,100
1650603029798,CSE 15L,A01,083654,Staff,0,2,50,50
1650603029798,CSE 15L,A02,083655,Staff,0,1,50,50
1650603035821,CSE 20,A01,083657,Staff,51,0,80,29
1650603041846,CSE 30,A01,083084,Eldon; John,0,78,40,40
1650603047872,CSE 100,A01,083659,Cao; Yingjun,0,68,50,50
1650603053896,CSE 134B,A01,083661,Powell; Thomas Allan,0,35,65,65
1650603059919,CSE 140,A01,083663,Staff,1,9,75,74
1650603065947,CSE 140L,A01,083088,Eldon; John,1,15,75,74
1650603071971,CSE 175,A01,083665,Kumar; Rakesh,7,0,25,18
1650603078005,CSE 190,A00,092507,Dubnov; Shlomo,11,0,20,9
1650603084030,ECE 45,A01,083139,Staff,1,2,60,59
1650603090057,ECE 65,A50,083695,Staff,1,6,30,29
1650603096086,ECE 109,A01,091882,Touri; Behrouz,33,0,70,37
1650603102113,ECE 180,A00,083140,Abi Samra; Nicholas Camill,21,0,30,9
1650603102113,ECE 180,B00,083141,Abi Samra; Nicholas Camill,0,0,30,30
1650603108159,MATH 10A,A01,083735,Patchell; Gregory David,4,0,30,26
1650603108159,MATH 10A,A02,083736,Patchell; Gregory David,27,0,30,3
1650603108159,MATH 10A,A03,083737,Patchell; Gregory David,24,0,30,6
1650603114183,MATH 10B,A01,083207,Staff,1,9,30,29
1650603114183,MATH 10B,A02,083208,Staff,0,8,30,30
1650603114183,MATH 10B,B01,083739,Staff,11,0,30,19
1650603114183,MATH 10B,B02,083740,Staff,28,0,30,2
1650603120223,MATH 18,A01,083743,Staff,0,0,30,30
1650603120223,MATH 18,A02,083744,Staff,23,0,30,7
1650603120223,MATH 18,A03,083745,Staff,21,0,30,9
1650603120223,MATH 18,A04,083746,Staff,26,0,30,4
1650603120223,MATH 18,B01,083748,Staff,0,15,30,30
1650603120223,MATH 18,B02,083749,Staff,1,11,30,29
1650603120223,MATH 18,B03,083750,Staff,0,12,30,30
1650603120223,MATH 18,B04,083751,Staff,0,12,30,30
1650603126247,MATH 20A,A01,083754,Staff,19,0,40,21
1650603132271,MATH 20B,A01,083756,Staff,1,12,30,29
1650603132271,MATH 20B,A02,083757,Staff,0,12,30,30
1650603138298,MATH 20C,A01,083760,Staff,0,16,30,30
1650603138298,MATH 20C,A02,083761,Staff,2,14,30,28
1650603138298,MATH 20C,B01,083762,Staff,11,0,30,19
1650603138298,MATH 20C,B02,083763,Staff,28,0,30,2
1650603144325,MATH 20D,A01,083765,Staff,1,1,30,29
1650603144325,MATH 20D,A02,083766,Staff,7,0,30,23
1650603144325,MATH 20D,A03,083767,Staff,24,0,30,6
1650603150349,MATH 20E,A01,083771,Staff,3,0,30,27
1650603150349,MATH 20E,A02,083772,Staff,17,0,30,13
1650603150349,MATH 20E,B01,083773,Staff,0,0,30,30
1650603150349,MATH 20E,B02,083774,Staff,9,0,30,21
1650603156378,MATH 103A,A01,083777,Staff,0,15,30,30
1650603156378,MATH 103A,A02,083778,Staff,0,14,30,30
1650603156378,MATH 103A,B01,083779,Staff,0,14,30,30
1650603156378,MATH 103A,B02,083780,Staff,0,14,30,30
1650603162402,MATH 105,A01,085443,Staff,0,21,30,30
1650603168428,MATH 109,A01,083213,Anzaldo; Leesa B,1,7,30,29
1650603168428,MATH 109,A02,083214,Anzaldo; Leesa B,0,7,30,30
1650603168428,MATH 109,B01,083215,Anzaldo; Leesa B,0,5,30,30
1650603168428,MATH 109,B02,083216,Anzaldo; Leesa B,1,6,30,29
1650603174452,MATH 142A,A01,083219,Chow; Bennett,0,16,30,30
1650603174452,MATH 142A,A02,083220,Chow; Bennett,0,15,30,30
1650603174452,MATH 142A,B01,083221,Chow; Bennett,0,14,30,30
1650603174452,MATH 142A,B02,083222,Chow; Bennett,0,13,30,30
1650603180484,MATH 193A,A01,083224,Staff,1,6,30,29
1650603180484,MATH 193A,A02,083225,Staff,0,6,30,30
1650603180484,MATH 193A,A03,083781,Staff,0,6,30,30
1650603180484,MATH 193A,A04,083782,Staff,0,7,30,30
1650603186507,MATH 197,001,091859,McAuley; Julian John,9998,0,9999,1
1650603192570,COGS 9,A01,083615,Staff,1,15,60,59
1650603198596,COGS 11,A01,083617,Boyle; Mary E. T.,18,0,40,22
1650603204628,COGS 13,A01,083071,Staff,0,37,40,40
1650603210652,COGS 14A,A01,092681,Staff,0,29,100,100
1650603216678,COGS 14B,A01,083073,Cheng; Tzu-Han,0,13,50,50
1650603222702,COGS 17,A01,092677,Staff,16,0,75,59
1650603228732,COGS 100,A01,083619,Staff,1,26,60,59
1650603234759,COGS 101A,A01,083621,Davis; Joshua Daniel,0,26,60,60
1650603240782,COGS 101B,A01,091572,Staff,1,5,60,59
1650603246811,COGS 101C,A01,083625,Delgado; Tania,15,0,30,15
1650603252945,COGS 107A,A01,083627,Boyle; Mary E. T.,0,15,60,60
1650603258985,COGS 118A,A01,083075,Staff,0,4,60,60
1650603265012,CSE 3,A50,083646,Miranda; Gregory Joseph,19,0,38,19
1650603265012,CSE 3,A51,083647,Miranda; Gregory Joseph,36,0,37,1
1650603271036,CSE 8A,A50,083650,Miranda; Gregory Joseph,0,30,40,40
1650603277060,CSE 11,A01,083080,Cao; Yingjun,0,95,40,40
1650603283082,CSE 12,A01,083652,Staff,0,20,100,100
1650603289110,CSE 15L,A01,083654,Staff,0,2,50,50
1650603289110,CSE 15L,A02,083655,Staff,0,1,50,50
1650603295133,CSE 20,A01,083657,Staff,51,0,80,29
1650603301160,CSE 30,A01,083084,Eldon; John,0,78,40,40
1650603307185,CSE 100,A01,083659,Cao; Yingjun,0,68,50,50
1650603313221,CSE 134B,A01,083661,Powell; Thomas Allan,0,35,65,65
1650603319251,CSE 140,A01,083663,Staff,1,9,75,74
1650603325283,CSE 140L,A01,083088,Eldon; John,1,15,75,74
1650603331307,CSE 175,A01,083665,Kumar; Rakesh,7,0,25,18
1650603337336,CSE 190,A00,092507,Dubnov; Shlomo,11,0,20,9
1650603343358,ECE 45,A01,083139,Staff,1,2,60,59
1650603349382,ECE 65,A50,083695,Staff,1,6,30,29
1650603355408,ECE 109,A01,091882,Touri; Behrouz,33,0,70,37
1650603361432,ECE 180,A00,083140,Abi Samra; Nicholas Camill,21,0,30,9
1650603361432,ECE 180,B00,083141,Abi Samra; Nicholas Camill,0,0,30,30
1650603367457,MATH 10A,A01,083735,Patchell; Gregory David,4,0,30,26
1650603367457,MATH 10A,A02,083736,Patchell; Gregory David,27,0,30,3
1650603367457,MATH 10A,A03,083737,Patchell; Gregory David,24,0,30,6
1650603373483,MATH 10B,A01,083207,Staff,1,9,30,29
1650603373483,MATH 10B,A02,083208,Staff,0,8,30,30
1650603373483,MATH 10B,B01,083739,Staff,11,0,30,19
1650603373483,MATH 10B,B02,083740,Staff,28,0,30,2
1650603379509,MATH 18,A01,083743,Staff,0,0,30,30
1650603379509,MATH 18,A02,083744,Staff,23,0,30,7
1650603379509,MATH 18,A03,083745,Staff,21,0,30,9
1650603379509,MATH 18,A04,083746,Staff,26,0,30,4
1650603379509,MATH 18,B01,083748,Staff,0,15,30,30
1650603379509,MATH 18,B02,083749,Staff,1,11,30,29
1650603379509,MATH 18,B03,083750,Staff,0,12,30,30
1650603379509,MATH 18,B04,083751,Staff,0,12,30,30
1650603385533,MATH 20A,A01,083754,Staff,19,0,40,21
1650603391556,MATH 20B,A01,083756,Staff,1,12,30,29
1650603391556,MATH 20B,A02,083757,Staff,0,12,30,30
1650603397580,MATH 20C,A01,083760,Staff,0,16,30,30
1650603397580,MATH 20C,A02,083761,Staff,2,14,30,28
1650603397580,MATH 20C,B01,083762,Staff,11,0,30,19
1650603397580,MATH 20C,B02,083763,Staff,28,0,30,2
1650603403605,MATH 20D,A01,083765,Staff,1,1,30,29
1650603403605,MATH 20D,A02,083766,Staff,7,0,30,23
1650603403605,MATH 20D,A03,083767,Staff,24,0,30,6
1650603409638,MATH 20E,A01,083771,Staff,3,0,30,27
1650603409638,MATH 20E,A02,083772,Staff,17,0,30,13
1650603409638,MATH 20E,B01,083773,Staff,0,0,30,30
1650603409638,MATH 20E,B02,083774,Staff,9,0,30,21
1650603415673,MATH 103A,A01,083777,Staff,0,15,30,30
1650603415673,MATH 103A,A02,083778,Staff,0,14,30,30
1650603415673,MATH 103A,B01,083779,Staff,0,14,30,30
1650603415673,MATH 103A,B02,083780,Staff,0,14,30,30
1650603421698,MATH 105,A01,085443,Staff,0,21,30,30
1650603427725,MATH 109,A01,083213,Anzaldo; Leesa B,1,7,30,29
1650603427725,MATH 109,A02,083214,Anzaldo; Leesa B,0,7,30,30
1650603427725,MATH 109,B01,083215,Anzaldo; Leesa B,0,5,30,30
1650603427725,MATH 109,B02,083216,Anzaldo; Leesa B,1,6,30,29
1650603433753,MATH 142A,A01,083219,Chow; Bennett,0,16,30,30
1650603433753,MATH 142A,A02,083220,Chow; Bennett,0,15,30,30
1650603433753,MATH 142A,B01,083221,Chow; Bennett,0,14,30,30
1650603433753,MATH 142A,B02,083222,Chow; Bennett,0,13,30,30
1650603439776,MATH 193A,A01,083224,Staff,1,6,30,29
1650603439776,MATH 193A,A02,083225,Staff,0,6,30,30
1650603439776,MATH 193A,A03,083781,Staff,0,6,30,30
1650603439776,MATH 193A,A04,083782,Staff,0,7,30,30
1650603445799,MATH 197,001,091859,McAuley; Julian John,9998,0,9999,1
1650603451850,COGS 9,A01,083615,Staff,1,15,60,59
1650603457875,COGS 11,A01,083617,Boyle; Mary E. T.,18,0,40,22
1650603463899,COGS 13,A01,083071,Staff,0,37,40,40
1650603469925,COGS 14A,A01,092681,Staff,0,29,100,100
1650603475948,COGS 14B,A01,083073,Cheng; Tzu-Han,0,13,50,50
1650603481989,COGS 17,A01,092677,Staff,16,0,75,59
1650603488012,COGS 100,A01,083619,Staff,1,26,60,59
1650603494041,COGS 101A,A01,083621,Davis; Joshua Daniel,0,26,60,60
1650603500079,COGS 101B,A01,091572,Staff,1,5,60,59
1650603506113,COGS 101C,A01,083625,Delgado; Tania,15,0,30,15
1650603512140,COGS 107A,A01,083627,Boyle; Mary E. T.,0,15,60,60
1650603518166,COGS 118A,A01,083075,Staff,0,4,60,60
1650603524193,CSE 3,A50,083646,Miranda; Gregory Joseph,19,0,38,19
1650603524193,CSE 3,A51,083647,Miranda; Gregory Joseph,36,0,37,1
1650603530220,CSE 8A,A50,083650,Miranda; Gregory Joseph,0,30,40,40
1650603536249,CSE 11,A01,083080,Cao; Yingjun,0,95,40,40
1650603542273,CSE 12,A01,083652,Staff,0,20,100,100
1650603548298,CSE 15L,A01,083654,Staff,0,2,50,50
1650603548298,CSE 15L,A02,083655,Staff,0,1,50,50
1650603554330,CSE 20,A01,083657,Staff,51,0,80,29
1650603560352,CSE 30,A01,083084,Eldon; John,0,78,40,40
1650603566378,CSE 100,A01,083659,Cao; Yingjun,0,68,50,50
1650603572405,CSE 134B,A01,083661,Powell; Thomas Allan,0,35,65,65
1650603578431,CSE 140,A01,083663,Staff,1,9,75,74
1650603584466,CSE 140L,A01,083088,Eldon; John,1,15,75,74
1650603590489,CSE 175,A01,083665,Kumar; Rakesh,7,0,25,18
1650603596520,CSE 190,A00,092507,Dubnov; Shlomo,11,0,20,9
1650603602557,ECE 45,A01,083139,Staff,1,2,60,59
1650603608581,ECE 65,A50,083695,Staff,1,6,30,29
1650603614610,ECE 109,A01,091882,Touri; Behrouz,33,0,70,37
1650603620633,ECE 180,A00,083140,Abi Samra; Nicholas Camill,21,0,30,9
1650603620633,ECE 180,B00,083141,Abi Samra; Nicholas Camill,0,0,30,30
1650603626664,MATH 10A,A01,083735,Patchell; Gregory David,4,0,30,26
1650603626664,MATH 10A,A02,083736,Patchell; Gregory David,27,0,30,3
1650603626664,MATH 10A,A03,083737,Patchell; Gregory David,24,0,30,6
1650603632688,MATH 10B,A01,083207,Staff,1,9,30,29
1650603632688,MATH 10B,A02,083208,Staff,0,8,30,30
1650603632688,MATH 10B,B01,083739,Staff,11,0,30,19
1650603632688,MATH 10B,B02,083740,Staff,28,0,30,2
1650603638721,MATH 18,A01,083743,Staff,0,0,30,30
1650603638721,MATH 18,A02,083744,Staff,23,0,30,7
1650603638721,MATH 18,A03,083745,Staff,21,0,30,9
1650603638721,MATH 18,A04,083746,Staff,26,0,30,4
1650603638721,MATH 18,B01,083748,Staff,0,15,30,30
1650603638721,MATH 18,B02,083749,Staff,1,11,30,29
1650603638721,MATH 18,B03,083750,Staff,0,12,30,30
1650603638721,MATH 18,B04,083751,Staff,0,12,30,30
1650603644744,MATH 20A,A01,083754,Staff,19,0,40,21
1650603650772,MATH 20B,A01,083756,Staff,1,12,30,29
1650603650772,MATH 20B,A02,083757,Staff,0,12,30,30
1650603656795,MATH 20C,A01,083760,Staff,0,16,30,30
1650603656795,MATH 20C,A02,083761,Staff,2,14,30,28
1650603656795,MATH 20C,B01,083762,Staff,11,0,30,19
1650603656795,MATH 20C,B02,083763,Staff,28,0,30,2
1650603662832,MATH 20D,A01,083765,Staff,1,1,30,29
1650603662832,MATH 20D,A02,083766,Staff,7,0,30,23
1650603662832,MATH 20D,A03,083767,Staff,24,0,30,6
1650603668857,MATH 20E,A01,083771,Staff,3,0,30,27
1650603668857,MATH 20E,A02,083772,Staff,17,0,30,13
1650603668857,MATH 20E,B01,083773,Staff,0,0,30,30
1650603668857,MATH 20E,B02,083774,Staff,9,0,30,21
1650603674886,MATH 103A,A01,083777,Staff,0,15,30,30
1650603674886,MATH 103A,A02,083778,Staff,0,14,30,30
1650603674886,MATH 103A,B01,083779,Staff,0,14,30,30
1650603674886,MATH 103A,B02,083780,Staff,0,14,30,30
1650603680908,MATH 105,A01,085443,Staff,0,21,30,30
1650603686933,MATH 109,A01,083213,Anzaldo; Leesa B,1,7,30,29
1650603686933,MATH 109,A02,083214,Anzaldo; Leesa B,0,7,30,30
1650603686933,MATH 109,B01,083215,Anzaldo; Leesa B,0,5,30,30
1650603686933,MATH 109,B02,083216,Anzaldo; Leesa B,1,6,30,29
1650603692958,MATH 142A,A01,083219,Chow; Bennett,0,16,30,30
1650603692958,MATH 142A,A02,083220,Chow; Bennett,0,15,30,30
1650603692958,MATH 142A,B01,083221,Chow; Bennett,0,14,30,30
1650603692958,MATH 142A,B02,083222,Chow; Bennett,0,13,30,30
1650603698984,MATH 193A,A01,083224,Staff,1,6,30,29
1650603698984,MATH 193A,A02,083225,Staff,0,6,30,30
1650603698984,MATH 193A,A03,083781,Staff,0,6,30,30
1650603698984,MATH 193A,A04,083782,Staff,0,7,30,30
1650603705010,MATH 197,001,091859,McAuley; Julian John,9998,0,9999,1
1650603711063,COGS 9,A01,083615,Staff,1,15,60,59
1650603717088,COGS 11,A01,083617,Boyle; Mary E. T.,18,0,40,22
1650603723115,COGS 13,A01,083071,Staff,0,37,40,40
1650603729145,COGS 14A,A01,092681,Staff,0,29,100,100
1650603735178,COGS 14B,A01,083073,Cheng; Tzu-Han,0,13,50,50
1650603741201,COGS 17,A01,092677,Staff,16,0,75,59
1650603747228,COGS 100,A01,083619,Staff,1,26,60,59
1650603753255,COGS 101A,A01,083621,Davis; Joshua Daniel,0,26,60,60
1650603759279,COGS 101B,A01,091572,Staff,1,5,60,59
1650603765305,COGS 101C,A01,083625,Delgado; Tania,15,0,30,15
1650603771332,COGS 107A,A01,083627,Boyle; Mary E. T.,0,15,60,60
1650603777361,COGS 118A,A01,083075,Staff,0,4,60,60
1650603783397,CSE 3,A50,083646,Miranda; Gregory Joseph,19,0,38,19
1650603783397,CSE 3,A51,083647,Miranda; Gregory Joseph,36,0,37,1
1650603789427,CSE 8A,A50,083650,Miranda; Gregory Joseph,0,30,40,40
1650603795452,CSE 11,A01,083080,Cao; Yingjun,0,95,40,40
1650603801479,CSE 12,A01,083652,Staff,0,20,100,100
1650603807506,CSE 15L,A01,083654,Staff,0,2,50,50
1650603807506,CSE 15L,A02,083655,Staff,0,1,50,50
1650603813534,CSE 20,A01,083657,Staff,51,0,80,29
1650603819564,CSE 30,A01,083084,Eldon; John,0,78,40,40
1650603825587,CSE 100,A01,083659,Cao; Yingjun,0,68,50,50
1650603831615,CSE 134B,A01,083661,Powell; Thomas Allan,0,35,65,65
1650603837641,CSE 140,A01,083663,Staff,1,9,75,74
1650603843668,CSE 140L,A01,083088,Eldon; John,1,15,75,74
1650603849790,CSE 175,A01,083665,Kumar; Rakesh,7,0,25,18
1650603855814,CSE 190,A00,092507,Dubnov; Shlomo,11,0,20,9
1650603861838,ECE 45,A01,083139,Staff,1,2,60,59
1650603867862,ECE 65,A50,083695,Staff,1,6,30,29
1650603873886,ECE 109,A01,091882,Touri; Behrouz,33,0,70,37
1650603879918,ECE 180,A00,083140,Abi Samra; Nicholas Camill,21,0,30,9
1650603879918,ECE 180,B00,083141,Abi Samra; Nicholas Camill,0,0,30,30
1650603885940,MATH 10A,A01,083735,Patchell; Gregory David,4,0,30,26
1650603885940,MATH 10A,A02,083736,Patchell; Gregory David,27,0,30,3
1650603885940,MATH 10A,A03,083737,Patchell; Gregory David,24,0,30,6
1650603891964,MATH 10B,A01,083207,Staff,1,9,30,29
1650603891964,MATH 10B,A02,083208,Staff,0,8,30,30
1650603891964,MATH 10B,B01,083739,Staff,11,0,30,19
1650603891964,MATH 10B,B02,083740,Staff,28,0,30,2
1650603897994,MATH 18,A01,083743,Staff,0,0,30,30
1650603897994,MATH 18,A02,083744,Staff,23,0,30,7
1650603897994,MATH 18,A03,083745,Staff,21,0,30,9
1650603897994,MATH 18,A04,083746,Staff,26,0,30,4
1650603897994,MATH 18,B01,083748,Staff,0,15,30,30
1650603897994,MATH 18,B02,083749,Staff,1,11,30,29
1650603897994,MATH 18,B03,083750,Staff,0,12,30,30
1650603897994,MATH 18,B04,083751,Staff,0,12,30,30
1650603904016,MATH 20A,A01,083754,Staff,19,0,40,21
1650603910039,MATH 20B,A01,083756,Staff,1,12,30,29
1650603910039,MATH 20B,A02,083757,Staff,0,12,30,30
1650603916073,MATH 20C,A01,083760,Staff,0,16,30,30
1650603916073,MATH 20C,A02,083761,Staff,2,14,30,28
1650603916073,MATH 20C,B01,083762,Staff,11,0,30,19
1650603916073,MATH 20C,B02,083763,Staff,28,0,30,2
1650603922104,MATH 20D,A01,083765,Staff,1,1,30,29
1650603922104,MATH 20D,A02,083766,Staff,7,0,30,23
1650603922104,MATH 20D,A03,083767,Staff,24,0,30,6
1650603928131,MATH 20E,A01,083771,Staff,3,0,30,27
1650603928131,MATH 20E,A02,083772,Staff,17,0,30,13
1650603928131,MATH 20E,B01,083773,Staff,0,0,30,30
1650603928131,MATH 20E,B02,083774,Staff,9,0,30,21
1650603934154,MATH 103A,A01,083777,Staff,0,15,30,30
1650603934154,MATH 103A,A02,083778,Staff,0,14,30,30
1650603934154,MATH 103A,B01,083779,Staff,0,14,30,30
1650603934154,MATH 103A,B02,083780,Staff,0,14,30,30
1650603940176,MATH 105,A01,085443,Staff,0,21,30,30
1650603946200,MATH 109,A01,083213,Anzaldo; Leesa B,1,7,30,29
1650603946200,MATH 109,A02,083214,Anzaldo; Leesa B,0,7,30,30
1650603946200,MATH 109,B01,083215,Anzaldo; Leesa B,0,5,30,30
1650603946200,MATH 109,B02,083216,Anzaldo; Leesa B,1,6,30,29
1650603952224,MATH 142A,A01,083219,Chow; Bennett,0,16,30,30
1650603952224,MATH 142A,A02,083220,Chow; Bennett,0,15,30,30
1650603952224,MATH 142A,B01,083221,Chow; Bennett,0,14,30,30
1650603952224,MATH 142A,B02,083222,Chow; Bennett,0,13,30,30
1650603958248,MATH 193A,A01,083224,Staff,1,6,30,29
1650603958248,MATH 193A,A02,083225,Staff,0,6,30,30
1650603958248,MATH 193A,A03,083781,Staff,0,6,30,30
1650603958248,MATH 193A,A04,083782,Staff,0,7,30,30
1650603964274,MATH 197,001,091859,McAuley; Julian John,9998,0,9999,1
1650603970334,COGS 9,A01,083615,Staff,1,15,60,59
1650603976360,COGS 11,A01,083617,Boyle; Mary E. T.,18,0,40,22
1650603982383,COGS 13,A01,083071,Staff,0,37,40,40
1650603988407,COGS 14A,A01,092681,Staff,0,29,100,100
1650603994435,COGS 14B,A01,083073,Cheng; Tzu-Han,0,13,50,50
1650604000459,COGS 17,A01,092677,Staff,16,0,75,59
1650604006482,COGS 100,A01,083619,Staff,1,26,60,59
1650604012506,COGS 101A,A01,083621,Davis; Joshua Daniel,0,26,60,60
1650604018530,COGS 101B,A01,091572,Staff,1,5,60,59
1650604024553,COGS 101C,A01,083625,Delgado; Tania,15,0,30,15
1650604030580,COGS 107A,A01,083627,Boyle; Mary E. T.,0,15,60,60
1650604036611,COGS 118A,A01,083075,Staff,0,4,60,60
1650604042642,CSE 3,A50,083646,Miranda; Gregory Joseph,19,0,38,19
1650604042642,CSE 3,A51,083647,Miranda; Gregory Joseph,36,0,37,1
1650604048666,CSE 8A,A50,083650,Miranda; Gregory Joseph,0,30,40,40
1650604054693,CSE 11,A01,083080,Cao; Yingjun,0,95,40,40
1650604060724,CSE 12,A01,083652,Staff,0,20,100,100
1650604066750,CSE 15L,A01,083654,Staff,0,2,50,50
1650604066750,CSE 15L,A02,083655,Staff,0,1,50,50
1650604072775,CSE 20,A01,083657,Staff,51,0,80,29
1650604078801,CSE 30,A01,083084,Eldon; John,0,78,40,40
1650604084834,CSE 100,A01,083659,Cao; Yingjun,0,68,50,50
1650604090857,CSE 134B,A01,083661,Powell; Thomas Allan,0,35,65,65
1650604096880,CSE 140,A01,083663,Staff,1,9,75,74
1650604102904,CSE 140L,A01,083088,Eldon; John,1,15,75,74
1650604108934,CSE 175,A01,083665,Kumar; Rakesh,7,0,25,18
1650604114960,CSE 190,A00,092507,Dubnov; Shlomo,11,0,20,9
1650604121001,ECE 45,A01,083139,Staff,1,2,60,59
1650604127026,ECE 65,A50,083695,Staff,1,6,30,29
1650604133050,ECE 109,A01,091882,Touri; Behrouz,33,0,70,37
1650604139085,ECE 180,A00,083140,Abi Samra; Nicholas Camill,21,0,30,9
1650604139085,ECE 180,B00,083141,Abi Samra; Nicholas Camill,0,0,30,30
1650604145107,MATH 10A,A01,083735,Patchell; Gregory David,4,0,30,26
1650604145107,MATH 10A,A02,083736,Patchell; Gregory David,27,0,30,3
1650604145107,MATH 10A,A03,083737,Patchell; Gregory David,24,0,30,6
1650604151136,MATH 10B,A01,083207,Staff,1,9,30,29
1650604151136,MATH 10B,A02,083208,Staff,0,8,30,30
1650604151136,MATH 10B,B01,083739,Staff,11,0,30,19
1650604151136,MATH 10B,B02,083740,Staff,28,0,30,2
1650604157166,MATH 18,A01,083743,Staff,0,0,30,30
1650604157166,MATH 18,A02,083744,Staff,23,0,30,7
1650604157166,MATH 18,A03,083745,Staff,21,0,30,9
1650604157166,MATH 18,A04,083746,Staff,26,0,30,4
1650604157166,MATH 18,B01,083748,Staff,0,15,30,30
1650604157166,MATH 18,B02,083749,Staff,1,11,30,29
1650604157166,MATH 18,B03,083750,Staff,0,12,30,30
1650604157166,MATH 18,B04,083751,Staff,0,12,30,30
1650604163193,MATH 20A,A01,083754,Staff,19,0,40,21
1650604169220,MATH 20B,A01,083756,Staff,1,12,30,29
1650604169220,MATH 20B,A02,083757,Staff,0,12,30,30
1650604175255,MATH 20C,A01,083760,Staff,0,16,30,30
1650604175255,MATH 20C,A02,083761,Staff,2,14,30,28
1650604175255,MATH 20C,B01,083762,Staff,11,0,30,19
1650604175255,MATH 20C,B02,083763,Staff,28,0,30,2
1650604181281,MATH 20D,A01,083765,Staff,1,1,30,29
1650604181281,MATH 20D,A02,083766,Staff,7,0,30,23
1650604181281,MATH 20D,A03,083767,Staff,24,0,30,6
1650604187305,MATH 20E,A01,083771,Staff,3,0,30,27
1650604187305,MATH 20E,A02,083772,Staff,17,0,30,13
1650604187305,MATH 20E,B01,083773,Staff,0,0,30,30
1650604187305,MATH 20E,B02,083774,Staff,9,0,30,21
1650604193333,MATH 103A,A01,083777,Staff,0,15,30,30
1650604193333,MATH 103A,A02,083778,Staff,0,14,30,30
1650604193333,MATH 103A,B01,083779,Staff,0,14,30,30
1650604193333,MATH 103A,B02,083780,Staff,0,14,30,30
1650604199359,MATH 105,A01,085443,Staff,0,21,30,30
1650604205385,MATH 109,A01,083213,Anzaldo; Leesa B,1,7,30,29
1650604205385,MATH 109,A02,083214,Anzaldo; Leesa B,0,7,30,30
1650604205385,MATH 109,B01,083215,Anzaldo; Leesa B,0,5,30,30
1650604205385,MATH 109,B02,083216,Anzaldo; Leesa B,1,6,30,29
1650604211409,MATH 142A,A01,083219,Chow; Bennett,0,16,30,30
1650604211409,MATH 142A,A02,083220,Chow; Bennett,0,15,30,30
1650604211409,MATH 142A,B01,083221,Chow; Bennett,0,14,30,30
1650604211409,MATH 142A,B02,083222,Chow; Bennett,0,13,30,30
1650604217440,MATH 193A,A01,083224,Staff,1,6,30,29
1650604217440,MATH 193A,A02,083225,Staff,0,6,30,30
1650604217440,MATH 193A,A03,083781,Staff,0,6,30,30
1650604217440,MATH 193A,A04,083782,Staff,0,7,30,30
1650604223466,MATH 197,001,091859,McAuley; Julian John,9998,0,9999,1
1650604229524,COGS 9,A01,083615,Staff,1,15,60,59
1650604235547,COGS 11,A01,083617,Boyle; Mary E. T.,18,0,40,22
1650604241571,COGS 13,A01,083071,Staff,0,37,40,40
1650604247596,COGS 14A,A01,092681,Staff,0,29,100,100
1650604253619,COGS 14B,A01,083073,Cheng; Tzu-Han,0,13,50,50
1650604259643,COGS 17,A01,092677,Staff,16,0,75,59
1650604265667,COGS 100,A01,083619,Staff,1,26,60,59
1650604271692,COGS 101A,A01,083621,Davis; Joshua Daniel,0,26,60,60
1650604277730,COGS 101B,A01,091572,Staff,1,5,60,59
1650604283757,COGS 101C,A01,083625,Delgado; Tania,15,0,30,15
1650604289797,COGS 107A,A01,083627,Boyle; Mary E. T.,0,15,60,60
1650604295824,COGS 118A,A01,083075,Staff,0,4,60,60
1650604301847,CSE 3,A50,083646,Miranda; Gregory Joseph,19,0,38,19
1650604301847,CSE 3,A51,083647,Miranda; Gregory Joseph,36,0,37,1
1650604307871,CSE 8A,A50,083650,Miranda; Gregory Joseph,0,30,40,40
1650604313897,CSE 11,A01,083080,Cao; Yingjun,0,95,40,40
1650604319924,CSE 12,A01,083652,Staff,0,20,100,100
1650604325948,CSE 15L,A01,083654,Staff,0,2,50,50
1650604325948,CSE 15L,A02,083655,Staff,0,1,50,50
1650604331975,CSE 20,A01,083657,Staff,51,0,80,29
1650604338005,CSE 30,A01,083084,Eldon; John,0,78,40,40
1650604344031,CSE 100,A01,083659,Cao; Yingjun,0,68,50,50
1650604350055,CSE 134B,A01,083661,Powell; Thomas Allan,0,35,65,65
1650604356104,CSE 140,A01,083663,Staff,1,9,75,74
1650604362133,CSE 140L,A01,083088,Eldon; John,1,15,75,74
1650604368159,CSE 175,A01,083665,Kumar; Rakesh,7,0,25,18
1650604374183,CSE 190,A00,092507,Dubnov; Shlomo,11,0,20,9
1650604380207,ECE 45,A01,083139,Staff,1,2,60,59
1650604386244,ECE 65,A50,083695,Staff,1,6,30,29
1650604392268,ECE 109,A01,091882,Touri; Behrouz,33,0,70,37
1650604398291,ECE 180,A00,083140,Abi Samra; Nicholas Camill,21,0,30,9
1650604398291,ECE 180,B00,083141,Abi Samra; Nicholas Camill,0,0,30,30
1650604404320,MATH 10A,A01,083735,Patchell; Gregory David,4,0,30,26
1650604404320,MATH 10A,A02,083736,Patchell; Gregory David,27,0,30,3
1650604404320,MATH 10A,A03,083737,Patchell; Gregory David,24,0,30,6
1650604410356,MATH 10B,A01,083207,Staff,1,9,30,29
1650604410356,MATH 10B,A02,083208,Staff,0,8,30,30
1650604410356,MATH 10B,B01,083739,Staff,11,0,30,19
1650604410356,MATH 10B,B02,083740,Staff,28,0,30,2
1650604416405,MATH 18,A01,083743,Staff,0,0,30,30
1650604416405,MATH 18,A02,083744,Staff,23,0,30,7
1650604416405,MATH 18,A03,083745,Staff,21,0,30,9
1650604416405,MATH 18,A04,083746,Staff,26,0,30,4
1650604416405,MATH 18,B01,083748,Staff,0,15,30,30
1650604416405,MATH 18,B02,083749,Staff,1,11,30,29
1650604416405,MATH 18,B03,083750,Staff,0,12,30,30
1650604416405,MATH 18,B04,083751,Staff,0,12,30,30
1650604422440,MATH 20A,A01,083754,Staff,19,0,40,21
1650604428468,MATH 20B,A01,083756,Staff,1,12,30,29
1650604428468,MATH 20B,A02,083757,Staff,0,12,30,30
1650604434509,MATH 20C,A01,083760,Staff,0,16,30,30
1650604434509,MATH 20C,A02,083761,Staff,2,14,30,28
1650604434509,MATH 20C,B01,083762,Staff,11,0,30,19
1650604434509,MATH 20C,B02,083763,Staff,28,0,30,2
1650604440549,MATH 20D,A01,083765,Staff,1,1,30,29
1650604440549,MATH 20D,A02,083766,Staff,7,0,30,23
1650604440549,MATH 20D,A03,083767,Staff,24,0,30,6
1650604446671,MATH 20E,A01,083771,Staff,3,0,30,27
1650604446671,MATH 20E,A02,083772,Staff,17,0,30,13
1650604446671,MATH 20E,B01,083773,Staff,0,0,30,30
1650604446671,MATH 20E,B02,083774,Staff,9,0,30,21
1650604452708,MATH 103A,A01,083777,Staff,0,15,30,30
1650604452708,MATH 103A,A02,083778,Staff,0,14,30,30
1650604452708,MATH 103A,B01,083779,Staff,0,14,30,30
1650604452708,MATH 103A,B02,083780,Staff,0,14,30,30
1650604458744,MATH 105,A01,085443,Staff,0,21,30,30
1650604464771,MATH 109,A01,083213,Anzaldo; Leesa B,1,7,30,29
1650604464771,MATH 109,A02,083214,Anzaldo; Leesa B,0,7,30,30
1650604464771,MATH 109,B01,083215,Anzaldo; Leesa B,0,6,30,30
1650604464771,MATH 109,B02,083216,Anzaldo; Leesa B,1,6,30,29
1650604470793,MATH 142A,A01,083219,Chow; Bennett,0,16,30,30
1650604470793,MATH 142A,A02,083220,Chow; Bennett,0,15,30,30
1650604470793,MATH 142A,B01,083221,Chow; Bennett,0,14,30,30
1650604470793,MATH 142A,B02,083222,Chow; Bennett,0,13,30,30
1650604476815,MATH 193A,A01,083224,Staff,1,6,30,29
1650604476815,MATH 193A,A02,083225,Staff,0,6,30,30
1650604476815,MATH 193A,A03,083781,Staff,0,6,30,30
1650604476815,MATH 193A,A04,083782,Staff,0,7,30,30
1650604482844,MATH 197,001,091859,McAuley; Julian John,9998,0,9999,1
1650604488904,COGS 9,A01,083615,Staff,1,15,60,59
1650604494937,COGS 11,A01,083617,Boyle; Mary E. T.,18,0,40,22
1650604500960,COGS 13,A01,083071,Staff,0,37,40,40
1650604506986,COGS 14A,A01,092681,Staff,0,29,100,100
1650604513012,COGS 14B,A01,083073,Cheng; Tzu-Han,0,13,50,50
1650604519045,COGS 17,A01,092677,Staff,16,0,75,59
1650604525079,COGS 100,A01,083619,Staff,1,26,60,59
1650604531105,COGS 101A,A01,083621,Davis; Joshua Daniel,0,26,60,60
1650604537134,COGS 101B,A01,091572,Staff,1,5,60,59
1650604543158,COGS 101C,A01,083625,Delgado; Tania,15,0,30,15
1650604549194,COGS 107A,A01,083627,Boyle; Mary E. T.,0,15,60,60
1650604555221,COGS 118A,A01,083075,Staff,0,4,60,60
1650604561256,CSE 3,A50,083646,Miranda; Gregory Joseph,19,0,38,19
1650604561256,CSE 3,A51,083647,Miranda; Gregory Joseph,36,0,37,1
1650604567283,CSE 8A,A50,083650,Miranda; Gregory Joseph,0,30,40,40
1650604573307,CSE 11,A01,083080,Cao; Yingjun,0,95,40,40
1650604579346,CSE 12,A01,083652,Staff,0,20,100,100
1650604585370,CSE 15L,A01,083654,Staff,0,2,50,50
1650604585370,CSE 15L,A02,083655,Staff,0,1,50,50
1650604591395,CSE 20,A01,083657,Staff,51,0,80,29
1650604597417,CSE 30,A01,083084,Eldon; John,0,78,40,40
1650604603443,CSE 100,A01,083659,Cao; Yingjun,0,68,50,50
1650604609476,CSE 134B,A01,083661,Powell; Thomas Allan,0,35,65,65
1650604615499,CSE 140,A01,083663,Staff,1,9,75,74
1650604621526,CSE 140L,A01,083088,Eldon; John,1,15,75,74
1650604627547,CSE 175,A01,083665,Kumar; Rakesh,7,0,25,18
1650604633575,CSE 190,A00,092507,Dubnov; Shlomo,11,0,20,9
1650604639602,ECE 45,A01,083139,Staff,1,2,60,59
1650604645708,ECE 65,A50,083695,Staff,1,6,30,29
1650604651731,ECE 109,A01,091882,Touri; Behrouz,33,0,70,37
1650604657756,ECE 180,A00,083140,Abi Samra; Nicholas Camill,21,0,30,9
1650604657756,ECE 180,B00,083141,Abi Samra; Nicholas Camill,0,0,30,30
1650604663785,MATH 10A,A01,083735,Patchell; Gregory David,4,0,30,26
1650604663785,MATH 10A,A02,083736,Patchell; Gregory David,27,0,30,3
1650604663785,MATH 10A,A03,083737,Patchell; Gregory David,24,0,30,6
1650604669820,MATH 10B,A01,083207,Staff,1,9,30,29
1650604669820,MATH 10B,A02,083208,Staff,0,8,30,30
1650604669820,MATH 10B,B01,083739,Staff,11,0,30,19
1650604669820,MATH 10B,B02,083740,Staff,28,0,30,2
1650604675864,MATH 18,A01,083743,Staff,0,0,30,30
1650604675864,MATH 18,A02,083744,Staff,23,0,30,7
1650604675864,MATH 18,A03,083745,Staff,21,0,30,9
1650604675864,MATH 18,A04,083746,Staff,26,0,30,4
1650604675864,MATH 18,B01,083748,Staff,0,15,30,30
1650604675864,MATH 18,B02,083749,Staff,1,11,30,29
1650604675864,MATH 18,B03,083750,Staff,0,12,30,30
1650604675864,MATH 18,B04,083751,Staff,0,12,30,30
1650604681888,MATH 20A,A01,083754,Staff,19,0,40,21
1650604687912,MATH 20B,A01,083756,Staff,1,12,30,29
1650604687912,MATH 20B,A02,083757,Staff,0,12,30,30
1650604693938,MATH 20C,A01,083760,Staff,0,16,30,30
1650604693938,MATH 20C,A02,083761,Staff,2,14,30,28
1650604693938,MATH 20C,B01,083762,Staff,11,0,30,19
1650604693938,MATH 20C,B02,083763,Staff,28,0,30,2
1650604699964,MATH 20D,A01,083765,Staff,1,1,30,29
1650604699964,MATH 20D,A02,083766,Staff,7,0,30,23
1650604699964,MATH 20D,A03,083767,Staff,24,0,30,6
1650604705987,MATH 20E,A01,083771,Staff,3,0,30,27
1650604705987,MATH 20E,A02,083772,Staff,17,0,30,13
1650604705987,MATH 20E,B01,083773,Staff,0,0,30,30
1650604705987,MATH 20E,B02,083774,Staff,9,0,30,21
1650604712016,MATH 103A,A01,083777,Staff,0,15,30,30
1650604712016,MATH 103A,A02,083778,Staff,0,14,30,30
1650604712016,MATH 103A,B01,083779,Staff,0,14,30,30
1650604712016,MATH 103A,B02,083780,Staff,0,14,30,30
1650604718040,MATH 105,A01,085443,Staff,0,21,30,30
1650604724066,MATH 109,A01,083213,Anzaldo; Leesa B,1,7,30,29
1650604724066,MATH 109,A02,083214,Anzaldo; Leesa B,0,7,30,30
1650604724066,MATH 109,B01,083215,Anzaldo; Leesa B,0,6,30,30
1650604724066,MATH 109,B02,083216,Anzaldo; Leesa B,1,6,30,29
1650604730090,MATH 142A,A01,083219,Chow; Bennett,0,16,30,30
1650604730090,MATH 142A,A02,083220,Chow; Bennett,0,15,30,30
1650604730090,MATH 142A,B01,083221,Chow; Bennett,0,14,30,30
1650604730090,MATH 142A,B02,083222,Chow; Bennett,0,13,30,30
1650604736114,MATH 193A,A01,083224,Staff,1,6,30,29
1650604736114,MATH 193A,A02,083225,Staff,0,6,30,30
1650604736114,MATH 193A,A03,083781,Staff,0,6,30,30
1650604736114,MATH 193A,A04,083782,Staff,0,7,30,30
1650604742141,MATH 197,001,091859,McAuley; Julian John,9998,0,9999,1
1650604748193,COGS 9,A01,083615,Staff,1,15,60,59
1650604754220,COGS 11,A01,083617,Boyle; Mary E. T.,18,0,40,22
1650604760243,COGS 13,A01,083071,Staff,0,37,40,40
1650604766276,COGS 14A,A01,092681,Staff,0,29,100,100
1650604772298,COGS 14B,A01,083073,Cheng; Tzu-Han,0,13,50,50
1650604778325,COGS 17,A01,092677,Staff,16,0,75,59
1650604784352,COGS 100,A01,083619,Staff,1,26,60,59
1650604790379,COGS 101A,A01,083621,Davis; Joshua Daniel,0,26,60,60
1650604796404,COGS 101B,A01,091572,Staff,1,5,60,59
1650604802429,COGS 101C,A01,083625,Delgado; Tania,15,0,30,15
1650604808461,COGS 107A,A01,083627,Boyle; Mary E. T.,0,15,60,60
1650604814489,COGS 118A,A01,083075,Staff,0,4,60,60
1650604820513,CSE 3,A50,083646,Miranda; Gregory Joseph,19,0,38,19
1650604820513,CSE 3,A51,083647,Miranda; Gregory Joseph,36,0,37,1
1650604826540,CSE 8A,A50,083650,Miranda; Gregory Joseph,0,30,40,40
1650604832568,CSE 11,A01,083080,Cao; Yingjun,0,95,40,40
1650604838595,CSE 12,A01,083652,Staff,0,20,100,100
1650604844619,CSE 15L,A01,083654,Staff,0,2,50,50
1650604844619,CSE 15L,A02,083655,Staff,0,1,50,50
1650604850645,CSE 20,A01,083657,Staff,51,0,80,29
1650604856670,CSE 30,A01,083084,Eldon; John,0,78,40,40
1650604862699,CSE 100,A01,083659,Cao; Yingjun,0,68,50,50
1650604868722,CSE 134B,A01,083661,Powell; Thomas Allan,0,35,65,65
1650604874750,CSE 140,A01,083663,Staff,1,9,75,74
1650604880778,CSE 140L,A01,083088,Eldon; John,1,15,75,74
1650604886802,CSE 175,A01,083665,Kumar; Rakesh,7,0,25,18
1650604892840,CSE 190,A00,092507,Dubnov; Shlomo,11,0,20,9
1650604898864,ECE 45,A01,083139,Staff,1,2,60,59
1650604904896,ECE 65,A50,083695,Staff,1,6,30,29
1650604910921,ECE 109,A01,091882,Touri; Behrouz,33,0,70,37
1650604916953,ECE 180,A00,083140,Abi Samra; Nicholas Camill,21,0,30,9
1650604916953,ECE 180,B00,083141,Abi Samra; Nicholas Camill,0,0,30,30
1650604922982,MATH 10A,A01,083735,Patchell; Gregory David,4,0,30,26
1650604922982,MATH 10A,A02,083736,Patchell; Gregory David,27,0,30,3
1650604922982,MATH 10A,A03,083737,Patchell; Gregory David,24,0,30,6
1650604929006,MATH 10B,A01,083207,Staff,1,9,30,29
1650604929006,MATH 10B,A02,083208,Staff,0,8,30,30
1650604929006,MATH 10B,B01,083739,Staff,11,0,30,19
1650604929006,MATH 10B,B02,083740,Staff,28,0,30,2
1650604935038,MATH 18,A01,083743,Staff,0,0,30,30
1650604935038,MATH 18,A02,083744,Staff,23,0,30,7
1650604935038,MATH 18,A03,083745,Staff,21,0,30,9
1650604935038,MATH 18,A04,083746,Staff,26,0,30,4
1650604935038,MATH 18,B01,083748,Staff,0,15,30,30
1650604935038,MATH 18,B02,083749,Staff,1,11,30,29
1650604935038,MATH 18,B03,083750,Staff,0,12,30,30
1650604935038,MATH 18,B04,083751,Staff,0,12,30,30
1650604941066,MATH 20A,A01,083754,Staff,19,0,40,21
1650604947094,MATH 20B,A01,083756,Staff,1,12,30,29
1650604947094,MATH 20B,A02,083757,Staff,0,12,30,30
1650604953118,MATH 20C,A01,083760,Staff,0,16,30,30
1650604953118,MATH 20C,A02,083761,Staff,2,14,30,28
1650604953118,MATH 20C,B01,083762,Staff,11,0,30,19
1650604953118,MATH 20C,B02,083763,Staff,28,0,30,2
1650604959146,MATH 20D,A01,083765,Staff,1,1,30,29
1650604959146,MATH 20D,A02,083766,Staff,7,0,30,23
1650604959146,MATH 20D,A03,083767,Staff,24,0,30,6
1650604965171,MATH 20E,A01,083771,Staff,3,0,30,27
1650604965171,MATH 20E,A02,083772,Staff,17,0,30,13
1650604965171,MATH 20E,B01,083773,Staff,0,0,30,30
1650604965171,MATH 20E,B02,083774,Staff,9,0,30,21
1650604971205,MATH 103A,A01,083777,Staff,0,15,30,30
1650604971205,MATH 103A,A02,083778,Staff,0,14,30,30
1650604971205,MATH 103A,B01,083779,Staff,0,14,30,30
1650604971205,MATH 103A,B02,083780,Staff,0,14,30,30
1650604977229,MATH 105,A01,085443,Staff,0,21,30,30
1650604983267,MATH 109,A01,083213,Anzaldo; Leesa B,1,7,30,29
1650604983267,MATH 109,A02,083214,Anzaldo; Leesa B,0,7,30,30
1650604983267,MATH 109,B01,083215,Anzaldo; Leesa B,0,6,30,30
1650604983267,MATH 109,B02,083216,Anzaldo; Leesa B,1,6,30,29
1650604989294,MATH 142A,A01,083219,Chow; Bennett,0,16,30,30
1650604989294,MATH 142A,A02,083220,Chow; Bennett,0,15,30,30
1650604989294,MATH 142A,B01,083221,Chow; Bennett,0,14,30,30
1650604989294,MATH 142A,B02,083222,Chow; Bennett,0,13,30,30
1650604995317,MATH 193A,A01,083224,Staff,1,6,30,29
1650604995317,MATH 193A,A02,083225,Staff,0,6,30,30
1650604995317,MATH 193A,A03,083781,Staff,0,6,30,30
1650604995317,MATH 193A,A04,083782,Staff,0,7,30,30
1650605001340,MATH 197,001,091859,McAuley; Julian John,9998,0,9999,1
1650605007398,COGS 9,A01,083615,Staff,1,15,60,59
1650605013425,COGS 11,A01,083617,Boyle; Mary E. T.,18,0,40,22
1650605019455,COGS 13,A01,083071,Staff,0,37,40,40
1650605025489,COGS 14A,A01,092681,Staff,0,29,100,100
1650605031517,COGS 14B,A01,083073,Cheng; Tzu-Han,0,13,50,50
1650605037627,COGS 17,A01,092677,Staff,16,0,75,59
1650605043653,COGS 100,A01,083619,Staff,1,26,60,59
1650605049683,COGS 101A,A01,083621,Davis; Joshua Daniel,0,26,60,60
1650605055708,COGS 101B,A01,091572,Staff,1,5,60,59
1650605061732,COGS 101C,A01,083625,Delgado; Tania,15,0,30,15
1650605067757,COGS 107A,A01,083627,Boyle; Mary E. T.,0,15,60,60
1650605073782,COGS 118A,A01,083075,Staff,0,4,60,60
1650605079810,CSE 3,A50,083646,Miranda; Gregory Joseph,19,0,38,19
1650605079810,CSE 3,A51,083647,Miranda; Gregory Joseph,36,0,37,1
1650605085846,CSE 8A,A50,083650,Miranda; Gregory Joseph,0,30,40,40
1650605091870,CSE 11,A01,083080,Cao; Yingjun,0,95,40,40
1650605097908,CSE 12,A01,083652,Staff,0,20,100,100
1650605103931,CSE 15L,A01,083654,Staff,0,2,50,50
1650605103931,CSE 15L,A02,083655,Staff,0,1,50,50
1650605109955,CSE 20,A01,083657,Staff,51,0,80,29
1650605115982,CSE 30,A01,083084,Eldon; John,0,78,40,40
1650605122015,CSE 100,A01,083659,Cao; Yingjun,0,68,50,50
1650605128052,CSE 134B,A01,083661,Powell; Thomas Allan,0,35,65,65
1650605134079,CSE 140,A01,083663,Staff,1,9,75,74
1650605140103,CSE 140L,A01,083088,Eldon; John,1,15,75,74
1650605146127,CSE 175,A01,083665,Kumar; Rakesh,7,0,25,18
1650605152151,CSE 190,A00,092507,Dubnov; Shlomo,11,0,20,9
1650605158177,ECE 45,A01,083139,Staff,1,2,60,59
1650605164201,ECE 65,A50,083695,Staff,1,6,30,29
1650605170227,ECE 109,A01,091882,Touri; Behrouz,33,0,70,37
1650605176250,ECE 180,A00,083140,Abi Samra; Nicholas Camill,21,0,30,9
1650605176250,ECE 180,B00,083141,Abi Samra; Nicholas Camill,0,0,30,30
1650605182275,MATH 10A,A01,083735,Patchell; Gregory David,4,0,30,26
1650605182275,MATH 10A,A02,083736,Patchell; Gregory David,27,0,30,3
1650605182275,MATH 10A,A03,083737,Patchell; Gregory David,24,0,30,6
1650605188300,MATH 10B,A01,083207,Staff,0,8,30,30
1650605188300,MATH 10B,A02,083208,Staff,0,8,30,30
1650605188300,MATH 10B,B01,083739,Staff,11,0,30,19
1650605188300,MATH 10B,B02,083740,Staff,28,0,30,2
1650605194327,MATH 18,A01,083743,Staff,0,0,30,30
1650605194327,MATH 18,A02,083744,Staff,23,0,30,7
1650605194327,MATH 18,A03,083745,Staff,21,0,30,9
1650605194327,MATH 18,A04,083746,Staff,26,0,30,4
1650605194327,MATH 18,B01,083748,Staff,0,15,30,30
1650605194327,MATH 18,B02,083749,Staff,0,10,30,30
1650605194327,MATH 18,B03,083750,Staff,0,12,30,30
1650605194327,MATH 18,B04,083751,Staff,0,12,30,30
1650605200357,MATH 20A,A01,083754,Staff,19,0,40,21
1650605206387,MATH 20B,A01,083756,Staff,0,11,30,30
1650605206387,MATH 20B,A02,083757,Staff,0,12,30,30
1650605212416,MATH 20C,A01,083760,Staff,0,16,30,30
1650605212416,MATH 20C,A02,083761,Staff,1,12,30,29
1650605212416,MATH 20C,B01,083762,Staff,11,0,30,19
1650605212416,MATH 20C,B02,083763,Staff,28,0,30,2
1650605218441,MATH 20D,A01,083765,Staff,1,1,30,29
1650605218441,MATH 20D,A02,083766,Staff,7,0,30,23
1650605218441,MATH 20D,A03,083767,Staff,24,0,30,6
1650605224482,MATH 20E,A01,083771,Staff,3,0,30,27
1650605224482,MATH 20E,A02,083772,Staff,17,0,30,13
1650605224482,MATH 20E,B01,083773,Staff,0,0,30,30
1650605224482,MATH 20E,B02,083774,Staff,9,0,30,21
1650605230507,MATH 103A,A01,083777,Staff,0,15,30,30
1650605230507,MATH 103A,A02,083778,Staff,0,14,30,30
1650605230507,MATH 103A,B01,083779,Staff,0,14,30,30
1650605230507,MATH 103A,B02,083780,Staff,0,14,30,30
1650605236534,MATH 105,A01,085443,Staff,0,21,30,30
1650605242559,MATH 109,A01,083213,Anzaldo; Leesa B,0,6,30,30
1650605242559,MATH 109,A02,083214,Anzaldo; Leesa B,0,7,30,30
1650605242559,MATH 109,B01,083215,Anzaldo; Leesa B,0,6,30,30
1650605242559,MATH 109,B02,083216,Anzaldo; Leesa B,0,5,30,30
1650605248584,MATH 142A,A01,083219,Chow; Bennett,0,16,30,30
1650605248584,MATH 142A,A02,083220,Chow; Bennett,0,15,30,30
1650605248584,MATH 142A,B01,083221,Chow; Bennett,0,14,30,30
1650605248584,MATH 142A,B02,083222,Chow; Bennett,0,13,30,30
1650605254617,MATH 193A,A01,083224,Staff,0,5,30,30
1650605254617,MATH 193A,A02,083225,Staff,0,6,30,30
1650605254617,MATH 193A,A03,083781,Staff,0,6,30,30
1650605254617,MATH 193A,A04,083782,Staff,0,7,30,30
1650605260639,MATH 197,001,091859,McAuley; Julian John,9998,0,9999,1
1650605266700,COGS 9,A01,083615,Staff,0,14,60,60
1650605272723,COGS 11,A01,083617,Boyle; Mary E. T.,18,0,40,22
1650605278750,COGS 13,A01,083071,Staff,0,37,40,40
1650605284776,COGS 14A,A01,092681,Staff,0,29,100,100
1650605290802,COGS 14B,A01,083073,Cheng; Tzu-Han,0,13,50,50
1650605296831,COGS 17,A01,092677,Staff,16,0,75,59
1650605302856,COGS 100,A01,083619,Staff,0,25,60,60
1650605308883,COGS 101A,A01,083621,Davis; Joshua Daniel,0,26,60,60
1650605314909,COGS 101B,A01,091572,Staff,0,4,60,60
1650605320934,COGS 101C,A01,083625,Delgado; Tania,15,0,30,15
1650605326958,COGS 107A,A01,083627,Boyle; Mary E. T.,0,15,60,60
1650605332981,COGS 118A,A01,083075,Staff,0,4,60,60
1650605339009,CSE 3,A50,083646,Miranda; Gregory Joseph,19,0,38,19
1650605339009,CSE 3,A51,083647,Miranda; Gregory Joseph,36,0,37,1
1650605345034,CSE 8A,A50,083650,Miranda; Gregory Joseph,0,30,40,40
1650605351059,CSE 11,A01,083080,Cao; Yingjun,0,95,40,40
1650605357098,CSE 12,A01,083652,Staff,0,20,100,100
1650605363124,CSE 15L,A01,083654,Staff,0,2,50,50
1650605363124,CSE 15L,A02,083655,Staff,0,1,50,50
1650605369147,CSE 20,A01,083657,Staff,51,0,80,29
1650605375169,CSE 30,A01,083084,Eldon; John,0,78,40,40
1650605381199,CSE 100,A01,083659,Cao; Yingjun,0,68,50,50
1650605387229,CSE 134B,A01,083661,Powell; Thomas Allan,0,35,65,65
1650605393253,CSE 140,A01,083663,Staff,0,8,75,75
1650605399277,CSE 140L,A01,083088,Eldon; John,0,14,75,75
1650605405312,CSE 175,A01,083665,Kumar; Rakesh,7,0,25,18
1650605411336,CSE 190,A00,092507,Dubnov; Shlomo,11,0,20,9
1650605417370,ECE 45,A01,083139,Staff,0,1,60,60
1650605423394,ECE 65,A50,083695,Staff,0,5,30,30
1650605429421,ECE 109,A01,091882,Touri; Behrouz,33,0,70,37
1650605435445,ECE 180,A00,083140,Abi Samra; Nicholas Camill,21,0,30,9
1650605435445,ECE 180,B00,083141,Abi Samra; Nicholas Camill,0,0,30,30
1650605441469,MATH 10A,A01,083735,Patchell; Gregory David,4,0,30,26
1650605441469,MATH 10A,A02,083736,Patchell; Gregory David,27,0,30,3
1650605441469,MATH 10A,A03,083737,Patchell; Gregory David,24,0,30,6
1650605447496,MATH 10B,A01,083207,Staff,0,8,30,30
1650605447496,MATH 10B,A02,083208,Staff,0,8,30,30
1650605447496,MATH 10B,B01,083739,Staff,11,0,30,19
1650605447496,MATH 10B,B02,083740,Staff,28,0,30,2
1650605453545,MATH 18,A01,083743,Staff,0,0,30,30
1650605453545,MATH 18,A02,083744,Staff,23,0,30,7
1650605453545,MATH 18,A03,083745,Staff,21,0,30,9
1650605453545,MATH 18,A04,083746,Staff,26,0,30,4
1650605453545,MATH 18,B01,083748,Staff,0,15,30,30
1650605453545,MATH 18,B02,083749,Staff,0,10,30,30
1650605453545,MATH 18,B03,083750,Staff,0,12,30,30
1650605453545,MATH 18,B04,083751,Staff,0,12,30,30
1650605459578,MATH 20A,A01,083754,Staff,19,0,40,21
1650605465608,MATH 20B,A01,083756,Staff,0,11,30,30
1650605465608,MATH 20B,A02,083757,Staff,0,12,30,30
1650605471653,MATH 20C,A01,083760,Staff,0,16,30,30
1650605471653,MATH 20C,A02,083761,Staff,1,12,30,29
1650605471653,MATH 20C,B01,083762,Staff,11,0,30,19
1650605471653,MATH 20C,B02,083763,Staff,28,0,30,2
1650605477709,MATH 20D,A01,083765,Staff,1,1,30,29
1650605477709,MATH 20D,A02,083766,Staff,7,0,30,23
1650605477709,MATH 20D,A03,083767,Staff,24,0,30,6
1650605483737,MATH 20E,A01,083771,Staff,3,0,30,27
1650605483737,MATH 20E,A02,083772,Staff,17,0,30,13
1650605483737,MATH 20E,B01,083773,Staff,0,0,30,30
1650605483737,MATH 20E,B02,083774,Staff,9,0,30,21
1650605489765,MATH 103A,A01,083777,Staff,0,15,30,30
1650605489765,MATH 103A,A02,083778,Staff,0,14,30,30
1650605489765,MATH 103A,B01,083779,Staff,0,14,30,30
1650605489765,MATH 103A,B02,083780,Staff,0,14,30,30
1650605495790,MATH 105,A01,085443,Staff,0,21,30,30
1650605501817,MATH 109,A01,083213,Anzaldo; Leesa B,0,6,30,30
1650605501817,MATH 109,A02,083214,Anzaldo; Leesa B,0,7,30,30
1650605501817,MATH 109,B01,083215,Anzaldo; Leesa B,0,6,30,30
1650605501817,MATH 109,B02,083216,Anzaldo; Leesa B,0,5,30,30
1650605507850,MATH 142A,A01,083219,Chow; Bennett,0,16,30,30
1650605507850,MATH 142A,A02,083220,Chow; Bennett,0,15,30,30
1650605507850,MATH 142A,B01,083221,Chow; Bennett,0,14,30,30
1650605507850,MATH 142A,B02,083222,Chow; Bennett,0,13,30,30
1650605513881,MATH 193A,A01,083224,Staff,0,5,30,30
1650605513881,MATH 193A,A02,083225,Staff,0,6,30,30
1650605513881,MATH 193A,A03,083781,Staff,0,6,30,30
1650605513881,MATH 193A,A04,083782,Staff,0,7,30,30
1650605519907,MATH 197,001,091859,McAuley; Julian John,9998,0,9999,1
1650605525970,COGS 9,A01,083615,Staff,0,14,60,60
1650605532004,COGS 11,A01,083617,Boyle; Mary E. T.,18,0,40,22
1650605538030,COGS 13,A01,083071,Staff,0,37,40,40
1650605544053,COGS 14A,A01,092681,Staff,0,29,100,100
1650605550080,COGS 14B,A01,083073,Cheng; Tzu-Han,0,13,50,50
1650605556112,COGS 17,A01,092677,Staff,16,0,75,59
1650605562137,COGS 100,A01,083619,Staff,0,25,60,60
1650605568169,COGS 101A,A01,083621,Davis; Joshua Daniel,0,26,60,60
1650605574192,COGS 101B,A01,091572,Staff,0,4,60,60
1650605580224,COGS 101C,A01,083625,Delgado; Tania,15,0,30,15
1650605586261,COGS 107A,A01,083627,Boyle; Mary E. T.,0,15,60,60
1650605592287,COGS 118A,A01,083075,Staff,0,4,60,60
1650605598316,CSE 3,A50,083646,Miranda; Gregory Joseph,19,0,38,19
1650605598316,CSE 3,A51,083647,Miranda; Gregory Joseph,36,0,37,1
1650605604340,CSE 8A,A50,083650,Miranda; Gregory Joseph,0,30,40,40
1650605610368,CSE 11,A01,083080,Cao; Yingjun,0,95,40,40
1650605616395,CSE 12,A01,083652,Staff,0,20,100,100
1650605622419,CSE 15L,A01,083654,Staff,0,2,50,50
1650605622419,CSE 15L,A02,083655,Staff,0,1,50,50
1650605628442,CSE 20,A01,083657,Staff,51,0,80,29
1650605634573,CSE 30,A01,083084,Eldon; John,0,78,40,40
1650605640598,CSE 100,A01,083659,Cao; Yingjun,0,68,50,50
1650605646621,CSE 134B,A01,083661,Powell; Thomas Allan,0,35,65,65
1650605652646,CSE 140,A01,083663,Staff,0,8,75,75
1650605658671,CSE 140L,A01,083088,Eldon; John,0,14,75,75
1650605664715,CSE 175,A01,083665,Kumar; Rakesh,7,0,25,18
1650605670739,CSE 190,A00,092507,Dubnov; Shlomo,11,0,20,9
1650605676764,ECE 45,A01,083139,Staff,0,1,60,60
1650605682790,ECE 65,A50,083695,Staff,0,5,30,30
1650605688813,ECE 109,A01,091882,Touri; Behrouz,33,0,70,37
1650605694845,ECE 180,A00,083140,Abi Samra; Nicholas Camill,21,0,30,9
1650605694845,ECE 180,B00,083141,Abi Samra; Nicholas Camill,0,0,30,30
1650605700873,MATH 10A,A01,083735,Patchell; Gregory David,4,0,30,26
1650605700873,MATH 10A,A02,083736,Patchell; Gregory David,27,0,30,3
1650605700873,MATH 10A,A03,083737,Patchell; Gregory David,24,0,30,6
1650605706909,MATH 10B,A01,083207,Staff,0,8,30,30
1650605706909,MATH 10B,A02,083208,Staff,0,8,30,30
1650605706909,MATH 10B,B01,083739,Staff,11,0,30,19
1650605706909,MATH 10B,B02,083740,Staff,28,0,30,2
1650605712948,MATH 18,A01,083743,Staff,0,0,30,30
1650605712948,MATH 18,A02,083744,Staff,23,0,30,7
1650605712948,MATH 18,A03,083745,Staff,21,0,30,9
1650605712948,MATH 18,A04,083746,Staff,26,0,30,4
1650605712948,MATH 18,B01,083748,Staff,0,15,30,30
1650605712948,MATH 18,B02,083749,Staff,0,10,30,30
1650605712948,MATH 18,B03,083750,Staff,0,12,30,30
1650605712948,MATH 18,B04,083751,Staff,0,12,30,30
1650605718977,MATH 20A,A01,083754,Staff,19,0,40,21
1650605725002,MATH 20B,A01,083756,Staff,0,11,30,30
1650605725002,MATH 20B,A02,083757,Staff,0,12,30,30
1650605731034,MATH 20C,A01,083760,Staff,0,16,30,30
1650605731034,MATH 20C,A02,083761,Staff,1,12,30,29
1650605731034,MATH 20C,B01,083762,Staff,11,0,30,19
1650605731034,MATH 20C,B02,083763,Staff,28,0,30,2
1650605737068,MATH 20D,A01,083765,Staff,1,1,30,29
1650605737068,MATH 20D,A02,083766,Staff,7,0,30,23
1650605737068,MATH 20D,A03,083767,Staff,24,0,30,6
1650605743093,MATH 20E,A01,083771,Staff,3,0,30,27
1650605743093,MATH 20E,A02,083772,Staff,17,0,30,13
1650605743093,MATH 20E,B01,083773,Staff,0,0,30,30
1650605743093,MATH 20E,B02,083774,Staff,9,0,30,21
1650605749119,MATH 103A,A01,083777,Staff,0,15,30,30
1650605749119,MATH 103A,A02,083778,Staff,0,14,30,30
1650605749119,MATH 103A,B01,083779,Staff,0,14,30,30
1650605749119,MATH 103A,B02,083780,Staff,0,14,30,30
1650605755143,MATH 105,A01,085443,Staff,0,21,30,30
1650605761171,MATH 109,A01,083213,Anzaldo; Leesa B,0,6,30,30
1650605761171,MATH 109,A02,083214,Anzaldo; Leesa B,0,7,30,30
1650605761171,MATH 109,B01,083215,Anzaldo; Leesa B,0,6,30,30
1650605761171,MATH 109,B02,083216,Anzaldo; Leesa B,0,5,30,30
1650605767195,MATH 142A,A01,083219,Chow; Bennett,0,16,30,30
1650605767195,MATH 142A,A02,083220,Chow; Bennett,0,15,30,30
1650605767195,MATH 142A,B01,083221,Chow; Bennett,0,14,30,30
1650605767195,MATH 142A,B02,083222,Chow; Bennett,0,13,30,30
1650605773218,MATH 193A,A01,083224,Staff,0,5,30,30
1650605773218,MATH 193A,A02,083225,Staff,0,6,30,30
1650605773218,MATH 193A,A03,083781,Staff,0,6,30,30
1650605773218,MATH 193A,A04,083782,Staff,0,7,30,30
1650605779240,MATH 197,001,091859,McAuley; Julian John,9998,0,9999,1
1650605785295,COGS 9,A01,083615,Staff,0,14,60,60
1650605791319,COGS 11,A01,083617,Boyle; Mary E. T.,18,0,40,22
1650605797345,COGS 13,A01,083071,Staff,0,37,40,40
1650605803369,COGS 14A,A01,092681,Staff,0,29,100,100
1650605809396,COGS 14B,A01,083073,Cheng; Tzu-Han,0,13,50,50
1650605815422,COGS 17,A01,092677,Staff,16,0,75,59
1650605821448,COGS 100,A01,083619,Staff,0,25,60,60
1650605827477,COGS 101A,A01,083621,Davis; Joshua Daniel,0,26,60,60
1650605833500,COGS 101B,A01,091572,Staff,0,4,60,60
1650605839527,COGS 101C,A01,083625,Delgado; Tania,15,0,30,15
1650605845550,COGS 107A,A01,083627,Boyle; Mary E. T.,0,15,60,60
1650605851578,COGS 118A,A01,083075,Staff,0,4,60,60
1650605857621,CSE 3,A50,083646,Miranda; Gregory Joseph,19,0,38,19
1650605857621,CSE 3,A51,083647,Miranda; Gregory Joseph,36,0,37,1
1650605863649,CSE 8A,A50,083650,Miranda; Gregory Joseph,0,30,40,40
1650605869679,CSE 11,A01,083080,Cao; Yingjun,0,95,40,40
1650605875707,CSE 12,A01,083652,Staff,0,20,100,100
1650605881731,CSE 15L,A01,083654,Staff,0,2,50,50
1650605881731,CSE 15L,A02,083655,Staff,0,1,50,50
1650605887757,CSE 20,A01,083657,Staff,51,0,80,29
1650605893780,CSE 30,A01,083084,Eldon; John,0,78,40,40
1650605899802,CSE 100,A01,083659,Cao; Yingjun,0,68,50,50
1650605905827,CSE 134B,A01,083661,Powell; Thomas Allan,0,35,65,65
1650605911851,CSE 140,A01,083663,Staff,0,8,75,75
1650605917878,CSE 140L,A01,083088,Eldon; John,0,14,75,75
1650605923910,CSE 175,A01,083665,Kumar; Rakesh,7,0,25,18
1650605929932,CSE 190,A00,092507,Dubnov; Shlomo,11,0,20,9
1650605935958,ECE 45,A01,083139,Staff,0,1,60,60
1650605941990,ECE 65,A50,083695,Staff,0,5,30,30
1650605948026,ECE 109,A01,091882,Touri; Behrouz,33,0,70,37
1650605954049,ECE 180,A00,083140,Abi Samra; Nicholas Camill,21,0,30,9
1650605954049,ECE 180,B00,083141,Abi Samra; Nicholas Camill,0,0,30,30
1650605960077,MATH 10A,A01,083735,Patchell; Gregory David,4,0,30,26
1650605960077,MATH 10A,A02,083736,Patchell; Gregory David,27,0,30,3
1650605960077,MATH 10A,A03,083737,Patchell; Gregory David,24,0,30,6
1650605966102,MATH 10B,A01,083207,Staff,0,8,30,30
1650605966102,MATH 10B,A02,083208,Staff,0,8,30,30
1650605966102,MATH 10B,B01,083739,Staff,11,0,30,19
1650605966102,MATH 10B,B02,083740,Staff,28,0,30,2
1650605972128,MATH 18,A01,083743,Staff,0,0,30,30
1650605972128,MATH 18,A02,083744,Staff,23,0,30,7
1650605972128,MATH 18,A03,083745,Staff,21,0,30,9
1650605972128,MATH 18,A04,083746,Staff,26,0,30,4
1650605972128,MATH 18,B01,083748,Staff,0,15,30,30
1650605972128,MATH 18,B02,083749,Staff,0,10,30,30
1650605972128,MATH 18,B03,083750,Staff,0,12,30,30
1650605972128,MATH 18,B04,083751,Staff,0,12,30,30
1650605978153,MATH 20A,A01,083754,Staff,19,0,40,21
1650605984177,MATH 20B,A01,083756,Staff,0,11,30,30
1650605984177,MATH 20B,A02,083757,Staff,0,12,30,30
1650605990202,MATH 20C,A01,083760,Staff,0,16,30,30
1650605990202,MATH 20C,A02,083761,Staff,1,12,30,29
1650605990202,MATH 20C,B01,083762,Staff,11,0,30,19
1650605990202,MATH 20C,B02,083763,Staff,28,0,30,2
1650605996229,MATH 20D,A01,083765,Staff,1,1,30,29
1650605996229,MATH 20D,A02,083766,Staff,7,0,30,23
1650605996229,MATH 20D,A03,083767,Staff,24,0,30,6
1650606002255,MATH 20E,A01,083771,Staff,3,0,30,27
1650606002255,MATH 20E,A02,083772,Staff,17,0,30,13
1650606002255,MATH 20E,B01,083773,Staff,0,0,30,30
1650606002255,MATH 20E,B02,083774,Staff,9,0,30,21
1650606008290,MATH 103A,A01,083777,Staff,0,15,30,30
1650606008290,MATH 103A,A02,083778,Staff,0,14,30,30
1650606008290,MATH 103A,B01,083779,Staff,0,14,30,30
1650606008290,MATH 103A,B02,083780,Staff,0,14,30,30
1650606014314,MATH 105,A01,085443,Staff,0,21,30,30
1650606020341,MATH 109,A01,083213,Anzaldo; Leesa B,0,6,30,30
1650606020341,MATH 109,A02,083214,Anzaldo; Leesa B,0,7,30,30
1650606020341,MATH 109,B01,083215,Anzaldo; Leesa B,0,6,30,30
1650606020341,MATH 109,B02,083216,Anzaldo; Leesa B,0,5,30,30
1650606026366,MATH 142A,A01,083219,Chow; Bennett,0,16,30,30
1650606026366,MATH 142A,A02,083220,Chow; Bennett,0,15,30,30
1650606026366,MATH 142A,B01,083221,Chow; Bennett,0,14,30,30
1650606026366,MATH 142A,B02,083222,Chow; Bennett,0,13,30,30
1650606032395,MATH 193A,A01,083224,Staff,0,5,30,30
1650606032395,MATH 193A,A02,083225,Staff,0,6,30,30
1650606032395,MATH 193A,A03,083781,Staff,0,6,30,30
1650606032395,MATH 193A,A04,083782,Staff,0,7,30,30
1650606038421,MATH 197,001,091859,McAuley; Julian John,9998,0,9999,1
1650606044476,COGS 9,A01,083615,Staff,0,14,60,60
1650606050506,COGS 11,A01,083617,Boyle; Mary E. T.,18,0,40,22
1650606056533,COGS 13,A01,083071,Staff,0,37,40,40
1650606062557,COGS 14A,A01,092681,Staff,0,29,100,100
1650606068583,COGS 14B,A01,083073,Cheng; Tzu-Han,0,13,50,50
1650606074607,COGS 17,A01,092677,Staff,16,0,75,59
1650606080632,COGS 100,A01,083619,Staff,0,25,60,60
1650606086656,COGS 101A,A01,083621,Davis; Joshua Daniel,0,26,60,60
1650606092680,COGS 101B,A01,091572,Staff,0,4,60,60
1650606098716,COGS 101C,A01,083625,Delgado; Tania,15,0,30,15
1650606104743,COGS 107A,A01,083627,Boyle; Mary E. T.,0,15,60,60
1650606110765,COGS 118A,A01,083075,Staff,0,4,60,60
1650606116799,CSE 3,A50,083646,Miranda; Gregory Joseph,19,0,38,19
1650606116799,CSE 3,A51,083647,Miranda; Gregory Joseph,36,0,37,1
1650606122827,CSE 8A,A50,083650,Miranda; Gregory Joseph,0,30,40,40
1650606128853,CSE 11,A01,083080,Cao; Yingjun,0,95,40,40
1650606134876,CSE 12,A01,083652,Staff,0,20,100,100
1650606140899,CSE 15L,A01,083654,Staff,0,2,50,50
1650606140899,CSE 15L,A02,083655,Staff,0,1,50,50
1650606146923,CSE 20,A01,083657,Staff,51,0,80,29
1650606152948,CSE 30,A01,083084,Eldon; John,0,78,40,40
1650606158973,CSE 100,A01,083659,Cao; Yingjun,0,68,50,50
1650606164997,CSE 134B,A01,083661,Powell; Thomas Allan,0,35,65,65
1650606171021,CSE 140,A01,083663,Staff,0,8,75,75
1650606177044,CSE 140L,A01,083088,Eldon; John,0,14,75,75
1650606183070,CSE 175,A01,083665,Kumar; Rakesh,7,0,25,18
1650606189098,CSE 190,A00,092507,Dubnov; Shlomo,11,0,20,9
1650606195127,ECE 45,A01,083139,Staff,0,1,60,60
1650606201150,ECE 65,A50,083695,Staff,0,5,30,30
1650606207176,ECE 109,A01,091882,Touri; Behrouz,33,0,70,37
1650606213205,ECE 180,A00,083140,Abi Samra; Nicholas Camill,21,0,30,9
1650606213205,ECE 180,B00,083141,Abi Samra; Nicholas Camill,0,0,30,30
1650606219228,MATH 10A,A01,083735,Patchell; Gregory David,4,0,30,26
1650606219228,MATH 10A,A02,083736,Patchell; Gregory David,27,0,30,3
1650606219228,MATH 10A,A03,083737,Patchell; Gregory David,24,0,30,6
1650606225253,MATH 10B,A01,083207,Staff,0,8,30,30
1650606225253,MATH 10B,A02,083208,Staff,0,8,30,30
1650606225253,MATH 10B,B01,083739,Staff,11,0,30,19
1650606225253,MATH 10B,B02,083740,Staff,28,0,30,2
1650606231370,MATH 18,A01,083743,Staff,0,0,30,30
1650606231370,MATH 18,A02,083744,Staff,23,0,30,7
1650606231370,MATH 18,A03,083745,Staff,21,0,30,9
1650606231370,MATH 18,A04,083746,Staff,26,0,30,4
1650606231370,MATH 18,B01,083748,Staff,0,15,30,30
1650606231370,MATH 18,B02,083749,Staff,0,10,30,30
1650606231370,MATH 18,B03,083750,Staff,0,12,30,30
1650606231370,MATH 18,B04,083751,Staff,0,12,30,30
1650606237393,MATH 20A,A01,083754,Staff,19,0,40,21
1650606243417,MATH 20B,A01,083756,Staff,0,11,30,30
1650606243417,MATH 20B,A02,083757,Staff,0,12,30,30
1650606249440,MATH 20C,A01,083760,Staff,0,16,30,30
1650606249440,MATH 20C,A02,083761,Staff,1,12,30,29
1650606249440,MATH 20C,B01,083762,Staff,11,0,30,19
1650606249440,MATH 20C,B02,083763,Staff,28,0,30,2
1650606255467,MATH 20D,A01,083765,Staff,1,1,30,29
1650606255467,MATH 20D,A02,083766,Staff,7,0,30,23
1650606255467,MATH 20D,A03,083767,Staff,24,0,30,6
1650606261491,MATH 20E,A01,083771,Staff,3,0,30,27
1650606261491,MATH 20E,A02,083772,Staff,17,0,30,13
1650606261491,MATH 20E,B01,083773,Staff,0,0,30,30
1650606261491,MATH 20E,B02,083774,Staff,9,0,30,21
1650606267515,MATH 103A,A01,083777,Staff,0,15,30,30
1650606267515,MATH 103A,A02,083778,Staff,0,15,30,30
1650606267515,MATH 103A,B01,083779,Staff,0,14,30,30
1650606267515,MATH 103A,B02,083780,Staff,0,14,30,30
1650606273539,MATH 105,A01,085443,Staff,0,21,30,30
1650606279562,MATH 109,A01,083213,Anzaldo; Leesa B,0,6,30,30
1650606279562,MATH 109,A02,083214,Anzaldo; Leesa B,0,7,30,30
1650606279562,MATH 109,B01,083215,Anzaldo; Leesa B,0,6,30,30
1650606279562,MATH 109,B02,083216,Anzaldo; Leesa B,0,5,30,30
1650606285585,MATH 142A,A01,083219,Chow; Bennett,0,16,30,30
1650606285585,MATH 142A,A02,083220,Chow; Bennett,0,15,30,30
1650606285585,MATH 142A,B01,083221,Chow; Bennett,0,14,30,30
1650606285585,MATH 142A,B02,083222,Chow; Bennett,0,13,30,30
1650606291608,MATH 193A,A01,083224,Staff,0,5,30,30
1650606291608,MATH 193A,A02,083225,Staff,0,6,30,30
1650606291608,MATH 193A,A03,083781,Staff,0,6,30,30
1650606291608,MATH 193A,A04,083782,Staff,0,7,30,30
1650606297632,MATH 197,001,091859,McAuley; Julian John,9998,0,9999,1
1650606303690,COGS 9,A01,083615,Staff,0,14,60,60
1650606309712,COGS 11,A01,083617,Boyle; Mary E. T.,18,0,40,22
1650606315736,COGS 13,A01,083071,Staff,0,38,40,40
1650606321764,COGS 14A,A01,092681,Staff,0,29,100,100
1650606327791,COGS 14B,A01,083073,Cheng; Tzu-Han,0,13,50,50
1650606333818,COGS 17,A01,092677,Staff,17,0,75,58
1650606339848,COGS 100,A01,083619,Staff,0,26,60,60
1650606345875,COGS 101A,A01,083621,Davis; Joshua Daniel,0,26,60,60
1650606351898,COGS 101B,A01,091572,Staff,0,4,60,60
1650606357935,COGS 101C,A01,083625,Delgado; Tania,15,0,30,15
1650606363960,COGS 107A,A01,083627,Boyle; Mary E. T.,0,15,60,60
1650606369984,COGS 118A,A01,083075,Staff,0,4,60,60
1650606376013,CSE 3,A50,083646,Miranda; Gregory Joseph,19,0,38,19
1650606376013,CSE 3,A51,083647,Miranda; Gregory Joseph,36,0,37,1
1650606382046,CSE 8A,A50,083650,Miranda; Gregory Joseph,0,30,40,40
1650606388073,CSE 11,A01,083080,Cao; Yingjun,0,95,40,40
1650606394098,CSE 12,A01,083652,Staff,0,20,100,100
1650606400120,CSE 15L,A01,083654,Staff,0,2,50,50
1650606400120,CSE 15L,A02,083655,Staff,0,1,50,50
1650606406158,CSE 20,A01,083657,Staff,51,0,80,29
1650606412181,CSE 30,A01,083084,Eldon; John,0,78,40,40
1650606418203,CSE 100,A01,083659,Cao; Yingjun,0,68,50,50
1650606424230,CSE 134B,A01,083661,Powell; Thomas Allan,0,35,65,65
1650606430256,CSE 140,A01,083663,Staff,0,8,75,75
1650606436280,CSE 140L,A01,083088,Eldon; John,0,14,75,75
1650606442304,CSE 175,A01,083665,Kumar; Rakesh,7,0,25,18
1650606448329,CSE 190,A00,092507,Dubnov; Shlomo,11,0,20,9
1650606454353,ECE 45,A01,083139,Staff,0,1,60,60
1650606460381,ECE 65,A50,083695,Staff,0,5,30,30
1650606466406,ECE 109,A01,091882,Touri; Behrouz,33,0,70,37
1650606472432,ECE 180,A00,083140,Abi Samra; Nicholas Camill,21,0,30,9
1650606472432,ECE 180,B00,083141,Abi Samra; Nicholas Camill,0,0,30,30
1650606478460,MATH 10A,A01,083735,Patchell; Gregory David,4,0,30,26
1650606478460,MATH 10A,A02,083736,Patchell; Gregory David,27,0,30,3
1650606478460,MATH 10A,A03,083737,Patchell; Gregory David,24,0,30,6
1650606484489,MATH 10B,A01,083207,Staff,0,8,30,30
1650606484489,MATH 10B,A02,083208,Staff,0,8,30,30
1650606484489,MATH 10B,B01,083739,Staff,11,0,30,19
1650606484489,MATH 10B,B02,083740,Staff,28,0,30,2
1650606490513,MATH 18,A01,083743,Staff,0,0,30,30
1650606490513,MATH 18,A02,083744,Staff,23,0,30,7
1650606490513,MATH 18,A03,083745,Staff,21,0,30,9
1650606490513,MATH 18,A04,083746,Staff,26,0,30,4
1650606490513,MATH 18,B01,083748,Staff,0,15,30,30
1650606490513,MATH 18,B02,083749,Staff,0,10,30,30
1650606490513,MATH 18,B03,083750,Staff,0,12,30,30
1650606490513,MATH 18,B04,083751,Staff,0,12,30,30
1650606496537,MATH 20A,A01,083754,Staff,19,0,40,21
1650606502568,MATH 20B,A01,083756,Staff,0,11,30,30
1650606502568,MATH 20B,A02,083757,Staff,0,12,30,30
1650606508596,MATH 20C,A01,083760,Staff,0,16,30,30
1650606508596,MATH 20C,A02,083761,Staff,1,12,30,29
1650606508596,MATH 20C,B01,083762,Staff,11,0,30,19
1650606508596,MATH 20C,B02,083763,Staff,28,0,30,2
1650606514624,MATH 20D,A01,083765,Staff,1,1,30,29
1650606514624,MATH 20D,A02,083766,Staff,7,0,30,23
1650606514624,MATH 20D,A03,083767,Staff,24,0,30,6
1650606520651,MATH 20E,A01,083771,Staff,3,0,30,27
1650606520651,MATH 20E,A02,083772,Staff,17,0,30,13
1650606520651,MATH 20E,B01,083773,Staff,0,0,30,30
1650606520651,MATH 20E,B02,083774,Staff,9,0,30,21
1650606526679,MATH 103A,A01,083777,Staff,0,15,30,30
1650606526679,MATH 103A,A02,083778,Staff,0,15,30,30
1650606526679,MATH 103A,B01,083779,Staff,0,14,30,30
1650606526679,MATH 103A,B02,083780,Staff,0,14,30,30
1650606532706,MATH 105,A01,085443,Staff,0,21,30,30
1650606538766,MATH 109,A01,083213,Anzaldo; Leesa B,0,6,30,30
1650606538766,MATH 109,A02,083214,Anzaldo; Leesa B,0,7,30,30
1650606538766,MATH 109,B01,083215,Anzaldo; Leesa B,0,6,30,30
1650606538766,MATH 109,B02,083216,Anzaldo; Leesa B,0,5,30,30
1650606544794,MATH 142A,A01,083219,Chow; Bennett,0,16,30,30
1650606544794,MATH 142A,A02,083220,Chow; Bennett,0,15,30,30
1650606544794,MATH 142A,B01,083221,Chow; Bennett,0,14,30,30
1650606544794,MATH 142A,B02,083222,Chow; Bennett,0,13,30,30
1650606550823,MATH 193A,A01,083224,Staff,0,5,30,30
1650606550823,MATH 193A,A02,083225,Staff,0,6,30,30
1650606550823,MATH 193A,A03,083781,Staff,0,6,30,30
1650606550823,MATH 193A,A04,083782,Staff,0,7,30,30
1650606556850,MATH 197,001,091859,McAuley; Julian John,9998,0,9999,1
1650606562928,COGS 9,A01,083615,Staff,0,14,60,60
1650606568954,COGS 11,A01,083617,Boyle; Mary E. T.,18,0,40,22
1650606574976,COGS 13,A01,083071,Staff,0,38,40,40
1650606581008,COGS 14A,A01,092681,Staff,0,29,100,100
1650606587034,COGS 14B,A01,083073,Cheng; Tzu-Han,0,13,50,50
1650606593068,COGS 17,A01,092677,Staff,17,0,75,58
1650606599092,COGS 100,A01,083619,Staff,0,26,60,60
1650606605115,COGS 101A,A01,083621,Davis; Joshua Daniel,0,26,60,60
1650606611138,COGS 101B,A01,091572,Staff,0,4,60,60
1650606617166,COGS 101C,A01,083625,Delgado; Tania,15,0,30,15
1650606623188,COGS 107A,A01,083627,Boyle; Mary E. T.,0,15,60,60
1650606629212,COGS 118A,A01,083075,Staff,0,4,60,60
1650606635239,CSE 3,A50,083646,Miranda; Gregory Joseph,19,0,38,19
1650606635239,CSE 3,A51,083647,Miranda; Gregory Joseph,36,0,37,1
1650606641266,CSE 8A,A50,083650,Miranda; Gregory Joseph,0,30,40,40
1650606647300,CSE 11,A01,083080,Cao; Yingjun,0,95,40,40
1650606653324,CSE 12,A01,083652,Staff,0,20,100,100
1650606659350,CSE 15L,A01,083654,Staff,0,2,50,50
1650606659350,CSE 15L,A02,083655,Staff,0,1,50,50
1650606665374,CSE 20,A01,083657,Staff,51,0,80,29
1650606671400,CSE 30,A01,083084,Eldon; John,0,78,40,40
1650606677428,CSE 100,A01,083659,Cao; Yingjun,0,68,50,50
1650606683451,CSE 134B,A01,083661,Powell; Thomas Allan,0,35,65,65
1650606689477,CSE 140,A01,083663,Staff,0,8,75,75
1650606695506,CSE 140L,A01,083088,Eldon; John,0,14,75,75
1650606701530,CSE 175,A01,083665,Kumar; Rakesh,7,0,25,18
1650606707562,CSE 190,A00,092507,Dubnov; Shlomo,11,0,20,9
1650606713586,ECE 45,A01,083139,Staff,0,1,60,60
1650606719610,ECE 65,A50,083695,Staff,0,5,30,30
1650606725633,ECE 109,A01,091882,Touri; Behrouz,33,0,70,37
1650606731663,ECE 180,A00,083140,Abi Samra; Nicholas Camill,21,0,30,9
1650606731663,ECE 180,B00,083141,Abi Samra; Nicholas Camill,0,0,30,30
1650606737689,MATH 10A,A01,083735,Patchell; Gregory David,4,0,30,26
1650606737689,MATH 10A,A02,083736,Patchell; Gregory David,27,0,30,3
1650606737689,MATH 10A,A03,083737,Patchell; Gregory David,24,0,30,6
1650606743713,MATH 10B,A01,083207,Staff,0,8,30,30
1650606743713,MATH 10B,A02,083208,Staff,0,8,30,30
1650606743713,MATH 10B,B01,083739,Staff,11,0,30,19
1650606743713,MATH 10B,B02,083740,Staff,28,0,30,2
1650606749739,MATH 18,A01,083743,Staff,0,0,30,30
1650606749739,MATH 18,A02,083744,Staff,23,0,30,7
1650606749739,MATH 18,A03,083745,Staff,21,0,30,9
1650606749739,MATH 18,A04,083746,Staff,26,0,30,4
1650606749739,MATH 18,B01,083748,Staff,0,15,30,30
1650606749739,MATH 18,B02,083749,Staff,0,10,30,30
1650606749739,MATH 18,B03,083750,Staff,0,12,30,30
1650606749739,MATH 18,B04,083751,Staff,0,12,30,30
1650606755770,MATH 20A,A01,083754,Staff,19,0,40,21
1650606761793,MATH 20B,A01,083756,Staff,0,12,30,30
1650606761793,MATH 20B,A02,083757,Staff,0,12,30,30
1650606767821,MATH 20C,A01,083760,Staff,0,16,30,30
1650606767821,MATH 20C,A02,083761,Staff,1,12,30,29
1650606767821,MATH 20C,B01,083762,Staff,11,0,30,19
1650606767821,MATH 20C,B02,083763,Staff,28,0,30,2
1650606773847,MATH 20D,A01,083765,Staff,1,1,30,29
1650606773847,MATH 20D,A02,083766,Staff,7,0,30,23
1650606773847,MATH 20D,A03,083767,Staff,24,0,30,6
1650606779889,MATH 20E,A01,083771,Staff,3,0,30,27
1650606779889,MATH 20E,A02,083772,Staff,17,0,30,13
1650606779889,MATH 20E,B01,083773,Staff,0,0,30,30
1650606779889,MATH 20E,B02,083774,Staff,9,0,30,21
1650606785914,MATH 103A,A01,083777,Staff,0,15,30,30
1650606785914,MATH 103A,A02,083778,Staff,0,15,30,30
1650606785914,MATH 103A,B01,083779,Staff,0,14,30,30
1650606785914,MATH 103A,B02,083780,Staff,0,14,30,30
1650606791945,MATH 105,A01,085443,Staff,0,21,30,30
1650606797972,MATH 109,A01,083213,Anzaldo; Leesa B,0,6,30,30
1650606797972,MATH 109,A02,083214,Anzaldo; Leesa B,0,7,30,30
1650606797972,MATH 109,B01,083215,Anzaldo; Leesa B,0,6,30,30
1650606797972,MATH 109,B02,083216,Anzaldo; Leesa B,0,5,30,30
1650606804007,MATH 142A,A01,083219,Chow; Bennett,0,16,30,30
1650606804007,MATH 142A,A02,083220,Chow; Bennett,0,15,30,30
1650606804007,MATH 142A,B01,083221,Chow; Bennett,0,14,30,30
1650606804007,MATH 142A,B02,083222,Chow; Bennett,0,13,30,30
1650606810033,MATH 193A,A01,083224,Staff,0,5,30,30
1650606810033,MATH 193A,A02,083225,Staff,0,6,30,30
1650606810033,MATH 193A,A03,083781,Staff,0,6,30,30
1650606810033,MATH 193A,A04,083782,Staff,0,7,30,30
1650606816057,MATH 197,001,091859,McAuley; Julian John,9998,0,9999,1
1650606822211,COGS 9,A01,083615,Staff,0,14,60,60
1650606828236,COGS 11,A01,083617,Boyle; Mary E. T.,18,0,40,22
1650606834263,COGS 13,A01,083071,Staff,0,38,40,40
1650606840286,COGS 14A,A01,092681,Staff,0,29,100,100
1650606846313,COGS 14B,A01,083073,Cheng; Tzu-Han,0,13,50,50
1650606852337,COGS 17,A01,092677,Staff,17,0,75,58
1650606858363,COGS 100,A01,083619,Staff,0,26,60,60
1650606864387,COGS 101A,A01,083621,Davis; Joshua Daniel,0,26,60,60
1650606870411,COGS 101B,A01,091572,Staff,0,4,60,60
1650606876432,COGS 101C,A01,083625,Delgado; Tania,15,0,30,15
1650606882455,COGS 107A,A01,083627,Boyle; Mary E. T.,0,15,60,60
1650606888479,COGS 118A,A01,083075,Staff,0,4,60,60
1650606894509,CSE 3,A50,083646,Miranda; Gregory Joseph,19,0,38,19
1650606894509,CSE 3,A51,083647,Miranda; Gregory Joseph,36,0,37,1
1650606900531,CSE 8A,A50,083650,Miranda; Gregory Joseph,0,30,40,40
1650606906554,CSE 11,A01,083080,Cao; Yingjun,0,95,40,40
1650606912577,CSE 12,A01,083652,Staff,0,20,100,100
1650606918603,CSE 15L,A01,083654,Staff,0,2,50,50
1650606918603,CSE 15L,A02,083655,Staff,0,1,50,50
1650606924625,CSE 20,A01,083657,Staff,51,0,80,29
1650606930649,CSE 30,A01,083084,Eldon; John,0,78,40,40
1650606936674,CSE 100,A01,083659,Cao; Yingjun,0,68,50,50
1650606942712,CSE 134B,A01,083661,Powell; Thomas Allan,0,35,65,65
1650606948734,CSE 140,A01,083663,Staff,0,8,75,75
1650606954757,CSE 140L,A01,083088,Eldon; John,0,14,75,75
1650606960782,CSE 175,A01,083665,Kumar; Rakesh,7,0,25,18
1650606966807,CSE 190,A00,092507,Dubnov; Shlomo,11,0,20,9
1650606972837,ECE 45,A01,083139,Staff,0,1,60,60
1650606978861,ECE 65,A50,083695,Staff,0,5,30,30
1650606984884,ECE 109,A01,091882,Touri; Behrouz,33,0,70,37
1650606990911,ECE 180,A00,083140,Abi Samra; Nicholas Camill,21,0,30,9
1650606990911,ECE 180,B00,083141,Abi Samra; Nicholas Camill,0,0,30,30
1650606996941,MATH 10A,A01,083735,Patchell; Gregory David,4,0,30,26
1650606996941,MATH 10A,A02,083736,Patchell; Gregory David,27,0,30,3
1650606996941,MATH 10A,A03,083737,Patchell; Gregory David,24,0,30,6
1650607002964,MATH 10B,A01,083207,Staff,0,8,30,30
1650607002964,MATH 10B,A02,083208,Staff,0,8,30,30
1650607002964,MATH 10B,B01,083739,Staff,11,0,30,19
1650607002964,MATH 10B,B02,083740,Staff,28,0,30,2
1650607008990,MATH 18,A01,083743,Staff,0,0,30,30
1650607008990,MATH 18,A02,083744,Staff,23,0,30,7
1650607008990,MATH 18,A03,083745,Staff,21,0,30,9
1650607008990,MATH 18,A04,083746,Staff,26,0,30,4
1650607008990,MATH 18,B01,083748,Staff,0,15,30,30
1650607008990,MATH 18,B02,083749,Staff,0,10,30,30
1650607008990,MATH 18,B03,083750,Staff,0,12,30,30
1650607008990,MATH 18,B04,083751,Staff,0,12,30,30
1650607015019,MATH 20A,A01,083754,Staff,19,0,40,21
1650607021042,MATH 20B,A01,083756,Staff,0,12,30,30
1650607021042,MATH 20B,A02,083757,Staff,0,12,30,30
1650607027070,MATH 20C,A01,083760,Staff,0,16,30,30
1650607027070,MATH 20C,A02,083761,Staff,1,12,30,29
1650607027070,MATH 20C,B01,083762,Staff,11,0,30,19
1650607027070,MATH 20C,B02,083763,Staff,28,0,30,2
1650607033098,MATH 20D,A01,083765,Staff,1,1,30,29
1650607033098,MATH 20D,A02,083766,Staff,7,0,30,23
1650607033098,MATH 20D,A03,083767,Staff,24,0,30,6
1650607039122,MATH 20E,A01,083771,Staff,3,0,30,27
1650607039122,MATH 20E,A02,083772,Staff,17,0,30,13
1650607039122,MATH 20E,B01,083773,Staff,0,0,30,30
1650607039122,MATH 20E,B02,083774,Staff,9,0,30,21
1650607045159,MATH 103A,A01,083777,Staff,0,15,30,30
1650607045159,MATH 103A,A02,083778,Staff,0,15,30,30
1650607045159,MATH 103A,B01,083779,Staff,0,14,30,30
1650607045159,MATH 103A,B02,083780,Staff,0,14,30,30
1650607051184,MATH 105,A01,085443,Staff,0,21,30,30
1650607057210,MATH 109,A01,083213,Anzaldo; Leesa B,0,6,30,30
1650607057210,MATH 109,A02,083214,Anzaldo; Leesa B,0,7,30,30
1650607057210,MATH 109,B01,083215,Anzaldo; Leesa B,0,6,30,30
1650607057210,MATH 109,B02,083216,Anzaldo; Leesa B,0,5,30,30
1650607063234,MATH 142A,A01,083219,Chow; Bennett,0,16,30,30
1650607063234,MATH 142A,A02,083220,Chow; Bennett,0,15,30,30
1650607063234,MATH 142A,B01,083221,Chow; Bennett,0,14,30,30
1650607063234,MATH 142A,B02,083222,Chow; Bennett,0,13,30,30
1650607069263,MATH 193A,A01,083224,Staff,0,5,30,30
1650607069263,MATH 193A,A02,083225,Staff,0,6,30,30
1650607069263,MATH 193A,A03,083781,Staff,0,6,30,30
1650607069263,MATH 193A,A04,083782,Staff,0,7,30,30
1650607075288,MATH 197,001,091859,McAuley; Julian John,9998,0,9999,1
1650607081353,COGS 9,A01,083615,Staff,0,14,60,60
1650607087379,COGS 11,A01,083617,Boyle; Mary E. T.,18,0,40,22
1650607093402,COGS 13,A01,083071,Staff,0,38,40,40
1650607099429,COGS 14A,A01,092681,Staff,0,29,100,100
1650607105457,COGS 14B,A01,083073,Cheng; Tzu-Han,0,13,50,50
1650607111485,COGS 17,A01,092677,Staff,17,0,75,58
1650607117517,COGS 100,A01,083619,Staff,0,26,60,60
1650607123541,COGS 101A,A01,083621,Davis; Joshua Daniel,0,26,60,60
1650607129564,COGS 101B,A01,091572,Staff,0,4,60,60
1650607135588,COGS 101C,A01,083625,Delgado; Tania,15,0,30,15
1650607141616,COGS 107A,A01,083627,Boyle; Mary E. T.,0,15,60,60
1650607147644,COGS 118A,A01,083075,Staff,0,4,60,60
1650607153675,CSE 3,A50,083646,Miranda; Gregory Joseph,19,0,38,19
1650607153675,CSE 3,A51,083647,Miranda; Gregory Joseph,36,0,37,1
1650607159703,CSE 8A,A50,083650,Miranda; Gregory Joseph,0,30,40,40
1650607165733,CSE 11,A01,083080,Cao; Yingjun,0,95,40,40
1650607171757,CSE 12,A01,083652,Staff,0,20,100,100
1650607177779,CSE 15L,A01,083654,Staff,0,2,50,50
1650607177779,CSE 15L,A02,083655,Staff,0,1,50,50
1650607183808,CSE 20,A01,083657,Staff,51,0,80,29
1650607189834,CSE 30,A01,083084,Eldon; John,0,78,40,40
1650607195860,CSE 100,A01,083659,Cao; Yingjun,0,68,50,50
1650607201883,CSE 134B,A01,083661,Powell; Thomas Allan,0,35,65,65
1650607207907,CSE 140,A01,083663,Staff,0,8,75,75
1650607213929,CSE 140L,A01,083088,Eldon; John,0,14,75,75
1650607219953,CSE 175,A01,083665,Kumar; Rakesh,7,0,25,18
1650607225977,CSE 190,A00,092507,Dubnov; Shlomo,11,0,20,9
1650607231999,ECE 45,A01,083139,Staff,0,1,60,60
1650607238028,ECE 65,A50,083695,Staff,0,5,30,30
1650607244055,ECE 109,A01,091882,Touri; Behrouz,33,0,70,37
1650607250079,ECE 180,A00,083140,Abi Samra; Nicholas Camill,21,0,30,9
1650607250079,ECE 180,B00,083141,Abi Samra; Nicholas Camill,0,0,30,30
1650607256104,MATH 10A,A01,083735,Patchell; Gregory David,4,0,30,26
1650607256104,MATH 10A,A02,083736,Patchell; Gregory David,27,0,30,3
1650607256104,MATH 10A,A03,083737,Patchell; Gregory David,24,0,30,6
1650607262133,MATH 10B,A01,083207,Staff,0,8,30,30
1650607262133,MATH 10B,A02,083208,Staff,0,8,30,30
1650607262133,MATH 10B,B01,083739,Staff,11,0,30,19
1650607262133,MATH 10B,B02,083740,Staff,28,0,30,2
1650607268159,MATH 18,A01,083743,Staff,0,0,30,30
1650607268159,MATH 18,A02,083744,Staff,23,0,30,7
1650607268159,MATH 18,A03,083745,Staff,21,0,30,9
1650607268159,MATH 18,A04,083746,Staff,26,0,30,4
1650607268159,MATH 18,B01,083748,Staff,0,15,30,30
1650607268159,MATH 18,B02,083749,Staff,0,10,30,30
1650607268159,MATH 18,B03,083750,Staff,0,12,30,30
1650607268159,MATH 18,B04,083751,Staff,0,12,30,30
1650607274185,MATH 20A,A01,083754,Staff,19,0,40,21
1650607280214,MATH 20B,A01,083756,Staff,0,12,30,30
1650607280214,MATH 20B,A02,083757,Staff,0,12,30,30
1650607286239,MATH 20C,A01,083760,Staff,0,15,30,30
1650607286239,MATH 20C,A02,083761,Staff,1,13,30,29
1650607286239,MATH 20C,B01,083762,Staff,11,0,30,19
1650607286239,MATH 20C,B02,083763,Staff,28,0,30,2
1650607292268,MATH 20D,A01,083765,Staff,1,1,30,29
1650607292268,MATH 20D,A02,083766,Staff,7,0,30,23
1650607292268,MATH 20D,A03,083767,Staff,24,0,30,6
1650607298304,MATH 20E,A01,083771,Staff,3,0,30,27
1650607298304,MATH 20E,A02,083772,Staff,17,0,30,13
1650607298304,MATH 20E,B01,083773,Staff,0,0,30,30
1650607298304,MATH 20E,B02,083774,Staff,9,0,30,21
1650607304333,MATH 103A,A01,083777,Staff,0,15,30,30
1650607304333,MATH 103A,A02,083778,Staff,0,15,30,30
1650607304333,MATH 103A,B01,083779,Staff,0,14,30,30
1650607304333,MATH 103A,B02,083780,Staff,0,14,30,30
1650607310357,MATH 105,A01,085443,Staff,0,21,30,30
1650607316382,MATH 109,A01,083213,Anzaldo; Leesa B,0,6,30,30
1650607316382,MATH 109,A02,083214,Anzaldo; Leesa B,0,7,30,30
1650607316382,MATH 109,B01,083215,Anzaldo; Leesa B,0,6,30,30
1650607316382,MATH 109,B02,083216,Anzaldo; Leesa B,0,5,30,30
1650607322413,MATH 142A,A01,083219,Chow; Bennett,0,16,30,30
1650607322413,MATH 142A,A02,083220,Chow; Bennett,0,15,30,30
1650607322413,MATH 142A,B01,083221,Chow; Bennett,0,14,30,30
1650607322413,MATH 142A,B02,083222,Chow; Bennett,0,13,30,30
1650607328437,MATH 193A,A01,083224,Staff,0,5,30,30
1650607328437,MATH 193A,A02,083225,Staff,0,6,30,30
1650607328437,MATH 193A,A03,083781,Staff,0,6,30,30
1650607328437,MATH 193A,A04,083782,Staff,0,7,30,30
1650607334467,MATH 197,001,091859,McAuley; Julian John,9998,0,9999,1
1650607340531,COGS 9,A01,083615,Staff,0,14,60,60
1650607346556,COGS 11,A01,083617,Boyle; Mary E. T.,18,0,40,22
1650607352584,COGS 13,A01,083071,Staff,0,38,40,40
1650607358612,COGS 14A,A01,092681,Staff,0,29,100,100
1650607364640,COGS 14B,A01,083073,Cheng; Tzu-Han,0,13,50,50
1650607370665,COGS 17,A01,092677,Staff,17,0,75,58
1650607376690,COGS 100,A01,083619,Staff,0,26,60,60
1650607382718,COGS 101A,A01,083621,Davis; Joshua Daniel,0,26,60,60
1650607388746,COGS 101B,A01,091572,Staff,0,4,60,60
1650607394781,COGS 101C,A01,083625,Delgado; Tania,15,0,30,15
1650607400807,COGS 107A,A01,083627,Boyle; Mary E. T.,0,15,60,60
1650607406833,COGS 118A,A01,083075,Staff,0,4,60,60
1650607412859,CSE 3,A50,083646,Miranda; Gregory Joseph,19,0,38,19
1650607412859,CSE 3,A51,083647,Miranda; Gregory Joseph,36,0,37,1
1650607418993,CSE 8A,A50,083650,Miranda; Gregory Joseph,0,30,40,40
1650607425018,CSE 11,A01,083080,Cao; Yingjun,0,95,40,40
1650607431041,CSE 12,A01,083652,Staff,0,20,100,100
1650607437089,CSE 15L,A01,083654,Staff,0,2,50,50
1650607437089,CSE 15L,A02,083655,Staff,0,1,50,50
1650607443113,CSE 20,A01,083657,Staff,51,0,80,29
1650607449140,CSE 30,A01,083084,Eldon; John,0,78,40,40
1650607455164,CSE 100,A01,083659,Cao; Yingjun,0,68,50,50
1650607461191,CSE 134B,A01,083661,Powell; Thomas Allan,0,35,65,65
1650607467231,CSE 140,A01,083663,Staff,0,8,75,75
1650607473258,CSE 140L,A01,083088,Eldon; John,0,14,75,75
1650607479285,CSE 175,A01,083665,Kumar; Rakesh,7,0,25,18
1650607485317,CSE 190,A00,092507,Dubnov; Shlomo,11,0,20,9
1650607491342,ECE 45,A01,083139,Staff,0,1,60,60
1650607497371,ECE 65,A50,083695,Staff,0,5,30,30
1650607503397,ECE 109,A01,091882,Touri; Behrouz,33,0,70,37
1650607509420,ECE 180,A00,083140,Abi Samra; Nicholas Camill,21,0,30,9
1650607509420,ECE 180,B00,083141,Abi Samra; Nicholas Camill,0,0,30,30
1650607515448,MATH 10A,A01,083735,Patchell; Gregory David,4,0,30,26
1650607515448,MATH 10A,A02,083736,Patchell; Gregory David,27,0,30,3
1650607515448,MATH 10A,A03,083737,Patchell; Gregory David,24,0,30,6
1650607521483,MATH 10B,A01,083207,Staff,0,8,30,30
1650607521483,MATH 10B,A02,083208,Staff,0,8,30,30
1650607521483,MATH 10B,B01,083739,Staff,11,0,30,19
1650607521483,MATH 10B,B02,083740,Staff,28,0,30,2
1650607527508,MATH 18,A01,083743,Staff,0,0,30,30
1650607527508,MATH 18,A02,083744,Staff,23,0,30,7
1650607527508,MATH 18,A03,083745,Staff,21,0,30,9
1650607527508,MATH 18,A04,083746,Staff,26,0,30,4
1650607527508,MATH 18,B01,083748,Staff,0,15,30,30
1650607527508,MATH 18,B02,083749,Staff,0,10,30,30
1650607527508,MATH 18,B03,083750,Staff,0,12,30,30
1650607527508,MATH 18,B04,083751,Staff,0,12,30,30
1650607533534,MATH 20A,A01,083754,Staff,19,0,40,21
1650607539563,MATH 20B,A01,083756,Staff,0,12,30,30
1650607539563,MATH 20B,A02,083757,Staff,0,12,30,30
1650607545592,MATH 20C,A01,083760,Staff,0,15,30,30
1650607545592,MATH 20C,A02,083761,Staff,1,13,30,29
1650607545592,MATH 20C,B01,083762,Staff,11,0,30,19
1650607545592,MATH 20C,B02,083763,Staff,28,0,30,2
1650607551625,MATH 20D,A01,083765,Staff,1,1,30,29
1650607551625,MATH 20D,A02,083766,Staff,7,0,30,23
1650607551625,MATH 20D,A03,083767,Staff,24,0,30,6
1650607557653,MATH 20E,A01,083771,Staff,3,0,30,27
1650607557653,MATH 20E,A02,083772,Staff,17,0,30,13
1650607557653,MATH 20E,B01,083773,Staff,0,0,30,30
1650607557653,MATH 20E,B02,083774,Staff,9,0,30,21
1650607563679,MATH 103A,A01,083777,Staff,0,15,30,30
1650607563679,MATH 103A,A02,083778,Staff,0,15,30,30
1650607563679,MATH 103A,B01,083779,Staff,0,14,30,30
1650607563679,MATH 103A,B02,083780,Staff,0,14,30,30
1650607569703,MATH 105,A01,085443,Staff,0,21,30,30
1650607575732,MATH 109,A01,083213,Anzaldo; Leesa B,0,6,30,30
1650607575732,MATH 109,A02,083214,Anzaldo; Leesa B,0,7,30,30
1650607575732,MATH 109,B01,083215,Anzaldo; Leesa B,0,6,30,30
1650607575732,MATH 109,B02,083216,Anzaldo; Leesa B,0,5,30,30
1650607581755,MATH 142A,A01,083219,Chow; Bennett,0,16,30,30
1650607581755,MATH 142A,A02,083220,Chow; Bennett,0,15,30,30
1650607581755,MATH 142A,B01,083221,Chow; Bennett,0,14,30,30
1650607581755,MATH 142A,B02,083222,Chow; Bennett,0,13,30,30
1650607587784,MATH 193A,A01,083224,Staff,0,5,30,30
1650607587784,MATH 193A,A02,083225,Staff,0,6,30,30
1650607587784,MATH 193A,A03,083781,Staff,0,6,30,30
1650607587784,MATH 193A,A04,083782,Staff,0,7,30,30
1650607593818,MATH 197,001,091859,McAuley; Julian John,9998,0,9999,1
1650607599883,COGS 9,A01,083615,Staff,0,14,60,60
1650607605911,COGS 11,A01,083617,Boyle; Mary E. T.,18,0,40,22
1650607611934,COGS 13,A01,083071,Staff,0,38,40,40
1650607617961,COGS 14A,A01,092681,Staff,0,29,100,100
1650607623988,COGS 14B,A01,083073,Cheng; Tzu-Han,0,13,50,50
1650607630011,COGS 17,A01,092677,Staff,17,0,75,58
1650607636036,COGS 100,A01,083619,Staff,0,26,60,60
1650607642058,COGS 101A,A01,083621,Davis; Joshua Daniel,0,26,60,60
1650607648089,COGS 101B,A01,091572,Staff,0,4,60,60
1650607654113,COGS 101C,A01,083625,Delgado; Tania,15,0,30,15
1650607660140,COGS 107A,A01,083627,Boyle; Mary E. T.,0,15,60,60
1650607666166,COGS 118A,A01,083075,Staff,0,4,60,60
1650607672195,CSE 3,A50,083646,Miranda; Gregory Joseph,19,0,38,19
1650607672195,CSE 3,A51,083647,Miranda; Gregory Joseph,36,0,37,1
1650607678229,CSE 8A,A50,083650,Miranda; Gregory Joseph,0,30,40,40
1650607684255,CSE 11,A01,083080,Cao; Yingjun,0,95,40,40
1650607690290,CSE 12,A01,083652,Staff,0,20,100,100
1650607696315,CSE 15L,A01,083654,Staff,0,2,50,50
1650607696315,CSE 15L,A02,083655,Staff,0,1,50,50
1650607702344,CSE 20,A01,083657,Staff,51,0,80,29
1650607708369,CSE 30,A01,083084,Eldon; John,0,78,40,40
1650607714395,CSE 100,A01,083659,Cao; Yingjun,0,68,50,50
1650607720422,CSE 134B,A01,083661,Powell; Thomas Allan,0,35,65,65
1650607726447,CSE 140,A01,083663,Staff,0,8,75,75
1650607732477,CSE 140L,A01,083088,Eldon; John,0,14,75,75
1650607738500,CSE 175,A01,083665,Kumar; Rakesh,7,0,25,18
1650607744524,CSE 190,A00,092507,Dubnov; Shlomo,11,0,20,9
1650607750553,ECE 45,A01,083139,Staff,0,1,60,60
1650607756581,ECE 65,A50,083695,Staff,0,5,30,30
1650607762605,ECE 109,A01,091882,Touri; Behrouz,33,0,70,37
1650607768633,ECE 180,A00,083140,Abi Samra; Nicholas Camill,21,0,30,9
1650607768633,ECE 180,B00,083141,Abi Samra; Nicholas Camill,0,0,30,30
1650607774657,MATH 10A,A01,083735,Patchell; Gregory David,4,0,30,26
1650607774657,MATH 10A,A02,083736,Patchell; Gregory David,27,0,30,3
1650607774657,MATH 10A,A03,083737,Patchell; Gregory David,24,0,30,6
1650607780692,MATH 10B,A01,083207,Staff,0,8,30,30
1650607780692,MATH 10B,A02,083208,Staff,0,8,30,30
1650607780692,MATH 10B,B01,083739,Staff,11,0,30,19
1650607780692,MATH 10B,B02,083740,Staff,28,0,30,2
1650607786722,MATH 18,A01,083743,Staff,0,0,30,30
1650607786722,MATH 18,A02,083744,Staff,23,0,30,7
1650607786722,MATH 18,A03,083745,Staff,21,0,30,9
1650607786722,MATH 18,A04,083746,Staff,26,0,30,4
1650607786722,MATH 18,B01,083748,Staff,0,15,30,30
1650607786722,MATH 18,B02,083749,Staff,0,10,30,30
1650607786722,MATH 18,B03,083750,Staff,0,12,30,30
1650607786722,MATH 18,B04,083751,Staff,0,12,30,30
1650607792748,MATH 20A,A01,083754,Staff,19,0,40,21
1650607798772,MATH 20B,A01,083756,Staff,0,12,30,30
1650607798772,MATH 20B,A02,083757,Staff,0,12,30,30
1650607804806,MATH 20C,A01,083760,Staff,0,15,30,30
1650607804806,MATH 20C,A02,083761,Staff,1,13,30,29
1650607804806,MATH 20C,B01,083762,Staff,11,0,30,19
1650607804806,MATH 20C,B02,083763,Staff,28,0,30,2
1650607810830,MATH 20D,A01,083765,Staff,1,1,30,29
1650607810830,MATH 20D,A02,083766,Staff,7,0,30,23
1650607810830,MATH 20D,A03,083767,Staff,24,0,30,6
1650607816855,MATH 20E,A01,083771,Staff,3,0,30,27
1650607816855,MATH 20E,A02,083772,Staff,17,0,30,13
1650607816855,MATH 20E,B01,083773,Staff,0,0,30,30
1650607816855,MATH 20E,B02,083774,Staff,9,0,30,21
1650607822879,MATH 103A,A01,083777,Staff,0,15,30,30
1650607822879,MATH 103A,A02,083778,Staff,0,15,30,30
1650607822879,MATH 103A,B01,083779,Staff,0,14,30,30
1650607822879,MATH 103A,B02,083780,Staff,0,14,30,30
1650607828914,MATH 105,A01,085443,Staff,0,21,30,30
1650607844585,MATH 109,A01,083213,Anzaldo; Leesa B,0,6,30,30
1650607844585,MATH 109,A02,083214,Anzaldo; Leesa B,0,7,30,30
1650607844585,MATH 109,B01,083215,Anzaldo; Leesa B,0,6,30,30
1650607844585,MATH 109,B02,083216,Anzaldo; Leesa B,0,5,30,30
1650607850625,MATH 142A,A01,083219,Chow; Bennett,0,16,30,30
1650607850625,MATH 142A,A02,083220,Chow; Bennett,0,15,30,30
1650607850625,MATH 142A,B01,083221,Chow; Bennett,0,14,30,30
1650607850625,MATH 142A,B02,083222,Chow; Bennett,0,13,30,30
1650607856650,MATH 193A,A01,083224,Staff,0,5,30,30
1650607856650,MATH 193A,A02,083225,Staff,0,6,30,30
1650607856650,MATH 193A,A03,083781,Staff,0,6,30,30
1650607856650,MATH 193A,A04,083782,Staff,0,7,30,30
1650607862676,MATH 197,001,091859,McAuley; Julian John,9998,0,9999,1
1650607868730,COGS 9,A01,083615,Staff,0,14,60,60
1650607874762,COGS 11,A01,083617,Boyle; Mary E. T.,18,0,40,22
1650607880787,COGS 13,A01,083071,Staff,0,38,40,40
1650607886812,COGS 14A,A01,092681,Staff,0,29,100,100
1650607892835,COGS 14B,A01,083073,Cheng; Tzu-Han,0,13,50,50
1650607898859,COGS 17,A01,092677,Staff,17,0,75,58
1650607904885,COGS 100,A01,083619,Staff,0,26,60,60
1650607910914,COGS 101A,A01,083621,Davis; Joshua Daniel,0,26,60,60
1650607916936,COGS 101B,A01,091572,Staff,0,4,60,60
1650607922964,COGS 101C,A01,083625,Delgado; Tania,15,0,30,15
1650607928992,COGS 107A,A01,083627,Boyle; Mary E. T.,0,15,60,60
1650607935014,COGS 118A,A01,083075,Staff,0,4,60,60
1650607941038,CSE 3,A50,083646,Miranda; Gregory Joseph,19,0,38,19
1650607941038,CSE 3,A51,083647,Miranda; Gregory Joseph,36,0,37,1
1650607947064,CSE 8A,A50,083650,Miranda; Gregory Joseph,0,30,40,40
1650607953088,CSE 11,A01,083080,Cao; Yingjun,0,95,40,40
1650607959113,CSE 12,A01,083652,Staff,0,20,100,100
1650607965139,CSE 15L,A01,083654,Staff,0,2,50,50
1650607965139,CSE 15L,A02,083655,Staff,0,1,50,50
1650607971170,CSE 20,A01,083657,Staff,51,0,80,29
1650607977194,CSE 30,A01,083084,Eldon; John,0,78,40,40
1650607983222,CSE 100,A01,083659,Cao; Yingjun,0,68,50,50
1650607989244,CSE 134B,A01,083661,Powell; Thomas Allan,0,35,65,65
1650607995269,CSE 140,A01,083663,Staff,0,8,75,75
1650608001296,CSE 140L,A01,083088,Eldon; John,0,14,75,75
1650608007319,CSE 175,A01,083665,Kumar; Rakesh,7,0,25,18
1650608013342,CSE 190,A00,092507,Dubnov; Shlomo,11,0,20,9
1650608019369,ECE 45,A01,083139,Staff,0,1,60,60
1650608025496,ECE 65,A50,083695,Staff,0,5,30,30
1650608031519,ECE 109,A01,091882,Touri; Behrouz,33,0,70,37
1650608037541,ECE 180,A00,083140,Abi Samra; Nicholas Camill,21,0,30,9
1650608037541,ECE 180,B00,083141,Abi Samra; Nicholas Camill,0,0,30,30
1650608043566,MATH 10A,A01,083735,Patchell; Gregory David,4,0,30,26
1650608043566,MATH 10A,A02,083736,Patchell; Gregory David,27,0,30,3
1650608043566,MATH 10A,A03,083737,Patchell; Gregory David,24,0,30,6
1650608049601,MATH 10B,A01,083207,Staff,0,8,30,30
1650608049601,MATH 10B,A02,083208,Staff,0,8,30,30
1650608049601,MATH 10B,B01,083739,Staff,11,0,30,19
1650608049601,MATH 10B,B02,083740,Staff,28,0,30,2
1650608055632,MATH 18,A01,083743,Staff,0,0,30,30
1650608055632,MATH 18,A02,083744,Staff,23,0,30,7
1650608055632,MATH 18,A03,083745,Staff,21,0,30,9
1650608055632,MATH 18,A04,083746,Staff,26,0,30,4
1650608055632,MATH 18,B01,083748,Staff,0,15,30,30
1650608055632,MATH 18,B02,083749,Staff,0,10,30,30
1650608055632,MATH 18,B03,083750,Staff,0,12,30,30
1650608055632,MATH 18,B04,083751,Staff,0,12,30,30
1650608061661,MATH 20A,A01,083754,Staff,19,0,40,21
1650608067685,MATH 20B,A01,083756,Staff,0,12,30,30
1650608067685,MATH 20B,A02,083757,Staff,0,12,30,30
1650608073711,MATH 20C,A01,083760,Staff,0,15,30,30
1650608073711,MATH 20C,A02,083761,Staff,1,13,30,29
1650608073711,MATH 20C,B01,083762,Staff,11,0,30,19
1650608073711,MATH 20C,B02,083763,Staff,28,0,30,2
1650608079740,MATH 20D,A01,083765,Staff,1,1,30,29
1650608079740,MATH 20D,A02,083766,Staff,7,0,30,23
1650608079740,MATH 20D,A03,083767,Staff,24,0,30,6
1650608085767,MATH 20E,A01,083771,Staff,3,0,30,27
1650608085767,MATH 20E,A02,083772,Staff,17,0,30,13
1650608085767,MATH 20E,B01,083773,Staff,0,0,30,30
1650608085767,MATH 20E,B02,083774,Staff,9,0,30,21
1650608091789,MATH 103A,A01,083777,Staff,0,15,30,30
1650608091789,MATH 103A,A02,083778,Staff,0,15,30,30
1650608091789,MATH 103A,B01,083779,Staff,0,14,30,30
1650608091789,MATH 103A,B02,083780,Staff,0,14,30,30
1650608097815,MATH 105,A01,085443,Staff,0,21,30,30
1650608103838,MATH 109,A01,083213,Anzaldo; Leesa B,0,6,30,30
1650608103838,MATH 109,A02,083214,Anzaldo; Leesa B,0,7,30,30
1650608103838,MATH 109,B01,083215,Anzaldo; Leesa B,0,6,30,30
1650608103838,MATH 109,B02,083216,Anzaldo; Leesa B,0,5,30,30
1650608109868,MATH 142A,A01,083219,Chow; Bennett,0,16,30,30
1650608109868,MATH 142A,A02,083220,Chow; Bennett,0,15,30,30
1650608109868,MATH 142A,B01,083221,Chow; Bennett,0,14,30,30
1650608109868,MATH 142A,B02,083222,Chow; Bennett,0,13,30,30
1650608115899,MATH 193A,A01,083224,Staff,0,5,30,30
1650608115899,MATH 193A,A02,083225,Staff,0,6,30,30
1650608115899,MATH 193A,A03,083781,Staff,0,6,30,30
1650608115899,MATH 193A,A04,083782,Staff,0,7,30,30
1650608121925,MATH 197,001,091859,McAuley; Julian John,9998,0,9999,1
1650608127988,COGS 9,A01,083615,Staff,0,14,60,60
1650608134012,COGS 11,A01,083617,Boyle; Mary E. T.,18,0,40,22
1650608140036,COGS 13,A01,083071,Staff,0,38,40,40
1650608146059,COGS 14A,A01,092681,Staff,0,29,100,100
1650608152082,COGS 14B,A01,083073,Cheng; Tzu-Han,0,13,50,50
1650608158106,COGS 17,A01,092677,Staff,17,0,75,58
1650608164131,COGS 100,A01,083619,Staff,0,26,60,60
1650608170154,COGS 101A,A01,083621,Davis; Joshua Daniel,0,26,60,60
1650608176182,COGS 101B,A01,091572,Staff,0,4,60,60
1650608182209,COGS 101C,A01,083625,Delgado; Tania,15,0,30,15
1650608188243,COGS 107A,A01,083627,Boyle; Mary E. T.,0,15,60,60
1650608194267,COGS 118A,A01,083075,Staff,0,4,60,60
1650608200290,CSE 3,A50,083646,Miranda; Gregory Joseph,19,0,38,19
1650608200290,CSE 3,A51,083647,Miranda; Gregory Joseph,36,0,37,1
1650608206324,CSE 8A,A50,083650,Miranda; Gregory Joseph,0,30,40,40
1650608212348,CSE 11,A01,083080,Cao; Yingjun,0,95,40,40
1650608218375,CSE 12,A01,083652,Staff,0,20,100,100
1650608224408,CSE 15L,A01,083654,Staff,0,2,50,50
1650608224408,CSE 15L,A02,083655,Staff,0,1,50,50
1650608230433,CSE 20,A01,083657,Staff,51,0,80,29
1650608236459,CSE 30,A01,083084,Eldon; John,0,78,40,40
1650608242488,CSE 100,A01,083659,Cao; Yingjun,0,68,50,50
1650608248520,CSE 134B,A01,083661,Powell; Thomas Allan,0,35,65,65
1650608254553,CSE 140,A01,083663,Staff,0,8,75,75
1650608260589,CSE 140L,A01,083088,Eldon; John,0,14,75,75
1650608266613,CSE 175,A01,083665,Kumar; Rakesh,7,0,25,18
1650608272640,CSE 190,A00,092507,Dubnov; Shlomo,11,0,20,9
1650608278672,ECE 45,A01,083139,Staff,0,1,60,60
1650608284699,ECE 65,A50,083695,Staff,0,5,30,30
1650608290731,ECE 109,A01,091882,Touri; Behrouz,33,0,70,37
1650608296755,ECE 180,A00,083140,Abi Samra; Nicholas Camill,21,0,30,9
1650608296755,ECE 180,B00,083141,Abi Samra; Nicholas Camill,0,0,30,30
1650608302785,MATH 10A,A01,083735,Patchell; Gregory David,4,0,30,26
1650608302785,MATH 10A,A02,083736,Patchell; Gregory David,27,0,30,3
1650608302785,MATH 10A,A03,083737,Patchell; Gregory David,24,0,30,6
1650608308814,MATH 10B,A01,083207,Staff,0,8,30,30
1650608308814,MATH 10B,A02,083208,Staff,0,8,30,30
1650608308814,MATH 10B,B01,083739,Staff,11,0,30,19
1650608308814,MATH 10B,B02,083740,Staff,28,0,30,2
1650608314839,MATH 18,A01,083743,Staff,0,0,30,30
1650608314839,MATH 18,A02,083744,Staff,23,0,30,7
1650608314839,MATH 18,A03,083745,Staff,21,0,30,9
1650608314839,MATH 18,A04,083746,Staff,26,0,30,4
1650608314839,MATH 18,B01,083748,Staff,0,15,30,30
1650608314839,MATH 18,B02,083749,Staff,0,10,30,30
1650608314839,MATH 18,B03,083750,Staff,0,12,30,30
1650608314839,MATH 18,B04,083751,Staff,0,12,30,30
1650608320874,MATH 20A,A01,083754,Staff,19,0,40,21
1650608326902,MATH 20B,A01,083756,Staff,0,12,30,30
1650608326902,MATH 20B,A02,083757,Staff,0,12,30,30
1650608332927,MATH 20C,A01,083760,Staff,0,15,30,30
1650608332927,MATH 20C,A02,083761,Staff,1,13,30,29
1650608332927,MATH 20C,B01,083762,Staff,11,0,30,19
1650608332927,MATH 20C,B02,083763,Staff,28,0,30,2
1650608338961,MATH 20D,A01,083765,Staff,1,1,30,29
1650608338961,MATH 20D,A02,083766,Staff,7,0,30,23
1650608338961,MATH 20D,A03,083767,Staff,24,0,30,6
1650608344989,MATH 20E,A01,083771,Staff,3,0,30,27
1650608344989,MATH 20E,A02,083772,Staff,17,0,30,13
1650608344989,MATH 20E,B01,083773,Staff,0,0,30,30
1650608344989,MATH 20E,B02,083774,Staff,9,0,30,21
1650608351027,MATH 103A,A01,083777,Staff,0,15,30,30
1650608351027,MATH 103A,A02,083778,Staff,0,15,30,30
1650608351027,MATH 103A,B01,083779,Staff,0,14,30,30
1650608351027,MATH 103A,B02,083780,Staff,0,14,30,30
1650608357119,MATH 105,A01,085443,Staff,0,21,30,30
1650608363142,MATH 109,A01,083213,Anzaldo; Leesa B,0,6,30,30
1650608363142,MATH 109,A02,083214,Anzaldo; Leesa B,0,7,30,30
1650608363142,MATH 109,B01,083215,Anzaldo; Leesa B,0,6,30,30
1650608363142,MATH 109,B02,083216,Anzaldo; Leesa B,0,5,30,30
1650608369168,MATH 142A,A01,083219,Chow; Bennett,0,16,30,30
1650608369168,MATH 142A,A02,083220,Chow; Bennett,0,15,30,30
1650608369168,MATH 142A,B01,083221,Chow; Bennett,0,14,30,30
1650608369168,MATH 142A,B02,083222,Chow; Bennett,0,13,30,30
1650608375193,MATH 193A,A01,083224,Staff,0,5,30,30
1650608375193,MATH 193A,A02,083225,Staff,0,6,30,30
1650608375193,MATH 193A,A03,083781,Staff,0,6,30,30
1650608375193,MATH 193A,A04,083782,Staff,0,7,30,30
1650608381217,MATH 197,001,091859,McAuley; Julian John,9998,0,9999,1
1650608387265,COGS 9,A01,083615,Staff,0,14,60,60
1650608393291,COGS 11,A01,083617,Boyle; Mary E. T.,18,0,40,22
1650608399327,COGS 13,A01,083071,Staff,0,38,40,40
1650608405353,COGS 14A,A01,092681,Staff,0,29,100,100
1650608411377,COGS 14B,A01,083073,Cheng; Tzu-Han,0,13,50,50
1650608417402,COGS 17,A01,092677,Staff,17,0,75,58
1650608423428,COGS 100,A01,083619,Staff,0,26,60,60
1650608429457,COGS 101A,A01,083621,Davis; Joshua Daniel,0,26,60,60
1650608435478,COGS 101B,A01,091572,Staff,0,4,60,60
1650608441510,COGS 101C,A01,083625,Delgado; Tania,15,0,30,15
1650608447535,COGS 107A,A01,083627,Boyle; Mary E. T.,0,15,60,60
1650608453558,COGS 118A,A01,083075,Staff,0,4,60,60
1650608459583,CSE 3,A50,083646,Miranda; Gregory Joseph,19,0,38,19
1650608459583,CSE 3,A51,083647,Miranda; Gregory Joseph,36,0,37,1
1650608465611,CSE 8A,A50,083650,Miranda; Gregory Joseph,0,30,40,40
1650608471635,CSE 11,A01,083080,Cao; Yingjun,0,95,40,40
1650608477660,CSE 12,A01,083652,Staff,0,20,100,100
1650608483683,CSE 15L,A01,083654,Staff,0,2,50,50
1650608483683,CSE 15L,A02,083655,Staff,0,1,50,50
1650608489709,CSE 20,A01,083657,Staff,51,0,80,29
1650608495736,CSE 30,A01,083084,Eldon; John,0,78,40,40
1650608501765,CSE 100,A01,083659,Cao; Yingjun,0,68,50,50
1650608507789,CSE 134B,A01,083661,Powell; Thomas Allan,0,35,65,65
1650608513812,CSE 140,A01,083663,Staff,0,8,75,75
1650608519834,CSE 140L,A01,083088,Eldon; John,0,15,75,75
1650608525857,CSE 175,A01,083665,Kumar; Rakesh,7,0,25,18
1650608531886,CSE 190,A00,092507,Dubnov; Shlomo,11,0,20,9
1650608537912,ECE 45,A01,083139,Staff,0,1,60,60
1650608543938,ECE 65,A50,083695,Staff,0,5,30,30
1650608549960,ECE 109,A01,091882,Touri; Behrouz,33,0,70,37
1650608555988,ECE 180,A00,083140,Abi Samra; Nicholas Camill,21,0,30,9
1650608555988,ECE 180,B00,083141,Abi Samra; Nicholas Camill,0,0,30,30
1650608562011,MATH 10A,A01,083735,Patchell; Gregory David,4,0,30,26
1650608562011,MATH 10A,A02,083736,Patchell; Gregory David,27,0,30,3
1650608562011,MATH 10A,A03,083737,Patchell; Gregory David,24,0,30,6
1650608568041,MATH 10B,A01,083207,Staff,0,8,30,30
1650608568041,MATH 10B,A02,083208,Staff,0,8,30,30
1650608568041,MATH 10B,B01,083739,Staff,11,0,30,19
1650608568041,MATH 10B,B02,083740,Staff,28,0,30,2
1650608574064,MATH 18,A01,083743,Staff,0,0,30,30
1650608574064,MATH 18,A02,083744,Staff,23,0,30,7
1650608574064,MATH 18,A03,083745,Staff,21,0,30,9
1650608574064,MATH 18,A04,083746,Staff,26,0,30,4
1650608574064,MATH 18,B01,083748,Staff,0,15,30,30
1650608574064,MATH 18,B02,083749,Staff,0,10,30,30
1650608574064,MATH 18,B03,083750,Staff,0,12,30,30
1650608574064,MATH 18,B04,083751,Staff,0,12,30,30
1650608580088,MATH 20A,A01,083754,Staff,19,0,40,21
1650608586111,MATH 20B,A01,083756,Staff,0,12,30,30
1650608586111,MATH 20B,A02,083757,Staff,0,12,30,30
1650608592142,MATH 20C,A01,083760,Staff,0,15,30,30
1650608592142,MATH 20C,A02,083761,Staff,1,13,30,29
1650608592142,MATH 20C,B01,083762,Staff,11,0,30,19
1650608592142,MATH 20C,B02,083763,Staff,28,0,30,2
1650608598165,MATH 20D,A01,083765,Staff,1,1,30,29
1650608598165,MATH 20D,A02,083766,Staff,7,0,30,23
1650608598165,MATH 20D,A03,083767,Staff,24,0,30,6
1650608604190,MATH 20E,A01,083771,Staff,3,0,30,27
1650608604190,MATH 20E,A02,083772,Staff,17,0,30,13
1650608604190,MATH 20E,B01,083773,Staff,0,0,30,30
1650608604190,MATH 20E,B02,083774,Staff,9,0,30,21
1650608610214,MATH 103A,A01,083777,Staff,0,15,30,30
1650608610214,MATH 103A,A02,083778,Staff,0,15,30,30
1650608610214,MATH 103A,B01,083779,Staff,0,14,30,30
1650608610214,MATH 103A,B02,083780,Staff,0,14,30,30
1650608616242,MATH 105,A01,085443,Staff,0,21,30,30
1650608622357,MATH 109,A01,083213,Anzaldo; Leesa B,0,6,30,30
1650608622357,MATH 109,A02,083214,Anzaldo; Leesa B,0,7,30,30
1650608622357,MATH 109,B01,083215,Anzaldo; Leesa B,0,6,30,30
1650608622357,MATH 109,B02,083216,Anzaldo; Leesa B,0,5,30,30
1650608628393,MATH 142A,A01,083219,Chow; Bennett,0,16,30,30
1650608628393,MATH 142A,A02,083220,Chow; Bennett,0,15,30,30
1650608628393,MATH 142A,B01,083221,Chow; Bennett,0,14,30,30
1650608628393,MATH 142A,B02,083222,Chow; Bennett,0,13,30,30
1650608634417,MATH 193A,A01,083224,Staff,0,5,30,30
1650608634417,MATH 193A,A02,083225,Staff,0,6,30,30
1650608634417,MATH 193A,A03,083781,Staff,0,6,30,30
1650608634417,MATH 193A,A04,083782,Staff,0,7,30,30
1650608640442,MATH 197,001,091859,McAuley; Julian John,9998,0,9999,1
1650608646504,COGS 9,A01,083615,Staff,0,14,60,60
1650608652526,COGS 11,A01,083617,Boyle; Mary E. T.,18,0,40,22
1650608658559,COGS 13,A01,083071,Staff,0,38,40,40
1650608664583,COGS 14A,A01,092681,Staff,0,29,100,100
1650608670609,COGS 14B,A01,083073,Cheng; Tzu-Han,0,13,50,50
1650608676632,COGS 17,A01,092677,Staff,17,0,75,58
1650608682653,COGS 100,A01,083619,Staff,0,26,60,60
1650608688688,COGS 101A,A01,083621,Davis; Joshua Daniel,0,26,60,60
1650608694713,COGS 101B,A01,091572,Staff,0,4,60,60
1650608700737,COGS 101C,A01,083625,Delgado; Tania,15,0,30,15
1650608706761,COGS 107A,A01,083627,Boyle; Mary E. T.,0,15,60,60
1650608712785,COGS 118A,A01,083075,Staff,0,4,60,60
1650608718808,CSE 3,A50,083646,Miranda; Gregory Joseph,19,0,38,19
1650608718808,CSE 3,A51,083647,Miranda; Gregory Joseph,36,0,37,1
1650608724843,CSE 8A,A50,083650,Miranda; Gregory Joseph,0,30,40,40
1650608730868,CSE 11,A01,083080,Cao; Yingjun,0,95,40,40
1650608736896,CSE 12,A01,083652,Staff,0,20,100,100
1650608742920,CSE 15L,A01,083654,Staff,0,2,50,50
1650608742920,CSE 15L,A02,083655,Staff,0,1,50,50
1650608748945,CSE 20,A01,083657,Staff,51,0,80,29
1650608754970,CSE 30,A01,083084,Eldon; John,0,78,40,40
1650608761005,CSE 100,A01,083659,Cao; Yingjun,0,68,50,50
1650608767033,CSE 134B,A01,083661,Powell; Thomas Allan,0,35,65,65
1650608773057,CSE 140,A01,083663,Staff,0,8,75,75
1650608779085,CSE 140L,A01,083088,Eldon; John,0,15,75,75
1650608785112,CSE 175,A01,083665,Kumar; Rakesh,7,0,25,18
1650608791136,CSE 190,A00,092507,Dubnov; Shlomo,11,0,20,9
1650608797165,ECE 45,A01,083139,Staff,0,1,60,60
1650608803190,ECE 65,A50,083695,Staff,0,5,30,30
1650608809214,ECE 109,A01,091882,Touri; Behrouz,33,0,70,37
1650608815251,ECE 180,A00,083140,Abi Samra; Nicholas Camill,21,0,30,9
1650608815251,ECE 180,B00,083141,Abi Samra; Nicholas Camill,0,0,30,30
1650608821277,MATH 10A,A01,083735,Patchell; Gregory David,4,0,30,26
1650608821277,MATH 10A,A02,083736,Patchell; Gregory David,27,0,30,3
1650608821277,MATH 10A,A03,083737,Patchell; Gregory David,24,0,30,6
1650608827301,MATH 10B,A01,083207,Staff,0,8,30,30
1650608827301,MATH 10B,A02,083208,Staff,0,8,30,30
1650608827301,MATH 10B,B01,083739,Staff,11,0,30,19
1650608827301,MATH 10B,B02,083740,Staff,28,0,30,2
1650608833326,MATH 18,A01,083743,Staff,0,0,30,30
1650608833326,MATH 18,A02,083744,Staff,23,0,30,7
1650608833326,MATH 18,A03,083745,Staff,21,0,30,9
1650608833326,MATH 18,A04,083746,Staff,26,0,30,4
1650608833326,MATH 18,B01,083748,Staff,0,15,30,30
1650608833326,MATH 18,B02,083749,Staff,0,10,30,30
1650608833326,MATH 18,B03,083750,Staff,0,12,30,30
1650608833326,MATH 18,B04,083751,Staff,0,12,30,30
1650608839350,MATH 20A,A01,083754,Staff,19,0,40,21
1650608845374,MATH 20B,A01,083756,Staff,0,12,30,30
1650608845374,MATH 20B,A02,083757,Staff,0,12,30,30
1650608851397,MATH 20C,A01,083760,Staff,0,15,30,30
1650608851397,MATH 20C,A02,083761,Staff,1,13,30,29
1650608851397,MATH 20C,B01,083762,Staff,11,0,30,19
1650608851397,MATH 20C,B02,083763,Staff,28,0,30,2
1650608857420,MATH 20D,A01,083765,Staff,1,1,30,29
1650608857420,MATH 20D,A02,083766,Staff,7,0,30,23
1650608857420,MATH 20D,A03,083767,Staff,24,0,30,6
1650608863450,MATH 20E,A01,083771,Staff,3,0,30,27
1650608863450,MATH 20E,A02,083772,Staff,17,0,30,13
1650608863450,MATH 20E,B01,083773,Staff,0,0,30,30
1650608863450,MATH 20E,B02,083774,Staff,9,0,30,21
1650608869474,MATH 103A,A01,083777,Staff,0,15,30,30
1650608869474,MATH 103A,A02,083778,Staff,0,15,30,30
1650608869474,MATH 103A,B01,083779,Staff,0,14,30,30
1650608869474,MATH 103A,B02,083780,Staff,0,14,30,30
1650608875497,MATH 105,A01,085443,Staff,0,21,30,30
1650608881529,MATH 109,A01,083213,Anzaldo; Leesa B,0,6,30,30
1650608881529,MATH 109,A02,083214,Anzaldo; Leesa B,0,7,30,30
1650608881529,MATH 109,B01,083215,Anzaldo; Leesa B,0,6,30,30
1650608881529,MATH 109,B02,083216,Anzaldo; Leesa B,0,6,30,30
1650608887555,MATH 142A,A01,083219,Chow; Bennett,0,16,30,30
1650608887555,MATH 142A,A02,083220,Chow; Bennett,0,15,30,30
1650608887555,MATH 142A,B01,083221,Chow; Bennett,0,14,30,30
1650608887555,MATH 142A,B02,083222,Chow; Bennett,0,13,30,30
1650608893579,MATH 193A,A01,083224,Staff,0,5,30,30
1650608893579,MATH 193A,A02,083225,Staff,0,6,30,30
1650608893579,MATH 193A,A03,083781,Staff,0,6,30,30
1650608893579,MATH 193A,A04,083782,Staff,0,7,30,30
1650608899601,MATH 197,001,091859,McAuley; Julian John,9998,0,9999,1
1650608905660,COGS 9,A01,083615,Staff,0,14,60,60
1650608911687,COGS 11,A01,083617,Boyle; Mary E. T.,18,0,40,22
1650608917709,COGS 13,A01,083071,Staff,0,38,40,40
1650608923733,COGS 14A,A01,092681,Staff,0,29,100,100
1650608929763,COGS 14B,A01,083073,Cheng; Tzu-Han,0,13,50,50
1650608935786,COGS 17,A01,092677,Staff,17,0,75,58
1650608941813,COGS 100,A01,083619,Staff,0,26,60,60
1650608947840,COGS 101A,A01,083621,Davis; Joshua Daniel,0,26,60,60
1650608953862,COGS 101B,A01,091572,Staff,0,4,60,60
1650608959885,COGS 101C,A01,083625,Delgado; Tania,15,0,30,15
1650608965912,COGS 107A,A01,083627,Boyle; Mary E. T.,0,15,60,60
1650608971938,COGS 118A,A01,083075,Staff,0,4,60,60
1650608977960,CSE 3,A50,083646,Miranda; Gregory Joseph,19,0,38,19
1650608977960,CSE 3,A51,083647,Miranda; Gregory Joseph,36,0,37,1
1650608983990,CSE 8A,A50,083650,Miranda; Gregory Joseph,0,30,40,40
1650608990019,CSE 11,A01,083080,Cao; Yingjun,0,95,40,40
1650608996047,CSE 12,A01,083652,Staff,0,20,100,100
1650609002068,CSE 15L,A01,083654,Staff,0,2,50,50
1650609002068,CSE 15L,A02,083655,Staff,0,1,50,50
1650609008095,CSE 20,A01,083657,Staff,51,0,80,29
1650609014119,CSE 30,A01,083084,Eldon; John,0,78,40,40
1650609020141,CSE 100,A01,083659,Cao; Yingjun,0,68,50,50
1650609026164,CSE 134B,A01,083661,Powell; Thomas Allan,0,35,65,65
1650609032187,CSE 140,A01,083663,Staff,0,8,75,75
1650609038211,CSE 140L,A01,083088,Eldon; John,0,15,75,75
1650609044237,CSE 175,A01,083665,Kumar; Rakesh,7,0,25,18
1650609050263,CSE 190,A00,092507,Dubnov; Shlomo,11,0,20,9
1650609056287,ECE 45,A01,083139,Staff,0,1,60,60
1650609062316,ECE 65,A50,083695,Staff,0,5,30,30
1650609068346,ECE 109,A01,091882,Touri; Behrouz,33,0,70,37
1650609074379,ECE 180,A00,083140,Abi Samra; Nicholas Camill,21,0,30,9
1650609074379,ECE 180,B00,083141,Abi Samra; Nicholas Camill,0,0,30,30
1650609080410,MATH 10A,A01,083735,Patchell; Gregory David,4,0,30,26
1650609080410,MATH 10A,A02,083736,Patchell; Gregory David,27,0,30,3
1650609080410,MATH 10A,A03,083737,Patchell; Gregory David,24,0,30,6
1650609086433,MATH 10B,A01,083207,Staff,0,8,30,30
1650609086433,MATH 10B,A02,083208,Staff,0,8,30,30
1650609086433,MATH 10B,B01,083739,Staff,11,0,30,19
1650609086433,MATH 10B,B02,083740,Staff,28,0,30,2
1650609092462,MATH 18,A01,083743,Staff,0,0,30,30
1650609092462,MATH 18,A02,083744,Staff,23,0,30,7
1650609092462,MATH 18,A03,083745,Staff,21,0,30,9
1650609092462,MATH 18,A04,083746,Staff,26,0,30,4
1650609092462,MATH 18,B01,083748,Staff,0,15,30,30
1650609092462,MATH 18,B02,083749,Staff,0,10,30,30
1650609092462,MATH 18,B03,083750,Staff,0,12,30,30
1650609092462,MATH 18,B04,083751,Staff,0,12,30,30
1650609098494,MATH 20A,A01,083754,Staff,19,0,40,21
1650609104519,MATH 20B,A01,083756,Staff,0,12,30,30
1650609104519,MATH 20B,A02,083757,Staff,0,12,30,30
1650609110544,MATH 20C,A01,083760,Staff,0,15,30,30
1650609110544,MATH 20C,A02,083761,Staff,1,13,30,29
1650609110544,MATH 20C,B01,083762,Staff,11,0,30,19
1650609110544,MATH 20C,B02,083763,Staff,28,0,30,2
1650609116569,MATH 20D,A01,083765,Staff,1,1,30,29
1650609116569,MATH 20D,A02,083766,Staff,7,0,30,23
1650609116569,MATH 20D,A03,083767,Staff,24,0,30,6
1650609122593,MATH 20E,A01,083771,Staff,3,0,30,27
1650609122593,MATH 20E,A02,083772,Staff,17,0,30,13
1650609122593,MATH 20E,B01,083773,Staff,0,0,30,30
1650609122593,MATH 20E,B02,083774,Staff,9,0,30,21
1650609128617,MATH 103A,A01,083777,Staff,0,15,30,30
1650609128617,MATH 103A,A02,083778,Staff,0,15,30,30
1650609128617,MATH 103A,B01,083779,Staff,0,14,30,30
1650609128617,MATH 103A,B02,083780,Staff,0,14,30,30
1650609134648,MATH 105,A01,085443,Staff,0,21,30,30
1650609140672,MATH 109,A01,083213,Anzaldo; Leesa B,0,6,30,30
1650609140672,MATH 109,A02,083214,Anzaldo; Leesa B,0,7,30,30
1650609140672,MATH 109,B01,083215,Anzaldo; Leesa B,0,6,30,30
1650609140672,MATH 109,B02,083216,Anzaldo; Leesa B,0,6,30,30
1650609146699,MATH 142A,A01,083219,Chow; Bennett,0,16,30,30
1650609146699,MATH 142A,A02,083220,Chow; Bennett,0,15,30,30
1650609146699,MATH 142A,B01,083221,Chow; Bennett,0,14,30,30
1650609146699,MATH 142A,B02,083222,Chow; Bennett,0,13,30,30
1650609152733,MATH 193A,A01,083224,Staff,0,5,30,30
1650609152733,MATH 193A,A02,083225,Staff,0,6,30,30
1650609152733,MATH 193A,A03,083781,Staff,0,6,30,30
1650609152733,MATH 193A,A04,083782,Staff,0,7,30,30
1650609158758,MATH 197,001,091859,McAuley; Julian John,9998,0,9999,1
1650609164819,COGS 9,A01,083615,Staff,0,14,60,60
1650609170853,COGS 11,A01,083617,Boyle; Mary E. T.,18,0,40,22
1650609176880,COGS 13,A01,083071,Staff,0,38,40,40
1650609182901,COGS 14A,A01,092681,Staff,0,29,100,100
1650609188963,COGS 14B,A01,083073,Cheng; Tzu-Han,0,13,50,50
1650609194987,COGS 17,A01,092677,Staff,17,0,75,58
1650609201010,COGS 100,A01,083619,Staff,0,26,60,60
1650609207033,COGS 101A,A01,083621,Davis; Joshua Daniel,0,26,60,60
1650609213146,COGS 101B,A01,091572,Staff,0,4,60,60
1650609219172,COGS 101C,A01,083625,Delgado; Tania,15,0,30,15
1650609225199,COGS 107A,A01,083627,Boyle; Mary E. T.,0,15,60,60
1650609231222,COGS 118A,A01,083075,Staff,0,4,60,60
1650609237250,CSE 3,A50,083646,Miranda; Gregory Joseph,19,0,38,19
1650609237250,CSE 3,A51,083647,Miranda; Gregory Joseph,36,0,37,1
1650609243277,CSE 8A,A50,083650,Miranda; Gregory Joseph,0,30,40,40
1650609249314,CSE 11,A01,083080,Cao; Yingjun,0,95,40,40
1650609255344,CSE 12,A01,083652,Staff,0,20,100,100
1650609261372,CSE 15L,A01,083654,Staff,0,2,50,50
1650609261372,CSE 15L,A02,083655,Staff,0,1,50,50
1650609267396,CSE 20,A01,083657,Staff,51,0,80,29
1650609273419,CSE 30,A01,083084,Eldon; John,0,78,40,40
1650609279458,CSE 100,A01,083659,Cao; Yingjun,0,68,50,50
1650609285480,CSE 134B,A01,083661,Powell; Thomas Allan,0,35,65,65
1650609291504,CSE 140,A01,083663,Staff,0,8,75,75
1650609297545,CSE 140L,A01,083088,Eldon; John,0,15,75,75
1650609303571,CSE 175,A01,083665,Kumar; Rakesh,7,0,25,18
1650609309598,CSE 190,A00,092507,Dubnov; Shlomo,10,0,20,10
1650609315622,ECE 45,A01,083139,Staff,0,1,60,60
1650609321650,ECE 65,A50,083695,Staff,0,5,30,30
1650609327675,ECE 109,A01,091882,Touri; Behrouz,33,0,70,37
1650609333701,ECE 180,A00,083140,Abi Samra; Nicholas Camill,21,0,30,9
1650609333701,ECE 180,B00,083141,Abi Samra; Nicholas Camill,0,0,30,30
1650609339725,MATH 10A,A01,083735,Patchell; Gregory David,4,0,30,26
1650609339725,MATH 10A,A02,083736,Patchell; Gregory David,27,0,30,3
1650609339725,MATH 10A,A03,083737,Patchell; Gregory David,24,0,30,6
1650609345752,MATH 10B,A01,083207,Staff,0,8,30,30
1650609345752,MATH 10B,A02,083208,Staff,0,8,30,30
1650609345752,MATH 10B,B01,083739,Staff,11,0,30,19
1650609345752,MATH 10B,B02,083740,Staff,28,0,30,2
1650609351785,MATH 18,A01,083743,Staff,0,0,30,30
1650609351785,MATH 18,A02,083744,Staff,23,0,30,7
1650609351785,MATH 18,A03,083745,Staff,21,0,30,9
1650609351785,MATH 18,A04,083746,Staff,26,0,30,4
1650609351785,MATH 18,B01,083748,Staff,0,15,30,30
1650609351785,MATH 18,B02,083749,Staff,0,11,30,30
1650609351785,MATH 18,B03,083750,Staff,0,12,30,30
1650609351785,MATH 18,B04,083751,Staff,0,12,30,30
1650609357828,MATH 20A,A01,083754,Staff,19,0,40,21
1650609363852,MATH 20B,A01,083756,Staff,0,12,30,30
1650609363852,MATH 20B,A02,083757,Staff,0,12,30,30
1650609369875,MATH 20C,A01,083760,Staff,0,15,30,30
1650609369875,MATH 20C,A02,083761,Staff,1,13,30,29
1650609369875,MATH 20C,B01,083762,Staff,11,0,30,19
1650609369875,MATH 20C,B02,083763,Staff,28,0,30,2
1650609375902,MATH 20D,A01,083765,Staff,1,1,30,29
1650609375902,MATH 20D,A02,083766,Staff,7,0,30,23
1650609375902,MATH 20D,A03,083767,Staff,24,0,30,6
1650609381927,MATH 20E,A01,083771,Staff,3,0,30,27
1650609381927,MATH 20E,A02,083772,Staff,17,0,30,13
1650609381927,MATH 20E,B01,083773,Staff,0,0,30,30
1650609381927,MATH 20E,B02,083774,Staff,9,0,30,21
1650609387952,MATH 103A,A01,083777,Staff,0,15,30,30
1650609387952,MATH 103A,A02,083778,Staff,0,15,30,30
1650609387952,MATH 103A,B01,083779,Staff,0,14,30,30
1650609387952,MATH 103A,B02,083780,Staff,0,14,30,30
1650609393979,MATH 105,A01,085443,Staff,0,21,30,30
1650609400009,MATH 109,A01,083213,Anzaldo; Leesa B,0,6,30,30
1650609400009,MATH 109,A02,083214,Anzaldo; Leesa B,0,7,30,30
1650609400009,MATH 109,B01,083215,Anzaldo; Leesa B,0,6,30,30
1650609400009,MATH 109,B02,083216,Anzaldo; Leesa B,0,6,30,30
1650609406038,MATH 142A,A01,083219,Chow; Bennett,0,16,30,30
1650609406038,MATH 142A,A02,083220,Chow; Bennett,0,15,30,30
1650609406038,MATH 142A,B01,083221,Chow; Bennett,0,14,30,30
1650609406038,MATH 142A,B02,083222,Chow; Bennett,0,13,30,30
1650609412063,MATH 193A,A01,083224,Staff,0,5,30,30
1650609412063,MATH 193A,A02,083225,Staff,0,6,30,30
1650609412063,MATH 193A,A03,083781,Staff,0,6,30,30
1650609412063,MATH 193A,A04,083782,Staff,0,7,30,30
1650609418085,MATH 197,001,091859,McAuley; Julian John,9998,0,9999,1
1650609424145,COGS 9,A01,083615,Staff,0,14,60,60
1650609430170,COGS 11,A01,083617,Boyle; Mary E. T.,18,0,40,22
1650609436193,COGS 13,A01,083071,Staff,0,38,40,40
1650609442220,COGS 14A,A01,092681,Staff,0,29,100,100
1650609448250,COGS 14B,A01,083073,Cheng; Tzu-Han,0,13,50,50
1650609454275,COGS 17,A01,092677,Staff,17,0,75,58
1650609460299,COGS 100,A01,083619,Staff,0,26,60,60
1650609466328,COGS 101A,A01,083621,Davis; Joshua Daniel,0,26,60,60
1650609472352,COGS 101B,A01,091572,Staff,0,4,60,60
1650609478377,COGS 101C,A01,083625,Delgado; Tania,15,0,30,15
1650609484401,COGS 107A,A01,083627,Boyle; Mary E. T.,0,15,60,60
1650609490427,COGS 118A,A01,083075,Staff,0,5,60,60
1650609496455,CSE 3,A50,083646,Miranda; Gregory Joseph,19,0,38,19
1650609496455,CSE 3,A51,083647,Miranda; Gregory Joseph,36,0,37,1
1650609502486,CSE 8A,A50,083650,Miranda; Gregory Joseph,0,30,40,40
1650609508509,CSE 11,A01,083080,Cao; Yingjun,0,95,40,40
1650609514538,CSE 12,A01,083652,Staff,0,20,100,100
1650609520563,CSE 15L,A01,083654,Staff,0,2,50,50
1650609520563,CSE 15L,A02,083655,Staff,0,1,50,50
1650609526587,CSE 20,A01,083657,Staff,51,0,80,29
1650609532612,CSE 30,A01,083084,Eldon; John,0,78,40,40
1650609538635,CSE 100,A01,083659,Cao; Yingjun,0,68,50,50
1650609544659,CSE 134B,A01,083661,Powell; Thomas Allan,0,35,65,65
1650609550682,CSE 140,A01,083663,Staff,0,8,75,75
1650609556706,CSE 140L,A01,083088,Eldon; John,0,15,75,75
1650609562732,CSE 175,A01,083665,Kumar; Rakesh,7,0,25,18
1650609568755,CSE 190,A00,092507,Dubnov; Shlomo,10,0,20,10
1650609574782,ECE 45,A01,083139,Staff,0,1,60,60
1650609580808,ECE 65,A50,083695,Staff,0,5,30,30
1650609586832,ECE 109,A01,091882,Touri; Behrouz,33,0,70,37
1650609592859,ECE 180,A00,083140,Abi Samra; Nicholas Camill,21,0,30,9
1650609592859,ECE 180,B00,083141,Abi Samra; Nicholas Camill,0,0,30,30
1650609598886,MATH 10A,A01,083735,Patchell; Gregory David,4,0,30,26
1650609598886,MATH 10A,A02,083736,Patchell; Gregory David,27,0,30,3
1650609598886,MATH 10A,A03,083737,Patchell; Gregory David,24,0,30,6
1650609604913,MATH 10B,A01,083207,Staff,0,8,30,30
1650609604913,MATH 10B,A02,083208,Staff,0,8,30,30
1650609604913,MATH 10B,B01,083739,Staff,11,0,30,19
1650609604913,MATH 10B,B02,083740,Staff,28,0,30,2
1650609610948,MATH 18,A01,083743,Staff,0,0,30,30
1650609610948,MATH 18,A02,083744,Staff,23,0,30,7
1650609610948,MATH 18,A03,083745,Staff,21,0,30,9
1650609610948,MATH 18,A04,083746,Staff,26,0,30,4
1650609610948,MATH 18,B01,083748,Staff,0,15,30,30
1650609610948,MATH 18,B02,083749,Staff,0,11,30,30
1650609610948,MATH 18,B03,083750,Staff,0,12,30,30
1650609610948,MATH 18,B04,083751,Staff,0,12,30,30
1650609616981,MATH 20A,A01,083754,Staff,19,0,40,21
1650609623007,MATH 20B,A01,083756,Staff,0,12,30,30
1650609623007,MATH 20B,A02,083757,Staff,0,12,30,30
1650609629035,MATH 20C,A01,083760,Staff,0,15,30,30
1650609629035,MATH 20C,A02,083761,Staff,1,13,30,29
1650609629035,MATH 20C,B01,083762,Staff,11,0,30,19
1650609629035,MATH 20C,B02,083763,Staff,28,0,30,2
1650609635058,MATH 20D,A01,083765,Staff,1,1,30,29
1650609635058,MATH 20D,A02,083766,Staff,7,0,30,23
1650609635058,MATH 20D,A03,083767,Staff,24,0,30,6
1650609641082,MATH 20E,A01,083771,Staff,3,0,30,27
1650609641082,MATH 20E,A02,083772,Staff,17,0,30,13
1650609641082,MATH 20E,B01,083773,Staff,0,0,30,30
1650609641082,MATH 20E,B02,083774,Staff,9,0,30,21
1650609647131,MATH 103A,A01,083777,Staff,0,15,30,30
1650609647131,MATH 103A,A02,083778,Staff,0,15,30,30
1650609647131,MATH 103A,B01,083779,Staff,0,14,30,30
1650609647131,MATH 103A,B02,083780,Staff,0,14,30,30
1650609653155,MATH 105,A01,085443,Staff,0,21,30,30
1650609659180,MATH 109,A01,083213,Anzaldo; Leesa B,0,6,30,30
1650609659180,MATH 109,A02,083214,Anzaldo; Leesa B,0,7,30,30
1650609659180,MATH 109,B01,083215,Anzaldo; Leesa B,0,6,30,30
1650609659180,MATH 109,B02,083216,Anzaldo; Leesa B,0,6,30,30
1650609665215,MATH 142A,A01,083219,Chow; Bennett,0,16,30,30
1650609665215,MATH 142A,A02,083220,Chow; Bennett,0,15,30,30
1650609665215,MATH 142A,B01,083221,Chow; Bennett,0,14,30,30
1650609665215,MATH 142A,B02,083222,Chow; Bennett,0,13,30,30
1650609671239,MATH 193A,A01,083224,Staff,0,5,30,30
1650609671239,MATH 193A,A02,083225,Staff,0,6,30,30
1650609671239,MATH 193A,A03,083781,Staff,0,6,30,30
1650609671239,MATH 193A,A04,083782,Staff,0,7,30,30
1650609677273,MATH 197,001,091859,McAuley; Julian John,9998,0,9999,1
1650609683333,COGS 9,A01,083615,Staff,0,14,60,60
1650609689359,COGS 11,A01,083617,Boyle; Mary E. T.,18,0,40,22
1650609695390,COGS 13,A01,083071,Staff,0,38,40,40
1650609701423,COGS 14A,A01,092681,Staff,0,29,100,100
1650609707449,COGS 14B,A01,083073,Cheng; Tzu-Han,0,13,50,50
1650609713475,COGS 17,A01,092677,Staff,17,0,75,58
1650609719502,COGS 100,A01,083619,Staff,0,26,60,60
1650609725529,COGS 101A,A01,083621,Davis; Joshua Daniel,0,26,60,60
1650609731563,COGS 101B,A01,091572,Staff,0,4,60,60
1650609737590,COGS 101C,A01,083625,Delgado; Tania,15,0,30,15
1650609743614,COGS 107A,A01,083627,Boyle; Mary E. T.,1,15,60,59
1650609749637,COGS 118A,A01,083075,Staff,0,5,60,60
1650609755661,CSE 3,A50,083646,Miranda; Gregory Joseph,19,0,38,19
1650609755661,CSE 3,A51,083647,Miranda; Gregory Joseph,36,0,37,1
1650609761687,CSE 8A,A50,083650,Miranda; Gregory Joseph,0,30,40,40
1650609767712,CSE 11,A01,083080,Cao; Yingjun,0,95,40,40
1650609773737,CSE 12,A01,083652,Staff,0,20,100,100
1650609779764,CSE 15L,A01,083654,Staff,0,2,50,50
1650609779764,CSE 15L,A02,083655,Staff,0,1,50,50
1650609785788,CSE 20,A01,083657,Staff,51,0,80,29
1650609791823,CSE 30,A01,083084,Eldon; John,0,78,40,40
1650609797847,CSE 100,A01,083659,Cao; Yingjun,0,68,50,50
1650609803871,CSE 134B,A01,083661,Powell; Thomas Allan,0,35,65,65
1650609809967,CSE 140,A01,083663,Staff,0,8,75,75
1650609815992,CSE 140L,A01,083088,Eldon; John,0,15,75,75
1650609822014,CSE 175,A01,083665,Kumar; Rakesh,7,0,25,18
1650609828037,CSE 190,A00,092507,Dubnov; Shlomo,10,0,20,10
1650609834063,ECE 45,A01,083139,Staff,0,1,60,60
1650609840095,ECE 65,A50,083695,Staff,0,5,30,30
1650609846121,ECE 109,A01,091882,Touri; Behrouz,33,0,70,37
1650609852145,ECE 180,A00,083140,Abi Samra; Nicholas Camill,21,0,30,9
1650609852145,ECE 180,B00,083141,Abi Samra; Nicholas Camill,0,0,30,30
1650609858172,MATH 10A,A01,083735,Patchell; Gregory David,4,0,30,26
1650609858172,MATH 10A,A02,083736,Patchell; Gregory David,27,0,30,3
1650609858172,MATH 10A,A03,083737,Patchell; Gregory David,24,0,30,6
1650609864198,MATH 10B,A01,083207,Staff,0,8,30,30
1650609864198,MATH 10B,A02,083208,Staff,0,8,30,30
1650609864198,MATH 10B,B01,083739,Staff,11,0,30,19
1650609864198,MATH 10B,B02,083740,Staff,28,0,30,2
1650609870227,MATH 18,A01,083743,Staff,0,0,30,30
1650609870227,MATH 18,A02,083744,Staff,23,0,30,7
1650609870227,MATH 18,A03,083745,Staff,21,0,30,9
1650609870227,MATH 18,A04,083746,Staff,26,0,30,4
1650609870227,MATH 18,B01,083748,Staff,0,15,30,30
1650609870227,MATH 18,B02,083749,Staff,0,11,30,30
1650609870227,MATH 18,B03,083750,Staff,0,12,30,30
1650609870227,MATH 18,B04,083751,Staff,0,12,30,30
1650609876250,MATH 20A,A01,083754,Staff,19,0,40,21
1650609882281,MATH 20B,A01,083756,Staff,0,12,30,30
1650609882281,MATH 20B,A02,083757,Staff,0,12,30,30
1650609888303,MATH 20C,A01,083760,Staff,0,15,30,30
1650609888303,MATH 20C,A02,083761,Staff,1,13,30,29
1650609888303,MATH 20C,B01,083762,Staff,11,0,30,19
1650609888303,MATH 20C,B02,083763,Staff,28,0,30,2
1650609894336,MATH 20D,A01,083765,Staff,1,1,30,29
1650609894336,MATH 20D,A02,083766,Staff,7,0,30,23
1650609894336,MATH 20D,A03,083767,Staff,24,0,30,6
1650609900365,MATH 20E,A01,083771,Staff,3,0,30,27
1650609900365,MATH 20E,A02,083772,Staff,17,0,30,13
1650609900365,MATH 20E,B01,083773,Staff,0,0,30,30
1650609900365,MATH 20E,B02,083774,Staff,9,0,30,21
1650609906398,MATH 103A,A01,083777,Staff,0,15,30,30
1650609906398,MATH 103A,A02,083778,Staff,0,15,30,30
1650609906398,MATH 103A,B01,083779,Staff,0,14,30,30
1650609906398,MATH 103A,B02,083780,Staff,0,14,30,30
1650609912429,MATH 105,A01,085443,Staff,0,21,30,30
1650609918457,MATH 109,A01,083213,Anzaldo; Leesa B,0,6,30,30
1650609918457,MATH 109,A02,083214,Anzaldo; Leesa B,0,7,30,30
1650609918457,MATH 109,B01,083215,Anzaldo; Leesa B,0,6,30,30
1650609918457,MATH 109,B02,083216,Anzaldo; Leesa B,0,6,30,30
1650609924481,MATH 142A,A01,083219,Chow; Bennett,0,16,30,30
1650609924481,MATH 142A,A02,083220,Chow; Bennett,0,15,30,30
1650609924481,MATH 142A,B01,083221,Chow; Bennett,0,14,30,30
1650609924481,MATH 142A,B02,083222,Chow; Bennett,0,13,30,30
1650609930509,MATH 193A,A01,083224,Staff,0,5,30,30
1650609930509,MATH 193A,A02,083225,Staff,0,6,30,30
1650609930509,MATH 193A,A03,083781,Staff,0,6,30,30
1650609930509,MATH 193A,A04,083782,Staff,0,7,30,30
1650609936547,MATH 197,001,091859,McAuley; Julian John,9998,0,9999,1
1650609942595,COGS 9,A01,083615,Staff,0,14,60,60
1650609948619,COGS 11,A01,083617,Boyle; Mary E. T.,18,0,40,22
1650609954643,COGS 13,A01,083071,Staff,0,38,40,40
1650609960673,COGS 14A,A01,092681,Staff,0,29,100,100
1650609966700,COGS 14B,A01,083073,Cheng; Tzu-Han,0,13,50,50
1650609972730,COGS 17,A01,092677,Staff,17,0,75,58
1650609978763,COGS 100,A01,083619,Staff,0,26,60,60
1650609984790,COGS 101A,A01,083621,Davis; Joshua Daniel,0,26,60,60
1650609990812,COGS 101B,A01,091572,Staff,0,4,60,60
1650609996838,COGS 101C,A01,083625,Delgado; Tania,15,0,30,15
1650610002863,COGS 107A,A01,083627,Boyle; Mary E. T.,1,15,60,59
1650610008885,COGS 118A,A01,083075,Staff,0,5,60,60
1650610014914,CSE 3,A50,083646,Miranda; Gregory Joseph,19,0,38,19
1650610014914,CSE 3,A51,083647,Miranda; Gregory Joseph,36,0,37,1
1650610020938,CSE 8A,A50,083650,Miranda; Gregory Joseph,0,30,40,40
1650610026964,CSE 11,A01,083080,Cao; Yingjun,0,95,40,40
1650610033001,CSE 12,A01,083652,Staff,0,20,100,100
1650610039023,CSE 15L,A01,083654,Staff,0,2,50,50
1650610039023,CSE 15L,A02,083655,Staff,0,1,50,50
1650610045047,CSE 20,A01,083657,Staff,51,0,80,29
1650610051078,CSE 30,A01,083084,Eldon; John,0,78,40,40
1650610057103,CSE 100,A01,083659,Cao; Yingjun,0,68,50,50
1650610063126,CSE 134B,A01,083661,Powell; Thomas Allan,0,35,65,65
1650610069150,CSE 140,A01,083663,Staff,0,8,75,75
1650610075176,CSE 140L,A01,083088,Eldon; John,0,15,75,75
1650610081204,CSE 175,A01,083665,Kumar; Rakesh,7,0,25,18
1650610087227,CSE 190,A00,092507,Dubnov; Shlomo,10,0,20,10
1650610093252,ECE 45,A01,083139,Staff,0,1,60,60
1650610099277,ECE 65,A50,083695,Staff,0,5,30,30
1650610105300,ECE 109,A01,091882,Touri; Behrouz,33,0,70,37
1650610111323,ECE 180,A00,083140,Abi Samra; Nicholas Camill,21,0,30,9
1650610111323,ECE 180,B00,083141,Abi Samra; Nicholas Camill,0,0,30,30
1650610117355,MATH 10A,A01,083735,Patchell; Gregory David,4,0,30,26
1650610117355,MATH 10A,A02,083736,Patchell; Gregory David,27,0,30,3
1650610117355,MATH 10A,A03,083737,Patchell; Gregory David,24,0,30,6
1650610123377,MATH 10B,A01,083207,Staff,0,8,30,30
1650610123377,MATH 10B,A02,083208,Staff,0,8,30,30
1650610123377,MATH 10B,B01,083739,Staff,11,0,30,19
1650610123377,MATH 10B,B02,083740,Staff,28,0,30,2
1650610129408,MATH 18,A01,083743,Staff,0,0,30,30
1650610129408,MATH 18,A02,083744,Staff,23,0,30,7
1650610129408,MATH 18,A03,083745,Staff,21,0,30,9
1650610129408,MATH 18,A04,083746,Staff,26,0,30,4
1650610129408,MATH 18,B01,083748,Staff,0,15,30,30
1650610129408,MATH 18,B02,083749,Staff,0,11,30,30
1650610129408,MATH 18,B03,083750,Staff,0,12,30,30
1650610129408,MATH 18,B04,083751,Staff,0,12,30,30
1650610135434,MATH 20A,A01,083754,Staff,19,0,40,21
1650610141463,MATH 20B,A01,083756,Staff,0,12,30,30
1650610141463,MATH 20B,A02,083757,Staff,0,12,30,30
1650610147487,MATH 20C,A01,083760,Staff,0,15,30,30
1650610147487,MATH 20C,A02,083761,Staff,1,13,30,29
1650610147487,MATH 20C,B01,083762,Staff,11,0,30,19
1650610147487,MATH 20C,B02,083763,Staff,28,0,30,2
1650610153513,MATH 20D,A01,083765,Staff,1,1,30,29
1650610153513,MATH 20D,A02,083766,Staff,7,0,30,23
1650610153513,MATH 20D,A03,083767,Staff,24,0,30,6
1650610159535,MATH 20E,A01,083771,Staff,3,0,30,27
1650610159535,MATH 20E,A02,083772,Staff,17,0,30,13
1650610159535,MATH 20E,B01,083773,Staff,0,0,30,30
1650610159535,MATH 20E,B02,083774,Staff,9,0,30,21
1650610165559,MATH 103A,A01,083777,Staff,0,15,30,30
1650610165559,MATH 103A,A02,083778,Staff,0,15,30,30
1650610165559,MATH 103A,B01,083779,Staff,0,14,30,30
1650610165559,MATH 103A,B02,083780,Staff,0,14,30,30
1650610171581,MATH 105,A01,085443,Staff,0,21,30,30
1650610177610,MATH 109,A01,083213,Anzaldo; Leesa B,0,6,30,30
1650610177610,MATH 109,A02,083214,Anzaldo; Leesa B,0,7,30,30
1650610177610,MATH 109,B01,083215,Anzaldo; Leesa B,0,6,30,30
1650610177610,MATH 109,B02,083216,Anzaldo; Leesa B,0,6,30,30
1650610183635,MATH 142A,A01,083219,Chow; Bennett,0,16,30,30
1650610183635,MATH 142A,A02,083220,Chow; Bennett,0,15,30,30
1650610183635,MATH 142A,B01,083221,Chow; Bennett,0,14,30,30
1650610183635,MATH 142A,B02,083222,Chow; Bennett,0,13,30,30
1650610189676,MATH 193A,A01,083224,Staff,0,5,30,30
1650610189676,MATH 193A,A02,083225,Staff,0,6,30,30
1650610189676,MATH 193A,A03,083781,Staff,0,6,30,30
1650610189676,MATH 193A,A04,083782,Staff,0,7,30,30
1650610195699,MATH 197,001,091859,McAuley; Julian John,9998,0,9999,1
1650610201760,COGS 9,A01,083615,Staff,0,14,60,60
1650610207785,COGS 11,A01,083617,Boyle; Mary E. T.,18,0,40,22
1650610213812,COGS 13,A01,083071,Staff,0,38,40,40
1650610219836,COGS 14A,A01,092681,Staff,0,29,100,100
1650610225860,COGS 14B,A01,083073,Cheng; Tzu-Han,0,13,50,50
1650610231887,COGS 17,A01,092677,Staff,17,0,75,58
1650610237909,COGS 100,A01,083619,Staff,0,26,60,60
1650610243933,COGS 101A,A01,083621,Davis; Joshua Daniel,0,26,60,60
1650610249955,COGS 101B,A01,091572,Staff,0,4,60,60
1650610255978,COGS 101C,A01,083625,Delgado; Tania,15,0,30,15
1650610262001,COGS 107A,A01,083627,Boyle; Mary E. T.,1,15,60,59
1650610268025,COGS 118A,A01,083075,Staff,0,5,60,60
1650610274054,CSE 3,A50,083646,Miranda; Gregory Joseph,19,0,38,19
1650610274054,CSE 3,A51,083647,Miranda; Gregory Joseph,36,0,37,1
1650610280082,CSE 8A,A50,083650,Miranda; Gregory Joseph,0,30,40,40
1650610286105,CSE 11,A01,083080,Cao; Yingjun,0,95,40,40
1650610292133,CSE 12,A01,083652,Staff,0,20,100,100
1650610298156,CSE 15L,A01,083654,Staff,0,2,50,50
1650610298156,CSE 15L,A02,083655,Staff,0,1,50,50
1650610304184,CSE 20,A01,083657,Staff,51,0,80,29
1650610310211,CSE 30,A01,083084,Eldon; John,0,78,40,40
1650610316237,CSE 100,A01,083659,Cao; Yingjun,0,68,50,50
1650610322261,CSE 134B,A01,083661,Powell; Thomas Allan,0,35,65,65
1650610328288,CSE 140,A01,083663,Staff,0,8,75,75
1650610334315,CSE 140L,A01,083088,Eldon; John,0,15,75,75
1650610340338,CSE 175,A01,083665,Kumar; Rakesh,7,0,25,18
1650610346367,CSE 190,A00,092507,Dubnov; Shlomo,10,0,20,10
1650610352392,ECE 45,A01,083139,Staff,0,1,60,60
1650610358419,ECE 65,A50,083695,Staff,0,5,30,30
1650610364443,ECE 109,A01,091882,Touri; Behrouz,33,0,70,37
1650610370467,ECE 180,A00,083140,Abi Samra; Nicholas Camill,21,0,30,9
1650610370467,ECE 180,B00,083141,Abi Samra; Nicholas Camill,0,0,30,30
1650610376493,MATH 10A,A01,083735,Patchell; Gregory David,4,0,30,26
1650610376493,MATH 10A,A02,083736,Patchell; Gregory David,27,0,30,3
1650610376493,MATH 10A,A03,083737,Patchell; Gregory David,24,0,30,6
1650610382521,MATH 10B,A01,083207,Staff,0,8,30,30
1650610382521,MATH 10B,A02,083208,Staff,0,8,30,30
1650610382521,MATH 10B,B01,083739,Staff,11,0,30,19
1650610382521,MATH 10B,B02,083740,Staff,28,0,30,2
1650610388546,MATH 18,A01,083743,Staff,0,0,30,30
1650610388546,MATH 18,A02,083744,Staff,23,0,30,7
1650610388546,MATH 18,A03,083745,Staff,21,0,30,9
1650610388546,MATH 18,A04,083746,Staff,26,0,30,4
1650610388546,MATH 18,B01,083748,Staff,0,15,30,30
1650610388546,MATH 18,B02,083749,Staff,0,11,30,30
1650610388546,MATH 18,B03,083750,Staff,0,12,30,30
1650610388546,MATH 18,B04,083751,Staff,0,12,30,30
1650610394569,MATH 20A,A01,083754,Staff,19,0,40,21
1650610400593,MATH 20B,A01,083756,Staff,0,12,30,30
1650610400593,MATH 20B,A02,083757,Staff,0,12,30,30
1650610406720,MATH 20C,A01,083760,Staff,0,15,30,30
1650610406720,MATH 20C,A02,083761,Staff,1,13,30,29
1650610406720,MATH 20C,B01,083762,Staff,11,0,30,19
1650610406720,MATH 20C,B02,083763,Staff,28,0,30,2
1650610412744,MATH 20D,A01,083765,Staff,1,1,30,29
1650610412744,MATH 20D,A02,083766,Staff,7,0,30,23
1650610412744,MATH 20D,A03,083767,Staff,24,0,30,6
1650610418767,MATH 20E,A01,083771,Staff,3,0,30,27
1650610418767,MATH 20E,A02,083772,Staff,17,0,30,13
1650610418767,MATH 20E,B01,083773,Staff,0,0,30,30
1650610418767,MATH 20E,B02,083774,Staff,9,0,30,21
1650610424794,MATH 103A,A01,083777,Staff,0,15,30,30
1650610424794,MATH 103A,A02,083778,Staff,0,15,30,30
1650610424794,MATH 103A,B01,083779,Staff,0,14,30,30
1650610424794,MATH 103A,B02,083780,Staff,0,14,30,30
1650610430816,MATH 105,A01,085443,Staff,0,21,30,30
1650610436839,MATH 109,A01,083213,Anzaldo; Leesa B,0,6,30,30
1650610436839,MATH 109,A02,083214,Anzaldo; Leesa B,0,7,30,30
1650610436839,MATH 109,B01,083215,Anzaldo; Leesa B,0,6,30,30
1650610436839,MATH 109,B02,083216,Anzaldo; Leesa B,0,6,30,30
1650610442866,MATH 142A,A01,083219,Chow; Bennett,0,16,30,30
1650610442866,MATH 142A,A02,083220,Chow; Bennett,0,15,30,30
1650610442866,MATH 142A,B01,083221,Chow; Bennett,0,14,30,30
1650610442866,MATH 142A,B02,083222,Chow; Bennett,0,13,30,30
1650610448889,MATH 193A,A01,083224,Staff,0,5,30,30
1650610448889,MATH 193A,A02,083225,Staff,0,6,30,30
1650610448889,MATH 193A,A03,083781,Staff,0,6,30,30
1650610448889,MATH 193A,A04,083782,Staff,0,7,30,30
1650610454912,MATH 197,001,091859,McAuley; Julian John,9998,0,9999,1
1650610460969,COGS 9,A01,083615,Staff,0,14,60,60
1650610466994,COGS 11,A01,083617,Boyle; Mary E. T.,18,0,40,22
1650610473016,COGS 13,A01,083071,Staff,0,38,40,40
1650610479042,COGS 14A,A01,092681,Staff,0,29,100,100
1650610485066,COGS 14B,A01,083073,Cheng; Tzu-Han,0,13,50,50
1650610491091,COGS 17,A01,092677,Staff,17,0,75,58
1650610497114,COGS 100,A01,083619,Staff,0,26,60,60
1650610503142,COGS 101A,A01,083621,Davis; Joshua Daniel,0,26,60,60
1650610509168,COGS 101B,A01,091572,Staff,0,4,60,60
1650610515191,COGS 101C,A01,083625,Delgado; Tania,15,0,30,15
1650610521228,COGS 107A,A01,083627,Boyle; Mary E. T.,1,15,60,59
1650610527261,COGS 118A,A01,083075,Staff,0,5,60,60
1650610533285,CSE 3,A50,083646,Miranda; Gregory Joseph,19,0,38,19
1650610533285,CSE 3,A51,083647,Miranda; Gregory Joseph,36,0,37,1
1650610539309,CSE 8A,A50,083650,Miranda; Gregory Joseph,0,30,40,40
1650610545336,CSE 11,A01,083080,Cao; Yingjun,0,95,40,40
1650610551359,CSE 12,A01,083652,Staff,0,20,100,100
1650610557383,CSE 15L,A01,083654,Staff,0,2,50,50
1650610557383,CSE 15L,A02,083655,Staff,0,1,50,50
1650610563411,CSE 20,A01,083657,Staff,51,0,80,29
1650610569440,CSE 30,A01,083084,Eldon; John,0,78,40,40
1650610575471,CSE 100,A01,083659,Cao; Yingjun,0,68,50,50
1650610581498,CSE 134B,A01,083661,Powell; Thomas Allan,0,35,65,65
1650610587523,CSE 140,A01,083663,Staff,0,8,75,75
1650610593547,CSE 140L,A01,083088,Eldon; John,0,15,75,75
1650610599573,CSE 175,A01,083665,Kumar; Rakesh,7,0,25,18
1650610605597,CSE 190,A00,092507,Dubnov; Shlomo,10,0,20,10
1650610611628,ECE 45,A01,083139,Staff,0,1,60,60
1650610617656,ECE 65,A50,083695,Staff,0,5,30,30
1650610623681,ECE 109,A01,091882,Touri; Behrouz,33,0,70,37
1650610629706,ECE 180,A00,083140,Abi Samra; Nicholas Camill,21,0,30,9
1650610629706,ECE 180,B00,083141,Abi Samra; Nicholas Camill,0,0,30,30
1650610635741,MATH 10A,A01,083735,Patchell; Gregory David,4,0,30,26
1650610635741,MATH 10A,A02,083736,Patchell; Gregory David,27,0,30,3
1650610635741,MATH 10A,A03,083737,Patchell; Gregory David,24,0,30,6
1650610641768,MATH 10B,A01,083207,Staff,0,8,30,30
1650610641768,MATH 10B,A02,083208,Staff,0,8,30,30
1650610641768,MATH 10B,B01,083739,Staff,11,0,30,19
1650610641768,MATH 10B,B02,083740,Staff,28,0,30,2
1650610647798,MATH 18,A01,083743,Staff,0,0,30,30
1650610647798,MATH 18,A02,083744,Staff,23,0,30,7
1650610647798,MATH 18,A03,083745,Staff,21,0,30,9
1650610647798,MATH 18,A04,083746,Staff,26,0,30,4
1650610647798,MATH 18,B01,083748,Staff,0,15,30,30
1650610647798,MATH 18,B02,083749,Staff,0,11,30,30
1650610647798,MATH 18,B03,083750,Staff,0,12,30,30
1650610647798,MATH 18,B04,083751,Staff,0,12,30,30
1650610653822,MATH 20A,A01,083754,Staff,19,0,40,21
1650610659856,MATH 20B,A01,083756,Staff,0,12,30,30
1650610659856,MATH 20B,A02,083757,Staff,0,12,30,30
1650610665885,MATH 20C,A01,083760,Staff,0,15,30,30
1650610665885,MATH 20C,A02,083761,Staff,1,13,30,29
1650610665885,MATH 20C,B01,083762,Staff,11,0,30,19
1650610665885,MATH 20C,B02,083763,Staff,28,0,30,2
1650610671910,MATH 20D,A01,083765,Staff,1,1,30,29
1650610671910,MATH 20D,A02,083766,Staff,7,0,30,23
1650610671910,MATH 20D,A03,083767,Staff,24,0,30,6
1650610677935,MATH 20E,A01,083771,Staff,3,0,30,27
1650610677935,MATH 20E,A02,083772,Staff,17,0,30,13
1650610677935,MATH 20E,B01,083773,Staff,0,0,30,30
1650610677935,MATH 20E,B02,083774,Staff,9,0,30,21
1650610683962,MATH 103A,A01,083777,Staff,0,15,30,30
1650610683962,MATH 103A,A02,083778,Staff,0,15,30,30
1650610683962,MATH 103A,B01,083779,Staff,0,14,30,30
1650610683962,MATH 103A,B02,083780,Staff,0,14,30,30
1650610689990,MATH 105,A01,085443,Staff,0,21,30,30
1650610696018,MATH 109,A01,083213,Anzaldo; Leesa B,0,6,30,30
1650610696018,MATH 109,A02,083214,Anzaldo; Leesa B,0,7,30,30
1650610696018,MATH 109,B01,083215,Anzaldo; Leesa B,0,6,30,30
1650610696018,MATH 109,B02,083216,Anzaldo; Leesa B,0,6,30,30
1650610702044,MATH 142A,A01,083219,Chow; Bennett,0,16,30,30
1650610702044,MATH 142A,A02,083220,Chow; Bennett,0,15,30,30
1650610702044,MATH 142A,B01,083221,Chow; Bennett,0,14,30,30
1650610702044,MATH 142A,B02,083222,Chow; Bennett,0,13,30,30
1650610708076,MATH 193A,A01,083224,Staff,0,5,30,30
1650610708076,MATH 193A,A02,083225,Staff,0,6,30,30
1650610708076,MATH 193A,A03,083781,Staff,0,6,30,30
1650610708076,MATH 193A,A04,083782,Staff,0,7,30,30
1650610714098,MATH 197,001,091859,McAuley; Julian John,9998,0,9999,1
1650610720150,COGS 9,A01,083615,Staff,0,14,60,60
1650610726174,COGS 11,A01,083617,Boyle; Mary E. T.,18,0,40,22
1650610732199,COGS 13,A01,083071,Staff,0,38,40,40
1650610738221,COGS 14A,A01,092681,Staff,0,29,100,100
1650610744245,COGS 14B,A01,083073,Cheng; Tzu-Han,0,13,50,50
1650610750267,COGS 17,A01,092677,Staff,17,0,75,58
1650610756293,COGS 100,A01,083619,Staff,0,26,60,60
1650610762321,COGS 101A,A01,083621,Davis; Joshua Daniel,0,26,60,60
1650610768344,COGS 101B,A01,091572,Staff,0,4,60,60
1650610774366,COGS 101C,A01,083625,Delgado; Tania,15,0,30,15
1650610780389,COGS 107A,A01,083627,Boyle; Mary E. T.,1,15,60,59
1650610786416,COGS 118A,A01,083075,Staff,0,5,60,60
1650610792443,CSE 3,A50,083646,Miranda; Gregory Joseph,19,0,38,19
1650610792443,CSE 3,A51,083647,Miranda; Gregory Joseph,36,0,37,1
1650610798490,CSE 8A,A50,083650,Miranda; Gregory Joseph,0,30,40,40
1650610804517,CSE 11,A01,083080,Cao; Yingjun,0,95,40,40
1650610810543,CSE 12,A01,083652,Staff,0,20,100,100
1650610816566,CSE 15L,A01,083654,Staff,0,2,50,50
1650610816566,CSE 15L,A02,083655,Staff,0,1,50,50
1650610822598,CSE 20,A01,083657,Staff,51,0,80,29
1650610828624,CSE 30,A01,083084,Eldon; John,0,78,40,40
1650610834649,CSE 100,A01,083659,Cao; Yingjun,0,68,50,50
1650610840672,CSE 134B,A01,083661,Powell; Thomas Allan,0,35,65,65
1650610846700,CSE 140,A01,083663,Staff,0,8,75,75
1650610852726,CSE 140L,A01,083088,Eldon; John,0,15,75,75
1650610858754,CSE 175,A01,083665,Kumar; Rakesh,7,0,25,18
1650610864783,CSE 190,A00,092507,Dubnov; Shlomo,10,0,20,10
1650610870809,ECE 45,A01,083139,Staff,0,1,60,60
1650610876833,ECE 65,A50,083695,Staff,0,5,30,30
1650610882858,ECE 109,A01,091882,Touri; Behrouz,33,0,70,37
1650610888883,ECE 180,A00,083140,Abi Samra; Nicholas Camill,21,0,30,9
1650610888883,ECE 180,B00,083141,Abi Samra; Nicholas Camill,0,0,30,30
1650610894913,MATH 10A,A01,083735,Patchell; Gregory David,4,0,30,26
1650610894913,MATH 10A,A02,083736,Patchell; Gregory David,27,0,30,3
1650610894913,MATH 10A,A03,083737,Patchell; Gregory David,24,0,30,6
1650610900946,MATH 10B,A01,083207,Staff,0,8,30,30
1650610900946,MATH 10B,A02,083208,Staff,0,8,30,30
1650610900946,MATH 10B,B01,083739,Staff,11,0,30,19
1650610900946,MATH 10B,B02,083740,Staff,28,0,30,2
1650610906973,MATH 18,A01,083743,Staff,0,0,30,30
1650610906973,MATH 18,A02,083744,Staff,23,0,30,7
1650610906973,MATH 18,A03,083745,Staff,21,0,30,9
1650610906973,MATH 18,A04,083746,Staff,26,0,30,4
1650610906973,MATH 18,B01,083748,Staff,0,15,30,30
1650610906973,MATH 18,B02,083749,Staff,0,11,30,30
1650610906973,MATH 18,B03,083750,Staff,0,12,30,30
1650610906973,MATH 18,B04,083751,Staff,0,12,30,30
1650610913005,MATH 20A,A01,083754,Staff,19,0,40,21
1650610919030,MATH 20B,A01,083756,Staff,0,12,30,30
1650610919030,MATH 20B,A02,083757,Staff,0,12,30,30
1650610925069,MATH 20C,A01,083760,Staff,0,15,30,30
1650610925069,MATH 20C,A02,083761,Staff,1,13,30,29
1650610925069,MATH 20C,B01,083762,Staff,11,0,30,19
1650610925069,MATH 20C,B02,083763,Staff,28,0,30,2
1650610931100,MATH 20D,A01,083765,Staff,1,1,30,29
1650610931100,MATH 20D,A02,083766,Staff,7,0,30,23
1650610931100,MATH 20D,A03,083767,Staff,24,0,30,6
1650610937124,MATH 20E,A01,083771,Staff,3,0,30,27
1650610937124,MATH 20E,A02,083772,Staff,17,0,30,13
1650610937124,MATH 20E,B01,083773,Staff,0,0,30,30
1650610937124,MATH 20E,B02,083774,Staff,9,0,30,21
1650610943151,MATH 103A,A01,083777,Staff,0,15,30,30
1650610943151,MATH 103A,A02,083778,Staff,0,15,30,30
1650610943151,MATH 103A,B01,083779,Staff,0,14,30,30
1650610943151,MATH 103A,B02,083780,Staff,0,14,30,30
1650610949190,MATH 105,A01,085443,Staff,0,21,30,30
1650610955223,MATH 109,A01,083213,Anzaldo; Leesa B,0,6,30,30
1650610955223,MATH 109,A02,083214,Anzaldo; Leesa B,0,7,30,30
1650610955223,MATH 109,B01,083215,Anzaldo; Leesa B,0,6,30,30
1650610955223,MATH 109,B02,083216,Anzaldo; Leesa B,0,6,30,30
1650610961248,MATH 142A,A01,083219,Chow; Bennett,0,16,30,30
1650610961248,MATH 142A,A02,083220,Chow; Bennett,0,15,30,30
1650610961248,MATH 142A,B01,083221,Chow; Bennett,0,14,30,30
1650610961248,MATH 142A,B02,083222,Chow; Bennett,0,13,30,30
1650610967281,MATH 193A,A01,083224,Staff,0,5,30,30
1650610967281,MATH 193A,A02,083225,Staff,0,6,30,30
1650610967281,MATH 193A,A03,083781,Staff,0,6,30,30
1650610967281,MATH 193A,A04,083782,Staff,0,7,30,30
1650610973307,MATH 197,001,091859,McAuley; Julian John,9998,0,9999,1
1650610979369,COGS 9,A01,083615,Staff,0,14,60,60
1650610985394,COGS 11,A01,083617,Boyle; Mary E. T.,18,0,40,22
1650610991426,COGS 13,A01,083071,Staff,0,38,40,40
1650610997523,COGS 14A,A01,092681,Staff,0,29,100,100
1650611003548,COGS 14B,A01,083073,Cheng; Tzu-Han,0,13,50,50
1650611009571,COGS 17,A01,092677,Staff,17,0,75,58
1650611015603,COGS 100,A01,083619,Staff,0,26,60,60
1650611021632,COGS 101A,A01,083621,Davis; Joshua Daniel,0,26,60,60
1650611027657,COGS 101B,A01,091572,Staff,0,4,60,60
1650611033681,COGS 101C,A01,083625,Delgado; Tania,15,0,30,15
1650611039722,COGS 107A,A01,083627,Boyle; Mary E. T.,1,15,60,59
1650611045744,COGS 118A,A01,083075,Staff,0,5,60,60
1650611051769,CSE 3,A50,083646,Miranda; Gregory Joseph,19,0,38,19
1650611051769,CSE 3,A51,083647,Miranda; Gregory Joseph,36,0,37,1
1650611057794,CSE 8A,A50,083650,Miranda; Gregory Joseph,0,30,40,40
1650611063824,CSE 11,A01,083080,Cao; Yingjun,0,95,40,40
1650611069855,CSE 12,A01,083652,Staff,0,19,100,100
1650611075879,CSE 15L,A01,083654,Staff,0,2,50,50
1650611075879,CSE 15L,A02,083655,Staff,0,1,50,50
1650611081912,CSE 20,A01,083657,Staff,51,0,80,29
1650611087939,CSE 30,A01,083084,Eldon; John,0,78,40,40
1650611093964,CSE 100,A01,083659,Cao; Yingjun,0,68,50,50
1650611099987,CSE 134B,A01,083661,Powell; Thomas Allan,0,35,65,65
1650611106015,CSE 140,A01,083663,Staff,0,8,75,75
1650611112039,CSE 140L,A01,083088,Eldon; John,0,15,75,75
1650611118062,CSE 175,A01,083665,Kumar; Rakesh,7,0,25,18
1650611124084,CSE 190,A00,092507,Dubnov; Shlomo,10,0,20,10
1650611130110,ECE 45,A01,083139,Staff,0,1,60,60
1650611136134,ECE 65,A50,083695,Staff,0,5,30,30
1650611142161,ECE 109,A01,091882,Touri; Behrouz,33,0,70,37
1650611148184,ECE 180,A00,083140,Abi Samra; Nicholas Camill,21,0,30,9
1650611148184,ECE 180,B00,083141,Abi Samra; Nicholas Camill,0,0,30,30
1650611154208,MATH 10A,A01,083735,Patchell; Gregory David,4,0,30,26
1650611154208,MATH 10A,A02,083736,Patchell; Gregory David,27,0,30,3
1650611154208,MATH 10A,A03,083737,Patchell; Gregory David,24,0,30,6
1650611160263,MATH 10B,A01,083207,Staff,0,8,30,30
1650611160263,MATH 10B,A02,083208,Staff,0,8,30,30
1650611160263,MATH 10B,B01,083739,Staff,11,0,30,19
1650611160263,MATH 10B,B02,083740,Staff,28,0,30,2
1650611166295,MATH 18,A01,083743,Staff,0,0,30,30
1650611166295,MATH 18,A02,083744,Staff,23,0,30,7
1650611166295,MATH 18,A03,083745,Staff,21,0,30,9
1650611166295,MATH 18,A04,083746,Staff,26,0,30,4
1650611166295,MATH 18,B01,083748,Staff,0,15,30,30
1650611166295,MATH 18,B02,083749,Staff,0,11,30,30
1650611166295,MATH 18,B03,083750,Staff,0,12,30,30
1650611166295,MATH 18,B04,083751,Staff,0,12,30,30
1650611172319,MATH 20A,A01,083754,Staff,19,0,40,21
1650611178343,MATH 20B,A01,083756,Staff,0,12,30,30
1650611178343,MATH 20B,A02,083757,Staff,0,12,30,30
1650611184367,MATH 20C,A01,083760,Staff,0,15,30,30
1650611184367,MATH 20C,A02,083761,Staff,1,13,30,29
1650611184367,MATH 20C,B01,083762,Staff,11,0,30,19
1650611184367,MATH 20C,B02,083763,Staff,28,0,30,2
1650611190391,MATH 20D,A01,083765,Staff,1,1,30,29
1650611190391,MATH 20D,A02,083766,Staff,7,0,30,23
1650611190391,MATH 20D,A03,083767,Staff,24,0,30,6
1650611196420,MATH 20E,A01,083771,Staff,3,0,30,27
1650611196420,MATH 20E,A02,083772,Staff,17,0,30,13
1650611196420,MATH 20E,B01,083773,Staff,0,0,30,30
1650611196420,MATH 20E,B02,083774,Staff,9,0,30,21
1650611202454,MATH 103A,A01,083777,Staff,0,15,30,30
1650611202454,MATH 103A,A02,083778,Staff,0,15,30,30
1650611202454,MATH 103A,B01,083779,Staff,0,14,30,30
1650611202454,MATH 103A,B02,083780,Staff,0,14,30,30
1650611208481,MATH 105,A01,085443,Staff,0,21,30,30
1650611214507,MATH 109,A01,083213,Anzaldo; Leesa B,0,6,30,30
1650611214507,MATH 109,A02,083214,Anzaldo; Leesa B,0,7,30,30
1650611214507,MATH 109,B01,083215,Anzaldo; Leesa B,0,6,30,30
1650611214507,MATH 109,B02,083216,Anzaldo; Leesa B,0,6,30,30
1650611220531,MATH 142A,A01,083219,Chow; Bennett,0,16,30,30
1650611220531,MATH 142A,A02,083220,Chow; Bennett,0,15,30,30
1650611220531,MATH 142A,B01,083221,Chow; Bennett,0,14,30,30
1650611220531,MATH 142A,B02,083222,Chow; Bennett,0,13,30,30
1650611226566,MATH 193A,A01,083224,Staff,0,5,30,30
1650611226566,MATH 193A,A02,083225,Staff,0,6,30,30
1650611226566,MATH 193A,A03,083781,Staff,0,6,30,30
1650611226566,MATH 193A,A04,083782,Staff,0,7,30,30
1650611232591,MATH 197,001,091859,McAuley; Julian John,9998,0,9999,1
1650611238651,COGS 9,A01,083615,Staff,0,14,60,60
1650611244689,COGS 11,A01,083617,Boyle; Mary E. T.,18,0,40,22
1650611250714,COGS 13,A01,083071,Staff,0,38,40,40
1650611256738,COGS 14A,A01,092681,Staff,0,29,100,100
1650611262761,COGS 14B,A01,083073,Cheng; Tzu-Han,0,13,50,50
1650611268789,COGS 17,A01,092677,Staff,17,0,75,58
1650611274811,COGS 100,A01,083619,Staff,0,26,60,60
1650611280845,COGS 101A,A01,083621,Davis; Joshua Daniel,0,26,60,60
1650611286874,COGS 101B,A01,091572,Staff,0,4,60,60
1650611292897,COGS 101C,A01,083625,Delgado; Tania,15,0,30,15
1650611298928,COGS 107A,A01,083627,Boyle; Mary E. T.,1,15,60,59
1650611304954,COGS 118A,A01,083075,Staff,0,5,60,60
1650611310978,CSE 3,A50,083646,Miranda; Gregory Joseph,19,0,38,19
1650611310978,CSE 3,A51,083647,Miranda; Gregory Joseph,36,0,37,1
1650611317029,CSE 8A,A50,083650,Miranda; Gregory Joseph,0,30,40,40
1650611323053,CSE 11,A01,083080,Cao; Yingjun,0,95,40,40
1650611329114,CSE 12,A01,083652,Staff,0,19,100,100
1650611335138,CSE 15L,A01,083654,Staff,0,2,50,50
1650611335138,CSE 15L,A02,083655,Staff,0,1,50,50
1650611341161,CSE 20,A01,083657,Staff,51,0,80,29
1650611347190,CSE 30,A01,083084,Eldon; John,0,78,40,40
1650611353214,CSE 100,A01,083659,Cao; Yingjun,0,68,50,50
1650611359243,CSE 134B,A01,083661,Powell; Thomas Allan,0,35,65,65
1650611365277,CSE 140,A01,083663,Staff,0,8,75,75
1650611371301,CSE 140L,A01,083088,Eldon; John,0,15,75,75
1650611377329,CSE 175,A01,083665,Kumar; Rakesh,7,0,25,18
1650611383358,CSE 190,A00,092507,Dubnov; Shlomo,10,0,20,10
1650611389382,ECE 45,A01,083139,Staff,0,1,60,60
1650611395407,ECE 65,A50,083695,Staff,0,5,30,30
1650611401432,ECE 109,A01,091882,Touri; Behrouz,33,0,70,37
1650611407463,ECE 180,A00,083140,Abi Samra; Nicholas Camill,21,0,30,9
1650611407463,ECE 180,B00,083141,Abi Samra; Nicholas Camill,0,0,30,30
1650611413487,MATH 10A,A01,083735,Patchell; Gregory David,4,0,30,26
1650611413487,MATH 10A,A02,083736,Patchell; Gregory David,27,0,30,3
1650611413487,MATH 10A,A03,083737,Patchell; Gregory David,24,0,30,6
1650611419511,MATH 10B,A01,083207,Staff,0,8,30,30
1650611419511,MATH 10B,A02,083208,Staff,0,8,30,30
1650611419511,MATH 10B,B01,083739,Staff,11,0,30,19
1650611419511,MATH 10B,B02,083740,Staff,28,0,30,2
1650611425537,MATH 18,A01,083743,Staff,0,0,30,30
1650611425537,MATH 18,A02,083744,Staff,23,0,30,7
1650611425537,MATH 18,A03,083745,Staff,21,0,30,9
1650611425537,MATH 18,A04,083746,Staff,26,0,30,4
1650611425537,MATH 18,B01,083748,Staff,0,15,30,30
1650611425537,MATH 18,B02,083749,Staff,0,11,30,30
1650611425537,MATH 18,B03,083750,Staff,0,12,30,30
1650611425537,MATH 18,B04,083751,Staff,0,12,30,30
1650611431563,MATH 20A,A01,083754,Staff,19,0,40,21
1650611437591,MATH 20B,A01,083756,Staff,0,12,30,30
1650611437591,MATH 20B,A02,083757,Staff,0,12,30,30
1650611443616,MATH 20C,A01,083760,Staff,0,15,30,30
1650611443616,MATH 20C,A02,083761,Staff,1,13,30,29
1650611443616,MATH 20C,B01,083762,Staff,11,0,30,19
1650611443616,MATH 20C,B02,083763,Staff,28,0,30,2
1650611449641,MATH 20D,A01,083765,Staff,1,1,30,29
1650611449641,MATH 20D,A02,083766,Staff,7,0,30,23
1650611449641,MATH 20D,A03,083767,Staff,24,0,30,6
1650611455667,MATH 20E,A01,083771,Staff,3,0,30,27
1650611455667,MATH 20E,A02,083772,Staff,17,0,30,13
1650611455667,MATH 20E,B01,083773,Staff,0,0,30,30
1650611455667,MATH 20E,B02,083774,Staff,9,0,30,21
1650611461691,MATH 103A,A01,083777,Staff,0,15,30,30
1650611461691,MATH 103A,A02,083778,Staff,0,15,30,30
1650611461691,MATH 103A,B01,083779,Staff,0,14,30,30
1650611461691,MATH 103A,B02,083780,Staff,0,14,30,30
1650611467729,MATH 105,A01,085443,Staff,0,21,30,30
1650611473753,MATH 109,A01,083213,Anzaldo; Leesa B,0,6,30,30
1650611473753,MATH 109,A02,083214,Anzaldo; Leesa B,0,7,30,30
1650611473753,MATH 109,B01,083215,Anzaldo; Leesa B,0,6,30,30
1650611473753,MATH 109,B02,083216,Anzaldo; Leesa B,0,6,30,30
1650611479778,MATH 142A,A01,083219,Chow; Bennett,0,16,30,30
1650611479778,MATH 142A,A02,083220,Chow; Bennett,0,15,30,30
1650611479778,MATH 142A,B01,083221,Chow; Bennett,0,14,30,30
1650611479778,MATH 142A,B02,083222,Chow; Bennett,0,13,30,30
1650611485803,MATH 193A,A01,083224,Staff,0,5,30,30
1650611485803,MATH 193A,A02,083225,Staff,0,6,30,30
1650611485803,MATH 193A,A03,083781,Staff,0,6,30,30
1650611485803,MATH 193A,A04,083782,Staff,0,7,30,30
1650611491830,MATH 197,001,091859,McAuley; Julian John,9998,0,9999,1
1650611497915,COGS 9,A01,083615,Staff,0,14,60,60
1650611503943,COGS 11,A01,083617,Boyle; Mary E. T.,18,0,40,22
1650611509980,COGS 13,A01,083071,Staff,0,38,40,40
1650611516017,COGS 14A,A01,092681,Staff,0,30,100,100
1650611522054,COGS 14B,A01,083073,Cheng; Tzu-Han,0,13,50,50
1650611528082,COGS 17,A01,092677,Staff,17,0,75,58
1650611534107,COGS 100,A01,083619,Staff,0,26,60,60
1650611540149,COGS 101A,A01,083621,Davis; Joshua Daniel,0,26,60,60
1650611546175,COGS 101B,A01,091572,Staff,0,4,60,60
1650611552201,COGS 101C,A01,083625,Delgado; Tania,15,0,30,15
1650611558226,COGS 107A,A01,083627,Boyle; Mary E. T.,1,15,60,59
1650611564250,COGS 118A,A01,083075,Staff,0,5,60,60
1650611570284,CSE 3,A50,083646,Miranda; Gregory Joseph,19,0,38,19
1650611570284,CSE 3,A51,083647,Miranda; Gregory Joseph,36,0,37,1
1650611576315,CSE 8A,A50,083650,Miranda; Gregory Joseph,0,30,40,40
1650611582359,CSE 11,A01,083080,Cao; Yingjun,0,95,40,40
1650611588384,CSE 12,A01,083652,Staff,0,19,100,100
1650611594487,CSE 15L,A01,083654,Staff,0,2,50,50
1650611594487,CSE 15L,A02,083655,Staff,0,1,50,50
1650611600511,CSE 20,A01,083657,Staff,51,0,80,29
1650611606549,CSE 30,A01,083084,Eldon; John,0,78,40,40
1650611612573,CSE 100,A01,083659,Cao; Yingjun,0,68,50,50
1650611618613,CSE 134B,A01,083661,Powell; Thomas Allan,0,35,65,65
1650611624644,CSE 140,A01,083663,Staff,0,8,75,75
1650611630670,CSE 140L,A01,083088,Eldon; John,0,15,75,75
1650611636695,CSE 175,A01,083665,Kumar; Rakesh,7,0,25,18
1650611642720,CSE 190,A00,092507,Dubnov; Shlomo,10,0,20,10
1650611648749,ECE 45,A01,083139,Staff,0,1,60,60
1650611654775,ECE 65,A50,083695,Staff,0,5,30,30
1650611660805,ECE 109,A01,091882,Touri; Behrouz,33,0,70,37
1650611666839,ECE 180,A00,083140,Abi Samra; Nicholas Camill,21,0,30,9
1650611666839,ECE 180,B00,083141,Abi Samra; Nicholas Camill,0,0,30,30
1650611672872,MATH 10A,A01,083735,Patchell; Gregory David,4,0,30,26
1650611672872,MATH 10A,A02,083736,Patchell; Gregory David,27,0,30,3
1650611672872,MATH 10A,A03,083737,Patchell; Gregory David,24,0,30,6
1650611678904,MATH 10B,A01,083207,Staff,0,8,30,30
1650611678904,MATH 10B,A02,083208,Staff,0,8,30,30
1650611678904,MATH 10B,B01,083739,Staff,11,0,30,19
1650611678904,MATH 10B,B02,083740,Staff,28,0,30,2
1650611684949,MATH 18,A01,083743,Staff,0,0,30,30
1650611684949,MATH 18,A02,083744,Staff,23,0,30,7
1650611684949,MATH 18,A03,083745,Staff,21,0,30,9
1650611684949,MATH 18,A04,083746,Staff,26,0,30,4
1650611684949,MATH 18,B01,083748,Staff,0,15,30,30
1650611684949,MATH 18,B02,083749,Staff,0,11,30,30
1650611684949,MATH 18,B03,083750,Staff,0,12,30,30
1650611684949,MATH 18,B04,083751,Staff,0,12,30,30
1650611690977,MATH 20A,A01,083754,Staff,19,0,40,21
1650611697004,MATH 20B,A01,083756,Staff,0,12,30,30
1650611697004,MATH 20B,A02,083757,Staff,0,12,30,30
1650611703044,MATH 20C,A01,083760,Staff,0,15,30,30
1650611703044,MATH 20C,A02,083761,Staff,1,13,30,29
1650611703044,MATH 20C,B01,083762,Staff,11,0,30,19
1650611703044,MATH 20C,B02,083763,Staff,28,0,30,2
1650611709073,MATH 20D,A01,083765,Staff,1,1,30,29
1650611709073,MATH 20D,A02,083766,Staff,7,0,30,23
1650611709073,MATH 20D,A03,083767,Staff,24,0,30,6
1650611715099,MATH 20E,A01,083771,Staff,3,0,30,27
1650611715099,MATH 20E,A02,083772,Staff,17,0,30,13
1650611715099,MATH 20E,B01,083773,Staff,0,0,30,30
1650611715099,MATH 20E,B02,083774,Staff,9,0,30,21
1650611721123,MATH 103A,A01,083777,Staff,0,15,30,30
1650611721123,MATH 103A,A02,083778,Staff,0,15,30,30
1650611721123,MATH 103A,B01,083779,Staff,0,14,30,30
1650611721123,MATH 103A,B02,083780,Staff,0,14,30,30
1650611727148,MATH 105,A01,085443,Staff,0,21,30,30
1650611733177,MATH 109,A01,083213,Anzaldo; Leesa B,0,6,30,30
1650611733177,MATH 109,A02,083214,Anzaldo; Leesa B,0,7,30,30
1650611733177,MATH 109,B01,083215,Anzaldo; Leesa B,0,6,30,30
1650611733177,MATH 109,B02,083216,Anzaldo; Leesa B,0,6,30,30
1650611739204,MATH 142A,A01,083219,Chow; Bennett,0,16,30,30
1650611739204,MATH 142A,A02,083220,Chow; Bennett,0,15,30,30
1650611739204,MATH 142A,B01,083221,Chow; Bennett,0,14,30,30
1650611739204,MATH 142A,B02,083222,Chow; Bennett,0,13,30,30
1650611745232,MATH 193A,A01,083224,Staff,0,5,30,30
1650611745232,MATH 193A,A02,083225,Staff,0,6,30,30
1650611745232,MATH 193A,A03,083781,Staff,0,6,30,30
1650611745232,MATH 193A,A04,083782,Staff,0,7,30,30
1650611751258,MATH 197,001,091859,McAuley; Julian John,9998,0,9999,1
1650611757319,COGS 9,A01,083615,Staff,0,14,60,60
1650611763341,COGS 11,A01,083617,Boyle; Mary E. T.,18,0,40,22
1650611769369,COGS 13,A01,083071,Staff,0,38,40,40
1650611775397,COGS 14A,A01,092681,Staff,0,30,100,100
1650611781422,COGS 14B,A01,083073,Cheng; Tzu-Han,0,13,50,50
1650611787444,COGS 17,A01,092677,Staff,17,0,75,58
1650611793473,COGS 100,A01,083619,Staff,0,26,60,60
1650611799496,COGS 101A,A01,083621,Davis; Joshua Daniel,0,26,60,60
1650611805572,COGS 101B,A01,091572,Staff,0,4,60,60
1650611811651,COGS 101C,A01,083625,Delgado; Tania,15,0,30,15
1650611817686,COGS 107A,A01,083627,Boyle; Mary E. T.,1,15,60,59
1650611823714,COGS 118A,A01,083075,Staff,0,5,60,60
1650611829739,CSE 3,A50,083646,Miranda; Gregory Joseph,19,0,38,19
1650611829739,CSE 3,A51,083647,Miranda; Gregory Joseph,36,0,37,1
1650611835767,CSE 8A,A50,083650,Miranda; Gregory Joseph,0,30,40,40
1650611841796,CSE 11,A01,083080,Cao; Yingjun,0,95,40,40
1650611847833,CSE 12,A01,083652,Staff,0,19,100,100
1650611853861,CSE 15L,A01,083654,Staff,0,2,50,50
1650611853861,CSE 15L,A02,083655,Staff,0,1,50,50
1650611859884,CSE 20,A01,083657,Staff,51,0,80,29
1650611865910,CSE 30,A01,083084,Eldon; John,0,78,40,40
1650611871938,CSE 100,A01,083659,Cao; Yingjun,0,68,50,50
1650611877967,CSE 134B,A01,083661,Powell; Thomas Allan,0,35,65,65
1650611883999,CSE 140,A01,083663,Staff,0,8,75,75
1650611890025,CSE 140L,A01,083088,Eldon; John,0,15,75,75
1650611896064,CSE 175,A01,083665,Kumar; Rakesh,7,0,25,18
1650611902099,CSE 190,A00,092507,Dubnov; Shlomo,10,0,20,10
1650611908123,ECE 45,A01,083139,Staff,0,1,60,60
1650611914148,ECE 65,A50,083695,Staff,0,5,30,30
1650611920177,ECE 109,A01,091882,Touri; Behrouz,33,0,70,37
1650611926201,ECE 180,A00,083140,Abi Samra; Nicholas Camill,21,0,30,9
1650611926201,ECE 180,B00,083141,Abi Samra; Nicholas Camill,0,0,30,30
1650611932230,MATH 10A,A01,083735,Patchell; Gregory David,4,0,30,26
1650611932230,MATH 10A,A02,083736,Patchell; Gregory David,27,0,30,3
1650611932230,MATH 10A,A03,083737,Patchell; Gregory David,24,0,30,6
1650611938258,MATH 10B,A01,083207,Staff,0,8,30,30
1650611938258,MATH 10B,A02,083208,Staff,0,8,30,30
1650611938258,MATH 10B,B01,083739,Staff,11,0,30,19
1650611938258,MATH 10B,B02,083740,Staff,28,0,30,2
1650611944295,MATH 18,A01,083743,Staff,0,0,30,30
1650611944295,MATH 18,A02,083744,Staff,23,0,30,7
1650611944295,MATH 18,A03,083745,Staff,21,0,30,9
1650611944295,MATH 18,A04,083746,Staff,26,0,30,4
1650611944295,MATH 18,B01,083748,Staff,0,15,30,30
1650611944295,MATH 18,B02,083749,Staff,0,11,30,30
1650611944295,MATH 18,B03,083750,Staff,0,12,30,30
1650611944295,MATH 18,B04,083751,Staff,0,12,30,30
1650611950318,MATH 20A,A01,083754,Staff,19,0,40,21
1650611956348,MATH 20B,A01,083756,Staff,0,12,30,30
1650611956348,MATH 20B,A02,083757,Staff,0,12,30,30
1650611962373,MATH 20C,A01,083760,Staff,0,15,30,30
1650611962373,MATH 20C,A02,083761,Staff,1,13,30,29
1650611962373,MATH 20C,B01,083762,Staff,11,0,30,19
1650611962373,MATH 20C,B02,083763,Staff,28,0,30,2
1650611968399,MATH 20D,A01,083765,Staff,1,1,30,29
1650611968399,MATH 20D,A02,083766,Staff,7,0,30,23
1650611968399,MATH 20D,A03,083767,Staff,24,0,30,6
1650611974425,MATH 20E,A01,083771,Staff,3,0,30,27
1650611974425,MATH 20E,A02,083772,Staff,17,0,30,13
1650611974425,MATH 20E,B01,083773,Staff,0,0,30,30
1650611974425,MATH 20E,B02,083774,Staff,9,0,30,21
1650611980449,MATH 103A,A01,083777,Staff,0,15,30,30
1650611980449,MATH 103A,A02,083778,Staff,0,15,30,30
1650611980449,MATH 103A,B01,083779,Staff,0,14,30,30
1650611980449,MATH 103A,B02,083780,Staff,0,14,30,30
1650611986477,MATH 105,A01,085443,Staff,0,21,30,30
1650611992501,MATH 109,A01,083213,Anzaldo; Leesa B,0,6,30,30
1650611992501,MATH 109,A02,083214,Anzaldo; Leesa B,0,7,30,30
1650611992501,MATH 109,B01,083215,Anzaldo; Leesa B,0,6,30,30
1650611992501,MATH 109,B02,083216,Anzaldo; Leesa B,0,6,30,30
1650611998527,MATH 142A,A01,083219,Chow; Bennett,0,16,30,30
1650611998527,MATH 142A,A02,083220,Chow; Bennett,0,15,30,30
1650611998527,MATH 142A,B01,083221,Chow; Bennett,0,14,30,30
1650611998527,MATH 142A,B02,083222,Chow; Bennett,0,13,30,30
1650612004561,MATH 193A,A01,083224,Staff,0,5,30,30
1650612004561,MATH 193A,A02,083225,Staff,0,6,30,30
1650612004561,MATH 193A,A03,083781,Staff,0,6,30,30
1650612004561,MATH 193A,A04,083782,Staff,0,7,30,30
1650612010587,MATH 197,001,091859,McAuley; Julian John,9998,0,9999,1
1650612016653,COGS 9,A01,083615,Staff,0,14,60,60
1650612022679,COGS 11,A01,083617,Boyle; Mary E. T.,18,0,40,22
1650612028707,COGS 13,A01,083071,Staff,0,38,40,40
1650612034736,COGS 14A,A01,092681,Staff,0,30,100,100
1650612040764,COGS 14B,A01,083073,Cheng; Tzu-Han,0,13,50,50
1650612046788,COGS 17,A01,092677,Staff,17,0,75,58
1650612052826,COGS 100,A01,083619,Staff,0,26,60,60
1650612058855,COGS 101A,A01,083621,Davis; Joshua Daniel,0,26,60,60
1650612064884,COGS 101B,A01,091572,Staff,0,4,60,60
1650612070909,COGS 101C,A01,083625,Delgado; Tania,15,0,30,15
1650612076946,COGS 107A,A01,083627,Boyle; Mary E. T.,1,15,60,59
1650612082974,COGS 118A,A01,083075,Staff,0,5,60,60
1650612089010,CSE 3,A50,083646,Miranda; Gregory Joseph,19,0,38,19
1650612089010,CSE 3,A51,083647,Miranda; Gregory Joseph,36,0,37,1
1650612095036,CSE 8A,A50,083650,Miranda; Gregory Joseph,0,30,40,40
1650612101073,CSE 11,A01,083080,Cao; Yingjun,0,95,40,40
1650612107100,CSE 12,A01,083652,Staff,0,19,100,100
1650612113127,CSE 15L,A01,083654,Staff,0,2,50,50
1650612113127,CSE 15L,A02,083655,Staff,0,1,50,50
1650612119153,CSE 20,A01,083657,Staff,51,0,80,29
1650612125187,CSE 30,A01,083084,Eldon; John,0,78,40,40
1650612131214,CSE 100,A01,083659,Cao; Yingjun,0,68,50,50
1650612137245,CSE 134B,A01,083661,Powell; Thomas Allan,0,35,65,65
1650612143271,CSE 140,A01,083663,Staff,0,8,75,75
1650612149295,CSE 140L,A01,083088,Eldon; John,0,15,75,75
1650612155330,CSE 175,A01,083665,Kumar; Rakesh,7,0,25,18
1650612161354,CSE 190,A00,092507,Dubnov; Shlomo,10,0,20,10
1650612167378,ECE 45,A01,083139,Staff,0,1,60,60
1650612173410,ECE 65,A50,083695,Staff,0,5,30,30
1650612179447,ECE 109,A01,091882,Touri; Behrouz,33,0,70,37
1650612185479,ECE 180,A00,083140,Abi Samra; Nicholas Camill,21,0,30,9
1650612185479,ECE 180,B00,083141,Abi Samra; Nicholas Camill,0,0,30,30
1650612191576,MATH 10A,A01,083735,Patchell; Gregory David,4,0,30,26
1650612191576,MATH 10A,A02,083736,Patchell; Gregory David,27,0,30,3
1650612191576,MATH 10A,A03,083737,Patchell; Gregory David,24,0,30,6
1650612197601,MATH 10B,A01,083207,Staff,0,8,30,30
1650612197601,MATH 10B,A02,083208,Staff,0,8,30,30
1650612197601,MATH 10B,B01,083739,Staff,11,0,30,19
1650612197601,MATH 10B,B02,083740,Staff,28,0,30,2
1650612203629,MATH 18,A01,083743,Staff,0,0,30,30
1650612203629,MATH 18,A02,083744,Staff,23,0,30,7
1650612203629,MATH 18,A03,083745,Staff,21,0,30,9
1650612203629,MATH 18,A04,083746,Staff,26,0,30,4
1650612203629,MATH 18,B01,083748,Staff,0,15,30,30
1650612203629,MATH 18,B02,083749,Staff,0,11,30,30
1650612203629,MATH 18,B03,083750,Staff,0,12,30,30
1650612203629,MATH 18,B04,083751,Staff,0,12,30,30
1650612209668,MATH 20A,A01,083754,Staff,19,0,40,21
1650612215705,MATH 20B,A01,083756,Staff,0,12,30,30
1650612215705,MATH 20B,A02,083757,Staff,0,12,30,30
1650612221730,MATH 20C,A01,083760,Staff,0,15,30,30
1650612221730,MATH 20C,A02,083761,Staff,1,13,30,29
1650612221730,MATH 20C,B01,083762,Staff,11,0,30,19
1650612221730,MATH 20C,B02,083763,Staff,28,0,30,2
1650612227754,MATH 20D,A01,083765,Staff,1,1,30,29
1650612227754,MATH 20D,A02,083766,Staff,7,0,30,23
1650612227754,MATH 20D,A03,083767,Staff,24,0,30,6
1650612233778,MATH 20E,A01,083771,Staff,3,0,30,27
1650612233778,MATH 20E,A02,083772,Staff,17,0,30,13
1650612233778,MATH 20E,B01,083773,Staff,0,0,30,30
1650612233778,MATH 20E,B02,083774,Staff,9,0,30,21
1650612239805,MATH 103A,A01,083777,Staff,0,15,30,30
1650612239805,MATH 103A,A02,083778,Staff,0,15,30,30
1650612239805,MATH 103A,B01,083779,Staff,0,14,30,30
1650612239805,MATH 103A,B02,083780,Staff,0,14,30,30
1650612245832,MATH 105,A01,085443,Staff,0,21,30,30
1650612251856,MATH 109,A01,083213,Anzaldo; Leesa B,0,6,30,30
1650612251856,MATH 109,A02,083214,Anzaldo; Leesa B,0,7,30,30
1650612251856,MATH 109,B01,083215,Anzaldo; Leesa B,0,6,30,30
1650612251856,MATH 109,B02,083216,Anzaldo; Leesa B,0,6,30,30
1650612257887,MATH 142A,A01,083219,Chow; Bennett,0,16,30,30
1650612257887,MATH 142A,A02,083220,Chow; Bennett,0,15,30,30
1650612257887,MATH 142A,B01,083221,Chow; Bennett,0,14,30,30
1650612257887,MATH 142A,B02,083222,Chow; Bennett,0,13,30,30
1650612263915,MATH 193A,A01,083224,Staff,0,5,30,30
1650612263915,MATH 193A,A02,083225,Staff,0,6,30,30
1650612263915,MATH 193A,A03,083781,Staff,0,6,30,30
1650612263915,MATH 193A,A04,083782,Staff,0,7,30,30
1650612269939,MATH 197,001,091859,McAuley; Julian John,9998,0,9999,1
1650612276006,COGS 9,A01,083615,Staff,0,15,60,60
1650612282036,COGS 11,A01,083617,Boyle; Mary E. T.,18,0,40,22
1650612288063,COGS 13,A01,083071,Staff,0,38,40,40
1650612294091,COGS 14A,A01,092681,Staff,0,30,100,100
1650612300114,COGS 14B,A01,083073,Cheng; Tzu-Han,0,13,50,50
1650612306139,COGS 17,A01,092677,Staff,17,0,75,58
1650612312165,COGS 100,A01,083619,Staff,0,26,60,60
1650612318199,COGS 101A,A01,083621,Davis; Joshua Daniel,0,26,60,60
1650612324227,COGS 101B,A01,091572,Staff,0,4,60,60
1650612330252,COGS 101C,A01,083625,Delgado; Tania,15,0,30,15
1650612336280,COGS 107A,A01,083627,Boyle; Mary E. T.,1,15,60,59
1650612342307,COGS 118A,A01,083075,Staff,0,5,60,60
1650612348331,CSE 3,A50,083646,Miranda; Gregory Joseph,19,0,38,19
1650612348331,CSE 3,A51,083647,Miranda; Gregory Joseph,36,0,37,1
1650612354355,CSE 8A,A50,083650,Miranda; Gregory Joseph,0,30,40,40
1650612360380,CSE 11,A01,083080,Cao; Yingjun,0,95,40,40
1650612366406,CSE 12,A01,083652,Staff,0,19,100,100
1650612372431,CSE 15L,A01,083654,Staff,0,2,50,50
1650612372431,CSE 15L,A02,083655,Staff,0,1,50,50
1650612378454,CSE 20,A01,083657,Staff,51,0,80,29
1650612384479,CSE 30,A01,083084,Eldon; John,0,78,40,40
1650612390506,CSE 100,A01,083659,Cao; Yingjun,0,68,50,50
1650612396529,CSE 134B,A01,083661,Powell; Thomas Allan,0,35,65,65
1650612402554,CSE 140,A01,083663,Staff,0,8,75,75
1650612408580,CSE 140L,A01,083088,Eldon; John,0,15,75,75
1650612414609,CSE 175,A01,083665,Kumar; Rakesh,7,0,25,18
1650612420637,CSE 190,A00,092507,Dubnov; Shlomo,10,0,20,10
1650612426676,ECE 45,A01,083139,Staff,0,1,60,60
1650612432699,ECE 65,A50,083695,Staff,0,5,30,30
1650612438723,ECE 109,A01,091882,Touri; Behrouz,33,0,70,37
1650612444748,ECE 180,A00,083140,Abi Samra; Nicholas Camill,21,0,30,9
1650612444748,ECE 180,B00,083141,Abi Samra; Nicholas Camill,0,0,30,30
1650612450778,MATH 10A,A01,083735,Patchell; Gregory David,4,0,30,26
1650612450778,MATH 10A,A02,083736,Patchell; Gregory David,27,0,30,3
1650612450778,MATH 10A,A03,083737,Patchell; Gregory David,24,0,30,6
1650612456804,MATH 10B,A01,083207,Staff,0,8,30,30
1650612456804,MATH 10B,A02,083208,Staff,0,8,30,30
1650612456804,MATH 10B,B01,083739,Staff,11,0,30,19
1650612456804,MATH 10B,B02,083740,Staff,28,0,30,2
1650612462843,MATH 18,A01,083743,Staff,0,0,30,30
1650612462843,MATH 18,A02,083744,Staff,23,0,30,7
1650612462843,MATH 18,A03,083745,Staff,21,0,30,9
1650612462843,MATH 18,A04,083746,Staff,26,0,30,4
1650612462843,MATH 18,B01,083748,Staff,0,15,30,30
1650612462843,MATH 18,B02,083749,Staff,0,11,30,30
1650612462843,MATH 18,B03,083750,Staff,0,12,30,30
1650612462843,MATH 18,B04,083751,Staff,0,12,30,30
1650612468868,MATH 20A,A01,083754,Staff,19,0,40,21
1650612474893,MATH 20B,A01,083756,Staff,0,12,30,30
1650612474893,MATH 20B,A02,083757,Staff,0,12,30,30
1650612480924,MATH 20C,A01,083760,Staff,0,15,30,30
1650612480924,MATH 20C,A02,083761,Staff,1,13,30,29
1650612480924,MATH 20C,B01,083762,Staff,11,0,30,19
1650612480924,MATH 20C,B02,083763,Staff,28,0,30,2
1650612486951,MATH 20D,A01,083765,Staff,1,1,30,29
1650612486951,MATH 20D,A02,083766,Staff,7,0,30,23
1650612486951,MATH 20D,A03,083767,Staff,24,0,30,6
1650612492981,MATH 20E,A01,083771,Staff,3,0,30,27
1650612492981,MATH 20E,A02,083772,Staff,17,0,30,13
1650612492981,MATH 20E,B01,083773,Staff,0,0,30,30
1650612492981,MATH 20E,B02,083774,Staff,9,0,30,21
1650612499007,MATH 103A,A01,083777,Staff,0,15,30,30
1650612499007,MATH 103A,A02,083778,Staff,0,15,30,30
1650612499007,MATH 103A,B01,083779,Staff,0,14,30,30
1650612499007,MATH 103A,B02,083780,Staff,0,14,30,30
1650612505031,MATH 105,A01,085443,Staff,0,21,30,30
1650612511057,MATH 109,A01,083213,Anzaldo; Leesa B,0,6,30,30
1650612511057,MATH 109,A02,083214,Anzaldo; Leesa B,0,7,30,30
1650612511057,MATH 109,B01,083215,Anzaldo; Leesa B,0,6,30,30
1650612511057,MATH 109,B02,083216,Anzaldo; Leesa B,0,6,30,30
1650612517082,MATH 142A,A01,083219,Chow; Bennett,0,16,30,30
1650612517082,MATH 142A,A02,083220,Chow; Bennett,0,15,30,30
1650612517082,MATH 142A,B01,083221,Chow; Bennett,0,14,30,30
1650612517082,MATH 142A,B02,083222,Chow; Bennett,0,13,30,30
1650612523110,MATH 193A,A01,083224,Staff,0,5,30,30
1650612523110,MATH 193A,A02,083225,Staff,0,6,30,30
1650612523110,MATH 193A,A03,083781,Staff,0,6,30,30
1650612523110,MATH 193A,A04,083782,Staff,0,7,30,30
1650612529137,MATH 197,001,091859,McAuley; Julian John,9998,0,9999,1
1650612535199,COGS 9,A01,083615,Staff,0,15,60,60
1650612541222,COGS 11,A01,083617,Boyle; Mary E. T.,18,0,40,22
1650612547247,COGS 13,A01,083071,Staff,0,38,40,40
1650612553271,COGS 14A,A01,092681,Staff,0,30,100,100
1650612559299,COGS 14B,A01,083073,Cheng; Tzu-Han,0,13,50,50
1650612565325,COGS 17,A01,092677,Staff,17,0,75,58
1650612571350,COGS 100,A01,083619,Staff,0,26,60,60
1650612577380,COGS 101A,A01,083621,Davis; Joshua Daniel,0,26,60,60
1650612583405,COGS 101B,A01,091572,Staff,0,4,60,60
1650612589438,COGS 101C,A01,083625,Delgado; Tania,15,0,30,15
1650612595463,COGS 107A,A01,083627,Boyle; Mary E. T.,1,15,60,59
1650612601486,COGS 118A,A01,083075,Staff,0,5,60,60
1650612607515,CSE 3,A50,083646,Miranda; Gregory Joseph,19,0,38,19
1650612607515,CSE 3,A51,083647,Miranda; Gregory Joseph,36,0,37,1
1650612613544,CSE 8A,A50,083650,Miranda; Gregory Joseph,0,30,40,40
1650612619569,CSE 11,A01,083080,Cao; Yingjun,0,95,40,40
1650612625600,CSE 12,A01,083652,Staff,0,19,100,100
1650612631629,CSE 15L,A01,083654,Staff,0,2,50,50
1650612631629,CSE 15L,A02,083655,Staff,0,1,50,50
1650612637653,CSE 20,A01,083657,Staff,51,0,80,29
1650612643677,CSE 30,A01,083084,Eldon; John,0,78,40,40
1650612649702,CSE 100,A01,083659,Cao; Yingjun,0,68,50,50
1650612655730,CSE 134B,A01,083661,Powell; Thomas Allan,0,35,65,65
1650612661755,CSE 140,A01,083663,Staff,0,8,75,75
1650612667786,CSE 140L,A01,083088,Eldon; John,0,15,75,75
1650612673815,CSE 175,A01,083665,Kumar; Rakesh,7,0,25,18
1650612679843,CSE 190,A00,092507,Dubnov; Shlomo,10,0,20,10
1650612685871,ECE 45,A01,083139,Staff,0,1,60,60
1650612691898,ECE 65,A50,083695,Staff,0,5,30,30
1650612697926,ECE 109,A01,091882,Touri; Behrouz,33,0,70,37
1650612703954,ECE 180,A00,083140,Abi Samra; Nicholas Camill,21,0,30,9
1650612703954,ECE 180,B00,083141,Abi Samra; Nicholas Camill,0,0,30,30
1650612709984,MATH 10A,A01,083735,Patchell; Gregory David,4,0,30,26
1650612709984,MATH 10A,A02,083736,Patchell; Gregory David,27,0,30,3
1650612709984,MATH 10A,A03,083737,Patchell; Gregory David,24,0,30,6
1650612716014,MATH 10B,A01,083207,Staff,0,8,30,30
1650612716014,MATH 10B,A02,083208,Staff,0,8,30,30
1650612716014,MATH 10B,B01,083739,Staff,11,0,30,19
1650612716014,MATH 10B,B02,083740,Staff,28,0,30,2
1650612722048,MATH 18,A01,083743,Staff,0,0,30,30
1650612722048,MATH 18,A02,083744,Staff,23,0,30,7
1650612722048,MATH 18,A03,083745,Staff,21,0,30,9
1650612722048,MATH 18,A04,083746,Staff,26,0,30,4
1650612722048,MATH 18,B01,083748,Staff,0,15,30,30
1650612722048,MATH 18,B02,083749,Staff,0,11,30,30
1650612722048,MATH 18,B03,083750,Staff,0,12,30,30
1650612722048,MATH 18,B04,083751,Staff,0,12,30,30
1650612728075,MATH 20A,A01,083754,Staff,19,0,40,21
1650612734104,MATH 20B,A01,083756,Staff,0,12,30,30
1650612734104,MATH 20B,A02,083757,Staff,0,12,30,30
1650612740129,MATH 20C,A01,083760,Staff,0,15,30,30
1650612740129,MATH 20C,A02,083761,Staff,1,13,30,29
1650612740129,MATH 20C,B01,083762,Staff,11,0,30,19
1650612740129,MATH 20C,B02,083763,Staff,28,0,30,2
1650612746151,MATH 20D,A01,083765,Staff,1,1,30,29
1650612746151,MATH 20D,A02,083766,Staff,7,0,30,23
1650612746151,MATH 20D,A03,083767,Staff,24,0,30,6
1650612752181,MATH 20E,A01,083771,Staff,3,0,30,27
1650612752181,MATH 20E,A02,083772,Staff,17,0,30,13
1650612752181,MATH 20E,B01,083773,Staff,0,0,30,30
1650612752181,MATH 20E,B02,083774,Staff,9,0,30,21
1650612758210,MATH 103A,A01,083777,Staff,0,15,30,30
1650612758210,MATH 103A,A02,083778,Staff,0,15,30,30
1650612758210,MATH 103A,B01,083779,Staff,0,14,30,30
1650612758210,MATH 103A,B02,083780,Staff,0,14,30,30
1650612764239,MATH 105,A01,085443,Staff,0,21,30,30
1650612770270,MATH 109,A01,083213,Anzaldo; Leesa B,0,6,30,30
1650612770270,MATH 109,A02,083214,Anzaldo; Leesa B,0,7,30,30
1650612770270,MATH 109,B01,083215,Anzaldo; Leesa B,0,6,30,30
1650612770270,MATH 109,B02,083216,Anzaldo; Leesa B,0,6,30,30
1650612776302,MATH 142A,A01,083219,Chow; Bennett,0,16,30,30
1650612776302,MATH 142A,A02,083220,Chow; Bennett,0,15,30,30
1650612776302,MATH 142A,B01,083221,Chow; Bennett,0,14,30,30
1650612776302,MATH 142A,B02,083222,Chow; Bennett,0,13,30,30
1650612782332,MATH 193A,A01,083224,Staff,0,5,30,30
1650612782332,MATH 193A,A02,083225,Staff,0,6,30,30
1650612782332,MATH 193A,A03,083781,Staff,0,6,30,30
1650612782332,MATH 193A,A04,083782,Staff,0,7,30,30
1650612788437,MATH 197,001,091859,McAuley; Julian John,9998,0,9999,1
1650612794497,COGS 9,A01,083615,Staff,0,15,60,60
1650612800523,COGS 11,A01,083617,Boyle; Mary E. T.,18,0,40,22
1650612806556,COGS 13,A01,083071,Staff,0,38,40,40
1650612812584,COGS 14A,A01,092681,Staff,0,30,100,100
1650612818609,COGS 14B,A01,083073,Cheng; Tzu-Han,0,13,50,50
1650612824637,COGS 17,A01,092677,Staff,17,0,75,58
1650612830666,COGS 100,A01,083619,Staff,0,26,60,60
1650612836691,COGS 101A,A01,083621,Davis; Joshua Daniel,0,26,60,60
1650612842723,COGS 101B,A01,091572,Staff,0,4,60,60
1650612848749,COGS 101C,A01,083625,Delgado; Tania,15,0,30,15
1650612854779,COGS 107A,A01,083627,Boyle; Mary E. T.,1,15,60,59
1650612860804,COGS 118A,A01,083075,Staff,0,5,60,60
1650612866830,CSE 3,A50,083646,Miranda; Gregory Joseph,19,0,38,19
1650612866830,CSE 3,A51,083647,Miranda; Gregory Joseph,36,0,37,1
1650612872859,CSE 8A,A50,083650,Miranda; Gregory Joseph,0,30,40,40
1650612878884,CSE 11,A01,083080,Cao; Yingjun,0,95,40,40
1650612884909,CSE 12,A01,083652,Staff,0,19,100,100
1650612890939,CSE 15L,A01,083654,Staff,0,2,50,50
1650612890939,CSE 15L,A02,083655,Staff,0,1,50,50
1650612896964,CSE 20,A01,083657,Staff,51,0,80,29
1650612902996,CSE 30,A01,083084,Eldon; John,0,78,40,40
1650612909020,CSE 100,A01,083659,Cao; Yingjun,0,68,50,50
1650612915049,CSE 134B,A01,083661,Powell; Thomas Allan,0,35,65,65
1650612921073,CSE 140,A01,083663,Staff,0,8,75,75
1650612927097,CSE 140L,A01,083088,Eldon; John,0,15,75,75
1650612933120,CSE 175,A01,083665,Kumar; Rakesh,7,0,25,18
1650612939143,CSE 190,A00,092507,Dubnov; Shlomo,10,0,20,10
1650612945172,ECE 45,A01,083139,Staff,0,1,60,60
1650612951201,ECE 65,A50,083695,Staff,0,5,30,30
1650612957226,ECE 109,A01,091882,Touri; Behrouz,33,0,70,37
1650612963250,ECE 180,A00,083140,Abi Samra; Nicholas Camill,21,0,30,9
1650612963250,ECE 180,B00,083141,Abi Samra; Nicholas Camill,0,0,30,30
1650612969275,MATH 10A,A01,083735,Patchell; Gregory David,4,0,30,26
1650612969275,MATH 10A,A02,083736,Patchell; Gregory David,27,0,30,3
1650612969275,MATH 10A,A03,083737,Patchell; Gregory David,24,0,30,6
1650612975307,MATH 10B,A01,083207,Staff,0,8,30,30
1650612975307,MATH 10B,A02,083208,Staff,0,8,30,30
1650612975307,MATH 10B,B01,083739,Staff,11,0,30,19
1650612975307,MATH 10B,B02,083740,Staff,28,0,30,2
1650612981340,MATH 18,A01,083743,Staff,0,0,30,30
1650612981340,MATH 18,A02,083744,Staff,23,0,30,7
1650612981340,MATH 18,A03,083745,Staff,21,0,30,9
1650612981340,MATH 18,A04,083746,Staff,26,0,30,4
1650612981340,MATH 18,B01,083748,Staff,0,15,30,30
1650612981340,MATH 18,B02,083749,Staff,0,11,30,30
1650612981340,MATH 18,B03,083750,Staff,0,12,30,30
1650612981340,MATH 18,B04,083751,Staff,0,12,30,30
1650612987377,MATH 20A,A01,083754,Staff,19,0,40,21
1650612993409,MATH 20B,A01,083756,Staff,0,12,30,30
1650612993409,MATH 20B,A02,083757,Staff,0,12,30,30
1650612999433,MATH 20C,A01,083760,Staff,0,15,30,30
1650612999433,MATH 20C,A02,083761,Staff,1,13,30,29
1650612999433,MATH 20C,B01,083762,Staff,11,0,30,19
1650612999433,MATH 20C,B02,083763,Staff,28,0,30,2
1650613005455,MATH 20D,A01,083765,Staff,1,1,30,29
1650613005455,MATH 20D,A02,083766,Staff,7,0,30,23
1650613005455,MATH 20D,A03,083767,Staff,24,0,30,6
1650613011488,MATH 20E,A01,083771,Staff,3,0,30,27
1650613011488,MATH 20E,A02,083772,Staff,17,0,30,13
1650613011488,MATH 20E,B01,083773,Staff,0,0,30,30
1650613011488,MATH 20E,B02,083774,Staff,9,0,30,21
1650613017519,MATH 103A,A01,083777,Staff,0,15,30,30
1650613017519,MATH 103A,A02,083778,Staff,0,15,30,30
1650613017519,MATH 103A,B01,083779,Staff,0,14,30,30
1650613017519,MATH 103A,B02,083780,Staff,0,14,30,30
1650613023547,MATH 105,A01,085443,Staff,0,21,30,30
1650613029573,MATH 109,A01,083213,Anzaldo; Leesa B,0,6,30,30
1650613029573,MATH 109,A02,083214,Anzaldo; Leesa B,0,7,30,30
1650613029573,MATH 109,B01,083215,Anzaldo; Leesa B,0,6,30,30
1650613029573,MATH 109,B02,083216,Anzaldo; Leesa B,0,6,30,30
1650613035595,MATH 142A,A01,083219,Chow; Bennett,0,16,30,30
1650613035595,MATH 142A,A02,083220,Chow; Bennett,0,15,30,30
1650613035595,MATH 142A,B01,083221,Chow; Bennett,0,14,30,30
1650613035595,MATH 142A,B02,083222,Chow; Bennett,0,13,30,30
1650613041632,MATH 193A,A01,083224,Staff,0,5,30,30
1650613041632,MATH 193A,A02,083225,Staff,0,6,30,30
1650613041632,MATH 193A,A03,083781,Staff,0,6,30,30
1650613041632,MATH 193A,A04,083782,Staff,0,7,30,30
1650613047657,MATH 197,001,091859,McAuley; Julian John,9998,0,9999,1
1650613053718,COGS 9,A01,083615,Staff,0,15,60,60
1650613059746,COGS 11,A01,083617,Boyle; Mary E. T.,18,0,40,22
1650613065783,COGS 13,A01,083071,Staff,0,38,40,40
1650613071806,COGS 14A,A01,092681,Staff,0,30,100,100
1650613077831,COGS 14B,A01,083073,Cheng; Tzu-Han,0,13,50,50
1650613083859,COGS 17,A01,092677,Staff,17,0,75,58
1650613089885,COGS 100,A01,083619,Staff,0,26,60,60
1650613095910,COGS 101A,A01,083621,Davis; Joshua Daniel,0,26,60,60
1650613101934,COGS 101B,A01,091572,Staff,0,4,60,60
1650613107958,COGS 101C,A01,083625,Delgado; Tania,15,0,30,15
1650613113987,COGS 107A,A01,083627,Boyle; Mary E. T.,1,15,60,59
1650613120015,COGS 118A,A01,083075,Staff,0,5,60,60
1650613126041,CSE 3,A50,083646,Miranda; Gregory Joseph,19,0,38,19
1650613126041,CSE 3,A51,083647,Miranda; Gregory Joseph,36,0,37,1
1650613132067,CSE 8A,A50,083650,Miranda; Gregory Joseph,0,30,40,40
1650613138095,CSE 11,A01,083080,Cao; Yingjun,0,95,40,40
1650613144119,CSE 12,A01,083652,Staff,0,19,100,100
1650613150143,CSE 15L,A01,083654,Staff,0,2,50,50
1650613150143,CSE 15L,A02,083655,Staff,0,1,50,50
1650613156166,CSE 20,A01,083657,Staff,51,0,80,29
1650613162190,CSE 30,A01,083084,Eldon; John,0,78,40,40
1650613168214,CSE 100,A01,083659,Cao; Yingjun,0,68,50,50
1650613174247,CSE 134B,A01,083661,Powell; Thomas Allan,0,35,65,65
1650613180274,CSE 140,A01,083663,Staff,0,8,75,75
1650613186300,CSE 140L,A01,083088,Eldon; John,0,15,75,75
1650613192334,CSE 175,A01,083665,Kumar; Rakesh,7,0,25,18
1650613198371,CSE 190,A00,092507,Dubnov; Shlomo,10,0,20,10
1650613204408,ECE 45,A01,083139,Staff,0,1,60,60
1650613210433,ECE 65,A50,083695,Staff,0,5,30,30
1650613216464,ECE 109,A01,091882,Touri; Behrouz,33,0,70,37
1650613222499,ECE 180,A00,083140,Abi Samra; Nicholas Camill,21,0,30,9
1650613222499,ECE 180,B00,083141,Abi Samra; Nicholas Camill,0,0,30,30
1650613228528,MATH 10A,A01,083735,Patchell; Gregory David,4,0,30,26
1650613228528,MATH 10A,A02,083736,Patchell; Gregory David,27,0,30,3
1650613228528,MATH 10A,A03,083737,Patchell; Gregory David,24,0,30,6
1650613234556,MATH 10B,A01,083207,Staff,0,8,30,30
1650613234556,MATH 10B,A02,083208,Staff,0,8,30,30
1650613234556,MATH 10B,B01,083739,Staff,11,0,30,19
1650613234556,MATH 10B,B02,083740,Staff,28,0,30,2
1650613240590,MATH 18,A01,083743,Staff,0,0,30,30
1650613240590,MATH 18,A02,083744,Staff,23,0,30,7
1650613240590,MATH 18,A03,083745,Staff,21,0,30,9
1650613240590,MATH 18,A04,083746,Staff,26,0,30,4
1650613240590,MATH 18,B01,083748,Staff,0,15,30,30
1650613240590,MATH 18,B02,083749,Staff,0,11,30,30
1650613240590,MATH 18,B03,083750,Staff,0,12,30,30
1650613240590,MATH 18,B04,083751,Staff,0,12,30,30
1650613246615,MATH 20A,A01,083754,Staff,19,0,40,21
1650613252649,MATH 20B,A01,083756,Staff,0,12,30,30
1650613252649,MATH 20B,A02,083757,Staff,0,12,30,30
1650613258680,MATH 20C,A01,083760,Staff,0,15,30,30
1650613258680,MATH 20C,A02,083761,Staff,1,13,30,29
1650613258680,MATH 20C,B01,083762,Staff,11,0,30,19
1650613258680,MATH 20C,B02,083763,Staff,28,0,30,2
1650613264723,MATH 20D,A01,083765,Staff,1,1,30,29
1650613264723,MATH 20D,A02,083766,Staff,7,0,30,23
1650613264723,MATH 20D,A03,083767,Staff,24,0,30,6
1650613270747,MATH 20E,A01,083771,Staff,3,0,30,27
1650613270747,MATH 20E,A02,083772,Staff,17,0,30,13
1650613270747,MATH 20E,B01,083773,Staff,0,0,30,30
1650613270747,MATH 20E,B02,083774,Staff,9,0,30,21
1650613276773,MATH 103A,A01,083777,Staff,0,15,30,30
1650613276773,MATH 103A,A02,083778,Staff,0,15,30,30
1650613276773,MATH 103A,B01,083779,Staff,0,14,30,30
1650613276773,MATH 103A,B02,083780,Staff,0,14,30,30
1650613282798,MATH 105,A01,085443,Staff,0,21,30,30
1650613288829,MATH 109,A01,083213,Anzaldo; Leesa B,0,6,30,30
1650613288829,MATH 109,A02,083214,Anzaldo; Leesa B,0,7,30,30
1650613288829,MATH 109,B01,083215,Anzaldo; Leesa B,0,6,30,30
1650613288829,MATH 109,B02,083216,Anzaldo; Leesa B,0,6,30,30
1650613294855,MATH 142A,A01,083219,Chow; Bennett,0,16,30,30
1650613294855,MATH 142A,A02,083220,Chow; Bennett,0,15,30,30
1650613294855,MATH 142A,B01,083221,Chow; Bennett,0,14,30,30
1650613294855,MATH 142A,B02,083222,Chow; Bennett,0,13,30,30
1650613300884,MATH 193A,A01,083224,Staff,0,5,30,30
1650613300884,MATH 193A,A02,083225,Staff,0,6,30,30
1650613300884,MATH 193A,A03,083781,Staff,0,6,30,30
1650613300884,MATH 193A,A04,083782,Staff,0,7,30,30
1650613306909,MATH 197,001,091859,McAuley; Julian John,9998,0,9999,1
1650613312985,COGS 9,A01,083615,Staff,0,15,60,60
1650613319029,COGS 11,A01,083617,Boyle; Mary E. T.,18,0,40,22
1650613325067,COGS 13,A01,083071,Staff,0,38,40,40
1650613331097,COGS 14A,A01,092681,Staff,0,30,100,100
1650613337122,COGS 14B,A01,083073,Cheng; Tzu-Han,0,13,50,50
1650613343152,COGS 17,A01,092677,Staff,17,0,75,58
1650613349180,COGS 100,A01,083619,Staff,0,26,60,60
1650613355205,COGS 101A,A01,083621,Davis; Joshua Daniel,0,26,60,60
1650613361232,COGS 101B,A01,091572,Staff,0,4,60,60
1650613367261,COGS 101C,A01,083625,Delgado; Tania,15,0,30,15
1650613373285,COGS 107A,A01,083627,Boyle; Mary E. T.,1,15,60,59
1650613379400,COGS 118A,A01,083075,Staff,0,5,60,60
1650613385441,CSE 3,A50,083646,Miranda; Gregory Joseph,19,0,38,19
1650613385441,CSE 3,A51,083647,Miranda; Gregory Joseph,36,0,37,1
1650613391466,CSE 8A,A50,083650,Miranda; Gregory Joseph,0,30,40,40
1650613397499,CSE 11,A01,083080,Cao; Yingjun,0,95,40,40
1650613403531,CSE 12,A01,083652,Staff,0,19,100,100
1650613409558,CSE 15L,A01,083654,Staff,0,2,50,50
1650613409558,CSE 15L,A02,083655,Staff,0,1,50,50
1650613415582,CSE 20,A01,083657,Staff,51,0,80,29
1650613421611,CSE 30,A01,083084,Eldon; John,0,78,40,40
1650613427642,CSE 100,A01,083659,Cao; Yingjun,0,68,50,50
1650613433672,CSE 134B,A01,083661,Powell; Thomas Allan,0,35,65,65
1650613439697,CSE 140,A01,083663,Staff,0,8,75,75
1650613445727,CSE 140L,A01,083088,Eldon; John,0,15,75,75
1650613451752,CSE 175,A01,083665,Kumar; Rakesh,7,0,25,18
1650613457776,CSE 190,A00,092507,Dubnov; Shlomo,10,0,20,10
1650613463806,ECE 45,A01,083139,Staff,0,1,60,60
1650613469832,ECE 65,A50,083695,Staff,0,5,30,30
1650613475858,ECE 109,A01,091882,Touri; Behrouz,33,0,70,37
1650613481886,ECE 180,A00,083140,Abi Samra; Nicholas Camill,21,0,30,9
1650613481886,ECE 180,B00,083141,Abi Samra; Nicholas Camill,0,0,30,30
1650613487912,MATH 10A,A01,083735,Patchell; Gregory David,4,0,30,26
1650613487912,MATH 10A,A02,083736,Patchell; Gregory David,27,0,30,3
1650613487912,MATH 10A,A03,083737,Patchell; Gregory David,24,0,30,6
1650613493939,MATH 10B,A01,083207,Staff,0,8,30,30
1650613493939,MATH 10B,A02,083208,Staff,0,8,30,30
1650613493939,MATH 10B,B01,083739,Staff,11,0,30,19
1650613493939,MATH 10B,B02,083740,Staff,28,0,30,2
1650613499967,MATH 18,A01,083743,Staff,0,0,30,30
1650613499967,MATH 18,A02,083744,Staff,23,0,30,7
1650613499967,MATH 18,A03,083745,Staff,21,0,30,9
1650613499967,MATH 18,A04,083746,Staff,26,0,30,4
1650613499967,MATH 18,B01,083748,Staff,0,15,30,30
1650613499967,MATH 18,B02,083749,Staff,0,11,30,30
1650613499967,MATH 18,B03,083750,Staff,0,12,30,30
1650613499967,MATH 18,B04,083751,Staff,0,12,30,30
1650613505991,MATH 20A,A01,083754,Staff,19,0,40,21
1650613512019,MATH 20B,A01,083756,Staff,0,12,30,30
1650613512019,MATH 20B,A02,083757,Staff,0,12,30,30
1650613518047,MATH 20C,A01,083760,Staff,0,15,30,30
1650613518047,MATH 20C,A02,083761,Staff,1,13,30,29
1650613518047,MATH 20C,B01,083762,Staff,11,0,30,19
1650613518047,MATH 20C,B02,083763,Staff,28,0,30,2
1650613524076,MATH 20D,A01,083765,Staff,1,1,30,29
1650613524076,MATH 20D,A02,083766,Staff,7,0,30,23
1650613524076,MATH 20D,A03,083767,Staff,24,0,30,6
1650613530100,MATH 20E,A01,083771,Staff,3,0,30,27
1650613530100,MATH 20E,A02,083772,Staff,17,0,30,13
1650613530100,MATH 20E,B01,083773,Staff,0,0,30,30
1650613530100,MATH 20E,B02,083774,Staff,9,0,30,21
1650613536129,MATH 103A,A01,083777,Staff,0,15,30,30
1650613536129,MATH 103A,A02,083778,Staff,0,15,30,30
1650613536129,MATH 103A,B01,083779,Staff,0,14,30,30
1650613536129,MATH 103A,B02,083780,Staff,0,14,30,30
1650613542158,MATH 105,A01,085443,Staff,0,21,30,30
1650613548191,MATH 109,A01,083213,Anzaldo; Leesa B,0,6,30,30
1650613548191,MATH 109,A02,083214,Anzaldo; Leesa B,0,7,30,30
1650613548191,MATH 109,B01,083215,Anzaldo; Leesa B,0,6,30,30
1650613548191,MATH 109,B02,083216,Anzaldo; Leesa B,0,6,30,30
1650613554220,MATH 142A,A01,083219,Chow; Bennett,0,16,30,30
1650613554220,MATH 142A,A02,083220,Chow; Bennett,0,15,30,30
1650613554220,MATH 142A,B01,083221,Chow; Bennett,0,14,30,30
1650613554220,MATH 142A,B02,083222,Chow; Bennett,0,13,30,30
1650613560249,MATH 193A,A01,083224,Staff,0,5,30,30
1650613560249,MATH 193A,A02,083225,Staff,0,6,30,30
1650613560249,MATH 193A,A03,083781,Staff,0,6,30,30
1650613560249,MATH 193A,A04,083782,Staff,0,7,30,30
1650613566274,MATH 197,001,091859,McAuley; Julian John,9998,0,9999,1
1650613572348,COGS 9,A01,083615,Staff,0,15,60,60
1650613578372,COGS 11,A01,083617,Boyle; Mary E. T.,18,0,40,22
1650613584397,COGS 13,A01,083071,Staff,0,38,40,40
1650613590425,COGS 14A,A01,092681,Staff,0,30,100,100
1650613596450,COGS 14B,A01,083073,Cheng; Tzu-Han,0,13,50,50
1650613602472,COGS 17,A01,092677,Staff,17,0,75,58
1650613608498,COGS 100,A01,083619,Staff,0,26,60,60
1650613614529,COGS 101A,A01,083621,Davis; Joshua Daniel,0,26,60,60
1650613620557,COGS 101B,A01,091572,Staff,0,4,60,60
1650613626588,COGS 101C,A01,083625,Delgado; Tania,15,0,30,15
1650613632615,COGS 107A,A01,083627,Boyle; Mary E. T.,1,15,60,59
1650613638639,COGS 118A,A01,083075,Staff,0,5,60,60
1650613644674,CSE 3,A50,083646,Miranda; Gregory Joseph,19,0,38,19
1650613644674,CSE 3,A51,083647,Miranda; Gregory Joseph,36,0,37,1
1650613650699,CSE 8A,A50,083650,Miranda; Gregory Joseph,0,30,40,40
1650613656729,CSE 11,A01,083080,Cao; Yingjun,0,95,40,40
1650613662761,CSE 12,A01,083652,Staff,0,19,100,100
1650613668790,CSE 15L,A01,083654,Staff,0,2,50,50
1650613668790,CSE 15L,A02,083655,Staff,0,1,50,50
1650613674812,CSE 20,A01,083657,Staff,51,0,80,29
1650613680838,CSE 30,A01,083084,Eldon; John,0,78,40,40
1650613686863,CSE 100,A01,083659,Cao; Yingjun,0,68,50,50
1650613692890,CSE 134B,A01,083661,Powell; Thomas Allan,0,35,65,65
1650613698922,CSE 140,A01,083663,Staff,0,8,75,75
1650613704956,CSE 140L,A01,083088,Eldon; John,0,15,75,75
1650613710994,CSE 175,A01,083665,Kumar; Rakesh,7,0,25,18
1650613717021,CSE 190,A00,092507,Dubnov; Shlomo,10,0,20,10
1650613723046,ECE 45,A01,083139,Staff,0,1,60,60
1650613729077,ECE 65,A50,083695,Staff,0,5,30,30
1650613735118,ECE 109,A01,091882,Touri; Behrouz,33,0,70,37
1650613741143,ECE 180,A00,083140,Abi Samra; Nicholas Camill,21,0,30,9
1650613741143,ECE 180,B00,083141,Abi Samra; Nicholas Camill,0,0,30,30
1650613747171,MATH 10A,A01,083735,Patchell; Gregory David,4,0,30,26
1650613747171,MATH 10A,A02,083736,Patchell; Gregory David,27,0,30,3
1650613747171,MATH 10A,A03,083737,Patchell; Gregory David,24,0,30,6
1650613753197,MATH 10B,A01,083207,Staff,0,8,30,30
1650613753197,MATH 10B,A02,083208,Staff,0,8,30,30
1650613753197,MATH 10B,B01,083739,Staff,11,0,30,19
1650613753197,MATH 10B,B02,083740,Staff,28,0,30,2
1650613759229,MATH 18,A01,083743,Staff,0,0,30,30
1650613759229,MATH 18,A02,083744,Staff,23,0,30,7
1650613759229,MATH 18,A03,083745,Staff,21,0,30,9
1650613759229,MATH 18,A04,083746,Staff,26,0,30,4
1650613759229,MATH 18,B01,083748,Staff,0,15,30,30
1650613759229,MATH 18,B02,083749,Staff,0,11,30,30
1650613759229,MATH 18,B03,083750,Staff,0,12,30,30
1650613759229,MATH 18,B04,083751,Staff,0,12,30,30
1650613765254,MATH 20A,A01,083754,Staff,19,0,40,21
1650613771281,MATH 20B,A01,083756,Staff,0,12,30,30
1650613771281,MATH 20B,A02,083757,Staff,0,12,30,30
1650613777307,MATH 20C,A01,083760,Staff,0,15,30,30
1650613777307,MATH 20C,A02,083761,Staff,1,13,30,29
1650613777307,MATH 20C,B01,083762,Staff,11,0,30,19
1650613777307,MATH 20C,B02,083763,Staff,28,0,30,2
1650613783331,MATH 20D,A01,083765,Staff,1,1,30,29
1650613783331,MATH 20D,A02,083766,Staff,7,0,30,23
1650613783331,MATH 20D,A03,083767,Staff,24,0,30,6
1650613789362,MATH 20E,A01,083771,Staff,3,0,30,27
1650613789362,MATH 20E,A02,083772,Staff,17,0,30,13
1650613789362,MATH 20E,B01,083773,Staff,0,0,30,30
1650613789362,MATH 20E,B02,083774,Staff,9,0,30,21
1650613795394,MATH 103A,A01,083777,Staff,0,15,30,30
1650613795394,MATH 103A,A02,083778,Staff,0,15,30,30
1650613795394,MATH 103A,B01,083779,Staff,0,14,30,30
1650613795394,MATH 103A,B02,083780,Staff,0,14,30,30
1650613801420,MATH 105,A01,085443,Staff,0,21,30,30
1650613807452,MATH 109,A01,083213,Anzaldo; Leesa B,0,6,30,30
1650613807452,MATH 109,A02,083214,Anzaldo; Leesa B,0,7,30,30
1650613807452,MATH 109,B01,083215,Anzaldo; Leesa B,0,6,30,30
1650613807452,MATH 109,B02,083216,Anzaldo; Leesa B,0,6,30,30
1650613813477,MATH 142A,A01,083219,Chow; Bennett,0,16,30,30
1650613813477,MATH 142A,A02,083220,Chow; Bennett,0,15,30,30
1650613813477,MATH 142A,B01,083221,Chow; Bennett,0,14,30,30
1650613813477,MATH 142A,B02,083222,Chow; Bennett,0,13,30,30
1650613819501,MATH 193A,A01,083224,Staff,0,5,30,30
1650613819501,MATH 193A,A02,083225,Staff,0,6,30,30
1650613819501,MATH 193A,A03,083781,Staff,0,6,30,30
1650613819501,MATH 193A,A04,083782,Staff,0,7,30,30
1650613825535,MATH 197,001,091859,McAuley; Julian John,9998,0,9999,1
1650613831603,COGS 9,A01,083615,Staff,0,15,60,60
1650613837631,COGS 11,A01,083617,Boyle; Mary E. T.,18,0,40,22
1650613843657,COGS 13,A01,083071,Staff,0,38,40,40
1650613849686,COGS 14A,A01,092681,Staff,0,30,100,100
1650613855711,COGS 14B,A01,083073,Cheng; Tzu-Han,0,13,50,50
1650613861733,COGS 17,A01,092677,Staff,17,0,75,58
1650613867769,COGS 100,A01,083619,Staff,0,26,60,60
1650613873799,COGS 101A,A01,083621,Davis; Joshua Daniel,0,26,60,60
1650613879827,COGS 101B,A01,091572,Staff,0,4,60,60
1650613885853,COGS 101C,A01,083625,Delgado; Tania,15,0,30,15
1650613891876,COGS 107A,A01,083627,Boyle; Mary E. T.,1,15,60,59
1650613897899,COGS 118A,A01,083075,Staff,0,5,60,60
1650613903940,CSE 3,A50,083646,Miranda; Gregory Joseph,19,0,38,19
1650613903940,CSE 3,A51,083647,Miranda; Gregory Joseph,36,0,37,1
1650613909967,CSE 8A,A50,083650,Miranda; Gregory Joseph,0,30,40,40
1650613915990,CSE 11,A01,083080,Cao; Yingjun,0,95,40,40
1650613922018,CSE 12,A01,083652,Staff,0,19,100,100
1650613928044,CSE 15L,A01,083654,Staff,0,2,50,50
1650613928044,CSE 15L,A02,083655,Staff,0,1,50,50
1650613934074,CSE 20,A01,083657,Staff,51,0,80,29
1650613940098,CSE 30,A01,083084,Eldon; John,0,78,40,40
1650613946126,CSE 100,A01,083659,Cao; Yingjun,0,68,50,50
1650613952154,CSE 134B,A01,083661,Powell; Thomas Allan,0,35,65,65
1650613958179,CSE 140,A01,083663,Staff,0,8,75,75
1650613964204,CSE 140L,A01,083088,Eldon; John,0,15,75,75
1650613970231,CSE 175,A01,083665,Kumar; Rakesh,7,0,25,18
1650613976350,CSE 190,A00,092507,Dubnov; Shlomo,10,0,20,10
1650613982377,ECE 45,A01,083139,Staff,0,1,60,60
1650613988402,ECE 65,A50,083695,Staff,0,5,30,30
1650613994428,ECE 109,A01,091882,Touri; Behrouz,33,0,70,37
1650614000453,ECE 180,A00,083140,Abi Samra; Nicholas Camill,21,0,30,9
1650614000453,ECE 180,B00,083141,Abi Samra; Nicholas Camill,0,0,30,30
1650614006490,MATH 10A,A01,083735,Patchell; Gregory David,4,0,30,26
1650614006490,MATH 10A,A02,083736,Patchell; Gregory David,27,0,30,3
1650614006490,MATH 10A,A03,083737,Patchell; Gregory David,24,0,30,6
1650614012515,MATH 10B,A01,083207,Staff,0,8,30,30
1650614012515,MATH 10B,A02,083208,Staff,0,8,30,30
1650614012515,MATH 10B,B01,083739,Staff,11,0,30,19
1650614012515,MATH 10B,B02,083740,Staff,28,0,30,2
1650614018548,MATH 18,A01,083743,Staff,0,0,30,30
1650614018548,MATH 18,A02,083744,Staff,23,0,30,7
1650614018548,MATH 18,A03,083745,Staff,21,0,30,9
1650614018548,MATH 18,A04,083746,Staff,26,0,30,4
1650614018548,MATH 18,B01,083748,Staff,0,15,30,30
1650614018548,MATH 18,B02,083749,Staff,0,11,30,30
1650614018548,MATH 18,B03,083750,Staff,0,12,30,30
1650614018548,MATH 18,B04,083751,Staff,0,12,30,30
1650614024576,MATH 20A,A01,083754,Staff,19,0,40,21
1650614030600,MATH 20B,A01,083756,Staff,0,12,30,30
1650614030600,MATH 20B,A02,083757,Staff,0,12,30,30
1650614036631,MATH 20C,A01,083760,Staff,0,15,30,30
1650614036631,MATH 20C,A02,083761,Staff,1,13,30,29
1650614036631,MATH 20C,B01,083762,Staff,11,0,30,19
1650614036631,MATH 20C,B02,083763,Staff,28,0,30,2
1650614042656,MATH 20D,A01,083765,Staff,1,1,30,29
1650614042656,MATH 20D,A02,083766,Staff,7,0,30,23
1650614042656,MATH 20D,A03,083767,Staff,24,0,30,6
1650614048683,MATH 20E,A01,083771,Staff,3,0,30,27
1650614048683,MATH 20E,A02,083772,Staff,17,0,30,13
1650614048683,MATH 20E,B01,083773,Staff,0,0,30,30
1650614048683,MATH 20E,B02,083774,Staff,9,0,30,21
1650614054709,MATH 103A,A01,083777,Staff,0,15,30,30
1650614054709,MATH 103A,A02,083778,Staff,0,15,30,30
1650614054709,MATH 103A,B01,083779,Staff,0,14,30,30
1650614054709,MATH 103A,B02,083780,Staff,0,14,30,30
1650614060750,MATH 105,A01,085443,Staff,0,21,30,30
1650614066778,MATH 109,A01,083213,Anzaldo; Leesa B,0,6,30,30
1650614066778,MATH 109,A02,083214,Anzaldo; Leesa B,0,7,30,30
1650614066778,MATH 109,B01,083215,Anzaldo; Leesa B,0,6,30,30
1650614066778,MATH 109,B02,083216,Anzaldo; Leesa B,0,6,30,30
1650614072809,MATH 142A,A01,083219,Chow; Bennett,0,16,30,30
1650614072809,MATH 142A,A02,083220,Chow; Bennett,0,15,30,30
1650614072809,MATH 142A,B01,083221,Chow; Bennett,0,14,30,30
1650614072809,MATH 142A,B02,083222,Chow; Bennett,0,13,30,30
1650614078845,MATH 193A,A01,083224,Staff,0,5,30,30
1650614078845,MATH 193A,A02,083225,Staff,0,6,30,30
1650614078845,MATH 193A,A03,083781,Staff,0,6,30,30
1650614078845,MATH 193A,A04,083782,Staff,0,7,30,30
1650614084896,MATH 197,001,091859,McAuley; Julian John,9998,0,9999,1
1650614090970,COGS 9,A01,083615,Staff,0,15,60,60
1650614096998,COGS 11,A01,083617,Boyle; Mary E. T.,18,0,40,22
1650614103023,COGS 13,A01,083071,Staff,0,38,40,40
1650614109055,COGS 14A,A01,092681,Staff,0,30,100,100
1650614115081,COGS 14B,A01,083073,Cheng; Tzu-Han,0,13,50,50
1650614121105,COGS 17,A01,092677,Staff,17,0,75,58
1650614127141,COGS 100,A01,083619,Staff,0,26,60,60
1650614133167,COGS 101A,A01,083621,Davis; Joshua Daniel,0,26,60,60
1650614139193,COGS 101B,A01,091572,Staff,0,4,60,60
1650614145219,COGS 101C,A01,083625,Delgado; Tania,15,0,30,15
1650614151243,COGS 107A,A01,083627,Boyle; Mary E. T.,1,15,60,59
1650614157273,COGS 118A,A01,083075,Staff,0,5,60,60
1650614163300,CSE 3,A50,083646,Miranda; Gregory Joseph,19,0,38,19
1650614163300,CSE 3,A51,083647,Miranda; Gregory Joseph,36,0,37,1
1650614169330,CSE 8A,A50,083650,Miranda; Gregory Joseph,0,30,40,40
1650614175359,CSE 11,A01,083080,Cao; Yingjun,0,95,40,40
1650614181383,CSE 12,A01,083652,Staff,0,19,100,100
1650614187411,CSE 15L,A01,083654,Staff,0,2,50,50
1650614187411,CSE 15L,A02,083655,Staff,0,1,50,50
1650614193436,CSE 20,A01,083657,Staff,51,0,80,29
1650614199461,CSE 30,A01,083084,Eldon; John,0,78,40,40
1650614205487,CSE 100,A01,083659,Cao; Yingjun,0,68,50,50
1650614211512,CSE 134B,A01,083661,Powell; Thomas Allan,0,35,65,65
1650614217548,CSE 140,A01,083663,Staff,0,8,75,75
1650614223578,CSE 140L,A01,083088,Eldon; John,0,15,75,75
1650614229618,CSE 175,A01,083665,Kumar; Rakesh,7,0,25,18
1650614235643,CSE 190,A00,092507,Dubnov; Shlomo,10,0,20,10
1650614241668,ECE 45,A01,083139,Staff,0,1,60,60
1650614247699,ECE 65,A50,083695,Staff,0,5,30,30
1650614253730,ECE 109,A01,091882,Touri; Behrouz,33,0,70,37
1650614259761,ECE 180,A00,083140,Abi Samra; Nicholas Camill,21,0,30,9
1650614259761,ECE 180,B00,083141,Abi Samra; Nicholas Camill,0,0,30,30
1650614265795,MATH 10A,A01,083735,Patchell; Gregory David,4,0,30,26
1650614265795,MATH 10A,A02,083736,Patchell; Gregory David,27,0,30,3
1650614265795,MATH 10A,A03,083737,Patchell; Gregory David,24,0,30,6
1650614271820,MATH 10B,A01,083207,Staff,0,8,30,30
1650614271820,MATH 10B,A02,083208,Staff,0,8,30,30
1650614271820,MATH 10B,B01,083739,Staff,11,0,30,19
1650614271820,MATH 10B,B02,083740,Staff,28,0,30,2
1650614277859,MATH 18,A01,083743,Staff,0,0,30,30
1650614277859,MATH 18,A02,083744,Staff,23,0,30,7
1650614277859,MATH 18,A03,083745,Staff,21,0,30,9
1650614277859,MATH 18,A04,083746,Staff,26,0,30,4
1650614277859,MATH 18,B01,083748,Staff,0,15,30,30
1650614277859,MATH 18,B02,083749,Staff,0,11,30,30
1650614277859,MATH 18,B03,083750,Staff,0,12,30,30
1650614277859,MATH 18,B04,083751,Staff,0,12,30,30
1650614283887,MATH 20A,A01,083754,Staff,19,0,40,21
1650614289917,MATH 20B,A01,083756,Staff,0,12,30,30
1650614289917,MATH 20B,A02,083757,Staff,0,12,30,30
1650614295946,MATH 20C,A01,083760,Staff,0,15,30,30
1650614295946,MATH 20C,A02,083761,Staff,1,13,30,29
1650614295946,MATH 20C,B01,083762,Staff,11,0,30,19
1650614295946,MATH 20C,B02,083763,Staff,28,0,30,2
1650614301975,MATH 20D,A01,083765,Staff,1,1,30,29
1650614301975,MATH 20D,A02,083766,Staff,7,0,30,23
1650614301975,MATH 20D,A03,083767,Staff,24,0,30,6
1650614308002,MATH 20E,A01,083771,Staff,3,0,30,27
1650614308002,MATH 20E,A02,083772,Staff,17,0,30,13
1650614308002,MATH 20E,B01,083773,Staff,0,0,30,30
1650614308002,MATH 20E,B02,083774,Staff,9,0,30,21
1650614314029,MATH 103A,A01,083777,Staff,0,15,30,30
1650614314029,MATH 103A,A02,083778,Staff,0,15,30,30
1650614314029,MATH 103A,B01,083779,Staff,0,14,30,30
1650614314029,MATH 103A,B02,083780,Staff,0,14,30,30
1650614320054,MATH 105,A01,085443,Staff,0,21,30,30
1650614326080,MATH 109,A01,083213,Anzaldo; Leesa B,0,6,30,30
1650614326080,MATH 109,A02,083214,Anzaldo; Leesa B,0,7,30,30
1650614326080,MATH 109,B01,083215,Anzaldo; Leesa B,0,6,30,30
1650614326080,MATH 109,B02,083216,Anzaldo; Leesa B,0,6,30,30
1650614332106,MATH 142A,A01,083219,Chow; Bennett,0,16,30,30
1650614332106,MATH 142A,A02,083220,Chow; Bennett,0,15,30,30
1650614332106,MATH 142A,B01,083221,Chow; Bennett,0,14,30,30
1650614332106,MATH 142A,B02,083222,Chow; Bennett,0,13,30,30
1650614338132,MATH 193A,A01,083224,Staff,0,5,30,30
1650614338132,MATH 193A,A02,083225,Staff,0,6,30,30
1650614338132,MATH 193A,A03,083781,Staff,0,6,30,30
1650614338132,MATH 193A,A04,083782,Staff,0,7,30,30
1650614344157,MATH 197,001,091859,McAuley; Julian John,9998,0,9999,1
1650614350221,COGS 9,A01,083615,Staff,0,15,60,60
1650614356251,COGS 11,A01,083617,Boyle; Mary E. T.,18,0,40,22
1650614362277,COGS 13,A01,083071,Staff,0,38,40,40
1650614368317,COGS 14A,A01,092681,Staff,0,30,100,100
1650614374341,COGS 14B,A01,083073,Cheng; Tzu-Han,0,13,50,50
1650614380369,COGS 17,A01,092677,Staff,17,0,75,58
1650614386394,COGS 100,A01,083619,Staff,0,26,60,60
1650614392426,COGS 101A,A01,083621,Davis; Joshua Daniel,0,26,60,60
1650614398460,COGS 101B,A01,091572,Staff,0,4,60,60
1650614404492,COGS 101C,A01,083625,Delgado; Tania,15,0,30,15
1650614410519,COGS 107A,A01,083627,Boyle; Mary E. T.,1,15,60,59
1650614416545,COGS 118A,A01,083075,Staff,0,5,60,60
1650614422573,CSE 3,A50,083646,Miranda; Gregory Joseph,19,0,38,19
1650614422573,CSE 3,A51,083647,Miranda; Gregory Joseph,36,0,37,1
1650614428605,CSE 8A,A50,083650,Miranda; Gregory Joseph,0,30,40,40
1650614434635,CSE 11,A01,083080,Cao; Yingjun,0,95,40,40
1650614440714,CSE 12,A01,083652,Staff,0,19,100,100
1650614446737,CSE 15L,A01,083654,Staff,0,2,50,50
1650614446737,CSE 15L,A02,083655,Staff,0,1,50,50
1650614452763,CSE 20,A01,083657,Staff,51,0,80,29
1650614458787,CSE 30,A01,083084,Eldon; John,0,78,40,40
1650614464821,CSE 100,A01,083659,Cao; Yingjun,0,68,50,50
1650614470845,CSE 134B,A01,083661,Powell; Thomas Allan,0,35,65,65
1650614476878,CSE 140,A01,083663,Staff,0,8,75,75
1650614482903,CSE 140L,A01,083088,Eldon; John,0,15,75,75
1650614488934,CSE 175,A01,083665,Kumar; Rakesh,7,0,25,18
1650614494960,CSE 190,A00,092507,Dubnov; Shlomo,10,0,20,10
1650614500989,ECE 45,A01,083139,Staff,0,1,60,60
1650614507016,ECE 65,A50,083695,Staff,0,5,30,30
1650614513046,ECE 109,A01,091882,Touri; Behrouz,33,0,70,37
1650614519072,ECE 180,A00,083140,Abi Samra; Nicholas Camill,21,0,30,9
1650614519072,ECE 180,B00,083141,Abi Samra; Nicholas Camill,0,0,30,30
1650614525110,MATH 10A,A01,083735,Patchell; Gregory David,4,0,30,26
1650614525110,MATH 10A,A02,083736,Patchell; Gregory David,27,0,30,3
1650614525110,MATH 10A,A03,083737,Patchell; Gregory David,24,0,30,6
1650614531134,MATH 10B,A01,083207,Staff,0,8,30,30
1650614531134,MATH 10B,A02,083208,Staff,0,8,30,30
1650614531134,MATH 10B,B01,083739,Staff,11,0,30,19
1650614531134,MATH 10B,B02,083740,Staff,28,0,30,2
1650614537163,MATH 18,A01,083743,Staff,0,0,30,30
1650614537163,MATH 18,A02,083744,Staff,23,0,30,7
1650614537163,MATH 18,A03,083745,Staff,21,0,30,9
1650614537163,MATH 18,A04,083746,Staff,26,0,30,4
1650614537163,MATH 18,B01,083748,Staff,0,15,30,30
1650614537163,MATH 18,B02,083749,Staff,0,11,30,30
1650614537163,MATH 18,B03,083750,Staff,0,12,30,30
1650614537163,MATH 18,B04,083751,Staff,0,12,30,30
1650614543187,MATH 20A,A01,083754,Staff,19,0,40,21
1650614549215,MATH 20B,A01,083756,Staff,0,12,30,30
1650614549215,MATH 20B,A02,083757,Staff,0,12,30,30
1650614555239,MATH 20C,A01,083760,Staff,0,15,30,30
1650614555239,MATH 20C,A02,083761,Staff,1,13,30,29
1650614555239,MATH 20C,B01,083762,Staff,11,0,30,19
1650614555239,MATH 20C,B02,083763,Staff,28,0,30,2
1650614561266,MATH 20D,A01,083765,Staff,1,1,30,29
1650614561266,MATH 20D,A02,083766,Staff,7,0,30,23
1650614561266,MATH 20D,A03,083767,Staff,24,0,30,6
1650614567298,MATH 20E,A01,083771,Staff,3,0,30,27
1650614567298,MATH 20E,A02,083772,Staff,17,0,30,13
1650614567298,MATH 20E,B01,083773,Staff,0,0,30,30
1650614567298,MATH 20E,B02,083774,Staff,9,0,30,21
1650614573396,MATH 103A,A01,083777,Staff,0,15,30,30
1650614573396,MATH 103A,A02,083778,Staff,0,15,30,30
1650614573396,MATH 103A,B01,083779,Staff,0,14,30,30
1650614573396,MATH 103A,B02,083780,Staff,0,14,30,30
1650614579422,MATH 105,A01,085443,Staff,0,21,30,30
1650614585453,MATH 109,A01,083213,Anzaldo; Leesa B,0,6,30,30
1650614585453,MATH 109,A02,083214,Anzaldo; Leesa B,0,7,30,30
1650614585453,MATH 109,B01,083215,Anzaldo; Leesa B,0,6,30,30
1650614585453,MATH 109,B02,083216,Anzaldo; Leesa B,0,6,30,30
1650614591479,MATH 142A,A01,083219,Chow; Bennett,0,16,30,30
1650614591479,MATH 142A,A02,083220,Chow; Bennett,0,15,30,30
1650614591479,MATH 142A,B01,083221,Chow; Bennett,0,14,30,30
1650614591479,MATH 142A,B02,083222,Chow; Bennett,0,13,30,30
1650614597515,MATH 193A,A01,083224,Staff,0,5,30,30
1650614597515,MATH 193A,A02,083225,Staff,0,6,30,30
1650614597515,MATH 193A,A03,083781,Staff,0,6,30,30
1650614597515,MATH 193A,A04,083782,Staff,0,7,30,30
1650614603540,MATH 197,001,091859,McAuley; Julian John,9998,0,9999,1
1650614609612,COGS 9,A01,083615,Staff,0,15,60,60
1650614615637,COGS 11,A01,083617,Boyle; Mary E. T.,18,0,40,22
1650614621679,COGS 13,A01,083071,Staff,0,38,40,40
1650614627701,COGS 14A,A01,092681,Staff,0,30,100,100
1650614633732,COGS 14B,A01,083073,Cheng; Tzu-Han,0,13,50,50
1650614639758,COGS 17,A01,092677,Staff,17,0,75,58
1650614645784,COGS 100,A01,083619,Staff,0,26,60,60
1650614651810,COGS 101A,A01,083621,Davis; Joshua Daniel,0,26,60,60
1650614657839,COGS 101B,A01,091572,Staff,0,4,60,60
1650614663863,COGS 101C,A01,083625,Delgado; Tania,15,0,30,15
1650614669894,COGS 107A,A01,083627,Boyle; Mary E. T.,1,15,60,59
1650614675918,COGS 118A,A01,083075,Staff,0,5,60,60
1650614681947,CSE 3,A50,083646,Miranda; Gregory Joseph,19,0,38,19
1650614681947,CSE 3,A51,083647,Miranda; Gregory Joseph,36,0,37,1
1650614687978,CSE 8A,A50,083650,Miranda; Gregory Joseph,0,30,40,40
1650614694003,CSE 11,A01,083080,Cao; Yingjun,0,95,40,40
1650614700032,CSE 12,A01,083652,Staff,0,19,100,100
1650614706060,CSE 15L,A01,083654,Staff,0,2,50,50
1650614706060,CSE 15L,A02,083655,Staff,0,1,50,50
1650614712086,CSE 20,A01,083657,Staff,51,0,80,29
1650614718115,CSE 30,A01,083084,Eldon; John,0,78,40,40
1650614724156,CSE 100,A01,083659,Cao; Yingjun,0,68,50,50
1650614730185,CSE 134B,A01,083661,Powell; Thomas Allan,0,35,65,65
1650614736209,CSE 140,A01,083663,Staff,0,8,75,75
1650614742235,CSE 140L,A01,083088,Eldon; John,0,15,75,75
1650614748267,CSE 175,A01,083665,Kumar; Rakesh,7,0,25,18
1650614754293,CSE 190,A00,092507,Dubnov; Shlomo,10,0,20,10
1650614760322,ECE 45,A01,083139,Staff,0,1,60,60
1650614766348,ECE 65,A50,083695,Staff,0,5,30,30
1650614772373,ECE 109,A01,091882,Touri; Behrouz,33,0,70,37
1650614778397,ECE 180,A00,083140,Abi Samra; Nicholas Camill,21,0,30,9
1650614778397,ECE 180,B00,083141,Abi Samra; Nicholas Camill,0,0,30,30
1650614784426,MATH 10A,A01,083735,Patchell; Gregory David,4,0,30,26
1650614784426,MATH 10A,A02,083736,Patchell; Gregory David,27,0,30,3
1650614784426,MATH 10A,A03,083737,Patchell; Gregory David,24,0,30,6
1650614790451,MATH 10B,A01,083207,Staff,0,8,30,30
1650614790451,MATH 10B,A02,083208,Staff,0,8,30,30
1650614790451,MATH 10B,B01,083739,Staff,11,0,30,19
1650614790451,MATH 10B,B02,083740,Staff,28,0,30,2
1650614796483,MATH 18,A01,083743,Staff,0,0,30,30
1650614796483,MATH 18,A02,083744,Staff,23,0,30,7
1650614796483,MATH 18,A03,083745,Staff,21,0,30,9
1650614796483,MATH 18,A04,083746,Staff,26,0,30,4
1650614796483,MATH 18,B01,083748,Staff,0,15,30,30
1650614796483,MATH 18,B02,083749,Staff,0,11,30,30
1650614796483,MATH 18,B03,083750,Staff,0,12,30,30
1650614796483,MATH 18,B04,083751,Staff,0,12,30,30
1650614802525,MATH 20A,A01,083754,Staff,19,0,40,21
1650614808552,MATH 20B,A01,083756,Staff,0,12,30,30
1650614808552,MATH 20B,A02,083757,Staff,0,12,30,30
1650614814575,MATH 20C,A01,083760,Staff,0,15,30,30
1650614814575,MATH 20C,A02,083761,Staff,1,13,30,29
1650614814575,MATH 20C,B01,083762,Staff,11,0,30,19
1650614814575,MATH 20C,B02,083763,Staff,28,0,30,2
1650614820600,MATH 20D,A01,083765,Staff,1,1,30,29
1650614820600,MATH 20D,A02,083766,Staff,7,0,30,23
1650614820600,MATH 20D,A03,083767,Staff,24,0,30,6
1650614826631,MATH 20E,A01,083771,Staff,3,0,30,27
1650614826631,MATH 20E,A02,083772,Staff,17,0,30,13
1650614826631,MATH 20E,B01,083773,Staff,0,0,30,30
1650614826631,MATH 20E,B02,083774,Staff,9,0,30,21
1650614832659,MATH 103A,A01,083777,Staff,0,15,30,30
1650614832659,MATH 103A,A02,083778,Staff,0,15,30,30
1650614832659,MATH 103A,B01,083779,Staff,0,14,30,30
1650614832659,MATH 103A,B02,083780,Staff,0,14,30,30
1650614838685,MATH 105,A01,085443,Staff,0,21,30,30
1650614844710,MATH 109,A01,083213,Anzaldo; Leesa B,0,6,30,30
1650614844710,MATH 109,A02,083214,Anzaldo; Leesa B,0,7,30,30
1650614844710,MATH 109,B01,083215,Anzaldo; Leesa B,0,6,30,30
1650614844710,MATH 109,B02,083216,Anzaldo; Leesa B,0,6,30,30
1650614850741,MATH 142A,A01,083219,Chow; Bennett,0,16,30,30
1650614850741,MATH 142A,A02,083220,Chow; Bennett,0,15,30,30
1650614850741,MATH 142A,B01,083221,Chow; Bennett,0,14,30,30
1650614850741,MATH 142A,B02,083222,Chow; Bennett,0,13,30,30
1650614856767,MATH 193A,A01,083224,Staff,0,5,30,30
1650614856767,MATH 193A,A02,083225,Staff,0,6,30,30
1650614856767,MATH 193A,A03,083781,Staff,0,6,30,30
1650614856767,MATH 193A,A04,083782,Staff,0,7,30,30
1650614862799,MATH 197,001,091859,McAuley; Julian John,9998,0,9999,1
1650614876623,COGS 9,A01,083615,Staff,0,15,60,60
1650614882647,COGS 11,A01,083617,Boyle; Mary E. T.,18,0,40,22
1650614888673,COGS 13,A01,083071,Staff,0,38,40,40
1650614894703,COGS 14A,A01,092681,Staff,0,30,100,100
1650614900734,COGS 14B,A01,083073,Cheng; Tzu-Han,0,13,50,50
1650614906763,COGS 17,A01,092677,Staff,17,0,75,58
1650614912797,COGS 100,A01,083619,Staff,0,26,60,60
1650614918822,COGS 101A,A01,083621,Davis; Joshua Daniel,0,26,60,60
1650614924847,COGS 101B,A01,091572,Staff,0,4,60,60
1650614930873,COGS 101C,A01,083625,Delgado; Tania,15,0,30,15
1650614936908,COGS 107A,A01,083627,Boyle; Mary E. T.,1,15,60,59
1650614942949,COGS 118A,A01,083075,Staff,0,5,60,60
1650614948975,CSE 3,A50,083646,Miranda; Gregory Joseph,19,0,38,19
1650614948975,CSE 3,A51,083647,Miranda; Gregory Joseph,36,0,37,1
1650614955001,CSE 8A,A50,083650,Miranda; Gregory Joseph,0,30,40,40
1650614961031,CSE 11,A01,083080,Cao; Yingjun,0,95,40,40
1650614967053,CSE 12,A01,083652,Staff,0,19,100,100
1650614973076,CSE 15L,A01,083654,Staff,0,2,50,50
1650614973076,CSE 15L,A02,083655,Staff,0,1,50,50
1650614979101,CSE 20,A01,083657,Staff,51,0,80,29
1650614985126,CSE 30,A01,083084,Eldon; John,0,78,40,40
1650614991155,CSE 100,A01,083659,Cao; Yingjun,0,68,50,50
1650614997187,CSE 134B,A01,083661,Powell; Thomas Allan,0,35,65,65
1650615003220,CSE 140,A01,083663,Staff,0,8,75,75
1650615009256,CSE 140L,A01,083088,Eldon; John,0,15,75,75
1650615015281,CSE 175,A01,083665,Kumar; Rakesh,7,0,25,18
1650615021307,CSE 190,A00,092507,Dubnov; Shlomo,10,0,20,10
1650615027335,ECE 45,A01,083139,Staff,0,1,60,60
1650615033369,ECE 65,A50,083695,Staff,0,5,30,30
1650615039399,ECE 109,A01,091882,Touri; Behrouz,33,0,70,37
1650615045427,ECE 180,A00,083140,Abi Samra; Nicholas Camill,21,0,30,9
1650615045427,ECE 180,B00,083141,Abi Samra; Nicholas Camill,0,0,30,30
1650615051465,MATH 10A,A01,083735,Patchell; Gregory David,4,0,30,26
1650615051465,MATH 10A,A02,083736,Patchell; Gregory David,27,0,30,3
1650615051465,MATH 10A,A03,083737,Patchell; Gregory David,24,0,30,6
1650615057496,MATH 10B,A01,083207,Staff,0,8,30,30
1650615057496,MATH 10B,A02,083208,Staff,0,8,30,30
1650615057496,MATH 10B,B01,083739,Staff,11,0,30,19
1650615057496,MATH 10B,B02,083740,Staff,28,0,30,2
1650615063525,MATH 18,A01,083743,Staff,0,0,30,30
1650615063525,MATH 18,A02,083744,Staff,23,0,30,7
1650615063525,MATH 18,A03,083745,Staff,21,0,30,9
1650615063525,MATH 18,A04,083746,Staff,26,0,30,4
1650615063525,MATH 18,B01,083748,Staff,0,15,30,30
1650615063525,MATH 18,B02,083749,Staff,0,11,30,30
1650615063525,MATH 18,B03,083750,Staff,0,12,30,30
1650615063525,MATH 18,B04,083751,Staff,0,12,30,30
1650615069554,MATH 20A,A01,083754,Staff,19,0,40,21
1650615075579,MATH 20B,A01,083756,Staff,0,12,30,30
1650615075579,MATH 20B,A02,083757,Staff,0,12,30,30
1650615081607,MATH 20C,A01,083760,Staff,0,15,30,30
1650615081607,MATH 20C,A02,083761,Staff,1,13,30,29
1650615081607,MATH 20C,B01,083762,Staff,11,0,30,19
1650615081607,MATH 20C,B02,083763,Staff,28,0,30,2
1650615087632,MATH 20D,A01,083765,Staff,1,1,30,29
1650615087632,MATH 20D,A02,083766,Staff,7,0,30,23
1650615087632,MATH 20D,A03,083767,Staff,24,0,30,6
1650615093657,MATH 20E,A01,083771,Staff,3,0,30,27
1650615093657,MATH 20E,A02,083772,Staff,17,0,30,13
1650615093657,MATH 20E,B01,083773,Staff,0,0,30,30
1650615093657,MATH 20E,B02,083774,Staff,9,0,30,21
1650615099690,MATH 103A,A01,083777,Staff,0,15,30,30
1650615099690,MATH 103A,A02,083778,Staff,0,15,30,30
1650615099690,MATH 103A,B01,083779,Staff,0,14,30,30
1650615099690,MATH 103A,B02,083780,Staff,0,14,30,30
1650615105720,MATH 105,A01,085443,Staff,0,21,30,30
1650615111744,MATH 109,A01,083213,Anzaldo; Leesa B,0,6,30,30
1650615111744,MATH 109,A02,083214,Anzaldo; Leesa B,0,7,30,30
1650615111744,MATH 109,B01,083215,Anzaldo; Leesa B,0,6,30,30
1650615111744,MATH 109,B02,083216,Anzaldo; Leesa B,0,6,30,30
1650615117770,MATH 142A,A01,083219,Chow; Bennett,0,16,30,30
1650615117770,MATH 142A,A02,083220,Chow; Bennett,0,15,30,30
1650615117770,MATH 142A,B01,083221,Chow; Bennett,0,14,30,30
1650615117770,MATH 142A,B02,083222,Chow; Bennett,0,13,30,30
1650615123799,MATH 193A,A01,083224,Staff,0,5,30,30
1650615123799,MATH 193A,A02,083225,Staff,0,6,30,30
1650615123799,MATH 193A,A03,083781,Staff,0,6,30,30
1650615123799,MATH 193A,A04,083782,Staff,0,7,30,30
1650615129828,MATH 197,001,091859,McAuley; Julian John,9998,0,9999,1
1650615135899,COGS 9,A01,083615,Staff,0,15,60,60
1650615141926,COGS 11,A01,083617,Boyle; Mary E. T.,18,0,40,22
1650615147951,COGS 13,A01,083071,Staff,0,38,40,40
1650615153978,COGS 14A,A01,092681,Staff,0,30,100,100
1650615160007,COGS 14B,A01,083073,Cheng; Tzu-Han,0,13,50,50
1650615166031,COGS 17,A01,092677,Staff,17,0,75,58
1650615172131,COGS 100,A01,083619,Staff,0,26,60,60
1650615178156,COGS 101A,A01,083621,Davis; Joshua Daniel,0,26,60,60
1650615184186,COGS 101B,A01,091572,Staff,0,4,60,60
1650615190221,COGS 101C,A01,083625,Delgado; Tania,15,0,30,15
1650615196246,COGS 107A,A01,083627,Boyle; Mary E. T.,1,15,60,59
1650615202274,COGS 118A,A01,083075,Staff,0,5,60,60
1650615208309,CSE 3,A50,083646,Miranda; Gregory Joseph,19,0,38,19
1650615208309,CSE 3,A51,083647,Miranda; Gregory Joseph,36,0,37,1
1650615214339,CSE 8A,A50,083650,Miranda; Gregory Joseph,0,30,40,40
1650615220363,CSE 11,A01,083080,Cao; Yingjun,0,95,40,40
1650615226388,CSE 12,A01,083652,Staff,0,19,100,100
1650615232412,CSE 15L,A01,083654,Staff,0,2,50,50
1650615232412,CSE 15L,A02,083655,Staff,0,1,50,50
1650615238439,CSE 20,A01,083657,Staff,51,0,80,29
1650615244464,CSE 30,A01,083084,Eldon; John,0,78,40,40
1650615250488,CSE 100,A01,083659,Cao; Yingjun,0,68,50,50
1650615256513,CSE 134B,A01,083661,Powell; Thomas Allan,0,35,65,65
1650615262536,CSE 140,A01,083663,Staff,0,8,75,75
1650615268564,CSE 140L,A01,083088,Eldon; John,0,15,75,75
1650615274589,CSE 175,A01,083665,Kumar; Rakesh,7,0,25,18
1650615280620,CSE 190,A00,092507,Dubnov; Shlomo,10,0,20,10
1650615286643,ECE 45,A01,083139,Staff,0,1,60,60
1650615292668,ECE 65,A50,083695,Staff,0,5,30,30
1650615298696,ECE 109,A01,091882,Touri; Behrouz,33,0,70,37
1650615304727,ECE 180,A00,083140,Abi Samra; Nicholas Camill,21,0,30,9
1650615304727,ECE 180,B00,083141,Abi Samra; Nicholas Camill,0,0,30,30
1650615310769,MATH 10A,A01,083735,Patchell; Gregory David,4,0,30,26
1650615310769,MATH 10A,A02,083736,Patchell; Gregory David,27,0,30,3
1650615310769,MATH 10A,A03,083737,Patchell; Gregory David,24,0,30,6
1650615316801,MATH 10B,A01,083207,Staff,0,8,30,30
1650615316801,MATH 10B,A02,083208,Staff,0,8,30,30
1650615316801,MATH 10B,B01,083739,Staff,11,0,30,19
1650615316801,MATH 10B,B02,083740,Staff,28,0,30,2
1650615322837,MATH 18,A01,083743,Staff,0,0,30,30
1650615322837,MATH 18,A02,083744,Staff,23,0,30,7
1650615322837,MATH 18,A03,083745,Staff,21,0,30,9
1650615322837,MATH 18,A04,083746,Staff,26,0,30,4
1650615322837,MATH 18,B01,083748,Staff,0,15,30,30
1650615322837,MATH 18,B02,083749,Staff,0,11,30,30
1650615322837,MATH 18,B03,083750,Staff,0,12,30,30
1650615322837,MATH 18,B04,083751,Staff,0,12,30,30
1650615328861,MATH 20A,A01,083754,Staff,19,0,40,21
1650615334890,MATH 20B,A01,083756,Staff,0,12,30,30
1650615334890,MATH 20B,A02,083757,Staff,0,12,30,30
1650615340915,MATH 20C,A01,083760,Staff,0,15,30,30
1650615340915,MATH 20C,A02,083761,Staff,1,13,30,29
1650615340915,MATH 20C,B01,083762,Staff,11,0,30,19
1650615340915,MATH 20C,B02,083763,Staff,28,0,30,2
1650615346938,MATH 20D,A01,083765,Staff,1,1,30,29
1650615346938,MATH 20D,A02,083766,Staff,7,0,30,23
1650615346938,MATH 20D,A03,083767,Staff,24,0,30,6
1650615352963,MATH 20E,A01,083771,Staff,3,0,30,27
1650615352963,MATH 20E,A02,083772,Staff,17,0,30,13
1650615352963,MATH 20E,B01,083773,Staff,0,0,30,30
1650615352963,MATH 20E,B02,083774,Staff,9,0,30,21
1650615358987,MATH 103A,A01,083777,Staff,0,15,30,30
1650615358987,MATH 103A,A02,083778,Staff,0,15,30,30
1650615358987,MATH 103A,B01,083779,Staff,0,14,30,30
1650615358987,MATH 103A,B02,083780,Staff,0,14,30,30
1650615365013,MATH 105,A01,085443,Staff,0,21,30,30
1650615371062,MATH 109,A01,083213,Anzaldo; Leesa B,0,6,30,30
1650615371062,MATH 109,A02,083214,Anzaldo; Leesa B,0,7,30,30
1650615371062,MATH 109,B01,083215,Anzaldo; Leesa B,0,6,30,30
1650615371062,MATH 109,B02,083216,Anzaldo; Leesa B,0,6,30,30
1650615377087,MATH 142A,A01,083219,Chow; Bennett,0,16,30,30
1650615377087,MATH 142A,A02,083220,Chow; Bennett,0,15,30,30
1650615377087,MATH 142A,B01,083221,Chow; Bennett,0,14,30,30
1650615377087,MATH 142A,B02,083222,Chow; Bennett,0,13,30,30
1650615383121,MATH 193A,A01,083224,Staff,0,5,30,30
1650615383121,MATH 193A,A02,083225,Staff,0,6,30,30
1650615383121,MATH 193A,A03,083781,Staff,0,6,30,30
1650615383121,MATH 193A,A04,083782,Staff,0,7,30,30
1650615389145,MATH 197,001,091859,McAuley; Julian John,9998,0,9999,1
1650615395204,COGS 9,A01,083615,Staff,0,15,60,60
1650615401228,COGS 11,A01,083617,Boyle; Mary E. T.,18,0,40,22
1650615407255,COGS 13,A01,083071,Staff,0,38,40,40
1650615413280,COGS 14A,A01,092681,Staff,0,30,100,100
1650615419304,COGS 14B,A01,083073,Cheng; Tzu-Han,0,13,50,50
1650615425327,COGS 17,A01,092677,Staff,17,0,75,58
1650615431359,COGS 100,A01,083619,Staff,0,26,60,60
1650615437392,COGS 101A,A01,083621,Davis; Joshua Daniel,0,26,60,60
1650615443415,COGS 101B,A01,091572,Staff,0,4,60,60
1650615449445,COGS 101C,A01,083625,Delgado; Tania,15,0,30,15
1650615455471,COGS 107A,A01,083627,Boyle; Mary E. T.,1,15,60,59
1650615461495,COGS 118A,A01,083075,Staff,0,5,60,60
1650615467524,CSE 3,A50,083646,Miranda; Gregory Joseph,19,0,38,19
1650615467524,CSE 3,A51,083647,Miranda; Gregory Joseph,36,0,37,1
1650615473548,CSE 8A,A50,083650,Miranda; Gregory Joseph,0,30,40,40
1650615479572,CSE 11,A01,083080,Cao; Yingjun,0,95,40,40
1650615485600,CSE 12,A01,083652,Staff,0,19,100,100
1650615491625,CSE 15L,A01,083654,Staff,0,2,50,50
1650615491625,CSE 15L,A02,083655,Staff,0,1,50,50
1650615497654,CSE 20,A01,083657,Staff,51,0,80,29
1650615503686,CSE 30,A01,083084,Eldon; John,0,78,40,40
1650615509710,CSE 100,A01,083659,Cao; Yingjun,0,68,50,50
1650615515737,CSE 134B,A01,083661,Powell; Thomas Allan,0,35,65,65
1650615521765,CSE 140,A01,083663,Staff,0,8,75,75
1650615527793,CSE 140L,A01,083088,Eldon; John,0,15,75,75
1650615533820,CSE 175,A01,083665,Kumar; Rakesh,7,0,25,18
1650615539848,CSE 190,A00,092507,Dubnov; Shlomo,10,0,20,10
1650615545875,ECE 45,A01,083139,Staff,0,1,60,60
1650615551900,ECE 65,A50,083695,Staff,0,5,30,30
1650615557927,ECE 109,A01,091882,Touri; Behrouz,33,0,70,37
1650615563951,ECE 180,A00,083140,Abi Samra; Nicholas Camill,21,0,30,9
1650615563951,ECE 180,B00,083141,Abi Samra; Nicholas Camill,0,0,30,30
1650615569983,MATH 10A,A01,083735,Patchell; Gregory David,4,0,30,26
1650615569983,MATH 10A,A02,083736,Patchell; Gregory David,27,0,30,3
1650615569983,MATH 10A,A03,083737,Patchell; Gregory David,24,0,30,6
1650615576025,MATH 10B,A01,083207,Staff,0,8,30,30
1650615576025,MATH 10B,A02,083208,Staff,0,8,30,30
1650615576025,MATH 10B,B01,083739,Staff,11,0,30,19
1650615576025,MATH 10B,B02,083740,Staff,28,0,30,2
1650615582052,MATH 18,A01,083743,Staff,0,0,30,30
1650615582052,MATH 18,A02,083744,Staff,23,0,30,7
1650615582052,MATH 18,A03,083745,Staff,21,0,30,9
1650615582052,MATH 18,A04,083746,Staff,26,0,30,4
1650615582052,MATH 18,B01,083748,Staff,0,15,30,30
1650615582052,MATH 18,B02,083749,Staff,0,11,30,30
1650615582052,MATH 18,B03,083750,Staff,0,12,30,30
1650615582052,MATH 18,B04,083751,Staff,0,12,30,30
1650615588081,MATH 20A,A01,083754,Staff,19,0,40,21
1650615594110,MATH 20B,A01,083756,Staff,0,12,30,30
1650615594110,MATH 20B,A02,083757,Staff,0,12,30,30
1650615600135,MATH 20C,A01,083760,Staff,0,15,30,30
1650615600135,MATH 20C,A02,083761,Staff,1,13,30,29
1650615600135,MATH 20C,B01,083762,Staff,11,0,30,19
1650615600135,MATH 20C,B02,083763,Staff,28,0,30,2
1650615606168,MATH 20D,A01,083765,Staff,1,1,30,29
1650615606168,MATH 20D,A02,083766,Staff,7,0,30,23
1650615606168,MATH 20D,A03,083767,Staff,24,0,30,6
1650615612194,MATH 20E,A01,083771,Staff,3,0,30,27
1650615612194,MATH 20E,A02,083772,Staff,17,0,30,13
1650615612194,MATH 20E,B01,083773,Staff,0,0,30,30
1650615612194,MATH 20E,B02,083774,Staff,9,0,30,21
1650615618222,MATH 103A,A01,083777,Staff,0,15,30,30
1650615618222,MATH 103A,A02,083778,Staff,0,15,30,30
1650615618222,MATH 103A,B01,083779,Staff,0,14,30,30
1650615618222,MATH 103A,B02,083780,Staff,0,14,30,30
1650615624246,MATH 105,A01,085443,Staff,0,21,30,30
1650615630270,MATH 109,A01,083213,Anzaldo; Leesa B,0,6,30,30
1650615630270,MATH 109,A02,083214,Anzaldo; Leesa B,0,7,30,30
1650615630270,MATH 109,B01,083215,Anzaldo; Leesa B,0,6,30,30
1650615630270,MATH 109,B02,083216,Anzaldo; Leesa B,0,6,30,30
1650615636300,MATH 142A,A01,083219,Chow; Bennett,0,16,30,30
1650615636300,MATH 142A,A02,083220,Chow; Bennett,0,15,30,30
1650615636300,MATH 142A,B01,083221,Chow; Bennett,0,14,30,30
1650615636300,MATH 142A,B02,083222,Chow; Bennett,0,13,30,30
1650615642324,MATH 193A,A01,083224,Staff,0,5,30,30
1650615642324,MATH 193A,A02,083225,Staff,0,6,30,30
1650615642324,MATH 193A,A03,083781,Staff,0,6,30,30
1650615642324,MATH 193A,A04,083782,Staff,0,7,30,30
1650615648351,MATH 197,001,091859,McAuley; Julian John,9998,0,9999,1
1650615654415,COGS 9,A01,083615,Staff,0,15,60,60
1650615660439,COGS 11,A01,083617,Boyle; Mary E. T.,18,0,40,22
1650615666465,COGS 13,A01,083071,Staff,0,38,40,40
1650615672491,COGS 14A,A01,092681,Staff,0,30,100,100
1650615678513,COGS 14B,A01,083073,Cheng; Tzu-Han,0,13,50,50
1650615684536,COGS 17,A01,092677,Staff,17,0,75,58
1650615690559,COGS 100,A01,083619,Staff,0,26,60,60
1650615696583,COGS 101A,A01,083621,Davis; Joshua Daniel,0,26,60,60
1650615702610,COGS 101B,A01,091572,Staff,0,4,60,60
1650615708635,COGS 101C,A01,083625,Delgado; Tania,15,0,30,15
1650615714664,COGS 107A,A01,083627,Boyle; Mary E. T.,1,15,60,59
1650615720689,COGS 118A,A01,083075,Staff,0,5,60,60
1650615726716,CSE 3,A50,083646,Miranda; Gregory Joseph,19,0,38,19
1650615726716,CSE 3,A51,083647,Miranda; Gregory Joseph,36,0,37,1
1650615732739,CSE 8A,A50,083650,Miranda; Gregory Joseph,0,30,40,40
1650615738767,CSE 11,A01,083080,Cao; Yingjun,0,95,40,40
1650615744793,CSE 12,A01,083652,Staff,0,19,100,100
1650615750824,CSE 15L,A01,083654,Staff,0,2,50,50
1650615750824,CSE 15L,A02,083655,Staff,0,1,50,50
1650615756849,CSE 20,A01,083657,Staff,51,0,80,29
1650615762879,CSE 30,A01,083084,Eldon; John,0,78,40,40
1650615768975,CSE 100,A01,083659,Cao; Yingjun,0,68,50,50
1650615774999,CSE 134B,A01,083661,Powell; Thomas Allan,0,35,65,65
1650615781024,CSE 140,A01,083663,Staff,0,8,75,75
1650615787049,CSE 140L,A01,083088,Eldon; John,0,15,75,75
1650615793074,CSE 175,A01,083665,Kumar; Rakesh,7,0,25,18
1650615799096,CSE 190,A00,092507,Dubnov; Shlomo,10,0,20,10
1650615805123,ECE 45,A01,083139,Staff,0,1,60,60
1650615811147,ECE 65,A50,083695,Staff,0,5,30,30
1650615817177,ECE 109,A01,091882,Touri; Behrouz,33,0,70,37
1650615823203,ECE 180,A00,083140,Abi Samra; Nicholas Camill,21,0,30,9
1650615823203,ECE 180,B00,083141,Abi Samra; Nicholas Camill,0,0,30,30
1650615829228,MATH 10A,A01,083735,Patchell; Gregory David,4,0,30,26
1650615829228,MATH 10A,A02,083736,Patchell; Gregory David,27,0,30,3
1650615829228,MATH 10A,A03,083737,Patchell; Gregory David,24,0,30,6
1650615835257,MATH 10B,A01,083207,Staff,0,8,30,30
1650615835257,MATH 10B,A02,083208,Staff,0,8,30,30
1650615835257,MATH 10B,B01,083739,Staff,11,0,30,19
1650615835257,MATH 10B,B02,083740,Staff,28,0,30,2
1650615841281,MATH 18,A01,083743,Staff,0,0,30,30
1650615841281,MATH 18,A02,083744,Staff,23,0,30,7
1650615841281,MATH 18,A03,083745,Staff,21,0,30,9
1650615841281,MATH 18,A04,083746,Staff,26,0,30,4
1650615841281,MATH 18,B01,083748,Staff,0,15,30,30
1650615841281,MATH 18,B02,083749,Staff,0,11,30,30
1650615841281,MATH 18,B03,083750,Staff,0,12,30,30
1650615841281,MATH 18,B04,083751,Staff,0,12,30,30
1650615847305,MATH 20A,A01,083754,Staff,19,0,40,21
1650615853336,MATH 20B,A01,083756,Staff,0,12,30,30
1650615853336,MATH 20B,A02,083757,Staff,0,12,30,30
1650615859364,MATH 20C,A01,083760,Staff,0,15,30,30
1650615859364,MATH 20C,A02,083761,Staff,1,13,30,29
1650615859364,MATH 20C,B01,083762,Staff,11,0,30,19
1650615859364,MATH 20C,B02,083763,Staff,28,0,30,2
1650615865392,MATH 20D,A01,083765,Staff,1,1,30,29
1650615865392,MATH 20D,A02,083766,Staff,7,0,30,23
1650615865392,MATH 20D,A03,083767,Staff,24,0,30,6
1650615871422,MATH 20E,A01,083771,Staff,3,0,30,27
1650615871422,MATH 20E,A02,083772,Staff,17,0,30,13
1650615871422,MATH 20E,B01,083773,Staff,0,0,30,30
1650615871422,MATH 20E,B02,083774,Staff,9,0,30,21
1650615877452,MATH 103A,A01,083777,Staff,0,15,30,30
1650615877452,MATH 103A,A02,083778,Staff,0,15,30,30
1650615877452,MATH 103A,B01,083779,Staff,0,14,30,30
1650615877452,MATH 103A,B02,083780,Staff,0,14,30,30
1650615883479,MATH 105,A01,085443,Staff,0,21,30,30
1650615889507,MATH 109,A01,083213,Anzaldo; Leesa B,0,6,30,30
1650615889507,MATH 109,A02,083214,Anzaldo; Leesa B,0,7,30,30
1650615889507,MATH 109,B01,083215,Anzaldo; Leesa B,0,6,30,30
1650615889507,MATH 109,B02,083216,Anzaldo; Leesa B,0,6,30,30
1650615895532,MATH 142A,A01,083219,Chow; Bennett,0,16,30,30
1650615895532,MATH 142A,A02,083220,Chow; Bennett,0,15,30,30
1650615895532,MATH 142A,B01,083221,Chow; Bennett,0,14,30,30
1650615895532,MATH 142A,B02,083222,Chow; Bennett,0,13,30,30
1650615901557,MATH 193A,A01,083224,Staff,0,5,30,30
1650615901557,MATH 193A,A02,083225,Staff,0,6,30,30
1650615901557,MATH 193A,A03,083781,Staff,0,6,30,30
1650615901557,MATH 193A,A04,083782,Staff,0,7,30,30
1650615907581,MATH 197,001,091859,McAuley; Julian John,9998,0,9999,1
1650615913651,COGS 9,A01,083615,Staff,0,15,60,60
1650615919680,COGS 11,A01,083617,Boyle; Mary E. T.,18,0,40,22
1650615925705,COGS 13,A01,083071,Staff,0,38,40,40
1650615931737,COGS 14A,A01,092681,Staff,0,30,100,100
1650615937759,COGS 14B,A01,083073,Cheng; Tzu-Han,0,13,50,50
1650615943792,COGS 17,A01,092677,Staff,17,0,75,58
1650615949817,COGS 100,A01,083619,Staff,0,26,60,60
1650615955846,COGS 101A,A01,083621,Davis; Joshua Daniel,0,26,60,60
1650615961874,COGS 101B,A01,091572,Staff,0,4,60,60
1650615967898,COGS 101C,A01,083625,Delgado; Tania,15,0,30,15
1650615973922,COGS 107A,A01,083627,Boyle; Mary E. T.,1,15,60,59
1650615979946,COGS 118A,A01,083075,Staff,0,5,60,60
1650615985971,CSE 3,A50,083646,Miranda; Gregory Joseph,19,0,38,19
1650615985971,CSE 3,A51,083647,Miranda; Gregory Joseph,36,0,37,1
1650615991995,CSE 8A,A50,083650,Miranda; Gregory Joseph,0,30,40,40
1650615998021,CSE 11,A01,083080,Cao; Yingjun,0,95,40,40
1650616004045,CSE 12,A01,083652,Staff,0,19,100,100
1650616010068,CSE 15L,A01,083654,Staff,0,2,50,50
1650616010068,CSE 15L,A02,083655,Staff,0,1,50,50
1650616016090,CSE 20,A01,083657,Staff,51,0,80,29
1650616022115,CSE 30,A01,083084,Eldon; John,0,78,40,40
1650616028140,CSE 100,A01,083659,Cao; Yingjun,0,68,50,50
1650616034165,CSE 134B,A01,083661,Powell; Thomas Allan,0,35,65,65
1650616040190,CSE 140,A01,083663,Staff,0,8,75,75
1650616046216,CSE 140L,A01,083088,Eldon; John,0,15,75,75
1650616052243,CSE 175,A01,083665,Kumar; Rakesh,7,0,25,18
1650616058266,CSE 190,A00,092507,Dubnov; Shlomo,10,0,20,10
1650616064299,ECE 45,A01,083139,Staff,0,1,60,60
1650616070324,ECE 65,A50,083695,Staff,0,5,30,30
1650616076351,ECE 109,A01,091882,Touri; Behrouz,33,0,70,37
1650616082376,ECE 180,A00,083140,Abi Samra; Nicholas Camill,21,0,30,9
1650616082376,ECE 180,B00,083141,Abi Samra; Nicholas Camill,0,0,30,30
1650616088403,MATH 10A,A01,083735,Patchell; Gregory David,4,0,30,26
1650616088403,MATH 10A,A02,083736,Patchell; Gregory David,27,0,30,3
1650616088403,MATH 10A,A03,083737,Patchell; Gregory David,24,0,30,6
1650616094432,MATH 10B,A01,083207,Staff,0,8,30,30
1650616094432,MATH 10B,A02,083208,Staff,0,8,30,30
1650616094432,MATH 10B,B01,083739,Staff,11,0,30,19
1650616094432,MATH 10B,B02,083740,Staff,28,0,30,2
1650616100463,MATH 18,A01,083743,Staff,0,0,30,30
1650616100463,MATH 18,A02,083744,Staff,23,0,30,7
1650616100463,MATH 18,A03,083745,Staff,21,0,30,9
1650616100463,MATH 18,A04,083746,Staff,26,0,30,4
1650616100463,MATH 18,B01,083748,Staff,0,15,30,30
1650616100463,MATH 18,B02,083749,Staff,0,11,30,30
1650616100463,MATH 18,B03,083750,Staff,0,12,30,30
1650616100463,MATH 18,B04,083751,Staff,0,12,30,30
1650616106488,MATH 20A,A01,083754,Staff,19,0,40,21
1650616112511,MATH 20B,A01,083756,Staff,0,12,30,30
1650616112511,MATH 20B,A02,083757,Staff,0,12,30,30
1650616118536,MATH 20C,A01,083760,Staff,0,15,30,30
1650616118536,MATH 20C,A02,083761,Staff,1,13,30,29
1650616118536,MATH 20C,B01,083762,Staff,11,0,30,19
1650616118536,MATH 20C,B02,083763,Staff,28,0,30,2
1650616124561,MATH 20D,A01,083765,Staff,1,1,30,29
1650616124561,MATH 20D,A02,083766,Staff,7,0,30,23
1650616124561,MATH 20D,A03,083767,Staff,24,0,30,6
1650616130589,MATH 20E,A01,083771,Staff,3,0,30,27
1650616130589,MATH 20E,A02,083772,Staff,17,0,30,13
1650616130589,MATH 20E,B01,083773,Staff,0,0,30,30
1650616130589,MATH 20E,B02,083774,Staff,9,0,30,21
1650616136614,MATH 103A,A01,083777,Staff,0,15,30,30
1650616136614,MATH 103A,A02,083778,Staff,0,15,30,30
1650616136614,MATH 103A,B01,083779,Staff,0,14,30,30
1650616136614,MATH 103A,B02,083780,Staff,0,14,30,30
1650616142642,MATH 105,A01,085443,Staff,0,21,30,30
1650616148670,MATH 109,A01,083213,Anzaldo; Leesa B,0,6,30,30
1650616148670,MATH 109,A02,083214,Anzaldo; Leesa B,0,7,30,30
1650616148670,MATH 109,B01,083215,Anzaldo; Leesa B,0,6,30,30
1650616148670,MATH 109,B02,083216,Anzaldo; Leesa B,0,6,30,30
1650616154695,MATH 142A,A01,083219,Chow; Bennett,0,16,30,30
1650616154695,MATH 142A,A02,083220,Chow; Bennett,0,15,30,30
1650616154695,MATH 142A,B01,083221,Chow; Bennett,0,14,30,30
1650616154695,MATH 142A,B02,083222,Chow; Bennett,0,13,30,30
1650616160729,MATH 193A,A01,083224,Staff,0,5,30,30
1650616160729,MATH 193A,A02,083225,Staff,0,6,30,30
1650616160729,MATH 193A,A03,083781,Staff,0,6,30,30
1650616160729,MATH 193A,A04,083782,Staff,0,7,30,30
1650616166753,MATH 197,001,091859,McAuley; Julian John,9998,0,9999,1
1650616172808,COGS 9,A01,083615,Staff,0,15,60,60
1650616178837,COGS 11,A01,083617,Boyle; Mary E. T.,18,0,40,22
1650616184864,COGS 13,A01,083071,Staff,0,38,40,40
1650616190891,COGS 14A,A01,092681,Staff,0,30,100,100
1650616196919,COGS 14B,A01,083073,Cheng; Tzu-Han,0,13,50,50
1650616202942,COGS 17,A01,092677,Staff,17,0,75,58
1650616208967,COGS 100,A01,083619,Staff,0,26,60,60
1650616214992,COGS 101A,A01,083621,Davis; Joshua Daniel,0,26,60,60
1650616221019,COGS 101B,A01,091572,Staff,0,4,60,60
1650616227046,COGS 101C,A01,083625,Delgado; Tania,15,0,30,15
1650616233074,COGS 107A,A01,083627,Boyle; Mary E. T.,1,15,60,59
1650616239109,COGS 118A,A01,083075,Staff,0,5,60,60
1650616245138,CSE 3,A50,083646,Miranda; Gregory Joseph,19,0,38,19
1650616245138,CSE 3,A51,083647,Miranda; Gregory Joseph,36,0,37,1
1650616251169,CSE 8A,A50,083650,Miranda; Gregory Joseph,0,30,40,40
1650616257191,CSE 11,A01,083080,Cao; Yingjun,0,95,40,40
1650616263220,CSE 12,A01,083652,Staff,0,19,100,100
1650616269245,CSE 15L,A01,083654,Staff,0,2,50,50
1650616269245,CSE 15L,A02,083655,Staff,0,1,50,50
1650616275273,CSE 20,A01,083657,Staff,51,0,80,29
1650616281297,CSE 30,A01,083084,Eldon; John,0,78,40,40
1650616287321,CSE 100,A01,083659,Cao; Yingjun,0,68,50,50
1650616293345,CSE 134B,A01,083661,Powell; Thomas Allan,0,35,65,65
1650616299372,CSE 140,A01,083663,Staff,0,8,75,75
1650616305396,CSE 140L,A01,083088,Eldon; John,0,15,75,75
1650616311427,CSE 175,A01,083665,Kumar; Rakesh,7,0,25,18
1650616317461,CSE 190,A00,092507,Dubnov; Shlomo,10,0,20,10
1650616323489,ECE 45,A01,083139,Staff,0,1,60,60
1650616329513,ECE 65,A50,083695,Staff,0,5,30,30
1650616335536,ECE 109,A01,091882,Touri; Behrouz,33,0,70,37
1650616341561,ECE 180,A00,083140,Abi Samra; Nicholas Camill,21,0,30,9
1650616341561,ECE 180,B00,083141,Abi Samra; Nicholas Camill,0,0,30,30
1650616347586,MATH 10A,A01,083735,Patchell; Gregory David,4,0,30,26
1650616347586,MATH 10A,A02,083736,Patchell; Gregory David,27,0,30,3
1650616347586,MATH 10A,A03,083737,Patchell; Gregory David,24,0,30,6
1650616353621,MATH 10B,A01,083207,Staff,0,8,30,30
1650616353621,MATH 10B,A02,083208,Staff,0,8,30,30
1650616353621,MATH 10B,B01,083739,Staff,11,0,30,19
1650616353621,MATH 10B,B02,083740,Staff,28,0,30,2
1650616359656,MATH 18,A01,083743,Staff,0,0,30,30
1650616359656,MATH 18,A02,083744,Staff,23,0,30,7
1650616359656,MATH 18,A03,083745,Staff,21,0,30,9
1650616359656,MATH 18,A04,083746,Staff,26,0,30,4
1650616359656,MATH 18,B01,083748,Staff,0,15,30,30
1650616359656,MATH 18,B02,083749,Staff,0,11,30,30
1650616359656,MATH 18,B03,083750,Staff,0,12,30,30
1650616359656,MATH 18,B04,083751,Staff,0,12,30,30
1650616365752,MATH 20A,A01,083754,Staff,19,0,40,21
1650616371780,MATH 20B,A01,083756,Staff,0,12,30,30
1650616371780,MATH 20B,A02,083757,Staff,0,12,30,30
1650616377803,MATH 20C,A01,083760,Staff,0,15,30,30
1650616377803,MATH 20C,A02,083761,Staff,1,13,30,29
1650616377803,MATH 20C,B01,083762,Staff,11,0,30,19
1650616377803,MATH 20C,B02,083763,Staff,28,0,30,2
1650616383832,MATH 20D,A01,083765,Staff,1,1,30,29
1650616383832,MATH 20D,A02,083766,Staff,7,0,30,23
1650616383832,MATH 20D,A03,083767,Staff,24,0,30,6
1650616389857,MATH 20E,A01,083771,Staff,3,0,30,27
1650616389857,MATH 20E,A02,083772,Staff,17,0,30,13
1650616389857,MATH 20E,B01,083773,Staff,0,0,30,30
1650616389857,MATH 20E,B02,083774,Staff,9,0,30,21
1650616395888,MATH 103A,A01,083777,Staff,0,15,30,30
1650616395888,MATH 103A,A02,083778,Staff,0,15,30,30
1650616395888,MATH 103A,B01,083779,Staff,0,14,30,30
1650616395888,MATH 103A,B02,083780,Staff,0,14,30,30
1650616401913,MATH 105,A01,085443,Staff,0,21,30,30
1650616407940,MATH 109,A01,083213,Anzaldo; Leesa B,0,6,30,30
1650616407940,MATH 109,A02,083214,Anzaldo; Leesa B,0,7,30,30
1650616407940,MATH 109,B01,083215,Anzaldo; Leesa B,0,6,30,30
1650616407940,MATH 109,B02,083216,Anzaldo; Leesa B,0,6,30,30
1650616413968,MATH 142A,A01,083219,Chow; Bennett,0,16,30,30
1650616413968,MATH 142A,A02,083220,Chow; Bennett,0,15,30,30
1650616413968,MATH 142A,B01,083221,Chow; Bennett,0,14,30,30
1650616413968,MATH 142A,B02,083222,Chow; Bennett,0,13,30,30
1650616419992,MATH 193A,A01,083224,Staff,0,5,30,30
1650616419992,MATH 193A,A02,083225,Staff,0,6,30,30
1650616419992,MATH 193A,A03,083781,Staff,0,6,30,30
1650616419992,MATH 193A,A04,083782,Staff,0,7,30,30
1650616426017,MATH 197,001,091859,McAuley; Julian John,9998,0,9999,1
1650616432079,COGS 9,A01,083615,Staff,0,15,60,60
1650616438102,COGS 11,A01,083617,Boyle; Mary E. T.,18,0,40,22
1650616444131,COGS 13,A01,083071,Staff,0,38,40,40
1650616450158,COGS 14A,A01,092681,Staff,0,30,100,100
1650616456182,COGS 14B,A01,083073,Cheng; Tzu-Han,0,13,50,50
1650616462214,COGS 17,A01,092677,Staff,17,0,75,58
1650616468240,COGS 100,A01,083619,Staff,0,26,60,60
1650616474262,COGS 101A,A01,083621,Davis; Joshua Daniel,0,26,60,60
1650616480291,COGS 101B,A01,091572,Staff,0,4,60,60
1650616486314,COGS 101C,A01,083625,Delgado; Tania,15,0,30,15
1650616492338,COGS 107A,A01,083627,Boyle; Mary E. T.,1,15,60,59
1650616498362,COGS 118A,A01,083075,Staff,0,5,60,60
1650616504386,CSE 3,A50,083646,Miranda; Gregory Joseph,19,0,38,19
1650616504386,CSE 3,A51,083647,Miranda; Gregory Joseph,36,0,37,1
1650616510411,CSE 8A,A50,083650,Miranda; Gregory Joseph,0,30,40,40
1650616516440,CSE 11,A01,083080,Cao; Yingjun,0,95,40,40
1650616522475,CSE 12,A01,083652,Staff,0,19,100,100
1650616528503,CSE 15L,A01,083654,Staff,0,2,50,50
1650616528503,CSE 15L,A02,083655,Staff,0,1,50,50
1650616534535,CSE 20,A01,083657,Staff,51,0,80,29
1650616540560,CSE 30,A01,083084,Eldon; John,0,78,40,40
1650616546588,CSE 100,A01,083659,Cao; Yingjun,0,68,50,50
1650616552615,CSE 134B,A01,083661,Powell; Thomas Allan,0,35,65,65
1650616558639,CSE 140,A01,083663,Staff,0,8,75,75
1650616564664,CSE 140L,A01,083088,Eldon; John,0,15,75,75
1650616570688,CSE 175,A01,083665,Kumar; Rakesh,7,0,25,18
1650616576718,CSE 190,A00,092507,Dubnov; Shlomo,10,0,20,10
1650616582742,ECE 45,A01,083139,Staff,0,1,60,60
1650616588768,ECE 65,A50,083695,Staff,0,5,30,30
1650616594810,ECE 109,A01,091882,Touri; Behrouz,33,0,70,37
1650616600838,ECE 180,A00,083140,Abi Samra; Nicholas Camill,21,0,30,9
1650616600838,ECE 180,B00,083141,Abi Samra; Nicholas Camill,0,0,30,30
1650616606868,MATH 10A,A01,083735,Patchell; Gregory David,4,0,30,26
1650616606868,MATH 10A,A02,083736,Patchell; Gregory David,27,0,30,3
1650616606868,MATH 10A,A03,083737,Patchell; Gregory David,24,0,30,6
1650616612891,MATH 10B,A01,083207,Staff,0,8,30,30
1650616612891,MATH 10B,A02,083208,Staff,0,8,30,30
1650616612891,MATH 10B,B01,083739,Staff,11,0,30,19
1650616612891,MATH 10B,B02,083740,Staff,28,0,30,2
1650616618917,MATH 18,A01,083743,Staff,0,0,30,30
1650616618917,MATH 18,A02,083744,Staff,23,0,30,7
1650616618917,MATH 18,A03,083745,Staff,21,0,30,9
1650616618917,MATH 18,A04,083746,Staff,26,0,30,4
1650616618917,MATH 18,B01,083748,Staff,0,15,30,30
1650616618917,MATH 18,B02,083749,Staff,0,11,30,30
1650616618917,MATH 18,B03,083750,Staff,0,12,30,30
1650616618917,MATH 18,B04,083751,Staff,0,12,30,30
1650616624944,MATH 20A,A01,083754,Staff,19,0,40,21
1650616630970,MATH 20B,A01,083756,Staff,0,12,30,30
1650616630970,MATH 20B,A02,083757,Staff,0,12,30,30
1650616636995,MATH 20C,A01,083760,Staff,0,15,30,30
1650616636995,MATH 20C,A02,083761,Staff,1,13,30,29
1650616636995,MATH 20C,B01,083762,Staff,11,0,30,19
1650616636995,MATH 20C,B02,083763,Staff,28,0,30,2
1650616643019,MATH 20D,A01,083765,Staff,1,1,30,29
1650616643019,MATH 20D,A02,083766,Staff,7,0,30,23
1650616643019,MATH 20D,A03,083767,Staff,24,0,30,6
1650616649050,MATH 20E,A01,083771,Staff,3,0,30,27
1650616649050,MATH 20E,A02,083772,Staff,17,0,30,13
1650616649050,MATH 20E,B01,083773,Staff,0,0,30,30
1650616649050,MATH 20E,B02,083774,Staff,9,0,30,21
1650616655081,MATH 103A,A01,083777,Staff,0,15,30,30
1650616655081,MATH 103A,A02,083778,Staff,0,15,30,30
1650616655081,MATH 103A,B01,083779,Staff,0,14,30,30
1650616655081,MATH 103A,B02,083780,Staff,0,14,30,30
1650616661108,MATH 105,A01,085443,Staff,0,21,30,30
1650616667132,MATH 109,A01,083213,Anzaldo; Leesa B,0,6,30,30
1650616667132,MATH 109,A02,083214,Anzaldo; Leesa B,0,7,30,30
1650616667132,MATH 109,B01,083215,Anzaldo; Leesa B,0,6,30,30
1650616667132,MATH 109,B02,083216,Anzaldo; Leesa B,0,6,30,30
1650616673158,MATH 142A,A01,083219,Chow; Bennett,0,16,30,30
1650616673158,MATH 142A,A02,083220,Chow; Bennett,0,15,30,30
1650616673158,MATH 142A,B01,083221,Chow; Bennett,0,14,30,30
1650616673158,MATH 142A,B02,083222,Chow; Bennett,0,13,30,30
1650616679184,MATH 193A,A01,083224,Staff,0,5,30,30
1650616679184,MATH 193A,A02,083225,Staff,0,6,30,30
1650616679184,MATH 193A,A03,083781,Staff,0,6,30,30
1650616679184,MATH 193A,A04,083782,Staff,0,7,30,30
1650616685211,MATH 197,001,091859,McAuley; Julian John,9998,0,9999,1
1650616691270,COGS 9,A01,083615,Staff,0,15,60,60
1650616697294,COGS 11,A01,083617,Boyle; Mary E. T.,18,0,40,22
1650616703318,COGS 13,A01,083071,Staff,0,38,40,40
1650616709341,COGS 14A,A01,092681,Staff,0,30,100,100
1650616715365,COGS 14B,A01,083073,Cheng; Tzu-Han,0,13,50,50
1650616721389,COGS 17,A01,092677,Staff,17,0,75,58
1650616727417,COGS 100,A01,083619,Staff,0,26,60,60
1650616733446,COGS 101A,A01,083621,Davis; Joshua Daniel,0,26,60,60
1650616739480,COGS 101B,A01,091572,Staff,0,4,60,60
1650616745505,COGS 101C,A01,083625,Delgado; Tania,15,0,30,15
1650616751529,COGS 107A,A01,083627,Boyle; Mary E. T.,1,15,60,59
1650616757556,COGS 118A,A01,083075,Staff,0,5,60,60
1650616763591,CSE 3,A50,083646,Miranda; Gregory Joseph,19,0,38,19
1650616763591,CSE 3,A51,083647,Miranda; Gregory Joseph,36,0,37,1
1650616769615,CSE 8A,A50,083650,Miranda; Gregory Joseph,0,30,40,40
1650616775644,CSE 11,A01,083080,Cao; Yingjun,0,95,40,40
1650616781670,CSE 12,A01,083652,Staff,0,19,100,100
1650616787696,CSE 15L,A01,083654,Staff,0,2,50,50
1650616787696,CSE 15L,A02,083655,Staff,0,1,50,50
1650616793729,CSE 20,A01,083657,Staff,51,0,80,29
1650616799756,CSE 30,A01,083084,Eldon; John,0,78,40,40
1650616805781,CSE 100,A01,083659,Cao; Yingjun,0,68,50,50
1650616811803,CSE 134B,A01,083661,Powell; Thomas Allan,0,35,65,65
1650616817827,CSE 140,A01,083663,Staff,0,8,75,75
1650616823855,CSE 140L,A01,083088,Eldon; John,0,15,75,75
1650616829879,CSE 175,A01,083665,Kumar; Rakesh,7,0,25,18
1650616835906,CSE 190,A00,092507,Dubnov; Shlomo,10,0,20,10
1650616841931,ECE 45,A01,083139,Staff,0,1,60,60
1650616847954,ECE 65,A50,083695,Staff,0,5,30,30
1650616853985,ECE 109,A01,091882,Touri; Behrouz,33,0,70,37
1650616860015,ECE 180,A00,083140,Abi Samra; Nicholas Camill,21,0,30,9
1650616860015,ECE 180,B00,083141,Abi Samra; Nicholas Camill,0,0,30,30
1650616866038,MATH 10A,A01,083735,Patchell; Gregory David,4,0,30,26
1650616866038,MATH 10A,A02,083736,Patchell; Gregory David,27,0,30,3
1650616866038,MATH 10A,A03,083737,Patchell; Gregory David,24,0,30,6
1650616872063,MATH 10B,A01,083207,Staff,0,8,30,30
1650616872063,MATH 10B,A02,083208,Staff,0,8,30,30
1650616872063,MATH 10B,B01,083739,Staff,11,0,30,19
1650616872063,MATH 10B,B02,083740,Staff,28,0,30,2
1650616878093,MATH 18,A01,083743,Staff,0,0,30,30
1650616878093,MATH 18,A02,083744,Staff,23,0,30,7
1650616878093,MATH 18,A03,083745,Staff,21,0,30,9
1650616878093,MATH 18,A04,083746,Staff,26,0,30,4
1650616878093,MATH 18,B01,083748,Staff,0,15,30,30
1650616878093,MATH 18,B02,083749,Staff,0,11,30,30
1650616878093,MATH 18,B03,083750,Staff,0,12,30,30
1650616878093,MATH 18,B04,083751,Staff,0,12,30,30
1650616884132,MATH 20A,A01,083754,Staff,19,0,40,21
1650616890156,MATH 20B,A01,083756,Staff,0,12,30,30
1650616890156,MATH 20B,A02,083757,Staff,0,12,30,30
1650616896186,MATH 20C,A01,083760,Staff,0,15,30,30
1650616896186,MATH 20C,A02,083761,Staff,1,13,30,29
1650616896186,MATH 20C,B01,083762,Staff,11,0,30,19
1650616896186,MATH 20C,B02,083763,Staff,28,0,30,2
1650616902214,MATH 20D,A01,083765,Staff,1,1,30,29
1650616902214,MATH 20D,A02,083766,Staff,7,0,30,23
1650616902214,MATH 20D,A03,083767,Staff,24,0,30,6
1650616908249,MATH 20E,A01,083771,Staff,3,0,30,27
1650616908249,MATH 20E,A02,083772,Staff,17,0,30,13
1650616908249,MATH 20E,B01,083773,Staff,0,0,30,30
1650616908249,MATH 20E,B02,083774,Staff,9,0,30,21
1650616914276,MATH 103A,A01,083777,Staff,0,15,30,30
1650616914276,MATH 103A,A02,083778,Staff,0,15,30,30
1650616914276,MATH 103A,B01,083779,Staff,0,14,30,30
1650616914276,MATH 103A,B02,083780,Staff,0,14,30,30
1650616920304,MATH 105,A01,085443,Staff,0,21,30,30
1650616926336,MATH 109,A01,083213,Anzaldo; Leesa B,0,6,30,30
1650616926336,MATH 109,A02,083214,Anzaldo; Leesa B,0,7,30,30
1650616926336,MATH 109,B01,083215,Anzaldo; Leesa B,0,6,30,30
1650616926336,MATH 109,B02,083216,Anzaldo; Leesa B,0,6,30,30
1650616932361,MATH 142A,A01,083219,Chow; Bennett,0,16,30,30
1650616932361,MATH 142A,A02,083220,Chow; Bennett,0,15,30,30
1650616932361,MATH 142A,B01,083221,Chow; Bennett,0,14,30,30
1650616932361,MATH 142A,B02,083222,Chow; Bennett,0,13,30,30
1650616938385,MATH 193A,A01,083224,Staff,0,5,30,30
1650616938385,MATH 193A,A02,083225,Staff,0,6,30,30
1650616938385,MATH 193A,A03,083781,Staff,0,6,30,30
1650616938385,MATH 193A,A04,083782,Staff,0,7,30,30
1650616944410,MATH 197,001,091859,McAuley; Julian John,9998,0,9999,1
1650616950470,COGS 9,A01,083615,Staff,0,15,60,60
1650616956570,COGS 11,A01,083617,Boyle; Mary E. T.,18,0,40,22
1650616962600,COGS 13,A01,083071,Staff,0,38,40,40
1650616968627,COGS 14A,A01,092681,Staff,0,30,100,100
1650616974653,COGS 14B,A01,083073,Cheng; Tzu-Han,0,13,50,50
1650616980677,COGS 17,A01,092677,Staff,17,0,75,58
1650616986703,COGS 100,A01,083619,Staff,0,26,60,60
1650616992729,COGS 101A,A01,083621,Davis; Joshua Daniel,0,26,60,60
1650616998753,COGS 101B,A01,091572,Staff,0,4,60,60
1650617004780,COGS 101C,A01,083625,Delgado; Tania,15,0,30,15
1650617010807,COGS 107A,A01,083627,Boyle; Mary E. T.,1,15,60,59
1650617016847,COGS 118A,A01,083075,Staff,0,5,60,60
1650617022877,CSE 3,A50,083646,Miranda; Gregory Joseph,19,0,38,19
1650617022877,CSE 3,A51,083647,Miranda; Gregory Joseph,36,0,37,1
1650617028905,CSE 8A,A50,083650,Miranda; Gregory Joseph,0,30,40,40
1650617034930,CSE 11,A01,083080,Cao; Yingjun,0,95,40,40
1650617040957,CSE 12,A01,083652,Staff,0,19,100,100
1650617046984,CSE 15L,A01,083654,Staff,0,2,50,50
1650617046984,CSE 15L,A02,083655,Staff,0,1,50,50
1650617053011,CSE 20,A01,083657,Staff,51,0,80,29
1650617059037,CSE 30,A01,083084,Eldon; John,0,78,40,40
1650617065075,CSE 100,A01,083659,Cao; Yingjun,0,68,50,50
1650617071098,CSE 134B,A01,083661,Powell; Thomas Allan,0,35,65,65
1650617077126,CSE 140,A01,083663,Staff,0,8,75,75
1650617083154,CSE 140L,A01,083088,Eldon; John,0,15,75,75
1650617089181,CSE 175,A01,083665,Kumar; Rakesh,7,0,25,18
1650617095210,CSE 190,A00,092507,Dubnov; Shlomo,10,0,20,10
1650617101240,ECE 45,A01,083139,Staff,0,1,60,60
1650617107269,ECE 65,A50,083695,Staff,0,5,30,30
1650617113293,ECE 109,A01,091882,Touri; Behrouz,33,0,70,37
1650617119318,ECE 180,A00,083140,Abi Samra; Nicholas Camill,21,0,30,9
1650617119318,ECE 180,B00,083141,Abi Samra; Nicholas Camill,0,0,30,30
1650617125344,MATH 10A,A01,083735,Patchell; Gregory David,4,0,30,26
1650617125344,MATH 10A,A02,083736,Patchell; Gregory David,27,0,30,3
1650617125344,MATH 10A,A03,083737,Patchell; Gregory David,24,0,30,6
1650617131370,MATH 10B,A01,083207,Staff,0,8,30,30
1650617131370,MATH 10B,A02,083208,Staff,0,8,30,30
1650617131370,MATH 10B,B01,083739,Staff,11,0,30,19
1650617131370,MATH 10B,B02,083740,Staff,28,0,30,2
1650617137397,MATH 18,A01,083743,Staff,0,0,30,30
1650617137397,MATH 18,A02,083744,Staff,23,0,30,7
1650617137397,MATH 18,A03,083745,Staff,21,0,30,9
1650617137397,MATH 18,A04,083746,Staff,26,0,30,4
1650617137397,MATH 18,B01,083748,Staff,0,15,30,30
1650617137397,MATH 18,B02,083749,Staff,0,11,30,30
1650617137397,MATH 18,B03,083750,Staff,0,12,30,30
1650617137397,MATH 18,B04,083751,Staff,0,12,30,30
1650617143422,MATH 20A,A01,083754,Staff,19,0,40,21
1650617149450,MATH 20B,A01,083756,Staff,0,12,30,30
1650617149450,MATH 20B,A02,083757,Staff,0,12,30,30
1650617155546,MATH 20C,A01,083760,Staff,0,15,30,30
1650617155546,MATH 20C,A02,083761,Staff,1,13,30,29
1650617155546,MATH 20C,B01,083762,Staff,11,0,30,19
1650617155546,MATH 20C,B02,083763,Staff,28,0,30,2
1650617161574,MATH 20D,A01,083765,Staff,1,1,30,29
1650617161574,MATH 20D,A02,083766,Staff,7,0,30,23
1650617161574,MATH 20D,A03,083767,Staff,24,0,30,6
1650617167605,MATH 20E,A01,083771,Staff,3,0,30,27
1650617167605,MATH 20E,A02,083772,Staff,17,0,30,13
1650617167605,MATH 20E,B01,083773,Staff,0,0,30,30
1650617167605,MATH 20E,B02,083774,Staff,9,0,30,21
1650617173662,MATH 103A,A01,083777,Staff,0,15,30,30
1650617173662,MATH 103A,A02,083778,Staff,0,15,30,30
1650617173662,MATH 103A,B01,083779,Staff,0,14,30,30
1650617173662,MATH 103A,B02,083780,Staff,0,14,30,30
1650617179691,MATH 105,A01,085443,Staff,0,21,30,30
1650617185721,MATH 109,A01,083213,Anzaldo; Leesa B,0,6,30,30
1650617185721,MATH 109,A02,083214,Anzaldo; Leesa B,0,7,30,30
1650617185721,MATH 109,B01,083215,Anzaldo; Leesa B,0,6,30,30
1650617185721,MATH 109,B02,083216,Anzaldo; Leesa B,0,6,30,30
1650617191749,MATH 142A,A01,083219,Chow; Bennett,0,16,30,30
1650617191749,MATH 142A,A02,083220,Chow; Bennett,0,15,30,30
1650617191749,MATH 142A,B01,083221,Chow; Bennett,0,14,30,30
1650617191749,MATH 142A,B02,083222,Chow; Bennett,0,13,30,30
1650617197774,MATH 193A,A01,083224,Staff,0,5,30,30
1650617197774,MATH 193A,A02,083225,Staff,0,6,30,30
1650617197774,MATH 193A,A03,083781,Staff,0,6,30,30
1650617197774,MATH 193A,A04,083782,Staff,0,7,30,30
1650617203804,MATH 197,001,091859,McAuley; Julian John,9998,0,9999,1
1650617209884,COGS 9,A01,083615,Staff,0,15,60,60
1650617215909,COGS 11,A01,083617,Boyle; Mary E. T.,18,0,40,22
1650617221937,COGS 13,A01,083071,Staff,0,38,40,40
1650617227962,COGS 14A,A01,092681,Staff,0,30,100,100
1650617233989,COGS 14B,A01,083073,Cheng; Tzu-Han,0,13,50,50
1650617240014,COGS 17,A01,092677,Staff,17,0,75,58
1650617246039,COGS 100,A01,083619,Staff,0,26,60,60
1650617252063,COGS 101A,A01,083621,Davis; Joshua Daniel,0,26,60,60
1650617258095,COGS 101B,A01,091572,Staff,0,4,60,60
1650617264123,COGS 101C,A01,083625,Delgado; Tania,15,0,30,15
1650617270148,COGS 107A,A01,083627,Boyle; Mary E. T.,1,15,60,59
1650617276173,COGS 118A,A01,083075,Staff,0,5,60,60
1650617282200,CSE 3,A50,083646,Miranda; Gregory Joseph,19,0,38,19
1650617282200,CSE 3,A51,083647,Miranda; Gregory Joseph,36,0,37,1
1650617288224,CSE 8A,A50,083650,Miranda; Gregory Joseph,0,30,40,40
1650617294252,CSE 11,A01,083080,Cao; Yingjun,0,95,40,40
1650617300278,CSE 12,A01,083652,Staff,0,19,100,100
1650617306305,CSE 15L,A01,083654,Staff,0,2,50,50
1650617306305,CSE 15L,A02,083655,Staff,0,1,50,50
1650617312330,CSE 20,A01,083657,Staff,51,0,80,29
1650617318354,CSE 30,A01,083084,Eldon; John,0,78,40,40
1650617324379,CSE 100,A01,083659,Cao; Yingjun,0,68,50,50
1650617330408,CSE 134B,A01,083661,Powell; Thomas Allan,0,35,65,65
1650617336433,CSE 140,A01,083663,Staff,0,8,75,75
1650617342458,CSE 140L,A01,083088,Eldon; John,0,15,75,75
1650617348483,CSE 175,A01,083665,Kumar; Rakesh,7,0,25,18
1650617354508,CSE 190,A00,092507,Dubnov; Shlomo,10,0,20,10
1650617360537,ECE 45,A01,083139,Staff,0,1,60,60
1650617366561,ECE 65,A50,083695,Staff,0,5,30,30
1650617372590,ECE 109,A01,091882,Touri; Behrouz,33,0,70,37
1650617378615,ECE 180,A00,083140,Abi Samra; Nicholas Camill,21,0,30,9
1650617378615,ECE 180,B00,083141,Abi Samra; Nicholas Camill,0,0,30,30
1650617384652,MATH 10A,A01,083735,Patchell; Gregory David,4,0,30,26
1650617384652,MATH 10A,A02,083736,Patchell; Gregory David,27,0,30,3
1650617384652,MATH 10A,A03,083737,Patchell; Gregory David,24,0,30,6
1650617390676,MATH 10B,A01,083207,Staff,0,8,30,30
1650617390676,MATH 10B,A02,083208,Staff,0,8,30,30
1650617390676,MATH 10B,B01,083739,Staff,11,0,30,19
1650617390676,MATH 10B,B02,083740,Staff,28,0,30,2
1650617396708,MATH 18,A01,083743,Staff,0,0,30,30
1650617396708,MATH 18,A02,083744,Staff,23,0,30,7
1650617396708,MATH 18,A03,083745,Staff,21,0,30,9
1650617396708,MATH 18,A04,083746,Staff,26,0,30,4
1650617396708,MATH 18,B01,083748,Staff,0,15,30,30
1650617396708,MATH 18,B02,083749,Staff,0,11,30,30
1650617396708,MATH 18,B03,083750,Staff,0,12,30,30
1650617396708,MATH 18,B04,083751,Staff,0,12,30,30
1650617402738,MATH 20A,A01,083754,Staff,19,0,40,21
1650617408767,MATH 20B,A01,083756,Staff,0,12,30,30
1650617408767,MATH 20B,A02,083757,Staff,0,12,30,30
1650617414793,MATH 20C,A01,083760,Staff,0,15,30,30
1650617414793,MATH 20C,A02,083761,Staff,1,13,30,29
1650617414793,MATH 20C,B01,083762,Staff,11,0,30,19
1650617414793,MATH 20C,B02,083763,Staff,28,0,30,2
1650617420821,MATH 20D,A01,083765,Staff,1,1,30,29
1650617420821,MATH 20D,A02,083766,Staff,7,0,30,23
1650617420821,MATH 20D,A03,083767,Staff,24,0,30,6
1650617426854,MATH 20E,A01,083771,Staff,3,0,30,27
1650617426854,MATH 20E,A02,083772,Staff,17,0,30,13
1650617426854,MATH 20E,B01,083773,Staff,0,0,30,30
1650617426854,MATH 20E,B02,083774,Staff,9,0,30,21
1650617432884,MATH 103A,A01,083777,Staff,0,15,30,30
1650617432884,MATH 103A,A02,083778,Staff,0,15,30,30
1650617432884,MATH 103A,B01,083779,Staff,0,14,30,30
1650617432884,MATH 103A,B02,083780,Staff,0,14,30,30
1650617438908,MATH 105,A01,085443,Staff,0,21,30,30
1650617444934,MATH 109,A01,083213,Anzaldo; Leesa B,0,6,30,30
1650617444934,MATH 109,A02,083214,Anzaldo; Leesa B,0,7,30,30
1650617444934,MATH 109,B01,083215,Anzaldo; Leesa B,0,6,30,30
1650617444934,MATH 109,B02,083216,Anzaldo; Leesa B,0,6,30,30
1650617450960,MATH 142A,A01,083219,Chow; Bennett,0,16,30,30
1650617450960,MATH 142A,A02,083220,Chow; Bennett,0,15,30,30
1650617450960,MATH 142A,B01,083221,Chow; Bennett,0,14,30,30
1650617450960,MATH 142A,B02,083222,Chow; Bennett,0,13,30,30
1650617456991,MATH 193A,A01,083224,Staff,0,5,30,30
1650617456991,MATH 193A,A02,083225,Staff,0,6,30,30
1650617456991,MATH 193A,A03,083781,Staff,0,6,30,30
1650617456991,MATH 193A,A04,083782,Staff,0,7,30,30
1650617463019,MATH 197,001,091859,McAuley; Julian John,9998,0,9999,1
1650617469086,COGS 9,A01,083615,Staff,0,15,60,60
1650617475122,COGS 11,A01,083617,Boyle; Mary E. T.,18,0,40,22
1650617481150,COGS 13,A01,083071,Staff,0,38,40,40
1650617487174,COGS 14A,A01,092681,Staff,0,30,100,100
1650617493199,COGS 14B,A01,083073,Cheng; Tzu-Han,0,13,50,50
1650617499226,COGS 17,A01,092677,Staff,17,0,75,58
1650617505253,COGS 100,A01,083619,Staff,0,26,60,60
1650617511279,COGS 101A,A01,083621,Davis; Joshua Daniel,0,26,60,60
1650617517304,COGS 101B,A01,091572,Staff,0,4,60,60
1650617523328,COGS 101C,A01,083625,Delgado; Tania,15,0,30,15
1650617529351,COGS 107A,A01,083627,Boyle; Mary E. T.,1,15,60,59
1650617535377,COGS 118A,A01,083075,Staff,0,5,60,60
1650617541401,CSE 3,A50,083646,Miranda; Gregory Joseph,19,0,38,19
1650617541401,CSE 3,A51,083647,Miranda; Gregory Joseph,36,0,37,1
1650617547427,CSE 8A,A50,083650,Miranda; Gregory Joseph,0,30,40,40
1650617553540,CSE 11,A01,083080,Cao; Yingjun,0,95,40,40
1650617559568,CSE 12,A01,083652,Staff,0,19,100,100
1650617565591,CSE 15L,A01,083654,Staff,0,2,50,50
1650617565591,CSE 15L,A02,083655,Staff,0,1,50,50
1650617571617,CSE 20,A01,083657,Staff,51,0,80,29
1650617577637,CSE 30,A01,083084,Eldon; John,0,78,40,40
1650617583666,CSE 100,A01,083659,Cao; Yingjun,0,68,50,50
1650617589688,CSE 134B,A01,083661,Powell; Thomas Allan,0,35,65,65
1650617595715,CSE 140,A01,083663,Staff,0,8,75,75
1650617601742,CSE 140L,A01,083088,Eldon; John,0,15,75,75
1650617607776,CSE 175,A01,083665,Kumar; Rakesh,7,0,25,18
1650617613798,CSE 190,A00,092507,Dubnov; Shlomo,10,0,20,10
1650617619822,ECE 45,A01,083139,Staff,0,1,60,60
1650617625849,ECE 65,A50,083695,Staff,0,5,30,30
1650617631875,ECE 109,A01,091882,Touri; Behrouz,33,0,70,37
1650617637899,ECE 180,A00,083140,Abi Samra; Nicholas Camill,21,0,30,9
1650617637899,ECE 180,B00,083141,Abi Samra; Nicholas Camill,0,0,30,30
1650617643929,MATH 10A,A01,083735,Patchell; Gregory David,4,0,30,26
1650617643929,MATH 10A,A02,083736,Patchell; Gregory David,27,0,30,3
1650617643929,MATH 10A,A03,083737,Patchell; Gregory David,24,0,30,6
1650617649958,MATH 10B,A01,083207,Staff,0,8,30,30
1650617649958,MATH 10B,A02,083208,Staff,0,8,30,30
1650617649958,MATH 10B,B01,083739,Staff,11,0,30,19
1650617649958,MATH 10B,B02,083740,Staff,28,0,30,2
1650617655984,MATH 18,A01,083743,Staff,0,0,30,30
1650617655984,MATH 18,A02,083744,Staff,23,0,30,7
1650617655984,MATH 18,A03,083745,Staff,21,0,30,9
1650617655984,MATH 18,A04,083746,Staff,26,0,30,4
1650617655984,MATH 18,B01,083748,Staff,0,15,30,30
1650617655984,MATH 18,B02,083749,Staff,0,11,30,30
1650617655984,MATH 18,B03,083750,Staff,0,12,30,30
1650617655984,MATH 18,B04,083751,Staff,0,12,30,30
1650617662008,MATH 20A,A01,083754,Staff,19,0,40,21
1650617668034,MATH 20B,A01,083756,Staff,0,12,30,30
1650617668034,MATH 20B,A02,083757,Staff,0,12,30,30
1650617674066,MATH 20C,A01,083760,Staff,0,15,30,30
1650617674066,MATH 20C,A02,083761,Staff,1,13,30,29
1650617674066,MATH 20C,B01,083762,Staff,11,0,30,19
1650617674066,MATH 20C,B02,083763,Staff,28,0,30,2
1650617680096,MATH 20D,A01,083765,Staff,1,1,30,29
1650617680096,MATH 20D,A02,083766,Staff,7,0,30,23
1650617680096,MATH 20D,A03,083767,Staff,24,0,30,6
1650617686119,MATH 20E,A01,083771,Staff,3,0,30,27
1650617686119,MATH 20E,A02,083772,Staff,17,0,30,13
1650617686119,MATH 20E,B01,083773,Staff,0,0,30,30
1650617686119,MATH 20E,B02,083774,Staff,9,0,30,21
1650617692148,MATH 103A,A01,083777,Staff,0,15,30,30
1650617692148,MATH 103A,A02,083778,Staff,0,15,30,30
1650617692148,MATH 103A,B01,083779,Staff,0,14,30,30
1650617692148,MATH 103A,B02,083780,Staff,0,14,30,30
1650617698172,MATH 105,A01,085443,Staff,0,21,30,30
1650617704200,MATH 109,A01,083213,Anzaldo; Leesa B,0,6,30,30
1650617704200,MATH 109,A02,083214,Anzaldo; Leesa B,0,7,30,30
1650617704200,MATH 109,B01,083215,Anzaldo; Leesa B,0,6,30,30
1650617704200,MATH 109,B02,083216,Anzaldo; Leesa B,0,6,30,30
1650617710229,MATH 142A,A01,083219,Chow; Bennett,0,16,30,30
1650617710229,MATH 142A,A02,083220,Chow; Bennett,0,15,30,30
1650617710229,MATH 142A,B01,083221,Chow; Bennett,0,14,30,30
1650617710229,MATH 142A,B02,083222,Chow; Bennett,0,13,30,30
1650617716254,MATH 193A,A01,083224,Staff,0,5,30,30
1650617716254,MATH 193A,A02,083225,Staff,0,6,30,30
1650617716254,MATH 193A,A03,083781,Staff,0,6,30,30
1650617716254,MATH 193A,A04,083782,Staff,0,7,30,30
1650617722278,MATH 197,001,091859,McAuley; Julian John,9998,0,9999,1
1650617728331,COGS 9,A01,083615,Staff,0,15,60,60
1650617734358,COGS 11,A01,083617,Boyle; Mary E. T.,18,0,40,22
1650617740386,COGS 13,A01,083071,Staff,0,38,40,40
1650617746410,COGS 14A,A01,092681,Staff,0,30,100,100
1650617752434,COGS 14B,A01,083073,Cheng; Tzu-Han,0,13,50,50
1650617758458,COGS 17,A01,092677,Staff,17,0,75,58
1650617764489,COGS 100,A01,083619,Staff,0,26,60,60
1650617770512,COGS 101A,A01,083621,Davis; Joshua Daniel,0,26,60,60
1650617776538,COGS 101B,A01,091572,Staff,0,4,60,60
1650617782565,COGS 101C,A01,083625,Delgado; Tania,15,0,30,15
1650617788590,COGS 107A,A01,083627,Boyle; Mary E. T.,1,15,60,59
1650617794614,COGS 118A,A01,083075,Staff,0,5,60,60
1650617800639,CSE 3,A50,083646,Miranda; Gregory Joseph,19,0,38,19
1650617800639,CSE 3,A51,083647,Miranda; Gregory Joseph,36,0,37,1
1650617806663,CSE 8A,A50,083650,Miranda; Gregory Joseph,0,30,40,40
1650617812691,CSE 11,A01,083080,Cao; Yingjun,0,95,40,40
1650617818718,CSE 12,A01,083652,Staff,0,19,100,100
1650617824747,CSE 15L,A01,083654,Staff,0,2,50,50
1650617824747,CSE 15L,A02,083655,Staff,0,1,50,50
1650617830769,CSE 20,A01,083657,Staff,51,0,80,29
1650617836797,CSE 30,A01,083084,Eldon; John,0,78,40,40
1650617842825,CSE 100,A01,083659,Cao; Yingjun,0,68,50,50
1650617848849,CSE 134B,A01,083661,Powell; Thomas Allan,0,35,65,65
1650617854884,CSE 140,A01,083663,Staff,0,8,75,75
1650617860912,CSE 140L,A01,083088,Eldon; John,0,15,75,75
1650617866935,CSE 175,A01,083665,Kumar; Rakesh,7,0,25,18
1650617872963,CSE 190,A00,092507,Dubnov; Shlomo,10,0,20,10
1650617878990,ECE 45,A01,083139,Staff,0,1,60,60
1650617885017,ECE 65,A50,083695,Staff,0,5,30,30
1650617891041,ECE 109,A01,091882,Touri; Behrouz,33,0,70,37
1650617897066,ECE 180,A00,083140,Abi Samra; Nicholas Camill,21,0,30,9
1650617897066,ECE 180,B00,083141,Abi Samra; Nicholas Camill,0,0,30,30
1650617903089,MATH 10A,A01,083735,Patchell; Gregory David,4,0,30,26
1650617903089,MATH 10A,A02,083736,Patchell; Gregory David,27,0,30,3
1650617903089,MATH 10A,A03,083737,Patchell; Gregory David,24,0,30,6
1650617909118,MATH 10B,A01,083207,Staff,0,8,30,30
1650617909118,MATH 10B,A02,083208,Staff,0,8,30,30
1650617909118,MATH 10B,B01,083739,Staff,11,0,30,19
1650617909118,MATH 10B,B02,083740,Staff,28,0,30,2
1650617915149,MATH 18,A01,083743,Staff,0,0,30,30
1650617915149,MATH 18,A02,083744,Staff,23,0,30,7
1650617915149,MATH 18,A03,083745,Staff,21,0,30,9
1650617915149,MATH 18,A04,083746,Staff,26,0,30,4
1650617915149,MATH 18,B01,083748,Staff,0,15,30,30
1650617915149,MATH 18,B02,083749,Staff,0,11,30,30
1650617915149,MATH 18,B03,083750,Staff,0,12,30,30
1650617915149,MATH 18,B04,083751,Staff,0,12,30,30
1650617921172,MATH 20A,A01,083754,Staff,19,0,40,21
1650617927200,MATH 20B,A01,083756,Staff,0,12,30,30
1650617927200,MATH 20B,A02,083757,Staff,0,12,30,30
1650617933230,MATH 20C,A01,083760,Staff,0,15,30,30
1650617933230,MATH 20C,A02,083761,Staff,1,13,30,29
1650617933230,MATH 20C,B01,083762,Staff,11,0,30,19
1650617933230,MATH 20C,B02,083763,Staff,28,0,30,2
1650617939252,MATH 20D,A01,083765,Staff,1,1,30,29
1650617939252,MATH 20D,A02,083766,Staff,7,0,30,23
1650617939252,MATH 20D,A03,083767,Staff,24,0,30,6
1650617945277,MATH 20E,A01,083771,Staff,3,0,30,27
1650617945277,MATH 20E,A02,083772,Staff,17,0,30,13
1650617945277,MATH 20E,B01,083773,Staff,0,0,30,30
1650617945277,MATH 20E,B02,083774,Staff,9,0,30,21
1650617951302,MATH 103A,A01,083777,Staff,0,15,30,30
1650617951302,MATH 103A,A02,083778,Staff,0,15,30,30
1650617951302,MATH 103A,B01,083779,Staff,0,14,30,30
1650617951302,MATH 103A,B02,083780,Staff,0,14,30,30
1650617957338,MATH 105,A01,085443,Staff,0,21,30,30
1650617963367,MATH 109,A01,083213,Anzaldo; Leesa B,0,6,30,30
1650617963367,MATH 109,A02,083214,Anzaldo; Leesa B,0,7,30,30
1650617963367,MATH 109,B01,083215,Anzaldo; Leesa B,0,6,30,30
1650617963367,MATH 109,B02,083216,Anzaldo; Leesa B,0,6,30,30
1650617969393,MATH 142A,A01,083219,Chow; Bennett,0,16,30,30
1650617969393,MATH 142A,A02,083220,Chow; Bennett,0,15,30,30
1650617969393,MATH 142A,B01,083221,Chow; Bennett,0,14,30,30
1650617969393,MATH 142A,B02,083222,Chow; Bennett,0,13,30,30
1650617975417,MATH 193A,A01,083224,Staff,0,5,30,30
1650617975417,MATH 193A,A02,083225,Staff,0,6,30,30
1650617975417,MATH 193A,A03,083781,Staff,0,6,30,30
1650617975417,MATH 193A,A04,083782,Staff,0,7,30,30
1650617981440,MATH 197,001,091859,McAuley; Julian John,9998,0,9999,1
1650617987495,COGS 9,A01,083615,Staff,0,15,60,60
1650617993519,COGS 11,A01,083617,Boyle; Mary E. T.,18,0,40,22
1650617999545,COGS 13,A01,083071,Staff,0,38,40,40
1650618005571,COGS 14A,A01,092681,Staff,0,30,100,100
1650618011594,COGS 14B,A01,083073,Cheng; Tzu-Han,0,13,50,50
1650618017625,COGS 17,A01,092677,Staff,17,0,75,58
1650618023652,COGS 100,A01,083619,Staff,0,26,60,60
1650618029680,COGS 101A,A01,083621,Davis; Joshua Daniel,0,26,60,60
1650618035710,COGS 101B,A01,091572,Staff,0,4,60,60
1650618041739,COGS 101C,A01,083625,Delgado; Tania,15,0,30,15
1650618047766,COGS 107A,A01,083627,Boyle; Mary E. T.,1,15,60,59
1650618053789,COGS 118A,A01,083075,Staff,0,5,60,60
1650618059816,CSE 3,A50,083646,Miranda; Gregory Joseph,19,0,38,19
1650618059816,CSE 3,A51,083647,Miranda; Gregory Joseph,36,0,37,1
1650618065847,CSE 8A,A50,083650,Miranda; Gregory Joseph,0,30,40,40
1650618071874,CSE 11,A01,083080,Cao; Yingjun,0,95,40,40
1650618077902,CSE 12,A01,083652,Staff,0,19,100,100
1650618083928,CSE 15L,A01,083654,Staff,0,2,50,50
1650618083928,CSE 15L,A02,083655,Staff,0,1,50,50
1650618089955,CSE 20,A01,083657,Staff,51,0,80,29
1650618095983,CSE 30,A01,083084,Eldon; John,0,78,40,40
1650618102007,CSE 100,A01,083659,Cao; Yingjun,0,68,50,50
1650618108032,CSE 134B,A01,083661,Powell; Thomas Allan,0,35,65,65
1650618114062,CSE 140,A01,083663,Staff,0,8,75,75
1650618120091,CSE 140L,A01,083088,Eldon; John,0,15,75,75
1650618126115,CSE 175,A01,083665,Kumar; Rakesh,7,0,25,18
1650618132141,CSE 190,A00,092507,Dubnov; Shlomo,10,0,20,10
1650618138172,ECE 45,A01,083139,Staff,0,1,60,60
1650618144199,ECE 65,A50,083695,Staff,0,5,30,30
1650618150318,ECE 109,A01,091882,Touri; Behrouz,33,0,70,37
1650618156347,ECE 180,A00,083140,Abi Samra; Nicholas Camill,21,0,30,9
1650618156347,ECE 180,B00,083141,Abi Samra; Nicholas Camill,0,0,30,30
1650618162375,MATH 10A,A01,083735,Patchell; Gregory David,4,0,30,26
1650618162375,MATH 10A,A02,083736,Patchell; Gregory David,27,0,30,3
1650618162375,MATH 10A,A03,083737,Patchell; Gregory David,24,0,30,6
1650618168399,MATH 10B,A01,083207,Staff,0,8,30,30
1650618168399,MATH 10B,A02,083208,Staff,0,8,30,30
1650618168399,MATH 10B,B01,083739,Staff,11,0,30,19
1650618168399,MATH 10B,B02,083740,Staff,28,0,30,2
1650618174433,MATH 18,A01,083743,Staff,0,0,30,30
1650618174433,MATH 18,A02,083744,Staff,23,0,30,7
1650618174433,MATH 18,A03,083745,Staff,21,0,30,9
1650618174433,MATH 18,A04,083746,Staff,26,0,30,4
1650618174433,MATH 18,B01,083748,Staff,0,15,30,30
1650618174433,MATH 18,B02,083749,Staff,0,11,30,30
1650618174433,MATH 18,B03,083750,Staff,0,12,30,30
1650618174433,MATH 18,B04,083751,Staff,0,12,30,30
1650618180461,MATH 20A,A01,083754,Staff,19,0,40,21
1650618186487,MATH 20B,A01,083756,Staff,0,12,30,30
1650618186487,MATH 20B,A02,083757,Staff,0,12,30,30
1650618192515,MATH 20C,A01,083760,Staff,0,15,30,30
1650618192515,MATH 20C,A02,083761,Staff,1,13,30,29
1650618192515,MATH 20C,B01,083762,Staff,11,0,30,19
1650618192515,MATH 20C,B02,083763,Staff,28,0,30,2
1650618198542,MATH 20D,A01,083765,Staff,1,1,30,29
1650618198542,MATH 20D,A02,083766,Staff,7,0,30,23
1650618198542,MATH 20D,A03,083767,Staff,24,0,30,6
1650618204568,MATH 20E,A01,083771,Staff,3,0,30,27
1650618204568,MATH 20E,A02,083772,Staff,17,0,30,13
1650618204568,MATH 20E,B01,083773,Staff,0,0,30,30
1650618204568,MATH 20E,B02,083774,Staff,9,0,30,21
1650618210593,MATH 103A,A01,083777,Staff,0,15,30,30
1650618210593,MATH 103A,A02,083778,Staff,0,15,30,30
1650618210593,MATH 103A,B01,083779,Staff,0,14,30,30
1650618210593,MATH 103A,B02,083780,Staff,0,14,30,30
1650618216620,MATH 105,A01,085443,Staff,0,21,30,30
1650618222643,MATH 109,A01,083213,Anzaldo; Leesa B,0,6,30,30
1650618222643,MATH 109,A02,083214,Anzaldo; Leesa B,0,7,30,30
1650618222643,MATH 109,B01,083215,Anzaldo; Leesa B,0,6,30,30
1650618222643,MATH 109,B02,083216,Anzaldo; Leesa B,0,6,30,30
1650618228672,MATH 142A,A01,083219,Chow; Bennett,0,16,30,30
1650618228672,MATH 142A,A02,083220,Chow; Bennett,0,15,30,30
1650618228672,MATH 142A,B01,083221,Chow; Bennett,0,14,30,30
1650618228672,MATH 142A,B02,083222,Chow; Bennett,0,13,30,30
1650618234701,MATH 193A,A01,083224,Staff,0,5,30,30
1650618234701,MATH 193A,A02,083225,Staff,0,6,30,30
1650618234701,MATH 193A,A03,083781,Staff,0,6,30,30
1650618234701,MATH 193A,A04,083782,Staff,0,7,30,30
1650618240723,MATH 197,001,091859,McAuley; Julian John,9998,0,9999,1
1650618246795,COGS 9,A01,083615,Staff,0,15,60,60
1650618252821,COGS 11,A01,083617,Boyle; Mary E. T.,18,0,40,22
1650618258845,COGS 13,A01,083071,Staff,0,38,40,40
1650618264870,COGS 14A,A01,092681,Staff,0,30,100,100
1650618270900,COGS 14B,A01,083073,Cheng; Tzu-Han,0,13,50,50
1650618276925,COGS 17,A01,092677,Staff,17,0,75,58
1650618282950,COGS 100,A01,083619,Staff,0,26,60,60
1650618288979,COGS 101A,A01,083621,Davis; Joshua Daniel,0,26,60,60
1650618295004,COGS 101B,A01,091572,Staff,0,4,60,60
1650618301030,COGS 101C,A01,083625,Delgado; Tania,15,0,30,15
1650618307055,COGS 107A,A01,083627,Boyle; Mary E. T.,1,15,60,59
1650618313081,COGS 118A,A01,083075,Staff,0,5,60,60
1650618319110,CSE 3,A50,083646,Miranda; Gregory Joseph,19,0,38,19
1650618319110,CSE 3,A51,083647,Miranda; Gregory Joseph,36,0,37,1
1650618325134,CSE 8A,A50,083650,Miranda; Gregory Joseph,0,30,40,40
1650618331159,CSE 11,A01,083080,Cao; Yingjun,0,95,40,40
1650618337185,CSE 12,A01,083652,Staff,0,19,100,100
1650618343209,CSE 15L,A01,083654,Staff,0,2,50,50
1650618343209,CSE 15L,A02,083655,Staff,0,1,50,50
1650618349236,CSE 20,A01,083657,Staff,51,0,80,29
1650618355259,CSE 30,A01,083084,Eldon; John,0,78,40,40
1650618361287,CSE 100,A01,083659,Cao; Yingjun,0,68,50,50
1650618367313,CSE 134B,A01,083661,Powell; Thomas Allan,0,35,65,65
1650618373336,CSE 140,A01,083663,Staff,0,8,75,75
1650618379359,CSE 140L,A01,083088,Eldon; John,0,15,75,75
1650618385383,CSE 175,A01,083665,Kumar; Rakesh,7,0,25,18
1650618391406,CSE 190,A00,092507,Dubnov; Shlomo,10,0,20,10
1650618397429,ECE 45,A01,083139,Staff,0,1,60,60
1650618403456,ECE 65,A50,083695,Staff,0,5,30,30
1650618409480,ECE 109,A01,091882,Touri; Behrouz,33,0,70,37
1650618415507,ECE 180,A00,083140,Abi Samra; Nicholas Camill,21,0,30,9
1650618415507,ECE 180,B00,083141,Abi Samra; Nicholas Camill,0,0,30,30
1650618421535,MATH 10A,A01,083735,Patchell; Gregory David,4,0,30,26
1650618421535,MATH 10A,A02,083736,Patchell; Gregory David,27,0,30,3
1650618421535,MATH 10A,A03,083737,Patchell; Gregory David,24,0,30,6
1650618427563,MATH 10B,A01,083207,Staff,0,8,30,30
1650618427563,MATH 10B,A02,083208,Staff,0,8,30,30
1650618427563,MATH 10B,B01,083739,Staff,11,0,30,19
1650618427563,MATH 10B,B02,083740,Staff,28,0,30,2
1650618433606,MATH 18,A01,083743,Staff,0,0,30,30
1650618433606,MATH 18,A02,083744,Staff,23,0,30,7
1650618433606,MATH 18,A03,083745,Staff,21,0,30,9
1650618433606,MATH 18,A04,083746,Staff,26,0,30,4
1650618433606,MATH 18,B01,083748,Staff,0,15,30,30
1650618433606,MATH 18,B02,083749,Staff,0,11,30,30
1650618433606,MATH 18,B03,083750,Staff,0,12,30,30
1650618433606,MATH 18,B04,083751,Staff,0,12,30,30
1650618439630,MATH 20A,A01,083754,Staff,19,0,40,21
1650618445652,MATH 20B,A01,083756,Staff,0,12,30,30
1650618445652,MATH 20B,A02,083757,Staff,0,12,30,30
1650618451681,MATH 20C,A01,083760,Staff,0,15,30,30
1650618451681,MATH 20C,A02,083761,Staff,1,13,30,29
1650618451681,MATH 20C,B01,083762,Staff,11,0,30,19
1650618451681,MATH 20C,B02,083763,Staff,28,0,30,2
1650618457703,MATH 20D,A01,083765,Staff,1,1,30,29
1650618457703,MATH 20D,A02,083766,Staff,7,0,30,23
1650618457703,MATH 20D,A03,083767,Staff,24,0,30,6
1650618463727,MATH 20E,A01,083771,Staff,3,0,30,27
1650618463727,MATH 20E,A02,083772,Staff,17,0,30,13
1650618463727,MATH 20E,B01,083773,Staff,0,0,30,30
1650618463727,MATH 20E,B02,083774,Staff,9,0,30,21
1650618469761,MATH 103A,A01,083777,Staff,0,15,30,30
1650618469761,MATH 103A,A02,083778,Staff,0,15,30,30
1650618469761,MATH 103A,B01,083779,Staff,0,14,30,30
1650618469761,MATH 103A,B02,083780,Staff,0,14,30,30
1650618475787,MATH 105,A01,085443,Staff,0,21,30,30
1650618481815,MATH 109,A01,083213,Anzaldo; Leesa B,0,6,30,30
1650618481815,MATH 109,A02,083214,Anzaldo; Leesa B,0,7,30,30
1650618481815,MATH 109,B01,083215,Anzaldo; Leesa B,0,6,30,30
1650618481815,MATH 109,B02,083216,Anzaldo; Leesa B,0,6,30,30
1650618487845,MATH 142A,A01,083219,Chow; Bennett,0,16,30,30
1650618487845,MATH 142A,A02,083220,Chow; Bennett,0,15,30,30
1650618487845,MATH 142A,B01,083221,Chow; Bennett,0,14,30,30
1650618487845,MATH 142A,B02,083222,Chow; Bennett,0,13,30,30
1650618493872,MATH 193A,A01,083224,Staff,0,5,30,30
1650618493872,MATH 193A,A02,083225,Staff,0,6,30,30
1650618493872,MATH 193A,A03,083781,Staff,0,6,30,30
1650618493872,MATH 193A,A04,083782,Staff,0,7,30,30
1650618499902,MATH 197,001,091859,McAuley; Julian John,9998,0,9999,1
1650618505960,COGS 9,A01,083615,Staff,0,15,60,60
1650618511982,COGS 11,A01,083617,Boyle; Mary E. T.,18,0,40,22
1650618518006,COGS 13,A01,083071,Staff,0,38,40,40
1650618524032,COGS 14A,A01,092681,Staff,0,30,100,100
1650618530056,COGS 14B,A01,083073,Cheng; Tzu-Han,0,13,50,50
1650618536080,COGS 17,A01,092677,Staff,17,0,75,58
1650618542104,COGS 100,A01,083619,Staff,0,26,60,60
1650618548127,COGS 101A,A01,083621,Davis; Joshua Daniel,0,26,60,60
1650618554153,COGS 101B,A01,091572,Staff,0,4,60,60
1650618560177,COGS 101C,A01,083625,Delgado; Tania,15,0,30,15
1650618566201,COGS 107A,A01,083627,Boyle; Mary E. T.,1,15,60,59
1650618572236,COGS 118A,A01,083075,Staff,0,5,60,60
1650618578261,CSE 3,A50,083646,Miranda; Gregory Joseph,19,0,38,19
1650618578261,CSE 3,A51,083647,Miranda; Gregory Joseph,36,0,37,1
1650618584284,CSE 8A,A50,083650,Miranda; Gregory Joseph,0,30,40,40
1650618590311,CSE 11,A01,083080,Cao; Yingjun,0,95,40,40
1650618596335,CSE 12,A01,083652,Staff,0,19,100,100
1650618602362,CSE 15L,A01,083654,Staff,0,2,50,50
1650618602362,CSE 15L,A02,083655,Staff,0,1,50,50
1650618608388,CSE 20,A01,083657,Staff,51,0,80,29
1650618614412,CSE 30,A01,083084,Eldon; John,0,78,40,40
1650618620450,CSE 100,A01,083659,Cao; Yingjun,0,68,50,50
1650618626472,CSE 134B,A01,083661,Powell; Thomas Allan,0,35,65,65
1650618632494,CSE 140,A01,083663,Staff,0,8,75,75
1650618638521,CSE 140L,A01,083088,Eldon; John,0,16,75,75
1650618644545,CSE 175,A01,083665,Kumar; Rakesh,7,0,25,18
1650618650574,CSE 190,A00,092507,Dubnov; Shlomo,10,0,20,10
1650618656600,ECE 45,A01,083139,Staff,0,1,60,60
1650618662626,ECE 65,A50,083695,Staff,0,5,30,30
1650618668649,ECE 109,A01,091882,Touri; Behrouz,33,0,70,37
1650618674673,ECE 180,A00,083140,Abi Samra; Nicholas Camill,21,0,30,9
1650618674673,ECE 180,B00,083141,Abi Samra; Nicholas Camill,0,0,30,30
1650618680698,MATH 10A,A01,083735,Patchell; Gregory David,4,0,30,26
1650618680698,MATH 10A,A02,083736,Patchell; Gregory David,27,0,30,3
1650618680698,MATH 10A,A03,083737,Patchell; Gregory David,24,0,30,6
1650618686729,MATH 10B,A01,083207,Staff,0,8,30,30
1650618686729,MATH 10B,A02,083208,Staff,0,8,30,30
1650618686729,MATH 10B,B01,083739,Staff,11,0,30,19
1650618686729,MATH 10B,B02,083740,Staff,28,0,30,2
1650618692796,MATH 18,A01,083743,Staff,0,0,30,30
1650618692796,MATH 18,A02,083744,Staff,23,0,30,7
1650618692796,MATH 18,A03,083745,Staff,21,0,30,9
1650618692796,MATH 18,A04,083746,Staff,26,0,30,4
1650618692796,MATH 18,B01,083748,Staff,0,15,30,30
1650618692796,MATH 18,B02,083749,Staff,0,11,30,30
1650618692796,MATH 18,B03,083750,Staff,0,12,30,30
1650618692796,MATH 18,B04,083751,Staff,0,12,30,30
1650618698823,MATH 20A,A01,083754,Staff,19,0,40,21
1650618704851,MATH 20B,A01,083756,Staff,0,12,30,30
1650618704851,MATH 20B,A02,083757,Staff,0,12,30,30
1650618710878,MATH 20C,A01,083760,Staff,0,15,30,30
1650618710878,MATH 20C,A02,083761,Staff,1,13,30,29
1650618710878,MATH 20C,B01,083762,Staff,11,0,30,19
1650618710878,MATH 20C,B02,083763,Staff,28,0,30,2
1650618716904,MATH 20D,A01,083765,Staff,1,1,30,29
1650618716904,MATH 20D,A02,083766,Staff,7,0,30,23
1650618716904,MATH 20D,A03,083767,Staff,24,0,30,6
1650618722928,MATH 20E,A01,083771,Staff,3,0,30,27
1650618722928,MATH 20E,A02,083772,Staff,17,0,30,13
1650618722928,MATH 20E,B01,083773,Staff,0,0,30,30
1650618722928,MATH 20E,B02,083774,Staff,9,0,30,21
1650618728957,MATH 103A,A01,083777,Staff,0,15,30,30
1650618728957,MATH 103A,A02,083778,Staff,0,15,30,30
1650618728957,MATH 103A,B01,083779,Staff,0,14,30,30
1650618728957,MATH 103A,B02,083780,Staff,0,14,30,30
1650618734984,MATH 105,A01,085443,Staff,0,21,30,30
1650618741008,MATH 109,A01,083213,Anzaldo; Leesa B,0,6,30,30
1650618741008,MATH 109,A02,083214,Anzaldo; Leesa B,0,7,30,30
1650618741008,MATH 109,B01,083215,Anzaldo; Leesa B,0,6,30,30
1650618741008,MATH 109,B02,083216,Anzaldo; Leesa B,0,6,30,30
1650618747108,MATH 142A,A01,083219,Chow; Bennett,0,16,30,30
1650618747108,MATH 142A,A02,083220,Chow; Bennett,0,15,30,30
1650618747108,MATH 142A,B01,083221,Chow; Bennett,0,14,30,30
1650618747108,MATH 142A,B02,083222,Chow; Bennett,0,13,30,30
1650618753136,MATH 193A,A01,083224,Staff,0,5,30,30
1650618753136,MATH 193A,A02,083225,Staff,0,6,30,30
1650618753136,MATH 193A,A03,083781,Staff,0,6,30,30
1650618753136,MATH 193A,A04,083782,Staff,0,7,30,30
1650618759161,MATH 197,001,091859,McAuley; Julian John,9998,0,9999,1
1650618765212,COGS 9,A01,083615,Staff,0,15,60,60
1650618771235,COGS 11,A01,083617,Boyle; Mary E. T.,18,0,40,22
1650618777260,COGS 13,A01,083071,Staff,0,38,40,40
1650618783283,COGS 14A,A01,092681,Staff,0,30,100,100
1650618789308,COGS 14B,A01,083073,Cheng; Tzu-Han,0,13,50,50
1650618795330,COGS 17,A01,092677,Staff,17,0,75,58
1650618801357,COGS 100,A01,083619,Staff,0,26,60,60
1650618807381,COGS 101A,A01,083621,Davis; Joshua Daniel,0,26,60,60
1650618813409,COGS 101B,A01,091572,Staff,0,4,60,60
1650618819432,COGS 101C,A01,083625,Delgado; Tania,15,0,30,15
1650618825455,COGS 107A,A01,083627,Boyle; Mary E. T.,1,15,60,59
1650618831483,COGS 118A,A01,083075,Staff,0,5,60,60
1650618837507,CSE 3,A50,083646,Miranda; Gregory Joseph,19,0,38,19
1650618837507,CSE 3,A51,083647,Miranda; Gregory Joseph,36,0,37,1
1650618843543,CSE 8A,A50,083650,Miranda; Gregory Joseph,0,30,40,40
1650618849565,CSE 11,A01,083080,Cao; Yingjun,0,95,40,40
1650618855588,CSE 12,A01,083652,Staff,0,19,100,100
1650618861614,CSE 15L,A01,083654,Staff,0,2,50,50
1650618861614,CSE 15L,A02,083655,Staff,0,1,50,50
1650618867638,CSE 20,A01,083657,Staff,51,0,80,29
1650618873664,CSE 30,A01,083084,Eldon; John,0,78,40,40
1650618879687,CSE 100,A01,083659,Cao; Yingjun,0,68,50,50
1650618885711,CSE 134B,A01,083661,Powell; Thomas Allan,0,35,65,65
1650618891738,CSE 140,A01,083663,Staff,0,8,75,75
1650618897761,CSE 140L,A01,083088,Eldon; John,0,16,75,75
1650618903784,CSE 175,A01,083665,Kumar; Rakesh,7,0,25,18
1650618909808,CSE 190,A00,092507,Dubnov; Shlomo,10,0,20,10
1650618915834,ECE 45,A01,083139,Staff,0,1,60,60
1650618921858,ECE 65,A50,083695,Staff,0,5,30,30
1650618927890,ECE 109,A01,091882,Touri; Behrouz,33,0,70,37
1650618933916,ECE 180,A00,083140,Abi Samra; Nicholas Camill,21,0,30,9
1650618933916,ECE 180,B00,083141,Abi Samra; Nicholas Camill,0,0,30,30
1650618939943,MATH 10A,A01,083735,Patchell; Gregory David,4,0,30,26
1650618939943,MATH 10A,A02,083736,Patchell; Gregory David,27,0,30,3
1650618939943,MATH 10A,A03,083737,Patchell; Gregory David,24,0,30,6
1650618945971,MATH 10B,A01,083207,Staff,0,8,30,30
1650618945971,MATH 10B,A02,083208,Staff,0,8,30,30
1650618945971,MATH 10B,B01,083739,Staff,11,0,30,19
1650618945971,MATH 10B,B02,083740,Staff,28,0,30,2
1650618952002,MATH 18,A01,083743,Staff,0,0,30,30
1650618952002,MATH 18,A02,083744,Staff,23,0,30,7
1650618952002,MATH 18,A03,083745,Staff,21,0,30,9
1650618952002,MATH 18,A04,083746,Staff,26,0,30,4
1650618952002,MATH 18,B01,083748,Staff,0,15,30,30
1650618952002,MATH 18,B02,083749,Staff,0,11,30,30
1650618952002,MATH 18,B03,083750,Staff,0,12,30,30
1650618952002,MATH 18,B04,083751,Staff,0,12,30,30
1650618958025,MATH 20A,A01,083754,Staff,19,0,40,21
1650618964051,MATH 20B,A01,083756,Staff,0,12,30,30
1650618964051,MATH 20B,A02,083757,Staff,0,12,30,30
1650618970076,MATH 20C,A01,083760,Staff,0,15,30,30
1650618970076,MATH 20C,A02,083761,Staff,1,13,30,29
1650618970076,MATH 20C,B01,083762,Staff,11,0,30,19
1650618970076,MATH 20C,B02,083763,Staff,28,0,30,2
1650618976099,MATH 20D,A01,083765,Staff,1,1,30,29
1650618976099,MATH 20D,A02,083766,Staff,7,0,30,23
1650618976099,MATH 20D,A03,083767,Staff,24,0,30,6
1650618982120,MATH 20E,A01,083771,Staff,3,0,30,27
1650618982120,MATH 20E,A02,083772,Staff,17,0,30,13
1650618982120,MATH 20E,B01,083773,Staff,0,0,30,30
1650618982120,MATH 20E,B02,083774,Staff,9,0,30,21
1650618988145,MATH 103A,A01,083777,Staff,0,15,30,30
1650618988145,MATH 103A,A02,083778,Staff,0,15,30,30
1650618988145,MATH 103A,B01,083779,Staff,0,14,30,30
1650618988145,MATH 103A,B02,083780,Staff,0,14,30,30
1650618994168,MATH 105,A01,085443,Staff,0,21,30,30
1650619000192,MATH 109,A01,083213,Anzaldo; Leesa B,0,6,30,30
1650619000192,MATH 109,A02,083214,Anzaldo; Leesa B,0,7,30,30
1650619000192,MATH 109,B01,083215,Anzaldo; Leesa B,0,6,30,30
1650619000192,MATH 109,B02,083216,Anzaldo; Leesa B,0,6,30,30
1650619006216,MATH 142A,A01,083219,Chow; Bennett,0,16,30,30
1650619006216,MATH 142A,A02,083220,Chow; Bennett,0,15,30,30
1650619006216,MATH 142A,B01,083221,Chow; Bennett,0,14,30,30
1650619006216,MATH 142A,B02,083222,Chow; Bennett,0,13,30,30
1650619012240,MATH 193A,A01,083224,Staff,0,5,30,30
1650619012240,MATH 193A,A02,083225,Staff,0,6,30,30
1650619012240,MATH 193A,A03,083781,Staff,0,6,30,30
1650619012240,MATH 193A,A04,083782,Staff,0,7,30,30
1650619018266,MATH 197,001,091859,McAuley; Julian John,9998,0,9999,1
1650619024318,COGS 9,A01,083615,Staff,0,15,60,60
1650619030342,COGS 11,A01,083617,Boyle; Mary E. T.,18,0,40,22
1650619036365,COGS 13,A01,083071,Staff,0,38,40,40
1650619042390,COGS 14A,A01,092681,Staff,0,30,100,100
1650619048415,COGS 14B,A01,083073,Cheng; Tzu-Han,0,13,50,50
1650619054445,COGS 17,A01,092677,Staff,17,0,75,58
1650619060471,COGS 100,A01,083619,Staff,0,26,60,60
1650619066498,COGS 101A,A01,083621,Davis; Joshua Daniel,0,26,60,60
1650619072521,COGS 101B,A01,091572,Staff,0,4,60,60
1650619078548,COGS 101C,A01,083625,Delgado; Tania,15,0,30,15
1650619084576,COGS 107A,A01,083627,Boyle; Mary E. T.,1,15,60,59
1650619090602,COGS 118A,A01,083075,Staff,0,5,60,60
1650619096631,CSE 3,A50,083646,Miranda; Gregory Joseph,19,0,38,19
1650619096631,CSE 3,A51,083647,Miranda; Gregory Joseph,36,0,37,1
1650619102655,CSE 8A,A50,083650,Miranda; Gregory Joseph,0,30,40,40
1650619108682,CSE 11,A01,083080,Cao; Yingjun,0,95,40,40
1650619114717,CSE 12,A01,083652,Staff,0,19,100,100
1650619120741,CSE 15L,A01,083654,Staff,0,2,50,50
1650619120741,CSE 15L,A02,083655,Staff,0,1,50,50
1650619126768,CSE 20,A01,083657,Staff,51,0,80,29
1650619132791,CSE 30,A01,083084,Eldon; John,0,78,40,40
1650619138815,CSE 100,A01,083659,Cao; Yingjun,0,68,50,50
1650619144842,CSE 134B,A01,083661,Powell; Thomas Allan,0,35,65,65
1650619150866,CSE 140,A01,083663,Staff,0,8,75,75
1650619156893,CSE 140L,A01,083088,Eldon; John,0,16,75,75
1650619162917,CSE 175,A01,083665,Kumar; Rakesh,7,0,25,18
1650619168940,CSE 190,A00,092507,Dubnov; Shlomo,10,0,20,10
1650619174964,ECE 45,A01,083139,Staff,0,1,60,60
1650619180989,ECE 65,A50,083695,Staff,0,5,30,30
1650619187016,ECE 109,A01,091882,Touri; Behrouz,33,0,70,37
1650619193042,ECE 180,A00,083140,Abi Samra; Nicholas Camill,21,0,30,9
1650619193042,ECE 180,B00,083141,Abi Samra; Nicholas Camill,0,0,30,30
1650619199077,MATH 10A,A01,083735,Patchell; Gregory David,4,0,30,26
1650619199077,MATH 10A,A02,083736,Patchell; Gregory David,27,0,30,3
1650619199077,MATH 10A,A03,083737,Patchell; Gregory David,24,0,30,6
1650619205104,MATH 10B,A01,083207,Staff,0,8,30,30
1650619205104,MATH 10B,A02,083208,Staff,0,8,30,30
1650619205104,MATH 10B,B01,083739,Staff,11,0,30,19
1650619205104,MATH 10B,B02,083740,Staff,28,0,30,2
1650619211134,MATH 18,A01,083743,Staff,0,0,30,30
1650619211134,MATH 18,A02,083744,Staff,23,0,30,7
1650619211134,MATH 18,A03,083745,Staff,21,0,30,9
1650619211134,MATH 18,A04,083746,Staff,26,0,30,4
1650619211134,MATH 18,B01,083748,Staff,0,15,30,30
1650619211134,MATH 18,B02,083749,Staff,0,11,30,30
1650619211134,MATH 18,B03,083750,Staff,0,12,30,30
1650619211134,MATH 18,B04,083751,Staff,0,12,30,30
1650619217157,MATH 20A,A01,083754,Staff,19,0,40,21
1650619223191,MATH 20B,A01,083756,Staff,0,12,30,30
1650619223191,MATH 20B,A02,083757,Staff,0,12,30,30
1650619229215,MATH 20C,A01,083760,Staff,0,15,30,30
1650619229215,MATH 20C,A02,083761,Staff,1,13,30,29
1650619229215,MATH 20C,B01,083762,Staff,11,0,30,19
1650619229215,MATH 20C,B02,083763,Staff,28,0,30,2
1650619235242,MATH 20D,A01,083765,Staff,1,1,30,29
1650619235242,MATH 20D,A02,083766,Staff,7,0,30,23
1650619235242,MATH 20D,A03,083767,Staff,24,0,30,6
1650619241266,MATH 20E,A01,083771,Staff,3,0,30,27
1650619241266,MATH 20E,A02,083772,Staff,17,0,30,13
1650619241266,MATH 20E,B01,083773,Staff,0,0,30,30
1650619241266,MATH 20E,B02,083774,Staff,9,0,30,21
1650619247291,MATH 103A,A01,083777,Staff,0,15,30,30
1650619247291,MATH 103A,A02,083778,Staff,0,15,30,30
1650619247291,MATH 103A,B01,083779,Staff,0,14,30,30
1650619247291,MATH 103A,B02,083780,Staff,0,14,30,30
1650619253314,MATH 105,A01,085443,Staff,0,21,30,30
1650619259338,MATH 109,A01,083213,Anzaldo; Leesa B,0,6,30,30
1650619259338,MATH 109,A02,083214,Anzaldo; Leesa B,0,7,30,30
1650619259338,MATH 109,B01,083215,Anzaldo; Leesa B,0,6,30,30
1650619259338,MATH 109,B02,083216,Anzaldo; Leesa B,0,6,30,30
1650619265362,MATH 142A,A01,083219,Chow; Bennett,0,16,30,30
1650619265362,MATH 142A,A02,083220,Chow; Bennett,0,15,30,30
1650619265362,MATH 142A,B01,083221,Chow; Bennett,0,14,30,30
1650619265362,MATH 142A,B02,083222,Chow; Bennett,0,13,30,30
1650619271387,MATH 193A,A01,083224,Staff,0,5,30,30
1650619271387,MATH 193A,A02,083225,Staff,0,6,30,30
1650619271387,MATH 193A,A03,083781,Staff,0,6,30,30
1650619271387,MATH 193A,A04,083782,Staff,0,7,30,30
1650619277409,MATH 197,001,091859,McAuley; Julian John,9998,0,9999,1
1650619283474,COGS 9,A01,083615,Staff,0,15,60,60
1650619289497,COGS 11,A01,083617,Boyle; Mary E. T.,18,0,40,22
1650619295524,COGS 13,A01,083071,Staff,0,38,40,40
1650619301548,COGS 14A,A01,092681,Staff,0,30,100,100
1650619307571,COGS 14B,A01,083073,Cheng; Tzu-Han,0,13,50,50
1650619313610,COGS 17,A01,092677,Staff,17,0,75,58
1650619319633,COGS 100,A01,083619,Staff,0,26,60,60
1650619325655,COGS 101A,A01,083621,Davis; Joshua Daniel,0,26,60,60
1650619331683,COGS 101B,A01,091572,Staff,0,4,60,60
1650619337783,COGS 101C,A01,083625,Delgado; Tania,15,0,30,15
1650619343810,COGS 107A,A01,083627,Boyle; Mary E. T.,1,15,60,59
1650619349833,COGS 118A,A01,083075,Staff,0,5,60,60
1650619355862,CSE 3,A50,083646,Miranda; Gregory Joseph,19,0,38,19
1650619355862,CSE 3,A51,083647,Miranda; Gregory Joseph,36,0,37,1
1650619361898,CSE 8A,A50,083650,Miranda; Gregory Joseph,0,30,40,40
1650619367922,CSE 11,A01,083080,Cao; Yingjun,0,95,40,40
1650619373946,CSE 12,A01,083652,Staff,0,19,100,100
1650619379970,CSE 15L,A01,083654,Staff,0,2,50,50
1650619379970,CSE 15L,A02,083655,Staff,0,1,50,50
1650619385992,CSE 20,A01,083657,Staff,51,0,80,29
1650619392017,CSE 30,A01,083084,Eldon; John,0,78,40,40
1650619398042,CSE 100,A01,083659,Cao; Yingjun,0,68,50,50
1650619404063,CSE 134B,A01,083661,Powell; Thomas Allan,0,35,65,65
1650619410087,CSE 140,A01,083663,Staff,0,8,75,75
1650619416114,CSE 140L,A01,083088,Eldon; John,0,16,75,75
1650619422142,CSE 175,A01,083665,Kumar; Rakesh,7,0,25,18
1650619428169,CSE 190,A00,092507,Dubnov; Shlomo,10,0,20,10
1650619434193,ECE 45,A01,083139,Staff,0,1,60,60
1650619440216,ECE 65,A50,083695,Staff,0,5,30,30
1650619446239,ECE 109,A01,091882,Touri; Behrouz,33,0,70,37
1650619452266,ECE 180,A00,083140,Abi Samra; Nicholas Camill,21,0,30,9
1650619452266,ECE 180,B00,083141,Abi Samra; Nicholas Camill,0,0,30,30
1650619458290,MATH 10A,A01,083735,Patchell; Gregory David,4,0,30,26
1650619458290,MATH 10A,A02,083736,Patchell; Gregory David,27,0,30,3
1650619458290,MATH 10A,A03,083737,Patchell; Gregory David,24,0,30,6
1650619464315,MATH 10B,A01,083207,Staff,0,8,30,30
1650619464315,MATH 10B,A02,083208,Staff,0,8,30,30
1650619464315,MATH 10B,B01,083739,Staff,11,0,30,19
1650619464315,MATH 10B,B02,083740,Staff,28,0,30,2
1650619470340,MATH 18,A01,083743,Staff,0,0,30,30
1650619470340,MATH 18,A02,083744,Staff,23,0,30,7
1650619470340,MATH 18,A03,083745,Staff,21,0,30,9
1650619470340,MATH 18,A04,083746,Staff,26,0,30,4
1650619470340,MATH 18,B01,083748,Staff,0,15,30,30
1650619470340,MATH 18,B02,083749,Staff,0,11,30,30
1650619470340,MATH 18,B03,083750,Staff,0,12,30,30
1650619470340,MATH 18,B04,083751,Staff,0,12,30,30
1650619476366,MATH 20A,A01,083754,Staff,19,0,40,21
1650619482390,MATH 20B,A01,083756,Staff,0,12,30,30
1650619482390,MATH 20B,A02,083757,Staff,0,12,30,30
1650619488424,MATH 20C,A01,083760,Staff,0,15,30,30
1650619488424,MATH 20C,A02,083761,Staff,1,13,30,29
1650619488424,MATH 20C,B01,083762,Staff,11,0,30,19
1650619488424,MATH 20C,B02,083763,Staff,28,0,30,2
1650619494447,MATH 20D,A01,083765,Staff,1,1,30,29
1650619494447,MATH 20D,A02,083766,Staff,7,0,30,23
1650619494447,MATH 20D,A03,083767,Staff,24,0,30,6
1650619500471,MATH 20E,A01,083771,Staff,3,0,30,27
1650619500471,MATH 20E,A02,083772,Staff,17,0,30,13
1650619500471,MATH 20E,B01,083773,Staff,0,0,30,30
1650619500471,MATH 20E,B02,083774,Staff,9,0,30,21
1650619506495,MATH 103A,A01,083777,Staff,0,15,30,30
1650619506495,MATH 103A,A02,083778,Staff,0,15,30,30
1650619506495,MATH 103A,B01,083779,Staff,0,14,30,30
1650619506495,MATH 103A,B02,083780,Staff,0,14,30,30
1650619512518,MATH 105,A01,085443,Staff,0,21,30,30
1650619518542,MATH 109,A01,083213,Anzaldo; Leesa B,0,6,30,30
1650619518542,MATH 109,A02,083214,Anzaldo; Leesa B,0,7,30,30
1650619518542,MATH 109,B01,083215,Anzaldo; Leesa B,0,6,30,30
1650619518542,MATH 109,B02,083216,Anzaldo; Leesa B,0,6,30,30
1650619524570,MATH 142A,A01,083219,Chow; Bennett,0,16,30,30
1650619524570,MATH 142A,A02,083220,Chow; Bennett,0,15,30,30
1650619524570,MATH 142A,B01,083221,Chow; Bennett,0,14,30,30
1650619524570,MATH 142A,B02,083222,Chow; Bennett,0,13,30,30
1650619530595,MATH 193A,A01,083224,Staff,0,5,30,30
1650619530595,MATH 193A,A02,083225,Staff,0,6,30,30
1650619530595,MATH 193A,A03,083781,Staff,0,6,30,30
1650619530595,MATH 193A,A04,083782,Staff,0,7,30,30
1650619536618,MATH 197,001,091859,McAuley; Julian John,9998,0,9999,1
1650619542666,COGS 9,A01,083615,Staff,0,15,60,60
1650619548690,COGS 11,A01,083617,Boyle; Mary E. T.,18,0,40,22
1650619554713,COGS 13,A01,083071,Staff,0,38,40,40
1650619560736,COGS 14A,A01,092681,Staff,0,30,100,100
1650619566760,COGS 14B,A01,083073,Cheng; Tzu-Han,0,13,50,50
1650619572783,COGS 17,A01,092677,Staff,17,0,75,58
1650619578808,COGS 100,A01,083619,Staff,0,26,60,60
1650619584835,COGS 101A,A01,083621,Davis; Joshua Daniel,0,26,60,60
1650619590860,COGS 101B,A01,091572,Staff,0,4,60,60
1650619596883,COGS 101C,A01,083625,Delgado; Tania,15,0,30,15
1650619602908,COGS 107A,A01,083627,Boyle; Mary E. T.,1,15,60,59
1650619608933,COGS 118A,A01,083075,Staff,0,5,60,60
1650619614961,CSE 3,A50,083646,Miranda; Gregory Joseph,19,0,38,19
1650619614961,CSE 3,A51,083647,Miranda; Gregory Joseph,36,0,37,1
1650619620985,CSE 8A,A50,083650,Miranda; Gregory Joseph,0,30,40,40
1650619627009,CSE 11,A01,083080,Cao; Yingjun,0,95,40,40
1650619633032,CSE 12,A01,083652,Staff,0,19,100,100
1650619639058,CSE 15L,A01,083654,Staff,0,2,50,50
1650619639058,CSE 15L,A02,083655,Staff,0,1,50,50
1650619645082,CSE 20,A01,083657,Staff,51,0,80,29
1650619651107,CSE 30,A01,083084,Eldon; John,0,78,40,40
1650619657135,CSE 100,A01,083659,Cao; Yingjun,0,68,50,50
1650619663160,CSE 134B,A01,083661,Powell; Thomas Allan,0,35,65,65
1650619669183,CSE 140,A01,083663,Staff,0,8,75,75
1650619675210,CSE 140L,A01,083088,Eldon; John,0,16,75,75
1650619681233,CSE 175,A01,083665,Kumar; Rakesh,7,0,25,18
1650619687259,CSE 190,A00,092507,Dubnov; Shlomo,10,0,20,10
1650619693284,ECE 45,A01,083139,Staff,0,1,60,60
1650619699310,ECE 65,A50,083695,Staff,0,5,30,30
1650619705350,ECE 109,A01,091882,Touri; Behrouz,33,0,70,37
1650619711374,ECE 180,A00,083140,Abi Samra; Nicholas Camill,21,0,30,9
1650619711374,ECE 180,B00,083141,Abi Samra; Nicholas Camill,0,0,30,30
1650619717402,MATH 10A,A01,083735,Patchell; Gregory David,4,0,30,26
1650619717402,MATH 10A,A02,083736,Patchell; Gregory David,27,0,30,3
1650619717402,MATH 10A,A03,083737,Patchell; Gregory David,24,0,30,6
1650619723438,MATH 10B,A01,083207,Staff,0,8,30,30
1650619723438,MATH 10B,A02,083208,Staff,0,8,30,30
1650619723438,MATH 10B,B01,083739,Staff,11,0,30,19
1650619723438,MATH 10B,B02,083740,Staff,28,0,30,2
1650619729462,MATH 18,A01,083743,Staff,0,0,30,30
1650619729462,MATH 18,A02,083744,Staff,23,0,30,7
1650619729462,MATH 18,A03,083745,Staff,21,0,30,9
1650619729462,MATH 18,A04,083746,Staff,26,0,30,4
1650619729462,MATH 18,B01,083748,Staff,0,15,30,30
1650619729462,MATH 18,B02,083749,Staff,0,11,30,30
1650619729462,MATH 18,B03,083750,Staff,0,12,30,30
1650619729462,MATH 18,B04,083751,Staff,0,12,30,30
1650619735484,MATH 20A,A01,083754,Staff,19,0,40,21
1650619741507,MATH 20B,A01,083756,Staff,0,12,30,30
1650619741507,MATH 20B,A02,083757,Staff,0,12,30,30
1650619747530,MATH 20C,A01,083760,Staff,0,15,30,30
1650619747530,MATH 20C,A02,083761,Staff,1,13,30,29
1650619747530,MATH 20C,B01,083762,Staff,11,0,30,19
1650619747530,MATH 20C,B02,083763,Staff,28,0,30,2
1650619753556,MATH 20D,A01,083765,Staff,1,1,30,29
1650619753556,MATH 20D,A02,083766,Staff,7,0,30,23
1650619753556,MATH 20D,A03,083767,Staff,24,0,30,6
1650619759585,MATH 20E,A01,083771,Staff,3,0,30,27
1650619759585,MATH 20E,A02,083772,Staff,17,0,30,13
1650619759585,MATH 20E,B01,083773,Staff,0,0,30,30
1650619759585,MATH 20E,B02,083774,Staff,9,0,30,21
1650619765609,MATH 103A,A01,083777,Staff,0,15,30,30
1650619765609,MATH 103A,A02,083778,Staff,0,15,30,30
1650619765609,MATH 103A,B01,083779,Staff,0,14,30,30
1650619765609,MATH 103A,B02,083780,Staff,0,14,30,30
1650619771632,MATH 105,A01,085443,Staff,0,21,30,30
1650619777657,MATH 109,A01,083213,Anzaldo; Leesa B,0,6,30,30
1650619777657,MATH 109,A02,083214,Anzaldo; Leesa B,0,7,30,30
1650619777657,MATH 109,B01,083215,Anzaldo; Leesa B,0,6,30,30
1650619777657,MATH 109,B02,083216,Anzaldo; Leesa B,0,6,30,30
1650619783680,MATH 142A,A01,083219,Chow; Bennett,0,16,30,30
1650619783680,MATH 142A,A02,083220,Chow; Bennett,0,15,30,30
1650619783680,MATH 142A,B01,083221,Chow; Bennett,0,14,30,30
1650619783680,MATH 142A,B02,083222,Chow; Bennett,0,13,30,30
1650619789704,MATH 193A,A01,083224,Staff,0,5,30,30
1650619789704,MATH 193A,A02,083225,Staff,0,6,30,30
1650619789704,MATH 193A,A03,083781,Staff,0,6,30,30
1650619789704,MATH 193A,A04,083782,Staff,0,7,30,30
1650619795731,MATH 197,001,091859,McAuley; Julian John,9998,0,9999,1
1650619801779,COGS 9,A01,083615,Staff,0,15,60,60
1650619807803,COGS 11,A01,083617,Boyle; Mary E. T.,18,0,40,22
1650619813830,COGS 13,A01,083071,Staff,0,38,40,40
1650619819853,COGS 14A,A01,092681,Staff,0,31,100,100
1650619825876,COGS 14B,A01,083073,Cheng; Tzu-Han,0,13,50,50
1650619831902,COGS 17,A01,092677,Staff,17,0,75,58
1650619837926,COGS 100,A01,083619,Staff,0,26,60,60
1650619843950,COGS 101A,A01,083621,Davis; Joshua Daniel,0,26,60,60
1650619849977,COGS 101B,A01,091572,Staff,0,4,60,60
1650619856001,COGS 101C,A01,083625,Delgado; Tania,15,0,30,15
1650619862031,COGS 107A,A01,083627,Boyle; Mary E. T.,1,15,60,59
1650619868056,COGS 118A,A01,083075,Staff,0,5,60,60
1650619874079,CSE 3,A50,083646,Miranda; Gregory Joseph,19,0,38,19
1650619874079,CSE 3,A51,083647,Miranda; Gregory Joseph,36,0,37,1
1650619880108,CSE 8A,A50,083650,Miranda; Gregory Joseph,0,30,40,40
1650619886131,CSE 11,A01,083080,Cao; Yingjun,0,95,40,40
1650619892153,CSE 12,A01,083652,Staff,0,19,100,100
1650619898180,CSE 15L,A01,083654,Staff,0,2,50,50
1650619898180,CSE 15L,A02,083655,Staff,0,1,50,50
1650619904204,CSE 20,A01,083657,Staff,51,0,80,29
1650619910231,CSE 30,A01,083084,Eldon; John,0,78,40,40
1650619916254,CSE 100,A01,083659,Cao; Yingjun,0,68,50,50
1650619922283,CSE 134B,A01,083661,Powell; Thomas Allan,0,35,65,65
1650619928307,CSE 140,A01,083663,Staff,0,8,75,75
1650619934422,CSE 140L,A01,083088,Eldon; John,0,16,75,75
1650619940446,CSE 175,A01,083665,Kumar; Rakesh,7,0,25,18
1650619946484,CSE 190,A00,092507,Dubnov; Shlomo,10,0,20,10
1650619952513,ECE 45,A01,083139,Staff,0,1,60,60
1650619958537,ECE 65,A50,083695,Staff,0,5,30,30
1650619964571,ECE 109,A01,091882,Touri; Behrouz,33,0,70,37
1650619970598,ECE 180,A00,083140,Abi Samra; Nicholas Camill,21,0,30,9
1650619970598,ECE 180,B00,083141,Abi Samra; Nicholas Camill,0,0,30,30
1650619976623,MATH 10A,A01,083735,Patchell; Gregory David,4,0,30,26
1650619976623,MATH 10A,A02,083736,Patchell; Gregory David,27,0,30,3
1650619976623,MATH 10A,A03,083737,Patchell; Gregory David,24,0,30,6
1650619982648,MATH 10B,A01,083207,Staff,0,8,30,30
1650619982648,MATH 10B,A02,083208,Staff,0,8,30,30
1650619982648,MATH 10B,B01,083739,Staff,11,0,30,19
1650619982648,MATH 10B,B02,083740,Staff,28,0,30,2
1650619988675,MATH 18,A01,083743,Staff,0,0,30,30
1650619988675,MATH 18,A02,083744,Staff,23,0,30,7
1650619988675,MATH 18,A03,083745,Staff,21,0,30,9
1650619988675,MATH 18,A04,083746,Staff,26,0,30,4
1650619988675,MATH 18,B01,083748,Staff,0,15,30,30
1650619988675,MATH 18,B02,083749,Staff,0,11,30,30
1650619988675,MATH 18,B03,083750,Staff,0,12,30,30
1650619988675,MATH 18,B04,083751,Staff,0,12,30,30
1650619994698,MATH 20A,A01,083754,Staff,19,0,40,21
1650620000720,MATH 20B,A01,083756,Staff,0,12,30,30
1650620000720,MATH 20B,A02,083757,Staff,0,12,30,30
1650620006745,MATH 20C,A01,083760,Staff,0,15,30,30
1650620006745,MATH 20C,A02,083761,Staff,1,13,30,29
1650620006745,MATH 20C,B01,083762,Staff,11,0,30,19
1650620006745,MATH 20C,B02,083763,Staff,28,0,30,2
1650620012769,MATH 20D,A01,083765,Staff,1,1,30,29
1650620012769,MATH 20D,A02,083766,Staff,7,0,30,23
1650620012769,MATH 20D,A03,083767,Staff,24,0,30,6
1650620018797,MATH 20E,A01,083771,Staff,3,0,30,27
1650620018797,MATH 20E,A02,083772,Staff,17,0,30,13
1650620018797,MATH 20E,B01,083773,Staff,0,0,30,30
1650620018797,MATH 20E,B02,083774,Staff,9,0,30,21
1650620024822,MATH 103A,A01,083777,Staff,0,15,30,30
1650620024822,MATH 103A,A02,083778,Staff,0,15,30,30
1650620024822,MATH 103A,B01,083779,Staff,0,14,30,30
1650620024822,MATH 103A,B02,083780,Staff,0,14,30,30
1650620030846,MATH 105,A01,085443,Staff,0,21,30,30
1650620036881,MATH 109,A01,083213,Anzaldo; Leesa B,0,6,30,30
1650620036881,MATH 109,A02,083214,Anzaldo; Leesa B,0,7,30,30
1650620036881,MATH 109,B01,083215,Anzaldo; Leesa B,0,6,30,30
1650620036881,MATH 109,B02,083216,Anzaldo; Leesa B,0,6,30,30
1650620042906,MATH 142A,A01,083219,Chow; Bennett,0,16,30,30
1650620042906,MATH 142A,A02,083220,Chow; Bennett,0,15,30,30
1650620042906,MATH 142A,B01,083221,Chow; Bennett,0,14,30,30
1650620042906,MATH 142A,B02,083222,Chow; Bennett,0,13,30,30
1650620048930,MATH 193A,A01,083224,Staff,0,5,30,30
1650620048930,MATH 193A,A02,083225,Staff,0,6,30,30
1650620048930,MATH 193A,A03,083781,Staff,0,6,30,30
1650620048930,MATH 193A,A04,083782,Staff,0,7,30,30
1650620054954,MATH 197,001,091859,McAuley; Julian John,9998,0,9999,1
1650620061015,COGS 9,A01,083615,Staff,0,15,60,60
1650620067047,COGS 11,A01,083617,Boyle; Mary E. T.,18,0,40,22
1650620073070,COGS 13,A01,083071,Staff,0,38,40,40
1650620079097,COGS 14A,A01,092681,Staff,0,31,100,100
1650620085137,COGS 14B,A01,083073,Cheng; Tzu-Han,0,13,50,50
1650620091164,COGS 17,A01,092677,Staff,17,0,75,58
1650620097187,COGS 100,A01,083619,Staff,0,26,60,60
1650620103210,COGS 101A,A01,083621,Davis; Joshua Daniel,0,26,60,60
1650620109236,COGS 101B,A01,091572,Staff,0,4,60,60
1650620115258,COGS 101C,A01,083625,Delgado; Tania,15,0,30,15
1650620121285,COGS 107A,A01,083627,Boyle; Mary E. T.,1,15,60,59
1650620127309,COGS 118A,A01,083075,Staff,0,5,60,60
1650620133333,CSE 3,A50,083646,Miranda; Gregory Joseph,19,0,38,19
1650620133333,CSE 3,A51,083647,Miranda; Gregory Joseph,36,0,37,1
1650620139362,CSE 8A,A50,083650,Miranda; Gregory Joseph,0,30,40,40
1650620145385,CSE 11,A01,083080,Cao; Yingjun,0,95,40,40
1650620151409,CSE 12,A01,083652,Staff,0,19,100,100
1650620157432,CSE 15L,A01,083654,Staff,0,2,50,50
1650620157432,CSE 15L,A02,083655,Staff,0,1,50,50
1650620163457,CSE 20,A01,083657,Staff,51,0,80,29
1650620169480,CSE 30,A01,083084,Eldon; John,0,77,40,40
1650620175502,CSE 100,A01,083659,Cao; Yingjun,0,68,50,50
1650620181530,CSE 134B,A01,083661,Powell; Thomas Allan,0,35,65,65
1650620187553,CSE 140,A01,083663,Staff,0,8,75,75
1650620193576,CSE 140L,A01,083088,Eldon; John,0,16,75,75
1650620199598,CSE 175,A01,083665,Kumar; Rakesh,7,0,25,18
1650620205621,CSE 190,A00,092507,Dubnov; Shlomo,10,0,20,10
1650620211646,ECE 45,A01,083139,Staff,0,1,60,60
1650620217677,ECE 65,A50,083695,Staff,0,5,30,30
1650620223700,ECE 109,A01,091882,Touri; Behrouz,33,0,70,37
1650620229727,ECE 180,A00,083140,Abi Samra; Nicholas Camill,21,0,30,9
1650620229727,ECE 180,B00,083141,Abi Samra; Nicholas Camill,0,0,30,30
1650620235755,MATH 10A,A01,083735,Patchell; Gregory David,4,0,30,26
1650620235755,MATH 10A,A02,083736,Patchell; Gregory David,27,0,30,3
1650620235755,MATH 10A,A03,083737,Patchell; Gregory David,24,0,30,6
1650620241778,MATH 10B,A01,083207,Staff,0,8,30,30
1650620241778,MATH 10B,A02,083208,Staff,0,8,30,30
1650620241778,MATH 10B,B01,083739,Staff,11,0,30,19
1650620241778,MATH 10B,B02,083740,Staff,28,0,30,2
1650620247801,MATH 18,A01,083743,Staff,0,0,30,30
1650620247801,MATH 18,A02,083744,Staff,23,0,30,7
1650620247801,MATH 18,A03,083745,Staff,21,0,30,9
1650620247801,MATH 18,A04,083746,Staff,26,0,30,4
1650620247801,MATH 18,B01,083748,Staff,0,15,30,30
1650620247801,MATH 18,B02,083749,Staff,0,11,30,30
1650620247801,MATH 18,B03,083750,Staff,0,12,30,30
1650620247801,MATH 18,B04,083751,Staff,0,12,30,30
1650620253828,MATH 20A,A01,083754,Staff,19,0,40,21
1650620259855,MATH 20B,A01,083756,Staff,0,12,30,30
1650620259855,MATH 20B,A02,083757,Staff,0,12,30,30
1650620265879,MATH 20C,A01,083760,Staff,0,15,30,30
1650620265879,MATH 20C,A02,083761,Staff,1,13,30,29
1650620265879,MATH 20C,B01,083762,Staff,11,0,30,19
1650620265879,MATH 20C,B02,083763,Staff,28,0,30,2
1650620271903,MATH 20D,A01,083765,Staff,1,1,30,29
1650620271903,MATH 20D,A02,083766,Staff,7,0,30,23
1650620271903,MATH 20D,A03,083767,Staff,24,0,30,6
1650620277932,MATH 20E,A01,083771,Staff,3,0,30,27
1650620277932,MATH 20E,A02,083772,Staff,17,0,30,13
1650620277932,MATH 20E,B01,083773,Staff,0,0,30,30
1650620277932,MATH 20E,B02,083774,Staff,9,0,30,21
1650620283956,MATH 103A,A01,083777,Staff,0,15,30,30
1650620283956,MATH 103A,A02,083778,Staff,0,15,30,30
1650620283956,MATH 103A,B01,083779,Staff,0,14,30,30
1650620283956,MATH 103A,B02,083780,Staff,0,14,30,30
1650620289978,MATH 105,A01,085443,Staff,0,21,30,30
1650620296004,MATH 109,A01,083213,Anzaldo; Leesa B,0,6,30,30
1650620296004,MATH 109,A02,083214,Anzaldo; Leesa B,0,7,30,30
1650620296004,MATH 109,B01,083215,Anzaldo; Leesa B,0,6,30,30
1650620296004,MATH 109,B02,083216,Anzaldo; Leesa B,0,6,30,30
1650620302033,MATH 142A,A01,083219,Chow; Bennett,0,16,30,30
1650620302033,MATH 142A,A02,083220,Chow; Bennett,0,15,30,30
1650620302033,MATH 142A,B01,083221,Chow; Bennett,0,14,30,30
1650620302033,MATH 142A,B02,083222,Chow; Bennett,0,13,30,30
1650620308060,MATH 193A,A01,083224,Staff,0,5,30,30
1650620308060,MATH 193A,A02,083225,Staff,0,6,30,30
1650620308060,MATH 193A,A03,083781,Staff,0,6,30,30
1650620308060,MATH 193A,A04,083782,Staff,0,7,30,30
1650620314086,MATH 197,001,091859,McAuley; Julian John,9998,0,9999,1
1650620320136,COGS 9,A01,083615,Staff,0,15,60,60
1650620326160,COGS 11,A01,083617,Boyle; Mary E. T.,18,0,40,22
1650620332184,COGS 13,A01,083071,Staff,0,38,40,40
1650620338208,COGS 14A,A01,092681,Staff,0,31,100,100
1650620344236,COGS 14B,A01,083073,Cheng; Tzu-Han,0,13,50,50
1650620350262,COGS 17,A01,092677,Staff,17,0,75,58
1650620356286,COGS 100,A01,083619,Staff,0,26,60,60
1650620362309,COGS 101A,A01,083621,Davis; Joshua Daniel,0,26,60,60
1650620368334,COGS 101B,A01,091572,Staff,0,4,60,60
1650620374357,COGS 101C,A01,083625,Delgado; Tania,15,0,30,15
1650620380380,COGS 107A,A01,083627,Boyle; Mary E. T.,1,15,60,59
1650620386404,COGS 118A,A01,083075,Staff,0,6,60,60
1650620392428,CSE 3,A50,083646,Miranda; Gregory Joseph,19,0,38,19
1650620392428,CSE 3,A51,083647,Miranda; Gregory Joseph,36,0,37,1
1650620398453,CSE 8A,A50,083650,Miranda; Gregory Joseph,0,30,40,40
1650620404477,CSE 11,A01,083080,Cao; Yingjun,0,95,40,40
1650620410504,CSE 12,A01,083652,Staff,0,19,100,100
1650620416529,CSE 15L,A01,083654,Staff,0,2,50,50
1650620416529,CSE 15L,A02,083655,Staff,0,1,50,50
1650620422552,CSE 20,A01,083657,Staff,51,0,80,29
1650620428579,CSE 30,A01,083084,Eldon; John,0,77,40,40
1650620434606,CSE 100,A01,083659,Cao; Yingjun,0,68,50,50
1650620440629,CSE 134B,A01,083661,Powell; Thomas Allan,0,35,65,65
1650620446654,CSE 140,A01,083663,Staff,0,8,75,75
1650620452676,CSE 140L,A01,083088,Eldon; John,0,16,75,75
1650620458703,CSE 175,A01,083665,Kumar; Rakesh,7,0,25,18
1650620464726,CSE 190,A00,092507,Dubnov; Shlomo,10,0,20,10
1650620470757,ECE 45,A01,083139,Staff,0,1,60,60
1650620476782,ECE 65,A50,083695,Staff,0,5,30,30
1650620482806,ECE 109,A01,091882,Touri; Behrouz,33,0,70,37
1650620488829,ECE 180,A00,083140,Abi Samra; Nicholas Camill,21,0,30,9
1650620488829,ECE 180,B00,083141,Abi Samra; Nicholas Camill,0,0,30,30
1650620494857,MATH 10A,A01,083735,Patchell; Gregory David,4,0,30,26
1650620494857,MATH 10A,A02,083736,Patchell; Gregory David,27,0,30,3
1650620494857,MATH 10A,A03,083737,Patchell; Gregory David,24,0,30,6
1650620500881,MATH 10B,A01,083207,Staff,0,8,30,30
1650620500881,MATH 10B,A02,083208,Staff,0,8,30,30
1650620500881,MATH 10B,B01,083739,Staff,11,0,30,19
1650620500881,MATH 10B,B02,083740,Staff,28,0,30,2
1650620506912,MATH 18,A01,083743,Staff,0,0,30,30
1650620506912,MATH 18,A02,083744,Staff,23,0,30,7
1650620506912,MATH 18,A03,083745,Staff,21,0,30,9
1650620506912,MATH 18,A04,083746,Staff,26,0,30,4
1650620506912,MATH 18,B01,083748,Staff,0,15,30,30
1650620506912,MATH 18,B02,083749,Staff,0,11,30,30
1650620506912,MATH 18,B03,083750,Staff,0,12,30,30
1650620506912,MATH 18,B04,083751,Staff,0,12,30,30
1650620512942,MATH 20A,A01,083754,Staff,19,0,40,21
1650620518965,MATH 20B,A01,083756,Staff,0,12,30,30
1650620518965,MATH 20B,A02,083757,Staff,0,12,30,30
1650620524991,MATH 20C,A01,083760,Staff,0,15,30,30
1650620524991,MATH 20C,A02,083761,Staff,1,13,30,29
1650620524991,MATH 20C,B01,083762,Staff,11,0,30,19
1650620524991,MATH 20C,B02,083763,Staff,28,0,30,2
1650620531092,MATH 20D,A01,083765,Staff,1,1,30,29
1650620531092,MATH 20D,A02,083766,Staff,7,0,30,23
1650620531092,MATH 20D,A03,083767,Staff,24,0,30,6
1650620537118,MATH 20E,A01,083771,Staff,3,0,30,27
1650620537118,MATH 20E,A02,083772,Staff,17,0,30,13
1650620537118,MATH 20E,B01,083773,Staff,0,0,30,30
1650620537118,MATH 20E,B02,083774,Staff,9,0,30,21
1650620543146,MATH 103A,A01,083777,Staff,0,15,30,30
1650620543146,MATH 103A,A02,083778,Staff,0,15,30,30
1650620543146,MATH 103A,B01,083779,Staff,0,14,30,30
1650620543146,MATH 103A,B02,083780,Staff,0,14,30,30
1650620549173,MATH 105,A01,085443,Staff,0,21,30,30
1650620555200,MATH 109,A01,083213,Anzaldo; Leesa B,0,6,30,30
1650620555200,MATH 109,A02,083214,Anzaldo; Leesa B,0,7,30,30
1650620555200,MATH 109,B01,083215,Anzaldo; Leesa B,0,6,30,30
1650620555200,MATH 109,B02,083216,Anzaldo; Leesa B,0,6,30,30
1650620561225,MATH 142A,A01,083219,Chow; Bennett,0,16,30,30
1650620561225,MATH 142A,A02,083220,Chow; Bennett,0,15,30,30
1650620561225,MATH 142A,B01,083221,Chow; Bennett,0,14,30,30
1650620561225,MATH 142A,B02,083222,Chow; Bennett,0,13,30,30
1650620567252,MATH 193A,A01,083224,Staff,0,5,30,30
1650620567252,MATH 193A,A02,083225,Staff,0,6,30,30
1650620567252,MATH 193A,A03,083781,Staff,0,6,30,30
1650620567252,MATH 193A,A04,083782,Staff,0,7,30,30
1650620573280,MATH 197,001,091859,McAuley; Julian John,9998,0,9999,1
1650620579333,COGS 9,A01,083615,Staff,0,15,60,60
1650620585359,COGS 11,A01,083617,Boyle; Mary E. T.,18,0,40,22
1650620591390,COGS 13,A01,083071,Staff,0,38,40,40
1650620597416,COGS 14A,A01,092681,Staff,0,31,100,100
1650620603439,COGS 14B,A01,083073,Cheng; Tzu-Han,0,13,50,50
1650620609463,COGS 17,A01,092677,Staff,17,0,75,58
1650620615486,COGS 100,A01,083619,Staff,0,26,60,60
1650620621510,COGS 101A,A01,083621,Davis; Joshua Daniel,0,26,60,60
1650620627536,COGS 101B,A01,091572,Staff,0,4,60,60
1650620633561,COGS 101C,A01,083625,Delgado; Tania,15,0,30,15
1650620639585,COGS 107A,A01,083627,Boyle; Mary E. T.,1,15,60,59
1650620645612,COGS 118A,A01,083075,Staff,0,6,60,60
1650620651635,CSE 3,A50,083646,Miranda; Gregory Joseph,19,0,38,19
1650620651635,CSE 3,A51,083647,Miranda; Gregory Joseph,36,0,37,1
1650620657675,CSE 8A,A50,083650,Miranda; Gregory Joseph,0,30,40,40
1650620663715,CSE 11,A01,083080,Cao; Yingjun,0,95,40,40
1650620669740,CSE 12,A01,083652,Staff,0,19,100,100
1650620675763,CSE 15L,A01,083654,Staff,0,2,50,50
1650620675763,CSE 15L,A02,083655,Staff,0,1,50,50
1650620681786,CSE 20,A01,083657,Staff,51,0,80,29
1650620687811,CSE 30,A01,083084,Eldon; John,0,77,40,40
1650620693834,CSE 100,A01,083659,Cao; Yingjun,0,68,50,50
1650620699857,CSE 134B,A01,083661,Powell; Thomas Allan,0,35,65,65
1650620705883,CSE 140,A01,083663,Staff,0,8,75,75
1650620711910,CSE 140L,A01,083088,Eldon; John,0,16,75,75
1650620717931,CSE 175,A01,083665,Kumar; Rakesh,7,0,25,18
1650620723957,CSE 190,A00,092507,Dubnov; Shlomo,10,0,20,10
1650620729989,ECE 45,A01,083139,Staff,0,1,60,60
1650620736011,ECE 65,A50,083695,Staff,0,5,30,30
1650620742038,ECE 109,A01,091882,Touri; Behrouz,33,0,70,37
1650620748060,ECE 180,A00,083140,Abi Samra; Nicholas Camill,21,0,30,9
1650620748060,ECE 180,B00,083141,Abi Samra; Nicholas Camill,0,0,30,30
1650620754084,MATH 10A,A01,083735,Patchell; Gregory David,4,0,30,26
1650620754084,MATH 10A,A02,083736,Patchell; Gregory David,27,0,30,3
1650620754084,MATH 10A,A03,083737,Patchell; Gregory David,24,0,30,6
1650620760111,MATH 10B,A01,083207,Staff,0,8,30,30
1650620760111,MATH 10B,A02,083208,Staff,0,8,30,30
1650620760111,MATH 10B,B01,083739,Staff,11,0,30,19
1650620760111,MATH 10B,B02,083740,Staff,28,0,30,2
1650620766146,MATH 18,A01,083743,Staff,0,0,30,30
1650620766146,MATH 18,A02,083744,Staff,23,0,30,7
1650620766146,MATH 18,A03,083745,Staff,21,0,30,9
1650620766146,MATH 18,A04,083746,Staff,26,0,30,4
1650620766146,MATH 18,B01,083748,Staff,0,15,30,30
1650620766146,MATH 18,B02,083749,Staff,0,11,30,30
1650620766146,MATH 18,B03,083750,Staff,0,12,30,30
1650620766146,MATH 18,B04,083751,Staff,0,12,30,30
1650620772169,MATH 20A,A01,083754,Staff,19,0,40,21
1650620778198,MATH 20B,A01,083756,Staff,0,12,30,30
1650620778198,MATH 20B,A02,083757,Staff,0,12,30,30
1650620784221,MATH 20C,A01,083760,Staff,0,15,30,30
1650620784221,MATH 20C,A02,083761,Staff,1,13,30,29
1650620784221,MATH 20C,B01,083762,Staff,11,0,30,19
1650620784221,MATH 20C,B02,083763,Staff,28,0,30,2
1650620790245,MATH 20D,A01,083765,Staff,1,1,30,29
1650620790245,MATH 20D,A02,083766,Staff,7,0,30,23
1650620790245,MATH 20D,A03,083767,Staff,24,0,30,6
1650620796272,MATH 20E,A01,083771,Staff,3,0,30,27
1650620796272,MATH 20E,A02,083772,Staff,17,0,30,13
1650620796272,MATH 20E,B01,083773,Staff,0,0,30,30
1650620796272,MATH 20E,B02,083774,Staff,9,0,30,21
1650620802300,MATH 103A,A01,083777,Staff,0,15,30,30
1650620802300,MATH 103A,A02,083778,Staff,0,15,30,30
1650620802300,MATH 103A,B01,083779,Staff,0,14,30,30
1650620802300,MATH 103A,B02,083780,Staff,0,14,30,30
1650620808324,MATH 105,A01,085443,Staff,0,21,30,30
1650620814347,MATH 109,A01,083213,Anzaldo; Leesa B,0,6,30,30
1650620814347,MATH 109,A02,083214,Anzaldo; Leesa B,0,7,30,30
1650620814347,MATH 109,B01,083215,Anzaldo; Leesa B,0,6,30,30
1650620814347,MATH 109,B02,083216,Anzaldo; Leesa B,0,6,30,30
1650620820372,MATH 142A,A01,083219,Chow; Bennett,0,16,30,30
1650620820372,MATH 142A,A02,083220,Chow; Bennett,0,15,30,30
1650620820372,MATH 142A,B01,083221,Chow; Bennett,0,14,30,30
1650620820372,MATH 142A,B02,083222,Chow; Bennett,0,13,30,30
1650620826396,MATH 193A,A01,083224,Staff,0,5,30,30
1650620826396,MATH 193A,A02,083225,Staff,0,6,30,30
1650620826396,MATH 193A,A03,083781,Staff,0,6,30,30
1650620826396,MATH 193A,A04,083782,Staff,0,7,30,30
1650620832422,MATH 197,001,091859,McAuley; Julian John,9998,0,9999,1
1650620838482,COGS 9,A01,083615,Staff,0,15,60,60
1650620844504,COGS 11,A01,083617,Boyle; Mary E. T.,18,0,40,22
1650620850528,COGS 13,A01,083071,Staff,0,38,40,40
1650620856550,COGS 14A,A01,092681,Staff,0,31,100,100
1650620862575,COGS 14B,A01,083073,Cheng; Tzu-Han,0,13,50,50
1650620868600,COGS 17,A01,092677,Staff,17,0,75,58
1650620874622,COGS 100,A01,083619,Staff,0,26,60,60
1650620880649,COGS 101A,A01,083621,Davis; Joshua Daniel,0,26,60,60
1650620886675,COGS 101B,A01,091572,Staff,0,4,60,60
1650620892700,COGS 101C,A01,083625,Delgado; Tania,15,0,30,15
1650620898723,COGS 107A,A01,083627,Boyle; Mary E. T.,1,15,60,59
1650620904747,COGS 118A,A01,083075,Staff,0,6,60,60
1650620910769,CSE 3,A50,083646,Miranda; Gregory Joseph,19,0,38,19
1650620910769,CSE 3,A51,083647,Miranda; Gregory Joseph,36,0,37,1
1650620916795,CSE 8A,A50,083650,Miranda; Gregory Joseph,0,30,40,40
1650620922819,CSE 11,A01,083080,Cao; Yingjun,0,95,40,40
1650620928842,CSE 12,A01,083652,Staff,0,19,100,100
1650620934868,CSE 15L,A01,083654,Staff,0,2,50,50
1650620934868,CSE 15L,A02,083655,Staff,0,1,50,50
1650620940892,CSE 20,A01,083657,Staff,51,0,80,29
1650620946916,CSE 30,A01,083084,Eldon; John,0,77,40,40
1650620952940,CSE 100,A01,083659,Cao; Yingjun,0,68,50,50
1650620958967,CSE 134B,A01,083661,Powell; Thomas Allan,0,35,65,65
1650620964990,CSE 140,A01,083663,Staff,0,8,75,75
1650620971015,CSE 140L,A01,083088,Eldon; John,0,16,75,75
1650620977040,CSE 175,A01,083665,Kumar; Rakesh,7,0,25,18
1650620983067,CSE 190,A00,092507,Dubnov; Shlomo,10,0,20,10
1650620989092,ECE 45,A01,083139,Staff,0,1,60,60
1650620995116,ECE 65,A50,083695,Staff,0,5,30,30
1650621001140,ECE 109,A01,091882,Touri; Behrouz,33,0,70,37
1650621007168,ECE 180,A00,083140,Abi Samra; Nicholas Camill,21,0,30,9
1650621007168,ECE 180,B00,083141,Abi Samra; Nicholas Camill,0,0,30,30
1650621013195,MATH 10A,A01,083735,Patchell; Gregory David,4,0,30,26
1650621013195,MATH 10A,A02,083736,Patchell; Gregory David,27,0,30,3
1650621013195,MATH 10A,A03,083737,Patchell; Gregory David,24,0,30,6
1650621019221,MATH 10B,A01,083207,Staff,0,8,30,30
1650621019221,MATH 10B,A02,083208,Staff,0,8,30,30
1650621019221,MATH 10B,B01,083739,Staff,11,0,30,19
1650621019221,MATH 10B,B02,083740,Staff,28,0,30,2
1650621025251,MATH 18,A01,083743,Staff,0,0,30,30
1650621025251,MATH 18,A02,083744,Staff,23,0,30,7
1650621025251,MATH 18,A03,083745,Staff,21,0,30,9
1650621025251,MATH 18,A04,083746,Staff,26,0,30,4
1650621025251,MATH 18,B01,083748,Staff,0,15,30,30
1650621025251,MATH 18,B02,083749,Staff,0,11,30,30
1650621025251,MATH 18,B03,083750,Staff,0,12,30,30
1650621025251,MATH 18,B04,083751,Staff,0,12,30,30
1650621031275,MATH 20A,A01,083754,Staff,19,0,40,21
1650621037298,MATH 20B,A01,083756,Staff,0,12,30,30
1650621037298,MATH 20B,A02,083757,Staff,0,12,30,30
1650621043323,MATH 20C,A01,083760,Staff,0,15,30,30
1650621043323,MATH 20C,A02,083761,Staff,1,13,30,29
1650621043323,MATH 20C,B01,083762,Staff,11,0,30,19
1650621043323,MATH 20C,B02,083763,Staff,28,0,30,2
1650621049351,MATH 20D,A01,083765,Staff,1,1,30,29
1650621049351,MATH 20D,A02,083766,Staff,7,0,30,23
1650621049351,MATH 20D,A03,083767,Staff,24,0,30,6
1650621055377,MATH 20E,A01,083771,Staff,3,0,30,27
1650621055377,MATH 20E,A02,083772,Staff,17,0,30,13
1650621055377,MATH 20E,B01,083773,Staff,0,0,30,30
1650621055377,MATH 20E,B02,083774,Staff,9,0,30,21
1650621061400,MATH 103A,A01,083777,Staff,0,15,30,30
1650621061400,MATH 103A,A02,083778,Staff,0,15,30,30
1650621061400,MATH 103A,B01,083779,Staff,0,14,30,30
1650621061400,MATH 103A,B02,083780,Staff,0,14,30,30
1650621067427,MATH 105,A01,085443,Staff,0,21,30,30
1650621073451,MATH 109,A01,083213,Anzaldo; Leesa B,0,6,30,30
1650621073451,MATH 109,A02,083214,Anzaldo; Leesa B,0,7,30,30
1650621073451,MATH 109,B01,083215,Anzaldo; Leesa B,0,6,30,30
1650621073451,MATH 109,B02,083216,Anzaldo; Leesa B,0,6,30,30
1650621079476,MATH 142A,A01,083219,Chow; Bennett,0,16,30,30
1650621079476,MATH 142A,A02,083220,Chow; Bennett,0,15,30,30
1650621079476,MATH 142A,B01,083221,Chow; Bennett,0,14,30,30
1650621079476,MATH 142A,B02,083222,Chow; Bennett,0,13,30,30
1650621085502,MATH 193A,A01,083224,Staff,0,5,30,30
1650621085502,MATH 193A,A02,083225,Staff,0,6,30,30
1650621085502,MATH 193A,A03,083781,Staff,0,6,30,30
1650621085502,MATH 193A,A04,083782,Staff,0,7,30,30
1650621091528,MATH 197,001,091859,McAuley; Julian John,9998,0,9999,1
1650621097578,COGS 9,A01,083615,Staff,0,15,60,60
1650621103602,COGS 11,A01,083617,Boyle; Mary E. T.,18,0,40,22
1650621109627,COGS 13,A01,083071,Staff,0,38,40,40
1650621115651,COGS 14A,A01,092681,Staff,0,31,100,100
1650621121750,COGS 14B,A01,083073,Cheng; Tzu-Han,0,13,50,50
1650621127773,COGS 17,A01,092677,Staff,17,0,75,58
1650621133797,COGS 100,A01,083619,Staff,0,26,60,60
1650621139820,COGS 101A,A01,083621,Davis; Joshua Daniel,0,26,60,60
1650621145846,COGS 101B,A01,091572,Staff,0,4,60,60
1650621151873,COGS 101C,A01,083625,Delgado; Tania,15,0,30,15
1650621157911,COGS 107A,A01,083627,Boyle; Mary E. T.,1,15,60,59
1650621163936,COGS 118A,A01,083075,Staff,0,6,60,60
1650621169963,CSE 3,A50,083646,Miranda; Gregory Joseph,19,0,38,19
1650621169963,CSE 3,A51,083647,Miranda; Gregory Joseph,36,0,37,1
1650621175987,CSE 8A,A50,083650,Miranda; Gregory Joseph,0,30,40,40
1650621182012,CSE 11,A01,083080,Cao; Yingjun,0,95,40,40
1650621188036,CSE 12,A01,083652,Staff,0,19,100,100
1650621194063,CSE 15L,A01,083654,Staff,0,2,50,50
1650621194063,CSE 15L,A02,083655,Staff,0,1,50,50
1650621200089,CSE 20,A01,083657,Staff,51,0,80,29
1650621206116,CSE 30,A01,083084,Eldon; John,0,77,40,40
1650621212139,CSE 100,A01,083659,Cao; Yingjun,0,68,50,50
1650621218165,CSE 134B,A01,083661,Powell; Thomas Allan,0,35,65,65
1650621224189,CSE 140,A01,083663,Staff,0,8,75,75
1650621230213,CSE 140L,A01,083088,Eldon; John,0,16,75,75
1650621236237,CSE 175,A01,083665,Kumar; Rakesh,7,0,25,18
1650621242262,CSE 190,A00,092507,Dubnov; Shlomo,10,0,20,10
1650621248285,ECE 45,A01,083139,Staff,0,1,60,60
1650621254312,ECE 65,A50,083695,Staff,0,5,30,30
1650621260336,ECE 109,A01,091882,Touri; Behrouz,33,0,70,37
1650621266360,ECE 180,A00,083140,Abi Samra; Nicholas Camill,21,0,30,9
1650621266360,ECE 180,B00,083141,Abi Samra; Nicholas Camill,0,0,30,30
1650621272383,MATH 10A,A01,083735,Patchell; Gregory David,4,0,30,26
1650621272383,MATH 10A,A02,083736,Patchell; Gregory David,27,0,30,3
1650621272383,MATH 10A,A03,083737,Patchell; Gregory David,24,0,30,6
1650621278406,MATH 10B,A01,083207,Staff,0,8,30,30
1650621278406,MATH 10B,A02,083208,Staff,0,8,30,30
1650621278406,MATH 10B,B01,083739,Staff,11,0,30,19
1650621278406,MATH 10B,B02,083740,Staff,28,0,30,2
1650621284436,MATH 18,A01,083743,Staff,0,0,30,30
1650621284436,MATH 18,A02,083744,Staff,23,0,30,7
1650621284436,MATH 18,A03,083745,Staff,21,0,30,9
1650621284436,MATH 18,A04,083746,Staff,26,0,30,4
1650621284436,MATH 18,B01,083748,Staff,0,15,30,30
1650621284436,MATH 18,B02,083749,Staff,0,11,30,30
1650621284436,MATH 18,B03,083750,Staff,0,12,30,30
1650621284436,MATH 18,B04,083751,Staff,0,12,30,30
1650621290460,MATH 20A,A01,083754,Staff,19,0,40,21
1650621296483,MATH 20B,A01,083756,Staff,0,12,30,30
1650621296483,MATH 20B,A02,083757,Staff,0,12,30,30
1650621302508,MATH 20C,A01,083760,Staff,0,15,30,30
1650621302508,MATH 20C,A02,083761,Staff,1,13,30,29
1650621302508,MATH 20C,B01,083762,Staff,11,0,30,19
1650621302508,MATH 20C,B02,083763,Staff,28,0,30,2
1650621308532,MATH 20D,A01,083765,Staff,1,1,30,29
1650621308532,MATH 20D,A02,083766,Staff,7,0,30,23
1650621308532,MATH 20D,A03,083767,Staff,24,0,30,6
1650621314559,MATH 20E,A01,083771,Staff,3,0,30,27
1650621314559,MATH 20E,A02,083772,Staff,17,0,30,13
1650621314559,MATH 20E,B01,083773,Staff,0,0,30,30
1650621314559,MATH 20E,B02,083774,Staff,9,0,30,21
1650621320587,MATH 103A,A01,083777,Staff,0,15,30,30
1650621320587,MATH 103A,A02,083778,Staff,0,15,30,30
1650621320587,MATH 103A,B01,083779,Staff,0,14,30,30
1650621320587,MATH 103A,B02,083780,Staff,0,14,30,30
1650621326611,MATH 105,A01,085443,Staff,0,21,30,30
1650621332639,MATH 109,A01,083213,Anzaldo; Leesa B,0,6,30,30
1650621332639,MATH 109,A02,083214,Anzaldo; Leesa B,0,7,30,30
1650621332639,MATH 109,B01,083215,Anzaldo; Leesa B,0,6,30,30
1650621332639,MATH 109,B02,083216,Anzaldo; Leesa B,0,6,30,30
1650621338663,MATH 142A,A01,083219,Chow; Bennett,0,16,30,30
1650621338663,MATH 142A,A02,083220,Chow; Bennett,0,15,30,30
1650621338663,MATH 142A,B01,083221,Chow; Bennett,0,14,30,30
1650621338663,MATH 142A,B02,083222,Chow; Bennett,0,13,30,30
1650621344687,MATH 193A,A01,083224,Staff,0,5,30,30
1650621344687,MATH 193A,A02,083225,Staff,0,6,30,30
1650621344687,MATH 193A,A03,083781,Staff,0,6,30,30
1650621344687,MATH 193A,A04,083782,Staff,0,7,30,30
1650621350710,MATH 197,001,091859,McAuley; Julian John,9998,0,9999,1
1650621356775,COGS 9,A01,083615,Staff,0,15,60,60
1650621362804,COGS 11,A01,083617,Boyle; Mary E. T.,18,0,40,22
1650621368829,COGS 13,A01,083071,Staff,0,38,40,40
1650621374851,COGS 14A,A01,092681,Staff,0,31,100,100
1650621380875,COGS 14B,A01,083073,Cheng; Tzu-Han,0,13,50,50
1650621386897,COGS 17,A01,092677,Staff,17,0,75,58
1650621392920,COGS 100,A01,083619,Staff,0,26,60,60
1650621398943,COGS 101A,A01,083621,Davis; Joshua Daniel,0,26,60,60
1650621404970,COGS 101B,A01,091572,Staff,0,4,60,60
1650621410992,COGS 101C,A01,083625,Delgado; Tania,15,0,30,15
1650621417016,COGS 107A,A01,083627,Boyle; Mary E. T.,1,15,60,59
1650621423040,COGS 118A,A01,083075,Staff,0,6,60,60
1650621429065,CSE 3,A50,083646,Miranda; Gregory Joseph,19,0,38,19
1650621429065,CSE 3,A51,083647,Miranda; Gregory Joseph,36,0,37,1
1650621435088,CSE 8A,A50,083650,Miranda; Gregory Joseph,0,30,40,40
1650621441112,CSE 11,A01,083080,Cao; Yingjun,0,95,40,40
1650621447135,CSE 12,A01,083652,Staff,0,19,100,100
1650621453159,CSE 15L,A01,083654,Staff,0,2,50,50
1650621453159,CSE 15L,A02,083655,Staff,0,1,50,50
1650621459184,CSE 20,A01,083657,Staff,51,0,80,29
1650621465213,CSE 30,A01,083084,Eldon; John,0,77,40,40
1650621471240,CSE 100,A01,083659,Cao; Yingjun,0,68,50,50
1650621477284,CSE 134B,A01,083661,Powell; Thomas Allan,0,35,65,65
1650621483309,CSE 140,A01,083663,Staff,0,8,75,75
1650621489344,CSE 140L,A01,083088,Eldon; John,0,16,75,75
1650621495370,CSE 175,A01,083665,Kumar; Rakesh,7,0,25,18
1650621501391,CSE 190,A00,092507,Dubnov; Shlomo,10,0,20,10
1650621507417,ECE 45,A01,083139,Staff,0,1,60,60
1650621513442,ECE 65,A50,083695,Staff,0,5,30,30
1650621519465,ECE 109,A01,091882,Touri; Behrouz,33,0,70,37
1650621525490,ECE 180,A00,083140,Abi Samra; Nicholas Camill,21,0,30,9
1650621525490,ECE 180,B00,083141,Abi Samra; Nicholas Camill,0,0,30,30
1650621531512,MATH 10A,A01,083735,Patchell; Gregory David,4,0,30,26
1650621531512,MATH 10A,A02,083736,Patchell; Gregory David,27,0,30,3
1650621531512,MATH 10A,A03,083737,Patchell; Gregory David,24,0,30,6
1650621537535,MATH 10B,A01,083207,Staff,0,8,30,30
1650621537535,MATH 10B,A02,083208,Staff,0,8,30,30
1650621537535,MATH 10B,B01,083739,Staff,11,0,30,19
1650621537535,MATH 10B,B02,083740,Staff,28,0,30,2
1650621543567,MATH 18,A01,083743,Staff,0,0,30,30
1650621543567,MATH 18,A02,083744,Staff,23,0,30,7
1650621543567,MATH 18,A03,083745,Staff,21,0,30,9
1650621543567,MATH 18,A04,083746,Staff,26,0,30,4
1650621543567,MATH 18,B01,083748,Staff,0,15,30,30
1650621543567,MATH 18,B02,083749,Staff,0,11,30,30
1650621543567,MATH 18,B03,083750,Staff,0,12,30,30
1650621543567,MATH 18,B04,083751,Staff,0,12,30,30
1650621549590,MATH 20A,A01,083754,Staff,19,0,40,21
1650621555614,MATH 20B,A01,083756,Staff,0,12,30,30
1650621555614,MATH 20B,A02,083757,Staff,0,12,30,30
1650621561640,MATH 20C,A01,083760,Staff,0,15,30,30
1650621561640,MATH 20C,A02,083761,Staff,1,13,30,29
1650621561640,MATH 20C,B01,083762,Staff,11,0,30,19
1650621561640,MATH 20C,B02,083763,Staff,28,0,30,2
1650621567663,MATH 20D,A01,083765,Staff,1,1,30,29
1650621567663,MATH 20D,A02,083766,Staff,7,0,30,23
1650621567663,MATH 20D,A03,083767,Staff,24,0,30,6
1650621573687,MATH 20E,A01,083771,Staff,3,0,30,27
1650621573687,MATH 20E,A02,083772,Staff,17,0,30,13
1650621573687,MATH 20E,B01,083773,Staff,0,0,30,30
1650621573687,MATH 20E,B02,083774,Staff,9,0,30,21
1650621579708,MATH 103A,A01,083777,Staff,0,15,30,30
1650621579708,MATH 103A,A02,083778,Staff,0,15,30,30
1650621579708,MATH 103A,B01,083779,Staff,0,14,30,30
1650621579708,MATH 103A,B02,083780,Staff,0,14,30,30
1650621585737,MATH 105,A01,085443,Staff,0,21,30,30
1650621591760,MATH 109,A01,083213,Anzaldo; Leesa B,0,6,30,30
1650621591760,MATH 109,A02,083214,Anzaldo; Leesa B,0,7,30,30
1650621591760,MATH 109,B01,083215,Anzaldo; Leesa B,0,6,30,30
1650621591760,MATH 109,B02,083216,Anzaldo; Leesa B,0,6,30,30
1650621597784,MATH 142A,A01,083219,Chow; Bennett,0,16,30,30
1650621597784,MATH 142A,A02,083220,Chow; Bennett,0,15,30,30
1650621597784,MATH 142A,B01,083221,Chow; Bennett,0,14,30,30
1650621597784,MATH 142A,B02,083222,Chow; Bennett,0,13,30,30
1650621603813,MATH 193A,A01,083224,Staff,0,5,30,30
1650621603813,MATH 193A,A02,083225,Staff,0,6,30,30
1650621603813,MATH 193A,A03,083781,Staff,0,6,30,30
1650621603813,MATH 193A,A04,083782,Staff,0,7,30,30
1650621609839,MATH 197,001,091859,McAuley; Julian John,9998,0,9999,1
1650621615890,COGS 9,A01,083615,Staff,0,15,60,60
1650621621917,COGS 11,A01,083617,Boyle; Mary E. T.,18,0,40,22
1650621627940,COGS 13,A01,083071,Staff,0,38,40,40
1650621633964,COGS 14A,A01,092681,Staff,0,31,100,100
1650621639988,COGS 14B,A01,083073,Cheng; Tzu-Han,0,13,50,50
1650621646014,COGS 17,A01,092677,Staff,17,0,75,58
1650621652038,COGS 100,A01,083619,Staff,0,26,60,60
1650621658066,COGS 101A,A01,083621,Davis; Joshua Daniel,0,26,60,60
1650621664099,COGS 101B,A01,091572,Staff,0,4,60,60
1650621670122,COGS 101C,A01,083625,Delgado; Tania,15,0,30,15
1650621676156,COGS 107A,A01,083627,Boyle; Mary E. T.,1,15,60,59
1650621682179,COGS 118A,A01,083075,Staff,0,6,60,60
1650621688202,CSE 3,A50,083646,Miranda; Gregory Joseph,19,0,38,19
1650621688202,CSE 3,A51,083647,Miranda; Gregory Joseph,36,0,37,1
1650621694227,CSE 8A,A50,083650,Miranda; Gregory Joseph,0,30,40,40
1650621700251,CSE 11,A01,083080,Cao; Yingjun,0,95,40,40
1650621706277,CSE 12,A01,083652,Staff,0,19,100,100
1650621712301,CSE 15L,A01,083654,Staff,0,2,50,50
1650621712301,CSE 15L,A02,083655,Staff,0,1,50,50
1650621718401,CSE 20,A01,083657,Staff,51,0,80,29
1650621724425,CSE 30,A01,083084,Eldon; John,0,77,40,40
1650621730452,CSE 100,A01,083659,Cao; Yingjun,0,68,50,50
1650621736476,CSE 134B,A01,083661,Powell; Thomas Allan,0,35,65,65
1650621742501,CSE 140,A01,083663,Staff,0,8,75,75
1650621748528,CSE 140L,A01,083088,Eldon; John,0,16,75,75
1650621754553,CSE 175,A01,083665,Kumar; Rakesh,7,0,25,18
1650621760580,CSE 190,A00,092507,Dubnov; Shlomo,10,0,20,10
1650621766604,ECE 45,A01,083139,Staff,0,1,60,60
1650621772628,ECE 65,A50,083695,Staff,0,5,30,30
1650621778652,ECE 109,A01,091882,Touri; Behrouz,33,0,70,37
1650621784678,ECE 180,A00,083140,Abi Samra; Nicholas Camill,21,0,30,9
1650621784678,ECE 180,B00,083141,Abi Samra; Nicholas Camill,0,0,30,30
1650621790705,MATH 10A,A01,083735,Patchell; Gregory David,4,0,30,26
1650621790705,MATH 10A,A02,083736,Patchell; Gregory David,27,0,30,3
1650621790705,MATH 10A,A03,083737,Patchell; Gregory David,24,0,30,6
1650621796729,MATH 10B,A01,083207,Staff,0,8,30,30
1650621796729,MATH 10B,A02,083208,Staff,0,8,30,30
1650621796729,MATH 10B,B01,083739,Staff,11,0,30,19
1650621796729,MATH 10B,B02,083740,Staff,28,0,30,2
1650621802760,MATH 18,A01,083743,Staff,0,0,30,30
1650621802760,MATH 18,A02,083744,Staff,23,0,30,7
1650621802760,MATH 18,A03,083745,Staff,21,0,30,9
1650621802760,MATH 18,A04,083746,Staff,26,0,30,4
1650621802760,MATH 18,B01,083748,Staff,0,15,30,30
1650621802760,MATH 18,B02,083749,Staff,0,11,30,30
1650621802760,MATH 18,B03,083750,Staff,0,12,30,30
1650621802760,MATH 18,B04,083751,Staff,0,12,30,30
1650621808783,MATH 20A,A01,083754,Staff,19,0,40,21
1650621814818,MATH 20B,A01,083756,Staff,0,12,30,30
1650621814818,MATH 20B,A02,083757,Staff,0,12,30,30
1650621820841,MATH 20C,A01,083760,Staff,0,15,30,30
1650621820841,MATH 20C,A02,083761,Staff,1,13,30,29
1650621820841,MATH 20C,B01,083762,Staff,11,0,30,19
1650621820841,MATH 20C,B02,083763,Staff,28,0,30,2
1650621826865,MATH 20D,A01,083765,Staff,1,1,30,29
1650621826865,MATH 20D,A02,083766,Staff,7,0,30,23
1650621826865,MATH 20D,A03,083767,Staff,24,0,30,6
1650621832892,MATH 20E,A01,083771,Staff,3,0,30,27
1650621832892,MATH 20E,A02,083772,Staff,17,0,30,13
1650621832892,MATH 20E,B01,083773,Staff,0,0,30,30
1650621832892,MATH 20E,B02,083774,Staff,9,0,30,21
1650621838916,MATH 103A,A01,083777,Staff,0,15,30,30
1650621838916,MATH 103A,A02,083778,Staff,0,15,30,30
1650621838916,MATH 103A,B01,083779,Staff,0,14,30,30
1650621838916,MATH 103A,B02,083780,Staff,0,14,30,30
1650621844942,MATH 105,A01,085443,Staff,0,21,30,30
1650621850977,MATH 109,A01,083213,Anzaldo; Leesa B,0,6,30,30
1650621850977,MATH 109,A02,083214,Anzaldo; Leesa B,0,7,30,30
1650621850977,MATH 109,B01,083215,Anzaldo; Leesa B,0,6,30,30
1650621850977,MATH 109,B02,083216,Anzaldo; Leesa B,0,6,30,30
1650621857005,MATH 142A,A01,083219,Chow; Bennett,0,16,30,30
1650621857005,MATH 142A,A02,083220,Chow; Bennett,0,15,30,30
1650621857005,MATH 142A,B01,083221,Chow; Bennett,0,14,30,30
1650621857005,MATH 142A,B02,083222,Chow; Bennett,0,13,30,30
1650621863027,MATH 193A,A01,083224,Staff,0,5,30,30
1650621863027,MATH 193A,A02,083225,Staff,0,6,30,30
1650621863027,MATH 193A,A03,083781,Staff,0,6,30,30
1650621863027,MATH 193A,A04,083782,Staff,0,7,30,30
1650621869061,MATH 197,001,091859,McAuley; Julian John,9998,0,9999,1
1650621875122,COGS 9,A01,083615,Staff,0,15,60,60
1650621881148,COGS 11,A01,083617,Boyle; Mary E. T.,18,0,40,22
1650621887173,COGS 13,A01,083071,Staff,0,38,40,40
1650621893204,COGS 14A,A01,092681,Staff,0,31,100,100
1650621899231,COGS 14B,A01,083073,Cheng; Tzu-Han,0,13,50,50
1650621905254,COGS 17,A01,092677,Staff,17,0,75,58
1650621911277,COGS 100,A01,083619,Staff,0,26,60,60
1650621917304,COGS 101A,A01,083621,Davis; Joshua Daniel,0,26,60,60
1650621923328,COGS 101B,A01,091572,Staff,0,4,60,60
1650621929351,COGS 101C,A01,083625,Delgado; Tania,15,0,30,15
1650621935375,COGS 107A,A01,083627,Boyle; Mary E. T.,1,15,60,59
1650621941401,COGS 118A,A01,083075,Staff,0,6,60,60
1650621947423,CSE 3,A50,083646,Miranda; Gregory Joseph,19,0,38,19
1650621947423,CSE 3,A51,083647,Miranda; Gregory Joseph,36,0,37,1
1650621953448,CSE 8A,A50,083650,Miranda; Gregory Joseph,0,30,40,40
1650621959472,CSE 11,A01,083080,Cao; Yingjun,0,95,40,40
1650621965500,CSE 12,A01,083652,Staff,0,19,100,100
1650621971523,CSE 15L,A01,083654,Staff,0,2,50,50
1650621971523,CSE 15L,A02,083655,Staff,0,1,50,50
1650621977550,CSE 20,A01,083657,Staff,51,0,80,29
1650621983577,CSE 30,A01,083084,Eldon; John,0,77,40,40
1650621989611,CSE 100,A01,083659,Cao; Yingjun,0,68,50,50
1650621995645,CSE 134B,A01,083661,Powell; Thomas Allan,0,35,65,65
1650622001669,CSE 140,A01,083663,Staff,0,8,75,75
1650622007693,CSE 140L,A01,083088,Eldon; John,0,16,75,75
1650622013718,CSE 175,A01,083665,Kumar; Rakesh,7,0,25,18
1650622019743,CSE 190,A00,092507,Dubnov; Shlomo,10,0,20,10
1650622025782,ECE 45,A01,083139,Staff,0,1,60,60
1650622031808,ECE 65,A50,083695,Staff,0,5,30,30
1650622037832,ECE 109,A01,091882,Touri; Behrouz,33,0,70,37
1650622043859,ECE 180,A00,083140,Abi Samra; Nicholas Camill,21,0,30,9
1650622043859,ECE 180,B00,083141,Abi Samra; Nicholas Camill,0,0,30,30
1650622049887,MATH 10A,A01,083735,Patchell; Gregory David,4,0,30,26
1650622049887,MATH 10A,A02,083736,Patchell; Gregory David,27,0,30,3
1650622049887,MATH 10A,A03,083737,Patchell; Gregory David,24,0,30,6
1650622055915,MATH 10B,A01,083207,Staff,0,8,30,30
1650622055915,MATH 10B,A02,083208,Staff,0,8,30,30
1650622055915,MATH 10B,B01,083739,Staff,11,0,30,19
1650622055915,MATH 10B,B02,083740,Staff,28,0,30,2
1650622061938,MATH 18,A01,083743,Staff,0,0,30,30
1650622061938,MATH 18,A02,083744,Staff,23,0,30,7
1650622061938,MATH 18,A03,083745,Staff,21,0,30,9
1650622061938,MATH 18,A04,083746,Staff,26,0,30,4
1650622061938,MATH 18,B01,083748,Staff,0,15,30,30
1650622061938,MATH 18,B02,083749,Staff,0,11,30,30
1650622061938,MATH 18,B03,083750,Staff,0,12,30,30
1650622061938,MATH 18,B04,083751,Staff,0,12,30,30
1650622067961,MATH 20A,A01,083754,Staff,19,0,40,21
1650622073984,MATH 20B,A01,083756,Staff,0,12,30,30
1650622073984,MATH 20B,A02,083757,Staff,0,12,30,30
1650622080012,MATH 20C,A01,083760,Staff,0,15,30,30
1650622080012,MATH 20C,A02,083761,Staff,1,13,30,29
1650622080012,MATH 20C,B01,083762,Staff,11,0,30,19
1650622080012,MATH 20C,B02,083763,Staff,28,0,30,2
1650622086038,MATH 20D,A01,083765,Staff,1,1,30,29
1650622086038,MATH 20D,A02,083766,Staff,7,0,30,23
1650622086038,MATH 20D,A03,083767,Staff,24,0,30,6
1650622092062,MATH 20E,A01,083771,Staff,3,0,30,27
1650622092062,MATH 20E,A02,083772,Staff,17,0,30,13
1650622092062,MATH 20E,B01,083773,Staff,0,0,30,30
1650622092062,MATH 20E,B02,083774,Staff,9,0,30,21
1650622098085,MATH 103A,A01,083777,Staff,0,15,30,30
1650622098085,MATH 103A,A02,083778,Staff,0,15,30,30
1650622098085,MATH 103A,B01,083779,Staff,0,14,30,30
1650622098085,MATH 103A,B02,083780,Staff,0,14,30,30
1650622104118,MATH 105,A01,085443,Staff,0,21,30,30
1650622110146,MATH 109,A01,083213,Anzaldo; Leesa B,0,6,30,30
1650622110146,MATH 109,A02,083214,Anzaldo; Leesa B,0,7,30,30
1650622110146,MATH 109,B01,083215,Anzaldo; Leesa B,0,6,30,30
1650622110146,MATH 109,B02,083216,Anzaldo; Leesa B,0,6,30,30
1650622116172,MATH 142A,A01,083219,Chow; Bennett,0,16,30,30
1650622116172,MATH 142A,A02,083220,Chow; Bennett,0,15,30,30
1650622116172,MATH 142A,B01,083221,Chow; Bennett,0,14,30,30
1650622116172,MATH 142A,B02,083222,Chow; Bennett,0,13,30,30
1650622122200,MATH 193A,A01,083224,Staff,0,5,30,30
1650622122200,MATH 193A,A02,083225,Staff,0,6,30,30
1650622122200,MATH 193A,A03,083781,Staff,0,6,30,30
1650622122200,MATH 193A,A04,083782,Staff,0,7,30,30
1650622128223,MATH 197,001,091859,McAuley; Julian John,9998,0,9999,1
1650622134274,COGS 9,A01,083615,Staff,0,15,60,60
1650622140305,COGS 11,A01,083617,Boyle; Mary E. T.,18,0,40,22
1650622146331,COGS 13,A01,083071,Staff,0,38,40,40
1650622152357,COGS 14A,A01,092681,Staff,0,31,100,100
1650622158384,COGS 14B,A01,083073,Cheng; Tzu-Han,0,13,50,50
1650622164411,COGS 17,A01,092677,Staff,17,0,75,58
1650622170435,COGS 100,A01,083619,Staff,0,26,60,60
1650622176461,COGS 101A,A01,083621,Davis; Joshua Daniel,0,26,60,60
1650622182483,COGS 101B,A01,091572,Staff,0,4,60,60
1650622188508,COGS 101C,A01,083625,Delgado; Tania,15,0,30,15
1650622194534,COGS 107A,A01,083627,Boyle; Mary E. T.,1,15,60,59
1650622200558,COGS 118A,A01,083075,Staff,0,6,60,60
1650622206583,CSE 3,A50,083646,Miranda; Gregory Joseph,19,0,38,19
1650622206583,CSE 3,A51,083647,Miranda; Gregory Joseph,36,0,37,1
1650622212606,CSE 8A,A50,083650,Miranda; Gregory Joseph,0,30,40,40
1650622218632,CSE 11,A01,083080,Cao; Yingjun,0,95,40,40
1650622224654,CSE 12,A01,083652,Staff,0,19,100,100
1650622230680,CSE 15L,A01,083654,Staff,0,2,50,50
1650622230680,CSE 15L,A02,083655,Staff,0,1,50,50
1650622236704,CSE 20,A01,083657,Staff,51,0,80,29
1650622242726,CSE 30,A01,083084,Eldon; John,0,77,40,40
1650622248749,CSE 100,A01,083659,Cao; Yingjun,0,68,50,50
1650622254772,CSE 134B,A01,083661,Powell; Thomas Allan,0,35,65,65
1650622260796,CSE 140,A01,083663,Staff,0,8,75,75
1650622266823,CSE 140L,A01,083088,Eldon; John,0,16,75,75
1650622272847,CSE 175,A01,083665,Kumar; Rakesh,7,0,25,18
1650622278870,CSE 190,A00,092507,Dubnov; Shlomo,10,0,20,10
1650622284897,ECE 45,A01,083139,Staff,0,1,60,60
1650622290922,ECE 65,A50,083695,Staff,0,5,30,30
1650622296945,ECE 109,A01,091882,Touri; Behrouz,33,0,70,37
1650622302979,ECE 180,A00,083140,Abi Samra; Nicholas Camill,21,0,30,9
1650622302979,ECE 180,B00,083141,Abi Samra; Nicholas Camill,0,0,30,30
1650622309002,MATH 10A,A01,083735,Patchell; Gregory David,4,0,30,26
1650622309002,MATH 10A,A02,083736,Patchell; Gregory David,27,0,30,3
1650622309002,MATH 10A,A03,083737,Patchell; Gregory David,24,0,30,6
1650622315100,MATH 10B,A01,083207,Staff,0,8,30,30
1650622315100,MATH 10B,A02,083208,Staff,0,8,30,30
1650622315100,MATH 10B,B01,083739,Staff,11,0,30,19
1650622315100,MATH 10B,B02,083740,Staff,28,0,30,2
1650622321130,MATH 18,A01,083743,Staff,0,0,30,30
1650622321130,MATH 18,A02,083744,Staff,23,0,30,7
1650622321130,MATH 18,A03,083745,Staff,21,0,30,9
1650622321130,MATH 18,A04,083746,Staff,26,0,30,4
1650622321130,MATH 18,B01,083748,Staff,0,15,30,30
1650622321130,MATH 18,B02,083749,Staff,0,11,30,30
1650622321130,MATH 18,B03,083750,Staff,0,12,30,30
1650622321130,MATH 18,B04,083751,Staff,0,12,30,30
1650622327156,MATH 20A,A01,083754,Staff,19,0,40,21
1650622333182,MATH 20B,A01,083756,Staff,0,12,30,30
1650622333182,MATH 20B,A02,083757,Staff,0,12,30,30
1650622339216,MATH 20C,A01,083760,Staff,0,15,30,30
1650622339216,MATH 20C,A02,083761,Staff,1,13,30,29
1650622339216,MATH 20C,B01,083762,Staff,11,0,30,19
1650622339216,MATH 20C,B02,083763,Staff,28,0,30,2
1650622345244,MATH 20D,A01,083765,Staff,1,1,30,29
1650622345244,MATH 20D,A02,083766,Staff,7,0,30,23
1650622345244,MATH 20D,A03,083767,Staff,24,0,30,6
1650622351272,MATH 20E,A01,083771,Staff,3,0,30,27
1650622351272,MATH 20E,A02,083772,Staff,17,0,30,13
1650622351272,MATH 20E,B01,083773,Staff,0,0,30,30
1650622351272,MATH 20E,B02,083774,Staff,9,0,30,21
1650622357295,MATH 103A,A01,083777,Staff,0,15,30,30
1650622357295,MATH 103A,A02,083778,Staff,0,15,30,30
1650622357295,MATH 103A,B01,083779,Staff,0,14,30,30
1650622357295,MATH 103A,B02,083780,Staff,0,14,30,30
1650622363320,MATH 105,A01,085443,Staff,0,21,30,30
1650622369344,MATH 109,A01,083213,Anzaldo; Leesa B,0,6,30,30
1650622369344,MATH 109,A02,083214,Anzaldo; Leesa B,0,7,30,30
1650622369344,MATH 109,B01,083215,Anzaldo; Leesa B,0,6,30,30
1650622369344,MATH 109,B02,083216,Anzaldo; Leesa B,0,6,30,30
1650622375367,MATH 142A,A01,083219,Chow; Bennett,0,16,30,30
1650622375367,MATH 142A,A02,083220,Chow; Bennett,0,15,30,30
1650622375367,MATH 142A,B01,083221,Chow; Bennett,0,14,30,30
1650622375367,MATH 142A,B02,083222,Chow; Bennett,0,13,30,30
1650622381394,MATH 193A,A01,083224,Staff,0,5,30,30
1650622381394,MATH 193A,A02,083225,Staff,0,6,30,30
1650622381394,MATH 193A,A03,083781,Staff,0,6,30,30
1650622381394,MATH 193A,A04,083782,Staff,0,7,30,30
1650622387421,MATH 197,001,091859,McAuley; Julian John,9998,0,9999,1
1650622393481,COGS 9,A01,083615,Staff,0,15,60,60
1650622399508,COGS 11,A01,083617,Boyle; Mary E. T.,18,0,40,22
1650622405535,COGS 13,A01,083071,Staff,0,38,40,40
1650622411558,COGS 14A,A01,092681,Staff,0,31,100,100
1650622417579,COGS 14B,A01,083073,Cheng; Tzu-Han,0,13,50,50
1650622423603,COGS 17,A01,092677,Staff,17,0,75,58
1650622429627,COGS 100,A01,083619,Staff,0,26,60,60
1650622435652,COGS 101A,A01,083621,Davis; Joshua Daniel,0,26,60,60
1650622441675,COGS 101B,A01,091572,Staff,0,4,60,60
1650622447703,COGS 101C,A01,083625,Delgado; Tania,15,0,30,15
1650622453727,COGS 107A,A01,083627,Boyle; Mary E. T.,1,15,60,59
1650622459754,COGS 118A,A01,083075,Staff,0,6,60,60
1650622465783,CSE 3,A50,083646,Miranda; Gregory Joseph,19,0,38,19
1650622465783,CSE 3,A51,083647,Miranda; Gregory Joseph,36,0,37,1
1650622471821,CSE 8A,A50,083650,Miranda; Gregory Joseph,0,30,40,40
1650622477847,CSE 11,A01,083080,Cao; Yingjun,0,95,40,40
1650622483872,CSE 12,A01,083652,Staff,0,19,100,100
1650622489896,CSE 15L,A01,083654,Staff,0,2,50,50
1650622489896,CSE 15L,A02,083655,Staff,0,1,50,50
1650622495922,CSE 20,A01,083657,Staff,51,0,80,29
1650622501948,CSE 30,A01,083084,Eldon; John,0,77,40,40
1650622507974,CSE 100,A01,083659,Cao; Yingjun,0,68,50,50
1650622513998,CSE 134B,A01,083661,Powell; Thomas Allan,0,35,65,65
1650622520020,CSE 140,A01,083663,Staff,0,8,75,75
1650622526048,CSE 140L,A01,083088,Eldon; John,0,16,75,75
1650622532074,CSE 175,A01,083665,Kumar; Rakesh,7,0,25,18
1650622538099,CSE 190,A00,092507,Dubnov; Shlomo,10,0,20,10
1650622544123,ECE 45,A01,083139,Staff,0,1,60,60
1650622550145,ECE 65,A50,083695,Staff,0,5,30,30
1650622556167,ECE 109,A01,091882,Touri; Behrouz,33,0,70,37
1650622562192,ECE 180,A00,083140,Abi Samra; Nicholas Camill,21,0,30,9
1650622562192,ECE 180,B00,083141,Abi Samra; Nicholas Camill,0,0,30,30
1650622568214,MATH 10A,A01,083735,Patchell; Gregory David,4,0,30,26
1650622568214,MATH 10A,A02,083736,Patchell; Gregory David,27,0,30,3
1650622568214,MATH 10A,A03,083737,Patchell; Gregory David,24,0,30,6
1650622574239,MATH 10B,A01,083207,Staff,0,8,30,30
1650622574239,MATH 10B,A02,083208,Staff,0,8,30,30
1650622574239,MATH 10B,B01,083739,Staff,11,0,30,19
1650622574239,MATH 10B,B02,083740,Staff,28,0,30,2
1650622580271,MATH 18,A01,083743,Staff,0,0,30,30
1650622580271,MATH 18,A02,083744,Staff,23,0,30,7
1650622580271,MATH 18,A03,083745,Staff,21,0,30,9
1650622580271,MATH 18,A04,083746,Staff,26,0,30,4
1650622580271,MATH 18,B01,083748,Staff,0,15,30,30
1650622580271,MATH 18,B02,083749,Staff,0,11,30,30
1650622580271,MATH 18,B03,083750,Staff,0,12,30,30
1650622580271,MATH 18,B04,083751,Staff,0,12,30,30
1650622586295,MATH 20A,A01,083754,Staff,19,0,40,21
1650622592319,MATH 20B,A01,083756,Staff,0,12,30,30
1650622592319,MATH 20B,A02,083757,Staff,0,12,30,30
1650622598342,MATH 20C,A01,083760,Staff,0,15,30,30
1650622598342,MATH 20C,A02,083761,Staff,1,13,30,29
1650622598342,MATH 20C,B01,083762,Staff,11,0,30,19
1650622598342,MATH 20C,B02,083763,Staff,28,0,30,2
1650622604365,MATH 20D,A01,083765,Staff,1,1,30,29
1650622604365,MATH 20D,A02,083766,Staff,7,0,30,23
1650622604365,MATH 20D,A03,083767,Staff,24,0,30,6
1650622610393,MATH 20E,A01,083771,Staff,3,0,30,27
1650622610393,MATH 20E,A02,083772,Staff,17,0,30,13
1650622610393,MATH 20E,B01,083773,Staff,0,0,30,30
1650622610393,MATH 20E,B02,083774,Staff,9,0,30,21
1650622616421,MATH 103A,A01,083777,Staff,0,15,30,30
1650622616421,MATH 103A,A02,083778,Staff,0,15,30,30
1650622616421,MATH 103A,B01,083779,Staff,0,14,30,30
1650622616421,MATH 103A,B02,083780,Staff,0,14,30,30
1650622622443,MATH 105,A01,085443,Staff,0,21,30,30
1650622628469,MATH 109,A01,083213,Anzaldo; Leesa B,0,6,30,30
1650622628469,MATH 109,A02,083214,Anzaldo; Leesa B,0,7,30,30
1650622628469,MATH 109,B01,083215,Anzaldo; Leesa B,0,6,30,30
1650622628469,MATH 109,B02,083216,Anzaldo; Leesa B,0,6,30,30
1650622634493,MATH 142A,A01,083219,Chow; Bennett,0,16,30,30
1650622634493,MATH 142A,A02,083220,Chow; Bennett,0,15,30,30
1650622634493,MATH 142A,B01,083221,Chow; Bennett,0,14,30,30
1650622634493,MATH 142A,B02,083222,Chow; Bennett,0,13,30,30
1650622640518,MATH 193A,A01,083224,Staff,0,5,30,30
1650622640518,MATH 193A,A02,083225,Staff,0,6,30,30
1650622640518,MATH 193A,A03,083781,Staff,0,6,30,30
1650622640518,MATH 193A,A04,083782,Staff,0,7,30,30
1650622646543,MATH 197,001,091859,McAuley; Julian John,9998,0,9999,1
1650622652602,COGS 9,A01,083615,Staff,0,15,60,60
1650622658625,COGS 11,A01,083617,Boyle; Mary E. T.,18,0,40,22
1650622664651,COGS 13,A01,083071,Staff,0,38,40,40
1650622670676,COGS 14A,A01,092681,Staff,0,31,100,100
1650622676699,COGS 14B,A01,083073,Cheng; Tzu-Han,0,13,50,50
1650622682731,COGS 17,A01,092677,Staff,17,0,75,58
1650622688754,COGS 100,A01,083619,Staff,0,26,60,60
1650622694778,COGS 101A,A01,083621,Davis; Joshua Daniel,0,26,60,60
1650622700799,COGS 101B,A01,091572,Staff,0,4,60,60
1650622706826,COGS 101C,A01,083625,Delgado; Tania,15,0,30,15
1650622712851,COGS 107A,A01,083627,Boyle; Mary E. T.,1,15,60,59
1650622718878,COGS 118A,A01,083075,Staff,0,6,60,60
1650622724900,CSE 3,A50,083646,Miranda; Gregory Joseph,19,0,38,19
1650622724900,CSE 3,A51,083647,Miranda; Gregory Joseph,36,0,37,1
1650622730924,CSE 8A,A50,083650,Miranda; Gregory Joseph,0,30,40,40
1650622736950,CSE 11,A01,083080,Cao; Yingjun,0,95,40,40
1650622742978,CSE 12,A01,083652,Staff,0,19,100,100
1650622749003,CSE 15L,A01,083654,Staff,0,2,50,50
1650622749003,CSE 15L,A02,083655,Staff,0,1,50,50
1650622755028,CSE 20,A01,083657,Staff,51,0,80,29
1650622761050,CSE 30,A01,083084,Eldon; John,0,77,40,40
1650622767073,CSE 100,A01,083659,Cao; Yingjun,0,68,50,50
1650622773099,CSE 134B,A01,083661,Powell; Thomas Allan,0,35,65,65
1650622779125,CSE 140,A01,083663,Staff,0,8,75,75
1650622785147,CSE 140L,A01,083088,Eldon; John,0,16,75,75
1650622791174,CSE 175,A01,083665,Kumar; Rakesh,7,0,25,18
1650622797202,CSE 190,A00,092507,Dubnov; Shlomo,10,0,20,10
1650622803226,ECE 45,A01,083139,Staff,0,1,60,60
1650622809252,ECE 65,A50,083695,Staff,0,5,30,30
1650622815278,ECE 109,A01,091882,Touri; Behrouz,33,0,70,37
1650622821307,ECE 180,A00,083140,Abi Samra; Nicholas Camill,21,0,30,9
1650622821307,ECE 180,B00,083141,Abi Samra; Nicholas Camill,0,0,30,30
1650622827332,MATH 10A,A01,083735,Patchell; Gregory David,4,0,30,26
1650622827332,MATH 10A,A02,083736,Patchell; Gregory David,27,0,30,3
1650622827332,MATH 10A,A03,083737,Patchell; Gregory David,24,0,30,6
1650622833354,MATH 10B,A01,083207,Staff,0,8,30,30
1650622833354,MATH 10B,A02,083208,Staff,0,8,30,30
1650622833354,MATH 10B,B01,083739,Staff,11,0,30,19
1650622833354,MATH 10B,B02,083740,Staff,28,0,30,2
1650622839386,MATH 18,A01,083743,Staff,0,0,30,30
1650622839386,MATH 18,A02,083744,Staff,23,0,30,7
1650622839386,MATH 18,A03,083745,Staff,21,0,30,9
1650622839386,MATH 18,A04,083746,Staff,26,0,30,4
1650622839386,MATH 18,B01,083748,Staff,0,15,30,30
1650622839386,MATH 18,B02,083749,Staff,0,11,30,30
1650622839386,MATH 18,B03,083750,Staff,0,12,30,30
1650622839386,MATH 18,B04,083751,Staff,0,12,30,30
1650622845411,MATH 20A,A01,083754,Staff,19,0,40,21
1650622851438,MATH 20B,A01,083756,Staff,0,12,30,30
1650622851438,MATH 20B,A02,083757,Staff,0,12,30,30
1650622857459,MATH 20C,A01,083760,Staff,0,15,30,30
1650622857459,MATH 20C,A02,083761,Staff,1,13,30,29
1650622857459,MATH 20C,B01,083762,Staff,11,0,30,19
1650622857459,MATH 20C,B02,083763,Staff,28,0,30,2
1650622863482,MATH 20D,A01,083765,Staff,1,1,30,29
1650622863482,MATH 20D,A02,083766,Staff,7,0,30,23
1650622863482,MATH 20D,A03,083767,Staff,24,0,30,6
1650622869509,MATH 20E,A01,083771,Staff,3,0,30,27
1650622869509,MATH 20E,A02,083772,Staff,17,0,30,13
1650622869509,MATH 20E,B01,083773,Staff,0,0,30,30
1650622869509,MATH 20E,B02,083774,Staff,9,0,30,21
1650622875534,MATH 103A,A01,083777,Staff,0,15,30,30
1650622875534,MATH 103A,A02,083778,Staff,0,15,30,30
1650622875534,MATH 103A,B01,083779,Staff,0,14,30,30
1650622875534,MATH 103A,B02,083780,Staff,0,14,30,30
1650622881556,MATH 105,A01,085443,Staff,0,21,30,30
1650622887580,MATH 109,A01,083213,Anzaldo; Leesa B,0,6,30,30
1650622887580,MATH 109,A02,083214,Anzaldo; Leesa B,0,7,30,30
1650622887580,MATH 109,B01,083215,Anzaldo; Leesa B,0,6,30,30
1650622887580,MATH 109,B02,083216,Anzaldo; Leesa B,0,6,30,30
1650622893609,MATH 142A,A01,083219,Chow; Bennett,0,16,30,30
1650622893609,MATH 142A,A02,083220,Chow; Bennett,0,15,30,30
1650622893609,MATH 142A,B01,083221,Chow; Bennett,0,14,30,30
1650622893609,MATH 142A,B02,083222,Chow; Bennett,0,13,30,30
1650622899635,MATH 193A,A01,083224,Staff,0,5,30,30
1650622899635,MATH 193A,A02,083225,Staff,0,6,30,30
1650622899635,MATH 193A,A03,083781,Staff,0,6,30,30
1650622899635,MATH 193A,A04,083782,Staff,0,7,30,30
1650622905659,MATH 197,001,091859,McAuley; Julian John,9998,0,9999,1
1650622911798,COGS 9,A01,083615,Staff,0,15,60,60
1650622917826,COGS 11,A01,083617,Boyle; Mary E. T.,18,0,40,22
1650622923851,COGS 13,A01,083071,Staff,0,38,40,40
1650622929884,COGS 14A,A01,092681,Staff,0,31,100,100
1650622935911,COGS 14B,A01,083073,Cheng; Tzu-Han,0,13,50,50
1650622941940,COGS 17,A01,092677,Staff,17,0,75,58
1650622947969,COGS 100,A01,083619,Staff,0,26,60,60
1650622953999,COGS 101A,A01,083621,Davis; Joshua Daniel,0,26,60,60
1650622960025,COGS 101B,A01,091572,Staff,0,4,60,60
1650622966056,COGS 101C,A01,083625,Delgado; Tania,15,0,30,15
1650622972081,COGS 107A,A01,083627,Boyle; Mary E. T.,1,15,60,59
1650622978106,COGS 118A,A01,083075,Staff,0,6,60,60
1650622984141,CSE 3,A50,083646,Miranda; Gregory Joseph,19,0,38,19
1650622984141,CSE 3,A51,083647,Miranda; Gregory Joseph,36,0,37,1
1650622990164,CSE 8A,A50,083650,Miranda; Gregory Joseph,0,30,40,40
1650622996187,CSE 11,A01,083080,Cao; Yingjun,0,95,40,40
1650623002210,CSE 12,A01,083652,Staff,0,19,100,100
1650623008236,CSE 15L,A01,083654,Staff,0,2,50,50
1650623008236,CSE 15L,A02,083655,Staff,0,1,50,50
1650623014264,CSE 20,A01,083657,Staff,51,0,80,29
1650623020289,CSE 30,A01,083084,Eldon; John,0,77,40,40
1650623026313,CSE 100,A01,083659,Cao; Yingjun,0,68,50,50
1650623032343,CSE 134B,A01,083661,Powell; Thomas Allan,0,35,65,65
1650623038372,CSE 140,A01,083663,Staff,0,8,75,75
1650623044401,CSE 140L,A01,083088,Eldon; John,0,16,75,75
1650623050428,CSE 175,A01,083665,Kumar; Rakesh,7,0,25,18
1650623056453,CSE 190,A00,092507,Dubnov; Shlomo,10,0,20,10
1650623062487,ECE 45,A01,083139,Staff,0,1,60,60
1650623068517,ECE 65,A50,083695,Staff,0,5,30,30
1650623074544,ECE 109,A01,091882,Touri; Behrouz,33,0,70,37
1650623080576,ECE 180,A00,083140,Abi Samra; Nicholas Camill,21,0,30,9
1650623080576,ECE 180,B00,083141,Abi Samra; Nicholas Camill,0,0,30,30
1650623086603,MATH 10A,A01,083735,Patchell; Gregory David,4,0,30,26
1650623086603,MATH 10A,A02,083736,Patchell; Gregory David,27,0,30,3
1650623086603,MATH 10A,A03,083737,Patchell; Gregory David,24,0,30,6
1650623092628,MATH 10B,A01,083207,Staff,0,8,30,30
1650623092628,MATH 10B,A02,083208,Staff,0,8,30,30
1650623092628,MATH 10B,B01,083739,Staff,11,0,30,19
1650623092628,MATH 10B,B02,083740,Staff,28,0,30,2
1650623098658,MATH 18,A01,083743,Staff,0,0,30,30
1650623098658,MATH 18,A02,083744,Staff,23,0,30,7
1650623098658,MATH 18,A03,083745,Staff,21,0,30,9
1650623098658,MATH 18,A04,083746,Staff,26,0,30,4
1650623098658,MATH 18,B01,083748,Staff,0,15,30,30
1650623098658,MATH 18,B02,083749,Staff,0,11,30,30
1650623098658,MATH 18,B03,083750,Staff,0,12,30,30
1650623098658,MATH 18,B04,083751,Staff,0,12,30,30
1650623104688,MATH 20A,A01,083754,Staff,19,0,40,21
1650623110715,MATH 20B,A01,083756,Staff,0,12,30,30
1650623110715,MATH 20B,A02,083757,Staff,0,12,30,30
1650623116746,MATH 20C,A01,083760,Staff,0,15,30,30
1650623116746,MATH 20C,A02,083761,Staff,1,13,30,29
1650623116746,MATH 20C,B01,083762,Staff,11,0,30,19
1650623116746,MATH 20C,B02,083763,Staff,28,0,30,2
1650623122783,MATH 20D,A01,083765,Staff,1,1,30,29
1650623122783,MATH 20D,A02,083766,Staff,7,0,30,23
1650623122783,MATH 20D,A03,083767,Staff,24,0,30,6
1650623128820,MATH 20E,A01,083771,Staff,3,0,30,27
1650623128820,MATH 20E,A02,083772,Staff,17,0,30,13
1650623128820,MATH 20E,B01,083773,Staff,0,0,30,30
1650623128820,MATH 20E,B02,083774,Staff,9,0,30,21
1650623134846,MATH 103A,A01,083777,Staff,0,15,30,30
1650623134846,MATH 103A,A02,083778,Staff,0,15,30,30
1650623134846,MATH 103A,B01,083779,Staff,0,14,30,30
1650623134846,MATH 103A,B02,083780,Staff,0,14,30,30
1650623140871,MATH 105,A01,085443,Staff,0,21,30,30
1650623146896,MATH 109,A01,083213,Anzaldo; Leesa B,0,6,30,30
1650623146896,MATH 109,A02,083214,Anzaldo; Leesa B,0,7,30,30
1650623146896,MATH 109,B01,083215,Anzaldo; Leesa B,0,6,30,30
1650623146896,MATH 109,B02,083216,Anzaldo; Leesa B,0,6,30,30
1650623152926,MATH 142A,A01,083219,Chow; Bennett,0,16,30,30
1650623152926,MATH 142A,A02,083220,Chow; Bennett,0,15,30,30
1650623152926,MATH 142A,B01,083221,Chow; Bennett,0,14,30,30
1650623152926,MATH 142A,B02,083222,Chow; Bennett,0,13,30,30
1650623158961,MATH 193A,A01,083224,Staff,0,5,30,30
1650623158961,MATH 193A,A02,083225,Staff,0,6,30,30
1650623158961,MATH 193A,A03,083781,Staff,0,6,30,30
1650623158961,MATH 193A,A04,083782,Staff,0,7,30,30
1650623164985,MATH 197,001,091859,McAuley; Julian John,9998,0,9999,1
1650623171052,COGS 9,A01,083615,Staff,0,15,60,60
1650623177078,COGS 11,A01,083617,Boyle; Mary E. T.,18,0,40,22
1650623183102,COGS 13,A01,083071,Staff,0,38,40,40
1650623189133,COGS 14A,A01,092681,Staff,0,31,100,100
1650623195157,COGS 14B,A01,083073,Cheng; Tzu-Han,0,13,50,50
1650623201182,COGS 17,A01,092677,Staff,17,0,75,58
1650623207207,COGS 100,A01,083619,Staff,0,26,60,60
1650623213236,COGS 101A,A01,083621,Davis; Joshua Daniel,0,26,60,60
1650623219262,COGS 101B,A01,091572,Staff,0,4,60,60
1650623225291,COGS 101C,A01,083625,Delgado; Tania,15,0,30,15
1650623231315,COGS 107A,A01,083627,Boyle; Mary E. T.,1,15,60,59
1650623237339,COGS 118A,A01,083075,Staff,0,6,60,60
1650623243365,CSE 3,A50,083646,Miranda; Gregory Joseph,19,0,38,19
1650623243365,CSE 3,A51,083647,Miranda; Gregory Joseph,36,0,37,1
1650623249393,CSE 8A,A50,083650,Miranda; Gregory Joseph,0,30,40,40
1650623255417,CSE 11,A01,083080,Cao; Yingjun,0,95,40,40
1650623261441,CSE 12,A01,083652,Staff,0,19,100,100
1650623267466,CSE 15L,A01,083654,Staff,0,2,50,50
1650623267466,CSE 15L,A02,083655,Staff,0,1,50,50
1650623273491,CSE 20,A01,083657,Staff,51,0,80,29
1650623279519,CSE 30,A01,083084,Eldon; John,0,77,40,40
1650623285544,CSE 100,A01,083659,Cao; Yingjun,0,68,50,50
1650623291570,CSE 134B,A01,083661,Powell; Thomas Allan,0,35,65,65
1650623297595,CSE 140,A01,083663,Staff,0,8,75,75
1650623303631,CSE 140L,A01,083088,Eldon; John,0,16,75,75
1650623309663,CSE 175,A01,083665,Kumar; Rakesh,7,0,25,18
1650623315695,CSE 190,A00,092507,Dubnov; Shlomo,10,0,20,10
1650623321723,ECE 45,A01,083139,Staff,0,1,60,60
1650623327754,ECE 65,A50,083695,Staff,0,5,30,30
1650623333778,ECE 109,A01,091882,Touri; Behrouz,33,0,70,37
1650623339809,ECE 180,A00,083140,Abi Samra; Nicholas Camill,21,0,30,9
1650623339809,ECE 180,B00,083141,Abi Samra; Nicholas Camill,0,0,30,30
1650623345837,MATH 10A,A01,083735,Patchell; Gregory David,4,0,30,26
1650623345837,MATH 10A,A02,083736,Patchell; Gregory David,27,0,30,3
1650623345837,MATH 10A,A03,083737,Patchell; Gregory David,24,0,30,6
1650623351864,MATH 10B,A01,083207,Staff,0,8,30,30
1650623351864,MATH 10B,A02,083208,Staff,0,8,30,30
1650623351864,MATH 10B,B01,083739,Staff,11,0,30,19
1650623351864,MATH 10B,B02,083740,Staff,28,0,30,2
1650623357891,MATH 18,A01,083743,Staff,0,0,30,30
1650623357891,MATH 18,A02,083744,Staff,23,0,30,7
1650623357891,MATH 18,A03,083745,Staff,21,0,30,9
1650623357891,MATH 18,A04,083746,Staff,26,0,30,4
1650623357891,MATH 18,B01,083748,Staff,0,15,30,30
1650623357891,MATH 18,B02,083749,Staff,0,11,30,30
1650623357891,MATH 18,B03,083750,Staff,0,12,30,30
1650623357891,MATH 18,B04,083751,Staff,0,12,30,30
1650623363916,MATH 20A,A01,083754,Staff,19,0,40,21
1650623369940,MATH 20B,A01,083756,Staff,0,12,30,30
1650623369940,MATH 20B,A02,083757,Staff,0,12,30,30
1650623375970,MATH 20C,A01,083760,Staff,0,15,30,30
1650623375970,MATH 20C,A02,083761,Staff,1,13,30,29
1650623375970,MATH 20C,B01,083762,Staff,11,0,30,19
1650623375970,MATH 20C,B02,083763,Staff,28,0,30,2
1650623381994,MATH 20D,A01,083765,Staff,1,1,30,29
1650623381994,MATH 20D,A02,083766,Staff,7,0,30,23
1650623381994,MATH 20D,A03,083767,Staff,24,0,30,6
1650623388021,MATH 20E,A01,083771,Staff,3,0,30,27
1650623388021,MATH 20E,A02,083772,Staff,17,0,30,13
1650623388021,MATH 20E,B01,083773,Staff,0,0,30,30
1650623388021,MATH 20E,B02,083774,Staff,9,0,30,21
1650623394053,MATH 103A,A01,083777,Staff,0,15,30,30
1650623394053,MATH 103A,A02,083778,Staff,0,15,30,30
1650623394053,MATH 103A,B01,083779,Staff,0,14,30,30
1650623394053,MATH 103A,B02,083780,Staff,0,14,30,30
1650623400083,MATH 105,A01,085443,Staff,0,21,30,30
1650623406114,MATH 109,A01,083213,Anzaldo; Leesa B,0,6,30,30
1650623406114,MATH 109,A02,083214,Anzaldo; Leesa B,0,7,30,30
1650623406114,MATH 109,B01,083215,Anzaldo; Leesa B,0,6,30,30
1650623406114,MATH 109,B02,083216,Anzaldo; Leesa B,0,6,30,30
1650623412144,MATH 142A,A01,083219,Chow; Bennett,0,16,30,30
1650623412144,MATH 142A,A02,083220,Chow; Bennett,0,15,30,30
1650623412144,MATH 142A,B01,083221,Chow; Bennett,0,14,30,30
1650623412144,MATH 142A,B02,083222,Chow; Bennett,0,13,30,30
1650623418173,MATH 193A,A01,083224,Staff,0,5,30,30
1650623418173,MATH 193A,A02,083225,Staff,0,6,30,30
1650623418173,MATH 193A,A03,083781,Staff,0,6,30,30
1650623418173,MATH 193A,A04,083782,Staff,0,7,30,30
1650623424201,MATH 197,001,091859,McAuley; Julian John,9998,0,9999,1
1650623430265,COGS 9,A01,083615,Staff,0,15,60,60
1650623436289,COGS 11,A01,083617,Boyle; Mary E. T.,18,0,40,22
1650623442313,COGS 13,A01,083071,Staff,0,38,40,40
1650623448337,COGS 14A,A01,092681,Staff,0,31,100,100
1650623454365,COGS 14B,A01,083073,Cheng; Tzu-Han,0,13,50,50
1650623460393,COGS 17,A01,092677,Staff,17,0,75,58
1650623466418,COGS 100,A01,083619,Staff,0,26,60,60
1650623472443,COGS 101A,A01,083621,Davis; Joshua Daniel,0,26,60,60
1650623478467,COGS 101B,A01,091572,Staff,0,4,60,60
1650623484492,COGS 101C,A01,083625,Delgado; Tania,15,0,30,15
1650623490522,COGS 107A,A01,083627,Boyle; Mary E. T.,1,15,60,59
1650623496547,COGS 118A,A01,083075,Staff,0,6,60,60
1650623502653,CSE 3,A50,083646,Miranda; Gregory Joseph,19,0,38,19
1650623502653,CSE 3,A51,083647,Miranda; Gregory Joseph,36,0,37,1
1650623508683,CSE 8A,A50,083650,Miranda; Gregory Joseph,0,30,40,40
1650623514706,CSE 11,A01,083080,Cao; Yingjun,0,95,40,40
1650623520734,CSE 12,A01,083652,Staff,0,19,100,100
1650623526766,CSE 15L,A01,083654,Staff,0,2,50,50
1650623526766,CSE 15L,A02,083655,Staff,0,1,50,50
1650623532794,CSE 20,A01,083657,Staff,51,0,80,29
1650623538824,CSE 30,A01,083084,Eldon; John,0,77,40,40
1650623544851,CSE 100,A01,083659,Cao; Yingjun,0,68,50,50
1650623550879,CSE 134B,A01,083661,Powell; Thomas Allan,0,35,65,65
1650623556904,CSE 140,A01,083663,Staff,0,8,75,75
1650623562932,CSE 140L,A01,083088,Eldon; John,0,16,75,75
1650623568958,CSE 175,A01,083665,Kumar; Rakesh,7,0,25,18
1650623574983,CSE 190,A00,092507,Dubnov; Shlomo,10,0,20,10
1650623581008,ECE 45,A01,083139,Staff,0,1,60,60
1650623587039,ECE 65,A50,083695,Staff,0,5,30,30
1650623593068,ECE 109,A01,091882,Touri; Behrouz,33,0,70,37
1650623599093,ECE 180,A00,083140,Abi Samra; Nicholas Camill,21,0,30,9
1650623599093,ECE 180,B00,083141,Abi Samra; Nicholas Camill,0,0,30,30
1650623605143,MATH 10A,A01,083735,Patchell; Gregory David,4,0,30,26
1650623605143,MATH 10A,A02,083736,Patchell; Gregory David,27,0,30,3
1650623605143,MATH 10A,A03,083737,Patchell; Gregory David,24,0,30,6
1650623611168,MATH 10B,A01,083207,Staff,0,8,30,30
1650623611168,MATH 10B,A02,083208,Staff,0,8,30,30
1650623611168,MATH 10B,B01,083739,Staff,11,0,30,19
1650623611168,MATH 10B,B02,083740,Staff,28,0,30,2
1650623617203,MATH 18,A01,083743,Staff,0,0,30,30
1650623617203,MATH 18,A02,083744,Staff,23,0,30,7
1650623617203,MATH 18,A03,083745,Staff,21,0,30,9
1650623617203,MATH 18,A04,083746,Staff,26,0,30,4
1650623617203,MATH 18,B01,083748,Staff,0,15,30,30
1650623617203,MATH 18,B02,083749,Staff,0,11,30,30
1650623617203,MATH 18,B03,083750,Staff,0,12,30,30
1650623617203,MATH 18,B04,083751,Staff,0,12,30,30
1650623623228,MATH 20A,A01,083754,Staff,19,0,40,21
1650623629259,MATH 20B,A01,083756,Staff,0,12,30,30
1650623629259,MATH 20B,A02,083757,Staff,0,12,30,30
1650623635290,MATH 20C,A01,083760,Staff,0,15,30,30
1650623635290,MATH 20C,A02,083761,Staff,1,13,30,29
1650623635290,MATH 20C,B01,083762,Staff,11,0,30,19
1650623635290,MATH 20C,B02,083763,Staff,28,0,30,2
1650623641317,MATH 20D,A01,083765,Staff,1,1,30,29
1650623641317,MATH 20D,A02,083766,Staff,7,0,30,23
1650623641317,MATH 20D,A03,083767,Staff,24,0,30,6
1650623647343,MATH 20E,A01,083771,Staff,3,0,30,27
1650623647343,MATH 20E,A02,083772,Staff,17,0,30,13
1650623647343,MATH 20E,B01,083773,Staff,0,0,30,30
1650623647343,MATH 20E,B02,083774,Staff,9,0,30,21
1650623653370,MATH 103A,A01,083777,Staff,0,15,30,30
1650623653370,MATH 103A,A02,083778,Staff,0,15,30,30
1650623653370,MATH 103A,B01,083779,Staff,0,14,30,30
1650623653370,MATH 103A,B02,083780,Staff,0,14,30,30
1650623659405,MATH 105,A01,085443,Staff,0,21,30,30
1650623665431,MATH 109,A01,083213,Anzaldo; Leesa B,0,6,30,30
1650623665431,MATH 109,A02,083214,Anzaldo; Leesa B,0,7,30,30
1650623665431,MATH 109,B01,083215,Anzaldo; Leesa B,0,6,30,30
1650623665431,MATH 109,B02,083216,Anzaldo; Leesa B,0,6,30,30
1650623671455,MATH 142A,A01,083219,Chow; Bennett,0,16,30,30
1650623671455,MATH 142A,A02,083220,Chow; Bennett,0,15,30,30
1650623671455,MATH 142A,B01,083221,Chow; Bennett,0,14,30,30
1650623671455,MATH 142A,B02,083222,Chow; Bennett,0,13,30,30
1650623677482,MATH 193A,A01,083224,Staff,0,5,30,30
1650623677482,MATH 193A,A02,083225,Staff,0,6,30,30
1650623677482,MATH 193A,A03,083781,Staff,0,6,30,30
1650623677482,MATH 193A,A04,083782,Staff,0,7,30,30
1650623683509,MATH 197,001,091859,McAuley; Julian John,9998,0,9999,1
1650623689575,COGS 9,A01,083615,Staff,0,15,60,60
1650623695601,COGS 11,A01,083617,Boyle; Mary E. T.,18,0,40,22
1650623701626,COGS 13,A01,083071,Staff,0,38,40,40
1650623707658,COGS 14A,A01,092681,Staff,0,31,100,100
1650623713684,COGS 14B,A01,083073,Cheng; Tzu-Han,0,13,50,50
1650623719713,COGS 17,A01,092677,Staff,17,0,75,58
1650623725738,COGS 100,A01,083619,Staff,0,26,60,60
1650623731771,COGS 101A,A01,083621,Davis; Joshua Daniel,0,26,60,60
1650623737797,COGS 101B,A01,091572,Staff,0,4,60,60
1650623743828,COGS 101C,A01,083625,Delgado; Tania,15,0,30,15
1650623749872,COGS 107A,A01,083627,Boyle; Mary E. T.,1,15,60,59
1650623755916,COGS 118A,A01,083075,Staff,0,6,60,60
1650623761961,CSE 3,A50,083646,Miranda; Gregory Joseph,19,0,38,19
1650623761961,CSE 3,A51,083647,Miranda; Gregory Joseph,36,0,37,1
1650623767989,CSE 8A,A50,083650,Miranda; Gregory Joseph,0,30,40,40
1650623774013,CSE 11,A01,083080,Cao; Yingjun,0,95,40,40
1650623780056,CSE 12,A01,083652,Staff,0,19,100,100
1650623786080,CSE 15L,A01,083654,Staff,0,2,50,50
1650623786080,CSE 15L,A02,083655,Staff,0,1,50,50
1650623792106,CSE 20,A01,083657,Staff,51,0,80,29
1650623798136,CSE 30,A01,083084,Eldon; John,0,77,40,40
1650623804163,CSE 100,A01,083659,Cao; Yingjun,0,68,50,50
1650623810203,CSE 134B,A01,083661,Powell; Thomas Allan,0,35,65,65
1650623816227,CSE 140,A01,083663,Staff,0,8,75,75
1650623822297,CSE 140L,A01,083088,Eldon; John,0,16,75,75
1650623828324,CSE 175,A01,083665,Kumar; Rakesh,7,0,25,18
1650623834359,CSE 190,A00,092507,Dubnov; Shlomo,10,0,20,10
1650623840387,ECE 45,A01,083139,Staff,0,1,60,60
1650623846416,ECE 65,A50,083695,Staff,0,5,30,30
1650623852443,ECE 109,A01,091882,Touri; Behrouz,33,0,70,37
1650623858470,ECE 180,A00,083140,Abi Samra; Nicholas Camill,21,0,30,9
1650623858470,ECE 180,B00,083141,Abi Samra; Nicholas Camill,0,0,30,30
1650623864499,MATH 10A,A01,083735,Patchell; Gregory David,4,0,30,26
1650623864499,MATH 10A,A02,083736,Patchell; Gregory David,27,0,30,3
1650623864499,MATH 10A,A03,083737,Patchell; Gregory David,24,0,30,6
1650623870524,MATH 10B,A01,083207,Staff,0,8,30,30
1650623870524,MATH 10B,A02,083208,Staff,0,8,30,30
1650623870524,MATH 10B,B01,083739,Staff,11,0,30,19
1650623870524,MATH 10B,B02,083740,Staff,28,0,30,2
1650623876558,MATH 18,A01,083743,Staff,0,0,30,30
1650623876558,MATH 18,A02,083744,Staff,23,0,30,7
1650623876558,MATH 18,A03,083745,Staff,21,0,30,9
1650623876558,MATH 18,A04,083746,Staff,26,0,30,4
1650623876558,MATH 18,B01,083748,Staff,0,15,30,30
1650623876558,MATH 18,B02,083749,Staff,0,11,30,30
1650623876558,MATH 18,B03,083750,Staff,0,12,30,30
1650623876558,MATH 18,B04,083751,Staff,0,12,30,30
1650623882582,MATH 20A,A01,083754,Staff,19,0,40,21
1650623888608,MATH 20B,A01,083756,Staff,0,12,30,30
1650623888608,MATH 20B,A02,083757,Staff,0,12,30,30
1650623894635,MATH 20C,A01,083760,Staff,0,15,30,30
1650623894635,MATH 20C,A02,083761,Staff,1,13,30,29
1650623894635,MATH 20C,B01,083762,Staff,11,0,30,19
1650623894635,MATH 20C,B02,083763,Staff,28,0,30,2
1650623900665,MATH 20D,A01,083765,Staff,1,1,30,29
1650623900665,MATH 20D,A02,083766,Staff,7,0,30,23
1650623900665,MATH 20D,A03,083767,Staff,24,0,30,6
1650623906690,MATH 20E,A01,083771,Staff,3,0,30,27
1650623906690,MATH 20E,A02,083772,Staff,17,0,30,13
1650623906690,MATH 20E,B01,083773,Staff,0,0,30,30
1650623906690,MATH 20E,B02,083774,Staff,9,0,30,21
1650623912718,MATH 103A,A01,083777,Staff,0,15,30,30
1650623912718,MATH 103A,A02,083778,Staff,0,15,30,30
1650623912718,MATH 103A,B01,083779,Staff,0,14,30,30
1650623912718,MATH 103A,B02,083780,Staff,0,14,30,30
1650623918742,MATH 105,A01,085443,Staff,0,21,30,30
1650623924773,MATH 109,A01,083213,Anzaldo; Leesa B,0,6,30,30
1650623924773,MATH 109,A02,083214,Anzaldo; Leesa B,0,7,30,30
1650623924773,MATH 109,B01,083215,Anzaldo; Leesa B,0,6,30,30
1650623924773,MATH 109,B02,083216,Anzaldo; Leesa B,0,6,30,30
1650623930799,MATH 142A,A01,083219,Chow; Bennett,0,16,30,30
1650623930799,MATH 142A,A02,083220,Chow; Bennett,0,15,30,30
1650623930799,MATH 142A,B01,083221,Chow; Bennett,0,14,30,30
1650623930799,MATH 142A,B02,083222,Chow; Bennett,0,13,30,30
1650623936830,MATH 193A,A01,083224,Staff,0,5,30,30
1650623936830,MATH 193A,A02,083225,Staff,0,6,30,30
1650623936830,MATH 193A,A03,083781,Staff,0,6,30,30
1650623936830,MATH 193A,A04,083782,Staff,0,7,30,30
1650623942854,MATH 197,001,091859,McAuley; Julian John,9998,0,9999,1
1650623948930,COGS 9,A01,083615,Staff,0,15,60,60
1650623954959,COGS 11,A01,083617,Boyle; Mary E. T.,18,0,40,22
1650623960983,COGS 13,A01,083071,Staff,0,38,40,40
1650623967009,COGS 14A,A01,092681,Staff,0,31,100,100
1650623973033,COGS 14B,A01,083073,Cheng; Tzu-Han,0,13,50,50
1650623979062,COGS 17,A01,092677,Staff,17,0,75,58
1650623985085,COGS 100,A01,083619,Staff,0,26,60,60
1650623991109,COGS 101A,A01,083621,Davis; Joshua Daniel,0,26,60,60
1650623997143,COGS 101B,A01,091572,Staff,0,4,60,60
1650624003166,COGS 101C,A01,083625,Delgado; Tania,15,0,30,15
1650624009188,COGS 107A,A01,083627,Boyle; Mary E. T.,1,15,60,59
1650624015212,COGS 118A,A01,083075,Staff,0,6,60,60
1650624021239,CSE 3,A50,083646,Miranda; Gregory Joseph,19,0,38,19
1650624021239,CSE 3,A51,083647,Miranda; Gregory Joseph,36,0,37,1
1650624027267,CSE 8A,A50,083650,Miranda; Gregory Joseph,0,30,40,40
1650624033295,CSE 11,A01,083080,Cao; Yingjun,0,95,40,40
1650624039323,CSE 12,A01,083652,Staff,0,19,100,100
1650624045351,CSE 15L,A01,083654,Staff,0,2,50,50
1650624045351,CSE 15L,A02,083655,Staff,0,1,50,50
1650624051379,CSE 20,A01,083657,Staff,51,0,80,29
1650624057403,CSE 30,A01,083084,Eldon; John,0,77,40,40
1650624063429,CSE 100,A01,083659,Cao; Yingjun,0,68,50,50
1650624069458,CSE 134B,A01,083661,Powell; Thomas Allan,0,35,65,65
1650624075482,CSE 140,A01,083663,Staff,0,8,75,75
1650624081512,CSE 140L,A01,083088,Eldon; John,0,16,75,75
1650624087547,CSE 175,A01,083665,Kumar; Rakesh,7,0,25,18
1650624093590,CSE 190,A00,092507,Dubnov; Shlomo,10,0,20,10
1650624099708,ECE 45,A01,083139,Staff,0,1,60,60
1650624105737,ECE 65,A50,083695,Staff,0,5,30,30
1650624111760,ECE 109,A01,091882,Touri; Behrouz,33,0,70,37
1650624117786,ECE 180,A00,083140,Abi Samra; Nicholas Camill,21,0,30,9
1650624117786,ECE 180,B00,083141,Abi Samra; Nicholas Camill,0,0,30,30
1650624123823,MATH 10A,A01,083735,Patchell; Gregory David,4,0,30,26
1650624123823,MATH 10A,A02,083736,Patchell; Gregory David,27,0,30,3
1650624123823,MATH 10A,A03,083737,Patchell; Gregory David,24,0,30,6
1650624129849,MATH 10B,A01,083207,Staff,0,8,30,30
1650624129849,MATH 10B,A02,083208,Staff,0,8,30,30
1650624129849,MATH 10B,B01,083739,Staff,11,0,30,19
1650624129849,MATH 10B,B02,083740,Staff,28,0,30,2
1650624135876,MATH 18,A01,083743,Staff,0,0,30,30
1650624135876,MATH 18,A02,083744,Staff,23,0,30,7
1650624135876,MATH 18,A03,083745,Staff,21,0,30,9
1650624135876,MATH 18,A04,083746,Staff,26,0,30,4
1650624135876,MATH 18,B01,083748,Staff,0,15,30,30
1650624135876,MATH 18,B02,083749,Staff,0,11,30,30
1650624135876,MATH 18,B03,083750,Staff,0,12,30,30
1650624135876,MATH 18,B04,083751,Staff,0,12,30,30
1650624141904,MATH 20A,A01,083754,Staff,19,0,40,21
1650624147929,MATH 20B,A01,083756,Staff,0,12,30,30
1650624147929,MATH 20B,A02,083757,Staff,0,12,30,30
1650624153955,MATH 20C,A01,083760,Staff,0,15,30,30
1650624153955,MATH 20C,A02,083761,Staff,1,13,30,29
1650624153955,MATH 20C,B01,083762,Staff,11,0,30,19
1650624153955,MATH 20C,B02,083763,Staff,28,0,30,2
1650624159978,MATH 20D,A01,083765,Staff,1,1,30,29
1650624159978,MATH 20D,A02,083766,Staff,7,0,30,23
1650624159978,MATH 20D,A03,083767,Staff,24,0,30,6
1650624166003,MATH 20E,A01,083771,Staff,3,0,30,27
1650624166003,MATH 20E,A02,083772,Staff,17,0,30,13
1650624166003,MATH 20E,B01,083773,Staff,0,0,30,30
1650624166003,MATH 20E,B02,083774,Staff,9,0,30,21
1650624172034,MATH 103A,A01,083777,Staff,0,15,30,30
1650624172034,MATH 103A,A02,083778,Staff,0,15,30,30
1650624172034,MATH 103A,B01,083779,Staff,0,14,30,30
1650624172034,MATH 103A,B02,083780,Staff,0,14,30,30
1650624178058,MATH 105,A01,085443,Staff,0,21,30,30
1650624184085,MATH 109,A01,083213,Anzaldo; Leesa B,0,6,30,30
1650624184085,MATH 109,A02,083214,Anzaldo; Leesa B,0,7,30,30
1650624184085,MATH 109,B01,083215,Anzaldo; Leesa B,0,6,30,30
1650624184085,MATH 109,B02,083216,Anzaldo; Leesa B,0,6,30,30
1650624190110,MATH 142A,A01,083219,Chow; Bennett,0,16,30,30
1650624190110,MATH 142A,A02,083220,Chow; Bennett,0,15,30,30
1650624190110,MATH 142A,B01,083221,Chow; Bennett,0,14,30,30
1650624190110,MATH 142A,B02,083222,Chow; Bennett,0,13,30,30
1650624196136,MATH 193A,A01,083224,Staff,0,5,30,30
1650624196136,MATH 193A,A02,083225,Staff,0,6,30,30
1650624196136,MATH 193A,A03,083781,Staff,0,6,30,30
1650624196136,MATH 193A,A04,083782,Staff,0,7,30,30
1650624202159,MATH 197,001,091859,McAuley; Julian John,9998,0,9999,1
1650624208228,COGS 9,A01,083615,Staff,0,15,60,60
1650624214253,COGS 11,A01,083617,Boyle; Mary E. T.,18,0,40,22
1650624220289,COGS 13,A01,083071,Staff,0,38,40,40
1650624226312,COGS 14A,A01,092681,Staff,0,31,100,100
1650624232340,COGS 14B,A01,083073,Cheng; Tzu-Han,0,13,50,50
1650624238367,COGS 17,A01,092677,Staff,17,0,75,58
1650624244394,COGS 100,A01,083619,Staff,0,26,60,60
1650624250420,COGS 101A,A01,083621,Davis; Joshua Daniel,0,26,60,60
1650624256445,COGS 101B,A01,091572,Staff,0,4,60,60
1650624262470,COGS 101C,A01,083625,Delgado; Tania,15,0,30,15
1650624268493,COGS 107A,A01,083627,Boyle; Mary E. T.,1,15,60,59
1650624274517,COGS 118A,A01,083075,Staff,0,6,60,60
1650624280542,CSE 3,A50,083646,Miranda; Gregory Joseph,19,0,38,19
1650624280542,CSE 3,A51,083647,Miranda; Gregory Joseph,36,0,37,1
1650624286572,CSE 8A,A50,083650,Miranda; Gregory Joseph,0,30,40,40
1650624292600,CSE 11,A01,083080,Cao; Yingjun,0,95,40,40
1650624298624,CSE 12,A01,083652,Staff,0,19,100,100
1650624304651,CSE 15L,A01,083654,Staff,0,2,50,50
1650624304651,CSE 15L,A02,083655,Staff,0,1,50,50
1650624310684,CSE 20,A01,083657,Staff,51,0,80,29
1650624316708,CSE 30,A01,083084,Eldon; John,0,77,40,40
1650624322735,CSE 100,A01,083659,Cao; Yingjun,0,68,50,50
1650624328763,CSE 134B,A01,083661,Powell; Thomas Allan,0,35,65,65
1650624334785,CSE 140,A01,083663,Staff,0,8,75,75
1650624340812,CSE 140L,A01,083088,Eldon; John,0,16,75,75
1650624346839,CSE 175,A01,083665,Kumar; Rakesh,7,0,25,18
1650624352883,CSE 190,A00,092507,Dubnov; Shlomo,10,0,20,10
1650624358914,ECE 45,A01,083139,Staff,0,1,60,60
1650624364943,ECE 65,A50,083695,Staff,0,5,30,30
1650624370966,ECE 109,A01,091882,Touri; Behrouz,33,0,70,37
1650624376991,ECE 180,A00,083140,Abi Samra; Nicholas Camill,21,0,30,9
1650624376991,ECE 180,B00,083141,Abi Samra; Nicholas Camill,0,0,30,30
1650624383018,MATH 10A,A01,083735,Patchell; Gregory David,4,0,30,26
1650624383018,MATH 10A,A02,083736,Patchell; Gregory David,27,0,30,3
1650624383018,MATH 10A,A03,083737,Patchell; Gregory David,24,0,30,6
1650624389044,MATH 10B,A01,083207,Staff,0,8,30,30
1650624389044,MATH 10B,A02,083208,Staff,0,8,30,30
1650624389044,MATH 10B,B01,083739,Staff,11,0,30,19
1650624389044,MATH 10B,B02,083740,Staff,28,0,30,2
1650624395071,MATH 18,A01,083743,Staff,0,0,30,30
1650624395071,MATH 18,A02,083744,Staff,23,0,30,7
1650624395071,MATH 18,A03,083745,Staff,21,0,30,9
1650624395071,MATH 18,A04,083746,Staff,26,0,30,4
1650624395071,MATH 18,B01,083748,Staff,0,15,30,30
1650624395071,MATH 18,B02,083749,Staff,0,11,30,30
1650624395071,MATH 18,B03,083750,Staff,0,12,30,30
1650624395071,MATH 18,B04,083751,Staff,0,12,30,30
1650624401109,MATH 20A,A01,083754,Staff,19,0,40,21
1650624407137,MATH 20B,A01,083756,Staff,0,12,30,30
1650624407137,MATH 20B,A02,083757,Staff,0,12,30,30
1650624413167,MATH 20C,A01,083760,Staff,0,15,30,30
1650624413167,MATH 20C,A02,083761,Staff,1,13,30,29
1650624413167,MATH 20C,B01,083762,Staff,11,0,30,19
1650624413167,MATH 20C,B02,083763,Staff,28,0,30,2
1650624419191,MATH 20D,A01,083765,Staff,1,1,30,29
1650624419191,MATH 20D,A02,083766,Staff,7,0,30,23
1650624419191,MATH 20D,A03,083767,Staff,24,0,30,6
1650624425215,MATH 20E,A01,083771,Staff,3,0,30,27
1650624425215,MATH 20E,A02,083772,Staff,17,0,30,13
1650624425215,MATH 20E,B01,083773,Staff,0,0,30,30
1650624425215,MATH 20E,B02,083774,Staff,9,0,30,21
1650624431239,MATH 103A,A01,083777,Staff,0,15,30,30
1650624431239,MATH 103A,A02,083778,Staff,0,15,30,30
1650624431239,MATH 103A,B01,083779,Staff,0,14,30,30
1650624431239,MATH 103A,B02,083780,Staff,0,14,30,30
1650624437263,MATH 105,A01,085443,Staff,0,21,30,30
1650624443287,MATH 109,A01,083213,Anzaldo; Leesa B,0,6,30,30
1650624443287,MATH 109,A02,083214,Anzaldo; Leesa B,0,7,30,30
1650624443287,MATH 109,B01,083215,Anzaldo; Leesa B,0,6,30,30
1650624443287,MATH 109,B02,083216,Anzaldo; Leesa B,0,6,30,30
1650624449312,MATH 142A,A01,083219,Chow; Bennett,0,16,30,30
1650624449312,MATH 142A,A02,083220,Chow; Bennett,0,15,30,30
1650624449312,MATH 142A,B01,083221,Chow; Bennett,0,14,30,30
1650624449312,MATH 142A,B02,083222,Chow; Bennett,0,13,30,30
1650624455343,MATH 193A,A01,083224,Staff,0,5,30,30
1650624455343,MATH 193A,A02,083225,Staff,0,6,30,30
1650624455343,MATH 193A,A03,083781,Staff,0,6,30,30
1650624455343,MATH 193A,A04,083782,Staff,0,7,30,30
1650624461365,MATH 197,001,091859,McAuley; Julian John,9998,0,9999,1
1650624467422,COGS 9,A01,083615,Staff,0,15,60,60
1650624473444,COGS 11,A01,083617,Boyle; Mary E. T.,18,0,40,22
1650624479468,COGS 13,A01,083071,Staff,0,38,40,40
1650624485496,COGS 14A,A01,092681,Staff,0,31,100,100
1650624491526,COGS 14B,A01,083073,Cheng; Tzu-Han,0,13,50,50
1650624497553,COGS 17,A01,092677,Staff,17,0,75,58
1650624503578,COGS 100,A01,083619,Staff,0,26,60,60
1650624509609,COGS 101A,A01,083621,Davis; Joshua Daniel,0,26,60,60
1650624515635,COGS 101B,A01,091572,Staff,0,4,60,60
1650624521659,COGS 101C,A01,083625,Delgado; Tania,15,0,30,15
1650624527686,COGS 107A,A01,083627,Boyle; Mary E. T.,1,15,60,59
1650624533710,COGS 118A,A01,083075,Staff,0,6,60,60
1650624539735,CSE 3,A50,083646,Miranda; Gregory Joseph,19,0,38,19
1650624539735,CSE 3,A51,083647,Miranda; Gregory Joseph,36,0,37,1
1650624545763,CSE 8A,A50,083650,Miranda; Gregory Joseph,0,30,40,40
1650624551793,CSE 11,A01,083080,Cao; Yingjun,0,95,40,40
1650624557820,CSE 12,A01,083652,Staff,0,19,100,100
1650624563851,CSE 15L,A01,083654,Staff,0,2,50,50
1650624563851,CSE 15L,A02,083655,Staff,0,1,50,50
1650624569878,CSE 20,A01,083657,Staff,51,0,80,29
1650624575906,CSE 30,A01,083084,Eldon; John,0,77,40,40
1650624581935,CSE 100,A01,083659,Cao; Yingjun,0,68,50,50
1650624587960,CSE 134B,A01,083661,Powell; Thomas Allan,0,35,65,65
1650624593983,CSE 140,A01,083663,Staff,0,8,75,75
1650624600010,CSE 140L,A01,083088,Eldon; John,0,16,75,75
1650624606034,CSE 175,A01,083665,Kumar; Rakesh,7,0,25,18
1650624612058,CSE 190,A00,092507,Dubnov; Shlomo,10,0,20,10
1650624618081,ECE 45,A01,083139,Staff,0,1,60,60
1650624624106,ECE 65,A50,083695,Staff,0,5,30,30
1650624630135,ECE 109,A01,091882,Touri; Behrouz,33,0,70,37
1650624636180,ECE 180,A00,083140,Abi Samra; Nicholas Camill,21,0,30,9
1650624636180,ECE 180,B00,083141,Abi Samra; Nicholas Camill,0,0,30,30
1650624642213,MATH 10A,A01,083735,Patchell; Gregory David,4,0,30,26
1650624642213,MATH 10A,A02,083736,Patchell; Gregory David,27,0,30,3
1650624642213,MATH 10A,A03,083737,Patchell; Gregory David,24,0,30,6
1650624648237,MATH 10B,A01,083207,Staff,0,8,30,30
1650624648237,MATH 10B,A02,083208,Staff,0,8,30,30
1650624648237,MATH 10B,B01,083739,Staff,11,0,30,19
1650624648237,MATH 10B,B02,083740,Staff,28,0,30,2
1650624654271,MATH 18,A01,083743,Staff,0,0,30,30
1650624654271,MATH 18,A02,083744,Staff,23,0,30,7
1650624654271,MATH 18,A03,083745,Staff,21,0,30,9
1650624654271,MATH 18,A04,083746,Staff,26,0,30,4
1650624654271,MATH 18,B01,083748,Staff,0,15,30,30
1650624654271,MATH 18,B02,083749,Staff,0,11,30,30
1650624654271,MATH 18,B03,083750,Staff,0,12,30,30
1650624654271,MATH 18,B04,083751,Staff,0,12,30,30
1650624660302,MATH 20A,A01,083754,Staff,19,0,40,21
1650624666326,MATH 20B,A01,083756,Staff,0,12,30,30
1650624666326,MATH 20B,A02,083757,Staff,0,12,30,30
1650624672356,MATH 20C,A01,083760,Staff,0,15,30,30
1650624672356,MATH 20C,A02,083761,Staff,1,13,30,29
1650624672356,MATH 20C,B01,083762,Staff,11,0,30,19
1650624672356,MATH 20C,B02,083763,Staff,28,0,30,2
1650624678379,MATH 20D,A01,083765,Staff,1,1,30,29
1650624678379,MATH 20D,A02,083766,Staff,7,0,30,23
1650624678379,MATH 20D,A03,083767,Staff,24,0,30,6
1650624684406,MATH 20E,A01,083771,Staff,3,0,30,27
1650624684406,MATH 20E,A02,083772,Staff,17,0,30,13
1650624684406,MATH 20E,B01,083773,Staff,0,0,30,30
1650624684406,MATH 20E,B02,083774,Staff,9,0,30,21
1650624690440,MATH 103A,A01,083777,Staff,0,15,30,30
1650624690440,MATH 103A,A02,083778,Staff,0,15,30,30
1650624690440,MATH 103A,B01,083779,Staff,0,14,30,30
1650624690440,MATH 103A,B02,083780,Staff,0,14,30,30
1650624696539,MATH 105,A01,085443,Staff,0,21,30,30
1650624702563,MATH 109,A01,083213,Anzaldo; Leesa B,0,6,30,30
1650624702563,MATH 109,A02,083214,Anzaldo; Leesa B,0,7,30,30
1650624702563,MATH 109,B01,083215,Anzaldo; Leesa B,0,6,30,30
1650624702563,MATH 109,B02,083216,Anzaldo; Leesa B,0,6,30,30
1650624708589,MATH 142A,A01,083219,Chow; Bennett,0,16,30,30
1650624708589,MATH 142A,A02,083220,Chow; Bennett,0,15,30,30
1650624708589,MATH 142A,B01,083221,Chow; Bennett,0,14,30,30
1650624708589,MATH 142A,B02,083222,Chow; Bennett,0,13,30,30
1650624714614,MATH 193A,A01,083224,Staff,0,5,30,30
1650624714614,MATH 193A,A02,083225,Staff,0,6,30,30
1650624714614,MATH 193A,A03,083781,Staff,0,6,30,30
1650624714614,MATH 193A,A04,083782,Staff,0,7,30,30
1650624720637,MATH 197,001,091859,McAuley; Julian John,9998,0,9999,1
1650624726706,COGS 9,A01,083615,Staff,0,15,60,60
1650624732732,COGS 11,A01,083617,Boyle; Mary E. T.,18,0,40,22
1650624738760,COGS 13,A01,083071,Staff,0,38,40,40
1650624744784,COGS 14A,A01,092681,Staff,0,31,100,100
1650624750811,COGS 14B,A01,083073,Cheng; Tzu-Han,0,13,50,50
1650624756840,COGS 17,A01,092677,Staff,17,0,75,58
1650624762875,COGS 100,A01,083619,Staff,0,26,60,60
1650624768900,COGS 101A,A01,083621,Davis; Joshua Daniel,0,26,60,60
1650624774924,COGS 101B,A01,091572,Staff,0,4,60,60
1650624780953,COGS 101C,A01,083625,Delgado; Tania,15,0,30,15
1650624786981,COGS 107A,A01,083627,Boyle; Mary E. T.,1,15,60,59
1650624793012,COGS 118A,A01,083075,Staff,0,6,60,60
1650624799039,CSE 3,A50,083646,Miranda; Gregory Joseph,19,0,38,19
1650624799039,CSE 3,A51,083647,Miranda; Gregory Joseph,36,0,37,1
1650624805064,CSE 8A,A50,083650,Miranda; Gregory Joseph,0,30,40,40
1650624811092,CSE 11,A01,083080,Cao; Yingjun,0,95,40,40
1650624817122,CSE 12,A01,083652,Staff,0,19,100,100
1650624823150,CSE 15L,A01,083654,Staff,0,2,50,50
1650624823150,CSE 15L,A02,083655,Staff,0,1,50,50
1650624829175,CSE 20,A01,083657,Staff,51,0,80,29
1650624835200,CSE 30,A01,083084,Eldon; John,0,77,40,40
1650624841228,CSE 100,A01,083659,Cao; Yingjun,0,68,50,50
1650624847259,CSE 134B,A01,083661,Powell; Thomas Allan,0,35,65,65
1650624853281,CSE 140,A01,083663,Staff,0,8,75,75
1650624859317,CSE 140L,A01,083088,Eldon; John,0,16,75,75
1650624865346,CSE 175,A01,083665,Kumar; Rakesh,7,0,25,18
1650624871369,CSE 190,A00,092507,Dubnov; Shlomo,10,0,20,10
1650624877400,ECE 45,A01,083139,Staff,0,1,60,60
1650624883426,ECE 65,A50,083695,Staff,0,5,30,30
1650624889451,ECE 109,A01,091882,Touri; Behrouz,33,0,70,37
1650624895482,ECE 180,A00,083140,Abi Samra; Nicholas Camill,21,0,30,9
1650624895482,ECE 180,B00,083141,Abi Samra; Nicholas Camill,0,0,30,30
1650624901510,MATH 10A,A01,083735,Patchell; Gregory David,4,0,30,26
1650624901510,MATH 10A,A02,083736,Patchell; Gregory David,27,0,30,3
1650624901510,MATH 10A,A03,083737,Patchell; Gregory David,24,0,30,6
1650624907537,MATH 10B,A01,083207,Staff,0,8,30,30
1650624907537,MATH 10B,A02,083208,Staff,0,8,30,30
1650624907537,MATH 10B,B01,083739,Staff,11,0,30,19
1650624907537,MATH 10B,B02,083740,Staff,28,0,30,2
1650624913564,MATH 18,A01,083743,Staff,0,0,30,30
1650624913564,MATH 18,A02,083744,Staff,23,0,30,7
1650624913564,MATH 18,A03,083745,Staff,21,0,30,9
1650624913564,MATH 18,A04,083746,Staff,26,0,30,4
1650624913564,MATH 18,B01,083748,Staff,0,15,30,30
1650624913564,MATH 18,B02,083749,Staff,0,11,30,30
1650624913564,MATH 18,B03,083750,Staff,0,12,30,30
1650624913564,MATH 18,B04,083751,Staff,0,12,30,30
1650624919590,MATH 20A,A01,083754,Staff,19,0,40,21
1650624925619,MATH 20B,A01,083756,Staff,0,12,30,30
1650624925619,MATH 20B,A02,083757,Staff,0,12,30,30
1650624931653,MATH 20C,A01,083760,Staff,0,15,30,30
1650624931653,MATH 20C,A02,083761,Staff,1,13,30,29
1650624931653,MATH 20C,B01,083762,Staff,11,0,30,19
1650624931653,MATH 20C,B02,083763,Staff,28,0,30,2
1650624937681,MATH 20D,A01,083765,Staff,1,1,30,29
1650624937681,MATH 20D,A02,083766,Staff,7,0,30,23
1650624937681,MATH 20D,A03,083767,Staff,24,0,30,6
1650624943712,MATH 20E,A01,083771,Staff,3,0,30,27
1650624943712,MATH 20E,A02,083772,Staff,17,0,30,13
1650624943712,MATH 20E,B01,083773,Staff,0,0,30,30
1650624943712,MATH 20E,B02,083774,Staff,9,0,30,21
1650624949742,MATH 103A,A01,083777,Staff,0,15,30,30
1650624949742,MATH 103A,A02,083778,Staff,0,15,30,30
1650624949742,MATH 103A,B01,083779,Staff,0,14,30,30
1650624949742,MATH 103A,B02,083780,Staff,0,14,30,30
1650624955764,MATH 105,A01,085443,Staff,0,21,30,30
1650624961791,MATH 109,A01,083213,Anzaldo; Leesa B,0,6,30,30
1650624961791,MATH 109,A02,083214,Anzaldo; Leesa B,0,7,30,30
1650624961791,MATH 109,B01,083215,Anzaldo; Leesa B,0,6,30,30
1650624961791,MATH 109,B02,083216,Anzaldo; Leesa B,0,6,30,30
1650624967815,MATH 142A,A01,083219,Chow; Bennett,0,16,30,30
1650624967815,MATH 142A,A02,083220,Chow; Bennett,0,15,30,30
1650624967815,MATH 142A,B01,083221,Chow; Bennett,0,14,30,30
1650624967815,MATH 142A,B02,083222,Chow; Bennett,0,13,30,30
1650624973843,MATH 193A,A01,083224,Staff,0,5,30,30
1650624973843,MATH 193A,A02,083225,Staff,0,6,30,30
1650624973843,MATH 193A,A03,083781,Staff,0,6,30,30
1650624973843,MATH 193A,A04,083782,Staff,0,7,30,30
1650624979875,MATH 197,001,091859,McAuley; Julian John,9998,0,9999,1
1650624985944,COGS 9,A01,083615,Staff,0,15,60,60
1650624991968,COGS 11,A01,083617,Boyle; Mary E. T.,18,0,40,22
1650624997992,COGS 13,A01,083071,Staff,0,38,40,40
1650625004014,COGS 14A,A01,092681,Staff,0,31,100,100
1650625010044,COGS 14B,A01,083073,Cheng; Tzu-Han,0,13,50,50
1650625016074,COGS 17,A01,092677,Staff,17,0,75,58
1650625022098,COGS 100,A01,083619,Staff,0,26,60,60
1650625028122,COGS 101A,A01,083621,Davis; Joshua Daniel,0,26,60,60
1650625034154,COGS 101B,A01,091572,Staff,0,4,60,60
1650625040180,COGS 101C,A01,083625,Delgado; Tania,15,0,30,15
1650625046204,COGS 107A,A01,083627,Boyle; Mary E. T.,1,15,60,59
1650625052231,COGS 118A,A01,083075,Staff,0,6,60,60
1650625058258,CSE 3,A50,083646,Miranda; Gregory Joseph,19,0,38,19
1650625058258,CSE 3,A51,083647,Miranda; Gregory Joseph,36,0,37,1
1650625064290,CSE 8A,A50,083650,Miranda; Gregory Joseph,0,30,40,40
1650625070318,CSE 11,A01,083080,Cao; Yingjun,0,95,40,40
1650625076343,CSE 12,A01,083652,Staff,0,19,100,100
1650625082370,CSE 15L,A01,083654,Staff,0,2,50,50
1650625082370,CSE 15L,A02,083655,Staff,0,1,50,50
1650625088400,CSE 20,A01,083657,Staff,51,0,80,29
1650625094427,CSE 30,A01,083084,Eldon; John,0,77,40,40
1650625100457,CSE 100,A01,083659,Cao; Yingjun,0,68,50,50
1650625106488,CSE 134B,A01,083661,Powell; Thomas Allan,0,35,65,65
1650625112514,CSE 140,A01,083663,Staff,0,8,75,75
1650625118548,CSE 140L,A01,083088,Eldon; John,0,16,75,75
1650625124572,CSE 175,A01,083665,Kumar; Rakesh,7,0,25,18
1650625130599,CSE 190,A00,092507,Dubnov; Shlomo,10,0,20,10
1650625136627,ECE 45,A01,083139,Staff,0,1,60,60
1650625142657,ECE 65,A50,083695,Staff,0,5,30,30
1650625148683,ECE 109,A01,091882,Touri; Behrouz,33,0,70,37
1650625154710,ECE 180,A00,083140,Abi Samra; Nicholas Camill,21,0,30,9
1650625154710,ECE 180,B00,083141,Abi Samra; Nicholas Camill,0,0,30,30
1650625160737,MATH 10A,A01,083735,Patchell; Gregory David,4,0,30,26
1650625160737,MATH 10A,A02,083736,Patchell; Gregory David,27,0,30,3
1650625160737,MATH 10A,A03,083737,Patchell; Gregory David,24,0,30,6
1650625166769,MATH 10B,A01,083207,Staff,0,8,30,30
1650625166769,MATH 10B,A02,083208,Staff,0,8,30,30
1650625166769,MATH 10B,B01,083739,Staff,11,0,30,19
1650625166769,MATH 10B,B02,083740,Staff,28,0,30,2
1650625172803,MATH 18,A01,083743,Staff,0,0,30,30
1650625172803,MATH 18,A02,083744,Staff,23,0,30,7
1650625172803,MATH 18,A03,083745,Staff,21,0,30,9
1650625172803,MATH 18,A04,083746,Staff,26,0,30,4
1650625172803,MATH 18,B01,083748,Staff,0,15,30,30
1650625172803,MATH 18,B02,083749,Staff,0,11,30,30
1650625172803,MATH 18,B03,083750,Staff,0,12,30,30
1650625172803,MATH 18,B04,083751,Staff,0,12,30,30
1650625178827,MATH 20A,A01,083754,Staff,19,0,40,21
1650625184857,MATH 20B,A01,083756,Staff,0,12,30,30
1650625184857,MATH 20B,A02,083757,Staff,0,12,30,30
1650625190887,MATH 20C,A01,083760,Staff,0,15,30,30
1650625190887,MATH 20C,A02,083761,Staff,1,13,30,29
1650625190887,MATH 20C,B01,083762,Staff,11,0,30,19
1650625190887,MATH 20C,B02,083763,Staff,28,0,30,2
1650625196913,MATH 20D,A01,083765,Staff,1,1,30,29
1650625196913,MATH 20D,A02,083766,Staff,7,0,30,23
1650625196913,MATH 20D,A03,083767,Staff,24,0,30,6
1650625202942,MATH 20E,A01,083771,Staff,3,0,30,27
1650625202942,MATH 20E,A02,083772,Staff,17,0,30,13
1650625202942,MATH 20E,B01,083773,Staff,0,0,30,30
1650625202942,MATH 20E,B02,083774,Staff,9,0,30,21
1650625208968,MATH 103A,A01,083777,Staff,0,15,30,30
1650625208968,MATH 103A,A02,083778,Staff,0,15,30,30
1650625208968,MATH 103A,B01,083779,Staff,0,14,30,30
1650625208968,MATH 103A,B02,083780,Staff,0,14,30,30
1650625214992,MATH 105,A01,085443,Staff,0,21,30,30
1650625221021,MATH 109,A01,083213,Anzaldo; Leesa B,0,6,30,30
1650625221021,MATH 109,A02,083214,Anzaldo; Leesa B,0,7,30,30
1650625221021,MATH 109,B01,083215,Anzaldo; Leesa B,0,6,30,30
1650625221021,MATH 109,B02,083216,Anzaldo; Leesa B,0,6,30,30
1650625227047,MATH 142A,A01,083219,Chow; Bennett,0,16,30,30
1650625227047,MATH 142A,A02,083220,Chow; Bennett,0,15,30,30
1650625227047,MATH 142A,B01,083221,Chow; Bennett,0,14,30,30
1650625227047,MATH 142A,B02,083222,Chow; Bennett,0,13,30,30
1650625233076,MATH 193A,A01,083224,Staff,0,5,30,30
1650625233076,MATH 193A,A02,083225,Staff,0,6,30,30
1650625233076,MATH 193A,A03,083781,Staff,0,6,30,30
1650625233076,MATH 193A,A04,083782,Staff,0,7,30,30
1650625239103,MATH 197,001,091859,McAuley; Julian John,9998,0,9999,1
1650625245192,COGS 9,A01,083615,Staff,0,15,60,60
1650625251225,COGS 11,A01,083617,Boyle; Mary E. T.,18,0,40,22
1650625257255,COGS 13,A01,083071,Staff,0,38,40,40
1650625263340,COGS 14A,A01,092681,Staff,0,31,100,100
1650625269364,COGS 14B,A01,083073,Cheng; Tzu-Han,0,13,50,50
1650625275388,COGS 17,A01,092677,Staff,17,0,75,58
1650625281413,COGS 100,A01,083619,Staff,0,26,60,60
1650625287526,COGS 101A,A01,083621,Davis; Joshua Daniel,0,26,60,60
1650625293552,COGS 101B,A01,091572,Staff,0,4,60,60
1650625299585,COGS 101C,A01,083625,Delgado; Tania,15,0,30,15
1650625305609,COGS 107A,A01,083627,Boyle; Mary E. T.,1,15,60,59
1650625311633,COGS 118A,A01,083075,Staff,0,6,60,60
1650625328718,CSE 3,A50,083646,Miranda; Gregory Joseph,19,0,38,19
1650625328718,CSE 3,A51,083647,Miranda; Gregory Joseph,36,0,37,1
1650625334746,CSE 8A,A50,083650,Miranda; Gregory Joseph,0,30,40,40
1650625353780,CSE 11,A01,083080,Cao; Yingjun,0,95,40,40
1650625359806,CSE 12,A01,083652,Staff,0,19,100,100
1650625378750,CSE 15L,A01,083654,Staff,0,2,50,50
1650625378750,CSE 15L,A02,083655,Staff,0,1,50,50
1650625384774,CSE 20,A01,083657,Staff,51,0,80,29
1650625403553,CSE 30,A01,083084,Eldon; John,0,77,40,40
1650625409583,CSE 100,A01,083659,Cao; Yingjun,0,68,50,50
1650625432482,CSE 140,A01,083663,Staff,0,8,75,75
1650625438522,CSE 140L,A01,083088,Eldon; John,0,16,75,75
1650625453805,CSE 175,A01,083665,Kumar; Rakesh,7,0,25,18
1650625459839,CSE 190,A00,092507,Dubnov; Shlomo,10,0,20,10
1650625478047,ECE 45,A01,083139,Staff,0,1,60,60
1650625484083,ECE 65,A50,083695,Staff,0,5,30,30
1650625502733,ECE 109,A01,091882,Touri; Behrouz,33,0,70,37
1650625508759,ECE 180,A00,083140,Abi Samra; Nicholas Camill,21,0,30,9
1650625508759,ECE 180,B00,083141,Abi Samra; Nicholas Camill,0,0,30,30
1650625527211,MATH 10A,A01,083735,Patchell; Gregory David,4,0,30,26
1650625527211,MATH 10A,A02,083736,Patchell; Gregory David,27,0,30,3
1650625527211,MATH 10A,A03,083737,Patchell; Gregory David,24,0,30,6
1650625533236,MATH 10B,A01,083207,Staff,0,8,30,30
1650625533236,MATH 10B,A02,083208,Staff,0,8,30,30
1650625533236,MATH 10B,B01,083739,Staff,11,0,30,19
1650625533236,MATH 10B,B02,083740,Staff,28,0,30,2
1650625551103,MATH 18,A01,083743,Staff,0,0,30,30
1650625551103,MATH 18,A02,083744,Staff,23,0,30,7
1650625551103,MATH 18,A03,083745,Staff,21,0,30,9
1650625551103,MATH 18,A04,083746,Staff,26,0,30,4
1650625551103,MATH 18,B01,083748,Staff,0,15,30,30
1650625551103,MATH 18,B02,083749,Staff,0,11,30,30
1650625551103,MATH 18,B03,083750,Staff,0,12,30,30
1650625551103,MATH 18,B04,083751,Staff,0,12,30,30
1650625557129,MATH 20A,A01,083754,Staff,19,0,40,21
1650625563180,MATH 20B,A01,083756,Staff,0,12,30,30
1650625563180,MATH 20B,A02,083757,Staff,0,12,30,30
1650625569212,MATH 20C,A01,083760,Staff,0,15,30,30
1650625569212,MATH 20C,A02,083761,Staff,1,13,30,29
1650625569212,MATH 20C,B01,083762,Staff,11,0,30,19
1650625569212,MATH 20C,B02,083763,Staff,28,0,30,2
1650625575234,MATH 20D,A01,083765,Staff,1,1,30,29
1650625575234,MATH 20D,A02,083766,Staff,7,0,30,23
1650625575234,MATH 20D,A03,083767,Staff,24,0,30,6
1650625581273,MATH 20E,A01,083771,Staff,3,0,30,27
1650625581273,MATH 20E,A02,083772,Staff,17,0,30,13
1650625581273,MATH 20E,B01,083773,Staff,0,0,30,30
1650625581273,MATH 20E,B02,083774,Staff,9,0,30,21
1650625587298,MATH 103A,A01,083777,Staff,0,15,30,30
1650625587298,MATH 103A,A02,083778,Staff,0,15,30,30
1650625587298,MATH 103A,B01,083779,Staff,0,14,30,30
1650625587298,MATH 103A,B02,083780,Staff,0,14,30,30
1650625593326,MATH 105,A01,085443,Staff,0,21,30,30
1650625599353,MATH 109,A01,083213,Anzaldo; Leesa B,0,6,30,30
1650625599353,MATH 109,A02,083214,Anzaldo; Leesa B,0,7,30,30
1650625599353,MATH 109,B01,083215,Anzaldo; Leesa B,0,6,30,30
1650625599353,MATH 109,B02,083216,Anzaldo; Leesa B,0,6,30,30
1650625605390,MATH 142A,A01,083219,Chow; Bennett,0,16,30,30
1650625605390,MATH 142A,A02,083220,Chow; Bennett,0,15,30,30
1650625605390,MATH 142A,B01,083221,Chow; Bennett,0,14,30,30
1650625605390,MATH 142A,B02,083222,Chow; Bennett,0,13,30,30
1650625611416,MATH 193A,A01,083224,Staff,0,5,30,30
1650625611416,MATH 193A,A02,083225,Staff,0,6,30,30
1650625611416,MATH 193A,A03,083781,Staff,0,6,30,30
1650625611416,MATH 193A,A04,083782,Staff,0,7,30,30
1650625617452,MATH 197,001,091859,McAuley; Julian John,9998,0,9999,1
1650625623550,COGS 9,A01,083615,Staff,0,15,60,60
1650625629583,COGS 11,A01,083617,Boyle; Mary E. T.,18,0,40,22
1650625635608,COGS 13,A01,083071,Staff,0,38,40,40
1650625641640,COGS 14A,A01,092681,Staff,0,31,100,100
1650625647666,COGS 14B,A01,083073,Cheng; Tzu-Han,0,13,50,50
1650625653694,COGS 17,A01,092677,Staff,17,0,75,58
1650625659722,COGS 100,A01,083619,Staff,0,26,60,60
1650625665757,COGS 101A,A01,083621,Davis; Joshua Daniel,0,26,60,60
1650625671781,COGS 101B,A01,091572,Staff,0,4,60,60
1650625677818,COGS 101C,A01,083625,Delgado; Tania,15,0,30,15
1650625683849,COGS 107A,A01,083627,Boyle; Mary E. T.,1,15,60,59
1650625689876,COGS 118A,A01,083075,Staff,0,6,60,60
1650625695909,CSE 3,A50,083646,Miranda; Gregory Joseph,19,0,38,19
1650625695909,CSE 3,A51,083647,Miranda; Gregory Joseph,36,0,37,1
1650625701938,CSE 8A,A50,083650,Miranda; Gregory Joseph,0,30,40,40
1650625707968,CSE 11,A01,083080,Cao; Yingjun,0,95,40,40
1650625713995,CSE 12,A01,083652,Staff,0,19,100,100
1650625720022,CSE 15L,A01,083654,Staff,0,2,50,50
1650625720022,CSE 15L,A02,083655,Staff,0,1,50,50
1650625726050,CSE 20,A01,083657,Staff,51,0,80,29
1650625732075,CSE 30,A01,083084,Eldon; John,0,77,40,40
1650625738101,CSE 100,A01,083659,Cao; Yingjun,0,68,50,50
1650625744133,CSE 134B,A01,083661,Powell; Thomas Allan,0,35,65,65
1650625750167,CSE 140,A01,083663,Staff,0,8,75,75
1650625756197,CSE 140L,A01,083088,Eldon; John,0,16,75,75
1650625762229,CSE 175,A01,083665,Kumar; Rakesh,7,0,25,18
1650625768256,CSE 190,A00,092507,Dubnov; Shlomo,10,0,20,10
1650625774279,ECE 45,A01,083139,Staff,0,1,60,60
1650625780305,ECE 65,A50,083695,Staff,0,5,30,30
1650625786335,ECE 109,A01,091882,Touri; Behrouz,33,0,70,37
1650625792377,ECE 180,A00,083140,Abi Samra; Nicholas Camill,21,0,30,9
1650625792377,ECE 180,B00,083141,Abi Samra; Nicholas Camill,0,0,30,30
1650625798404,MATH 10A,A01,083735,Patchell; Gregory David,4,0,30,26
1650625798404,MATH 10A,A02,083736,Patchell; Gregory David,27,0,30,3
1650625798404,MATH 10A,A03,083737,Patchell; Gregory David,24,0,30,6
1650625804435,MATH 10B,A01,083207,Staff,0,8,30,30
1650625804435,MATH 10B,A02,083208,Staff,0,8,30,30
1650625804435,MATH 10B,B01,083739,Staff,11,0,30,19
1650625804435,MATH 10B,B02,083740,Staff,28,0,30,2
1650625822141,MATH 18,A01,083743,Staff,0,0,30,30
1650625822141,MATH 18,A02,083744,Staff,23,0,30,7
1650625822141,MATH 18,A03,083745,Staff,21,0,30,9
1650625822141,MATH 18,A04,083746,Staff,26,0,30,4
1650625822141,MATH 18,B01,083748,Staff,0,15,30,30
1650625822141,MATH 18,B02,083749,Staff,0,11,30,30
1650625822141,MATH 18,B03,083750,Staff,0,12,30,30
1650625822141,MATH 18,B04,083751,Staff,0,12,30,30
1650625828185,MATH 20A,A01,083754,Staff,19,0,40,21
1650625834208,MATH 20B,A01,083756,Staff,0,12,30,30
1650625834208,MATH 20B,A02,083757,Staff,0,12,30,30
1650625840236,MATH 20C,A01,083760,Staff,0,15,30,30
1650625840236,MATH 20C,A02,083761,Staff,1,13,30,29
1650625840236,MATH 20C,B01,083762,Staff,11,0,30,19
1650625840236,MATH 20C,B02,083763,Staff,28,0,30,2
1650625846260,MATH 20D,A01,083765,Staff,1,1,30,29
1650625846260,MATH 20D,A02,083766,Staff,7,0,30,23
1650625846260,MATH 20D,A03,083767,Staff,24,0,30,6
1650625852294,MATH 20E,A01,083771,Staff,3,0,30,27
1650625852294,MATH 20E,A02,083772,Staff,17,0,30,13
1650625852294,MATH 20E,B01,083773,Staff,0,0,30,30
1650625852294,MATH 20E,B02,083774,Staff,9,0,30,21
1650625858321,MATH 103A,A01,083777,Staff,0,15,30,30
1650625858321,MATH 103A,A02,083778,Staff,0,15,30,30
1650625858321,MATH 103A,B01,083779,Staff,0,14,30,30
1650625858321,MATH 103A,B02,083780,Staff,0,14,30,30
1650625864347,MATH 105,A01,085443,Staff,0,21,30,30
1650625870372,MATH 109,A01,083213,Anzaldo; Leesa B,0,6,30,30
1650625870372,MATH 109,A02,083214,Anzaldo; Leesa B,0,7,30,30
1650625870372,MATH 109,B01,083215,Anzaldo; Leesa B,0,6,30,30
1650625870372,MATH 109,B02,083216,Anzaldo; Leesa B,0,6,30,30
1650625876400,MATH 142A,A01,083219,Chow; Bennett,0,16,30,30
1650625876400,MATH 142A,A02,083220,Chow; Bennett,0,15,30,30
1650625876400,MATH 142A,B01,083221,Chow; Bennett,0,14,30,30
1650625876400,MATH 142A,B02,083222,Chow; Bennett,0,13,30,30
1650625882426,MATH 193A,A01,083224,Staff,0,5,30,30
1650625882426,MATH 193A,A02,083225,Staff,0,6,30,30
1650625882426,MATH 193A,A03,083781,Staff,0,6,30,30
1650625882426,MATH 193A,A04,083782,Staff,0,7,30,30
1650625888457,MATH 197,001,091859,McAuley; Julian John,9998,0,9999,1
1650625894531,COGS 9,A01,083615,Staff,0,15,60,60
1650625900561,COGS 11,A01,083617,Boyle; Mary E. T.,18,0,40,22
1650625906588,COGS 13,A01,083071,Staff,0,38,40,40
1650625912613,COGS 14A,A01,092681,Staff,0,31,100,100
1650625918644,COGS 14B,A01,083073,Cheng; Tzu-Han,0,13,50,50
1650625924669,COGS 17,A01,092677,Staff,17,0,75,58
1650625930705,COGS 100,A01,083619,Staff,0,26,60,60
1650625936730,COGS 101A,A01,083621,Davis; Joshua Daniel,0,26,60,60
1650625942759,COGS 101B,A01,091572,Staff,0,4,60,60
1650625948786,COGS 101C,A01,083625,Delgado; Tania,15,0,30,15
1650625954811,COGS 107A,A01,083627,Boyle; Mary E. T.,1,15,60,59
1650625960836,COGS 118A,A01,083075,Staff,0,6,60,60
1650625966872,CSE 3,A50,083646,Miranda; Gregory Joseph,19,0,38,19
1650625966872,CSE 3,A51,083647,Miranda; Gregory Joseph,36,0,37,1
1650625972901,CSE 8A,A50,083650,Miranda; Gregory Joseph,0,30,40,40
1650625978927,CSE 11,A01,083080,Cao; Yingjun,0,95,40,40
1650625984958,CSE 12,A01,083652,Staff,0,19,100,100
1650625990981,CSE 15L,A01,083654,Staff,0,2,50,50
1650625990981,CSE 15L,A02,083655,Staff,0,1,50,50
1650625997006,CSE 20,A01,083657,Staff,51,0,80,29
1650626003052,CSE 30,A01,083084,Eldon; John,0,77,40,40
1650626009098,CSE 100,A01,083659,Cao; Yingjun,0,68,50,50
1650626015122,CSE 134B,A01,083661,Powell; Thomas Allan,0,35,65,65
1650626021150,CSE 140,A01,083663,Staff,0,8,75,75
1650626027181,CSE 140L,A01,083088,Eldon; John,0,16,75,75
1650626033213,CSE 175,A01,083665,Kumar; Rakesh,7,0,25,18
1650626039245,CSE 190,A00,092507,Dubnov; Shlomo,10,0,20,10
1650626045274,ECE 45,A01,083139,Staff,0,1,60,60
1650626051300,ECE 65,A50,083695,Staff,0,5,30,30
1650626057332,ECE 109,A01,091882,Touri; Behrouz,33,0,70,37
1650626063358,ECE 180,A00,083140,Abi Samra; Nicholas Camill,21,0,30,9
1650626063358,ECE 180,B00,083141,Abi Samra; Nicholas Camill,0,0,30,30
1650626069386,MATH 10A,A01,083735,Patchell; Gregory David,4,0,30,26
1650626069386,MATH 10A,A02,083736,Patchell; Gregory David,27,0,30,3
1650626069386,MATH 10A,A03,083737,Patchell; Gregory David,24,0,30,6
1650626075420,MATH 10B,A01,083207,Staff,0,8,30,30
1650626075420,MATH 10B,A02,083208,Staff,0,8,30,30
1650626075420,MATH 10B,B01,083739,Staff,11,0,30,19
1650626075420,MATH 10B,B02,083740,Staff,28,0,30,2
1650626081450,MATH 18,A01,083743,Staff,0,0,30,30
1650626081450,MATH 18,A02,083744,Staff,23,0,30,7
1650626081450,MATH 18,A03,083745,Staff,21,0,30,9
1650626081450,MATH 18,A04,083746,Staff,26,0,30,4
1650626081450,MATH 18,B01,083748,Staff,0,15,30,30
1650626081450,MATH 18,B02,083749,Staff,0,11,30,30
1650626081450,MATH 18,B03,083750,Staff,0,12,30,30
1650626081450,MATH 18,B04,083751,Staff,0,12,30,30
1650626087474,MATH 20A,A01,083754,Staff,19,0,40,21
1650626093512,MATH 20B,A01,083756,Staff,0,12,30,30
1650626093512,MATH 20B,A02,083757,Staff,0,12,30,30
1650626099632,MATH 20C,A01,083760,Staff,0,15,30,30
1650626099632,MATH 20C,A02,083761,Staff,1,13,30,29
1650626099632,MATH 20C,B01,083762,Staff,11,0,30,19
1650626099632,MATH 20C,B02,083763,Staff,28,0,30,2
1650626105663,MATH 20D,A01,083765,Staff,1,1,30,29
1650626105663,MATH 20D,A02,083766,Staff,7,0,30,23
1650626105663,MATH 20D,A03,083767,Staff,24,0,30,6
1650626111694,MATH 20E,A01,083771,Staff,3,0,30,27
1650626111694,MATH 20E,A02,083772,Staff,17,0,30,13
1650626111694,MATH 20E,B01,083773,Staff,0,0,30,30
1650626111694,MATH 20E,B02,083774,Staff,9,0,30,21
1650626117747,MATH 103A,A01,083777,Staff,0,15,30,30
1650626117747,MATH 103A,A02,083778,Staff,0,15,30,30
1650626117747,MATH 103A,B01,083779,Staff,0,14,30,30
1650626117747,MATH 103A,B02,083780,Staff,0,14,30,30
1650626123784,MATH 105,A01,085443,Staff,0,21,30,30
1650626129811,MATH 109,A01,083213,Anzaldo; Leesa B,0,6,30,30
1650626129811,MATH 109,A02,083214,Anzaldo; Leesa B,0,7,30,30
1650626129811,MATH 109,B01,083215,Anzaldo; Leesa B,0,6,30,30
1650626129811,MATH 109,B02,083216,Anzaldo; Leesa B,0,6,30,30
1650626135844,MATH 142A,A01,083219,Chow; Bennett,0,16,30,30
1650626135844,MATH 142A,A02,083220,Chow; Bennett,0,15,30,30
1650626135844,MATH 142A,B01,083221,Chow; Bennett,0,14,30,30
1650626135844,MATH 142A,B02,083222,Chow; Bennett,0,13,30,30
1650626141874,MATH 193A,A01,083224,Staff,0,5,30,30
1650626141874,MATH 193A,A02,083225,Staff,0,6,30,30
1650626141874,MATH 193A,A03,083781,Staff,0,6,30,30
1650626141874,MATH 193A,A04,083782,Staff,0,7,30,30
1650626147899,MATH 197,001,091859,McAuley; Julian John,9998,0,9999,1
1650626153965,COGS 9,A01,083615,Staff,0,15,60,60
1650626159990,COGS 11,A01,083617,Boyle; Mary E. T.,18,0,40,22
1650626166014,COGS 13,A01,083071,Staff,0,38,40,40
1650626172046,COGS 14A,A01,092681,Staff,0,31,100,100
1650626178095,COGS 14B,A01,083073,Cheng; Tzu-Han,0,13,50,50
1650626184124,COGS 17,A01,092677,Staff,17,0,75,58
1650626190156,COGS 100,A01,083619,Staff,0,26,60,60
1650626196186,COGS 101A,A01,083621,Davis; Joshua Daniel,0,26,60,60
1650626202238,COGS 101B,A01,091572,Staff,0,4,60,60
1650626208265,COGS 101C,A01,083625,Delgado; Tania,15,0,30,15
1650626214291,COGS 107A,A01,083627,Boyle; Mary E. T.,1,15,60,59
1650626220319,COGS 118A,A01,083075,Staff,0,6,60,60
1650626226344,CSE 3,A50,083646,Miranda; Gregory Joseph,19,0,38,19
1650626226344,CSE 3,A51,083647,Miranda; Gregory Joseph,36,0,37,1
1650626232381,CSE 8A,A50,083650,Miranda; Gregory Joseph,0,30,40,40
1650626238406,CSE 11,A01,083080,Cao; Yingjun,0,95,40,40
1650626244446,CSE 12,A01,083652,Staff,0,19,100,100
1650626250472,CSE 15L,A01,083654,Staff,0,2,50,50
1650626250472,CSE 15L,A02,083655,Staff,0,1,50,50
1650626256534,CSE 20,A01,083657,Staff,51,0,80,29
1650626262559,CSE 30,A01,083084,Eldon; John,0,77,40,40
1650626268613,CSE 100,A01,083659,Cao; Yingjun,0,68,50,50
1650626274637,CSE 134B,A01,083661,Powell; Thomas Allan,0,35,65,65
1650626280667,CSE 140,A01,083663,Staff,0,8,75,75
1650626286697,CSE 140L,A01,083088,Eldon; John,0,16,75,75
1650626292726,CSE 175,A01,083665,Kumar; Rakesh,7,0,25,18
1650626298750,CSE 190,A00,092507,Dubnov; Shlomo,10,0,20,10
1650626304776,ECE 45,A01,083139,Staff,0,1,60,60
1650626310805,ECE 65,A50,083695,Staff,0,5,30,30
1650626316838,ECE 109,A01,091882,Touri; Behrouz,33,0,70,37
1650626322868,ECE 180,A00,083140,Abi Samra; Nicholas Camill,21,0,30,9
1650626322868,ECE 180,B00,083141,Abi Samra; Nicholas Camill,0,0,30,30
1650626328900,MATH 10A,A01,083735,Patchell; Gregory David,4,0,30,26
1650626328900,MATH 10A,A02,083736,Patchell; Gregory David,27,0,30,3
1650626328900,MATH 10A,A03,083737,Patchell; Gregory David,24,0,30,6
