time,subj_course_id,sec_code,sec_id,prof,available,waitlist,total,enrolled_ct
1650972503802,COGS 9,A01,083615,Staff,0,18,60,60
1650972509841,COGS 11,A01,083617,Boyle; Mary E. T.,15,0,40,25
1650972515870,COGS 13,A01,083071,Staff,0,41,40,40
1650972521900,COGS 14A,A01,092681,Staff,0,38,100,100
1650972527938,COGS 14B,A01,083073,Cheng; Tzu-Han,0,13,50,50
1650972533973,COGS 17,A01,092677,Staff,6,0,75,69
1650972540003,COGS 100,A01,083619,Staff,0,31,60,60
1650972546032,COGS 101A,A01,083621,Davis; Joshua Daniel,0,29,60,60
1650972552066,COGS 101B,A01,091572,Staff,0,5,60,60
1650972558097,COGS 101C,A01,083625,Delgado; Tania,14,0,30,16
1650972564130,COGS 107A,A01,083627,Boyle; Mary E. T.,0,16,60,60
1650972570156,COGS 118A,A01,083075,Staff,0,10,60,60
1650972576184,CSE 3,A50,083646,Miranda; Gregory Joseph,15,0,38,23
1650972576184,CSE 3,A51,083647,Miranda; Gregory Joseph,36,0,37,1
1650972582219,CSE 8A,A50,083650,Miranda; Gregory Joseph,0,31,40,40
1650972588249,CSE 11,A01,083080,Cao; Yingjun,0,98,40,40
1650972594281,CSE 12,A01,083652,Staff,0,24,100,100
1650972600315,CSE 15L,A01,083654,Staff,0,3,50,50
1650972600315,CSE 15L,A02,083655,Staff,0,3,50,50
1650972606345,CSE 20,A01,083657,Staff,47,0,80,33
1650972612379,CSE 30,A01,083084,Eldon; John,1,38,80,79
1650972618414,CSE 100,A01,083659,Cao; Yingjun,0,71,50,50
1650972624440,CSE 134B,A01,083661,Powell; Thomas Allan,1,40,65,64
1650972630469,CSE 140,A01,083663,Staff,0,13,75,75
1650972636493,CSE 140L,A01,083088,Eldon; John,4,0,100,96
1650972642519,CSE 175,A01,083665,Kumar; Rakesh,0,0,25,25
1650972648546,CSE 190,A00,092507,Dubnov; Shlomo,9,0,20,11
1650972654575,ECE 45,A01,083139,Staff,0,6,60,60
1650972660607,ECE 65,A50,083695,Staff,0,7,30,30
1650972666635,ECE 109,A01,091882,Touri; Behrouz,32,0,70,38
1650972672669,ECE 180,A00,083140,Abi Samra; Nicholas Camill,18,0,30,12
1650972672669,ECE 180,B00,083141,Abi Samra; Nicholas Camill,0,0,30,30
1650972678701,MATH 10A,A01,083735,Patchell; Gregory David,2,0,30,28
1650972678701,MATH 10A,A02,083736,Patchell; Gregory David,27,0,30,3
1650972678701,MATH 10A,A03,083737,Patchell; Gregory David,23,0,30,7
1650972684729,MATH 10B,A01,083207,Staff,0,9,30,30
1650972684729,MATH 10B,A02,083208,Staff,0,5,30,30
1650972684729,MATH 10B,B01,083739,Staff,9,0,30,21
1650972684729,MATH 10B,B02,083740,Staff,28,0,30,2
1650972690759,MATH 18,A01,083743,Staff,0,0,30,30
1650972690759,MATH 18,A02,083744,Staff,24,0,30,6
1650972690759,MATH 18,A03,083745,Staff,19,0,30,11
1650972690759,MATH 18,A04,083746,Staff,26,0,30,4
1650972690759,MATH 18,B01,083748,Staff,0,15,30,30
1650972690759,MATH 18,B02,083749,Staff,0,14,30,30
1650972690759,MATH 18,B03,083750,Staff,0,13,30,30
1650972690759,MATH 18,B04,083751,Staff,0,13,30,30
1650972696787,MATH 20A,A01,083754,Staff,19,0,40,21
1650972702813,MATH 20B,A01,083756,Staff,0,14,30,30
1650972702813,MATH 20B,A02,083757,Staff,0,11,30,30
1650972708843,MATH 20C,A01,083760,Staff,0,17,30,30
1650972708843,MATH 20C,A02,083761,Staff,0,15,30,30
1650972708843,MATH 20C,B01,083762,Staff,9,0,30,21
1650972708843,MATH 20C,B02,083763,Staff,28,0,30,2
1650972714874,MATH 20D,A01,083765,Staff,2,1,30,28
1650972714874,MATH 20D,A02,083766,Staff,2,0,30,28
1650972714874,MATH 20D,A03,083767,Staff,22,0,30,8
1650972720900,MATH 20E,A01,083771,Staff,2,0,30,28
1650972720900,MATH 20E,A02,083772,Staff,13,0,30,17
1650972720900,MATH 20E,B01,083773,Staff,0,0,30,30
1650972720900,MATH 20E,B02,083774,Staff,1,0,30,29
1650972726924,MATH 103A,A01,083777,Staff,0,17,30,30
1650972726924,MATH 103A,A02,083778,Staff,0,15,30,30
1650972726924,MATH 103A,B01,083779,Staff,0,15,30,30
1650972726924,MATH 103A,B02,083780,Staff,0,14,30,30
1650972732955,MATH 105,A01,085443,Staff,0,23,30,30
1650972738987,MATH 109,A01,083213,Anzaldo; Leesa B,0,7,30,30
1650972738987,MATH 109,A02,083214,Anzaldo; Leesa B,0,7,30,30
1650972738987,MATH 109,B01,083215,Anzaldo; Leesa B,0,8,30,30
1650972738987,MATH 109,B02,083216,Anzaldo; Leesa B,0,7,30,30
1650972745013,MATH 142A,A01,083219,Chow; Bennett,0,14,30,30
1650972745013,MATH 142A,A02,083220,Chow; Bennett,0,15,30,30
1650972745013,MATH 142A,B01,083221,Chow; Bennett,0,16,30,30
1650972745013,MATH 142A,B02,083222,Chow; Bennett,0,14,30,30
1650972751038,MATH 193A,A01,083224,Staff,0,6,30,30
1650972751038,MATH 193A,A02,083225,Staff,0,7,30,30
1650972751038,MATH 193A,A03,083781,Staff,0,6,30,30
1650972751038,MATH 193A,A04,083782,Staff,0,7,30,30
1650972757065,MATH 197,001,091859,McAuley; Julian John,9998,0,9999,1
1650972763132,COGS 9,A01,083615,Staff,0,18,60,60
1650972769157,COGS 11,A01,083617,Boyle; Mary E. T.,15,0,40,25
1650972780944,COGS 13,A01,083071,Staff,0,41,40,40
1650972786969,COGS 14A,A01,092681,Staff,0,38,100,100
1650972801213,COGS 14B,A01,083073,Cheng; Tzu-Han,0,13,50,50
1650972807242,COGS 17,A01,092677,Staff,6,0,75,69
1650972813270,COGS 100,A01,083619,Staff,0,31,60,60
1650972819305,COGS 101A,A01,083621,Davis; Joshua Daniel,0,29,60,60
1650972825384,COGS 101B,A01,091572,Staff,0,5,60,60
1650972831414,COGS 101C,A01,083625,Delgado; Tania,14,0,30,16
1650972837441,COGS 107A,A01,083627,Boyle; Mary E. T.,0,16,60,60
1650972843467,COGS 118A,A01,083075,Staff,0,10,60,60
1650972849502,CSE 3,A50,083646,Miranda; Gregory Joseph,15,0,38,23
1650972849502,CSE 3,A51,083647,Miranda; Gregory Joseph,36,0,37,1
1650972855528,CSE 8A,A50,083650,Miranda; Gregory Joseph,0,31,40,40
1650972861556,CSE 11,A01,083080,Cao; Yingjun,0,98,40,40
1650972867585,CSE 12,A01,083652,Staff,0,24,100,100
1650972873612,CSE 15L,A01,083654,Staff,0,3,50,50
1650972873612,CSE 15L,A02,083655,Staff,0,3,50,50
1650972879638,CSE 20,A01,083657,Staff,47,0,80,33
1650972885669,CSE 30,A01,083084,Eldon; John,1,38,80,79
1650972891699,CSE 100,A01,083659,Cao; Yingjun,0,71,50,50
1650972897731,CSE 134B,A01,083661,Powell; Thomas Allan,1,40,65,64
1650972903761,CSE 140,A01,083663,Staff,0,13,75,75
1650972909784,CSE 140L,A01,083088,Eldon; John,4,0,100,96
1650972915813,CSE 175,A01,083665,Kumar; Rakesh,0,0,25,25
1650972921841,CSE 190,A00,092507,Dubnov; Shlomo,9,0,20,11
1650972927866,ECE 45,A01,083139,Staff,0,6,60,60
1650972933897,ECE 65,A50,083695,Staff,0,7,30,30
1650972939929,ECE 109,A01,091882,Touri; Behrouz,32,0,70,38
1650972945956,ECE 180,A00,083140,Abi Samra; Nicholas Camill,18,0,30,12
1650972945956,ECE 180,B00,083141,Abi Samra; Nicholas Camill,0,0,30,30
1650972951983,MATH 10A,A01,083735,Patchell; Gregory David,2,0,30,28
1650972951983,MATH 10A,A02,083736,Patchell; Gregory David,27,0,30,3
1650972951983,MATH 10A,A03,083737,Patchell; Gregory David,23,0,30,7
1650972958012,MATH 10B,A01,083207,Staff,0,9,30,30
1650972958012,MATH 10B,A02,083208,Staff,0,5,30,30
1650972958012,MATH 10B,B01,083739,Staff,9,0,30,21
1650972958012,MATH 10B,B02,083740,Staff,28,0,30,2
1650972964046,MATH 18,A01,083743,Staff,0,0,30,30
1650972964046,MATH 18,A02,083744,Staff,24,0,30,6
1650972964046,MATH 18,A03,083745,Staff,19,0,30,11
1650972964046,MATH 18,A04,083746,Staff,26,0,30,4
1650972964046,MATH 18,B01,083748,Staff,0,15,30,30
1650972964046,MATH 18,B02,083749,Staff,0,14,30,30
1650972964046,MATH 18,B03,083750,Staff,0,13,30,30
1650972964046,MATH 18,B04,083751,Staff,0,13,30,30
1650972970070,MATH 20A,A01,083754,Staff,19,0,40,21
1650972976096,MATH 20B,A01,083756,Staff,0,14,30,30
1650972976096,MATH 20B,A02,083757,Staff,0,11,30,30
1650972982121,MATH 20C,A01,083760,Staff,0,17,30,30
1650972982121,MATH 20C,A02,083761,Staff,0,15,30,30
1650972982121,MATH 20C,B01,083762,Staff,9,0,30,21
1650972982121,MATH 20C,B02,083763,Staff,28,0,30,2
1650972988149,MATH 20D,A01,083765,Staff,2,1,30,28
1650972988149,MATH 20D,A02,083766,Staff,2,0,30,28
1650972988149,MATH 20D,A03,083767,Staff,22,0,30,8
1650972994181,MATH 20E,A01,083771,Staff,2,0,30,28
1650972994181,MATH 20E,A02,083772,Staff,13,0,30,17
1650972994181,MATH 20E,B01,083773,Staff,0,0,30,30
1650972994181,MATH 20E,B02,083774,Staff,1,0,30,29
1650973000206,MATH 103A,A01,083777,Staff,0,17,30,30
1650973000206,MATH 103A,A02,083778,Staff,0,15,30,30
1650973000206,MATH 103A,B01,083779,Staff,0,15,30,30
1650973000206,MATH 103A,B02,083780,Staff,0,14,30,30
1650973006245,MATH 105,A01,085443,Staff,0,23,30,30
1650973012277,MATH 109,A01,083213,Anzaldo; Leesa B,0,7,30,30
1650973012277,MATH 109,A02,083214,Anzaldo; Leesa B,0,7,30,30
1650973012277,MATH 109,B01,083215,Anzaldo; Leesa B,0,8,30,30
1650973012277,MATH 109,B02,083216,Anzaldo; Leesa B,0,7,30,30
1650973018309,MATH 142A,A01,083219,Chow; Bennett,0,14,30,30
1650973018309,MATH 142A,A02,083220,Chow; Bennett,0,15,30,30
1650973018309,MATH 142A,B01,083221,Chow; Bennett,0,16,30,30
1650973018309,MATH 142A,B02,083222,Chow; Bennett,0,14,30,30
1650973024334,MATH 193A,A01,083224,Staff,0,6,30,30
1650973024334,MATH 193A,A02,083225,Staff,0,7,30,30
1650973024334,MATH 193A,A03,083781,Staff,0,6,30,30
1650973024334,MATH 193A,A04,083782,Staff,0,7,30,30
1650973030360,MATH 197,001,091859,McAuley; Julian John,9998,0,9999,1
1650973036435,COGS 9,A01,083615,Staff,0,18,60,60
1650973042465,COGS 11,A01,083617,Boyle; Mary E. T.,15,0,40,25
1650973048491,COGS 13,A01,083071,Staff,0,41,40,40
1650973054521,COGS 14A,A01,092681,Staff,0,38,100,100
1650973060769,COGS 14B,A01,083073,Cheng; Tzu-Han,0,13,50,50
1650973066795,COGS 17,A01,092677,Staff,6,0,75,69
1650973072826,COGS 100,A01,083619,Staff,0,31,60,60
1650973078857,COGS 101A,A01,083621,Davis; Joshua Daniel,0,29,60,60
1650973084884,COGS 101B,A01,091572,Staff,0,5,60,60
1650973091029,COGS 101C,A01,083625,Delgado; Tania,14,0,30,16
1650973097064,COGS 107A,A01,083627,Boyle; Mary E. T.,0,16,60,60
1650973103090,COGS 118A,A01,083075,Staff,0,10,60,60
1650973109126,CSE 3,A50,083646,Miranda; Gregory Joseph,15,0,38,23
1650973109126,CSE 3,A51,083647,Miranda; Gregory Joseph,36,0,37,1
1650973115158,CSE 8A,A50,083650,Miranda; Gregory Joseph,0,31,40,40
1650973121189,CSE 11,A01,083080,Cao; Yingjun,0,98,40,40
1650973127219,CSE 12,A01,083652,Staff,0,24,100,100
1650973133253,CSE 15L,A01,083654,Staff,0,3,50,50
1650973133253,CSE 15L,A02,083655,Staff,0,3,50,50
1650973139294,CSE 20,A01,083657,Staff,47,0,80,33
1650973145327,CSE 30,A01,083084,Eldon; John,1,38,80,79
1650973151359,CSE 100,A01,083659,Cao; Yingjun,0,71,50,50
1650973157385,CSE 134B,A01,083661,Powell; Thomas Allan,1,40,65,64
1650973163409,CSE 140,A01,083663,Staff,0,13,75,75
1650973169434,CSE 140L,A01,083088,Eldon; John,4,0,100,96
1650973175461,CSE 175,A01,083665,Kumar; Rakesh,0,0,25,25
1650973181486,CSE 190,A00,092507,Dubnov; Shlomo,9,0,20,11
1650973187514,ECE 45,A01,083139,Staff,0,6,60,60
1650973193543,ECE 65,A50,083695,Staff,0,7,30,30
1650973199574,ECE 109,A01,091882,Touri; Behrouz,32,0,70,38
1650973205600,ECE 180,A00,083140,Abi Samra; Nicholas Camill,18,0,30,12
1650973205600,ECE 180,B00,083141,Abi Samra; Nicholas Camill,0,0,30,30
1650973211626,MATH 10A,A01,083735,Patchell; Gregory David,2,0,30,28
1650973211626,MATH 10A,A02,083736,Patchell; Gregory David,27,0,30,3
1650973211626,MATH 10A,A03,083737,Patchell; Gregory David,23,0,30,7
1650973217652,MATH 10B,A01,083207,Staff,0,9,30,30
1650973217652,MATH 10B,A02,083208,Staff,0,5,30,30
1650973217652,MATH 10B,B01,083739,Staff,9,0,30,21
1650973217652,MATH 10B,B02,083740,Staff,28,0,30,2
1650973223690,MATH 18,A01,083743,Staff,0,0,30,30
1650973223690,MATH 18,A02,083744,Staff,24,0,30,6
1650973223690,MATH 18,A03,083745,Staff,19,0,30,11
1650973223690,MATH 18,A04,083746,Staff,26,0,30,4
1650973223690,MATH 18,B01,083748,Staff,0,15,30,30
1650973223690,MATH 18,B02,083749,Staff,0,14,30,30
1650973223690,MATH 18,B03,083750,Staff,0,13,30,30
1650973223690,MATH 18,B04,083751,Staff,0,13,30,30
1650973229720,MATH 20A,A01,083754,Staff,19,0,40,21
1650973235747,MATH 20B,A01,083756,Staff,0,14,30,30
1650973235747,MATH 20B,A02,083757,Staff,0,11,30,30
1650973241776,MATH 20C,A01,083760,Staff,0,17,30,30
1650973241776,MATH 20C,A02,083761,Staff,0,15,30,30
1650973241776,MATH 20C,B01,083762,Staff,9,0,30,21
1650973241776,MATH 20C,B02,083763,Staff,28,0,30,2
1650973247801,MATH 20D,A01,083765,Staff,2,1,30,28
1650973247801,MATH 20D,A02,083766,Staff,2,0,30,28
1650973247801,MATH 20D,A03,083767,Staff,22,0,30,8
1650973253830,MATH 20E,A01,083771,Staff,2,0,30,28
1650973253830,MATH 20E,A02,083772,Staff,13,0,30,17
1650973253830,MATH 20E,B01,083773,Staff,0,0,30,30
1650973253830,MATH 20E,B02,083774,Staff,1,0,30,29
1650973259859,MATH 103A,A01,083777,Staff,0,17,30,30
1650973259859,MATH 103A,A02,083778,Staff,0,15,30,30
1650973259859,MATH 103A,B01,083779,Staff,0,15,30,30
1650973259859,MATH 103A,B02,083780,Staff,0,14,30,30
1650973265884,MATH 105,A01,085443,Staff,0,23,30,30
1650973271910,MATH 109,A01,083213,Anzaldo; Leesa B,0,7,30,30
1650973271910,MATH 109,A02,083214,Anzaldo; Leesa B,0,7,30,30
1650973271910,MATH 109,B01,083215,Anzaldo; Leesa B,0,8,30,30
1650973271910,MATH 109,B02,083216,Anzaldo; Leesa B,0,7,30,30
1650973277943,MATH 142A,A01,083219,Chow; Bennett,0,14,30,30
1650973277943,MATH 142A,A02,083220,Chow; Bennett,0,15,30,30
1650973277943,MATH 142A,B01,083221,Chow; Bennett,0,16,30,30
1650973277943,MATH 142A,B02,083222,Chow; Bennett,0,14,30,30
1650973283968,MATH 193A,A01,083224,Staff,0,6,30,30
1650973283968,MATH 193A,A02,083225,Staff,0,7,30,30
1650973283968,MATH 193A,A03,083781,Staff,0,6,30,30
1650973283968,MATH 193A,A04,083782,Staff,0,7,30,30
1650973289995,MATH 197,001,091859,McAuley; Julian John,9998,0,9999,1
1650973296064,COGS 9,A01,083615,Staff,0,18,60,60
1650973302095,COGS 11,A01,083617,Boyle; Mary E. T.,15,0,40,25
1650973308124,COGS 13,A01,083071,Staff,0,41,40,40
1650973314149,COGS 14A,A01,092681,Staff,0,38,100,100
1650973320178,COGS 14B,A01,083073,Cheng; Tzu-Han,0,13,50,50
1650973326206,COGS 17,A01,092677,Staff,6,0,75,69
1650973332235,COGS 100,A01,083619,Staff,0,31,60,60
1650973338261,COGS 101A,A01,083621,Davis; Joshua Daniel,0,29,60,60
1650973344291,COGS 101B,A01,091572,Staff,0,5,60,60
1650973350317,COGS 101C,A01,083625,Delgado; Tania,14,0,30,16
1650973356342,COGS 107A,A01,083627,Boyle; Mary E. T.,0,16,60,60
1650973362367,COGS 118A,A01,083075,Staff,0,10,60,60
1650973368401,CSE 3,A50,083646,Miranda; Gregory Joseph,15,0,38,23
1650973368401,CSE 3,A51,083647,Miranda; Gregory Joseph,36,0,37,1
1650973374427,CSE 8A,A50,083650,Miranda; Gregory Joseph,0,31,40,40
1650973380454,CSE 11,A01,083080,Cao; Yingjun,0,98,40,40
1650973386482,CSE 12,A01,083652,Staff,0,24,100,100
1650973392516,CSE 15L,A01,083654,Staff,0,3,50,50
1650973392516,CSE 15L,A02,083655,Staff,0,3,50,50
1650973398543,CSE 20,A01,083657,Staff,47,0,80,33
1650973404577,CSE 30,A01,083084,Eldon; John,1,38,80,79
1650973410613,CSE 100,A01,083659,Cao; Yingjun,0,71,50,50
1650973416638,CSE 134B,A01,083661,Powell; Thomas Allan,1,40,65,64
1650973422663,CSE 140,A01,083663,Staff,0,13,75,75
1650973428692,CSE 140L,A01,083088,Eldon; John,4,0,100,96
1650973434718,CSE 175,A01,083665,Kumar; Rakesh,0,0,25,25
1650973440751,CSE 190,A00,092507,Dubnov; Shlomo,9,0,20,11
1650973446788,ECE 45,A01,083139,Staff,0,6,60,60
1650973452831,ECE 65,A50,083695,Staff,0,7,30,30
1650973458873,ECE 109,A01,091882,Touri; Behrouz,32,0,70,38
1650973464905,ECE 180,A00,083140,Abi Samra; Nicholas Camill,18,0,30,12
1650973464905,ECE 180,B00,083141,Abi Samra; Nicholas Camill,0,0,30,30
1650973470935,MATH 10A,A01,083735,Patchell; Gregory David,2,0,30,28
1650973470935,MATH 10A,A02,083736,Patchell; Gregory David,27,0,30,3
1650973470935,MATH 10A,A03,083737,Patchell; Gregory David,23,0,30,7
1650973476967,MATH 10B,A01,083207,Staff,0,9,30,30
1650973476967,MATH 10B,A02,083208,Staff,0,5,30,30
1650973476967,MATH 10B,B01,083739,Staff,9,0,30,21
1650973476967,MATH 10B,B02,083740,Staff,28,0,30,2
1650973483011,MATH 18,A01,083743,Staff,0,0,30,30
1650973483011,MATH 18,A02,083744,Staff,24,0,30,6
1650973483011,MATH 18,A03,083745,Staff,19,0,30,11
1650973483011,MATH 18,A04,083746,Staff,26,0,30,4
1650973483011,MATH 18,B01,083748,Staff,0,15,30,30
1650973483011,MATH 18,B02,083749,Staff,0,14,30,30
1650973483011,MATH 18,B03,083750,Staff,0,13,30,30
1650973483011,MATH 18,B04,083751,Staff,0,13,30,30
1650973489038,MATH 20A,A01,083754,Staff,19,0,40,21
1650973495066,MATH 20B,A01,083756,Staff,0,14,30,30
1650973495066,MATH 20B,A02,083757,Staff,0,11,30,30
1650973501100,MATH 20C,A01,083760,Staff,0,17,30,30
1650973501100,MATH 20C,A02,083761,Staff,0,15,30,30
1650973501100,MATH 20C,B01,083762,Staff,9,0,30,21
1650973501100,MATH 20C,B02,083763,Staff,28,0,30,2
1650973507124,MATH 20D,A01,083765,Staff,2,1,30,28
1650973507124,MATH 20D,A02,083766,Staff,2,0,30,28
1650973507124,MATH 20D,A03,083767,Staff,22,0,30,8
1650973513151,MATH 20E,A01,083771,Staff,2,0,30,28
1650973513151,MATH 20E,A02,083772,Staff,13,0,30,17
1650973513151,MATH 20E,B01,083773,Staff,0,0,30,30
1650973513151,MATH 20E,B02,083774,Staff,1,0,30,29
1650973519178,MATH 103A,A01,083777,Staff,0,17,30,30
1650973519178,MATH 103A,A02,083778,Staff,0,15,30,30
1650973519178,MATH 103A,B01,083779,Staff,0,15,30,30
1650973519178,MATH 103A,B02,083780,Staff,0,14,30,30
1650973525211,MATH 105,A01,085443,Staff,0,23,30,30
1650973531239,MATH 109,A01,083213,Anzaldo; Leesa B,0,7,30,30
1650973531239,MATH 109,A02,083214,Anzaldo; Leesa B,0,7,30,30
1650973531239,MATH 109,B01,083215,Anzaldo; Leesa B,0,8,30,30
1650973531239,MATH 109,B02,083216,Anzaldo; Leesa B,0,7,30,30
1650973537266,MATH 142A,A01,083219,Chow; Bennett,0,14,30,30
1650973537266,MATH 142A,A02,083220,Chow; Bennett,0,15,30,30
1650973537266,MATH 142A,B01,083221,Chow; Bennett,0,16,30,30
1650973537266,MATH 142A,B02,083222,Chow; Bennett,0,14,30,30
1650973543293,MATH 193A,A01,083224,Staff,0,6,30,30
1650973543293,MATH 193A,A02,083225,Staff,0,7,30,30
1650973543293,MATH 193A,A03,083781,Staff,0,6,30,30
1650973543293,MATH 193A,A04,083782,Staff,0,7,30,30
1650973549320,MATH 197,001,091859,McAuley; Julian John,9998,0,9999,1
1650973555378,COGS 9,A01,083615,Staff,0,18,60,60
1650973561409,COGS 11,A01,083617,Boyle; Mary E. T.,15,0,40,25
1650973567439,COGS 13,A01,083071,Staff,0,41,40,40
1650973573465,COGS 14A,A01,092681,Staff,0,38,100,100
1650973579491,COGS 14B,A01,083073,Cheng; Tzu-Han,0,13,50,50
1650973585518,COGS 17,A01,092677,Staff,6,0,75,69
1650973591544,COGS 100,A01,083619,Staff,0,31,60,60
1650973597572,COGS 101A,A01,083621,Davis; Joshua Daniel,0,29,60,60
1650973603604,COGS 101B,A01,091572,Staff,0,5,60,60
1650973609646,COGS 101C,A01,083625,Delgado; Tania,14,0,30,16
1650973615673,COGS 107A,A01,083627,Boyle; Mary E. T.,0,16,60,60
1650973621696,COGS 118A,A01,083075,Staff,0,10,60,60
1650973627728,CSE 3,A50,083646,Miranda; Gregory Joseph,15,0,38,23
1650973627728,CSE 3,A51,083647,Miranda; Gregory Joseph,36,0,37,1
1650973633753,CSE 8A,A50,083650,Miranda; Gregory Joseph,0,31,40,40
1650973639778,CSE 11,A01,083080,Cao; Yingjun,0,98,40,40
1650973645805,CSE 12,A01,083652,Staff,0,24,100,100
1650973651829,CSE 15L,A01,083654,Staff,0,3,50,50
1650973651829,CSE 15L,A02,083655,Staff,0,3,50,50
1650973657864,CSE 20,A01,083657,Staff,47,0,80,33
1650973663890,CSE 30,A01,083084,Eldon; John,1,38,80,79
1650973669921,CSE 100,A01,083659,Cao; Yingjun,0,71,50,50
1650973675946,CSE 134B,A01,083661,Powell; Thomas Allan,1,40,65,64
1650973681971,CSE 140,A01,083663,Staff,0,13,75,75
1650973688088,CSE 140L,A01,083088,Eldon; John,4,0,100,96
1650973694124,CSE 175,A01,083665,Kumar; Rakesh,0,0,25,25
1650973700156,CSE 190,A00,092507,Dubnov; Shlomo,9,0,20,11
1650973706180,ECE 45,A01,083139,Staff,0,6,60,60
1650973712208,ECE 65,A50,083695,Staff,0,7,30,30
1650973718239,ECE 109,A01,091882,Touri; Behrouz,32,0,70,38
1650973724270,ECE 180,A00,083140,Abi Samra; Nicholas Camill,18,0,30,12
1650973724270,ECE 180,B00,083141,Abi Samra; Nicholas Camill,0,0,30,30
1650973730297,MATH 10A,A01,083735,Patchell; Gregory David,2,0,30,28
1650973730297,MATH 10A,A02,083736,Patchell; Gregory David,27,0,30,3
1650973730297,MATH 10A,A03,083737,Patchell; Gregory David,23,0,30,7
1650973736323,MATH 10B,A01,083207,Staff,0,9,30,30
1650973736323,MATH 10B,A02,083208,Staff,0,5,30,30
1650973736323,MATH 10B,B01,083739,Staff,9,0,30,21
1650973736323,MATH 10B,B02,083740,Staff,28,0,30,2
1650973742355,MATH 18,A01,083743,Staff,0,0,30,30
1650973742355,MATH 18,A02,083744,Staff,24,0,30,6
1650973742355,MATH 18,A03,083745,Staff,19,0,30,11
1650973742355,MATH 18,A04,083746,Staff,26,0,30,4
1650973742355,MATH 18,B01,083748,Staff,0,15,30,30
1650973742355,MATH 18,B02,083749,Staff,0,14,30,30
1650973742355,MATH 18,B03,083750,Staff,0,13,30,30
1650973742355,MATH 18,B04,083751,Staff,0,13,30,30
1650973748379,MATH 20A,A01,083754,Staff,19,0,40,21
1650973754410,MATH 20B,A01,083756,Staff,0,14,30,30
1650973754410,MATH 20B,A02,083757,Staff,0,11,30,30
1650973760441,MATH 20C,A01,083760,Staff,0,17,30,30
1650973760441,MATH 20C,A02,083761,Staff,0,15,30,30
1650973760441,MATH 20C,B01,083762,Staff,9,0,30,21
1650973760441,MATH 20C,B02,083763,Staff,28,0,30,2
1650973766468,MATH 20D,A01,083765,Staff,2,1,30,28
1650973766468,MATH 20D,A02,083766,Staff,2,0,30,28
1650973766468,MATH 20D,A03,083767,Staff,22,0,30,8
1650973772492,MATH 20E,A01,083771,Staff,2,0,30,28
1650973772492,MATH 20E,A02,083772,Staff,13,0,30,17
1650973772492,MATH 20E,B01,083773,Staff,0,0,30,30
1650973772492,MATH 20E,B02,083774,Staff,1,0,30,29
1650973778519,MATH 103A,A01,083777,Staff,0,17,30,30
1650973778519,MATH 103A,A02,083778,Staff,0,15,30,30
1650973778519,MATH 103A,B01,083779,Staff,0,15,30,30
1650973778519,MATH 103A,B02,083780,Staff,0,14,30,30
1650973784547,MATH 105,A01,085443,Staff,0,23,30,30
1650973790574,MATH 109,A01,083213,Anzaldo; Leesa B,0,7,30,30
1650973790574,MATH 109,A02,083214,Anzaldo; Leesa B,0,7,30,30
1650973790574,MATH 109,B01,083215,Anzaldo; Leesa B,0,8,30,30
1650973790574,MATH 109,B02,083216,Anzaldo; Leesa B,0,7,30,30
1650973796605,MATH 142A,A01,083219,Chow; Bennett,0,14,30,30
1650973796605,MATH 142A,A02,083220,Chow; Bennett,0,15,30,30
1650973796605,MATH 142A,B01,083221,Chow; Bennett,0,16,30,30
1650973796605,MATH 142A,B02,083222,Chow; Bennett,0,14,30,30
1650973802636,MATH 193A,A01,083224,Staff,0,6,30,30
1650973802636,MATH 193A,A02,083225,Staff,0,7,30,30
1650973802636,MATH 193A,A03,083781,Staff,0,6,30,30
1650973802636,MATH 193A,A04,083782,Staff,0,7,30,30
1650973808660,MATH 197,001,091859,McAuley; Julian John,9998,0,9999,1
1650973814737,COGS 9,A01,083615,Staff,0,18,60,60
1650973820763,COGS 11,A01,083617,Boyle; Mary E. T.,15,0,40,25
1650973826789,COGS 13,A01,083071,Staff,0,41,40,40
1650973832814,COGS 14A,A01,092681,Staff,0,38,100,100
1650973838839,COGS 14B,A01,083073,Cheng; Tzu-Han,0,13,50,50
1650973844867,COGS 17,A01,092677,Staff,6,0,75,69
1650973850892,COGS 100,A01,083619,Staff,0,31,60,60
1650973856917,COGS 101A,A01,083621,Davis; Joshua Daniel,0,29,60,60
1650973862942,COGS 101B,A01,091572,Staff,0,5,60,60
1650973868972,COGS 101C,A01,083625,Delgado; Tania,14,0,30,16
1650973874996,COGS 107A,A01,083627,Boyle; Mary E. T.,0,16,60,60
1650973881023,COGS 118A,A01,083075,Staff,0,10,60,60
1650973887054,CSE 3,A50,083646,Miranda; Gregory Joseph,15,0,38,23
1650973887054,CSE 3,A51,083647,Miranda; Gregory Joseph,36,0,37,1
1650973893081,CSE 8A,A50,083650,Miranda; Gregory Joseph,0,31,40,40
1650973899109,CSE 11,A01,083080,Cao; Yingjun,0,98,40,40
1650973905135,CSE 12,A01,083652,Staff,0,24,100,100
1650973911162,CSE 15L,A01,083654,Staff,0,3,50,50
1650973911162,CSE 15L,A02,083655,Staff,0,3,50,50
1650973917195,CSE 20,A01,083657,Staff,47,0,80,33
1650973923222,CSE 30,A01,083084,Eldon; John,1,38,80,79
1650973929254,CSE 100,A01,083659,Cao; Yingjun,0,71,50,50
1650973935284,CSE 134B,A01,083661,Powell; Thomas Allan,1,40,65,64
1650973941312,CSE 140,A01,083663,Staff,0,13,75,75
1650973947341,CSE 140L,A01,083088,Eldon; John,4,0,100,96
1650973953370,CSE 175,A01,083665,Kumar; Rakesh,0,0,25,25
1650973959397,CSE 190,A00,092507,Dubnov; Shlomo,9,0,20,11
1650973965424,ECE 45,A01,083139,Staff,0,6,60,60
1650973971455,ECE 65,A50,083695,Staff,0,7,30,30
1650973977486,ECE 109,A01,091882,Touri; Behrouz,32,0,70,38
1650973983512,ECE 180,A00,083140,Abi Samra; Nicholas Camill,18,0,30,12
1650973983512,ECE 180,B00,083141,Abi Samra; Nicholas Camill,0,0,30,30
1650973989542,MATH 10A,A01,083735,Patchell; Gregory David,2,0,30,28
1650973989542,MATH 10A,A02,083736,Patchell; Gregory David,27,0,30,3
1650973989542,MATH 10A,A03,083737,Patchell; Gregory David,23,0,30,7
1650973995569,MATH 10B,A01,083207,Staff,0,9,30,30
1650973995569,MATH 10B,A02,083208,Staff,0,5,30,30
1650973995569,MATH 10B,B01,083739,Staff,9,0,30,21
1650973995569,MATH 10B,B02,083740,Staff,28,0,30,2
1650974001602,MATH 18,A01,083743,Staff,0,0,30,30
1650974001602,MATH 18,A02,083744,Staff,24,0,30,6
1650974001602,MATH 18,A03,083745,Staff,19,0,30,11
1650974001602,MATH 18,A04,083746,Staff,26,0,30,4
1650974001602,MATH 18,B01,083748,Staff,0,15,30,30
1650974001602,MATH 18,B02,083749,Staff,0,14,30,30
1650974001602,MATH 18,B03,083750,Staff,0,13,30,30
1650974001602,MATH 18,B04,083751,Staff,0,13,30,30
1650974007627,MATH 20A,A01,083754,Staff,19,0,40,21
1650974013657,MATH 20B,A01,083756,Staff,0,14,30,30
1650974013657,MATH 20B,A02,083757,Staff,0,11,30,30
1650974019681,MATH 20C,A01,083760,Staff,0,17,30,30
1650974019681,MATH 20C,A02,083761,Staff,0,15,30,30
1650974019681,MATH 20C,B01,083762,Staff,9,0,30,21
1650974019681,MATH 20C,B02,083763,Staff,28,0,30,2
1650974025710,MATH 20D,A01,083765,Staff,2,1,30,28
1650974025710,MATH 20D,A02,083766,Staff,2,0,30,28
1650974025710,MATH 20D,A03,083767,Staff,22,0,30,8
1650974031743,MATH 20E,A01,083771,Staff,2,0,30,28
1650974031743,MATH 20E,A02,083772,Staff,13,0,30,17
1650974031743,MATH 20E,B01,083773,Staff,0,0,30,30
1650974031743,MATH 20E,B02,083774,Staff,1,0,30,29
1650974037773,MATH 103A,A01,083777,Staff,0,17,30,30
1650974037773,MATH 103A,A02,083778,Staff,0,15,30,30
1650974037773,MATH 103A,B01,083779,Staff,0,15,30,30
1650974037773,MATH 103A,B02,083780,Staff,0,14,30,30
1650974043800,MATH 105,A01,085443,Staff,0,23,30,30
1650974049832,MATH 109,A01,083213,Anzaldo; Leesa B,0,7,30,30
1650974049832,MATH 109,A02,083214,Anzaldo; Leesa B,0,7,30,30
1650974049832,MATH 109,B01,083215,Anzaldo; Leesa B,0,8,30,30
1650974049832,MATH 109,B02,083216,Anzaldo; Leesa B,0,7,30,30
1650974055865,MATH 142A,A01,083219,Chow; Bennett,0,14,30,30
1650974055865,MATH 142A,A02,083220,Chow; Bennett,0,15,30,30
1650974055865,MATH 142A,B01,083221,Chow; Bennett,0,16,30,30
1650974055865,MATH 142A,B02,083222,Chow; Bennett,0,14,30,30
1650974061908,MATH 193A,A01,083224,Staff,0,6,30,30
1650974061908,MATH 193A,A02,083225,Staff,0,7,30,30
1650974061908,MATH 193A,A03,083781,Staff,0,6,30,30
1650974061908,MATH 193A,A04,083782,Staff,0,7,30,30
1650974067933,MATH 197,001,091859,McAuley; Julian John,9998,0,9999,1
1650974074001,COGS 9,A01,083615,Staff,0,18,60,60
1650974080026,COGS 11,A01,083617,Boyle; Mary E. T.,15,0,40,25
1650974086055,COGS 13,A01,083071,Staff,0,41,40,40
1650974092079,COGS 14A,A01,092681,Staff,0,38,100,100
1650974098111,COGS 14B,A01,083073,Cheng; Tzu-Han,0,13,50,50
1650974104136,COGS 17,A01,092677,Staff,6,0,75,69
1650974110158,COGS 100,A01,083619,Staff,0,31,60,60
1650974116187,COGS 101A,A01,083621,Davis; Joshua Daniel,0,29,60,60
1650974122215,COGS 101B,A01,091572,Staff,0,5,60,60
1650974128245,COGS 101C,A01,083625,Delgado; Tania,14,0,30,16
1650974134273,COGS 107A,A01,083627,Boyle; Mary E. T.,0,16,60,60
1650974140298,COGS 118A,A01,083075,Staff,0,10,60,60
1650974146329,CSE 3,A50,083646,Miranda; Gregory Joseph,15,0,38,23
1650974146329,CSE 3,A51,083647,Miranda; Gregory Joseph,36,0,37,1
1650974152362,CSE 8A,A50,083650,Miranda; Gregory Joseph,0,31,40,40
1650974158387,CSE 11,A01,083080,Cao; Yingjun,0,98,40,40
1650974164415,CSE 12,A01,083652,Staff,0,24,100,100
1650974170531,CSE 15L,A01,083654,Staff,0,3,50,50
1650974170531,CSE 15L,A02,083655,Staff,0,3,50,50
1650974176556,CSE 20,A01,083657,Staff,47,0,80,33
1650974182584,CSE 30,A01,083084,Eldon; John,1,38,80,79
1650974188611,CSE 100,A01,083659,Cao; Yingjun,0,71,50,50
1650974194637,CSE 134B,A01,083661,Powell; Thomas Allan,1,40,65,64
1650974200671,CSE 140,A01,083663,Staff,0,13,75,75
1650974206695,CSE 140L,A01,083088,Eldon; John,4,0,100,96
1650974212729,CSE 175,A01,083665,Kumar; Rakesh,0,0,25,25
1650974218758,CSE 190,A00,092507,Dubnov; Shlomo,9,0,20,11
1650974224789,ECE 45,A01,083139,Staff,0,6,60,60
1650974230818,ECE 65,A50,083695,Staff,0,7,30,30
1650974236845,ECE 109,A01,091882,Touri; Behrouz,32,0,70,38
1650974242873,ECE 180,A00,083140,Abi Samra; Nicholas Camill,18,0,30,12
1650974242873,ECE 180,B00,083141,Abi Samra; Nicholas Camill,0,0,30,30
1650974248909,MATH 10A,A01,083735,Patchell; Gregory David,2,0,30,28
1650974248909,MATH 10A,A02,083736,Patchell; Gregory David,27,0,30,3
1650974248909,MATH 10A,A03,083737,Patchell; Gregory David,23,0,30,7
1650974254940,MATH 10B,A01,083207,Staff,0,9,30,30
1650974254940,MATH 10B,A02,083208,Staff,0,5,30,30
1650974254940,MATH 10B,B01,083739,Staff,9,0,30,21
1650974254940,MATH 10B,B02,083740,Staff,28,0,30,2
1650974260969,MATH 18,A01,083743,Staff,0,0,30,30
1650974260969,MATH 18,A02,083744,Staff,24,0,30,6
1650974260969,MATH 18,A03,083745,Staff,19,0,30,11
1650974260969,MATH 18,A04,083746,Staff,26,0,30,4
1650974260969,MATH 18,B01,083748,Staff,0,15,30,30
1650974260969,MATH 18,B02,083749,Staff,0,14,30,30
1650974260969,MATH 18,B03,083750,Staff,0,13,30,30
1650974260969,MATH 18,B04,083751,Staff,0,13,30,30
1650974266993,MATH 20A,A01,083754,Staff,19,0,40,21
1650974273018,MATH 20B,A01,083756,Staff,0,14,30,30
1650974273018,MATH 20B,A02,083757,Staff,0,11,30,30
1650974279048,MATH 20C,A01,083760,Staff,0,17,30,30
1650974279048,MATH 20C,A02,083761,Staff,0,15,30,30
1650974279048,MATH 20C,B01,083762,Staff,9,0,30,21
1650974279048,MATH 20C,B02,083763,Staff,28,0,30,2
1650974285166,MATH 20D,A01,083765,Staff,2,1,30,28
1650974285166,MATH 20D,A02,083766,Staff,2,0,30,28
1650974285166,MATH 20D,A03,083767,Staff,22,0,30,8
1650974291199,MATH 20E,A01,083771,Staff,2,0,30,28
1650974291199,MATH 20E,A02,083772,Staff,13,0,30,17
1650974291199,MATH 20E,B01,083773,Staff,0,0,30,30
1650974291199,MATH 20E,B02,083774,Staff,1,0,30,29
1650974297237,MATH 103A,A01,083777,Staff,0,17,30,30
1650974297237,MATH 103A,A02,083778,Staff,0,15,30,30
1650974297237,MATH 103A,B01,083779,Staff,0,15,30,30
1650974297237,MATH 103A,B02,083780,Staff,0,14,30,30
1650974303271,MATH 105,A01,085443,Staff,0,23,30,30
1650974309298,MATH 109,A01,083213,Anzaldo; Leesa B,0,7,30,30
1650974309298,MATH 109,A02,083214,Anzaldo; Leesa B,0,7,30,30
1650974309298,MATH 109,B01,083215,Anzaldo; Leesa B,0,8,30,30
1650974309298,MATH 109,B02,083216,Anzaldo; Leesa B,0,7,30,30
1650974315325,MATH 142A,A01,083219,Chow; Bennett,0,14,30,30
1650974315325,MATH 142A,A02,083220,Chow; Bennett,0,15,30,30
1650974315325,MATH 142A,B01,083221,Chow; Bennett,0,16,30,30
1650974315325,MATH 142A,B02,083222,Chow; Bennett,0,14,30,30
1650974321352,MATH 193A,A01,083224,Staff,0,6,30,30
1650974321352,MATH 193A,A02,083225,Staff,0,7,30,30
1650974321352,MATH 193A,A03,083781,Staff,0,6,30,30
1650974321352,MATH 193A,A04,083782,Staff,0,7,30,30
1650974327378,MATH 197,001,091859,McAuley; Julian John,9998,0,9999,1
1650974333453,COGS 9,A01,083615,Staff,0,18,60,60
1650974339480,COGS 11,A01,083617,Boyle; Mary E. T.,15,0,40,25
1650974345505,COGS 13,A01,083071,Staff,0,41,40,40
1650974351531,COGS 14A,A01,092681,Staff,0,38,100,100
1650974357555,COGS 14B,A01,083073,Cheng; Tzu-Han,0,13,50,50
1650974363579,COGS 17,A01,092677,Staff,6,0,75,69
1650974369612,COGS 100,A01,083619,Staff,0,31,60,60
1650974375639,COGS 101A,A01,083621,Davis; Joshua Daniel,0,29,60,60
1650974381666,COGS 101B,A01,091572,Staff,0,5,60,60
1650974387705,COGS 101C,A01,083625,Delgado; Tania,14,0,30,16
1650974393733,COGS 107A,A01,083627,Boyle; Mary E. T.,0,16,60,60
1650974399761,COGS 118A,A01,083075,Staff,0,10,60,60
1650974405793,CSE 3,A50,083646,Miranda; Gregory Joseph,15,0,38,23
1650974405793,CSE 3,A51,083647,Miranda; Gregory Joseph,36,0,37,1
1650974411825,CSE 8A,A50,083650,Miranda; Gregory Joseph,0,31,40,40
1650974417850,CSE 11,A01,083080,Cao; Yingjun,0,98,40,40
1650974423877,CSE 12,A01,083652,Staff,0,24,100,100
1650974429913,CSE 15L,A01,083654,Staff,0,3,50,50
1650974429913,CSE 15L,A02,083655,Staff,0,3,50,50
1650974435938,CSE 20,A01,083657,Staff,47,0,80,33
1650974441962,CSE 30,A01,083084,Eldon; John,1,38,80,79
1650974447985,CSE 100,A01,083659,Cao; Yingjun,0,71,50,50
1650974454020,CSE 134B,A01,083661,Powell; Thomas Allan,1,40,65,64
1650974460045,CSE 140,A01,083663,Staff,0,13,75,75
1650974466070,CSE 140L,A01,083088,Eldon; John,4,0,100,96
1650974472103,CSE 175,A01,083665,Kumar; Rakesh,0,0,25,25
1650974478128,CSE 190,A00,092507,Dubnov; Shlomo,9,0,20,11
1650974484154,ECE 45,A01,083139,Staff,0,6,60,60
1650974490177,ECE 65,A50,083695,Staff,0,7,30,30
1650974496202,ECE 109,A01,091882,Touri; Behrouz,32,0,70,38
1650974502229,ECE 180,A00,083140,Abi Samra; Nicholas Camill,18,0,30,12
1650974502229,ECE 180,B00,083141,Abi Samra; Nicholas Camill,0,0,30,30
1650974508259,MATH 10A,A01,083735,Patchell; Gregory David,2,0,30,28
1650974508259,MATH 10A,A02,083736,Patchell; Gregory David,27,0,30,3
1650974508259,MATH 10A,A03,083737,Patchell; Gregory David,23,0,30,7
1650974514285,MATH 10B,A01,083207,Staff,0,9,30,30
1650974514285,MATH 10B,A02,083208,Staff,0,5,30,30
1650974514285,MATH 10B,B01,083739,Staff,9,0,30,21
1650974514285,MATH 10B,B02,083740,Staff,28,0,30,2
1650974520334,MATH 18,A01,083743,Staff,0,0,30,30
1650974520334,MATH 18,A02,083744,Staff,24,0,30,6
1650974520334,MATH 18,A03,083745,Staff,19,0,30,11
1650974520334,MATH 18,A04,083746,Staff,26,0,30,4
1650974520334,MATH 18,B01,083748,Staff,0,15,30,30
1650974520334,MATH 18,B02,083749,Staff,0,14,30,30
1650974520334,MATH 18,B03,083750,Staff,0,13,30,30
1650974520334,MATH 18,B04,083751,Staff,0,13,30,30
1650974526359,MATH 20A,A01,083754,Staff,19,0,40,21
1650974532419,MATH 20B,A01,083756,Staff,0,14,30,30
1650974532419,MATH 20B,A02,083757,Staff,0,11,30,30
1650974538451,MATH 20C,A01,083760,Staff,0,17,30,30
1650974538451,MATH 20C,A02,083761,Staff,0,15,30,30
1650974538451,MATH 20C,B01,083762,Staff,9,0,30,21
1650974538451,MATH 20C,B02,083763,Staff,28,0,30,2
1650974544477,MATH 20D,A01,083765,Staff,2,1,30,28
1650974544477,MATH 20D,A02,083766,Staff,2,0,30,28
1650974544477,MATH 20D,A03,083767,Staff,22,0,30,8
1650974550503,MATH 20E,A01,083771,Staff,2,0,30,28
1650974550503,MATH 20E,A02,083772,Staff,13,0,30,17
1650974550503,MATH 20E,B01,083773,Staff,0,0,30,30
1650974550503,MATH 20E,B02,083774,Staff,1,0,30,29
1650974556528,MATH 103A,A01,083777,Staff,0,17,30,30
1650974556528,MATH 103A,A02,083778,Staff,0,15,30,30
1650974556528,MATH 103A,B01,083779,Staff,0,15,30,30
1650974556528,MATH 103A,B02,083780,Staff,0,14,30,30
1650974562558,MATH 105,A01,085443,Staff,0,23,30,30
1650974568587,MATH 109,A01,083213,Anzaldo; Leesa B,0,7,30,30
1650974568587,MATH 109,A02,083214,Anzaldo; Leesa B,0,7,30,30
1650974568587,MATH 109,B01,083215,Anzaldo; Leesa B,0,8,30,30
1650974568587,MATH 109,B02,083216,Anzaldo; Leesa B,0,7,30,30
1650974574612,MATH 142A,A01,083219,Chow; Bennett,0,14,30,30
1650974574612,MATH 142A,A02,083220,Chow; Bennett,0,15,30,30
1650974574612,MATH 142A,B01,083221,Chow; Bennett,0,16,30,30
1650974574612,MATH 142A,B02,083222,Chow; Bennett,0,14,30,30
1650974580642,MATH 193A,A01,083224,Staff,0,6,30,30
1650974580642,MATH 193A,A02,083225,Staff,0,7,30,30
1650974580642,MATH 193A,A03,083781,Staff,0,6,30,30
1650974580642,MATH 193A,A04,083782,Staff,0,7,30,30
1650974586670,MATH 197,001,091859,McAuley; Julian John,9998,0,9999,1
1650974592724,COGS 9,A01,083615,Staff,0,18,60,60
1650974598749,COGS 11,A01,083617,Boyle; Mary E. T.,15,0,40,25
1650974604779,COGS 13,A01,083071,Staff,0,41,40,40
1650974610805,COGS 14A,A01,092681,Staff,0,38,100,100
1650974616833,COGS 14B,A01,083073,Cheng; Tzu-Han,0,13,50,50
1650974622861,COGS 17,A01,092677,Staff,6,0,75,69
1650974628886,COGS 100,A01,083619,Staff,0,31,60,60
1650974634913,COGS 101A,A01,083621,Davis; Joshua Daniel,0,29,60,60
1650974640941,COGS 101B,A01,091572,Staff,0,5,60,60
1650974646968,COGS 101C,A01,083625,Delgado; Tania,14,0,30,16
1650974652996,COGS 107A,A01,083627,Boyle; Mary E. T.,0,16,60,60
1650974659030,COGS 118A,A01,083075,Staff,0,10,60,60
1650974665061,CSE 3,A50,083646,Miranda; Gregory Joseph,15,0,38,23
1650974665061,CSE 3,A51,083647,Miranda; Gregory Joseph,36,0,37,1
1650974671088,CSE 8A,A50,083650,Miranda; Gregory Joseph,0,31,40,40
1650974677116,CSE 11,A01,083080,Cao; Yingjun,0,98,40,40
1650974683146,CSE 12,A01,083652,Staff,0,24,100,100
1650974689181,CSE 15L,A01,083654,Staff,0,3,50,50
1650974689181,CSE 15L,A02,083655,Staff,0,3,50,50
1650974695208,CSE 20,A01,083657,Staff,47,0,80,33
1650974701236,CSE 30,A01,083084,Eldon; John,1,38,80,79
1650974707264,CSE 100,A01,083659,Cao; Yingjun,0,71,50,50
1650974713296,CSE 134B,A01,083661,Powell; Thomas Allan,1,40,65,64
1650974719321,CSE 140,A01,083663,Staff,0,13,75,75
1650974725348,CSE 140L,A01,083088,Eldon; John,4,0,100,96
1650974731375,CSE 175,A01,083665,Kumar; Rakesh,0,0,25,25
1650974737458,CSE 190,A00,092507,Dubnov; Shlomo,9,0,20,11
1650974743484,ECE 45,A01,083139,Staff,0,6,60,60
1650974749511,ECE 65,A50,083695,Staff,0,7,30,30
1650974755542,ECE 109,A01,091882,Touri; Behrouz,32,0,70,38
1650974761580,ECE 180,A00,083140,Abi Samra; Nicholas Camill,18,0,30,12
1650974761580,ECE 180,B00,083141,Abi Samra; Nicholas Camill,0,0,30,30
1650974767673,MATH 10A,A01,083735,Patchell; Gregory David,2,0,30,28
1650974767673,MATH 10A,A02,083736,Patchell; Gregory David,27,0,30,3
1650974767673,MATH 10A,A03,083737,Patchell; Gregory David,23,0,30,7
1650974773701,MATH 10B,A01,083207,Staff,0,9,30,30
1650974773701,MATH 10B,A02,083208,Staff,0,5,30,30
1650974773701,MATH 10B,B01,083739,Staff,9,0,30,21
1650974773701,MATH 10B,B02,083740,Staff,28,0,30,2
1650974779730,MATH 18,A01,083743,Staff,0,0,30,30
1650974779730,MATH 18,A02,083744,Staff,24,0,30,6
1650974779730,MATH 18,A03,083745,Staff,19,0,30,11
1650974779730,MATH 18,A04,083746,Staff,26,0,30,4
1650974779730,MATH 18,B01,083748,Staff,0,15,30,30
1650974779730,MATH 18,B02,083749,Staff,0,14,30,30
1650974779730,MATH 18,B03,083750,Staff,0,13,30,30
1650974779730,MATH 18,B04,083751,Staff,0,13,30,30
1650974785763,MATH 20A,A01,083754,Staff,19,0,40,21
1650974791788,MATH 20B,A01,083756,Staff,0,14,30,30
1650974791788,MATH 20B,A02,083757,Staff,0,11,30,30
1650974797813,MATH 20C,A01,083760,Staff,0,17,30,30
1650974797813,MATH 20C,A02,083761,Staff,0,15,30,30
1650974797813,MATH 20C,B01,083762,Staff,9,0,30,21
1650974797813,MATH 20C,B02,083763,Staff,28,0,30,2
1650974803850,MATH 20D,A01,083765,Staff,2,1,30,28
1650974803850,MATH 20D,A02,083766,Staff,2,0,30,28
1650974803850,MATH 20D,A03,083767,Staff,22,0,30,8
1650974809882,MATH 20E,A01,083771,Staff,2,0,30,28
1650974809882,MATH 20E,A02,083772,Staff,13,0,30,17
1650974809882,MATH 20E,B01,083773,Staff,0,0,30,30
1650974809882,MATH 20E,B02,083774,Staff,1,0,30,29
1650974815923,MATH 103A,A01,083777,Staff,0,17,30,30
1650974815923,MATH 103A,A02,083778,Staff,0,15,30,30
1650974815923,MATH 103A,B01,083779,Staff,0,15,30,30
1650974815923,MATH 103A,B02,083780,Staff,0,14,30,30
1650974821968,MATH 105,A01,085443,Staff,0,23,30,30
1650974827992,MATH 109,A01,083213,Anzaldo; Leesa B,0,7,30,30
1650974827992,MATH 109,A02,083214,Anzaldo; Leesa B,0,7,30,30
1650974827992,MATH 109,B01,083215,Anzaldo; Leesa B,0,8,30,30
1650974827992,MATH 109,B02,083216,Anzaldo; Leesa B,0,7,30,30
1650974834024,MATH 142A,A01,083219,Chow; Bennett,0,14,30,30
1650974834024,MATH 142A,A02,083220,Chow; Bennett,0,15,30,30
1650974834024,MATH 142A,B01,083221,Chow; Bennett,0,16,30,30
1650974834024,MATH 142A,B02,083222,Chow; Bennett,0,14,30,30
1650974840057,MATH 193A,A01,083224,Staff,0,6,30,30
1650974840057,MATH 193A,A02,083225,Staff,0,7,30,30
1650974840057,MATH 193A,A03,083781,Staff,0,6,30,30
1650974840057,MATH 193A,A04,083782,Staff,0,7,30,30
1650974846087,MATH 197,001,091859,McAuley; Julian John,9998,0,9999,1
1650974852151,COGS 9,A01,083615,Staff,0,18,60,60
1650974858175,COGS 11,A01,083617,Boyle; Mary E. T.,15,0,40,25
1650974864204,COGS 13,A01,083071,Staff,0,41,40,40
1650974870234,COGS 14A,A01,092681,Staff,0,38,100,100
1650974876365,COGS 14B,A01,083073,Cheng; Tzu-Han,0,13,50,50
1650974882395,COGS 17,A01,092677,Staff,6,0,75,69
1650974888418,COGS 100,A01,083619,Staff,0,31,60,60
1650974894444,COGS 101A,A01,083621,Davis; Joshua Daniel,0,29,60,60
1650974900472,COGS 101B,A01,091572,Staff,0,5,60,60
1650974906496,COGS 101C,A01,083625,Delgado; Tania,14,0,30,16
1650974912536,COGS 107A,A01,083627,Boyle; Mary E. T.,0,16,60,60
1650974918560,COGS 118A,A01,083075,Staff,0,10,60,60
1650974924594,CSE 3,A50,083646,Miranda; Gregory Joseph,15,0,38,23
1650974924594,CSE 3,A51,083647,Miranda; Gregory Joseph,36,0,37,1
1650974930620,CSE 8A,A50,083650,Miranda; Gregory Joseph,0,31,40,40
1650974936643,CSE 11,A01,083080,Cao; Yingjun,0,98,40,40
1650974942669,CSE 12,A01,083652,Staff,0,24,100,100
1650974948706,CSE 15L,A01,083654,Staff,0,3,50,50
1650974948706,CSE 15L,A02,083655,Staff,0,3,50,50
1650974954732,CSE 20,A01,083657,Staff,47,0,80,33
1650974962140,CSE 30,A01,083084,Eldon; John,1,38,80,79
1650974968173,CSE 100,A01,083659,Cao; Yingjun,0,71,50,50
1650974974205,CSE 134B,A01,083661,Powell; Thomas Allan,1,40,65,64
1650974980231,CSE 140,A01,083663,Staff,0,13,75,75
1650974986253,CSE 140L,A01,083088,Eldon; John,4,0,100,96
1650974992279,CSE 175,A01,083665,Kumar; Rakesh,0,0,25,25
1650974998312,CSE 190,A00,092507,Dubnov; Shlomo,9,0,20,11
1650975004339,ECE 45,A01,083139,Staff,0,6,60,60
1650975010368,ECE 65,A50,083695,Staff,0,7,30,30
1650975016398,ECE 109,A01,091882,Touri; Behrouz,32,0,70,38
1650975022424,ECE 180,A00,083140,Abi Samra; Nicholas Camill,18,0,30,12
1650975022424,ECE 180,B00,083141,Abi Samra; Nicholas Camill,0,0,30,30
1650975028464,MATH 10A,A01,083735,Patchell; Gregory David,2,0,30,28
1650975028464,MATH 10A,A02,083736,Patchell; Gregory David,27,0,30,3
1650975028464,MATH 10A,A03,083737,Patchell; Gregory David,23,0,30,7
1650975034499,MATH 10B,A01,083207,Staff,0,9,30,30
1650975034499,MATH 10B,A02,083208,Staff,0,5,30,30
1650975034499,MATH 10B,B01,083739,Staff,9,0,30,21
1650975034499,MATH 10B,B02,083740,Staff,28,0,30,2
1650975040534,MATH 18,A01,083743,Staff,0,0,30,30
1650975040534,MATH 18,A02,083744,Staff,24,0,30,6
1650975040534,MATH 18,A03,083745,Staff,19,0,30,11
1650975040534,MATH 18,A04,083746,Staff,26,0,30,4
1650975040534,MATH 18,B01,083748,Staff,0,15,30,30
1650975040534,MATH 18,B02,083749,Staff,0,14,30,30
1650975040534,MATH 18,B03,083750,Staff,0,13,30,30
1650975040534,MATH 18,B04,083751,Staff,0,13,30,30
1650975046560,MATH 20A,A01,083754,Staff,19,0,40,21
1650975052592,MATH 20B,A01,083756,Staff,0,14,30,30
1650975052592,MATH 20B,A02,083757,Staff,0,11,30,30
1650975058633,MATH 20C,A01,083760,Staff,0,17,30,30
1650975058633,MATH 20C,A02,083761,Staff,0,15,30,30
1650975058633,MATH 20C,B01,083762,Staff,9,0,30,21
1650975058633,MATH 20C,B02,083763,Staff,28,0,30,2
1650975064662,MATH 20D,A01,083765,Staff,2,1,30,28
1650975064662,MATH 20D,A02,083766,Staff,2,0,30,28
1650975064662,MATH 20D,A03,083767,Staff,22,0,30,8
1650975070690,MATH 20E,A01,083771,Staff,2,0,30,28
1650975070690,MATH 20E,A02,083772,Staff,13,0,30,17
1650975070690,MATH 20E,B01,083773,Staff,0,0,30,30
1650975070690,MATH 20E,B02,083774,Staff,1,0,30,29
1650975076724,MATH 103A,A01,083777,Staff,0,17,30,30
1650975076724,MATH 103A,A02,083778,Staff,0,15,30,30
1650975076724,MATH 103A,B01,083779,Staff,0,15,30,30
1650975076724,MATH 103A,B02,083780,Staff,0,14,30,30
1650975082753,MATH 105,A01,085443,Staff,0,23,30,30
1650975088780,MATH 109,A01,083213,Anzaldo; Leesa B,0,7,30,30
1650975088780,MATH 109,A02,083214,Anzaldo; Leesa B,0,7,30,30
1650975088780,MATH 109,B01,083215,Anzaldo; Leesa B,0,8,30,30
1650975088780,MATH 109,B02,083216,Anzaldo; Leesa B,0,7,30,30
1650975094833,MATH 142A,A01,083219,Chow; Bennett,0,14,30,30
1650975094833,MATH 142A,A02,083220,Chow; Bennett,0,15,30,30
1650975094833,MATH 142A,B01,083221,Chow; Bennett,0,16,30,30
1650975094833,MATH 142A,B02,083222,Chow; Bennett,0,14,30,30
1650975100860,MATH 193A,A01,083224,Staff,0,6,30,30
1650975100860,MATH 193A,A02,083225,Staff,0,7,30,30
1650975100860,MATH 193A,A03,083781,Staff,0,6,30,30
1650975100860,MATH 193A,A04,083782,Staff,0,7,30,30
1650975106887,MATH 197,001,091859,McAuley; Julian John,9998,0,9999,1
1650975112951,COGS 9,A01,083615,Staff,0,18,60,60
1650975118984,COGS 11,A01,083617,Boyle; Mary E. T.,15,0,40,25
1650975125011,COGS 13,A01,083071,Staff,0,41,40,40
1650975131038,COGS 14A,A01,092681,Staff,0,38,100,100
1650975137067,COGS 14B,A01,083073,Cheng; Tzu-Han,0,13,50,50
1650975143094,COGS 17,A01,092677,Staff,6,0,75,69
1650975149121,COGS 100,A01,083619,Staff,0,31,60,60
1650975155147,COGS 101A,A01,083621,Davis; Joshua Daniel,0,29,60,60
1650975161171,COGS 101B,A01,091572,Staff,0,5,60,60
1650975167196,COGS 101C,A01,083625,Delgado; Tania,14,0,30,16
1650975173222,COGS 107A,A01,083627,Boyle; Mary E. T.,0,16,60,60
1650975179256,COGS 118A,A01,083075,Staff,0,10,60,60
1650975185290,CSE 3,A50,083646,Miranda; Gregory Joseph,15,0,38,23
1650975185290,CSE 3,A51,083647,Miranda; Gregory Joseph,36,0,37,1
1650975191320,CSE 8A,A50,083650,Miranda; Gregory Joseph,0,31,40,40
1650975197356,CSE 11,A01,083080,Cao; Yingjun,0,98,40,40
1650975203388,CSE 12,A01,083652,Staff,0,24,100,100
1650975209417,CSE 15L,A01,083654,Staff,0,3,50,50
1650975209417,CSE 15L,A02,083655,Staff,0,3,50,50
1650975215446,CSE 20,A01,083657,Staff,47,0,80,33
1650975221480,CSE 30,A01,083084,Eldon; John,1,38,80,79
1650975227511,CSE 100,A01,083659,Cao; Yingjun,0,71,50,50
1650975233543,CSE 134B,A01,083661,Powell; Thomas Allan,1,40,65,64
1650975239569,CSE 140,A01,083663,Staff,0,13,75,75
1650975245618,CSE 140L,A01,083088,Eldon; John,4,0,100,96
1650975251647,CSE 175,A01,083665,Kumar; Rakesh,0,0,25,25
1650975257678,CSE 190,A00,092507,Dubnov; Shlomo,9,0,20,11
1650975263707,ECE 45,A01,083139,Staff,0,6,60,60
1650975269739,ECE 65,A50,083695,Staff,0,7,30,30
1650975275770,ECE 109,A01,091882,Touri; Behrouz,32,0,70,38
1650975281801,ECE 180,A00,083140,Abi Samra; Nicholas Camill,18,0,30,12
1650975281801,ECE 180,B00,083141,Abi Samra; Nicholas Camill,0,0,30,30
1650975287837,MATH 10A,A01,083735,Patchell; Gregory David,2,0,30,28
1650975287837,MATH 10A,A02,083736,Patchell; Gregory David,27,0,30,3
1650975287837,MATH 10A,A03,083737,Patchell; Gregory David,23,0,30,7
1650975293866,MATH 10B,A01,083207,Staff,0,9,30,30
1650975293866,MATH 10B,A02,083208,Staff,0,5,30,30
1650975293866,MATH 10B,B01,083739,Staff,9,0,30,21
1650975293866,MATH 10B,B02,083740,Staff,28,0,30,2
1650975299896,MATH 18,A01,083743,Staff,0,0,30,30
1650975299896,MATH 18,A02,083744,Staff,24,0,30,6
1650975299896,MATH 18,A03,083745,Staff,19,0,30,11
1650975299896,MATH 18,A04,083746,Staff,26,0,30,4
1650975299896,MATH 18,B01,083748,Staff,0,15,30,30
1650975299896,MATH 18,B02,083749,Staff,0,14,30,30
1650975299896,MATH 18,B03,083750,Staff,0,13,30,30
1650975299896,MATH 18,B04,083751,Staff,0,13,30,30
1650975305945,MATH 20A,A01,083754,Staff,19,0,40,21
1650975311971,MATH 20B,A01,083756,Staff,0,14,30,30
1650975311971,MATH 20B,A02,083757,Staff,0,11,30,30
1650975317996,MATH 20C,A01,083760,Staff,0,17,30,30
1650975317996,MATH 20C,A02,083761,Staff,0,15,30,30
1650975317996,MATH 20C,B01,083762,Staff,9,0,30,21
1650975317996,MATH 20C,B02,083763,Staff,28,0,30,2
1650975324023,MATH 20D,A01,083765,Staff,2,1,30,28
1650975324023,MATH 20D,A02,083766,Staff,2,0,30,28
1650975324023,MATH 20D,A03,083767,Staff,22,0,30,8
1650975330055,MATH 20E,A01,083771,Staff,2,0,30,28
1650975330055,MATH 20E,A02,083772,Staff,13,0,30,17
1650975330055,MATH 20E,B01,083773,Staff,0,0,30,30
1650975330055,MATH 20E,B02,083774,Staff,1,0,30,29
1650975336085,MATH 103A,A01,083777,Staff,0,17,30,30
1650975336085,MATH 103A,A02,083778,Staff,0,15,30,30
1650975336085,MATH 103A,B01,083779,Staff,0,15,30,30
1650975336085,MATH 103A,B02,083780,Staff,0,14,30,30
1650975342114,MATH 105,A01,085443,Staff,0,23,30,30
1650975348141,MATH 109,A01,083213,Anzaldo; Leesa B,0,7,30,30
1650975348141,MATH 109,A02,083214,Anzaldo; Leesa B,0,7,30,30
1650975348141,MATH 109,B01,083215,Anzaldo; Leesa B,0,8,30,30
1650975348141,MATH 109,B02,083216,Anzaldo; Leesa B,0,7,30,30
1650975354173,MATH 142A,A01,083219,Chow; Bennett,0,14,30,30
1650975354173,MATH 142A,A02,083220,Chow; Bennett,0,15,30,30
1650975354173,MATH 142A,B01,083221,Chow; Bennett,0,16,30,30
1650975354173,MATH 142A,B02,083222,Chow; Bennett,0,14,30,30
1650975360208,MATH 193A,A01,083224,Staff,0,6,30,30
1650975360208,MATH 193A,A02,083225,Staff,0,7,30,30
1650975360208,MATH 193A,A03,083781,Staff,0,6,30,30
1650975360208,MATH 193A,A04,083782,Staff,0,7,30,30
1650975366237,MATH 197,001,091859,McAuley; Julian John,9998,0,9999,1
1650975372320,COGS 9,A01,083615,Staff,0,18,60,60
1650975378351,COGS 11,A01,083617,Boyle; Mary E. T.,15,0,40,25
1650975384380,COGS 13,A01,083071,Staff,0,41,40,40
1650975390411,COGS 14A,A01,092681,Staff,0,38,100,100
1650975396437,COGS 14B,A01,083073,Cheng; Tzu-Han,0,13,50,50
1650975402465,COGS 17,A01,092677,Staff,6,0,75,69
1650975408494,COGS 100,A01,083619,Staff,0,31,60,60
1650975414520,COGS 101A,A01,083621,Davis; Joshua Daniel,0,29,60,60
1650975420556,COGS 101B,A01,091572,Staff,0,5,60,60
1650975426583,COGS 101C,A01,083625,Delgado; Tania,14,0,30,16
1650975432616,COGS 107A,A01,083627,Boyle; Mary E. T.,0,16,60,60
1650975438641,COGS 118A,A01,083075,Staff,0,10,60,60
1650975444667,CSE 3,A50,083646,Miranda; Gregory Joseph,15,0,38,23
1650975444667,CSE 3,A51,083647,Miranda; Gregory Joseph,36,0,37,1
1650975450698,CSE 8A,A50,083650,Miranda; Gregory Joseph,0,31,40,40
1650975456721,CSE 11,A01,083080,Cao; Yingjun,0,98,40,40
1650975462751,CSE 12,A01,083652,Staff,0,24,100,100
1650975468780,CSE 15L,A01,083654,Staff,0,3,50,50
1650975468780,CSE 15L,A02,083655,Staff,0,3,50,50
1650975474877,CSE 20,A01,083657,Staff,47,0,80,33
1650975480902,CSE 30,A01,083084,Eldon; John,1,38,80,79
1650975486928,CSE 100,A01,083659,Cao; Yingjun,0,71,50,50
1650975492954,CSE 134B,A01,083661,Powell; Thomas Allan,1,40,65,64
1650975498977,CSE 140,A01,083663,Staff,0,13,75,75
1650975505003,CSE 140L,A01,083088,Eldon; John,4,0,100,96
1650975511031,CSE 175,A01,083665,Kumar; Rakesh,0,0,25,25
1650975517057,CSE 190,A00,092507,Dubnov; Shlomo,9,0,20,11
1650975523082,ECE 45,A01,083139,Staff,0,6,60,60
1650975529107,ECE 65,A50,083695,Staff,0,7,30,30
1650975535136,ECE 109,A01,091882,Touri; Behrouz,32,0,70,38
1650975541160,ECE 180,A00,083140,Abi Samra; Nicholas Camill,18,0,30,12
1650975541160,ECE 180,B00,083141,Abi Samra; Nicholas Camill,0,0,30,30
1650975547193,MATH 10A,A01,083735,Patchell; Gregory David,2,0,30,28
1650975547193,MATH 10A,A02,083736,Patchell; Gregory David,27,0,30,3
1650975547193,MATH 10A,A03,083737,Patchell; Gregory David,23,0,30,7
1650975553223,MATH 10B,A01,083207,Staff,0,9,30,30
1650975553223,MATH 10B,A02,083208,Staff,0,5,30,30
1650975553223,MATH 10B,B01,083739,Staff,9,0,30,21
1650975553223,MATH 10B,B02,083740,Staff,28,0,30,2
1650975559260,MATH 18,A01,083743,Staff,0,0,30,30
1650975559260,MATH 18,A02,083744,Staff,24,0,30,6
1650975559260,MATH 18,A03,083745,Staff,19,0,30,11
1650975559260,MATH 18,A04,083746,Staff,26,0,30,4
1650975559260,MATH 18,B01,083748,Staff,0,15,30,30
1650975559260,MATH 18,B02,083749,Staff,0,14,30,30
1650975559260,MATH 18,B03,083750,Staff,0,13,30,30
1650975559260,MATH 18,B04,083751,Staff,0,13,30,30
1650975565296,MATH 20A,A01,083754,Staff,19,0,40,21
1650975571321,MATH 20B,A01,083756,Staff,0,14,30,30
1650975571321,MATH 20B,A02,083757,Staff,0,11,30,30
1650975577346,MATH 20C,A01,083760,Staff,0,17,30,30
1650975577346,MATH 20C,A02,083761,Staff,0,15,30,30
1650975577346,MATH 20C,B01,083762,Staff,9,0,30,21
1650975577346,MATH 20C,B02,083763,Staff,28,0,30,2
1650975583375,MATH 20D,A01,083765,Staff,2,1,30,28
1650975583375,MATH 20D,A02,083766,Staff,2,0,30,28
1650975583375,MATH 20D,A03,083767,Staff,22,0,30,8
1650975589405,MATH 20E,A01,083771,Staff,2,0,30,28
1650975589405,MATH 20E,A02,083772,Staff,13,0,30,17
1650975589405,MATH 20E,B01,083773,Staff,0,0,30,30
1650975589405,MATH 20E,B02,083774,Staff,1,0,30,29
1650975595461,MATH 103A,A01,083777,Staff,0,17,30,30
1650975595461,MATH 103A,A02,083778,Staff,0,15,30,30
1650975595461,MATH 103A,B01,083779,Staff,0,15,30,30
1650975595461,MATH 103A,B02,083780,Staff,0,14,30,30
1650975601489,MATH 105,A01,085443,Staff,0,23,30,30
1650975607525,MATH 109,A01,083213,Anzaldo; Leesa B,0,7,30,30
1650975607525,MATH 109,A02,083214,Anzaldo; Leesa B,0,7,30,30
1650975607525,MATH 109,B01,083215,Anzaldo; Leesa B,0,8,30,30
1650975607525,MATH 109,B02,083216,Anzaldo; Leesa B,0,7,30,30
1650975613550,MATH 142A,A01,083219,Chow; Bennett,0,14,30,30
1650975613550,MATH 142A,A02,083220,Chow; Bennett,0,15,30,30
1650975613550,MATH 142A,B01,083221,Chow; Bennett,0,16,30,30
1650975613550,MATH 142A,B02,083222,Chow; Bennett,0,14,30,30
1650975619576,MATH 193A,A01,083224,Staff,0,6,30,30
1650975619576,MATH 193A,A02,083225,Staff,0,7,30,30
1650975619576,MATH 193A,A03,083781,Staff,0,6,30,30
1650975619576,MATH 193A,A04,083782,Staff,0,7,30,30
1650975625602,MATH 197,001,091859,McAuley; Julian John,9998,0,9999,1
1650975631660,COGS 9,A01,083615,Staff,0,18,60,60
1650975637689,COGS 11,A01,083617,Boyle; Mary E. T.,15,0,40,25
1650975643714,COGS 13,A01,083071,Staff,0,41,40,40
1650975649738,COGS 14A,A01,092681,Staff,0,38,100,100
1650975655762,COGS 14B,A01,083073,Cheng; Tzu-Han,0,13,50,50
1650975661795,COGS 17,A01,092677,Staff,6,0,75,69
1650975667823,COGS 100,A01,083619,Staff,0,31,60,60
1650975673847,COGS 101A,A01,083621,Davis; Joshua Daniel,0,29,60,60
1650975679872,COGS 101B,A01,091572,Staff,0,5,60,60
1650975685901,COGS 101C,A01,083625,Delgado; Tania,14,0,30,16
1650975691931,COGS 107A,A01,083627,Boyle; Mary E. T.,0,16,60,60
1650975697971,COGS 118A,A01,083075,Staff,0,10,60,60
1650975703997,CSE 3,A50,083646,Miranda; Gregory Joseph,15,0,38,23
1650975703997,CSE 3,A51,083647,Miranda; Gregory Joseph,36,0,37,1
1650975710041,CSE 8A,A50,083650,Miranda; Gregory Joseph,0,31,40,40
1650975716071,CSE 11,A01,083080,Cao; Yingjun,0,98,40,40
1650975722096,CSE 12,A01,083652,Staff,0,24,100,100
1650975728125,CSE 15L,A01,083654,Staff,0,3,50,50
1650975728125,CSE 15L,A02,083655,Staff,0,3,50,50
1650975734153,CSE 20,A01,083657,Staff,47,0,80,33
1650975740195,CSE 30,A01,083084,Eldon; John,1,38,80,79
1650975746221,CSE 100,A01,083659,Cao; Yingjun,0,71,50,50
1650975752252,CSE 134B,A01,083661,Powell; Thomas Allan,1,40,65,64
1650975758281,CSE 140,A01,083663,Staff,0,13,75,75
1650975764305,CSE 140L,A01,083088,Eldon; John,4,0,100,96
1650975770333,CSE 175,A01,083665,Kumar; Rakesh,0,0,25,25
1650975776359,CSE 190,A00,092507,Dubnov; Shlomo,9,0,20,11
1650975782388,ECE 45,A01,083139,Staff,0,6,60,60
1650975788415,ECE 65,A50,083695,Staff,0,7,30,30
1650975794440,ECE 109,A01,091882,Touri; Behrouz,32,0,70,38
1650975800474,ECE 180,A00,083140,Abi Samra; Nicholas Camill,18,0,30,12
1650975800474,ECE 180,B00,083141,Abi Samra; Nicholas Camill,0,0,30,30
1650975806498,MATH 10A,A01,083735,Patchell; Gregory David,2,0,30,28
1650975806498,MATH 10A,A02,083736,Patchell; Gregory David,27,0,30,3
1650975806498,MATH 10A,A03,083737,Patchell; Gregory David,23,0,30,7
1650975812539,MATH 10B,A01,083207,Staff,0,9,30,30
1650975812539,MATH 10B,A02,083208,Staff,0,5,30,30
1650975812539,MATH 10B,B01,083739,Staff,9,0,30,21
1650975812539,MATH 10B,B02,083740,Staff,28,0,30,2
1650975818575,MATH 18,A01,083743,Staff,0,0,30,30
1650975818575,MATH 18,A02,083744,Staff,24,0,30,6
1650975818575,MATH 18,A03,083745,Staff,19,0,30,11
1650975818575,MATH 18,A04,083746,Staff,26,0,30,4
1650975818575,MATH 18,B01,083748,Staff,0,15,30,30
1650975818575,MATH 18,B02,083749,Staff,0,14,30,30
1650975818575,MATH 18,B03,083750,Staff,0,13,30,30
1650975818575,MATH 18,B04,083751,Staff,0,13,30,30
1650975824604,MATH 20A,A01,083754,Staff,19,0,40,21
1650975830633,MATH 20B,A01,083756,Staff,0,14,30,30
1650975830633,MATH 20B,A02,083757,Staff,0,11,30,30
1650975836657,MATH 20C,A01,083760,Staff,0,17,30,30
1650975836657,MATH 20C,A02,083761,Staff,0,15,30,30
1650975836657,MATH 20C,B01,083762,Staff,9,0,30,21
1650975836657,MATH 20C,B02,083763,Staff,28,0,30,2
1650975842689,MATH 20D,A01,083765,Staff,2,1,30,28
1650975842689,MATH 20D,A02,083766,Staff,2,0,30,28
1650975842689,MATH 20D,A03,083767,Staff,22,0,30,8
1650975848720,MATH 20E,A01,083771,Staff,2,0,30,28
1650975848720,MATH 20E,A02,083772,Staff,13,0,30,17
1650975848720,MATH 20E,B01,083773,Staff,0,0,30,30
1650975848720,MATH 20E,B02,083774,Staff,1,0,30,29
1650975854753,MATH 103A,A01,083777,Staff,0,17,30,30
1650975854753,MATH 103A,A02,083778,Staff,0,15,30,30
1650975854753,MATH 103A,B01,083779,Staff,0,15,30,30
1650975854753,MATH 103A,B02,083780,Staff,0,14,30,30
1650975860777,MATH 105,A01,085443,Staff,0,23,30,30
1650975866808,MATH 109,A01,083213,Anzaldo; Leesa B,0,7,30,30
1650975866808,MATH 109,A02,083214,Anzaldo; Leesa B,0,7,30,30
1650975866808,MATH 109,B01,083215,Anzaldo; Leesa B,0,8,30,30
1650975866808,MATH 109,B02,083216,Anzaldo; Leesa B,0,7,30,30
1650975872835,MATH 142A,A01,083219,Chow; Bennett,0,14,30,30
1650975872835,MATH 142A,A02,083220,Chow; Bennett,0,15,30,30
1650975872835,MATH 142A,B01,083221,Chow; Bennett,0,16,30,30
1650975872835,MATH 142A,B02,083222,Chow; Bennett,0,14,30,30
1650975878869,MATH 193A,A01,083224,Staff,0,6,30,30
1650975878869,MATH 193A,A02,083225,Staff,0,7,30,30
1650975878869,MATH 193A,A03,083781,Staff,0,6,30,30
1650975878869,MATH 193A,A04,083782,Staff,0,7,30,30
1650975884895,MATH 197,001,091859,McAuley; Julian John,9998,0,9999,1
1650975890962,COGS 9,A01,083615,Staff,0,18,60,60
1650975896989,COGS 11,A01,083617,Boyle; Mary E. T.,15,0,40,25
1650975903015,COGS 13,A01,083071,Staff,0,41,40,40
1650975909040,COGS 14A,A01,092681,Staff,0,38,100,100
1650975915066,COGS 14B,A01,083073,Cheng; Tzu-Han,0,13,50,50
1650975921094,COGS 17,A01,092677,Staff,6,0,75,69
1650975927124,COGS 100,A01,083619,Staff,0,31,60,60
1650975933161,COGS 101A,A01,083621,Davis; Joshua Daniel,0,29,60,60
1650975939190,COGS 101B,A01,091572,Staff,0,5,60,60
1650975945217,COGS 101C,A01,083625,Delgado; Tania,14,0,30,16
1650975951252,COGS 107A,A01,083627,Boyle; Mary E. T.,0,16,60,60
1650975957277,COGS 118A,A01,083075,Staff,0,10,60,60
1650975963316,CSE 3,A50,083646,Miranda; Gregory Joseph,15,0,38,23
1650975963316,CSE 3,A51,083647,Miranda; Gregory Joseph,36,0,37,1
1650975969341,CSE 8A,A50,083650,Miranda; Gregory Joseph,0,31,40,40
1650975975369,CSE 11,A01,083080,Cao; Yingjun,0,98,40,40
1650975981391,CSE 12,A01,083652,Staff,0,24,100,100
1650975987421,CSE 15L,A01,083654,Staff,0,3,50,50
1650975987421,CSE 15L,A02,083655,Staff,0,3,50,50
1650975993447,CSE 20,A01,083657,Staff,47,0,80,33
1650975999481,CSE 30,A01,083084,Eldon; John,1,38,80,79
1650976005509,CSE 100,A01,083659,Cao; Yingjun,0,71,50,50
1650976011535,CSE 134B,A01,083661,Powell; Thomas Allan,1,40,65,64
1650976017558,CSE 140,A01,083663,Staff,0,13,75,75
1650976023589,CSE 140L,A01,083088,Eldon; John,4,0,100,96
1650976029613,CSE 175,A01,083665,Kumar; Rakesh,0,0,25,25
1650976035639,CSE 190,A00,092507,Dubnov; Shlomo,9,0,20,11
1650976041668,ECE 45,A01,083139,Staff,0,6,60,60
1650976047693,ECE 65,A50,083695,Staff,0,7,30,30
1650976053720,ECE 109,A01,091882,Touri; Behrouz,32,0,70,38
1650976059745,ECE 180,A00,083140,Abi Samra; Nicholas Camill,18,0,30,12
1650976059745,ECE 180,B00,083141,Abi Samra; Nicholas Camill,0,0,30,30
1650976065771,MATH 10A,A01,083735,Patchell; Gregory David,2,0,30,28
1650976065771,MATH 10A,A02,083736,Patchell; Gregory David,27,0,30,3
1650976065771,MATH 10A,A03,083737,Patchell; Gregory David,23,0,30,7
1650976071893,MATH 10B,A01,083207,Staff,0,9,30,30
1650976071893,MATH 10B,A02,083208,Staff,0,5,30,30
1650976071893,MATH 10B,B01,083739,Staff,9,0,30,21
1650976071893,MATH 10B,B02,083740,Staff,28,0,30,2
1650976077923,MATH 18,A01,083743,Staff,0,0,30,30
1650976077923,MATH 18,A02,083744,Staff,24,0,30,6
1650976077923,MATH 18,A03,083745,Staff,19,0,30,11
1650976077923,MATH 18,A04,083746,Staff,26,0,30,4
1650976077923,MATH 18,B01,083748,Staff,0,15,30,30
1650976077923,MATH 18,B02,083749,Staff,0,14,30,30
1650976077923,MATH 18,B03,083750,Staff,0,13,30,30
1650976077923,MATH 18,B04,083751,Staff,0,13,30,30
1650976083951,MATH 20A,A01,083754,Staff,19,0,40,21
1650976089981,MATH 20B,A01,083756,Staff,0,14,30,30
1650976089981,MATH 20B,A02,083757,Staff,0,11,30,30
1650976096007,MATH 20C,A01,083760,Staff,0,17,30,30
1650976096007,MATH 20C,A02,083761,Staff,0,15,30,30
1650976096007,MATH 20C,B01,083762,Staff,9,0,30,21
1650976096007,MATH 20C,B02,083763,Staff,28,0,30,2
1650976102044,MATH 20D,A01,083765,Staff,2,1,30,28
1650976102044,MATH 20D,A02,083766,Staff,2,0,30,28
1650976102044,MATH 20D,A03,083767,Staff,22,0,30,8
1650976108075,MATH 20E,A01,083771,Staff,2,0,30,28
1650976108075,MATH 20E,A02,083772,Staff,13,0,30,17
1650976108075,MATH 20E,B01,083773,Staff,0,0,30,30
1650976108075,MATH 20E,B02,083774,Staff,1,0,30,29
1650976114106,MATH 103A,A01,083777,Staff,0,17,30,30
1650976114106,MATH 103A,A02,083778,Staff,0,15,30,30
1650976114106,MATH 103A,B01,083779,Staff,0,15,30,30
1650976114106,MATH 103A,B02,083780,Staff,0,14,30,30
1650976120134,MATH 105,A01,085443,Staff,0,23,30,30
1650976126161,MATH 109,A01,083213,Anzaldo; Leesa B,0,7,30,30
1650976126161,MATH 109,A02,083214,Anzaldo; Leesa B,0,7,30,30
1650976126161,MATH 109,B01,083215,Anzaldo; Leesa B,0,8,30,30
1650976126161,MATH 109,B02,083216,Anzaldo; Leesa B,0,7,30,30
1650976132188,MATH 142A,A01,083219,Chow; Bennett,0,14,30,30
1650976132188,MATH 142A,A02,083220,Chow; Bennett,0,15,30,30
1650976132188,MATH 142A,B01,083221,Chow; Bennett,0,16,30,30
1650976132188,MATH 142A,B02,083222,Chow; Bennett,0,14,30,30
1650976138218,MATH 193A,A01,083224,Staff,0,6,30,30
1650976138218,MATH 193A,A02,083225,Staff,0,7,30,30
1650976138218,MATH 193A,A03,083781,Staff,0,6,30,30
1650976138218,MATH 193A,A04,083782,Staff,0,7,30,30
1650976144243,MATH 197,001,091859,McAuley; Julian John,9998,0,9999,1
1650976150309,COGS 9,A01,083615,Staff,0,18,60,60
1650976156334,COGS 11,A01,083617,Boyle; Mary E. T.,15,0,40,25
1650976162367,COGS 13,A01,083071,Staff,0,41,40,40
1650976168396,COGS 14A,A01,092681,Staff,0,38,100,100
1650976174425,COGS 14B,A01,083073,Cheng; Tzu-Han,0,13,50,50
1650976180450,COGS 17,A01,092677,Staff,6,0,75,69
1650976186476,COGS 100,A01,083619,Staff,0,31,60,60
1650976192503,COGS 101A,A01,083621,Davis; Joshua Daniel,0,29,60,60
1650976198528,COGS 101B,A01,091572,Staff,0,5,60,60
1650976204558,COGS 101C,A01,083625,Delgado; Tania,14,0,30,16
1650976210582,COGS 107A,A01,083627,Boyle; Mary E. T.,0,16,60,60
1650976216607,COGS 118A,A01,083075,Staff,0,10,60,60
1650976222635,CSE 3,A50,083646,Miranda; Gregory Joseph,15,0,38,23
1650976222635,CSE 3,A51,083647,Miranda; Gregory Joseph,36,0,37,1
1650976228663,CSE 8A,A50,083650,Miranda; Gregory Joseph,0,31,40,40
1650976234691,CSE 11,A01,083080,Cao; Yingjun,0,98,40,40
1650976240720,CSE 12,A01,083652,Staff,0,24,100,100
1650976246745,CSE 15L,A01,083654,Staff,0,3,50,50
1650976246745,CSE 15L,A02,083655,Staff,0,3,50,50
1650976252778,CSE 20,A01,083657,Staff,47,0,80,33
1650976258806,CSE 30,A01,083084,Eldon; John,1,38,80,79
1650976264835,CSE 100,A01,083659,Cao; Yingjun,0,71,50,50
1650976270860,CSE 134B,A01,083661,Powell; Thomas Allan,1,40,65,64
1650976276884,CSE 140,A01,083663,Staff,0,13,75,75
1650976282907,CSE 140L,A01,083088,Eldon; John,4,0,100,96
1650976288935,CSE 175,A01,083665,Kumar; Rakesh,0,0,25,25
1650976294969,CSE 190,A00,092507,Dubnov; Shlomo,9,0,20,11
1650976301002,ECE 45,A01,083139,Staff,0,6,60,60
1650976307028,ECE 65,A50,083695,Staff,0,7,30,30
1650976313061,ECE 109,A01,091882,Touri; Behrouz,32,0,70,38
1650976319088,ECE 180,A00,083140,Abi Samra; Nicholas Camill,18,0,30,12
1650976319088,ECE 180,B00,083141,Abi Samra; Nicholas Camill,0,0,30,30
1650976325118,MATH 10A,A01,083735,Patchell; Gregory David,2,0,30,28
1650976325118,MATH 10A,A02,083736,Patchell; Gregory David,27,0,30,3
1650976325118,MATH 10A,A03,083737,Patchell; Gregory David,23,0,30,7
1650976331150,MATH 10B,A01,083207,Staff,0,9,30,30
1650976331150,MATH 10B,A02,083208,Staff,0,5,30,30
1650976331150,MATH 10B,B01,083739,Staff,9,0,30,21
1650976331150,MATH 10B,B02,083740,Staff,28,0,30,2
1650976337174,MATH 18,A01,083743,Staff,0,0,30,30
1650976337174,MATH 18,A02,083744,Staff,24,0,30,6
1650976337174,MATH 18,A03,083745,Staff,19,0,30,11
1650976337174,MATH 18,A04,083746,Staff,26,0,30,4
1650976337174,MATH 18,B01,083748,Staff,0,15,30,30
1650976337174,MATH 18,B02,083749,Staff,0,14,30,30
1650976337174,MATH 18,B03,083750,Staff,0,13,30,30
1650976337174,MATH 18,B04,083751,Staff,0,13,30,30
1650976343199,MATH 20A,A01,083754,Staff,19,0,40,21
1650976349227,MATH 20B,A01,083756,Staff,0,14,30,30
1650976349227,MATH 20B,A02,083757,Staff,0,11,30,30
1650976359800,MATH 20C,A01,083760,Staff,0,17,30,30
1650976359800,MATH 20C,A02,083761,Staff,0,15,30,30
1650976359800,MATH 20C,B01,083762,Staff,9,0,30,21
1650976359800,MATH 20C,B02,083763,Staff,28,0,30,2
1650976365831,MATH 20D,A01,083765,Staff,2,1,30,28
1650976365831,MATH 20D,A02,083766,Staff,2,0,30,28
1650976365831,MATH 20D,A03,083767,Staff,22,0,30,8
1650976371860,MATH 20E,A01,083771,Staff,2,0,30,28
1650976371860,MATH 20E,A02,083772,Staff,13,0,30,17
1650976371860,MATH 20E,B01,083773,Staff,0,0,30,30
1650976371860,MATH 20E,B02,083774,Staff,1,0,30,29
1650976377892,MATH 103A,A01,083777,Staff,0,17,30,30
1650976377892,MATH 103A,A02,083778,Staff,0,15,30,30
1650976377892,MATH 103A,B01,083779,Staff,0,15,30,30
1650976377892,MATH 103A,B02,083780,Staff,0,14,30,30
1650976383916,MATH 105,A01,085443,Staff,0,23,30,30
1650976389948,MATH 109,A01,083213,Anzaldo; Leesa B,0,7,30,30
1650976389948,MATH 109,A02,083214,Anzaldo; Leesa B,0,7,30,30
1650976389948,MATH 109,B01,083215,Anzaldo; Leesa B,0,8,30,30
1650976389948,MATH 109,B02,083216,Anzaldo; Leesa B,0,7,30,30
1650976395983,MATH 142A,A01,083219,Chow; Bennett,0,14,30,30
1650976395983,MATH 142A,A02,083220,Chow; Bennett,0,15,30,30
1650976395983,MATH 142A,B01,083221,Chow; Bennett,0,16,30,30
1650976395983,MATH 142A,B02,083222,Chow; Bennett,0,14,30,30
1650976402007,MATH 193A,A01,083224,Staff,0,6,30,30
1650976402007,MATH 193A,A02,083225,Staff,0,7,30,30
1650976402007,MATH 193A,A03,083781,Staff,0,6,30,30
1650976402007,MATH 193A,A04,083782,Staff,0,7,30,30
1650976408044,MATH 197,001,091859,McAuley; Julian John,9998,0,9999,1
1650976414110,COGS 9,A01,083615,Staff,0,18,60,60
1650976420134,COGS 11,A01,083617,Boyle; Mary E. T.,15,0,40,25
1650976426162,COGS 13,A01,083071,Staff,0,41,40,40
1650976432186,COGS 14A,A01,092681,Staff,0,38,100,100
1650976438214,COGS 14B,A01,083073,Cheng; Tzu-Han,0,13,50,50
1650976444245,COGS 17,A01,092677,Staff,6,0,75,69
1650976450269,COGS 100,A01,083619,Staff,0,31,60,60
1650976456293,COGS 101A,A01,083621,Davis; Joshua Daniel,0,29,60,60
1650976462318,COGS 101B,A01,091572,Staff,0,5,60,60
1650976468350,COGS 101C,A01,083625,Delgado; Tania,14,0,30,16
1650976474381,COGS 107A,A01,083627,Boyle; Mary E. T.,0,16,60,60
1650976480406,COGS 118A,A01,083075,Staff,0,10,60,60
1650976486430,CSE 3,A50,083646,Miranda; Gregory Joseph,15,0,38,23
1650976486430,CSE 3,A51,083647,Miranda; Gregory Joseph,36,0,37,1
1650976492455,CSE 8A,A50,083650,Miranda; Gregory Joseph,0,31,40,40
1650976498478,CSE 11,A01,083080,Cao; Yingjun,0,98,40,40
1650976504509,CSE 12,A01,083652,Staff,0,24,100,100
1650976510535,CSE 15L,A01,083654,Staff,0,3,50,50
1650976510535,CSE 15L,A02,083655,Staff,0,3,50,50
1650976516560,CSE 20,A01,083657,Staff,47,0,80,33
1650976522586,CSE 30,A01,083084,Eldon; John,1,38,80,79
1650976528613,CSE 100,A01,083659,Cao; Yingjun,0,71,50,50
1650976534639,CSE 134B,A01,083661,Powell; Thomas Allan,1,40,65,64
1650976540668,CSE 140,A01,083663,Staff,0,13,75,75
1650976546697,CSE 140L,A01,083088,Eldon; John,4,0,100,96
1650976552729,CSE 175,A01,083665,Kumar; Rakesh,0,0,25,25
1650976558753,CSE 190,A00,092507,Dubnov; Shlomo,9,0,20,11
1650976564784,ECE 45,A01,083139,Staff,0,6,60,60
1650976570813,ECE 65,A50,083695,Staff,0,7,30,30
1650976576844,ECE 109,A01,091882,Touri; Behrouz,32,0,70,38
1650976582873,ECE 180,A00,083140,Abi Samra; Nicholas Camill,18,0,30,12
1650976582873,ECE 180,B00,083141,Abi Samra; Nicholas Camill,0,0,30,30
1650976588905,MATH 10A,A01,083735,Patchell; Gregory David,2,0,30,28
1650976588905,MATH 10A,A02,083736,Patchell; Gregory David,27,0,30,3
1650976588905,MATH 10A,A03,083737,Patchell; Gregory David,23,0,30,7
1650976594933,MATH 10B,A01,083207,Staff,0,9,30,30
1650976594933,MATH 10B,A02,083208,Staff,0,5,30,30
1650976594933,MATH 10B,B01,083739,Staff,9,0,30,21
1650976594933,MATH 10B,B02,083740,Staff,28,0,30,2
1650976600961,MATH 18,A01,083743,Staff,0,0,30,30
1650976600961,MATH 18,A02,083744,Staff,24,0,30,6
1650976600961,MATH 18,A03,083745,Staff,19,0,30,11
1650976600961,MATH 18,A04,083746,Staff,26,0,30,4
1650976600961,MATH 18,B01,083748,Staff,0,15,30,30
1650976600961,MATH 18,B02,083749,Staff,0,14,30,30
1650976600961,MATH 18,B03,083750,Staff,0,13,30,30
1650976600961,MATH 18,B04,083751,Staff,0,13,30,30
1650976606985,MATH 20A,A01,083754,Staff,19,0,40,21
1650976613011,MATH 20B,A01,083756,Staff,0,14,30,30
1650976613011,MATH 20B,A02,083757,Staff,0,11,30,30
1650976619040,MATH 20C,A01,083760,Staff,0,17,30,30
1650976619040,MATH 20C,A02,083761,Staff,0,15,30,30
1650976619040,MATH 20C,B01,083762,Staff,9,0,30,21
1650976619040,MATH 20C,B02,083763,Staff,28,0,30,2
1650976625065,MATH 20D,A01,083765,Staff,2,1,30,28
1650976625065,MATH 20D,A02,083766,Staff,2,0,30,28
1650976625065,MATH 20D,A03,083767,Staff,22,0,30,8
1650976631097,MATH 20E,A01,083771,Staff,2,0,30,28
1650976631097,MATH 20E,A02,083772,Staff,13,0,30,17
1650976631097,MATH 20E,B01,083773,Staff,0,0,30,30
1650976631097,MATH 20E,B02,083774,Staff,1,0,30,29
1650976637128,MATH 103A,A01,083777,Staff,0,17,30,30
1650976637128,MATH 103A,A02,083778,Staff,0,15,30,30
1650976637128,MATH 103A,B01,083779,Staff,0,15,30,30
1650976637128,MATH 103A,B02,083780,Staff,0,14,30,30
1650976643156,MATH 105,A01,085443,Staff,0,23,30,30
1650976649188,MATH 109,A01,083213,Anzaldo; Leesa B,0,7,30,30
1650976649188,MATH 109,A02,083214,Anzaldo; Leesa B,0,7,30,30
1650976649188,MATH 109,B01,083215,Anzaldo; Leesa B,0,8,30,30
1650976649188,MATH 109,B02,083216,Anzaldo; Leesa B,0,7,30,30
1650976655220,MATH 142A,A01,083219,Chow; Bennett,0,14,30,30
1650976655220,MATH 142A,A02,083220,Chow; Bennett,0,15,30,30
1650976655220,MATH 142A,B01,083221,Chow; Bennett,0,16,30,30
1650976655220,MATH 142A,B02,083222,Chow; Bennett,0,14,30,30
1650976661245,MATH 193A,A01,083224,Staff,0,6,30,30
1650976661245,MATH 193A,A02,083225,Staff,0,7,30,30
1650976661245,MATH 193A,A03,083781,Staff,0,6,30,30
1650976661245,MATH 193A,A04,083782,Staff,0,7,30,30
1650976667273,MATH 197,001,091859,McAuley; Julian John,9998,0,9999,1
1650976673435,COGS 9,A01,083615,Staff,0,18,60,60
1650976679465,COGS 11,A01,083617,Boyle; Mary E. T.,15,0,40,25
1650976685489,COGS 13,A01,083071,Staff,0,41,40,40
1650976691514,COGS 14A,A01,092681,Staff,0,38,100,100
1650976697537,COGS 14B,A01,083073,Cheng; Tzu-Han,0,13,50,50
1650976703563,COGS 17,A01,092677,Staff,6,0,75,69
1650976709587,COGS 100,A01,083619,Staff,0,31,60,60
1650976715612,COGS 101A,A01,083621,Davis; Joshua Daniel,0,29,60,60
1650976721634,COGS 101B,A01,091572,Staff,0,5,60,60
1650976727661,COGS 101C,A01,083625,Delgado; Tania,14,0,30,16
1650976733684,COGS 107A,A01,083627,Boyle; Mary E. T.,0,16,60,60
1650976739709,COGS 118A,A01,083075,Staff,0,10,60,60
1650976745736,CSE 3,A50,083646,Miranda; Gregory Joseph,15,0,38,23
1650976745736,CSE 3,A51,083647,Miranda; Gregory Joseph,36,0,37,1
1650976751765,CSE 8A,A50,083650,Miranda; Gregory Joseph,0,31,40,40
1650976757795,CSE 11,A01,083080,Cao; Yingjun,0,98,40,40
1650976763824,CSE 12,A01,083652,Staff,0,24,100,100
1650976769850,CSE 15L,A01,083654,Staff,0,3,50,50
1650976769850,CSE 15L,A02,083655,Staff,0,3,50,50
1650976775878,CSE 20,A01,083657,Staff,47,0,80,33
1650976781903,CSE 30,A01,083084,Eldon; John,1,38,80,79
1650976787931,CSE 100,A01,083659,Cao; Yingjun,0,71,50,50
1650976793986,CSE 134B,A01,083661,Powell; Thomas Allan,1,40,65,64
1650976800015,CSE 140,A01,083663,Staff,0,13,75,75
1650976806042,CSE 140L,A01,083088,Eldon; John,4,0,100,96
1650976812068,CSE 175,A01,083665,Kumar; Rakesh,0,0,25,25
1650976818106,CSE 190,A00,092507,Dubnov; Shlomo,9,0,20,11
1650976824131,ECE 45,A01,083139,Staff,0,6,60,60
1650976830154,ECE 65,A50,083695,Staff,0,7,30,30
1650976836181,ECE 109,A01,091882,Touri; Behrouz,32,0,70,38
1650976842206,ECE 180,A00,083140,Abi Samra; Nicholas Camill,18,0,30,12
1650976842206,ECE 180,B00,083141,Abi Samra; Nicholas Camill,0,0,30,30
1650976848232,MATH 10A,A01,083735,Patchell; Gregory David,2,0,30,28
1650976848232,MATH 10A,A02,083736,Patchell; Gregory David,27,0,30,3
1650976848232,MATH 10A,A03,083737,Patchell; Gregory David,23,0,30,7
1650976854271,MATH 10B,A01,083207,Staff,0,9,30,30
1650976854271,MATH 10B,A02,083208,Staff,0,5,30,30
1650976854271,MATH 10B,B01,083739,Staff,9,0,30,21
1650976854271,MATH 10B,B02,083740,Staff,28,0,30,2
1650976860307,MATH 18,A01,083743,Staff,0,0,30,30
1650976860307,MATH 18,A02,083744,Staff,24,0,30,6
1650976860307,MATH 18,A03,083745,Staff,19,0,30,11
1650976860307,MATH 18,A04,083746,Staff,26,0,30,4
1650976860307,MATH 18,B01,083748,Staff,0,15,30,30
1650976860307,MATH 18,B02,083749,Staff,0,14,30,30
1650976860307,MATH 18,B03,083750,Staff,0,13,30,30
1650976860307,MATH 18,B04,083751,Staff,0,13,30,30
1650976866334,MATH 20A,A01,083754,Staff,19,0,40,21
1650976872366,MATH 20B,A01,083756,Staff,0,14,30,30
1650976872366,MATH 20B,A02,083757,Staff,0,11,30,30
1650976878400,MATH 20C,A01,083760,Staff,0,17,30,30
1650976878400,MATH 20C,A02,083761,Staff,0,15,30,30
1650976878400,MATH 20C,B01,083762,Staff,9,0,30,21
1650976878400,MATH 20C,B02,083763,Staff,28,0,30,2
1650976884425,MATH 20D,A01,083765,Staff,2,1,30,28
1650976884425,MATH 20D,A02,083766,Staff,2,0,30,28
1650976884425,MATH 20D,A03,083767,Staff,22,0,30,8
1650976890451,MATH 20E,A01,083771,Staff,2,0,30,28
1650976890451,MATH 20E,A02,083772,Staff,13,0,30,17
1650976890451,MATH 20E,B01,083773,Staff,0,0,30,30
1650976890451,MATH 20E,B02,083774,Staff,1,0,30,29
1650976896482,MATH 103A,A01,083777,Staff,0,17,30,30
1650976896482,MATH 103A,A02,083778,Staff,0,15,30,30
1650976896482,MATH 103A,B01,083779,Staff,0,15,30,30
1650976896482,MATH 103A,B02,083780,Staff,0,14,30,30
1650976902508,MATH 105,A01,085443,Staff,0,23,30,30
1650976908534,MATH 109,A01,083213,Anzaldo; Leesa B,0,7,30,30
1650976908534,MATH 109,A02,083214,Anzaldo; Leesa B,0,7,30,30
1650976908534,MATH 109,B01,083215,Anzaldo; Leesa B,0,8,30,30
1650976908534,MATH 109,B02,083216,Anzaldo; Leesa B,0,7,30,30
1650976914565,MATH 142A,A01,083219,Chow; Bennett,0,14,30,30
1650976914565,MATH 142A,A02,083220,Chow; Bennett,0,15,30,30
1650976914565,MATH 142A,B01,083221,Chow; Bennett,0,16,30,30
1650976914565,MATH 142A,B02,083222,Chow; Bennett,0,14,30,30
1650976920599,MATH 193A,A01,083224,Staff,0,6,30,30
1650976920599,MATH 193A,A02,083225,Staff,0,7,30,30
1650976920599,MATH 193A,A03,083781,Staff,0,6,30,30
1650976920599,MATH 193A,A04,083782,Staff,0,7,30,30
1650976926623,MATH 197,001,091859,McAuley; Julian John,9998,0,9999,1
1650976932681,COGS 9,A01,083615,Staff,0,18,60,60
1650976938706,COGS 11,A01,083617,Boyle; Mary E. T.,15,0,40,25
1650976944733,COGS 13,A01,083071,Staff,0,41,40,40
1650976950760,COGS 14A,A01,092681,Staff,0,38,100,100
1650976956791,COGS 14B,A01,083073,Cheng; Tzu-Han,0,13,50,50
1650976962817,COGS 17,A01,092677,Staff,6,0,75,69
1650976968841,COGS 100,A01,083619,Staff,0,31,60,60
1650976974867,COGS 101A,A01,083621,Davis; Joshua Daniel,0,29,60,60
1650976980896,COGS 101B,A01,091572,Staff,0,5,60,60
1650976986926,COGS 101C,A01,083625,Delgado; Tania,14,0,30,16
1650976992953,COGS 107A,A01,083627,Boyle; Mary E. T.,0,16,60,60
1650976998977,COGS 118A,A01,083075,Staff,0,10,60,60
1650977005004,CSE 3,A50,083646,Miranda; Gregory Joseph,15,0,38,23
1650977005004,CSE 3,A51,083647,Miranda; Gregory Joseph,36,0,37,1
1650977011032,CSE 8A,A50,083650,Miranda; Gregory Joseph,0,31,40,40
1650977017057,CSE 11,A01,083080,Cao; Yingjun,0,98,40,40
1650977023081,CSE 12,A01,083652,Staff,0,24,100,100
1650977029108,CSE 15L,A01,083654,Staff,0,3,50,50
1650977029108,CSE 15L,A02,083655,Staff,0,3,50,50
1650977035133,CSE 20,A01,083657,Staff,47,0,80,33
1650977041157,CSE 30,A01,083084,Eldon; John,1,38,80,79
1650977047183,CSE 100,A01,083659,Cao; Yingjun,0,71,50,50
1650977053212,CSE 134B,A01,083661,Powell; Thomas Allan,1,40,65,64
1650977059239,CSE 140,A01,083663,Staff,0,13,75,75
1650977065268,CSE 140L,A01,083088,Eldon; John,4,0,100,96
1650977071293,CSE 175,A01,083665,Kumar; Rakesh,0,0,25,25
1650977077324,CSE 190,A00,092507,Dubnov; Shlomo,9,0,20,11
1650977083351,ECE 45,A01,083139,Staff,0,6,60,60
1650977089380,ECE 65,A50,083695,Staff,0,7,30,30
1650977095408,ECE 109,A01,091882,Touri; Behrouz,32,0,70,38
1650977101434,ECE 180,A00,083140,Abi Samra; Nicholas Camill,18,0,30,12
1650977101434,ECE 180,B00,083141,Abi Samra; Nicholas Camill,0,0,30,30
1650977107459,MATH 10A,A01,083735,Patchell; Gregory David,2,0,30,28
1650977107459,MATH 10A,A02,083736,Patchell; Gregory David,27,0,30,3
1650977107459,MATH 10A,A03,083737,Patchell; Gregory David,23,0,30,7
1650977113482,MATH 10B,A01,083207,Staff,0,9,30,30
1650977113482,MATH 10B,A02,083208,Staff,0,5,30,30
1650977113482,MATH 10B,B01,083739,Staff,9,0,30,21
1650977113482,MATH 10B,B02,083740,Staff,28,0,30,2
1650977119509,MATH 18,A01,083743,Staff,0,0,30,30
1650977119509,MATH 18,A02,083744,Staff,24,0,30,6
1650977119509,MATH 18,A03,083745,Staff,19,0,30,11
1650977119509,MATH 18,A04,083746,Staff,26,0,30,4
1650977119509,MATH 18,B01,083748,Staff,0,15,30,30
1650977119509,MATH 18,B02,083749,Staff,0,14,30,30
1650977119509,MATH 18,B03,083750,Staff,0,13,30,30
1650977119509,MATH 18,B04,083751,Staff,0,13,30,30
1650977125532,MATH 20A,A01,083754,Staff,19,0,40,21
1650977131558,MATH 20B,A01,083756,Staff,0,14,30,30
1650977131558,MATH 20B,A02,083757,Staff,0,11,30,30
1650977137584,MATH 20C,A01,083760,Staff,0,17,30,30
1650977137584,MATH 20C,A02,083761,Staff,0,15,30,30
1650977137584,MATH 20C,B01,083762,Staff,9,0,30,21
1650977137584,MATH 20C,B02,083763,Staff,28,0,30,2
1650977143608,MATH 20D,A01,083765,Staff,2,1,30,28
1650977143608,MATH 20D,A02,083766,Staff,2,0,30,28
1650977143608,MATH 20D,A03,083767,Staff,22,0,30,8
1650977149630,MATH 20E,A01,083771,Staff,2,0,30,28
1650977149630,MATH 20E,A02,083772,Staff,13,0,30,17
1650977149630,MATH 20E,B01,083773,Staff,0,0,30,30
1650977149630,MATH 20E,B02,083774,Staff,1,0,30,29
1650977155654,MATH 103A,A01,083777,Staff,0,17,30,30
1650977155654,MATH 103A,A02,083778,Staff,0,15,30,30
1650977155654,MATH 103A,B01,083779,Staff,0,15,30,30
1650977155654,MATH 103A,B02,083780,Staff,0,14,30,30
1650977161679,MATH 105,A01,085443,Staff,0,23,30,30
1650977167704,MATH 109,A01,083213,Anzaldo; Leesa B,0,7,30,30
1650977167704,MATH 109,A02,083214,Anzaldo; Leesa B,0,7,30,30
1650977167704,MATH 109,B01,083215,Anzaldo; Leesa B,0,8,30,30
1650977167704,MATH 109,B02,083216,Anzaldo; Leesa B,0,7,30,30
1650977173734,MATH 142A,A01,083219,Chow; Bennett,0,14,30,30
1650977173734,MATH 142A,A02,083220,Chow; Bennett,0,15,30,30
1650977173734,MATH 142A,B01,083221,Chow; Bennett,0,16,30,30
1650977173734,MATH 142A,B02,083222,Chow; Bennett,0,14,30,30
1650977179762,MATH 193A,A01,083224,Staff,0,6,30,30
1650977179762,MATH 193A,A02,083225,Staff,0,7,30,30
1650977179762,MATH 193A,A03,083781,Staff,0,6,30,30
1650977179762,MATH 193A,A04,083782,Staff,0,7,30,30
1650977185789,MATH 197,001,091859,McAuley; Julian John,9998,0,9999,1
1650977191854,COGS 9,A01,083615,Staff,0,18,60,60
1650977197879,COGS 11,A01,083617,Boyle; Mary E. T.,15,0,40,25
1650977203902,COGS 13,A01,083071,Staff,0,41,40,40
1650977209925,COGS 14A,A01,092681,Staff,0,38,100,100
1650977215953,COGS 14B,A01,083073,Cheng; Tzu-Han,0,13,50,50
1650977221986,COGS 17,A01,092677,Staff,6,0,75,69
1650977228014,COGS 100,A01,083619,Staff,0,31,60,60
1650977234044,COGS 101A,A01,083621,Davis; Joshua Daniel,0,29,60,60
1650977240068,COGS 101B,A01,091572,Staff,0,5,60,60
1650977246095,COGS 101C,A01,083625,Delgado; Tania,14,0,30,16
1650977252119,COGS 107A,A01,083627,Boyle; Mary E. T.,0,16,60,60
1650977258146,COGS 118A,A01,083075,Staff,0,10,60,60
1650977264266,CSE 3,A50,083646,Miranda; Gregory Joseph,15,0,38,23
1650977264266,CSE 3,A51,083647,Miranda; Gregory Joseph,36,0,37,1
1650977270295,CSE 8A,A50,083650,Miranda; Gregory Joseph,0,31,40,40
1650977276321,CSE 11,A01,083080,Cao; Yingjun,0,98,40,40
1650977282350,CSE 12,A01,083652,Staff,0,24,100,100
1650977288377,CSE 15L,A01,083654,Staff,0,3,50,50
1650977288377,CSE 15L,A02,083655,Staff,0,3,50,50
1650977294406,CSE 20,A01,083657,Staff,47,0,80,33
1650977300430,CSE 30,A01,083084,Eldon; John,1,38,80,79
1650977306455,CSE 100,A01,083659,Cao; Yingjun,0,71,50,50
1650977312479,CSE 134B,A01,083661,Powell; Thomas Allan,1,40,65,64
1650977318503,CSE 140,A01,083663,Staff,0,13,75,75
1650977324531,CSE 140L,A01,083088,Eldon; John,4,0,100,96
1650977330556,CSE 175,A01,083665,Kumar; Rakesh,0,0,25,25
1650977336588,CSE 190,A00,092507,Dubnov; Shlomo,9,0,20,11
1650977342611,ECE 45,A01,083139,Staff,0,6,60,60
1650977348636,ECE 65,A50,083695,Staff,0,7,30,30
1650977354673,ECE 109,A01,091882,Touri; Behrouz,32,0,70,38
1650977360700,ECE 180,A00,083140,Abi Samra; Nicholas Camill,18,0,30,12
1650977360700,ECE 180,B00,083141,Abi Samra; Nicholas Camill,0,0,30,30
1650977366732,MATH 10A,A01,083735,Patchell; Gregory David,2,0,30,28
1650977366732,MATH 10A,A02,083736,Patchell; Gregory David,27,0,30,3
1650977366732,MATH 10A,A03,083737,Patchell; Gregory David,23,0,30,7
1650977372763,MATH 10B,A01,083207,Staff,0,9,30,30
1650977372763,MATH 10B,A02,083208,Staff,0,5,30,30
1650977372763,MATH 10B,B01,083739,Staff,9,0,30,21
1650977372763,MATH 10B,B02,083740,Staff,28,0,30,2
1650977378791,MATH 18,A01,083743,Staff,0,0,30,30
1650977378791,MATH 18,A02,083744,Staff,24,0,30,6
1650977378791,MATH 18,A03,083745,Staff,19,0,30,11
1650977378791,MATH 18,A04,083746,Staff,26,0,30,4
1650977378791,MATH 18,B01,083748,Staff,0,15,30,30
1650977378791,MATH 18,B02,083749,Staff,0,14,30,30
1650977378791,MATH 18,B03,083750,Staff,0,13,30,30
1650977378791,MATH 18,B04,083751,Staff,0,13,30,30
1650977384816,MATH 20A,A01,083754,Staff,19,0,40,21
1650977390855,MATH 20B,A01,083756,Staff,0,14,30,30
1650977390855,MATH 20B,A02,083757,Staff,0,11,30,30
1650977396878,MATH 20C,A01,083760,Staff,0,17,30,30
1650977396878,MATH 20C,A02,083761,Staff,0,15,30,30
1650977396878,MATH 20C,B01,083762,Staff,9,0,30,21
1650977396878,MATH 20C,B02,083763,Staff,28,0,30,2
1650977402902,MATH 20D,A01,083765,Staff,2,1,30,28
1650977402902,MATH 20D,A02,083766,Staff,2,0,30,28
1650977402902,MATH 20D,A03,083767,Staff,22,0,30,8
1650977408927,MATH 20E,A01,083771,Staff,2,0,30,28
1650977408927,MATH 20E,A02,083772,Staff,13,0,30,17
1650977408927,MATH 20E,B01,083773,Staff,0,0,30,30
1650977408927,MATH 20E,B02,083774,Staff,1,0,30,29
1650977414959,MATH 103A,A01,083777,Staff,0,17,30,30
1650977414959,MATH 103A,A02,083778,Staff,0,15,30,30
1650977414959,MATH 103A,B01,083779,Staff,0,15,30,30
1650977414959,MATH 103A,B02,083780,Staff,0,14,30,30
1650977420983,MATH 105,A01,085443,Staff,0,23,30,30
1650977427008,MATH 109,A01,083213,Anzaldo; Leesa B,0,7,30,30
1650977427008,MATH 109,A02,083214,Anzaldo; Leesa B,0,7,30,30
1650977427008,MATH 109,B01,083215,Anzaldo; Leesa B,0,8,30,30
1650977427008,MATH 109,B02,083216,Anzaldo; Leesa B,0,7,30,30
1650977433038,MATH 142A,A01,083219,Chow; Bennett,0,14,30,30
1650977433038,MATH 142A,A02,083220,Chow; Bennett,0,15,30,30
1650977433038,MATH 142A,B01,083221,Chow; Bennett,0,16,30,30
1650977433038,MATH 142A,B02,083222,Chow; Bennett,0,14,30,30
1650977439072,MATH 193A,A01,083224,Staff,0,6,30,30
1650977439072,MATH 193A,A02,083225,Staff,0,7,30,30
1650977439072,MATH 193A,A03,083781,Staff,0,6,30,30
1650977439072,MATH 193A,A04,083782,Staff,0,7,30,30
1650977445101,MATH 197,001,091859,McAuley; Julian John,9998,0,9999,1
1650977451157,COGS 9,A01,083615,Staff,0,18,60,60
1650977457187,COGS 11,A01,083617,Boyle; Mary E. T.,15,0,40,25
1650977463213,COGS 13,A01,083071,Staff,0,41,40,40
1650977469256,COGS 14A,A01,092681,Staff,0,38,100,100
1650977475347,COGS 14B,A01,083073,Cheng; Tzu-Han,0,13,50,50
1650977481374,COGS 17,A01,092677,Staff,6,0,75,69
1650977487403,COGS 100,A01,083619,Staff,0,31,60,60
1650977493428,COGS 101A,A01,083621,Davis; Joshua Daniel,0,29,60,60
1650977499454,COGS 101B,A01,091572,Staff,0,5,60,60
1650977505484,COGS 101C,A01,083625,Delgado; Tania,14,0,30,16
1650977511509,COGS 107A,A01,083627,Boyle; Mary E. T.,0,16,60,60
1650977517535,COGS 118A,A01,083075,Staff,0,10,60,60
1650977523564,CSE 3,A50,083646,Miranda; Gregory Joseph,15,0,38,23
1650977523564,CSE 3,A51,083647,Miranda; Gregory Joseph,36,0,37,1
1650977529590,CSE 8A,A50,083650,Miranda; Gregory Joseph,0,31,40,40
1650977535621,CSE 11,A01,083080,Cao; Yingjun,0,98,40,40
1650977541646,CSE 12,A01,083652,Staff,0,24,100,100
1650977547675,CSE 15L,A01,083654,Staff,0,3,50,50
1650977547675,CSE 15L,A02,083655,Staff,0,3,50,50
1650977553699,CSE 20,A01,083657,Staff,47,0,80,33
1650977559727,CSE 30,A01,083084,Eldon; John,1,38,80,79
1650977565755,CSE 100,A01,083659,Cao; Yingjun,0,71,50,50
1650977571787,CSE 134B,A01,083661,Powell; Thomas Allan,1,40,65,64
1650977577811,CSE 140,A01,083663,Staff,0,13,75,75
1650977583837,CSE 140L,A01,083088,Eldon; John,4,0,100,96
1650977589863,CSE 175,A01,083665,Kumar; Rakesh,0,0,25,25
1650977595890,CSE 190,A00,092507,Dubnov; Shlomo,9,0,20,11
1650977601913,ECE 45,A01,083139,Staff,0,6,60,60
1650977607945,ECE 65,A50,083695,Staff,0,7,30,30
1650977613972,ECE 109,A01,091882,Touri; Behrouz,32,0,70,38
1650977619997,ECE 180,A00,083140,Abi Samra; Nicholas Camill,18,0,30,12
1650977619997,ECE 180,B00,083141,Abi Samra; Nicholas Camill,0,0,30,30
1650977626030,MATH 10A,A01,083735,Patchell; Gregory David,2,0,30,28
1650977626030,MATH 10A,A02,083736,Patchell; Gregory David,27,0,30,3
1650977626030,MATH 10A,A03,083737,Patchell; Gregory David,23,0,30,7
1650977632063,MATH 10B,A01,083207,Staff,0,9,30,30
1650977632063,MATH 10B,A02,083208,Staff,0,5,30,30
1650977632063,MATH 10B,B01,083739,Staff,9,0,30,21
1650977632063,MATH 10B,B02,083740,Staff,28,0,30,2
1650977638098,MATH 18,A01,083743,Staff,0,0,30,30
1650977638098,MATH 18,A02,083744,Staff,24,0,30,6
1650977638098,MATH 18,A03,083745,Staff,19,0,30,11
1650977638098,MATH 18,A04,083746,Staff,26,0,30,4
1650977638098,MATH 18,B01,083748,Staff,0,15,30,30
1650977638098,MATH 18,B02,083749,Staff,0,14,30,30
1650977638098,MATH 18,B03,083750,Staff,0,13,30,30
1650977638098,MATH 18,B04,083751,Staff,0,13,30,30
1650977644125,MATH 20A,A01,083754,Staff,19,0,40,21
1650977650155,MATH 20B,A01,083756,Staff,0,14,30,30
1650977650155,MATH 20B,A02,083757,Staff,0,11,30,30
1650977656190,MATH 20C,A01,083760,Staff,0,17,30,30
1650977656190,MATH 20C,A02,083761,Staff,0,15,30,30
1650977656190,MATH 20C,B01,083762,Staff,9,0,30,21
1650977656190,MATH 20C,B02,083763,Staff,28,0,30,2
1650977662219,MATH 20D,A01,083765,Staff,2,1,30,28
1650977662219,MATH 20D,A02,083766,Staff,2,0,30,28
1650977662219,MATH 20D,A03,083767,Staff,22,0,30,8
1650977668250,MATH 20E,A01,083771,Staff,2,0,30,28
1650977668250,MATH 20E,A02,083772,Staff,12,0,30,18
1650977668250,MATH 20E,B01,083773,Staff,0,0,30,30
1650977668250,MATH 20E,B02,083774,Staff,1,0,30,29
1650977674283,MATH 103A,A01,083777,Staff,0,17,30,30
1650977674283,MATH 103A,A02,083778,Staff,0,15,30,30
1650977674283,MATH 103A,B01,083779,Staff,0,15,30,30
1650977674283,MATH 103A,B02,083780,Staff,0,14,30,30
1650977680312,MATH 105,A01,085443,Staff,0,23,30,30
1650977686345,MATH 109,A01,083213,Anzaldo; Leesa B,0,7,30,30
1650977686345,MATH 109,A02,083214,Anzaldo; Leesa B,0,7,30,30
1650977686345,MATH 109,B01,083215,Anzaldo; Leesa B,0,8,30,30
1650977686345,MATH 109,B02,083216,Anzaldo; Leesa B,0,7,30,30
1650977692371,MATH 142A,A01,083219,Chow; Bennett,0,14,30,30
1650977692371,MATH 142A,A02,083220,Chow; Bennett,0,15,30,30
1650977692371,MATH 142A,B01,083221,Chow; Bennett,0,16,30,30
1650977692371,MATH 142A,B02,083222,Chow; Bennett,0,14,30,30
1650977698397,MATH 193A,A01,083224,Staff,0,6,30,30
1650977698397,MATH 193A,A02,083225,Staff,0,7,30,30
1650977698397,MATH 193A,A03,083781,Staff,0,6,30,30
1650977698397,MATH 193A,A04,083782,Staff,0,7,30,30
1650977704426,MATH 197,001,091859,McAuley; Julian John,9998,0,9999,1
1650977710497,COGS 9,A01,083615,Staff,0,18,60,60
1650977716525,COGS 11,A01,083617,Boyle; Mary E. T.,15,0,40,25
1650977722551,COGS 13,A01,083071,Staff,0,41,40,40
1650977728585,COGS 14A,A01,092681,Staff,0,38,100,100
1650977734615,COGS 14B,A01,083073,Cheng; Tzu-Han,0,13,50,50
1650977740643,COGS 17,A01,092677,Staff,6,0,75,69
1650977746667,COGS 100,A01,083619,Staff,0,31,60,60
1650977752692,COGS 101A,A01,083621,Davis; Joshua Daniel,0,29,60,60
1650977758717,COGS 101B,A01,091572,Staff,0,5,60,60
1650977764745,COGS 101C,A01,083625,Delgado; Tania,14,0,30,16
1650977770778,COGS 107A,A01,083627,Boyle; Mary E. T.,0,16,60,60
1650977776808,COGS 118A,A01,083075,Staff,0,10,60,60
1650977782832,CSE 3,A50,083646,Miranda; Gregory Joseph,15,0,38,23
1650977782832,CSE 3,A51,083647,Miranda; Gregory Joseph,36,0,37,1
1650977788860,CSE 8A,A50,083650,Miranda; Gregory Joseph,0,31,40,40
1650977794885,CSE 11,A01,083080,Cao; Yingjun,0,97,40,40
1650977800913,CSE 12,A01,083652,Staff,0,24,100,100
1650977806938,CSE 15L,A01,083654,Staff,0,3,50,50
1650977806938,CSE 15L,A02,083655,Staff,0,3,50,50
1650977812964,CSE 20,A01,083657,Staff,47,0,80,33
1650977818987,CSE 30,A01,083084,Eldon; John,1,38,80,79
1650977825018,CSE 100,A01,083659,Cao; Yingjun,0,71,50,50
1650977831050,CSE 134B,A01,083661,Powell; Thomas Allan,1,40,65,64
1650977837081,CSE 140,A01,083663,Staff,0,13,75,75
1650977843111,CSE 140L,A01,083088,Eldon; John,4,0,100,96
1650977849137,CSE 175,A01,083665,Kumar; Rakesh,0,0,25,25
1650977855177,CSE 190,A00,092507,Dubnov; Shlomo,9,0,20,11
1650977861289,ECE 45,A01,083139,Staff,0,6,60,60
1650977867317,ECE 65,A50,083695,Staff,0,7,30,30
1650977873342,ECE 109,A01,091882,Touri; Behrouz,32,0,70,38
1650977879368,ECE 180,A00,083140,Abi Samra; Nicholas Camill,18,0,30,12
1650977879368,ECE 180,B00,083141,Abi Samra; Nicholas Camill,0,0,30,30
1650977885410,MATH 10A,A01,083735,Patchell; Gregory David,2,0,30,28
1650977885410,MATH 10A,A02,083736,Patchell; Gregory David,27,0,30,3
1650977885410,MATH 10A,A03,083737,Patchell; Gregory David,23,0,30,7
1650977891443,MATH 10B,A01,083207,Staff,0,9,30,30
1650977891443,MATH 10B,A02,083208,Staff,0,5,30,30
1650977891443,MATH 10B,B01,083739,Staff,9,0,30,21
1650977891443,MATH 10B,B02,083740,Staff,28,0,30,2
1650977897474,MATH 18,A01,083743,Staff,0,0,30,30
1650977897474,MATH 18,A02,083744,Staff,24,0,30,6
1650977897474,MATH 18,A03,083745,Staff,19,0,30,11
1650977897474,MATH 18,A04,083746,Staff,26,0,30,4
1650977897474,MATH 18,B01,083748,Staff,0,15,30,30
1650977897474,MATH 18,B02,083749,Staff,0,14,30,30
1650977897474,MATH 18,B03,083750,Staff,0,13,30,30
1650977897474,MATH 18,B04,083751,Staff,0,13,30,30
1650977903497,MATH 20A,A01,083754,Staff,19,0,40,21
1650977909528,MATH 20B,A01,083756,Staff,0,14,30,30
1650977909528,MATH 20B,A02,083757,Staff,0,11,30,30
1650977915554,MATH 20C,A01,083760,Staff,0,17,30,30
1650977915554,MATH 20C,A02,083761,Staff,0,15,30,30
1650977915554,MATH 20C,B01,083762,Staff,9,0,30,21
1650977915554,MATH 20C,B02,083763,Staff,28,0,30,2
1650977921576,MATH 20D,A01,083765,Staff,2,1,30,28
1650977921576,MATH 20D,A02,083766,Staff,2,0,30,28
1650977921576,MATH 20D,A03,083767,Staff,22,0,30,8
1650977927601,MATH 20E,A01,083771,Staff,2,0,30,28
1650977927601,MATH 20E,A02,083772,Staff,12,0,30,18
1650977927601,MATH 20E,B01,083773,Staff,0,0,30,30
1650977927601,MATH 20E,B02,083774,Staff,1,0,30,29
1650977933624,MATH 103A,A01,083777,Staff,0,17,30,30
1650977933624,MATH 103A,A02,083778,Staff,0,15,30,30
1650977933624,MATH 103A,B01,083779,Staff,0,15,30,30
1650977933624,MATH 103A,B02,083780,Staff,0,14,30,30
1650977939654,MATH 105,A01,085443,Staff,0,23,30,30
1650977945679,MATH 109,A01,083213,Anzaldo; Leesa B,0,7,30,30
1650977945679,MATH 109,A02,083214,Anzaldo; Leesa B,0,7,30,30
1650977945679,MATH 109,B01,083215,Anzaldo; Leesa B,0,8,30,30
1650977945679,MATH 109,B02,083216,Anzaldo; Leesa B,0,7,30,30
1650977951704,MATH 142A,A01,083219,Chow; Bennett,0,14,30,30
1650977951704,MATH 142A,A02,083220,Chow; Bennett,0,15,30,30
1650977951704,MATH 142A,B01,083221,Chow; Bennett,0,16,30,30
1650977951704,MATH 142A,B02,083222,Chow; Bennett,0,14,30,30
1650977957728,MATH 193A,A01,083224,Staff,0,6,30,30
1650977957728,MATH 193A,A02,083225,Staff,0,7,30,30
1650977957728,MATH 193A,A03,083781,Staff,0,6,30,30
1650977957728,MATH 193A,A04,083782,Staff,0,7,30,30
1650977963754,MATH 197,001,091859,McAuley; Julian John,9998,0,9999,1
1650977969827,COGS 9,A01,083615,Staff,0,18,60,60
1650977975852,COGS 11,A01,083617,Boyle; Mary E. T.,15,0,40,25
1650977981877,COGS 13,A01,083071,Staff,0,41,40,40
1650977987907,COGS 14A,A01,092681,Staff,0,38,100,100
1650977993933,COGS 14B,A01,083073,Cheng; Tzu-Han,0,13,50,50
1650977999956,COGS 17,A01,092677,Staff,6,0,75,69
1650978005981,COGS 100,A01,083619,Staff,0,31,60,60
1650978012026,COGS 101A,A01,083621,Davis; Joshua Daniel,0,29,60,60
1650978018050,COGS 101B,A01,091572,Staff,0,5,60,60
1650978024078,COGS 101C,A01,083625,Delgado; Tania,14,0,30,16
1650978030115,COGS 107A,A01,083627,Boyle; Mary E. T.,0,16,60,60
1650978036141,COGS 118A,A01,083075,Staff,0,10,60,60
1650978042177,CSE 3,A50,083646,Miranda; Gregory Joseph,15,0,38,23
1650978042177,CSE 3,A51,083647,Miranda; Gregory Joseph,36,0,37,1
1650978048202,CSE 8A,A50,083650,Miranda; Gregory Joseph,0,31,40,40
1650978054227,CSE 11,A01,083080,Cao; Yingjun,0,97,40,40
1650978060253,CSE 12,A01,083652,Staff,0,24,100,100
1650978066284,CSE 15L,A01,083654,Staff,0,3,50,50
1650978066284,CSE 15L,A02,083655,Staff,0,3,50,50
1650978072311,CSE 20,A01,083657,Staff,47,0,80,33
1650978078341,CSE 30,A01,083084,Eldon; John,1,38,80,79
1650978084366,CSE 100,A01,083659,Cao; Yingjun,0,71,50,50
1650978090393,CSE 134B,A01,083661,Powell; Thomas Allan,1,40,65,64
1650978096418,CSE 140,A01,083663,Staff,0,13,75,75
1650978102450,CSE 140L,A01,083088,Eldon; John,4,0,100,96
1650978108480,CSE 175,A01,083665,Kumar; Rakesh,0,0,25,25
1650978114505,CSE 190,A00,092507,Dubnov; Shlomo,9,0,20,11
1650978120543,ECE 45,A01,083139,Staff,0,6,60,60
1650978126571,ECE 65,A50,083695,Staff,0,7,30,30
1650978132595,ECE 109,A01,091882,Touri; Behrouz,32,0,70,38
1650978138620,ECE 180,A00,083140,Abi Samra; Nicholas Camill,18,0,30,12
1650978138620,ECE 180,B00,083141,Abi Samra; Nicholas Camill,0,0,30,30
1650978144654,MATH 10A,A01,083735,Patchell; Gregory David,2,0,30,28
1650978144654,MATH 10A,A02,083736,Patchell; Gregory David,27,0,30,3
1650978144654,MATH 10A,A03,083737,Patchell; Gregory David,23,0,30,7
1650978150683,MATH 10B,A01,083207,Staff,0,9,30,30
1650978150683,MATH 10B,A02,083208,Staff,0,5,30,30
1650978150683,MATH 10B,B01,083739,Staff,9,0,30,21
1650978150683,MATH 10B,B02,083740,Staff,28,0,30,2
1650978156712,MATH 18,A01,083743,Staff,0,0,30,30
1650978156712,MATH 18,A02,083744,Staff,24,0,30,6
1650978156712,MATH 18,A03,083745,Staff,19,0,30,11
1650978156712,MATH 18,A04,083746,Staff,26,0,30,4
1650978156712,MATH 18,B01,083748,Staff,0,15,30,30
1650978156712,MATH 18,B02,083749,Staff,0,14,30,30
1650978156712,MATH 18,B03,083750,Staff,0,13,30,30
1650978156712,MATH 18,B04,083751,Staff,0,13,30,30
1650978162737,MATH 20A,A01,083754,Staff,19,0,40,21
1650978168762,MATH 20B,A01,083756,Staff,0,14,30,30
1650978168762,MATH 20B,A02,083757,Staff,0,11,30,30
1650978174788,MATH 20C,A01,083760,Staff,0,17,30,30
1650978174788,MATH 20C,A02,083761,Staff,0,15,30,30
1650978174788,MATH 20C,B01,083762,Staff,9,0,30,21
1650978174788,MATH 20C,B02,083763,Staff,28,0,30,2
1650978180811,MATH 20D,A01,083765,Staff,2,1,30,28
1650978180811,MATH 20D,A02,083766,Staff,2,0,30,28
1650978180811,MATH 20D,A03,083767,Staff,22,0,30,8
1650978186840,MATH 20E,A01,083771,Staff,2,0,30,28
1650978186840,MATH 20E,A02,083772,Staff,12,0,30,18
1650978186840,MATH 20E,B01,083773,Staff,0,0,30,30
1650978186840,MATH 20E,B02,083774,Staff,1,0,30,29
1650978192871,MATH 103A,A01,083777,Staff,0,17,30,30
1650978192871,MATH 103A,A02,083778,Staff,0,15,30,30
1650978192871,MATH 103A,B01,083779,Staff,0,15,30,30
1650978192871,MATH 103A,B02,083780,Staff,0,14,30,30
1650978198899,MATH 105,A01,085443,Staff,0,23,30,30
1650978204932,MATH 109,A01,083213,Anzaldo; Leesa B,0,7,30,30
1650978204932,MATH 109,A02,083214,Anzaldo; Leesa B,0,7,30,30
1650978204932,MATH 109,B01,083215,Anzaldo; Leesa B,0,8,30,30
1650978204932,MATH 109,B02,083216,Anzaldo; Leesa B,0,7,30,30
1650978210962,MATH 142A,A01,083219,Chow; Bennett,0,14,30,30
1650978210962,MATH 142A,A02,083220,Chow; Bennett,0,15,30,30
1650978210962,MATH 142A,B01,083221,Chow; Bennett,0,16,30,30
1650978210962,MATH 142A,B02,083222,Chow; Bennett,0,14,30,30
1650978216985,MATH 193A,A01,083224,Staff,0,6,30,30
1650978216985,MATH 193A,A02,083225,Staff,0,7,30,30
1650978216985,MATH 193A,A03,083781,Staff,0,6,30,30
1650978216985,MATH 193A,A04,083782,Staff,0,7,30,30
1650978223009,MATH 197,001,091859,McAuley; Julian John,9998,0,9999,1
1650978229078,COGS 9,A01,083615,Staff,0,18,60,60
1650978235114,COGS 11,A01,083617,Boyle; Mary E. T.,15,0,40,25
1650978241138,COGS 13,A01,083071,Staff,0,41,40,40
1650978247163,COGS 14A,A01,092681,Staff,0,38,100,100
1650978253192,COGS 14B,A01,083073,Cheng; Tzu-Han,0,13,50,50
1650978259219,COGS 17,A01,092677,Staff,6,0,75,69
1650978265244,COGS 100,A01,083619,Staff,0,31,60,60
1650978271271,COGS 101A,A01,083621,Davis; Joshua Daniel,0,29,60,60
1650978277300,COGS 101B,A01,091572,Staff,0,5,60,60
1650978283325,COGS 101C,A01,083625,Delgado; Tania,14,0,30,16
1650978289352,COGS 107A,A01,083627,Boyle; Mary E. T.,0,16,60,60
1650978295376,COGS 118A,A01,083075,Staff,0,10,60,60
1650978301408,CSE 3,A50,083646,Miranda; Gregory Joseph,15,0,38,23
1650978301408,CSE 3,A51,083647,Miranda; Gregory Joseph,36,0,37,1
1650978307436,CSE 8A,A50,083650,Miranda; Gregory Joseph,0,31,40,40
1650978313461,CSE 11,A01,083080,Cao; Yingjun,0,97,40,40
1650978319487,CSE 12,A01,083652,Staff,0,24,100,100
1650978325515,CSE 15L,A01,083654,Staff,0,3,50,50
1650978325515,CSE 15L,A02,083655,Staff,0,3,50,50
1650978331540,CSE 20,A01,083657,Staff,47,0,80,33
1650978337568,CSE 30,A01,083084,Eldon; John,1,38,80,79
1650978343599,CSE 100,A01,083659,Cao; Yingjun,0,71,50,50
1650978349634,CSE 134B,A01,083661,Powell; Thomas Allan,1,40,65,64
1650978355665,CSE 140,A01,083663,Staff,0,13,75,75
1650978361690,CSE 140L,A01,083088,Eldon; John,4,0,100,96
1650978367719,CSE 175,A01,083665,Kumar; Rakesh,0,0,25,25
1650978373744,CSE 190,A00,092507,Dubnov; Shlomo,9,0,20,11
1650978379773,ECE 45,A01,083139,Staff,0,6,60,60
1650978385802,ECE 65,A50,083695,Staff,0,7,30,30
1650978391826,ECE 109,A01,091882,Touri; Behrouz,32,0,70,38
1650978397864,ECE 180,A00,083140,Abi Samra; Nicholas Camill,18,0,30,12
1650978397864,ECE 180,B00,083141,Abi Samra; Nicholas Camill,0,0,30,30
1650978403891,MATH 10A,A01,083735,Patchell; Gregory David,2,0,30,28
1650978403891,MATH 10A,A02,083736,Patchell; Gregory David,27,0,30,3
1650978403891,MATH 10A,A03,083737,Patchell; Gregory David,23,0,30,7
1650978409916,MATH 10B,A01,083207,Staff,0,9,30,30
1650978409916,MATH 10B,A02,083208,Staff,0,5,30,30
1650978409916,MATH 10B,B01,083739,Staff,9,0,30,21
1650978409916,MATH 10B,B02,083740,Staff,28,0,30,2
1650978415954,MATH 18,A01,083743,Staff,0,0,30,30
1650978415954,MATH 18,A02,083744,Staff,24,0,30,6
1650978415954,MATH 18,A03,083745,Staff,19,0,30,11
1650978415954,MATH 18,A04,083746,Staff,26,0,30,4
1650978415954,MATH 18,B01,083748,Staff,0,15,30,30
1650978415954,MATH 18,B02,083749,Staff,0,14,30,30
1650978415954,MATH 18,B03,083750,Staff,0,13,30,30
1650978415954,MATH 18,B04,083751,Staff,0,13,30,30
1650978421981,MATH 20A,A01,083754,Staff,19,0,40,21
1650978428011,MATH 20B,A01,083756,Staff,0,14,30,30
1650978428011,MATH 20B,A02,083757,Staff,0,11,30,30
1650978434045,MATH 20C,A01,083760,Staff,0,17,30,30
1650978434045,MATH 20C,A02,083761,Staff,0,15,30,30
1650978434045,MATH 20C,B01,083762,Staff,9,0,30,21
1650978434045,MATH 20C,B02,083763,Staff,28,0,30,2
1650978440080,MATH 20D,A01,083765,Staff,2,1,30,28
1650978440080,MATH 20D,A02,083766,Staff,2,0,30,28
1650978440080,MATH 20D,A03,083767,Staff,22,0,30,8
1650978446117,MATH 20E,A01,083771,Staff,2,0,30,28
1650978446117,MATH 20E,A02,083772,Staff,12,0,30,18
1650978446117,MATH 20E,B01,083773,Staff,0,0,30,30
1650978446117,MATH 20E,B02,083774,Staff,1,0,30,29
1650978452143,MATH 103A,A01,083777,Staff,0,17,30,30
1650978452143,MATH 103A,A02,083778,Staff,0,15,30,30
1650978452143,MATH 103A,B01,083779,Staff,0,15,30,30
1650978452143,MATH 103A,B02,083780,Staff,0,14,30,30
1650978458265,MATH 105,A01,085443,Staff,0,23,30,30
1650978464291,MATH 109,A01,083213,Anzaldo; Leesa B,0,7,30,30
1650978464291,MATH 109,A02,083214,Anzaldo; Leesa B,0,7,30,30
1650978464291,MATH 109,B01,083215,Anzaldo; Leesa B,0,8,30,30
1650978464291,MATH 109,B02,083216,Anzaldo; Leesa B,0,7,30,30
1650978470321,MATH 142A,A01,083219,Chow; Bennett,0,14,30,30
1650978470321,MATH 142A,A02,083220,Chow; Bennett,0,15,30,30
1650978470321,MATH 142A,B01,083221,Chow; Bennett,0,16,30,30
1650978470321,MATH 142A,B02,083222,Chow; Bennett,0,14,30,30
1650978476349,MATH 193A,A01,083224,Staff,0,6,30,30
1650978476349,MATH 193A,A02,083225,Staff,0,7,30,30
1650978476349,MATH 193A,A03,083781,Staff,0,6,30,30
1650978476349,MATH 193A,A04,083782,Staff,0,7,30,30
1650978482373,MATH 197,001,091859,McAuley; Julian John,9998,0,9999,1
1650978488435,COGS 9,A01,083615,Staff,0,18,60,60
1650978494461,COGS 11,A01,083617,Boyle; Mary E. T.,15,0,40,25
1650978500490,COGS 13,A01,083071,Staff,0,41,40,40
1650978506513,COGS 14A,A01,092681,Staff,0,38,100,100
1650978512547,COGS 14B,A01,083073,Cheng; Tzu-Han,0,13,50,50
1650978518570,COGS 17,A01,092677,Staff,6,0,75,69
1650978524596,COGS 100,A01,083619,Staff,0,31,60,60
1650978530625,COGS 101A,A01,083621,Davis; Joshua Daniel,0,29,60,60
1650978536651,COGS 101B,A01,091572,Staff,0,5,60,60
1650978542676,COGS 101C,A01,083625,Delgado; Tania,14,0,30,16
1650978548718,COGS 107A,A01,083627,Boyle; Mary E. T.,0,16,60,60
1650978554747,COGS 118A,A01,083075,Staff,0,10,60,60
1650978560772,CSE 3,A50,083646,Miranda; Gregory Joseph,15,0,38,23
1650978560772,CSE 3,A51,083647,Miranda; Gregory Joseph,36,0,37,1
1650978566798,CSE 8A,A50,083650,Miranda; Gregory Joseph,0,31,40,40
1650978572831,CSE 11,A01,083080,Cao; Yingjun,0,97,40,40
1650978578857,CSE 12,A01,083652,Staff,0,24,100,100
1650978584881,CSE 15L,A01,083654,Staff,0,3,50,50
1650978584881,CSE 15L,A02,083655,Staff,0,3,50,50
1650978590910,CSE 20,A01,083657,Staff,47,0,80,33
1650978596936,CSE 30,A01,083084,Eldon; John,1,38,80,79
1650978602960,CSE 100,A01,083659,Cao; Yingjun,0,71,50,50
1650978608987,CSE 134B,A01,083661,Powell; Thomas Allan,1,40,65,64
1650978615012,CSE 140,A01,083663,Staff,0,13,75,75
1650978621037,CSE 140L,A01,083088,Eldon; John,4,0,100,96
1650978627066,CSE 175,A01,083665,Kumar; Rakesh,0,0,25,25
1650978633090,CSE 190,A00,092507,Dubnov; Shlomo,9,0,20,11
1650978639114,ECE 45,A01,083139,Staff,0,6,60,60
1650978645144,ECE 65,A50,083695,Staff,0,7,30,30
1650978651174,ECE 109,A01,091882,Touri; Behrouz,32,0,70,38
1650978657200,ECE 180,A00,083140,Abi Samra; Nicholas Camill,18,0,30,12
1650978657200,ECE 180,B00,083141,Abi Samra; Nicholas Camill,0,0,30,30
1650978663225,MATH 10A,A01,083735,Patchell; Gregory David,2,0,30,28
1650978663225,MATH 10A,A02,083736,Patchell; Gregory David,27,0,30,3
1650978663225,MATH 10A,A03,083737,Patchell; Gregory David,23,0,30,7
1650978669251,MATH 10B,A01,083207,Staff,0,9,30,30
1650978669251,MATH 10B,A02,083208,Staff,0,5,30,30
1650978669251,MATH 10B,B01,083739,Staff,9,0,30,21
1650978669251,MATH 10B,B02,083740,Staff,28,0,30,2
1650978675285,MATH 18,A01,083743,Staff,0,0,30,30
1650978675285,MATH 18,A02,083744,Staff,24,0,30,6
1650978675285,MATH 18,A03,083745,Staff,19,0,30,11
1650978675285,MATH 18,A04,083746,Staff,26,0,30,4
1650978675285,MATH 18,B01,083748,Staff,0,15,30,30
1650978675285,MATH 18,B02,083749,Staff,0,14,30,30
1650978675285,MATH 18,B03,083750,Staff,0,13,30,30
1650978675285,MATH 18,B04,083751,Staff,0,13,30,30
1650978681312,MATH 20A,A01,083754,Staff,19,0,40,21
1650978687337,MATH 20B,A01,083756,Staff,0,14,30,30
1650978687337,MATH 20B,A02,083757,Staff,0,11,30,30
1650978693367,MATH 20C,A01,083760,Staff,0,17,30,30
1650978693367,MATH 20C,A02,083761,Staff,0,15,30,30
1650978693367,MATH 20C,B01,083762,Staff,9,0,30,21
1650978693367,MATH 20C,B02,083763,Staff,28,0,30,2
1650978699391,MATH 20D,A01,083765,Staff,2,1,30,28
1650978699391,MATH 20D,A02,083766,Staff,2,0,30,28
1650978699391,MATH 20D,A03,083767,Staff,22,0,30,8
1650978705422,MATH 20E,A01,083771,Staff,2,0,30,28
1650978705422,MATH 20E,A02,083772,Staff,12,0,30,18
1650978705422,MATH 20E,B01,083773,Staff,0,0,30,30
1650978705422,MATH 20E,B02,083774,Staff,1,0,30,29
1650978711459,MATH 103A,A01,083777,Staff,0,17,30,30
1650978711459,MATH 103A,A02,083778,Staff,0,15,30,30
1650978711459,MATH 103A,B01,083779,Staff,0,15,30,30
1650978711459,MATH 103A,B02,083780,Staff,0,14,30,30
1650978717485,MATH 105,A01,085443,Staff,0,23,30,30
1650978723509,MATH 109,A01,083213,Anzaldo; Leesa B,0,7,30,30
1650978723509,MATH 109,A02,083214,Anzaldo; Leesa B,0,7,30,30
1650978723509,MATH 109,B01,083215,Anzaldo; Leesa B,0,8,30,30
1650978723509,MATH 109,B02,083216,Anzaldo; Leesa B,0,7,30,30
1650978729537,MATH 142A,A01,083219,Chow; Bennett,0,14,30,30
1650978729537,MATH 142A,A02,083220,Chow; Bennett,0,15,30,30
1650978729537,MATH 142A,B01,083221,Chow; Bennett,0,16,30,30
1650978729537,MATH 142A,B02,083222,Chow; Bennett,0,14,30,30
1650978735562,MATH 193A,A01,083224,Staff,0,6,30,30
1650978735562,MATH 193A,A02,083225,Staff,0,7,30,30
1650978735562,MATH 193A,A03,083781,Staff,0,6,30,30
1650978735562,MATH 193A,A04,083782,Staff,0,7,30,30
1650978741598,MATH 197,001,091859,McAuley; Julian John,9998,0,9999,1
1650978747674,COGS 9,A01,083615,Staff,0,18,60,60
1650978753699,COGS 11,A01,083617,Boyle; Mary E. T.,15,0,40,25
1650978759727,COGS 13,A01,083071,Staff,0,41,40,40
1650978765752,COGS 14A,A01,092681,Staff,0,38,100,100
1650978771778,COGS 14B,A01,083073,Cheng; Tzu-Han,0,13,50,50
1650978777801,COGS 17,A01,092677,Staff,6,0,75,69
1650978783827,COGS 100,A01,083619,Staff,0,31,60,60
1650978789852,COGS 101A,A01,083621,Davis; Joshua Daniel,0,29,60,60
1650978795875,COGS 101B,A01,091572,Staff,0,5,60,60
1650978801906,COGS 101C,A01,083625,Delgado; Tania,14,0,30,16
1650978807934,COGS 107A,A01,083627,Boyle; Mary E. T.,0,16,60,60
1650978813959,COGS 118A,A01,083075,Staff,0,10,60,60
1650978819993,CSE 3,A50,083646,Miranda; Gregory Joseph,15,0,38,23
1650978819993,CSE 3,A51,083647,Miranda; Gregory Joseph,36,0,37,1
1650978826022,CSE 8A,A50,083650,Miranda; Gregory Joseph,0,31,40,40
1650978832046,CSE 11,A01,083080,Cao; Yingjun,0,97,40,40
1650978838070,CSE 12,A01,083652,Staff,0,24,100,100
1650978844096,CSE 15L,A01,083654,Staff,0,3,50,50
1650978844096,CSE 15L,A02,083655,Staff,0,3,50,50
1650978850118,CSE 20,A01,083657,Staff,47,0,80,33
1650978856144,CSE 30,A01,083084,Eldon; John,1,38,80,79
1650978862169,CSE 100,A01,083659,Cao; Yingjun,0,71,50,50
1650978868194,CSE 134B,A01,083661,Powell; Thomas Allan,1,40,65,64
1650978874222,CSE 140,A01,083663,Staff,0,13,75,75
1650978880248,CSE 140L,A01,083088,Eldon; John,4,0,100,96
1650978886274,CSE 175,A01,083665,Kumar; Rakesh,0,0,25,25
1650978892298,CSE 190,A00,092507,Dubnov; Shlomo,9,0,20,11
1650978898323,ECE 45,A01,083139,Staff,0,6,60,60
1650978904347,ECE 65,A50,083695,Staff,0,7,30,30
1650978910370,ECE 109,A01,091882,Touri; Behrouz,32,0,70,38
1650978916398,ECE 180,A00,083140,Abi Samra; Nicholas Camill,18,0,30,12
1650978916398,ECE 180,B00,083141,Abi Samra; Nicholas Camill,0,0,30,30
1650978922430,MATH 10A,A01,083735,Patchell; Gregory David,2,0,30,28
1650978922430,MATH 10A,A02,083736,Patchell; Gregory David,27,0,30,3
1650978922430,MATH 10A,A03,083737,Patchell; Gregory David,23,0,30,7
1650978928463,MATH 10B,A01,083207,Staff,0,9,30,30
1650978928463,MATH 10B,A02,083208,Staff,0,5,30,30
1650978928463,MATH 10B,B01,083739,Staff,9,0,30,21
1650978928463,MATH 10B,B02,083740,Staff,28,0,30,2
1650978934497,MATH 18,A01,083743,Staff,0,0,30,30
1650978934497,MATH 18,A02,083744,Staff,24,0,30,6
1650978934497,MATH 18,A03,083745,Staff,19,0,30,11
1650978934497,MATH 18,A04,083746,Staff,26,0,30,4
1650978934497,MATH 18,B01,083748,Staff,0,15,30,30
1650978934497,MATH 18,B02,083749,Staff,0,14,30,30
1650978934497,MATH 18,B03,083750,Staff,0,13,30,30
1650978934497,MATH 18,B04,083751,Staff,0,13,30,30
1650978940522,MATH 20A,A01,083754,Staff,19,0,40,21
1650978946554,MATH 20B,A01,083756,Staff,0,14,30,30
1650978946554,MATH 20B,A02,083757,Staff,0,11,30,30
1650978952584,MATH 20C,A01,083760,Staff,0,17,30,30
1650978952584,MATH 20C,A02,083761,Staff,0,15,30,30
1650978952584,MATH 20C,B01,083762,Staff,9,0,30,21
1650978952584,MATH 20C,B02,083763,Staff,28,0,30,2
1650978958607,MATH 20D,A01,083765,Staff,2,1,30,28
1650978958607,MATH 20D,A02,083766,Staff,2,0,30,28
1650978958607,MATH 20D,A03,083767,Staff,22,0,30,8
1650978964632,MATH 20E,A01,083771,Staff,2,0,30,28
1650978964632,MATH 20E,A02,083772,Staff,12,0,30,18
1650978964632,MATH 20E,B01,083773,Staff,0,0,30,30
1650978964632,MATH 20E,B02,083774,Staff,1,0,30,29
1650978970657,MATH 103A,A01,083777,Staff,0,17,30,30
1650978970657,MATH 103A,A02,083778,Staff,0,15,30,30
1650978970657,MATH 103A,B01,083779,Staff,0,15,30,30
1650978970657,MATH 103A,B02,083780,Staff,0,14,30,30
1650978976683,MATH 105,A01,085443,Staff,0,23,30,30
1650978982713,MATH 109,A01,083213,Anzaldo; Leesa B,0,7,30,30
1650978982713,MATH 109,A02,083214,Anzaldo; Leesa B,0,7,30,30
1650978982713,MATH 109,B01,083215,Anzaldo; Leesa B,0,8,30,30
1650978982713,MATH 109,B02,083216,Anzaldo; Leesa B,0,7,30,30
1650978988743,MATH 142A,A01,083219,Chow; Bennett,0,14,30,30
1650978988743,MATH 142A,A02,083220,Chow; Bennett,0,15,30,30
1650978988743,MATH 142A,B01,083221,Chow; Bennett,0,16,30,30
1650978988743,MATH 142A,B02,083222,Chow; Bennett,0,14,30,30
1650978994781,MATH 193A,A01,083224,Staff,0,6,30,30
1650978994781,MATH 193A,A02,083225,Staff,0,7,30,30
1650978994781,MATH 193A,A03,083781,Staff,0,6,30,30
1650978994781,MATH 193A,A04,083782,Staff,0,7,30,30
1650979000808,MATH 197,001,091859,McAuley; Julian John,9998,0,9999,1
1650979006867,COGS 9,A01,083615,Staff,0,18,60,60
1650979012893,COGS 11,A01,083617,Boyle; Mary E. T.,15,0,40,25
1650979018916,COGS 13,A01,083071,Staff,0,41,40,40
1650979024941,COGS 14A,A01,092681,Staff,0,38,100,100
1650979030971,COGS 14B,A01,083073,Cheng; Tzu-Han,0,13,50,50
1650979036997,COGS 17,A01,092677,Staff,6,0,75,69
1650979043021,COGS 100,A01,083619,Staff,0,31,60,60
1650979049145,COGS 101A,A01,083621,Davis; Joshua Daniel,0,29,60,60
1650979055168,COGS 101B,A01,091572,Staff,0,5,60,60
1650979061193,COGS 101C,A01,083625,Delgado; Tania,14,0,30,16
1650979067224,COGS 107A,A01,083627,Boyle; Mary E. T.,0,16,60,60
1650979073249,COGS 118A,A01,083075,Staff,0,10,60,60
1650979079274,CSE 3,A50,083646,Miranda; Gregory Joseph,15,0,38,23
1650979079274,CSE 3,A51,083647,Miranda; Gregory Joseph,36,0,37,1
1650979085297,CSE 8A,A50,083650,Miranda; Gregory Joseph,0,31,40,40
1650979091323,CSE 11,A01,083080,Cao; Yingjun,0,97,40,40
1650979097348,CSE 12,A01,083652,Staff,0,24,100,100
1650979103375,CSE 15L,A01,083654,Staff,0,3,50,50
1650979103375,CSE 15L,A02,083655,Staff,0,3,50,50
1650979109399,CSE 20,A01,083657,Staff,47,0,80,33
1650979115427,CSE 30,A01,083084,Eldon; John,1,38,80,79
1650979121456,CSE 100,A01,083659,Cao; Yingjun,0,71,50,50
1650979127481,CSE 134B,A01,083661,Powell; Thomas Allan,1,40,65,64
1650979133505,CSE 140,A01,083663,Staff,0,13,75,75
1650979139529,CSE 140L,A01,083088,Eldon; John,4,0,100,96
1650979145557,CSE 175,A01,083665,Kumar; Rakesh,0,0,25,25
1650979151584,CSE 190,A00,092507,Dubnov; Shlomo,9,0,20,11
1650979157611,ECE 45,A01,083139,Staff,0,6,60,60
1650979163640,ECE 65,A50,083695,Staff,0,7,30,30
1650979169663,ECE 109,A01,091882,Touri; Behrouz,32,0,70,38
1650979175686,ECE 180,A00,083140,Abi Samra; Nicholas Camill,18,0,30,12
1650979175686,ECE 180,B00,083141,Abi Samra; Nicholas Camill,0,0,30,30
1650979181715,MATH 10A,A01,083735,Patchell; Gregory David,2,0,30,28
1650979181715,MATH 10A,A02,083736,Patchell; Gregory David,27,0,30,3
1650979181715,MATH 10A,A03,083737,Patchell; Gregory David,23,0,30,7
1650979187737,MATH 10B,A01,083207,Staff,0,9,30,30
1650979187737,MATH 10B,A02,083208,Staff,0,5,30,30
1650979187737,MATH 10B,B01,083739,Staff,9,0,30,21
1650979187737,MATH 10B,B02,083740,Staff,28,0,30,2
1650979193764,MATH 18,A01,083743,Staff,0,0,30,30
1650979193764,MATH 18,A02,083744,Staff,24,0,30,6
1650979193764,MATH 18,A03,083745,Staff,19,0,30,11
1650979193764,MATH 18,A04,083746,Staff,26,0,30,4
1650979193764,MATH 18,B01,083748,Staff,0,15,30,30
1650979193764,MATH 18,B02,083749,Staff,0,14,30,30
1650979193764,MATH 18,B03,083750,Staff,0,13,30,30
1650979193764,MATH 18,B04,083751,Staff,0,13,30,30
1650979199788,MATH 20A,A01,083754,Staff,19,0,40,21
1650979205812,MATH 20B,A01,083756,Staff,0,14,30,30
1650979205812,MATH 20B,A02,083757,Staff,0,11,30,30
1650979211838,MATH 20C,A01,083760,Staff,0,17,30,30
1650979211838,MATH 20C,A02,083761,Staff,0,15,30,30
1650979211838,MATH 20C,B01,083762,Staff,9,0,30,21
1650979211838,MATH 20C,B02,083763,Staff,28,0,30,2
1650979217866,MATH 20D,A01,083765,Staff,2,1,30,28
1650979217866,MATH 20D,A02,083766,Staff,2,0,30,28
1650979217866,MATH 20D,A03,083767,Staff,22,0,30,8
1650979223890,MATH 20E,A01,083771,Staff,2,0,30,28
1650979223890,MATH 20E,A02,083772,Staff,12,0,30,18
1650979223890,MATH 20E,B01,083773,Staff,0,0,30,30
1650979223890,MATH 20E,B02,083774,Staff,1,0,30,29
1650979229913,MATH 103A,A01,083777,Staff,0,17,30,30
1650979229913,MATH 103A,A02,083778,Staff,0,15,30,30
1650979229913,MATH 103A,B01,083779,Staff,0,15,30,30
1650979229913,MATH 103A,B02,083780,Staff,0,14,30,30
1650979235943,MATH 105,A01,085443,Staff,0,23,30,30
1650979241972,MATH 109,A01,083213,Anzaldo; Leesa B,0,7,30,30
1650979241972,MATH 109,A02,083214,Anzaldo; Leesa B,0,7,30,30
1650979241972,MATH 109,B01,083215,Anzaldo; Leesa B,0,8,30,30
1650979241972,MATH 109,B02,083216,Anzaldo; Leesa B,0,7,30,30
1650979247998,MATH 142A,A01,083219,Chow; Bennett,0,14,30,30
1650979247998,MATH 142A,A02,083220,Chow; Bennett,0,15,30,30
1650979247998,MATH 142A,B01,083221,Chow; Bennett,0,16,30,30
1650979247998,MATH 142A,B02,083222,Chow; Bennett,0,14,30,30
1650979254026,MATH 193A,A01,083224,Staff,0,6,30,30
1650979254026,MATH 193A,A02,083225,Staff,0,7,30,30
1650979254026,MATH 193A,A03,083781,Staff,0,6,30,30
1650979254026,MATH 193A,A04,083782,Staff,0,7,30,30
1650979260054,MATH 197,001,091859,McAuley; Julian John,9998,0,9999,1
1650979266123,COGS 9,A01,083615,Staff,0,18,60,60
1650979272145,COGS 11,A01,083617,Boyle; Mary E. T.,15,0,40,25
1650979278171,COGS 13,A01,083071,Staff,0,41,40,40
1650979284199,COGS 14A,A01,092681,Staff,0,38,100,100
1650979290224,COGS 14B,A01,083073,Cheng; Tzu-Han,0,13,50,50
1650979296249,COGS 17,A01,092677,Staff,6,0,75,69
1650979302277,COGS 100,A01,083619,Staff,0,31,60,60
1650979308302,COGS 101A,A01,083621,Davis; Joshua Daniel,0,29,60,60
1650979314332,COGS 101B,A01,091572,Staff,0,5,60,60
1650979320357,COGS 101C,A01,083625,Delgado; Tania,14,0,30,16
1650979326380,COGS 107A,A01,083627,Boyle; Mary E. T.,0,16,60,60
1650979332405,COGS 118A,A01,083075,Staff,0,10,60,60
1650979338430,CSE 3,A50,083646,Miranda; Gregory Joseph,15,0,38,23
1650979338430,CSE 3,A51,083647,Miranda; Gregory Joseph,36,0,37,1
1650979344459,CSE 8A,A50,083650,Miranda; Gregory Joseph,0,31,40,40
1650979350486,CSE 11,A01,083080,Cao; Yingjun,0,97,40,40
1650979356513,CSE 12,A01,083652,Staff,0,24,100,100
1650979362539,CSE 15L,A01,083654,Staff,0,3,50,50
1650979362539,CSE 15L,A02,083655,Staff,0,3,50,50
1650979368564,CSE 20,A01,083657,Staff,47,0,80,33
1650979374591,CSE 30,A01,083084,Eldon; John,1,38,80,79
1650979380618,CSE 100,A01,083659,Cao; Yingjun,0,71,50,50
1650979386643,CSE 134B,A01,083661,Powell; Thomas Allan,1,40,65,64
1650979392670,CSE 140,A01,083663,Staff,0,13,75,75
1650979398695,CSE 140L,A01,083088,Eldon; John,4,0,100,96
1650979404723,CSE 175,A01,083665,Kumar; Rakesh,0,0,25,25
1650979410748,CSE 190,A00,092507,Dubnov; Shlomo,9,0,20,11
1650979416772,ECE 45,A01,083139,Staff,0,6,60,60
1650979422798,ECE 65,A50,083695,Staff,0,7,30,30
1650979428825,ECE 109,A01,091882,Touri; Behrouz,32,0,70,38
1650979434854,ECE 180,A00,083140,Abi Samra; Nicholas Camill,18,0,30,12
1650979434854,ECE 180,B00,083141,Abi Samra; Nicholas Camill,0,0,30,30
1650979440893,MATH 10A,A01,083735,Patchell; Gregory David,2,0,30,28
1650979440893,MATH 10A,A02,083736,Patchell; Gregory David,27,0,30,3
1650979440893,MATH 10A,A03,083737,Patchell; Gregory David,23,0,30,7
1650979446916,MATH 10B,A01,083207,Staff,0,9,30,30
1650979446916,MATH 10B,A02,083208,Staff,0,5,30,30
1650979446916,MATH 10B,B01,083739,Staff,9,0,30,21
1650979446916,MATH 10B,B02,083740,Staff,28,0,30,2
1650979452941,MATH 18,A01,083743,Staff,0,0,30,30
1650979452941,MATH 18,A02,083744,Staff,24,0,30,6
1650979452941,MATH 18,A03,083745,Staff,19,0,30,11
1650979452941,MATH 18,A04,083746,Staff,26,0,30,4
1650979452941,MATH 18,B01,083748,Staff,0,15,30,30
1650979452941,MATH 18,B02,083749,Staff,0,14,30,30
1650979452941,MATH 18,B03,083750,Staff,0,13,30,30
1650979452941,MATH 18,B04,083751,Staff,0,13,30,30
1650979458964,MATH 20A,A01,083754,Staff,19,0,40,21
1650979464987,MATH 20B,A01,083756,Staff,0,14,30,30
1650979464987,MATH 20B,A02,083757,Staff,0,11,30,30
1650979471017,MATH 20C,A01,083760,Staff,0,17,30,30
1650979471017,MATH 20C,A02,083761,Staff,0,15,30,30
1650979471017,MATH 20C,B01,083762,Staff,9,0,30,21
1650979471017,MATH 20C,B02,083763,Staff,28,0,30,2
1650979477040,MATH 20D,A01,083765,Staff,2,1,30,28
1650979477040,MATH 20D,A02,083766,Staff,2,0,30,28
1650979477040,MATH 20D,A03,083767,Staff,22,0,30,8
1650979483066,MATH 20E,A01,083771,Staff,2,0,30,28
1650979483066,MATH 20E,A02,083772,Staff,12,0,30,18
1650979483066,MATH 20E,B01,083773,Staff,0,0,30,30
1650979483066,MATH 20E,B02,083774,Staff,1,0,30,29
1650979489097,MATH 103A,A01,083777,Staff,0,17,30,30
1650979489097,MATH 103A,A02,083778,Staff,0,15,30,30
1650979489097,MATH 103A,B01,083779,Staff,0,15,30,30
1650979489097,MATH 103A,B02,083780,Staff,0,14,30,30
1650979495121,MATH 105,A01,085443,Staff,0,23,30,30
1650979501155,MATH 109,A01,083213,Anzaldo; Leesa B,0,7,30,30
1650979501155,MATH 109,A02,083214,Anzaldo; Leesa B,0,7,30,30
1650979501155,MATH 109,B01,083215,Anzaldo; Leesa B,0,8,30,30
1650979501155,MATH 109,B02,083216,Anzaldo; Leesa B,0,7,30,30
1650979507180,MATH 142A,A01,083219,Chow; Bennett,0,14,30,30
1650979507180,MATH 142A,A02,083220,Chow; Bennett,0,15,30,30
1650979507180,MATH 142A,B01,083221,Chow; Bennett,0,16,30,30
1650979507180,MATH 142A,B02,083222,Chow; Bennett,0,14,30,30
1650979513207,MATH 193A,A01,083224,Staff,0,6,30,30
1650979513207,MATH 193A,A02,083225,Staff,0,7,30,30
1650979513207,MATH 193A,A03,083781,Staff,0,6,30,30
1650979513207,MATH 193A,A04,083782,Staff,0,7,30,30
1650979519230,MATH 197,001,091859,McAuley; Julian John,9998,0,9999,1
1650979525283,COGS 9,A01,083615,Staff,0,18,60,60
1650979531309,COGS 11,A01,083617,Boyle; Mary E. T.,15,0,40,25
1650979537345,COGS 13,A01,083071,Staff,0,41,40,40
1650979543369,COGS 14A,A01,092681,Staff,0,38,100,100
1650979549396,COGS 14B,A01,083073,Cheng; Tzu-Han,0,13,50,50
1650979555421,COGS 17,A01,092677,Staff,6,0,75,69
1650979561443,COGS 100,A01,083619,Staff,0,31,60,60
1650979567468,COGS 101A,A01,083621,Davis; Joshua Daniel,0,29,60,60
1650979573491,COGS 101B,A01,091572,Staff,0,5,60,60
1650979579519,COGS 101C,A01,083625,Delgado; Tania,14,0,30,16
1650979585542,COGS 107A,A01,083627,Boyle; Mary E. T.,0,16,60,60
1650979591568,COGS 118A,A01,083075,Staff,0,10,60,60
1650979597591,CSE 3,A50,083646,Miranda; Gregory Joseph,15,0,38,23
1650979597591,CSE 3,A51,083647,Miranda; Gregory Joseph,36,0,37,1
1650979603614,CSE 8A,A50,083650,Miranda; Gregory Joseph,0,31,40,40
1650979609640,CSE 11,A01,083080,Cao; Yingjun,0,97,40,40
1650979615665,CSE 12,A01,083652,Staff,0,24,100,100
1650979621691,CSE 15L,A01,083654,Staff,0,3,50,50
1650979621691,CSE 15L,A02,083655,Staff,0,3,50,50
1650979627715,CSE 20,A01,083657,Staff,47,0,80,33
1650979633739,CSE 30,A01,083084,Eldon; John,1,38,80,79
1650979639765,CSE 100,A01,083659,Cao; Yingjun,0,71,50,50
1650979645887,CSE 134B,A01,083661,Powell; Thomas Allan,1,40,65,64
1650979651910,CSE 140,A01,083663,Staff,0,13,75,75
1650979657936,CSE 140L,A01,083088,Eldon; John,4,0,100,96
1650979663962,CSE 175,A01,083665,Kumar; Rakesh,0,0,25,25
1650979669995,CSE 190,A00,092507,Dubnov; Shlomo,9,0,20,11
1650979676022,ECE 45,A01,083139,Staff,0,6,60,60
1650979682049,ECE 65,A50,083695,Staff,0,7,30,30
1650979688073,ECE 109,A01,091882,Touri; Behrouz,32,0,70,38
1650979694095,ECE 180,A00,083140,Abi Samra; Nicholas Camill,18,0,30,12
1650979694095,ECE 180,B00,083141,Abi Samra; Nicholas Camill,0,0,30,30
1650979700119,MATH 10A,A01,083735,Patchell; Gregory David,2,0,30,28
1650979700119,MATH 10A,A02,083736,Patchell; Gregory David,27,0,30,3
1650979700119,MATH 10A,A03,083737,Patchell; Gregory David,23,0,30,7
1650979706154,MATH 10B,A01,083207,Staff,0,9,30,30
1650979706154,MATH 10B,A02,083208,Staff,0,5,30,30
1650979706154,MATH 10B,B01,083739,Staff,9,0,30,21
1650979706154,MATH 10B,B02,083740,Staff,28,0,30,2
1650979712187,MATH 18,A01,083743,Staff,0,0,30,30
1650979712187,MATH 18,A02,083744,Staff,24,0,30,6
1650979712187,MATH 18,A03,083745,Staff,19,0,30,11
1650979712187,MATH 18,A04,083746,Staff,26,0,30,4
1650979712187,MATH 18,B01,083748,Staff,0,15,30,30
1650979712187,MATH 18,B02,083749,Staff,0,14,30,30
1650979712187,MATH 18,B03,083750,Staff,0,13,30,30
1650979712187,MATH 18,B04,083751,Staff,0,13,30,30
1650979718212,MATH 20A,A01,083754,Staff,19,0,40,21
1650979724241,MATH 20B,A01,083756,Staff,0,14,30,30
1650979724241,MATH 20B,A02,083757,Staff,0,11,30,30
1650979730266,MATH 20C,A01,083760,Staff,0,17,30,30
1650979730266,MATH 20C,A02,083761,Staff,0,15,30,30
1650979730266,MATH 20C,B01,083762,Staff,9,0,30,21
1650979730266,MATH 20C,B02,083763,Staff,28,0,30,2
1650979736292,MATH 20D,A01,083765,Staff,2,1,30,28
1650979736292,MATH 20D,A02,083766,Staff,2,0,30,28
1650979736292,MATH 20D,A03,083767,Staff,22,0,30,8
1650979742316,MATH 20E,A01,083771,Staff,2,0,30,28
1650979742316,MATH 20E,A02,083772,Staff,12,0,30,18
1650979742316,MATH 20E,B01,083773,Staff,0,0,30,30
1650979742316,MATH 20E,B02,083774,Staff,1,0,30,29
1650979748342,MATH 103A,A01,083777,Staff,0,17,30,30
1650979748342,MATH 103A,A02,083778,Staff,0,15,30,30
1650979748342,MATH 103A,B01,083779,Staff,0,15,30,30
1650979748342,MATH 103A,B02,083780,Staff,0,14,30,30
1650979754372,MATH 105,A01,085443,Staff,0,23,30,30
1650979760400,MATH 109,A01,083213,Anzaldo; Leesa B,0,7,30,30
1650979760400,MATH 109,A02,083214,Anzaldo; Leesa B,0,7,30,30
1650979760400,MATH 109,B01,083215,Anzaldo; Leesa B,0,8,30,30
1650979760400,MATH 109,B02,083216,Anzaldo; Leesa B,0,7,30,30
1650979766427,MATH 142A,A01,083219,Chow; Bennett,0,14,30,30
1650979766427,MATH 142A,A02,083220,Chow; Bennett,0,15,30,30
1650979766427,MATH 142A,B01,083221,Chow; Bennett,0,16,30,30
1650979766427,MATH 142A,B02,083222,Chow; Bennett,0,14,30,30
1650979772453,MATH 193A,A01,083224,Staff,0,6,30,30
1650979772453,MATH 193A,A02,083225,Staff,0,7,30,30
1650979772453,MATH 193A,A03,083781,Staff,0,6,30,30
1650979772453,MATH 193A,A04,083782,Staff,0,7,30,30
1650979778484,MATH 197,001,091859,McAuley; Julian John,9998,0,9999,1
1650979784551,COGS 9,A01,083615,Staff,0,18,60,60
1650979790578,COGS 11,A01,083617,Boyle; Mary E. T.,15,0,40,25
1650979796601,COGS 13,A01,083071,Staff,0,41,40,40
1650979802630,COGS 14A,A01,092681,Staff,0,38,100,100
1650979808655,COGS 14B,A01,083073,Cheng; Tzu-Han,0,13,50,50
1650979814681,COGS 17,A01,092677,Staff,6,0,75,69
1650979820705,COGS 100,A01,083619,Staff,0,31,60,60
1650979826728,COGS 101A,A01,083621,Davis; Joshua Daniel,0,29,60,60
1650979832756,COGS 101B,A01,091572,Staff,0,5,60,60
1650979838783,COGS 101C,A01,083625,Delgado; Tania,14,0,30,16
1650979844813,COGS 107A,A01,083627,Boyle; Mary E. T.,0,16,60,60
1650979850839,COGS 118A,A01,083075,Staff,0,10,60,60
1650979856864,CSE 3,A50,083646,Miranda; Gregory Joseph,15,0,38,23
1650979856864,CSE 3,A51,083647,Miranda; Gregory Joseph,36,0,37,1
1650979862890,CSE 8A,A50,083650,Miranda; Gregory Joseph,0,31,40,40
1650979868912,CSE 11,A01,083080,Cao; Yingjun,0,97,40,40
1650979874941,CSE 12,A01,083652,Staff,0,24,100,100
1650979880979,CSE 15L,A01,083654,Staff,0,3,50,50
1650979880979,CSE 15L,A02,083655,Staff,0,3,50,50
1650979887008,CSE 20,A01,083657,Staff,47,0,80,33
1650979893040,CSE 30,A01,083084,Eldon; John,1,38,80,79
1650979899069,CSE 100,A01,083659,Cao; Yingjun,0,71,50,50
1650979905091,CSE 134B,A01,083661,Powell; Thomas Allan,1,40,65,64
1650979911114,CSE 140,A01,083663,Staff,0,13,75,75
1650979917138,CSE 140L,A01,083088,Eldon; John,4,0,100,96
1650979923170,CSE 175,A01,083665,Kumar; Rakesh,0,0,25,25
1650979929197,CSE 190,A00,092507,Dubnov; Shlomo,9,0,20,11
1650979935223,ECE 45,A01,083139,Staff,0,6,60,60
1650979941272,ECE 65,A50,083695,Staff,0,7,30,30
1650979947296,ECE 109,A01,091882,Touri; Behrouz,32,0,70,38
1650979953320,ECE 180,A00,083140,Abi Samra; Nicholas Camill,18,0,30,12
1650979953320,ECE 180,B00,083141,Abi Samra; Nicholas Camill,0,0,30,30
1650979959342,MATH 10A,A01,083735,Patchell; Gregory David,2,0,30,28
1650979959342,MATH 10A,A02,083736,Patchell; Gregory David,27,0,30,3
1650979959342,MATH 10A,A03,083737,Patchell; Gregory David,23,0,30,7
1650979965375,MATH 10B,A01,083207,Staff,0,9,30,30
1650979965375,MATH 10B,A02,083208,Staff,0,5,30,30
1650979965375,MATH 10B,B01,083739,Staff,9,0,30,21
1650979965375,MATH 10B,B02,083740,Staff,28,0,30,2
1650979971399,MATH 18,A01,083743,Staff,0,0,30,30
1650979971399,MATH 18,A02,083744,Staff,24,0,30,6
1650979971399,MATH 18,A03,083745,Staff,19,0,30,11
1650979971399,MATH 18,A04,083746,Staff,26,0,30,4
1650979971399,MATH 18,B01,083748,Staff,0,15,30,30
1650979971399,MATH 18,B02,083749,Staff,0,14,30,30
1650979971399,MATH 18,B03,083750,Staff,0,13,30,30
1650979971399,MATH 18,B04,083751,Staff,0,13,30,30
1650979977435,MATH 20A,A01,083754,Staff,19,0,40,21
1650979983459,MATH 20B,A01,083756,Staff,0,14,30,30
1650979983459,MATH 20B,A02,083757,Staff,0,11,30,30
1650979989483,MATH 20C,A01,083760,Staff,0,17,30,30
1650979989483,MATH 20C,A02,083761,Staff,0,15,30,30
1650979989483,MATH 20C,B01,083762,Staff,9,0,30,21
1650979989483,MATH 20C,B02,083763,Staff,28,0,30,2
1650979995507,MATH 20D,A01,083765,Staff,2,1,30,28
1650979995507,MATH 20D,A02,083766,Staff,2,0,30,28
1650979995507,MATH 20D,A03,083767,Staff,22,0,30,8
1650980001534,MATH 20E,A01,083771,Staff,2,0,30,28
1650980001534,MATH 20E,A02,083772,Staff,12,0,30,18
1650980001534,MATH 20E,B01,083773,Staff,0,0,30,30
1650980001534,MATH 20E,B02,083774,Staff,1,0,30,29
1650980007568,MATH 103A,A01,083777,Staff,0,17,30,30
1650980007568,MATH 103A,A02,083778,Staff,0,15,30,30
1650980007568,MATH 103A,B01,083779,Staff,0,15,30,30
1650980007568,MATH 103A,B02,083780,Staff,0,14,30,30
1650980013608,MATH 105,A01,085443,Staff,0,23,30,30
1650980019635,MATH 109,A01,083213,Anzaldo; Leesa B,0,7,30,30
1650980019635,MATH 109,A02,083214,Anzaldo; Leesa B,0,7,30,30
1650980019635,MATH 109,B01,083215,Anzaldo; Leesa B,0,8,30,30
1650980019635,MATH 109,B02,083216,Anzaldo; Leesa B,0,7,30,30
1650980025663,MATH 142A,A01,083219,Chow; Bennett,0,14,30,30
1650980025663,MATH 142A,A02,083220,Chow; Bennett,0,15,30,30
1650980025663,MATH 142A,B01,083221,Chow; Bennett,0,16,30,30
1650980025663,MATH 142A,B02,083222,Chow; Bennett,0,14,30,30
1650980031689,MATH 193A,A01,083224,Staff,0,6,30,30
1650980031689,MATH 193A,A02,083225,Staff,0,7,30,30
1650980031689,MATH 193A,A03,083781,Staff,0,6,30,30
1650980031689,MATH 193A,A04,083782,Staff,0,7,30,30
1650980037721,MATH 197,001,091859,McAuley; Julian John,9998,0,9999,1
1650980043781,COGS 9,A01,083615,Staff,0,18,60,60
1650980049813,COGS 11,A01,083617,Boyle; Mary E. T.,15,0,40,25
1650980055837,COGS 13,A01,083071,Staff,0,41,40,40
1650980061862,COGS 14A,A01,092681,Staff,0,38,100,100
1650980067885,COGS 14B,A01,083073,Cheng; Tzu-Han,0,13,50,50
1650980073921,COGS 17,A01,092677,Staff,6,0,75,69
1650980079944,COGS 100,A01,083619,Staff,0,31,60,60
1650980085970,COGS 101A,A01,083621,Davis; Joshua Daniel,0,29,60,60
1650980092004,COGS 101B,A01,091572,Staff,0,5,60,60
1650980098035,COGS 101C,A01,083625,Delgado; Tania,14,0,30,16
1650980104062,COGS 107A,A01,083627,Boyle; Mary E. T.,0,16,60,60
1650980110085,COGS 118A,A01,083075,Staff,0,10,60,60
1650980116123,CSE 3,A50,083646,Miranda; Gregory Joseph,15,0,38,23
1650980116123,CSE 3,A51,083647,Miranda; Gregory Joseph,36,0,37,1
1650980122149,CSE 8A,A50,083650,Miranda; Gregory Joseph,0,31,40,40
1650980128173,CSE 11,A01,083080,Cao; Yingjun,0,97,40,40
1650980134197,CSE 12,A01,083652,Staff,0,24,100,100
1650980140219,CSE 15L,A01,083654,Staff,0,3,50,50
1650980140219,CSE 15L,A02,083655,Staff,0,3,50,50
1650980146249,CSE 20,A01,083657,Staff,47,0,80,33
1650980152274,CSE 30,A01,083084,Eldon; John,1,38,80,79
1650980158297,CSE 100,A01,083659,Cao; Yingjun,0,71,50,50
1650980164323,CSE 134B,A01,083661,Powell; Thomas Allan,1,40,65,64
1650980170349,CSE 140,A01,083663,Staff,0,13,75,75
1650980176373,CSE 140L,A01,083088,Eldon; John,4,0,100,96
1650980182397,CSE 175,A01,083665,Kumar; Rakesh,0,0,25,25
1650980188420,CSE 190,A00,092507,Dubnov; Shlomo,9,0,20,11
1650980194444,ECE 45,A01,083139,Staff,0,6,60,60
1650980200472,ECE 65,A50,083695,Staff,0,7,30,30
1650980206495,ECE 109,A01,091882,Touri; Behrouz,32,0,70,38
1650980212521,ECE 180,A00,083140,Abi Samra; Nicholas Camill,18,0,30,12
1650980212521,ECE 180,B00,083141,Abi Samra; Nicholas Camill,0,0,30,30
1650980218549,MATH 10A,A01,083735,Patchell; Gregory David,2,0,30,28
1650980218549,MATH 10A,A02,083736,Patchell; Gregory David,27,0,30,3
1650980218549,MATH 10A,A03,083737,Patchell; Gregory David,23,0,30,7
1650980224574,MATH 10B,A01,083207,Staff,0,9,30,30
1650980224574,MATH 10B,A02,083208,Staff,0,5,30,30
1650980224574,MATH 10B,B01,083739,Staff,9,0,30,21
1650980224574,MATH 10B,B02,083740,Staff,28,0,30,2
1650980230612,MATH 18,A01,083743,Staff,0,0,30,30
1650980230612,MATH 18,A02,083744,Staff,24,0,30,6
1650980230612,MATH 18,A03,083745,Staff,19,0,30,11
1650980230612,MATH 18,A04,083746,Staff,26,0,30,4
1650980230612,MATH 18,B01,083748,Staff,0,15,30,30
1650980230612,MATH 18,B02,083749,Staff,0,14,30,30
1650980230612,MATH 18,B03,083750,Staff,0,13,30,30
1650980230612,MATH 18,B04,083751,Staff,0,13,30,30
1650980236638,MATH 20A,A01,083754,Staff,19,0,40,21
1650980242757,MATH 20B,A01,083756,Staff,0,14,30,30
1650980242757,MATH 20B,A02,083757,Staff,0,11,30,30
1650980248786,MATH 20C,A01,083760,Staff,0,17,30,30
1650980248786,MATH 20C,A02,083761,Staff,0,15,30,30
1650980248786,MATH 20C,B01,083762,Staff,9,0,30,21
1650980248786,MATH 20C,B02,083763,Staff,28,0,30,2
1650980254815,MATH 20D,A01,083765,Staff,2,1,30,28
1650980254815,MATH 20D,A02,083766,Staff,2,0,30,28
1650980254815,MATH 20D,A03,083767,Staff,22,0,30,8
1650980260844,MATH 20E,A01,083771,Staff,2,0,30,28
1650980260844,MATH 20E,A02,083772,Staff,12,0,30,18
1650980260844,MATH 20E,B01,083773,Staff,0,0,30,30
1650980260844,MATH 20E,B02,083774,Staff,1,0,30,29
1650980266873,MATH 103A,A01,083777,Staff,0,17,30,30
1650980266873,MATH 103A,A02,083778,Staff,0,15,30,30
1650980266873,MATH 103A,B01,083779,Staff,0,15,30,30
1650980266873,MATH 103A,B02,083780,Staff,0,14,30,30
1650980272900,MATH 105,A01,085443,Staff,0,23,30,30
1650980278924,MATH 109,A01,083213,Anzaldo; Leesa B,0,7,30,30
1650980278924,MATH 109,A02,083214,Anzaldo; Leesa B,0,7,30,30
1650980278924,MATH 109,B01,083215,Anzaldo; Leesa B,0,8,30,30
1650980278924,MATH 109,B02,083216,Anzaldo; Leesa B,0,7,30,30
1650980284949,MATH 142A,A01,083219,Chow; Bennett,0,14,30,30
1650980284949,MATH 142A,A02,083220,Chow; Bennett,0,15,30,30
1650980284949,MATH 142A,B01,083221,Chow; Bennett,0,16,30,30
1650980284949,MATH 142A,B02,083222,Chow; Bennett,0,14,30,30
1650980290973,MATH 193A,A01,083224,Staff,0,6,30,30
1650980290973,MATH 193A,A02,083225,Staff,0,7,30,30
1650980290973,MATH 193A,A03,083781,Staff,0,6,30,30
1650980290973,MATH 193A,A04,083782,Staff,0,7,30,30
1650980296996,MATH 197,001,091859,McAuley; Julian John,9998,0,9999,1
1650980303052,COGS 9,A01,083615,Staff,0,18,60,60
1650980309077,COGS 11,A01,083617,Boyle; Mary E. T.,15,0,40,25
1650980315105,COGS 13,A01,083071,Staff,0,41,40,40
1650980321131,COGS 14A,A01,092681,Staff,0,38,100,100
1650980327157,COGS 14B,A01,083073,Cheng; Tzu-Han,0,13,50,50
1650980333182,COGS 17,A01,092677,Staff,6,0,75,69
1650980339208,COGS 100,A01,083619,Staff,0,31,60,60
1650980345241,COGS 101A,A01,083621,Davis; Joshua Daniel,0,29,60,60
1650980351267,COGS 101B,A01,091572,Staff,0,5,60,60
1650980357292,COGS 101C,A01,083625,Delgado; Tania,14,0,30,16
1650980363319,COGS 107A,A01,083627,Boyle; Mary E. T.,0,16,60,60
1650980369346,COGS 118A,A01,083075,Staff,0,10,60,60
1650980375371,CSE 3,A50,083646,Miranda; Gregory Joseph,15,0,38,23
1650980375371,CSE 3,A51,083647,Miranda; Gregory Joseph,36,0,37,1
1650980381396,CSE 8A,A50,083650,Miranda; Gregory Joseph,0,31,40,40
1650980387423,CSE 11,A01,083080,Cao; Yingjun,0,97,40,40
1650980393453,CSE 12,A01,083652,Staff,0,24,100,100
1650980399482,CSE 15L,A01,083654,Staff,0,3,50,50
1650980399482,CSE 15L,A02,083655,Staff,0,3,50,50
1650980405507,CSE 20,A01,083657,Staff,47,0,80,33
1650980411535,CSE 30,A01,083084,Eldon; John,1,38,80,79
1650980417567,CSE 100,A01,083659,Cao; Yingjun,0,71,50,50
1650980423594,CSE 134B,A01,083661,Powell; Thomas Allan,1,40,65,64
1650980429616,CSE 140,A01,083663,Staff,0,13,75,75
1650980435646,CSE 140L,A01,083088,Eldon; John,4,0,100,96
1650980441670,CSE 175,A01,083665,Kumar; Rakesh,0,0,25,25
1650980447695,CSE 190,A00,092507,Dubnov; Shlomo,9,0,20,11
1650980453720,ECE 45,A01,083139,Staff,0,6,60,60
1650980459746,ECE 65,A50,083695,Staff,0,7,30,30
1650980465774,ECE 109,A01,091882,Touri; Behrouz,32,0,70,38
1650980471809,ECE 180,A00,083140,Abi Samra; Nicholas Camill,18,0,30,12
1650980471809,ECE 180,B00,083141,Abi Samra; Nicholas Camill,0,0,30,30
1650980477846,MATH 10A,A01,083735,Patchell; Gregory David,2,0,30,28
1650980477846,MATH 10A,A02,083736,Patchell; Gregory David,27,0,30,3
1650980477846,MATH 10A,A03,083737,Patchell; Gregory David,23,0,30,7
1650980483874,MATH 10B,A01,083207,Staff,0,9,30,30
1650980483874,MATH 10B,A02,083208,Staff,0,5,30,30
1650980483874,MATH 10B,B01,083739,Staff,9,0,30,21
1650980483874,MATH 10B,B02,083740,Staff,28,0,30,2
1650980489905,MATH 18,A01,083743,Staff,0,0,30,30
1650980489905,MATH 18,A02,083744,Staff,24,0,30,6
1650980489905,MATH 18,A03,083745,Staff,19,0,30,11
1650980489905,MATH 18,A04,083746,Staff,26,0,30,4
1650980489905,MATH 18,B01,083748,Staff,0,15,30,30
1650980489905,MATH 18,B02,083749,Staff,0,14,30,30
1650980489905,MATH 18,B03,083750,Staff,0,13,30,30
1650980489905,MATH 18,B04,083751,Staff,0,13,30,30
1650980495929,MATH 20A,A01,083754,Staff,19,0,40,21
1650980501956,MATH 20B,A01,083756,Staff,0,14,30,30
1650980501956,MATH 20B,A02,083757,Staff,0,11,30,30
1650980507979,MATH 20C,A01,083760,Staff,0,17,30,30
1650980507979,MATH 20C,A02,083761,Staff,0,15,30,30
1650980507979,MATH 20C,B01,083762,Staff,9,0,30,21
1650980507979,MATH 20C,B02,083763,Staff,28,0,30,2
1650980514002,MATH 20D,A01,083765,Staff,2,1,30,28
1650980514002,MATH 20D,A02,083766,Staff,2,0,30,28
1650980514002,MATH 20D,A03,083767,Staff,22,0,30,8
1650980520028,MATH 20E,A01,083771,Staff,2,0,30,28
1650980520028,MATH 20E,A02,083772,Staff,12,0,30,18
1650980520028,MATH 20E,B01,083773,Staff,0,0,30,30
1650980520028,MATH 20E,B02,083774,Staff,1,0,30,29
1650980526057,MATH 103A,A01,083777,Staff,0,17,30,30
1650980526057,MATH 103A,A02,083778,Staff,0,15,30,30
1650980526057,MATH 103A,B01,083779,Staff,0,15,30,30
1650980526057,MATH 103A,B02,083780,Staff,0,14,30,30
1650980532081,MATH 105,A01,085443,Staff,0,23,30,30
1650980538109,MATH 109,A01,083213,Anzaldo; Leesa B,0,7,30,30
1650980538109,MATH 109,A02,083214,Anzaldo; Leesa B,0,7,30,30
1650980538109,MATH 109,B01,083215,Anzaldo; Leesa B,0,8,30,30
1650980538109,MATH 109,B02,083216,Anzaldo; Leesa B,0,7,30,30
1650980544147,MATH 142A,A01,083219,Chow; Bennett,0,14,30,30
1650980544147,MATH 142A,A02,083220,Chow; Bennett,0,15,30,30
1650980544147,MATH 142A,B01,083221,Chow; Bennett,0,16,30,30
1650980544147,MATH 142A,B02,083222,Chow; Bennett,0,14,30,30
1650980550171,MATH 193A,A01,083224,Staff,0,6,30,30
1650980550171,MATH 193A,A02,083225,Staff,0,7,30,30
1650980550171,MATH 193A,A03,083781,Staff,0,6,30,30
1650980550171,MATH 193A,A04,083782,Staff,0,7,30,30
1650980556195,MATH 197,001,091859,McAuley; Julian John,9998,0,9999,1
1650980562249,COGS 9,A01,083615,Staff,0,18,60,60
1650980568275,COGS 11,A01,083617,Boyle; Mary E. T.,15,0,40,25
1650980574318,COGS 13,A01,083071,Staff,0,41,40,40
1650980580351,COGS 14A,A01,092681,Staff,0,38,100,100
1650980586379,COGS 14B,A01,083073,Cheng; Tzu-Han,0,13,50,50
1650980592402,COGS 17,A01,092677,Staff,6,0,75,69
1650980598425,COGS 100,A01,083619,Staff,0,31,60,60
1650980604452,COGS 101A,A01,083621,Davis; Joshua Daniel,0,29,60,60
1650980610475,COGS 101B,A01,091572,Staff,0,5,60,60
1650980616526,COGS 101C,A01,083625,Delgado; Tania,14,0,30,16
1650980622550,COGS 107A,A01,083627,Boyle; Mary E. T.,0,16,60,60
1650980628576,COGS 118A,A01,083075,Staff,0,10,60,60
1650980634604,CSE 3,A50,083646,Miranda; Gregory Joseph,15,0,38,23
1650980634604,CSE 3,A51,083647,Miranda; Gregory Joseph,36,0,37,1
1650980640630,CSE 8A,A50,083650,Miranda; Gregory Joseph,0,31,40,40
1650980646667,CSE 11,A01,083080,Cao; Yingjun,0,97,40,40
1650980652704,CSE 12,A01,083652,Staff,0,24,100,100
1650980658731,CSE 15L,A01,083654,Staff,0,3,50,50
1650980658731,CSE 15L,A02,083655,Staff,0,3,50,50
1650980664758,CSE 20,A01,083657,Staff,47,0,80,33
1650980670782,CSE 30,A01,083084,Eldon; John,1,38,80,79
1650980676806,CSE 100,A01,083659,Cao; Yingjun,0,71,50,50
1650980682830,CSE 134B,A01,083661,Powell; Thomas Allan,1,40,65,64
1650980688870,CSE 140,A01,083663,Staff,0,13,75,75
1650980694896,CSE 140L,A01,083088,Eldon; John,4,0,100,96
1650980700923,CSE 175,A01,083665,Kumar; Rakesh,0,0,25,25
1650980706950,CSE 190,A00,092507,Dubnov; Shlomo,9,0,20,11
1650980712973,ECE 45,A01,083139,Staff,0,6,60,60
1650980718997,ECE 65,A50,083695,Staff,0,7,30,30
1650980725023,ECE 109,A01,091882,Touri; Behrouz,32,0,70,38
1650980731047,ECE 180,A00,083140,Abi Samra; Nicholas Camill,18,0,30,12
1650980731047,ECE 180,B00,083141,Abi Samra; Nicholas Camill,0,0,30,30
1650980737074,MATH 10A,A01,083735,Patchell; Gregory David,2,0,30,28
1650980737074,MATH 10A,A02,083736,Patchell; Gregory David,27,0,30,3
1650980737074,MATH 10A,A03,083737,Patchell; Gregory David,23,0,30,7
1650980743097,MATH 10B,A01,083207,Staff,0,9,30,30
1650980743097,MATH 10B,A02,083208,Staff,0,5,30,30
1650980743097,MATH 10B,B01,083739,Staff,9,0,30,21
1650980743097,MATH 10B,B02,083740,Staff,28,0,30,2
1650980749123,MATH 18,A01,083743,Staff,0,0,30,30
1650980749123,MATH 18,A02,083744,Staff,24,0,30,6
1650980749123,MATH 18,A03,083745,Staff,19,0,30,11
1650980749123,MATH 18,A04,083746,Staff,26,0,30,4
1650980749123,MATH 18,B01,083748,Staff,0,15,30,30
1650980749123,MATH 18,B02,083749,Staff,0,14,30,30
1650980749123,MATH 18,B03,083750,Staff,0,13,30,30
1650980749123,MATH 18,B04,083751,Staff,0,13,30,30
1650980755147,MATH 20A,A01,083754,Staff,19,0,40,21
1650980761172,MATH 20B,A01,083756,Staff,0,14,30,30
1650980761172,MATH 20B,A02,083757,Staff,0,11,30,30
1650980767203,MATH 20C,A01,083760,Staff,0,17,30,30
1650980767203,MATH 20C,A02,083761,Staff,0,15,30,30
1650980767203,MATH 20C,B01,083762,Staff,9,0,30,21
1650980767203,MATH 20C,B02,083763,Staff,28,0,30,2
1650980773229,MATH 20D,A01,083765,Staff,2,1,30,28
1650980773229,MATH 20D,A02,083766,Staff,2,0,30,28
1650980773229,MATH 20D,A03,083767,Staff,22,0,30,8
1650980779254,MATH 20E,A01,083771,Staff,2,0,30,28
1650980779254,MATH 20E,A02,083772,Staff,12,0,30,18
1650980779254,MATH 20E,B01,083773,Staff,0,0,30,30
1650980779254,MATH 20E,B02,083774,Staff,1,0,30,29
1650980785279,MATH 103A,A01,083777,Staff,0,17,30,30
1650980785279,MATH 103A,A02,083778,Staff,0,15,30,30
1650980785279,MATH 103A,B01,083779,Staff,0,15,30,30
1650980785279,MATH 103A,B02,083780,Staff,0,14,30,30
1650980791309,MATH 105,A01,085443,Staff,0,23,30,30
1650980797337,MATH 109,A01,083213,Anzaldo; Leesa B,0,7,30,30
1650980797337,MATH 109,A02,083214,Anzaldo; Leesa B,0,7,30,30
1650980797337,MATH 109,B01,083215,Anzaldo; Leesa B,0,8,30,30
1650980797337,MATH 109,B02,083216,Anzaldo; Leesa B,0,7,30,30
1650980803366,MATH 142A,A01,083219,Chow; Bennett,0,14,30,30
1650980803366,MATH 142A,A02,083220,Chow; Bennett,0,15,30,30
1650980803366,MATH 142A,B01,083221,Chow; Bennett,0,16,30,30
1650980803366,MATH 142A,B02,083222,Chow; Bennett,0,14,30,30
1650980809397,MATH 193A,A01,083224,Staff,0,6,30,30
1650980809397,MATH 193A,A02,083225,Staff,0,7,30,30
1650980809397,MATH 193A,A03,083781,Staff,0,6,30,30
1650980809397,MATH 193A,A04,083782,Staff,0,7,30,30
1650980815423,MATH 197,001,091859,McAuley; Julian John,9998,0,9999,1
1650980821473,COGS 9,A01,083615,Staff,0,18,60,60
1650980827496,COGS 11,A01,083617,Boyle; Mary E. T.,15,0,40,25
1650980833616,COGS 13,A01,083071,Staff,0,41,40,40
1650980839647,COGS 14A,A01,092681,Staff,0,38,100,100
1650980845673,COGS 14B,A01,083073,Cheng; Tzu-Han,0,13,50,50
1650980851699,COGS 17,A01,092677,Staff,6,0,75,69
1650980857725,COGS 100,A01,083619,Staff,0,31,60,60
1650980863752,COGS 101A,A01,083621,Davis; Joshua Daniel,0,29,60,60
1650980869775,COGS 101B,A01,091572,Staff,0,5,60,60
1650980875801,COGS 101C,A01,083625,Delgado; Tania,14,0,30,16
1650980881828,COGS 107A,A01,083627,Boyle; Mary E. T.,0,16,60,60
1650980887852,COGS 118A,A01,083075,Staff,0,10,60,60
1650980893880,CSE 3,A50,083646,Miranda; Gregory Joseph,15,0,38,23
1650980893880,CSE 3,A51,083647,Miranda; Gregory Joseph,36,0,37,1
1650980899904,CSE 8A,A50,083650,Miranda; Gregory Joseph,0,31,40,40
1650980905929,CSE 11,A01,083080,Cao; Yingjun,0,97,40,40
1650980911954,CSE 12,A01,083652,Staff,0,24,100,100
1650980917981,CSE 15L,A01,083654,Staff,0,3,50,50
1650980917981,CSE 15L,A02,083655,Staff,0,3,50,50
1650980924005,CSE 20,A01,083657,Staff,47,0,80,33
1650980930031,CSE 30,A01,083084,Eldon; John,1,38,80,79
1650980936055,CSE 100,A01,083659,Cao; Yingjun,0,71,50,50
1650980942082,CSE 134B,A01,083661,Powell; Thomas Allan,1,40,65,64
1650980948106,CSE 140,A01,083663,Staff,0,13,75,75
1650980954138,CSE 140L,A01,083088,Eldon; John,4,0,100,96
1650980960163,CSE 175,A01,083665,Kumar; Rakesh,0,0,25,25
1650980966186,CSE 190,A00,092507,Dubnov; Shlomo,9,0,20,11
1650980972209,ECE 45,A01,083139,Staff,0,6,60,60
1650980978233,ECE 65,A50,083695,Staff,0,7,30,30
1650980984256,ECE 109,A01,091882,Touri; Behrouz,32,0,70,38
1650980990279,ECE 180,A00,083140,Abi Samra; Nicholas Camill,18,0,30,12
1650980990279,ECE 180,B00,083141,Abi Samra; Nicholas Camill,0,0,30,30
1650980996305,MATH 10A,A01,083735,Patchell; Gregory David,2,0,30,28
1650980996305,MATH 10A,A02,083736,Patchell; Gregory David,27,0,30,3
1650980996305,MATH 10A,A03,083737,Patchell; Gregory David,23,0,30,7
1650981002332,MATH 10B,A01,083207,Staff,0,9,30,30
1650981002332,MATH 10B,A02,083208,Staff,0,5,30,30
1650981002332,MATH 10B,B01,083739,Staff,9,0,30,21
1650981002332,MATH 10B,B02,083740,Staff,28,0,30,2
1650981008361,MATH 18,A01,083743,Staff,0,0,30,30
1650981008361,MATH 18,A02,083744,Staff,24,0,30,6
1650981008361,MATH 18,A03,083745,Staff,19,0,30,11
1650981008361,MATH 18,A04,083746,Staff,26,0,30,4
1650981008361,MATH 18,B01,083748,Staff,0,15,30,30
1650981008361,MATH 18,B02,083749,Staff,0,14,30,30
1650981008361,MATH 18,B03,083750,Staff,0,13,30,30
1650981008361,MATH 18,B04,083751,Staff,0,13,30,30
1650981014386,MATH 20A,A01,083754,Staff,19,0,40,21
1650981020423,MATH 20B,A01,083756,Staff,0,14,30,30
1650981020423,MATH 20B,A02,083757,Staff,0,11,30,30
1650981026446,MATH 20C,A01,083760,Staff,0,17,30,30
1650981026446,MATH 20C,A02,083761,Staff,0,15,30,30
1650981026446,MATH 20C,B01,083762,Staff,9,0,30,21
1650981026446,MATH 20C,B02,083763,Staff,28,0,30,2
1650981032469,MATH 20D,A01,083765,Staff,2,1,30,28
1650981032469,MATH 20D,A02,083766,Staff,2,0,30,28
1650981032469,MATH 20D,A03,083767,Staff,22,0,30,8
1650981038493,MATH 20E,A01,083771,Staff,2,0,30,28
1650981038493,MATH 20E,A02,083772,Staff,12,0,30,18
1650981038493,MATH 20E,B01,083773,Staff,0,0,30,30
1650981038493,MATH 20E,B02,083774,Staff,1,0,30,29
1650981044515,MATH 103A,A01,083777,Staff,0,17,30,30
1650981044515,MATH 103A,A02,083778,Staff,0,15,30,30
1650981044515,MATH 103A,B01,083779,Staff,0,15,30,30
1650981044515,MATH 103A,B02,083780,Staff,0,14,30,30
1650981050537,MATH 105,A01,085443,Staff,0,23,30,30
1650981056567,MATH 109,A01,083213,Anzaldo; Leesa B,0,7,30,30
1650981056567,MATH 109,A02,083214,Anzaldo; Leesa B,0,7,30,30
1650981056567,MATH 109,B01,083215,Anzaldo; Leesa B,0,8,30,30
1650981056567,MATH 109,B02,083216,Anzaldo; Leesa B,0,7,30,30
1650981062590,MATH 142A,A01,083219,Chow; Bennett,0,14,30,30
1650981062590,MATH 142A,A02,083220,Chow; Bennett,0,15,30,30
1650981062590,MATH 142A,B01,083221,Chow; Bennett,0,16,30,30
1650981062590,MATH 142A,B02,083222,Chow; Bennett,0,14,30,30
1650981068614,MATH 193A,A01,083224,Staff,0,6,30,30
1650981068614,MATH 193A,A02,083225,Staff,0,7,30,30
1650981068614,MATH 193A,A03,083781,Staff,0,6,30,30
1650981068614,MATH 193A,A04,083782,Staff,0,7,30,30
1650981074645,MATH 197,001,091859,McAuley; Julian John,9998,0,9999,1
1650981080726,COGS 9,A01,083615,Staff,0,18,60,60
1650981086755,COGS 11,A01,083617,Boyle; Mary E. T.,15,0,40,25
1650981092787,COGS 13,A01,083071,Staff,0,41,40,40
1650981098811,COGS 14A,A01,092681,Staff,0,38,100,100
1650981104839,COGS 14B,A01,083073,Cheng; Tzu-Han,0,13,50,50
1650981110864,COGS 17,A01,092677,Staff,6,0,75,69
1650981116887,COGS 100,A01,083619,Staff,0,31,60,60
1650981122915,COGS 101A,A01,083621,Davis; Joshua Daniel,0,29,60,60
1650981128938,COGS 101B,A01,091572,Staff,0,5,60,60
1650981134962,COGS 101C,A01,083625,Delgado; Tania,14,0,30,16
1650981140987,COGS 107A,A01,083627,Boyle; Mary E. T.,0,16,60,60
1650981147011,COGS 118A,A01,083075,Staff,0,10,60,60
1650981153036,CSE 3,A50,083646,Miranda; Gregory Joseph,15,0,38,23
1650981153036,CSE 3,A51,083647,Miranda; Gregory Joseph,36,0,37,1
1650981159063,CSE 8A,A50,083650,Miranda; Gregory Joseph,0,31,40,40
1650981165087,CSE 11,A01,083080,Cao; Yingjun,0,97,40,40
1650981171114,CSE 12,A01,083652,Staff,0,24,100,100
1650981177135,CSE 15L,A01,083654,Staff,0,3,50,50
1650981177135,CSE 15L,A02,083655,Staff,0,3,50,50
1650981183163,CSE 20,A01,083657,Staff,47,0,80,33
1650981189184,CSE 30,A01,083084,Eldon; John,1,38,80,79
1650981195208,CSE 100,A01,083659,Cao; Yingjun,0,71,50,50
1650981201231,CSE 134B,A01,083661,Powell; Thomas Allan,1,40,65,64
1650981207255,CSE 140,A01,083663,Staff,0,13,75,75
1650981213279,CSE 140L,A01,083088,Eldon; John,4,0,100,96
1650981219306,CSE 175,A01,083665,Kumar; Rakesh,0,0,25,25
1650981225337,CSE 190,A00,092507,Dubnov; Shlomo,9,0,20,11
1650981231361,ECE 45,A01,083139,Staff,0,6,60,60
1650981237385,ECE 65,A50,083695,Staff,0,7,30,30
1650981243411,ECE 109,A01,091882,Touri; Behrouz,32,0,70,38
1650981249434,ECE 180,A00,083140,Abi Samra; Nicholas Camill,18,0,30,12
1650981249434,ECE 180,B00,083141,Abi Samra; Nicholas Camill,0,0,30,30
1650981255470,MATH 10A,A01,083735,Patchell; Gregory David,2,0,30,28
1650981255470,MATH 10A,A02,083736,Patchell; Gregory David,27,0,30,3
1650981255470,MATH 10A,A03,083737,Patchell; Gregory David,23,0,30,7
1650981261491,MATH 10B,A01,083207,Staff,0,9,30,30
1650981261491,MATH 10B,A02,083208,Staff,0,5,30,30
1650981261491,MATH 10B,B01,083739,Staff,9,0,30,21
1650981261491,MATH 10B,B02,083740,Staff,28,0,30,2
1650981267517,MATH 18,A01,083743,Staff,0,0,30,30
1650981267517,MATH 18,A02,083744,Staff,24,0,30,6
1650981267517,MATH 18,A03,083745,Staff,19,0,30,11
1650981267517,MATH 18,A04,083746,Staff,26,0,30,4
1650981267517,MATH 18,B01,083748,Staff,0,15,30,30
1650981267517,MATH 18,B02,083749,Staff,0,14,30,30
1650981267517,MATH 18,B03,083750,Staff,0,13,30,30
1650981267517,MATH 18,B04,083751,Staff,0,13,30,30
1650981273543,MATH 20A,A01,083754,Staff,19,0,40,21
1650981279569,MATH 20B,A01,083756,Staff,0,14,30,30
1650981279569,MATH 20B,A02,083757,Staff,0,11,30,30
1650981285593,MATH 20C,A01,083760,Staff,0,17,30,30
1650981285593,MATH 20C,A02,083761,Staff,0,15,30,30
1650981285593,MATH 20C,B01,083762,Staff,9,0,30,21
1650981285593,MATH 20C,B02,083763,Staff,28,0,30,2
1650981291618,MATH 20D,A01,083765,Staff,2,1,30,28
1650981291618,MATH 20D,A02,083766,Staff,2,0,30,28
1650981291618,MATH 20D,A03,083767,Staff,22,0,30,8
1650981297649,MATH 20E,A01,083771,Staff,2,0,30,28
1650981297649,MATH 20E,A02,083772,Staff,12,0,30,18
1650981297649,MATH 20E,B01,083773,Staff,0,0,30,30
1650981297649,MATH 20E,B02,083774,Staff,1,0,30,29
1650981303673,MATH 103A,A01,083777,Staff,0,17,30,30
1650981303673,MATH 103A,A02,083778,Staff,0,15,30,30
1650981303673,MATH 103A,B01,083779,Staff,0,15,30,30
1650981303673,MATH 103A,B02,083780,Staff,0,14,30,30
1650981309699,MATH 105,A01,085443,Staff,0,23,30,30
1650981315724,MATH 109,A01,083213,Anzaldo; Leesa B,0,7,30,30
1650981315724,MATH 109,A02,083214,Anzaldo; Leesa B,0,7,30,30
1650981315724,MATH 109,B01,083215,Anzaldo; Leesa B,0,8,30,30
1650981315724,MATH 109,B02,083216,Anzaldo; Leesa B,0,7,30,30
1650981321748,MATH 142A,A01,083219,Chow; Bennett,0,14,30,30
1650981321748,MATH 142A,A02,083220,Chow; Bennett,0,15,30,30
1650981321748,MATH 142A,B01,083221,Chow; Bennett,0,16,30,30
1650981321748,MATH 142A,B02,083222,Chow; Bennett,0,14,30,30
1650981327774,MATH 193A,A01,083224,Staff,0,6,30,30
1650981327774,MATH 193A,A02,083225,Staff,0,7,30,30
1650981327774,MATH 193A,A03,083781,Staff,0,6,30,30
1650981327774,MATH 193A,A04,083782,Staff,0,7,30,30
1650981333798,MATH 197,001,091859,McAuley; Julian John,9998,0,9999,1
1650981339854,COGS 9,A01,083615,Staff,0,18,60,60
1650981345878,COGS 11,A01,083617,Boyle; Mary E. T.,15,0,40,25
1650981351902,COGS 13,A01,083071,Staff,0,41,40,40
1650981357933,COGS 14A,A01,092681,Staff,0,38,100,100
1650981363957,COGS 14B,A01,083073,Cheng; Tzu-Han,0,13,50,50
1650981369985,COGS 17,A01,092677,Staff,6,0,75,69
1650981376012,COGS 100,A01,083619,Staff,0,31,60,60
1650981382036,COGS 101A,A01,083621,Davis; Joshua Daniel,0,29,60,60
1650981388061,COGS 101B,A01,091572,Staff,0,5,60,60
1650981394085,COGS 101C,A01,083625,Delgado; Tania,14,0,30,16
1650981400108,COGS 107A,A01,083627,Boyle; Mary E. T.,0,16,60,60
1650981406131,COGS 118A,A01,083075,Staff,0,10,60,60
1650981412157,CSE 3,A50,083646,Miranda; Gregory Joseph,15,0,38,23
1650981412157,CSE 3,A51,083647,Miranda; Gregory Joseph,36,0,37,1
1650981418184,CSE 8A,A50,083650,Miranda; Gregory Joseph,0,31,40,40
1650981424208,CSE 11,A01,083080,Cao; Yingjun,0,97,40,40
1650981430321,CSE 12,A01,083652,Staff,0,24,100,100
1650981436343,CSE 15L,A01,083654,Staff,0,3,50,50
1650981436343,CSE 15L,A02,083655,Staff,0,3,50,50
1650981442367,CSE 20,A01,083657,Staff,47,0,80,33
1650981448393,CSE 30,A01,083084,Eldon; John,1,38,80,79
1650981454417,CSE 100,A01,083659,Cao; Yingjun,0,71,50,50
1650981460443,CSE 134B,A01,083661,Powell; Thomas Allan,1,40,65,64
1650981466469,CSE 140,A01,083663,Staff,0,13,75,75
1650981472493,CSE 140L,A01,083088,Eldon; John,4,0,100,96
1650981478519,CSE 175,A01,083665,Kumar; Rakesh,0,0,25,25
1650981484548,CSE 190,A00,092507,Dubnov; Shlomo,9,0,20,11
1650981490574,ECE 45,A01,083139,Staff,0,6,60,60
1650981496602,ECE 65,A50,083695,Staff,0,7,30,30
1650981502626,ECE 109,A01,091882,Touri; Behrouz,32,0,70,38
1650981508650,ECE 180,A00,083140,Abi Samra; Nicholas Camill,18,0,30,12
1650981508650,ECE 180,B00,083141,Abi Samra; Nicholas Camill,0,0,30,30
1650981514679,MATH 10A,A01,083735,Patchell; Gregory David,2,0,30,28
1650981514679,MATH 10A,A02,083736,Patchell; Gregory David,27,0,30,3
1650981514679,MATH 10A,A03,083737,Patchell; Gregory David,23,0,30,7
1650981520716,MATH 10B,A01,083207,Staff,0,9,30,30
1650981520716,MATH 10B,A02,083208,Staff,0,5,30,30
1650981520716,MATH 10B,B01,083739,Staff,9,0,30,21
1650981520716,MATH 10B,B02,083740,Staff,28,0,30,2
1650981526741,MATH 18,A01,083743,Staff,0,0,30,30
1650981526741,MATH 18,A02,083744,Staff,24,0,30,6
1650981526741,MATH 18,A03,083745,Staff,19,0,30,11
1650981526741,MATH 18,A04,083746,Staff,26,0,30,4
1650981526741,MATH 18,B01,083748,Staff,0,15,30,30
1650981526741,MATH 18,B02,083749,Staff,0,14,30,30
1650981526741,MATH 18,B03,083750,Staff,0,13,30,30
1650981526741,MATH 18,B04,083751,Staff,0,13,30,30
1650981532764,MATH 20A,A01,083754,Staff,19,0,40,21
1650981538789,MATH 20B,A01,083756,Staff,0,14,30,30
1650981538789,MATH 20B,A02,083757,Staff,0,11,30,30
1650981544813,MATH 20C,A01,083760,Staff,0,17,30,30
1650981544813,MATH 20C,A02,083761,Staff,0,15,30,30
1650981544813,MATH 20C,B01,083762,Staff,9,0,30,21
1650981544813,MATH 20C,B02,083763,Staff,28,0,30,2
1650981550841,MATH 20D,A01,083765,Staff,2,1,30,28
1650981550841,MATH 20D,A02,083766,Staff,2,0,30,28
1650981550841,MATH 20D,A03,083767,Staff,22,0,30,8
1650981556864,MATH 20E,A01,083771,Staff,2,0,30,28
1650981556864,MATH 20E,A02,083772,Staff,12,0,30,18
1650981556864,MATH 20E,B01,083773,Staff,0,0,30,30
1650981556864,MATH 20E,B02,083774,Staff,1,0,30,29
1650981562891,MATH 103A,A01,083777,Staff,0,17,30,30
1650981562891,MATH 103A,A02,083778,Staff,0,15,30,30
1650981562891,MATH 103A,B01,083779,Staff,0,15,30,30
1650981562891,MATH 103A,B02,083780,Staff,0,14,30,30
1650981568916,MATH 105,A01,085443,Staff,0,23,30,30
1650981574943,MATH 109,A01,083213,Anzaldo; Leesa B,0,7,30,30
1650981574943,MATH 109,A02,083214,Anzaldo; Leesa B,0,7,30,30
1650981574943,MATH 109,B01,083215,Anzaldo; Leesa B,0,8,30,30
1650981574943,MATH 109,B02,083216,Anzaldo; Leesa B,0,7,30,30
1650981580972,MATH 142A,A01,083219,Chow; Bennett,0,14,30,30
1650981580972,MATH 142A,A02,083220,Chow; Bennett,0,15,30,30
1650981580972,MATH 142A,B01,083221,Chow; Bennett,0,16,30,30
1650981580972,MATH 142A,B02,083222,Chow; Bennett,0,14,30,30
1650981587002,MATH 193A,A01,083224,Staff,0,6,30,30
1650981587002,MATH 193A,A02,083225,Staff,0,7,30,30
1650981587002,MATH 193A,A03,083781,Staff,0,6,30,30
1650981587002,MATH 193A,A04,083782,Staff,0,7,30,30
1650981593027,MATH 197,001,091859,McAuley; Julian John,9998,0,9999,1
1650981599075,COGS 9,A01,083615,Staff,0,18,60,60
1650981605100,COGS 11,A01,083617,Boyle; Mary E. T.,15,0,40,25
1650981611123,COGS 13,A01,083071,Staff,0,41,40,40
1650981617163,COGS 14A,A01,092681,Staff,0,38,100,100
1650981623197,COGS 14B,A01,083073,Cheng; Tzu-Han,0,13,50,50
1650981629226,COGS 17,A01,092677,Staff,6,0,75,69
1650981635252,COGS 100,A01,083619,Staff,0,31,60,60
1650981641278,COGS 101A,A01,083621,Davis; Joshua Daniel,0,29,60,60
1650981647305,COGS 101B,A01,091572,Staff,0,5,60,60
1650981653332,COGS 101C,A01,083625,Delgado; Tania,14,0,30,16
1650981659358,COGS 107A,A01,083627,Boyle; Mary E. T.,0,16,60,60
1650981665383,COGS 118A,A01,083075,Staff,0,10,60,60
1650981671412,CSE 3,A50,083646,Miranda; Gregory Joseph,15,0,38,23
1650981671412,CSE 3,A51,083647,Miranda; Gregory Joseph,36,0,37,1
1650981677437,CSE 8A,A50,083650,Miranda; Gregory Joseph,0,31,40,40
1650981683461,CSE 11,A01,083080,Cao; Yingjun,0,97,40,40
1650981689489,CSE 12,A01,083652,Staff,0,24,100,100
1650981695512,CSE 15L,A01,083654,Staff,0,3,50,50
1650981695512,CSE 15L,A02,083655,Staff,0,3,50,50
1650981701536,CSE 20,A01,083657,Staff,47,0,80,33
1650981707559,CSE 30,A01,083084,Eldon; John,1,38,80,79
1650981713583,CSE 100,A01,083659,Cao; Yingjun,0,71,50,50
1650981719609,CSE 134B,A01,083661,Powell; Thomas Allan,1,40,65,64
1650981725643,CSE 140,A01,083663,Staff,0,13,75,75
1650981731673,CSE 140L,A01,083088,Eldon; John,4,0,100,96
1650981737697,CSE 175,A01,083665,Kumar; Rakesh,0,0,25,25
1650981743737,CSE 190,A00,092507,Dubnov; Shlomo,9,0,20,11
1650981749761,ECE 45,A01,083139,Staff,0,6,60,60
1650981755800,ECE 65,A50,083695,Staff,0,7,30,30
1650981761825,ECE 109,A01,091882,Touri; Behrouz,32,0,70,38
1650981767852,ECE 180,A00,083140,Abi Samra; Nicholas Camill,18,0,30,12
1650981767852,ECE 180,B00,083141,Abi Samra; Nicholas Camill,0,0,30,30
1650981773876,MATH 10A,A01,083735,Patchell; Gregory David,2,0,30,28
1650981773876,MATH 10A,A02,083736,Patchell; Gregory David,27,0,30,3
1650981773876,MATH 10A,A03,083737,Patchell; Gregory David,23,0,30,7
1650981779900,MATH 10B,A01,083207,Staff,0,9,30,30
1650981779900,MATH 10B,A02,083208,Staff,0,5,30,30
1650981779900,MATH 10B,B01,083739,Staff,9,0,30,21
1650981779900,MATH 10B,B02,083740,Staff,28,0,30,2
1650981785931,MATH 18,A01,083743,Staff,0,0,30,30
1650981785931,MATH 18,A02,083744,Staff,24,0,30,6
1650981785931,MATH 18,A03,083745,Staff,19,0,30,11
1650981785931,MATH 18,A04,083746,Staff,26,0,30,4
1650981785931,MATH 18,B01,083748,Staff,0,15,30,30
1650981785931,MATH 18,B02,083749,Staff,0,14,30,30
1650981785931,MATH 18,B03,083750,Staff,0,13,30,30
1650981785931,MATH 18,B04,083751,Staff,0,13,30,30
1650981791958,MATH 20A,A01,083754,Staff,19,0,40,21
1650981797982,MATH 20B,A01,083756,Staff,0,14,30,30
1650981797982,MATH 20B,A02,083757,Staff,0,11,30,30
1650981804010,MATH 20C,A01,083760,Staff,0,17,30,30
1650981804010,MATH 20C,A02,083761,Staff,0,15,30,30
1650981804010,MATH 20C,B01,083762,Staff,9,0,30,21
1650981804010,MATH 20C,B02,083763,Staff,28,0,30,2
1650981810037,MATH 20D,A01,083765,Staff,2,1,30,28
1650981810037,MATH 20D,A02,083766,Staff,2,0,30,28
1650981810037,MATH 20D,A03,083767,Staff,22,0,30,8
1650981816060,MATH 20E,A01,083771,Staff,2,0,30,28
1650981816060,MATH 20E,A02,083772,Staff,12,0,30,18
1650981816060,MATH 20E,B01,083773,Staff,0,0,30,30
1650981816060,MATH 20E,B02,083774,Staff,1,0,30,29
1650981822084,MATH 103A,A01,083777,Staff,0,17,30,30
1650981822084,MATH 103A,A02,083778,Staff,0,15,30,30
1650981822084,MATH 103A,B01,083779,Staff,0,15,30,30
1650981822084,MATH 103A,B02,083780,Staff,0,14,30,30
1650981828111,MATH 105,A01,085443,Staff,0,23,30,30
1650981834148,MATH 109,A01,083213,Anzaldo; Leesa B,0,7,30,30
1650981834148,MATH 109,A02,083214,Anzaldo; Leesa B,0,7,30,30
1650981834148,MATH 109,B01,083215,Anzaldo; Leesa B,0,8,30,30
1650981834148,MATH 109,B02,083216,Anzaldo; Leesa B,0,7,30,30
1650981840177,MATH 142A,A01,083219,Chow; Bennett,0,14,30,30
1650981840177,MATH 142A,A02,083220,Chow; Bennett,0,15,30,30
1650981840177,MATH 142A,B01,083221,Chow; Bennett,0,16,30,30
1650981840177,MATH 142A,B02,083222,Chow; Bennett,0,14,30,30
1650981846202,MATH 193A,A01,083224,Staff,0,6,30,30
1650981846202,MATH 193A,A02,083225,Staff,0,7,30,30
1650981846202,MATH 193A,A03,083781,Staff,0,6,30,30
1650981846202,MATH 193A,A04,083782,Staff,0,7,30,30
1650981852229,MATH 197,001,091859,McAuley; Julian John,9998,0,9999,1
1650981858304,COGS 9,A01,083615,Staff,0,18,60,60
1650981864327,COGS 11,A01,083617,Boyle; Mary E. T.,15,0,40,25
1650981870354,COGS 13,A01,083071,Staff,0,41,40,40
1650981876382,COGS 14A,A01,092681,Staff,0,38,100,100
1650981882405,COGS 14B,A01,083073,Cheng; Tzu-Han,0,13,50,50
1650981888432,COGS 17,A01,092677,Staff,6,0,75,69
1650981894455,COGS 100,A01,083619,Staff,0,31,60,60
1650981900478,COGS 101A,A01,083621,Davis; Joshua Daniel,0,29,60,60
1650981906519,COGS 101B,A01,091572,Staff,0,5,60,60
1650981912547,COGS 101C,A01,083625,Delgado; Tania,14,0,30,16
1650981918574,COGS 107A,A01,083627,Boyle; Mary E. T.,0,16,60,60
1650981924605,COGS 118A,A01,083075,Staff,0,10,60,60
1650981930632,CSE 3,A50,083646,Miranda; Gregory Joseph,15,0,38,23
1650981930632,CSE 3,A51,083647,Miranda; Gregory Joseph,36,0,37,1
1650981936653,CSE 8A,A50,083650,Miranda; Gregory Joseph,0,31,40,40
1650981942677,CSE 11,A01,083080,Cao; Yingjun,0,97,40,40
1650981948708,CSE 12,A01,083652,Staff,0,24,100,100
1650981954732,CSE 15L,A01,083654,Staff,0,3,50,50
1650981954732,CSE 15L,A02,083655,Staff,0,3,50,50
1650981960759,CSE 20,A01,083657,Staff,47,0,80,33
1650981966804,CSE 30,A01,083084,Eldon; John,1,38,80,79
1650981972830,CSE 100,A01,083659,Cao; Yingjun,0,71,50,50
1650981978853,CSE 134B,A01,083661,Powell; Thomas Allan,1,40,65,64
1650981984878,CSE 140,A01,083663,Staff,0,13,75,75
1650981990902,CSE 140L,A01,083088,Eldon; John,4,0,100,96
1650981996928,CSE 175,A01,083665,Kumar; Rakesh,0,0,25,25
1650982002951,CSE 190,A00,092507,Dubnov; Shlomo,9,0,20,11
1650982008975,ECE 45,A01,083139,Staff,0,6,60,60
1650982015003,ECE 65,A50,083695,Staff,0,7,30,30
1650982021028,ECE 109,A01,091882,Touri; Behrouz,32,0,70,38
1650982027148,ECE 180,A00,083140,Abi Samra; Nicholas Camill,18,0,30,12
1650982027148,ECE 180,B00,083141,Abi Samra; Nicholas Camill,0,0,30,30
1650982033180,MATH 10A,A01,083735,Patchell; Gregory David,2,0,30,28
1650982033180,MATH 10A,A02,083736,Patchell; Gregory David,27,0,30,3
1650982033180,MATH 10A,A03,083737,Patchell; Gregory David,23,0,30,7
1650982039205,MATH 10B,A01,083207,Staff,0,9,30,30
1650982039205,MATH 10B,A02,083208,Staff,0,5,30,30
1650982039205,MATH 10B,B01,083739,Staff,9,0,30,21
1650982039205,MATH 10B,B02,083740,Staff,28,0,30,2
1650982045231,MATH 18,A01,083743,Staff,0,0,30,30
1650982045231,MATH 18,A02,083744,Staff,24,0,30,6
1650982045231,MATH 18,A03,083745,Staff,19,0,30,11
1650982045231,MATH 18,A04,083746,Staff,26,0,30,4
1650982045231,MATH 18,B01,083748,Staff,0,15,30,30
1650982045231,MATH 18,B02,083749,Staff,0,14,30,30
1650982045231,MATH 18,B03,083750,Staff,0,13,30,30
1650982045231,MATH 18,B04,083751,Staff,0,13,30,30
1650982051259,MATH 20A,A01,083754,Staff,19,0,40,21
1650982057286,MATH 20B,A01,083756,Staff,0,14,30,30
1650982057286,MATH 20B,A02,083757,Staff,0,11,30,30
1650982063316,MATH 20C,A01,083760,Staff,0,17,30,30
1650982063316,MATH 20C,A02,083761,Staff,0,15,30,30
1650982063316,MATH 20C,B01,083762,Staff,9,0,30,21
1650982063316,MATH 20C,B02,083763,Staff,28,0,30,2
1650982069339,MATH 20D,A01,083765,Staff,2,1,30,28
1650982069339,MATH 20D,A02,083766,Staff,2,0,30,28
1650982069339,MATH 20D,A03,083767,Staff,22,0,30,8
1650982075367,MATH 20E,A01,083771,Staff,2,0,30,28
1650982075367,MATH 20E,A02,083772,Staff,12,0,30,18
1650982075367,MATH 20E,B01,083773,Staff,0,0,30,30
1650982075367,MATH 20E,B02,083774,Staff,1,0,30,29
1650982081394,MATH 103A,A01,083777,Staff,0,17,30,30
1650982081394,MATH 103A,A02,083778,Staff,0,15,30,30
1650982081394,MATH 103A,B01,083779,Staff,0,15,30,30
1650982081394,MATH 103A,B02,083780,Staff,0,14,30,30
1650982087423,MATH 105,A01,085443,Staff,0,23,30,30
1650982093448,MATH 109,A01,083213,Anzaldo; Leesa B,0,7,30,30
1650982093448,MATH 109,A02,083214,Anzaldo; Leesa B,0,7,30,30
1650982093448,MATH 109,B01,083215,Anzaldo; Leesa B,0,8,30,30
1650982093448,MATH 109,B02,083216,Anzaldo; Leesa B,0,7,30,30
1650982099473,MATH 142A,A01,083219,Chow; Bennett,0,14,30,30
1650982099473,MATH 142A,A02,083220,Chow; Bennett,0,15,30,30
1650982099473,MATH 142A,B01,083221,Chow; Bennett,0,16,30,30
1650982099473,MATH 142A,B02,083222,Chow; Bennett,0,14,30,30
1650982105499,MATH 193A,A01,083224,Staff,0,6,30,30
1650982105499,MATH 193A,A02,083225,Staff,0,7,30,30
1650982105499,MATH 193A,A03,083781,Staff,0,6,30,30
1650982105499,MATH 193A,A04,083782,Staff,0,7,30,30
1650982111523,MATH 197,001,091859,McAuley; Julian John,9998,0,9999,1
1650982117589,COGS 9,A01,083615,Staff,0,18,60,60
1650982123613,COGS 11,A01,083617,Boyle; Mary E. T.,15,0,40,25
1650982129638,COGS 13,A01,083071,Staff,0,41,40,40
1650982135663,COGS 14A,A01,092681,Staff,0,38,100,100
1650982141705,COGS 14B,A01,083073,Cheng; Tzu-Han,0,13,50,50
1650982147740,COGS 17,A01,092677,Staff,6,0,75,69
1650982153767,COGS 100,A01,083619,Staff,0,31,60,60
1650982159801,COGS 101A,A01,083621,Davis; Joshua Daniel,0,29,60,60
1650982165825,COGS 101B,A01,091572,Staff,0,5,60,60
1650982171852,COGS 101C,A01,083625,Delgado; Tania,14,0,30,16
1650982177876,COGS 107A,A01,083627,Boyle; Mary E. T.,0,16,60,60
1650982183903,COGS 118A,A01,083075,Staff,0,10,60,60
1650982189930,CSE 3,A50,083646,Miranda; Gregory Joseph,15,0,38,23
1650982189930,CSE 3,A51,083647,Miranda; Gregory Joseph,36,0,37,1
1650982195966,CSE 8A,A50,083650,Miranda; Gregory Joseph,0,31,40,40
1650982201991,CSE 11,A01,083080,Cao; Yingjun,0,97,40,40
1650982208022,CSE 12,A01,083652,Staff,0,24,100,100
1650982214047,CSE 15L,A01,083654,Staff,0,3,50,50
1650982214047,CSE 15L,A02,083655,Staff,0,3,50,50
1650982220075,CSE 20,A01,083657,Staff,47,0,80,33
1650982226109,CSE 30,A01,083084,Eldon; John,1,38,80,79
1650982232133,CSE 100,A01,083659,Cao; Yingjun,0,71,50,50
1650982238160,CSE 134B,A01,083661,Powell; Thomas Allan,1,40,65,64
1650982244187,CSE 140,A01,083663,Staff,0,13,75,75
1650982250209,CSE 140L,A01,083088,Eldon; John,4,0,100,96
1650982256235,CSE 175,A01,083665,Kumar; Rakesh,0,0,25,25
1650982262259,CSE 190,A00,092507,Dubnov; Shlomo,9,0,20,11
1650982268282,ECE 45,A01,083139,Staff,0,6,60,60
1650982274309,ECE 65,A50,083695,Staff,0,7,30,30
1650982280333,ECE 109,A01,091882,Touri; Behrouz,32,0,70,38
1650982286355,ECE 180,A00,083140,Abi Samra; Nicholas Camill,18,0,30,12
1650982286355,ECE 180,B00,083141,Abi Samra; Nicholas Camill,0,0,30,30
1650982292384,MATH 10A,A01,083735,Patchell; Gregory David,2,0,30,28
1650982292384,MATH 10A,A02,083736,Patchell; Gregory David,27,0,30,3
1650982292384,MATH 10A,A03,083737,Patchell; Gregory David,23,0,30,7
1650982298407,MATH 10B,A01,083207,Staff,0,9,30,30
1650982298407,MATH 10B,A02,083208,Staff,0,5,30,30
1650982298407,MATH 10B,B01,083739,Staff,9,0,30,21
1650982298407,MATH 10B,B02,083740,Staff,28,0,30,2
1650982304433,MATH 18,A01,083743,Staff,0,0,30,30
1650982304433,MATH 18,A02,083744,Staff,24,0,30,6
1650982304433,MATH 18,A03,083745,Staff,19,0,30,11
1650982304433,MATH 18,A04,083746,Staff,26,0,30,4
1650982304433,MATH 18,B01,083748,Staff,0,15,30,30
1650982304433,MATH 18,B02,083749,Staff,0,14,30,30
1650982304433,MATH 18,B03,083750,Staff,0,13,30,30
1650982304433,MATH 18,B04,083751,Staff,0,13,30,30
1650982310460,MATH 20A,A01,083754,Staff,19,0,40,21
1650982316483,MATH 20B,A01,083756,Staff,0,14,30,30
1650982316483,MATH 20B,A02,083757,Staff,0,11,30,30
1650982322510,MATH 20C,A01,083760,Staff,0,17,30,30
1650982322510,MATH 20C,A02,083761,Staff,0,15,30,30
1650982322510,MATH 20C,B01,083762,Staff,9,0,30,21
1650982322510,MATH 20C,B02,083763,Staff,28,0,30,2
1650982328533,MATH 20D,A01,083765,Staff,2,1,30,28
1650982328533,MATH 20D,A02,083766,Staff,2,0,30,28
1650982328533,MATH 20D,A03,083767,Staff,22,0,30,8
1650982334560,MATH 20E,A01,083771,Staff,2,0,30,28
1650982334560,MATH 20E,A02,083772,Staff,12,0,30,18
1650982334560,MATH 20E,B01,083773,Staff,0,0,30,30
1650982334560,MATH 20E,B02,083774,Staff,1,0,30,29
1650982340584,MATH 103A,A01,083777,Staff,0,17,30,30
1650982340584,MATH 103A,A02,083778,Staff,0,15,30,30
1650982340584,MATH 103A,B01,083779,Staff,0,15,30,30
1650982340584,MATH 103A,B02,083780,Staff,0,14,30,30
1650982346611,MATH 105,A01,085443,Staff,0,23,30,30
1650982352635,MATH 109,A01,083213,Anzaldo; Leesa B,0,7,30,30
1650982352635,MATH 109,A02,083214,Anzaldo; Leesa B,0,7,30,30
1650982352635,MATH 109,B01,083215,Anzaldo; Leesa B,0,8,30,30
1650982352635,MATH 109,B02,083216,Anzaldo; Leesa B,0,7,30,30
1650982358658,MATH 142A,A01,083219,Chow; Bennett,0,14,30,30
1650982358658,MATH 142A,A02,083220,Chow; Bennett,0,15,30,30
1650982358658,MATH 142A,B01,083221,Chow; Bennett,0,16,30,30
1650982358658,MATH 142A,B02,083222,Chow; Bennett,0,14,30,30
1650982364690,MATH 193A,A01,083224,Staff,0,6,30,30
1650982364690,MATH 193A,A02,083225,Staff,0,7,30,30
1650982364690,MATH 193A,A03,083781,Staff,0,6,30,30
1650982364690,MATH 193A,A04,083782,Staff,0,7,30,30
1650982370712,MATH 197,001,091859,McAuley; Julian John,9998,0,9999,1
1650982376764,COGS 9,A01,083615,Staff,0,18,60,60
1650982382796,COGS 11,A01,083617,Boyle; Mary E. T.,15,0,40,25
1650982388819,COGS 13,A01,083071,Staff,0,41,40,40
1650982394845,COGS 14A,A01,092681,Staff,0,38,100,100
1650982400869,COGS 14B,A01,083073,Cheng; Tzu-Han,0,13,50,50
1650982406891,COGS 17,A01,092677,Staff,6,0,75,69
1650982412918,COGS 100,A01,083619,Staff,0,31,60,60
1650982418948,COGS 101A,A01,083621,Davis; Joshua Daniel,0,29,60,60
1650982424976,COGS 101B,A01,091572,Staff,0,5,60,60
1650982431001,COGS 101C,A01,083625,Delgado; Tania,14,0,30,16
1650982437028,COGS 107A,A01,083627,Boyle; Mary E. T.,0,16,60,60
1650982443075,COGS 118A,A01,083075,Staff,0,10,60,60
1650982449104,CSE 3,A50,083646,Miranda; Gregory Joseph,15,0,38,23
1650982449104,CSE 3,A51,083647,Miranda; Gregory Joseph,36,0,37,1
1650982455139,CSE 8A,A50,083650,Miranda; Gregory Joseph,0,31,40,40
1650982461163,CSE 11,A01,083080,Cao; Yingjun,0,97,40,40
1650982467187,CSE 12,A01,083652,Staff,0,24,100,100
1650982473212,CSE 15L,A01,083654,Staff,0,3,50,50
1650982473212,CSE 15L,A02,083655,Staff,0,3,50,50
1650982479235,CSE 20,A01,083657,Staff,47,0,80,33
1650982485259,CSE 30,A01,083084,Eldon; John,1,38,80,79
1650982491282,CSE 100,A01,083659,Cao; Yingjun,0,71,50,50
1650982497306,CSE 134B,A01,083661,Powell; Thomas Allan,1,40,65,64
1650982503330,CSE 140,A01,083663,Staff,0,13,75,75
1650982509354,CSE 140L,A01,083088,Eldon; John,4,0,100,96
1650982515380,CSE 175,A01,083665,Kumar; Rakesh,0,0,25,25
1650982521408,CSE 190,A00,092507,Dubnov; Shlomo,9,0,20,11
1650982527431,ECE 45,A01,083139,Staff,0,6,60,60
1650982533456,ECE 65,A50,083695,Staff,0,7,30,30
1650982539480,ECE 109,A01,091882,Touri; Behrouz,32,0,70,38
1650982545506,ECE 180,A00,083140,Abi Samra; Nicholas Camill,18,0,30,12
1650982545506,ECE 180,B00,083141,Abi Samra; Nicholas Camill,0,0,30,30
1650982551531,MATH 10A,A01,083735,Patchell; Gregory David,2,0,30,28
1650982551531,MATH 10A,A02,083736,Patchell; Gregory David,27,0,30,3
1650982551531,MATH 10A,A03,083737,Patchell; Gregory David,23,0,30,7
1650982557559,MATH 10B,A01,083207,Staff,0,9,30,30
1650982557559,MATH 10B,A02,083208,Staff,0,5,30,30
1650982557559,MATH 10B,B01,083739,Staff,9,0,30,21
1650982557559,MATH 10B,B02,083740,Staff,28,0,30,2
1650982563584,MATH 18,A01,083743,Staff,0,0,30,30
1650982563584,MATH 18,A02,083744,Staff,24,0,30,6
1650982563584,MATH 18,A03,083745,Staff,19,0,30,11
1650982563584,MATH 18,A04,083746,Staff,26,0,30,4
1650982563584,MATH 18,B01,083748,Staff,0,15,30,30
1650982563584,MATH 18,B02,083749,Staff,0,14,30,30
1650982563584,MATH 18,B03,083750,Staff,0,13,30,30
1650982563584,MATH 18,B04,083751,Staff,0,13,30,30
1650982569610,MATH 20A,A01,083754,Staff,19,0,40,21
1650982575635,MATH 20B,A01,083756,Staff,0,14,30,30
1650982575635,MATH 20B,A02,083757,Staff,0,11,30,30
1650982581659,MATH 20C,A01,083760,Staff,0,17,30,30
1650982581659,MATH 20C,A02,083761,Staff,0,15,30,30
1650982581659,MATH 20C,B01,083762,Staff,9,0,30,21
1650982581659,MATH 20C,B02,083763,Staff,28,0,30,2
1650982587684,MATH 20D,A01,083765,Staff,2,1,30,28
1650982587684,MATH 20D,A02,083766,Staff,2,0,30,28
1650982587684,MATH 20D,A03,083767,Staff,22,0,30,8
1650982593708,MATH 20E,A01,083771,Staff,2,0,30,28
1650982593708,MATH 20E,A02,083772,Staff,12,0,30,18
1650982593708,MATH 20E,B01,083773,Staff,0,0,30,30
1650982593708,MATH 20E,B02,083774,Staff,1,0,30,29
1650982599731,MATH 103A,A01,083777,Staff,0,17,30,30
1650982599731,MATH 103A,A02,083778,Staff,0,15,30,30
1650982599731,MATH 103A,B01,083779,Staff,0,15,30,30
1650982599731,MATH 103A,B02,083780,Staff,0,14,30,30
1650982605755,MATH 105,A01,085443,Staff,0,23,30,30
1650982611779,MATH 109,A01,083213,Anzaldo; Leesa B,0,7,30,30
1650982611779,MATH 109,A02,083214,Anzaldo; Leesa B,0,7,30,30
1650982611779,MATH 109,B01,083215,Anzaldo; Leesa B,0,8,30,30
1650982611779,MATH 109,B02,083216,Anzaldo; Leesa B,0,7,30,30
1650982617841,MATH 142A,A01,083219,Chow; Bennett,0,14,30,30
1650982617841,MATH 142A,A02,083220,Chow; Bennett,0,15,30,30
1650982617841,MATH 142A,B01,083221,Chow; Bennett,0,16,30,30
1650982617841,MATH 142A,B02,083222,Chow; Bennett,0,14,30,30
1650982623941,MATH 193A,A01,083224,Staff,0,6,30,30
1650982623941,MATH 193A,A02,083225,Staff,0,7,30,30
1650982623941,MATH 193A,A03,083781,Staff,0,6,30,30
1650982623941,MATH 193A,A04,083782,Staff,0,7,30,30
1650982629965,MATH 197,001,091859,McAuley; Julian John,9998,0,9999,1
1650982636020,COGS 9,A01,083615,Staff,0,18,60,60
1650982642051,COGS 11,A01,083617,Boyle; Mary E. T.,15,0,40,25
1650982648074,COGS 13,A01,083071,Staff,0,41,40,40
1650982654099,COGS 14A,A01,092681,Staff,0,38,100,100
1650982660126,COGS 14B,A01,083073,Cheng; Tzu-Han,0,13,50,50
1650982666152,COGS 17,A01,092677,Staff,6,0,75,69
1650982672182,COGS 100,A01,083619,Staff,0,31,60,60
1650982678214,COGS 101A,A01,083621,Davis; Joshua Daniel,0,29,60,60
1650982684240,COGS 101B,A01,091572,Staff,0,5,60,60
1650982690262,COGS 101C,A01,083625,Delgado; Tania,14,0,30,16
1650982696289,COGS 107A,A01,083627,Boyle; Mary E. T.,0,16,60,60
1650982702313,COGS 118A,A01,083075,Staff,0,10,60,60
1650982708335,CSE 3,A50,083646,Miranda; Gregory Joseph,15,0,38,23
1650982708335,CSE 3,A51,083647,Miranda; Gregory Joseph,36,0,37,1
1650982714358,CSE 8A,A50,083650,Miranda; Gregory Joseph,0,31,40,40
1650982720390,CSE 11,A01,083080,Cao; Yingjun,0,97,40,40
1650982726413,CSE 12,A01,083652,Staff,0,24,100,100
1650982732437,CSE 15L,A01,083654,Staff,0,3,50,50
1650982732437,CSE 15L,A02,083655,Staff,0,3,50,50
1650982738464,CSE 20,A01,083657,Staff,47,0,80,33
1650982744487,CSE 30,A01,083084,Eldon; John,1,38,80,79
1650982750514,CSE 100,A01,083659,Cao; Yingjun,0,71,50,50
1650982756539,CSE 134B,A01,083661,Powell; Thomas Allan,1,40,65,64
1650982762562,CSE 140,A01,083663,Staff,0,13,75,75
1650982768587,CSE 140L,A01,083088,Eldon; John,4,0,100,96
1650982774610,CSE 175,A01,083665,Kumar; Rakesh,0,0,25,25
1650982780637,CSE 190,A00,092507,Dubnov; Shlomo,9,0,20,11
1650982786660,ECE 45,A01,083139,Staff,0,6,60,60
1650982792686,ECE 65,A50,083695,Staff,0,7,30,30
1650982798710,ECE 109,A01,091882,Touri; Behrouz,32,0,70,38
1650982804734,ECE 180,A00,083140,Abi Samra; Nicholas Camill,18,0,30,12
1650982804734,ECE 180,B00,083141,Abi Samra; Nicholas Camill,0,0,30,30
1650982810757,MATH 10A,A01,083735,Patchell; Gregory David,2,0,30,28
1650982810757,MATH 10A,A02,083736,Patchell; Gregory David,27,0,30,3
1650982810757,MATH 10A,A03,083737,Patchell; Gregory David,23,0,30,7
1650982816785,MATH 10B,A01,083207,Staff,0,9,30,30
1650982816785,MATH 10B,A02,083208,Staff,0,5,30,30
1650982816785,MATH 10B,B01,083739,Staff,9,0,30,21
1650982816785,MATH 10B,B02,083740,Staff,28,0,30,2
1650982822820,MATH 18,A01,083743,Staff,0,0,30,30
1650982822820,MATH 18,A02,083744,Staff,24,0,30,6
1650982822820,MATH 18,A03,083745,Staff,19,0,30,11
1650982822820,MATH 18,A04,083746,Staff,26,0,30,4
1650982822820,MATH 18,B01,083748,Staff,0,15,30,30
1650982822820,MATH 18,B02,083749,Staff,0,14,30,30
1650982822820,MATH 18,B03,083750,Staff,0,13,30,30
1650982822820,MATH 18,B04,083751,Staff,0,13,30,30
1650982828844,MATH 20A,A01,083754,Staff,19,0,40,21
1650982834868,MATH 20B,A01,083756,Staff,0,14,30,30
1650982834868,MATH 20B,A02,083757,Staff,0,11,30,30
1650982840892,MATH 20C,A01,083760,Staff,0,17,30,30
1650982840892,MATH 20C,A02,083761,Staff,0,15,30,30
1650982840892,MATH 20C,B01,083762,Staff,9,0,30,21
1650982840892,MATH 20C,B02,083763,Staff,28,0,30,2
1650982846914,MATH 20D,A01,083765,Staff,2,1,30,28
1650982846914,MATH 20D,A02,083766,Staff,2,0,30,28
1650982846914,MATH 20D,A03,083767,Staff,22,0,30,8
1650982852941,MATH 20E,A01,083771,Staff,2,0,30,28
1650982852941,MATH 20E,A02,083772,Staff,12,0,30,18
1650982852941,MATH 20E,B01,083773,Staff,0,0,30,30
1650982852941,MATH 20E,B02,083774,Staff,1,0,30,29
1650982858966,MATH 103A,A01,083777,Staff,0,17,30,30
1650982858966,MATH 103A,A02,083778,Staff,0,15,30,30
1650982858966,MATH 103A,B01,083779,Staff,0,15,30,30
1650982858966,MATH 103A,B02,083780,Staff,0,14,30,30
1650982864990,MATH 105,A01,085443,Staff,0,23,30,30
1650982871027,MATH 109,A01,083213,Anzaldo; Leesa B,0,7,30,30
1650982871027,MATH 109,A02,083214,Anzaldo; Leesa B,0,7,30,30
1650982871027,MATH 109,B01,083215,Anzaldo; Leesa B,0,8,30,30
1650982871027,MATH 109,B02,083216,Anzaldo; Leesa B,0,7,30,30
1650982877052,MATH 142A,A01,083219,Chow; Bennett,0,14,30,30
1650982877052,MATH 142A,A02,083220,Chow; Bennett,0,15,30,30
1650982877052,MATH 142A,B01,083221,Chow; Bennett,0,16,30,30
1650982877052,MATH 142A,B02,083222,Chow; Bennett,0,14,30,30
1650982883080,MATH 193A,A01,083224,Staff,0,6,30,30
1650982883080,MATH 193A,A02,083225,Staff,0,7,30,30
1650982883080,MATH 193A,A03,083781,Staff,0,6,30,30
1650982883080,MATH 193A,A04,083782,Staff,0,7,30,30
1650982889104,MATH 197,001,091859,McAuley; Julian John,9998,0,9999,1
1650982895153,COGS 9,A01,083615,Staff,0,18,60,60
1650982901177,COGS 11,A01,083617,Boyle; Mary E. T.,15,0,40,25
1650982907211,COGS 13,A01,083071,Staff,0,41,40,40
1650982913235,COGS 14A,A01,092681,Staff,0,38,100,100
1650982919262,COGS 14B,A01,083073,Cheng; Tzu-Han,0,13,50,50
1650982925285,COGS 17,A01,092677,Staff,6,0,75,69
1650982931312,COGS 100,A01,083619,Staff,0,31,60,60
1650982937336,COGS 101A,A01,083621,Davis; Joshua Daniel,0,29,60,60
1650982943364,COGS 101B,A01,091572,Staff,0,5,60,60
1650982949390,COGS 101C,A01,083625,Delgado; Tania,14,0,30,16
1650982955417,COGS 107A,A01,083627,Boyle; Mary E. T.,0,16,60,60
1650982961439,COGS 118A,A01,083075,Staff,0,10,60,60
1650982967470,CSE 3,A50,083646,Miranda; Gregory Joseph,15,0,38,23
1650982967470,CSE 3,A51,083647,Miranda; Gregory Joseph,36,0,37,1
1650982973492,CSE 8A,A50,083650,Miranda; Gregory Joseph,0,31,40,40
1650982979518,CSE 11,A01,083080,Cao; Yingjun,0,97,40,40
1650982985541,CSE 12,A01,083652,Staff,0,24,100,100
1650982991565,CSE 15L,A01,083654,Staff,0,3,50,50
1650982991565,CSE 15L,A02,083655,Staff,0,3,50,50
1650982997589,CSE 20,A01,083657,Staff,47,0,80,33
1650983003617,CSE 30,A01,083084,Eldon; John,1,38,80,79
1650983009640,CSE 100,A01,083659,Cao; Yingjun,0,71,50,50
1650983015679,CSE 134B,A01,083661,Powell; Thomas Allan,1,40,65,64
1650983021714,CSE 140,A01,083663,Staff,0,13,75,75
1650983027738,CSE 140L,A01,083088,Eldon; John,4,0,100,96
1650983033764,CSE 175,A01,083665,Kumar; Rakesh,0,0,25,25
1650983039789,CSE 190,A00,092507,Dubnov; Shlomo,9,0,20,11
1650983045816,ECE 45,A01,083139,Staff,0,6,60,60
1650983051852,ECE 65,A50,083695,Staff,0,7,30,30
1650983057895,ECE 109,A01,091882,Touri; Behrouz,32,0,70,38
1650983063918,ECE 180,A00,083140,Abi Samra; Nicholas Camill,18,0,30,12
1650983063918,ECE 180,B00,083141,Abi Samra; Nicholas Camill,0,0,30,30
1650983069949,MATH 10A,A01,083735,Patchell; Gregory David,2,0,30,28
1650983069949,MATH 10A,A02,083736,Patchell; Gregory David,27,0,30,3
1650983069949,MATH 10A,A03,083737,Patchell; Gregory David,23,0,30,7
1650983075977,MATH 10B,A01,083207,Staff,0,9,30,30
1650983075977,MATH 10B,A02,083208,Staff,0,5,30,30
1650983075977,MATH 10B,B01,083739,Staff,9,0,30,21
1650983075977,MATH 10B,B02,083740,Staff,28,0,30,2
1650983082006,MATH 18,A01,083743,Staff,0,0,30,30
1650983082006,MATH 18,A02,083744,Staff,24,0,30,6
1650983082006,MATH 18,A03,083745,Staff,19,0,30,11
1650983082006,MATH 18,A04,083746,Staff,26,0,30,4
1650983082006,MATH 18,B01,083748,Staff,0,15,30,30
1650983082006,MATH 18,B02,083749,Staff,0,14,30,30
1650983082006,MATH 18,B03,083750,Staff,0,13,30,30
1650983082006,MATH 18,B04,083751,Staff,0,13,30,30
1650983088030,MATH 20A,A01,083754,Staff,19,0,40,21
1650983094052,MATH 20B,A01,083756,Staff,0,14,30,30
1650983094052,MATH 20B,A02,083757,Staff,0,11,30,30
1650983100076,MATH 20C,A01,083760,Staff,0,17,30,30
1650983100076,MATH 20C,A02,083761,Staff,0,15,30,30
1650983100076,MATH 20C,B01,083762,Staff,9,0,30,21
1650983100076,MATH 20C,B02,083763,Staff,28,0,30,2
1650983106103,MATH 20D,A01,083765,Staff,2,1,30,28
1650983106103,MATH 20D,A02,083766,Staff,2,0,30,28
1650983106103,MATH 20D,A03,083767,Staff,22,0,30,8
1650983112127,MATH 20E,A01,083771,Staff,2,0,30,28
1650983112127,MATH 20E,A02,083772,Staff,12,0,30,18
1650983112127,MATH 20E,B01,083773,Staff,0,0,30,30
1650983112127,MATH 20E,B02,083774,Staff,1,0,30,29
1650983118150,MATH 103A,A01,083777,Staff,0,17,30,30
1650983118150,MATH 103A,A02,083778,Staff,0,15,30,30
1650983118150,MATH 103A,B01,083779,Staff,0,15,30,30
1650983118150,MATH 103A,B02,083780,Staff,0,14,30,30
1650983124174,MATH 105,A01,085443,Staff,0,23,30,30
1650983130199,MATH 109,A01,083213,Anzaldo; Leesa B,0,7,30,30
1650983130199,MATH 109,A02,083214,Anzaldo; Leesa B,0,7,30,30
1650983130199,MATH 109,B01,083215,Anzaldo; Leesa B,0,8,30,30
1650983130199,MATH 109,B02,083216,Anzaldo; Leesa B,0,7,30,30
1650983136226,MATH 142A,A01,083219,Chow; Bennett,0,14,30,30
1650983136226,MATH 142A,A02,083220,Chow; Bennett,0,15,30,30
1650983136226,MATH 142A,B01,083221,Chow; Bennett,0,16,30,30
1650983136226,MATH 142A,B02,083222,Chow; Bennett,0,14,30,30
1650983142249,MATH 193A,A01,083224,Staff,0,6,30,30
1650983142249,MATH 193A,A02,083225,Staff,0,7,30,30
1650983142249,MATH 193A,A03,083781,Staff,0,6,30,30
1650983142249,MATH 193A,A04,083782,Staff,0,7,30,30
1650983148274,MATH 197,001,091859,McAuley; Julian John,9998,0,9999,1
1650983154329,COGS 9,A01,083615,Staff,0,18,60,60
1650983160355,COGS 11,A01,083617,Boyle; Mary E. T.,15,0,40,25
1650983166381,COGS 13,A01,083071,Staff,0,41,40,40
1650983172404,COGS 14A,A01,092681,Staff,0,38,100,100
1650983178427,COGS 14B,A01,083073,Cheng; Tzu-Han,0,13,50,50
1650983184458,COGS 17,A01,092677,Staff,6,0,75,69
1650983190481,COGS 100,A01,083619,Staff,0,31,60,60
1650983196505,COGS 101A,A01,083621,Davis; Joshua Daniel,0,29,60,60
1650983202530,COGS 101B,A01,091572,Staff,0,5,60,60
1650983208559,COGS 101C,A01,083625,Delgado; Tania,14,0,30,16
1650983214663,COGS 107A,A01,083627,Boyle; Mary E. T.,0,16,60,60
1650983220689,COGS 118A,A01,083075,Staff,0,10,60,60
1650983226721,CSE 3,A50,083646,Miranda; Gregory Joseph,15,0,38,23
1650983226721,CSE 3,A51,083647,Miranda; Gregory Joseph,36,0,37,1
1650983232757,CSE 8A,A50,083650,Miranda; Gregory Joseph,0,31,40,40
1650983238782,CSE 11,A01,083080,Cao; Yingjun,0,97,40,40
1650983244807,CSE 12,A01,083652,Staff,0,24,100,100
1650983250834,CSE 15L,A01,083654,Staff,0,3,50,50
1650983250834,CSE 15L,A02,083655,Staff,0,3,50,50
1650983256860,CSE 20,A01,083657,Staff,47,0,80,33
1650983262882,CSE 30,A01,083084,Eldon; John,1,38,80,79
1650983268908,CSE 100,A01,083659,Cao; Yingjun,0,71,50,50
1650983274932,CSE 134B,A01,083661,Powell; Thomas Allan,1,40,65,64
1650983280957,CSE 140,A01,083663,Staff,0,13,75,75
1650983286983,CSE 140L,A01,083088,Eldon; John,4,0,100,96
1650983293010,CSE 175,A01,083665,Kumar; Rakesh,0,0,25,25
1650983299031,CSE 190,A00,092507,Dubnov; Shlomo,9,0,20,11
1650983305061,ECE 45,A01,083139,Staff,0,6,60,60
1650983311088,ECE 65,A50,083695,Staff,0,7,30,30
1650983317120,ECE 109,A01,091882,Touri; Behrouz,32,0,70,38
1650983323148,ECE 180,A00,083140,Abi Samra; Nicholas Camill,18,0,30,12
1650983323148,ECE 180,B00,083141,Abi Samra; Nicholas Camill,0,0,30,30
1650983329175,MATH 10A,A01,083735,Patchell; Gregory David,2,0,30,28
1650983329175,MATH 10A,A02,083736,Patchell; Gregory David,27,0,30,3
1650983329175,MATH 10A,A03,083737,Patchell; Gregory David,23,0,30,7
1650983335203,MATH 10B,A01,083207,Staff,0,9,30,30
1650983335203,MATH 10B,A02,083208,Staff,0,5,30,30
1650983335203,MATH 10B,B01,083739,Staff,9,0,30,21
1650983335203,MATH 10B,B02,083740,Staff,28,0,30,2
1650983341229,MATH 18,A01,083743,Staff,0,0,30,30
1650983341229,MATH 18,A02,083744,Staff,24,0,30,6
1650983341229,MATH 18,A03,083745,Staff,19,0,30,11
1650983341229,MATH 18,A04,083746,Staff,26,0,30,4
1650983341229,MATH 18,B01,083748,Staff,0,15,30,30
1650983341229,MATH 18,B02,083749,Staff,0,14,30,30
1650983341229,MATH 18,B03,083750,Staff,0,13,30,30
1650983341229,MATH 18,B04,083751,Staff,0,13,30,30
1650983347260,MATH 20A,A01,083754,Staff,19,0,40,21
1650983353288,MATH 20B,A01,083756,Staff,0,14,30,30
1650983353288,MATH 20B,A02,083757,Staff,0,11,30,30
1650983359315,MATH 20C,A01,083760,Staff,0,17,30,30
1650983359315,MATH 20C,A02,083761,Staff,0,15,30,30
1650983359315,MATH 20C,B01,083762,Staff,9,0,30,21
1650983359315,MATH 20C,B02,083763,Staff,28,0,30,2
1650983365343,MATH 20D,A01,083765,Staff,2,1,30,28
1650983365343,MATH 20D,A02,083766,Staff,2,0,30,28
1650983365343,MATH 20D,A03,083767,Staff,22,0,30,8
1650983371369,MATH 20E,A01,083771,Staff,2,0,30,28
1650983371369,MATH 20E,A02,083772,Staff,12,0,30,18
1650983371369,MATH 20E,B01,083773,Staff,0,0,30,30
1650983371369,MATH 20E,B02,083774,Staff,1,0,30,29
1650983377397,MATH 103A,A01,083777,Staff,0,17,30,30
1650983377397,MATH 103A,A02,083778,Staff,0,15,30,30
1650983377397,MATH 103A,B01,083779,Staff,0,15,30,30
1650983377397,MATH 103A,B02,083780,Staff,0,14,30,30
1650983383428,MATH 105,A01,085443,Staff,0,23,30,30
1650983389459,MATH 109,A01,083213,Anzaldo; Leesa B,0,7,30,30
1650983389459,MATH 109,A02,083214,Anzaldo; Leesa B,0,7,30,30
1650983389459,MATH 109,B01,083215,Anzaldo; Leesa B,0,8,30,30
1650983389459,MATH 109,B02,083216,Anzaldo; Leesa B,0,7,30,30
1650983395488,MATH 142A,A01,083219,Chow; Bennett,0,14,30,30
1650983395488,MATH 142A,A02,083220,Chow; Bennett,0,15,30,30
1650983395488,MATH 142A,B01,083221,Chow; Bennett,0,16,30,30
1650983395488,MATH 142A,B02,083222,Chow; Bennett,0,14,30,30
1650983401516,MATH 193A,A01,083224,Staff,0,6,30,30
1650983401516,MATH 193A,A02,083225,Staff,0,7,30,30
1650983401516,MATH 193A,A03,083781,Staff,0,6,30,30
1650983401516,MATH 193A,A04,083782,Staff,0,7,30,30
1650983407540,MATH 197,001,091859,McAuley; Julian John,9998,0,9999,1
1650983413603,COGS 9,A01,083615,Staff,0,18,60,60
1650983419637,COGS 11,A01,083617,Boyle; Mary E. T.,15,0,40,25
1650983425664,COGS 13,A01,083071,Staff,0,41,40,40
1650983431690,COGS 14A,A01,092681,Staff,0,38,100,100
1650983437714,COGS 14B,A01,083073,Cheng; Tzu-Han,0,13,50,50
1650983443739,COGS 17,A01,092677,Staff,6,0,75,69
1650983449764,COGS 100,A01,083619,Staff,0,31,60,60
1650983455786,COGS 101A,A01,083621,Davis; Joshua Daniel,0,29,60,60
1650983461810,COGS 101B,A01,091572,Staff,0,5,60,60
1650983467836,COGS 101C,A01,083625,Delgado; Tania,14,0,30,16
1650983473864,COGS 107A,A01,083627,Boyle; Mary E. T.,0,16,60,60
1650983479907,COGS 118A,A01,083075,Staff,0,10,60,60
1650983485931,CSE 3,A50,083646,Miranda; Gregory Joseph,15,0,38,23
1650983485931,CSE 3,A51,083647,Miranda; Gregory Joseph,36,0,37,1
1650983491958,CSE 8A,A50,083650,Miranda; Gregory Joseph,0,31,40,40
1650983497981,CSE 11,A01,083080,Cao; Yingjun,0,97,40,40
1650983504007,CSE 12,A01,083652,Staff,0,24,100,100
1650983510035,CSE 15L,A01,083654,Staff,0,3,50,50
1650983510035,CSE 15L,A02,083655,Staff,0,3,50,50
1650983516061,CSE 20,A01,083657,Staff,47,0,80,33
1650983522088,CSE 30,A01,083084,Eldon; John,1,38,80,79
1650983528113,CSE 100,A01,083659,Cao; Yingjun,0,71,50,50
1650983534150,CSE 134B,A01,083661,Powell; Thomas Allan,1,40,65,64
1650983540176,CSE 140,A01,083663,Staff,0,13,75,75
1650983546201,CSE 140L,A01,083088,Eldon; John,4,0,100,96
1650983552228,CSE 175,A01,083665,Kumar; Rakesh,0,0,25,25
1650983558264,CSE 190,A00,092507,Dubnov; Shlomo,9,0,20,11
1650983564286,ECE 45,A01,083139,Staff,0,6,60,60
1650983570310,ECE 65,A50,083695,Staff,0,7,30,30
1650983576337,ECE 109,A01,091882,Touri; Behrouz,32,0,70,38
1650983582368,ECE 180,A00,083140,Abi Samra; Nicholas Camill,18,0,30,12
1650983582368,ECE 180,B00,083141,Abi Samra; Nicholas Camill,0,0,30,30
1650983588392,MATH 10A,A01,083735,Patchell; Gregory David,2,0,30,28
1650983588392,MATH 10A,A02,083736,Patchell; Gregory David,27,0,30,3
1650983588392,MATH 10A,A03,083737,Patchell; Gregory David,23,0,30,7
1650983594416,MATH 10B,A01,083207,Staff,0,9,30,30
1650983594416,MATH 10B,A02,083208,Staff,0,5,30,30
1650983594416,MATH 10B,B01,083739,Staff,9,0,30,21
1650983594416,MATH 10B,B02,083740,Staff,28,0,30,2
1650983600444,MATH 18,A01,083743,Staff,0,0,30,30
1650983600444,MATH 18,A02,083744,Staff,24,0,30,6
1650983600444,MATH 18,A03,083745,Staff,19,0,30,11
1650983600444,MATH 18,A04,083746,Staff,26,0,30,4
1650983600444,MATH 18,B01,083748,Staff,0,15,30,30
1650983600444,MATH 18,B02,083749,Staff,0,14,30,30
1650983600444,MATH 18,B03,083750,Staff,0,13,30,30
1650983600444,MATH 18,B04,083751,Staff,0,13,30,30
1650983606470,MATH 20A,A01,083754,Staff,19,0,40,21
1650983612498,MATH 20B,A01,083756,Staff,0,14,30,30
1650983612498,MATH 20B,A02,083757,Staff,0,11,30,30
1650983618523,MATH 20C,A01,083760,Staff,0,17,30,30
1650983618523,MATH 20C,A02,083761,Staff,0,15,30,30
1650983618523,MATH 20C,B01,083762,Staff,9,0,30,21
1650983618523,MATH 20C,B02,083763,Staff,28,0,30,2
1650983624545,MATH 20D,A01,083765,Staff,2,1,30,28
1650983624545,MATH 20D,A02,083766,Staff,2,0,30,28
1650983624545,MATH 20D,A03,083767,Staff,22,0,30,8
1650983630572,MATH 20E,A01,083771,Staff,2,0,30,28
1650983630572,MATH 20E,A02,083772,Staff,12,0,30,18
1650983630572,MATH 20E,B01,083773,Staff,0,0,30,30
1650983630572,MATH 20E,B02,083774,Staff,1,0,30,29
1650983636599,MATH 103A,A01,083777,Staff,0,17,30,30
1650983636599,MATH 103A,A02,083778,Staff,0,15,30,30
1650983636599,MATH 103A,B01,083779,Staff,0,15,30,30
1650983636599,MATH 103A,B02,083780,Staff,0,14,30,30
1650983642623,MATH 105,A01,085443,Staff,0,23,30,30
1650983648645,MATH 109,A01,083213,Anzaldo; Leesa B,0,7,30,30
1650983648645,MATH 109,A02,083214,Anzaldo; Leesa B,0,7,30,30
1650983648645,MATH 109,B01,083215,Anzaldo; Leesa B,0,8,30,30
1650983648645,MATH 109,B02,083216,Anzaldo; Leesa B,0,7,30,30
1650983654676,MATH 142A,A01,083219,Chow; Bennett,0,14,30,30
1650983654676,MATH 142A,A02,083220,Chow; Bennett,0,15,30,30
1650983654676,MATH 142A,B01,083221,Chow; Bennett,0,16,30,30
1650983654676,MATH 142A,B02,083222,Chow; Bennett,0,14,30,30
1650983660704,MATH 193A,A01,083224,Staff,0,6,30,30
1650983660704,MATH 193A,A02,083225,Staff,0,7,30,30
1650983660704,MATH 193A,A03,083781,Staff,0,6,30,30
1650983660704,MATH 193A,A04,083782,Staff,0,7,30,30
1650983666731,MATH 197,001,091859,McAuley; Julian John,9998,0,9999,1
1650983672790,COGS 9,A01,083615,Staff,0,18,60,60
1650983678814,COGS 11,A01,083617,Boyle; Mary E. T.,15,0,40,25
1650983684840,COGS 13,A01,083071,Staff,0,41,40,40
1650983690866,COGS 14A,A01,092681,Staff,0,38,100,100
1650983696895,COGS 14B,A01,083073,Cheng; Tzu-Han,0,13,50,50
1650983702923,COGS 17,A01,092677,Staff,6,0,75,69
1650983708959,COGS 100,A01,083619,Staff,0,31,60,60
1650983714993,COGS 101A,A01,083621,Davis; Joshua Daniel,0,29,60,60
1650983721024,COGS 101B,A01,091572,Staff,0,5,60,60
1650983727048,COGS 101C,A01,083625,Delgado; Tania,14,0,30,16
1650983733075,COGS 107A,A01,083627,Boyle; Mary E. T.,0,16,60,60
1650983739100,COGS 118A,A01,083075,Staff,0,10,60,60
1650983745124,CSE 3,A50,083646,Miranda; Gregory Joseph,15,0,38,23
1650983745124,CSE 3,A51,083647,Miranda; Gregory Joseph,36,0,37,1
1650983751147,CSE 8A,A50,083650,Miranda; Gregory Joseph,0,31,40,40
1650983757176,CSE 11,A01,083080,Cao; Yingjun,0,97,40,40
1650983763201,CSE 12,A01,083652,Staff,0,24,100,100
1650983769228,CSE 15L,A01,083654,Staff,0,3,50,50
1650983769228,CSE 15L,A02,083655,Staff,0,3,50,50
1650983775252,CSE 20,A01,083657,Staff,47,0,80,33
1650983781279,CSE 30,A01,083084,Eldon; John,1,38,80,79
1650983787305,CSE 100,A01,083659,Cao; Yingjun,0,71,50,50
1650983793327,CSE 134B,A01,083661,Powell; Thomas Allan,1,40,65,64
1650983799349,CSE 140,A01,083663,Staff,0,13,75,75
1650983805387,CSE 140L,A01,083088,Eldon; John,4,0,100,96
1650983811488,CSE 175,A01,083665,Kumar; Rakesh,0,0,25,25
1650983817523,CSE 190,A00,092507,Dubnov; Shlomo,9,0,20,11
1650983823550,ECE 45,A01,083139,Staff,0,6,60,60
1650983829573,ECE 65,A50,083695,Staff,0,7,30,30
1650983835597,ECE 109,A01,091882,Touri; Behrouz,32,0,70,38
1650983841621,ECE 180,A00,083140,Abi Samra; Nicholas Camill,18,0,30,12
1650983841621,ECE 180,B00,083141,Abi Samra; Nicholas Camill,0,0,30,30
1650983847645,MATH 10A,A01,083735,Patchell; Gregory David,2,0,30,28
1650983847645,MATH 10A,A02,083736,Patchell; Gregory David,27,0,30,3
1650983847645,MATH 10A,A03,083737,Patchell; Gregory David,23,0,30,7
1650983853669,MATH 10B,A01,083207,Staff,0,9,30,30
1650983853669,MATH 10B,A02,083208,Staff,0,5,30,30
1650983853669,MATH 10B,B01,083739,Staff,9,0,30,21
1650983853669,MATH 10B,B02,083740,Staff,28,0,30,2
1650983859696,MATH 18,A01,083743,Staff,0,0,30,30
1650983859696,MATH 18,A02,083744,Staff,24,0,30,6
1650983859696,MATH 18,A03,083745,Staff,19,0,30,11
1650983859696,MATH 18,A04,083746,Staff,26,0,30,4
1650983859696,MATH 18,B01,083748,Staff,0,15,30,30
1650983859696,MATH 18,B02,083749,Staff,0,14,30,30
1650983859696,MATH 18,B03,083750,Staff,0,13,30,30
1650983859696,MATH 18,B04,083751,Staff,0,13,30,30
1650983865722,MATH 20A,A01,083754,Staff,19,0,40,21
1650983871747,MATH 20B,A01,083756,Staff,0,14,30,30
1650983871747,MATH 20B,A02,083757,Staff,0,11,30,30
1650983877771,MATH 20C,A01,083760,Staff,0,17,30,30
1650983877771,MATH 20C,A02,083761,Staff,0,15,30,30
1650983877771,MATH 20C,B01,083762,Staff,9,0,30,21
1650983877771,MATH 20C,B02,083763,Staff,28,0,30,2
1650983883801,MATH 20D,A01,083765,Staff,2,1,30,28
1650983883801,MATH 20D,A02,083766,Staff,2,0,30,28
1650983883801,MATH 20D,A03,083767,Staff,22,0,30,8
1650983889829,MATH 20E,A01,083771,Staff,2,0,30,28
1650983889829,MATH 20E,A02,083772,Staff,12,0,30,18
1650983889829,MATH 20E,B01,083773,Staff,0,0,30,30
1650983889829,MATH 20E,B02,083774,Staff,1,0,30,29
1650983895852,MATH 103A,A01,083777,Staff,0,17,30,30
1650983895852,MATH 103A,A02,083778,Staff,0,15,30,30
1650983895852,MATH 103A,B01,083779,Staff,0,15,30,30
1650983895852,MATH 103A,B02,083780,Staff,0,14,30,30
1650983901877,MATH 105,A01,085443,Staff,0,23,30,30
1650983907900,MATH 109,A01,083213,Anzaldo; Leesa B,0,7,30,30
1650983907900,MATH 109,A02,083214,Anzaldo; Leesa B,0,7,30,30
1650983907900,MATH 109,B01,083215,Anzaldo; Leesa B,0,8,30,30
1650983907900,MATH 109,B02,083216,Anzaldo; Leesa B,0,7,30,30
1650983913923,MATH 142A,A01,083219,Chow; Bennett,0,14,30,30
1650983913923,MATH 142A,A02,083220,Chow; Bennett,0,15,30,30
1650983913923,MATH 142A,B01,083221,Chow; Bennett,0,16,30,30
1650983913923,MATH 142A,B02,083222,Chow; Bennett,0,14,30,30
1650983919950,MATH 193A,A01,083224,Staff,0,6,30,30
1650983919950,MATH 193A,A02,083225,Staff,0,7,30,30
1650983919950,MATH 193A,A03,083781,Staff,0,6,30,30
1650983919950,MATH 193A,A04,083782,Staff,0,7,30,30
1650983925974,MATH 197,001,091859,McAuley; Julian John,9998,0,9999,1
1650983932035,COGS 9,A01,083615,Staff,0,18,60,60
1650983938062,COGS 11,A01,083617,Boyle; Mary E. T.,15,0,40,25
1650983944084,COGS 13,A01,083071,Staff,0,41,40,40
1650983950112,COGS 14A,A01,092681,Staff,0,38,100,100
1650983956139,COGS 14B,A01,083073,Cheng; Tzu-Han,0,13,50,50
1650983962163,COGS 17,A01,092677,Staff,6,0,75,69
1650983968202,COGS 100,A01,083619,Staff,0,31,60,60
1650983974225,COGS 101A,A01,083621,Davis; Joshua Daniel,0,29,60,60
1650983980253,COGS 101B,A01,091572,Staff,0,5,60,60
1650983986278,COGS 101C,A01,083625,Delgado; Tania,14,0,30,16
1650983992302,COGS 107A,A01,083627,Boyle; Mary E. T.,0,16,60,60
1650983998323,COGS 118A,A01,083075,Staff,0,10,60,60
1650984004350,CSE 3,A50,083646,Miranda; Gregory Joseph,15,0,38,23
1650984004350,CSE 3,A51,083647,Miranda; Gregory Joseph,36,0,37,1
1650984010374,CSE 8A,A50,083650,Miranda; Gregory Joseph,0,31,40,40
1650984016407,CSE 11,A01,083080,Cao; Yingjun,0,97,40,40
1650984022431,CSE 12,A01,083652,Staff,0,24,100,100
1650984028454,CSE 15L,A01,083654,Staff,0,3,50,50
1650984028454,CSE 15L,A02,083655,Staff,0,3,50,50
1650984034478,CSE 20,A01,083657,Staff,47,0,80,33
1650984040502,CSE 30,A01,083084,Eldon; John,1,38,80,79
1650984046527,CSE 100,A01,083659,Cao; Yingjun,0,71,50,50
1650984052550,CSE 134B,A01,083661,Powell; Thomas Allan,1,40,65,64
1650984058582,CSE 140,A01,083663,Staff,0,13,75,75
1650984064612,CSE 140L,A01,083088,Eldon; John,4,0,100,96
1650984070634,CSE 175,A01,083665,Kumar; Rakesh,0,0,25,25
1650984076656,CSE 190,A00,092507,Dubnov; Shlomo,9,0,20,11
1650984082680,ECE 45,A01,083139,Staff,0,6,60,60
1650984088706,ECE 65,A50,083695,Staff,0,7,30,30
1650984094730,ECE 109,A01,091882,Touri; Behrouz,32,0,70,38
1650984100759,ECE 180,A00,083140,Abi Samra; Nicholas Camill,18,0,30,12
1650984100759,ECE 180,B00,083141,Abi Samra; Nicholas Camill,0,0,30,30
1650984106792,MATH 10A,A01,083735,Patchell; Gregory David,2,0,30,28
1650984106792,MATH 10A,A02,083736,Patchell; Gregory David,27,0,30,3
1650984106792,MATH 10A,A03,083737,Patchell; Gregory David,23,0,30,7
1650984112816,MATH 10B,A01,083207,Staff,0,9,30,30
1650984112816,MATH 10B,A02,083208,Staff,0,5,30,30
1650984112816,MATH 10B,B01,083739,Staff,9,0,30,21
1650984112816,MATH 10B,B02,083740,Staff,28,0,30,2
1650984118849,MATH 18,A01,083743,Staff,0,0,30,30
1650984118849,MATH 18,A02,083744,Staff,24,0,30,6
1650984118849,MATH 18,A03,083745,Staff,19,0,30,11
1650984118849,MATH 18,A04,083746,Staff,26,0,30,4
1650984118849,MATH 18,B01,083748,Staff,0,15,30,30
1650984118849,MATH 18,B02,083749,Staff,0,14,30,30
1650984118849,MATH 18,B03,083750,Staff,0,13,30,30
1650984118849,MATH 18,B04,083751,Staff,0,13,30,30
1650984124871,MATH 20A,A01,083754,Staff,19,0,40,21
1650984130898,MATH 20B,A01,083756,Staff,0,14,30,30
1650984130898,MATH 20B,A02,083757,Staff,0,11,30,30
1650984136925,MATH 20C,A01,083760,Staff,0,17,30,30
1650984136925,MATH 20C,A02,083761,Staff,0,15,30,30
1650984136925,MATH 20C,B01,083762,Staff,9,0,30,21
1650984136925,MATH 20C,B02,083763,Staff,28,0,30,2
1650984142948,MATH 20D,A01,083765,Staff,2,1,30,28
1650984142948,MATH 20D,A02,083766,Staff,2,0,30,28
1650984142948,MATH 20D,A03,083767,Staff,22,0,30,8
1650984148974,MATH 20E,A01,083771,Staff,2,0,30,28
1650984148974,MATH 20E,A02,083772,Staff,12,0,30,18
1650984148974,MATH 20E,B01,083773,Staff,0,0,30,30
1650984148974,MATH 20E,B02,083774,Staff,1,0,30,29
1650984154998,MATH 103A,A01,083777,Staff,0,17,30,30
1650984154998,MATH 103A,A02,083778,Staff,0,15,30,30
1650984154998,MATH 103A,B01,083779,Staff,0,15,30,30
1650984154998,MATH 103A,B02,083780,Staff,0,14,30,30
1650984161032,MATH 105,A01,085443,Staff,0,23,30,30
1650984167064,MATH 109,A01,083213,Anzaldo; Leesa B,0,7,30,30
1650984167064,MATH 109,A02,083214,Anzaldo; Leesa B,0,7,30,30
1650984167064,MATH 109,B01,083215,Anzaldo; Leesa B,0,8,30,30
1650984167064,MATH 109,B02,083216,Anzaldo; Leesa B,0,7,30,30
1650984173091,MATH 142A,A01,083219,Chow; Bennett,0,14,30,30
1650984173091,MATH 142A,A02,083220,Chow; Bennett,0,15,30,30
1650984173091,MATH 142A,B01,083221,Chow; Bennett,0,16,30,30
1650984173091,MATH 142A,B02,083222,Chow; Bennett,0,14,30,30
1650984179117,MATH 193A,A01,083224,Staff,0,6,30,30
1650984179117,MATH 193A,A02,083225,Staff,0,7,30,30
1650984179117,MATH 193A,A03,083781,Staff,0,6,30,30
1650984179117,MATH 193A,A04,083782,Staff,0,7,30,30
1650984185142,MATH 197,001,091859,McAuley; Julian John,9998,0,9999,1
1650984191193,COGS 9,A01,083615,Staff,0,18,60,60
1650984197216,COGS 11,A01,083617,Boyle; Mary E. T.,15,0,40,25
1650984203243,COGS 13,A01,083071,Staff,0,41,40,40
1650984209267,COGS 14A,A01,092681,Staff,0,38,100,100
1650984215297,COGS 14B,A01,083073,Cheng; Tzu-Han,0,13,50,50
1650984221321,COGS 17,A01,092677,Staff,6,0,75,69
1650984227344,COGS 100,A01,083619,Staff,0,31,60,60
1650984233367,COGS 101A,A01,083621,Davis; Joshua Daniel,0,29,60,60
1650984239393,COGS 101B,A01,091572,Staff,0,5,60,60
1650984245415,COGS 101C,A01,083625,Delgado; Tania,14,0,30,16
1650984251438,COGS 107A,A01,083627,Boyle; Mary E. T.,0,16,60,60
1650984257459,COGS 118A,A01,083075,Staff,0,10,60,60
1650984263485,CSE 3,A50,083646,Miranda; Gregory Joseph,15,0,38,23
1650984263485,CSE 3,A51,083647,Miranda; Gregory Joseph,36,0,37,1
1650984269509,CSE 8A,A50,083650,Miranda; Gregory Joseph,0,31,40,40
1650984275533,CSE 11,A01,083080,Cao; Yingjun,0,97,40,40
1650984281562,CSE 12,A01,083652,Staff,0,24,100,100
1650984287585,CSE 15L,A01,083654,Staff,0,3,50,50
1650984287585,CSE 15L,A02,083655,Staff,0,3,50,50
1650984293616,CSE 20,A01,083657,Staff,47,0,80,33
1650984299638,CSE 30,A01,083084,Eldon; John,1,38,80,79
1650984305661,CSE 100,A01,083659,Cao; Yingjun,0,71,50,50
1650984311684,CSE 134B,A01,083661,Powell; Thomas Allan,1,40,65,64
1650984317708,CSE 140,A01,083663,Staff,0,13,75,75
1650984323732,CSE 140L,A01,083088,Eldon; John,4,0,100,96
1650984329768,CSE 175,A01,083665,Kumar; Rakesh,0,0,25,25
1650984335794,CSE 190,A00,092507,Dubnov; Shlomo,9,0,20,11
1650984341818,ECE 45,A01,083139,Staff,0,6,60,60
1650984347845,ECE 65,A50,083695,Staff,0,7,30,30
1650984353877,ECE 109,A01,091882,Touri; Behrouz,32,0,70,38
1650984359909,ECE 180,A00,083140,Abi Samra; Nicholas Camill,18,0,30,12
1650984359909,ECE 180,B00,083141,Abi Samra; Nicholas Camill,0,0,30,30
1650984365932,MATH 10A,A01,083735,Patchell; Gregory David,2,0,30,28
1650984365932,MATH 10A,A02,083736,Patchell; Gregory David,27,0,30,3
1650984365932,MATH 10A,A03,083737,Patchell; Gregory David,23,0,30,7
1650984371961,MATH 10B,A01,083207,Staff,0,9,30,30
1650984371961,MATH 10B,A02,083208,Staff,0,5,30,30
1650984371961,MATH 10B,B01,083739,Staff,9,0,30,21
1650984371961,MATH 10B,B02,083740,Staff,28,0,30,2
1650984377991,MATH 18,A01,083743,Staff,0,0,30,30
1650984377991,MATH 18,A02,083744,Staff,24,0,30,6
1650984377991,MATH 18,A03,083745,Staff,19,0,30,11
1650984377991,MATH 18,A04,083746,Staff,26,0,30,4
1650984377991,MATH 18,B01,083748,Staff,0,15,30,30
1650984377991,MATH 18,B02,083749,Staff,0,14,30,30
1650984377991,MATH 18,B03,083750,Staff,0,13,30,30
1650984377991,MATH 18,B04,083751,Staff,0,13,30,30
1650984384015,MATH 20A,A01,083754,Staff,19,0,40,21
1650984390042,MATH 20B,A01,083756,Staff,0,14,30,30
1650984390042,MATH 20B,A02,083757,Staff,0,11,30,30
1650984396071,MATH 20C,A01,083760,Staff,0,17,30,30
1650984396071,MATH 20C,A02,083761,Staff,0,15,30,30
1650984396071,MATH 20C,B01,083762,Staff,9,0,30,21
1650984396071,MATH 20C,B02,083763,Staff,28,0,30,2
1650984402099,MATH 20D,A01,083765,Staff,2,1,30,28
1650984402099,MATH 20D,A02,083766,Staff,2,0,30,28
1650984402099,MATH 20D,A03,083767,Staff,22,0,30,8
1650984408200,MATH 20E,A01,083771,Staff,2,0,30,28
1650984408200,MATH 20E,A02,083772,Staff,12,0,30,18
1650984408200,MATH 20E,B01,083773,Staff,0,0,30,30
1650984408200,MATH 20E,B02,083774,Staff,1,0,30,29
1650984414227,MATH 103A,A01,083777,Staff,0,17,30,30
1650984414227,MATH 103A,A02,083778,Staff,0,15,30,30
1650984414227,MATH 103A,B01,083779,Staff,0,15,30,30
1650984414227,MATH 103A,B02,083780,Staff,0,14,30,30
1650984420256,MATH 105,A01,085443,Staff,0,23,30,30
1650984426280,MATH 109,A01,083213,Anzaldo; Leesa B,0,7,30,30
1650984426280,MATH 109,A02,083214,Anzaldo; Leesa B,0,7,30,30
1650984426280,MATH 109,B01,083215,Anzaldo; Leesa B,0,8,30,30
1650984426280,MATH 109,B02,083216,Anzaldo; Leesa B,0,7,30,30
1650984432313,MATH 142A,A01,083219,Chow; Bennett,0,14,30,30
1650984432313,MATH 142A,A02,083220,Chow; Bennett,0,15,30,30
1650984432313,MATH 142A,B01,083221,Chow; Bennett,0,16,30,30
1650984432313,MATH 142A,B02,083222,Chow; Bennett,0,14,30,30
1650984438341,MATH 193A,A01,083224,Staff,0,6,30,30
1650984438341,MATH 193A,A02,083225,Staff,0,7,30,30
1650984438341,MATH 193A,A03,083781,Staff,0,6,30,30
1650984438341,MATH 193A,A04,083782,Staff,0,7,30,30
1650984444367,MATH 197,001,091859,McAuley; Julian John,9998,0,9999,1
1650984450425,COGS 9,A01,083615,Staff,0,18,60,60
1650984456453,COGS 11,A01,083617,Boyle; Mary E. T.,15,0,40,25
1650984462479,COGS 13,A01,083071,Staff,0,41,40,40
1650984468501,COGS 14A,A01,092681,Staff,0,38,100,100
1650984474537,COGS 14B,A01,083073,Cheng; Tzu-Han,0,13,50,50
1650984480561,COGS 17,A01,092677,Staff,6,0,75,69
1650984486583,COGS 100,A01,083619,Staff,0,31,60,60
1650984492612,COGS 101A,A01,083621,Davis; Joshua Daniel,0,29,60,60
1650984498639,COGS 101B,A01,091572,Staff,0,5,60,60
1650984504671,COGS 101C,A01,083625,Delgado; Tania,14,0,30,16
1650984510700,COGS 107A,A01,083627,Boyle; Mary E. T.,0,16,60,60
1650984516724,COGS 118A,A01,083075,Staff,0,10,60,60
1650984522751,CSE 3,A50,083646,Miranda; Gregory Joseph,15,0,38,23
1650984522751,CSE 3,A51,083647,Miranda; Gregory Joseph,36,0,37,1
1650984528780,CSE 8A,A50,083650,Miranda; Gregory Joseph,0,31,40,40
1650984534806,CSE 11,A01,083080,Cao; Yingjun,0,97,40,40
1650984540829,CSE 12,A01,083652,Staff,0,24,100,100
1650984546853,CSE 15L,A01,083654,Staff,0,3,50,50
1650984546853,CSE 15L,A02,083655,Staff,0,3,50,50
1650984552876,CSE 20,A01,083657,Staff,47,0,80,33
1650984558917,CSE 30,A01,083084,Eldon; John,1,38,80,79
1650984564942,CSE 100,A01,083659,Cao; Yingjun,0,71,50,50
1650984570969,CSE 134B,A01,083661,Powell; Thomas Allan,1,40,65,64
1650984576994,CSE 140,A01,083663,Staff,0,13,75,75
1650984583021,CSE 140L,A01,083088,Eldon; John,4,0,100,96
1650984589044,CSE 175,A01,083665,Kumar; Rakesh,0,0,25,25
1650984595071,CSE 190,A00,092507,Dubnov; Shlomo,9,0,20,11
1650984601097,ECE 45,A01,083139,Staff,0,6,60,60
1650984607121,ECE 65,A50,083695,Staff,0,7,30,30
1650984613144,ECE 109,A01,091882,Touri; Behrouz,32,0,70,38
1650984619171,ECE 180,A00,083140,Abi Samra; Nicholas Camill,18,0,30,12
1650984619171,ECE 180,B00,083141,Abi Samra; Nicholas Camill,0,0,30,30
1650984625195,MATH 10A,A01,083735,Patchell; Gregory David,2,0,30,28
1650984625195,MATH 10A,A02,083736,Patchell; Gregory David,27,0,30,3
1650984625195,MATH 10A,A03,083737,Patchell; Gregory David,23,0,30,7
1650984631219,MATH 10B,A01,083207,Staff,0,9,30,30
1650984631219,MATH 10B,A02,083208,Staff,0,5,30,30
1650984631219,MATH 10B,B01,083739,Staff,9,0,30,21
1650984631219,MATH 10B,B02,083740,Staff,28,0,30,2
1650984637243,MATH 18,A01,083743,Staff,0,0,30,30
1650984637243,MATH 18,A02,083744,Staff,24,0,30,6
1650984637243,MATH 18,A03,083745,Staff,19,0,30,11
1650984637243,MATH 18,A04,083746,Staff,26,0,30,4
1650984637243,MATH 18,B01,083748,Staff,0,15,30,30
1650984637243,MATH 18,B02,083749,Staff,0,14,30,30
1650984637243,MATH 18,B03,083750,Staff,0,13,30,30
1650984637243,MATH 18,B04,083751,Staff,0,13,30,30
1650984643270,MATH 20A,A01,083754,Staff,19,0,40,21
1650984649305,MATH 20B,A01,083756,Staff,0,14,30,30
1650984649305,MATH 20B,A02,083757,Staff,0,11,30,30
1650984655348,MATH 20C,A01,083760,Staff,0,17,30,30
1650984655348,MATH 20C,A02,083761,Staff,0,15,30,30
1650984655348,MATH 20C,B01,083762,Staff,9,0,30,21
1650984655348,MATH 20C,B02,083763,Staff,28,0,30,2
1650984661379,MATH 20D,A01,083765,Staff,2,1,30,28
1650984661379,MATH 20D,A02,083766,Staff,2,0,30,28
1650984661379,MATH 20D,A03,083767,Staff,22,0,30,8
1650984667406,MATH 20E,A01,083771,Staff,2,0,30,28
1650984667406,MATH 20E,A02,083772,Staff,12,0,30,18
1650984667406,MATH 20E,B01,083773,Staff,0,0,30,30
1650984667406,MATH 20E,B02,083774,Staff,1,0,30,29
1650984673433,MATH 103A,A01,083777,Staff,0,17,30,30
1650984673433,MATH 103A,A02,083778,Staff,0,15,30,30
1650984673433,MATH 103A,B01,083779,Staff,0,15,30,30
1650984673433,MATH 103A,B02,083780,Staff,0,14,30,30
1650984679463,MATH 105,A01,085443,Staff,0,23,30,30
1650984685513,MATH 109,A01,083213,Anzaldo; Leesa B,0,7,30,30
1650984685513,MATH 109,A02,083214,Anzaldo; Leesa B,0,7,30,30
1650984685513,MATH 109,B01,083215,Anzaldo; Leesa B,0,8,30,30
1650984685513,MATH 109,B02,083216,Anzaldo; Leesa B,0,7,30,30
1650984691538,MATH 142A,A01,083219,Chow; Bennett,0,14,30,30
1650984691538,MATH 142A,A02,083220,Chow; Bennett,0,15,30,30
1650984691538,MATH 142A,B01,083221,Chow; Bennett,0,16,30,30
1650984691538,MATH 142A,B02,083222,Chow; Bennett,0,14,30,30
1650984697561,MATH 193A,A01,083224,Staff,0,6,30,30
1650984697561,MATH 193A,A02,083225,Staff,0,7,30,30
1650984697561,MATH 193A,A03,083781,Staff,0,6,30,30
1650984697561,MATH 193A,A04,083782,Staff,0,7,30,30
1650984703589,MATH 197,001,091859,McAuley; Julian John,9998,0,9999,1
1650984709642,COGS 9,A01,083615,Staff,0,18,60,60
1650984715667,COGS 11,A01,083617,Boyle; Mary E. T.,15,0,40,25
1650984721700,COGS 13,A01,083071,Staff,0,41,40,40
1650984727725,COGS 14A,A01,092681,Staff,0,38,100,100
1650984733752,COGS 14B,A01,083073,Cheng; Tzu-Han,0,13,50,50
1650984739778,COGS 17,A01,092677,Staff,6,0,75,69
1650984745801,COGS 100,A01,083619,Staff,0,31,60,60
1650984751829,COGS 101A,A01,083621,Davis; Joshua Daniel,0,29,60,60
1650984757851,COGS 101B,A01,091572,Staff,0,5,60,60
1650984763874,COGS 101C,A01,083625,Delgado; Tania,14,0,30,16
1650984769897,COGS 107A,A01,083627,Boyle; Mary E. T.,0,16,60,60
1650984775920,COGS 118A,A01,083075,Staff,0,10,60,60
1650984781947,CSE 3,A50,083646,Miranda; Gregory Joseph,15,0,38,23
1650984781947,CSE 3,A51,083647,Miranda; Gregory Joseph,36,0,37,1
1650984787979,CSE 8A,A50,083650,Miranda; Gregory Joseph,0,31,40,40
1650984794003,CSE 11,A01,083080,Cao; Yingjun,0,97,40,40
1650984800030,CSE 12,A01,083652,Staff,0,24,100,100
1650984806060,CSE 15L,A01,083654,Staff,0,3,50,50
1650984806060,CSE 15L,A02,083655,Staff,0,3,50,50
1650984812097,CSE 20,A01,083657,Staff,47,0,80,33
1650984818125,CSE 30,A01,083084,Eldon; John,1,38,80,79
1650984824148,CSE 100,A01,083659,Cao; Yingjun,0,71,50,50
1650984830170,CSE 134B,A01,083661,Powell; Thomas Allan,1,40,65,64
1650984836193,CSE 140,A01,083663,Staff,0,13,75,75
1650984842225,CSE 140L,A01,083088,Eldon; John,4,0,100,96
1650984848250,CSE 175,A01,083665,Kumar; Rakesh,0,0,25,25
1650984854275,CSE 190,A00,092507,Dubnov; Shlomo,9,0,20,11
1650984860302,ECE 45,A01,083139,Staff,0,6,60,60
1650984866326,ECE 65,A50,083695,Staff,0,7,30,30
1650984872350,ECE 109,A01,091882,Touri; Behrouz,32,0,70,38
1650984878377,ECE 180,A00,083140,Abi Samra; Nicholas Camill,18,0,30,12
1650984878377,ECE 180,B00,083141,Abi Samra; Nicholas Camill,0,0,30,30
1650984884409,MATH 10A,A01,083735,Patchell; Gregory David,2,0,30,28
1650984884409,MATH 10A,A02,083736,Patchell; Gregory David,27,0,30,3
1650984884409,MATH 10A,A03,083737,Patchell; Gregory David,23,0,30,7
1650984890445,MATH 10B,A01,083207,Staff,0,9,30,30
1650984890445,MATH 10B,A02,083208,Staff,0,5,30,30
1650984890445,MATH 10B,B01,083739,Staff,9,0,30,21
1650984890445,MATH 10B,B02,083740,Staff,28,0,30,2
1650984896477,MATH 18,A01,083743,Staff,0,0,30,30
1650984896477,MATH 18,A02,083744,Staff,24,0,30,6
1650984896477,MATH 18,A03,083745,Staff,19,0,30,11
1650984896477,MATH 18,A04,083746,Staff,26,0,30,4
1650984896477,MATH 18,B01,083748,Staff,0,15,30,30
1650984896477,MATH 18,B02,083749,Staff,0,14,30,30
1650984896477,MATH 18,B03,083750,Staff,0,13,30,30
1650984896477,MATH 18,B04,083751,Staff,0,13,30,30
1650984902499,MATH 20A,A01,083754,Staff,19,0,40,21
1650984908526,MATH 20B,A01,083756,Staff,0,14,30,30
1650984908526,MATH 20B,A02,083757,Staff,0,11,30,30
1650984914554,MATH 20C,A01,083760,Staff,0,17,30,30
1650984914554,MATH 20C,A02,083761,Staff,0,15,30,30
1650984914554,MATH 20C,B01,083762,Staff,9,0,30,21
1650984914554,MATH 20C,B02,083763,Staff,28,0,30,2
1650984920577,MATH 20D,A01,083765,Staff,2,1,30,28
1650984920577,MATH 20D,A02,083766,Staff,2,0,30,28
1650984920577,MATH 20D,A03,083767,Staff,22,0,30,8
1650984926599,MATH 20E,A01,083771,Staff,2,0,30,28
1650984926599,MATH 20E,A02,083772,Staff,12,0,30,18
1650984926599,MATH 20E,B01,083773,Staff,0,0,30,30
1650984926599,MATH 20E,B02,083774,Staff,1,0,30,29
1650984932629,MATH 103A,A01,083777,Staff,0,17,30,30
1650984932629,MATH 103A,A02,083778,Staff,0,15,30,30
1650984932629,MATH 103A,B01,083779,Staff,0,15,30,30
1650984932629,MATH 103A,B02,083780,Staff,0,14,30,30
1650984938658,MATH 105,A01,085443,Staff,0,23,30,30
1650984944686,MATH 109,A01,083213,Anzaldo; Leesa B,0,7,30,30
1650984944686,MATH 109,A02,083214,Anzaldo; Leesa B,0,7,30,30
1650984944686,MATH 109,B01,083215,Anzaldo; Leesa B,0,8,30,30
1650984944686,MATH 109,B02,083216,Anzaldo; Leesa B,0,7,30,30
1650984950712,MATH 142A,A01,083219,Chow; Bennett,0,14,30,30
1650984950712,MATH 142A,A02,083220,Chow; Bennett,0,15,30,30
1650984950712,MATH 142A,B01,083221,Chow; Bennett,0,16,30,30
1650984950712,MATH 142A,B02,083222,Chow; Bennett,0,14,30,30
1650984956735,MATH 193A,A01,083224,Staff,0,6,30,30
1650984956735,MATH 193A,A02,083225,Staff,0,7,30,30
1650984956735,MATH 193A,A03,083781,Staff,0,6,30,30
1650984956735,MATH 193A,A04,083782,Staff,0,7,30,30
1650984962757,MATH 197,001,091859,McAuley; Julian John,9998,0,9999,1
1650984968817,COGS 9,A01,083615,Staff,0,18,60,60
1650984974843,COGS 11,A01,083617,Boyle; Mary E. T.,15,0,40,25
1650984980867,COGS 13,A01,083071,Staff,0,41,40,40
1650984986891,COGS 14A,A01,092681,Staff,0,38,100,100
1650984992914,COGS 14B,A01,083073,Cheng; Tzu-Han,0,13,50,50
1650984999012,COGS 17,A01,092677,Staff,6,0,75,69
1650985005035,COGS 100,A01,083619,Staff,0,31,60,60
1650985011059,COGS 101A,A01,083621,Davis; Joshua Daniel,0,29,60,60
1650985017081,COGS 101B,A01,091572,Staff,0,5,60,60
1650985023104,COGS 101C,A01,083625,Delgado; Tania,14,0,30,16
1650985029133,COGS 107A,A01,083627,Boyle; Mary E. T.,0,16,60,60
1650985035156,COGS 118A,A01,083075,Staff,0,10,60,60
1650985041181,CSE 3,A50,083646,Miranda; Gregory Joseph,15,0,38,23
1650985041181,CSE 3,A51,083647,Miranda; Gregory Joseph,36,0,37,1
1650985047209,CSE 8A,A50,083650,Miranda; Gregory Joseph,0,31,40,40
1650985053233,CSE 11,A01,083080,Cao; Yingjun,0,97,40,40
1650985059258,CSE 12,A01,083652,Staff,0,24,100,100
1650985065285,CSE 15L,A01,083654,Staff,0,3,50,50
1650985065285,CSE 15L,A02,083655,Staff,0,3,50,50
1650985071307,CSE 20,A01,083657,Staff,47,0,80,33
1650985077351,CSE 30,A01,083084,Eldon; John,1,38,80,79
1650985083374,CSE 100,A01,083659,Cao; Yingjun,0,71,50,50
1650985089398,CSE 134B,A01,083661,Powell; Thomas Allan,1,40,65,64
1650985095422,CSE 140,A01,083663,Staff,0,13,75,75
1650985101475,CSE 140L,A01,083088,Eldon; John,4,0,100,96
1650985107503,CSE 175,A01,083665,Kumar; Rakesh,0,0,25,25
1650985113526,CSE 190,A00,092507,Dubnov; Shlomo,9,0,20,11
1650985119553,ECE 45,A01,083139,Staff,0,6,60,60
1650985125585,ECE 65,A50,083695,Staff,0,7,30,30
1650985131611,ECE 109,A01,091882,Touri; Behrouz,32,0,70,38
1650985137640,ECE 180,A00,083140,Abi Samra; Nicholas Camill,18,0,30,12
1650985137640,ECE 180,B00,083141,Abi Samra; Nicholas Camill,0,0,30,30
1650985143690,MATH 10A,A01,083735,Patchell; Gregory David,2,0,30,28
1650985143690,MATH 10A,A02,083736,Patchell; Gregory David,27,0,30,3
1650985143690,MATH 10A,A03,083737,Patchell; Gregory David,23,0,30,7
1650985149720,MATH 10B,A01,083207,Staff,0,9,30,30
1650985149720,MATH 10B,A02,083208,Staff,0,5,30,30
1650985149720,MATH 10B,B01,083739,Staff,9,0,30,21
1650985149720,MATH 10B,B02,083740,Staff,28,0,30,2
1650985155749,MATH 18,A01,083743,Staff,0,0,30,30
1650985155749,MATH 18,A02,083744,Staff,24,0,30,6
1650985155749,MATH 18,A03,083745,Staff,19,0,30,11
1650985155749,MATH 18,A04,083746,Staff,26,0,30,4
1650985155749,MATH 18,B01,083748,Staff,0,15,30,30
1650985155749,MATH 18,B02,083749,Staff,0,14,30,30
1650985155749,MATH 18,B03,083750,Staff,0,13,30,30
1650985155749,MATH 18,B04,083751,Staff,0,13,30,30
1650985161782,MATH 20A,A01,083754,Staff,19,0,40,21
1650985167806,MATH 20B,A01,083756,Staff,0,14,30,30
1650985167806,MATH 20B,A02,083757,Staff,0,11,30,30
1650985173830,MATH 20C,A01,083760,Staff,0,17,30,30
1650985173830,MATH 20C,A02,083761,Staff,0,15,30,30
1650985173830,MATH 20C,B01,083762,Staff,9,0,30,21
1650985173830,MATH 20C,B02,083763,Staff,28,0,30,2
1650985179860,MATH 20D,A01,083765,Staff,2,1,30,28
1650985179860,MATH 20D,A02,083766,Staff,2,0,30,28
1650985179860,MATH 20D,A03,083767,Staff,22,0,30,8
1650985185885,MATH 20E,A01,083771,Staff,2,0,30,28
1650985185885,MATH 20E,A02,083772,Staff,12,0,30,18
1650985185885,MATH 20E,B01,083773,Staff,0,0,30,30
1650985185885,MATH 20E,B02,083774,Staff,1,0,30,29
1650985191914,MATH 103A,A01,083777,Staff,0,17,30,30
1650985191914,MATH 103A,A02,083778,Staff,0,15,30,30
1650985191914,MATH 103A,B01,083779,Staff,0,15,30,30
1650985191914,MATH 103A,B02,083780,Staff,0,14,30,30
1650985197937,MATH 105,A01,085443,Staff,0,23,30,30
1650985203960,MATH 109,A01,083213,Anzaldo; Leesa B,0,7,30,30
1650985203960,MATH 109,A02,083214,Anzaldo; Leesa B,0,7,30,30
1650985203960,MATH 109,B01,083215,Anzaldo; Leesa B,0,8,30,30
1650985203960,MATH 109,B02,083216,Anzaldo; Leesa B,0,7,30,30
1650985209987,MATH 142A,A01,083219,Chow; Bennett,0,14,30,30
1650985209987,MATH 142A,A02,083220,Chow; Bennett,0,15,30,30
1650985209987,MATH 142A,B01,083221,Chow; Bennett,0,16,30,30
1650985209987,MATH 142A,B02,083222,Chow; Bennett,0,14,30,30
1650985216011,MATH 193A,A01,083224,Staff,0,6,30,30
1650985216011,MATH 193A,A02,083225,Staff,0,7,30,30
1650985216011,MATH 193A,A03,083781,Staff,0,6,30,30
1650985216011,MATH 193A,A04,083782,Staff,0,7,30,30
1650985222038,MATH 197,001,091859,McAuley; Julian John,9998,0,9999,1
1650985228098,COGS 9,A01,083615,Staff,0,18,60,60
1650985234129,COGS 11,A01,083617,Boyle; Mary E. T.,15,0,40,25
1650985240154,COGS 13,A01,083071,Staff,0,41,40,40
1650985246178,COGS 14A,A01,092681,Staff,0,38,100,100
1650985252205,COGS 14B,A01,083073,Cheng; Tzu-Han,0,13,50,50
1650985258228,COGS 17,A01,092677,Staff,6,0,75,69
1650985264254,COGS 100,A01,083619,Staff,0,31,60,60
1650985270278,COGS 101A,A01,083621,Davis; Joshua Daniel,0,29,60,60
1650985276300,COGS 101B,A01,091572,Staff,0,5,60,60
1650985282324,COGS 101C,A01,083625,Delgado; Tania,14,0,30,16
1650985288347,COGS 107A,A01,083627,Boyle; Mary E. T.,0,16,60,60
1650985294372,COGS 118A,A01,083075,Staff,0,10,60,60
1650985300408,CSE 3,A50,083646,Miranda; Gregory Joseph,15,0,38,23
1650985300408,CSE 3,A51,083647,Miranda; Gregory Joseph,36,0,37,1
1650985306437,CSE 8A,A50,083650,Miranda; Gregory Joseph,0,31,40,40
1650985312461,CSE 11,A01,083080,Cao; Yingjun,0,97,40,40
1650985318492,CSE 12,A01,083652,Staff,0,24,100,100
1650985324514,CSE 15L,A01,083654,Staff,0,3,50,50
1650985324514,CSE 15L,A02,083655,Staff,0,3,50,50
1650985330542,CSE 20,A01,083657,Staff,47,0,80,33
1650985336566,CSE 30,A01,083084,Eldon; John,1,38,80,79
1650985342601,CSE 100,A01,083659,Cao; Yingjun,0,71,50,50
1650985348624,CSE 134B,A01,083661,Powell; Thomas Allan,1,40,65,64
1650985354653,CSE 140,A01,083663,Staff,0,13,75,75
1650985360675,CSE 140L,A01,083088,Eldon; John,4,0,100,96
1650985366699,CSE 175,A01,083665,Kumar; Rakesh,0,0,25,25
1650985372729,CSE 190,A00,092507,Dubnov; Shlomo,9,0,20,11
1650985378756,ECE 45,A01,083139,Staff,0,6,60,60
1650985384779,ECE 65,A50,083695,Staff,0,7,30,30
1650985390810,ECE 109,A01,091882,Touri; Behrouz,32,0,70,38
1650985396834,ECE 180,A00,083140,Abi Samra; Nicholas Camill,18,0,30,12
1650985396834,ECE 180,B00,083141,Abi Samra; Nicholas Camill,0,0,30,30
1650985402861,MATH 10A,A01,083735,Patchell; Gregory David,2,0,30,28
1650985402861,MATH 10A,A02,083736,Patchell; Gregory David,27,0,30,3
1650985402861,MATH 10A,A03,083737,Patchell; Gregory David,23,0,30,7
1650985408886,MATH 10B,A01,083207,Staff,0,9,30,30
1650985408886,MATH 10B,A02,083208,Staff,0,5,30,30
1650985408886,MATH 10B,B01,083739,Staff,9,0,30,21
1650985408886,MATH 10B,B02,083740,Staff,28,0,30,2
1650985414912,MATH 18,A01,083743,Staff,0,0,30,30
1650985414912,MATH 18,A02,083744,Staff,24,0,30,6
1650985414912,MATH 18,A03,083745,Staff,19,0,30,11
1650985414912,MATH 18,A04,083746,Staff,26,0,30,4
1650985414912,MATH 18,B01,083748,Staff,0,15,30,30
1650985414912,MATH 18,B02,083749,Staff,0,14,30,30
1650985414912,MATH 18,B03,083750,Staff,0,13,30,30
1650985414912,MATH 18,B04,083751,Staff,0,13,30,30
1650985420939,MATH 20A,A01,083754,Staff,19,0,40,21
1650985426966,MATH 20B,A01,083756,Staff,0,14,30,30
1650985426966,MATH 20B,A02,083757,Staff,0,11,30,30
1650985432993,MATH 20C,A01,083760,Staff,0,17,30,30
1650985432993,MATH 20C,A02,083761,Staff,0,15,30,30
1650985432993,MATH 20C,B01,083762,Staff,9,0,30,21
1650985432993,MATH 20C,B02,083763,Staff,28,0,30,2
1650985439017,MATH 20D,A01,083765,Staff,2,1,30,28
1650985439017,MATH 20D,A02,083766,Staff,2,0,30,28
1650985439017,MATH 20D,A03,083767,Staff,22,0,30,8
1650985445045,MATH 20E,A01,083771,Staff,2,0,30,28
1650985445045,MATH 20E,A02,083772,Staff,12,0,30,18
1650985445045,MATH 20E,B01,083773,Staff,0,0,30,30
1650985445045,MATH 20E,B02,083774,Staff,1,0,30,29
1650985451074,MATH 103A,A01,083777,Staff,0,17,30,30
1650985451074,MATH 103A,A02,083778,Staff,0,15,30,30
1650985451074,MATH 103A,B01,083779,Staff,0,15,30,30
1650985451074,MATH 103A,B02,083780,Staff,0,14,30,30
1650985457098,MATH 105,A01,085443,Staff,0,23,30,30
1650985463132,MATH 109,A01,083213,Anzaldo; Leesa B,0,7,30,30
1650985463132,MATH 109,A02,083214,Anzaldo; Leesa B,0,7,30,30
1650985463132,MATH 109,B01,083215,Anzaldo; Leesa B,0,8,30,30
1650985463132,MATH 109,B02,083216,Anzaldo; Leesa B,0,7,30,30
1650985469157,MATH 142A,A01,083219,Chow; Bennett,0,14,30,30
1650985469157,MATH 142A,A02,083220,Chow; Bennett,0,15,30,30
1650985469157,MATH 142A,B01,083221,Chow; Bennett,0,16,30,30
1650985469157,MATH 142A,B02,083222,Chow; Bennett,0,14,30,30
1650985475187,MATH 193A,A01,083224,Staff,0,6,30,30
1650985475187,MATH 193A,A02,083225,Staff,0,7,30,30
1650985475187,MATH 193A,A03,083781,Staff,0,6,30,30
1650985475187,MATH 193A,A04,083782,Staff,0,7,30,30
1650985481216,MATH 197,001,091859,McAuley; Julian John,9998,0,9999,1
1650985487271,COGS 9,A01,083615,Staff,0,18,60,60
1650985493297,COGS 11,A01,083617,Boyle; Mary E. T.,15,0,40,25
1650985499326,COGS 13,A01,083071,Staff,0,41,40,40
1650985505351,COGS 14A,A01,092681,Staff,0,38,100,100
1650985511384,COGS 14B,A01,083073,Cheng; Tzu-Han,0,13,50,50
1650985517409,COGS 17,A01,092677,Staff,6,0,75,69
1650985523436,COGS 100,A01,083619,Staff,0,31,60,60
1650985529469,COGS 101A,A01,083621,Davis; Joshua Daniel,0,29,60,60
1650985535494,COGS 101B,A01,091572,Staff,0,5,60,60
1650985541519,COGS 101C,A01,083625,Delgado; Tania,14,0,30,16
1650985547544,COGS 107A,A01,083627,Boyle; Mary E. T.,0,16,60,60
1650985553570,COGS 118A,A01,083075,Staff,0,10,60,60
1650985559592,CSE 3,A50,083646,Miranda; Gregory Joseph,15,0,38,23
1650985559592,CSE 3,A51,083647,Miranda; Gregory Joseph,36,0,37,1
1650985565619,CSE 8A,A50,083650,Miranda; Gregory Joseph,0,31,40,40
1650985571642,CSE 11,A01,083080,Cao; Yingjun,0,97,40,40
1650985577670,CSE 12,A01,083652,Staff,0,24,100,100
1650985583701,CSE 15L,A01,083654,Staff,0,3,50,50
1650985583701,CSE 15L,A02,083655,Staff,0,3,50,50
1650985589728,CSE 20,A01,083657,Staff,47,0,80,33
1650985595873,CSE 30,A01,083084,Eldon; John,1,38,80,79
1650985601898,CSE 100,A01,083659,Cao; Yingjun,0,71,50,50
1650985607925,CSE 134B,A01,083661,Powell; Thomas Allan,1,40,65,64
1650985613952,CSE 140,A01,083663,Staff,0,13,75,75
1650985619976,CSE 140L,A01,083088,Eldon; John,4,0,100,96
1650985626001,CSE 175,A01,083665,Kumar; Rakesh,0,0,25,25
1650985632025,CSE 190,A00,092507,Dubnov; Shlomo,9,0,20,11
1650985638070,ECE 45,A01,083139,Staff,0,6,60,60
1650985644093,ECE 65,A50,083695,Staff,0,7,30,30
1650985650118,ECE 109,A01,091882,Touri; Behrouz,32,0,70,38
1650985656145,ECE 180,A00,083140,Abi Samra; Nicholas Camill,18,0,30,12
1650985656145,ECE 180,B00,083141,Abi Samra; Nicholas Camill,0,0,30,30
1650985662172,MATH 10A,A01,083735,Patchell; Gregory David,2,0,30,28
1650985662172,MATH 10A,A02,083736,Patchell; Gregory David,27,0,30,3
1650985662172,MATH 10A,A03,083737,Patchell; Gregory David,23,0,30,7
1650985668203,MATH 10B,A01,083207,Staff,0,9,30,30
1650985668203,MATH 10B,A02,083208,Staff,0,5,30,30
1650985668203,MATH 10B,B01,083739,Staff,9,0,30,21
1650985668203,MATH 10B,B02,083740,Staff,28,0,30,2
1650985674228,MATH 18,A01,083743,Staff,0,0,30,30
1650985674228,MATH 18,A02,083744,Staff,24,0,30,6
1650985674228,MATH 18,A03,083745,Staff,19,0,30,11
1650985674228,MATH 18,A04,083746,Staff,26,0,30,4
1650985674228,MATH 18,B01,083748,Staff,0,15,30,30
1650985674228,MATH 18,B02,083749,Staff,0,14,30,30
1650985674228,MATH 18,B03,083750,Staff,0,13,30,30
1650985674228,MATH 18,B04,083751,Staff,0,13,30,30
1650985680250,MATH 20A,A01,083754,Staff,19,0,40,21
1650985686272,MATH 20B,A01,083756,Staff,0,14,30,30
1650985686272,MATH 20B,A02,083757,Staff,0,11,30,30
1650985692298,MATH 20C,A01,083760,Staff,0,17,30,30
1650985692298,MATH 20C,A02,083761,Staff,0,15,30,30
1650985692298,MATH 20C,B01,083762,Staff,9,0,30,21
1650985692298,MATH 20C,B02,083763,Staff,28,0,30,2
1650985698322,MATH 20D,A01,083765,Staff,2,1,30,28
1650985698322,MATH 20D,A02,083766,Staff,2,0,30,28
1650985698322,MATH 20D,A03,083767,Staff,22,0,30,8
1650985704346,MATH 20E,A01,083771,Staff,2,0,30,28
1650985704346,MATH 20E,A02,083772,Staff,12,0,30,18
1650985704346,MATH 20E,B01,083773,Staff,0,0,30,30
1650985704346,MATH 20E,B02,083774,Staff,0,0,30,30
1650985710370,MATH 103A,A01,083777,Staff,0,17,30,30
1650985710370,MATH 103A,A02,083778,Staff,0,15,30,30
1650985710370,MATH 103A,B01,083779,Staff,0,15,30,30
1650985710370,MATH 103A,B02,083780,Staff,0,14,30,30
1650985716403,MATH 105,A01,085443,Staff,0,23,30,30
1650985722426,MATH 109,A01,083213,Anzaldo; Leesa B,0,7,30,30
1650985722426,MATH 109,A02,083214,Anzaldo; Leesa B,0,7,30,30
1650985722426,MATH 109,B01,083215,Anzaldo; Leesa B,0,8,30,30
1650985722426,MATH 109,B02,083216,Anzaldo; Leesa B,0,7,30,30
1650985728450,MATH 142A,A01,083219,Chow; Bennett,0,14,30,30
1650985728450,MATH 142A,A02,083220,Chow; Bennett,0,15,30,30
1650985728450,MATH 142A,B01,083221,Chow; Bennett,0,16,30,30
1650985728450,MATH 142A,B02,083222,Chow; Bennett,0,14,30,30
1650985734480,MATH 193A,A01,083224,Staff,0,6,30,30
1650985734480,MATH 193A,A02,083225,Staff,0,7,30,30
1650985734480,MATH 193A,A03,083781,Staff,0,6,30,30
1650985734480,MATH 193A,A04,083782,Staff,0,7,30,30
1650985740516,MATH 197,001,091859,McAuley; Julian John,9998,0,9999,1
1650985746582,COGS 9,A01,083615,Staff,0,18,60,60
1650985752607,COGS 11,A01,083617,Boyle; Mary E. T.,15,0,40,25
1650985758632,COGS 13,A01,083071,Staff,0,41,40,40
1650985764667,COGS 14A,A01,092681,Staff,0,38,100,100
1650985770691,COGS 14B,A01,083073,Cheng; Tzu-Han,0,13,50,50
1650985776717,COGS 17,A01,092677,Staff,6,0,75,69
1650985782743,COGS 100,A01,083619,Staff,0,31,60,60
1650985788767,COGS 101A,A01,083621,Davis; Joshua Daniel,0,29,60,60
1650985794800,COGS 101B,A01,091572,Staff,0,5,60,60
1650985800826,COGS 101C,A01,083625,Delgado; Tania,14,0,30,16
1650985806850,COGS 107A,A01,083627,Boyle; Mary E. T.,0,16,60,60
1650985812872,COGS 118A,A01,083075,Staff,0,10,60,60
1650985818905,CSE 3,A50,083646,Miranda; Gregory Joseph,15,0,38,23
1650985818905,CSE 3,A51,083647,Miranda; Gregory Joseph,36,0,37,1
1650985824932,CSE 8A,A50,083650,Miranda; Gregory Joseph,0,31,40,40
1650985830956,CSE 11,A01,083080,Cao; Yingjun,0,97,40,40
1650985836983,CSE 12,A01,083652,Staff,0,24,100,100
1650985843007,CSE 15L,A01,083654,Staff,0,3,50,50
1650985843007,CSE 15L,A02,083655,Staff,0,3,50,50
1650985849045,CSE 20,A01,083657,Staff,47,0,80,33
1650985855069,CSE 30,A01,083084,Eldon; John,1,38,80,79
1650985861096,CSE 100,A01,083659,Cao; Yingjun,0,71,50,50
1650985867135,CSE 134B,A01,083661,Powell; Thomas Allan,1,40,65,64
1650985873157,CSE 140,A01,083663,Staff,0,13,75,75
1650985879179,CSE 140L,A01,083088,Eldon; John,4,0,100,96
1650985885202,CSE 175,A01,083665,Kumar; Rakesh,0,0,25,25
1650985891226,CSE 190,A00,092507,Dubnov; Shlomo,9,0,20,11
1650985897258,ECE 45,A01,083139,Staff,0,6,60,60
1650985903280,ECE 65,A50,083695,Staff,0,7,30,30
1650985909309,ECE 109,A01,091882,Touri; Behrouz,32,0,70,38
1650985915331,ECE 180,A00,083140,Abi Samra; Nicholas Camill,18,0,30,12
1650985915331,ECE 180,B00,083141,Abi Samra; Nicholas Camill,0,0,30,30
1650985921357,MATH 10A,A01,083735,Patchell; Gregory David,2,0,30,28
1650985921357,MATH 10A,A02,083736,Patchell; Gregory David,27,0,30,3
1650985921357,MATH 10A,A03,083737,Patchell; Gregory David,23,0,30,7
1650985927384,MATH 10B,A01,083207,Staff,0,9,30,30
1650985927384,MATH 10B,A02,083208,Staff,0,5,30,30
1650985927384,MATH 10B,B01,083739,Staff,9,0,30,21
1650985927384,MATH 10B,B02,083740,Staff,28,0,30,2
1650985933414,MATH 18,A01,083743,Staff,0,0,30,30
1650985933414,MATH 18,A02,083744,Staff,24,0,30,6
1650985933414,MATH 18,A03,083745,Staff,19,0,30,11
1650985933414,MATH 18,A04,083746,Staff,26,0,30,4
1650985933414,MATH 18,B01,083748,Staff,0,15,30,30
1650985933414,MATH 18,B02,083749,Staff,0,14,30,30
1650985933414,MATH 18,B03,083750,Staff,0,13,30,30
1650985933414,MATH 18,B04,083751,Staff,0,13,30,30
1650985939439,MATH 20A,A01,083754,Staff,19,0,40,21
1650985945466,MATH 20B,A01,083756,Staff,0,14,30,30
1650985945466,MATH 20B,A02,083757,Staff,0,11,30,30
1650985951492,MATH 20C,A01,083760,Staff,0,17,30,30
1650985951492,MATH 20C,A02,083761,Staff,0,15,30,30
1650985951492,MATH 20C,B01,083762,Staff,9,0,30,21
1650985951492,MATH 20C,B02,083763,Staff,28,0,30,2
1650985957516,MATH 20D,A01,083765,Staff,2,1,30,28
1650985957516,MATH 20D,A02,083766,Staff,2,0,30,28
1650985957516,MATH 20D,A03,083767,Staff,22,0,30,8
1650985963541,MATH 20E,A01,083771,Staff,2,0,30,28
1650985963541,MATH 20E,A02,083772,Staff,12,0,30,18
1650985963541,MATH 20E,B01,083773,Staff,0,0,30,30
1650985963541,MATH 20E,B02,083774,Staff,0,0,30,30
1650985969564,MATH 103A,A01,083777,Staff,0,17,30,30
1650985969564,MATH 103A,A02,083778,Staff,0,15,30,30
1650985969564,MATH 103A,B01,083779,Staff,0,15,30,30
1650985969564,MATH 103A,B02,083780,Staff,0,14,30,30
1650985975591,MATH 105,A01,085443,Staff,0,23,30,30
1650985981616,MATH 109,A01,083213,Anzaldo; Leesa B,0,7,30,30
1650985981616,MATH 109,A02,083214,Anzaldo; Leesa B,0,7,30,30
1650985981616,MATH 109,B01,083215,Anzaldo; Leesa B,0,8,30,30
1650985981616,MATH 109,B02,083216,Anzaldo; Leesa B,0,7,30,30
1650985987645,MATH 142A,A01,083219,Chow; Bennett,0,14,30,30
1650985987645,MATH 142A,A02,083220,Chow; Bennett,0,15,30,30
1650985987645,MATH 142A,B01,083221,Chow; Bennett,0,16,30,30
1650985987645,MATH 142A,B02,083222,Chow; Bennett,0,14,30,30
1650985993668,MATH 193A,A01,083224,Staff,0,6,30,30
1650985993668,MATH 193A,A02,083225,Staff,0,7,30,30
1650985993668,MATH 193A,A03,083781,Staff,0,6,30,30
1650985993668,MATH 193A,A04,083782,Staff,0,7,30,30
1650985999695,MATH 197,001,091859,McAuley; Julian John,9998,0,9999,1
1650986005753,COGS 9,A01,083615,Staff,0,18,60,60
1650986011788,COGS 11,A01,083617,Boyle; Mary E. T.,15,0,40,25
1650986017810,COGS 13,A01,083071,Staff,0,41,40,40
1650986023844,COGS 14A,A01,092681,Staff,0,38,100,100
1650986029868,COGS 14B,A01,083073,Cheng; Tzu-Han,0,13,50,50
1650986035891,COGS 17,A01,092677,Staff,6,0,75,69
1650986041924,COGS 100,A01,083619,Staff,0,31,60,60
1650986047950,COGS 101A,A01,083621,Davis; Joshua Daniel,0,29,60,60
1650986053982,COGS 101B,A01,091572,Staff,0,5,60,60
1650986060023,COGS 101C,A01,083625,Delgado; Tania,14,0,30,16
1650986066049,COGS 107A,A01,083627,Boyle; Mary E. T.,0,16,60,60
1650986072072,COGS 118A,A01,083075,Staff,0,10,60,60
1650986078102,CSE 3,A50,083646,Miranda; Gregory Joseph,15,0,38,23
1650986078102,CSE 3,A51,083647,Miranda; Gregory Joseph,36,0,37,1
1650986084126,CSE 8A,A50,083650,Miranda; Gregory Joseph,0,31,40,40
1650986090172,CSE 11,A01,083080,Cao; Yingjun,0,97,40,40
1650986096199,CSE 12,A01,083652,Staff,0,24,100,100
1650986102224,CSE 15L,A01,083654,Staff,0,3,50,50
1650986102224,CSE 15L,A02,083655,Staff,0,3,50,50
1650986108252,CSE 20,A01,083657,Staff,47,0,80,33
1650986114287,CSE 30,A01,083084,Eldon; John,1,38,80,79
1650986120312,CSE 100,A01,083659,Cao; Yingjun,0,71,50,50
1650986126347,CSE 134B,A01,083661,Powell; Thomas Allan,1,40,65,64
1650986132369,CSE 140,A01,083663,Staff,0,13,75,75
1650986138391,CSE 140L,A01,083088,Eldon; John,4,0,100,96
1650986144418,CSE 175,A01,083665,Kumar; Rakesh,0,0,25,25
1650986150457,CSE 190,A00,092507,Dubnov; Shlomo,9,0,20,11
1650986156488,ECE 45,A01,083139,Staff,0,6,60,60
1650986162524,ECE 65,A50,083695,Staff,0,7,30,30
1650986168550,ECE 109,A01,091882,Touri; Behrouz,32,0,70,38
1650986174577,ECE 180,A00,083140,Abi Samra; Nicholas Camill,18,0,30,12
1650986174577,ECE 180,B00,083141,Abi Samra; Nicholas Camill,0,0,30,30
1650986180603,MATH 10A,A01,083735,Patchell; Gregory David,2,0,30,28
1650986180603,MATH 10A,A02,083736,Patchell; Gregory David,27,0,30,3
1650986180603,MATH 10A,A03,083737,Patchell; Gregory David,23,0,30,7
1650986186632,MATH 10B,A01,083207,Staff,0,9,30,30
1650986186632,MATH 10B,A02,083208,Staff,0,5,30,30
1650986186632,MATH 10B,B01,083739,Staff,9,0,30,21
1650986186632,MATH 10B,B02,083740,Staff,28,0,30,2
1650986192758,MATH 18,A01,083743,Staff,0,0,30,30
1650986192758,MATH 18,A02,083744,Staff,24,0,30,6
1650986192758,MATH 18,A03,083745,Staff,19,0,30,11
1650986192758,MATH 18,A04,083746,Staff,26,0,30,4
1650986192758,MATH 18,B01,083748,Staff,0,15,30,30
1650986192758,MATH 18,B02,083749,Staff,0,14,30,30
1650986192758,MATH 18,B03,083750,Staff,0,13,30,30
1650986192758,MATH 18,B04,083751,Staff,0,13,30,30
1650986198785,MATH 20A,A01,083754,Staff,19,0,40,21
1650986204812,MATH 20B,A01,083756,Staff,0,14,30,30
1650986204812,MATH 20B,A02,083757,Staff,0,11,30,30
1650986210836,MATH 20C,A01,083760,Staff,0,17,30,30
1650986210836,MATH 20C,A02,083761,Staff,0,15,30,30
1650986210836,MATH 20C,B01,083762,Staff,9,0,30,21
1650986210836,MATH 20C,B02,083763,Staff,28,0,30,2
1650986216872,MATH 20D,A01,083765,Staff,2,1,30,28
1650986216872,MATH 20D,A02,083766,Staff,2,0,30,28
1650986216872,MATH 20D,A03,083767,Staff,22,0,30,8
1650986222902,MATH 20E,A01,083771,Staff,2,0,30,28
1650986222902,MATH 20E,A02,083772,Staff,12,0,30,18
1650986222902,MATH 20E,B01,083773,Staff,0,0,30,30
1650986222902,MATH 20E,B02,083774,Staff,0,0,30,30
1650986228931,MATH 103A,A01,083777,Staff,0,17,30,30
1650986228931,MATH 103A,A02,083778,Staff,0,15,30,30
1650986228931,MATH 103A,B01,083779,Staff,0,15,30,30
1650986228931,MATH 103A,B02,083780,Staff,0,14,30,30
1650986234954,MATH 105,A01,085443,Staff,0,23,30,30
1650986240978,MATH 109,A01,083213,Anzaldo; Leesa B,0,7,30,30
1650986240978,MATH 109,A02,083214,Anzaldo; Leesa B,0,7,30,30
1650986240978,MATH 109,B01,083215,Anzaldo; Leesa B,0,8,30,30
1650986240978,MATH 109,B02,083216,Anzaldo; Leesa B,0,7,30,30
1650986247006,MATH 142A,A01,083219,Chow; Bennett,0,14,30,30
1650986247006,MATH 142A,A02,083220,Chow; Bennett,0,15,30,30
1650986247006,MATH 142A,B01,083221,Chow; Bennett,0,16,30,30
1650986247006,MATH 142A,B02,083222,Chow; Bennett,0,14,30,30
1650986253034,MATH 193A,A01,083224,Staff,0,6,30,30
1650986253034,MATH 193A,A02,083225,Staff,0,7,30,30
1650986253034,MATH 193A,A03,083781,Staff,0,6,30,30
1650986253034,MATH 193A,A04,083782,Staff,0,7,30,30
1650986259060,MATH 197,001,091859,McAuley; Julian John,9998,0,9999,1
1650986265121,COGS 9,A01,083615,Staff,0,18,60,60
1650986271147,COGS 11,A01,083617,Boyle; Mary E. T.,15,0,40,25
1650986277174,COGS 13,A01,083071,Staff,0,41,40,40
1650986283197,COGS 14A,A01,092681,Staff,0,38,100,100
1650986289224,COGS 14B,A01,083073,Cheng; Tzu-Han,0,13,50,50
1650986295249,COGS 17,A01,092677,Staff,6,0,75,69
1650986301287,COGS 100,A01,083619,Staff,0,31,60,60
1650986307327,COGS 101A,A01,083621,Davis; Joshua Daniel,0,29,60,60
1650986313351,COGS 101B,A01,091572,Staff,0,5,60,60
1650986319383,COGS 101C,A01,083625,Delgado; Tania,14,0,30,16
1650986325422,COGS 107A,A01,083627,Boyle; Mary E. T.,0,16,60,60
1650986331447,COGS 118A,A01,083075,Staff,0,10,60,60
1650986337476,CSE 3,A50,083646,Miranda; Gregory Joseph,15,0,38,23
1650986337476,CSE 3,A51,083647,Miranda; Gregory Joseph,36,0,37,1
1650986343501,CSE 8A,A50,083650,Miranda; Gregory Joseph,0,31,40,40
1650986349529,CSE 11,A01,083080,Cao; Yingjun,0,97,40,40
1650986355554,CSE 12,A01,083652,Staff,0,24,100,100
1650986361577,CSE 15L,A01,083654,Staff,0,3,50,50
1650986361577,CSE 15L,A02,083655,Staff,0,3,50,50
1650986367607,CSE 20,A01,083657,Staff,47,0,80,33
1650986373632,CSE 30,A01,083084,Eldon; John,1,38,80,79
1650986379659,CSE 100,A01,083659,Cao; Yingjun,0,71,50,50
1650986385690,CSE 134B,A01,083661,Powell; Thomas Allan,1,40,65,64
1650986391714,CSE 140,A01,083663,Staff,0,13,75,75
1650986397752,CSE 140L,A01,083088,Eldon; John,4,0,100,96
1650986403776,CSE 175,A01,083665,Kumar; Rakesh,0,0,25,25
1650986409802,CSE 190,A00,092507,Dubnov; Shlomo,9,0,20,11
1650986415825,ECE 45,A01,083139,Staff,0,6,60,60
1650986421852,ECE 65,A50,083695,Staff,0,7,30,30
1650986427876,ECE 109,A01,091882,Touri; Behrouz,32,0,70,38
1650986433899,ECE 180,A00,083140,Abi Samra; Nicholas Camill,18,0,30,12
1650986433899,ECE 180,B00,083141,Abi Samra; Nicholas Camill,0,0,30,30
1650986439925,MATH 10A,A01,083735,Patchell; Gregory David,2,0,30,28
1650986439925,MATH 10A,A02,083736,Patchell; Gregory David,27,0,30,3
1650986439925,MATH 10A,A03,083737,Patchell; Gregory David,23,0,30,7
1650986445948,MATH 10B,A01,083207,Staff,0,9,30,30
1650986445948,MATH 10B,A02,083208,Staff,0,5,30,30
1650986445948,MATH 10B,B01,083739,Staff,9,0,30,21
1650986445948,MATH 10B,B02,083740,Staff,28,0,30,2
1650986451973,MATH 18,A01,083743,Staff,0,0,30,30
1650986451973,MATH 18,A02,083744,Staff,24,0,30,6
1650986451973,MATH 18,A03,083745,Staff,19,0,30,11
1650986451973,MATH 18,A04,083746,Staff,26,0,30,4
1650986451973,MATH 18,B01,083748,Staff,0,15,30,30
1650986451973,MATH 18,B02,083749,Staff,0,14,30,30
1650986451973,MATH 18,B03,083750,Staff,0,13,30,30
1650986451973,MATH 18,B04,083751,Staff,0,13,30,30
1650986458000,MATH 20A,A01,083754,Staff,19,0,40,21
1650986464022,MATH 20B,A01,083756,Staff,0,14,30,30
1650986464022,MATH 20B,A02,083757,Staff,0,11,30,30
1650986470047,MATH 20C,A01,083760,Staff,0,17,30,30
1650986470047,MATH 20C,A02,083761,Staff,0,15,30,30
1650986470047,MATH 20C,B01,083762,Staff,9,0,30,21
1650986470047,MATH 20C,B02,083763,Staff,28,0,30,2
1650986476072,MATH 20D,A01,083765,Staff,2,1,30,28
1650986476072,MATH 20D,A02,083766,Staff,2,0,30,28
1650986476072,MATH 20D,A03,083767,Staff,22,0,30,8
1650986482095,MATH 20E,A01,083771,Staff,2,0,30,28
1650986482095,MATH 20E,A02,083772,Staff,12,0,30,18
1650986482095,MATH 20E,B01,083773,Staff,0,0,30,30
1650986482095,MATH 20E,B02,083774,Staff,0,0,30,30
1650986488120,MATH 103A,A01,083777,Staff,0,17,30,30
1650986488120,MATH 103A,A02,083778,Staff,0,15,30,30
1650986488120,MATH 103A,B01,083779,Staff,0,15,30,30
1650986488120,MATH 103A,B02,083780,Staff,0,14,30,30
1650986494147,MATH 105,A01,085443,Staff,0,23,30,30
1650986500176,MATH 109,A01,083213,Anzaldo; Leesa B,0,7,30,30
1650986500176,MATH 109,A02,083214,Anzaldo; Leesa B,0,7,30,30
1650986500176,MATH 109,B01,083215,Anzaldo; Leesa B,0,8,30,30
1650986500176,MATH 109,B02,083216,Anzaldo; Leesa B,0,7,30,30
1650986506199,MATH 142A,A01,083219,Chow; Bennett,0,14,30,30
1650986506199,MATH 142A,A02,083220,Chow; Bennett,0,15,30,30
1650986506199,MATH 142A,B01,083221,Chow; Bennett,0,16,30,30
1650986506199,MATH 142A,B02,083222,Chow; Bennett,0,14,30,30
1650986512227,MATH 193A,A01,083224,Staff,0,6,30,30
1650986512227,MATH 193A,A02,083225,Staff,0,7,30,30
1650986512227,MATH 193A,A03,083781,Staff,0,6,30,30
1650986512227,MATH 193A,A04,083782,Staff,0,7,30,30
1650986518255,MATH 197,001,091859,McAuley; Julian John,9998,0,9999,1
1650986524323,COGS 9,A01,083615,Staff,0,18,60,60
1650986530350,COGS 11,A01,083617,Boyle; Mary E. T.,15,0,40,25
1650986536373,COGS 13,A01,083071,Staff,0,41,40,40
1650986542395,COGS 14A,A01,092681,Staff,0,38,100,100
1650986548417,COGS 14B,A01,083073,Cheng; Tzu-Han,0,13,50,50
1650986554458,COGS 17,A01,092677,Staff,6,0,75,69
1650986560486,COGS 100,A01,083619,Staff,0,31,60,60
1650986566509,COGS 101A,A01,083621,Davis; Joshua Daniel,0,29,60,60
1650986572543,COGS 101B,A01,091572,Staff,0,5,60,60
1650986578574,COGS 101C,A01,083625,Delgado; Tania,14,0,30,16
1650986584603,COGS 107A,A01,083627,Boyle; Mary E. T.,0,16,60,60
1650986590630,COGS 118A,A01,083075,Staff,0,10,60,60
1650986596665,CSE 3,A50,083646,Miranda; Gregory Joseph,15,0,38,23
1650986596665,CSE 3,A51,083647,Miranda; Gregory Joseph,36,0,37,1
1650986602689,CSE 8A,A50,083650,Miranda; Gregory Joseph,0,31,40,40
1650986608726,CSE 11,A01,083080,Cao; Yingjun,0,97,40,40
1650986614756,CSE 12,A01,083652,Staff,0,24,100,100
1650986620780,CSE 15L,A01,083654,Staff,0,3,50,50
1650986620780,CSE 15L,A02,083655,Staff,0,3,50,50
1650986626804,CSE 20,A01,083657,Staff,47,0,80,33
1650986632826,CSE 30,A01,083084,Eldon; John,1,38,80,79
1650986638854,CSE 100,A01,083659,Cao; Yingjun,0,71,50,50
1650986644878,CSE 134B,A01,083661,Powell; Thomas Allan,1,40,65,64
1650986650902,CSE 140,A01,083663,Staff,0,13,75,75
1650986656927,CSE 140L,A01,083088,Eldon; John,4,0,100,96
1650986662951,CSE 175,A01,083665,Kumar; Rakesh,0,0,25,25
1650986668976,CSE 190,A00,092507,Dubnov; Shlomo,9,0,20,11
1650986675002,ECE 45,A01,083139,Staff,0,6,60,60
1650986681029,ECE 65,A50,083695,Staff,0,7,30,30
1650986687054,ECE 109,A01,091882,Touri; Behrouz,32,0,70,38
1650986693089,ECE 180,A00,083140,Abi Samra; Nicholas Camill,18,0,30,12
1650986693089,ECE 180,B00,083141,Abi Samra; Nicholas Camill,0,0,30,30
1650986699114,MATH 10A,A01,083735,Patchell; Gregory David,2,0,30,28
1650986699114,MATH 10A,A02,083736,Patchell; Gregory David,27,0,30,3
1650986699114,MATH 10A,A03,083737,Patchell; Gregory David,23,0,30,7
1650986705143,MATH 10B,A01,083207,Staff,0,9,30,30
1650986705143,MATH 10B,A02,083208,Staff,0,5,30,30
1650986705143,MATH 10B,B01,083739,Staff,9,0,30,21
1650986705143,MATH 10B,B02,083740,Staff,28,0,30,2
1650986711184,MATH 18,A01,083743,Staff,0,0,30,30
1650986711184,MATH 18,A02,083744,Staff,24,0,30,6
1650986711184,MATH 18,A03,083745,Staff,19,0,30,11
1650986711184,MATH 18,A04,083746,Staff,26,0,30,4
1650986711184,MATH 18,B01,083748,Staff,0,15,30,30
1650986711184,MATH 18,B02,083749,Staff,0,14,30,30
1650986711184,MATH 18,B03,083750,Staff,0,13,30,30
1650986711184,MATH 18,B04,083751,Staff,0,13,30,30
1650986717210,MATH 20A,A01,083754,Staff,19,0,40,21
1650986723248,MATH 20B,A01,083756,Staff,0,14,30,30
1650986723248,MATH 20B,A02,083757,Staff,0,11,30,30
1650986729285,MATH 20C,A01,083760,Staff,0,17,30,30
1650986729285,MATH 20C,A02,083761,Staff,0,15,30,30
1650986729285,MATH 20C,B01,083762,Staff,9,0,30,21
1650986729285,MATH 20C,B02,083763,Staff,28,0,30,2
1650986735309,MATH 20D,A01,083765,Staff,2,1,30,28
1650986735309,MATH 20D,A02,083766,Staff,2,0,30,28
1650986735309,MATH 20D,A03,083767,Staff,22,0,30,8
1650986741345,MATH 20E,A01,083771,Staff,2,0,30,28
1650986741345,MATH 20E,A02,083772,Staff,12,0,30,18
1650986741345,MATH 20E,B01,083773,Staff,0,0,30,30
1650986741345,MATH 20E,B02,083774,Staff,0,0,30,30
1650986747381,MATH 103A,A01,083777,Staff,0,17,30,30
1650986747381,MATH 103A,A02,083778,Staff,0,15,30,30
1650986747381,MATH 103A,B01,083779,Staff,0,15,30,30
1650986747381,MATH 103A,B02,083780,Staff,0,14,30,30
1650986753409,MATH 105,A01,085443,Staff,0,23,30,30
1650986759431,MATH 109,A01,083213,Anzaldo; Leesa B,0,7,30,30
1650986759431,MATH 109,A02,083214,Anzaldo; Leesa B,0,7,30,30
1650986759431,MATH 109,B01,083215,Anzaldo; Leesa B,0,8,30,30
1650986759431,MATH 109,B02,083216,Anzaldo; Leesa B,0,7,30,30
1650986765453,MATH 142A,A01,083219,Chow; Bennett,0,14,30,30
1650986765453,MATH 142A,A02,083220,Chow; Bennett,0,15,30,30
1650986765453,MATH 142A,B01,083221,Chow; Bennett,0,16,30,30
1650986765453,MATH 142A,B02,083222,Chow; Bennett,0,14,30,30
1650986771485,MATH 193A,A01,083224,Staff,0,6,30,30
1650986771485,MATH 193A,A02,083225,Staff,0,7,30,30
1650986771485,MATH 193A,A03,083781,Staff,0,6,30,30
1650986771485,MATH 193A,A04,083782,Staff,0,7,30,30
1650986777529,MATH 197,001,091859,McAuley; Julian John,9998,0,9999,1
1650986783695,COGS 9,A01,083615,Staff,0,18,60,60
1650986789725,COGS 11,A01,083617,Boyle; Mary E. T.,15,0,40,25
1650986795751,COGS 13,A01,083071,Staff,0,41,40,40
1650986801774,COGS 14A,A01,092681,Staff,0,38,100,100
1650986807803,COGS 14B,A01,083073,Cheng; Tzu-Han,0,13,50,50
1650986813826,COGS 17,A01,092677,Staff,6,0,75,69
1650986819849,COGS 100,A01,083619,Staff,0,31,60,60
1650986825881,COGS 101A,A01,083621,Davis; Joshua Daniel,0,29,60,60
1650986831913,COGS 101B,A01,091572,Staff,0,5,60,60
1650986837944,COGS 101C,A01,083625,Delgado; Tania,14,0,30,16
1650986843970,COGS 107A,A01,083627,Boyle; Mary E. T.,0,16,60,60
1650986849996,COGS 118A,A01,083075,Staff,0,10,60,60
1650986856020,CSE 3,A50,083646,Miranda; Gregory Joseph,15,0,38,23
1650986856020,CSE 3,A51,083647,Miranda; Gregory Joseph,36,0,37,1
1650986862063,CSE 8A,A50,083650,Miranda; Gregory Joseph,0,31,40,40
1650986868085,CSE 11,A01,083080,Cao; Yingjun,0,97,40,40
1650986874109,CSE 12,A01,083652,Staff,0,24,100,100
1650986880138,CSE 15L,A01,083654,Staff,0,3,50,50
1650986880138,CSE 15L,A02,083655,Staff,0,3,50,50
1650986886162,CSE 20,A01,083657,Staff,47,0,80,33
1650986892203,CSE 30,A01,083084,Eldon; John,1,38,80,79
1650986898244,CSE 100,A01,083659,Cao; Yingjun,0,71,50,50
1650986904276,CSE 134B,A01,083661,Powell; Thomas Allan,1,40,65,64
1650986910299,CSE 140,A01,083663,Staff,0,13,75,75
1650986916328,CSE 140L,A01,083088,Eldon; John,4,0,100,96
1650986922354,CSE 175,A01,083665,Kumar; Rakesh,0,0,25,25
1650986928386,CSE 190,A00,092507,Dubnov; Shlomo,9,0,20,11
1650986934421,ECE 45,A01,083139,Staff,0,6,60,60
1650986940447,ECE 65,A50,083695,Staff,0,7,30,30
1650986946475,ECE 109,A01,091882,Touri; Behrouz,32,0,70,38
1650986952499,ECE 180,A00,083140,Abi Samra; Nicholas Camill,18,0,30,12
1650986952499,ECE 180,B00,083141,Abi Samra; Nicholas Camill,0,0,30,30
1650986958528,MATH 10A,A01,083735,Patchell; Gregory David,2,0,30,28
1650986958528,MATH 10A,A02,083736,Patchell; Gregory David,27,0,30,3
1650986958528,MATH 10A,A03,083737,Patchell; Gregory David,23,0,30,7
1650986964556,MATH 10B,A01,083207,Staff,0,9,30,30
1650986964556,MATH 10B,A02,083208,Staff,0,5,30,30
1650986964556,MATH 10B,B01,083739,Staff,9,0,30,21
1650986964556,MATH 10B,B02,083740,Staff,28,0,30,2
1650986970581,MATH 18,A01,083743,Staff,0,0,30,30
1650986970581,MATH 18,A02,083744,Staff,24,0,30,6
1650986970581,MATH 18,A03,083745,Staff,19,0,30,11
1650986970581,MATH 18,A04,083746,Staff,26,0,30,4
1650986970581,MATH 18,B01,083748,Staff,0,15,30,30
1650986970581,MATH 18,B02,083749,Staff,0,14,30,30
1650986970581,MATH 18,B03,083750,Staff,0,13,30,30
1650986970581,MATH 18,B04,083751,Staff,0,13,30,30
1650986976605,MATH 20A,A01,083754,Staff,19,0,40,21
1650986982629,MATH 20B,A01,083756,Staff,0,14,30,30
1650986982629,MATH 20B,A02,083757,Staff,0,11,30,30
1650986988657,MATH 20C,A01,083760,Staff,0,17,30,30
1650986988657,MATH 20C,A02,083761,Staff,0,15,30,30
1650986988657,MATH 20C,B01,083762,Staff,9,0,30,21
1650986988657,MATH 20C,B02,083763,Staff,28,0,30,2
1650986994681,MATH 20D,A01,083765,Staff,2,1,30,28
1650986994681,MATH 20D,A02,083766,Staff,2,0,30,28
1650986994681,MATH 20D,A03,083767,Staff,22,0,30,8
1650987000706,MATH 20E,A01,083771,Staff,2,0,30,28
1650987000706,MATH 20E,A02,083772,Staff,12,0,30,18
1650987000706,MATH 20E,B01,083773,Staff,0,0,30,30
1650987000706,MATH 20E,B02,083774,Staff,0,0,30,30
1650987006729,MATH 103A,A01,083777,Staff,0,17,30,30
1650987006729,MATH 103A,A02,083778,Staff,0,15,30,30
1650987006729,MATH 103A,B01,083779,Staff,0,15,30,30
1650987006729,MATH 103A,B02,083780,Staff,0,14,30,30
1650987012754,MATH 105,A01,085443,Staff,0,23,30,30
1650987018778,MATH 109,A01,083213,Anzaldo; Leesa B,0,7,30,30
1650987018778,MATH 109,A02,083214,Anzaldo; Leesa B,0,7,30,30
1650987018778,MATH 109,B01,083215,Anzaldo; Leesa B,0,8,30,30
1650987018778,MATH 109,B02,083216,Anzaldo; Leesa B,0,7,30,30
1650987024807,MATH 142A,A01,083219,Chow; Bennett,0,14,30,30
1650987024807,MATH 142A,A02,083220,Chow; Bennett,0,15,30,30
1650987024807,MATH 142A,B01,083221,Chow; Bennett,0,16,30,30
1650987024807,MATH 142A,B02,083222,Chow; Bennett,0,14,30,30
1650987030831,MATH 193A,A01,083224,Staff,0,6,30,30
1650987030831,MATH 193A,A02,083225,Staff,0,7,30,30
1650987030831,MATH 193A,A03,083781,Staff,0,6,30,30
1650987030831,MATH 193A,A04,083782,Staff,0,7,30,30
1650987036856,MATH 197,001,091859,McAuley; Julian John,9998,0,9999,1
1650987042916,COGS 9,A01,083615,Staff,0,18,60,60
1650987048942,COGS 11,A01,083617,Boyle; Mary E. T.,15,0,40,25
1650987054964,COGS 13,A01,083071,Staff,0,41,40,40
1650987060988,COGS 14A,A01,092681,Staff,0,38,100,100
1650987067012,COGS 14B,A01,083073,Cheng; Tzu-Han,0,13,50,50
1650987073040,COGS 17,A01,092677,Staff,6,0,75,69
1650987079064,COGS 100,A01,083619,Staff,0,31,60,60
1650987085096,COGS 101A,A01,083621,Davis; Joshua Daniel,0,29,60,60
1650987091122,COGS 101B,A01,091572,Staff,0,5,60,60
1650987097153,COGS 101C,A01,083625,Delgado; Tania,14,0,30,16
1650987103177,COGS 107A,A01,083627,Boyle; Mary E. T.,0,16,60,60
1650987109201,COGS 118A,A01,083075,Staff,0,10,60,60
1650987115226,CSE 3,A50,083646,Miranda; Gregory Joseph,15,0,38,23
1650987115226,CSE 3,A51,083647,Miranda; Gregory Joseph,36,0,37,1
1650987121255,CSE 8A,A50,083650,Miranda; Gregory Joseph,0,31,40,40
1650987127283,CSE 11,A01,083080,Cao; Yingjun,0,97,40,40
1650987133305,CSE 12,A01,083652,Staff,0,24,100,100
1650987139338,CSE 15L,A01,083654,Staff,0,3,50,50
1650987139338,CSE 15L,A02,083655,Staff,0,3,50,50
1650987145363,CSE 20,A01,083657,Staff,47,0,80,33
1650987151399,CSE 30,A01,083084,Eldon; John,1,38,80,79
1650987157447,CSE 100,A01,083659,Cao; Yingjun,0,71,50,50
1650987163471,CSE 134B,A01,083661,Powell; Thomas Allan,1,40,65,64
1650987169498,CSE 140,A01,083663,Staff,0,13,75,75
1650987175535,CSE 140L,A01,083088,Eldon; John,4,0,100,96
1650987181560,CSE 175,A01,083665,Kumar; Rakesh,0,0,25,25
1650987187588,CSE 190,A00,092507,Dubnov; Shlomo,9,0,20,11
1650987193621,ECE 45,A01,083139,Staff,0,6,60,60
1650987199653,ECE 65,A50,083695,Staff,0,7,30,30
1650987205679,ECE 109,A01,091882,Touri; Behrouz,32,0,70,38
1650987211706,ECE 180,A00,083140,Abi Samra; Nicholas Camill,18,0,30,12
1650987211706,ECE 180,B00,083141,Abi Samra; Nicholas Camill,0,0,30,30
1650987217733,MATH 10A,A01,083735,Patchell; Gregory David,2,0,30,28
1650987217733,MATH 10A,A02,083736,Patchell; Gregory David,27,0,30,3
1650987217733,MATH 10A,A03,083737,Patchell; Gregory David,23,0,30,7
1650987223763,MATH 10B,A01,083207,Staff,0,9,30,30
1650987223763,MATH 10B,A02,083208,Staff,0,5,30,30
1650987223763,MATH 10B,B01,083739,Staff,9,0,30,21
1650987223763,MATH 10B,B02,083740,Staff,28,0,30,2
1650987229788,MATH 18,A01,083743,Staff,0,0,30,30
1650987229788,MATH 18,A02,083744,Staff,24,0,30,6
1650987229788,MATH 18,A03,083745,Staff,19,0,30,11
1650987229788,MATH 18,A04,083746,Staff,26,0,30,4
1650987229788,MATH 18,B01,083748,Staff,0,15,30,30
1650987229788,MATH 18,B02,083749,Staff,0,14,30,30
1650987229788,MATH 18,B03,083750,Staff,0,13,30,30
1650987229788,MATH 18,B04,083751,Staff,0,13,30,30
1650987235816,MATH 20A,A01,083754,Staff,19,0,40,21
1650987241844,MATH 20B,A01,083756,Staff,0,14,30,30
1650987241844,MATH 20B,A02,083757,Staff,0,11,30,30
1650987247873,MATH 20C,A01,083760,Staff,0,17,30,30
1650987247873,MATH 20C,A02,083761,Staff,0,15,30,30
1650987247873,MATH 20C,B01,083762,Staff,9,0,30,21
1650987247873,MATH 20C,B02,083763,Staff,28,0,30,2
1650987253899,MATH 20D,A01,083765,Staff,2,1,30,28
1650987253899,MATH 20D,A02,083766,Staff,2,0,30,28
1650987253899,MATH 20D,A03,083767,Staff,22,0,30,8
1650987259928,MATH 20E,A01,083771,Staff,2,0,30,28
1650987259928,MATH 20E,A02,083772,Staff,12,0,30,18
1650987259928,MATH 20E,B01,083773,Staff,0,0,30,30
1650987259928,MATH 20E,B02,083774,Staff,0,0,30,30
1650987265966,MATH 103A,A01,083777,Staff,0,17,30,30
1650987265966,MATH 103A,A02,083778,Staff,0,15,30,30
1650987265966,MATH 103A,B01,083779,Staff,0,15,30,30
1650987265966,MATH 103A,B02,083780,Staff,0,14,30,30
1650987272001,MATH 105,A01,085443,Staff,0,23,30,30
1650987278025,MATH 109,A01,083213,Anzaldo; Leesa B,0,7,30,30
1650987278025,MATH 109,A02,083214,Anzaldo; Leesa B,0,7,30,30
1650987278025,MATH 109,B01,083215,Anzaldo; Leesa B,0,8,30,30
1650987278025,MATH 109,B02,083216,Anzaldo; Leesa B,0,7,30,30
1650987284060,MATH 142A,A01,083219,Chow; Bennett,0,14,30,30
1650987284060,MATH 142A,A02,083220,Chow; Bennett,0,15,30,30
1650987284060,MATH 142A,B01,083221,Chow; Bennett,0,16,30,30
1650987284060,MATH 142A,B02,083222,Chow; Bennett,0,14,30,30
1650987290084,MATH 193A,A01,083224,Staff,0,6,30,30
1650987290084,MATH 193A,A02,083225,Staff,0,7,30,30
1650987290084,MATH 193A,A03,083781,Staff,0,6,30,30
1650987290084,MATH 193A,A04,083782,Staff,0,7,30,30
1650987296108,MATH 197,001,091859,McAuley; Julian John,9998,0,9999,1
1650987302182,COGS 9,A01,083615,Staff,0,18,60,60
1650987308207,COGS 11,A01,083617,Boyle; Mary E. T.,15,0,40,25
1650987314241,COGS 13,A01,083071,Staff,0,41,40,40
1650987320273,COGS 14A,A01,092681,Staff,0,38,100,100
1650987326305,COGS 14B,A01,083073,Cheng; Tzu-Han,0,13,50,50
1650987332331,COGS 17,A01,092677,Staff,6,0,75,69
1650987338357,COGS 100,A01,083619,Staff,0,31,60,60
1650987344396,COGS 101A,A01,083621,Davis; Joshua Daniel,0,29,60,60
1650987350421,COGS 101B,A01,091572,Staff,0,5,60,60
1650987356446,COGS 101C,A01,083625,Delgado; Tania,14,0,30,16
1650987362473,COGS 107A,A01,083627,Boyle; Mary E. T.,0,16,60,60
1650987368495,COGS 118A,A01,083075,Staff,0,10,60,60
1650987374519,CSE 3,A50,083646,Miranda; Gregory Joseph,15,0,38,23
1650987374519,CSE 3,A51,083647,Miranda; Gregory Joseph,36,0,37,1
1650987381362,CSE 8A,A50,083650,Miranda; Gregory Joseph,0,31,40,40
1650987387391,CSE 11,A01,083080,Cao; Yingjun,0,97,40,40
1650987393415,CSE 12,A01,083652,Staff,0,24,100,100
1650987399442,CSE 15L,A01,083654,Staff,0,3,50,50
1650987399442,CSE 15L,A02,083655,Staff,0,3,50,50
1650987405465,CSE 20,A01,083657,Staff,47,0,80,33
1650987411490,CSE 30,A01,083084,Eldon; John,1,38,80,79
1650987417516,CSE 100,A01,083659,Cao; Yingjun,0,71,50,50
1650987423542,CSE 134B,A01,083661,Powell; Thomas Allan,1,40,65,64
1650987429566,CSE 140,A01,083663,Staff,0,13,75,75
1650987435590,CSE 140L,A01,083088,Eldon; John,4,0,100,96
1650987441617,CSE 175,A01,083665,Kumar; Rakesh,0,0,25,25
1650987447639,CSE 190,A00,092507,Dubnov; Shlomo,9,0,20,11
1650987453663,ECE 45,A01,083139,Staff,0,6,60,60
1650987459689,ECE 65,A50,083695,Staff,0,7,30,30
1650987465713,ECE 109,A01,091882,Touri; Behrouz,32,0,70,38
1650987471735,ECE 180,A00,083140,Abi Samra; Nicholas Camill,18,0,30,12
1650987471735,ECE 180,B00,083141,Abi Samra; Nicholas Camill,0,0,30,30
1650987477775,MATH 10A,A01,083735,Patchell; Gregory David,2,0,30,28
1650987477775,MATH 10A,A02,083736,Patchell; Gregory David,27,0,30,3
1650987477775,MATH 10A,A03,083737,Patchell; Gregory David,23,0,30,7
1650987483797,MATH 10B,A01,083207,Staff,0,9,30,30
1650987483797,MATH 10B,A02,083208,Staff,0,5,30,30
1650987483797,MATH 10B,B01,083739,Staff,9,0,30,21
1650987483797,MATH 10B,B02,083740,Staff,28,0,30,2
1650987489825,MATH 18,A01,083743,Staff,0,0,30,30
1650987489825,MATH 18,A02,083744,Staff,24,0,30,6
1650987489825,MATH 18,A03,083745,Staff,19,0,30,11
1650987489825,MATH 18,A04,083746,Staff,26,0,30,4
1650987489825,MATH 18,B01,083748,Staff,0,15,30,30
1650987489825,MATH 18,B02,083749,Staff,0,14,30,30
1650987489825,MATH 18,B03,083750,Staff,0,13,30,30
1650987489825,MATH 18,B04,083751,Staff,0,13,30,30
1650987495849,MATH 20A,A01,083754,Staff,19,0,40,21
1650987501873,MATH 20B,A01,083756,Staff,0,14,30,30
1650987501873,MATH 20B,A02,083757,Staff,0,11,30,30
1650987507897,MATH 20C,A01,083760,Staff,0,17,30,30
1650987507897,MATH 20C,A02,083761,Staff,0,15,30,30
1650987507897,MATH 20C,B01,083762,Staff,9,0,30,21
1650987507897,MATH 20C,B02,083763,Staff,28,0,30,2
1650987513920,MATH 20D,A01,083765,Staff,2,1,30,28
1650987513920,MATH 20D,A02,083766,Staff,2,0,30,28
1650987513920,MATH 20D,A03,083767,Staff,22,0,30,8
1650987519947,MATH 20E,A01,083771,Staff,2,0,30,28
1650987519947,MATH 20E,A02,083772,Staff,12,0,30,18
1650987519947,MATH 20E,B01,083773,Staff,0,0,30,30
1650987519947,MATH 20E,B02,083774,Staff,0,0,30,30
1650987525976,MATH 103A,A01,083777,Staff,0,17,30,30
1650987525976,MATH 103A,A02,083778,Staff,0,15,30,30
1650987525976,MATH 103A,B01,083779,Staff,0,15,30,30
1650987525976,MATH 103A,B02,083780,Staff,0,14,30,30
1650987532002,MATH 105,A01,085443,Staff,0,23,30,30
1650987538030,MATH 109,A01,083213,Anzaldo; Leesa B,0,7,30,30
1650987538030,MATH 109,A02,083214,Anzaldo; Leesa B,0,7,30,30
1650987538030,MATH 109,B01,083215,Anzaldo; Leesa B,0,8,30,30
1650987538030,MATH 109,B02,083216,Anzaldo; Leesa B,0,7,30,30
1650987544059,MATH 142A,A01,083219,Chow; Bennett,0,14,30,30
1650987544059,MATH 142A,A02,083220,Chow; Bennett,0,15,30,30
1650987544059,MATH 142A,B01,083221,Chow; Bennett,0,16,30,30
1650987544059,MATH 142A,B02,083222,Chow; Bennett,0,14,30,30
1650987550083,MATH 193A,A01,083224,Staff,0,6,30,30
1650987550083,MATH 193A,A02,083225,Staff,0,7,30,30
1650987550083,MATH 193A,A03,083781,Staff,0,6,30,30
1650987550083,MATH 193A,A04,083782,Staff,0,7,30,30
1650987556105,MATH 197,001,091859,McAuley; Julian John,9998,0,9999,1
1650987562157,COGS 9,A01,083615,Staff,0,18,60,60
1650987568184,COGS 11,A01,083617,Boyle; Mary E. T.,15,0,40,25
1650987574208,COGS 13,A01,083071,Staff,0,41,40,40
1650987580232,COGS 14A,A01,092681,Staff,0,38,100,100
1650987586255,COGS 14B,A01,083073,Cheng; Tzu-Han,0,13,50,50
1650987592278,COGS 17,A01,092677,Staff,6,0,75,69
1650987598304,COGS 100,A01,083619,Staff,0,31,60,60
1650987604329,COGS 101A,A01,083621,Davis; Joshua Daniel,0,29,60,60
1650987610351,COGS 101B,A01,091572,Staff,0,5,60,60
1650987616377,COGS 101C,A01,083625,Delgado; Tania,14,0,30,16
1650987622401,COGS 107A,A01,083627,Boyle; Mary E. T.,0,16,60,60
1650987628427,COGS 118A,A01,083075,Staff,0,10,60,60
1650987634451,CSE 3,A50,083646,Miranda; Gregory Joseph,15,0,38,23
1650987634451,CSE 3,A51,083647,Miranda; Gregory Joseph,36,0,37,1
1650987640484,CSE 8A,A50,083650,Miranda; Gregory Joseph,0,31,40,40
1650987646511,CSE 11,A01,083080,Cao; Yingjun,0,97,40,40
1650987652534,CSE 12,A01,083652,Staff,0,24,100,100
1650987658561,CSE 15L,A01,083654,Staff,0,3,50,50
1650987658561,CSE 15L,A02,083655,Staff,0,3,50,50
1650987664584,CSE 20,A01,083657,Staff,47,0,80,33
1650987670608,CSE 30,A01,083084,Eldon; John,1,38,80,79
1650987676633,CSE 100,A01,083659,Cao; Yingjun,0,71,50,50
1650987682657,CSE 134B,A01,083661,Powell; Thomas Allan,1,40,65,64
1650987688682,CSE 140,A01,083663,Staff,0,13,75,75
1650987694706,CSE 140L,A01,083088,Eldon; John,4,0,100,96
1650987700732,CSE 175,A01,083665,Kumar; Rakesh,0,0,25,25
1650987706756,CSE 190,A00,092507,Dubnov; Shlomo,9,0,20,11
1650987712779,ECE 45,A01,083139,Staff,0,6,60,60
1650987718802,ECE 65,A50,083695,Staff,0,7,30,30
1650987724825,ECE 109,A01,091882,Touri; Behrouz,32,0,70,38
1650987730848,ECE 180,A00,083140,Abi Samra; Nicholas Camill,18,0,30,12
1650987730848,ECE 180,B00,083141,Abi Samra; Nicholas Camill,0,0,30,30
1650987736872,MATH 10A,A01,083735,Patchell; Gregory David,2,0,30,28
1650987736872,MATH 10A,A02,083736,Patchell; Gregory David,27,0,30,3
1650987736872,MATH 10A,A03,083737,Patchell; Gregory David,23,0,30,7
1650987742899,MATH 10B,A01,083207,Staff,0,9,30,30
1650987742899,MATH 10B,A02,083208,Staff,0,5,30,30
1650987742899,MATH 10B,B01,083739,Staff,9,0,30,21
1650987742899,MATH 10B,B02,083740,Staff,28,0,30,2
1650987748939,MATH 18,A01,083743,Staff,0,0,30,30
1650987748939,MATH 18,A02,083744,Staff,24,0,30,6
1650987748939,MATH 18,A03,083745,Staff,19,0,30,11
1650987748939,MATH 18,A04,083746,Staff,26,0,30,4
1650987748939,MATH 18,B01,083748,Staff,0,15,30,30
1650987748939,MATH 18,B02,083749,Staff,0,14,30,30
1650987748939,MATH 18,B03,083750,Staff,0,13,30,30
1650987748939,MATH 18,B04,083751,Staff,0,13,30,30
1650987754962,MATH 20A,A01,083754,Staff,19,0,40,21
1650987760984,MATH 20B,A01,083756,Staff,0,14,30,30
1650987760984,MATH 20B,A02,083757,Staff,0,11,30,30
1650987767012,MATH 20C,A01,083760,Staff,0,17,30,30
1650987767012,MATH 20C,A02,083761,Staff,0,15,30,30
1650987767012,MATH 20C,B01,083762,Staff,9,0,30,21
1650987767012,MATH 20C,B02,083763,Staff,28,0,30,2
1650987773036,MATH 20D,A01,083765,Staff,2,1,30,28
1650987773036,MATH 20D,A02,083766,Staff,2,0,30,28
1650987773036,MATH 20D,A03,083767,Staff,22,0,30,8
1650987779065,MATH 20E,A01,083771,Staff,2,0,30,28
1650987779065,MATH 20E,A02,083772,Staff,12,0,30,18
1650987779065,MATH 20E,B01,083773,Staff,0,0,30,30
1650987779065,MATH 20E,B02,083774,Staff,0,0,30,30
1650987785088,MATH 103A,A01,083777,Staff,0,17,30,30
1650987785088,MATH 103A,A02,083778,Staff,0,15,30,30
1650987785088,MATH 103A,B01,083779,Staff,0,15,30,30
1650987785088,MATH 103A,B02,083780,Staff,0,14,30,30
1650987791112,MATH 105,A01,085443,Staff,0,23,30,30
1650987797136,MATH 109,A01,083213,Anzaldo; Leesa B,0,8,30,30
1650987797136,MATH 109,A02,083214,Anzaldo; Leesa B,0,7,30,30
1650987797136,MATH 109,B01,083215,Anzaldo; Leesa B,0,8,30,30
1650987797136,MATH 109,B02,083216,Anzaldo; Leesa B,0,7,30,30
1650987803164,MATH 142A,A01,083219,Chow; Bennett,0,14,30,30
1650987803164,MATH 142A,A02,083220,Chow; Bennett,0,15,30,30
1650987803164,MATH 142A,B01,083221,Chow; Bennett,0,16,30,30
1650987803164,MATH 142A,B02,083222,Chow; Bennett,0,14,30,30
1650987809191,MATH 193A,A01,083224,Staff,0,6,30,30
1650987809191,MATH 193A,A02,083225,Staff,0,7,30,30
1650987809191,MATH 193A,A03,083781,Staff,0,6,30,30
1650987809191,MATH 193A,A04,083782,Staff,0,7,30,30
1650987815216,MATH 197,001,091859,McAuley; Julian John,9998,0,9999,1
1650987821273,COGS 9,A01,083615,Staff,0,18,60,60
1650987827297,COGS 11,A01,083617,Boyle; Mary E. T.,15,0,40,25
1650987833320,COGS 13,A01,083071,Staff,0,41,40,40
1650987839343,COGS 14A,A01,092681,Staff,0,38,100,100
1650987845366,COGS 14B,A01,083073,Cheng; Tzu-Han,0,13,50,50
1650987851390,COGS 17,A01,092677,Staff,6,0,75,69
1650987857414,COGS 100,A01,083619,Staff,0,31,60,60
1650987863440,COGS 101A,A01,083621,Davis; Joshua Daniel,0,29,60,60
1650987869466,COGS 101B,A01,091572,Staff,0,5,60,60
1650987875494,COGS 101C,A01,083625,Delgado; Tania,14,0,30,16
1650987881529,COGS 107A,A01,083627,Boyle; Mary E. T.,0,16,60,60
1650987887553,COGS 118A,A01,083075,Staff,0,10,60,60
1650987893576,CSE 3,A50,083646,Miranda; Gregory Joseph,15,0,38,23
1650987893576,CSE 3,A51,083647,Miranda; Gregory Joseph,36,0,37,1
1650987899602,CSE 8A,A50,083650,Miranda; Gregory Joseph,0,31,40,40
1650987905629,CSE 11,A01,083080,Cao; Yingjun,0,97,40,40
1650987911651,CSE 12,A01,083652,Staff,0,24,100,100
1650987917673,CSE 15L,A01,083654,Staff,0,3,50,50
1650987917673,CSE 15L,A02,083655,Staff,0,3,50,50
1650987923698,CSE 20,A01,083657,Staff,47,0,80,33
1650987929722,CSE 30,A01,083084,Eldon; John,1,38,80,79
1650987935745,CSE 100,A01,083659,Cao; Yingjun,0,71,50,50
1650987941775,CSE 134B,A01,083661,Powell; Thomas Allan,1,40,65,64
1650987947800,CSE 140,A01,083663,Staff,0,13,75,75
1650987953832,CSE 140L,A01,083088,Eldon; John,4,0,100,96
1650987959862,CSE 175,A01,083665,Kumar; Rakesh,0,0,25,25
1650987965905,CSE 190,A00,092507,Dubnov; Shlomo,9,0,20,11
1650987971935,ECE 45,A01,083139,Staff,0,6,60,60
1650987978063,ECE 65,A50,083695,Staff,0,7,30,30
1650987984100,ECE 109,A01,091882,Touri; Behrouz,32,0,70,38
1650987990127,ECE 180,A00,083140,Abi Samra; Nicholas Camill,18,0,30,12
1650987990127,ECE 180,B00,083141,Abi Samra; Nicholas Camill,0,0,30,30
1650987996159,MATH 10A,A01,083735,Patchell; Gregory David,2,0,30,28
1650987996159,MATH 10A,A02,083736,Patchell; Gregory David,27,0,30,3
1650987996159,MATH 10A,A03,083737,Patchell; Gregory David,23,0,30,7
1650988002185,MATH 10B,A01,083207,Staff,0,9,30,30
1650988002185,MATH 10B,A02,083208,Staff,0,5,30,30
1650988002185,MATH 10B,B01,083739,Staff,9,0,30,21
1650988002185,MATH 10B,B02,083740,Staff,28,0,30,2
1650988008214,MATH 18,A01,083743,Staff,0,0,30,30
1650988008214,MATH 18,A02,083744,Staff,24,0,30,6
1650988008214,MATH 18,A03,083745,Staff,19,0,30,11
1650988008214,MATH 18,A04,083746,Staff,26,0,30,4
1650988008214,MATH 18,B01,083748,Staff,0,15,30,30
1650988008214,MATH 18,B02,083749,Staff,0,14,30,30
1650988008214,MATH 18,B03,083750,Staff,0,13,30,30
1650988008214,MATH 18,B04,083751,Staff,0,13,30,30
1650988014236,MATH 20A,A01,083754,Staff,19,0,40,21
1650988020270,MATH 20B,A01,083756,Staff,0,14,30,30
1650988020270,MATH 20B,A02,083757,Staff,0,11,30,30
1650988026294,MATH 20C,A01,083760,Staff,0,17,30,30
1650988026294,MATH 20C,A02,083761,Staff,0,15,30,30
1650988026294,MATH 20C,B01,083762,Staff,9,0,30,21
1650988026294,MATH 20C,B02,083763,Staff,28,0,30,2
1650988032317,MATH 20D,A01,083765,Staff,2,1,30,28
1650988032317,MATH 20D,A02,083766,Staff,2,0,30,28
1650988032317,MATH 20D,A03,083767,Staff,22,0,30,8
1650988038345,MATH 20E,A01,083771,Staff,2,0,30,28
1650988038345,MATH 20E,A02,083772,Staff,12,0,30,18
1650988038345,MATH 20E,B01,083773,Staff,0,0,30,30
1650988038345,MATH 20E,B02,083774,Staff,0,0,30,30
1650988044374,MATH 103A,A01,083777,Staff,0,17,30,30
1650988044374,MATH 103A,A02,083778,Staff,0,15,30,30
1650988044374,MATH 103A,B01,083779,Staff,0,15,30,30
1650988044374,MATH 103A,B02,083780,Staff,0,14,30,30
1650988050399,MATH 105,A01,085443,Staff,0,23,30,30
1650988056425,MATH 109,A01,083213,Anzaldo; Leesa B,0,8,30,30
1650988056425,MATH 109,A02,083214,Anzaldo; Leesa B,0,7,30,30
1650988056425,MATH 109,B01,083215,Anzaldo; Leesa B,0,8,30,30
1650988056425,MATH 109,B02,083216,Anzaldo; Leesa B,0,7,30,30
1650988062447,MATH 142A,A01,083219,Chow; Bennett,0,14,30,30
1650988062447,MATH 142A,A02,083220,Chow; Bennett,0,15,30,30
1650988062447,MATH 142A,B01,083221,Chow; Bennett,0,16,30,30
1650988062447,MATH 142A,B02,083222,Chow; Bennett,0,14,30,30
1650988068478,MATH 193A,A01,083224,Staff,0,6,30,30
1650988068478,MATH 193A,A02,083225,Staff,0,7,30,30
1650988068478,MATH 193A,A03,083781,Staff,0,6,30,30
1650988068478,MATH 193A,A04,083782,Staff,0,7,30,30
1650988074503,MATH 197,001,091859,McAuley; Julian John,9998,0,9999,1
1650988080581,COGS 9,A01,083615,Staff,0,18,60,60
1650988086619,COGS 11,A01,083617,Boyle; Mary E. T.,15,0,40,25
1650988092646,COGS 13,A01,083071,Staff,0,41,40,40
1650988098672,COGS 14A,A01,092681,Staff,0,38,100,100
1650988104695,COGS 14B,A01,083073,Cheng; Tzu-Han,0,13,50,50
1650988110719,COGS 17,A01,092677,Staff,6,0,75,69
1650988116740,COGS 100,A01,083619,Staff,0,31,60,60
1650988122763,COGS 101A,A01,083621,Davis; Joshua Daniel,0,29,60,60
1650988128788,COGS 101B,A01,091572,Staff,0,5,60,60
1650988134822,COGS 101C,A01,083625,Delgado; Tania,14,0,30,16
1650988140847,COGS 107A,A01,083627,Boyle; Mary E. T.,0,16,60,60
1650988146874,COGS 118A,A01,083075,Staff,0,10,60,60
1650988152898,CSE 3,A50,083646,Miranda; Gregory Joseph,15,0,38,23
1650988152898,CSE 3,A51,083647,Miranda; Gregory Joseph,36,0,37,1
1650988158925,CSE 8A,A50,083650,Miranda; Gregory Joseph,0,31,40,40
1650988164949,CSE 11,A01,083080,Cao; Yingjun,0,97,40,40
1650988170973,CSE 12,A01,083652,Staff,0,24,100,100
1650988176997,CSE 15L,A01,083654,Staff,0,3,50,50
1650988176997,CSE 15L,A02,083655,Staff,0,3,50,50
1650988183021,CSE 20,A01,083657,Staff,47,0,80,33
1650988189044,CSE 30,A01,083084,Eldon; John,1,38,80,79
1650988195069,CSE 100,A01,083659,Cao; Yingjun,0,71,50,50
1650988201097,CSE 134B,A01,083661,Powell; Thomas Allan,1,40,65,64
1650988207120,CSE 140,A01,083663,Staff,0,13,75,75
1650988213146,CSE 140L,A01,083088,Eldon; John,4,0,100,96
1650988219172,CSE 175,A01,083665,Kumar; Rakesh,0,0,25,25
1650988225195,CSE 190,A00,092507,Dubnov; Shlomo,9,0,20,11
1650988231221,ECE 45,A01,083139,Staff,0,6,60,60
1650988237244,ECE 65,A50,083695,Staff,0,7,30,30
1650988243281,ECE 109,A01,091882,Touri; Behrouz,32,0,70,38
1650988249319,ECE 180,A00,083140,Abi Samra; Nicholas Camill,18,0,30,12
1650988249319,ECE 180,B00,083141,Abi Samra; Nicholas Camill,0,0,30,30
1650988255348,MATH 10A,A01,083735,Patchell; Gregory David,2,0,30,28
1650988255348,MATH 10A,A02,083736,Patchell; Gregory David,27,0,30,3
1650988255348,MATH 10A,A03,083737,Patchell; Gregory David,23,0,30,7
1650988261376,MATH 10B,A01,083207,Staff,0,9,30,30
1650988261376,MATH 10B,A02,083208,Staff,0,5,30,30
1650988261376,MATH 10B,B01,083739,Staff,9,0,30,21
1650988261376,MATH 10B,B02,083740,Staff,28,0,30,2
1650988267413,MATH 18,A01,083743,Staff,0,0,30,30
1650988267413,MATH 18,A02,083744,Staff,24,0,30,6
1650988267413,MATH 18,A03,083745,Staff,19,0,30,11
1650988267413,MATH 18,A04,083746,Staff,26,0,30,4
1650988267413,MATH 18,B01,083748,Staff,0,15,30,30
1650988267413,MATH 18,B02,083749,Staff,0,14,30,30
1650988267413,MATH 18,B03,083750,Staff,0,13,30,30
1650988267413,MATH 18,B04,083751,Staff,0,13,30,30
1650988273436,MATH 20A,A01,083754,Staff,19,0,40,21
1650988279460,MATH 20B,A01,083756,Staff,0,14,30,30
1650988279460,MATH 20B,A02,083757,Staff,0,11,30,30
1650988285484,MATH 20C,A01,083760,Staff,0,17,30,30
1650988285484,MATH 20C,A02,083761,Staff,0,15,30,30
1650988285484,MATH 20C,B01,083762,Staff,9,0,30,21
1650988285484,MATH 20C,B02,083763,Staff,28,0,30,2
1650988291507,MATH 20D,A01,083765,Staff,2,1,30,28
1650988291507,MATH 20D,A02,083766,Staff,2,0,30,28
1650988291507,MATH 20D,A03,083767,Staff,22,0,30,8
1650988297532,MATH 20E,A01,083771,Staff,2,0,30,28
1650988297532,MATH 20E,A02,083772,Staff,12,0,30,18
1650988297532,MATH 20E,B01,083773,Staff,0,0,30,30
1650988297532,MATH 20E,B02,083774,Staff,0,0,30,30
1650988303554,MATH 103A,A01,083777,Staff,0,17,30,30
1650988303554,MATH 103A,A02,083778,Staff,0,15,30,30
1650988303554,MATH 103A,B01,083779,Staff,0,15,30,30
1650988303554,MATH 103A,B02,083780,Staff,0,14,30,30
1650988309584,MATH 105,A01,085443,Staff,0,23,30,30
1650988315608,MATH 109,A01,083213,Anzaldo; Leesa B,0,8,30,30
1650988315608,MATH 109,A02,083214,Anzaldo; Leesa B,0,7,30,30
1650988315608,MATH 109,B01,083215,Anzaldo; Leesa B,0,8,30,30
1650988315608,MATH 109,B02,083216,Anzaldo; Leesa B,0,7,30,30
1650988321641,MATH 142A,A01,083219,Chow; Bennett,0,14,30,30
1650988321641,MATH 142A,A02,083220,Chow; Bennett,0,15,30,30
1650988321641,MATH 142A,B01,083221,Chow; Bennett,0,16,30,30
1650988321641,MATH 142A,B02,083222,Chow; Bennett,0,14,30,30
1650988327664,MATH 193A,A01,083224,Staff,0,6,30,30
1650988327664,MATH 193A,A02,083225,Staff,0,7,30,30
1650988327664,MATH 193A,A03,083781,Staff,0,6,30,30
1650988327664,MATH 193A,A04,083782,Staff,0,7,30,30
1650988333693,MATH 197,001,091859,McAuley; Julian John,9998,0,9999,1
1650988339768,COGS 9,A01,083615,Staff,0,18,60,60
1650988345793,COGS 11,A01,083617,Boyle; Mary E. T.,15,0,40,25
1650988351818,COGS 13,A01,083071,Staff,0,41,40,40
1650988357843,COGS 14A,A01,092681,Staff,0,38,100,100
1650988363864,COGS 14B,A01,083073,Cheng; Tzu-Han,0,13,50,50
1650988369887,COGS 17,A01,092677,Staff,6,0,75,69
1650988375911,COGS 100,A01,083619,Staff,0,31,60,60
1650988381936,COGS 101A,A01,083621,Davis; Joshua Daniel,0,29,60,60
1650988387960,COGS 101B,A01,091572,Staff,0,5,60,60
1650988393984,COGS 101C,A01,083625,Delgado; Tania,14,0,30,16
1650988400019,COGS 107A,A01,083627,Boyle; Mary E. T.,0,16,60,60
1650988406045,COGS 118A,A01,083075,Staff,0,10,60,60
1650988412070,CSE 3,A50,083646,Miranda; Gregory Joseph,15,0,38,23
1650988412070,CSE 3,A51,083647,Miranda; Gregory Joseph,36,0,37,1
1650988418093,CSE 8A,A50,083650,Miranda; Gregory Joseph,0,31,40,40
1650988424117,CSE 11,A01,083080,Cao; Yingjun,0,97,40,40
1650988430147,CSE 12,A01,083652,Staff,0,24,100,100
1650988436171,CSE 15L,A01,083654,Staff,0,3,50,50
1650988436171,CSE 15L,A02,083655,Staff,0,3,50,50
1650988442198,CSE 20,A01,083657,Staff,47,0,80,33
1650988448221,CSE 30,A01,083084,Eldon; John,1,38,80,79
1650988454247,CSE 100,A01,083659,Cao; Yingjun,0,71,50,50
1650988460277,CSE 134B,A01,083661,Powell; Thomas Allan,1,40,65,64
1650988466299,CSE 140,A01,083663,Staff,0,13,75,75
1650988472324,CSE 140L,A01,083088,Eldon; John,4,0,100,96
1650988478352,CSE 175,A01,083665,Kumar; Rakesh,0,0,25,25
1650988484375,CSE 190,A00,092507,Dubnov; Shlomo,9,0,20,11
1650988490399,ECE 45,A01,083139,Staff,0,6,60,60
1650988496423,ECE 65,A50,083695,Staff,0,7,30,30
1650988502449,ECE 109,A01,091882,Touri; Behrouz,32,0,70,38
1650988508475,ECE 180,A00,083140,Abi Samra; Nicholas Camill,18,0,30,12
1650988508475,ECE 180,B00,083141,Abi Samra; Nicholas Camill,0,0,30,30
1650988514507,MATH 10A,A01,083735,Patchell; Gregory David,2,0,30,28
1650988514507,MATH 10A,A02,083736,Patchell; Gregory David,27,0,30,3
1650988514507,MATH 10A,A03,083737,Patchell; Gregory David,23,0,30,7
1650988520529,MATH 10B,A01,083207,Staff,0,9,30,30
1650988520529,MATH 10B,A02,083208,Staff,0,5,30,30
1650988520529,MATH 10B,B01,083739,Staff,9,0,30,21
1650988520529,MATH 10B,B02,083740,Staff,28,0,30,2
1650988526555,MATH 18,A01,083743,Staff,0,0,30,30
1650988526555,MATH 18,A02,083744,Staff,24,0,30,6
1650988526555,MATH 18,A03,083745,Staff,19,0,30,11
1650988526555,MATH 18,A04,083746,Staff,26,0,30,4
1650988526555,MATH 18,B01,083748,Staff,0,15,30,30
1650988526555,MATH 18,B02,083749,Staff,0,14,30,30
1650988526555,MATH 18,B03,083750,Staff,0,13,30,30
1650988526555,MATH 18,B04,083751,Staff,0,13,30,30
1650988532582,MATH 20A,A01,083754,Staff,19,0,40,21
1650988538607,MATH 20B,A01,083756,Staff,0,14,30,30
1650988538607,MATH 20B,A02,083757,Staff,0,11,30,30
1650988544631,MATH 20C,A01,083760,Staff,0,17,30,30
1650988544631,MATH 20C,A02,083761,Staff,0,15,30,30
1650988544631,MATH 20C,B01,083762,Staff,9,0,30,21
1650988544631,MATH 20C,B02,083763,Staff,28,0,30,2
1650988550666,MATH 20D,A01,083765,Staff,2,1,30,28
1650988550666,MATH 20D,A02,083766,Staff,2,0,30,28
1650988550666,MATH 20D,A03,083767,Staff,22,0,30,8
1650988556699,MATH 20E,A01,083771,Staff,2,0,30,28
1650988556699,MATH 20E,A02,083772,Staff,12,0,30,18
1650988556699,MATH 20E,B01,083773,Staff,0,0,30,30
1650988556699,MATH 20E,B02,083774,Staff,0,0,30,30
1650988562723,MATH 103A,A01,083777,Staff,0,17,30,30
1650988562723,MATH 103A,A02,083778,Staff,0,15,30,30
1650988562723,MATH 103A,B01,083779,Staff,0,15,30,30
1650988562723,MATH 103A,B02,083780,Staff,0,14,30,30
1650988568746,MATH 105,A01,085443,Staff,0,23,30,30
1650988574862,MATH 109,A01,083213,Anzaldo; Leesa B,0,8,30,30
1650988574862,MATH 109,A02,083214,Anzaldo; Leesa B,0,7,30,30
1650988574862,MATH 109,B01,083215,Anzaldo; Leesa B,0,8,30,30
1650988574862,MATH 109,B02,083216,Anzaldo; Leesa B,0,7,30,30
1650988580888,MATH 142A,A01,083219,Chow; Bennett,0,14,30,30
1650988580888,MATH 142A,A02,083220,Chow; Bennett,0,15,30,30
1650988580888,MATH 142A,B01,083221,Chow; Bennett,0,16,30,30
1650988580888,MATH 142A,B02,083222,Chow; Bennett,0,14,30,30
1650988586922,MATH 193A,A01,083224,Staff,0,6,30,30
1650988586922,MATH 193A,A02,083225,Staff,0,7,30,30
1650988586922,MATH 193A,A03,083781,Staff,0,6,30,30
1650988586922,MATH 193A,A04,083782,Staff,0,7,30,30
1650988592947,MATH 197,001,091859,McAuley; Julian John,9998,0,9999,1
1650988599005,COGS 9,A01,083615,Staff,0,18,60,60
1650988605036,COGS 11,A01,083617,Boyle; Mary E. T.,15,0,40,25
1650988611061,COGS 13,A01,083071,Staff,0,41,40,40
1650988617088,COGS 14A,A01,092681,Staff,0,38,100,100
1650988623113,COGS 14B,A01,083073,Cheng; Tzu-Han,0,13,50,50
1650988629138,COGS 17,A01,092677,Staff,6,0,75,69
1650988635160,COGS 100,A01,083619,Staff,0,31,60,60
1650988641185,COGS 101A,A01,083621,Davis; Joshua Daniel,0,29,60,60
1650988647209,COGS 101B,A01,091572,Staff,0,5,60,60
1650988653236,COGS 101C,A01,083625,Delgado; Tania,14,0,30,16
1650988659260,COGS 107A,A01,083627,Boyle; Mary E. T.,0,16,60,60
1650988665286,COGS 118A,A01,083075,Staff,0,10,60,60
1650988671316,CSE 3,A50,083646,Miranda; Gregory Joseph,15,0,38,23
1650988671316,CSE 3,A51,083647,Miranda; Gregory Joseph,36,0,37,1
1650988677345,CSE 8A,A50,083650,Miranda; Gregory Joseph,0,31,40,40
1650988683371,CSE 11,A01,083080,Cao; Yingjun,0,97,40,40
1650988689395,CSE 12,A01,083652,Staff,0,24,100,100
1650988695420,CSE 15L,A01,083654,Staff,0,3,50,50
1650988695420,CSE 15L,A02,083655,Staff,0,3,50,50
1650988701444,CSE 20,A01,083657,Staff,47,0,80,33
1650988707467,CSE 30,A01,083084,Eldon; John,1,38,80,79
1650988713495,CSE 100,A01,083659,Cao; Yingjun,0,71,50,50
1650988719521,CSE 134B,A01,083661,Powell; Thomas Allan,1,40,65,64
1650988725547,CSE 140,A01,083663,Staff,0,13,75,75
1650988731572,CSE 140L,A01,083088,Eldon; John,4,0,100,96
1650988737599,CSE 175,A01,083665,Kumar; Rakesh,0,0,25,25
1650988743626,CSE 190,A00,092507,Dubnov; Shlomo,9,0,20,11
1650988749651,ECE 45,A01,083139,Staff,0,6,60,60
1650988755689,ECE 65,A50,083695,Staff,0,7,30,30
1650988761712,ECE 109,A01,091882,Touri; Behrouz,32,0,70,38
1650988767743,ECE 180,A00,083140,Abi Samra; Nicholas Camill,18,0,30,12
1650988767743,ECE 180,B00,083141,Abi Samra; Nicholas Camill,0,0,30,30
1650988773766,MATH 10A,A01,083735,Patchell; Gregory David,2,0,30,28
1650988773766,MATH 10A,A02,083736,Patchell; Gregory David,27,0,30,3
1650988773766,MATH 10A,A03,083737,Patchell; Gregory David,23,0,30,7
1650988779790,MATH 10B,A01,083207,Staff,0,9,30,30
1650988779790,MATH 10B,A02,083208,Staff,0,5,30,30
1650988779790,MATH 10B,B01,083739,Staff,9,0,30,21
1650988779790,MATH 10B,B02,083740,Staff,28,0,30,2
1650988785823,MATH 18,A01,083743,Staff,0,0,30,30
1650988785823,MATH 18,A02,083744,Staff,24,0,30,6
1650988785823,MATH 18,A03,083745,Staff,19,0,30,11
1650988785823,MATH 18,A04,083746,Staff,26,0,30,4
1650988785823,MATH 18,B01,083748,Staff,0,15,30,30
1650988785823,MATH 18,B02,083749,Staff,0,14,30,30
1650988785823,MATH 18,B03,083750,Staff,0,13,30,30
1650988785823,MATH 18,B04,083751,Staff,0,13,30,30
1650988791852,MATH 20A,A01,083754,Staff,19,0,40,21
1650988797883,MATH 20B,A01,083756,Staff,0,14,30,30
1650988797883,MATH 20B,A02,083757,Staff,0,11,30,30
1650988803912,MATH 20C,A01,083760,Staff,0,17,30,30
1650988803912,MATH 20C,A02,083761,Staff,0,15,30,30
1650988803912,MATH 20C,B01,083762,Staff,9,0,30,21
1650988803912,MATH 20C,B02,083763,Staff,28,0,30,2
1650988809938,MATH 20D,A01,083765,Staff,2,1,30,28
1650988809938,MATH 20D,A02,083766,Staff,2,0,30,28
1650988809938,MATH 20D,A03,083767,Staff,22,0,30,8
1650988815963,MATH 20E,A01,083771,Staff,2,0,30,28
1650988815963,MATH 20E,A02,083772,Staff,12,0,30,18
1650988815963,MATH 20E,B01,083773,Staff,0,0,30,30
1650988815963,MATH 20E,B02,083774,Staff,0,0,30,30
1650988821990,MATH 103A,A01,083777,Staff,0,17,30,30
1650988821990,MATH 103A,A02,083778,Staff,0,15,30,30
1650988821990,MATH 103A,B01,083779,Staff,0,15,30,30
1650988821990,MATH 103A,B02,083780,Staff,0,14,30,30
1650988828017,MATH 105,A01,085443,Staff,0,23,30,30
1650988834038,MATH 109,A01,083213,Anzaldo; Leesa B,0,7,30,30
1650988834038,MATH 109,A02,083214,Anzaldo; Leesa B,0,7,30,30
1650988834038,MATH 109,B01,083215,Anzaldo; Leesa B,0,8,30,30
1650988834038,MATH 109,B02,083216,Anzaldo; Leesa B,0,7,30,30
1650988840077,MATH 142A,A01,083219,Chow; Bennett,0,14,30,30
1650988840077,MATH 142A,A02,083220,Chow; Bennett,0,15,30,30
1650988840077,MATH 142A,B01,083221,Chow; Bennett,0,16,30,30
1650988840077,MATH 142A,B02,083222,Chow; Bennett,0,14,30,30
1650988846100,MATH 193A,A01,083224,Staff,0,6,30,30
1650988846100,MATH 193A,A02,083225,Staff,0,7,30,30
1650988846100,MATH 193A,A03,083781,Staff,0,6,30,30
1650988846100,MATH 193A,A04,083782,Staff,0,7,30,30
1650988852122,MATH 197,001,091859,McAuley; Julian John,9998,0,9999,1
1650988858180,COGS 9,A01,083615,Staff,0,18,60,60
1650988864202,COGS 11,A01,083617,Boyle; Mary E. T.,15,0,40,25
1650988870225,COGS 13,A01,083071,Staff,0,41,40,40
1650988876262,COGS 14A,A01,092681,Staff,0,38,100,100
1650988882292,COGS 14B,A01,083073,Cheng; Tzu-Han,0,13,50,50
1650988888321,COGS 17,A01,092677,Staff,6,0,75,69
1650988894348,COGS 100,A01,083619,Staff,0,31,60,60
1650988900375,COGS 101A,A01,083621,Davis; Joshua Daniel,0,29,60,60
1650988906413,COGS 101B,A01,091572,Staff,0,5,60,60
1650988912438,COGS 101C,A01,083625,Delgado; Tania,14,0,30,16
1650988918460,COGS 107A,A01,083627,Boyle; Mary E. T.,0,16,60,60
1650988924487,COGS 118A,A01,083075,Staff,0,10,60,60
1650988930513,CSE 3,A50,083646,Miranda; Gregory Joseph,15,0,38,23
1650988930513,CSE 3,A51,083647,Miranda; Gregory Joseph,36,0,37,1
1650988936540,CSE 8A,A50,083650,Miranda; Gregory Joseph,0,31,40,40
1650988942565,CSE 11,A01,083080,Cao; Yingjun,0,97,40,40
1650988948588,CSE 12,A01,083652,Staff,0,24,100,100
1650988954621,CSE 15L,A01,083654,Staff,0,3,50,50
1650988954621,CSE 15L,A02,083655,Staff,0,3,50,50
1650988960646,CSE 20,A01,083657,Staff,47,0,80,33
1650988966670,CSE 30,A01,083084,Eldon; John,1,38,80,79
1650988972696,CSE 100,A01,083659,Cao; Yingjun,0,71,50,50
1650988978733,CSE 134B,A01,083661,Powell; Thomas Allan,1,40,65,64
1650988984757,CSE 140,A01,083663,Staff,0,13,75,75
1650988990780,CSE 140L,A01,083088,Eldon; John,4,0,100,96
1650988996818,CSE 175,A01,083665,Kumar; Rakesh,0,0,25,25
1650989002845,CSE 190,A00,092507,Dubnov; Shlomo,9,0,20,11
1650989008869,ECE 45,A01,083139,Staff,0,6,60,60
1650989014893,ECE 65,A50,083695,Staff,0,7,30,30
1650989020920,ECE 109,A01,091882,Touri; Behrouz,32,0,70,38
1650989026942,ECE 180,A00,083140,Abi Samra; Nicholas Camill,18,0,30,12
1650989026942,ECE 180,B00,083141,Abi Samra; Nicholas Camill,0,0,30,30
1650989032965,MATH 10A,A01,083735,Patchell; Gregory David,2,0,30,28
1650989032965,MATH 10A,A02,083736,Patchell; Gregory David,27,0,30,3
1650989032965,MATH 10A,A03,083737,Patchell; Gregory David,23,0,30,7
1650989038989,MATH 10B,A01,083207,Staff,0,9,30,30
1650989038989,MATH 10B,A02,083208,Staff,0,5,30,30
1650989038989,MATH 10B,B01,083739,Staff,9,0,30,21
1650989038989,MATH 10B,B02,083740,Staff,28,0,30,2
1650989045013,MATH 18,A01,083743,Staff,0,0,30,30
1650989045013,MATH 18,A02,083744,Staff,24,0,30,6
1650989045013,MATH 18,A03,083745,Staff,19,0,30,11
1650989045013,MATH 18,A04,083746,Staff,26,0,30,4
1650989045013,MATH 18,B01,083748,Staff,0,15,30,30
1650989045013,MATH 18,B02,083749,Staff,0,14,30,30
1650989045013,MATH 18,B03,083750,Staff,0,13,30,30
1650989045013,MATH 18,B04,083751,Staff,0,13,30,30
1650989051041,MATH 20A,A01,083754,Staff,19,0,40,21
1650989057068,MATH 20B,A01,083756,Staff,0,14,30,30
1650989057068,MATH 20B,A02,083757,Staff,0,11,30,30
1650989063093,MATH 20C,A01,083760,Staff,0,17,30,30
1650989063093,MATH 20C,A02,083761,Staff,0,15,30,30
1650989063093,MATH 20C,B01,083762,Staff,9,0,30,21
1650989063093,MATH 20C,B02,083763,Staff,28,0,30,2
1650989069125,MATH 20D,A01,083765,Staff,2,1,30,28
1650989069125,MATH 20D,A02,083766,Staff,2,0,30,28
1650989069125,MATH 20D,A03,083767,Staff,22,0,30,8
1650989075151,MATH 20E,A01,083771,Staff,2,0,30,28
1650989075151,MATH 20E,A02,083772,Staff,12,0,30,18
1650989075151,MATH 20E,B01,083773,Staff,0,0,30,30
1650989075151,MATH 20E,B02,083774,Staff,0,0,30,30
1650989081175,MATH 103A,A01,083777,Staff,0,17,30,30
1650989081175,MATH 103A,A02,083778,Staff,0,15,30,30
1650989081175,MATH 103A,B01,083779,Staff,0,15,30,30
1650989081175,MATH 103A,B02,083780,Staff,0,14,30,30
1650989087208,MATH 105,A01,085443,Staff,0,23,30,30
1650989093251,MATH 109,A01,083213,Anzaldo; Leesa B,0,7,30,30
1650989093251,MATH 109,A02,083214,Anzaldo; Leesa B,0,7,30,30
1650989093251,MATH 109,B01,083215,Anzaldo; Leesa B,0,8,30,30
1650989093251,MATH 109,B02,083216,Anzaldo; Leesa B,0,7,30,30
1650989099273,MATH 142A,A01,083219,Chow; Bennett,0,14,30,30
1650989099273,MATH 142A,A02,083220,Chow; Bennett,0,15,30,30
1650989099273,MATH 142A,B01,083221,Chow; Bennett,0,16,30,30
1650989099273,MATH 142A,B02,083222,Chow; Bennett,0,14,30,30
1650989105302,MATH 193A,A01,083224,Staff,0,6,30,30
1650989105302,MATH 193A,A02,083225,Staff,0,7,30,30
1650989105302,MATH 193A,A03,083781,Staff,0,6,30,30
1650989105302,MATH 193A,A04,083782,Staff,0,7,30,30
1650989111326,MATH 197,001,091859,McAuley; Julian John,9998,0,9999,1
1650989117387,COGS 9,A01,083615,Staff,0,18,60,60
1650989123414,COGS 11,A01,083617,Boyle; Mary E. T.,15,0,40,25
1650989129439,COGS 13,A01,083071,Staff,0,41,40,40
1650989135462,COGS 14A,A01,092681,Staff,0,38,100,100
1650989141487,COGS 14B,A01,083073,Cheng; Tzu-Han,0,13,50,50
1650989147508,COGS 17,A01,092677,Staff,6,0,75,69
1650989153531,COGS 100,A01,083619,Staff,0,31,60,60
1650989159554,COGS 101A,A01,083621,Davis; Joshua Daniel,0,29,60,60
1650989165677,COGS 101B,A01,091572,Staff,0,5,60,60
1650989171721,COGS 101C,A01,083625,Delgado; Tania,14,0,30,16
1650989177744,COGS 107A,A01,083627,Boyle; Mary E. T.,0,16,60,60
1650989183767,COGS 118A,A01,083075,Staff,0,10,60,60
1650989189810,CSE 3,A50,083646,Miranda; Gregory Joseph,15,0,38,23
1650989189810,CSE 3,A51,083647,Miranda; Gregory Joseph,36,0,37,1
1650989195834,CSE 8A,A50,083650,Miranda; Gregory Joseph,0,31,40,40
1650989201874,CSE 11,A01,083080,Cao; Yingjun,0,97,40,40
1650989207900,CSE 12,A01,083652,Staff,0,24,100,100
1650989213922,CSE 15L,A01,083654,Staff,0,3,50,50
1650989213922,CSE 15L,A02,083655,Staff,0,3,50,50
1650989219956,CSE 20,A01,083657,Staff,47,0,80,33
1650989225979,CSE 30,A01,083084,Eldon; John,1,38,80,79
1650989232002,CSE 100,A01,083659,Cao; Yingjun,0,71,50,50
1650989238038,CSE 134B,A01,083661,Powell; Thomas Allan,1,40,65,64
1650989244061,CSE 140,A01,083663,Staff,0,13,75,75
1650989250089,CSE 140L,A01,083088,Eldon; John,4,0,100,96
1650989256113,CSE 175,A01,083665,Kumar; Rakesh,0,0,25,25
1650989262137,CSE 190,A00,092507,Dubnov; Shlomo,9,0,20,11
1650989268162,ECE 45,A01,083139,Staff,0,6,60,60
1650989274189,ECE 65,A50,083695,Staff,0,7,30,30
1650989280231,ECE 109,A01,091882,Touri; Behrouz,32,0,70,38
1650989286257,ECE 180,A00,083140,Abi Samra; Nicholas Camill,18,0,30,12
1650989286257,ECE 180,B00,083141,Abi Samra; Nicholas Camill,0,0,30,30
1650989292291,MATH 10A,A01,083735,Patchell; Gregory David,2,0,30,28
1650989292291,MATH 10A,A02,083736,Patchell; Gregory David,27,0,30,3
1650989292291,MATH 10A,A03,083737,Patchell; Gregory David,23,0,30,7
1650989298319,MATH 10B,A01,083207,Staff,0,9,30,30
1650989298319,MATH 10B,A02,083208,Staff,0,5,30,30
1650989298319,MATH 10B,B01,083739,Staff,9,0,30,21
1650989298319,MATH 10B,B02,083740,Staff,28,0,30,2
1650989304345,MATH 18,A01,083743,Staff,0,0,30,30
1650989304345,MATH 18,A02,083744,Staff,24,0,30,6
1650989304345,MATH 18,A03,083745,Staff,19,0,30,11
1650989304345,MATH 18,A04,083746,Staff,26,0,30,4
1650989304345,MATH 18,B01,083748,Staff,0,15,30,30
1650989304345,MATH 18,B02,083749,Staff,0,14,30,30
1650989304345,MATH 18,B03,083750,Staff,0,13,30,30
1650989304345,MATH 18,B04,083751,Staff,0,13,30,30
1650989310370,MATH 20A,A01,083754,Staff,19,0,40,21
1650989316396,MATH 20B,A01,083756,Staff,0,14,30,30
1650989316396,MATH 20B,A02,083757,Staff,0,11,30,30
1650989322419,MATH 20C,A01,083760,Staff,0,17,30,30
1650989322419,MATH 20C,A02,083761,Staff,0,15,30,30
1650989322419,MATH 20C,B01,083762,Staff,9,0,30,21
1650989322419,MATH 20C,B02,083763,Staff,28,0,30,2
1650989328442,MATH 20D,A01,083765,Staff,2,1,30,28
1650989328442,MATH 20D,A02,083766,Staff,2,0,30,28
1650989328442,MATH 20D,A03,083767,Staff,22,0,30,8
1650989334470,MATH 20E,A01,083771,Staff,2,0,30,28
1650989334470,MATH 20E,A02,083772,Staff,12,0,30,18
1650989334470,MATH 20E,B01,083773,Staff,0,0,30,30
1650989334470,MATH 20E,B02,083774,Staff,0,0,30,30
1650989340494,MATH 103A,A01,083777,Staff,0,17,30,30
1650989340494,MATH 103A,A02,083778,Staff,0,15,30,30
1650989340494,MATH 103A,B01,083779,Staff,0,15,30,30
1650989340494,MATH 103A,B02,083780,Staff,0,14,30,30
1650989346521,MATH 105,A01,085443,Staff,0,23,30,30
1650989352545,MATH 109,A01,083213,Anzaldo; Leesa B,0,7,30,30
1650989352545,MATH 109,A02,083214,Anzaldo; Leesa B,0,7,30,30
1650989352545,MATH 109,B01,083215,Anzaldo; Leesa B,0,8,30,30
1650989352545,MATH 109,B02,083216,Anzaldo; Leesa B,0,7,30,30
1650989358569,MATH 142A,A01,083219,Chow; Bennett,0,14,30,30
1650989358569,MATH 142A,A02,083220,Chow; Bennett,0,15,30,30
1650989358569,MATH 142A,B01,083221,Chow; Bennett,0,16,30,30
1650989358569,MATH 142A,B02,083222,Chow; Bennett,0,14,30,30
1650989364597,MATH 193A,A01,083224,Staff,0,6,30,30
1650989364597,MATH 193A,A02,083225,Staff,0,7,30,30
1650989364597,MATH 193A,A03,083781,Staff,0,6,30,30
1650989364597,MATH 193A,A04,083782,Staff,0,7,30,30
1650989370622,MATH 197,001,091859,McAuley; Julian John,9998,0,9999,1
1650989376677,COGS 9,A01,083615,Staff,0,18,60,60
1650989382701,COGS 11,A01,083617,Boyle; Mary E. T.,15,0,40,25
1650989388735,COGS 13,A01,083071,Staff,0,41,40,40
1650989394758,COGS 14A,A01,092681,Staff,0,38,100,100
1650989400781,COGS 14B,A01,083073,Cheng; Tzu-Han,0,13,50,50
1650989406804,COGS 17,A01,092677,Staff,6,0,75,69
1650989412832,COGS 100,A01,083619,Staff,0,31,60,60
1650989418855,COGS 101A,A01,083621,Davis; Joshua Daniel,0,29,60,60
1650989424888,COGS 101B,A01,091572,Staff,0,5,60,60
1650989430921,COGS 101C,A01,083625,Delgado; Tania,14,0,30,16
1650989436943,COGS 107A,A01,083627,Boyle; Mary E. T.,0,16,60,60
1650989457394,COGS 118A,A01,083075,Staff,0,10,60,60
1650989463418,CSE 3,A50,083646,Miranda; Gregory Joseph,15,0,38,23
1650989463418,CSE 3,A51,083647,Miranda; Gregory Joseph,36,0,37,1
1650989469446,CSE 8A,A50,083650,Miranda; Gregory Joseph,0,31,40,40
1650989475475,CSE 11,A01,083080,Cao; Yingjun,0,97,40,40
1650989481498,CSE 12,A01,083652,Staff,0,24,100,100
1650989487520,CSE 15L,A01,083654,Staff,0,3,50,50
1650989487520,CSE 15L,A02,083655,Staff,0,3,50,50
1650989493542,CSE 20,A01,083657,Staff,47,0,80,33
1650989499568,CSE 30,A01,083084,Eldon; John,1,38,80,79
1650989505591,CSE 100,A01,083659,Cao; Yingjun,0,71,50,50
1650989511615,CSE 134B,A01,083661,Powell; Thomas Allan,1,40,65,64
1650989517642,CSE 140,A01,083663,Staff,0,13,75,75
1650989523669,CSE 140L,A01,083088,Eldon; John,4,0,100,96
1650989529696,CSE 175,A01,083665,Kumar; Rakesh,0,0,25,25
1650989535719,CSE 190,A00,092507,Dubnov; Shlomo,9,0,20,11
1650989541748,ECE 45,A01,083139,Staff,0,6,60,60
1650989547770,ECE 65,A50,083695,Staff,0,7,30,30
1650989553798,ECE 109,A01,091882,Touri; Behrouz,32,0,70,38
1650989559824,ECE 180,A00,083140,Abi Samra; Nicholas Camill,18,0,30,12
1650989559824,ECE 180,B00,083141,Abi Samra; Nicholas Camill,0,0,30,30
1650989565848,MATH 10A,A01,083735,Patchell; Gregory David,2,0,30,28
1650989565848,MATH 10A,A02,083736,Patchell; Gregory David,27,0,30,3
1650989565848,MATH 10A,A03,083737,Patchell; Gregory David,23,0,30,7
1650989571871,MATH 10B,A01,083207,Staff,0,9,30,30
1650989571871,MATH 10B,A02,083208,Staff,0,5,30,30
1650989571871,MATH 10B,B01,083739,Staff,9,0,30,21
1650989571871,MATH 10B,B02,083740,Staff,28,0,30,2
1650989577899,MATH 18,A01,083743,Staff,0,0,30,30
1650989577899,MATH 18,A02,083744,Staff,24,0,30,6
1650989577899,MATH 18,A03,083745,Staff,19,0,30,11
1650989577899,MATH 18,A04,083746,Staff,26,0,30,4
1650989577899,MATH 18,B01,083748,Staff,0,15,30,30
1650989577899,MATH 18,B02,083749,Staff,0,14,30,30
1650989577899,MATH 18,B03,083750,Staff,0,13,30,30
1650989577899,MATH 18,B04,083751,Staff,0,13,30,30
1650989583924,MATH 20A,A01,083754,Staff,19,0,40,21
1650989589957,MATH 20B,A01,083756,Staff,0,14,30,30
1650989589957,MATH 20B,A02,083757,Staff,0,11,30,30
1650989595979,MATH 20C,A01,083760,Staff,0,17,30,30
1650989595979,MATH 20C,A02,083761,Staff,0,15,30,30
1650989595979,MATH 20C,B01,083762,Staff,9,0,30,21
1650989595979,MATH 20C,B02,083763,Staff,28,0,30,2
1650989602006,MATH 20D,A01,083765,Staff,2,1,30,28
1650989602006,MATH 20D,A02,083766,Staff,2,0,30,28
1650989602006,MATH 20D,A03,083767,Staff,22,0,30,8
1650989608042,MATH 20E,A01,083771,Staff,2,0,30,28
1650989608042,MATH 20E,A02,083772,Staff,12,0,30,18
1650989608042,MATH 20E,B01,083773,Staff,0,0,30,30
1650989608042,MATH 20E,B02,083774,Staff,0,0,30,30
1650989614065,MATH 103A,A01,083777,Staff,0,17,30,30
1650989614065,MATH 103A,A02,083778,Staff,0,15,30,30
1650989614065,MATH 103A,B01,083779,Staff,0,15,30,30
1650989614065,MATH 103A,B02,083780,Staff,0,14,30,30
1650989620089,MATH 105,A01,085443,Staff,0,23,30,30
1650989626120,MATH 109,A01,083213,Anzaldo; Leesa B,0,7,30,30
1650989626120,MATH 109,A02,083214,Anzaldo; Leesa B,0,7,30,30
1650989626120,MATH 109,B01,083215,Anzaldo; Leesa B,0,8,30,30
1650989626120,MATH 109,B02,083216,Anzaldo; Leesa B,0,7,30,30
1650989632143,MATH 142A,A01,083219,Chow; Bennett,0,14,30,30
1650989632143,MATH 142A,A02,083220,Chow; Bennett,0,15,30,30
1650989632143,MATH 142A,B01,083221,Chow; Bennett,0,16,30,30
1650989632143,MATH 142A,B02,083222,Chow; Bennett,0,14,30,30
1650989638181,MATH 193A,A01,083224,Staff,0,6,30,30
1650989638181,MATH 193A,A02,083225,Staff,0,7,30,30
1650989638181,MATH 193A,A03,083781,Staff,0,6,30,30
1650989638181,MATH 193A,A04,083782,Staff,0,7,30,30
1650989644211,MATH 197,001,091859,McAuley; Julian John,9998,0,9999,1
1650989650281,COGS 9,A01,083615,Staff,0,18,60,60
1650989656315,COGS 11,A01,083617,Boyle; Mary E. T.,15,0,40,25
1650989662343,COGS 13,A01,083071,Staff,0,41,40,40
1650989668370,COGS 14A,A01,092681,Staff,0,38,100,100
1650989674398,COGS 14B,A01,083073,Cheng; Tzu-Han,0,13,50,50
1650989680420,COGS 17,A01,092677,Staff,5,0,75,70
1650989686443,COGS 100,A01,083619,Staff,0,31,60,60
1650989692469,COGS 101A,A01,083621,Davis; Joshua Daniel,0,29,60,60
1650989698495,COGS 101B,A01,091572,Staff,0,5,60,60
1650989704518,COGS 101C,A01,083625,Delgado; Tania,14,0,30,16
1650989710548,COGS 107A,A01,083627,Boyle; Mary E. T.,0,16,60,60
1650989716574,COGS 118A,A01,083075,Staff,0,10,60,60
1650989722598,CSE 3,A50,083646,Miranda; Gregory Joseph,15,0,38,23
1650989722598,CSE 3,A51,083647,Miranda; Gregory Joseph,36,0,37,1
1650989728625,CSE 8A,A50,083650,Miranda; Gregory Joseph,0,31,40,40
1650989734646,CSE 11,A01,083080,Cao; Yingjun,0,97,40,40
1650989740680,CSE 12,A01,083652,Staff,0,24,100,100
1650989746704,CSE 15L,A01,083654,Staff,0,3,50,50
1650989746704,CSE 15L,A02,083655,Staff,0,3,50,50
1650989752727,CSE 20,A01,083657,Staff,47,0,80,33
1650989758751,CSE 30,A01,083084,Eldon; John,1,38,80,79
1650989764784,CSE 100,A01,083659,Cao; Yingjun,0,71,50,50
1650989770811,CSE 134B,A01,083661,Powell; Thomas Allan,1,40,65,64
1650989776927,CSE 140,A01,083663,Staff,0,13,75,75
1650989782956,CSE 140L,A01,083088,Eldon; John,4,0,100,96
1650989788982,CSE 175,A01,083665,Kumar; Rakesh,0,0,25,25
1650989795010,CSE 190,A00,092507,Dubnov; Shlomo,9,0,20,11
1650989801042,ECE 45,A01,083139,Staff,0,6,60,60
1650989807072,ECE 65,A50,083695,Staff,0,7,30,30
1650989813099,ECE 109,A01,091882,Touri; Behrouz,32,0,70,38
1650989819128,ECE 180,A00,083140,Abi Samra; Nicholas Camill,18,0,30,12
1650989819128,ECE 180,B00,083141,Abi Samra; Nicholas Camill,0,0,30,30
1650989825151,MATH 10A,A01,083735,Patchell; Gregory David,2,0,30,28
1650989825151,MATH 10A,A02,083736,Patchell; Gregory David,27,0,30,3
1650989825151,MATH 10A,A03,083737,Patchell; Gregory David,23,0,30,7
1650989831175,MATH 10B,A01,083207,Staff,0,9,30,30
1650989831175,MATH 10B,A02,083208,Staff,0,5,30,30
1650989831175,MATH 10B,B01,083739,Staff,9,0,30,21
1650989831175,MATH 10B,B02,083740,Staff,28,0,30,2
1650989837205,MATH 18,A01,083743,Staff,0,0,30,30
1650989837205,MATH 18,A02,083744,Staff,24,0,30,6
1650989837205,MATH 18,A03,083745,Staff,19,0,30,11
1650989837205,MATH 18,A04,083746,Staff,26,0,30,4
1650989837205,MATH 18,B01,083748,Staff,0,15,30,30
1650989837205,MATH 18,B02,083749,Staff,0,14,30,30
1650989837205,MATH 18,B03,083750,Staff,0,13,30,30
1650989837205,MATH 18,B04,083751,Staff,0,13,30,30
1650989843229,MATH 20A,A01,083754,Staff,19,0,40,21
1650989849256,MATH 20B,A01,083756,Staff,0,14,30,30
1650989849256,MATH 20B,A02,083757,Staff,0,11,30,30
1650989855278,MATH 20C,A01,083760,Staff,0,17,30,30
1650989855278,MATH 20C,A02,083761,Staff,0,15,30,30
1650989855278,MATH 20C,B01,083762,Staff,9,0,30,21
1650989855278,MATH 20C,B02,083763,Staff,28,0,30,2
1650989861301,MATH 20D,A01,083765,Staff,2,1,30,28
1650989861301,MATH 20D,A02,083766,Staff,2,0,30,28
1650989861301,MATH 20D,A03,083767,Staff,22,0,30,8
1650989867330,MATH 20E,A01,083771,Staff,2,0,30,28
1650989867330,MATH 20E,A02,083772,Staff,12,0,30,18
1650989867330,MATH 20E,B01,083773,Staff,0,0,30,30
1650989867330,MATH 20E,B02,083774,Staff,0,0,30,30
1650989873359,MATH 103A,A01,083777,Staff,0,17,30,30
1650989873359,MATH 103A,A02,083778,Staff,0,15,30,30
1650989873359,MATH 103A,B01,083779,Staff,0,15,30,30
1650989873359,MATH 103A,B02,083780,Staff,0,14,30,30
1650989879384,MATH 105,A01,085443,Staff,0,23,30,30
1650989885411,MATH 109,A01,083213,Anzaldo; Leesa B,0,7,30,30
1650989885411,MATH 109,A02,083214,Anzaldo; Leesa B,0,7,30,30
1650989885411,MATH 109,B01,083215,Anzaldo; Leesa B,0,8,30,30
1650989885411,MATH 109,B02,083216,Anzaldo; Leesa B,0,7,30,30
1650989891436,MATH 142A,A01,083219,Chow; Bennett,0,14,30,30
1650989891436,MATH 142A,A02,083220,Chow; Bennett,0,15,30,30
1650989891436,MATH 142A,B01,083221,Chow; Bennett,0,16,30,30
1650989891436,MATH 142A,B02,083222,Chow; Bennett,0,14,30,30
1650989897462,MATH 193A,A01,083224,Staff,0,6,30,30
1650989897462,MATH 193A,A02,083225,Staff,0,7,30,30
1650989897462,MATH 193A,A03,083781,Staff,0,6,30,30
1650989897462,MATH 193A,A04,083782,Staff,0,7,30,30
1650989903491,MATH 197,001,091859,McAuley; Julian John,9998,0,9999,1
1650989909547,COGS 9,A01,083615,Staff,0,18,60,60
1650989915582,COGS 11,A01,083617,Boyle; Mary E. T.,15,0,40,25
1650989921605,COGS 13,A01,083071,Staff,0,41,40,40
1650989927632,COGS 14A,A01,092681,Staff,0,38,100,100
1650989933656,COGS 14B,A01,083073,Cheng; Tzu-Han,0,13,50,50
1650989939681,COGS 17,A01,092677,Staff,5,0,75,70
1650989945705,COGS 100,A01,083619,Staff,0,31,60,60
1650989951728,COGS 101A,A01,083621,Davis; Joshua Daniel,0,29,60,60
1650989957752,COGS 101B,A01,091572,Staff,0,5,60,60
1650989963775,COGS 101C,A01,083625,Delgado; Tania,14,0,30,16
1650989969799,COGS 107A,A01,083627,Boyle; Mary E. T.,0,16,60,60
1650989975825,COGS 118A,A01,083075,Staff,0,10,60,60
1650989981851,CSE 3,A50,083646,Miranda; Gregory Joseph,15,0,38,23
1650989981851,CSE 3,A51,083647,Miranda; Gregory Joseph,36,0,37,1
1650989987888,CSE 8A,A50,083650,Miranda; Gregory Joseph,0,31,40,40
1650989993915,CSE 11,A01,083080,Cao; Yingjun,0,97,40,40
1650989999942,CSE 12,A01,083652,Staff,0,24,100,100
1650990005971,CSE 15L,A01,083654,Staff,0,3,50,50
1650990005971,CSE 15L,A02,083655,Staff,0,3,50,50
1650990011994,CSE 20,A01,083657,Staff,47,0,80,33
1650990018024,CSE 30,A01,083084,Eldon; John,1,38,80,79
1650990024047,CSE 100,A01,083659,Cao; Yingjun,0,71,50,50
1650990030073,CSE 134B,A01,083661,Powell; Thomas Allan,1,40,65,64
1650990036095,CSE 140,A01,083663,Staff,0,13,75,75
1650990042126,CSE 140L,A01,083088,Eldon; John,4,0,100,96
1650990048153,CSE 175,A01,083665,Kumar; Rakesh,0,0,25,25
1650990054189,CSE 190,A00,092507,Dubnov; Shlomo,9,0,20,11
1650990060214,ECE 45,A01,083139,Staff,0,7,60,60
1650990066242,ECE 65,A50,083695,Staff,0,7,30,30
1650990072266,ECE 109,A01,091882,Touri; Behrouz,32,0,70,38
1650990078290,ECE 180,A00,083140,Abi Samra; Nicholas Camill,18,0,30,12
1650990078290,ECE 180,B00,083141,Abi Samra; Nicholas Camill,0,0,30,30
1650990084313,MATH 10A,A01,083735,Patchell; Gregory David,2,0,30,28
1650990084313,MATH 10A,A02,083736,Patchell; Gregory David,27,0,30,3
1650990084313,MATH 10A,A03,083737,Patchell; Gregory David,23,0,30,7
1650990090351,MATH 10B,A01,083207,Staff,0,9,30,30
1650990090351,MATH 10B,A02,083208,Staff,0,5,30,30
1650990090351,MATH 10B,B01,083739,Staff,9,0,30,21
1650990090351,MATH 10B,B02,083740,Staff,28,0,30,2
1650990096379,MATH 18,A01,083743,Staff,0,0,30,30
1650990096379,MATH 18,A02,083744,Staff,24,0,30,6
1650990096379,MATH 18,A03,083745,Staff,19,0,30,11
1650990096379,MATH 18,A04,083746,Staff,26,0,30,4
1650990096379,MATH 18,B01,083748,Staff,0,15,30,30
1650990096379,MATH 18,B02,083749,Staff,0,14,30,30
1650990096379,MATH 18,B03,083750,Staff,0,13,30,30
1650990096379,MATH 18,B04,083751,Staff,0,13,30,30
1650990102405,MATH 20A,A01,083754,Staff,19,0,40,21
1650990108427,MATH 20B,A01,083756,Staff,0,14,30,30
1650990108427,MATH 20B,A02,083757,Staff,0,11,30,30
1650990114453,MATH 20C,A01,083760,Staff,0,17,30,30
1650990114453,MATH 20C,A02,083761,Staff,0,15,30,30
1650990114453,MATH 20C,B01,083762,Staff,9,0,30,21
1650990114453,MATH 20C,B02,083763,Staff,28,0,30,2
1650990120476,MATH 20D,A01,083765,Staff,2,1,30,28
1650990120476,MATH 20D,A02,083766,Staff,1,0,30,29
1650990120476,MATH 20D,A03,083767,Staff,22,0,30,8
1650990126502,MATH 20E,A01,083771,Staff,2,0,30,28
1650990126502,MATH 20E,A02,083772,Staff,12,0,30,18
1650990126502,MATH 20E,B01,083773,Staff,0,0,30,30
1650990126502,MATH 20E,B02,083774,Staff,0,0,30,30
1650990132527,MATH 103A,A01,083777,Staff,0,17,30,30
1650990132527,MATH 103A,A02,083778,Staff,0,15,30,30
1650990132527,MATH 103A,B01,083779,Staff,0,15,30,30
1650990132527,MATH 103A,B02,083780,Staff,0,14,30,30
1650990138554,MATH 105,A01,085443,Staff,0,23,30,30
1650990144577,MATH 109,A01,083213,Anzaldo; Leesa B,0,7,30,30
1650990144577,MATH 109,A02,083214,Anzaldo; Leesa B,0,7,30,30
1650990144577,MATH 109,B01,083215,Anzaldo; Leesa B,0,8,30,30
1650990144577,MATH 109,B02,083216,Anzaldo; Leesa B,0,7,30,30
1650990150613,MATH 142A,A01,083219,Chow; Bennett,0,14,30,30
1650990150613,MATH 142A,A02,083220,Chow; Bennett,0,15,30,30
1650990150613,MATH 142A,B01,083221,Chow; Bennett,0,16,30,30
1650990150613,MATH 142A,B02,083222,Chow; Bennett,0,14,30,30
1650990156641,MATH 193A,A01,083224,Staff,0,6,30,30
1650990156641,MATH 193A,A02,083225,Staff,0,7,30,30
1650990156641,MATH 193A,A03,083781,Staff,0,6,30,30
1650990156641,MATH 193A,A04,083782,Staff,0,7,30,30
1650990162668,MATH 197,001,091859,McAuley; Julian John,9998,0,9999,1
1650990168736,COGS 9,A01,083615,Staff,0,18,60,60
1650990174770,COGS 11,A01,083617,Boyle; Mary E. T.,15,0,40,25
1650990180808,COGS 13,A01,083071,Staff,0,41,40,40
1650990186833,COGS 14A,A01,092681,Staff,0,38,100,100
1650990192865,COGS 14B,A01,083073,Cheng; Tzu-Han,0,13,50,50
1650990198895,COGS 17,A01,092677,Staff,6,0,75,69
1650990204926,COGS 100,A01,083619,Staff,0,31,60,60
1650990210947,COGS 101A,A01,083621,Davis; Joshua Daniel,0,29,60,60
1650990216982,COGS 101B,A01,091572,Staff,0,5,60,60
1650990223011,COGS 101C,A01,083625,Delgado; Tania,14,0,30,16
1650990229038,COGS 107A,A01,083627,Boyle; Mary E. T.,0,16,60,60
1650990235061,COGS 118A,A01,083075,Staff,0,10,60,60
1650990241087,CSE 3,A50,083646,Miranda; Gregory Joseph,15,0,38,23
1650990241087,CSE 3,A51,083647,Miranda; Gregory Joseph,36,0,37,1
1650990247119,CSE 8A,A50,083650,Miranda; Gregory Joseph,0,31,40,40
1650990253145,CSE 11,A01,083080,Cao; Yingjun,0,97,40,40
1650990259174,CSE 12,A01,083652,Staff,0,24,100,100
1650990265196,CSE 15L,A01,083654,Staff,0,3,50,50
1650990265196,CSE 15L,A02,083655,Staff,0,3,50,50
1650990271234,CSE 20,A01,083657,Staff,47,0,80,33
1650990277260,CSE 30,A01,083084,Eldon; John,1,38,80,79
1650990283290,CSE 100,A01,083659,Cao; Yingjun,0,71,50,50
1650990289315,CSE 134B,A01,083661,Powell; Thomas Allan,1,40,65,64
1650990295341,CSE 140,A01,083663,Staff,0,13,75,75
1650990301373,CSE 140L,A01,083088,Eldon; John,4,0,100,96
1650990307398,CSE 175,A01,083665,Kumar; Rakesh,0,0,25,25
1650990313420,CSE 190,A00,092507,Dubnov; Shlomo,9,0,20,11
1650990319445,ECE 45,A01,083139,Staff,0,7,60,60
1650990325473,ECE 65,A50,083695,Staff,0,7,30,30
1650990331495,ECE 109,A01,091882,Touri; Behrouz,32,0,70,38
1650990337521,ECE 180,A00,083140,Abi Samra; Nicholas Camill,18,0,30,12
1650990337521,ECE 180,B00,083141,Abi Samra; Nicholas Camill,0,0,30,30
1650990343546,MATH 10A,A01,083735,Patchell; Gregory David,2,0,30,28
1650990343546,MATH 10A,A02,083736,Patchell; Gregory David,27,0,30,3
1650990343546,MATH 10A,A03,083737,Patchell; Gregory David,23,0,30,7
1650990349582,MATH 10B,A01,083207,Staff,0,9,30,30
1650990349582,MATH 10B,A02,083208,Staff,0,5,30,30
1650990349582,MATH 10B,B01,083739,Staff,9,0,30,21
1650990349582,MATH 10B,B02,083740,Staff,28,0,30,2
1650990355608,MATH 18,A01,083743,Staff,0,0,30,30
1650990355608,MATH 18,A02,083744,Staff,24,0,30,6
1650990355608,MATH 18,A03,083745,Staff,19,0,30,11
1650990355608,MATH 18,A04,083746,Staff,26,0,30,4
1650990355608,MATH 18,B01,083748,Staff,0,15,30,30
1650990355608,MATH 18,B02,083749,Staff,0,14,30,30
1650990355608,MATH 18,B03,083750,Staff,0,13,30,30
1650990355608,MATH 18,B04,083751,Staff,0,13,30,30
1650990361630,MATH 20A,A01,083754,Staff,19,0,40,21
1650990367668,MATH 20B,A01,083756,Staff,0,14,30,30
1650990367668,MATH 20B,A02,083757,Staff,0,11,30,30
1650990373797,MATH 20C,A01,083760,Staff,0,17,30,30
1650990373797,MATH 20C,A02,083761,Staff,0,15,30,30
1650990373797,MATH 20C,B01,083762,Staff,9,0,30,21
1650990373797,MATH 20C,B02,083763,Staff,28,0,30,2
1650990379825,MATH 20D,A01,083765,Staff,2,1,30,28
1650990379825,MATH 20D,A02,083766,Staff,1,0,30,29
1650990379825,MATH 20D,A03,083767,Staff,22,0,30,8
1650990385849,MATH 20E,A01,083771,Staff,2,0,30,28
1650990385849,MATH 20E,A02,083772,Staff,12,0,30,18
1650990385849,MATH 20E,B01,083773,Staff,0,0,30,30
1650990385849,MATH 20E,B02,083774,Staff,0,0,30,30
1650990391872,MATH 103A,A01,083777,Staff,0,17,30,30
1650990391872,MATH 103A,A02,083778,Staff,0,15,30,30
1650990391872,MATH 103A,B01,083779,Staff,0,15,30,30
1650990391872,MATH 103A,B02,083780,Staff,0,14,30,30
1650990397895,MATH 105,A01,085443,Staff,0,23,30,30
1650990403922,MATH 109,A01,083213,Anzaldo; Leesa B,0,7,30,30
1650990403922,MATH 109,A02,083214,Anzaldo; Leesa B,0,7,30,30
1650990403922,MATH 109,B01,083215,Anzaldo; Leesa B,0,8,30,30
1650990403922,MATH 109,B02,083216,Anzaldo; Leesa B,0,7,30,30
1650990409954,MATH 142A,A01,083219,Chow; Bennett,0,14,30,30
1650990409954,MATH 142A,A02,083220,Chow; Bennett,0,15,30,30
1650990409954,MATH 142A,B01,083221,Chow; Bennett,0,16,30,30
1650990409954,MATH 142A,B02,083222,Chow; Bennett,0,14,30,30
1650990415989,MATH 193A,A01,083224,Staff,0,6,30,30
1650990415989,MATH 193A,A02,083225,Staff,0,7,30,30
1650990415989,MATH 193A,A03,083781,Staff,0,6,30,30
1650990415989,MATH 193A,A04,083782,Staff,0,7,30,30
1650990422014,MATH 197,001,091859,McAuley; Julian John,9998,0,9999,1
1650990428072,COGS 9,A01,083615,Staff,0,18,60,60
1650990434096,COGS 11,A01,083617,Boyle; Mary E. T.,15,0,40,25
1650990440122,COGS 13,A01,083071,Staff,0,41,40,40
1650990446145,COGS 14A,A01,092681,Staff,0,38,100,100
1650990452180,COGS 14B,A01,083073,Cheng; Tzu-Han,0,13,50,50
1650990458203,COGS 17,A01,092677,Staff,6,0,75,69
1650990464232,COGS 100,A01,083619,Staff,0,31,60,60
1650990470254,COGS 101A,A01,083621,Davis; Joshua Daniel,0,29,60,60
1650990476283,COGS 101B,A01,091572,Staff,0,5,60,60
1650990482315,COGS 101C,A01,083625,Delgado; Tania,14,0,30,16
1650990488342,COGS 107A,A01,083627,Boyle; Mary E. T.,0,16,60,60
1650990494368,COGS 118A,A01,083075,Staff,0,10,60,60
1650990500391,CSE 3,A50,083646,Miranda; Gregory Joseph,15,0,38,23
1650990500391,CSE 3,A51,083647,Miranda; Gregory Joseph,36,0,37,1
1650990506421,CSE 8A,A50,083650,Miranda; Gregory Joseph,0,31,40,40
1650990512448,CSE 11,A01,083080,Cao; Yingjun,0,97,40,40
1650990518470,CSE 12,A01,083652,Staff,0,24,100,100
1650990524492,CSE 15L,A01,083654,Staff,0,3,50,50
1650990524492,CSE 15L,A02,083655,Staff,0,3,50,50
1650990530530,CSE 20,A01,083657,Staff,47,0,80,33
1650990536555,CSE 30,A01,083084,Eldon; John,1,38,80,79
1650990542582,CSE 100,A01,083659,Cao; Yingjun,0,71,50,50
1650990548604,CSE 134B,A01,083661,Powell; Thomas Allan,1,40,65,64
1650990554641,CSE 140,A01,083663,Staff,0,13,75,75
1650990560671,CSE 140L,A01,083088,Eldon; John,4,0,100,96
1650990566694,CSE 175,A01,083665,Kumar; Rakesh,0,0,25,25
1650990572723,CSE 190,A00,092507,Dubnov; Shlomo,9,0,20,11
1650990578754,ECE 45,A01,083139,Staff,0,7,60,60
1650990584785,ECE 65,A50,083695,Staff,0,7,30,30
1650990590818,ECE 109,A01,091882,Touri; Behrouz,32,0,70,38
1650990596840,ECE 180,A00,083140,Abi Samra; Nicholas Camill,17,0,30,13
1650990596840,ECE 180,B00,083141,Abi Samra; Nicholas Camill,0,0,30,30
1650990602864,MATH 10A,A01,083735,Patchell; Gregory David,2,0,30,28
1650990602864,MATH 10A,A02,083736,Patchell; Gregory David,27,0,30,3
1650990602864,MATH 10A,A03,083737,Patchell; Gregory David,23,0,30,7
1650990608893,MATH 10B,A01,083207,Staff,0,9,30,30
1650990608893,MATH 10B,A02,083208,Staff,0,5,30,30
1650990608893,MATH 10B,B01,083739,Staff,9,0,30,21
1650990608893,MATH 10B,B02,083740,Staff,28,0,30,2
1650990614917,MATH 18,A01,083743,Staff,0,0,30,30
1650990614917,MATH 18,A02,083744,Staff,23,0,30,7
1650990614917,MATH 18,A03,083745,Staff,19,0,30,11
1650990614917,MATH 18,A04,083746,Staff,26,0,30,4
1650990614917,MATH 18,B01,083748,Staff,0,15,30,30
1650990614917,MATH 18,B02,083749,Staff,0,14,30,30
1650990614917,MATH 18,B03,083750,Staff,0,13,30,30
1650990614917,MATH 18,B04,083751,Staff,0,13,30,30
1650990620944,MATH 20A,A01,083754,Staff,19,0,40,21
1650990626970,MATH 20B,A01,083756,Staff,0,14,30,30
1650990626970,MATH 20B,A02,083757,Staff,0,11,30,30
1650990632993,MATH 20C,A01,083760,Staff,0,17,30,30
1650990632993,MATH 20C,A02,083761,Staff,0,15,30,30
1650990632993,MATH 20C,B01,083762,Staff,9,0,30,21
1650990632993,MATH 20C,B02,083763,Staff,28,0,30,2
1650990639019,MATH 20D,A01,083765,Staff,3,1,30,27
1650990639019,MATH 20D,A02,083766,Staff,1,0,30,29
1650990639019,MATH 20D,A03,083767,Staff,22,0,30,8
1650990645046,MATH 20E,A01,083771,Staff,2,0,30,28
1650990645046,MATH 20E,A02,083772,Staff,12,0,30,18
1650990645046,MATH 20E,B01,083773,Staff,0,0,30,30
1650990645046,MATH 20E,B02,083774,Staff,0,0,30,30
1650990651069,MATH 103A,A01,083777,Staff,0,17,30,30
1650990651069,MATH 103A,A02,083778,Staff,0,15,30,30
1650990651069,MATH 103A,B01,083779,Staff,0,15,30,30
1650990651069,MATH 103A,B02,083780,Staff,0,14,30,30
1650990657097,MATH 105,A01,085443,Staff,0,23,30,30
1650990663127,MATH 109,A01,083213,Anzaldo; Leesa B,0,7,30,30
1650990663127,MATH 109,A02,083214,Anzaldo; Leesa B,0,7,30,30
1650990663127,MATH 109,B01,083215,Anzaldo; Leesa B,0,8,30,30
1650990663127,MATH 109,B02,083216,Anzaldo; Leesa B,0,7,30,30
1650990669153,MATH 142A,A01,083219,Chow; Bennett,0,14,30,30
1650990669153,MATH 142A,A02,083220,Chow; Bennett,0,15,30,30
1650990669153,MATH 142A,B01,083221,Chow; Bennett,0,16,30,30
1650990669153,MATH 142A,B02,083222,Chow; Bennett,0,14,30,30
1650990675184,MATH 193A,A01,083224,Staff,0,6,30,30
1650990675184,MATH 193A,A02,083225,Staff,0,7,30,30
1650990675184,MATH 193A,A03,083781,Staff,0,6,30,30
1650990675184,MATH 193A,A04,083782,Staff,0,7,30,30
1650990681212,MATH 197,001,091859,McAuley; Julian John,9998,0,9999,1
1650990687275,COGS 9,A01,083615,Staff,0,18,60,60
1650990693300,COGS 11,A01,083617,Boyle; Mary E. T.,15,0,40,25
1650990699336,COGS 13,A01,083071,Staff,0,41,40,40
1650990705362,COGS 14A,A01,092681,Staff,0,38,100,100
1650990711389,COGS 14B,A01,083073,Cheng; Tzu-Han,0,13,50,50
1650990717410,COGS 17,A01,092677,Staff,6,0,75,69
1650990723434,COGS 100,A01,083619,Staff,0,31,60,60
1650990729458,COGS 101A,A01,083621,Davis; Joshua Daniel,0,29,60,60
1650990735483,COGS 101B,A01,091572,Staff,0,5,60,60
1650990741517,COGS 101C,A01,083625,Delgado; Tania,14,0,30,16
1650990747541,COGS 107A,A01,083627,Boyle; Mary E. T.,0,16,60,60
1650990753564,COGS 118A,A01,083075,Staff,0,10,60,60
1650990759599,CSE 3,A50,083646,Miranda; Gregory Joseph,15,0,38,23
1650990759599,CSE 3,A51,083647,Miranda; Gregory Joseph,36,0,37,1
1650990765628,CSE 8A,A50,083650,Miranda; Gregory Joseph,0,31,40,40
1650990771652,CSE 11,A01,083080,Cao; Yingjun,0,97,40,40
1650990777673,CSE 12,A01,083652,Staff,0,24,100,100
1650990783701,CSE 15L,A01,083654,Staff,0,3,50,50
1650990783701,CSE 15L,A02,083655,Staff,0,3,50,50
1650990789727,CSE 20,A01,083657,Staff,47,0,80,33
1650990795750,CSE 30,A01,083084,Eldon; John,1,38,80,79
1650990801775,CSE 100,A01,083659,Cao; Yingjun,0,71,50,50
1650990807798,CSE 134B,A01,083661,Powell; Thomas Allan,1,40,65,64
1650990813823,CSE 140,A01,083663,Staff,0,13,75,75
1650990819851,CSE 140L,A01,083088,Eldon; John,4,0,100,96
1650990825875,CSE 175,A01,083665,Kumar; Rakesh,0,0,25,25
1650990831899,CSE 190,A00,092507,Dubnov; Shlomo,9,0,20,11
1650990837933,ECE 45,A01,083139,Staff,0,7,60,60
1650990843959,ECE 65,A50,083695,Staff,0,7,30,30
1650990849993,ECE 109,A01,091882,Touri; Behrouz,32,0,70,38
1650990856019,ECE 180,A00,083140,Abi Samra; Nicholas Camill,17,0,30,13
1650990856019,ECE 180,B00,083141,Abi Samra; Nicholas Camill,0,0,30,30
1650990862043,MATH 10A,A01,083735,Patchell; Gregory David,2,0,30,28
1650990862043,MATH 10A,A02,083736,Patchell; Gregory David,27,0,30,3
1650990862043,MATH 10A,A03,083737,Patchell; Gregory David,23,0,30,7
1650990868084,MATH 10B,A01,083207,Staff,0,9,30,30
1650990868084,MATH 10B,A02,083208,Staff,0,5,30,30
1650990868084,MATH 10B,B01,083739,Staff,9,0,30,21
1650990868084,MATH 10B,B02,083740,Staff,28,0,30,2
1650990874110,MATH 18,A01,083743,Staff,0,0,30,30
1650990874110,MATH 18,A02,083744,Staff,23,0,30,7
1650990874110,MATH 18,A03,083745,Staff,19,0,30,11
1650990874110,MATH 18,A04,083746,Staff,26,0,30,4
1650990874110,MATH 18,B01,083748,Staff,0,15,30,30
1650990874110,MATH 18,B02,083749,Staff,0,14,30,30
1650990874110,MATH 18,B03,083750,Staff,0,13,30,30
1650990874110,MATH 18,B04,083751,Staff,0,13,30,30
1650990880132,MATH 20A,A01,083754,Staff,19,0,40,21
1650990886158,MATH 20B,A01,083756,Staff,0,14,30,30
1650990886158,MATH 20B,A02,083757,Staff,0,11,30,30
1650990892188,MATH 20C,A01,083760,Staff,0,17,30,30
1650990892188,MATH 20C,A02,083761,Staff,0,15,30,30
1650990892188,MATH 20C,B01,083762,Staff,9,0,30,21
1650990892188,MATH 20C,B02,083763,Staff,28,0,30,2
1650990898215,MATH 20D,A01,083765,Staff,3,1,30,27
1650990898215,MATH 20D,A02,083766,Staff,2,0,30,28
1650990898215,MATH 20D,A03,083767,Staff,22,0,30,8
1650990904238,MATH 20E,A01,083771,Staff,2,0,30,28
1650990904238,MATH 20E,A02,083772,Staff,12,0,30,18
1650990904238,MATH 20E,B01,083773,Staff,0,0,30,30
1650990904238,MATH 20E,B02,083774,Staff,0,0,30,30
1650990910262,MATH 103A,A01,083777,Staff,0,17,30,30
1650990910262,MATH 103A,A02,083778,Staff,0,15,30,30
1650990910262,MATH 103A,B01,083779,Staff,0,15,30,30
1650990910262,MATH 103A,B02,083780,Staff,0,14,30,30
1650990916287,MATH 105,A01,085443,Staff,0,23,30,30
1650990922330,MATH 109,A01,083213,Anzaldo; Leesa B,0,7,30,30
1650990922330,MATH 109,A02,083214,Anzaldo; Leesa B,0,7,30,30
1650990922330,MATH 109,B01,083215,Anzaldo; Leesa B,0,8,30,30
1650990922330,MATH 109,B02,083216,Anzaldo; Leesa B,0,7,30,30
1650990928353,MATH 142A,A01,083219,Chow; Bennett,0,14,30,30
1650990928353,MATH 142A,A02,083220,Chow; Bennett,0,15,30,30
1650990928353,MATH 142A,B01,083221,Chow; Bennett,0,16,30,30
1650990928353,MATH 142A,B02,083222,Chow; Bennett,0,14,30,30
1650990934376,MATH 193A,A01,083224,Staff,0,6,30,30
1650990934376,MATH 193A,A02,083225,Staff,0,7,30,30
1650990934376,MATH 193A,A03,083781,Staff,0,6,30,30
1650990934376,MATH 193A,A04,083782,Staff,0,7,30,30
1650990940403,MATH 197,001,091859,McAuley; Julian John,9998,0,9999,1
1650990946461,COGS 9,A01,083615,Staff,0,18,60,60
1650990952484,COGS 11,A01,083617,Boyle; Mary E. T.,15,0,40,25
1650990958507,COGS 13,A01,083071,Staff,0,41,40,40
1650990964924,COGS 14A,A01,092681,Staff,0,38,100,100
1650990970964,COGS 14B,A01,083073,Cheng; Tzu-Han,0,13,50,50
1650990976994,COGS 17,A01,092677,Staff,6,0,75,69
1650990983019,COGS 100,A01,083619,Staff,0,31,60,60
1650990989044,COGS 101A,A01,083621,Davis; Joshua Daniel,0,29,60,60
1650990995067,COGS 101B,A01,091572,Staff,0,5,60,60
1650991001090,COGS 101C,A01,083625,Delgado; Tania,14,0,30,16
1650991007117,COGS 107A,A01,083627,Boyle; Mary E. T.,0,16,60,60
1650991013139,COGS 118A,A01,083075,Staff,0,10,60,60
1650991019166,CSE 3,A50,083646,Miranda; Gregory Joseph,15,0,38,23
1650991019166,CSE 3,A51,083647,Miranda; Gregory Joseph,36,0,37,1
1650991025189,CSE 8A,A50,083650,Miranda; Gregory Joseph,0,31,40,40
1650991031211,CSE 11,A01,083080,Cao; Yingjun,0,97,40,40
1650991037233,CSE 12,A01,083652,Staff,0,24,100,100
1650991043270,CSE 15L,A01,083654,Staff,0,3,50,50
1650991043270,CSE 15L,A02,083655,Staff,0,3,50,50
1650991049293,CSE 20,A01,083657,Staff,47,0,80,33
1650991055320,CSE 30,A01,083084,Eldon; John,1,38,80,79
1650991061346,CSE 100,A01,083659,Cao; Yingjun,0,71,50,50
1650991067374,CSE 134B,A01,083661,Powell; Thomas Allan,1,40,65,64
1650991073396,CSE 140,A01,083663,Staff,0,13,75,75
1650991079417,CSE 140L,A01,083088,Eldon; John,4,0,100,96
1650991085456,CSE 175,A01,083665,Kumar; Rakesh,0,0,25,25
1650991091478,CSE 190,A00,092507,Dubnov; Shlomo,9,0,20,11
1650991097503,ECE 45,A01,083139,Staff,0,7,60,60
1650991103528,ECE 65,A50,083695,Staff,0,7,30,30
1650991109552,ECE 109,A01,091882,Touri; Behrouz,32,0,70,38
1650991115575,ECE 180,A00,083140,Abi Samra; Nicholas Camill,17,0,30,13
1650991115575,ECE 180,B00,083141,Abi Samra; Nicholas Camill,0,0,30,30
1650991121597,MATH 10A,A01,083735,Patchell; Gregory David,2,0,30,28
1650991121597,MATH 10A,A02,083736,Patchell; Gregory David,27,0,30,3
1650991121597,MATH 10A,A03,083737,Patchell; Gregory David,23,0,30,7
1650991127621,MATH 10B,A01,083207,Staff,0,9,30,30
1650991127621,MATH 10B,A02,083208,Staff,0,5,30,30
1650991127621,MATH 10B,B01,083739,Staff,9,0,30,21
1650991127621,MATH 10B,B02,083740,Staff,28,0,30,2
1650991133646,MATH 18,A01,083743,Staff,0,0,30,30
1650991133646,MATH 18,A02,083744,Staff,23,0,30,7
1650991133646,MATH 18,A03,083745,Staff,19,0,30,11
1650991133646,MATH 18,A04,083746,Staff,26,0,30,4
1650991133646,MATH 18,B01,083748,Staff,0,15,30,30
1650991133646,MATH 18,B02,083749,Staff,0,14,30,30
1650991133646,MATH 18,B03,083750,Staff,0,13,30,30
1650991133646,MATH 18,B04,083751,Staff,0,13,30,30
1650991139681,MATH 20A,A01,083754,Staff,19,0,40,21
1650991145706,MATH 20B,A01,083756,Staff,0,14,30,30
1650991145706,MATH 20B,A02,083757,Staff,0,11,30,30
1650991151731,MATH 20C,A01,083760,Staff,0,17,30,30
1650991151731,MATH 20C,A02,083761,Staff,0,15,30,30
1650991151731,MATH 20C,B01,083762,Staff,9,0,30,21
1650991151731,MATH 20C,B02,083763,Staff,28,0,30,2
1650991157760,MATH 20D,A01,083765,Staff,3,1,30,27
1650991157760,MATH 20D,A02,083766,Staff,2,0,30,28
1650991157760,MATH 20D,A03,083767,Staff,22,0,30,8
1650991163787,MATH 20E,A01,083771,Staff,2,0,30,28
1650991163787,MATH 20E,A02,083772,Staff,12,0,30,18
1650991163787,MATH 20E,B01,083773,Staff,0,0,30,30
1650991163787,MATH 20E,B02,083774,Staff,0,0,30,30
1650991169810,MATH 103A,A01,083777,Staff,0,17,30,30
1650991169810,MATH 103A,A02,083778,Staff,0,15,30,30
1650991169810,MATH 103A,B01,083779,Staff,0,15,30,30
1650991169810,MATH 103A,B02,083780,Staff,0,14,30,30
1650991175833,MATH 105,A01,085443,Staff,0,23,30,30
1650991181861,MATH 109,A01,083213,Anzaldo; Leesa B,0,7,30,30
1650991181861,MATH 109,A02,083214,Anzaldo; Leesa B,0,7,30,30
1650991181861,MATH 109,B01,083215,Anzaldo; Leesa B,0,8,30,30
1650991181861,MATH 109,B02,083216,Anzaldo; Leesa B,0,7,30,30
1650991187893,MATH 142A,A01,083219,Chow; Bennett,0,14,30,30
1650991187893,MATH 142A,A02,083220,Chow; Bennett,0,15,30,30
1650991187893,MATH 142A,B01,083221,Chow; Bennett,0,16,30,30
1650991187893,MATH 142A,B02,083222,Chow; Bennett,0,14,30,30
1650991193928,MATH 193A,A01,083224,Staff,0,6,30,30
1650991193928,MATH 193A,A02,083225,Staff,0,7,30,30
1650991193928,MATH 193A,A03,083781,Staff,0,6,30,30
1650991193928,MATH 193A,A04,083782,Staff,0,7,30,30
1650991199965,MATH 197,001,091859,McAuley; Julian John,9998,0,9999,1
1650991206017,COGS 9,A01,083615,Staff,0,18,60,60
1650991212040,COGS 11,A01,083617,Boyle; Mary E. T.,15,0,40,25
1650991218070,COGS 13,A01,083071,Staff,0,41,40,40
1650991224094,COGS 14A,A01,092681,Staff,0,38,100,100
1650991230120,COGS 14B,A01,083073,Cheng; Tzu-Han,0,13,50,50
1650991236146,COGS 17,A01,092677,Staff,6,0,75,69
1650991242169,COGS 100,A01,083619,Staff,0,31,60,60
1650991248196,COGS 101A,A01,083621,Davis; Joshua Daniel,0,29,60,60
1650991254223,COGS 101B,A01,091572,Staff,0,5,60,60
1650991260248,COGS 101C,A01,083625,Delgado; Tania,14,0,30,16
1650991266279,COGS 107A,A01,083627,Boyle; Mary E. T.,0,16,60,60
1650991272302,COGS 118A,A01,083075,Staff,0,10,60,60
1650991278325,CSE 3,A50,083646,Miranda; Gregory Joseph,15,0,38,23
1650991278325,CSE 3,A51,083647,Miranda; Gregory Joseph,36,0,37,1
1650991284365,CSE 8A,A50,083650,Miranda; Gregory Joseph,0,31,40,40
1650991290389,CSE 11,A01,083080,Cao; Yingjun,0,97,40,40
1650991296412,CSE 12,A01,083652,Staff,0,24,100,100
1650991302436,CSE 15L,A01,083654,Staff,0,3,50,50
1650991302436,CSE 15L,A02,083655,Staff,0,3,50,50
1650991308473,CSE 20,A01,083657,Staff,47,0,80,33
1650991314496,CSE 30,A01,083084,Eldon; John,1,38,80,79
1650991320524,CSE 100,A01,083659,Cao; Yingjun,0,71,50,50
1650991326552,CSE 134B,A01,083661,Powell; Thomas Allan,1,40,65,64
1650991332583,CSE 140,A01,083663,Staff,0,13,75,75
1650991338607,CSE 140L,A01,083088,Eldon; John,4,0,100,96
1650991344628,CSE 175,A01,083665,Kumar; Rakesh,0,0,25,25
1650991350655,CSE 190,A00,092507,Dubnov; Shlomo,9,0,20,11
1650991356678,ECE 45,A01,083139,Staff,0,7,60,60
1650991362703,ECE 65,A50,083695,Staff,0,7,30,30
1650991368728,ECE 109,A01,091882,Touri; Behrouz,32,0,70,38
1650991374758,ECE 180,A00,083140,Abi Samra; Nicholas Camill,17,0,30,13
1650991374758,ECE 180,B00,083141,Abi Samra; Nicholas Camill,0,0,30,30
1650991380786,MATH 10A,A01,083735,Patchell; Gregory David,2,0,30,28
1650991380786,MATH 10A,A02,083736,Patchell; Gregory David,27,0,30,3
1650991380786,MATH 10A,A03,083737,Patchell; Gregory David,23,0,30,7
1650991386811,MATH 10B,A01,083207,Staff,0,9,30,30
1650991386811,MATH 10B,A02,083208,Staff,0,5,30,30
1650991386811,MATH 10B,B01,083739,Staff,9,0,30,21
1650991386811,MATH 10B,B02,083740,Staff,28,0,30,2
1650991392838,MATH 18,A01,083743,Staff,0,0,30,30
1650991392838,MATH 18,A02,083744,Staff,23,0,30,7
1650991392838,MATH 18,A03,083745,Staff,19,0,30,11
1650991392838,MATH 18,A04,083746,Staff,26,0,30,4
1650991392838,MATH 18,B01,083748,Staff,0,15,30,30
1650991392838,MATH 18,B02,083749,Staff,0,14,30,30
1650991392838,MATH 18,B03,083750,Staff,0,13,30,30
1650991392838,MATH 18,B04,083751,Staff,0,13,30,30
1650991398863,MATH 20A,A01,083754,Staff,19,0,40,21
1650991404889,MATH 20B,A01,083756,Staff,0,14,30,30
1650991404889,MATH 20B,A02,083757,Staff,0,11,30,30
1650991410920,MATH 20C,A01,083760,Staff,0,17,30,30
1650991410920,MATH 20C,A02,083761,Staff,0,15,30,30
1650991410920,MATH 20C,B01,083762,Staff,9,0,30,21
1650991410920,MATH 20C,B02,083763,Staff,28,0,30,2
1650991416945,MATH 20D,A01,083765,Staff,3,1,30,27
1650991416945,MATH 20D,A02,083766,Staff,2,0,30,28
1650991416945,MATH 20D,A03,083767,Staff,22,0,30,8
1650991422971,MATH 20E,A01,083771,Staff,2,0,30,28
1650991422971,MATH 20E,A02,083772,Staff,12,0,30,18
1650991422971,MATH 20E,B01,083773,Staff,0,0,30,30
1650991422971,MATH 20E,B02,083774,Staff,0,0,30,30
1650991428994,MATH 103A,A01,083777,Staff,0,17,30,30
1650991428994,MATH 103A,A02,083778,Staff,0,15,30,30
1650991428994,MATH 103A,B01,083779,Staff,0,15,30,30
1650991428994,MATH 103A,B02,083780,Staff,0,14,30,30
1650991435017,MATH 105,A01,085443,Staff,0,23,30,30
1650991441055,MATH 109,A01,083213,Anzaldo; Leesa B,0,7,30,30
1650991441055,MATH 109,A02,083214,Anzaldo; Leesa B,0,7,30,30
1650991441055,MATH 109,B01,083215,Anzaldo; Leesa B,0,8,30,30
1650991441055,MATH 109,B02,083216,Anzaldo; Leesa B,0,7,30,30
1650991447082,MATH 142A,A01,083219,Chow; Bennett,0,14,30,30
1650991447082,MATH 142A,A02,083220,Chow; Bennett,0,15,30,30
1650991447082,MATH 142A,B01,083221,Chow; Bennett,0,16,30,30
1650991447082,MATH 142A,B02,083222,Chow; Bennett,0,14,30,30
1650991453109,MATH 193A,A01,083224,Staff,0,6,30,30
1650991453109,MATH 193A,A02,083225,Staff,0,7,30,30
1650991453109,MATH 193A,A03,083781,Staff,0,6,30,30
1650991453109,MATH 193A,A04,083782,Staff,0,7,30,30
1650991459133,MATH 197,001,091859,McAuley; Julian John,9998,0,9999,1
1650991465187,COGS 9,A01,083615,Staff,0,18,60,60
1650991471209,COGS 11,A01,083617,Boyle; Mary E. T.,15,0,40,25
1650991477235,COGS 13,A01,083071,Staff,0,41,40,40
1650991483259,COGS 14A,A01,092681,Staff,0,38,100,100
1650991489288,COGS 14B,A01,083073,Cheng; Tzu-Han,0,13,50,50
1650991495309,COGS 17,A01,092677,Staff,6,0,75,69
1650991501336,COGS 100,A01,083619,Staff,0,31,60,60
1650991507361,COGS 101A,A01,083621,Davis; Joshua Daniel,0,29,60,60
1650991513387,COGS 101B,A01,091572,Staff,0,5,60,60
1650991519409,COGS 101C,A01,083625,Delgado; Tania,14,0,30,16
1650991525432,COGS 107A,A01,083627,Boyle; Mary E. T.,0,16,60,60
1650991531454,COGS 118A,A01,083075,Staff,0,10,60,60
1650991537478,CSE 3,A50,083646,Miranda; Gregory Joseph,15,0,38,23
1650991537478,CSE 3,A51,083647,Miranda; Gregory Joseph,36,0,37,1
1650991543500,CSE 8A,A50,083650,Miranda; Gregory Joseph,0,31,40,40
1650991549526,CSE 11,A01,083080,Cao; Yingjun,0,97,40,40
1650991555550,CSE 12,A01,083652,Staff,0,24,100,100
1650991561664,CSE 15L,A01,083654,Staff,0,3,50,50
1650991561664,CSE 15L,A02,083655,Staff,0,3,50,50
1650991567691,CSE 20,A01,083657,Staff,47,0,80,33
1650991573727,CSE 30,A01,083084,Eldon; John,1,38,80,79
1650991579753,CSE 100,A01,083659,Cao; Yingjun,0,71,50,50
1650991585783,CSE 134B,A01,083661,Powell; Thomas Allan,1,40,65,64
1650991591807,CSE 140,A01,083663,Staff,0,13,75,75
1650991597831,CSE 140L,A01,083088,Eldon; John,4,0,100,96
1650991603858,CSE 175,A01,083665,Kumar; Rakesh,0,0,25,25
1650991609881,CSE 190,A00,092507,Dubnov; Shlomo,9,0,20,11
1650991615903,ECE 45,A01,083139,Staff,0,7,60,60
1650991621932,ECE 65,A50,083695,Staff,0,7,30,30
1650991627962,ECE 109,A01,091882,Touri; Behrouz,32,0,70,38
1650991633989,ECE 180,A00,083140,Abi Samra; Nicholas Camill,17,0,30,13
1650991633989,ECE 180,B00,083141,Abi Samra; Nicholas Camill,0,0,30,30
1650991640021,MATH 10A,A01,083735,Patchell; Gregory David,2,0,30,28
1650991640021,MATH 10A,A02,083736,Patchell; Gregory David,27,0,30,3
1650991640021,MATH 10A,A03,083737,Patchell; Gregory David,23,0,30,7
1650991646044,MATH 10B,A01,083207,Staff,0,9,30,30
1650991646044,MATH 10B,A02,083208,Staff,0,5,30,30
1650991646044,MATH 10B,B01,083739,Staff,9,0,30,21
1650991646044,MATH 10B,B02,083740,Staff,28,0,30,2
1650991652142,MATH 18,A01,083743,Staff,0,0,30,30
1650991652142,MATH 18,A02,083744,Staff,23,0,30,7
1650991652142,MATH 18,A03,083745,Staff,19,0,30,11
1650991652142,MATH 18,A04,083746,Staff,26,0,30,4
1650991652142,MATH 18,B01,083748,Staff,0,15,30,30
1650991652142,MATH 18,B02,083749,Staff,0,14,30,30
1650991652142,MATH 18,B03,083750,Staff,0,13,30,30
1650991652142,MATH 18,B04,083751,Staff,0,13,30,30
1650991658168,MATH 20A,A01,083754,Staff,19,0,40,21
1650991664196,MATH 20B,A01,083756,Staff,0,14,30,30
1650991664196,MATH 20B,A02,083757,Staff,0,11,30,30
1650991670223,MATH 20C,A01,083760,Staff,0,17,30,30
1650991670223,MATH 20C,A02,083761,Staff,0,15,30,30
1650991670223,MATH 20C,B01,083762,Staff,9,0,30,21
1650991670223,MATH 20C,B02,083763,Staff,28,0,30,2
1650991676249,MATH 20D,A01,083765,Staff,3,1,30,27
1650991676249,MATH 20D,A02,083766,Staff,2,0,30,28
1650991676249,MATH 20D,A03,083767,Staff,22,0,30,8
1650991682271,MATH 20E,A01,083771,Staff,2,0,30,28
1650991682271,MATH 20E,A02,083772,Staff,12,0,30,18
1650991682271,MATH 20E,B01,083773,Staff,0,0,30,30
1650991682271,MATH 20E,B02,083774,Staff,0,0,30,30
1650991688301,MATH 103A,A01,083777,Staff,0,17,30,30
1650991688301,MATH 103A,A02,083778,Staff,0,15,30,30
1650991688301,MATH 103A,B01,083779,Staff,0,15,30,30
1650991688301,MATH 103A,B02,083780,Staff,0,14,30,30
1650991694328,MATH 105,A01,085443,Staff,0,23,30,30
1650991700353,MATH 109,A01,083213,Anzaldo; Leesa B,0,7,30,30
1650991700353,MATH 109,A02,083214,Anzaldo; Leesa B,0,7,30,30
1650991700353,MATH 109,B01,083215,Anzaldo; Leesa B,0,8,30,30
1650991700353,MATH 109,B02,083216,Anzaldo; Leesa B,0,7,30,30
1650991706380,MATH 142A,A01,083219,Chow; Bennett,0,14,30,30
1650991706380,MATH 142A,A02,083220,Chow; Bennett,0,15,30,30
1650991706380,MATH 142A,B01,083221,Chow; Bennett,0,16,30,30
1650991706380,MATH 142A,B02,083222,Chow; Bennett,0,14,30,30
1650991712412,MATH 193A,A01,083224,Staff,0,6,30,30
1650991712412,MATH 193A,A02,083225,Staff,0,7,30,30
1650991712412,MATH 193A,A03,083781,Staff,0,6,30,30
1650991712412,MATH 193A,A04,083782,Staff,0,7,30,30
1650991718437,MATH 197,001,091859,McAuley; Julian John,9998,0,9999,1
1650991724530,COGS 9,A01,083615,Staff,0,18,60,60
1650991730555,COGS 11,A01,083617,Boyle; Mary E. T.,15,0,40,25
1650991736578,COGS 13,A01,083071,Staff,0,41,40,40
1650991742600,COGS 14A,A01,092681,Staff,0,38,100,100
1650991748624,COGS 14B,A01,083073,Cheng; Tzu-Han,0,13,50,50
1650991754650,COGS 17,A01,092677,Staff,6,0,75,69
1650991760681,COGS 100,A01,083619,Staff,0,31,60,60
1650991766703,COGS 101A,A01,083621,Davis; Joshua Daniel,0,29,60,60
1650991772729,COGS 101B,A01,091572,Staff,0,5,60,60
1650991778751,COGS 101C,A01,083625,Delgado; Tania,14,0,30,16
1650991784789,COGS 107A,A01,083627,Boyle; Mary E. T.,0,16,60,60
1650991790812,COGS 118A,A01,083075,Staff,0,10,60,60
1650991796839,CSE 3,A50,083646,Miranda; Gregory Joseph,15,0,38,23
1650991796839,CSE 3,A51,083647,Miranda; Gregory Joseph,36,0,37,1
1650991802862,CSE 8A,A50,083650,Miranda; Gregory Joseph,0,31,40,40
1650991808885,CSE 11,A01,083080,Cao; Yingjun,0,97,40,40
1650991814912,CSE 12,A01,083652,Staff,0,24,100,100
1650991820937,CSE 15L,A01,083654,Staff,0,3,50,50
1650991820937,CSE 15L,A02,083655,Staff,0,3,50,50
1650991826962,CSE 20,A01,083657,Staff,47,0,80,33
1650991832985,CSE 30,A01,083084,Eldon; John,1,38,80,79
1650991839022,CSE 100,A01,083659,Cao; Yingjun,0,71,50,50
1650991845047,CSE 134B,A01,083661,Powell; Thomas Allan,1,40,65,64
1650991851072,CSE 140,A01,083663,Staff,0,13,75,75
1650991857096,CSE 140L,A01,083088,Eldon; John,4,0,100,96
1650991863124,CSE 175,A01,083665,Kumar; Rakesh,0,0,25,25
1650991869150,CSE 190,A00,092507,Dubnov; Shlomo,9,0,20,11
1650991875177,ECE 45,A01,083139,Staff,0,7,60,60
1650991881203,ECE 65,A50,083695,Staff,0,7,30,30
1650991887229,ECE 109,A01,091882,Touri; Behrouz,32,0,70,38
1650991893254,ECE 180,A00,083140,Abi Samra; Nicholas Camill,17,0,30,13
1650991893254,ECE 180,B00,083141,Abi Samra; Nicholas Camill,0,0,30,30
1650991899286,MATH 10A,A01,083735,Patchell; Gregory David,2,0,30,28
1650991899286,MATH 10A,A02,083736,Patchell; Gregory David,27,0,30,3
1650991899286,MATH 10A,A03,083737,Patchell; Gregory David,23,0,30,7
1650991905311,MATH 10B,A01,083207,Staff,0,9,30,30
1650991905311,MATH 10B,A02,083208,Staff,0,5,30,30
1650991905311,MATH 10B,B01,083739,Staff,9,0,30,21
1650991905311,MATH 10B,B02,083740,Staff,28,0,30,2
1650991911336,MATH 18,A01,083743,Staff,0,0,30,30
1650991911336,MATH 18,A02,083744,Staff,23,0,30,7
1650991911336,MATH 18,A03,083745,Staff,19,0,30,11
1650991911336,MATH 18,A04,083746,Staff,26,0,30,4
1650991911336,MATH 18,B01,083748,Staff,0,15,30,30
1650991911336,MATH 18,B02,083749,Staff,0,14,30,30
1650991911336,MATH 18,B03,083750,Staff,0,13,30,30
1650991911336,MATH 18,B04,083751,Staff,0,13,30,30
1650991917368,MATH 20A,A01,083754,Staff,19,0,40,21
1650991923390,MATH 20B,A01,083756,Staff,0,14,30,30
1650991923390,MATH 20B,A02,083757,Staff,0,11,30,30
1650991929418,MATH 20C,A01,083760,Staff,0,17,30,30
1650991929418,MATH 20C,A02,083761,Staff,0,15,30,30
1650991929418,MATH 20C,B01,083762,Staff,9,0,30,21
1650991929418,MATH 20C,B02,083763,Staff,28,0,30,2
1650991935442,MATH 20D,A01,083765,Staff,3,1,30,27
1650991935442,MATH 20D,A02,083766,Staff,2,0,30,28
1650991935442,MATH 20D,A03,083767,Staff,22,0,30,8
1650991941470,MATH 20E,A01,083771,Staff,2,0,30,28
1650991941470,MATH 20E,A02,083772,Staff,12,0,30,18
1650991941470,MATH 20E,B01,083773,Staff,0,0,30,30
1650991941470,MATH 20E,B02,083774,Staff,0,0,30,30
1650991947493,MATH 103A,A01,083777,Staff,0,17,30,30
1650991947493,MATH 103A,A02,083778,Staff,0,15,30,30
1650991947493,MATH 103A,B01,083779,Staff,0,15,30,30
1650991947493,MATH 103A,B02,083780,Staff,0,14,30,30
1650991953534,MATH 105,A01,085443,Staff,0,23,30,30
1650991959563,MATH 109,A01,083213,Anzaldo; Leesa B,0,7,30,30
1650991959563,MATH 109,A02,083214,Anzaldo; Leesa B,0,7,30,30
1650991959563,MATH 109,B01,083215,Anzaldo; Leesa B,0,8,30,30
1650991959563,MATH 109,B02,083216,Anzaldo; Leesa B,0,7,30,30
1650991965592,MATH 142A,A01,083219,Chow; Bennett,0,14,30,30
1650991965592,MATH 142A,A02,083220,Chow; Bennett,0,15,30,30
1650991965592,MATH 142A,B01,083221,Chow; Bennett,0,16,30,30
1650991965592,MATH 142A,B02,083222,Chow; Bennett,0,14,30,30
1650991971620,MATH 193A,A01,083224,Staff,0,6,30,30
1650991971620,MATH 193A,A02,083225,Staff,0,7,30,30
1650991971620,MATH 193A,A03,083781,Staff,0,6,30,30
1650991971620,MATH 193A,A04,083782,Staff,0,7,30,30
1650991977643,MATH 197,001,091859,McAuley; Julian John,9998,0,9999,1
1650991983694,COGS 9,A01,083615,Staff,0,18,60,60
1650991989720,COGS 11,A01,083617,Boyle; Mary E. T.,15,0,40,25
1650991995747,COGS 13,A01,083071,Staff,0,41,40,40
1650992001773,COGS 14A,A01,092681,Staff,0,38,100,100
1650992007796,COGS 14B,A01,083073,Cheng; Tzu-Han,0,13,50,50
1650992013822,COGS 17,A01,092677,Staff,6,0,75,69
1650992019849,COGS 100,A01,083619,Staff,0,31,60,60
1650992025880,COGS 101A,A01,083621,Davis; Joshua Daniel,0,29,60,60
1650992031903,COGS 101B,A01,091572,Staff,0,5,60,60
1650992037926,COGS 101C,A01,083625,Delgado; Tania,14,0,30,16
1650992043953,COGS 107A,A01,083627,Boyle; Mary E. T.,0,16,60,60
1650992049982,COGS 118A,A01,083075,Staff,0,10,60,60
1650992056009,CSE 3,A50,083646,Miranda; Gregory Joseph,15,0,38,23
1650992056009,CSE 3,A51,083647,Miranda; Gregory Joseph,36,0,37,1
1650992062032,CSE 8A,A50,083650,Miranda; Gregory Joseph,0,31,40,40
1650992068058,CSE 11,A01,083080,Cao; Yingjun,0,97,40,40
1650992074083,CSE 12,A01,083652,Staff,0,24,100,100
1650992080106,CSE 15L,A01,083654,Staff,0,3,50,50
1650992080106,CSE 15L,A02,083655,Staff,0,3,50,50
1650992086127,CSE 20,A01,083657,Staff,47,0,80,33
1650992092157,CSE 30,A01,083084,Eldon; John,1,38,80,79
1650992098179,CSE 100,A01,083659,Cao; Yingjun,0,71,50,50
1650992104202,CSE 134B,A01,083661,Powell; Thomas Allan,1,40,65,64
1650992110226,CSE 140,A01,083663,Staff,0,13,75,75
1650992116251,CSE 140L,A01,083088,Eldon; John,4,0,100,96
1650992122281,CSE 175,A01,083665,Kumar; Rakesh,0,0,25,25
1650992128306,CSE 190,A00,092507,Dubnov; Shlomo,9,0,20,11
1650992134331,ECE 45,A01,083139,Staff,0,7,60,60
1650992140366,ECE 65,A50,083695,Staff,0,7,30,30
1650992146402,ECE 109,A01,091882,Touri; Behrouz,32,0,70,38
1650992152429,ECE 180,A00,083140,Abi Samra; Nicholas Camill,17,0,30,13
1650992152429,ECE 180,B00,083141,Abi Samra; Nicholas Camill,0,0,30,30
1650992158546,MATH 10A,A01,083735,Patchell; Gregory David,2,0,30,28
1650992158546,MATH 10A,A02,083736,Patchell; Gregory David,27,0,30,3
1650992158546,MATH 10A,A03,083737,Patchell; Gregory David,23,0,30,7
1650992164572,MATH 10B,A01,083207,Staff,0,9,30,30
1650992164572,MATH 10B,A02,083208,Staff,0,5,30,30
1650992164572,MATH 10B,B01,083739,Staff,9,0,30,21
1650992164572,MATH 10B,B02,083740,Staff,28,0,30,2
1650992170609,MATH 18,A01,083743,Staff,0,0,30,30
1650992170609,MATH 18,A02,083744,Staff,23,0,30,7
1650992170609,MATH 18,A03,083745,Staff,19,0,30,11
1650992170609,MATH 18,A04,083746,Staff,26,0,30,4
1650992170609,MATH 18,B01,083748,Staff,0,15,30,30
1650992170609,MATH 18,B02,083749,Staff,0,14,30,30
1650992170609,MATH 18,B03,083750,Staff,0,13,30,30
1650992170609,MATH 18,B04,083751,Staff,0,13,30,30
1650992176643,MATH 20A,A01,083754,Staff,19,0,40,21
1650992182694,MATH 20B,A01,083756,Staff,0,14,30,30
1650992182694,MATH 20B,A02,083757,Staff,0,11,30,30
1650992188721,MATH 20C,A01,083760,Staff,0,17,30,30
1650992188721,MATH 20C,A02,083761,Staff,0,15,30,30
1650992188721,MATH 20C,B01,083762,Staff,9,0,30,21
1650992188721,MATH 20C,B02,083763,Staff,28,0,30,2
1650992194748,MATH 20D,A01,083765,Staff,3,1,30,27
1650992194748,MATH 20D,A02,083766,Staff,2,0,30,28
1650992194748,MATH 20D,A03,083767,Staff,22,0,30,8
1650992200777,MATH 20E,A01,083771,Staff,2,0,30,28
1650992200777,MATH 20E,A02,083772,Staff,12,0,30,18
1650992200777,MATH 20E,B01,083773,Staff,0,0,30,30
1650992200777,MATH 20E,B02,083774,Staff,0,0,30,30
1650992206804,MATH 103A,A01,083777,Staff,0,17,30,30
1650992206804,MATH 103A,A02,083778,Staff,0,15,30,30
1650992206804,MATH 103A,B01,083779,Staff,0,15,30,30
1650992206804,MATH 103A,B02,083780,Staff,0,14,30,30
1650992212853,MATH 105,A01,085443,Staff,0,23,30,30
1650992218882,MATH 109,A01,083213,Anzaldo; Leesa B,0,7,30,30
1650992218882,MATH 109,A02,083214,Anzaldo; Leesa B,0,7,30,30
1650992218882,MATH 109,B01,083215,Anzaldo; Leesa B,0,8,30,30
1650992218882,MATH 109,B02,083216,Anzaldo; Leesa B,0,7,30,30
1650992224906,MATH 142A,A01,083219,Chow; Bennett,0,14,30,30
1650992224906,MATH 142A,A02,083220,Chow; Bennett,0,15,30,30
1650992224906,MATH 142A,B01,083221,Chow; Bennett,0,16,30,30
1650992224906,MATH 142A,B02,083222,Chow; Bennett,0,14,30,30
1650992230931,MATH 193A,A01,083224,Staff,0,6,30,30
1650992230931,MATH 193A,A02,083225,Staff,0,7,30,30
1650992230931,MATH 193A,A03,083781,Staff,0,6,30,30
1650992230931,MATH 193A,A04,083782,Staff,0,7,30,30
1650992236955,MATH 197,001,091859,McAuley; Julian John,9998,0,9999,1
1650992243027,COGS 9,A01,083615,Staff,0,18,60,60
1650992249053,COGS 11,A01,083617,Boyle; Mary E. T.,15,0,40,25
1650992255078,COGS 13,A01,083071,Staff,0,41,40,40
1650992261104,COGS 14A,A01,092681,Staff,0,38,100,100
1650992267127,COGS 14B,A01,083073,Cheng; Tzu-Han,0,13,50,50
1650992273154,COGS 17,A01,092677,Staff,6,0,75,69
1650992279179,COGS 100,A01,083619,Staff,0,31,60,60
1650992285203,COGS 101A,A01,083621,Davis; Joshua Daniel,0,29,60,60
1650992291227,COGS 101B,A01,091572,Staff,0,5,60,60
1650992297252,COGS 101C,A01,083625,Delgado; Tania,14,0,30,16
1650992303277,COGS 107A,A01,083627,Boyle; Mary E. T.,0,16,60,60
1650992309304,COGS 118A,A01,083075,Staff,0,10,60,60
1650992315337,CSE 3,A50,083646,Miranda; Gregory Joseph,15,0,38,23
1650992315337,CSE 3,A51,083647,Miranda; Gregory Joseph,36,0,37,1
1650992321364,CSE 8A,A50,083650,Miranda; Gregory Joseph,0,31,40,40
1650992327390,CSE 11,A01,083080,Cao; Yingjun,0,97,40,40
1650992333414,CSE 12,A01,083652,Staff,0,24,100,100
1650992339460,CSE 15L,A01,083654,Staff,0,3,50,50
1650992339460,CSE 15L,A02,083655,Staff,0,3,50,50
1650992345483,CSE 20,A01,083657,Staff,47,0,80,33
1650992351504,CSE 30,A01,083084,Eldon; John,1,38,80,79
1650992357528,CSE 100,A01,083659,Cao; Yingjun,0,71,50,50
1650992363552,CSE 134B,A01,083661,Powell; Thomas Allan,1,40,65,64
1650992369585,CSE 140,A01,083663,Staff,0,13,75,75
1650992375609,CSE 140L,A01,083088,Eldon; John,4,0,100,96
1650992381634,CSE 175,A01,083665,Kumar; Rakesh,0,0,25,25
1650992387661,CSE 190,A00,092507,Dubnov; Shlomo,9,0,20,11
1650992393689,ECE 45,A01,083139,Staff,0,7,60,60
1650992399722,ECE 65,A50,083695,Staff,0,7,30,30
1650992405758,ECE 109,A01,091882,Touri; Behrouz,32,0,70,38
1650992411784,ECE 180,A00,083140,Abi Samra; Nicholas Camill,17,0,30,13
1650992411784,ECE 180,B00,083141,Abi Samra; Nicholas Camill,0,0,30,30
1650992417814,MATH 10A,A01,083735,Patchell; Gregory David,2,0,30,28
1650992417814,MATH 10A,A02,083736,Patchell; Gregory David,27,0,30,3
1650992417814,MATH 10A,A03,083737,Patchell; Gregory David,23,0,30,7
1650992423836,MATH 10B,A01,083207,Staff,0,9,30,30
1650992423836,MATH 10B,A02,083208,Staff,0,5,30,30
1650992423836,MATH 10B,B01,083739,Staff,9,0,30,21
1650992423836,MATH 10B,B02,083740,Staff,28,0,30,2
1650992429868,MATH 18,A01,083743,Staff,0,0,30,30
1650992429868,MATH 18,A02,083744,Staff,23,0,30,7
1650992429868,MATH 18,A03,083745,Staff,19,0,30,11
1650992429868,MATH 18,A04,083746,Staff,26,0,30,4
1650992429868,MATH 18,B01,083748,Staff,0,15,30,30
1650992429868,MATH 18,B02,083749,Staff,0,14,30,30
1650992429868,MATH 18,B03,083750,Staff,0,13,30,30
1650992429868,MATH 18,B04,083751,Staff,0,13,30,30
1650992435893,MATH 20A,A01,083754,Staff,19,0,40,21
1650992441933,MATH 20B,A01,083756,Staff,0,14,30,30
1650992441933,MATH 20B,A02,083757,Staff,0,11,30,30
1650992447969,MATH 20C,A01,083760,Staff,0,17,30,30
1650992447969,MATH 20C,A02,083761,Staff,0,15,30,30
1650992447969,MATH 20C,B01,083762,Staff,9,0,30,21
1650992447969,MATH 20C,B02,083763,Staff,28,0,30,2
1650992453995,MATH 20D,A01,083765,Staff,3,1,30,27
1650992453995,MATH 20D,A02,083766,Staff,2,0,30,28
1650992453995,MATH 20D,A03,083767,Staff,22,0,30,8
1650992460022,MATH 20E,A01,083771,Staff,2,0,30,28
1650992460022,MATH 20E,A02,083772,Staff,12,0,30,18
1650992460022,MATH 20E,B01,083773,Staff,0,0,30,30
1650992460022,MATH 20E,B02,083774,Staff,0,0,30,30
1650992466047,MATH 103A,A01,083777,Staff,0,17,30,30
1650992466047,MATH 103A,A02,083778,Staff,0,15,30,30
1650992466047,MATH 103A,B01,083779,Staff,0,15,30,30
1650992466047,MATH 103A,B02,083780,Staff,0,14,30,30
1650992472073,MATH 105,A01,085443,Staff,0,23,30,30
1650992478097,MATH 109,A01,083213,Anzaldo; Leesa B,0,7,30,30
1650992478097,MATH 109,A02,083214,Anzaldo; Leesa B,0,7,30,30
1650992478097,MATH 109,B01,083215,Anzaldo; Leesa B,0,8,30,30
1650992478097,MATH 109,B02,083216,Anzaldo; Leesa B,0,7,30,30
1650992484121,MATH 142A,A01,083219,Chow; Bennett,0,14,30,30
1650992484121,MATH 142A,A02,083220,Chow; Bennett,0,15,30,30
1650992484121,MATH 142A,B01,083221,Chow; Bennett,0,16,30,30
1650992484121,MATH 142A,B02,083222,Chow; Bennett,0,14,30,30
1650992490148,MATH 193A,A01,083224,Staff,0,6,30,30
1650992490148,MATH 193A,A02,083225,Staff,0,7,30,30
1650992490148,MATH 193A,A03,083781,Staff,0,6,30,30
1650992490148,MATH 193A,A04,083782,Staff,0,7,30,30
1650992496170,MATH 197,001,091859,McAuley; Julian John,9998,0,9999,1
1650992502233,COGS 9,A01,083615,Staff,0,18,60,60
1650992508257,COGS 11,A01,083617,Boyle; Mary E. T.,15,0,40,25
1650992514286,COGS 13,A01,083071,Staff,0,41,40,40
1650992520313,COGS 14A,A01,092681,Staff,0,38,100,100
1650992526348,COGS 14B,A01,083073,Cheng; Tzu-Han,0,13,50,50
1650992532374,COGS 17,A01,092677,Staff,6,0,75,69
1650992538398,COGS 100,A01,083619,Staff,0,31,60,60
1650992544421,COGS 101A,A01,083621,Davis; Joshua Daniel,0,29,60,60
1650992550448,COGS 101B,A01,091572,Staff,0,5,60,60
1650992556480,COGS 101C,A01,083625,Delgado; Tania,14,0,30,16
1650992562504,COGS 107A,A01,083627,Boyle; Mary E. T.,0,16,60,60
1650992568525,COGS 118A,A01,083075,Staff,0,10,60,60
1650992574549,CSE 3,A50,083646,Miranda; Gregory Joseph,15,0,38,23
1650992574549,CSE 3,A51,083647,Miranda; Gregory Joseph,36,0,37,1
1650992580573,CSE 8A,A50,083650,Miranda; Gregory Joseph,0,31,40,40
1650992586606,CSE 11,A01,083080,Cao; Yingjun,0,97,40,40
1650992592631,CSE 12,A01,083652,Staff,0,24,100,100
1650992598656,CSE 15L,A01,083654,Staff,0,3,50,50
1650992598656,CSE 15L,A02,083655,Staff,0,3,50,50
1650992604685,CSE 20,A01,083657,Staff,47,0,80,33
1650992610708,CSE 30,A01,083084,Eldon; John,1,38,80,79
1650992616730,CSE 100,A01,083659,Cao; Yingjun,0,71,50,50
1650992622763,CSE 134B,A01,083661,Powell; Thomas Allan,1,40,65,64
1650992628788,CSE 140,A01,083663,Staff,0,13,75,75
1650992634821,CSE 140L,A01,083088,Eldon; John,4,0,100,96
1650992640845,CSE 175,A01,083665,Kumar; Rakesh,0,0,25,25
1650992646875,CSE 190,A00,092507,Dubnov; Shlomo,9,0,20,11
1650992652901,ECE 45,A01,083139,Staff,0,7,60,60
1650992658930,ECE 65,A50,083695,Staff,0,7,30,30
1650992664958,ECE 109,A01,091882,Touri; Behrouz,32,0,70,38
1650992671010,ECE 180,A00,083140,Abi Samra; Nicholas Camill,17,0,30,13
1650992671010,ECE 180,B00,083141,Abi Samra; Nicholas Camill,0,0,30,30
1650992677120,MATH 10A,A01,083735,Patchell; Gregory David,2,0,30,28
1650992677120,MATH 10A,A02,083736,Patchell; Gregory David,27,0,30,3
1650992677120,MATH 10A,A03,083737,Patchell; Gregory David,23,0,30,7
1650992683144,MATH 10B,A01,083207,Staff,0,9,30,30
1650992683144,MATH 10B,A02,083208,Staff,0,5,30,30
1650992683144,MATH 10B,B01,083739,Staff,9,0,30,21
1650992683144,MATH 10B,B02,083740,Staff,28,0,30,2
1650992689170,MATH 18,A01,083743,Staff,0,0,30,30
1650992689170,MATH 18,A02,083744,Staff,23,0,30,7
1650992689170,MATH 18,A03,083745,Staff,19,0,30,11
1650992689170,MATH 18,A04,083746,Staff,26,0,30,4
1650992689170,MATH 18,B01,083748,Staff,0,15,30,30
1650992689170,MATH 18,B02,083749,Staff,0,14,30,30
1650992689170,MATH 18,B03,083750,Staff,0,13,30,30
1650992689170,MATH 18,B04,083751,Staff,0,13,30,30
1650992695193,MATH 20A,A01,083754,Staff,19,0,40,21
1650992701218,MATH 20B,A01,083756,Staff,0,14,30,30
1650992701218,MATH 20B,A02,083757,Staff,0,11,30,30
1650992707263,MATH 20C,A01,083760,Staff,0,17,30,30
1650992707263,MATH 20C,A02,083761,Staff,0,15,30,30
1650992707263,MATH 20C,B01,083762,Staff,9,0,30,21
1650992707263,MATH 20C,B02,083763,Staff,28,0,30,2
1650992713288,MATH 20D,A01,083765,Staff,3,1,30,27
1650992713288,MATH 20D,A02,083766,Staff,2,0,30,28
1650992713288,MATH 20D,A03,083767,Staff,22,0,30,8
1650992719328,MATH 20E,A01,083771,Staff,2,0,30,28
1650992719328,MATH 20E,A02,083772,Staff,12,0,30,18
1650992719328,MATH 20E,B01,083773,Staff,0,0,30,30
1650992719328,MATH 20E,B02,083774,Staff,0,0,30,30
1650992725364,MATH 103A,A01,083777,Staff,0,17,30,30
1650992725364,MATH 103A,A02,083778,Staff,0,15,30,30
1650992725364,MATH 103A,B01,083779,Staff,0,15,30,30
1650992725364,MATH 103A,B02,083780,Staff,0,14,30,30
1650992731389,MATH 105,A01,085443,Staff,0,23,30,30
1650992737419,MATH 109,A01,083213,Anzaldo; Leesa B,0,7,30,30
1650992737419,MATH 109,A02,083214,Anzaldo; Leesa B,0,7,30,30
1650992737419,MATH 109,B01,083215,Anzaldo; Leesa B,0,8,30,30
1650992737419,MATH 109,B02,083216,Anzaldo; Leesa B,0,7,30,30
1650992743444,MATH 142A,A01,083219,Chow; Bennett,0,14,30,30
1650992743444,MATH 142A,A02,083220,Chow; Bennett,0,15,30,30
1650992743444,MATH 142A,B01,083221,Chow; Bennett,0,16,30,30
1650992743444,MATH 142A,B02,083222,Chow; Bennett,0,14,30,30
1650992749470,MATH 193A,A01,083224,Staff,0,6,30,30
1650992749470,MATH 193A,A02,083225,Staff,0,7,30,30
1650992749470,MATH 193A,A03,083781,Staff,0,6,30,30
1650992749470,MATH 193A,A04,083782,Staff,0,7,30,30
1650992755612,MATH 197,001,091859,McAuley; Julian John,9998,0,9999,1
1650992761674,COGS 9,A01,083615,Staff,0,18,60,60
1650992767696,COGS 11,A01,083617,Boyle; Mary E. T.,15,0,40,25
1650992773720,COGS 13,A01,083071,Staff,0,41,40,40
1650992779746,COGS 14A,A01,092681,Staff,0,38,100,100
1650992785771,COGS 14B,A01,083073,Cheng; Tzu-Han,0,13,50,50
1650992791798,COGS 17,A01,092677,Staff,6,0,75,69
1650992797823,COGS 100,A01,083619,Staff,0,31,60,60
1650992803860,COGS 101A,A01,083621,Davis; Joshua Daniel,0,29,60,60
1650992809888,COGS 101B,A01,091572,Staff,0,5,60,60
1650992815916,COGS 101C,A01,083625,Delgado; Tania,14,0,30,16
1650992821945,COGS 107A,A01,083627,Boyle; Mary E. T.,0,16,60,60
1650992827981,COGS 118A,A01,083075,Staff,0,10,60,60
1650992834018,CSE 3,A50,083646,Miranda; Gregory Joseph,15,0,38,23
1650992834018,CSE 3,A51,083647,Miranda; Gregory Joseph,36,0,37,1
1650992840051,CSE 8A,A50,083650,Miranda; Gregory Joseph,0,31,40,40
1650992846075,CSE 11,A01,083080,Cao; Yingjun,0,97,40,40
1650992852099,CSE 12,A01,083652,Staff,0,24,100,100
1650992858124,CSE 15L,A01,083654,Staff,0,3,50,50
1650992858124,CSE 15L,A02,083655,Staff,0,3,50,50
1650992864161,CSE 20,A01,083657,Staff,47,0,80,33
1650992870186,CSE 30,A01,083084,Eldon; John,1,38,80,79
1650992876212,CSE 100,A01,083659,Cao; Yingjun,0,71,50,50
1650992882236,CSE 134B,A01,083661,Powell; Thomas Allan,1,40,65,64
1650992888257,CSE 140,A01,083663,Staff,0,13,75,75
1650992894282,CSE 140L,A01,083088,Eldon; John,4,0,100,96
1650992900312,CSE 175,A01,083665,Kumar; Rakesh,0,0,25,25
1650992906335,CSE 190,A00,092507,Dubnov; Shlomo,9,0,20,11
1650992912372,ECE 45,A01,083139,Staff,0,7,60,60
1650992918396,ECE 65,A50,083695,Staff,0,7,30,30
1650992924425,ECE 109,A01,091882,Touri; Behrouz,32,0,70,38
1650992930454,ECE 180,A00,083140,Abi Samra; Nicholas Camill,17,0,30,13
1650992930454,ECE 180,B00,083141,Abi Samra; Nicholas Camill,0,0,30,30
1650992936476,MATH 10A,A01,083735,Patchell; Gregory David,2,0,30,28
1650992936476,MATH 10A,A02,083736,Patchell; Gregory David,27,0,30,3
1650992936476,MATH 10A,A03,083737,Patchell; Gregory David,23,0,30,7
1650992942502,MATH 10B,A01,083207,Staff,0,9,30,30
1650992942502,MATH 10B,A02,083208,Staff,0,5,30,30
1650992942502,MATH 10B,B01,083739,Staff,9,0,30,21
1650992942502,MATH 10B,B02,083740,Staff,28,0,30,2
1650992948530,MATH 18,A01,083743,Staff,0,0,30,30
1650992948530,MATH 18,A02,083744,Staff,23,0,30,7
1650992948530,MATH 18,A03,083745,Staff,19,0,30,11
1650992948530,MATH 18,A04,083746,Staff,26,0,30,4
1650992948530,MATH 18,B01,083748,Staff,0,15,30,30
1650992948530,MATH 18,B02,083749,Staff,0,14,30,30
1650992948530,MATH 18,B03,083750,Staff,0,13,30,30
1650992948530,MATH 18,B04,083751,Staff,0,13,30,30
1650992954553,MATH 20A,A01,083754,Staff,19,0,40,21
1650992960576,MATH 20B,A01,083756,Staff,0,14,30,30
1650992960576,MATH 20B,A02,083757,Staff,0,11,30,30
1650992966603,MATH 20C,A01,083760,Staff,0,17,30,30
1650992966603,MATH 20C,A02,083761,Staff,0,15,30,30
1650992966603,MATH 20C,B01,083762,Staff,9,0,30,21
1650992966603,MATH 20C,B02,083763,Staff,28,0,30,2
1650992972630,MATH 20D,A01,083765,Staff,3,1,30,27
1650992972630,MATH 20D,A02,083766,Staff,2,0,30,28
1650992972630,MATH 20D,A03,083767,Staff,22,0,30,8
1650992978669,MATH 20E,A01,083771,Staff,2,0,30,28
1650992978669,MATH 20E,A02,083772,Staff,12,0,30,18
1650992978669,MATH 20E,B01,083773,Staff,0,0,30,30
1650992978669,MATH 20E,B02,083774,Staff,0,0,30,30
1650992984692,MATH 103A,A01,083777,Staff,0,17,30,30
1650992984692,MATH 103A,A02,083778,Staff,0,15,30,30
1650992984692,MATH 103A,B01,083779,Staff,0,15,30,30
1650992984692,MATH 103A,B02,083780,Staff,0,14,30,30
1650992990723,MATH 105,A01,085443,Staff,0,23,30,30
1650992996750,MATH 109,A01,083213,Anzaldo; Leesa B,0,7,30,30
1650992996750,MATH 109,A02,083214,Anzaldo; Leesa B,0,7,30,30
1650992996750,MATH 109,B01,083215,Anzaldo; Leesa B,0,8,30,30
1650992996750,MATH 109,B02,083216,Anzaldo; Leesa B,0,7,30,30
1650993002778,MATH 142A,A01,083219,Chow; Bennett,0,14,30,30
1650993002778,MATH 142A,A02,083220,Chow; Bennett,0,15,30,30
1650993002778,MATH 142A,B01,083221,Chow; Bennett,0,16,30,30
1650993002778,MATH 142A,B02,083222,Chow; Bennett,0,14,30,30
1650993008805,MATH 193A,A01,083224,Staff,0,6,30,30
1650993008805,MATH 193A,A02,083225,Staff,0,7,30,30
1650993008805,MATH 193A,A03,083781,Staff,0,6,30,30
1650993008805,MATH 193A,A04,083782,Staff,0,7,30,30
1650993014836,MATH 197,001,091859,McAuley; Julian John,9998,0,9999,1
1650993020895,COGS 9,A01,083615,Staff,0,18,60,60
1650993026925,COGS 11,A01,083617,Boyle; Mary E. T.,15,0,40,25
1650993032948,COGS 13,A01,083071,Staff,0,41,40,40
1650993038971,COGS 14A,A01,092681,Staff,0,38,100,100
1650993044996,COGS 14B,A01,083073,Cheng; Tzu-Han,0,13,50,50
1650993051020,COGS 17,A01,092677,Staff,6,0,75,69
1650993057046,COGS 100,A01,083619,Staff,0,31,60,60
1650993063071,COGS 101A,A01,083621,Davis; Joshua Daniel,0,29,60,60
1650993069101,COGS 101B,A01,091572,Staff,0,5,60,60
1650993075127,COGS 101C,A01,083625,Delgado; Tania,14,0,30,16
1650993081152,COGS 107A,A01,083627,Boyle; Mary E. T.,0,16,60,60
1650993087175,COGS 118A,A01,083075,Staff,0,10,60,60
1650993093199,CSE 3,A50,083646,Miranda; Gregory Joseph,15,0,38,23
1650993093199,CSE 3,A51,083647,Miranda; Gregory Joseph,36,0,37,1
1650993099232,CSE 8A,A50,083650,Miranda; Gregory Joseph,0,31,40,40
1650993105268,CSE 11,A01,083080,Cao; Yingjun,0,97,40,40
1650993111298,CSE 12,A01,083652,Staff,0,24,100,100
1650993117330,CSE 15L,A01,083654,Staff,0,3,50,50
1650993117330,CSE 15L,A02,083655,Staff,0,3,50,50
1650993123353,CSE 20,A01,083657,Staff,47,0,80,33
1650993129385,CSE 30,A01,083084,Eldon; John,1,38,80,79
1650993135409,CSE 100,A01,083659,Cao; Yingjun,0,71,50,50
1650993141442,CSE 134B,A01,083661,Powell; Thomas Allan,1,40,65,64
1650993147466,CSE 140,A01,083663,Staff,0,13,75,75
1650993153503,CSE 140L,A01,083088,Eldon; John,4,0,100,96
1650993159530,CSE 175,A01,083665,Kumar; Rakesh,0,0,25,25
1650993165554,CSE 190,A00,092507,Dubnov; Shlomo,9,0,20,11
1650993171579,ECE 45,A01,083139,Staff,0,7,60,60
1650993177603,ECE 65,A50,083695,Staff,0,7,30,30
1650993183625,ECE 109,A01,091882,Touri; Behrouz,32,0,70,38
1650993189647,ECE 180,A00,083140,Abi Samra; Nicholas Camill,17,0,30,13
1650993189647,ECE 180,B00,083141,Abi Samra; Nicholas Camill,0,0,30,30
1650993195670,MATH 10A,A01,083735,Patchell; Gregory David,2,0,30,28
1650993195670,MATH 10A,A02,083736,Patchell; Gregory David,27,0,30,3
1650993195670,MATH 10A,A03,083737,Patchell; Gregory David,23,0,30,7
1650993201698,MATH 10B,A01,083207,Staff,0,9,30,30
1650993201698,MATH 10B,A02,083208,Staff,0,5,30,30
1650993201698,MATH 10B,B01,083739,Staff,9,0,30,21
1650993201698,MATH 10B,B02,083740,Staff,28,0,30,2
1650993207723,MATH 18,A01,083743,Staff,0,0,30,30
1650993207723,MATH 18,A02,083744,Staff,23,0,30,7
1650993207723,MATH 18,A03,083745,Staff,19,0,30,11
1650993207723,MATH 18,A04,083746,Staff,26,0,30,4
1650993207723,MATH 18,B01,083748,Staff,0,15,30,30
1650993207723,MATH 18,B02,083749,Staff,0,14,30,30
1650993207723,MATH 18,B03,083750,Staff,0,13,30,30
1650993207723,MATH 18,B04,083751,Staff,0,13,30,30
1650993213746,MATH 20A,A01,083754,Staff,19,0,40,21
1650993219770,MATH 20B,A01,083756,Staff,0,14,30,30
1650993219770,MATH 20B,A02,083757,Staff,0,11,30,30
1650993225793,MATH 20C,A01,083760,Staff,0,17,30,30
1650993225793,MATH 20C,A02,083761,Staff,0,15,30,30
1650993225793,MATH 20C,B01,083762,Staff,9,0,30,21
1650993225793,MATH 20C,B02,083763,Staff,28,0,30,2
1650993231815,MATH 20D,A01,083765,Staff,3,1,30,27
1650993231815,MATH 20D,A02,083766,Staff,2,0,30,28
1650993231815,MATH 20D,A03,083767,Staff,22,0,30,8
1650993237843,MATH 20E,A01,083771,Staff,2,0,30,28
1650993237843,MATH 20E,A02,083772,Staff,12,0,30,18
1650993237843,MATH 20E,B01,083773,Staff,0,0,30,30
1650993237843,MATH 20E,B02,083774,Staff,0,0,30,30
1650993243868,MATH 103A,A01,083777,Staff,0,17,30,30
1650993243868,MATH 103A,A02,083778,Staff,0,15,30,30
1650993243868,MATH 103A,B01,083779,Staff,0,15,30,30
1650993243868,MATH 103A,B02,083780,Staff,0,14,30,30
1650993249891,MATH 105,A01,085443,Staff,0,23,30,30
1650993255918,MATH 109,A01,083213,Anzaldo; Leesa B,0,7,30,30
1650993255918,MATH 109,A02,083214,Anzaldo; Leesa B,0,7,30,30
1650993255918,MATH 109,B01,083215,Anzaldo; Leesa B,0,8,30,30
1650993255918,MATH 109,B02,083216,Anzaldo; Leesa B,0,7,30,30
1650993261943,MATH 142A,A01,083219,Chow; Bennett,0,14,30,30
1650993261943,MATH 142A,A02,083220,Chow; Bennett,0,15,30,30
1650993261943,MATH 142A,B01,083221,Chow; Bennett,0,16,30,30
1650993261943,MATH 142A,B02,083222,Chow; Bennett,0,14,30,30
1650993267970,MATH 193A,A01,083224,Staff,0,6,30,30
1650993267970,MATH 193A,A02,083225,Staff,0,7,30,30
1650993267970,MATH 193A,A03,083781,Staff,0,6,30,30
1650993267970,MATH 193A,A04,083782,Staff,0,7,30,30
1650993273993,MATH 197,001,091859,McAuley; Julian John,9998,0,9999,1
1650993280055,COGS 9,A01,083615,Staff,0,18,60,60
1650993286079,COGS 11,A01,083617,Boyle; Mary E. T.,15,0,40,25
1650993292111,COGS 13,A01,083071,Staff,0,41,40,40
1650993298137,COGS 14A,A01,092681,Staff,0,38,100,100
1650993304171,COGS 14B,A01,083073,Cheng; Tzu-Han,0,13,50,50
1650993310194,COGS 17,A01,092677,Staff,6,0,75,69
1650993316220,COGS 100,A01,083619,Staff,0,31,60,60
1650993322245,COGS 101A,A01,083621,Davis; Joshua Daniel,0,29,60,60
1650993328278,COGS 101B,A01,091572,Staff,0,5,60,60
1650993334301,COGS 101C,A01,083625,Delgado; Tania,14,0,30,16
1650993340326,COGS 107A,A01,083627,Boyle; Mary E. T.,0,16,60,60
1650993346424,COGS 118A,A01,083075,Staff,0,10,60,60
1650993352448,CSE 3,A50,083646,Miranda; Gregory Joseph,15,0,38,23
1650993352448,CSE 3,A51,083647,Miranda; Gregory Joseph,36,0,37,1
1650993358475,CSE 8A,A50,083650,Miranda; Gregory Joseph,0,31,40,40
1650993364500,CSE 11,A01,083080,Cao; Yingjun,0,97,40,40
1650993370524,CSE 12,A01,083652,Staff,0,24,100,100
1650993376547,CSE 15L,A01,083654,Staff,0,3,50,50
1650993376547,CSE 15L,A02,083655,Staff,0,3,50,50
1650993382571,CSE 20,A01,083657,Staff,47,0,80,33
1650993388594,CSE 30,A01,083084,Eldon; John,1,38,80,79
1650993394622,CSE 100,A01,083659,Cao; Yingjun,0,71,50,50
1650993400650,CSE 134B,A01,083661,Powell; Thomas Allan,1,40,65,64
1650993406673,CSE 140,A01,083663,Staff,0,13,75,75
1650993412702,CSE 140L,A01,083088,Eldon; John,4,0,100,96
1650993418729,CSE 175,A01,083665,Kumar; Rakesh,0,0,25,25
1650993424754,CSE 190,A00,092507,Dubnov; Shlomo,9,0,20,11
1650993430779,ECE 45,A01,083139,Staff,0,7,60,60
1650993436809,ECE 65,A50,083695,Staff,0,7,30,30
1650993442839,ECE 109,A01,091882,Touri; Behrouz,32,0,70,38
1650993448862,ECE 180,A00,083140,Abi Samra; Nicholas Camill,17,0,30,13
1650993448862,ECE 180,B00,083141,Abi Samra; Nicholas Camill,0,0,30,30
1650993454891,MATH 10A,A01,083735,Patchell; Gregory David,2,0,30,28
1650993454891,MATH 10A,A02,083736,Patchell; Gregory David,27,0,30,3
1650993454891,MATH 10A,A03,083737,Patchell; Gregory David,23,0,30,7
1650993460930,MATH 10B,A01,083207,Staff,0,9,30,30
1650993460930,MATH 10B,A02,083208,Staff,0,5,30,30
1650993460930,MATH 10B,B01,083739,Staff,9,0,30,21
1650993460930,MATH 10B,B02,083740,Staff,28,0,30,2
1650993466955,MATH 18,A01,083743,Staff,0,0,30,30
1650993466955,MATH 18,A02,083744,Staff,23,0,30,7
1650993466955,MATH 18,A03,083745,Staff,19,0,30,11
1650993466955,MATH 18,A04,083746,Staff,26,0,30,4
1650993466955,MATH 18,B01,083748,Staff,0,15,30,30
1650993466955,MATH 18,B02,083749,Staff,0,14,30,30
1650993466955,MATH 18,B03,083750,Staff,0,13,30,30
1650993466955,MATH 18,B04,083751,Staff,0,13,30,30
1650993472981,MATH 20A,A01,083754,Staff,19,0,40,21
1650993479013,MATH 20B,A01,083756,Staff,0,14,30,30
1650993479013,MATH 20B,A02,083757,Staff,0,11,30,30
1650993485242,MATH 20C,A01,083760,Staff,0,17,30,30
1650993485242,MATH 20C,A02,083761,Staff,0,15,30,30
1650993485242,MATH 20C,B01,083762,Staff,9,0,30,21
1650993485242,MATH 20C,B02,083763,Staff,28,0,30,2
1650993491277,MATH 20D,A01,083765,Staff,3,1,30,27
1650993491277,MATH 20D,A02,083766,Staff,2,0,30,28
1650993491277,MATH 20D,A03,083767,Staff,22,0,30,8
1650993497300,MATH 20E,A01,083771,Staff,2,0,30,28
1650993497300,MATH 20E,A02,083772,Staff,12,0,30,18
1650993497300,MATH 20E,B01,083773,Staff,0,0,30,30
1650993497300,MATH 20E,B02,083774,Staff,0,0,30,30
1650993503330,MATH 103A,A01,083777,Staff,0,17,30,30
1650993503330,MATH 103A,A02,083778,Staff,0,15,30,30
1650993503330,MATH 103A,B01,083779,Staff,0,15,30,30
1650993503330,MATH 103A,B02,083780,Staff,0,14,30,30
1650993509354,MATH 105,A01,085443,Staff,0,23,30,30
1650993515377,MATH 109,A01,083213,Anzaldo; Leesa B,0,7,30,30
1650993515377,MATH 109,A02,083214,Anzaldo; Leesa B,0,7,30,30
1650993515377,MATH 109,B01,083215,Anzaldo; Leesa B,0,8,30,30
1650993515377,MATH 109,B02,083216,Anzaldo; Leesa B,0,7,30,30
1650993521398,MATH 142A,A01,083219,Chow; Bennett,0,14,30,30
1650993521398,MATH 142A,A02,083220,Chow; Bennett,0,15,30,30
1650993521398,MATH 142A,B01,083221,Chow; Bennett,0,16,30,30
1650993521398,MATH 142A,B02,083222,Chow; Bennett,0,14,30,30
1650993527427,MATH 193A,A01,083224,Staff,0,6,30,30
1650993527427,MATH 193A,A02,083225,Staff,0,7,30,30
1650993527427,MATH 193A,A03,083781,Staff,0,6,30,30
1650993527427,MATH 193A,A04,083782,Staff,0,7,30,30
1650993533452,MATH 197,001,091859,McAuley; Julian John,9998,0,9999,1
1650993539502,COGS 9,A01,083615,Staff,0,18,60,60
1650993545537,COGS 11,A01,083617,Boyle; Mary E. T.,15,0,40,25
1650993551558,COGS 13,A01,083071,Staff,0,41,40,40
1650993557582,COGS 14A,A01,092681,Staff,0,39,100,100
1650993563604,COGS 14B,A01,083073,Cheng; Tzu-Han,0,13,50,50
1650993569630,COGS 17,A01,092677,Staff,6,0,75,69
1650993575662,COGS 100,A01,083619,Staff,0,31,60,60
1650993581701,COGS 101A,A01,083621,Davis; Joshua Daniel,0,29,60,60
1650993587726,COGS 101B,A01,091572,Staff,0,5,60,60
1650993593753,COGS 101C,A01,083625,Delgado; Tania,14,0,30,16
1650993599783,COGS 107A,A01,083627,Boyle; Mary E. T.,0,16,60,60
1650993605806,COGS 118A,A01,083075,Staff,0,10,60,60
1650993611845,CSE 3,A50,083646,Miranda; Gregory Joseph,15,0,38,23
1650993611845,CSE 3,A51,083647,Miranda; Gregory Joseph,36,0,37,1
1650993617869,CSE 8A,A50,083650,Miranda; Gregory Joseph,0,31,40,40
1650993623899,CSE 11,A01,083080,Cao; Yingjun,0,97,40,40
1650993629922,CSE 12,A01,083652,Staff,0,24,100,100
1650993635947,CSE 15L,A01,083654,Staff,0,3,50,50
1650993635947,CSE 15L,A02,083655,Staff,0,3,50,50
1650993641975,CSE 20,A01,083657,Staff,47,0,80,33
1650993648016,CSE 30,A01,083084,Eldon; John,1,38,80,79
1650993654039,CSE 100,A01,083659,Cao; Yingjun,0,71,50,50
1650993660065,CSE 134B,A01,083661,Powell; Thomas Allan,1,40,65,64
1650993666093,CSE 140,A01,083663,Staff,0,13,75,75
1650993672124,CSE 140L,A01,083088,Eldon; John,4,0,100,96
1650993678150,CSE 175,A01,083665,Kumar; Rakesh,0,0,25,25
1650993684177,CSE 190,A00,092507,Dubnov; Shlomo,9,0,20,11
1650993690203,ECE 45,A01,083139,Staff,0,7,60,60
1650993696236,ECE 65,A50,083695,Staff,0,7,30,30
1650993702261,ECE 109,A01,091882,Touri; Behrouz,32,0,70,38
1650993708289,ECE 180,A00,083140,Abi Samra; Nicholas Camill,17,0,30,13
1650993708289,ECE 180,B00,083141,Abi Samra; Nicholas Camill,0,0,30,30
1650993714330,MATH 10A,A01,083735,Patchell; Gregory David,2,0,30,28
1650993714330,MATH 10A,A02,083736,Patchell; Gregory David,27,0,30,3
1650993714330,MATH 10A,A03,083737,Patchell; Gregory David,23,0,30,7
1650993720351,MATH 10B,A01,083207,Staff,0,9,30,30
1650993720351,MATH 10B,A02,083208,Staff,0,5,30,30
1650993720351,MATH 10B,B01,083739,Staff,9,0,30,21
1650993720351,MATH 10B,B02,083740,Staff,28,0,30,2
1650993726397,MATH 18,A01,083743,Staff,0,0,30,30
1650993726397,MATH 18,A02,083744,Staff,23,0,30,7
1650993726397,MATH 18,A03,083745,Staff,19,0,30,11
1650993726397,MATH 18,A04,083746,Staff,26,0,30,4
1650993726397,MATH 18,B01,083748,Staff,0,15,30,30
1650993726397,MATH 18,B02,083749,Staff,0,14,30,30
1650993726397,MATH 18,B03,083750,Staff,0,13,30,30
1650993726397,MATH 18,B04,083751,Staff,0,13,30,30
1650993732437,MATH 20A,A01,083754,Staff,19,0,40,21
1650993738477,MATH 20B,A01,083756,Staff,0,14,30,30
1650993738477,MATH 20B,A02,083757,Staff,0,11,30,30
1650993744520,MATH 20C,A01,083760,Staff,0,17,30,30
1650993744520,MATH 20C,A02,083761,Staff,0,15,30,30
1650993744520,MATH 20C,B01,083762,Staff,9,0,30,21
1650993744520,MATH 20C,B02,083763,Staff,28,0,30,2
1650993750554,MATH 20D,A01,083765,Staff,3,1,30,27
1650993750554,MATH 20D,A02,083766,Staff,2,0,30,28
1650993750554,MATH 20D,A03,083767,Staff,22,0,30,8
1650993756578,MATH 20E,A01,083771,Staff,2,0,30,28
1650993756578,MATH 20E,A02,083772,Staff,12,0,30,18
1650993756578,MATH 20E,B01,083773,Staff,0,0,30,30
1650993756578,MATH 20E,B02,083774,Staff,0,0,30,30
1650993762602,MATH 103A,A01,083777,Staff,0,17,30,30
1650993762602,MATH 103A,A02,083778,Staff,0,15,30,30
1650993762602,MATH 103A,B01,083779,Staff,0,15,30,30
1650993762602,MATH 103A,B02,083780,Staff,0,14,30,30
1650993768626,MATH 105,A01,085443,Staff,0,23,30,30
1650993774650,MATH 109,A01,083213,Anzaldo; Leesa B,0,7,30,30
1650993774650,MATH 109,A02,083214,Anzaldo; Leesa B,0,7,30,30
1650993774650,MATH 109,B01,083215,Anzaldo; Leesa B,0,8,30,30
1650993774650,MATH 109,B02,083216,Anzaldo; Leesa B,0,7,30,30
1650993780680,MATH 142A,A01,083219,Chow; Bennett,0,14,30,30
1650993780680,MATH 142A,A02,083220,Chow; Bennett,0,15,30,30
1650993780680,MATH 142A,B01,083221,Chow; Bennett,0,16,30,30
1650993780680,MATH 142A,B02,083222,Chow; Bennett,0,14,30,30
1650993786705,MATH 193A,A01,083224,Staff,0,6,30,30
1650993786705,MATH 193A,A02,083225,Staff,0,7,30,30
1650993786705,MATH 193A,A03,083781,Staff,0,6,30,30
1650993786705,MATH 193A,A04,083782,Staff,0,7,30,30
1650993792729,MATH 197,001,091859,McAuley; Julian John,9998,0,9999,1
1650993798797,COGS 9,A01,083615,Staff,0,18,60,60
1650993804827,COGS 11,A01,083617,Boyle; Mary E. T.,15,0,40,25
1650993810854,COGS 13,A01,083071,Staff,0,41,40,40
1650993816877,COGS 14A,A01,092681,Staff,0,39,100,100
1650993822900,COGS 14B,A01,083073,Cheng; Tzu-Han,0,13,50,50
1650993828923,COGS 17,A01,092677,Staff,6,0,75,69
1650993834948,COGS 100,A01,083619,Staff,0,31,60,60
1650993840981,COGS 101A,A01,083621,Davis; Joshua Daniel,0,29,60,60
1650993847009,COGS 101B,A01,091572,Staff,0,5,60,60
1650993853031,COGS 101C,A01,083625,Delgado; Tania,14,0,30,16
1650993859055,COGS 107A,A01,083627,Boyle; Mary E. T.,0,16,60,60
1650993865081,COGS 118A,A01,083075,Staff,0,10,60,60
1650993871107,CSE 3,A50,083646,Miranda; Gregory Joseph,15,0,38,23
1650993871107,CSE 3,A51,083647,Miranda; Gregory Joseph,36,0,37,1
1650993877145,CSE 8A,A50,083650,Miranda; Gregory Joseph,0,31,40,40
1650993883167,CSE 11,A01,083080,Cao; Yingjun,0,97,40,40
1650993889191,CSE 12,A01,083652,Staff,0,24,100,100
1650993895217,CSE 15L,A01,083654,Staff,0,3,50,50
1650993895217,CSE 15L,A02,083655,Staff,0,3,50,50
1650993901241,CSE 20,A01,083657,Staff,47,0,80,33
1650993907273,CSE 30,A01,083084,Eldon; John,1,38,80,79
1650993913297,CSE 100,A01,083659,Cao; Yingjun,0,71,50,50
1650993919325,CSE 134B,A01,083661,Powell; Thomas Allan,1,40,65,64
1650993925353,CSE 140,A01,083663,Staff,0,13,75,75
1650993931377,CSE 140L,A01,083088,Eldon; John,4,0,100,96
1650993937408,CSE 175,A01,083665,Kumar; Rakesh,0,0,25,25
1650993943530,CSE 190,A00,092507,Dubnov; Shlomo,9,0,20,11
1650993949557,ECE 45,A01,083139,Staff,0,7,60,60
1650993955581,ECE 65,A50,083695,Staff,0,7,30,30
1650993961604,ECE 109,A01,091882,Touri; Behrouz,32,0,70,38
1650993967634,ECE 180,A00,083140,Abi Samra; Nicholas Camill,17,0,30,13
1650993967634,ECE 180,B00,083141,Abi Samra; Nicholas Camill,0,0,30,30
1650993973669,MATH 10A,A01,083735,Patchell; Gregory David,2,0,30,28
1650993973669,MATH 10A,A02,083736,Patchell; Gregory David,27,0,30,3
1650993973669,MATH 10A,A03,083737,Patchell; Gregory David,23,0,30,7
1650993979702,MATH 10B,A01,083207,Staff,0,9,30,30
1650993979702,MATH 10B,A02,083208,Staff,0,5,30,30
1650993979702,MATH 10B,B01,083739,Staff,9,0,30,21
1650993979702,MATH 10B,B02,083740,Staff,28,0,30,2
1650993985732,MATH 18,A01,083743,Staff,0,0,30,30
1650993985732,MATH 18,A02,083744,Staff,23,0,30,7
1650993985732,MATH 18,A03,083745,Staff,19,0,30,11
1650993985732,MATH 18,A04,083746,Staff,26,0,30,4
1650993985732,MATH 18,B01,083748,Staff,0,15,30,30
1650993985732,MATH 18,B02,083749,Staff,0,14,30,30
1650993985732,MATH 18,B03,083750,Staff,0,13,30,30
1650993985732,MATH 18,B04,083751,Staff,0,13,30,30
1650993991757,MATH 20A,A01,083754,Staff,19,0,40,21
1650993997782,MATH 20B,A01,083756,Staff,0,14,30,30
1650993997782,MATH 20B,A02,083757,Staff,0,11,30,30
1650994003810,MATH 20C,A01,083760,Staff,0,17,30,30
1650994003810,MATH 20C,A02,083761,Staff,0,15,30,30
1650994003810,MATH 20C,B01,083762,Staff,9,0,30,21
1650994003810,MATH 20C,B02,083763,Staff,28,0,30,2
1650994009834,MATH 20D,A01,083765,Staff,3,1,30,27
1650994009834,MATH 20D,A02,083766,Staff,2,0,30,28
1650994009834,MATH 20D,A03,083767,Staff,22,0,30,8
1650994015865,MATH 20E,A01,083771,Staff,2,0,30,28
1650994015865,MATH 20E,A02,083772,Staff,12,0,30,18
1650994015865,MATH 20E,B01,083773,Staff,0,0,30,30
1650994015865,MATH 20E,B02,083774,Staff,0,0,30,30
1650994021889,MATH 103A,A01,083777,Staff,0,17,30,30
1650994021889,MATH 103A,A02,083778,Staff,0,15,30,30
1650994021889,MATH 103A,B01,083779,Staff,0,15,30,30
1650994021889,MATH 103A,B02,083780,Staff,0,14,30,30
1650994027911,MATH 105,A01,085443,Staff,0,23,30,30
1650994033945,MATH 109,A01,083213,Anzaldo; Leesa B,0,7,30,30
1650994033945,MATH 109,A02,083214,Anzaldo; Leesa B,0,7,30,30
1650994033945,MATH 109,B01,083215,Anzaldo; Leesa B,0,8,30,30
1650994033945,MATH 109,B02,083216,Anzaldo; Leesa B,0,7,30,30
1650994039972,MATH 142A,A01,083219,Chow; Bennett,0,14,30,30
1650994039972,MATH 142A,A02,083220,Chow; Bennett,0,15,30,30
1650994039972,MATH 142A,B01,083221,Chow; Bennett,0,16,30,30
1650994039972,MATH 142A,B02,083222,Chow; Bennett,0,14,30,30
1650994045999,MATH 193A,A01,083224,Staff,0,6,30,30
1650994045999,MATH 193A,A02,083225,Staff,0,7,30,30
1650994045999,MATH 193A,A03,083781,Staff,0,6,30,30
1650994045999,MATH 193A,A04,083782,Staff,0,7,30,30
1650994052033,MATH 197,001,091859,McAuley; Julian John,9998,0,9999,1
1650994058110,COGS 9,A01,083615,Staff,0,18,60,60
1650994064153,COGS 11,A01,083617,Boyle; Mary E. T.,15,0,40,25
1650994070183,COGS 13,A01,083071,Staff,0,41,40,40
1650994076214,COGS 14A,A01,092681,Staff,0,39,100,100
1650994082238,COGS 14B,A01,083073,Cheng; Tzu-Han,0,13,50,50
1650994088262,COGS 17,A01,092677,Staff,6,0,75,69
1650994094288,COGS 100,A01,083619,Staff,0,31,60,60
1650994100311,COGS 101A,A01,083621,Davis; Joshua Daniel,0,29,60,60
1650994106335,COGS 101B,A01,091572,Staff,0,5,60,60
1650994112357,COGS 101C,A01,083625,Delgado; Tania,14,0,30,16
1650994118378,COGS 107A,A01,083627,Boyle; Mary E. T.,0,16,60,60
1650994124401,COGS 118A,A01,083075,Staff,0,10,60,60
1650994130434,CSE 3,A50,083646,Miranda; Gregory Joseph,15,0,38,23
1650994130434,CSE 3,A51,083647,Miranda; Gregory Joseph,36,0,37,1
1650994136456,CSE 8A,A50,083650,Miranda; Gregory Joseph,0,31,40,40
1650994142487,CSE 11,A01,083080,Cao; Yingjun,0,97,40,40
1650994148511,CSE 12,A01,083652,Staff,0,24,100,100
1650994154549,CSE 15L,A01,083654,Staff,0,3,50,50
1650994154549,CSE 15L,A02,083655,Staff,0,3,50,50
1650994160578,CSE 20,A01,083657,Staff,47,0,80,33
1650994166607,CSE 30,A01,083084,Eldon; John,1,38,80,79
1650994172635,CSE 100,A01,083659,Cao; Yingjun,0,71,50,50
1650994178659,CSE 134B,A01,083661,Powell; Thomas Allan,1,40,65,64
1650994184684,CSE 140,A01,083663,Staff,0,13,75,75
1650994190706,CSE 140L,A01,083088,Eldon; John,4,0,100,96
1650994196730,CSE 175,A01,083665,Kumar; Rakesh,0,0,25,25
1650994202753,CSE 190,A00,092507,Dubnov; Shlomo,9,0,20,11
1650994208783,ECE 45,A01,083139,Staff,0,7,60,60
1650994214810,ECE 65,A50,083695,Staff,0,7,30,30
1650994220836,ECE 109,A01,091882,Touri; Behrouz,32,0,70,38
1650994226867,ECE 180,A00,083140,Abi Samra; Nicholas Camill,17,0,30,13
1650994226867,ECE 180,B00,083141,Abi Samra; Nicholas Camill,0,0,30,30
1650994232891,MATH 10A,A01,083735,Patchell; Gregory David,2,0,30,28
1650994232891,MATH 10A,A02,083736,Patchell; Gregory David,27,0,30,3
1650994232891,MATH 10A,A03,083737,Patchell; Gregory David,23,0,30,7
1650994238919,MATH 10B,A01,083207,Staff,0,9,30,30
1650994238919,MATH 10B,A02,083208,Staff,0,5,30,30
1650994238919,MATH 10B,B01,083739,Staff,9,0,30,21
1650994238919,MATH 10B,B02,083740,Staff,28,0,30,2
1650994244946,MATH 18,A01,083743,Staff,0,0,30,30
1650994244946,MATH 18,A02,083744,Staff,23,0,30,7
1650994244946,MATH 18,A03,083745,Staff,19,0,30,11
1650994244946,MATH 18,A04,083746,Staff,26,0,30,4
1650994244946,MATH 18,B01,083748,Staff,0,15,30,30
1650994244946,MATH 18,B02,083749,Staff,0,14,30,30
1650994244946,MATH 18,B03,083750,Staff,0,13,30,30
1650994244946,MATH 18,B04,083751,Staff,0,13,30,30
1650994250969,MATH 20A,A01,083754,Staff,19,0,40,21
1650994256996,MATH 20B,A01,083756,Staff,0,14,30,30
1650994256996,MATH 20B,A02,083757,Staff,0,11,30,30
1650994263025,MATH 20C,A01,083760,Staff,0,17,30,30
1650994263025,MATH 20C,A02,083761,Staff,0,15,30,30
1650994263025,MATH 20C,B01,083762,Staff,9,0,30,21
1650994263025,MATH 20C,B02,083763,Staff,28,0,30,2
1650994269054,MATH 20D,A01,083765,Staff,3,1,30,27
1650994269054,MATH 20D,A02,083766,Staff,2,0,30,28
1650994269054,MATH 20D,A03,083767,Staff,22,0,30,8
1650994275083,MATH 20E,A01,083771,Staff,2,0,30,28
1650994275083,MATH 20E,A02,083772,Staff,12,0,30,18
1650994275083,MATH 20E,B01,083773,Staff,0,0,30,30
1650994275083,MATH 20E,B02,083774,Staff,0,0,30,30
1650994281106,MATH 103A,A01,083777,Staff,0,17,30,30
1650994281106,MATH 103A,A02,083778,Staff,0,15,30,30
1650994281106,MATH 103A,B01,083779,Staff,0,15,30,30
1650994281106,MATH 103A,B02,083780,Staff,0,14,30,30
1650994287127,MATH 105,A01,085443,Staff,0,23,30,30
1650994293160,MATH 109,A01,083213,Anzaldo; Leesa B,0,7,30,30
1650994293160,MATH 109,A02,083214,Anzaldo; Leesa B,0,7,30,30
1650994293160,MATH 109,B01,083215,Anzaldo; Leesa B,0,8,30,30
1650994293160,MATH 109,B02,083216,Anzaldo; Leesa B,0,7,30,30
1650994299188,MATH 142A,A01,083219,Chow; Bennett,0,14,30,30
1650994299188,MATH 142A,A02,083220,Chow; Bennett,0,15,30,30
1650994299188,MATH 142A,B01,083221,Chow; Bennett,0,16,30,30
1650994299188,MATH 142A,B02,083222,Chow; Bennett,0,14,30,30
1650994305211,MATH 193A,A01,083224,Staff,0,6,30,30
1650994305211,MATH 193A,A02,083225,Staff,0,7,30,30
1650994305211,MATH 193A,A03,083781,Staff,0,6,30,30
1650994305211,MATH 193A,A04,083782,Staff,0,7,30,30
1650994311239,MATH 197,001,091859,McAuley; Julian John,9998,0,9999,1
1650994317289,COGS 9,A01,083615,Staff,0,18,60,60
1650994323316,COGS 11,A01,083617,Boyle; Mary E. T.,15,0,40,25
1650994329339,COGS 13,A01,083071,Staff,0,41,40,40
1650994335366,COGS 14A,A01,092681,Staff,0,39,100,100
1650994341390,COGS 14B,A01,083073,Cheng; Tzu-Han,0,13,50,50
1650994347413,COGS 17,A01,092677,Staff,6,0,75,69
1650994353436,COGS 100,A01,083619,Staff,0,31,60,60
1650994359479,COGS 101A,A01,083621,Davis; Joshua Daniel,0,30,60,60
1650994365501,COGS 101B,A01,091572,Staff,0,5,60,60
1650994371527,COGS 101C,A01,083625,Delgado; Tania,14,0,30,16
1650994377562,COGS 107A,A01,083627,Boyle; Mary E. T.,0,16,60,60
1650994383587,COGS 118A,A01,083075,Staff,0,10,60,60
1650994389611,CSE 3,A50,083646,Miranda; Gregory Joseph,15,0,38,23
1650994389611,CSE 3,A51,083647,Miranda; Gregory Joseph,36,0,37,1
1650994395636,CSE 8A,A50,083650,Miranda; Gregory Joseph,0,31,40,40
1650994401665,CSE 11,A01,083080,Cao; Yingjun,0,97,40,40
1650994407688,CSE 12,A01,083652,Staff,0,24,100,100
1650994413713,CSE 15L,A01,083654,Staff,0,3,50,50
1650994413713,CSE 15L,A02,083655,Staff,0,3,50,50
1650994419739,CSE 20,A01,083657,Staff,47,0,80,33
1650994425764,CSE 30,A01,083084,Eldon; John,1,38,80,79
1650994431799,CSE 100,A01,083659,Cao; Yingjun,0,71,50,50
1650994437828,CSE 134B,A01,083661,Powell; Thomas Allan,1,40,65,64
1650994443852,CSE 140,A01,083663,Staff,0,13,75,75
1650994449880,CSE 140L,A01,083088,Eldon; John,4,0,100,96
1650994455911,CSE 175,A01,083665,Kumar; Rakesh,0,0,25,25
1650994461950,CSE 190,A00,092507,Dubnov; Shlomo,9,0,20,11
1650994467973,ECE 45,A01,083139,Staff,0,7,60,60
1650994474005,ECE 65,A50,083695,Staff,0,7,30,30
1650994480027,ECE 109,A01,091882,Touri; Behrouz,32,0,70,38
1650994486049,ECE 180,A00,083140,Abi Samra; Nicholas Camill,17,0,30,13
1650994486049,ECE 180,B00,083141,Abi Samra; Nicholas Camill,0,0,30,30
1650994492082,MATH 10A,A01,083735,Patchell; Gregory David,2,0,30,28
1650994492082,MATH 10A,A02,083736,Patchell; Gregory David,27,0,30,3
1650994492082,MATH 10A,A03,083737,Patchell; Gregory David,23,0,30,7
1650994498107,MATH 10B,A01,083207,Staff,0,9,30,30
1650994498107,MATH 10B,A02,083208,Staff,0,5,30,30
1650994498107,MATH 10B,B01,083739,Staff,9,0,30,21
1650994498107,MATH 10B,B02,083740,Staff,28,0,30,2
1650994504129,MATH 18,A01,083743,Staff,0,0,30,30
1650994504129,MATH 18,A02,083744,Staff,23,0,30,7
1650994504129,MATH 18,A03,083745,Staff,19,0,30,11
1650994504129,MATH 18,A04,083746,Staff,26,0,30,4
1650994504129,MATH 18,B01,083748,Staff,0,15,30,30
1650994504129,MATH 18,B02,083749,Staff,0,14,30,30
1650994504129,MATH 18,B03,083750,Staff,0,13,30,30
1650994504129,MATH 18,B04,083751,Staff,0,13,30,30
1650994510153,MATH 20A,A01,083754,Staff,19,0,40,21
1650994516182,MATH 20B,A01,083756,Staff,0,14,30,30
1650994516182,MATH 20B,A02,083757,Staff,0,11,30,30
1650994522212,MATH 20C,A01,083760,Staff,0,17,30,30
1650994522212,MATH 20C,A02,083761,Staff,0,15,30,30
1650994522212,MATH 20C,B01,083762,Staff,9,0,30,21
1650994522212,MATH 20C,B02,083763,Staff,28,0,30,2
1650994528236,MATH 20D,A01,083765,Staff,3,1,30,27
1650994528236,MATH 20D,A02,083766,Staff,2,0,30,28
1650994528236,MATH 20D,A03,083767,Staff,22,0,30,8
1650994534265,MATH 20E,A01,083771,Staff,2,0,30,28
1650994534265,MATH 20E,A02,083772,Staff,12,0,30,18
1650994534265,MATH 20E,B01,083773,Staff,0,0,30,30
1650994534265,MATH 20E,B02,083774,Staff,0,0,30,30
1650994540387,MATH 103A,A01,083777,Staff,0,17,30,30
1650994540387,MATH 103A,A02,083778,Staff,0,15,30,30
1650994540387,MATH 103A,B01,083779,Staff,0,15,30,30
1650994540387,MATH 103A,B02,083780,Staff,0,14,30,30
1650994546411,MATH 105,A01,085443,Staff,0,23,30,30
1650994552434,MATH 109,A01,083213,Anzaldo; Leesa B,0,7,30,30
1650994552434,MATH 109,A02,083214,Anzaldo; Leesa B,0,7,30,30
1650994552434,MATH 109,B01,083215,Anzaldo; Leesa B,0,8,30,30
1650994552434,MATH 109,B02,083216,Anzaldo; Leesa B,0,7,30,30
1650994558458,MATH 142A,A01,083219,Chow; Bennett,0,14,30,30
1650994558458,MATH 142A,A02,083220,Chow; Bennett,0,15,30,30
1650994558458,MATH 142A,B01,083221,Chow; Bennett,0,16,30,30
1650994558458,MATH 142A,B02,083222,Chow; Bennett,0,14,30,30
1650994564493,MATH 193A,A01,083224,Staff,0,6,30,30
1650994564493,MATH 193A,A02,083225,Staff,0,7,30,30
1650994564493,MATH 193A,A03,083781,Staff,0,6,30,30
1650994564493,MATH 193A,A04,083782,Staff,0,7,30,30
1650994570516,MATH 197,001,091859,McAuley; Julian John,9998,0,9999,1
1650994576582,COGS 9,A01,083615,Staff,0,18,60,60
1650994582606,COGS 11,A01,083617,Boyle; Mary E. T.,15,0,40,25
1650994588633,COGS 13,A01,083071,Staff,0,41,40,40
1650994594663,COGS 14A,A01,092681,Staff,0,39,100,100
1650994600694,COGS 14B,A01,083073,Cheng; Tzu-Han,0,13,50,50
1650994606722,COGS 17,A01,092677,Staff,6,0,75,69
1650994612747,COGS 100,A01,083619,Staff,0,31,60,60
1650994618774,COGS 101A,A01,083621,Davis; Joshua Daniel,0,30,60,60
1650994624799,COGS 101B,A01,091572,Staff,0,5,60,60
1650994630833,COGS 101C,A01,083625,Delgado; Tania,14,0,30,16
1650994636855,COGS 107A,A01,083627,Boyle; Mary E. T.,0,16,60,60
1650994642877,COGS 118A,A01,083075,Staff,0,10,60,60
1650994648916,CSE 3,A50,083646,Miranda; Gregory Joseph,15,0,38,23
1650994648916,CSE 3,A51,083647,Miranda; Gregory Joseph,36,0,37,1
1650994654948,CSE 8A,A50,083650,Miranda; Gregory Joseph,0,31,40,40
1650994660970,CSE 11,A01,083080,Cao; Yingjun,0,97,40,40
1650994667004,CSE 12,A01,083652,Staff,0,24,100,100
1650994673029,CSE 15L,A01,083654,Staff,0,3,50,50
1650994673029,CSE 15L,A02,083655,Staff,0,3,50,50
1650994679051,CSE 20,A01,083657,Staff,47,0,80,33
1650994685090,CSE 30,A01,083084,Eldon; John,1,38,80,79
1650994691118,CSE 100,A01,083659,Cao; Yingjun,0,71,50,50
1650994697140,CSE 134B,A01,083661,Powell; Thomas Allan,1,40,65,64
1650994703163,CSE 140,A01,083663,Staff,0,13,75,75
1650994709197,CSE 140L,A01,083088,Eldon; John,4,0,100,96
1650994715221,CSE 175,A01,083665,Kumar; Rakesh,0,0,25,25
1650994721246,CSE 190,A00,092507,Dubnov; Shlomo,9,0,20,11
1650994727272,ECE 45,A01,083139,Staff,0,7,60,60
1650994733297,ECE 65,A50,083695,Staff,0,7,30,30
1650994739321,ECE 109,A01,091882,Touri; Behrouz,32,0,70,38
1650994745345,ECE 180,A00,083140,Abi Samra; Nicholas Camill,17,0,30,13
1650994745345,ECE 180,B00,083141,Abi Samra; Nicholas Camill,0,0,30,30
1650994751375,MATH 10A,A01,083735,Patchell; Gregory David,2,0,30,28
1650994751375,MATH 10A,A02,083736,Patchell; Gregory David,27,0,30,3
1650994751375,MATH 10A,A03,083737,Patchell; Gregory David,23,0,30,7
1650994757398,MATH 10B,A01,083207,Staff,0,9,30,30
1650994757398,MATH 10B,A02,083208,Staff,0,5,30,30
1650994757398,MATH 10B,B01,083739,Staff,9,0,30,21
1650994757398,MATH 10B,B02,083740,Staff,28,0,30,2
1650994763422,MATH 18,A01,083743,Staff,0,0,30,30
1650994763422,MATH 18,A02,083744,Staff,23,0,30,7
1650994763422,MATH 18,A03,083745,Staff,19,0,30,11
1650994763422,MATH 18,A04,083746,Staff,26,0,30,4
1650994763422,MATH 18,B01,083748,Staff,0,15,30,30
1650994763422,MATH 18,B02,083749,Staff,0,14,30,30
1650994763422,MATH 18,B03,083750,Staff,0,13,30,30
1650994763422,MATH 18,B04,083751,Staff,0,13,30,30
1650994769444,MATH 20A,A01,083754,Staff,19,0,40,21
1650994775482,MATH 20B,A01,083756,Staff,0,14,30,30
1650994775482,MATH 20B,A02,083757,Staff,0,11,30,30
1650994781504,MATH 20C,A01,083760,Staff,0,17,30,30
1650994781504,MATH 20C,A02,083761,Staff,0,15,30,30
1650994781504,MATH 20C,B01,083762,Staff,9,0,30,21
1650994781504,MATH 20C,B02,083763,Staff,28,0,30,2
1650994787530,MATH 20D,A01,083765,Staff,3,1,30,27
1650994787530,MATH 20D,A02,083766,Staff,2,0,30,28
1650994787530,MATH 20D,A03,083767,Staff,22,0,30,8
1650994793563,MATH 20E,A01,083771,Staff,2,0,30,28
1650994793563,MATH 20E,A02,083772,Staff,12,0,30,18
1650994793563,MATH 20E,B01,083773,Staff,0,0,30,30
1650994793563,MATH 20E,B02,083774,Staff,0,0,30,30
1650994799588,MATH 103A,A01,083777,Staff,0,17,30,30
1650994799588,MATH 103A,A02,083778,Staff,0,15,30,30
1650994799588,MATH 103A,B01,083779,Staff,0,15,30,30
1650994799588,MATH 103A,B02,083780,Staff,0,14,30,30
1650994805611,MATH 105,A01,085443,Staff,0,23,30,30
1650994811640,MATH 109,A01,083213,Anzaldo; Leesa B,0,7,30,30
1650994811640,MATH 109,A02,083214,Anzaldo; Leesa B,0,7,30,30
1650994811640,MATH 109,B01,083215,Anzaldo; Leesa B,0,8,30,30
1650994811640,MATH 109,B02,083216,Anzaldo; Leesa B,0,7,30,30
1650994817681,MATH 142A,A01,083219,Chow; Bennett,0,14,30,30
1650994817681,MATH 142A,A02,083220,Chow; Bennett,0,15,30,30
1650994817681,MATH 142A,B01,083221,Chow; Bennett,0,16,30,30
1650994817681,MATH 142A,B02,083222,Chow; Bennett,0,14,30,30
1650994823713,MATH 193A,A01,083224,Staff,0,6,30,30
1650994823713,MATH 193A,A02,083225,Staff,0,7,30,30
1650994823713,MATH 193A,A03,083781,Staff,0,6,30,30
1650994823713,MATH 193A,A04,083782,Staff,0,7,30,30
1650994829738,MATH 197,001,091859,McAuley; Julian John,9998,0,9999,1
1650994835793,COGS 9,A01,083615,Staff,0,18,60,60
1650994841827,COGS 11,A01,083617,Boyle; Mary E. T.,15,0,40,25
1650994847850,COGS 13,A01,083071,Staff,0,41,40,40
1650994853881,COGS 14A,A01,092681,Staff,0,39,100,100
1650994859916,COGS 14B,A01,083073,Cheng; Tzu-Han,0,13,50,50
1650994865942,COGS 17,A01,092677,Staff,6,0,75,69
1650994871978,COGS 100,A01,083619,Staff,0,31,60,60
1650994878000,COGS 101A,A01,083621,Davis; Joshua Daniel,0,30,60,60
1650994884033,COGS 101B,A01,091572,Staff,0,5,60,60
1650994890058,COGS 101C,A01,083625,Delgado; Tania,14,0,30,16
1650994896089,COGS 107A,A01,083627,Boyle; Mary E. T.,0,16,60,60
1650994902112,COGS 118A,A01,083075,Staff,0,10,60,60
1650994908135,CSE 3,A50,083646,Miranda; Gregory Joseph,15,0,38,23
1650994908135,CSE 3,A51,083647,Miranda; Gregory Joseph,36,0,37,1
1650994914161,CSE 8A,A50,083650,Miranda; Gregory Joseph,0,31,40,40
1650994920193,CSE 11,A01,083080,Cao; Yingjun,0,97,40,40
1650994926217,CSE 12,A01,083652,Staff,0,24,100,100
1650994932252,CSE 15L,A01,083654,Staff,0,3,50,50
1650994932252,CSE 15L,A02,083655,Staff,0,3,50,50
1650994938289,CSE 20,A01,083657,Staff,47,0,80,33
1650994944317,CSE 30,A01,083084,Eldon; John,1,38,80,79
1650994950343,CSE 100,A01,083659,Cao; Yingjun,0,71,50,50
1650994956367,CSE 134B,A01,083661,Powell; Thomas Allan,1,40,65,64
1650994962389,CSE 140,A01,083663,Staff,0,13,75,75
1650994968413,CSE 140L,A01,083088,Eldon; John,4,0,100,96
1650994974437,CSE 175,A01,083665,Kumar; Rakesh,0,0,25,25
1650994980479,CSE 190,A00,092507,Dubnov; Shlomo,9,0,20,11
1650994986515,ECE 45,A01,083139,Staff,0,7,60,60
1650994992546,ECE 65,A50,083695,Staff,0,7,30,30
1650994998574,ECE 109,A01,091882,Touri; Behrouz,32,0,70,38
1650995004599,ECE 180,A00,083140,Abi Samra; Nicholas Camill,17,0,30,13
1650995004599,ECE 180,B00,083141,Abi Samra; Nicholas Camill,0,0,30,30
1650995010628,MATH 10A,A01,083735,Patchell; Gregory David,2,0,30,28
1650995010628,MATH 10A,A02,083736,Patchell; Gregory David,27,0,30,3
1650995010628,MATH 10A,A03,083737,Patchell; Gregory David,23,0,30,7
1650995016660,MATH 10B,A01,083207,Staff,0,9,30,30
1650995016660,MATH 10B,A02,083208,Staff,0,5,30,30
1650995016660,MATH 10B,B01,083739,Staff,9,0,30,21
1650995016660,MATH 10B,B02,083740,Staff,28,0,30,2
1650995022684,MATH 18,A01,083743,Staff,0,0,30,30
1650995022684,MATH 18,A02,083744,Staff,23,0,30,7
1650995022684,MATH 18,A03,083745,Staff,19,0,30,11
1650995022684,MATH 18,A04,083746,Staff,26,0,30,4
1650995022684,MATH 18,B01,083748,Staff,0,15,30,30
1650995022684,MATH 18,B02,083749,Staff,0,14,30,30
1650995022684,MATH 18,B03,083750,Staff,0,13,30,30
1650995022684,MATH 18,B04,083751,Staff,0,13,30,30
1650995028708,MATH 20A,A01,083754,Staff,19,0,40,21
1650995034736,MATH 20B,A01,083756,Staff,0,14,30,30
1650995034736,MATH 20B,A02,083757,Staff,0,11,30,30
1650995040769,MATH 20C,A01,083760,Staff,0,17,30,30
1650995040769,MATH 20C,A02,083761,Staff,0,15,30,30
1650995040769,MATH 20C,B01,083762,Staff,9,0,30,21
1650995040769,MATH 20C,B02,083763,Staff,28,0,30,2
1650995046800,MATH 20D,A01,083765,Staff,3,1,30,27
1650995046800,MATH 20D,A02,083766,Staff,2,0,30,28
1650995046800,MATH 20D,A03,083767,Staff,22,0,30,8
1650995052827,MATH 20E,A01,083771,Staff,2,0,30,28
1650995052827,MATH 20E,A02,083772,Staff,12,0,30,18
1650995052827,MATH 20E,B01,083773,Staff,0,0,30,30
1650995052827,MATH 20E,B02,083774,Staff,0,0,30,30
1650995058855,MATH 103A,A01,083777,Staff,0,17,30,30
1650995058855,MATH 103A,A02,083778,Staff,0,15,30,30
1650995058855,MATH 103A,B01,083779,Staff,0,15,30,30
1650995058855,MATH 103A,B02,083780,Staff,0,14,30,30
1650995064879,MATH 105,A01,085443,Staff,0,23,30,30
1650995070917,MATH 109,A01,083213,Anzaldo; Leesa B,0,7,30,30
1650995070917,MATH 109,A02,083214,Anzaldo; Leesa B,0,7,30,30
1650995070917,MATH 109,B01,083215,Anzaldo; Leesa B,0,8,30,30
1650995070917,MATH 109,B02,083216,Anzaldo; Leesa B,0,7,30,30
1650995076948,MATH 142A,A01,083219,Chow; Bennett,0,14,30,30
1650995076948,MATH 142A,A02,083220,Chow; Bennett,0,15,30,30
1650995076948,MATH 142A,B01,083221,Chow; Bennett,0,16,30,30
1650995076948,MATH 142A,B02,083222,Chow; Bennett,0,14,30,30
1650995082978,MATH 193A,A01,083224,Staff,0,6,30,30
1650995082978,MATH 193A,A02,083225,Staff,0,7,30,30
1650995082978,MATH 193A,A03,083781,Staff,0,6,30,30
1650995082978,MATH 193A,A04,083782,Staff,0,7,30,30
1650995089002,MATH 197,001,091859,McAuley; Julian John,9998,0,9999,1
1650995095058,COGS 9,A01,083615,Staff,0,18,60,60
1650995101084,COGS 11,A01,083617,Boyle; Mary E. T.,15,0,40,25
1650995107109,COGS 13,A01,083071,Staff,0,41,40,40
1650995113130,COGS 14A,A01,092681,Staff,0,39,100,100
1650995119155,COGS 14B,A01,083073,Cheng; Tzu-Han,0,13,50,50
1650995125221,COGS 17,A01,092677,Staff,6,0,75,69
1650995131353,COGS 100,A01,083619,Staff,0,31,60,60
1650995137380,COGS 101A,A01,083621,Davis; Joshua Daniel,0,30,60,60
1650995143402,COGS 101B,A01,091572,Staff,0,5,60,60
1650995149443,COGS 101C,A01,083625,Delgado; Tania,14,0,30,16
1650995155468,COGS 107A,A01,083627,Boyle; Mary E. T.,0,16,60,60
1650995161505,COGS 118A,A01,083075,Staff,0,10,60,60
1650995167534,CSE 3,A50,083646,Miranda; Gregory Joseph,15,0,38,23
1650995167534,CSE 3,A51,083647,Miranda; Gregory Joseph,36,0,37,1
1650995173576,CSE 8A,A50,083650,Miranda; Gregory Joseph,0,31,40,40
1650995179606,CSE 11,A01,083080,Cao; Yingjun,0,97,40,40
1650995185640,CSE 12,A01,083652,Staff,0,24,100,100
1650995191676,CSE 15L,A01,083654,Staff,0,3,50,50
1650995191676,CSE 15L,A02,083655,Staff,0,3,50,50
1650995197702,CSE 20,A01,083657,Staff,47,0,80,33
1650995203728,CSE 30,A01,083084,Eldon; John,1,38,80,79
1650995209752,CSE 100,A01,083659,Cao; Yingjun,0,71,50,50
1650995215776,CSE 134B,A01,083661,Powell; Thomas Allan,1,40,65,64
1650995221798,CSE 140,A01,083663,Staff,0,13,75,75
1650995227823,CSE 140L,A01,083088,Eldon; John,4,0,100,96
1650995233846,CSE 175,A01,083665,Kumar; Rakesh,0,0,25,25
1650995239881,CSE 190,A00,092507,Dubnov; Shlomo,9,0,20,11
1650995245911,ECE 45,A01,083139,Staff,0,7,60,60
1650995251935,ECE 65,A50,083695,Staff,0,7,30,30
1650995257958,ECE 109,A01,091882,Touri; Behrouz,32,0,70,38
1650995263980,ECE 180,A00,083140,Abi Samra; Nicholas Camill,17,0,30,13
1650995263980,ECE 180,B00,083141,Abi Samra; Nicholas Camill,0,0,30,30
1650995270017,MATH 10A,A01,083735,Patchell; Gregory David,2,0,30,28
1650995270017,MATH 10A,A02,083736,Patchell; Gregory David,27,0,30,3
1650995270017,MATH 10A,A03,083737,Patchell; Gregory David,23,0,30,7
1650995276048,MATH 10B,A01,083207,Staff,0,9,30,30
1650995276048,MATH 10B,A02,083208,Staff,0,5,30,30
1650995276048,MATH 10B,B01,083739,Staff,9,0,30,21
1650995276048,MATH 10B,B02,083740,Staff,28,0,30,2
1650995282078,MATH 18,A01,083743,Staff,0,0,30,30
1650995282078,MATH 18,A02,083744,Staff,23,0,30,7
1650995282078,MATH 18,A03,083745,Staff,19,0,30,11
1650995282078,MATH 18,A04,083746,Staff,26,0,30,4
1650995282078,MATH 18,B01,083748,Staff,0,15,30,30
1650995282078,MATH 18,B02,083749,Staff,0,14,30,30
1650995282078,MATH 18,B03,083750,Staff,0,13,30,30
1650995282078,MATH 18,B04,083751,Staff,0,13,30,30
1650995288115,MATH 20A,A01,083754,Staff,19,0,40,21
1650995294143,MATH 20B,A01,083756,Staff,0,14,30,30
1650995294143,MATH 20B,A02,083757,Staff,0,11,30,30
1650995300170,MATH 20C,A01,083760,Staff,0,17,30,30
1650995300170,MATH 20C,A02,083761,Staff,0,15,30,30
1650995300170,MATH 20C,B01,083762,Staff,9,0,30,21
1650995300170,MATH 20C,B02,083763,Staff,28,0,30,2
1650995306192,MATH 20D,A01,083765,Staff,3,1,30,27
1650995306192,MATH 20D,A02,083766,Staff,2,0,30,28
1650995306192,MATH 20D,A03,083767,Staff,22,0,30,8
1650995312222,MATH 20E,A01,083771,Staff,2,0,30,28
1650995312222,MATH 20E,A02,083772,Staff,12,0,30,18
1650995312222,MATH 20E,B01,083773,Staff,0,0,30,30
1650995312222,MATH 20E,B02,083774,Staff,0,0,30,30
1650995318260,MATH 103A,A01,083777,Staff,0,17,30,30
1650995318260,MATH 103A,A02,083778,Staff,0,15,30,30
1650995318260,MATH 103A,B01,083779,Staff,0,15,30,30
1650995318260,MATH 103A,B02,083780,Staff,0,14,30,30
1650995324283,MATH 105,A01,085443,Staff,0,23,30,30
1650995330306,MATH 109,A01,083213,Anzaldo; Leesa B,0,7,30,30
1650995330306,MATH 109,A02,083214,Anzaldo; Leesa B,0,7,30,30
1650995330306,MATH 109,B01,083215,Anzaldo; Leesa B,0,8,30,30
1650995330306,MATH 109,B02,083216,Anzaldo; Leesa B,0,7,30,30
1650995336330,MATH 142A,A01,083219,Chow; Bennett,0,14,30,30
1650995336330,MATH 142A,A02,083220,Chow; Bennett,0,15,30,30
1650995336330,MATH 142A,B01,083221,Chow; Bennett,0,16,30,30
1650995336330,MATH 142A,B02,083222,Chow; Bennett,0,14,30,30
1650995342354,MATH 193A,A01,083224,Staff,0,6,30,30
1650995342354,MATH 193A,A02,083225,Staff,0,7,30,30
1650995342354,MATH 193A,A03,083781,Staff,0,6,30,30
1650995342354,MATH 193A,A04,083782,Staff,0,7,30,30
1650995348384,MATH 197,001,091859,McAuley; Julian John,9998,0,9999,1
1650995354444,COGS 9,A01,083615,Staff,0,18,60,60
1650995360472,COGS 11,A01,083617,Boyle; Mary E. T.,15,0,40,25
1650995366494,COGS 13,A01,083071,Staff,0,41,40,40
1650995372526,COGS 14A,A01,092681,Staff,0,39,100,100
1650995378550,COGS 14B,A01,083073,Cheng; Tzu-Han,0,13,50,50
1650995384571,COGS 17,A01,092677,Staff,6,0,75,69
1650995390598,COGS 100,A01,083619,Staff,0,31,60,60
1650995396621,COGS 101A,A01,083621,Davis; Joshua Daniel,0,30,60,60
1650995402662,COGS 101B,A01,091572,Staff,0,5,60,60
1650995408688,COGS 101C,A01,083625,Delgado; Tania,14,0,30,16
1650995414726,COGS 107A,A01,083627,Boyle; Mary E. T.,0,16,60,60
1650995420752,COGS 118A,A01,083075,Staff,0,10,60,60
1650995426780,CSE 3,A50,083646,Miranda; Gregory Joseph,15,0,38,23
1650995426780,CSE 3,A51,083647,Miranda; Gregory Joseph,36,0,37,1
1650995432802,CSE 8A,A50,083650,Miranda; Gregory Joseph,0,31,40,40
1650995438829,CSE 11,A01,083080,Cao; Yingjun,0,97,40,40
1650995444861,CSE 12,A01,083652,Staff,0,24,100,100
1650995450887,CSE 15L,A01,083654,Staff,0,3,50,50
1650995450887,CSE 15L,A02,083655,Staff,0,3,50,50
1650995456910,CSE 20,A01,083657,Staff,47,0,80,33
1650995462934,CSE 30,A01,083084,Eldon; John,1,38,80,79
1650995468969,CSE 100,A01,083659,Cao; Yingjun,0,71,50,50
1650995474991,CSE 134B,A01,083661,Powell; Thomas Allan,1,40,65,64
1650995481012,CSE 140,A01,083663,Staff,0,13,75,75
1650995487034,CSE 140L,A01,083088,Eldon; John,4,0,100,96
1650995493060,CSE 175,A01,083665,Kumar; Rakesh,0,0,25,25
1650995499084,CSE 190,A00,092507,Dubnov; Shlomo,9,0,20,11
1650995505106,ECE 45,A01,083139,Staff,0,7,60,60
1650995511128,ECE 65,A50,083695,Staff,0,7,30,30
1650995517155,ECE 109,A01,091882,Touri; Behrouz,32,0,70,38
1650995523186,ECE 180,A00,083140,Abi Samra; Nicholas Camill,17,0,30,13
1650995523186,ECE 180,B00,083141,Abi Samra; Nicholas Camill,0,0,30,30
1650995529217,MATH 10A,A01,083735,Patchell; Gregory David,2,0,30,28
1650995529217,MATH 10A,A02,083736,Patchell; Gregory David,27,0,30,3
1650995529217,MATH 10A,A03,083737,Patchell; Gregory David,23,0,30,7
1650995535255,MATH 10B,A01,083207,Staff,0,9,30,30
1650995535255,MATH 10B,A02,083208,Staff,0,5,30,30
1650995535255,MATH 10B,B01,083739,Staff,9,0,30,21
1650995535255,MATH 10B,B02,083740,Staff,28,0,30,2
1650995541283,MATH 18,A01,083743,Staff,0,0,30,30
1650995541283,MATH 18,A02,083744,Staff,23,0,30,7
1650995541283,MATH 18,A03,083745,Staff,19,0,30,11
1650995541283,MATH 18,A04,083746,Staff,26,0,30,4
1650995541283,MATH 18,B01,083748,Staff,0,15,30,30
1650995541283,MATH 18,B02,083749,Staff,0,14,30,30
1650995541283,MATH 18,B03,083750,Staff,0,13,30,30
1650995541283,MATH 18,B04,083751,Staff,0,13,30,30
1650995547306,MATH 20A,A01,083754,Staff,19,0,40,21
1650995553335,MATH 20B,A01,083756,Staff,0,14,30,30
1650995553335,MATH 20B,A02,083757,Staff,0,11,30,30
1650995559367,MATH 20C,A01,083760,Staff,0,17,30,30
1650995559367,MATH 20C,A02,083761,Staff,0,15,30,30
1650995559367,MATH 20C,B01,083762,Staff,9,0,30,21
1650995559367,MATH 20C,B02,083763,Staff,28,0,30,2
1650995565403,MATH 20D,A01,083765,Staff,3,1,30,27
1650995565403,MATH 20D,A02,083766,Staff,2,0,30,28
1650995565403,MATH 20D,A03,083767,Staff,22,0,30,8
1650995571426,MATH 20E,A01,083771,Staff,2,0,30,28
1650995571426,MATH 20E,A02,083772,Staff,12,0,30,18
1650995571426,MATH 20E,B01,083773,Staff,0,0,30,30
1650995571426,MATH 20E,B02,083774,Staff,0,0,30,30
1650995577449,MATH 103A,A01,083777,Staff,0,17,30,30
1650995577449,MATH 103A,A02,083778,Staff,0,15,30,30
1650995577449,MATH 103A,B01,083779,Staff,0,15,30,30
1650995577449,MATH 103A,B02,083780,Staff,0,14,30,30
1650995583490,MATH 105,A01,085443,Staff,0,23,30,30
1650995589514,MATH 109,A01,083213,Anzaldo; Leesa B,0,7,30,30
1650995589514,MATH 109,A02,083214,Anzaldo; Leesa B,0,7,30,30
1650995589514,MATH 109,B01,083215,Anzaldo; Leesa B,0,8,30,30
1650995589514,MATH 109,B02,083216,Anzaldo; Leesa B,0,7,30,30
1650995595541,MATH 142A,A01,083219,Chow; Bennett,0,14,30,30
1650995595541,MATH 142A,A02,083220,Chow; Bennett,0,15,30,30
1650995595541,MATH 142A,B01,083221,Chow; Bennett,0,16,30,30
1650995595541,MATH 142A,B02,083222,Chow; Bennett,0,14,30,30
1650995601568,MATH 193A,A01,083224,Staff,0,6,30,30
1650995601568,MATH 193A,A02,083225,Staff,0,7,30,30
1650995601568,MATH 193A,A03,083781,Staff,0,6,30,30
1650995601568,MATH 193A,A04,083782,Staff,0,7,30,30
1650995607598,MATH 197,001,091859,McAuley; Julian John,9998,0,9999,1
1650995613653,COGS 9,A01,083615,Staff,0,18,60,60
1650995619682,COGS 11,A01,083617,Boyle; Mary E. T.,15,0,40,25
1650995625704,COGS 13,A01,083071,Staff,0,41,40,40
1650995631728,COGS 14A,A01,092681,Staff,0,39,100,100
1650995637766,COGS 14B,A01,083073,Cheng; Tzu-Han,0,13,50,50
1650995643808,COGS 17,A01,092677,Staff,7,0,75,68
1650995649843,COGS 100,A01,083619,Staff,0,31,60,60
1650995655870,COGS 101A,A01,083621,Davis; Joshua Daniel,0,30,60,60
1650995661902,COGS 101B,A01,091572,Staff,0,5,60,60
1650995667931,COGS 101C,A01,083625,Delgado; Tania,14,0,30,16
1650995673958,COGS 107A,A01,083627,Boyle; Mary E. T.,0,16,60,60
1650995679985,COGS 118A,A01,083075,Staff,0,10,60,60
1650995686019,CSE 3,A50,083646,Miranda; Gregory Joseph,15,0,38,23
1650995686019,CSE 3,A51,083647,Miranda; Gregory Joseph,36,0,37,1
1650995692059,CSE 8A,A50,083650,Miranda; Gregory Joseph,0,31,40,40
1650995698086,CSE 11,A01,083080,Cao; Yingjun,0,97,40,40
1650995704120,CSE 12,A01,083652,Staff,0,24,100,100
1650995710149,CSE 15L,A01,083654,Staff,0,3,50,50
1650995710149,CSE 15L,A02,083655,Staff,0,3,50,50
1650995716195,CSE 20,A01,083657,Staff,47,0,80,33
1650995722219,CSE 30,A01,083084,Eldon; John,1,38,80,79
1650995728348,CSE 100,A01,083659,Cao; Yingjun,0,71,50,50
1650995734372,CSE 134B,A01,083661,Powell; Thomas Allan,1,40,65,64
1650995740394,CSE 140,A01,083663,Staff,0,13,75,75
1650995746434,CSE 140L,A01,083088,Eldon; John,4,0,100,96
1650995752473,CSE 175,A01,083665,Kumar; Rakesh,0,0,25,25
1650995758497,CSE 190,A00,092507,Dubnov; Shlomo,9,0,20,11
1650995764522,ECE 45,A01,083139,Staff,0,7,60,60
1650995770549,ECE 65,A50,083695,Staff,0,7,30,30
1650995776576,ECE 109,A01,091882,Touri; Behrouz,32,0,70,38
1650995782599,ECE 180,A00,083140,Abi Samra; Nicholas Camill,17,0,30,13
1650995782599,ECE 180,B00,083141,Abi Samra; Nicholas Camill,0,0,30,30
1650995788625,MATH 10A,A01,083735,Patchell; Gregory David,2,0,30,28
1650995788625,MATH 10A,A02,083736,Patchell; Gregory David,27,0,30,3
1650995788625,MATH 10A,A03,083737,Patchell; Gregory David,23,0,30,7
1650995794649,MATH 10B,A01,083207,Staff,0,9,30,30
1650995794649,MATH 10B,A02,083208,Staff,0,5,30,30
1650995794649,MATH 10B,B01,083739,Staff,9,0,30,21
1650995794649,MATH 10B,B02,083740,Staff,28,0,30,2
1650995800674,MATH 18,A01,083743,Staff,0,0,30,30
1650995800674,MATH 18,A02,083744,Staff,23,0,30,7
1650995800674,MATH 18,A03,083745,Staff,19,0,30,11
1650995800674,MATH 18,A04,083746,Staff,26,0,30,4
1650995800674,MATH 18,B01,083748,Staff,0,15,30,30
1650995800674,MATH 18,B02,083749,Staff,0,14,30,30
1650995800674,MATH 18,B03,083750,Staff,0,13,30,30
1650995800674,MATH 18,B04,083751,Staff,0,13,30,30
1650995806698,MATH 20A,A01,083754,Staff,19,0,40,21
1650995812727,MATH 20B,A01,083756,Staff,0,14,30,30
1650995812727,MATH 20B,A02,083757,Staff,0,11,30,30
1650995818758,MATH 20C,A01,083760,Staff,0,17,30,30
1650995818758,MATH 20C,A02,083761,Staff,0,15,30,30
1650995818758,MATH 20C,B01,083762,Staff,9,0,30,21
1650995818758,MATH 20C,B02,083763,Staff,28,0,30,2
1650995824789,MATH 20D,A01,083765,Staff,3,1,30,27
1650995824789,MATH 20D,A02,083766,Staff,2,0,30,28
1650995824789,MATH 20D,A03,083767,Staff,22,0,30,8
1650995830820,MATH 20E,A01,083771,Staff,2,0,30,28
1650995830820,MATH 20E,A02,083772,Staff,12,0,30,18
1650995830820,MATH 20E,B01,083773,Staff,0,0,30,30
1650995830820,MATH 20E,B02,083774,Staff,0,0,30,30
1650995836854,MATH 103A,A01,083777,Staff,0,17,30,30
1650995836854,MATH 103A,A02,083778,Staff,0,15,30,30
1650995836854,MATH 103A,B01,083779,Staff,0,15,30,30
1650995836854,MATH 103A,B02,083780,Staff,0,14,30,30
1650995842884,MATH 105,A01,085443,Staff,0,23,30,30
1650995848924,MATH 109,A01,083213,Anzaldo; Leesa B,0,7,30,30
1650995848924,MATH 109,A02,083214,Anzaldo; Leesa B,0,7,30,30
1650995848924,MATH 109,B01,083215,Anzaldo; Leesa B,0,8,30,30
1650995848924,MATH 109,B02,083216,Anzaldo; Leesa B,0,7,30,30
1650995854950,MATH 142A,A01,083219,Chow; Bennett,0,14,30,30
1650995854950,MATH 142A,A02,083220,Chow; Bennett,0,15,30,30
1650995854950,MATH 142A,B01,083221,Chow; Bennett,0,16,30,30
1650995854950,MATH 142A,B02,083222,Chow; Bennett,0,14,30,30
1650995860971,MATH 193A,A01,083224,Staff,0,6,30,30
1650995860971,MATH 193A,A02,083225,Staff,0,7,30,30
1650995860971,MATH 193A,A03,083781,Staff,0,6,30,30
1650995860971,MATH 193A,A04,083782,Staff,0,7,30,30
1650995866996,MATH 197,001,091859,McAuley; Julian John,9998,0,9999,1
1650995873050,COGS 9,A01,083615,Staff,0,18,60,60
1650995879077,COGS 11,A01,083617,Boyle; Mary E. T.,15,0,40,25
1650995885099,COGS 13,A01,083071,Staff,0,41,40,40
1650995891130,COGS 14A,A01,092681,Staff,0,39,100,100
1650995897156,COGS 14B,A01,083073,Cheng; Tzu-Han,0,13,50,50
1650995903185,COGS 17,A01,092677,Staff,7,0,75,68
1650995909207,COGS 100,A01,083619,Staff,0,31,60,60
1650995915235,COGS 101A,A01,083621,Davis; Joshua Daniel,0,30,60,60
1650995921270,COGS 101B,A01,091572,Staff,0,5,60,60
1650995927298,COGS 101C,A01,083625,Delgado; Tania,14,0,30,16
1650995933325,COGS 107A,A01,083627,Boyle; Mary E. T.,0,16,60,60
1650995939348,COGS 118A,A01,083075,Staff,0,10,60,60
1650995945370,CSE 3,A50,083646,Miranda; Gregory Joseph,15,0,38,23
1650995945370,CSE 3,A51,083647,Miranda; Gregory Joseph,36,0,37,1
1650995951393,CSE 8A,A50,083650,Miranda; Gregory Joseph,0,31,40,40
1650995957415,CSE 11,A01,083080,Cao; Yingjun,0,97,40,40
1650995963450,CSE 12,A01,083652,Staff,0,24,100,100
1650995969473,CSE 15L,A01,083654,Staff,0,3,50,50
1650995969473,CSE 15L,A02,083655,Staff,0,3,50,50
1650995975499,CSE 20,A01,083657,Staff,47,0,80,33
1650995981521,CSE 30,A01,083084,Eldon; John,1,38,80,79
1650995987549,CSE 100,A01,083659,Cao; Yingjun,0,71,50,50
1650995993587,CSE 134B,A01,083661,Powell; Thomas Allan,1,40,65,64
1650995999609,CSE 140,A01,083663,Staff,0,13,75,75
1650996005635,CSE 140L,A01,083088,Eldon; John,4,0,100,96
1650996011656,CSE 175,A01,083665,Kumar; Rakesh,0,0,25,25
1650996017679,CSE 190,A00,092507,Dubnov; Shlomo,9,0,20,11
1650996023702,ECE 45,A01,083139,Staff,0,7,60,60
1650996029731,ECE 65,A50,083695,Staff,0,7,30,30
1650996035757,ECE 109,A01,091882,Touri; Behrouz,32,0,70,38
1650996041789,ECE 180,A00,083140,Abi Samra; Nicholas Camill,17,0,30,13
1650996041789,ECE 180,B00,083141,Abi Samra; Nicholas Camill,0,0,30,30
1650996047816,MATH 10A,A01,083735,Patchell; Gregory David,2,0,30,28
1650996047816,MATH 10A,A02,083736,Patchell; Gregory David,27,0,30,3
1650996047816,MATH 10A,A03,083737,Patchell; Gregory David,23,0,30,7
1650996053842,MATH 10B,A01,083207,Staff,0,9,30,30
1650996053842,MATH 10B,A02,083208,Staff,0,5,30,30
1650996053842,MATH 10B,B01,083739,Staff,9,0,30,21
1650996053842,MATH 10B,B02,083740,Staff,28,0,30,2
1650996059869,MATH 18,A01,083743,Staff,0,0,30,30
1650996059869,MATH 18,A02,083744,Staff,23,0,30,7
1650996059869,MATH 18,A03,083745,Staff,19,0,30,11
1650996059869,MATH 18,A04,083746,Staff,26,0,30,4
1650996059869,MATH 18,B01,083748,Staff,0,15,30,30
1650996059869,MATH 18,B02,083749,Staff,0,14,30,30
1650996059869,MATH 18,B03,083750,Staff,0,13,30,30
1650996059869,MATH 18,B04,083751,Staff,0,13,30,30
1650996065897,MATH 20A,A01,083754,Staff,19,0,40,21
1650996071921,MATH 20B,A01,083756,Staff,0,14,30,30
1650996071921,MATH 20B,A02,083757,Staff,0,11,30,30
1650996077951,MATH 20C,A01,083760,Staff,0,17,30,30
1650996077951,MATH 20C,A02,083761,Staff,0,15,30,30
1650996077951,MATH 20C,B01,083762,Staff,9,0,30,21
1650996077951,MATH 20C,B02,083763,Staff,28,0,30,2
1650996083975,MATH 20D,A01,083765,Staff,3,1,30,27
1650996083975,MATH 20D,A02,083766,Staff,2,0,30,28
1650996083975,MATH 20D,A03,083767,Staff,22,0,30,8
1650996090001,MATH 20E,A01,083771,Staff,2,0,30,28
1650996090001,MATH 20E,A02,083772,Staff,12,0,30,18
1650996090001,MATH 20E,B01,083773,Staff,0,0,30,30
1650996090001,MATH 20E,B02,083774,Staff,0,0,30,30
1650996096025,MATH 103A,A01,083777,Staff,0,17,30,30
1650996096025,MATH 103A,A02,083778,Staff,0,15,30,30
1650996096025,MATH 103A,B01,083779,Staff,0,15,30,30
1650996096025,MATH 103A,B02,083780,Staff,0,14,30,30
1650996102051,MATH 105,A01,085443,Staff,0,23,30,30
1650996108079,MATH 109,A01,083213,Anzaldo; Leesa B,0,7,30,30
1650996108079,MATH 109,A02,083214,Anzaldo; Leesa B,0,7,30,30
1650996108079,MATH 109,B01,083215,Anzaldo; Leesa B,0,8,30,30
1650996108079,MATH 109,B02,083216,Anzaldo; Leesa B,0,7,30,30
1650996114105,MATH 142A,A01,083219,Chow; Bennett,0,14,30,30
1650996114105,MATH 142A,A02,083220,Chow; Bennett,0,15,30,30
1650996114105,MATH 142A,B01,083221,Chow; Bennett,0,16,30,30
1650996114105,MATH 142A,B02,083222,Chow; Bennett,0,14,30,30
1650996120137,MATH 193A,A01,083224,Staff,0,6,30,30
1650996120137,MATH 193A,A02,083225,Staff,0,7,30,30
1650996120137,MATH 193A,A03,083781,Staff,0,6,30,30
1650996120137,MATH 193A,A04,083782,Staff,0,7,30,30
1650996126163,MATH 197,001,091859,McAuley; Julian John,9998,0,9999,1
1650996132233,COGS 9,A01,083615,Staff,0,18,60,60
1650996138272,COGS 11,A01,083617,Boyle; Mary E. T.,15,0,40,25
1650996144296,COGS 13,A01,083071,Staff,0,41,40,40
1650996150329,COGS 14A,A01,092681,Staff,0,39,100,100
1650996156356,COGS 14B,A01,083073,Cheng; Tzu-Han,0,13,50,50
1650996162386,COGS 17,A01,092677,Staff,7,0,75,68
1650996168416,COGS 100,A01,083619,Staff,0,31,60,60
1650996174438,COGS 101A,A01,083621,Davis; Joshua Daniel,0,30,60,60
1650996180461,COGS 101B,A01,091572,Staff,0,5,60,60
1650996186483,COGS 101C,A01,083625,Delgado; Tania,14,0,30,16
1650996192510,COGS 107A,A01,083627,Boyle; Mary E. T.,0,16,60,60
1650996198533,COGS 118A,A01,083075,Staff,0,10,60,60
1650996204557,CSE 3,A50,083646,Miranda; Gregory Joseph,15,0,38,23
1650996204557,CSE 3,A51,083647,Miranda; Gregory Joseph,36,0,37,1
1650996210587,CSE 8A,A50,083650,Miranda; Gregory Joseph,0,31,40,40
1650996216610,CSE 11,A01,083080,Cao; Yingjun,0,97,40,40
1650996222631,CSE 12,A01,083652,Staff,0,24,100,100
1650996228654,CSE 15L,A01,083654,Staff,0,3,50,50
1650996228654,CSE 15L,A02,083655,Staff,0,3,50,50
1650996234687,CSE 20,A01,083657,Staff,47,0,80,33
1650996240710,CSE 30,A01,083084,Eldon; John,1,38,80,79
1650996246746,CSE 100,A01,083659,Cao; Yingjun,0,71,50,50
1650996252770,CSE 134B,A01,083661,Powell; Thomas Allan,1,40,65,64
1650996258801,CSE 140,A01,083663,Staff,0,13,75,75
1650996264827,CSE 140L,A01,083088,Eldon; John,4,0,100,96
1650996270854,CSE 175,A01,083665,Kumar; Rakesh,0,0,25,25
1650996276883,CSE 190,A00,092507,Dubnov; Shlomo,9,0,20,11
1650996282907,ECE 45,A01,083139,Staff,0,7,60,60
1650996288932,ECE 65,A50,083695,Staff,0,7,30,30
1650996294954,ECE 109,A01,091882,Touri; Behrouz,32,0,70,38
1650996300978,ECE 180,A00,083140,Abi Samra; Nicholas Camill,17,0,30,13
1650996300978,ECE 180,B00,083141,Abi Samra; Nicholas Camill,0,0,30,30
1650996307000,MATH 10A,A01,083735,Patchell; Gregory David,2,0,30,28
1650996307000,MATH 10A,A02,083736,Patchell; Gregory David,27,0,30,3
1650996307000,MATH 10A,A03,083737,Patchell; Gregory David,23,0,30,7
1650996313037,MATH 10B,A01,083207,Staff,0,9,30,30
1650996313037,MATH 10B,A02,083208,Staff,0,5,30,30
1650996313037,MATH 10B,B01,083739,Staff,9,0,30,21
1650996313037,MATH 10B,B02,083740,Staff,28,0,30,2
1650996319164,MATH 18,A01,083743,Staff,0,0,30,30
1650996319164,MATH 18,A02,083744,Staff,23,0,30,7
1650996319164,MATH 18,A03,083745,Staff,19,0,30,11
1650996319164,MATH 18,A04,083746,Staff,26,0,30,4
1650996319164,MATH 18,B01,083748,Staff,0,15,30,30
1650996319164,MATH 18,B02,083749,Staff,0,14,30,30
1650996319164,MATH 18,B03,083750,Staff,0,13,30,30
1650996319164,MATH 18,B04,083751,Staff,0,13,30,30
1650996325301,MATH 20A,A01,083754,Staff,19,0,40,21
1650996331328,MATH 20B,A01,083756,Staff,0,14,30,30
1650996331328,MATH 20B,A02,083757,Staff,0,11,30,30
1650996337360,MATH 20C,A01,083760,Staff,0,17,30,30
1650996337360,MATH 20C,A02,083761,Staff,0,15,30,30
1650996337360,MATH 20C,B01,083762,Staff,9,0,30,21
1650996337360,MATH 20C,B02,083763,Staff,28,0,30,2
1650996343382,MATH 20D,A01,083765,Staff,3,1,30,27
1650996343382,MATH 20D,A02,083766,Staff,2,0,30,28
1650996343382,MATH 20D,A03,083767,Staff,22,0,30,8
1650996349410,MATH 20E,A01,083771,Staff,2,0,30,28
1650996349410,MATH 20E,A02,083772,Staff,12,0,30,18
1650996349410,MATH 20E,B01,083773,Staff,0,0,30,30
1650996349410,MATH 20E,B02,083774,Staff,0,0,30,30
1650996355434,MATH 103A,A01,083777,Staff,0,17,30,30
1650996355434,MATH 103A,A02,083778,Staff,0,15,30,30
1650996355434,MATH 103A,B01,083779,Staff,0,15,30,30
1650996355434,MATH 103A,B02,083780,Staff,0,14,30,30
1650996361467,MATH 105,A01,085443,Staff,0,23,30,30
1650996367529,MATH 109,A01,083213,Anzaldo; Leesa B,0,7,30,30
1650996367529,MATH 109,A02,083214,Anzaldo; Leesa B,0,7,30,30
1650996367529,MATH 109,B01,083215,Anzaldo; Leesa B,0,8,30,30
1650996367529,MATH 109,B02,083216,Anzaldo; Leesa B,0,7,30,30
1650996373570,MATH 142A,A01,083219,Chow; Bennett,0,14,30,30
1650996373570,MATH 142A,A02,083220,Chow; Bennett,0,15,30,30
1650996373570,MATH 142A,B01,083221,Chow; Bennett,0,16,30,30
1650996373570,MATH 142A,B02,083222,Chow; Bennett,0,14,30,30
1650996379598,MATH 193A,A01,083224,Staff,0,6,30,30
1650996379598,MATH 193A,A02,083225,Staff,0,7,30,30
1650996379598,MATH 193A,A03,083781,Staff,0,6,30,30
1650996379598,MATH 193A,A04,083782,Staff,0,7,30,30
1650996385620,MATH 197,001,091859,McAuley; Julian John,9998,0,9999,1
1650996391673,COGS 9,A01,083615,Staff,0,18,60,60
1650996397696,COGS 11,A01,083617,Boyle; Mary E. T.,15,0,40,25
1650996403722,COGS 13,A01,083071,Staff,0,41,40,40
1650996409748,COGS 14A,A01,092681,Staff,0,39,100,100
1650996415777,COGS 14B,A01,083073,Cheng; Tzu-Han,0,13,50,50
1650996421801,COGS 17,A01,092677,Staff,7,0,75,68
1650996427824,COGS 100,A01,083619,Staff,0,31,60,60
1650996433848,COGS 101A,A01,083621,Davis; Joshua Daniel,0,30,60,60
1650996439875,COGS 101B,A01,091572,Staff,0,5,60,60
1650996445900,COGS 101C,A01,083625,Delgado; Tania,14,0,30,16
1650996451936,COGS 107A,A01,083627,Boyle; Mary E. T.,0,16,60,60
1650996457960,COGS 118A,A01,083075,Staff,0,10,60,60
1650996463982,CSE 3,A50,083646,Miranda; Gregory Joseph,15,0,38,23
1650996463982,CSE 3,A51,083647,Miranda; Gregory Joseph,36,0,37,1
1650996470012,CSE 8A,A50,083650,Miranda; Gregory Joseph,0,31,40,40
1650996476039,CSE 11,A01,083080,Cao; Yingjun,0,97,40,40
1650996482063,CSE 12,A01,083652,Staff,0,24,100,100
1650996488096,CSE 15L,A01,083654,Staff,0,3,50,50
1650996488096,CSE 15L,A02,083655,Staff,0,3,50,50
1650996494138,CSE 20,A01,083657,Staff,47,0,80,33
1650996500168,CSE 30,A01,083084,Eldon; John,1,38,80,79
1650996506198,CSE 100,A01,083659,Cao; Yingjun,0,71,50,50
1650996512226,CSE 134B,A01,083661,Powell; Thomas Allan,1,40,65,64
1650996518250,CSE 140,A01,083663,Staff,0,13,75,75
1650996524287,CSE 140L,A01,083088,Eldon; John,4,0,100,96
1650996530321,CSE 175,A01,083665,Kumar; Rakesh,0,0,25,25
1650996536344,CSE 190,A00,092507,Dubnov; Shlomo,9,0,20,11
1650996542367,ECE 45,A01,083139,Staff,0,7,60,60
1650996548390,ECE 65,A50,083695,Staff,0,7,30,30
1650996554422,ECE 109,A01,091882,Touri; Behrouz,32,0,70,38
1650996560449,ECE 180,A00,083140,Abi Samra; Nicholas Camill,17,0,30,13
1650996560449,ECE 180,B00,083141,Abi Samra; Nicholas Camill,0,0,30,30
1650996566478,MATH 10A,A01,083735,Patchell; Gregory David,2,0,30,28
1650996566478,MATH 10A,A02,083736,Patchell; Gregory David,27,0,30,3
1650996566478,MATH 10A,A03,083737,Patchell; Gregory David,23,0,30,7
1650996572503,MATH 10B,A01,083207,Staff,0,9,30,30
1650996572503,MATH 10B,A02,083208,Staff,0,5,30,30
1650996572503,MATH 10B,B01,083739,Staff,9,0,30,21
1650996572503,MATH 10B,B02,083740,Staff,28,0,30,2
1650996578534,MATH 18,A01,083743,Staff,0,0,30,30
1650996578534,MATH 18,A02,083744,Staff,23,0,30,7
1650996578534,MATH 18,A03,083745,Staff,19,0,30,11
1650996578534,MATH 18,A04,083746,Staff,26,0,30,4
1650996578534,MATH 18,B01,083748,Staff,0,15,30,30
1650996578534,MATH 18,B02,083749,Staff,0,14,30,30
1650996578534,MATH 18,B03,083750,Staff,0,13,30,30
1650996578534,MATH 18,B04,083751,Staff,0,13,30,30
1650996584557,MATH 20A,A01,083754,Staff,19,0,40,21
1650996590583,MATH 20B,A01,083756,Staff,0,14,30,30
1650996590583,MATH 20B,A02,083757,Staff,0,11,30,30
1650996596615,MATH 20C,A01,083760,Staff,0,17,30,30
1650996596615,MATH 20C,A02,083761,Staff,0,15,30,30
1650996596615,MATH 20C,B01,083762,Staff,9,0,30,21
1650996596615,MATH 20C,B02,083763,Staff,28,0,30,2
1650996602640,MATH 20D,A01,083765,Staff,3,1,30,27
1650996602640,MATH 20D,A02,083766,Staff,2,0,30,28
1650996602640,MATH 20D,A03,083767,Staff,22,0,30,8
1650996608667,MATH 20E,A01,083771,Staff,2,0,30,28
1650996608667,MATH 20E,A02,083772,Staff,12,0,30,18
1650996608667,MATH 20E,B01,083773,Staff,0,0,30,30
1650996608667,MATH 20E,B02,083774,Staff,0,0,30,30
1650996614691,MATH 103A,A01,083777,Staff,0,17,30,30
1650996614691,MATH 103A,A02,083778,Staff,0,15,30,30
1650996614691,MATH 103A,B01,083779,Staff,0,15,30,30
1650996614691,MATH 103A,B02,083780,Staff,0,14,30,30
1650996620717,MATH 105,A01,085443,Staff,0,23,30,30
1650996626756,MATH 109,A01,083213,Anzaldo; Leesa B,0,7,30,30
1650996626756,MATH 109,A02,083214,Anzaldo; Leesa B,0,7,30,30
1650996626756,MATH 109,B01,083215,Anzaldo; Leesa B,0,8,30,30
1650996626756,MATH 109,B02,083216,Anzaldo; Leesa B,0,7,30,30
1650996632783,MATH 142A,A01,083219,Chow; Bennett,0,14,30,30
1650996632783,MATH 142A,A02,083220,Chow; Bennett,0,15,30,30
1650996632783,MATH 142A,B01,083221,Chow; Bennett,0,16,30,30
1650996632783,MATH 142A,B02,083222,Chow; Bennett,0,14,30,30
1650996638810,MATH 193A,A01,083224,Staff,0,6,30,30
1650996638810,MATH 193A,A02,083225,Staff,0,7,30,30
1650996638810,MATH 193A,A03,083781,Staff,0,6,30,30
1650996638810,MATH 193A,A04,083782,Staff,0,7,30,30
1650996644835,MATH 197,001,091859,McAuley; Julian John,9998,0,9999,1
1650996650906,COGS 9,A01,083615,Staff,0,18,60,60
1650996656929,COGS 11,A01,083617,Boyle; Mary E. T.,15,0,40,25
1650996662979,COGS 13,A01,083071,Staff,0,41,40,40
1650996669001,COGS 14A,A01,092681,Staff,0,39,100,100
1650996675031,COGS 14B,A01,083073,Cheng; Tzu-Han,0,13,50,50
1650996681057,COGS 17,A01,092677,Staff,7,0,75,68
1650996687080,COGS 100,A01,083619,Staff,0,31,60,60
1650996693111,COGS 101A,A01,083621,Davis; Joshua Daniel,0,30,60,60
1650996699144,COGS 101B,A01,091572,Staff,0,5,60,60
1650996705171,COGS 101C,A01,083625,Delgado; Tania,14,0,30,16
1650996711195,COGS 107A,A01,083627,Boyle; Mary E. T.,0,16,60,60
1650996717218,COGS 118A,A01,083075,Staff,0,10,60,60
1650996723244,CSE 3,A50,083646,Miranda; Gregory Joseph,15,0,38,23
1650996723244,CSE 3,A51,083647,Miranda; Gregory Joseph,36,0,37,1
1650996729288,CSE 8A,A50,083650,Miranda; Gregory Joseph,0,31,40,40
1650996735324,CSE 11,A01,083080,Cao; Yingjun,0,97,40,40
1650996741362,CSE 12,A01,083652,Staff,0,24,100,100
1650996747389,CSE 15L,A01,083654,Staff,0,3,50,50
1650996747389,CSE 15L,A02,083655,Staff,0,3,50,50
1650996753412,CSE 20,A01,083657,Staff,47,0,80,33
1650996759446,CSE 30,A01,083084,Eldon; John,1,38,80,79
1650996765469,CSE 100,A01,083659,Cao; Yingjun,0,71,50,50
1650996771501,CSE 134B,A01,083661,Powell; Thomas Allan,1,40,65,64
1650996777527,CSE 140,A01,083663,Staff,0,13,75,75
1650996783550,CSE 140L,A01,083088,Eldon; John,4,0,100,96
1650996789578,CSE 175,A01,083665,Kumar; Rakesh,0,0,25,25
1650996795609,CSE 190,A00,092507,Dubnov; Shlomo,9,0,20,11
1650996801632,ECE 45,A01,083139,Staff,0,7,60,60
1650996807658,ECE 65,A50,083695,Staff,0,7,30,30
1650996813684,ECE 109,A01,091882,Touri; Behrouz,32,0,70,38
1650996819719,ECE 180,A00,083140,Abi Samra; Nicholas Camill,17,0,30,13
1650996819719,ECE 180,B00,083141,Abi Samra; Nicholas Camill,0,0,30,30
1650996825745,MATH 10A,A01,083735,Patchell; Gregory David,2,0,30,28
1650996825745,MATH 10A,A02,083736,Patchell; Gregory David,27,0,30,3
1650996825745,MATH 10A,A03,083737,Patchell; Gregory David,23,0,30,7
1650996831774,MATH 10B,A01,083207,Staff,0,9,30,30
1650996831774,MATH 10B,A02,083208,Staff,0,5,30,30
1650996831774,MATH 10B,B01,083739,Staff,9,0,30,21
1650996831774,MATH 10B,B02,083740,Staff,28,0,30,2
1650996837805,MATH 18,A01,083743,Staff,0,0,30,30
1650996837805,MATH 18,A02,083744,Staff,23,0,30,7
1650996837805,MATH 18,A03,083745,Staff,19,0,30,11
1650996837805,MATH 18,A04,083746,Staff,26,0,30,4
1650996837805,MATH 18,B01,083748,Staff,0,15,30,30
1650996837805,MATH 18,B02,083749,Staff,0,14,30,30
1650996837805,MATH 18,B03,083750,Staff,0,13,30,30
1650996837805,MATH 18,B04,083751,Staff,0,13,30,30
1650996843830,MATH 20A,A01,083754,Staff,19,0,40,21
1650996849855,MATH 20B,A01,083756,Staff,0,14,30,30
1650996849855,MATH 20B,A02,083757,Staff,0,11,30,30
1650996855893,MATH 20C,A01,083760,Staff,0,17,30,30
1650996855893,MATH 20C,A02,083761,Staff,0,15,30,30
1650996855893,MATH 20C,B01,083762,Staff,9,0,30,21
1650996855893,MATH 20C,B02,083763,Staff,28,0,30,2
1650996861917,MATH 20D,A01,083765,Staff,3,1,30,27
1650996861917,MATH 20D,A02,083766,Staff,2,0,30,28
1650996861917,MATH 20D,A03,083767,Staff,22,0,30,8
1650996867941,MATH 20E,A01,083771,Staff,2,0,30,28
1650996867941,MATH 20E,A02,083772,Staff,12,0,30,18
1650996867941,MATH 20E,B01,083773,Staff,0,0,30,30
1650996867941,MATH 20E,B02,083774,Staff,0,0,30,30
1650996873966,MATH 103A,A01,083777,Staff,0,17,30,30
1650996873966,MATH 103A,A02,083778,Staff,0,15,30,30
1650996873966,MATH 103A,B01,083779,Staff,0,15,30,30
1650996873966,MATH 103A,B02,083780,Staff,0,14,30,30
1650996879992,MATH 105,A01,085443,Staff,0,23,30,30
1650996886017,MATH 109,A01,083213,Anzaldo; Leesa B,0,7,30,30
1650996886017,MATH 109,A02,083214,Anzaldo; Leesa B,0,7,30,30
1650996886017,MATH 109,B01,083215,Anzaldo; Leesa B,0,8,30,30
1650996886017,MATH 109,B02,083216,Anzaldo; Leesa B,0,7,30,30
1650996892055,MATH 142A,A01,083219,Chow; Bennett,0,14,30,30
1650996892055,MATH 142A,A02,083220,Chow; Bennett,0,15,30,30
1650996892055,MATH 142A,B01,083221,Chow; Bennett,0,16,30,30
1650996892055,MATH 142A,B02,083222,Chow; Bennett,0,14,30,30
1650996917692,MATH 193A,A01,083224,Staff,0,6,30,30
1650996917692,MATH 193A,A02,083225,Staff,0,7,30,30
1650996917692,MATH 193A,A03,083781,Staff,0,6,30,30
1650996917692,MATH 193A,A04,083782,Staff,0,7,30,30
1650996923717,MATH 197,001,091859,McAuley; Julian John,9998,0,9999,1
1650996929776,COGS 9,A01,083615,Staff,0,18,60,60
1650996935889,COGS 11,A01,083617,Boyle; Mary E. T.,15,0,40,25
1650996941915,COGS 13,A01,083071,Staff,0,41,40,40
1650996947946,COGS 14A,A01,092681,Staff,0,39,100,100
1650996953981,COGS 14B,A01,083073,Cheng; Tzu-Han,0,13,50,50
1650996960005,COGS 17,A01,092677,Staff,7,0,75,68
1650996966030,COGS 100,A01,083619,Staff,0,31,60,60
1650996972062,COGS 101A,A01,083621,Davis; Joshua Daniel,0,30,60,60
1650996978088,COGS 101B,A01,091572,Staff,0,5,60,60
1650996984115,COGS 101C,A01,083625,Delgado; Tania,14,0,30,16
1650996990142,COGS 107A,A01,083627,Boyle; Mary E. T.,0,16,60,60
1650996996174,COGS 118A,A01,083075,Staff,0,10,60,60
1650997002201,CSE 3,A50,083646,Miranda; Gregory Joseph,15,0,38,23
1650997002201,CSE 3,A51,083647,Miranda; Gregory Joseph,36,0,37,1
1650997008225,CSE 8A,A50,083650,Miranda; Gregory Joseph,0,31,40,40
1650997014248,CSE 11,A01,083080,Cao; Yingjun,0,97,40,40
1650997020284,CSE 12,A01,083652,Staff,0,24,100,100
1650997026314,CSE 15L,A01,083654,Staff,0,3,50,50
1650997026314,CSE 15L,A02,083655,Staff,0,3,50,50
1650997032337,CSE 20,A01,083657,Staff,47,0,80,33
1650997038363,CSE 30,A01,083084,Eldon; John,1,38,80,79
1650997044392,CSE 100,A01,083659,Cao; Yingjun,0,71,50,50
1650997050416,CSE 134B,A01,083661,Powell; Thomas Allan,1,40,65,64
1650997056439,CSE 140,A01,083663,Staff,0,13,75,75
1650997062481,CSE 140L,A01,083088,Eldon; John,4,0,100,96
1650997068504,CSE 175,A01,083665,Kumar; Rakesh,0,0,25,25
1650997074529,CSE 190,A00,092507,Dubnov; Shlomo,9,0,20,11
1650997080568,ECE 45,A01,083139,Staff,0,7,60,60
1650997086601,ECE 65,A50,083695,Staff,0,7,30,30
1650997092629,ECE 109,A01,091882,Touri; Behrouz,32,0,70,38
1650997098662,ECE 180,A00,083140,Abi Samra; Nicholas Camill,17,0,30,13
1650997098662,ECE 180,B00,083141,Abi Samra; Nicholas Camill,0,0,30,30
1650997104685,MATH 10A,A01,083735,Patchell; Gregory David,2,0,30,28
1650997104685,MATH 10A,A02,083736,Patchell; Gregory David,27,0,30,3
1650997104685,MATH 10A,A03,083737,Patchell; Gregory David,23,0,30,7
1650997110711,MATH 10B,A01,083207,Staff,0,9,30,30
1650997110711,MATH 10B,A02,083208,Staff,0,5,30,30
1650997110711,MATH 10B,B01,083739,Staff,9,0,30,21
1650997110711,MATH 10B,B02,083740,Staff,28,0,30,2
1650997116739,MATH 18,A01,083743,Staff,0,0,30,30
1650997116739,MATH 18,A02,083744,Staff,23,0,30,7
1650997116739,MATH 18,A03,083745,Staff,19,0,30,11
1650997116739,MATH 18,A04,083746,Staff,26,0,30,4
1650997116739,MATH 18,B01,083748,Staff,0,15,30,30
1650997116739,MATH 18,B02,083749,Staff,0,14,30,30
1650997116739,MATH 18,B03,083750,Staff,0,13,30,30
1650997116739,MATH 18,B04,083751,Staff,0,13,30,30
1650997122782,MATH 20A,A01,083754,Staff,19,0,40,21
1650997128815,MATH 20B,A01,083756,Staff,0,14,30,30
1650997128815,MATH 20B,A02,083757,Staff,0,11,30,30
1650997134842,MATH 20C,A01,083760,Staff,0,17,30,30
1650997134842,MATH 20C,A02,083761,Staff,0,15,30,30
1650997134842,MATH 20C,B01,083762,Staff,9,0,30,21
1650997134842,MATH 20C,B02,083763,Staff,28,0,30,2
1650997140870,MATH 20D,A01,083765,Staff,3,1,30,27
1650997140870,MATH 20D,A02,083766,Staff,2,0,30,28
1650997140870,MATH 20D,A03,083767,Staff,22,0,30,8
1650997146897,MATH 20E,A01,083771,Staff,2,0,30,28
1650997146897,MATH 20E,A02,083772,Staff,12,0,30,18
1650997146897,MATH 20E,B01,083773,Staff,0,0,30,30
1650997146897,MATH 20E,B02,083774,Staff,0,0,30,30
1650997152923,MATH 103A,A01,083777,Staff,0,17,30,30
1650997152923,MATH 103A,A02,083778,Staff,0,15,30,30
1650997152923,MATH 103A,B01,083779,Staff,0,15,30,30
1650997152923,MATH 103A,B02,083780,Staff,0,14,30,30
1650997158951,MATH 105,A01,085443,Staff,0,23,30,30
1650997164975,MATH 109,A01,083213,Anzaldo; Leesa B,0,7,30,30
1650997164975,MATH 109,A02,083214,Anzaldo; Leesa B,0,7,30,30
1650997164975,MATH 109,B01,083215,Anzaldo; Leesa B,0,8,30,30
1650997164975,MATH 109,B02,083216,Anzaldo; Leesa B,0,7,30,30
1650997171008,MATH 142A,A01,083219,Chow; Bennett,0,14,30,30
1650997171008,MATH 142A,A02,083220,Chow; Bennett,0,15,30,30
1650997171008,MATH 142A,B01,083221,Chow; Bennett,0,16,30,30
1650997171008,MATH 142A,B02,083222,Chow; Bennett,0,14,30,30
1650997177032,MATH 193A,A01,083224,Staff,0,6,30,30
1650997177032,MATH 193A,A02,083225,Staff,0,7,30,30
1650997177032,MATH 193A,A03,083781,Staff,0,6,30,30
1650997177032,MATH 193A,A04,083782,Staff,0,7,30,30
1650997183060,MATH 197,001,091859,McAuley; Julian John,9998,0,9999,1
1650997189140,COGS 9,A01,083615,Staff,0,18,60,60
1650997195164,COGS 11,A01,083617,Boyle; Mary E. T.,15,0,40,25
1650997201189,COGS 13,A01,083071,Staff,0,41,40,40
1650997207212,COGS 14A,A01,092681,Staff,0,39,100,100
1650997213242,COGS 14B,A01,083073,Cheng; Tzu-Han,0,13,50,50
1650997219267,COGS 17,A01,092677,Staff,7,0,75,68
1650997225292,COGS 100,A01,083619,Staff,0,31,60,60
1650997231320,COGS 101A,A01,083621,Davis; Joshua Daniel,0,30,60,60
1650997237359,COGS 101B,A01,091572,Staff,0,5,60,60
1650997243381,COGS 101C,A01,083625,Delgado; Tania,14,0,30,16
1650997249404,COGS 107A,A01,083627,Boyle; Mary E. T.,0,16,60,60
1650997255427,COGS 118A,A01,083075,Staff,0,10,60,60
1650997261461,CSE 3,A50,083646,Miranda; Gregory Joseph,15,0,38,23
1650997261461,CSE 3,A51,083647,Miranda; Gregory Joseph,36,0,37,1
1650997267488,CSE 8A,A50,083650,Miranda; Gregory Joseph,0,31,40,40
1650997273517,CSE 11,A01,083080,Cao; Yingjun,0,97,40,40
1650997279557,CSE 12,A01,083652,Staff,0,24,100,100
1650997285584,CSE 15L,A01,083654,Staff,0,3,50,50
1650997285584,CSE 15L,A02,083655,Staff,0,3,50,50
1650997291612,CSE 20,A01,083657,Staff,47,0,80,33
1650997297634,CSE 30,A01,083084,Eldon; John,1,38,80,79
1650997303657,CSE 100,A01,083659,Cao; Yingjun,0,71,50,50
1650997309680,CSE 134B,A01,083661,Powell; Thomas Allan,1,40,65,64
1650997315705,CSE 140,A01,083663,Staff,0,13,75,75
1650997321736,CSE 140L,A01,083088,Eldon; John,4,0,100,96
1650997327760,CSE 175,A01,083665,Kumar; Rakesh,0,0,25,25
1650997333783,CSE 190,A00,092507,Dubnov; Shlomo,9,0,20,11
1650997339808,ECE 45,A01,083139,Staff,0,7,60,60
1650997345838,ECE 65,A50,083695,Staff,0,7,30,30
1650997351864,ECE 109,A01,091882,Touri; Behrouz,32,0,70,38
1650997357885,ECE 180,A00,083140,Abi Samra; Nicholas Camill,17,0,30,13
1650997357885,ECE 180,B00,083141,Abi Samra; Nicholas Camill,0,0,30,30
1650997363914,MATH 10A,A01,083735,Patchell; Gregory David,2,0,30,28
1650997363914,MATH 10A,A02,083736,Patchell; Gregory David,27,0,30,3
1650997363914,MATH 10A,A03,083737,Patchell; Gregory David,23,0,30,7
1650997369942,MATH 10B,A01,083207,Staff,0,9,30,30
1650997369942,MATH 10B,A02,083208,Staff,0,5,30,30
1650997369942,MATH 10B,B01,083739,Staff,9,0,30,21
1650997369942,MATH 10B,B02,083740,Staff,28,0,30,2
1650997375973,MATH 18,A01,083743,Staff,0,0,30,30
1650997375973,MATH 18,A02,083744,Staff,23,0,30,7
1650997375973,MATH 18,A03,083745,Staff,19,0,30,11
1650997375973,MATH 18,A04,083746,Staff,26,0,30,4
1650997375973,MATH 18,B01,083748,Staff,0,15,30,30
1650997375973,MATH 18,B02,083749,Staff,0,14,30,30
1650997375973,MATH 18,B03,083750,Staff,0,13,30,30
1650997375973,MATH 18,B04,083751,Staff,0,13,30,30
1650997381996,MATH 20A,A01,083754,Staff,19,0,40,21
1650997388020,MATH 20B,A01,083756,Staff,0,14,30,30
1650997388020,MATH 20B,A02,083757,Staff,0,11,30,30
1650997394045,MATH 20C,A01,083760,Staff,0,17,30,30
1650997394045,MATH 20C,A02,083761,Staff,0,15,30,30
1650997394045,MATH 20C,B01,083762,Staff,9,0,30,21
1650997394045,MATH 20C,B02,083763,Staff,28,0,30,2
1650997400075,MATH 20D,A01,083765,Staff,3,1,30,27
1650997400075,MATH 20D,A02,083766,Staff,2,0,30,28
1650997400075,MATH 20D,A03,083767,Staff,22,0,30,8
1650997406098,MATH 20E,A01,083771,Staff,2,0,30,28
1650997406098,MATH 20E,A02,083772,Staff,12,0,30,18
1650997406098,MATH 20E,B01,083773,Staff,0,0,30,30
1650997406098,MATH 20E,B02,083774,Staff,0,0,30,30
1650997412122,MATH 103A,A01,083777,Staff,0,17,30,30
1650997412122,MATH 103A,A02,083778,Staff,0,15,30,30
1650997412122,MATH 103A,B01,083779,Staff,0,15,30,30
1650997412122,MATH 103A,B02,083780,Staff,0,14,30,30
1650997418144,MATH 105,A01,085443,Staff,0,23,30,30
1650997424168,MATH 109,A01,083213,Anzaldo; Leesa B,0,7,30,30
1650997424168,MATH 109,A02,083214,Anzaldo; Leesa B,0,7,30,30
1650997424168,MATH 109,B01,083215,Anzaldo; Leesa B,0,8,30,30
1650997424168,MATH 109,B02,083216,Anzaldo; Leesa B,0,7,30,30
1650997430192,MATH 142A,A01,083219,Chow; Bennett,0,14,30,30
1650997430192,MATH 142A,A02,083220,Chow; Bennett,0,15,30,30
1650997430192,MATH 142A,B01,083221,Chow; Bennett,0,16,30,30
1650997430192,MATH 142A,B02,083222,Chow; Bennett,0,14,30,30
1650997436222,MATH 193A,A01,083224,Staff,0,6,30,30
1650997436222,MATH 193A,A02,083225,Staff,0,7,30,30
1650997436222,MATH 193A,A03,083781,Staff,0,6,30,30
1650997436222,MATH 193A,A04,083782,Staff,0,7,30,30
1650997442246,MATH 197,001,091859,McAuley; Julian John,9998,0,9999,1
1650997448301,COGS 9,A01,083615,Staff,0,18,60,60
1650997454323,COGS 11,A01,083617,Boyle; Mary E. T.,15,0,40,25
1650997460349,COGS 13,A01,083071,Staff,0,41,40,40
1650997466372,COGS 14A,A01,092681,Staff,0,39,100,100
1650997472402,COGS 14B,A01,083073,Cheng; Tzu-Han,0,13,50,50
1650997478444,COGS 17,A01,092677,Staff,7,0,75,68
1650997484467,COGS 100,A01,083619,Staff,0,31,60,60
1650997490490,COGS 101A,A01,083621,Davis; Joshua Daniel,0,30,60,60
1650997496533,COGS 101B,A01,091572,Staff,0,5,60,60
1650997502566,COGS 101C,A01,083625,Delgado; Tania,14,0,30,16
1650997508592,COGS 107A,A01,083627,Boyle; Mary E. T.,0,16,60,60
1650997514617,COGS 118A,A01,083075,Staff,0,10,60,60
1650997520653,CSE 3,A50,083646,Miranda; Gregory Joseph,15,0,38,23
1650997520653,CSE 3,A51,083647,Miranda; Gregory Joseph,36,0,37,1
1650997526689,CSE 8A,A50,083650,Miranda; Gregory Joseph,0,31,40,40
1650997532823,CSE 11,A01,083080,Cao; Yingjun,0,97,40,40
1650997538845,CSE 12,A01,083652,Staff,0,24,100,100
1650997544868,CSE 15L,A01,083654,Staff,0,3,50,50
1650997544868,CSE 15L,A02,083655,Staff,0,3,50,50
1650997550901,CSE 20,A01,083657,Staff,47,0,80,33
1650997556928,CSE 30,A01,083084,Eldon; John,1,38,80,79
1650997562952,CSE 100,A01,083659,Cao; Yingjun,0,71,50,50
1650997568982,CSE 134B,A01,083661,Powell; Thomas Allan,1,40,65,64
1650997575013,CSE 140,A01,083663,Staff,0,13,75,75
1650997581045,CSE 140L,A01,083088,Eldon; John,4,0,100,96
1650997587069,CSE 175,A01,083665,Kumar; Rakesh,0,0,25,25
1650997593099,CSE 190,A00,092507,Dubnov; Shlomo,9,0,20,11
1650997599121,ECE 45,A01,083139,Staff,0,7,60,60
1650997605147,ECE 65,A50,083695,Staff,0,7,30,30
1650997611187,ECE 109,A01,091882,Touri; Behrouz,32,0,70,38
1650997617215,ECE 180,A00,083140,Abi Samra; Nicholas Camill,17,0,30,13
1650997617215,ECE 180,B00,083141,Abi Samra; Nicholas Camill,0,0,30,30
1650997623249,MATH 10A,A01,083735,Patchell; Gregory David,2,0,30,28
1650997623249,MATH 10A,A02,083736,Patchell; Gregory David,27,0,30,3
1650997623249,MATH 10A,A03,083737,Patchell; Gregory David,23,0,30,7
1650997629276,MATH 10B,A01,083207,Staff,0,9,30,30
1650997629276,MATH 10B,A02,083208,Staff,0,5,30,30
1650997629276,MATH 10B,B01,083739,Staff,9,0,30,21
1650997629276,MATH 10B,B02,083740,Staff,28,0,30,2
1650997635312,MATH 18,A01,083743,Staff,0,0,30,30
1650997635312,MATH 18,A02,083744,Staff,23,0,30,7
1650997635312,MATH 18,A03,083745,Staff,19,0,30,11
1650997635312,MATH 18,A04,083746,Staff,26,0,30,4
1650997635312,MATH 18,B01,083748,Staff,0,15,30,30
1650997635312,MATH 18,B02,083749,Staff,0,14,30,30
1650997635312,MATH 18,B03,083750,Staff,0,13,30,30
1650997635312,MATH 18,B04,083751,Staff,0,13,30,30
1650997641333,MATH 20A,A01,083754,Staff,19,0,40,21
1650997647361,MATH 20B,A01,083756,Staff,0,14,30,30
1650997647361,MATH 20B,A02,083757,Staff,0,11,30,30
1650997653387,MATH 20C,A01,083760,Staff,0,17,30,30
1650997653387,MATH 20C,A02,083761,Staff,0,15,30,30
1650997653387,MATH 20C,B01,083762,Staff,9,0,30,21
1650997653387,MATH 20C,B02,083763,Staff,28,0,30,2
1650997659414,MATH 20D,A01,083765,Staff,3,1,30,27
1650997659414,MATH 20D,A02,083766,Staff,2,0,30,28
1650997659414,MATH 20D,A03,083767,Staff,22,0,30,8
1650997665447,MATH 20E,A01,083771,Staff,2,0,30,28
1650997665447,MATH 20E,A02,083772,Staff,12,0,30,18
1650997665447,MATH 20E,B01,083773,Staff,0,0,30,30
1650997665447,MATH 20E,B02,083774,Staff,0,0,30,30
1650997671477,MATH 103A,A01,083777,Staff,0,17,30,30
1650997671477,MATH 103A,A02,083778,Staff,0,15,30,30
1650997671477,MATH 103A,B01,083779,Staff,0,15,30,30
1650997671477,MATH 103A,B02,083780,Staff,0,14,30,30
1650997677500,MATH 105,A01,085443,Staff,0,23,30,30
1650997683522,MATH 109,A01,083213,Anzaldo; Leesa B,0,7,30,30
1650997683522,MATH 109,A02,083214,Anzaldo; Leesa B,0,7,30,30
1650997683522,MATH 109,B01,083215,Anzaldo; Leesa B,0,8,30,30
1650997683522,MATH 109,B02,083216,Anzaldo; Leesa B,0,7,30,30
1650997689550,MATH 142A,A01,083219,Chow; Bennett,0,14,30,30
1650997689550,MATH 142A,A02,083220,Chow; Bennett,0,15,30,30
1650997689550,MATH 142A,B01,083221,Chow; Bennett,0,16,30,30
1650997689550,MATH 142A,B02,083222,Chow; Bennett,0,14,30,30
1650997695572,MATH 193A,A01,083224,Staff,0,6,30,30
1650997695572,MATH 193A,A02,083225,Staff,0,7,30,30
1650997695572,MATH 193A,A03,083781,Staff,0,6,30,30
1650997695572,MATH 193A,A04,083782,Staff,0,7,30,30
1650997701600,MATH 197,001,091859,McAuley; Julian John,9998,0,9999,1
1650997707667,COGS 9,A01,083615,Staff,0,18,60,60
1650997713688,COGS 11,A01,083617,Boyle; Mary E. T.,15,0,40,25
1650997719711,COGS 13,A01,083071,Staff,0,41,40,40
1650997725749,COGS 14A,A01,092681,Staff,0,39,100,100
1650997731784,COGS 14B,A01,083073,Cheng; Tzu-Han,0,13,50,50
1650997737809,COGS 17,A01,092677,Staff,7,0,75,68
1650997743850,COGS 100,A01,083619,Staff,0,31,60,60
1650997749881,COGS 101A,A01,083621,Davis; Joshua Daniel,0,30,60,60
1650997755908,COGS 101B,A01,091572,Staff,0,5,60,60
1650997761935,COGS 101C,A01,083625,Delgado; Tania,14,0,30,16
1650997767958,COGS 107A,A01,083627,Boyle; Mary E. T.,0,16,60,60
1650997773980,COGS 118A,A01,083075,Staff,0,10,60,60
1650997780014,CSE 3,A50,083646,Miranda; Gregory Joseph,15,0,38,23
1650997780014,CSE 3,A51,083647,Miranda; Gregory Joseph,36,0,37,1
1650997786040,CSE 8A,A50,083650,Miranda; Gregory Joseph,0,31,40,40
1650997792066,CSE 11,A01,083080,Cao; Yingjun,0,97,40,40
1650997798088,CSE 12,A01,083652,Staff,0,24,100,100
1650997804111,CSE 15L,A01,083654,Staff,0,3,50,50
1650997804111,CSE 15L,A02,083655,Staff,0,3,50,50
1650997810135,CSE 20,A01,083657,Staff,47,0,80,33
1650997816170,CSE 30,A01,083084,Eldon; John,1,38,80,79
1650997822195,CSE 100,A01,083659,Cao; Yingjun,0,71,50,50
1650997828224,CSE 134B,A01,083661,Powell; Thomas Allan,1,40,65,64
1650997834248,CSE 140,A01,083663,Staff,0,13,75,75
1650997840289,CSE 140L,A01,083088,Eldon; John,4,0,100,96
1650997846312,CSE 175,A01,083665,Kumar; Rakesh,0,0,25,25
1650997852335,CSE 190,A00,092507,Dubnov; Shlomo,9,0,20,11
1650997858357,ECE 45,A01,083139,Staff,0,7,60,60
1650997864385,ECE 65,A50,083695,Staff,0,7,30,30
1650997870428,ECE 109,A01,091882,Touri; Behrouz,32,0,70,38
1650997876450,ECE 180,A00,083140,Abi Samra; Nicholas Camill,17,0,30,13
1650997876450,ECE 180,B00,083141,Abi Samra; Nicholas Camill,0,0,30,30
1650997882476,MATH 10A,A01,083735,Patchell; Gregory David,1,0,30,29
1650997882476,MATH 10A,A02,083736,Patchell; Gregory David,27,0,30,3
1650997882476,MATH 10A,A03,083737,Patchell; Gregory David,23,0,30,7
1650997888506,MATH 10B,A01,083207,Staff,0,9,30,30
1650997888506,MATH 10B,A02,083208,Staff,0,5,30,30
1650997888506,MATH 10B,B01,083739,Staff,9,0,30,21
1650997888506,MATH 10B,B02,083740,Staff,28,0,30,2
1650997894548,MATH 18,A01,083743,Staff,0,0,30,30
1650997894548,MATH 18,A02,083744,Staff,23,0,30,7
1650997894548,MATH 18,A03,083745,Staff,19,0,30,11
1650997894548,MATH 18,A04,083746,Staff,26,0,30,4
1650997894548,MATH 18,B01,083748,Staff,0,15,30,30
1650997894548,MATH 18,B02,083749,Staff,0,14,30,30
1650997894548,MATH 18,B03,083750,Staff,0,13,30,30
1650997894548,MATH 18,B04,083751,Staff,0,13,30,30
1650997900571,MATH 20A,A01,083754,Staff,19,0,40,21
1650997906602,MATH 20B,A01,083756,Staff,0,14,30,30
1650997906602,MATH 20B,A02,083757,Staff,0,11,30,30
1650997912624,MATH 20C,A01,083760,Staff,0,17,30,30
1650997912624,MATH 20C,A02,083761,Staff,0,15,30,30
1650997912624,MATH 20C,B01,083762,Staff,9,0,30,21
1650997912624,MATH 20C,B02,083763,Staff,28,0,30,2
1650997918651,MATH 20D,A01,083765,Staff,3,1,30,27
1650997918651,MATH 20D,A02,083766,Staff,2,0,30,28
1650997918651,MATH 20D,A03,083767,Staff,22,0,30,8
1650997924676,MATH 20E,A01,083771,Staff,2,0,30,28
1650997924676,MATH 20E,A02,083772,Staff,12,0,30,18
1650997924676,MATH 20E,B01,083773,Staff,0,0,30,30
1650997924676,MATH 20E,B02,083774,Staff,0,0,30,30
1650997930701,MATH 103A,A01,083777,Staff,0,17,30,30
1650997930701,MATH 103A,A02,083778,Staff,0,15,30,30
1650997930701,MATH 103A,B01,083779,Staff,0,15,30,30
1650997930701,MATH 103A,B02,083780,Staff,0,14,30,30
1650997936734,MATH 105,A01,085443,Staff,0,23,30,30
1650997942761,MATH 109,A01,083213,Anzaldo; Leesa B,0,7,30,30
1650997942761,MATH 109,A02,083214,Anzaldo; Leesa B,0,7,30,30
1650997942761,MATH 109,B01,083215,Anzaldo; Leesa B,0,8,30,30
1650997942761,MATH 109,B02,083216,Anzaldo; Leesa B,0,7,30,30
1650997948785,MATH 142A,A01,083219,Chow; Bennett,0,14,30,30
1650997948785,MATH 142A,A02,083220,Chow; Bennett,0,15,30,30
1650997948785,MATH 142A,B01,083221,Chow; Bennett,0,16,30,30
1650997948785,MATH 142A,B02,083222,Chow; Bennett,0,14,30,30
1650997954816,MATH 193A,A01,083224,Staff,0,6,30,30
1650997954816,MATH 193A,A02,083225,Staff,0,7,30,30
1650997954816,MATH 193A,A03,083781,Staff,0,6,30,30
1650997954816,MATH 193A,A04,083782,Staff,0,7,30,30
1650997960840,MATH 197,001,091859,McAuley; Julian John,9998,0,9999,1
1650997966901,COGS 9,A01,083615,Staff,0,18,60,60
1650997972929,COGS 11,A01,083617,Boyle; Mary E. T.,15,0,40,25
1650997978964,COGS 13,A01,083071,Staff,0,41,40,40
1650997984995,COGS 14A,A01,092681,Staff,0,39,100,100
1650997991022,COGS 14B,A01,083073,Cheng; Tzu-Han,0,13,50,50
1650997997053,COGS 17,A01,092677,Staff,7,0,75,68
1650998003078,COGS 100,A01,083619,Staff,0,31,60,60
1650998009105,COGS 101A,A01,083621,Davis; Joshua Daniel,0,30,60,60
1650998015139,COGS 101B,A01,091572,Staff,0,5,60,60
1650998021164,COGS 101C,A01,083625,Delgado; Tania,14,0,30,16
1650998027190,COGS 107A,A01,083627,Boyle; Mary E. T.,0,16,60,60
1650998033218,COGS 118A,A01,083075,Staff,0,10,60,60
1650998039246,CSE 3,A50,083646,Miranda; Gregory Joseph,15,0,38,23
1650998039246,CSE 3,A51,083647,Miranda; Gregory Joseph,36,0,37,1
1650998045273,CSE 8A,A50,083650,Miranda; Gregory Joseph,0,31,40,40
1650998051311,CSE 11,A01,083080,Cao; Yingjun,0,97,40,40
1650998057341,CSE 12,A01,083652,Staff,0,24,100,100
1650998063368,CSE 15L,A01,083654,Staff,0,3,50,50
1650998063368,CSE 15L,A02,083655,Staff,0,3,50,50
1650998069391,CSE 20,A01,083657,Staff,47,0,80,33
1650998075421,CSE 30,A01,083084,Eldon; John,1,38,80,79
1650998081446,CSE 100,A01,083659,Cao; Yingjun,0,71,50,50
1650998087471,CSE 134B,A01,083661,Powell; Thomas Allan,1,40,65,64
1650998093498,CSE 140,A01,083663,Staff,0,13,75,75
1650998099523,CSE 140L,A01,083088,Eldon; John,4,0,100,96
1650998105556,CSE 175,A01,083665,Kumar; Rakesh,0,0,25,25
1650998111590,CSE 190,A00,092507,Dubnov; Shlomo,9,0,20,11
1650998117615,ECE 45,A01,083139,Staff,0,7,60,60
1650998123639,ECE 65,A50,083695,Staff,0,7,30,30
1650998129755,ECE 109,A01,091882,Touri; Behrouz,32,0,70,38
1650998135781,ECE 180,A00,083140,Abi Samra; Nicholas Camill,17,0,30,13
1650998135781,ECE 180,B00,083141,Abi Samra; Nicholas Camill,0,0,30,30
1650998141810,MATH 10A,A01,083735,Patchell; Gregory David,1,0,30,29
1650998141810,MATH 10A,A02,083736,Patchell; Gregory David,27,0,30,3
1650998141810,MATH 10A,A03,083737,Patchell; Gregory David,23,0,30,7
1650998147834,MATH 10B,A01,083207,Staff,0,9,30,30
1650998147834,MATH 10B,A02,083208,Staff,0,5,30,30
1650998147834,MATH 10B,B01,083739,Staff,9,0,30,21
1650998147834,MATH 10B,B02,083740,Staff,28,0,30,2
1650998153859,MATH 18,A01,083743,Staff,0,0,30,30
1650998153859,MATH 18,A02,083744,Staff,23,0,30,7
1650998153859,MATH 18,A03,083745,Staff,19,0,30,11
1650998153859,MATH 18,A04,083746,Staff,26,0,30,4
1650998153859,MATH 18,B01,083748,Staff,0,15,30,30
1650998153859,MATH 18,B02,083749,Staff,0,14,30,30
1650998153859,MATH 18,B03,083750,Staff,0,13,30,30
1650998153859,MATH 18,B04,083751,Staff,0,13,30,30
1650998159884,MATH 20A,A01,083754,Staff,19,0,40,21
1650998165909,MATH 20B,A01,083756,Staff,0,14,30,30
1650998165909,MATH 20B,A02,083757,Staff,0,11,30,30
1650998171942,MATH 20C,A01,083760,Staff,0,17,30,30
1650998171942,MATH 20C,A02,083761,Staff,0,15,30,30
1650998171942,MATH 20C,B01,083762,Staff,9,0,30,21
1650998171942,MATH 20C,B02,083763,Staff,28,0,30,2
1650998177977,MATH 20D,A01,083765,Staff,3,1,30,27
1650998177977,MATH 20D,A02,083766,Staff,2,0,30,28
1650998177977,MATH 20D,A03,083767,Staff,22,0,30,8
1650998184006,MATH 20E,A01,083771,Staff,2,0,30,28
1650998184006,MATH 20E,A02,083772,Staff,12,0,30,18
1650998184006,MATH 20E,B01,083773,Staff,0,0,30,30
1650998184006,MATH 20E,B02,083774,Staff,0,0,30,30
1650998190028,MATH 103A,A01,083777,Staff,0,17,30,30
1650998190028,MATH 103A,A02,083778,Staff,0,15,30,30
1650998190028,MATH 103A,B01,083779,Staff,0,15,30,30
1650998190028,MATH 103A,B02,083780,Staff,0,14,30,30
1650998196053,MATH 105,A01,085443,Staff,0,23,30,30
1650998202076,MATH 109,A01,083213,Anzaldo; Leesa B,0,7,30,30
1650998202076,MATH 109,A02,083214,Anzaldo; Leesa B,0,7,30,30
1650998202076,MATH 109,B01,083215,Anzaldo; Leesa B,0,8,30,30
1650998202076,MATH 109,B02,083216,Anzaldo; Leesa B,0,7,30,30
1650998208099,MATH 142A,A01,083219,Chow; Bennett,0,14,30,30
1650998208099,MATH 142A,A02,083220,Chow; Bennett,0,15,30,30
1650998208099,MATH 142A,B01,083221,Chow; Bennett,0,16,30,30
1650998208099,MATH 142A,B02,083222,Chow; Bennett,0,14,30,30
1650998214122,MATH 193A,A01,083224,Staff,0,6,30,30
1650998214122,MATH 193A,A02,083225,Staff,0,7,30,30
1650998214122,MATH 193A,A03,083781,Staff,0,6,30,30
1650998214122,MATH 193A,A04,083782,Staff,0,7,30,30
1650998220146,MATH 197,001,091859,McAuley; Julian John,9998,0,9999,1
1650998226222,COGS 9,A01,083615,Staff,0,18,60,60
1650998232253,COGS 11,A01,083617,Boyle; Mary E. T.,15,0,40,25
1650998238279,COGS 13,A01,083071,Staff,0,41,40,40
1650998244304,COGS 14A,A01,092681,Staff,0,39,100,100
1650998250326,COGS 14B,A01,083073,Cheng; Tzu-Han,0,13,50,50
1650998256352,COGS 17,A01,092677,Staff,7,0,75,68
1650998262376,COGS 100,A01,083619,Staff,0,31,60,60
1650998268412,COGS 101A,A01,083621,Davis; Joshua Daniel,0,30,60,60
1650998274449,COGS 101B,A01,091572,Staff,0,5,60,60
1650998280490,COGS 101C,A01,083625,Delgado; Tania,14,0,30,16
1650998286512,COGS 107A,A01,083627,Boyle; Mary E. T.,0,16,60,60
1650998292535,COGS 118A,A01,083075,Staff,0,10,60,60
1650998298562,CSE 3,A50,083646,Miranda; Gregory Joseph,15,0,38,23
1650998298562,CSE 3,A51,083647,Miranda; Gregory Joseph,36,0,37,1
1650998304589,CSE 8A,A50,083650,Miranda; Gregory Joseph,0,31,40,40
1650998310624,CSE 11,A01,083080,Cao; Yingjun,0,97,40,40
1650998316647,CSE 12,A01,083652,Staff,0,24,100,100
1650998322678,CSE 15L,A01,083654,Staff,0,3,50,50
1650998322678,CSE 15L,A02,083655,Staff,0,3,50,50
1650998328704,CSE 20,A01,083657,Staff,47,0,80,33
1650998334725,CSE 30,A01,083084,Eldon; John,1,38,80,79
1650998340748,CSE 100,A01,083659,Cao; Yingjun,0,71,50,50
1650998346775,CSE 134B,A01,083661,Powell; Thomas Allan,1,40,65,64
1650998352798,CSE 140,A01,083663,Staff,0,13,75,75
1650998358838,CSE 140L,A01,083088,Eldon; John,4,0,100,96
1650998364865,CSE 175,A01,083665,Kumar; Rakesh,0,0,25,25
1650998370887,CSE 190,A00,092507,Dubnov; Shlomo,9,0,20,11
1650998376919,ECE 45,A01,083139,Staff,0,7,60,60
1650998382947,ECE 65,A50,083695,Staff,0,7,30,30
1650998388971,ECE 109,A01,091882,Touri; Behrouz,32,0,70,38
1650998394995,ECE 180,A00,083140,Abi Samra; Nicholas Camill,17,0,30,13
1650998394995,ECE 180,B00,083141,Abi Samra; Nicholas Camill,0,0,30,30
1650998401019,MATH 10A,A01,083735,Patchell; Gregory David,1,0,30,29
1650998401019,MATH 10A,A02,083736,Patchell; Gregory David,27,0,30,3
1650998401019,MATH 10A,A03,083737,Patchell; Gregory David,23,0,30,7
1650998407052,MATH 10B,A01,083207,Staff,0,9,30,30
1650998407052,MATH 10B,A02,083208,Staff,0,5,30,30
1650998407052,MATH 10B,B01,083739,Staff,9,0,30,21
1650998407052,MATH 10B,B02,083740,Staff,28,0,30,2
1650998413079,MATH 18,A01,083743,Staff,0,0,30,30
1650998413079,MATH 18,A02,083744,Staff,23,0,30,7
1650998413079,MATH 18,A03,083745,Staff,19,0,30,11
1650998413079,MATH 18,A04,083746,Staff,26,0,30,4
1650998413079,MATH 18,B01,083748,Staff,0,15,30,30
1650998413079,MATH 18,B02,083749,Staff,0,14,30,30
1650998413079,MATH 18,B03,083750,Staff,0,13,30,30
1650998413079,MATH 18,B04,083751,Staff,0,13,30,30
1650998419114,MATH 20A,A01,083754,Staff,19,0,40,21
1650998425136,MATH 20B,A01,083756,Staff,0,14,30,30
1650998425136,MATH 20B,A02,083757,Staff,0,11,30,30
1650998431165,MATH 20C,A01,083760,Staff,0,17,30,30
1650998431165,MATH 20C,A02,083761,Staff,0,15,30,30
1650998431165,MATH 20C,B01,083762,Staff,9,0,30,21
1650998431165,MATH 20C,B02,083763,Staff,28,0,30,2
1650998437189,MATH 20D,A01,083765,Staff,3,1,30,27
1650998437189,MATH 20D,A02,083766,Staff,2,0,30,28
1650998437189,MATH 20D,A03,083767,Staff,22,0,30,8
1650998443213,MATH 20E,A01,083771,Staff,2,0,30,28
1650998443213,MATH 20E,A02,083772,Staff,12,0,30,18
1650998443213,MATH 20E,B01,083773,Staff,0,0,30,30
1650998443213,MATH 20E,B02,083774,Staff,0,0,30,30
1650998449236,MATH 103A,A01,083777,Staff,0,17,30,30
1650998449236,MATH 103A,A02,083778,Staff,0,15,30,30
1650998449236,MATH 103A,B01,083779,Staff,0,15,30,30
1650998449236,MATH 103A,B02,083780,Staff,0,14,30,30
1650998455265,MATH 105,A01,085443,Staff,0,23,30,30
1650998461300,MATH 109,A01,083213,Anzaldo; Leesa B,0,7,30,30
1650998461300,MATH 109,A02,083214,Anzaldo; Leesa B,0,7,30,30
1650998461300,MATH 109,B01,083215,Anzaldo; Leesa B,0,8,30,30
1650998461300,MATH 109,B02,083216,Anzaldo; Leesa B,0,7,30,30
1650998467328,MATH 142A,A01,083219,Chow; Bennett,0,14,30,30
1650998467328,MATH 142A,A02,083220,Chow; Bennett,0,15,30,30
1650998467328,MATH 142A,B01,083221,Chow; Bennett,0,16,30,30
1650998467328,MATH 142A,B02,083222,Chow; Bennett,0,14,30,30
1650998473354,MATH 193A,A01,083224,Staff,0,6,30,30
1650998473354,MATH 193A,A02,083225,Staff,0,7,30,30
1650998473354,MATH 193A,A03,083781,Staff,0,6,30,30
1650998473354,MATH 193A,A04,083782,Staff,0,7,30,30
1650998479379,MATH 197,001,091859,McAuley; Julian John,9998,0,9999,1
1650998485437,COGS 9,A01,083615,Staff,0,18,60,60
1650998491462,COGS 11,A01,083617,Boyle; Mary E. T.,15,0,40,25
1650998497503,COGS 13,A01,083071,Staff,0,41,40,40
1650998503537,COGS 14A,A01,092681,Staff,0,40,100,100
1650998509564,COGS 14B,A01,083073,Cheng; Tzu-Han,0,13,50,50
1650998515586,COGS 17,A01,092677,Staff,7,0,75,68
1650998521610,COGS 100,A01,083619,Staff,0,31,60,60
1650998527638,COGS 101A,A01,083621,Davis; Joshua Daniel,0,30,60,60
1650998533668,COGS 101B,A01,091572,Staff,0,6,60,60
1650998539700,COGS 101C,A01,083625,Delgado; Tania,14,0,30,16
1650998545727,COGS 107A,A01,083627,Boyle; Mary E. T.,0,16,60,60
1650998551751,COGS 118A,A01,083075,Staff,0,10,60,60
1650998557778,CSE 3,A50,083646,Miranda; Gregory Joseph,15,0,38,23
1650998557778,CSE 3,A51,083647,Miranda; Gregory Joseph,36,0,37,1
1650998563800,CSE 8A,A50,083650,Miranda; Gregory Joseph,0,31,40,40
1650998569838,CSE 11,A01,083080,Cao; Yingjun,0,97,40,40
1650998575861,CSE 12,A01,083652,Staff,0,24,100,100
1650998581886,CSE 15L,A01,083654,Staff,0,3,50,50
1650998581886,CSE 15L,A02,083655,Staff,0,3,50,50
1650998587911,CSE 20,A01,083657,Staff,47,0,80,33
1650998593932,CSE 30,A01,083084,Eldon; John,1,38,80,79
1650998599960,CSE 100,A01,083659,Cao; Yingjun,0,71,50,50
1650998605981,CSE 134B,A01,083661,Powell; Thomas Allan,1,40,65,64
1650998612004,CSE 140,A01,083663,Staff,0,13,75,75
1650998618027,CSE 140L,A01,083088,Eldon; John,4,0,100,96
1650998624053,CSE 175,A01,083665,Kumar; Rakesh,0,0,25,25
1650998630079,CSE 190,A00,092507,Dubnov; Shlomo,9,0,20,11
1650998636107,ECE 45,A01,083139,Staff,0,7,60,60
1650998642134,ECE 65,A50,083695,Staff,0,7,30,30
1650998648159,ECE 109,A01,091882,Touri; Behrouz,32,0,70,38
1650998654184,ECE 180,A00,083140,Abi Samra; Nicholas Camill,17,0,30,13
1650998654184,ECE 180,B00,083141,Abi Samra; Nicholas Camill,0,0,30,30
1650998660236,MATH 10A,A01,083735,Patchell; Gregory David,1,0,30,29
1650998660236,MATH 10A,A02,083736,Patchell; Gregory David,27,0,30,3
1650998660236,MATH 10A,A03,083737,Patchell; Gregory David,23,0,30,7
1650998666259,MATH 10B,A01,083207,Staff,0,9,30,30
1650998666259,MATH 10B,A02,083208,Staff,0,5,30,30
1650998666259,MATH 10B,B01,083739,Staff,9,0,30,21
1650998666259,MATH 10B,B02,083740,Staff,28,0,30,2
1650998672288,MATH 18,A01,083743,Staff,0,0,30,30
1650998672288,MATH 18,A02,083744,Staff,23,0,30,7
1650998672288,MATH 18,A03,083745,Staff,19,0,30,11
1650998672288,MATH 18,A04,083746,Staff,26,0,30,4
1650998672288,MATH 18,B01,083748,Staff,0,15,30,30
1650998672288,MATH 18,B02,083749,Staff,0,14,30,30
1650998672288,MATH 18,B03,083750,Staff,0,13,30,30
1650998672288,MATH 18,B04,083751,Staff,0,13,30,30
1650998678318,MATH 20A,A01,083754,Staff,19,0,40,21
1650998684344,MATH 20B,A01,083756,Staff,0,14,30,30
1650998684344,MATH 20B,A02,083757,Staff,0,11,30,30
1650998690366,MATH 20C,A01,083760,Staff,0,17,30,30
1650998690366,MATH 20C,A02,083761,Staff,0,15,30,30
1650998690366,MATH 20C,B01,083762,Staff,9,0,30,21
1650998690366,MATH 20C,B02,083763,Staff,28,0,30,2
1650998696395,MATH 20D,A01,083765,Staff,3,1,30,27
1650998696395,MATH 20D,A02,083766,Staff,2,0,30,28
1650998696395,MATH 20D,A03,083767,Staff,22,0,30,8
1650998702423,MATH 20E,A01,083771,Staff,2,0,30,28
1650998702423,MATH 20E,A02,083772,Staff,12,0,30,18
1650998702423,MATH 20E,B01,083773,Staff,0,0,30,30
1650998702423,MATH 20E,B02,083774,Staff,0,0,30,30
1650998708451,MATH 103A,A01,083777,Staff,0,17,30,30
1650998708451,MATH 103A,A02,083778,Staff,0,15,30,30
1650998708451,MATH 103A,B01,083779,Staff,0,15,30,30
1650998708451,MATH 103A,B02,083780,Staff,0,14,30,30
1650998714483,MATH 105,A01,085443,Staff,0,23,30,30
1650998720518,MATH 109,A01,083213,Anzaldo; Leesa B,0,7,30,30
1650998720518,MATH 109,A02,083214,Anzaldo; Leesa B,0,7,30,30
1650998720518,MATH 109,B01,083215,Anzaldo; Leesa B,0,8,30,30
1650998720518,MATH 109,B02,083216,Anzaldo; Leesa B,0,7,30,30
1650998726634,MATH 142A,A01,083219,Chow; Bennett,0,14,30,30
1650998726634,MATH 142A,A02,083220,Chow; Bennett,0,15,30,30
1650998726634,MATH 142A,B01,083221,Chow; Bennett,0,16,30,30
1650998726634,MATH 142A,B02,083222,Chow; Bennett,0,14,30,30
1650998732658,MATH 193A,A01,083224,Staff,0,6,30,30
1650998732658,MATH 193A,A02,083225,Staff,0,7,30,30
1650998732658,MATH 193A,A03,083781,Staff,0,6,30,30
1650998732658,MATH 193A,A04,083782,Staff,0,7,30,30
1650998738768,MATH 197,001,091859,McAuley; Julian John,9998,0,9999,1
1650998744822,COGS 9,A01,083615,Staff,0,18,60,60
1650998750856,COGS 11,A01,083617,Boyle; Mary E. T.,15,0,40,25
1650998756895,COGS 13,A01,083071,Staff,0,40,40,40
1650998762917,COGS 14A,A01,092681,Staff,0,40,100,100
1650998768944,COGS 14B,A01,083073,Cheng; Tzu-Han,0,13,50,50
1650998774969,COGS 17,A01,092677,Staff,7,0,75,68
1650998781008,COGS 100,A01,083619,Staff,0,31,60,60
1650998787036,COGS 101A,A01,083621,Davis; Joshua Daniel,0,30,60,60
1650998793063,COGS 101B,A01,091572,Staff,0,6,60,60
1650998799086,COGS 101C,A01,083625,Delgado; Tania,14,0,30,16
1650998805116,COGS 107A,A01,083627,Boyle; Mary E. T.,0,16,60,60
1650998811142,COGS 118A,A01,083075,Staff,0,10,60,60
1650998817164,CSE 3,A50,083646,Miranda; Gregory Joseph,15,0,38,23
1650998817164,CSE 3,A51,083647,Miranda; Gregory Joseph,36,0,37,1
1650998823186,CSE 8A,A50,083650,Miranda; Gregory Joseph,0,31,40,40
1650998829215,CSE 11,A01,083080,Cao; Yingjun,0,97,40,40
1650998835247,CSE 12,A01,083652,Staff,0,24,100,100
1650998841273,CSE 15L,A01,083654,Staff,0,3,50,50
1650998841273,CSE 15L,A02,083655,Staff,0,3,50,50
1650998847299,CSE 20,A01,083657,Staff,47,0,80,33
1650998853322,CSE 30,A01,083084,Eldon; John,1,38,80,79
1650998859343,CSE 100,A01,083659,Cao; Yingjun,0,71,50,50
1650998865366,CSE 134B,A01,083661,Powell; Thomas Allan,1,40,65,64
1650998871391,CSE 140,A01,083663,Staff,0,13,75,75
1650998877415,CSE 140L,A01,083088,Eldon; John,4,0,100,96
1650998883437,CSE 175,A01,083665,Kumar; Rakesh,0,0,25,25
1650998889467,CSE 190,A00,092507,Dubnov; Shlomo,9,0,20,11
1650998895491,ECE 45,A01,083139,Staff,0,7,60,60
1650998901517,ECE 65,A50,083695,Staff,0,7,30,30
1650998907540,ECE 109,A01,091882,Touri; Behrouz,32,0,70,38
1650998913570,ECE 180,A00,083140,Abi Samra; Nicholas Camill,17,0,30,13
1650998913570,ECE 180,B00,083141,Abi Samra; Nicholas Camill,0,0,30,30
1650998919605,MATH 10A,A01,083735,Patchell; Gregory David,1,0,30,29
1650998919605,MATH 10A,A02,083736,Patchell; Gregory David,27,0,30,3
1650998919605,MATH 10A,A03,083737,Patchell; Gregory David,23,0,30,7
1650998925630,MATH 10B,A01,083207,Staff,0,9,30,30
1650998925630,MATH 10B,A02,083208,Staff,0,5,30,30
1650998925630,MATH 10B,B01,083739,Staff,9,0,30,21
1650998925630,MATH 10B,B02,083740,Staff,28,0,30,2
1650998931657,MATH 18,A01,083743,Staff,0,0,30,30
1650998931657,MATH 18,A02,083744,Staff,23,0,30,7
1650998931657,MATH 18,A03,083745,Staff,19,0,30,11
1650998931657,MATH 18,A04,083746,Staff,26,0,30,4
1650998931657,MATH 18,B01,083748,Staff,0,15,30,30
1650998931657,MATH 18,B02,083749,Staff,0,14,30,30
1650998931657,MATH 18,B03,083750,Staff,0,13,30,30
1650998931657,MATH 18,B04,083751,Staff,0,13,30,30
1650998937682,MATH 20A,A01,083754,Staff,19,0,40,21
1650998943710,MATH 20B,A01,083756,Staff,0,14,30,30
1650998943710,MATH 20B,A02,083757,Staff,0,11,30,30
1650998949741,MATH 20C,A01,083760,Staff,0,17,30,30
1650998949741,MATH 20C,A02,083761,Staff,0,15,30,30
1650998949741,MATH 20C,B01,083762,Staff,9,0,30,21
1650998949741,MATH 20C,B02,083763,Staff,28,0,30,2
1650998955763,MATH 20D,A01,083765,Staff,3,1,30,27
1650998955763,MATH 20D,A02,083766,Staff,2,0,30,28
1650998955763,MATH 20D,A03,083767,Staff,22,0,30,8
1650998961784,MATH 20E,A01,083771,Staff,2,0,30,28
1650998961784,MATH 20E,A02,083772,Staff,12,0,30,18
1650998961784,MATH 20E,B01,083773,Staff,0,0,30,30
1650998961784,MATH 20E,B02,083774,Staff,0,0,30,30
1650998967815,MATH 103A,A01,083777,Staff,0,17,30,30
1650998967815,MATH 103A,A02,083778,Staff,0,15,30,30
1650998967815,MATH 103A,B01,083779,Staff,0,15,30,30
1650998967815,MATH 103A,B02,083780,Staff,0,14,30,30
1650998973838,MATH 105,A01,085443,Staff,0,23,30,30
1650998979875,MATH 109,A01,083213,Anzaldo; Leesa B,0,7,30,30
1650998979875,MATH 109,A02,083214,Anzaldo; Leesa B,0,7,30,30
1650998979875,MATH 109,B01,083215,Anzaldo; Leesa B,0,8,30,30
1650998979875,MATH 109,B02,083216,Anzaldo; Leesa B,0,7,30,30
1650998985898,MATH 142A,A01,083219,Chow; Bennett,0,14,30,30
1650998985898,MATH 142A,A02,083220,Chow; Bennett,0,15,30,30
1650998985898,MATH 142A,B01,083221,Chow; Bennett,0,16,30,30
1650998985898,MATH 142A,B02,083222,Chow; Bennett,0,14,30,30
1650998991920,MATH 193A,A01,083224,Staff,0,6,30,30
1650998991920,MATH 193A,A02,083225,Staff,0,7,30,30
1650998991920,MATH 193A,A03,083781,Staff,0,6,30,30
1650998991920,MATH 193A,A04,083782,Staff,0,7,30,30
1650998997957,MATH 197,001,091859,McAuley; Julian John,9998,0,9999,1
1650999004017,COGS 9,A01,083615,Staff,0,18,60,60
1650999010045,COGS 11,A01,083617,Boyle; Mary E. T.,15,0,40,25
1650999016083,COGS 13,A01,083071,Staff,0,40,40,40
1650999022108,COGS 14A,A01,092681,Staff,0,40,100,100
1650999028141,COGS 14B,A01,083073,Cheng; Tzu-Han,0,13,50,50
1650999034164,COGS 17,A01,092677,Staff,7,0,75,68
1650999040186,COGS 100,A01,083619,Staff,0,31,60,60
1650999046209,COGS 101A,A01,083621,Davis; Joshua Daniel,0,30,60,60
1650999052233,COGS 101B,A01,091572,Staff,0,6,60,60
1650999058255,COGS 101C,A01,083625,Delgado; Tania,14,0,30,16
1650999064288,COGS 107A,A01,083627,Boyle; Mary E. T.,0,16,60,60
1650999070310,COGS 118A,A01,083075,Staff,0,10,60,60
1650999076333,CSE 3,A50,083646,Miranda; Gregory Joseph,15,0,38,23
1650999076333,CSE 3,A51,083647,Miranda; Gregory Joseph,36,0,37,1
1650999082357,CSE 8A,A50,083650,Miranda; Gregory Joseph,0,31,40,40
1650999088392,CSE 11,A01,083080,Cao; Yingjun,0,97,40,40
1650999094419,CSE 12,A01,083652,Staff,0,24,100,100
1650999100440,CSE 15L,A01,083654,Staff,0,3,50,50
1650999100440,CSE 15L,A02,083655,Staff,0,3,50,50
1650999106463,CSE 20,A01,083657,Staff,47,0,80,33
1650999112488,CSE 30,A01,083084,Eldon; John,1,38,80,79
1650999118516,CSE 100,A01,083659,Cao; Yingjun,0,71,50,50
1650999124543,CSE 134B,A01,083661,Powell; Thomas Allan,1,40,65,64
1650999130568,CSE 140,A01,083663,Staff,0,13,75,75
1650999136591,CSE 140L,A01,083088,Eldon; John,4,0,100,96
1650999142614,CSE 175,A01,083665,Kumar; Rakesh,0,0,25,25
1650999148639,CSE 190,A00,092507,Dubnov; Shlomo,9,0,20,11
1650999154662,ECE 45,A01,083139,Staff,0,7,60,60
1650999160685,ECE 65,A50,083695,Staff,0,7,30,30
1650999166728,ECE 109,A01,091882,Touri; Behrouz,32,0,70,38
1650999172751,ECE 180,A00,083140,Abi Samra; Nicholas Camill,17,0,30,13
1650999172751,ECE 180,B00,083141,Abi Samra; Nicholas Camill,0,0,30,30
1650999178775,MATH 10A,A01,083735,Patchell; Gregory David,1,0,30,29
1650999178775,MATH 10A,A02,083736,Patchell; Gregory David,27,0,30,3
1650999178775,MATH 10A,A03,083737,Patchell; Gregory David,23,0,30,7
1650999184800,MATH 10B,A01,083207,Staff,0,9,30,30
1650999184800,MATH 10B,A02,083208,Staff,0,5,30,30
1650999184800,MATH 10B,B01,083739,Staff,9,0,30,21
1650999184800,MATH 10B,B02,083740,Staff,28,0,30,2
1650999190830,MATH 18,A01,083743,Staff,0,0,30,30
1650999190830,MATH 18,A02,083744,Staff,23,0,30,7
1650999190830,MATH 18,A03,083745,Staff,19,0,30,11
1650999190830,MATH 18,A04,083746,Staff,26,0,30,4
1650999190830,MATH 18,B01,083748,Staff,0,15,30,30
1650999190830,MATH 18,B02,083749,Staff,0,14,30,30
1650999190830,MATH 18,B03,083750,Staff,0,13,30,30
1650999190830,MATH 18,B04,083751,Staff,0,13,30,30
1650999196854,MATH 20A,A01,083754,Staff,19,0,40,21
1650999202879,MATH 20B,A01,083756,Staff,0,14,30,30
1650999202879,MATH 20B,A02,083757,Staff,0,11,30,30
1650999208909,MATH 20C,A01,083760,Staff,0,17,30,30
1650999208909,MATH 20C,A02,083761,Staff,0,15,30,30
1650999208909,MATH 20C,B01,083762,Staff,9,0,30,21
1650999208909,MATH 20C,B02,083763,Staff,28,0,30,2
1650999214934,MATH 20D,A01,083765,Staff,3,1,30,27
1650999214934,MATH 20D,A02,083766,Staff,2,0,30,28
1650999214934,MATH 20D,A03,083767,Staff,22,0,30,8
1650999220957,MATH 20E,A01,083771,Staff,2,0,30,28
1650999220957,MATH 20E,A02,083772,Staff,12,0,30,18
1650999220957,MATH 20E,B01,083773,Staff,0,0,30,30
1650999220957,MATH 20E,B02,083774,Staff,0,0,30,30
1650999226978,MATH 103A,A01,083777,Staff,0,17,30,30
1650999226978,MATH 103A,A02,083778,Staff,0,15,30,30
1650999226978,MATH 103A,B01,083779,Staff,0,15,30,30
1650999226978,MATH 103A,B02,083780,Staff,0,14,30,30
1650999233012,MATH 105,A01,085443,Staff,0,23,30,30
1650999239045,MATH 109,A01,083213,Anzaldo; Leesa B,0,7,30,30
1650999239045,MATH 109,A02,083214,Anzaldo; Leesa B,0,7,30,30
1650999239045,MATH 109,B01,083215,Anzaldo; Leesa B,0,8,30,30
1650999239045,MATH 109,B02,083216,Anzaldo; Leesa B,0,7,30,30
1650999245072,MATH 142A,A01,083219,Chow; Bennett,0,14,30,30
1650999245072,MATH 142A,A02,083220,Chow; Bennett,0,15,30,30
1650999245072,MATH 142A,B01,083221,Chow; Bennett,0,16,30,30
1650999245072,MATH 142A,B02,083222,Chow; Bennett,0,14,30,30
1650999251101,MATH 193A,A01,083224,Staff,0,6,30,30
1650999251101,MATH 193A,A02,083225,Staff,0,7,30,30
1650999251101,MATH 193A,A03,083781,Staff,0,6,30,30
1650999251101,MATH 193A,A04,083782,Staff,0,7,30,30
1650999257128,MATH 197,001,091859,McAuley; Julian John,9998,0,9999,1
1650999263199,COGS 9,A01,083615,Staff,0,18,60,60
1650999269224,COGS 11,A01,083617,Boyle; Mary E. T.,15,0,40,25
1650999275247,COGS 13,A01,083071,Staff,0,40,40,40
1650999281282,COGS 14A,A01,092681,Staff,0,40,100,100
1650999287329,COGS 14B,A01,083073,Cheng; Tzu-Han,0,13,50,50
1650999293351,COGS 17,A01,092677,Staff,7,0,75,68
1650999299391,COGS 100,A01,083619,Staff,0,31,60,60
1650999305413,COGS 101A,A01,083621,Davis; Joshua Daniel,0,30,60,60
1650999311434,COGS 101B,A01,091572,Staff,0,6,60,60
1650999317534,COGS 101C,A01,083625,Delgado; Tania,14,0,30,16
1650999323560,COGS 107A,A01,083627,Boyle; Mary E. T.,0,16,60,60
1650999329586,COGS 118A,A01,083075,Staff,0,10,60,60
1650999335609,CSE 3,A50,083646,Miranda; Gregory Joseph,15,0,38,23
1650999335609,CSE 3,A51,083647,Miranda; Gregory Joseph,36,0,37,1
1650999341648,CSE 8A,A50,083650,Miranda; Gregory Joseph,0,31,40,40
1650999347673,CSE 11,A01,083080,Cao; Yingjun,0,97,40,40
1650999353702,CSE 12,A01,083652,Staff,0,24,100,100
1650999359730,CSE 15L,A01,083654,Staff,0,3,50,50
1650999359730,CSE 15L,A02,083655,Staff,0,3,50,50
1650999365752,CSE 20,A01,083657,Staff,47,0,80,33
1650999371791,CSE 30,A01,083084,Eldon; John,1,38,80,79
1650999377816,CSE 100,A01,083659,Cao; Yingjun,0,71,50,50
1650999383838,CSE 134B,A01,083661,Powell; Thomas Allan,1,40,65,64
1650999389960,CSE 140,A01,083663,Staff,0,13,75,75
1650999396000,CSE 140L,A01,083088,Eldon; John,4,0,100,96
1650999402023,CSE 175,A01,083665,Kumar; Rakesh,0,0,25,25
1650999408061,CSE 190,A00,092507,Dubnov; Shlomo,9,0,20,11
1650999414086,ECE 45,A01,083139,Staff,0,7,60,60
1650999420108,ECE 65,A50,083695,Staff,0,7,30,30
1650999426130,ECE 109,A01,091882,Touri; Behrouz,32,0,70,38
1650999432153,ECE 180,A00,083140,Abi Samra; Nicholas Camill,17,0,30,13
1650999432153,ECE 180,B00,083141,Abi Samra; Nicholas Camill,0,0,30,30
1650999438181,MATH 10A,A01,083735,Patchell; Gregory David,1,0,30,29
1650999438181,MATH 10A,A02,083736,Patchell; Gregory David,27,0,30,3
1650999438181,MATH 10A,A03,083737,Patchell; Gregory David,23,0,30,7
1650999444205,MATH 10B,A01,083207,Staff,0,9,30,30
1650999444205,MATH 10B,A02,083208,Staff,0,5,30,30
1650999444205,MATH 10B,B01,083739,Staff,9,0,30,21
1650999444205,MATH 10B,B02,083740,Staff,28,0,30,2
1650999450240,MATH 18,A01,083743,Staff,0,0,30,30
1650999450240,MATH 18,A02,083744,Staff,23,0,30,7
1650999450240,MATH 18,A03,083745,Staff,19,0,30,11
1650999450240,MATH 18,A04,083746,Staff,26,0,30,4
1650999450240,MATH 18,B01,083748,Staff,0,15,30,30
1650999450240,MATH 18,B02,083749,Staff,0,14,30,30
1650999450240,MATH 18,B03,083750,Staff,0,13,30,30
1650999450240,MATH 18,B04,083751,Staff,0,13,30,30
1650999456265,MATH 20A,A01,083754,Staff,19,0,40,21
1650999462299,MATH 20B,A01,083756,Staff,0,14,30,30
1650999462299,MATH 20B,A02,083757,Staff,0,11,30,30
1650999468324,MATH 20C,A01,083760,Staff,0,17,30,30
1650999468324,MATH 20C,A02,083761,Staff,0,15,30,30
1650999468324,MATH 20C,B01,083762,Staff,9,0,30,21
1650999468324,MATH 20C,B02,083763,Staff,28,0,30,2
1650999474348,MATH 20D,A01,083765,Staff,3,1,30,27
1650999474348,MATH 20D,A02,083766,Staff,2,0,30,28
1650999474348,MATH 20D,A03,083767,Staff,22,0,30,8
1650999480384,MATH 20E,A01,083771,Staff,2,0,30,28
1650999480384,MATH 20E,A02,083772,Staff,12,0,30,18
1650999480384,MATH 20E,B01,083773,Staff,0,0,30,30
1650999480384,MATH 20E,B02,083774,Staff,0,0,30,30
1650999486419,MATH 103A,A01,083777,Staff,0,17,30,30
1650999486419,MATH 103A,A02,083778,Staff,0,15,30,30
1650999486419,MATH 103A,B01,083779,Staff,0,15,30,30
1650999486419,MATH 103A,B02,083780,Staff,0,14,30,30
1650999492442,MATH 105,A01,085443,Staff,0,23,30,30
1650999498482,MATH 109,A01,083213,Anzaldo; Leesa B,0,7,30,30
1650999498482,MATH 109,A02,083214,Anzaldo; Leesa B,0,7,30,30
1650999498482,MATH 109,B01,083215,Anzaldo; Leesa B,0,8,30,30
1650999498482,MATH 109,B02,083216,Anzaldo; Leesa B,0,7,30,30
1650999504513,MATH 142A,A01,083219,Chow; Bennett,0,14,30,30
1650999504513,MATH 142A,A02,083220,Chow; Bennett,0,15,30,30
1650999504513,MATH 142A,B01,083221,Chow; Bennett,0,16,30,30
1650999504513,MATH 142A,B02,083222,Chow; Bennett,0,14,30,30
1650999510541,MATH 193A,A01,083224,Staff,0,6,30,30
1650999510541,MATH 193A,A02,083225,Staff,0,7,30,30
1650999510541,MATH 193A,A03,083781,Staff,0,6,30,30
1650999510541,MATH 193A,A04,083782,Staff,0,7,30,30
1650999516566,MATH 197,001,091859,McAuley; Julian John,9998,0,9999,1
1650999522626,COGS 9,A01,083615,Staff,0,18,60,60
1650999528650,COGS 11,A01,083617,Boyle; Mary E. T.,15,0,40,25
1650999534673,COGS 13,A01,083071,Staff,0,40,40,40
1650999540701,COGS 14A,A01,092681,Staff,0,40,100,100
1650999546722,COGS 14B,A01,083073,Cheng; Tzu-Han,0,13,50,50
1650999552758,COGS 17,A01,092677,Staff,7,0,75,68
1650999558789,COGS 100,A01,083619,Staff,0,31,60,60
1650999564816,COGS 101A,A01,083621,Davis; Joshua Daniel,0,30,60,60
1650999570841,COGS 101B,A01,091572,Staff,0,6,60,60
1650999576869,COGS 101C,A01,083625,Delgado; Tania,14,0,30,16
1650999582900,COGS 107A,A01,083627,Boyle; Mary E. T.,0,16,60,60
1650999588923,COGS 118A,A01,083075,Staff,0,10,60,60
1650999594946,CSE 3,A50,083646,Miranda; Gregory Joseph,15,0,38,23
1650999594946,CSE 3,A51,083647,Miranda; Gregory Joseph,36,0,37,1
1650999600980,CSE 8A,A50,083650,Miranda; Gregory Joseph,0,31,40,40
1650999607016,CSE 11,A01,083080,Cao; Yingjun,0,97,40,40
1650999613037,CSE 12,A01,083652,Staff,0,24,100,100
1650999619063,CSE 15L,A01,083654,Staff,0,3,50,50
1650999619063,CSE 15L,A02,083655,Staff,0,3,50,50
1650999625087,CSE 20,A01,083657,Staff,47,0,80,33
1650999631123,CSE 30,A01,083084,Eldon; John,1,38,80,79
1650999637150,CSE 100,A01,083659,Cao; Yingjun,0,71,50,50
1650999643174,CSE 134B,A01,083661,Powell; Thomas Allan,1,40,65,64
1650999649199,CSE 140,A01,083663,Staff,0,13,75,75
1650999655232,CSE 140L,A01,083088,Eldon; John,4,0,100,96
1650999661258,CSE 175,A01,083665,Kumar; Rakesh,0,0,25,25
1650999667284,CSE 190,A00,092507,Dubnov; Shlomo,9,0,20,11
1650999673315,ECE 45,A01,083139,Staff,0,7,60,60
1650999679338,ECE 65,A50,083695,Staff,0,7,30,30
1650999685366,ECE 109,A01,091882,Touri; Behrouz,32,0,70,38
1650999691394,ECE 180,A00,083140,Abi Samra; Nicholas Camill,17,0,30,13
1650999691394,ECE 180,B00,083141,Abi Samra; Nicholas Camill,0,0,30,30
1650999697429,MATH 10A,A01,083735,Patchell; Gregory David,1,0,30,29
1650999697429,MATH 10A,A02,083736,Patchell; Gregory David,27,0,30,3
1650999697429,MATH 10A,A03,083737,Patchell; Gregory David,23,0,30,7
1650999703456,MATH 10B,A01,083207,Staff,0,9,30,30
1650999703456,MATH 10B,A02,083208,Staff,0,5,30,30
1650999703456,MATH 10B,B01,083739,Staff,9,0,30,21
1650999703456,MATH 10B,B02,083740,Staff,28,0,30,2
1650999709489,MATH 18,A01,083743,Staff,0,0,30,30
1650999709489,MATH 18,A02,083744,Staff,23,0,30,7
1650999709489,MATH 18,A03,083745,Staff,19,0,30,11
1650999709489,MATH 18,A04,083746,Staff,26,0,30,4
1650999709489,MATH 18,B01,083748,Staff,0,15,30,30
1650999709489,MATH 18,B02,083749,Staff,0,14,30,30
1650999709489,MATH 18,B03,083750,Staff,0,13,30,30
1650999709489,MATH 18,B04,083751,Staff,0,13,30,30
1650999715514,MATH 20A,A01,083754,Staff,19,0,40,21
1650999721537,MATH 20B,A01,083756,Staff,0,14,30,30
1650999721537,MATH 20B,A02,083757,Staff,0,11,30,30
1650999727562,MATH 20C,A01,083760,Staff,0,17,30,30
1650999727562,MATH 20C,A02,083761,Staff,0,15,30,30
1650999727562,MATH 20C,B01,083762,Staff,9,0,30,21
1650999727562,MATH 20C,B02,083763,Staff,28,0,30,2
1650999733590,MATH 20D,A01,083765,Staff,3,1,30,27
1650999733590,MATH 20D,A02,083766,Staff,2,0,30,28
1650999733590,MATH 20D,A03,083767,Staff,22,0,30,8
1650999739622,MATH 20E,A01,083771,Staff,2,0,30,28
1650999739622,MATH 20E,A02,083772,Staff,12,0,30,18
1650999739622,MATH 20E,B01,083773,Staff,0,0,30,30
1650999739622,MATH 20E,B02,083774,Staff,0,0,30,30
1650999745649,MATH 103A,A01,083777,Staff,0,17,30,30
1650999745649,MATH 103A,A02,083778,Staff,0,15,30,30
1650999745649,MATH 103A,B01,083779,Staff,0,15,30,30
1650999745649,MATH 103A,B02,083780,Staff,0,14,30,30
1650999751677,MATH 105,A01,085443,Staff,0,23,30,30
1650999757700,MATH 109,A01,083213,Anzaldo; Leesa B,0,7,30,30
1650999757700,MATH 109,A02,083214,Anzaldo; Leesa B,0,7,30,30
1650999757700,MATH 109,B01,083215,Anzaldo; Leesa B,0,8,30,30
1650999757700,MATH 109,B02,083216,Anzaldo; Leesa B,0,7,30,30
1650999763730,MATH 142A,A01,083219,Chow; Bennett,0,14,30,30
1650999763730,MATH 142A,A02,083220,Chow; Bennett,0,15,30,30
1650999763730,MATH 142A,B01,083221,Chow; Bennett,0,16,30,30
1650999763730,MATH 142A,B02,083222,Chow; Bennett,0,14,30,30
1650999769754,MATH 193A,A01,083224,Staff,0,6,30,30
1650999769754,MATH 193A,A02,083225,Staff,0,7,30,30
1650999769754,MATH 193A,A03,083781,Staff,0,6,30,30
1650999769754,MATH 193A,A04,083782,Staff,0,7,30,30
1650999775779,MATH 197,001,091859,McAuley; Julian John,9998,0,9999,1
1650999781845,COGS 9,A01,083615,Staff,0,18,60,60
1650999787868,COGS 11,A01,083617,Boyle; Mary E. T.,15,0,40,25
1650999793893,COGS 13,A01,083071,Staff,0,40,40,40
1650999799916,COGS 14A,A01,092681,Staff,0,40,100,100
1650999805940,COGS 14B,A01,083073,Cheng; Tzu-Han,0,13,50,50
1650999811977,COGS 17,A01,092677,Staff,7,0,75,68
1650999818001,COGS 100,A01,083619,Staff,0,31,60,60
1650999824025,COGS 101A,A01,083621,Davis; Joshua Daniel,0,30,60,60
1650999830051,COGS 101B,A01,091572,Staff,0,6,60,60
1650999836074,COGS 101C,A01,083625,Delgado; Tania,14,0,30,16
1650999842103,COGS 107A,A01,083627,Boyle; Mary E. T.,0,16,60,60
1650999848135,COGS 118A,A01,083075,Staff,0,10,60,60
1650999854159,CSE 3,A50,083646,Miranda; Gregory Joseph,15,0,38,23
1650999854159,CSE 3,A51,083647,Miranda; Gregory Joseph,36,0,37,1
1650999860184,CSE 8A,A50,083650,Miranda; Gregory Joseph,0,31,40,40
1650999866213,CSE 11,A01,083080,Cao; Yingjun,0,97,40,40
1650999872237,CSE 12,A01,083652,Staff,0,24,100,100
1650999878260,CSE 15L,A01,083654,Staff,0,3,50,50
1650999878260,CSE 15L,A02,083655,Staff,0,3,50,50
1650999884285,CSE 20,A01,083657,Staff,47,0,80,33
1650999890312,CSE 30,A01,083084,Eldon; John,1,38,80,79
1650999896336,CSE 100,A01,083659,Cao; Yingjun,0,71,50,50
1650999902360,CSE 134B,A01,083661,Powell; Thomas Allan,1,40,65,64
1650999908385,CSE 140,A01,083663,Staff,0,13,75,75
1650999914503,CSE 140L,A01,083088,Eldon; John,4,0,100,96
1650999920525,CSE 175,A01,083665,Kumar; Rakesh,0,0,25,25
1650999926557,CSE 190,A00,092507,Dubnov; Shlomo,9,0,20,11
1650999932579,ECE 45,A01,083139,Staff,0,7,60,60
1650999938601,ECE 65,A50,083695,Staff,0,7,30,30
1650999944626,ECE 109,A01,091882,Touri; Behrouz,32,0,70,38
1650999950649,ECE 180,A00,083140,Abi Samra; Nicholas Camill,17,0,30,13
1650999950649,ECE 180,B00,083141,Abi Samra; Nicholas Camill,0,0,30,30
1650999956680,MATH 10A,A01,083735,Patchell; Gregory David,1,0,30,29
1650999956680,MATH 10A,A02,083736,Patchell; Gregory David,27,0,30,3
1650999956680,MATH 10A,A03,083737,Patchell; Gregory David,23,0,30,7
1650999962707,MATH 10B,A01,083207,Staff,0,9,30,30
1650999962707,MATH 10B,A02,083208,Staff,0,5,30,30
1650999962707,MATH 10B,B01,083739,Staff,9,0,30,21
1650999962707,MATH 10B,B02,083740,Staff,28,0,30,2
1650999968737,MATH 18,A01,083743,Staff,0,0,30,30
1650999968737,MATH 18,A02,083744,Staff,23,0,30,7
1650999968737,MATH 18,A03,083745,Staff,19,0,30,11
1650999968737,MATH 18,A04,083746,Staff,26,0,30,4
1650999968737,MATH 18,B01,083748,Staff,0,15,30,30
1650999968737,MATH 18,B02,083749,Staff,0,14,30,30
1650999968737,MATH 18,B03,083750,Staff,0,13,30,30
1650999968737,MATH 18,B04,083751,Staff,0,13,30,30
1650999974766,MATH 20A,A01,083754,Staff,19,0,40,21
1650999980794,MATH 20B,A01,083756,Staff,0,14,30,30
1650999980794,MATH 20B,A02,083757,Staff,0,11,30,30
1650999986819,MATH 20C,A01,083760,Staff,0,17,30,30
1650999986819,MATH 20C,A02,083761,Staff,0,15,30,30
1650999986819,MATH 20C,B01,083762,Staff,9,0,30,21
1650999986819,MATH 20C,B02,083763,Staff,28,0,30,2
1650999992843,MATH 20D,A01,083765,Staff,3,1,30,27
1650999992843,MATH 20D,A02,083766,Staff,2,0,30,28
1650999992843,MATH 20D,A03,083767,Staff,22,0,30,8
1650999998871,MATH 20E,A01,083771,Staff,2,0,30,28
1650999998871,MATH 20E,A02,083772,Staff,12,0,30,18
1650999998871,MATH 20E,B01,083773,Staff,0,0,30,30
1650999998871,MATH 20E,B02,083774,Staff,0,0,30,30
1651000004896,MATH 103A,A01,083777,Staff,0,17,30,30
1651000004896,MATH 103A,A02,083778,Staff,0,15,30,30
1651000004896,MATH 103A,B01,083779,Staff,0,15,30,30
1651000004896,MATH 103A,B02,083780,Staff,0,14,30,30
1651000010919,MATH 105,A01,085443,Staff,0,23,30,30
1651000016942,MATH 109,A01,083213,Anzaldo; Leesa B,0,7,30,30
1651000016942,MATH 109,A02,083214,Anzaldo; Leesa B,0,7,30,30
1651000016942,MATH 109,B01,083215,Anzaldo; Leesa B,0,8,30,30
1651000016942,MATH 109,B02,083216,Anzaldo; Leesa B,0,7,30,30
1651000022968,MATH 142A,A01,083219,Chow; Bennett,0,14,30,30
1651000022968,MATH 142A,A02,083220,Chow; Bennett,0,15,30,30
1651000022968,MATH 142A,B01,083221,Chow; Bennett,0,16,30,30
1651000022968,MATH 142A,B02,083222,Chow; Bennett,0,14,30,30
1651000028998,MATH 193A,A01,083224,Staff,0,6,30,30
1651000028998,MATH 193A,A02,083225,Staff,0,7,30,30
1651000028998,MATH 193A,A03,083781,Staff,0,7,30,30
1651000028998,MATH 193A,A04,083782,Staff,0,7,30,30
1651000035025,MATH 197,001,091859,McAuley; Julian John,9998,0,9999,1
1651000041088,COGS 9,A01,083615,Staff,0,19,60,60
1651000047114,COGS 11,A01,083617,Boyle; Mary E. T.,15,0,40,25
1651000053137,COGS 13,A01,083071,Staff,0,40,40,40
1651000059161,COGS 14A,A01,092681,Staff,0,40,100,100
1651000065190,COGS 14B,A01,083073,Cheng; Tzu-Han,0,13,50,50
1651000071215,COGS 17,A01,092677,Staff,7,0,75,68
1651000077249,COGS 100,A01,083619,Staff,0,31,60,60
1651000083276,COGS 101A,A01,083621,Davis; Joshua Daniel,0,30,60,60
1651000089300,COGS 101B,A01,091572,Staff,0,6,60,60
1651000095326,COGS 101C,A01,083625,Delgado; Tania,14,0,30,16
1651000101371,COGS 107A,A01,083627,Boyle; Mary E. T.,0,16,60,60
1651000107396,COGS 118A,A01,083075,Staff,0,10,60,60
1651000113424,CSE 3,A50,083646,Miranda; Gregory Joseph,15,0,38,23
1651000113424,CSE 3,A51,083647,Miranda; Gregory Joseph,36,0,37,1
1651000119451,CSE 8A,A50,083650,Miranda; Gregory Joseph,0,31,40,40
1651000125475,CSE 11,A01,083080,Cao; Yingjun,0,97,40,40
1651000131504,CSE 12,A01,083652,Staff,0,24,100,100
1651000137536,CSE 15L,A01,083654,Staff,0,3,50,50
1651000137536,CSE 15L,A02,083655,Staff,0,3,50,50
1651000143561,CSE 20,A01,083657,Staff,47,0,80,33
1651000149589,CSE 30,A01,083084,Eldon; John,1,38,80,79
1651000155611,CSE 100,A01,083659,Cao; Yingjun,0,71,50,50
1651000161645,CSE 134B,A01,083661,Powell; Thomas Allan,1,40,65,64
1651000167673,CSE 140,A01,083663,Staff,0,13,75,75
1651000173699,CSE 140L,A01,083088,Eldon; John,4,0,100,96
1651000179722,CSE 175,A01,083665,Kumar; Rakesh,0,0,25,25
1651000185750,CSE 190,A00,092507,Dubnov; Shlomo,9,0,20,11
1651000191773,ECE 45,A01,083139,Staff,0,7,60,60
1651000197802,ECE 65,A50,083695,Staff,0,7,30,30
1651000203831,ECE 109,A01,091882,Touri; Behrouz,32,0,70,38
1651000209862,ECE 180,A00,083140,Abi Samra; Nicholas Camill,17,0,30,13
1651000209862,ECE 180,B00,083141,Abi Samra; Nicholas Camill,0,0,30,30
1651000215891,MATH 10A,A01,083735,Patchell; Gregory David,1,0,30,29
1651000215891,MATH 10A,A02,083736,Patchell; Gregory David,27,0,30,3
1651000215891,MATH 10A,A03,083737,Patchell; Gregory David,23,0,30,7
1651000221916,MATH 10B,A01,083207,Staff,0,9,30,30
1651000221916,MATH 10B,A02,083208,Staff,0,5,30,30
1651000221916,MATH 10B,B01,083739,Staff,9,0,30,21
1651000221916,MATH 10B,B02,083740,Staff,28,0,30,2
1651000227945,MATH 18,A01,083743,Staff,0,0,30,30
1651000227945,MATH 18,A02,083744,Staff,23,0,30,7
1651000227945,MATH 18,A03,083745,Staff,19,0,30,11
1651000227945,MATH 18,A04,083746,Staff,26,0,30,4
1651000227945,MATH 18,B01,083748,Staff,0,15,30,30
1651000227945,MATH 18,B02,083749,Staff,0,14,30,30
1651000227945,MATH 18,B03,083750,Staff,0,14,30,30
1651000227945,MATH 18,B04,083751,Staff,0,13,30,30
1651000233969,MATH 20A,A01,083754,Staff,19,0,40,21
1651000239991,MATH 20B,A01,083756,Staff,0,14,30,30
1651000239991,MATH 20B,A02,083757,Staff,0,11,30,30
1651000246014,MATH 20C,A01,083760,Staff,0,17,30,30
1651000246014,MATH 20C,A02,083761,Staff,0,15,30,30
1651000246014,MATH 20C,B01,083762,Staff,9,0,30,21
1651000246014,MATH 20C,B02,083763,Staff,28,0,30,2
1651000252050,MATH 20D,A01,083765,Staff,3,1,30,27
1651000252050,MATH 20D,A02,083766,Staff,2,0,30,28
1651000252050,MATH 20D,A03,083767,Staff,22,0,30,8
1651000258082,MATH 20E,A01,083771,Staff,2,0,30,28
1651000258082,MATH 20E,A02,083772,Staff,12,0,30,18
1651000258082,MATH 20E,B01,083773,Staff,0,0,30,30
1651000258082,MATH 20E,B02,083774,Staff,0,0,30,30
1651000264118,MATH 103A,A01,083777,Staff,0,17,30,30
1651000264118,MATH 103A,A02,083778,Staff,0,15,30,30
1651000264118,MATH 103A,B01,083779,Staff,0,15,30,30
1651000264118,MATH 103A,B02,083780,Staff,0,14,30,30
1651000270150,MATH 105,A01,085443,Staff,0,23,30,30
1651000276178,MATH 109,A01,083213,Anzaldo; Leesa B,0,7,30,30
1651000276178,MATH 109,A02,083214,Anzaldo; Leesa B,0,7,30,30
1651000276178,MATH 109,B01,083215,Anzaldo; Leesa B,0,8,30,30
1651000276178,MATH 109,B02,083216,Anzaldo; Leesa B,0,7,30,30
1651000282205,MATH 142A,A01,083219,Chow; Bennett,0,14,30,30
1651000282205,MATH 142A,A02,083220,Chow; Bennett,0,15,30,30
1651000282205,MATH 142A,B01,083221,Chow; Bennett,0,16,30,30
1651000282205,MATH 142A,B02,083222,Chow; Bennett,0,14,30,30
1651000288229,MATH 193A,A01,083224,Staff,0,6,30,30
1651000288229,MATH 193A,A02,083225,Staff,0,7,30,30
1651000288229,MATH 193A,A03,083781,Staff,0,7,30,30
1651000288229,MATH 193A,A04,083782,Staff,0,7,30,30
1651000294252,MATH 197,001,091859,McAuley; Julian John,9998,0,9999,1
1651000300306,COGS 9,A01,083615,Staff,0,19,60,60
1651000306330,COGS 11,A01,083617,Boyle; Mary E. T.,15,0,40,25
1651000312353,COGS 13,A01,083071,Staff,0,40,40,40
1651000318381,COGS 14A,A01,092681,Staff,0,40,100,100
1651000324416,COGS 14B,A01,083073,Cheng; Tzu-Han,0,13,50,50
1651000330440,COGS 17,A01,092677,Staff,7,0,75,68
1651000336468,COGS 100,A01,083619,Staff,0,30,60,60
1651000342492,COGS 101A,A01,083621,Davis; Joshua Daniel,0,30,60,60
1651000348516,COGS 101B,A01,091572,Staff,0,6,60,60
1651000354539,COGS 101C,A01,083625,Delgado; Tania,14,0,30,16
1651000360573,COGS 107A,A01,083627,Boyle; Mary E. T.,0,16,60,60
1651000366596,COGS 118A,A01,083075,Staff,0,10,60,60
1651000372621,CSE 3,A50,083646,Miranda; Gregory Joseph,15,0,38,23
1651000372621,CSE 3,A51,083647,Miranda; Gregory Joseph,36,0,37,1
1651000378644,CSE 8A,A50,083650,Miranda; Gregory Joseph,0,31,40,40
1651000384679,CSE 11,A01,083080,Cao; Yingjun,0,97,40,40
1651000390706,CSE 12,A01,083652,Staff,0,24,100,100
1651000396744,CSE 15L,A01,083654,Staff,0,3,50,50
1651000396744,CSE 15L,A02,083655,Staff,0,3,50,50
1651000402779,CSE 20,A01,083657,Staff,47,0,80,33
1651000408801,CSE 30,A01,083084,Eldon; John,1,38,80,79
1651000414832,CSE 100,A01,083659,Cao; Yingjun,0,71,50,50
1651000420862,CSE 134B,A01,083661,Powell; Thomas Allan,1,40,65,64
1651000426885,CSE 140,A01,083663,Staff,0,13,75,75
1651000432909,CSE 140L,A01,083088,Eldon; John,4,0,100,96
1651000438938,CSE 175,A01,083665,Kumar; Rakesh,0,0,25,25
1651000444968,CSE 190,A00,092507,Dubnov; Shlomo,9,0,20,11
1651000450991,ECE 45,A01,083139,Staff,0,7,60,60
1651000457018,ECE 65,A50,083695,Staff,0,7,30,30
1651000463042,ECE 109,A01,091882,Touri; Behrouz,32,0,70,38
1651000469069,ECE 180,A00,083140,Abi Samra; Nicholas Camill,17,0,30,13
1651000469069,ECE 180,B00,083141,Abi Samra; Nicholas Camill,0,0,30,30
1651000475093,MATH 10A,A01,083735,Patchell; Gregory David,1,0,30,29
1651000475093,MATH 10A,A02,083736,Patchell; Gregory David,27,0,30,3
1651000475093,MATH 10A,A03,083737,Patchell; Gregory David,23,0,30,7
1651000481115,MATH 10B,A01,083207,Staff,0,9,30,30
1651000481115,MATH 10B,A02,083208,Staff,0,5,30,30
1651000481115,MATH 10B,B01,083739,Staff,9,0,30,21
1651000481115,MATH 10B,B02,083740,Staff,28,0,30,2
1651000487144,MATH 18,A01,083743,Staff,0,0,30,30
1651000487144,MATH 18,A02,083744,Staff,23,0,30,7
1651000487144,MATH 18,A03,083745,Staff,19,0,30,11
1651000487144,MATH 18,A04,083746,Staff,26,0,30,4
1651000487144,MATH 18,B01,083748,Staff,0,15,30,30
1651000487144,MATH 18,B02,083749,Staff,0,14,30,30
1651000487144,MATH 18,B03,083750,Staff,0,14,30,30
1651000487144,MATH 18,B04,083751,Staff,0,13,30,30
1651000493167,MATH 20A,A01,083754,Staff,19,0,40,21
1651000499194,MATH 20B,A01,083756,Staff,0,14,30,30
1651000499194,MATH 20B,A02,083757,Staff,0,11,30,30
1651000505218,MATH 20C,A01,083760,Staff,0,17,30,30
1651000505218,MATH 20C,A02,083761,Staff,0,15,30,30
1651000505218,MATH 20C,B01,083762,Staff,9,0,30,21
1651000505218,MATH 20C,B02,083763,Staff,28,0,30,2
1651000511342,MATH 20D,A01,083765,Staff,3,1,30,27
1651000511342,MATH 20D,A02,083766,Staff,2,0,30,28
1651000511342,MATH 20D,A03,083767,Staff,22,0,30,8
1651000517372,MATH 20E,A01,083771,Staff,2,0,30,28
1651000517372,MATH 20E,A02,083772,Staff,12,0,30,18
1651000517372,MATH 20E,B01,083773,Staff,0,0,30,30
1651000517372,MATH 20E,B02,083774,Staff,0,0,30,30
1651000523395,MATH 103A,A01,083777,Staff,0,17,30,30
1651000523395,MATH 103A,A02,083778,Staff,0,15,30,30
1651000523395,MATH 103A,B01,083779,Staff,0,15,30,30
1651000523395,MATH 103A,B02,083780,Staff,0,14,30,30
1651000529425,MATH 105,A01,085443,Staff,0,23,30,30
1651000535456,MATH 109,A01,083213,Anzaldo; Leesa B,0,7,30,30
1651000535456,MATH 109,A02,083214,Anzaldo; Leesa B,0,7,30,30
1651000535456,MATH 109,B01,083215,Anzaldo; Leesa B,0,8,30,30
1651000535456,MATH 109,B02,083216,Anzaldo; Leesa B,0,7,30,30
1651000541478,MATH 142A,A01,083219,Chow; Bennett,0,14,30,30
1651000541478,MATH 142A,A02,083220,Chow; Bennett,0,15,30,30
1651000541478,MATH 142A,B01,083221,Chow; Bennett,0,16,30,30
1651000541478,MATH 142A,B02,083222,Chow; Bennett,0,14,30,30
1651000547507,MATH 193A,A01,083224,Staff,0,6,30,30
1651000547507,MATH 193A,A02,083225,Staff,0,7,30,30
1651000547507,MATH 193A,A03,083781,Staff,0,7,30,30
1651000547507,MATH 193A,A04,083782,Staff,0,7,30,30
1651000553529,MATH 197,001,091859,McAuley; Julian John,9998,0,9999,1
1651000559579,COGS 9,A01,083615,Staff,0,19,60,60
1651000565601,COGS 11,A01,083617,Boyle; Mary E. T.,15,0,40,25
1651000571627,COGS 13,A01,083071,Staff,0,40,40,40
1651000577650,COGS 14A,A01,092681,Staff,0,40,100,100
1651000583673,COGS 14B,A01,083073,Cheng; Tzu-Han,0,13,50,50
1651000589698,COGS 17,A01,092677,Staff,7,0,75,68
1651000595727,COGS 100,A01,083619,Staff,0,30,60,60
1651000601750,COGS 101A,A01,083621,Davis; Joshua Daniel,0,30,60,60
1651000607777,COGS 101B,A01,091572,Staff,0,6,60,60
1651000613800,COGS 101C,A01,083625,Delgado; Tania,14,0,30,16
1651000619837,COGS 107A,A01,083627,Boyle; Mary E. T.,0,16,60,60
1651000625861,COGS 118A,A01,083075,Staff,0,10,60,60
1651000631887,CSE 3,A50,083646,Miranda; Gregory Joseph,15,0,38,23
1651000631887,CSE 3,A51,083647,Miranda; Gregory Joseph,36,0,37,1
1651000637911,CSE 8A,A50,083650,Miranda; Gregory Joseph,0,31,40,40
1651000643944,CSE 11,A01,083080,Cao; Yingjun,0,97,40,40
1651000649972,CSE 12,A01,083652,Staff,0,24,100,100
1651000655996,CSE 15L,A01,083654,Staff,0,3,50,50
1651000655996,CSE 15L,A02,083655,Staff,0,3,50,50
1651000662019,CSE 20,A01,083657,Staff,47,0,80,33
1651000668053,CSE 30,A01,083084,Eldon; John,1,38,80,79
1651000674076,CSE 100,A01,083659,Cao; Yingjun,0,71,50,50
1651000680100,CSE 134B,A01,083661,Powell; Thomas Allan,1,40,65,64
1651000686130,CSE 140,A01,083663,Staff,0,13,75,75
1651000692157,CSE 140L,A01,083088,Eldon; John,4,0,100,96
1651000698182,CSE 175,A01,083665,Kumar; Rakesh,0,0,25,25
1651000704206,CSE 190,A00,092507,Dubnov; Shlomo,9,0,20,11
1651000710231,ECE 45,A01,083139,Staff,0,7,60,60
1651000716254,ECE 65,A50,083695,Staff,0,7,30,30
1651000722284,ECE 109,A01,091882,Touri; Behrouz,32,0,70,38
1651000728307,ECE 180,A00,083140,Abi Samra; Nicholas Camill,17,0,30,13
1651000728307,ECE 180,B00,083141,Abi Samra; Nicholas Camill,0,0,30,30
1651000734333,MATH 10A,A01,083735,Patchell; Gregory David,1,0,30,29
1651000734333,MATH 10A,A02,083736,Patchell; Gregory David,27,0,30,3
1651000734333,MATH 10A,A03,083737,Patchell; Gregory David,23,0,30,7
1651000740359,MATH 10B,A01,083207,Staff,0,9,30,30
1651000740359,MATH 10B,A02,083208,Staff,0,5,30,30
1651000740359,MATH 10B,B01,083739,Staff,9,0,30,21
1651000740359,MATH 10B,B02,083740,Staff,28,0,30,2
1651000746385,MATH 18,A01,083743,Staff,0,0,30,30
1651000746385,MATH 18,A02,083744,Staff,23,0,30,7
1651000746385,MATH 18,A03,083745,Staff,19,0,30,11
1651000746385,MATH 18,A04,083746,Staff,26,0,30,4
1651000746385,MATH 18,B01,083748,Staff,0,15,30,30
1651000746385,MATH 18,B02,083749,Staff,0,14,30,30
1651000746385,MATH 18,B03,083750,Staff,0,14,30,30
1651000746385,MATH 18,B04,083751,Staff,0,13,30,30
1651000752408,MATH 20A,A01,083754,Staff,19,0,40,21
1651000758440,MATH 20B,A01,083756,Staff,0,14,30,30
1651000758440,MATH 20B,A02,083757,Staff,0,11,30,30
1651000764472,MATH 20C,A01,083760,Staff,0,17,30,30
1651000764472,MATH 20C,A02,083761,Staff,0,15,30,30
1651000764472,MATH 20C,B01,083762,Staff,9,0,30,21
1651000764472,MATH 20C,B02,083763,Staff,28,0,30,2
1651000770499,MATH 20D,A01,083765,Staff,3,1,30,27
1651000770499,MATH 20D,A02,083766,Staff,2,0,30,28
1651000770499,MATH 20D,A03,083767,Staff,22,0,30,8
1651000776535,MATH 20E,A01,083771,Staff,2,0,30,28
1651000776535,MATH 20E,A02,083772,Staff,12,0,30,18
1651000776535,MATH 20E,B01,083773,Staff,0,0,30,30
1651000776535,MATH 20E,B02,083774,Staff,0,0,30,30
1651000782572,MATH 103A,A01,083777,Staff,0,17,30,30
1651000782572,MATH 103A,A02,083778,Staff,0,15,30,30
1651000782572,MATH 103A,B01,083779,Staff,0,15,30,30
1651000782572,MATH 103A,B02,083780,Staff,0,14,30,30
1651000788597,MATH 105,A01,085443,Staff,0,23,30,30
1651000794620,MATH 109,A01,083213,Anzaldo; Leesa B,0,7,30,30
1651000794620,MATH 109,A02,083214,Anzaldo; Leesa B,0,7,30,30
1651000794620,MATH 109,B01,083215,Anzaldo; Leesa B,0,8,30,30
1651000794620,MATH 109,B02,083216,Anzaldo; Leesa B,0,7,30,30
1651000800648,MATH 142A,A01,083219,Chow; Bennett,0,14,30,30
1651000800648,MATH 142A,A02,083220,Chow; Bennett,0,15,30,30
1651000800648,MATH 142A,B01,083221,Chow; Bennett,0,16,30,30
1651000800648,MATH 142A,B02,083222,Chow; Bennett,0,14,30,30
1651000806677,MATH 193A,A01,083224,Staff,0,6,30,30
1651000806677,MATH 193A,A02,083225,Staff,0,7,30,30
1651000806677,MATH 193A,A03,083781,Staff,0,7,30,30
1651000806677,MATH 193A,A04,083782,Staff,0,7,30,30
1651000812710,MATH 197,001,091859,McAuley; Julian John,9998,0,9999,1
1651000818785,COGS 9,A01,083615,Staff,0,19,60,60
1651000824817,COGS 11,A01,083617,Boyle; Mary E. T.,15,0,40,25
1651000830840,COGS 13,A01,083071,Staff,0,40,40,40
1651000836873,COGS 14A,A01,092681,Staff,0,40,100,100
1651000842897,COGS 14B,A01,083073,Cheng; Tzu-Han,0,13,50,50
1651000848923,COGS 17,A01,092677,Staff,7,0,75,68
1651000854947,COGS 100,A01,083619,Staff,0,30,60,60
1651000860970,COGS 101A,A01,083621,Davis; Joshua Daniel,0,30,60,60
1651000866999,COGS 101B,A01,091572,Staff,0,6,60,60
1651000873027,COGS 101C,A01,083625,Delgado; Tania,14,0,30,16
1651000879056,COGS 107A,A01,083627,Boyle; Mary E. T.,0,16,60,60
1651000885092,COGS 118A,A01,083075,Staff,0,10,60,60
1651000891115,CSE 3,A50,083646,Miranda; Gregory Joseph,15,0,38,23
1651000891115,CSE 3,A51,083647,Miranda; Gregory Joseph,36,0,37,1
1651000897139,CSE 8A,A50,083650,Miranda; Gregory Joseph,0,31,40,40
1651000903169,CSE 11,A01,083080,Cao; Yingjun,0,97,40,40
1651000909191,CSE 12,A01,083652,Staff,0,24,100,100
1651000915213,CSE 15L,A01,083654,Staff,0,3,50,50
1651000915213,CSE 15L,A02,083655,Staff,0,3,50,50
1651000921236,CSE 20,A01,083657,Staff,47,0,80,33
1651000927263,CSE 30,A01,083084,Eldon; John,1,38,80,79
1651000933286,CSE 100,A01,083659,Cao; Yingjun,0,71,50,50
1651000939311,CSE 134B,A01,083661,Powell; Thomas Allan,1,40,65,64
1651000945339,CSE 140,A01,083663,Staff,0,13,75,75
1651000951364,CSE 140L,A01,083088,Eldon; John,4,0,100,96
1651000957387,CSE 175,A01,083665,Kumar; Rakesh,0,0,25,25
1651000963417,CSE 190,A00,092507,Dubnov; Shlomo,9,0,20,11
1651000969443,ECE 45,A01,083139,Staff,0,7,60,60
1651000975465,ECE 65,A50,083695,Staff,0,7,30,30
1651000981495,ECE 109,A01,091882,Touri; Behrouz,32,0,70,38
1651000987517,ECE 180,A00,083140,Abi Samra; Nicholas Camill,17,0,30,13
1651000987517,ECE 180,B00,083141,Abi Samra; Nicholas Camill,0,0,30,30
1651000993555,MATH 10A,A01,083735,Patchell; Gregory David,1,0,30,29
1651000993555,MATH 10A,A02,083736,Patchell; Gregory David,27,0,30,3
1651000993555,MATH 10A,A03,083737,Patchell; Gregory David,23,0,30,7
1651000999583,MATH 10B,A01,083207,Staff,0,9,30,30
1651000999583,MATH 10B,A02,083208,Staff,0,5,30,30
1651000999583,MATH 10B,B01,083739,Staff,9,0,30,21
1651000999583,MATH 10B,B02,083740,Staff,28,0,30,2
1651001005608,MATH 18,A01,083743,Staff,0,0,30,30
1651001005608,MATH 18,A02,083744,Staff,23,0,30,7
1651001005608,MATH 18,A03,083745,Staff,19,0,30,11
1651001005608,MATH 18,A04,083746,Staff,26,0,30,4
1651001005608,MATH 18,B01,083748,Staff,0,15,30,30
1651001005608,MATH 18,B02,083749,Staff,0,14,30,30
1651001005608,MATH 18,B03,083750,Staff,0,14,30,30
1651001005608,MATH 18,B04,083751,Staff,0,13,30,30
1651001011635,MATH 20A,A01,083754,Staff,19,0,40,21
1651001017661,MATH 20B,A01,083756,Staff,0,14,30,30
1651001017661,MATH 20B,A02,083757,Staff,0,11,30,30
1651001023696,MATH 20C,A01,083760,Staff,0,17,30,30
1651001023696,MATH 20C,A02,083761,Staff,0,15,30,30
1651001023696,MATH 20C,B01,083762,Staff,9,0,30,21
1651001023696,MATH 20C,B02,083763,Staff,28,0,30,2
1651001029725,MATH 20D,A01,083765,Staff,3,1,30,27
1651001029725,MATH 20D,A02,083766,Staff,2,0,30,28
1651001029725,MATH 20D,A03,083767,Staff,22,0,30,8
1651001035749,MATH 20E,A01,083771,Staff,2,0,30,28
1651001035749,MATH 20E,A02,083772,Staff,12,0,30,18
1651001035749,MATH 20E,B01,083773,Staff,0,0,30,30
1651001035749,MATH 20E,B02,083774,Staff,0,0,30,30
1651001041782,MATH 103A,A01,083777,Staff,0,17,30,30
1651001041782,MATH 103A,A02,083778,Staff,0,15,30,30
1651001041782,MATH 103A,B01,083779,Staff,0,15,30,30
1651001041782,MATH 103A,B02,083780,Staff,0,14,30,30
1651001047811,MATH 105,A01,085443,Staff,0,23,30,30
1651001053838,MATH 109,A01,083213,Anzaldo; Leesa B,0,7,30,30
1651001053838,MATH 109,A02,083214,Anzaldo; Leesa B,0,7,30,30
1651001053838,MATH 109,B01,083215,Anzaldo; Leesa B,0,8,30,30
1651001053838,MATH 109,B02,083216,Anzaldo; Leesa B,0,7,30,30
1651001059867,MATH 142A,A01,083219,Chow; Bennett,0,14,30,30
1651001059867,MATH 142A,A02,083220,Chow; Bennett,0,15,30,30
1651001059867,MATH 142A,B01,083221,Chow; Bennett,0,16,30,30
1651001059867,MATH 142A,B02,083222,Chow; Bennett,0,14,30,30
1651001065890,MATH 193A,A01,083224,Staff,0,6,30,30
1651001065890,MATH 193A,A02,083225,Staff,0,7,30,30
1651001065890,MATH 193A,A03,083781,Staff,0,7,30,30
1651001065890,MATH 193A,A04,083782,Staff,0,7,30,30
1651001071913,MATH 197,001,091859,McAuley; Julian John,9998,0,9999,1
1651001077978,COGS 9,A01,083615,Staff,0,19,60,60
1651001084004,COGS 11,A01,083617,Boyle; Mary E. T.,15,0,40,25
1651001090028,COGS 13,A01,083071,Staff,0,40,40,40
1651001096051,COGS 14A,A01,092681,Staff,0,40,100,100
1651001102183,COGS 14B,A01,083073,Cheng; Tzu-Han,0,13,50,50
1651001108210,COGS 17,A01,092677,Staff,7,0,75,68
1651001114240,COGS 100,A01,083619,Staff,0,30,60,60
1651001120265,COGS 101A,A01,083621,Davis; Joshua Daniel,0,30,60,60
1651001126306,COGS 101B,A01,091572,Staff,0,6,60,60
1651001132342,COGS 101C,A01,083625,Delgado; Tania,14,0,30,16
1651001138365,COGS 107A,A01,083627,Boyle; Mary E. T.,0,16,60,60
1651001144397,COGS 118A,A01,083075,Staff,0,10,60,60
1651001150421,CSE 3,A50,083646,Miranda; Gregory Joseph,15,0,38,23
1651001150421,CSE 3,A51,083647,Miranda; Gregory Joseph,36,0,37,1
1651001156443,CSE 8A,A50,083650,Miranda; Gregory Joseph,0,31,40,40
1651001162466,CSE 11,A01,083080,Cao; Yingjun,0,97,40,40
1651001168489,CSE 12,A01,083652,Staff,0,24,100,100
1651001174512,CSE 15L,A01,083654,Staff,0,3,50,50
1651001174512,CSE 15L,A02,083655,Staff,0,3,50,50
1651001180536,CSE 20,A01,083657,Staff,47,0,80,33
1651001186558,CSE 30,A01,083084,Eldon; John,1,38,80,79
1651001192584,CSE 100,A01,083659,Cao; Yingjun,0,71,50,50
1651001198612,CSE 134B,A01,083661,Powell; Thomas Allan,1,40,65,64
1651001204638,CSE 140,A01,083663,Staff,0,13,75,75
1651001210663,CSE 140L,A01,083088,Eldon; John,4,0,100,96
1651001216685,CSE 175,A01,083665,Kumar; Rakesh,0,0,25,25
1651001222712,CSE 190,A00,092507,Dubnov; Shlomo,9,0,20,11
1651001228742,ECE 45,A01,083139,Staff,0,7,60,60
1651001234776,ECE 65,A50,083695,Staff,0,7,30,30
1651001240800,ECE 109,A01,091882,Touri; Behrouz,32,0,70,38
1651001246825,ECE 180,A00,083140,Abi Samra; Nicholas Camill,17,0,30,13
1651001246825,ECE 180,B00,083141,Abi Samra; Nicholas Camill,0,0,30,30
1651001252860,MATH 10A,A01,083735,Patchell; Gregory David,1,0,30,29
1651001252860,MATH 10A,A02,083736,Patchell; Gregory David,27,0,30,3
1651001252860,MATH 10A,A03,083737,Patchell; Gregory David,23,0,30,7
1651001258884,MATH 10B,A01,083207,Staff,0,9,30,30
1651001258884,MATH 10B,A02,083208,Staff,0,5,30,30
1651001258884,MATH 10B,B01,083739,Staff,9,0,30,21
1651001258884,MATH 10B,B02,083740,Staff,28,0,30,2
1651001264914,MATH 18,A01,083743,Staff,0,0,30,30
1651001264914,MATH 18,A02,083744,Staff,23,0,30,7
1651001264914,MATH 18,A03,083745,Staff,19,0,30,11
1651001264914,MATH 18,A04,083746,Staff,26,0,30,4
1651001264914,MATH 18,B01,083748,Staff,0,15,30,30
1651001264914,MATH 18,B02,083749,Staff,0,14,30,30
1651001264914,MATH 18,B03,083750,Staff,0,14,30,30
1651001264914,MATH 18,B04,083751,Staff,0,13,30,30
1651001270937,MATH 20A,A01,083754,Staff,19,0,40,21
1651001276969,MATH 20B,A01,083756,Staff,0,14,30,30
1651001276969,MATH 20B,A02,083757,Staff,0,11,30,30
1651001282996,MATH 20C,A01,083760,Staff,0,17,30,30
1651001282996,MATH 20C,A02,083761,Staff,0,15,30,30
1651001282996,MATH 20C,B01,083762,Staff,9,0,30,21
1651001282996,MATH 20C,B02,083763,Staff,28,0,30,2
1651001289025,MATH 20D,A01,083765,Staff,3,1,30,27
1651001289025,MATH 20D,A02,083766,Staff,2,0,30,28
1651001289025,MATH 20D,A03,083767,Staff,22,0,30,8
1651001295057,MATH 20E,A01,083771,Staff,1,0,30,29
1651001295057,MATH 20E,A02,083772,Staff,12,0,30,18
1651001295057,MATH 20E,B01,083773,Staff,0,0,30,30
1651001295057,MATH 20E,B02,083774,Staff,0,0,30,30
1651001301086,MATH 103A,A01,083777,Staff,0,17,30,30
1651001301086,MATH 103A,A02,083778,Staff,0,15,30,30
1651001301086,MATH 103A,B01,083779,Staff,0,15,30,30
1651001301086,MATH 103A,B02,083780,Staff,0,14,30,30
1651001307117,MATH 105,A01,085443,Staff,0,23,30,30
1651001313143,MATH 109,A01,083213,Anzaldo; Leesa B,0,7,30,30
1651001313143,MATH 109,A02,083214,Anzaldo; Leesa B,0,7,30,30
1651001313143,MATH 109,B01,083215,Anzaldo; Leesa B,0,8,30,30
1651001313143,MATH 109,B02,083216,Anzaldo; Leesa B,0,7,30,30
1651001319167,MATH 142A,A01,083219,Chow; Bennett,0,14,30,30
1651001319167,MATH 142A,A02,083220,Chow; Bennett,0,15,30,30
1651001319167,MATH 142A,B01,083221,Chow; Bennett,0,16,30,30
1651001319167,MATH 142A,B02,083222,Chow; Bennett,0,14,30,30
1651001325191,MATH 193A,A01,083224,Staff,0,6,30,30
1651001325191,MATH 193A,A02,083225,Staff,0,7,30,30
1651001325191,MATH 193A,A03,083781,Staff,0,7,30,30
1651001325191,MATH 193A,A04,083782,Staff,0,7,30,30
1651001331213,MATH 197,001,091859,McAuley; Julian John,9998,0,9999,1
1651001337292,COGS 9,A01,083615,Staff,0,19,60,60
1651001343315,COGS 11,A01,083617,Boyle; Mary E. T.,15,0,40,25
1651001349340,COGS 13,A01,083071,Staff,0,40,40,40
1651001355364,COGS 14A,A01,092681,Staff,0,40,100,100
1651001361388,COGS 14B,A01,083073,Cheng; Tzu-Han,0,13,50,50
1651001367410,COGS 17,A01,092677,Staff,7,0,75,68
1651001373434,COGS 100,A01,083619,Staff,0,30,60,60
1651001379459,COGS 101A,A01,083621,Davis; Joshua Daniel,0,30,60,60
1651001385481,COGS 101B,A01,091572,Staff,0,6,60,60
1651001391514,COGS 101C,A01,083625,Delgado; Tania,14,0,30,16
1651001397541,COGS 107A,A01,083627,Boyle; Mary E. T.,0,16,60,60
1651001403566,COGS 118A,A01,083075,Staff,0,10,60,60
1651001409591,CSE 3,A50,083646,Miranda; Gregory Joseph,15,0,38,23
1651001409591,CSE 3,A51,083647,Miranda; Gregory Joseph,36,0,37,1
1651001415620,CSE 8A,A50,083650,Miranda; Gregory Joseph,0,31,40,40
1651001421645,CSE 11,A01,083080,Cao; Yingjun,0,97,40,40
1651001427668,CSE 12,A01,083652,Staff,0,24,100,100
1651001433692,CSE 15L,A01,083654,Staff,0,3,50,50
1651001433692,CSE 15L,A02,083655,Staff,0,3,50,50
1651001439718,CSE 20,A01,083657,Staff,47,0,80,33
1651001445751,CSE 30,A01,083084,Eldon; John,1,38,80,79
1651001451776,CSE 100,A01,083659,Cao; Yingjun,0,71,50,50
1651001457808,CSE 134B,A01,083661,Powell; Thomas Allan,1,40,65,64
1651001463837,CSE 140,A01,083663,Staff,0,13,75,75
1651001469860,CSE 140L,A01,083088,Eldon; John,4,0,100,96
1651001475886,CSE 175,A01,083665,Kumar; Rakesh,0,0,25,25
1651001481909,CSE 190,A00,092507,Dubnov; Shlomo,9,0,20,11
1651001487942,ECE 45,A01,083139,Staff,0,7,60,60
1651001493967,ECE 65,A50,083695,Staff,0,7,30,30
1651001499995,ECE 109,A01,091882,Touri; Behrouz,32,0,70,38
1651001506018,ECE 180,A00,083140,Abi Samra; Nicholas Camill,17,0,30,13
1651001506018,ECE 180,B00,083141,Abi Samra; Nicholas Camill,0,0,30,30
1651001512068,MATH 10A,A01,083735,Patchell; Gregory David,1,0,30,29
1651001512068,MATH 10A,A02,083736,Patchell; Gregory David,27,0,30,3
1651001512068,MATH 10A,A03,083737,Patchell; Gregory David,23,0,30,7
1651001518099,MATH 10B,A01,083207,Staff,0,9,30,30
1651001518099,MATH 10B,A02,083208,Staff,0,5,30,30
1651001518099,MATH 10B,B01,083739,Staff,9,0,30,21
1651001518099,MATH 10B,B02,083740,Staff,28,0,30,2
1651001524129,MATH 18,A01,083743,Staff,0,0,30,30
1651001524129,MATH 18,A02,083744,Staff,23,0,30,7
1651001524129,MATH 18,A03,083745,Staff,19,0,30,11
1651001524129,MATH 18,A04,083746,Staff,26,0,30,4
1651001524129,MATH 18,B01,083748,Staff,0,15,30,30
1651001524129,MATH 18,B02,083749,Staff,0,14,30,30
1651001524129,MATH 18,B03,083750,Staff,0,14,30,30
1651001524129,MATH 18,B04,083751,Staff,0,13,30,30
1651001530161,MATH 20A,A01,083754,Staff,19,0,40,21
1651001536184,MATH 20B,A01,083756,Staff,0,14,30,30
1651001536184,MATH 20B,A02,083757,Staff,0,11,30,30
1651001542210,MATH 20C,A01,083760,Staff,0,17,30,30
1651001542210,MATH 20C,A02,083761,Staff,0,15,30,30
1651001542210,MATH 20C,B01,083762,Staff,9,0,30,21
1651001542210,MATH 20C,B02,083763,Staff,28,0,30,2
1651001548236,MATH 20D,A01,083765,Staff,3,1,30,27
1651001548236,MATH 20D,A02,083766,Staff,2,0,30,28
1651001548236,MATH 20D,A03,083767,Staff,22,0,30,8
1651001554278,MATH 20E,A01,083771,Staff,1,0,30,29
1651001554278,MATH 20E,A02,083772,Staff,12,0,30,18
1651001554278,MATH 20E,B01,083773,Staff,0,0,30,30
1651001554278,MATH 20E,B02,083774,Staff,0,0,30,30
1651001560311,MATH 103A,A01,083777,Staff,0,17,30,30
1651001560311,MATH 103A,A02,083778,Staff,0,15,30,30
1651001560311,MATH 103A,B01,083779,Staff,0,15,30,30
1651001560311,MATH 103A,B02,083780,Staff,0,14,30,30
1651001566333,MATH 105,A01,085443,Staff,0,23,30,30
1651001572358,MATH 109,A01,083213,Anzaldo; Leesa B,0,7,30,30
1651001572358,MATH 109,A02,083214,Anzaldo; Leesa B,0,7,30,30
1651001572358,MATH 109,B01,083215,Anzaldo; Leesa B,0,8,30,30
1651001572358,MATH 109,B02,083216,Anzaldo; Leesa B,0,7,30,30
1651001578384,MATH 142A,A01,083219,Chow; Bennett,0,14,30,30
1651001578384,MATH 142A,A02,083220,Chow; Bennett,0,15,30,30
1651001578384,MATH 142A,B01,083221,Chow; Bennett,0,16,30,30
1651001578384,MATH 142A,B02,083222,Chow; Bennett,0,14,30,30
1651001584413,MATH 193A,A01,083224,Staff,0,6,30,30
1651001584413,MATH 193A,A02,083225,Staff,0,7,30,30
1651001584413,MATH 193A,A03,083781,Staff,0,7,30,30
1651001584413,MATH 193A,A04,083782,Staff,0,7,30,30
1651001590439,MATH 197,001,091859,McAuley; Julian John,9998,0,9999,1
1651001596497,COGS 9,A01,083615,Staff,0,19,60,60
1651001602520,COGS 11,A01,083617,Boyle; Mary E. T.,15,0,40,25
1651001608542,COGS 13,A01,083071,Staff,0,40,40,40
1651001614565,COGS 14A,A01,092681,Staff,0,40,100,100
1651001620588,COGS 14B,A01,083073,Cheng; Tzu-Han,0,13,50,50
1651001626612,COGS 17,A01,092677,Staff,6,0,75,69
1651001632639,COGS 100,A01,083619,Staff,0,30,60,60
1651001638664,COGS 101A,A01,083621,Davis; Joshua Daniel,0,30,60,60
1651001644687,COGS 101B,A01,091572,Staff,0,6,60,60
1651001650711,COGS 101C,A01,083625,Delgado; Tania,14,0,30,16
1651001656736,COGS 107A,A01,083627,Boyle; Mary E. T.,0,16,60,60
1651001662768,COGS 118A,A01,083075,Staff,0,10,60,60
1651001668792,CSE 3,A50,083646,Miranda; Gregory Joseph,15,0,38,23
1651001668792,CSE 3,A51,083647,Miranda; Gregory Joseph,36,0,37,1
1651001674816,CSE 8A,A50,083650,Miranda; Gregory Joseph,0,31,40,40
1651001680841,CSE 11,A01,083080,Cao; Yingjun,0,97,40,40
1651001686864,CSE 12,A01,083652,Staff,0,24,100,100
1651001692888,CSE 15L,A01,083654,Staff,0,3,50,50
1651001692888,CSE 15L,A02,083655,Staff,0,3,50,50
1651001699010,CSE 20,A01,083657,Staff,47,0,80,33
1651001705033,CSE 30,A01,083084,Eldon; John,1,38,80,79
1651001711059,CSE 100,A01,083659,Cao; Yingjun,0,71,50,50
1651001717083,CSE 134B,A01,083661,Powell; Thomas Allan,1,40,65,64
1651001723107,CSE 140,A01,083663,Staff,0,13,75,75
1651001729131,CSE 140L,A01,083088,Eldon; John,4,0,100,96
1651001735154,CSE 175,A01,083665,Kumar; Rakesh,0,0,25,25
1651001741179,CSE 190,A00,092507,Dubnov; Shlomo,9,0,20,11
1651001747204,ECE 45,A01,083139,Staff,0,7,60,60
1651001753233,ECE 65,A50,083695,Staff,0,7,30,30
1651001759256,ECE 109,A01,091882,Touri; Behrouz,32,0,70,38
1651001765283,ECE 180,A00,083140,Abi Samra; Nicholas Camill,17,0,30,13
1651001765283,ECE 180,B00,083141,Abi Samra; Nicholas Camill,0,0,30,30
1651001771312,MATH 10A,A01,083735,Patchell; Gregory David,1,0,30,29
1651001771312,MATH 10A,A02,083736,Patchell; Gregory David,27,0,30,3
1651001771312,MATH 10A,A03,083737,Patchell; Gregory David,23,0,30,7
1651001777339,MATH 10B,A01,083207,Staff,0,9,30,30
1651001777339,MATH 10B,A02,083208,Staff,0,5,30,30
1651001777339,MATH 10B,B01,083739,Staff,9,0,30,21
1651001777339,MATH 10B,B02,083740,Staff,28,0,30,2
1651001783362,MATH 18,A01,083743,Staff,0,0,30,30
1651001783362,MATH 18,A02,083744,Staff,23,0,30,7
1651001783362,MATH 18,A03,083745,Staff,19,0,30,11
1651001783362,MATH 18,A04,083746,Staff,26,0,30,4
1651001783362,MATH 18,B01,083748,Staff,0,15,30,30
1651001783362,MATH 18,B02,083749,Staff,0,14,30,30
1651001783362,MATH 18,B03,083750,Staff,0,14,30,30
1651001783362,MATH 18,B04,083751,Staff,0,13,30,30
1651001789387,MATH 20A,A01,083754,Staff,19,0,40,21
1651001795409,MATH 20B,A01,083756,Staff,0,14,30,30
1651001795409,MATH 20B,A02,083757,Staff,0,11,30,30
1651001801436,MATH 20C,A01,083760,Staff,0,17,30,30
1651001801436,MATH 20C,A02,083761,Staff,0,15,30,30
1651001801436,MATH 20C,B01,083762,Staff,9,0,30,21
1651001801436,MATH 20C,B02,083763,Staff,28,0,30,2
1651001807470,MATH 20D,A01,083765,Staff,3,1,30,27
1651001807470,MATH 20D,A02,083766,Staff,2,0,30,28
1651001807470,MATH 20D,A03,083767,Staff,22,0,30,8
1651001813496,MATH 20E,A01,083771,Staff,1,0,30,29
1651001813496,MATH 20E,A02,083772,Staff,12,0,30,18
1651001813496,MATH 20E,B01,083773,Staff,0,0,30,30
1651001813496,MATH 20E,B02,083774,Staff,0,0,30,30
1651001819525,MATH 103A,A01,083777,Staff,0,17,30,30
1651001819525,MATH 103A,A02,083778,Staff,0,15,30,30
1651001819525,MATH 103A,B01,083779,Staff,0,15,30,30
1651001819525,MATH 103A,B02,083780,Staff,0,14,30,30
1651001825549,MATH 105,A01,085443,Staff,0,23,30,30
1651001831572,MATH 109,A01,083213,Anzaldo; Leesa B,0,7,30,30
1651001831572,MATH 109,A02,083214,Anzaldo; Leesa B,0,7,30,30
1651001831572,MATH 109,B01,083215,Anzaldo; Leesa B,0,8,30,30
1651001831572,MATH 109,B02,083216,Anzaldo; Leesa B,0,7,30,30
1651001837602,MATH 142A,A01,083219,Chow; Bennett,0,14,30,30
1651001837602,MATH 142A,A02,083220,Chow; Bennett,0,15,30,30
1651001837602,MATH 142A,B01,083221,Chow; Bennett,0,16,30,30
1651001837602,MATH 142A,B02,083222,Chow; Bennett,0,14,30,30
1651001843627,MATH 193A,A01,083224,Staff,0,6,30,30
1651001843627,MATH 193A,A02,083225,Staff,0,7,30,30
1651001843627,MATH 193A,A03,083781,Staff,0,7,30,30
1651001843627,MATH 193A,A04,083782,Staff,0,7,30,30
1651001849651,MATH 197,001,091859,McAuley; Julian John,9998,0,9999,1
1651001855711,COGS 9,A01,083615,Staff,0,19,60,60
1651001861738,COGS 11,A01,083617,Boyle; Mary E. T.,15,0,40,25
1651001867781,COGS 13,A01,083071,Staff,0,40,40,40
1651001873815,COGS 14A,A01,092681,Staff,0,40,100,100
1651001879843,COGS 14B,A01,083073,Cheng; Tzu-Han,0,13,50,50
1651001885867,COGS 17,A01,092677,Staff,6,0,75,69
1651001891899,COGS 100,A01,083619,Staff,0,30,60,60
1651001897926,COGS 101A,A01,083621,Davis; Joshua Daniel,0,30,60,60
1651001903952,COGS 101B,A01,091572,Staff,0,6,60,60
1651001909990,COGS 101C,A01,083625,Delgado; Tania,14,0,30,16
1651001916016,COGS 107A,A01,083627,Boyle; Mary E. T.,0,16,60,60
1651001922039,COGS 118A,A01,083075,Staff,0,10,60,60
1651001928061,CSE 3,A50,083646,Miranda; Gregory Joseph,15,0,38,23
1651001928061,CSE 3,A51,083647,Miranda; Gregory Joseph,36,0,37,1
1651001934091,CSE 8A,A50,083650,Miranda; Gregory Joseph,0,31,40,40
1651001940119,CSE 11,A01,083080,Cao; Yingjun,0,97,40,40
1651001946144,CSE 12,A01,083652,Staff,0,24,100,100
1651001952167,CSE 15L,A01,083654,Staff,0,3,50,50
1651001952167,CSE 15L,A02,083655,Staff,0,3,50,50
1651001958189,CSE 20,A01,083657,Staff,47,0,80,33
1651001964224,CSE 30,A01,083084,Eldon; John,1,38,80,79
1651001970250,CSE 100,A01,083659,Cao; Yingjun,0,71,50,50
1651001976272,CSE 134B,A01,083661,Powell; Thomas Allan,1,40,65,64
1651001982295,CSE 140,A01,083663,Staff,0,13,75,75
1651001988326,CSE 140L,A01,083088,Eldon; John,4,0,100,96
1651001994355,CSE 175,A01,083665,Kumar; Rakesh,0,0,25,25
1651002000378,CSE 190,A00,092507,Dubnov; Shlomo,9,0,20,11
1651002006403,ECE 45,A01,083139,Staff,0,7,60,60
1651002012426,ECE 65,A50,083695,Staff,0,7,30,30
1651002018461,ECE 109,A01,091882,Touri; Behrouz,32,0,70,38
1651002024495,ECE 180,A00,083140,Abi Samra; Nicholas Camill,17,0,30,13
1651002024495,ECE 180,B00,083141,Abi Samra; Nicholas Camill,0,0,30,30
1651002030520,MATH 10A,A01,083735,Patchell; Gregory David,1,0,30,29
1651002030520,MATH 10A,A02,083736,Patchell; Gregory David,27,0,30,3
1651002030520,MATH 10A,A03,083737,Patchell; Gregory David,23,0,30,7
1651002036548,MATH 10B,A01,083207,Staff,0,9,30,30
1651002036548,MATH 10B,A02,083208,Staff,0,5,30,30
1651002036548,MATH 10B,B01,083739,Staff,9,0,30,21
1651002036548,MATH 10B,B02,083740,Staff,28,0,30,2
1651002042578,MATH 18,A01,083743,Staff,0,0,30,30
1651002042578,MATH 18,A02,083744,Staff,23,0,30,7
1651002042578,MATH 18,A03,083745,Staff,19,0,30,11
1651002042578,MATH 18,A04,083746,Staff,26,0,30,4
1651002042578,MATH 18,B01,083748,Staff,0,15,30,30
1651002042578,MATH 18,B02,083749,Staff,0,14,30,30
1651002042578,MATH 18,B03,083750,Staff,0,14,30,30
1651002042578,MATH 18,B04,083751,Staff,0,13,30,30
1651002048611,MATH 20A,A01,083754,Staff,19,0,40,21
1651002054634,MATH 20B,A01,083756,Staff,0,14,30,30
1651002054634,MATH 20B,A02,083757,Staff,0,11,30,30
1651002060659,MATH 20C,A01,083760,Staff,0,17,30,30
1651002060659,MATH 20C,A02,083761,Staff,0,15,30,30
1651002060659,MATH 20C,B01,083762,Staff,9,0,30,21
1651002060659,MATH 20C,B02,083763,Staff,28,0,30,2
1651002066689,MATH 20D,A01,083765,Staff,3,1,30,27
1651002066689,MATH 20D,A02,083766,Staff,2,0,30,28
1651002066689,MATH 20D,A03,083767,Staff,22,0,30,8
1651002072713,MATH 20E,A01,083771,Staff,1,0,30,29
1651002072713,MATH 20E,A02,083772,Staff,12,0,30,18
1651002072713,MATH 20E,B01,083773,Staff,0,0,30,30
1651002072713,MATH 20E,B02,083774,Staff,0,0,30,30
1651002078745,MATH 103A,A01,083777,Staff,0,17,30,30
1651002078745,MATH 103A,A02,083778,Staff,0,15,30,30
1651002078745,MATH 103A,B01,083779,Staff,0,15,30,30
1651002078745,MATH 103A,B02,083780,Staff,0,14,30,30
1651002084771,MATH 105,A01,085443,Staff,0,23,30,30
1651002090795,MATH 109,A01,083213,Anzaldo; Leesa B,0,7,30,30
1651002090795,MATH 109,A02,083214,Anzaldo; Leesa B,0,7,30,30
1651002090795,MATH 109,B01,083215,Anzaldo; Leesa B,0,8,30,30
1651002090795,MATH 109,B02,083216,Anzaldo; Leesa B,0,7,30,30
1651002096819,MATH 142A,A01,083219,Chow; Bennett,0,14,30,30
1651002096819,MATH 142A,A02,083220,Chow; Bennett,0,15,30,30
1651002096819,MATH 142A,B01,083221,Chow; Bennett,0,16,30,30
1651002096819,MATH 142A,B02,083222,Chow; Bennett,0,14,30,30
1651002102841,MATH 193A,A01,083224,Staff,0,6,30,30
1651002102841,MATH 193A,A02,083225,Staff,0,7,30,30
1651002102841,MATH 193A,A03,083781,Staff,0,7,30,30
1651002102841,MATH 193A,A04,083782,Staff,0,7,30,30
1651002108863,MATH 197,001,091859,McAuley; Julian John,9998,0,9999,1
1651002114925,COGS 9,A01,083615,Staff,0,19,60,60
1651002120957,COGS 11,A01,083617,Boyle; Mary E. T.,15,0,40,25
1651002126993,COGS 13,A01,083071,Staff,0,40,40,40
1651002133017,COGS 14A,A01,092681,Staff,0,40,100,100
1651002139052,COGS 14B,A01,083073,Cheng; Tzu-Han,0,13,50,50
1651002145077,COGS 17,A01,092677,Staff,6,0,75,69
1651002151119,COGS 100,A01,083619,Staff,0,30,60,60
1651002157146,COGS 101A,A01,083621,Davis; Joshua Daniel,0,30,60,60
1651002163173,COGS 101B,A01,091572,Staff,0,6,60,60
1651002169204,COGS 101C,A01,083625,Delgado; Tania,14,0,30,16
1651002175232,COGS 107A,A01,083627,Boyle; Mary E. T.,0,16,60,60
1651002181255,COGS 118A,A01,083075,Staff,0,10,60,60
1651002187281,CSE 3,A50,083646,Miranda; Gregory Joseph,15,0,38,23
1651002187281,CSE 3,A51,083647,Miranda; Gregory Joseph,36,0,37,1
1651002193312,CSE 8A,A50,083650,Miranda; Gregory Joseph,0,31,40,40
1651002199347,CSE 11,A01,083080,Cao; Yingjun,0,97,40,40
1651002205398,CSE 12,A01,083652,Staff,0,24,100,100
1651002211423,CSE 15L,A01,083654,Staff,0,3,50,50
1651002211423,CSE 15L,A02,083655,Staff,0,3,50,50
1651002217452,CSE 20,A01,083657,Staff,47,0,80,33
1651002223486,CSE 30,A01,083084,Eldon; John,1,38,80,79
1651002229514,CSE 100,A01,083659,Cao; Yingjun,0,71,50,50
1651002235550,CSE 134B,A01,083661,Powell; Thomas Allan,1,40,65,64
1651002241578,CSE 140,A01,083663,Staff,0,13,75,75
1651002247609,CSE 140L,A01,083088,Eldon; John,4,0,100,96
1651002253632,CSE 175,A01,083665,Kumar; Rakesh,0,0,25,25
1651002259659,CSE 190,A00,092507,Dubnov; Shlomo,9,0,20,11
1651002265682,ECE 45,A01,083139,Staff,0,7,60,60
1651002271706,ECE 65,A50,083695,Staff,0,7,30,30
1651002277733,ECE 109,A01,091882,Touri; Behrouz,32,0,70,38
1651002283763,ECE 180,A00,083140,Abi Samra; Nicholas Camill,17,0,30,13
1651002283763,ECE 180,B00,083141,Abi Samra; Nicholas Camill,0,0,30,30
1651002289802,MATH 10A,A01,083735,Patchell; Gregory David,1,0,30,29
1651002289802,MATH 10A,A02,083736,Patchell; Gregory David,27,0,30,3
1651002289802,MATH 10A,A03,083737,Patchell; Gregory David,23,0,30,7
1651002295952,MATH 10B,A01,083207,Staff,0,10,30,30
1651002295952,MATH 10B,A02,083208,Staff,0,5,30,30
1651002295952,MATH 10B,B01,083739,Staff,9,0,30,21
1651002295952,MATH 10B,B02,083740,Staff,28,0,30,2
1651002301976,MATH 18,A01,083743,Staff,0,0,30,30
1651002301976,MATH 18,A02,083744,Staff,23,0,30,7
1651002301976,MATH 18,A03,083745,Staff,19,0,30,11
1651002301976,MATH 18,A04,083746,Staff,26,0,30,4
1651002301976,MATH 18,B01,083748,Staff,0,15,30,30
1651002301976,MATH 18,B02,083749,Staff,0,14,30,30
1651002301976,MATH 18,B03,083750,Staff,0,14,30,30
1651002301976,MATH 18,B04,083751,Staff,0,13,30,30
1651002308002,MATH 20A,A01,083754,Staff,19,0,40,21
1651002314025,MATH 20B,A01,083756,Staff,0,14,30,30
1651002314025,MATH 20B,A02,083757,Staff,0,11,30,30
1651002320052,MATH 20C,A01,083760,Staff,0,17,30,30
1651002320052,MATH 20C,A02,083761,Staff,0,15,30,30
1651002320052,MATH 20C,B01,083762,Staff,9,0,30,21
1651002320052,MATH 20C,B02,083763,Staff,28,0,30,2
1651002326083,MATH 20D,A01,083765,Staff,3,1,30,27
1651002326083,MATH 20D,A02,083766,Staff,2,0,30,28
1651002326083,MATH 20D,A03,083767,Staff,22,0,30,8
1651002332115,MATH 20E,A01,083771,Staff,1,0,30,29
1651002332115,MATH 20E,A02,083772,Staff,12,0,30,18
1651002332115,MATH 20E,B01,083773,Staff,0,0,30,30
1651002332115,MATH 20E,B02,083774,Staff,0,0,30,30
1651002338154,MATH 103A,A01,083777,Staff,0,17,30,30
1651002338154,MATH 103A,A02,083778,Staff,0,15,30,30
1651002338154,MATH 103A,B01,083779,Staff,0,15,30,30
1651002338154,MATH 103A,B02,083780,Staff,0,14,30,30
1651002344179,MATH 105,A01,085443,Staff,0,23,30,30
1651002350207,MATH 109,A01,083213,Anzaldo; Leesa B,0,7,30,30
1651002350207,MATH 109,A02,083214,Anzaldo; Leesa B,0,7,30,30
1651002350207,MATH 109,B01,083215,Anzaldo; Leesa B,0,8,30,30
1651002350207,MATH 109,B02,083216,Anzaldo; Leesa B,0,7,30,30
1651002356230,MATH 142A,A01,083219,Chow; Bennett,0,14,30,30
1651002356230,MATH 142A,A02,083220,Chow; Bennett,0,15,30,30
1651002356230,MATH 142A,B01,083221,Chow; Bennett,0,16,30,30
1651002356230,MATH 142A,B02,083222,Chow; Bennett,0,14,30,30
1651002362253,MATH 193A,A01,083224,Staff,0,6,30,30
1651002362253,MATH 193A,A02,083225,Staff,0,7,30,30
1651002362253,MATH 193A,A03,083781,Staff,0,7,30,30
1651002362253,MATH 193A,A04,083782,Staff,0,7,30,30
1651002368286,MATH 197,001,091859,McAuley; Julian John,9998,0,9999,1
1651002374345,COGS 9,A01,083615,Staff,0,19,60,60
1651002380372,COGS 11,A01,083617,Boyle; Mary E. T.,15,0,40,25
1651002386407,COGS 13,A01,083071,Staff,0,40,40,40
1651002392433,COGS 14A,A01,092681,Staff,0,40,100,100
1651002398466,COGS 14B,A01,083073,Cheng; Tzu-Han,0,13,50,50
1651002404507,COGS 17,A01,092677,Staff,6,0,75,69
1651002410539,COGS 100,A01,083619,Staff,0,30,60,60
1651002416564,COGS 101A,A01,083621,Davis; Joshua Daniel,0,30,60,60
1651002422588,COGS 101B,A01,091572,Staff,0,6,60,60
1651002428611,COGS 101C,A01,083625,Delgado; Tania,14,0,30,16
1651002434637,COGS 107A,A01,083627,Boyle; Mary E. T.,0,16,60,60
1651002440660,COGS 118A,A01,083075,Staff,0,10,60,60
1651002446688,CSE 3,A50,083646,Miranda; Gregory Joseph,15,0,38,23
1651002446688,CSE 3,A51,083647,Miranda; Gregory Joseph,36,0,37,1
1651002452712,CSE 8A,A50,083650,Miranda; Gregory Joseph,0,31,40,40
1651002458736,CSE 11,A01,083080,Cao; Yingjun,0,97,40,40
1651002464763,CSE 12,A01,083652,Staff,0,24,100,100
1651002470796,CSE 15L,A01,083654,Staff,0,3,50,50
1651002470796,CSE 15L,A02,083655,Staff,0,3,50,50
1651002476819,CSE 20,A01,083657,Staff,47,0,80,33
1651002482845,CSE 30,A01,083084,Eldon; John,1,38,80,79
1651002488868,CSE 100,A01,083659,Cao; Yingjun,0,71,50,50
1651002494890,CSE 134B,A01,083661,Powell; Thomas Allan,1,40,65,64
1651002500914,CSE 140,A01,083663,Staff,0,13,75,75
1651002506939,CSE 140L,A01,083088,Eldon; John,4,0,100,96
1651002512966,CSE 175,A01,083665,Kumar; Rakesh,0,0,25,25
1651002518996,CSE 190,A00,092507,Dubnov; Shlomo,9,0,20,11
1651002525019,ECE 45,A01,083139,Staff,0,7,60,60
1651002531042,ECE 65,A50,083695,Staff,0,7,30,30
1651002537070,ECE 109,A01,091882,Touri; Behrouz,32,0,70,38
1651002543098,ECE 180,A00,083140,Abi Samra; Nicholas Camill,17,0,30,13
1651002543098,ECE 180,B00,083141,Abi Samra; Nicholas Camill,0,0,30,30
1651002549125,MATH 10A,A01,083735,Patchell; Gregory David,1,0,30,29
1651002549125,MATH 10A,A02,083736,Patchell; Gregory David,27,0,30,3
1651002549125,MATH 10A,A03,083737,Patchell; Gregory David,23,0,30,7
1651002555154,MATH 10B,A01,083207,Staff,0,9,30,30
1651002555154,MATH 10B,A02,083208,Staff,0,5,30,30
1651002555154,MATH 10B,B01,083739,Staff,8,0,30,22
1651002555154,MATH 10B,B02,083740,Staff,28,0,30,2
1651002569952,MATH 18,A01,083743,Staff,0,0,30,30
1651002569952,MATH 18,A02,083744,Staff,23,0,30,7
1651002569952,MATH 18,A03,083745,Staff,19,0,30,11
1651002569952,MATH 18,A04,083746,Staff,26,0,30,4
1651002569952,MATH 18,B01,083748,Staff,0,15,30,30
1651002569952,MATH 18,B02,083749,Staff,0,14,30,30
1651002569952,MATH 18,B03,083750,Staff,0,14,30,30
1651002569952,MATH 18,B04,083751,Staff,0,13,30,30
1651002575983,MATH 20A,A01,083754,Staff,19,0,40,21
1651002582015,MATH 20B,A01,083756,Staff,0,14,30,30
1651002582015,MATH 20B,A02,083757,Staff,0,11,30,30
1651002588038,MATH 20C,A01,083760,Staff,0,17,30,30
1651002588038,MATH 20C,A02,083761,Staff,0,15,30,30
1651002588038,MATH 20C,B01,083762,Staff,9,0,30,21
1651002588038,MATH 20C,B02,083763,Staff,28,0,30,2
1651002594063,MATH 20D,A01,083765,Staff,3,1,30,27
1651002594063,MATH 20D,A02,083766,Staff,2,0,30,28
1651002594063,MATH 20D,A03,083767,Staff,22,0,30,8
1651002600094,MATH 20E,A01,083771,Staff,1,0,30,29
1651002600094,MATH 20E,A02,083772,Staff,12,0,30,18
1651002600094,MATH 20E,B01,083773,Staff,0,0,30,30
1651002600094,MATH 20E,B02,083774,Staff,0,0,30,30
1651002606122,MATH 103A,A01,083777,Staff,0,17,30,30
1651002606122,MATH 103A,A02,083778,Staff,0,15,30,30
1651002606122,MATH 103A,B01,083779,Staff,0,15,30,30
1651002606122,MATH 103A,B02,083780,Staff,0,14,30,30
1651002612145,MATH 105,A01,085443,Staff,0,23,30,30
1651002618168,MATH 109,A01,083213,Anzaldo; Leesa B,0,7,30,30
1651002618168,MATH 109,A02,083214,Anzaldo; Leesa B,0,7,30,30
1651002618168,MATH 109,B01,083215,Anzaldo; Leesa B,0,8,30,30
1651002618168,MATH 109,B02,083216,Anzaldo; Leesa B,0,7,30,30
1651002624194,MATH 142A,A01,083219,Chow; Bennett,0,14,30,30
1651002624194,MATH 142A,A02,083220,Chow; Bennett,0,15,30,30
1651002624194,MATH 142A,B01,083221,Chow; Bennett,0,16,30,30
1651002624194,MATH 142A,B02,083222,Chow; Bennett,0,14,30,30
1651002630220,MATH 193A,A01,083224,Staff,0,6,30,30
1651002630220,MATH 193A,A02,083225,Staff,0,7,30,30
1651002630220,MATH 193A,A03,083781,Staff,0,7,30,30
1651002630220,MATH 193A,A04,083782,Staff,0,7,30,30
1651002636242,MATH 197,001,091859,McAuley; Julian John,9998,0,9999,1
1651002642297,COGS 9,A01,083615,Staff,0,19,60,60
1651002648321,COGS 11,A01,083617,Boyle; Mary E. T.,15,0,40,25
1651002654360,COGS 13,A01,083071,Staff,0,40,40,40
1651002660381,COGS 14A,A01,092681,Staff,0,40,100,100
1651002666411,COGS 14B,A01,083073,Cheng; Tzu-Han,0,13,50,50
1651002672436,COGS 17,A01,092677,Staff,6,0,75,69
1651002678469,COGS 100,A01,083619,Staff,0,30,60,60
1651002684492,COGS 101A,A01,083621,Davis; Joshua Daniel,0,30,60,60
1651002690518,COGS 101B,A01,091572,Staff,0,6,60,60
1651002696542,COGS 101C,A01,083625,Delgado; Tania,14,0,30,16
1651002702575,COGS 107A,A01,083627,Boyle; Mary E. T.,0,16,60,60
1651002708601,COGS 118A,A01,083075,Staff,0,10,60,60
1651002714629,CSE 3,A50,083646,Miranda; Gregory Joseph,15,0,38,23
1651002714629,CSE 3,A51,083647,Miranda; Gregory Joseph,36,0,37,1
1651002720654,CSE 8A,A50,083650,Miranda; Gregory Joseph,0,31,40,40
1651002726680,CSE 11,A01,083080,Cao; Yingjun,0,97,40,40
1651002732705,CSE 12,A01,083652,Staff,0,24,100,100
1651002738728,CSE 15L,A01,083654,Staff,0,3,50,50
1651002738728,CSE 15L,A02,083655,Staff,0,3,50,50
1651002744753,CSE 20,A01,083657,Staff,47,0,80,33
1651002750779,CSE 30,A01,083084,Eldon; John,1,38,80,79
1651002756809,CSE 100,A01,083659,Cao; Yingjun,0,72,50,50
1651002762832,CSE 134B,A01,083661,Powell; Thomas Allan,1,40,65,64
1651002768889,CSE 140,A01,083663,Staff,0,13,75,75
1651002774909,CSE 140L,A01,083088,Eldon; John,4,0,100,96
1651002780931,CSE 175,A01,083665,Kumar; Rakesh,0,0,25,25
1651002786954,CSE 190,A00,092507,Dubnov; Shlomo,9,0,20,11
1651002792977,ECE 45,A01,083139,Staff,0,7,60,60
1651002799010,ECE 65,A50,083695,Staff,0,7,30,30
1651002805033,ECE 109,A01,091882,Touri; Behrouz,32,0,70,38
1651002811059,ECE 180,A00,083140,Abi Samra; Nicholas Camill,17,0,30,13
1651002811059,ECE 180,B00,083141,Abi Samra; Nicholas Camill,0,0,30,30
1651002817086,MATH 10A,A01,083735,Patchell; Gregory David,1,0,30,29
1651002817086,MATH 10A,A02,083736,Patchell; Gregory David,27,0,30,3
1651002817086,MATH 10A,A03,083737,Patchell; Gregory David,23,0,30,7
1651002823114,MATH 10B,A01,083207,Staff,0,9,30,30
1651002823114,MATH 10B,A02,083208,Staff,0,5,30,30
1651002823114,MATH 10B,B01,083739,Staff,8,0,30,22
1651002823114,MATH 10B,B02,083740,Staff,28,0,30,2
1651002829140,MATH 18,A01,083743,Staff,0,0,30,30
1651002829140,MATH 18,A02,083744,Staff,23,0,30,7
1651002829140,MATH 18,A03,083745,Staff,19,0,30,11
1651002829140,MATH 18,A04,083746,Staff,26,0,30,4
1651002829140,MATH 18,B01,083748,Staff,0,15,30,30
1651002829140,MATH 18,B02,083749,Staff,0,14,30,30
1651002829140,MATH 18,B03,083750,Staff,0,14,30,30
1651002829140,MATH 18,B04,083751,Staff,0,13,30,30
1651002835165,MATH 20A,A01,083754,Staff,19,0,40,21
1651002841192,MATH 20B,A01,083756,Staff,0,14,30,30
1651002841192,MATH 20B,A02,083757,Staff,0,11,30,30
1651002847216,MATH 20C,A01,083760,Staff,0,17,30,30
1651002847216,MATH 20C,A02,083761,Staff,0,15,30,30
1651002847216,MATH 20C,B01,083762,Staff,9,0,30,21
1651002847216,MATH 20C,B02,083763,Staff,28,0,30,2
1651002853241,MATH 20D,A01,083765,Staff,3,1,30,27
1651002853241,MATH 20D,A02,083766,Staff,2,0,30,28
1651002853241,MATH 20D,A03,083767,Staff,22,0,30,8
1651002859272,MATH 20E,A01,083771,Staff,1,0,30,29
1651002859272,MATH 20E,A02,083772,Staff,12,0,30,18
1651002859272,MATH 20E,B01,083773,Staff,0,0,30,30
1651002859272,MATH 20E,B02,083774,Staff,0,0,30,30
1651002865301,MATH 103A,A01,083777,Staff,0,17,30,30
1651002865301,MATH 103A,A02,083778,Staff,0,15,30,30
1651002865301,MATH 103A,B01,083779,Staff,0,15,30,30
1651002865301,MATH 103A,B02,083780,Staff,0,14,30,30
1651002871323,MATH 105,A01,085443,Staff,0,23,30,30
1651002877349,MATH 109,A01,083213,Anzaldo; Leesa B,0,7,30,30
1651002877349,MATH 109,A02,083214,Anzaldo; Leesa B,0,7,30,30
1651002877349,MATH 109,B01,083215,Anzaldo; Leesa B,0,8,30,30
1651002877349,MATH 109,B02,083216,Anzaldo; Leesa B,0,7,30,30
1651002883371,MATH 142A,A01,083219,Chow; Bennett,0,14,30,30
1651002883371,MATH 142A,A02,083220,Chow; Bennett,0,15,30,30
1651002883371,MATH 142A,B01,083221,Chow; Bennett,0,16,30,30
1651002883371,MATH 142A,B02,083222,Chow; Bennett,0,14,30,30
1651002889406,MATH 193A,A01,083224,Staff,0,6,30,30
1651002889406,MATH 193A,A02,083225,Staff,0,7,30,30
1651002889406,MATH 193A,A03,083781,Staff,0,7,30,30
1651002889406,MATH 193A,A04,083782,Staff,0,7,30,30
1651002895435,MATH 197,001,091859,McAuley; Julian John,9998,0,9999,1
1651002901587,COGS 9,A01,083615,Staff,0,19,60,60
1651002907611,COGS 11,A01,083617,Boyle; Mary E. T.,15,0,40,25
1651002913636,COGS 13,A01,083071,Staff,0,40,40,40
1651002919658,COGS 14A,A01,092681,Staff,0,40,100,100
1651002925681,COGS 14B,A01,083073,Cheng; Tzu-Han,0,13,50,50
1651002931706,COGS 17,A01,092677,Staff,6,0,75,69
1651002937727,COGS 100,A01,083619,Staff,0,30,60,60
1651002943749,COGS 101A,A01,083621,Davis; Joshua Daniel,0,30,60,60
1651002949774,COGS 101B,A01,091572,Staff,0,6,60,60
1651002955798,COGS 101C,A01,083625,Delgado; Tania,14,0,30,16
1651002961822,COGS 107A,A01,083627,Boyle; Mary E. T.,0,16,60,60
1651002967860,COGS 118A,A01,083075,Staff,0,10,60,60
1651002973884,CSE 3,A50,083646,Miranda; Gregory Joseph,15,0,38,23
1651002973884,CSE 3,A51,083647,Miranda; Gregory Joseph,36,0,37,1
1651002979908,CSE 8A,A50,083650,Miranda; Gregory Joseph,0,31,40,40
1651002985932,CSE 11,A01,083080,Cao; Yingjun,0,97,40,40
1651002991955,CSE 12,A01,083652,Staff,0,24,100,100
1651002997981,CSE 15L,A01,083654,Staff,0,3,50,50
1651002997981,CSE 15L,A02,083655,Staff,0,3,50,50
1651003004006,CSE 20,A01,083657,Staff,47,0,80,33
1651003010039,CSE 30,A01,083084,Eldon; John,1,38,80,79
1651003016067,CSE 100,A01,083659,Cao; Yingjun,0,72,50,50
1651003022090,CSE 134B,A01,083661,Powell; Thomas Allan,1,40,65,64
1651003028115,CSE 140,A01,083663,Staff,0,13,75,75
1651003034138,CSE 140L,A01,083088,Eldon; John,4,0,100,96
1651003040174,CSE 175,A01,083665,Kumar; Rakesh,0,0,25,25
1651003046197,CSE 190,A00,092507,Dubnov; Shlomo,9,0,20,11
1651003052223,ECE 45,A01,083139,Staff,0,7,60,60
1651003058261,ECE 65,A50,083695,Staff,0,7,30,30
1651003064284,ECE 109,A01,091882,Touri; Behrouz,32,0,70,38
1651003070319,ECE 180,A00,083140,Abi Samra; Nicholas Camill,17,0,30,13
1651003070319,ECE 180,B00,083141,Abi Samra; Nicholas Camill,0,0,30,30
1651003076340,MATH 10A,A01,083735,Patchell; Gregory David,1,0,30,29
1651003076340,MATH 10A,A02,083736,Patchell; Gregory David,27,0,30,3
1651003076340,MATH 10A,A03,083737,Patchell; Gregory David,23,0,30,7
1651003082373,MATH 10B,A01,083207,Staff,0,9,30,30
1651003082373,MATH 10B,A02,083208,Staff,0,5,30,30
1651003082373,MATH 10B,B01,083739,Staff,8,0,30,22
1651003082373,MATH 10B,B02,083740,Staff,28,0,30,2
1651003088397,MATH 18,A01,083743,Staff,0,0,30,30
1651003088397,MATH 18,A02,083744,Staff,23,0,30,7
1651003088397,MATH 18,A03,083745,Staff,19,0,30,11
1651003088397,MATH 18,A04,083746,Staff,26,0,30,4
1651003088397,MATH 18,B01,083748,Staff,0,15,30,30
1651003088397,MATH 18,B02,083749,Staff,0,14,30,30
1651003088397,MATH 18,B03,083750,Staff,0,14,30,30
1651003088397,MATH 18,B04,083751,Staff,0,13,30,30
1651003094422,MATH 20A,A01,083754,Staff,19,0,40,21
1651003100445,MATH 20B,A01,083756,Staff,0,14,30,30
1651003100445,MATH 20B,A02,083757,Staff,0,11,30,30
1651003106472,MATH 20C,A01,083760,Staff,0,17,30,30
1651003106472,MATH 20C,A02,083761,Staff,0,15,30,30
1651003106472,MATH 20C,B01,083762,Staff,9,0,30,21
1651003106472,MATH 20C,B02,083763,Staff,28,0,30,2
1651003112494,MATH 20D,A01,083765,Staff,3,1,30,27
1651003112494,MATH 20D,A02,083766,Staff,2,0,30,28
1651003112494,MATH 20D,A03,083767,Staff,22,0,30,8
1651003118522,MATH 20E,A01,083771,Staff,1,0,30,29
1651003118522,MATH 20E,A02,083772,Staff,12,0,30,18
1651003118522,MATH 20E,B01,083773,Staff,0,0,30,30
1651003118522,MATH 20E,B02,083774,Staff,0,0,30,30
1651003124549,MATH 103A,A01,083777,Staff,0,17,30,30
1651003124549,MATH 103A,A02,083778,Staff,0,15,30,30
1651003124549,MATH 103A,B01,083779,Staff,0,15,30,30
1651003124549,MATH 103A,B02,083780,Staff,0,14,30,30
1651003130580,MATH 105,A01,085443,Staff,0,23,30,30
1651003136608,MATH 109,A01,083213,Anzaldo; Leesa B,0,7,30,30
1651003136608,MATH 109,A02,083214,Anzaldo; Leesa B,0,7,30,30
1651003136608,MATH 109,B01,083215,Anzaldo; Leesa B,0,8,30,30
1651003136608,MATH 109,B02,083216,Anzaldo; Leesa B,0,7,30,30
1651003142642,MATH 142A,A01,083219,Chow; Bennett,0,14,30,30
1651003142642,MATH 142A,A02,083220,Chow; Bennett,0,15,30,30
1651003142642,MATH 142A,B01,083221,Chow; Bennett,0,16,30,30
1651003142642,MATH 142A,B02,083222,Chow; Bennett,0,14,30,30
1651003148665,MATH 193A,A01,083224,Staff,0,6,30,30
1651003148665,MATH 193A,A02,083225,Staff,0,7,30,30
1651003148665,MATH 193A,A03,083781,Staff,0,7,30,30
1651003148665,MATH 193A,A04,083782,Staff,0,7,30,30
1651003154696,MATH 197,001,091859,McAuley; Julian John,9998,0,9999,1
1651003160757,COGS 9,A01,083615,Staff,0,19,60,60
1651003166786,COGS 11,A01,083617,Boyle; Mary E. T.,15,0,40,25
1651003172822,COGS 13,A01,083071,Staff,0,40,40,40
1651003178847,COGS 14A,A01,092681,Staff,0,40,100,100
1651003184874,COGS 14B,A01,083073,Cheng; Tzu-Han,0,13,50,50
1651003190897,COGS 17,A01,092677,Staff,6,0,75,69
1651003196930,COGS 100,A01,083619,Staff,0,30,60,60
1651003202953,COGS 101A,A01,083621,Davis; Joshua Daniel,0,30,60,60
1651003208975,COGS 101B,A01,091572,Staff,0,6,60,60
1651003214998,COGS 101C,A01,083625,Delgado; Tania,14,0,30,16
1651003221025,COGS 107A,A01,083627,Boyle; Mary E. T.,0,16,60,60
1651003227051,COGS 118A,A01,083075,Staff,0,10,60,60
1651003233082,CSE 3,A50,083646,Miranda; Gregory Joseph,15,0,38,23
1651003233082,CSE 3,A51,083647,Miranda; Gregory Joseph,36,0,37,1
1651003239107,CSE 8A,A50,083650,Miranda; Gregory Joseph,0,31,40,40
1651003245134,CSE 11,A01,083080,Cao; Yingjun,0,97,40,40
1651003251176,CSE 12,A01,083652,Staff,0,24,100,100
1651003257208,CSE 15L,A01,083654,Staff,0,3,50,50
1651003257208,CSE 15L,A02,083655,Staff,0,3,50,50
1651003263234,CSE 20,A01,083657,Staff,47,0,80,33
1651003269259,CSE 30,A01,083084,Eldon; John,1,38,80,79
1651003275284,CSE 100,A01,083659,Cao; Yingjun,0,72,50,50
1651003281309,CSE 134B,A01,083661,Powell; Thomas Allan,1,40,65,64
1651003287338,CSE 140,A01,083663,Staff,0,13,75,75
1651003293365,CSE 140L,A01,083088,Eldon; John,4,0,100,96
1651003299396,CSE 175,A01,083665,Kumar; Rakesh,0,0,25,25
1651003305418,CSE 190,A00,092507,Dubnov; Shlomo,9,0,20,11
1651003311441,ECE 45,A01,083139,Staff,0,7,60,60
1651003317468,ECE 65,A50,083695,Staff,0,7,30,30
1651003323489,ECE 109,A01,091882,Touri; Behrouz,32,0,70,38
1651003329513,ECE 180,A00,083140,Abi Samra; Nicholas Camill,17,0,30,13
1651003329513,ECE 180,B00,083141,Abi Samra; Nicholas Camill,0,0,30,30
1651003335543,MATH 10A,A01,083735,Patchell; Gregory David,1,0,30,29
1651003335543,MATH 10A,A02,083736,Patchell; Gregory David,27,0,30,3
1651003335543,MATH 10A,A03,083737,Patchell; Gregory David,23,0,30,7
1651003341577,MATH 10B,A01,083207,Staff,0,9,30,30
1651003341577,MATH 10B,A02,083208,Staff,0,5,30,30
1651003341577,MATH 10B,B01,083739,Staff,8,0,30,22
1651003341577,MATH 10B,B02,083740,Staff,28,0,30,2
1651003347601,MATH 18,A01,083743,Staff,0,0,30,30
1651003347601,MATH 18,A02,083744,Staff,23,0,30,7
1651003347601,MATH 18,A03,083745,Staff,19,0,30,11
1651003347601,MATH 18,A04,083746,Staff,26,0,30,4
1651003347601,MATH 18,B01,083748,Staff,0,15,30,30
1651003347601,MATH 18,B02,083749,Staff,0,14,30,30
1651003347601,MATH 18,B03,083750,Staff,0,14,30,30
1651003347601,MATH 18,B04,083751,Staff,0,13,30,30
1651003353626,MATH 20A,A01,083754,Staff,19,0,40,21
1651003359656,MATH 20B,A01,083756,Staff,0,14,30,30
1651003359656,MATH 20B,A02,083757,Staff,0,11,30,30
1651003365687,MATH 20C,A01,083760,Staff,0,17,30,30
1651003365687,MATH 20C,A02,083761,Staff,0,15,30,30
1651003365687,MATH 20C,B01,083762,Staff,9,0,30,21
1651003365687,MATH 20C,B02,083763,Staff,28,0,30,2
1651003371712,MATH 20D,A01,083765,Staff,3,1,30,27
1651003371712,MATH 20D,A02,083766,Staff,2,0,30,28
1651003371712,MATH 20D,A03,083767,Staff,22,0,30,8
1651003377739,MATH 20E,A01,083771,Staff,1,0,30,29
1651003377739,MATH 20E,A02,083772,Staff,12,0,30,18
1651003377739,MATH 20E,B01,083773,Staff,0,0,30,30
1651003377739,MATH 20E,B02,083774,Staff,0,0,30,30
1651003383762,MATH 103A,A01,083777,Staff,0,17,30,30
1651003383762,MATH 103A,A02,083778,Staff,0,15,30,30
1651003383762,MATH 103A,B01,083779,Staff,0,15,30,30
1651003383762,MATH 103A,B02,083780,Staff,0,14,30,30
1651003389789,MATH 105,A01,085443,Staff,0,23,30,30
1651003395817,MATH 109,A01,083213,Anzaldo; Leesa B,0,7,30,30
1651003395817,MATH 109,A02,083214,Anzaldo; Leesa B,0,7,30,30
1651003395817,MATH 109,B01,083215,Anzaldo; Leesa B,0,8,30,30
1651003395817,MATH 109,B02,083216,Anzaldo; Leesa B,0,7,30,30
1651003401840,MATH 142A,A01,083219,Chow; Bennett,0,14,30,30
1651003401840,MATH 142A,A02,083220,Chow; Bennett,0,15,30,30
1651003401840,MATH 142A,B01,083221,Chow; Bennett,0,16,30,30
1651003401840,MATH 142A,B02,083222,Chow; Bennett,0,14,30,30
1651003407862,MATH 193A,A01,083224,Staff,0,6,30,30
1651003407862,MATH 193A,A02,083225,Staff,0,7,30,30
1651003407862,MATH 193A,A03,083781,Staff,0,7,30,30
1651003407862,MATH 193A,A04,083782,Staff,0,7,30,30
1651003413885,MATH 197,001,091859,McAuley; Julian John,9998,0,9999,1
1651003419936,COGS 9,A01,083615,Staff,0,19,60,60
1651003425962,COGS 11,A01,083617,Boyle; Mary E. T.,15,0,40,25
1651003431985,COGS 13,A01,083071,Staff,0,40,40,40
1651003438008,COGS 14A,A01,092681,Staff,0,40,100,100
1651003444035,COGS 14B,A01,083073,Cheng; Tzu-Han,0,13,50,50
1651003450058,COGS 17,A01,092677,Staff,6,0,75,69
1651003456092,COGS 100,A01,083619,Staff,0,30,60,60
1651003462116,COGS 101A,A01,083621,Davis; Joshua Daniel,0,30,60,60
1651003468147,COGS 101B,A01,091572,Staff,0,6,60,60
1651003474170,COGS 101C,A01,083625,Delgado; Tania,14,0,30,16
1651003480193,COGS 107A,A01,083627,Boyle; Mary E. T.,0,16,60,60
1651003486218,COGS 118A,A01,083075,Staff,0,10,60,60
1651003492331,CSE 3,A50,083646,Miranda; Gregory Joseph,15,0,38,23
1651003492331,CSE 3,A51,083647,Miranda; Gregory Joseph,36,0,37,1
1651003498363,CSE 8A,A50,083650,Miranda; Gregory Joseph,0,31,40,40
1651003504389,CSE 11,A01,083080,Cao; Yingjun,0,97,40,40
1651003510413,CSE 12,A01,083652,Staff,0,24,100,100
1651003516439,CSE 15L,A01,083654,Staff,0,3,50,50
1651003516439,CSE 15L,A02,083655,Staff,0,3,50,50
1651003522461,CSE 20,A01,083657,Staff,47,0,80,33
1651003528488,CSE 30,A01,083084,Eldon; John,1,38,80,79
1651003534514,CSE 100,A01,083659,Cao; Yingjun,0,72,50,50
1651003540544,CSE 134B,A01,083661,Powell; Thomas Allan,1,40,65,64
1651003546582,CSE 140,A01,083663,Staff,0,13,75,75
1651003552606,CSE 140L,A01,083088,Eldon; John,4,0,100,96
1651003558637,CSE 175,A01,083665,Kumar; Rakesh,0,0,25,25
1651003564659,CSE 190,A00,092507,Dubnov; Shlomo,9,0,20,11
1651003570693,ECE 45,A01,083139,Staff,0,7,60,60
1651003576721,ECE 65,A50,083695,Staff,0,7,30,30
1651003582751,ECE 109,A01,091882,Touri; Behrouz,32,0,70,38
1651003588782,ECE 180,A00,083140,Abi Samra; Nicholas Camill,17,0,30,13
1651003588782,ECE 180,B00,083141,Abi Samra; Nicholas Camill,0,0,30,30
1651003594806,MATH 10A,A01,083735,Patchell; Gregory David,1,0,30,29
1651003594806,MATH 10A,A02,083736,Patchell; Gregory David,27,0,30,3
1651003594806,MATH 10A,A03,083737,Patchell; Gregory David,23,0,30,7
1651003600830,MATH 10B,A01,083207,Staff,0,9,30,30
1651003600830,MATH 10B,A02,083208,Staff,0,5,30,30
1651003600830,MATH 10B,B01,083739,Staff,8,0,30,22
1651003600830,MATH 10B,B02,083740,Staff,28,0,30,2
1651003606855,MATH 18,A01,083743,Staff,0,0,30,30
1651003606855,MATH 18,A02,083744,Staff,23,0,30,7
1651003606855,MATH 18,A03,083745,Staff,19,0,30,11
1651003606855,MATH 18,A04,083746,Staff,26,0,30,4
1651003606855,MATH 18,B01,083748,Staff,0,15,30,30
1651003606855,MATH 18,B02,083749,Staff,0,14,30,30
1651003606855,MATH 18,B03,083750,Staff,0,14,30,30
1651003606855,MATH 18,B04,083751,Staff,0,13,30,30
1651003612879,MATH 20A,A01,083754,Staff,19,0,40,21
1651003618911,MATH 20B,A01,083756,Staff,0,14,30,30
1651003618911,MATH 20B,A02,083757,Staff,0,11,30,30
1651003624938,MATH 20C,A01,083760,Staff,0,17,30,30
1651003624938,MATH 20C,A02,083761,Staff,0,15,30,30
1651003624938,MATH 20C,B01,083762,Staff,9,0,30,21
1651003624938,MATH 20C,B02,083763,Staff,28,0,30,2
1651003630961,MATH 20D,A01,083765,Staff,3,1,30,27
1651003630961,MATH 20D,A02,083766,Staff,2,0,30,28
1651003630961,MATH 20D,A03,083767,Staff,22,0,30,8
1651003637011,MATH 20E,A01,083771,Staff,2,0,30,28
1651003637011,MATH 20E,A02,083772,Staff,12,0,30,18
1651003637011,MATH 20E,B01,083773,Staff,0,0,30,30
1651003637011,MATH 20E,B02,083774,Staff,0,0,30,30
1651003643048,MATH 103A,A01,083777,Staff,0,17,30,30
1651003643048,MATH 103A,A02,083778,Staff,0,15,30,30
1651003643048,MATH 103A,B01,083779,Staff,0,15,30,30
1651003643048,MATH 103A,B02,083780,Staff,0,14,30,30
1651003649073,MATH 105,A01,085443,Staff,0,23,30,30
1651003655100,MATH 109,A01,083213,Anzaldo; Leesa B,0,7,30,30
1651003655100,MATH 109,A02,083214,Anzaldo; Leesa B,0,7,30,30
1651003655100,MATH 109,B01,083215,Anzaldo; Leesa B,0,8,30,30
1651003655100,MATH 109,B02,083216,Anzaldo; Leesa B,0,7,30,30
1651003661128,MATH 142A,A01,083219,Chow; Bennett,0,14,30,30
1651003661128,MATH 142A,A02,083220,Chow; Bennett,0,15,30,30
1651003661128,MATH 142A,B01,083221,Chow; Bennett,0,16,30,30
1651003661128,MATH 142A,B02,083222,Chow; Bennett,0,14,30,30
1651003667159,MATH 193A,A01,083224,Staff,0,7,30,30
1651003667159,MATH 193A,A02,083225,Staff,0,7,30,30
1651003667159,MATH 193A,A03,083781,Staff,0,7,30,30
1651003667159,MATH 193A,A04,083782,Staff,0,7,30,30
1651003673185,MATH 197,001,091859,McAuley; Julian John,9998,0,9999,1
1651003679246,COGS 9,A01,083615,Staff,0,19,60,60
1651003685272,COGS 11,A01,083617,Boyle; Mary E. T.,15,0,40,25
1651003691295,COGS 13,A01,083071,Staff,0,40,40,40
1651003697319,COGS 14A,A01,092681,Staff,0,40,100,100
1651003703348,COGS 14B,A01,083073,Cheng; Tzu-Han,0,13,50,50
1651003709371,COGS 17,A01,092677,Staff,6,0,75,69
1651003715403,COGS 100,A01,083619,Staff,0,30,60,60
1651003721426,COGS 101A,A01,083621,Davis; Joshua Daniel,0,30,60,60
1651003727448,COGS 101B,A01,091572,Staff,0,6,60,60
1651003733476,COGS 101C,A01,083625,Delgado; Tania,14,0,30,16
1651003739515,COGS 107A,A01,083627,Boyle; Mary E. T.,0,16,60,60
1651003745540,COGS 118A,A01,083075,Staff,0,10,60,60
1651003751562,CSE 3,A50,083646,Miranda; Gregory Joseph,15,0,38,23
1651003751562,CSE 3,A51,083647,Miranda; Gregory Joseph,36,0,37,1
1651003757598,CSE 8A,A50,083650,Miranda; Gregory Joseph,0,31,40,40
1651003763626,CSE 11,A01,083080,Cao; Yingjun,0,97,40,40
1651003769657,CSE 12,A01,083652,Staff,0,24,100,100
1651003775691,CSE 15L,A01,083654,Staff,0,3,50,50
1651003775691,CSE 15L,A02,083655,Staff,0,3,50,50
1651003781713,CSE 20,A01,083657,Staff,47,0,80,33
1651003787739,CSE 30,A01,083084,Eldon; John,1,38,80,79
1651003793767,CSE 100,A01,083659,Cao; Yingjun,0,72,50,50
1651003799791,CSE 134B,A01,083661,Powell; Thomas Allan,1,40,65,64
1651003805817,CSE 140,A01,083663,Staff,0,13,75,75
1651003811841,CSE 140L,A01,083088,Eldon; John,4,0,100,96
1651003817864,CSE 175,A01,083665,Kumar; Rakesh,0,0,25,25
1651003823886,CSE 190,A00,092507,Dubnov; Shlomo,9,0,20,11
1651003829912,ECE 45,A01,083139,Staff,0,7,60,60
1651003835937,ECE 65,A50,083695,Staff,0,7,30,30
1651003841964,ECE 109,A01,091882,Touri; Behrouz,32,0,70,38
1651003847988,ECE 180,A00,083140,Abi Samra; Nicholas Camill,17,0,30,13
1651003847988,ECE 180,B00,083141,Abi Samra; Nicholas Camill,0,0,30,30
1651003854012,MATH 10A,A01,083735,Patchell; Gregory David,1,0,30,29
1651003854012,MATH 10A,A02,083736,Patchell; Gregory David,27,0,30,3
1651003854012,MATH 10A,A03,083737,Patchell; Gregory David,23,0,30,7
1651003860039,MATH 10B,A01,083207,Staff,0,9,30,30
1651003860039,MATH 10B,A02,083208,Staff,0,5,30,30
1651003860039,MATH 10B,B01,083739,Staff,8,0,30,22
1651003860039,MATH 10B,B02,083740,Staff,28,0,30,2
1651003866071,MATH 18,A01,083743,Staff,0,0,30,30
1651003866071,MATH 18,A02,083744,Staff,23,0,30,7
1651003866071,MATH 18,A03,083745,Staff,19,0,30,11
1651003866071,MATH 18,A04,083746,Staff,26,0,30,4
1651003866071,MATH 18,B01,083748,Staff,0,15,30,30
1651003866071,MATH 18,B02,083749,Staff,0,14,30,30
1651003866071,MATH 18,B03,083750,Staff,0,14,30,30
1651003866071,MATH 18,B04,083751,Staff,0,13,30,30
1651003872092,MATH 20A,A01,083754,Staff,19,0,40,21
1651003878126,MATH 20B,A01,083756,Staff,0,14,30,30
1651003878126,MATH 20B,A02,083757,Staff,0,11,30,30
1651003884153,MATH 20C,A01,083760,Staff,0,17,30,30
1651003884153,MATH 20C,A02,083761,Staff,0,15,30,30
1651003884153,MATH 20C,B01,083762,Staff,9,0,30,21
1651003884153,MATH 20C,B02,083763,Staff,28,0,30,2
1651003890183,MATH 20D,A01,083765,Staff,3,1,30,27
1651003890183,MATH 20D,A02,083766,Staff,2,0,30,28
1651003890183,MATH 20D,A03,083767,Staff,22,0,30,8
1651003896207,MATH 20E,A01,083771,Staff,2,0,30,28
1651003896207,MATH 20E,A02,083772,Staff,12,0,30,18
1651003896207,MATH 20E,B01,083773,Staff,0,0,30,30
1651003896207,MATH 20E,B02,083774,Staff,0,0,30,30
1651003902236,MATH 103A,A01,083777,Staff,0,17,30,30
1651003902236,MATH 103A,A02,083778,Staff,0,15,30,30
1651003902236,MATH 103A,B01,083779,Staff,0,15,30,30
1651003902236,MATH 103A,B02,083780,Staff,0,14,30,30
1651003908265,MATH 105,A01,085443,Staff,0,23,30,30
1651003914306,MATH 109,A01,083213,Anzaldo; Leesa B,0,7,30,30
1651003914306,MATH 109,A02,083214,Anzaldo; Leesa B,0,7,30,30
1651003914306,MATH 109,B01,083215,Anzaldo; Leesa B,0,8,30,30
1651003914306,MATH 109,B02,083216,Anzaldo; Leesa B,0,7,30,30
1651003920333,MATH 142A,A01,083219,Chow; Bennett,0,14,30,30
1651003920333,MATH 142A,A02,083220,Chow; Bennett,0,15,30,30
1651003920333,MATH 142A,B01,083221,Chow; Bennett,0,16,30,30
1651003920333,MATH 142A,B02,083222,Chow; Bennett,0,14,30,30
1651003926360,MATH 193A,A01,083224,Staff,0,7,30,30
1651003926360,MATH 193A,A02,083225,Staff,0,7,30,30
1651003926360,MATH 193A,A03,083781,Staff,0,7,30,30
1651003926360,MATH 193A,A04,083782,Staff,0,7,30,30
1651003932383,MATH 197,001,091859,McAuley; Julian John,9998,0,9999,1
1651003938435,COGS 9,A01,083615,Staff,0,19,60,60
1651003944459,COGS 11,A01,083617,Boyle; Mary E. T.,15,0,40,25
1651003950491,COGS 13,A01,083071,Staff,0,40,40,40
1651003956527,COGS 14A,A01,092681,Staff,0,40,100,100
1651003962551,COGS 14B,A01,083073,Cheng; Tzu-Han,0,13,50,50
1651003968608,COGS 17,A01,092677,Staff,6,0,75,69
1651003974642,COGS 100,A01,083619,Staff,0,30,60,60
1651003980666,COGS 101A,A01,083621,Davis; Joshua Daniel,0,30,60,60
1651003986698,COGS 101B,A01,091572,Staff,0,6,60,60
1651003992727,COGS 101C,A01,083625,Delgado; Tania,14,0,30,16
1651003998751,COGS 107A,A01,083627,Boyle; Mary E. T.,0,16,60,60
1651004004775,COGS 118A,A01,083075,Staff,0,10,60,60
1651004010802,CSE 3,A50,083646,Miranda; Gregory Joseph,15,0,38,23
1651004010802,CSE 3,A51,083647,Miranda; Gregory Joseph,36,0,37,1
1651004016827,CSE 8A,A50,083650,Miranda; Gregory Joseph,0,31,40,40
1651004022853,CSE 11,A01,083080,Cao; Yingjun,0,97,40,40
1651004028880,CSE 12,A01,083652,Staff,0,24,100,100
1651004034903,CSE 15L,A01,083654,Staff,0,3,50,50
1651004034903,CSE 15L,A02,083655,Staff,0,3,50,50
1651004040926,CSE 20,A01,083657,Staff,47,0,80,33
1651004046956,CSE 30,A01,083084,Eldon; John,1,38,80,79
1651004052985,CSE 100,A01,083659,Cao; Yingjun,0,72,50,50
1651004059010,CSE 134B,A01,083661,Powell; Thomas Allan,1,40,65,64
1651004065033,CSE 140,A01,083663,Staff,0,13,75,75
1651004071057,CSE 140L,A01,083088,Eldon; John,4,0,100,96
1651004077081,CSE 175,A01,083665,Kumar; Rakesh,0,0,25,25
1651004083107,CSE 190,A00,092507,Dubnov; Shlomo,9,0,20,11
1651004089219,ECE 45,A01,083139,Staff,0,7,60,60
1651004095241,ECE 65,A50,083695,Staff,0,7,30,30
1651004101272,ECE 109,A01,091882,Touri; Behrouz,32,0,70,38
1651004107298,ECE 180,A00,083140,Abi Samra; Nicholas Camill,17,0,30,13
1651004107298,ECE 180,B00,083141,Abi Samra; Nicholas Camill,0,0,30,30
1651004113321,MATH 10A,A01,083735,Patchell; Gregory David,1,0,30,29
1651004113321,MATH 10A,A02,083736,Patchell; Gregory David,27,0,30,3
1651004113321,MATH 10A,A03,083737,Patchell; Gregory David,23,0,30,7
1651004119348,MATH 10B,A01,083207,Staff,0,9,30,30
1651004119348,MATH 10B,A02,083208,Staff,0,5,30,30
1651004119348,MATH 10B,B01,083739,Staff,8,0,30,22
1651004119348,MATH 10B,B02,083740,Staff,28,0,30,2
1651004125377,MATH 18,A01,083743,Staff,0,0,30,30
1651004125377,MATH 18,A02,083744,Staff,23,0,30,7
1651004125377,MATH 18,A03,083745,Staff,19,0,30,11
1651004125377,MATH 18,A04,083746,Staff,26,0,30,4
1651004125377,MATH 18,B01,083748,Staff,0,15,30,30
1651004125377,MATH 18,B02,083749,Staff,0,14,30,30
1651004125377,MATH 18,B03,083750,Staff,0,14,30,30
1651004125377,MATH 18,B04,083751,Staff,0,13,30,30
1651004131399,MATH 20A,A01,083754,Staff,19,0,40,21
1651004137420,MATH 20B,A01,083756,Staff,0,14,30,30
1651004137420,MATH 20B,A02,083757,Staff,0,11,30,30
1651004143442,MATH 20C,A01,083760,Staff,0,17,30,30
1651004143442,MATH 20C,A02,083761,Staff,0,15,30,30
1651004143442,MATH 20C,B01,083762,Staff,9,0,30,21
1651004143442,MATH 20C,B02,083763,Staff,28,0,30,2
1651004149468,MATH 20D,A01,083765,Staff,3,1,30,27
1651004149468,MATH 20D,A02,083766,Staff,2,0,30,28
1651004149468,MATH 20D,A03,083767,Staff,22,0,30,8
1651004155492,MATH 20E,A01,083771,Staff,2,0,30,28
1651004155492,MATH 20E,A02,083772,Staff,12,0,30,18
1651004155492,MATH 20E,B01,083773,Staff,0,0,30,30
1651004155492,MATH 20E,B02,083774,Staff,0,0,30,30
1651004161519,MATH 103A,A01,083777,Staff,0,17,30,30
1651004161519,MATH 103A,A02,083778,Staff,0,15,30,30
1651004161519,MATH 103A,B01,083779,Staff,0,15,30,30
1651004161519,MATH 103A,B02,083780,Staff,0,14,30,30
1651004167553,MATH 105,A01,085443,Staff,0,23,30,30
1651004173576,MATH 109,A01,083213,Anzaldo; Leesa B,0,7,30,30
1651004173576,MATH 109,A02,083214,Anzaldo; Leesa B,0,7,30,30
1651004173576,MATH 109,B01,083215,Anzaldo; Leesa B,0,8,30,30
1651004173576,MATH 109,B02,083216,Anzaldo; Leesa B,0,7,30,30
1651004179604,MATH 142A,A01,083219,Chow; Bennett,0,14,30,30
1651004179604,MATH 142A,A02,083220,Chow; Bennett,0,15,30,30
1651004179604,MATH 142A,B01,083221,Chow; Bennett,0,16,30,30
1651004179604,MATH 142A,B02,083222,Chow; Bennett,0,14,30,30
1651004185628,MATH 193A,A01,083224,Staff,0,7,30,30
1651004185628,MATH 193A,A02,083225,Staff,0,7,30,30
1651004185628,MATH 193A,A03,083781,Staff,0,7,30,30
1651004185628,MATH 193A,A04,083782,Staff,0,7,30,30
1651004191650,MATH 197,001,091859,McAuley; Julian John,9998,0,9999,1
1651004197707,COGS 9,A01,083615,Staff,0,19,60,60
1651004203729,COGS 11,A01,083617,Boyle; Mary E. T.,15,0,40,25
1651004209755,COGS 13,A01,083071,Staff,0,40,40,40
1651004215782,COGS 14A,A01,092681,Staff,0,40,100,100
1651004221805,COGS 14B,A01,083073,Cheng; Tzu-Han,0,13,50,50
1651004227840,COGS 17,A01,092677,Staff,7,0,75,68
1651004233863,COGS 100,A01,083619,Staff,0,30,60,60
1651004239893,COGS 101A,A01,083621,Davis; Joshua Daniel,0,30,60,60
1651004245914,COGS 101B,A01,091572,Staff,0,6,60,60
1651004251940,COGS 101C,A01,083625,Delgado; Tania,14,0,30,16
1651004257964,COGS 107A,A01,083627,Boyle; Mary E. T.,0,16,60,60
1651004263990,COGS 118A,A01,083075,Staff,0,10,60,60
1651004270022,CSE 3,A50,083646,Miranda; Gregory Joseph,15,0,38,23
1651004270022,CSE 3,A51,083647,Miranda; Gregory Joseph,36,0,37,1
1651004276051,CSE 8A,A50,083650,Miranda; Gregory Joseph,0,31,40,40
1651004282081,CSE 11,A01,083080,Cao; Yingjun,0,97,40,40
1651004288107,CSE 12,A01,083652,Staff,0,24,100,100
1651004294130,CSE 15L,A01,083654,Staff,0,3,50,50
1651004294130,CSE 15L,A02,083655,Staff,0,3,50,50
1651004300155,CSE 20,A01,083657,Staff,47,0,80,33
1651004306177,CSE 30,A01,083084,Eldon; John,1,38,80,79
1651004312200,CSE 100,A01,083659,Cao; Yingjun,0,72,50,50
1651004318223,CSE 134B,A01,083661,Powell; Thomas Allan,1,40,65,64
1651004324245,CSE 140,A01,083663,Staff,0,13,75,75
1651004330271,CSE 140L,A01,083088,Eldon; John,4,0,100,96
1651004336294,CSE 175,A01,083665,Kumar; Rakesh,0,0,25,25
1651004342325,CSE 190,A00,092507,Dubnov; Shlomo,9,0,20,11
1651004348363,ECE 45,A01,083139,Staff,0,7,60,60
1651004354390,ECE 65,A50,083695,Staff,0,7,30,30
1651004360420,ECE 109,A01,091882,Touri; Behrouz,32,0,70,38
1651004366466,ECE 180,A00,083140,Abi Samra; Nicholas Camill,17,0,30,13
1651004366466,ECE 180,B00,083141,Abi Samra; Nicholas Camill,0,0,30,30
1651004372490,MATH 10A,A01,083735,Patchell; Gregory David,1,0,30,29
1651004372490,MATH 10A,A02,083736,Patchell; Gregory David,27,0,30,3
1651004372490,MATH 10A,A03,083737,Patchell; Gregory David,23,0,30,7
1651004378513,MATH 10B,A01,083207,Staff,0,9,30,30
1651004378513,MATH 10B,A02,083208,Staff,0,5,30,30
1651004378513,MATH 10B,B01,083739,Staff,8,0,30,22
1651004378513,MATH 10B,B02,083740,Staff,28,0,30,2
1651004384540,MATH 18,A01,083743,Staff,0,0,30,30
1651004384540,MATH 18,A02,083744,Staff,23,0,30,7
1651004384540,MATH 18,A03,083745,Staff,19,0,30,11
1651004384540,MATH 18,A04,083746,Staff,26,0,30,4
1651004384540,MATH 18,B01,083748,Staff,0,15,30,30
1651004384540,MATH 18,B02,083749,Staff,0,14,30,30
1651004384540,MATH 18,B03,083750,Staff,0,14,30,30
1651004384540,MATH 18,B04,083751,Staff,0,13,30,30
1651004390576,MATH 20A,A01,083754,Staff,19,0,40,21
1651004396604,MATH 20B,A01,083756,Staff,0,14,30,30
1651004396604,MATH 20B,A02,083757,Staff,0,11,30,30
1651004402636,MATH 20C,A01,083760,Staff,0,17,30,30
1651004402636,MATH 20C,A02,083761,Staff,0,15,30,30
1651004402636,MATH 20C,B01,083762,Staff,9,0,30,21
1651004402636,MATH 20C,B02,083763,Staff,28,0,30,2
1651004408662,MATH 20D,A01,083765,Staff,3,1,30,27
1651004408662,MATH 20D,A02,083766,Staff,2,0,30,28
1651004408662,MATH 20D,A03,083767,Staff,22,0,30,8
1651004414686,MATH 20E,A01,083771,Staff,2,0,30,28
1651004414686,MATH 20E,A02,083772,Staff,12,0,30,18
1651004414686,MATH 20E,B01,083773,Staff,0,0,30,30
1651004414686,MATH 20E,B02,083774,Staff,0,0,30,30
1651004420714,MATH 103A,A01,083777,Staff,0,17,30,30
1651004420714,MATH 103A,A02,083778,Staff,0,15,30,30
1651004420714,MATH 103A,B01,083779,Staff,0,15,30,30
1651004420714,MATH 103A,B02,083780,Staff,0,14,30,30
1651004426743,MATH 105,A01,085443,Staff,0,23,30,30
1651004432766,MATH 109,A01,083213,Anzaldo; Leesa B,0,7,30,30
1651004432766,MATH 109,A02,083214,Anzaldo; Leesa B,0,7,30,30
1651004432766,MATH 109,B01,083215,Anzaldo; Leesa B,0,8,30,30
1651004432766,MATH 109,B02,083216,Anzaldo; Leesa B,0,7,30,30
1651004438797,MATH 142A,A01,083219,Chow; Bennett,0,14,30,30
1651004438797,MATH 142A,A02,083220,Chow; Bennett,0,15,30,30
1651004438797,MATH 142A,B01,083221,Chow; Bennett,0,16,30,30
1651004438797,MATH 142A,B02,083222,Chow; Bennett,0,14,30,30
1651004444823,MATH 193A,A01,083224,Staff,0,7,30,30
1651004444823,MATH 193A,A02,083225,Staff,0,7,30,30
1651004444823,MATH 193A,A03,083781,Staff,0,7,30,30
1651004444823,MATH 193A,A04,083782,Staff,0,7,30,30
1651004450845,MATH 197,001,091859,McAuley; Julian John,9998,0,9999,1
1651004456910,COGS 9,A01,083615,Staff,0,19,60,60
1651004462942,COGS 11,A01,083617,Boyle; Mary E. T.,15,0,40,25
1651004468969,COGS 13,A01,083071,Staff,0,40,40,40
1651004474991,COGS 14A,A01,092681,Staff,0,40,100,100
1651004481015,COGS 14B,A01,083073,Cheng; Tzu-Han,0,13,50,50
1651004487044,COGS 17,A01,092677,Staff,7,0,75,68
1651004493081,COGS 100,A01,083619,Staff,0,30,60,60
1651004499108,COGS 101A,A01,083621,Davis; Joshua Daniel,0,30,60,60
1651004505130,COGS 101B,A01,091572,Staff,0,6,60,60
1651004511159,COGS 101C,A01,083625,Delgado; Tania,14,0,30,16
1651004517182,COGS 107A,A01,083627,Boyle; Mary E. T.,0,16,60,60
1651004523216,COGS 118A,A01,083075,Staff,0,10,60,60
1651004529243,CSE 3,A50,083646,Miranda; Gregory Joseph,15,0,38,23
1651004529243,CSE 3,A51,083647,Miranda; Gregory Joseph,36,0,37,1
1651004535282,CSE 8A,A50,083650,Miranda; Gregory Joseph,0,31,40,40
1651004541313,CSE 11,A01,083080,Cao; Yingjun,0,97,40,40
1651004547337,CSE 12,A01,083652,Staff,0,24,100,100
1651004553362,CSE 15L,A01,083654,Staff,0,3,50,50
1651004553362,CSE 15L,A02,083655,Staff,0,3,50,50
1651004559389,CSE 20,A01,083657,Staff,47,0,80,33
1651004565430,CSE 30,A01,083084,Eldon; John,1,38,80,79
1651004571454,CSE 100,A01,083659,Cao; Yingjun,0,72,50,50
1651004577480,CSE 134B,A01,083661,Powell; Thomas Allan,1,40,65,64
1651004583516,CSE 140,A01,083663,Staff,0,13,75,75
1651004589539,CSE 140L,A01,083088,Eldon; John,4,0,100,96
1651004595562,CSE 175,A01,083665,Kumar; Rakesh,0,0,25,25
1651004601595,CSE 190,A00,092507,Dubnov; Shlomo,9,0,20,11
1651004607618,ECE 45,A01,083139,Staff,0,7,60,60
1651004613641,ECE 65,A50,083695,Staff,0,7,30,30
1651004619668,ECE 109,A01,091882,Touri; Behrouz,32,0,70,38
1651004625698,ECE 180,A00,083140,Abi Samra; Nicholas Camill,17,0,30,13
1651004625698,ECE 180,B00,083141,Abi Samra; Nicholas Camill,0,0,30,30
1651004631720,MATH 10A,A01,083735,Patchell; Gregory David,1,0,30,29
1651004631720,MATH 10A,A02,083736,Patchell; Gregory David,27,0,30,3
1651004631720,MATH 10A,A03,083737,Patchell; Gregory David,23,0,30,7
1651004637746,MATH 10B,A01,083207,Staff,0,9,30,30
1651004637746,MATH 10B,A02,083208,Staff,0,5,30,30
1651004637746,MATH 10B,B01,083739,Staff,8,0,30,22
1651004637746,MATH 10B,B02,083740,Staff,28,0,30,2
1651004643769,MATH 18,A01,083743,Staff,0,0,30,30
1651004643769,MATH 18,A02,083744,Staff,23,0,30,7
1651004643769,MATH 18,A03,083745,Staff,19,0,30,11
1651004643769,MATH 18,A04,083746,Staff,26,0,30,4
1651004643769,MATH 18,B01,083748,Staff,0,16,30,30
1651004643769,MATH 18,B02,083749,Staff,0,14,30,30
1651004643769,MATH 18,B03,083750,Staff,0,14,30,30
1651004643769,MATH 18,B04,083751,Staff,0,13,30,30
1651004649794,MATH 20A,A01,083754,Staff,19,0,40,21
1651004655819,MATH 20B,A01,083756,Staff,0,14,30,30
1651004655819,MATH 20B,A02,083757,Staff,0,11,30,30
1651004661841,MATH 20C,A01,083760,Staff,0,17,30,30
1651004661841,MATH 20C,A02,083761,Staff,0,15,30,30
1651004661841,MATH 20C,B01,083762,Staff,9,0,30,21
1651004661841,MATH 20C,B02,083763,Staff,28,0,30,2
1651004667865,MATH 20D,A01,083765,Staff,3,1,30,27
1651004667865,MATH 20D,A02,083766,Staff,2,0,30,28
1651004667865,MATH 20D,A03,083767,Staff,22,0,30,8
1651004673897,MATH 20E,A01,083771,Staff,2,0,30,28
1651004673897,MATH 20E,A02,083772,Staff,12,0,30,18
1651004673897,MATH 20E,B01,083773,Staff,0,0,30,30
1651004673897,MATH 20E,B02,083774,Staff,0,0,30,30
1651004679921,MATH 103A,A01,083777,Staff,0,17,30,30
1651004679921,MATH 103A,A02,083778,Staff,0,15,30,30
1651004679921,MATH 103A,B01,083779,Staff,0,15,30,30
1651004679921,MATH 103A,B02,083780,Staff,0,14,30,30
1651004686034,MATH 105,A01,085443,Staff,0,23,30,30
1651004692066,MATH 109,A01,083213,Anzaldo; Leesa B,0,7,30,30
1651004692066,MATH 109,A02,083214,Anzaldo; Leesa B,0,7,30,30
1651004692066,MATH 109,B01,083215,Anzaldo; Leesa B,0,8,30,30
1651004692066,MATH 109,B02,083216,Anzaldo; Leesa B,0,7,30,30
1651004698090,MATH 142A,A01,083219,Chow; Bennett,0,14,30,30
1651004698090,MATH 142A,A02,083220,Chow; Bennett,0,15,30,30
1651004698090,MATH 142A,B01,083221,Chow; Bennett,0,16,30,30
1651004698090,MATH 142A,B02,083222,Chow; Bennett,0,14,30,30
1651004704136,MATH 193A,A01,083224,Staff,0,7,30,30
1651004704136,MATH 193A,A02,083225,Staff,0,7,30,30
1651004704136,MATH 193A,A03,083781,Staff,0,7,30,30
1651004704136,MATH 193A,A04,083782,Staff,0,7,30,30
1651004710161,MATH 197,001,091859,McAuley; Julian John,9998,0,9999,1
1651004716216,COGS 9,A01,083615,Staff,0,19,60,60
1651004722242,COGS 11,A01,083617,Boyle; Mary E. T.,15,0,40,25
1651004728275,COGS 13,A01,083071,Staff,0,40,40,40
1651004734301,COGS 14A,A01,092681,Staff,0,40,100,100
1651004740326,COGS 14B,A01,083073,Cheng; Tzu-Han,0,13,50,50
1651004746351,COGS 17,A01,092677,Staff,7,0,75,68
1651004752374,COGS 100,A01,083619,Staff,0,30,60,60
1651004758400,COGS 101A,A01,083621,Davis; Joshua Daniel,0,30,60,60
1651004764426,COGS 101B,A01,091572,Staff,0,6,60,60
1651004770448,COGS 101C,A01,083625,Delgado; Tania,14,0,30,16
1651004776474,COGS 107A,A01,083627,Boyle; Mary E. T.,0,16,60,60
1651004782503,COGS 118A,A01,083075,Staff,0,10,60,60
1651004788536,CSE 3,A50,083646,Miranda; Gregory Joseph,15,0,38,23
1651004788536,CSE 3,A51,083647,Miranda; Gregory Joseph,36,0,37,1
1651004794579,CSE 8A,A50,083650,Miranda; Gregory Joseph,0,31,40,40
1651004800605,CSE 11,A01,083080,Cao; Yingjun,0,97,40,40
1651004806630,CSE 12,A01,083652,Staff,0,24,100,100
1651004812654,CSE 15L,A01,083654,Staff,0,3,50,50
1651004812654,CSE 15L,A02,083655,Staff,0,3,50,50
1651004818678,CSE 20,A01,083657,Staff,47,0,80,33
1651004824702,CSE 30,A01,083084,Eldon; John,1,38,80,79
1651004830727,CSE 100,A01,083659,Cao; Yingjun,0,72,50,50
1651004836755,CSE 134B,A01,083661,Powell; Thomas Allan,1,40,65,64
1651004842779,CSE 140,A01,083663,Staff,0,13,75,75
1651004848817,CSE 140L,A01,083088,Eldon; John,4,0,100,96
1651004854840,CSE 175,A01,083665,Kumar; Rakesh,0,0,25,25
1651004860866,CSE 190,A00,092507,Dubnov; Shlomo,9,0,20,11
1651004866892,ECE 45,A01,083139,Staff,0,7,60,60
1651004872914,ECE 65,A50,083695,Staff,0,7,30,30
1651004878940,ECE 109,A01,091882,Touri; Behrouz,32,0,70,38
1651004884962,ECE 180,A00,083140,Abi Samra; Nicholas Camill,17,0,30,13
1651004884962,ECE 180,B00,083141,Abi Samra; Nicholas Camill,0,0,30,30
1651004890996,MATH 10A,A01,083735,Patchell; Gregory David,1,0,30,29
1651004890996,MATH 10A,A02,083736,Patchell; Gregory David,27,0,30,3
1651004890996,MATH 10A,A03,083737,Patchell; Gregory David,23,0,30,7
1651004897019,MATH 10B,A01,083207,Staff,0,9,30,30
1651004897019,MATH 10B,A02,083208,Staff,0,5,30,30
1651004897019,MATH 10B,B01,083739,Staff,8,0,30,22
1651004897019,MATH 10B,B02,083740,Staff,28,0,30,2
1651004903049,MATH 18,A01,083743,Staff,0,0,30,30
1651004903049,MATH 18,A02,083744,Staff,23,0,30,7
1651004903049,MATH 18,A03,083745,Staff,19,0,30,11
1651004903049,MATH 18,A04,083746,Staff,26,0,30,4
1651004903049,MATH 18,B01,083748,Staff,0,16,30,30
1651004903049,MATH 18,B02,083749,Staff,0,14,30,30
1651004903049,MATH 18,B03,083750,Staff,0,14,30,30
1651004903049,MATH 18,B04,083751,Staff,0,13,30,30
1651004909071,MATH 20A,A01,083754,Staff,19,0,40,21
1651004915095,MATH 20B,A01,083756,Staff,0,14,30,30
1651004915095,MATH 20B,A02,083757,Staff,0,11,30,30
1651004921117,MATH 20C,A01,083760,Staff,0,17,30,30
1651004921117,MATH 20C,A02,083761,Staff,0,15,30,30
1651004921117,MATH 20C,B01,083762,Staff,9,0,30,21
1651004921117,MATH 20C,B02,083763,Staff,28,0,30,2
1651004927145,MATH 20D,A01,083765,Staff,3,1,30,27
1651004927145,MATH 20D,A02,083766,Staff,2,0,30,28
1651004927145,MATH 20D,A03,083767,Staff,22,0,30,8
1651004933171,MATH 20E,A01,083771,Staff,2,0,30,28
1651004933171,MATH 20E,A02,083772,Staff,12,0,30,18
1651004933171,MATH 20E,B01,083773,Staff,0,0,30,30
1651004933171,MATH 20E,B02,083774,Staff,0,0,30,30
1651004939195,MATH 103A,A01,083777,Staff,0,17,30,30
1651004939195,MATH 103A,A02,083778,Staff,0,15,30,30
1651004939195,MATH 103A,B01,083779,Staff,0,15,30,30
1651004939195,MATH 103A,B02,083780,Staff,0,14,30,30
1651004945223,MATH 105,A01,085443,Staff,0,23,30,30
1651004951248,MATH 109,A01,083213,Anzaldo; Leesa B,0,7,30,30
1651004951248,MATH 109,A02,083214,Anzaldo; Leesa B,0,7,30,30
1651004951248,MATH 109,B01,083215,Anzaldo; Leesa B,0,8,30,30
1651004951248,MATH 109,B02,083216,Anzaldo; Leesa B,0,7,30,30
1651004957274,MATH 142A,A01,083219,Chow; Bennett,0,14,30,30
1651004957274,MATH 142A,A02,083220,Chow; Bennett,0,15,30,30
1651004957274,MATH 142A,B01,083221,Chow; Bennett,0,16,30,30
1651004957274,MATH 142A,B02,083222,Chow; Bennett,0,14,30,30
1651004963303,MATH 193A,A01,083224,Staff,0,7,30,30
1651004963303,MATH 193A,A02,083225,Staff,0,7,30,30
1651004963303,MATH 193A,A03,083781,Staff,0,7,30,30
1651004963303,MATH 193A,A04,083782,Staff,0,7,30,30
1651004969332,MATH 197,001,091859,McAuley; Julian John,9998,0,9999,1
1651004975387,COGS 9,A01,083615,Staff,0,19,60,60
1651004981412,COGS 11,A01,083617,Boyle; Mary E. T.,15,0,40,25
1651004987436,COGS 13,A01,083071,Staff,0,40,40,40
1651004993463,COGS 14A,A01,092681,Staff,0,40,100,100
1651004999495,COGS 14B,A01,083073,Cheng; Tzu-Han,0,13,50,50
1651005005518,COGS 17,A01,092677,Staff,7,0,75,68
1651005011539,COGS 100,A01,083619,Staff,0,30,60,60
1651005017565,COGS 101A,A01,083621,Davis; Joshua Daniel,0,30,60,60
1651005023586,COGS 101B,A01,091572,Staff,0,6,60,60
1651005029617,COGS 101C,A01,083625,Delgado; Tania,14,0,30,16
1651005035642,COGS 107A,A01,083627,Boyle; Mary E. T.,0,16,60,60
1651005041664,COGS 118A,A01,083075,Staff,0,10,60,60
1651005047695,CSE 3,A50,083646,Miranda; Gregory Joseph,15,0,38,23
1651005047695,CSE 3,A51,083647,Miranda; Gregory Joseph,36,0,37,1
1651005053812,CSE 8A,A50,083650,Miranda; Gregory Joseph,0,31,40,40
1651005059835,CSE 11,A01,083080,Cao; Yingjun,0,97,40,40
1651005065858,CSE 12,A01,083652,Staff,0,24,100,100
1651005071880,CSE 15L,A01,083654,Staff,0,3,50,50
1651005071880,CSE 15L,A02,083655,Staff,0,3,50,50
1651005077903,CSE 20,A01,083657,Staff,47,0,80,33
1651005083934,CSE 30,A01,083084,Eldon; John,1,38,80,79
1651005089955,CSE 100,A01,083659,Cao; Yingjun,0,72,50,50
1651005095977,CSE 134B,A01,083661,Powell; Thomas Allan,1,40,65,64
1651005102013,CSE 140,A01,083663,Staff,0,13,75,75
1651005108044,CSE 140L,A01,083088,Eldon; John,4,0,100,96
1651005114067,CSE 175,A01,083665,Kumar; Rakesh,0,0,25,25
1651005120105,CSE 190,A00,092507,Dubnov; Shlomo,9,0,20,11
1651005126133,ECE 45,A01,083139,Staff,0,7,60,60
1651005132162,ECE 65,A50,083695,Staff,0,7,30,30
1651005138187,ECE 109,A01,091882,Touri; Behrouz,32,0,70,38
1651005144215,ECE 180,A00,083140,Abi Samra; Nicholas Camill,17,0,30,13
1651005144215,ECE 180,B00,083141,Abi Samra; Nicholas Camill,0,0,30,30
1651005150240,MATH 10A,A01,083735,Patchell; Gregory David,1,0,30,29
1651005150240,MATH 10A,A02,083736,Patchell; Gregory David,27,0,30,3
1651005150240,MATH 10A,A03,083737,Patchell; Gregory David,23,0,30,7
1651005156270,MATH 10B,A01,083207,Staff,0,9,30,30
1651005156270,MATH 10B,A02,083208,Staff,0,5,30,30
1651005156270,MATH 10B,B01,083739,Staff,8,0,30,22
1651005156270,MATH 10B,B02,083740,Staff,28,0,30,2
1651005162332,MATH 18,A01,083743,Staff,0,0,30,30
1651005162332,MATH 18,A02,083744,Staff,23,0,30,7
1651005162332,MATH 18,A03,083745,Staff,19,0,30,11
1651005162332,MATH 18,A04,083746,Staff,26,0,30,4
1651005162332,MATH 18,B01,083748,Staff,0,16,30,30
1651005162332,MATH 18,B02,083749,Staff,0,14,30,30
1651005162332,MATH 18,B03,083750,Staff,0,14,30,30
1651005162332,MATH 18,B04,083751,Staff,0,13,30,30
1651005168362,MATH 20A,A01,083754,Staff,19,0,40,21
1651005174385,MATH 20B,A01,083756,Staff,0,14,30,30
1651005174385,MATH 20B,A02,083757,Staff,0,11,30,30
1651005180410,MATH 20C,A01,083760,Staff,0,17,30,30
1651005180410,MATH 20C,A02,083761,Staff,0,15,30,30
1651005180410,MATH 20C,B01,083762,Staff,9,0,30,21
1651005180410,MATH 20C,B02,083763,Staff,28,0,30,2
1651005186434,MATH 20D,A01,083765,Staff,3,1,30,27
1651005186434,MATH 20D,A02,083766,Staff,2,0,30,28
1651005186434,MATH 20D,A03,083767,Staff,22,0,30,8
1651005192459,MATH 20E,A01,083771,Staff,2,0,30,28
1651005192459,MATH 20E,A02,083772,Staff,12,0,30,18
1651005192459,MATH 20E,B01,083773,Staff,0,0,30,30
1651005192459,MATH 20E,B02,083774,Staff,0,0,30,30
1651005198484,MATH 103A,A01,083777,Staff,0,17,30,30
1651005198484,MATH 103A,A02,083778,Staff,0,15,30,30
1651005198484,MATH 103A,B01,083779,Staff,0,15,30,30
1651005198484,MATH 103A,B02,083780,Staff,0,14,30,30
1651005204506,MATH 105,A01,085443,Staff,0,23,30,30
1651005210532,MATH 109,A01,083213,Anzaldo; Leesa B,0,7,30,30
1651005210532,MATH 109,A02,083214,Anzaldo; Leesa B,0,7,30,30
1651005210532,MATH 109,B01,083215,Anzaldo; Leesa B,0,8,30,30
1651005210532,MATH 109,B02,083216,Anzaldo; Leesa B,0,7,30,30
1651005216554,MATH 142A,A01,083219,Chow; Bennett,0,14,30,30
1651005216554,MATH 142A,A02,083220,Chow; Bennett,0,15,30,30
1651005216554,MATH 142A,B01,083221,Chow; Bennett,0,16,30,30
1651005216554,MATH 142A,B02,083222,Chow; Bennett,0,14,30,30
1651005222591,MATH 193A,A01,083224,Staff,0,7,30,30
1651005222591,MATH 193A,A02,083225,Staff,0,7,30,30
1651005222591,MATH 193A,A03,083781,Staff,0,7,30,30
1651005222591,MATH 193A,A04,083782,Staff,0,7,30,30
1651005228613,MATH 197,001,091859,McAuley; Julian John,9998,0,9999,1
1651005234670,COGS 9,A01,083615,Staff,0,19,60,60
1651005240710,COGS 11,A01,083617,Boyle; Mary E. T.,15,0,40,25
1651005246736,COGS 13,A01,083071,Staff,0,40,40,40
1651005252764,COGS 14A,A01,092681,Staff,0,40,100,100
1651005258800,COGS 14B,A01,083073,Cheng; Tzu-Han,0,13,50,50
1651005264822,COGS 17,A01,092677,Staff,7,0,75,68
1651005270862,COGS 100,A01,083619,Staff,0,30,60,60
1651005276959,COGS 101A,A01,083621,Davis; Joshua Daniel,0,30,60,60
1651005282991,COGS 101B,A01,091572,Staff,0,6,60,60
1651005289017,COGS 101C,A01,083625,Delgado; Tania,14,0,30,16
1651005295069,COGS 107A,A01,083627,Boyle; Mary E. T.,0,16,60,60
1651005301092,COGS 118A,A01,083075,Staff,0,10,60,60
1651005307114,CSE 3,A50,083646,Miranda; Gregory Joseph,15,0,38,23
1651005307114,CSE 3,A51,083647,Miranda; Gregory Joseph,36,0,37,1
1651005313136,CSE 8A,A50,083650,Miranda; Gregory Joseph,0,31,40,40
1651005319166,CSE 11,A01,083080,Cao; Yingjun,0,97,40,40
1651005325189,CSE 12,A01,083652,Staff,0,24,100,100
1651005331214,CSE 15L,A01,083654,Staff,0,3,50,50
1651005331214,CSE 15L,A02,083655,Staff,0,3,50,50
1651005337235,CSE 20,A01,083657,Staff,47,0,80,33
1651005343260,CSE 30,A01,083084,Eldon; John,1,38,80,79
1651005349290,CSE 100,A01,083659,Cao; Yingjun,0,72,50,50
1651005355313,CSE 134B,A01,083661,Powell; Thomas Allan,1,40,65,64
1651005361355,CSE 140,A01,083663,Staff,0,13,75,75
1651005367389,CSE 140L,A01,083088,Eldon; John,4,0,100,96
1651005373412,CSE 175,A01,083665,Kumar; Rakesh,0,0,25,25
1651005379439,CSE 190,A00,092507,Dubnov; Shlomo,9,0,20,11
1651005385462,ECE 45,A01,083139,Staff,0,7,60,60
1651005391485,ECE 65,A50,083695,Staff,0,7,30,30
1651005397507,ECE 109,A01,091882,Touri; Behrouz,32,0,70,38
1651005403536,ECE 180,A00,083140,Abi Samra; Nicholas Camill,17,0,30,13
1651005403536,ECE 180,B00,083141,Abi Samra; Nicholas Camill,0,0,30,30
1651005409563,MATH 10A,A01,083735,Patchell; Gregory David,1,0,30,29
1651005409563,MATH 10A,A02,083736,Patchell; Gregory David,27,0,30,3
1651005409563,MATH 10A,A03,083737,Patchell; Gregory David,23,0,30,7
1651005415589,MATH 10B,A01,083207,Staff,0,9,30,30
1651005415589,MATH 10B,A02,083208,Staff,0,5,30,30
1651005415589,MATH 10B,B01,083739,Staff,8,0,30,22
1651005415589,MATH 10B,B02,083740,Staff,28,0,30,2
1651005421617,MATH 18,A01,083743,Staff,0,0,30,30
1651005421617,MATH 18,A02,083744,Staff,23,0,30,7
1651005421617,MATH 18,A03,083745,Staff,19,0,30,11
1651005421617,MATH 18,A04,083746,Staff,26,0,30,4
1651005421617,MATH 18,B01,083748,Staff,0,16,30,30
1651005421617,MATH 18,B02,083749,Staff,0,14,30,30
1651005421617,MATH 18,B03,083750,Staff,0,14,30,30
1651005421617,MATH 18,B04,083751,Staff,0,13,30,30
1651005427642,MATH 20A,A01,083754,Staff,19,0,40,21
1651005433664,MATH 20B,A01,083756,Staff,0,14,30,30
1651005433664,MATH 20B,A02,083757,Staff,0,11,30,30
1651005439691,MATH 20C,A01,083760,Staff,0,17,30,30
1651005439691,MATH 20C,A02,083761,Staff,0,15,30,30
1651005439691,MATH 20C,B01,083762,Staff,9,0,30,21
1651005439691,MATH 20C,B02,083763,Staff,28,0,30,2
1651005445715,MATH 20D,A01,083765,Staff,3,1,30,27
1651005445715,MATH 20D,A02,083766,Staff,2,0,30,28
1651005445715,MATH 20D,A03,083767,Staff,22,0,30,8
1651005451742,MATH 20E,A01,083771,Staff,2,0,30,28
1651005451742,MATH 20E,A02,083772,Staff,12,0,30,18
1651005451742,MATH 20E,B01,083773,Staff,0,0,30,30
1651005451742,MATH 20E,B02,083774,Staff,0,0,30,30
1651005457773,MATH 103A,A01,083777,Staff,0,17,30,30
1651005457773,MATH 103A,A02,083778,Staff,0,15,30,30
1651005457773,MATH 103A,B01,083779,Staff,0,15,30,30
1651005457773,MATH 103A,B02,083780,Staff,0,14,30,30
1651005463796,MATH 105,A01,085443,Staff,0,23,30,30
1651005469819,MATH 109,A01,083213,Anzaldo; Leesa B,0,7,30,30
1651005469819,MATH 109,A02,083214,Anzaldo; Leesa B,0,7,30,30
1651005469819,MATH 109,B01,083215,Anzaldo; Leesa B,0,8,30,30
1651005469819,MATH 109,B02,083216,Anzaldo; Leesa B,0,7,30,30
1651005475841,MATH 142A,A01,083219,Chow; Bennett,0,14,30,30
1651005475841,MATH 142A,A02,083220,Chow; Bennett,0,15,30,30
1651005475841,MATH 142A,B01,083221,Chow; Bennett,0,16,30,30
1651005475841,MATH 142A,B02,083222,Chow; Bennett,0,14,30,30
1651005481865,MATH 193A,A01,083224,Staff,0,7,30,30
1651005481865,MATH 193A,A02,083225,Staff,0,7,30,30
1651005481865,MATH 193A,A03,083781,Staff,0,7,30,30
1651005481865,MATH 193A,A04,083782,Staff,0,7,30,30
1651005487887,MATH 197,001,091859,McAuley; Julian John,9998,0,9999,1
1651005493963,COGS 9,A01,083615,Staff,0,19,60,60
1651005499989,COGS 11,A01,083617,Boyle; Mary E. T.,15,0,40,25
1651005506022,COGS 13,A01,083071,Staff,0,40,40,40
1651005512046,COGS 14A,A01,092681,Staff,0,40,100,100
1651005518072,COGS 14B,A01,083073,Cheng; Tzu-Han,0,13,50,50
1651005524098,COGS 17,A01,092677,Staff,7,0,75,68
1651005530120,COGS 100,A01,083619,Staff,0,30,60,60
1651005536153,COGS 101A,A01,083621,Davis; Joshua Daniel,0,30,60,60
1651005542178,COGS 101B,A01,091572,Staff,0,6,60,60
1651005548202,COGS 101C,A01,083625,Delgado; Tania,14,0,30,16
1651005554228,COGS 107A,A01,083627,Boyle; Mary E. T.,0,16,60,60
1651005560251,COGS 118A,A01,083075,Staff,0,10,60,60
1651005566275,CSE 3,A50,083646,Miranda; Gregory Joseph,15,0,38,23
1651005566275,CSE 3,A51,083647,Miranda; Gregory Joseph,36,0,37,1
1651005572312,CSE 8A,A50,083650,Miranda; Gregory Joseph,0,31,40,40
1651005578349,CSE 11,A01,083080,Cao; Yingjun,0,97,40,40
1651005584372,CSE 12,A01,083652,Staff,0,24,100,100
1651005590398,CSE 15L,A01,083654,Staff,0,3,50,50
1651005590398,CSE 15L,A02,083655,Staff,0,3,50,50
1651005596431,CSE 20,A01,083657,Staff,47,0,80,33
1651005602457,CSE 30,A01,083084,Eldon; John,1,38,80,79
1651005608485,CSE 100,A01,083659,Cao; Yingjun,0,72,50,50
1651005614518,CSE 134B,A01,083661,Powell; Thomas Allan,1,40,65,64
1651005620543,CSE 140,A01,083663,Staff,0,13,75,75
1651005626565,CSE 140L,A01,083088,Eldon; John,4,0,100,96
1651005632591,CSE 175,A01,083665,Kumar; Rakesh,0,0,25,25
1651005638614,CSE 190,A00,092507,Dubnov; Shlomo,9,0,20,11
1651005644649,ECE 45,A01,083139,Staff,0,7,60,60
1651005650679,ECE 65,A50,083695,Staff,0,7,30,30
1651005656702,ECE 109,A01,091882,Touri; Behrouz,32,0,70,38
1651005662734,ECE 180,A00,083140,Abi Samra; Nicholas Camill,17,0,30,13
1651005662734,ECE 180,B00,083141,Abi Samra; Nicholas Camill,0,0,30,30
1651005668780,MATH 10A,A01,083735,Patchell; Gregory David,1,0,30,29
1651005668780,MATH 10A,A02,083736,Patchell; Gregory David,27,0,30,3
1651005668780,MATH 10A,A03,083737,Patchell; Gregory David,23,0,30,7
1651005674804,MATH 10B,A01,083207,Staff,0,9,30,30
1651005674804,MATH 10B,A02,083208,Staff,0,5,30,30
1651005674804,MATH 10B,B01,083739,Staff,8,0,30,22
1651005674804,MATH 10B,B02,083740,Staff,28,0,30,2
1651005680834,MATH 18,A01,083743,Staff,0,0,30,30
1651005680834,MATH 18,A02,083744,Staff,23,0,30,7
1651005680834,MATH 18,A03,083745,Staff,19,0,30,11
1651005680834,MATH 18,A04,083746,Staff,26,0,30,4
1651005680834,MATH 18,B01,083748,Staff,0,16,30,30
1651005680834,MATH 18,B02,083749,Staff,0,14,30,30
1651005680834,MATH 18,B03,083750,Staff,0,14,30,30
1651005680834,MATH 18,B04,083751,Staff,0,13,30,30
1651005686865,MATH 20A,A01,083754,Staff,19,0,40,21
1651005692891,MATH 20B,A01,083756,Staff,0,14,30,30
1651005692891,MATH 20B,A02,083757,Staff,0,11,30,30
1651005698915,MATH 20C,A01,083760,Staff,0,17,30,30
1651005698915,MATH 20C,A02,083761,Staff,0,15,30,30
1651005698915,MATH 20C,B01,083762,Staff,9,0,30,21
1651005698915,MATH 20C,B02,083763,Staff,28,0,30,2
1651005704938,MATH 20D,A01,083765,Staff,3,1,30,27
1651005704938,MATH 20D,A02,083766,Staff,2,0,30,28
1651005704938,MATH 20D,A03,083767,Staff,22,0,30,8
1651005710965,MATH 20E,A01,083771,Staff,2,0,30,28
1651005710965,MATH 20E,A02,083772,Staff,12,0,30,18
1651005710965,MATH 20E,B01,083773,Staff,0,0,30,30
1651005710965,MATH 20E,B02,083774,Staff,0,0,30,30
1651005716988,MATH 103A,A01,083777,Staff,0,17,30,30
1651005716988,MATH 103A,A02,083778,Staff,0,15,30,30
1651005716988,MATH 103A,B01,083779,Staff,0,15,30,30
1651005716988,MATH 103A,B02,083780,Staff,0,14,30,30
1651005723015,MATH 105,A01,085443,Staff,0,23,30,30
1651005729038,MATH 109,A01,083213,Anzaldo; Leesa B,0,7,30,30
1651005729038,MATH 109,A02,083214,Anzaldo; Leesa B,0,7,30,30
1651005729038,MATH 109,B01,083215,Anzaldo; Leesa B,0,8,30,30
1651005729038,MATH 109,B02,083216,Anzaldo; Leesa B,0,7,30,30
1651005735071,MATH 142A,A01,083219,Chow; Bennett,0,14,30,30
1651005735071,MATH 142A,A02,083220,Chow; Bennett,0,15,30,30
1651005735071,MATH 142A,B01,083221,Chow; Bennett,0,16,30,30
1651005735071,MATH 142A,B02,083222,Chow; Bennett,0,14,30,30
1651005741098,MATH 193A,A01,083224,Staff,0,7,30,30
1651005741098,MATH 193A,A02,083225,Staff,0,7,30,30
1651005741098,MATH 193A,A03,083781,Staff,0,7,30,30
1651005741098,MATH 193A,A04,083782,Staff,0,7,30,30
1651005747124,MATH 197,001,091859,McAuley; Julian John,9998,0,9999,1
1651005753185,COGS 9,A01,083615,Staff,0,19,60,60
1651005759213,COGS 11,A01,083617,Boyle; Mary E. T.,15,0,40,25
1651005765237,COGS 13,A01,083071,Staff,0,40,40,40
1651005771261,COGS 14A,A01,092681,Staff,0,40,100,100
1651005777287,COGS 14B,A01,083073,Cheng; Tzu-Han,0,13,50,50
1651005783311,COGS 17,A01,092677,Staff,7,0,75,68
1651005789336,COGS 100,A01,083619,Staff,0,30,60,60
1651005795358,COGS 101A,A01,083621,Davis; Joshua Daniel,0,30,60,60
1651005801385,COGS 101B,A01,091572,Staff,0,6,60,60
1651005807415,COGS 101C,A01,083625,Delgado; Tania,14,0,30,16
1651005813438,COGS 107A,A01,083627,Boyle; Mary E. T.,0,16,60,60
1651005819462,COGS 118A,A01,083075,Staff,0,10,60,60
1651005825488,CSE 3,A50,083646,Miranda; Gregory Joseph,15,0,38,23
1651005825488,CSE 3,A51,083647,Miranda; Gregory Joseph,36,0,37,1
1651005831515,CSE 8A,A50,083650,Miranda; Gregory Joseph,0,31,40,40
1651005837539,CSE 11,A01,083080,Cao; Yingjun,0,97,40,40
1651005843561,CSE 12,A01,083652,Staff,0,24,100,100
1651005849585,CSE 15L,A01,083654,Staff,0,3,50,50
1651005849585,CSE 15L,A02,083655,Staff,0,3,50,50
1651005855611,CSE 20,A01,083657,Staff,47,0,80,33
1651005861633,CSE 30,A01,083084,Eldon; John,1,38,80,79
1651005867660,CSE 100,A01,083659,Cao; Yingjun,0,72,50,50
1651005873844,CSE 134B,A01,083661,Powell; Thomas Allan,1,40,65,64
1651005879869,CSE 140,A01,083663,Staff,0,13,75,75
1651005885892,CSE 140L,A01,083088,Eldon; John,4,0,100,96
1651005891914,CSE 175,A01,083665,Kumar; Rakesh,0,0,25,25
1651005897935,CSE 190,A00,092507,Dubnov; Shlomo,9,0,20,11
1651005903962,ECE 45,A01,083139,Staff,0,7,60,60
1651005909985,ECE 65,A50,083695,Staff,0,7,30,30
1651005916016,ECE 109,A01,091882,Touri; Behrouz,32,0,70,38
1651005922040,ECE 180,A00,083140,Abi Samra; Nicholas Camill,17,0,30,13
1651005922040,ECE 180,B00,083141,Abi Samra; Nicholas Camill,0,0,30,30
1651005928067,MATH 10A,A01,083735,Patchell; Gregory David,1,0,30,29
1651005928067,MATH 10A,A02,083736,Patchell; Gregory David,27,0,30,3
1651005928067,MATH 10A,A03,083737,Patchell; Gregory David,23,0,30,7
1651005934091,MATH 10B,A01,083207,Staff,0,9,30,30
1651005934091,MATH 10B,A02,083208,Staff,0,5,30,30
1651005934091,MATH 10B,B01,083739,Staff,8,0,30,22
1651005934091,MATH 10B,B02,083740,Staff,28,0,30,2
1651005940116,MATH 18,A01,083743,Staff,0,0,30,30
1651005940116,MATH 18,A02,083744,Staff,23,0,30,7
1651005940116,MATH 18,A03,083745,Staff,19,0,30,11
1651005940116,MATH 18,A04,083746,Staff,26,0,30,4
1651005940116,MATH 18,B01,083748,Staff,0,16,30,30
1651005940116,MATH 18,B02,083749,Staff,0,14,30,30
1651005940116,MATH 18,B03,083750,Staff,0,14,30,30
1651005940116,MATH 18,B04,083751,Staff,0,13,30,30
1651005946148,MATH 20A,A01,083754,Staff,19,0,40,21
1651005952170,MATH 20B,A01,083756,Staff,0,14,30,30
1651005952170,MATH 20B,A02,083757,Staff,0,11,30,30
1651005958193,MATH 20C,A01,083760,Staff,0,17,30,30
1651005958193,MATH 20C,A02,083761,Staff,0,15,30,30
1651005958193,MATH 20C,B01,083762,Staff,9,0,30,21
1651005958193,MATH 20C,B02,083763,Staff,28,0,30,2
1651005964219,MATH 20D,A01,083765,Staff,3,1,30,27
1651005964219,MATH 20D,A02,083766,Staff,2,0,30,28
1651005964219,MATH 20D,A03,083767,Staff,22,0,30,8
1651005970246,MATH 20E,A01,083771,Staff,2,0,30,28
1651005970246,MATH 20E,A02,083772,Staff,12,0,30,18
1651005970246,MATH 20E,B01,083773,Staff,0,0,30,30
1651005970246,MATH 20E,B02,083774,Staff,0,0,30,30
1651005976268,MATH 103A,A01,083777,Staff,0,17,30,30
1651005976268,MATH 103A,A02,083778,Staff,0,15,30,30
1651005976268,MATH 103A,B01,083779,Staff,0,15,30,30
1651005976268,MATH 103A,B02,083780,Staff,0,14,30,30
1651005982294,MATH 105,A01,085443,Staff,0,23,30,30
1651005988319,MATH 109,A01,083213,Anzaldo; Leesa B,0,7,30,30
1651005988319,MATH 109,A02,083214,Anzaldo; Leesa B,0,7,30,30
1651005988319,MATH 109,B01,083215,Anzaldo; Leesa B,0,8,30,30
1651005988319,MATH 109,B02,083216,Anzaldo; Leesa B,0,7,30,30
1651005994341,MATH 142A,A01,083219,Chow; Bennett,0,14,30,30
1651005994341,MATH 142A,A02,083220,Chow; Bennett,0,15,30,30
1651005994341,MATH 142A,B01,083221,Chow; Bennett,0,16,30,30
1651005994341,MATH 142A,B02,083222,Chow; Bennett,0,14,30,30
1651006000365,MATH 193A,A01,083224,Staff,0,7,30,30
1651006000365,MATH 193A,A02,083225,Staff,0,7,30,30
1651006000365,MATH 193A,A03,083781,Staff,0,7,30,30
1651006000365,MATH 193A,A04,083782,Staff,0,7,30,30
1651006006402,MATH 197,001,091859,McAuley; Julian John,9998,0,9999,1
1651006012466,COGS 9,A01,083615,Staff,0,19,60,60
1651006018492,COGS 11,A01,083617,Boyle; Mary E. T.,15,0,40,25
1651006024518,COGS 13,A01,083071,Staff,0,40,40,40
1651006030544,COGS 14A,A01,092681,Staff,0,40,100,100
1651006036577,COGS 14B,A01,083073,Cheng; Tzu-Han,0,13,50,50
1651006042607,COGS 17,A01,092677,Staff,7,0,75,68
1651006048643,COGS 100,A01,083619,Staff,0,30,60,60
1651006054671,COGS 101A,A01,083621,Davis; Joshua Daniel,0,30,60,60
1651006060696,COGS 101B,A01,091572,Staff,0,6,60,60
1651006066720,COGS 101C,A01,083625,Delgado; Tania,14,0,30,16
1651006072756,COGS 107A,A01,083627,Boyle; Mary E. T.,0,16,60,60
1651006078788,COGS 118A,A01,083075,Staff,0,10,60,60
1651006084816,CSE 3,A50,083646,Miranda; Gregory Joseph,15,0,38,23
1651006084816,CSE 3,A51,083647,Miranda; Gregory Joseph,36,0,37,1
1651006090841,CSE 8A,A50,083650,Miranda; Gregory Joseph,0,31,40,40
1651006096864,CSE 11,A01,083080,Cao; Yingjun,0,97,40,40
1651006102885,CSE 12,A01,083652,Staff,0,24,100,100
1651006108908,CSE 15L,A01,083654,Staff,0,3,50,50
1651006108908,CSE 15L,A02,083655,Staff,0,3,50,50
1651006114931,CSE 20,A01,083657,Staff,47,0,80,33
1651006120967,CSE 30,A01,083084,Eldon; John,1,38,80,79
1651006126993,CSE 100,A01,083659,Cao; Yingjun,0,72,50,50
1651006133026,CSE 134B,A01,083661,Powell; Thomas Allan,1,40,65,64
1651006139052,CSE 140,A01,083663,Staff,0,13,75,75
1651006145079,CSE 140L,A01,083088,Eldon; John,4,0,100,96
1651006151103,CSE 175,A01,083665,Kumar; Rakesh,0,0,25,25
1651006157131,CSE 190,A00,092507,Dubnov; Shlomo,9,0,20,11
1651006163153,ECE 45,A01,083139,Staff,0,7,60,60
1651006169176,ECE 65,A50,083695,Staff,0,7,30,30
1651006175202,ECE 109,A01,091882,Touri; Behrouz,32,0,70,38
1651006181224,ECE 180,A00,083140,Abi Samra; Nicholas Camill,17,0,30,13
1651006181224,ECE 180,B00,083141,Abi Samra; Nicholas Camill,0,0,30,30
1651006187250,MATH 10A,A01,083735,Patchell; Gregory David,1,0,30,29
1651006187250,MATH 10A,A02,083736,Patchell; Gregory David,27,0,30,3
1651006187250,MATH 10A,A03,083737,Patchell; Gregory David,23,0,30,7
1651006193282,MATH 10B,A01,083207,Staff,0,9,30,30
1651006193282,MATH 10B,A02,083208,Staff,0,5,30,30
1651006193282,MATH 10B,B01,083739,Staff,8,0,30,22
1651006193282,MATH 10B,B02,083740,Staff,28,0,30,2
1651006199306,MATH 18,A01,083743,Staff,0,0,30,30
1651006199306,MATH 18,A02,083744,Staff,23,0,30,7
1651006199306,MATH 18,A03,083745,Staff,19,0,30,11
1651006199306,MATH 18,A04,083746,Staff,26,0,30,4
1651006199306,MATH 18,B01,083748,Staff,0,16,30,30
1651006199306,MATH 18,B02,083749,Staff,0,14,30,30
1651006199306,MATH 18,B03,083750,Staff,0,14,30,30
1651006199306,MATH 18,B04,083751,Staff,0,13,30,30
1651006205328,MATH 20A,A01,083754,Staff,19,0,40,21
1651006211351,MATH 20B,A01,083756,Staff,0,14,30,30
1651006211351,MATH 20B,A02,083757,Staff,0,11,30,30
1651006217378,MATH 20C,A01,083760,Staff,0,17,30,30
1651006217378,MATH 20C,A02,083761,Staff,0,15,30,30
1651006217378,MATH 20C,B01,083762,Staff,9,0,30,21
1651006217378,MATH 20C,B02,083763,Staff,28,0,30,2
1651006223402,MATH 20D,A01,083765,Staff,3,1,30,27
1651006223402,MATH 20D,A02,083766,Staff,2,0,30,28
1651006223402,MATH 20D,A03,083767,Staff,22,0,30,8
1651006229427,MATH 20E,A01,083771,Staff,2,0,30,28
1651006229427,MATH 20E,A02,083772,Staff,12,0,30,18
1651006229427,MATH 20E,B01,083773,Staff,0,0,30,30
1651006229427,MATH 20E,B02,083774,Staff,0,0,30,30
1651006235462,MATH 103A,A01,083777,Staff,0,17,30,30
1651006235462,MATH 103A,A02,083778,Staff,0,15,30,30
1651006235462,MATH 103A,B01,083779,Staff,0,15,30,30
1651006235462,MATH 103A,B02,083780,Staff,0,14,30,30
1651006241484,MATH 105,A01,085443,Staff,0,23,30,30
1651006247507,MATH 109,A01,083213,Anzaldo; Leesa B,0,7,30,30
1651006247507,MATH 109,A02,083214,Anzaldo; Leesa B,0,7,30,30
1651006247507,MATH 109,B01,083215,Anzaldo; Leesa B,0,8,30,30
1651006247507,MATH 109,B02,083216,Anzaldo; Leesa B,0,7,30,30
1651006253531,MATH 142A,A01,083219,Chow; Bennett,0,14,30,30
1651006253531,MATH 142A,A02,083220,Chow; Bennett,0,15,30,30
1651006253531,MATH 142A,B01,083221,Chow; Bennett,0,16,30,30
1651006253531,MATH 142A,B02,083222,Chow; Bennett,0,14,30,30
1651006259554,MATH 193A,A01,083224,Staff,0,7,30,30
1651006259554,MATH 193A,A02,083225,Staff,0,7,30,30
1651006259554,MATH 193A,A03,083781,Staff,0,7,30,30
1651006259554,MATH 193A,A04,083782,Staff,0,7,30,30
1651006265577,MATH 197,001,091859,McAuley; Julian John,9998,0,9999,1
1651006271652,COGS 9,A01,083615,Staff,0,19,60,60
1651006277677,COGS 11,A01,083617,Boyle; Mary E. T.,15,0,40,25
1651006283703,COGS 13,A01,083071,Staff,0,40,40,40
1651006289726,COGS 14A,A01,092681,Staff,0,40,100,100
1651006295749,COGS 14B,A01,083073,Cheng; Tzu-Han,0,13,50,50
1651006301781,COGS 17,A01,092677,Staff,7,0,75,68
1651006307808,COGS 100,A01,083619,Staff,0,30,60,60
1651006313835,COGS 101A,A01,083621,Davis; Joshua Daniel,0,30,60,60
1651006319861,COGS 101B,A01,091572,Staff,0,6,60,60
1651006325884,COGS 101C,A01,083625,Delgado; Tania,14,0,30,16
1651006331909,COGS 107A,A01,083627,Boyle; Mary E. T.,0,16,60,60
1651006337937,COGS 118A,A01,083075,Staff,0,10,60,60
1651006343964,CSE 3,A50,083646,Miranda; Gregory Joseph,15,0,38,23
1651006343964,CSE 3,A51,083647,Miranda; Gregory Joseph,36,0,37,1
1651006349988,CSE 8A,A50,083650,Miranda; Gregory Joseph,0,31,40,40
1651006356019,CSE 11,A01,083080,Cao; Yingjun,0,97,40,40
1651006362040,CSE 12,A01,083652,Staff,0,24,100,100
1651006368068,CSE 15L,A01,083654,Staff,0,3,50,50
1651006368068,CSE 15L,A02,083655,Staff,0,3,50,50
1651006374092,CSE 20,A01,083657,Staff,47,0,80,33
1651006380115,CSE 30,A01,083084,Eldon; John,1,38,80,79
1651006386138,CSE 100,A01,083659,Cao; Yingjun,0,72,50,50
1651006392165,CSE 134B,A01,083661,Powell; Thomas Allan,1,40,65,64
1651006398191,CSE 140,A01,083663,Staff,0,13,75,75
1651006404215,CSE 140L,A01,083088,Eldon; John,4,0,100,96
1651006410248,CSE 175,A01,083665,Kumar; Rakesh,0,0,25,25
1651006416275,CSE 190,A00,092507,Dubnov; Shlomo,9,0,20,11
1651006422311,ECE 45,A01,083139,Staff,0,7,60,60
1651006428336,ECE 65,A50,083695,Staff,0,7,30,30
1651006434361,ECE 109,A01,091882,Touri; Behrouz,32,0,70,38
1651006440384,ECE 180,A00,083140,Abi Samra; Nicholas Camill,17,0,30,13
1651006440384,ECE 180,B00,083141,Abi Samra; Nicholas Camill,0,0,30,30
1651006446412,MATH 10A,A01,083735,Patchell; Gregory David,1,0,30,29
1651006446412,MATH 10A,A02,083736,Patchell; Gregory David,27,0,30,3
1651006446412,MATH 10A,A03,083737,Patchell; Gregory David,23,0,30,7
1651006452439,MATH 10B,A01,083207,Staff,0,9,30,30
1651006452439,MATH 10B,A02,083208,Staff,0,5,30,30
1651006452439,MATH 10B,B01,083739,Staff,8,0,30,22
1651006452439,MATH 10B,B02,083740,Staff,28,0,30,2
1651006458472,MATH 18,A01,083743,Staff,0,0,30,30
1651006458472,MATH 18,A02,083744,Staff,23,0,30,7
1651006458472,MATH 18,A03,083745,Staff,19,0,30,11
1651006458472,MATH 18,A04,083746,Staff,26,0,30,4
1651006458472,MATH 18,B01,083748,Staff,0,16,30,30
1651006458472,MATH 18,B02,083749,Staff,0,14,30,30
1651006458472,MATH 18,B03,083750,Staff,0,14,30,30
1651006458472,MATH 18,B04,083751,Staff,0,13,30,30
1651006464506,MATH 20A,A01,083754,Staff,19,0,40,21
1651006470641,MATH 20B,A01,083756,Staff,0,14,30,30
1651006470641,MATH 20B,A02,083757,Staff,0,11,30,30
1651006476666,MATH 20C,A01,083760,Staff,0,17,30,30
1651006476666,MATH 20C,A02,083761,Staff,0,15,30,30
1651006476666,MATH 20C,B01,083762,Staff,9,0,30,21
1651006476666,MATH 20C,B02,083763,Staff,28,0,30,2
1651006482696,MATH 20D,A01,083765,Staff,3,1,30,27
1651006482696,MATH 20D,A02,083766,Staff,2,0,30,28
1651006482696,MATH 20D,A03,083767,Staff,22,0,30,8
1651006488721,MATH 20E,A01,083771,Staff,2,0,30,28
1651006488721,MATH 20E,A02,083772,Staff,12,0,30,18
1651006488721,MATH 20E,B01,083773,Staff,0,0,30,30
1651006488721,MATH 20E,B02,083774,Staff,0,0,30,30
1651006494743,MATH 103A,A01,083777,Staff,0,17,30,30
1651006494743,MATH 103A,A02,083778,Staff,0,15,30,30
1651006494743,MATH 103A,B01,083779,Staff,0,15,30,30
1651006494743,MATH 103A,B02,083780,Staff,0,14,30,30
1651006500774,MATH 105,A01,085443,Staff,0,23,30,30
1651006506797,MATH 109,A01,083213,Anzaldo; Leesa B,0,7,30,30
1651006506797,MATH 109,A02,083214,Anzaldo; Leesa B,0,7,30,30
1651006506797,MATH 109,B01,083215,Anzaldo; Leesa B,0,8,30,30
1651006506797,MATH 109,B02,083216,Anzaldo; Leesa B,0,7,30,30
1651006512822,MATH 142A,A01,083219,Chow; Bennett,0,14,30,30
1651006512822,MATH 142A,A02,083220,Chow; Bennett,0,15,30,30
1651006512822,MATH 142A,B01,083221,Chow; Bennett,0,16,30,30
1651006512822,MATH 142A,B02,083222,Chow; Bennett,0,14,30,30
1651006518854,MATH 193A,A01,083224,Staff,0,7,30,30
1651006518854,MATH 193A,A02,083225,Staff,0,7,30,30
1651006518854,MATH 193A,A03,083781,Staff,0,7,30,30
1651006518854,MATH 193A,A04,083782,Staff,0,7,30,30
1651006524876,MATH 197,001,091859,McAuley; Julian John,9998,0,9999,1
1651006530938,COGS 9,A01,083615,Staff,0,19,60,60
1651006536961,COGS 11,A01,083617,Boyle; Mary E. T.,15,0,40,25
1651006542986,COGS 13,A01,083071,Staff,0,40,40,40
1651006549016,COGS 14A,A01,092681,Staff,0,40,100,100
1651006555044,COGS 14B,A01,083073,Cheng; Tzu-Han,0,13,50,50
1651006561073,COGS 17,A01,092677,Staff,7,0,75,68
1651006567110,COGS 100,A01,083619,Staff,0,30,60,60
1651006573139,COGS 101A,A01,083621,Davis; Joshua Daniel,0,30,60,60
1651006579172,COGS 101B,A01,091572,Staff,0,6,60,60
1651006585196,COGS 101C,A01,083625,Delgado; Tania,14,0,30,16
1651006591219,COGS 107A,A01,083627,Boyle; Mary E. T.,0,16,60,60
1651006597244,COGS 118A,A01,083075,Staff,0,10,60,60
1651006603268,CSE 3,A50,083646,Miranda; Gregory Joseph,15,0,38,23
1651006603268,CSE 3,A51,083647,Miranda; Gregory Joseph,36,0,37,1
1651006609310,CSE 8A,A50,083650,Miranda; Gregory Joseph,0,31,40,40
1651006615334,CSE 11,A01,083080,Cao; Yingjun,0,97,40,40
1651006621359,CSE 12,A01,083652,Staff,0,24,100,100
1651006627403,CSE 15L,A01,083654,Staff,0,3,50,50
1651006627403,CSE 15L,A02,083655,Staff,0,3,50,50
1651006633434,CSE 20,A01,083657,Staff,47,0,80,33
1651006639457,CSE 30,A01,083084,Eldon; John,1,38,80,79
1651006645483,CSE 100,A01,083659,Cao; Yingjun,0,72,50,50
1651006651510,CSE 134B,A01,083661,Powell; Thomas Allan,1,40,65,64
1651006657533,CSE 140,A01,083663,Staff,0,13,75,75
1651006663559,CSE 140L,A01,083088,Eldon; John,4,0,100,96
1651006669581,CSE 175,A01,083665,Kumar; Rakesh,0,0,25,25
1651006675605,CSE 190,A00,092507,Dubnov; Shlomo,9,0,20,11
1651006681628,ECE 45,A01,083139,Staff,0,7,60,60
1651006687654,ECE 65,A50,083695,Staff,0,7,30,30
1651006693681,ECE 109,A01,091882,Touri; Behrouz,32,0,70,38
1651006699704,ECE 180,A00,083140,Abi Samra; Nicholas Camill,17,0,30,13
1651006699704,ECE 180,B00,083141,Abi Samra; Nicholas Camill,0,0,30,30
1651006705726,MATH 10A,A01,083735,Patchell; Gregory David,1,0,30,29
1651006705726,MATH 10A,A02,083736,Patchell; Gregory David,27,0,30,3
1651006705726,MATH 10A,A03,083737,Patchell; Gregory David,23,0,30,7
1651006711750,MATH 10B,A01,083207,Staff,0,9,30,30
1651006711750,MATH 10B,A02,083208,Staff,0,5,30,30
1651006711750,MATH 10B,B01,083739,Staff,8,0,30,22
1651006711750,MATH 10B,B02,083740,Staff,28,0,30,2
1651006717775,MATH 18,A01,083743,Staff,0,0,30,30
1651006717775,MATH 18,A02,083744,Staff,23,0,30,7
1651006717775,MATH 18,A03,083745,Staff,19,0,30,11
1651006717775,MATH 18,A04,083746,Staff,26,0,30,4
1651006717775,MATH 18,B01,083748,Staff,0,16,30,30
1651006717775,MATH 18,B02,083749,Staff,0,14,30,30
1651006717775,MATH 18,B03,083750,Staff,0,14,30,30
1651006717775,MATH 18,B04,083751,Staff,0,13,30,30
1651006723806,MATH 20A,A01,083754,Staff,19,0,40,21
1651006729838,MATH 20B,A01,083756,Staff,0,14,30,30
1651006729838,MATH 20B,A02,083757,Staff,0,11,30,30
1651006735866,MATH 20C,A01,083760,Staff,0,17,30,30
1651006735866,MATH 20C,A02,083761,Staff,0,15,30,30
1651006735866,MATH 20C,B01,083762,Staff,9,0,30,21
1651006735866,MATH 20C,B02,083763,Staff,28,0,30,2
1651006741892,MATH 20D,A01,083765,Staff,3,1,30,27
1651006741892,MATH 20D,A02,083766,Staff,2,0,30,28
1651006741892,MATH 20D,A03,083767,Staff,22,0,30,8
1651006747918,MATH 20E,A01,083771,Staff,2,0,30,28
1651006747918,MATH 20E,A02,083772,Staff,12,0,30,18
1651006747918,MATH 20E,B01,083773,Staff,0,0,30,30
1651006747918,MATH 20E,B02,083774,Staff,0,0,30,30
1651006753942,MATH 103A,A01,083777,Staff,0,17,30,30
1651006753942,MATH 103A,A02,083778,Staff,0,15,30,30
1651006753942,MATH 103A,B01,083779,Staff,0,15,30,30
1651006753942,MATH 103A,B02,083780,Staff,0,14,30,30
1651006759967,MATH 105,A01,085443,Staff,0,23,30,30
1651006765991,MATH 109,A01,083213,Anzaldo; Leesa B,0,7,30,30
1651006765991,MATH 109,A02,083214,Anzaldo; Leesa B,0,7,30,30
1651006765991,MATH 109,B01,083215,Anzaldo; Leesa B,0,8,30,30
1651006765991,MATH 109,B02,083216,Anzaldo; Leesa B,0,7,30,30
1651006772024,MATH 142A,A01,083219,Chow; Bennett,0,14,30,30
1651006772024,MATH 142A,A02,083220,Chow; Bennett,0,15,30,30
1651006772024,MATH 142A,B01,083221,Chow; Bennett,0,16,30,30
1651006772024,MATH 142A,B02,083222,Chow; Bennett,0,14,30,30
1651006778053,MATH 193A,A01,083224,Staff,0,7,30,30
1651006778053,MATH 193A,A02,083225,Staff,0,7,30,30
1651006778053,MATH 193A,A03,083781,Staff,0,7,30,30
1651006778053,MATH 193A,A04,083782,Staff,0,7,30,30
1651006784076,MATH 197,001,091859,McAuley; Julian John,9998,0,9999,1
1651006790126,COGS 9,A01,083615,Staff,0,19,60,60
1651006796149,COGS 11,A01,083617,Boyle; Mary E. T.,15,0,40,25
1651006802175,COGS 13,A01,083071,Staff,0,40,40,40
1651006808197,COGS 14A,A01,092681,Staff,0,40,100,100
1651006814223,COGS 14B,A01,083073,Cheng; Tzu-Han,0,13,50,50
1651006820254,COGS 17,A01,092677,Staff,7,0,75,68
1651006826281,COGS 100,A01,083619,Staff,0,30,60,60
1651006832304,COGS 101A,A01,083621,Davis; Joshua Daniel,0,30,60,60
1651006838329,COGS 101B,A01,091572,Staff,0,6,60,60
1651006844354,COGS 101C,A01,083625,Delgado; Tania,14,0,30,16
1651006850385,COGS 107A,A01,083627,Boyle; Mary E. T.,0,16,60,60
1651006856424,COGS 118A,A01,083075,Staff,0,10,60,60
1651006862451,CSE 3,A50,083646,Miranda; Gregory Joseph,15,0,38,23
1651006862451,CSE 3,A51,083647,Miranda; Gregory Joseph,36,0,37,1
1651006868492,CSE 8A,A50,083650,Miranda; Gregory Joseph,0,31,40,40
1651006874524,CSE 11,A01,083080,Cao; Yingjun,0,97,40,40
1651006880550,CSE 12,A01,083652,Staff,0,24,100,100
1651006886584,CSE 15L,A01,083654,Staff,0,3,50,50
1651006886584,CSE 15L,A02,083655,Staff,0,3,50,50
1651006892609,CSE 20,A01,083657,Staff,47,0,80,33
1651006898633,CSE 30,A01,083084,Eldon; John,1,38,80,79
1651006904663,CSE 100,A01,083659,Cao; Yingjun,0,72,50,50
1651006910690,CSE 134B,A01,083661,Powell; Thomas Allan,1,40,65,64
1651006916711,CSE 140,A01,083663,Staff,0,13,75,75
1651006922748,CSE 140L,A01,083088,Eldon; John,4,0,100,96
1651006928773,CSE 175,A01,083665,Kumar; Rakesh,0,0,25,25
1651006934797,CSE 190,A00,092507,Dubnov; Shlomo,9,0,20,11
1651006940820,ECE 45,A01,083139,Staff,0,7,60,60
1651006946850,ECE 65,A50,083695,Staff,0,7,30,30
1651006952876,ECE 109,A01,091882,Touri; Behrouz,32,0,70,38
1651006958910,ECE 180,A00,083140,Abi Samra; Nicholas Camill,17,0,30,13
1651006958910,ECE 180,B00,083141,Abi Samra; Nicholas Camill,0,0,30,30
1651006964944,MATH 10A,A01,083735,Patchell; Gregory David,1,0,30,29
1651006964944,MATH 10A,A02,083736,Patchell; Gregory David,27,0,30,3
1651006964944,MATH 10A,A03,083737,Patchell; Gregory David,23,0,30,7
1651006970977,MATH 10B,A01,083207,Staff,0,9,30,30
1651006970977,MATH 10B,A02,083208,Staff,0,5,30,30
1651006970977,MATH 10B,B01,083739,Staff,8,0,30,22
1651006970977,MATH 10B,B02,083740,Staff,28,0,30,2
1651006977007,MATH 18,A01,083743,Staff,0,0,30,30
1651006977007,MATH 18,A02,083744,Staff,23,0,30,7
1651006977007,MATH 18,A03,083745,Staff,19,0,30,11
1651006977007,MATH 18,A04,083746,Staff,26,0,30,4
1651006977007,MATH 18,B01,083748,Staff,0,16,30,30
1651006977007,MATH 18,B02,083749,Staff,0,14,30,30
1651006977007,MATH 18,B03,083750,Staff,0,14,30,30
1651006977007,MATH 18,B04,083751,Staff,0,13,30,30
1651006983033,MATH 20A,A01,083754,Staff,19,0,40,21
1651006989056,MATH 20B,A01,083756,Staff,0,14,30,30
1651006989056,MATH 20B,A02,083757,Staff,0,11,30,30
1651006995085,MATH 20C,A01,083760,Staff,0,17,30,30
1651006995085,MATH 20C,A02,083761,Staff,0,15,30,30
1651006995085,MATH 20C,B01,083762,Staff,9,0,30,21
1651006995085,MATH 20C,B02,083763,Staff,28,0,30,2
1651007001109,MATH 20D,A01,083765,Staff,3,1,30,27
1651007001109,MATH 20D,A02,083766,Staff,2,0,30,28
1651007001109,MATH 20D,A03,083767,Staff,22,0,30,8
1651007007134,MATH 20E,A01,083771,Staff,2,0,30,28
1651007007134,MATH 20E,A02,083772,Staff,12,0,30,18
1651007007134,MATH 20E,B01,083773,Staff,0,0,30,30
1651007007134,MATH 20E,B02,083774,Staff,0,0,30,30
1651007013157,MATH 103A,A01,083777,Staff,0,17,30,30
1651007013157,MATH 103A,A02,083778,Staff,0,15,30,30
1651007013157,MATH 103A,B01,083779,Staff,0,15,30,30
1651007013157,MATH 103A,B02,083780,Staff,0,14,30,30
1651007019183,MATH 105,A01,085443,Staff,0,23,30,30
1651007025207,MATH 109,A01,083213,Anzaldo; Leesa B,0,7,30,30
1651007025207,MATH 109,A02,083214,Anzaldo; Leesa B,0,7,30,30
1651007025207,MATH 109,B01,083215,Anzaldo; Leesa B,0,8,30,30
1651007025207,MATH 109,B02,083216,Anzaldo; Leesa B,0,7,30,30
1651007031231,MATH 142A,A01,083219,Chow; Bennett,0,14,30,30
1651007031231,MATH 142A,A02,083220,Chow; Bennett,0,15,30,30
1651007031231,MATH 142A,B01,083221,Chow; Bennett,0,16,30,30
1651007031231,MATH 142A,B02,083222,Chow; Bennett,0,14,30,30
1651007037253,MATH 193A,A01,083224,Staff,0,7,30,30
1651007037253,MATH 193A,A02,083225,Staff,0,7,30,30
1651007037253,MATH 193A,A03,083781,Staff,0,7,30,30
1651007037253,MATH 193A,A04,083782,Staff,0,7,30,30
1651007043301,MATH 197,001,091859,McAuley; Julian John,9998,0,9999,1
1651007049361,COGS 9,A01,083615,Staff,0,19,60,60
1651007055383,COGS 11,A01,083617,Boyle; Mary E. T.,15,0,40,25
1651007061499,COGS 13,A01,083071,Staff,0,40,40,40
1651007067524,COGS 14A,A01,092681,Staff,0,40,100,100
1651007073548,COGS 14B,A01,083073,Cheng; Tzu-Han,0,13,50,50
1651007079573,COGS 17,A01,092677,Staff,7,0,75,68
1651007085597,COGS 100,A01,083619,Staff,0,30,60,60
1651007091624,COGS 101A,A01,083621,Davis; Joshua Daniel,0,30,60,60
1651007097657,COGS 101B,A01,091572,Staff,0,6,60,60
1651007103687,COGS 101C,A01,083625,Delgado; Tania,14,0,30,16
1651007109711,COGS 107A,A01,083627,Boyle; Mary E. T.,0,16,60,60
1651007115737,COGS 118A,A01,083075,Staff,0,10,60,60
1651007121769,CSE 3,A50,083646,Miranda; Gregory Joseph,15,0,38,23
1651007121769,CSE 3,A51,083647,Miranda; Gregory Joseph,36,0,37,1
1651007127795,CSE 8A,A50,083650,Miranda; Gregory Joseph,0,31,40,40
1651007133832,CSE 11,A01,083080,Cao; Yingjun,0,97,40,40
1651007139853,CSE 12,A01,083652,Staff,0,24,100,100
1651007145881,CSE 15L,A01,083654,Staff,0,3,50,50
1651007145881,CSE 15L,A02,083655,Staff,0,3,50,50
1651007151904,CSE 20,A01,083657,Staff,47,0,80,33
1651007157935,CSE 30,A01,083084,Eldon; John,1,39,80,79
1651007163963,CSE 100,A01,083659,Cao; Yingjun,0,72,50,50
1651007169988,CSE 134B,A01,083661,Powell; Thomas Allan,1,40,65,64
1651007176019,CSE 140,A01,083663,Staff,0,13,75,75
1651007182049,CSE 140L,A01,083088,Eldon; John,4,0,100,96
1651007188073,CSE 175,A01,083665,Kumar; Rakesh,0,0,25,25
1651007194096,CSE 190,A00,092507,Dubnov; Shlomo,9,0,20,11
1651007200127,ECE 45,A01,083139,Staff,0,7,60,60
1651007206150,ECE 65,A50,083695,Staff,0,7,30,30
1651007212176,ECE 109,A01,091882,Touri; Behrouz,32,0,70,38
1651007218201,ECE 180,A00,083140,Abi Samra; Nicholas Camill,17,0,30,13
1651007218201,ECE 180,B00,083141,Abi Samra; Nicholas Camill,0,0,30,30
1651007224233,MATH 10A,A01,083735,Patchell; Gregory David,1,0,30,29
1651007224233,MATH 10A,A02,083736,Patchell; Gregory David,27,0,30,3
1651007224233,MATH 10A,A03,083737,Patchell; Gregory David,23,0,30,7
1651007230257,MATH 10B,A01,083207,Staff,0,9,30,30
1651007230257,MATH 10B,A02,083208,Staff,0,5,30,30
1651007230257,MATH 10B,B01,083739,Staff,8,0,30,22
1651007230257,MATH 10B,B02,083740,Staff,28,0,30,2
1651007236288,MATH 18,A01,083743,Staff,0,0,30,30
1651007236288,MATH 18,A02,083744,Staff,23,0,30,7
1651007236288,MATH 18,A03,083745,Staff,19,0,30,11
1651007236288,MATH 18,A04,083746,Staff,26,0,30,4
1651007236288,MATH 18,B01,083748,Staff,0,16,30,30
1651007236288,MATH 18,B02,083749,Staff,0,14,30,30
1651007236288,MATH 18,B03,083750,Staff,0,14,30,30
1651007236288,MATH 18,B04,083751,Staff,0,13,30,30
1651007242311,MATH 20A,A01,083754,Staff,19,0,40,21
1651007248333,MATH 20B,A01,083756,Staff,0,14,30,30
1651007248333,MATH 20B,A02,083757,Staff,0,11,30,30
1651007254361,MATH 20C,A01,083760,Staff,0,17,30,30
1651007254361,MATH 20C,A02,083761,Staff,0,15,30,30
1651007254361,MATH 20C,B01,083762,Staff,9,0,30,21
1651007254361,MATH 20C,B02,083763,Staff,28,0,30,2
1651007260385,MATH 20D,A01,083765,Staff,3,1,30,27
1651007260385,MATH 20D,A02,083766,Staff,2,0,30,28
1651007260385,MATH 20D,A03,083767,Staff,22,0,30,8
1651007266413,MATH 20E,A01,083771,Staff,2,0,30,28
1651007266413,MATH 20E,A02,083772,Staff,12,0,30,18
1651007266413,MATH 20E,B01,083773,Staff,0,0,30,30
1651007266413,MATH 20E,B02,083774,Staff,1,0,30,29
1651007272452,MATH 103A,A01,083777,Staff,0,17,30,30
1651007272452,MATH 103A,A02,083778,Staff,0,15,30,30
1651007272452,MATH 103A,B01,083779,Staff,0,15,30,30
1651007272452,MATH 103A,B02,083780,Staff,0,14,30,30
1651007278476,MATH 105,A01,085443,Staff,0,23,30,30
1651007284503,MATH 109,A01,083213,Anzaldo; Leesa B,0,7,30,30
1651007284503,MATH 109,A02,083214,Anzaldo; Leesa B,0,7,30,30
1651007284503,MATH 109,B01,083215,Anzaldo; Leesa B,0,8,30,30
1651007284503,MATH 109,B02,083216,Anzaldo; Leesa B,0,7,30,30
1651007290534,MATH 142A,A01,083219,Chow; Bennett,0,14,30,30
1651007290534,MATH 142A,A02,083220,Chow; Bennett,0,15,30,30
1651007290534,MATH 142A,B01,083221,Chow; Bennett,0,16,30,30
1651007290534,MATH 142A,B02,083222,Chow; Bennett,0,14,30,30
1651007296562,MATH 193A,A01,083224,Staff,0,7,30,30
1651007296562,MATH 193A,A02,083225,Staff,0,7,30,30
1651007296562,MATH 193A,A03,083781,Staff,0,7,30,30
1651007296562,MATH 193A,A04,083782,Staff,0,7,30,30
1651007302589,MATH 197,001,091859,McAuley; Julian John,9998,0,9999,1
1651007308647,COGS 9,A01,083615,Staff,0,19,60,60
1651007314670,COGS 11,A01,083617,Boyle; Mary E. T.,15,0,40,25
1651007320694,COGS 13,A01,083071,Staff,0,40,40,40
1651007326717,COGS 14A,A01,092681,Staff,0,40,100,100
1651007332740,COGS 14B,A01,083073,Cheng; Tzu-Han,0,13,50,50
1651007338764,COGS 17,A01,092677,Staff,7,0,75,68
1651007344796,COGS 100,A01,083619,Staff,0,30,60,60
1651007350827,COGS 101A,A01,083621,Davis; Joshua Daniel,0,30,60,60
1651007356850,COGS 101B,A01,091572,Staff,0,6,60,60
1651007362882,COGS 101C,A01,083625,Delgado; Tania,14,0,30,16
1651007368914,COGS 107A,A01,083627,Boyle; Mary E. T.,0,16,60,60
1651007374938,COGS 118A,A01,083075,Staff,0,10,60,60
1651007380966,CSE 3,A50,083646,Miranda; Gregory Joseph,15,0,38,23
1651007380966,CSE 3,A51,083647,Miranda; Gregory Joseph,36,0,37,1
1651007386989,CSE 8A,A50,083650,Miranda; Gregory Joseph,0,31,40,40
1651007393015,CSE 11,A01,083080,Cao; Yingjun,0,97,40,40
1651007399042,CSE 12,A01,083652,Staff,0,24,100,100
1651007405065,CSE 15L,A01,083654,Staff,0,3,50,50
1651007405065,CSE 15L,A02,083655,Staff,0,3,50,50
1651007411089,CSE 20,A01,083657,Staff,47,0,80,33
1651007417112,CSE 30,A01,083084,Eldon; John,1,39,80,79
1651007423141,CSE 100,A01,083659,Cao; Yingjun,0,72,50,50
1651007429167,CSE 134B,A01,083661,Powell; Thomas Allan,1,40,65,64
1651007435196,CSE 140,A01,083663,Staff,0,13,75,75
1651007441224,CSE 140L,A01,083088,Eldon; John,4,0,100,96
1651007447258,CSE 175,A01,083665,Kumar; Rakesh,0,0,25,25
1651007453298,CSE 190,A00,092507,Dubnov; Shlomo,9,0,20,11
1651007459324,ECE 45,A01,083139,Staff,0,7,60,60
1651007465347,ECE 65,A50,083695,Staff,0,7,30,30
1651007471379,ECE 109,A01,091882,Touri; Behrouz,32,0,70,38
1651007477401,ECE 180,A00,083140,Abi Samra; Nicholas Camill,17,0,30,13
1651007477401,ECE 180,B00,083141,Abi Samra; Nicholas Camill,0,0,30,30
1651007483433,MATH 10A,A01,083735,Patchell; Gregory David,1,0,30,29
1651007483433,MATH 10A,A02,083736,Patchell; Gregory David,27,0,30,3
1651007483433,MATH 10A,A03,083737,Patchell; Gregory David,23,0,30,7
1651007489456,MATH 10B,A01,083207,Staff,0,9,30,30
1651007489456,MATH 10B,A02,083208,Staff,0,5,30,30
1651007489456,MATH 10B,B01,083739,Staff,8,0,30,22
1651007489456,MATH 10B,B02,083740,Staff,28,0,30,2
1651007495481,MATH 18,A01,083743,Staff,0,0,30,30
1651007495481,MATH 18,A02,083744,Staff,23,0,30,7
1651007495481,MATH 18,A03,083745,Staff,19,0,30,11
1651007495481,MATH 18,A04,083746,Staff,26,0,30,4
1651007495481,MATH 18,B01,083748,Staff,0,16,30,30
1651007495481,MATH 18,B02,083749,Staff,0,14,30,30
1651007495481,MATH 18,B03,083750,Staff,0,14,30,30
1651007495481,MATH 18,B04,083751,Staff,0,13,30,30
1651007501505,MATH 20A,A01,083754,Staff,19,0,40,21
1651007507533,MATH 20B,A01,083756,Staff,0,14,30,30
1651007507533,MATH 20B,A02,083757,Staff,0,11,30,30
1651007513573,MATH 20C,A01,083760,Staff,0,17,30,30
1651007513573,MATH 20C,A02,083761,Staff,0,15,30,30
1651007513573,MATH 20C,B01,083762,Staff,9,0,30,21
1651007513573,MATH 20C,B02,083763,Staff,28,0,30,2
1651007519610,MATH 20D,A01,083765,Staff,3,1,30,27
1651007519610,MATH 20D,A02,083766,Staff,2,0,30,28
1651007519610,MATH 20D,A03,083767,Staff,22,0,30,8
1651007525632,MATH 20E,A01,083771,Staff,2,0,30,28
1651007525632,MATH 20E,A02,083772,Staff,12,0,30,18
1651007525632,MATH 20E,B01,083773,Staff,0,0,30,30
1651007525632,MATH 20E,B02,083774,Staff,1,0,30,29
1651007531654,MATH 103A,A01,083777,Staff,0,17,30,30
1651007531654,MATH 103A,A02,083778,Staff,0,15,30,30
1651007531654,MATH 103A,B01,083779,Staff,0,15,30,30
1651007531654,MATH 103A,B02,083780,Staff,0,14,30,30
1651007537677,MATH 105,A01,085443,Staff,0,23,30,30
1651007543702,MATH 109,A01,083213,Anzaldo; Leesa B,0,7,30,30
1651007543702,MATH 109,A02,083214,Anzaldo; Leesa B,0,7,30,30
1651007543702,MATH 109,B01,083215,Anzaldo; Leesa B,0,8,30,30
1651007543702,MATH 109,B02,083216,Anzaldo; Leesa B,0,7,30,30
1651007549725,MATH 142A,A01,083219,Chow; Bennett,0,14,30,30
1651007549725,MATH 142A,A02,083220,Chow; Bennett,0,15,30,30
1651007549725,MATH 142A,B01,083221,Chow; Bennett,0,16,30,30
1651007549725,MATH 142A,B02,083222,Chow; Bennett,0,14,30,30
1651007555752,MATH 193A,A01,083224,Staff,0,7,30,30
1651007555752,MATH 193A,A02,083225,Staff,0,7,30,30
1651007555752,MATH 193A,A03,083781,Staff,0,7,30,30
1651007555752,MATH 193A,A04,083782,Staff,0,7,30,30
1651007561774,MATH 197,001,091859,McAuley; Julian John,9998,0,9999,1
1651007567826,COGS 9,A01,083615,Staff,0,19,60,60
1651007573858,COGS 11,A01,083617,Boyle; Mary E. T.,15,0,40,25
1651007579881,COGS 13,A01,083071,Staff,0,40,40,40
1651007585908,COGS 14A,A01,092681,Staff,0,40,100,100
1651007591935,COGS 14B,A01,083073,Cheng; Tzu-Han,0,13,50,50
1651007597965,COGS 17,A01,092677,Staff,7,0,75,68
1651007603989,COGS 100,A01,083619,Staff,0,30,60,60
1651007610016,COGS 101A,A01,083621,Davis; Joshua Daniel,0,30,60,60
1651007616041,COGS 101B,A01,091572,Staff,0,6,60,60
1651007622068,COGS 101C,A01,083625,Delgado; Tania,14,0,30,16
1651007628100,COGS 107A,A01,083627,Boyle; Mary E. T.,0,16,60,60
1651007634126,COGS 118A,A01,083075,Staff,0,10,60,60
1651007640157,CSE 3,A50,083646,Miranda; Gregory Joseph,15,0,38,23
1651007640157,CSE 3,A51,083647,Miranda; Gregory Joseph,36,0,37,1
1651007646182,CSE 8A,A50,083650,Miranda; Gregory Joseph,0,31,40,40
1651007652208,CSE 11,A01,083080,Cao; Yingjun,0,97,40,40
1651007658323,CSE 12,A01,083652,Staff,0,24,100,100
1651007664357,CSE 15L,A01,083654,Staff,0,3,50,50
1651007664357,CSE 15L,A02,083655,Staff,0,3,50,50
1651007670382,CSE 20,A01,083657,Staff,47,0,80,33
1651007676421,CSE 30,A01,083084,Eldon; John,1,39,80,79
1651007682443,CSE 100,A01,083659,Cao; Yingjun,0,72,50,50
1651007688469,CSE 134B,A01,083661,Powell; Thomas Allan,1,40,65,64
1651007694493,CSE 140,A01,083663,Staff,0,13,75,75
1651007700519,CSE 140L,A01,083088,Eldon; John,4,0,100,96
1651007706540,CSE 175,A01,083665,Kumar; Rakesh,0,0,25,25
1651007712572,CSE 190,A00,092507,Dubnov; Shlomo,9,0,20,11
1651007718595,ECE 45,A01,083139,Staff,0,7,60,60
1651007724626,ECE 65,A50,083695,Staff,0,7,30,30
1651007730649,ECE 109,A01,091882,Touri; Behrouz,32,0,70,38
1651007736681,ECE 180,A00,083140,Abi Samra; Nicholas Camill,17,0,30,13
1651007736681,ECE 180,B00,083141,Abi Samra; Nicholas Camill,0,0,30,30
1651007742705,MATH 10A,A01,083735,Patchell; Gregory David,1,0,30,29
1651007742705,MATH 10A,A02,083736,Patchell; Gregory David,27,0,30,3
1651007742705,MATH 10A,A03,083737,Patchell; Gregory David,23,0,30,7
1651007748729,MATH 10B,A01,083207,Staff,0,9,30,30
1651007748729,MATH 10B,A02,083208,Staff,0,5,30,30
1651007748729,MATH 10B,B01,083739,Staff,8,0,30,22
1651007748729,MATH 10B,B02,083740,Staff,28,0,30,2
1651007754758,MATH 18,A01,083743,Staff,0,0,30,30
1651007754758,MATH 18,A02,083744,Staff,23,0,30,7
1651007754758,MATH 18,A03,083745,Staff,19,0,30,11
1651007754758,MATH 18,A04,083746,Staff,26,0,30,4
1651007754758,MATH 18,B01,083748,Staff,0,16,30,30
1651007754758,MATH 18,B02,083749,Staff,0,14,30,30
1651007754758,MATH 18,B03,083750,Staff,0,14,30,30
1651007754758,MATH 18,B04,083751,Staff,0,13,30,30
1651007760784,MATH 20A,A01,083754,Staff,19,0,40,21
1651007766807,MATH 20B,A01,083756,Staff,0,14,30,30
1651007766807,MATH 20B,A02,083757,Staff,0,11,30,30
1651007772834,MATH 20C,A01,083760,Staff,0,17,30,30
1651007772834,MATH 20C,A02,083761,Staff,0,15,30,30
1651007772834,MATH 20C,B01,083762,Staff,9,0,30,21
1651007772834,MATH 20C,B02,083763,Staff,28,0,30,2
1651007778858,MATH 20D,A01,083765,Staff,3,1,30,27
1651007778858,MATH 20D,A02,083766,Staff,2,0,30,28
1651007778858,MATH 20D,A03,083767,Staff,22,0,30,8
1651007784886,MATH 20E,A01,083771,Staff,2,0,30,28
1651007784886,MATH 20E,A02,083772,Staff,12,0,30,18
1651007784886,MATH 20E,B01,083773,Staff,0,0,30,30
1651007784886,MATH 20E,B02,083774,Staff,1,0,30,29
1651007790917,MATH 103A,A01,083777,Staff,0,17,30,30
1651007790917,MATH 103A,A02,083778,Staff,0,15,30,30
1651007790917,MATH 103A,B01,083779,Staff,0,15,30,30
1651007790917,MATH 103A,B02,083780,Staff,0,14,30,30
1651007796940,MATH 105,A01,085443,Staff,0,23,30,30
1651007802971,MATH 109,A01,083213,Anzaldo; Leesa B,0,7,30,30
1651007802971,MATH 109,A02,083214,Anzaldo; Leesa B,0,7,30,30
1651007802971,MATH 109,B01,083215,Anzaldo; Leesa B,0,8,30,30
1651007802971,MATH 109,B02,083216,Anzaldo; Leesa B,0,7,30,30
1651007808999,MATH 142A,A01,083219,Chow; Bennett,0,14,30,30
1651007808999,MATH 142A,A02,083220,Chow; Bennett,0,15,30,30
1651007808999,MATH 142A,B01,083221,Chow; Bennett,0,16,30,30
1651007808999,MATH 142A,B02,083222,Chow; Bennett,0,14,30,30
1651007815031,MATH 193A,A01,083224,Staff,0,7,30,30
1651007815031,MATH 193A,A02,083225,Staff,0,7,30,30
1651007815031,MATH 193A,A03,083781,Staff,0,7,30,30
1651007815031,MATH 193A,A04,083782,Staff,0,7,30,30
1651007821052,MATH 197,001,091859,McAuley; Julian John,9998,0,9999,1
1651007827117,COGS 9,A01,083615,Staff,0,19,60,60
1651007833143,COGS 11,A01,083617,Boyle; Mary E. T.,15,0,40,25
1651007839185,COGS 13,A01,083071,Staff,0,40,40,40
1651007845209,COGS 14A,A01,092681,Staff,0,40,100,100
1651007851236,COGS 14B,A01,083073,Cheng; Tzu-Han,0,13,50,50
1651007857258,COGS 17,A01,092677,Staff,7,0,75,68
1651007863290,COGS 100,A01,083619,Staff,0,30,60,60
1651007869313,COGS 101A,A01,083621,Davis; Joshua Daniel,0,30,60,60
1651007875336,COGS 101B,A01,091572,Staff,0,6,60,60
1651007881359,COGS 101C,A01,083625,Delgado; Tania,14,0,30,16
1651007887387,COGS 107A,A01,083627,Boyle; Mary E. T.,0,16,60,60
1651007893408,COGS 118A,A01,083075,Staff,0,10,60,60
1651007899434,CSE 3,A50,083646,Miranda; Gregory Joseph,15,0,38,23
1651007899434,CSE 3,A51,083647,Miranda; Gregory Joseph,36,0,37,1
1651007905458,CSE 8A,A50,083650,Miranda; Gregory Joseph,0,31,40,40
1651007911497,CSE 11,A01,083080,Cao; Yingjun,0,97,40,40
1651007917520,CSE 12,A01,083652,Staff,0,24,100,100
1651007923546,CSE 15L,A01,083654,Staff,0,3,50,50
1651007923546,CSE 15L,A02,083655,Staff,0,3,50,50
1651007929570,CSE 20,A01,083657,Staff,47,0,80,33
1651007935593,CSE 30,A01,083084,Eldon; John,1,39,80,79
1651007941616,CSE 100,A01,083659,Cao; Yingjun,0,72,50,50
1651007947639,CSE 134B,A01,083661,Powell; Thomas Allan,1,40,65,64
1651007953663,CSE 140,A01,083663,Staff,0,13,75,75
1651007959693,CSE 140L,A01,083088,Eldon; John,4,0,100,96
1651007965725,CSE 175,A01,083665,Kumar; Rakesh,0,0,25,25
1651007971749,CSE 190,A00,092507,Dubnov; Shlomo,9,0,20,11
1651007977779,ECE 45,A01,083139,Staff,0,7,60,60
1651007983804,ECE 65,A50,083695,Staff,0,7,30,30
1651007989830,ECE 109,A01,091882,Touri; Behrouz,32,0,70,38
1651007995862,ECE 180,A00,083140,Abi Samra; Nicholas Camill,17,0,30,13
1651007995862,ECE 180,B00,083141,Abi Samra; Nicholas Camill,0,0,30,30
1651008001892,MATH 10A,A01,083735,Patchell; Gregory David,1,0,30,29
1651008001892,MATH 10A,A02,083736,Patchell; Gregory David,27,0,30,3
1651008001892,MATH 10A,A03,083737,Patchell; Gregory David,23,0,30,7
1651008007915,MATH 10B,A01,083207,Staff,0,9,30,30
1651008007915,MATH 10B,A02,083208,Staff,0,5,30,30
1651008007915,MATH 10B,B01,083739,Staff,8,0,30,22
1651008007915,MATH 10B,B02,083740,Staff,28,0,30,2
1651008013942,MATH 18,A01,083743,Staff,0,0,30,30
1651008013942,MATH 18,A02,083744,Staff,23,0,30,7
1651008013942,MATH 18,A03,083745,Staff,19,0,30,11
1651008013942,MATH 18,A04,083746,Staff,26,0,30,4
1651008013942,MATH 18,B01,083748,Staff,0,16,30,30
1651008013942,MATH 18,B02,083749,Staff,0,14,30,30
1651008013942,MATH 18,B03,083750,Staff,0,14,30,30
1651008013942,MATH 18,B04,083751,Staff,0,13,30,30
1651008019973,MATH 20A,A01,083754,Staff,19,0,40,21
1651008025995,MATH 20B,A01,083756,Staff,0,14,30,30
1651008025995,MATH 20B,A02,083757,Staff,0,11,30,30
1651008032021,MATH 20C,A01,083760,Staff,0,17,30,30
1651008032021,MATH 20C,A02,083761,Staff,0,15,30,30
1651008032021,MATH 20C,B01,083762,Staff,9,0,30,21
1651008032021,MATH 20C,B02,083763,Staff,28,0,30,2
1651008038044,MATH 20D,A01,083765,Staff,3,1,30,27
1651008038044,MATH 20D,A02,083766,Staff,2,0,30,28
1651008038044,MATH 20D,A03,083767,Staff,22,0,30,8
1651008044067,MATH 20E,A01,083771,Staff,2,0,30,28
1651008044067,MATH 20E,A02,083772,Staff,12,0,30,18
1651008044067,MATH 20E,B01,083773,Staff,0,0,30,30
1651008044067,MATH 20E,B02,083774,Staff,1,0,30,29
1651008050100,MATH 103A,A01,083777,Staff,0,17,30,30
1651008050100,MATH 103A,A02,083778,Staff,0,15,30,30
1651008050100,MATH 103A,B01,083779,Staff,0,15,30,30
1651008050100,MATH 103A,B02,083780,Staff,0,14,30,30
1651008056124,MATH 105,A01,085443,Staff,0,23,30,30
1651008062147,MATH 109,A01,083213,Anzaldo; Leesa B,0,7,30,30
1651008062147,MATH 109,A02,083214,Anzaldo; Leesa B,0,7,30,30
1651008062147,MATH 109,B01,083215,Anzaldo; Leesa B,0,8,30,30
1651008062147,MATH 109,B02,083216,Anzaldo; Leesa B,0,7,30,30
1651008068184,MATH 142A,A01,083219,Chow; Bennett,0,14,30,30
1651008068184,MATH 142A,A02,083220,Chow; Bennett,0,15,30,30
1651008068184,MATH 142A,B01,083221,Chow; Bennett,0,16,30,30
1651008068184,MATH 142A,B02,083222,Chow; Bennett,0,14,30,30
1651008074210,MATH 193A,A01,083224,Staff,0,7,30,30
1651008074210,MATH 193A,A02,083225,Staff,0,7,30,30
1651008074210,MATH 193A,A03,083781,Staff,0,7,30,30
1651008074210,MATH 193A,A04,083782,Staff,0,7,30,30
1651008080231,MATH 197,001,091859,McAuley; Julian John,9998,0,9999,1
1651008086280,COGS 9,A01,083615,Staff,0,19,60,60
1651008092303,COGS 11,A01,083617,Boyle; Mary E. T.,15,0,40,25
1651008098328,COGS 13,A01,083071,Staff,0,40,40,40
1651008104356,COGS 14A,A01,092681,Staff,0,40,100,100
1651008110379,COGS 14B,A01,083073,Cheng; Tzu-Han,0,13,50,50
1651008116400,COGS 17,A01,092677,Staff,7,0,75,68
1651008122422,COGS 100,A01,083619,Staff,0,30,60,60
1651008128468,COGS 101A,A01,083621,Davis; Joshua Daniel,0,30,60,60
1651008134499,COGS 101B,A01,091572,Staff,0,6,60,60
1651008140521,COGS 101C,A01,083625,Delgado; Tania,14,0,30,16
1651008146549,COGS 107A,A01,083627,Boyle; Mary E. T.,0,16,60,60
1651008152571,COGS 118A,A01,083075,Staff,0,10,60,60
1651008158593,CSE 3,A50,083646,Miranda; Gregory Joseph,15,0,38,23
1651008158593,CSE 3,A51,083647,Miranda; Gregory Joseph,36,0,37,1
1651008164624,CSE 8A,A50,083650,Miranda; Gregory Joseph,0,31,40,40
1651008170651,CSE 11,A01,083080,Cao; Yingjun,0,97,40,40
1651008176687,CSE 12,A01,083652,Staff,0,24,100,100
1651008182717,CSE 15L,A01,083654,Staff,0,3,50,50
1651008182717,CSE 15L,A02,083655,Staff,0,3,50,50
1651008188743,CSE 20,A01,083657,Staff,47,0,80,33
1651008194775,CSE 30,A01,083084,Eldon; John,1,39,80,79
1651008200806,CSE 100,A01,083659,Cao; Yingjun,0,72,50,50
1651008206828,CSE 134B,A01,083661,Powell; Thomas Allan,1,40,65,64
1651008212851,CSE 140,A01,083663,Staff,0,13,75,75
1651008218882,CSE 140L,A01,083088,Eldon; John,4,0,100,96
1651008224911,CSE 175,A01,083665,Kumar; Rakesh,0,0,25,25
1651008230944,CSE 190,A00,092507,Dubnov; Shlomo,9,0,20,11
1651008236968,ECE 45,A01,083139,Staff,0,7,60,60
1651008242993,ECE 65,A50,083695,Staff,0,7,30,30
1651008249017,ECE 109,A01,091882,Touri; Behrouz,32,0,70,38
1651008255142,ECE 180,A00,083140,Abi Samra; Nicholas Camill,17,0,30,13
1651008255142,ECE 180,B00,083141,Abi Samra; Nicholas Camill,0,0,30,30
1651008261166,MATH 10A,A01,083735,Patchell; Gregory David,1,0,30,29
1651008261166,MATH 10A,A02,083736,Patchell; Gregory David,27,0,30,3
1651008261166,MATH 10A,A03,083737,Patchell; Gregory David,23,0,30,7
1651008267207,MATH 10B,A01,083207,Staff,0,9,30,30
1651008267207,MATH 10B,A02,083208,Staff,0,5,30,30
1651008267207,MATH 10B,B01,083739,Staff,8,0,30,22
1651008267207,MATH 10B,B02,083740,Staff,28,0,30,2
1651008273234,MATH 18,A01,083743,Staff,0,0,30,30
1651008273234,MATH 18,A02,083744,Staff,23,0,30,7
1651008273234,MATH 18,A03,083745,Staff,19,0,30,11
1651008273234,MATH 18,A04,083746,Staff,26,0,30,4
1651008273234,MATH 18,B01,083748,Staff,0,16,30,30
1651008273234,MATH 18,B02,083749,Staff,0,14,30,30
1651008273234,MATH 18,B03,083750,Staff,0,14,30,30
1651008273234,MATH 18,B04,083751,Staff,0,13,30,30
1651008279257,MATH 20A,A01,083754,Staff,19,0,40,21
1651008285279,MATH 20B,A01,083756,Staff,0,14,30,30
1651008285279,MATH 20B,A02,083757,Staff,0,11,30,30
1651008291313,MATH 20C,A01,083760,Staff,0,17,30,30
1651008291313,MATH 20C,A02,083761,Staff,0,15,30,30
1651008291313,MATH 20C,B01,083762,Staff,9,0,30,21
1651008291313,MATH 20C,B02,083763,Staff,28,0,30,2
1651008297336,MATH 20D,A01,083765,Staff,3,1,30,27
1651008297336,MATH 20D,A02,083766,Staff,2,0,30,28
1651008297336,MATH 20D,A03,083767,Staff,22,0,30,8
1651008303359,MATH 20E,A01,083771,Staff,2,0,30,28
1651008303359,MATH 20E,A02,083772,Staff,12,0,30,18
1651008303359,MATH 20E,B01,083773,Staff,0,0,30,30
1651008303359,MATH 20E,B02,083774,Staff,1,0,30,29
1651008309387,MATH 103A,A01,083777,Staff,0,17,30,30
1651008309387,MATH 103A,A02,083778,Staff,0,15,30,30
1651008309387,MATH 103A,B01,083779,Staff,0,15,30,30
1651008309387,MATH 103A,B02,083780,Staff,0,14,30,30
1651008315445,MATH 105,A01,085443,Staff,0,23,30,30
1651008321468,MATH 109,A01,083213,Anzaldo; Leesa B,0,7,30,30
1651008321468,MATH 109,A02,083214,Anzaldo; Leesa B,0,7,30,30
1651008321468,MATH 109,B01,083215,Anzaldo; Leesa B,0,8,30,30
1651008321468,MATH 109,B02,083216,Anzaldo; Leesa B,0,7,30,30
1651008327493,MATH 142A,A01,083219,Chow; Bennett,0,14,30,30
1651008327493,MATH 142A,A02,083220,Chow; Bennett,0,15,30,30
1651008327493,MATH 142A,B01,083221,Chow; Bennett,0,16,30,30
1651008327493,MATH 142A,B02,083222,Chow; Bennett,0,14,30,30
1651008333517,MATH 193A,A01,083224,Staff,0,7,30,30
1651008333517,MATH 193A,A02,083225,Staff,0,7,30,30
1651008333517,MATH 193A,A03,083781,Staff,0,7,30,30
1651008333517,MATH 193A,A04,083782,Staff,0,7,30,30
1651008339554,MATH 197,001,091859,McAuley; Julian John,9998,0,9999,1
1651008345628,COGS 9,A01,083615,Staff,0,19,60,60
1651008351650,COGS 11,A01,083617,Boyle; Mary E. T.,15,0,40,25
1651008357672,COGS 13,A01,083071,Staff,0,40,40,40
1651008363694,COGS 14A,A01,092681,Staff,0,40,100,100
1651008369716,COGS 14B,A01,083073,Cheng; Tzu-Han,0,13,50,50
1651008375738,COGS 17,A01,092677,Staff,7,0,75,68
1651008381771,COGS 100,A01,083619,Staff,0,30,60,60
1651008387799,COGS 101A,A01,083621,Davis; Joshua Daniel,0,30,60,60
1651008393832,COGS 101B,A01,091572,Staff,0,6,60,60
1651008399865,COGS 101C,A01,083625,Delgado; Tania,14,0,30,16
1651008405887,COGS 107A,A01,083627,Boyle; Mary E. T.,0,16,60,60
1651008411911,COGS 118A,A01,083075,Staff,0,10,60,60
1651008417940,CSE 3,A50,083646,Miranda; Gregory Joseph,15,0,38,23
1651008417940,CSE 3,A51,083647,Miranda; Gregory Joseph,36,0,37,1
1651008423969,CSE 8A,A50,083650,Miranda; Gregory Joseph,0,31,40,40
1651008429997,CSE 11,A01,083080,Cao; Yingjun,0,97,40,40
1651008436020,CSE 12,A01,083652,Staff,0,24,100,100
1651008442048,CSE 15L,A01,083654,Staff,0,3,50,50
1651008442048,CSE 15L,A02,083655,Staff,0,3,50,50
1651008448072,CSE 20,A01,083657,Staff,47,0,80,33
1651008454097,CSE 30,A01,083084,Eldon; John,1,39,80,79
1651008460126,CSE 100,A01,083659,Cao; Yingjun,0,72,50,50
1651008466151,CSE 134B,A01,083661,Powell; Thomas Allan,1,40,65,64
1651008472175,CSE 140,A01,083663,Staff,0,13,75,75
1651008478201,CSE 140L,A01,083088,Eldon; John,4,0,100,96
1651008484226,CSE 175,A01,083665,Kumar; Rakesh,0,0,25,25
1651008490252,CSE 190,A00,092507,Dubnov; Shlomo,9,0,20,11
1651008496277,ECE 45,A01,083139,Staff,0,7,60,60
1651008502301,ECE 65,A50,083695,Staff,0,7,30,30
1651008508337,ECE 109,A01,091882,Touri; Behrouz,32,0,70,38
1651008514363,ECE 180,A00,083140,Abi Samra; Nicholas Camill,17,0,30,13
1651008514363,ECE 180,B00,083141,Abi Samra; Nicholas Camill,0,0,30,30
1651008520399,MATH 10A,A01,083735,Patchell; Gregory David,1,0,30,29
1651008520399,MATH 10A,A02,083736,Patchell; Gregory David,27,0,30,3
1651008520399,MATH 10A,A03,083737,Patchell; Gregory David,23,0,30,7
1651008526424,MATH 10B,A01,083207,Staff,0,9,30,30
1651008526424,MATH 10B,A02,083208,Staff,0,5,30,30
1651008526424,MATH 10B,B01,083739,Staff,8,0,30,22
1651008526424,MATH 10B,B02,083740,Staff,28,0,30,2
1651008532458,MATH 18,A01,083743,Staff,0,0,30,30
1651008532458,MATH 18,A02,083744,Staff,23,0,30,7
1651008532458,MATH 18,A03,083745,Staff,19,0,30,11
1651008532458,MATH 18,A04,083746,Staff,26,0,30,4
1651008532458,MATH 18,B01,083748,Staff,0,16,30,30
1651008532458,MATH 18,B02,083749,Staff,0,14,30,30
1651008532458,MATH 18,B03,083750,Staff,0,14,30,30
1651008532458,MATH 18,B04,083751,Staff,0,13,30,30
1651008538480,MATH 20A,A01,083754,Staff,19,0,40,21
1651008544505,MATH 20B,A01,083756,Staff,0,14,30,30
1651008544505,MATH 20B,A02,083757,Staff,0,11,30,30
1651008550536,MATH 20C,A01,083760,Staff,0,17,30,30
1651008550536,MATH 20C,A02,083761,Staff,0,15,30,30
1651008550536,MATH 20C,B01,083762,Staff,9,0,30,21
1651008550536,MATH 20C,B02,083763,Staff,28,0,30,2
1651008556566,MATH 20D,A01,083765,Staff,3,1,30,27
1651008556566,MATH 20D,A02,083766,Staff,2,0,30,28
1651008556566,MATH 20D,A03,083767,Staff,22,0,30,8
1651008562592,MATH 20E,A01,083771,Staff,2,0,30,28
1651008562592,MATH 20E,A02,083772,Staff,12,0,30,18
1651008562592,MATH 20E,B01,083773,Staff,0,0,30,30
1651008562592,MATH 20E,B02,083774,Staff,1,0,30,29
1651008568620,MATH 103A,A01,083777,Staff,0,17,30,30
1651008568620,MATH 103A,A02,083778,Staff,0,15,30,30
1651008568620,MATH 103A,B01,083779,Staff,0,15,30,30
1651008568620,MATH 103A,B02,083780,Staff,0,14,30,30
1651008574646,MATH 105,A01,085443,Staff,0,23,30,30
1651008580673,MATH 109,A01,083213,Anzaldo; Leesa B,0,7,30,30
1651008580673,MATH 109,A02,083214,Anzaldo; Leesa B,0,7,30,30
1651008580673,MATH 109,B01,083215,Anzaldo; Leesa B,0,8,30,30
1651008580673,MATH 109,B02,083216,Anzaldo; Leesa B,0,7,30,30
1651008586700,MATH 142A,A01,083219,Chow; Bennett,0,14,30,30
1651008586700,MATH 142A,A02,083220,Chow; Bennett,0,15,30,30
1651008586700,MATH 142A,B01,083221,Chow; Bennett,0,16,30,30
1651008586700,MATH 142A,B02,083222,Chow; Bennett,0,14,30,30
1651008592725,MATH 193A,A01,083224,Staff,0,7,30,30
1651008592725,MATH 193A,A02,083225,Staff,0,7,30,30
1651008592725,MATH 193A,A03,083781,Staff,0,7,30,30
1651008592725,MATH 193A,A04,083782,Staff,0,7,30,30
1651008598758,MATH 197,001,091859,McAuley; Julian John,9998,0,9999,1
1651008604823,COGS 9,A01,083615,Staff,0,19,60,60
1651008610849,COGS 11,A01,083617,Boyle; Mary E. T.,15,0,40,25
1651008616883,COGS 13,A01,083071,Staff,0,40,40,40
1651008622907,COGS 14A,A01,092681,Staff,0,40,100,100
1651008628933,COGS 14B,A01,083073,Cheng; Tzu-Han,0,13,50,50
1651008634956,COGS 17,A01,092677,Staff,7,0,75,68
1651008640979,COGS 100,A01,083619,Staff,0,30,60,60
1651008647005,COGS 101A,A01,083621,Davis; Joshua Daniel,0,30,60,60
1651008653029,COGS 101B,A01,091572,Staff,0,6,60,60
1651008659051,COGS 101C,A01,083625,Delgado; Tania,14,0,30,16
1651008665073,COGS 107A,A01,083627,Boyle; Mary E. T.,0,16,60,60
1651008671096,COGS 118A,A01,083075,Staff,0,10,60,60
1651008677129,CSE 3,A50,083646,Miranda; Gregory Joseph,15,0,38,23
1651008677129,CSE 3,A51,083647,Miranda; Gregory Joseph,36,0,37,1
1651008683153,CSE 8A,A50,083650,Miranda; Gregory Joseph,0,31,40,40
1651008689177,CSE 11,A01,083080,Cao; Yingjun,0,97,40,40
1651008695203,CSE 12,A01,083652,Staff,0,24,100,100
1651008701229,CSE 15L,A01,083654,Staff,0,3,50,50
1651008701229,CSE 15L,A02,083655,Staff,0,3,50,50
1651008707254,CSE 20,A01,083657,Staff,47,0,80,33
1651008713280,CSE 30,A01,083084,Eldon; John,1,39,80,79
1651008719303,CSE 100,A01,083659,Cao; Yingjun,0,72,50,50
1651008725327,CSE 134B,A01,083661,Powell; Thomas Allan,1,40,65,64
1651008731356,CSE 140,A01,083663,Staff,0,13,75,75
1651008737386,CSE 140L,A01,083088,Eldon; John,4,0,100,96
1651008743411,CSE 175,A01,083665,Kumar; Rakesh,0,0,25,25
1651008749434,CSE 190,A00,092507,Dubnov; Shlomo,9,0,20,11
1651008755461,ECE 45,A01,083139,Staff,0,7,60,60
1651008761482,ECE 65,A50,083695,Staff,0,7,30,30
1651008767506,ECE 109,A01,091882,Touri; Behrouz,32,0,70,38
1651008773529,ECE 180,A00,083140,Abi Samra; Nicholas Camill,17,0,30,13
1651008773529,ECE 180,B00,083141,Abi Samra; Nicholas Camill,0,0,30,30
1651008779561,MATH 10A,A01,083735,Patchell; Gregory David,1,0,30,29
1651008779561,MATH 10A,A02,083736,Patchell; Gregory David,27,0,30,3
1651008779561,MATH 10A,A03,083737,Patchell; Gregory David,23,0,30,7
1651008785585,MATH 10B,A01,083207,Staff,0,9,30,30
1651008785585,MATH 10B,A02,083208,Staff,0,5,30,30
1651008785585,MATH 10B,B01,083739,Staff,8,0,30,22
1651008785585,MATH 10B,B02,083740,Staff,28,0,30,2
1651008791609,MATH 18,A01,083743,Staff,0,0,30,30
1651008791609,MATH 18,A02,083744,Staff,23,0,30,7
1651008791609,MATH 18,A03,083745,Staff,19,0,30,11
1651008791609,MATH 18,A04,083746,Staff,26,0,30,4
1651008791609,MATH 18,B01,083748,Staff,0,16,30,30
1651008791609,MATH 18,B02,083749,Staff,0,14,30,30
1651008791609,MATH 18,B03,083750,Staff,0,14,30,30
1651008791609,MATH 18,B04,083751,Staff,0,13,30,30
1651008797635,MATH 20A,A01,083754,Staff,19,0,40,21
1651008803662,MATH 20B,A01,083756,Staff,0,14,30,30
1651008803662,MATH 20B,A02,083757,Staff,0,11,30,30
1651008809685,MATH 20C,A01,083760,Staff,0,17,30,30
1651008809685,MATH 20C,A02,083761,Staff,0,15,30,30
1651008809685,MATH 20C,B01,083762,Staff,9,0,30,21
1651008809685,MATH 20C,B02,083763,Staff,28,0,30,2
1651008815712,MATH 20D,A01,083765,Staff,3,1,30,27
1651008815712,MATH 20D,A02,083766,Staff,2,0,30,28
1651008815712,MATH 20D,A03,083767,Staff,22,0,30,8
1651008821738,MATH 20E,A01,083771,Staff,2,0,30,28
1651008821738,MATH 20E,A02,083772,Staff,12,0,30,18
1651008821738,MATH 20E,B01,083773,Staff,0,0,30,30
1651008821738,MATH 20E,B02,083774,Staff,1,0,30,29
1651008827766,MATH 103A,A01,083777,Staff,0,17,30,30
1651008827766,MATH 103A,A02,083778,Staff,0,15,30,30
1651008827766,MATH 103A,B01,083779,Staff,0,15,30,30
1651008827766,MATH 103A,B02,083780,Staff,0,14,30,30
1651008833792,MATH 105,A01,085443,Staff,0,23,30,30
1651008839816,MATH 109,A01,083213,Anzaldo; Leesa B,0,7,30,30
1651008839816,MATH 109,A02,083214,Anzaldo; Leesa B,0,7,30,30
1651008839816,MATH 109,B01,083215,Anzaldo; Leesa B,0,8,30,30
1651008839816,MATH 109,B02,083216,Anzaldo; Leesa B,0,7,30,30
1651008845839,MATH 142A,A01,083219,Chow; Bennett,0,14,30,30
1651008845839,MATH 142A,A02,083220,Chow; Bennett,0,15,30,30
1651008845839,MATH 142A,B01,083221,Chow; Bennett,0,16,30,30
1651008845839,MATH 142A,B02,083222,Chow; Bennett,0,14,30,30
1651008851998,MATH 193A,A01,083224,Staff,0,7,30,30
1651008851998,MATH 193A,A02,083225,Staff,0,7,30,30
1651008851998,MATH 193A,A03,083781,Staff,0,7,30,30
1651008851998,MATH 193A,A04,083782,Staff,0,7,30,30
1651008858020,MATH 197,001,091859,McAuley; Julian John,9998,0,9999,1
1651008864076,COGS 9,A01,083615,Staff,0,19,60,60
1651008870100,COGS 11,A01,083617,Boyle; Mary E. T.,15,0,40,25
1651008876125,COGS 13,A01,083071,Staff,0,40,40,40
1651008882148,COGS 14A,A01,092681,Staff,0,40,100,100
1651008888173,COGS 14B,A01,083073,Cheng; Tzu-Han,0,13,50,50
1651008894198,COGS 17,A01,092677,Staff,7,0,75,68
1651008900219,COGS 100,A01,083619,Staff,0,30,60,60
1651008906245,COGS 101A,A01,083621,Davis; Joshua Daniel,0,30,60,60
1651008912272,COGS 101B,A01,091572,Staff,0,6,60,60
1651008918365,COGS 101C,A01,083625,Delgado; Tania,14,0,30,16
1651008924391,COGS 107A,A01,083627,Boyle; Mary E. T.,0,16,60,60
1651008930422,COGS 118A,A01,083075,Staff,0,10,60,60
1651008936445,CSE 3,A50,083646,Miranda; Gregory Joseph,15,0,38,23
1651008936445,CSE 3,A51,083647,Miranda; Gregory Joseph,36,0,37,1
1651008942473,CSE 8A,A50,083650,Miranda; Gregory Joseph,0,31,40,40
1651008948495,CSE 11,A01,083080,Cao; Yingjun,0,97,40,40
1651008954525,CSE 12,A01,083652,Staff,0,24,100,100
1651008960556,CSE 15L,A01,083654,Staff,0,3,50,50
1651008960556,CSE 15L,A02,083655,Staff,0,3,50,50
1651008966579,CSE 20,A01,083657,Staff,47,0,80,33
1651008972612,CSE 30,A01,083084,Eldon; John,1,39,80,79
1651008978647,CSE 100,A01,083659,Cao; Yingjun,0,72,50,50
1651008984675,CSE 134B,A01,083661,Powell; Thomas Allan,1,40,65,64
1651008990702,CSE 140,A01,083663,Staff,0,13,75,75
1651008996727,CSE 140L,A01,083088,Eldon; John,4,0,100,96
1651009002751,CSE 175,A01,083665,Kumar; Rakesh,0,0,25,25
1651009008776,CSE 190,A00,092507,Dubnov; Shlomo,9,0,20,11
1651009014807,ECE 45,A01,083139,Staff,0,7,60,60
1651009020840,ECE 65,A50,083695,Staff,0,7,30,30
1651009026863,ECE 109,A01,091882,Touri; Behrouz,32,0,70,38
1651009032895,ECE 180,A00,083140,Abi Samra; Nicholas Camill,17,0,30,13
1651009032895,ECE 180,B00,083141,Abi Samra; Nicholas Camill,0,0,30,30
1651009038923,MATH 10A,A01,083735,Patchell; Gregory David,1,0,30,29
1651009038923,MATH 10A,A02,083736,Patchell; Gregory David,27,0,30,3
1651009038923,MATH 10A,A03,083737,Patchell; Gregory David,23,0,30,7
1651009044951,MATH 10B,A01,083207,Staff,0,9,30,30
1651009044951,MATH 10B,A02,083208,Staff,0,5,30,30
1651009044951,MATH 10B,B01,083739,Staff,8,0,30,22
1651009044951,MATH 10B,B02,083740,Staff,28,0,30,2
1651009050986,MATH 18,A01,083743,Staff,0,0,30,30
1651009050986,MATH 18,A02,083744,Staff,23,0,30,7
1651009050986,MATH 18,A03,083745,Staff,19,0,30,11
1651009050986,MATH 18,A04,083746,Staff,26,0,30,4
1651009050986,MATH 18,B01,083748,Staff,0,16,30,30
1651009050986,MATH 18,B02,083749,Staff,0,14,30,30
1651009050986,MATH 18,B03,083750,Staff,0,14,30,30
1651009050986,MATH 18,B04,083751,Staff,0,13,30,30
1651009057008,MATH 20A,A01,083754,Staff,19,0,40,21
1651009063030,MATH 20B,A01,083756,Staff,0,14,30,30
1651009063030,MATH 20B,A02,083757,Staff,0,11,30,30
1651009069060,MATH 20C,A01,083760,Staff,0,17,30,30
1651009069060,MATH 20C,A02,083761,Staff,0,15,30,30
1651009069060,MATH 20C,B01,083762,Staff,9,0,30,21
1651009069060,MATH 20C,B02,083763,Staff,28,0,30,2
1651009075088,MATH 20D,A01,083765,Staff,3,1,30,27
1651009075088,MATH 20D,A02,083766,Staff,2,0,30,28
1651009075088,MATH 20D,A03,083767,Staff,22,0,30,8
1651009081113,MATH 20E,A01,083771,Staff,2,0,30,28
1651009081113,MATH 20E,A02,083772,Staff,12,0,30,18
1651009081113,MATH 20E,B01,083773,Staff,0,0,30,30
1651009081113,MATH 20E,B02,083774,Staff,1,0,30,29
1651009087147,MATH 103A,A01,083777,Staff,0,17,30,30
1651009087147,MATH 103A,A02,083778,Staff,0,15,30,30
1651009087147,MATH 103A,B01,083779,Staff,0,15,30,30
1651009087147,MATH 103A,B02,083780,Staff,0,14,30,30
1651009093170,MATH 105,A01,085443,Staff,0,23,30,30
1651009099206,MATH 109,A01,083213,Anzaldo; Leesa B,0,7,30,30
1651009099206,MATH 109,A02,083214,Anzaldo; Leesa B,0,7,30,30
1651009099206,MATH 109,B01,083215,Anzaldo; Leesa B,0,8,30,30
1651009099206,MATH 109,B02,083216,Anzaldo; Leesa B,0,7,30,30
1651009105229,MATH 142A,A01,083219,Chow; Bennett,0,14,30,30
1651009105229,MATH 142A,A02,083220,Chow; Bennett,0,15,30,30
1651009105229,MATH 142A,B01,083221,Chow; Bennett,0,16,30,30
1651009105229,MATH 142A,B02,083222,Chow; Bennett,0,14,30,30
1651009111254,MATH 193A,A01,083224,Staff,0,7,30,30
1651009111254,MATH 193A,A02,083225,Staff,0,7,30,30
1651009111254,MATH 193A,A03,083781,Staff,0,7,30,30
1651009111254,MATH 193A,A04,083782,Staff,0,7,30,30
1651009117278,MATH 197,001,091859,McAuley; Julian John,9998,0,9999,1
1651009123336,COGS 9,A01,083615,Staff,0,19,60,60
1651009129373,COGS 11,A01,083617,Boyle; Mary E. T.,15,0,40,25
1651009135399,COGS 13,A01,083071,Staff,0,40,40,40
1651009141421,COGS 14A,A01,092681,Staff,0,40,100,100
1651009147450,COGS 14B,A01,083073,Cheng; Tzu-Han,0,13,50,50
1651009153475,COGS 17,A01,092677,Staff,7,0,75,68
1651009159509,COGS 100,A01,083619,Staff,0,30,60,60
1651009165536,COGS 101A,A01,083621,Davis; Joshua Daniel,0,30,60,60
1651009171571,COGS 101B,A01,091572,Staff,0,6,60,60
1651009177593,COGS 101C,A01,083625,Delgado; Tania,14,0,30,16
1651009183618,COGS 107A,A01,083627,Boyle; Mary E. T.,0,16,60,60
1651009189641,COGS 118A,A01,083075,Staff,0,10,60,60
1651009195675,CSE 3,A50,083646,Miranda; Gregory Joseph,15,0,38,23
1651009195675,CSE 3,A51,083647,Miranda; Gregory Joseph,36,0,37,1
1651009201702,CSE 8A,A50,083650,Miranda; Gregory Joseph,0,31,40,40
1651009207730,CSE 11,A01,083080,Cao; Yingjun,0,97,40,40
1651009213757,CSE 12,A01,083652,Staff,0,24,100,100
1651009219783,CSE 15L,A01,083654,Staff,0,3,50,50
1651009219783,CSE 15L,A02,083655,Staff,0,3,50,50
1651009225812,CSE 20,A01,083657,Staff,47,0,80,33
1651009231838,CSE 30,A01,083084,Eldon; John,1,39,80,79
1651009237873,CSE 100,A01,083659,Cao; Yingjun,0,72,50,50
1651009243914,CSE 134B,A01,083661,Powell; Thomas Allan,1,40,65,64
1651009249938,CSE 140,A01,083663,Staff,0,13,75,75
1651009255962,CSE 140L,A01,083088,Eldon; John,4,0,100,96
1651009261985,CSE 175,A01,083665,Kumar; Rakesh,0,0,25,25
1651009268011,CSE 190,A00,092507,Dubnov; Shlomo,9,0,20,11
1651009274037,ECE 45,A01,083139,Staff,0,7,60,60
1651009280060,ECE 65,A50,083695,Staff,0,7,30,30
1651009286084,ECE 109,A01,091882,Touri; Behrouz,32,0,70,38
1651009292115,ECE 180,A00,083140,Abi Samra; Nicholas Camill,17,0,30,13
1651009292115,ECE 180,B00,083141,Abi Samra; Nicholas Camill,0,0,30,30
1651009298150,MATH 10A,A01,083735,Patchell; Gregory David,1,0,30,29
1651009298150,MATH 10A,A02,083736,Patchell; Gregory David,27,0,30,3
1651009298150,MATH 10A,A03,083737,Patchell; Gregory David,23,0,30,7
1651009304180,MATH 10B,A01,083207,Staff,0,9,30,30
1651009304180,MATH 10B,A02,083208,Staff,0,5,30,30
1651009304180,MATH 10B,B01,083739,Staff,8,0,30,22
1651009304180,MATH 10B,B02,083740,Staff,28,0,30,2
1651009310214,MATH 18,A01,083743,Staff,0,0,30,30
1651009310214,MATH 18,A02,083744,Staff,23,0,30,7
1651009310214,MATH 18,A03,083745,Staff,19,0,30,11
1651009310214,MATH 18,A04,083746,Staff,26,0,30,4
1651009310214,MATH 18,B01,083748,Staff,0,16,30,30
1651009310214,MATH 18,B02,083749,Staff,0,14,30,30
1651009310214,MATH 18,B03,083750,Staff,0,14,30,30
1651009310214,MATH 18,B04,083751,Staff,0,13,30,30
1651009316252,MATH 20A,A01,083754,Staff,19,0,40,21
1651009322276,MATH 20B,A01,083756,Staff,0,14,30,30
1651009322276,MATH 20B,A02,083757,Staff,0,11,30,30
1651009328302,MATH 20C,A01,083760,Staff,0,17,30,30
1651009328302,MATH 20C,A02,083761,Staff,0,15,30,30
1651009328302,MATH 20C,B01,083762,Staff,9,0,30,21
1651009328302,MATH 20C,B02,083763,Staff,28,0,30,2
1651009334334,MATH 20D,A01,083765,Staff,3,1,30,27
1651009334334,MATH 20D,A02,083766,Staff,2,0,30,28
1651009334334,MATH 20D,A03,083767,Staff,22,0,30,8
1651009340357,MATH 20E,A01,083771,Staff,2,0,30,28
1651009340357,MATH 20E,A02,083772,Staff,12,0,30,18
1651009340357,MATH 20E,B01,083773,Staff,0,0,30,30
1651009340357,MATH 20E,B02,083774,Staff,1,0,30,29
1651009346380,MATH 103A,A01,083777,Staff,0,17,30,30
1651009346380,MATH 103A,A02,083778,Staff,0,15,30,30
1651009346380,MATH 103A,B01,083779,Staff,0,15,30,30
1651009346380,MATH 103A,B02,083780,Staff,0,14,30,30
1651009352402,MATH 105,A01,085443,Staff,0,23,30,30
1651009358424,MATH 109,A01,083213,Anzaldo; Leesa B,0,7,30,30
1651009358424,MATH 109,A02,083214,Anzaldo; Leesa B,0,7,30,30
1651009358424,MATH 109,B01,083215,Anzaldo; Leesa B,0,8,30,30
1651009358424,MATH 109,B02,083216,Anzaldo; Leesa B,0,7,30,30
1651009364458,MATH 142A,A01,083219,Chow; Bennett,0,14,30,30
1651009364458,MATH 142A,A02,083220,Chow; Bennett,0,15,30,30
1651009364458,MATH 142A,B01,083221,Chow; Bennett,0,16,30,30
1651009364458,MATH 142A,B02,083222,Chow; Bennett,0,14,30,30
1651009370483,MATH 193A,A01,083224,Staff,0,7,30,30
1651009370483,MATH 193A,A02,083225,Staff,0,7,30,30
1651009370483,MATH 193A,A03,083781,Staff,0,7,30,30
1651009370483,MATH 193A,A04,083782,Staff,0,7,30,30
1651009376512,MATH 197,001,091859,McAuley; Julian John,9998,0,9999,1
1651009382567,COGS 9,A01,083615,Staff,0,19,60,60
1651009388589,COGS 11,A01,083617,Boyle; Mary E. T.,15,0,40,25
1651009394622,COGS 13,A01,083071,Staff,0,40,40,40
1651009400645,COGS 14A,A01,092681,Staff,0,40,100,100
1651009406671,COGS 14B,A01,083073,Cheng; Tzu-Han,0,13,50,50
1651009412695,COGS 17,A01,092677,Staff,7,0,75,68
1651009418721,COGS 100,A01,083619,Staff,0,30,60,60
1651009424755,COGS 101A,A01,083621,Davis; Joshua Daniel,0,30,60,60
1651009430785,COGS 101B,A01,091572,Staff,0,6,60,60
1651009436815,COGS 101C,A01,083625,Delgado; Tania,14,0,30,16
1651009442940,COGS 107A,A01,083627,Boyle; Mary E. T.,0,16,60,60
1651009448962,COGS 118A,A01,083075,Staff,0,10,60,60
1651009454996,CSE 3,A50,083646,Miranda; Gregory Joseph,15,0,38,23
1651009454996,CSE 3,A51,083647,Miranda; Gregory Joseph,36,0,37,1
1651009461022,CSE 8A,A50,083650,Miranda; Gregory Joseph,0,31,40,40
1651009467047,CSE 11,A01,083080,Cao; Yingjun,0,97,40,40
1651009473073,CSE 12,A01,083652,Staff,0,24,100,100
1651009479108,CSE 15L,A01,083654,Staff,0,3,50,50
1651009479108,CSE 15L,A02,083655,Staff,0,3,50,50
1651009485131,CSE 20,A01,083657,Staff,47,0,80,33
1651009491157,CSE 30,A01,083084,Eldon; John,1,39,80,79
1651009497183,CSE 100,A01,083659,Cao; Yingjun,0,72,50,50
1651009503208,CSE 134B,A01,083661,Powell; Thomas Allan,1,40,65,64
1651009509231,CSE 140,A01,083663,Staff,0,13,75,75
1651009515264,CSE 140L,A01,083088,Eldon; John,4,0,100,96
1651009521301,CSE 175,A01,083665,Kumar; Rakesh,0,0,25,25
1651009527323,CSE 190,A00,092507,Dubnov; Shlomo,9,0,20,11
1651009533350,ECE 45,A01,083139,Staff,0,7,60,60
1651009539377,ECE 65,A50,083695,Staff,0,7,30,30
1651009545403,ECE 109,A01,091882,Touri; Behrouz,32,0,70,38
1651009551428,ECE 180,A00,083140,Abi Samra; Nicholas Camill,17,0,30,13
1651009551428,ECE 180,B00,083141,Abi Samra; Nicholas Camill,0,0,30,30
1651009557455,MATH 10A,A01,083735,Patchell; Gregory David,1,0,30,29
1651009557455,MATH 10A,A02,083736,Patchell; Gregory David,27,0,30,3
1651009557455,MATH 10A,A03,083737,Patchell; Gregory David,23,0,30,7
1651009563479,MATH 10B,A01,083207,Staff,0,9,30,30
1651009563479,MATH 10B,A02,083208,Staff,0,5,30,30
1651009563479,MATH 10B,B01,083739,Staff,8,0,30,22
1651009563479,MATH 10B,B02,083740,Staff,28,0,30,2
1651009569502,MATH 18,A01,083743,Staff,0,0,30,30
1651009569502,MATH 18,A02,083744,Staff,23,0,30,7
1651009569502,MATH 18,A03,083745,Staff,19,0,30,11
1651009569502,MATH 18,A04,083746,Staff,26,0,30,4
1651009569502,MATH 18,B01,083748,Staff,0,16,30,30
1651009569502,MATH 18,B02,083749,Staff,0,14,30,30
1651009569502,MATH 18,B03,083750,Staff,0,14,30,30
1651009569502,MATH 18,B04,083751,Staff,0,13,30,30
1651009575528,MATH 20A,A01,083754,Staff,19,0,40,21
1651009581566,MATH 20B,A01,083756,Staff,0,14,30,30
1651009581566,MATH 20B,A02,083757,Staff,0,11,30,30
1651009587590,MATH 20C,A01,083760,Staff,0,17,30,30
1651009587590,MATH 20C,A02,083761,Staff,0,15,30,30
1651009587590,MATH 20C,B01,083762,Staff,9,0,30,21
1651009587590,MATH 20C,B02,083763,Staff,28,0,30,2
1651009593613,MATH 20D,A01,083765,Staff,3,1,30,27
1651009593613,MATH 20D,A02,083766,Staff,2,0,30,28
1651009593613,MATH 20D,A03,083767,Staff,22,0,30,8
1651009599635,MATH 20E,A01,083771,Staff,2,0,30,28
1651009599635,MATH 20E,A02,083772,Staff,12,0,30,18
1651009599635,MATH 20E,B01,083773,Staff,0,0,30,30
1651009599635,MATH 20E,B02,083774,Staff,1,0,30,29
1651009605659,MATH 103A,A01,083777,Staff,0,17,30,30
1651009605659,MATH 103A,A02,083778,Staff,0,15,30,30
1651009605659,MATH 103A,B01,083779,Staff,0,15,30,30
1651009605659,MATH 103A,B02,083780,Staff,0,14,30,30
1651009611682,MATH 105,A01,085443,Staff,0,23,30,30
1651009617714,MATH 109,A01,083213,Anzaldo; Leesa B,0,7,30,30
1651009617714,MATH 109,A02,083214,Anzaldo; Leesa B,0,7,30,30
1651009617714,MATH 109,B01,083215,Anzaldo; Leesa B,0,8,30,30
1651009617714,MATH 109,B02,083216,Anzaldo; Leesa B,0,7,30,30
1651009623743,MATH 142A,A01,083219,Chow; Bennett,0,14,30,30
1651009623743,MATH 142A,A02,083220,Chow; Bennett,0,15,30,30
1651009623743,MATH 142A,B01,083221,Chow; Bennett,0,16,30,30
1651009623743,MATH 142A,B02,083222,Chow; Bennett,0,14,30,30
1651009629765,MATH 193A,A01,083224,Staff,0,7,30,30
1651009629765,MATH 193A,A02,083225,Staff,0,7,30,30
1651009629765,MATH 193A,A03,083781,Staff,0,7,30,30
1651009629765,MATH 193A,A04,083782,Staff,0,7,30,30
1651009635789,MATH 197,001,091859,McAuley; Julian John,9998,0,9999,1
1651009641848,COGS 9,A01,083615,Staff,0,19,60,60
1651009647872,COGS 11,A01,083617,Boyle; Mary E. T.,15,0,40,25
1651009653895,COGS 13,A01,083071,Staff,0,40,40,40
1651009659921,COGS 14A,A01,092681,Staff,0,40,100,100
1651009665944,COGS 14B,A01,083073,Cheng; Tzu-Han,0,13,50,50
1651009671971,COGS 17,A01,092677,Staff,7,0,75,68
1651009677997,COGS 100,A01,083619,Staff,0,30,60,60
1651009684026,COGS 101A,A01,083621,Davis; Joshua Daniel,0,30,60,60
1651009690049,COGS 101B,A01,091572,Staff,0,6,60,60
1651009696076,COGS 101C,A01,083625,Delgado; Tania,14,0,30,16
1651009702100,COGS 107A,A01,083627,Boyle; Mary E. T.,0,16,60,60
1651009708138,COGS 118A,A01,083075,Staff,0,10,60,60
1651009714160,CSE 3,A50,083646,Miranda; Gregory Joseph,15,0,38,23
1651009714160,CSE 3,A51,083647,Miranda; Gregory Joseph,36,0,37,1
1651009720184,CSE 8A,A50,083650,Miranda; Gregory Joseph,0,31,40,40
1651009726212,CSE 11,A01,083080,Cao; Yingjun,0,97,40,40
1651009732233,CSE 12,A01,083652,Staff,0,24,100,100
1651009738258,CSE 15L,A01,083654,Staff,0,3,50,50
1651009738258,CSE 15L,A02,083655,Staff,0,3,50,50
1651009744294,CSE 20,A01,083657,Staff,47,0,80,33
1651009750315,CSE 30,A01,083084,Eldon; John,1,39,80,79
1651009756347,CSE 100,A01,083659,Cao; Yingjun,0,72,50,50
1651009762382,CSE 134B,A01,083661,Powell; Thomas Allan,1,39,65,64
1651009768410,CSE 140,A01,083663,Staff,0,13,75,75
1651009774437,CSE 140L,A01,083088,Eldon; John,4,0,100,96
1651009780466,CSE 175,A01,083665,Kumar; Rakesh,0,0,25,25
1651009786492,CSE 190,A00,092507,Dubnov; Shlomo,9,0,20,11
1651009792517,ECE 45,A01,083139,Staff,0,7,60,60
1651009798541,ECE 65,A50,083695,Staff,0,7,30,30
1651009804565,ECE 109,A01,091882,Touri; Behrouz,32,0,70,38
1651009810599,ECE 180,A00,083140,Abi Samra; Nicholas Camill,17,0,30,13
1651009810599,ECE 180,B00,083141,Abi Samra; Nicholas Camill,0,0,30,30
1651009816627,MATH 10A,A01,083735,Patchell; Gregory David,1,0,30,29
1651009816627,MATH 10A,A02,083736,Patchell; Gregory David,27,0,30,3
1651009816627,MATH 10A,A03,083737,Patchell; Gregory David,23,0,30,7
1651009822669,MATH 10B,A01,083207,Staff,0,9,30,30
1651009822669,MATH 10B,A02,083208,Staff,0,5,30,30
1651009822669,MATH 10B,B01,083739,Staff,8,0,30,22
1651009822669,MATH 10B,B02,083740,Staff,28,0,30,2
1651009828694,MATH 18,A01,083743,Staff,0,0,30,30
1651009828694,MATH 18,A02,083744,Staff,23,0,30,7
1651009828694,MATH 18,A03,083745,Staff,19,0,30,11
1651009828694,MATH 18,A04,083746,Staff,26,0,30,4
1651009828694,MATH 18,B01,083748,Staff,0,16,30,30
1651009828694,MATH 18,B02,083749,Staff,0,14,30,30
1651009828694,MATH 18,B03,083750,Staff,0,14,30,30
1651009828694,MATH 18,B04,083751,Staff,0,13,30,30
1651009834716,MATH 20A,A01,083754,Staff,19,0,40,21
1651009840739,MATH 20B,A01,083756,Staff,0,14,30,30
1651009840739,MATH 20B,A02,083757,Staff,0,11,30,30
1651009846768,MATH 20C,A01,083760,Staff,0,17,30,30
1651009846768,MATH 20C,A02,083761,Staff,0,15,30,30
1651009846768,MATH 20C,B01,083762,Staff,9,0,30,21
1651009846768,MATH 20C,B02,083763,Staff,28,0,30,2
1651009852790,MATH 20D,A01,083765,Staff,3,1,30,27
1651009852790,MATH 20D,A02,083766,Staff,2,0,30,28
1651009852790,MATH 20D,A03,083767,Staff,22,0,30,8
1651009858816,MATH 20E,A01,083771,Staff,2,0,30,28
1651009858816,MATH 20E,A02,083772,Staff,12,0,30,18
1651009858816,MATH 20E,B01,083773,Staff,0,0,30,30
1651009858816,MATH 20E,B02,083774,Staff,1,0,30,29
1651009864839,MATH 103A,A01,083777,Staff,0,17,30,30
1651009864839,MATH 103A,A02,083778,Staff,0,15,30,30
1651009864839,MATH 103A,B01,083779,Staff,0,15,30,30
1651009864839,MATH 103A,B02,083780,Staff,0,14,30,30
1651009870868,MATH 105,A01,085443,Staff,0,23,30,30
1651009876896,MATH 109,A01,083213,Anzaldo; Leesa B,0,7,30,30
1651009876896,MATH 109,A02,083214,Anzaldo; Leesa B,0,7,30,30
1651009876896,MATH 109,B01,083215,Anzaldo; Leesa B,0,8,30,30
1651009876896,MATH 109,B02,083216,Anzaldo; Leesa B,0,7,30,30
1651009882921,MATH 142A,A01,083219,Chow; Bennett,0,14,30,30
1651009882921,MATH 142A,A02,083220,Chow; Bennett,0,15,30,30
1651009882921,MATH 142A,B01,083221,Chow; Bennett,0,16,30,30
1651009882921,MATH 142A,B02,083222,Chow; Bennett,0,14,30,30
1651009888944,MATH 193A,A01,083224,Staff,0,7,30,30
1651009888944,MATH 193A,A02,083225,Staff,0,7,30,30
1651009888944,MATH 193A,A03,083781,Staff,0,7,30,30
1651009888944,MATH 193A,A04,083782,Staff,0,7,30,30
1651009894966,MATH 197,001,091859,McAuley; Julian John,9998,0,9999,1
1651009901024,COGS 9,A01,083615,Staff,0,19,60,60
1651009907049,COGS 11,A01,083617,Boyle; Mary E. T.,15,0,40,25
1651009913074,COGS 13,A01,083071,Staff,0,40,40,40
1651009919105,COGS 14A,A01,092681,Staff,0,40,100,100
1651009925132,COGS 14B,A01,083073,Cheng; Tzu-Han,0,13,50,50
1651009931154,COGS 17,A01,092677,Staff,7,0,75,68
1651009937180,COGS 100,A01,083619,Staff,0,30,60,60
1651009943203,COGS 101A,A01,083621,Davis; Joshua Daniel,0,30,60,60
1651009949225,COGS 101B,A01,091572,Staff,0,6,60,60
1651009955249,COGS 101C,A01,083625,Delgado; Tania,14,0,30,16
1651009961272,COGS 107A,A01,083627,Boyle; Mary E. T.,0,16,60,60
1651009967296,COGS 118A,A01,083075,Staff,0,10,60,60
1651009973321,CSE 3,A50,083646,Miranda; Gregory Joseph,15,0,38,23
1651009973321,CSE 3,A51,083647,Miranda; Gregory Joseph,36,0,37,1
1651009979348,CSE 8A,A50,083650,Miranda; Gregory Joseph,0,31,40,40
1651009985375,CSE 11,A01,083080,Cao; Yingjun,0,97,40,40
1651009991403,CSE 12,A01,083652,Staff,0,24,100,100
1651009997428,CSE 15L,A01,083654,Staff,0,3,50,50
1651009997428,CSE 15L,A02,083655,Staff,0,3,50,50
1651010003454,CSE 20,A01,083657,Staff,47,0,80,33
1651010009482,CSE 30,A01,083084,Eldon; John,1,39,80,79
1651010015507,CSE 100,A01,083659,Cao; Yingjun,0,72,50,50
1651010021529,CSE 134B,A01,083661,Powell; Thomas Allan,1,39,65,64
1651010027551,CSE 140,A01,083663,Staff,0,13,75,75
1651010033573,CSE 140L,A01,083088,Eldon; John,4,0,100,96
1651010039684,CSE 175,A01,083665,Kumar; Rakesh,0,0,25,25
1651010045710,CSE 190,A00,092507,Dubnov; Shlomo,9,0,20,11
1651010051732,ECE 45,A01,083139,Staff,0,7,60,60
1651010057755,ECE 65,A50,083695,Staff,0,7,30,30
1651010063786,ECE 109,A01,091882,Touri; Behrouz,32,0,70,38
1651010069814,ECE 180,A00,083140,Abi Samra; Nicholas Camill,17,0,30,13
1651010069814,ECE 180,B00,083141,Abi Samra; Nicholas Camill,0,0,30,30
1651010075838,MATH 10A,A01,083735,Patchell; Gregory David,1,0,30,29
1651010075838,MATH 10A,A02,083736,Patchell; Gregory David,27,0,30,3
1651010075838,MATH 10A,A03,083737,Patchell; Gregory David,23,0,30,7
1651010081865,MATH 10B,A01,083207,Staff,0,9,30,30
1651010081865,MATH 10B,A02,083208,Staff,0,5,30,30
1651010081865,MATH 10B,B01,083739,Staff,8,0,30,22
1651010081865,MATH 10B,B02,083740,Staff,28,0,30,2
1651010087894,MATH 18,A01,083743,Staff,0,0,30,30
1651010087894,MATH 18,A02,083744,Staff,23,0,30,7
1651010087894,MATH 18,A03,083745,Staff,19,0,30,11
1651010087894,MATH 18,A04,083746,Staff,26,0,30,4
1651010087894,MATH 18,B01,083748,Staff,0,16,30,30
1651010087894,MATH 18,B02,083749,Staff,0,14,30,30
1651010087894,MATH 18,B03,083750,Staff,0,14,30,30
1651010087894,MATH 18,B04,083751,Staff,0,13,30,30
1651010093917,MATH 20A,A01,083754,Staff,19,0,40,21
1651010099946,MATH 20B,A01,083756,Staff,0,14,30,30
1651010099946,MATH 20B,A02,083757,Staff,0,11,30,30
1651010105969,MATH 20C,A01,083760,Staff,0,17,30,30
1651010105969,MATH 20C,A02,083761,Staff,0,15,30,30
1651010105969,MATH 20C,B01,083762,Staff,9,0,30,21
1651010105969,MATH 20C,B02,083763,Staff,28,0,30,2
1651010111992,MATH 20D,A01,083765,Staff,3,1,30,27
1651010111992,MATH 20D,A02,083766,Staff,2,0,30,28
1651010111992,MATH 20D,A03,083767,Staff,22,0,30,8
1651010118019,MATH 20E,A01,083771,Staff,2,0,30,28
1651010118019,MATH 20E,A02,083772,Staff,12,0,30,18
1651010118019,MATH 20E,B01,083773,Staff,0,0,30,30
1651010118019,MATH 20E,B02,083774,Staff,1,0,30,29
1651010124042,MATH 103A,A01,083777,Staff,0,17,30,30
1651010124042,MATH 103A,A02,083778,Staff,0,15,30,30
1651010124042,MATH 103A,B01,083779,Staff,0,15,30,30
1651010124042,MATH 103A,B02,083780,Staff,0,14,30,30
1651010130069,MATH 105,A01,085443,Staff,0,23,30,30
1651010136096,MATH 109,A01,083213,Anzaldo; Leesa B,0,7,30,30
1651010136096,MATH 109,A02,083214,Anzaldo; Leesa B,0,7,30,30
1651010136096,MATH 109,B01,083215,Anzaldo; Leesa B,0,8,30,30
1651010136096,MATH 109,B02,083216,Anzaldo; Leesa B,0,7,30,30
1651010142124,MATH 142A,A01,083219,Chow; Bennett,0,14,30,30
1651010142124,MATH 142A,A02,083220,Chow; Bennett,0,15,30,30
1651010142124,MATH 142A,B01,083221,Chow; Bennett,0,16,30,30
1651010142124,MATH 142A,B02,083222,Chow; Bennett,0,14,30,30
1651010148146,MATH 193A,A01,083224,Staff,0,7,30,30
1651010148146,MATH 193A,A02,083225,Staff,0,7,30,30
1651010148146,MATH 193A,A03,083781,Staff,0,7,30,30
1651010148146,MATH 193A,A04,083782,Staff,0,7,30,30
1651010154168,MATH 197,001,091859,McAuley; Julian John,9998,0,9999,1
1651010160222,COGS 9,A01,083615,Staff,0,19,60,60
1651010166250,COGS 11,A01,083617,Boyle; Mary E. T.,15,0,40,25
1651010172273,COGS 13,A01,083071,Staff,0,40,40,40
1651010178305,COGS 14A,A01,092681,Staff,0,40,100,100
1651010184332,COGS 14B,A01,083073,Cheng; Tzu-Han,0,13,50,50
1651010190364,COGS 17,A01,092677,Staff,7,0,75,68
1651010196387,COGS 100,A01,083619,Staff,0,30,60,60
1651010202408,COGS 101A,A01,083621,Davis; Joshua Daniel,0,30,60,60
1651010208431,COGS 101B,A01,091572,Staff,0,6,60,60
1651010214453,COGS 101C,A01,083625,Delgado; Tania,14,0,30,16
1651010220477,COGS 107A,A01,083627,Boyle; Mary E. T.,0,16,60,60
1651010226504,COGS 118A,A01,083075,Staff,0,10,60,60
1651010232528,CSE 3,A50,083646,Miranda; Gregory Joseph,15,0,38,23
1651010232528,CSE 3,A51,083647,Miranda; Gregory Joseph,36,0,37,1
1651010238553,CSE 8A,A50,083650,Miranda; Gregory Joseph,0,31,40,40
1651010244588,CSE 11,A01,083080,Cao; Yingjun,0,97,40,40
1651010250609,CSE 12,A01,083652,Staff,0,24,100,100
1651010256638,CSE 15L,A01,083654,Staff,0,3,50,50
1651010256638,CSE 15L,A02,083655,Staff,0,3,50,50
1651010262678,CSE 20,A01,083657,Staff,47,0,80,33
1651010268701,CSE 30,A01,083084,Eldon; John,1,39,80,79
1651010274726,CSE 100,A01,083659,Cao; Yingjun,0,72,50,50
1651010280748,CSE 134B,A01,083661,Powell; Thomas Allan,1,39,65,64
1651010286779,CSE 140,A01,083663,Staff,0,13,75,75
1651010292816,CSE 140L,A01,083088,Eldon; John,4,0,100,96
1651010298839,CSE 175,A01,083665,Kumar; Rakesh,0,0,25,25
1651010304864,CSE 190,A00,092507,Dubnov; Shlomo,9,0,20,11
1651010310892,ECE 45,A01,083139,Staff,0,7,60,60
1651010316917,ECE 65,A50,083695,Staff,0,7,30,30
1651010322940,ECE 109,A01,091882,Touri; Behrouz,32,0,70,38
1651010328964,ECE 180,A00,083140,Abi Samra; Nicholas Camill,17,0,30,13
1651010328964,ECE 180,B00,083141,Abi Samra; Nicholas Camill,0,0,30,30
1651010334986,MATH 10A,A01,083735,Patchell; Gregory David,1,0,30,29
1651010334986,MATH 10A,A02,083736,Patchell; Gregory David,27,0,30,3
1651010334986,MATH 10A,A03,083737,Patchell; Gregory David,23,0,30,7
1651010341016,MATH 10B,A01,083207,Staff,0,9,30,30
1651010341016,MATH 10B,A02,083208,Staff,0,5,30,30
1651010341016,MATH 10B,B01,083739,Staff,8,0,30,22
1651010341016,MATH 10B,B02,083740,Staff,28,0,30,2
1651010347044,MATH 18,A01,083743,Staff,0,0,30,30
1651010347044,MATH 18,A02,083744,Staff,23,0,30,7
1651010347044,MATH 18,A03,083745,Staff,19,0,30,11
1651010347044,MATH 18,A04,083746,Staff,26,0,30,4
1651010347044,MATH 18,B01,083748,Staff,0,16,30,30
1651010347044,MATH 18,B02,083749,Staff,0,14,30,30
1651010347044,MATH 18,B03,083750,Staff,0,14,30,30
1651010347044,MATH 18,B04,083751,Staff,0,13,30,30
1651010353073,MATH 20A,A01,083754,Staff,19,0,40,21
1651010359095,MATH 20B,A01,083756,Staff,0,14,30,30
1651010359095,MATH 20B,A02,083757,Staff,0,11,30,30
1651010365133,MATH 20C,A01,083760,Staff,0,17,30,30
1651010365133,MATH 20C,A02,083761,Staff,0,15,30,30
1651010365133,MATH 20C,B01,083762,Staff,9,0,30,21
1651010365133,MATH 20C,B02,083763,Staff,28,0,30,2
1651010371159,MATH 20D,A01,083765,Staff,3,1,30,27
1651010371159,MATH 20D,A02,083766,Staff,2,0,30,28
1651010371159,MATH 20D,A03,083767,Staff,22,0,30,8
1651010377187,MATH 20E,A01,083771,Staff,2,0,30,28
1651010377187,MATH 20E,A02,083772,Staff,12,0,30,18
1651010377187,MATH 20E,B01,083773,Staff,0,0,30,30
1651010377187,MATH 20E,B02,083774,Staff,1,0,30,29
1651010383211,MATH 103A,A01,083777,Staff,0,17,30,30
1651010383211,MATH 103A,A02,083778,Staff,0,15,30,30
1651010383211,MATH 103A,B01,083779,Staff,0,15,30,30
1651010383211,MATH 103A,B02,083780,Staff,0,14,30,30
1651010389242,MATH 105,A01,085443,Staff,0,23,30,30
1651010395274,MATH 109,A01,083213,Anzaldo; Leesa B,0,7,30,30
1651010395274,MATH 109,A02,083214,Anzaldo; Leesa B,0,7,30,30
1651010395274,MATH 109,B01,083215,Anzaldo; Leesa B,0,8,30,30
1651010395274,MATH 109,B02,083216,Anzaldo; Leesa B,0,7,30,30
1651010401297,MATH 142A,A01,083219,Chow; Bennett,0,14,30,30
1651010401297,MATH 142A,A02,083220,Chow; Bennett,0,15,30,30
1651010401297,MATH 142A,B01,083221,Chow; Bennett,0,16,30,30
1651010401297,MATH 142A,B02,083222,Chow; Bennett,0,14,30,30
1651010407324,MATH 193A,A01,083224,Staff,0,7,30,30
1651010407324,MATH 193A,A02,083225,Staff,0,7,30,30
1651010407324,MATH 193A,A03,083781,Staff,0,7,30,30
1651010407324,MATH 193A,A04,083782,Staff,0,7,30,30
1651010413346,MATH 197,001,091859,McAuley; Julian John,9998,0,9999,1
1651010419416,COGS 9,A01,083615,Staff,0,19,60,60
1651010425451,COGS 11,A01,083617,Boyle; Mary E. T.,15,0,40,25
1651010431473,COGS 13,A01,083071,Staff,0,40,40,40
1651010437499,COGS 14A,A01,092681,Staff,0,40,100,100
1651010443529,COGS 14B,A01,083073,Cheng; Tzu-Han,0,13,50,50
1651010449558,COGS 17,A01,092677,Staff,7,0,75,68
1651010455584,COGS 100,A01,083619,Staff,0,30,60,60
1651010461610,COGS 101A,A01,083621,Davis; Joshua Daniel,0,30,60,60
1651010467641,COGS 101B,A01,091572,Staff,0,6,60,60
1651010473667,COGS 101C,A01,083625,Delgado; Tania,14,0,30,16
1651010479692,COGS 107A,A01,083627,Boyle; Mary E. T.,0,16,60,60
1651010485724,COGS 118A,A01,083075,Staff,0,10,60,60
1651010491762,CSE 3,A50,083646,Miranda; Gregory Joseph,15,0,38,23
1651010491762,CSE 3,A51,083647,Miranda; Gregory Joseph,36,0,37,1
1651010497787,CSE 8A,A50,083650,Miranda; Gregory Joseph,0,31,40,40
1651010503816,CSE 11,A01,083080,Cao; Yingjun,0,97,40,40
1651010509842,CSE 12,A01,083652,Staff,0,24,100,100
1651010515864,CSE 15L,A01,083654,Staff,0,3,50,50
1651010515864,CSE 15L,A02,083655,Staff,0,3,50,50
1651010521887,CSE 20,A01,083657,Staff,47,0,80,33
1651010527918,CSE 30,A01,083084,Eldon; John,1,39,80,79
1651010533942,CSE 100,A01,083659,Cao; Yingjun,0,72,50,50
1651010539967,CSE 134B,A01,083661,Powell; Thomas Allan,1,39,65,64
1651010545992,CSE 140,A01,083663,Staff,0,13,75,75
1651010552014,CSE 140L,A01,083088,Eldon; John,4,0,100,96
1651010558043,CSE 175,A01,083665,Kumar; Rakesh,0,0,25,25
1651010564068,CSE 190,A00,092507,Dubnov; Shlomo,9,0,20,11
1651010570091,ECE 45,A01,083139,Staff,0,7,60,60
1651010576127,ECE 65,A50,083695,Staff,0,7,30,30
1651010582160,ECE 109,A01,091882,Touri; Behrouz,32,0,70,38
1651010588184,ECE 180,A00,083140,Abi Samra; Nicholas Camill,17,0,30,13
1651010588184,ECE 180,B00,083141,Abi Samra; Nicholas Camill,0,0,30,30
1651010594207,MATH 10A,A01,083735,Patchell; Gregory David,1,0,30,29
1651010594207,MATH 10A,A02,083736,Patchell; Gregory David,27,0,30,3
1651010594207,MATH 10A,A03,083737,Patchell; Gregory David,23,0,30,7
1651010600236,MATH 10B,A01,083207,Staff,0,9,30,30
1651010600236,MATH 10B,A02,083208,Staff,0,5,30,30
1651010600236,MATH 10B,B01,083739,Staff,8,0,30,22
1651010600236,MATH 10B,B02,083740,Staff,28,0,30,2
1651010606260,MATH 18,A01,083743,Staff,0,0,30,30
1651010606260,MATH 18,A02,083744,Staff,23,0,30,7
1651010606260,MATH 18,A03,083745,Staff,19,0,30,11
1651010606260,MATH 18,A04,083746,Staff,26,0,30,4
1651010606260,MATH 18,B01,083748,Staff,0,16,30,30
1651010606260,MATH 18,B02,083749,Staff,0,14,30,30
1651010606260,MATH 18,B03,083750,Staff,0,14,30,30
1651010606260,MATH 18,B04,083751,Staff,0,13,30,30
1651010612283,MATH 20A,A01,083754,Staff,19,0,40,21
1651010618310,MATH 20B,A01,083756,Staff,0,14,30,30
1651010618310,MATH 20B,A02,083757,Staff,0,11,30,30
1651010624331,MATH 20C,A01,083760,Staff,0,17,30,30
1651010624331,MATH 20C,A02,083761,Staff,0,15,30,30
1651010624331,MATH 20C,B01,083762,Staff,9,0,30,21
1651010624331,MATH 20C,B02,083763,Staff,28,0,30,2
1651010630376,MATH 20D,A01,083765,Staff,3,1,30,27
1651010630376,MATH 20D,A02,083766,Staff,2,0,30,28
1651010630376,MATH 20D,A03,083767,Staff,22,0,30,8
1651010636503,MATH 20E,A01,083771,Staff,2,0,30,28
1651010636503,MATH 20E,A02,083772,Staff,12,0,30,18
1651010636503,MATH 20E,B01,083773,Staff,0,0,30,30
1651010636503,MATH 20E,B02,083774,Staff,1,0,30,29
1651010642538,MATH 103A,A01,083777,Staff,0,17,30,30
1651010642538,MATH 103A,A02,083778,Staff,0,15,30,30
1651010642538,MATH 103A,B01,083779,Staff,0,15,30,30
1651010642538,MATH 103A,B02,083780,Staff,0,14,30,30
1651010648563,MATH 105,A01,085443,Staff,0,23,30,30
1651010654596,MATH 109,A01,083213,Anzaldo; Leesa B,0,7,30,30
1651010654596,MATH 109,A02,083214,Anzaldo; Leesa B,0,7,30,30
1651010654596,MATH 109,B01,083215,Anzaldo; Leesa B,0,8,30,30
1651010654596,MATH 109,B02,083216,Anzaldo; Leesa B,0,7,30,30
1651010660620,MATH 142A,A01,083219,Chow; Bennett,0,14,30,30
1651010660620,MATH 142A,A02,083220,Chow; Bennett,0,15,30,30
1651010660620,MATH 142A,B01,083221,Chow; Bennett,0,16,30,30
1651010660620,MATH 142A,B02,083222,Chow; Bennett,0,14,30,30
1651010666649,MATH 193A,A01,083224,Staff,0,7,30,30
1651010666649,MATH 193A,A02,083225,Staff,0,7,30,30
1651010666649,MATH 193A,A03,083781,Staff,0,7,30,30
1651010666649,MATH 193A,A04,083782,Staff,0,7,30,30
1651010672672,MATH 197,001,091859,McAuley; Julian John,9998,0,9999,1
1651010678735,COGS 9,A01,083615,Staff,0,19,60,60
1651010684774,COGS 11,A01,083617,Boyle; Mary E. T.,15,0,40,25
1651010690797,COGS 13,A01,083071,Staff,0,40,40,40
1651010696820,COGS 14A,A01,092681,Staff,0,40,100,100
1651010702843,COGS 14B,A01,083073,Cheng; Tzu-Han,0,13,50,50
1651010708869,COGS 17,A01,092677,Staff,7,0,75,68
1651010714905,COGS 100,A01,083619,Staff,0,30,60,60
1651010720929,COGS 101A,A01,083621,Davis; Joshua Daniel,0,30,60,60
1651010726971,COGS 101B,A01,091572,Staff,0,6,60,60
1651010732998,COGS 101C,A01,083625,Delgado; Tania,14,0,30,16
1651010739020,COGS 107A,A01,083627,Boyle; Mary E. T.,0,16,60,60
1651010745043,COGS 118A,A01,083075,Staff,0,10,60,60
1651010751071,CSE 3,A50,083646,Miranda; Gregory Joseph,15,0,38,23
1651010751071,CSE 3,A51,083647,Miranda; Gregory Joseph,36,0,37,1
1651010757097,CSE 8A,A50,083650,Miranda; Gregory Joseph,0,31,40,40
1651010763123,CSE 11,A01,083080,Cao; Yingjun,0,97,40,40
1651010769147,CSE 12,A01,083652,Staff,0,24,100,100
1651010775174,CSE 15L,A01,083654,Staff,0,3,50,50
1651010775174,CSE 15L,A02,083655,Staff,0,3,50,50
1651010781195,CSE 20,A01,083657,Staff,47,0,80,33
1651010787218,CSE 30,A01,083084,Eldon; John,1,39,80,79
1651010793243,CSE 100,A01,083659,Cao; Yingjun,0,72,50,50
1651010799270,CSE 134B,A01,083661,Powell; Thomas Allan,1,39,65,64
1651010805294,CSE 140,A01,083663,Staff,0,13,75,75
1651010811315,CSE 140L,A01,083088,Eldon; John,4,0,100,96
1651010817338,CSE 175,A01,083665,Kumar; Rakesh,0,0,25,25
1651010823379,CSE 190,A00,092507,Dubnov; Shlomo,9,0,20,11
1651010829414,ECE 45,A01,083139,Staff,0,7,60,60
1651010835436,ECE 65,A50,083695,Staff,0,7,30,30
1651010841467,ECE 109,A01,091882,Touri; Behrouz,32,0,70,38
1651010847494,ECE 180,A00,083140,Abi Samra; Nicholas Camill,17,0,30,13
1651010847494,ECE 180,B00,083141,Abi Samra; Nicholas Camill,0,0,30,30
1651010853516,MATH 10A,A01,083735,Patchell; Gregory David,1,0,30,29
1651010853516,MATH 10A,A02,083736,Patchell; Gregory David,27,0,30,3
1651010853516,MATH 10A,A03,083737,Patchell; Gregory David,23,0,30,7
1651010859553,MATH 10B,A01,083207,Staff,0,9,30,30
1651010859553,MATH 10B,A02,083208,Staff,0,5,30,30
1651010859553,MATH 10B,B01,083739,Staff,8,0,30,22
1651010859553,MATH 10B,B02,083740,Staff,28,0,30,2
1651010865576,MATH 18,A01,083743,Staff,0,0,30,30
1651010865576,MATH 18,A02,083744,Staff,23,0,30,7
1651010865576,MATH 18,A03,083745,Staff,19,0,30,11
1651010865576,MATH 18,A04,083746,Staff,26,0,30,4
1651010865576,MATH 18,B01,083748,Staff,0,16,30,30
1651010865576,MATH 18,B02,083749,Staff,0,14,30,30
1651010865576,MATH 18,B03,083750,Staff,0,14,30,30
1651010865576,MATH 18,B04,083751,Staff,0,13,30,30
1651010871598,MATH 20A,A01,083754,Staff,19,0,40,21
1651010877628,MATH 20B,A01,083756,Staff,0,14,30,30
1651010877628,MATH 20B,A02,083757,Staff,0,11,30,30
1651010883653,MATH 20C,A01,083760,Staff,0,17,30,30
1651010883653,MATH 20C,A02,083761,Staff,0,15,30,30
1651010883653,MATH 20C,B01,083762,Staff,9,0,30,21
1651010883653,MATH 20C,B02,083763,Staff,28,0,30,2
1651010889693,MATH 20D,A01,083765,Staff,3,1,30,27
1651010889693,MATH 20D,A02,083766,Staff,2,0,30,28
1651010889693,MATH 20D,A03,083767,Staff,22,0,30,8
1651010895715,MATH 20E,A01,083771,Staff,2,0,30,28
1651010895715,MATH 20E,A02,083772,Staff,12,0,30,18
1651010895715,MATH 20E,B01,083773,Staff,0,0,30,30
1651010895715,MATH 20E,B02,083774,Staff,1,0,30,29
1651010901739,MATH 103A,A01,083777,Staff,0,17,30,30
1651010901739,MATH 103A,A02,083778,Staff,0,15,30,30
1651010901739,MATH 103A,B01,083779,Staff,0,15,30,30
1651010901739,MATH 103A,B02,083780,Staff,0,14,30,30
1651010907764,MATH 105,A01,085443,Staff,0,23,30,30
1651010913797,MATH 109,A01,083213,Anzaldo; Leesa B,0,7,30,30
1651010913797,MATH 109,A02,083214,Anzaldo; Leesa B,0,7,30,30
1651010913797,MATH 109,B01,083215,Anzaldo; Leesa B,0,8,30,30
1651010913797,MATH 109,B02,083216,Anzaldo; Leesa B,0,7,30,30
1651010919824,MATH 142A,A01,083219,Chow; Bennett,0,14,30,30
1651010919824,MATH 142A,A02,083220,Chow; Bennett,0,15,30,30
1651010919824,MATH 142A,B01,083221,Chow; Bennett,0,16,30,30
1651010919824,MATH 142A,B02,083222,Chow; Bennett,0,14,30,30
1651010925846,MATH 193A,A01,083224,Staff,0,7,30,30
1651010925846,MATH 193A,A02,083225,Staff,0,7,30,30
1651010925846,MATH 193A,A03,083781,Staff,0,7,30,30
1651010925846,MATH 193A,A04,083782,Staff,0,7,30,30
1651010931870,MATH 197,001,091859,McAuley; Julian John,9998,0,9999,1
1651010937930,COGS 9,A01,083615,Staff,0,19,60,60
1651010943952,COGS 11,A01,083617,Boyle; Mary E. T.,15,0,40,25
1651010949979,COGS 13,A01,083071,Staff,0,40,40,40
1651010956014,COGS 14A,A01,092681,Staff,0,40,100,100
1651010962041,COGS 14B,A01,083073,Cheng; Tzu-Han,0,13,50,50
1651010968066,COGS 17,A01,092677,Staff,7,0,75,68
1651010990689,COGS 100,A01,083619,Staff,0,30,60,60
1651010996715,COGS 101A,A01,083621,Davis; Joshua Daniel,0,30,60,60
1651011002740,COGS 101B,A01,091572,Staff,0,6,60,60
1651011008770,COGS 101C,A01,083625,Delgado; Tania,14,0,30,16
1651011014794,COGS 107A,A01,083627,Boyle; Mary E. T.,0,16,60,60
1651011020819,COGS 118A,A01,083075,Staff,0,10,60,60
1651011026852,CSE 3,A50,083646,Miranda; Gregory Joseph,15,0,38,23
1651011026852,CSE 3,A51,083647,Miranda; Gregory Joseph,36,0,37,1
1651011032875,CSE 8A,A50,083650,Miranda; Gregory Joseph,0,31,40,40
1651011038897,CSE 11,A01,083080,Cao; Yingjun,0,97,40,40
1651011044929,CSE 12,A01,083652,Staff,0,24,100,100
1651011050952,CSE 15L,A01,083654,Staff,0,3,50,50
1651011050952,CSE 15L,A02,083655,Staff,0,3,50,50
1651011056975,CSE 20,A01,083657,Staff,47,0,80,33
1651011063006,CSE 30,A01,083084,Eldon; John,1,39,80,79
1651011069029,CSE 100,A01,083659,Cao; Yingjun,0,72,50,50
1651011075053,CSE 134B,A01,083661,Powell; Thomas Allan,1,39,65,64
1651011081077,CSE 140,A01,083663,Staff,0,13,75,75
1651011087099,CSE 140L,A01,083088,Eldon; John,4,0,100,96
1651011093124,CSE 175,A01,083665,Kumar; Rakesh,0,0,25,25
1651011099148,CSE 190,A00,092507,Dubnov; Shlomo,9,0,20,11
1651011105185,ECE 45,A01,083139,Staff,0,7,60,60
1651011111211,ECE 65,A50,083695,Staff,0,7,30,30
1651011117243,ECE 109,A01,091882,Touri; Behrouz,32,0,70,38
1651011123265,ECE 180,A00,083140,Abi Samra; Nicholas Camill,17,0,30,13
1651011123265,ECE 180,B00,083141,Abi Samra; Nicholas Camill,0,0,30,30
1651011129290,MATH 10A,A01,083735,Patchell; Gregory David,1,0,30,29
1651011129290,MATH 10A,A02,083736,Patchell; Gregory David,27,0,30,3
1651011129290,MATH 10A,A03,083737,Patchell; Gregory David,23,0,30,7
1651011135320,MATH 10B,A01,083207,Staff,0,9,30,30
1651011135320,MATH 10B,A02,083208,Staff,0,5,30,30
1651011135320,MATH 10B,B01,083739,Staff,8,0,30,22
1651011135320,MATH 10B,B02,083740,Staff,28,0,30,2
1651011141350,MATH 18,A01,083743,Staff,0,0,30,30
1651011141350,MATH 18,A02,083744,Staff,23,0,30,7
1651011141350,MATH 18,A03,083745,Staff,19,0,30,11
1651011141350,MATH 18,A04,083746,Staff,26,0,30,4
1651011141350,MATH 18,B01,083748,Staff,0,16,30,30
1651011141350,MATH 18,B02,083749,Staff,0,14,30,30
1651011141350,MATH 18,B03,083750,Staff,0,14,30,30
1651011141350,MATH 18,B04,083751,Staff,0,13,30,30
1651011147373,MATH 20A,A01,083754,Staff,19,0,40,21
1651011153395,MATH 20B,A01,083756,Staff,0,14,30,30
1651011153395,MATH 20B,A02,083757,Staff,0,11,30,30
1651011159422,MATH 20C,A01,083760,Staff,0,17,30,30
1651011159422,MATH 20C,A02,083761,Staff,0,15,30,30
1651011159422,MATH 20C,B01,083762,Staff,9,0,30,21
1651011159422,MATH 20C,B02,083763,Staff,28,0,30,2
1651011165447,MATH 20D,A01,083765,Staff,3,1,30,27
1651011165447,MATH 20D,A02,083766,Staff,2,0,30,28
1651011165447,MATH 20D,A03,083767,Staff,22,0,30,8
1651011171475,MATH 20E,A01,083771,Staff,2,0,30,28
1651011171475,MATH 20E,A02,083772,Staff,12,0,30,18
1651011171475,MATH 20E,B01,083773,Staff,0,0,30,30
1651011171475,MATH 20E,B02,083774,Staff,1,0,30,29
1651011177513,MATH 103A,A01,083777,Staff,0,17,30,30
1651011177513,MATH 103A,A02,083778,Staff,0,15,30,30
1651011177513,MATH 103A,B01,083779,Staff,0,15,30,30
1651011177513,MATH 103A,B02,083780,Staff,0,14,30,30
1651011183536,MATH 105,A01,085443,Staff,0,23,30,30
1651011189560,MATH 109,A01,083213,Anzaldo; Leesa B,0,7,30,30
1651011189560,MATH 109,A02,083214,Anzaldo; Leesa B,0,7,30,30
1651011189560,MATH 109,B01,083215,Anzaldo; Leesa B,0,8,30,30
1651011189560,MATH 109,B02,083216,Anzaldo; Leesa B,0,7,30,30
1651011195589,MATH 142A,A01,083219,Chow; Bennett,0,14,30,30
1651011195589,MATH 142A,A02,083220,Chow; Bennett,0,15,30,30
1651011195589,MATH 142A,B01,083221,Chow; Bennett,0,16,30,30
1651011195589,MATH 142A,B02,083222,Chow; Bennett,0,14,30,30
1651011201613,MATH 193A,A01,083224,Staff,0,7,30,30
1651011201613,MATH 193A,A02,083225,Staff,0,7,30,30
1651011201613,MATH 193A,A03,083781,Staff,0,7,30,30
1651011201613,MATH 193A,A04,083782,Staff,0,7,30,30
1651011207637,MATH 197,001,091859,McAuley; Julian John,9998,0,9999,1
1651011213694,COGS 9,A01,083615,Staff,0,19,60,60
1651011219726,COGS 11,A01,083617,Boyle; Mary E. T.,15,0,40,25
1651011225753,COGS 13,A01,083071,Staff,0,40,40,40
1651011231775,COGS 14A,A01,092681,Staff,0,40,100,100
1651011237798,COGS 14B,A01,083073,Cheng; Tzu-Han,0,13,50,50
1651011243894,COGS 17,A01,092677,Staff,7,0,75,68
1651011249919,COGS 100,A01,083619,Staff,0,30,60,60
1651011255941,COGS 101A,A01,083621,Davis; Joshua Daniel,0,30,60,60
1651011261968,COGS 101B,A01,091572,Staff,0,6,60,60
1651011268004,COGS 101C,A01,083625,Delgado; Tania,14,0,30,16
1651011274026,COGS 107A,A01,083627,Boyle; Mary E. T.,0,16,60,60
1651011280051,COGS 118A,A01,083075,Staff,0,10,60,60
1651011286090,CSE 3,A50,083646,Miranda; Gregory Joseph,15,0,38,23
1651011286090,CSE 3,A51,083647,Miranda; Gregory Joseph,36,0,37,1
1651011292114,CSE 8A,A50,083650,Miranda; Gregory Joseph,0,31,40,40
1651011298136,CSE 11,A01,083080,Cao; Yingjun,0,97,40,40
1651011304162,CSE 12,A01,083652,Staff,0,24,100,100
1651011310198,CSE 15L,A01,083654,Staff,0,3,50,50
1651011310198,CSE 15L,A02,083655,Staff,0,3,50,50
1651011316222,CSE 20,A01,083657,Staff,47,0,80,33
1651011322255,CSE 30,A01,083084,Eldon; John,1,39,80,79
1651011328290,CSE 100,A01,083659,Cao; Yingjun,0,72,50,50
1651011334315,CSE 134B,A01,083661,Powell; Thomas Allan,1,39,65,64
1651011340337,CSE 140,A01,083663,Staff,0,13,75,75
1651011346368,CSE 140L,A01,083088,Eldon; John,4,0,100,96
1651011352394,CSE 175,A01,083665,Kumar; Rakesh,0,0,25,25
1651011358426,CSE 190,A00,092507,Dubnov; Shlomo,9,0,20,11
1651011364456,ECE 45,A01,083139,Staff,0,7,60,60
1651011370483,ECE 65,A50,083695,Staff,0,7,30,30
1651011376518,ECE 109,A01,091882,Touri; Behrouz,32,0,70,38
1651011382545,ECE 180,A00,083140,Abi Samra; Nicholas Camill,17,0,30,13
1651011382545,ECE 180,B00,083141,Abi Samra; Nicholas Camill,0,0,30,30
1651011388568,MATH 10A,A01,083735,Patchell; Gregory David,1,0,30,29
1651011388568,MATH 10A,A02,083736,Patchell; Gregory David,27,0,30,3
1651011388568,MATH 10A,A03,083737,Patchell; Gregory David,23,0,30,7
1651011394601,MATH 10B,A01,083207,Staff,0,9,30,30
1651011394601,MATH 10B,A02,083208,Staff,0,5,30,30
1651011394601,MATH 10B,B01,083739,Staff,8,0,30,22
1651011394601,MATH 10B,B02,083740,Staff,28,0,30,2
1651011400631,MATH 18,A01,083743,Staff,0,0,30,30
1651011400631,MATH 18,A02,083744,Staff,23,0,30,7
1651011400631,MATH 18,A03,083745,Staff,19,0,30,11
1651011400631,MATH 18,A04,083746,Staff,26,0,30,4
1651011400631,MATH 18,B01,083748,Staff,0,16,30,30
1651011400631,MATH 18,B02,083749,Staff,0,14,30,30
1651011400631,MATH 18,B03,083750,Staff,0,14,30,30
1651011400631,MATH 18,B04,083751,Staff,0,13,30,30
1651011406654,MATH 20A,A01,083754,Staff,19,0,40,21
1651011412680,MATH 20B,A01,083756,Staff,0,14,30,30
1651011412680,MATH 20B,A02,083757,Staff,0,11,30,30
1651011418712,MATH 20C,A01,083760,Staff,0,17,30,30
1651011418712,MATH 20C,A02,083761,Staff,0,15,30,30
1651011418712,MATH 20C,B01,083762,Staff,9,0,30,21
1651011418712,MATH 20C,B02,083763,Staff,28,0,30,2
1651011424739,MATH 20D,A01,083765,Staff,3,1,30,27
1651011424739,MATH 20D,A02,083766,Staff,2,0,30,28
1651011424739,MATH 20D,A03,083767,Staff,22,0,30,8
1651011430780,MATH 20E,A01,083771,Staff,2,0,30,28
1651011430780,MATH 20E,A02,083772,Staff,12,0,30,18
1651011430780,MATH 20E,B01,083773,Staff,0,0,30,30
1651011430780,MATH 20E,B02,083774,Staff,1,0,30,29
1651011436824,MATH 103A,A01,083777,Staff,0,17,30,30
1651011436824,MATH 103A,A02,083778,Staff,0,15,30,30
1651011436824,MATH 103A,B01,083779,Staff,0,15,30,30
1651011436824,MATH 103A,B02,083780,Staff,0,14,30,30
1651011442849,MATH 105,A01,085443,Staff,0,23,30,30
1651011448873,MATH 109,A01,083213,Anzaldo; Leesa B,0,7,30,30
1651011448873,MATH 109,A02,083214,Anzaldo; Leesa B,0,7,30,30
1651011448873,MATH 109,B01,083215,Anzaldo; Leesa B,0,8,30,30
1651011448873,MATH 109,B02,083216,Anzaldo; Leesa B,0,7,30,30
1651011454901,MATH 142A,A01,083219,Chow; Bennett,0,14,30,30
1651011454901,MATH 142A,A02,083220,Chow; Bennett,0,15,30,30
1651011454901,MATH 142A,B01,083221,Chow; Bennett,0,16,30,30
1651011454901,MATH 142A,B02,083222,Chow; Bennett,0,14,30,30
1651011460930,MATH 193A,A01,083224,Staff,0,7,30,30
1651011460930,MATH 193A,A02,083225,Staff,0,7,30,30
1651011460930,MATH 193A,A03,083781,Staff,0,7,30,30
1651011460930,MATH 193A,A04,083782,Staff,0,7,30,30
1651011466960,MATH 197,001,091859,McAuley; Julian John,9998,0,9999,1
1651011473012,COGS 9,A01,083615,Staff,0,19,60,60
1651011479047,COGS 11,A01,083617,Boyle; Mary E. T.,15,0,40,25
1651011485073,COGS 13,A01,083071,Staff,0,40,40,40
1651011491102,COGS 14A,A01,092681,Staff,0,40,100,100
1651011497136,COGS 14B,A01,083073,Cheng; Tzu-Han,0,13,50,50
1651011503161,COGS 17,A01,092677,Staff,7,0,75,68
1651011509186,COGS 100,A01,083619,Staff,0,30,60,60
1651011515215,COGS 101A,A01,083621,Davis; Joshua Daniel,0,30,60,60
1651011521242,COGS 101B,A01,091572,Staff,0,6,60,60
1651011527267,COGS 101C,A01,083625,Delgado; Tania,14,0,30,16
1651011533290,COGS 107A,A01,083627,Boyle; Mary E. T.,0,16,60,60
1651011539318,COGS 118A,A01,083075,Staff,0,10,60,60
1651011545342,CSE 3,A50,083646,Miranda; Gregory Joseph,15,0,38,23
1651011545342,CSE 3,A51,083647,Miranda; Gregory Joseph,36,0,37,1
1651011551368,CSE 8A,A50,083650,Miranda; Gregory Joseph,0,31,40,40
1651011557390,CSE 11,A01,083080,Cao; Yingjun,0,97,40,40
1651011563416,CSE 12,A01,083652,Staff,0,24,100,100
1651011569439,CSE 15L,A01,083654,Staff,0,3,50,50
1651011569439,CSE 15L,A02,083655,Staff,0,3,50,50
1651011575472,CSE 20,A01,083657,Staff,47,0,80,33
1651011581494,CSE 30,A01,083084,Eldon; John,1,39,80,79
1651011587517,CSE 100,A01,083659,Cao; Yingjun,0,72,50,50
1651011593538,CSE 134B,A01,083661,Powell; Thomas Allan,1,39,65,64
1651011599560,CSE 140,A01,083663,Staff,0,13,75,75
1651011605581,CSE 140L,A01,083088,Eldon; John,4,0,100,96
1651011611603,CSE 175,A01,083665,Kumar; Rakesh,0,0,25,25
1651011617633,CSE 190,A00,092507,Dubnov; Shlomo,9,0,20,11
1651011623661,ECE 45,A01,083139,Staff,0,7,60,60
1651011629684,ECE 65,A50,083695,Staff,0,7,30,30
1651011635714,ECE 109,A01,091882,Touri; Behrouz,32,0,70,38
1651011641740,ECE 180,A00,083140,Abi Samra; Nicholas Camill,17,0,30,13
1651011641740,ECE 180,B00,083141,Abi Samra; Nicholas Camill,0,0,30,30
1651011647766,MATH 10A,A01,083735,Patchell; Gregory David,1,0,30,29
1651011647766,MATH 10A,A02,083736,Patchell; Gregory David,27,0,30,3
1651011647766,MATH 10A,A03,083737,Patchell; Gregory David,23,0,30,7
1651011653805,MATH 10B,A01,083207,Staff,0,9,30,30
1651011653805,MATH 10B,A02,083208,Staff,0,5,30,30
1651011653805,MATH 10B,B01,083739,Staff,8,0,30,22
1651011653805,MATH 10B,B02,083740,Staff,28,0,30,2
1651011659828,MATH 18,A01,083743,Staff,0,0,30,30
1651011659828,MATH 18,A02,083744,Staff,23,0,30,7
1651011659828,MATH 18,A03,083745,Staff,19,0,30,11
1651011659828,MATH 18,A04,083746,Staff,26,0,30,4
1651011659828,MATH 18,B01,083748,Staff,0,16,30,30
1651011659828,MATH 18,B02,083749,Staff,0,14,30,30
1651011659828,MATH 18,B03,083750,Staff,0,14,30,30
1651011659828,MATH 18,B04,083751,Staff,0,13,30,30
1651011665854,MATH 20A,A01,083754,Staff,19,0,40,21
1651011671881,MATH 20B,A01,083756,Staff,0,14,30,30
1651011671881,MATH 20B,A02,083757,Staff,0,11,30,30
1651011677905,MATH 20C,A01,083760,Staff,0,17,30,30
1651011677905,MATH 20C,A02,083761,Staff,0,15,30,30
1651011677905,MATH 20C,B01,083762,Staff,9,0,30,21
1651011677905,MATH 20C,B02,083763,Staff,28,0,30,2
1651011683928,MATH 20D,A01,083765,Staff,3,1,30,27
1651011683928,MATH 20D,A02,083766,Staff,2,0,30,28
1651011683928,MATH 20D,A03,083767,Staff,22,0,30,8
1651011689956,MATH 20E,A01,083771,Staff,2,0,30,28
1651011689956,MATH 20E,A02,083772,Staff,12,0,30,18
1651011689956,MATH 20E,B01,083773,Staff,0,0,30,30
1651011689956,MATH 20E,B02,083774,Staff,1,0,30,29
1651011695979,MATH 103A,A01,083777,Staff,0,17,30,30
1651011695979,MATH 103A,A02,083778,Staff,0,15,30,30
1651011695979,MATH 103A,B01,083779,Staff,0,15,30,30
1651011695979,MATH 103A,B02,083780,Staff,0,14,30,30
1651011702005,MATH 105,A01,085443,Staff,0,23,30,30
1651011708035,MATH 109,A01,083213,Anzaldo; Leesa B,0,7,30,30
1651011708035,MATH 109,A02,083214,Anzaldo; Leesa B,0,7,30,30
1651011708035,MATH 109,B01,083215,Anzaldo; Leesa B,0,8,30,30
1651011708035,MATH 109,B02,083216,Anzaldo; Leesa B,0,7,30,30
1651011714067,MATH 142A,A01,083219,Chow; Bennett,0,14,30,30
1651011714067,MATH 142A,A02,083220,Chow; Bennett,0,15,30,30
1651011714067,MATH 142A,B01,083221,Chow; Bennett,0,16,30,30
1651011714067,MATH 142A,B02,083222,Chow; Bennett,0,14,30,30
1651011720112,MATH 193A,A01,083224,Staff,0,7,30,30
1651011720112,MATH 193A,A02,083225,Staff,0,7,30,30
1651011720112,MATH 193A,A03,083781,Staff,0,7,30,30
1651011720112,MATH 193A,A04,083782,Staff,0,7,30,30
1651011726146,MATH 197,001,091859,McAuley; Julian John,9998,0,9999,1
1651011732203,COGS 9,A01,083615,Staff,0,19,60,60
1651011738226,COGS 11,A01,083617,Boyle; Mary E. T.,15,0,40,25
1651011744249,COGS 13,A01,083071,Staff,0,40,40,40
1651011750274,COGS 14A,A01,092681,Staff,0,40,100,100
1651011756300,COGS 14B,A01,083073,Cheng; Tzu-Han,0,13,50,50
1651011762323,COGS 17,A01,092677,Staff,7,0,75,68
1651011768348,COGS 100,A01,083619,Staff,0,30,60,60
1651011774386,COGS 101A,A01,083621,Davis; Joshua Daniel,0,30,60,60
1651011780408,COGS 101B,A01,091572,Staff,0,6,60,60
1651011786431,COGS 101C,A01,083625,Delgado; Tania,14,0,30,16
1651011792471,COGS 107A,A01,083627,Boyle; Mary E. T.,0,16,60,60
1651011798495,COGS 118A,A01,083075,Staff,0,10,60,60
1651011804528,CSE 3,A50,083646,Miranda; Gregory Joseph,15,0,38,23
1651011804528,CSE 3,A51,083647,Miranda; Gregory Joseph,36,0,37,1
1651011810551,CSE 8A,A50,083650,Miranda; Gregory Joseph,0,31,40,40
1651011816575,CSE 11,A01,083080,Cao; Yingjun,0,97,40,40
1651011822604,CSE 12,A01,083652,Staff,0,24,100,100
1651011828641,CSE 15L,A01,083654,Staff,0,3,50,50
1651011828641,CSE 15L,A02,083655,Staff,0,3,50,50
1651011834669,CSE 20,A01,083657,Staff,47,0,80,33
1651011840789,CSE 30,A01,083084,Eldon; John,1,39,80,79
1651011846814,CSE 100,A01,083659,Cao; Yingjun,0,72,50,50
1651011852837,CSE 134B,A01,083661,Powell; Thomas Allan,1,39,65,64
1651011858861,CSE 140,A01,083663,Staff,0,13,75,75
1651011864893,CSE 140L,A01,083088,Eldon; John,4,0,100,96
1651011870932,CSE 175,A01,083665,Kumar; Rakesh,0,0,25,25
1651011876956,CSE 190,A00,092507,Dubnov; Shlomo,9,0,20,11
1651011882985,ECE 45,A01,083139,Staff,0,7,60,60
1651011889009,ECE 65,A50,083695,Staff,0,7,30,30
1651011895039,ECE 109,A01,091882,Touri; Behrouz,32,0,70,38
1651011901063,ECE 180,A00,083140,Abi Samra; Nicholas Camill,17,0,30,13
1651011901063,ECE 180,B00,083141,Abi Samra; Nicholas Camill,0,0,30,30
1651011907093,MATH 10A,A01,083735,Patchell; Gregory David,1,0,30,29
1651011907093,MATH 10A,A02,083736,Patchell; Gregory David,27,0,30,3
1651011907093,MATH 10A,A03,083737,Patchell; Gregory David,23,0,30,7
1651011913116,MATH 10B,A01,083207,Staff,0,9,30,30
1651011913116,MATH 10B,A02,083208,Staff,0,5,30,30
1651011913116,MATH 10B,B01,083739,Staff,8,0,30,22
1651011913116,MATH 10B,B02,083740,Staff,28,0,30,2
1651011919142,MATH 18,A01,083743,Staff,0,0,30,30
1651011919142,MATH 18,A02,083744,Staff,23,0,30,7
1651011919142,MATH 18,A03,083745,Staff,19,0,30,11
1651011919142,MATH 18,A04,083746,Staff,26,0,30,4
1651011919142,MATH 18,B01,083748,Staff,0,16,30,30
1651011919142,MATH 18,B02,083749,Staff,0,14,30,30
1651011919142,MATH 18,B03,083750,Staff,0,14,30,30
1651011919142,MATH 18,B04,083751,Staff,0,13,30,30
1651011925178,MATH 20A,A01,083754,Staff,19,0,40,21
1651011931201,MATH 20B,A01,083756,Staff,0,14,30,30
1651011931201,MATH 20B,A02,083757,Staff,0,11,30,30
1651011937243,MATH 20C,A01,083760,Staff,0,17,30,30
1651011937243,MATH 20C,A02,083761,Staff,0,15,30,30
1651011937243,MATH 20C,B01,083762,Staff,9,0,30,21
1651011937243,MATH 20C,B02,083763,Staff,28,0,30,2
1651011943270,MATH 20D,A01,083765,Staff,3,1,30,27
1651011943270,MATH 20D,A02,083766,Staff,2,0,30,28
1651011943270,MATH 20D,A03,083767,Staff,22,0,30,8
1651011949297,MATH 20E,A01,083771,Staff,2,0,30,28
1651011949297,MATH 20E,A02,083772,Staff,12,0,30,18
1651011949297,MATH 20E,B01,083773,Staff,0,0,30,30
1651011949297,MATH 20E,B02,083774,Staff,1,0,30,29
1651011955328,MATH 103A,A01,083777,Staff,0,17,30,30
1651011955328,MATH 103A,A02,083778,Staff,0,15,30,30
1651011955328,MATH 103A,B01,083779,Staff,0,15,30,30
1651011955328,MATH 103A,B02,083780,Staff,0,14,30,30
1651011961351,MATH 105,A01,085443,Staff,0,23,30,30
1651011967378,MATH 109,A01,083213,Anzaldo; Leesa B,0,7,30,30
1651011967378,MATH 109,A02,083214,Anzaldo; Leesa B,0,7,30,30
1651011967378,MATH 109,B01,083215,Anzaldo; Leesa B,0,8,30,30
1651011967378,MATH 109,B02,083216,Anzaldo; Leesa B,0,7,30,30
1651011973413,MATH 142A,A01,083219,Chow; Bennett,0,14,30,30
1651011973413,MATH 142A,A02,083220,Chow; Bennett,0,15,30,30
1651011973413,MATH 142A,B01,083221,Chow; Bennett,0,16,30,30
1651011973413,MATH 142A,B02,083222,Chow; Bennett,0,14,30,30
1651011979435,MATH 193A,A01,083224,Staff,0,7,30,30
1651011979435,MATH 193A,A02,083225,Staff,0,7,30,30
1651011979435,MATH 193A,A03,083781,Staff,0,7,30,30
1651011979435,MATH 193A,A04,083782,Staff,0,7,30,30
1651011985458,MATH 197,001,091859,McAuley; Julian John,9998,0,9999,1
1651011991514,COGS 9,A01,083615,Staff,0,19,60,60
1651011997537,COGS 11,A01,083617,Boyle; Mary E. T.,15,0,40,25
1651012003559,COGS 13,A01,083071,Staff,0,40,40,40
1651012009586,COGS 14A,A01,092681,Staff,0,40,100,100
1651012015621,COGS 14B,A01,083073,Cheng; Tzu-Han,0,13,50,50
1651012021646,COGS 17,A01,092677,Staff,7,0,75,68
1651012027671,COGS 100,A01,083619,Staff,0,30,60,60
1651012033692,COGS 101A,A01,083621,Davis; Joshua Daniel,0,30,60,60
1651012039718,COGS 101B,A01,091572,Staff,0,6,60,60
1651012045741,COGS 101C,A01,083625,Delgado; Tania,14,0,30,16
1651012051768,COGS 107A,A01,083627,Boyle; Mary E. T.,0,16,60,60
1651012057789,COGS 118A,A01,083075,Staff,0,10,60,60
1651012063811,CSE 3,A50,083646,Miranda; Gregory Joseph,15,0,38,23
1651012063811,CSE 3,A51,083647,Miranda; Gregory Joseph,36,0,37,1
1651012069852,CSE 8A,A50,083650,Miranda; Gregory Joseph,0,31,40,40
1651012075875,CSE 11,A01,083080,Cao; Yingjun,0,97,40,40
1651012081906,CSE 12,A01,083652,Staff,0,24,100,100
1651012087944,CSE 15L,A01,083654,Staff,0,3,50,50
1651012087944,CSE 15L,A02,083655,Staff,0,3,50,50
1651012093983,CSE 20,A01,083657,Staff,47,0,80,33
1651012100010,CSE 30,A01,083084,Eldon; John,1,39,80,79
1651012106034,CSE 100,A01,083659,Cao; Yingjun,0,72,50,50
1651012112069,CSE 134B,A01,083661,Powell; Thomas Allan,1,39,65,64
1651012118099,CSE 140,A01,083663,Staff,0,13,75,75
1651012124123,CSE 140L,A01,083088,Eldon; John,4,0,100,96
1651012130148,CSE 175,A01,083665,Kumar; Rakesh,0,0,25,25
1651012136170,CSE 190,A00,092507,Dubnov; Shlomo,9,0,20,11
1651012142195,ECE 45,A01,083139,Staff,0,7,60,60
1651012148228,ECE 65,A50,083695,Staff,0,7,30,30
1651012154257,ECE 109,A01,091882,Touri; Behrouz,32,0,70,38
1651012160281,ECE 180,A00,083140,Abi Samra; Nicholas Camill,17,0,30,13
1651012160281,ECE 180,B00,083141,Abi Samra; Nicholas Camill,0,0,30,30
1651012166305,MATH 10A,A01,083735,Patchell; Gregory David,1,0,30,29
1651012166305,MATH 10A,A02,083736,Patchell; Gregory David,27,0,30,3
1651012166305,MATH 10A,A03,083737,Patchell; Gregory David,23,0,30,7
1651012172329,MATH 10B,A01,083207,Staff,0,9,30,30
1651012172329,MATH 10B,A02,083208,Staff,0,5,30,30
1651012172329,MATH 10B,B01,083739,Staff,8,0,30,22
1651012172329,MATH 10B,B02,083740,Staff,28,0,30,2
1651012178366,MATH 18,A01,083743,Staff,0,0,30,30
1651012178366,MATH 18,A02,083744,Staff,23,0,30,7
1651012178366,MATH 18,A03,083745,Staff,19,0,30,11
1651012178366,MATH 18,A04,083746,Staff,26,0,30,4
1651012178366,MATH 18,B01,083748,Staff,0,16,30,30
1651012178366,MATH 18,B02,083749,Staff,0,14,30,30
1651012178366,MATH 18,B03,083750,Staff,0,14,30,30
1651012178366,MATH 18,B04,083751,Staff,0,13,30,30
1651012184403,MATH 20A,A01,083754,Staff,19,0,40,21
1651012190424,MATH 20B,A01,083756,Staff,0,14,30,30
1651012190424,MATH 20B,A02,083757,Staff,0,11,30,30
1651012196452,MATH 20C,A01,083760,Staff,0,17,30,30
1651012196452,MATH 20C,A02,083761,Staff,0,15,30,30
1651012196452,MATH 20C,B01,083762,Staff,9,0,30,21
1651012196452,MATH 20C,B02,083763,Staff,28,0,30,2
1651012202474,MATH 20D,A01,083765,Staff,3,1,30,27
1651012202474,MATH 20D,A02,083766,Staff,2,0,30,28
1651012202474,MATH 20D,A03,083767,Staff,22,0,30,8
1651012208500,MATH 20E,A01,083771,Staff,2,0,30,28
1651012208500,MATH 20E,A02,083772,Staff,12,0,30,18
1651012208500,MATH 20E,B01,083773,Staff,0,0,30,30
1651012208500,MATH 20E,B02,083774,Staff,1,0,30,29
1651012214522,MATH 103A,A01,083777,Staff,0,17,30,30
1651012214522,MATH 103A,A02,083778,Staff,0,15,30,30
1651012214522,MATH 103A,B01,083779,Staff,0,15,30,30
1651012214522,MATH 103A,B02,083780,Staff,0,14,30,30
1651012220545,MATH 105,A01,085443,Staff,0,23,30,30
1651012226592,MATH 109,A01,083213,Anzaldo; Leesa B,0,7,30,30
1651012226592,MATH 109,A02,083214,Anzaldo; Leesa B,0,7,30,30
1651012226592,MATH 109,B01,083215,Anzaldo; Leesa B,0,8,30,30
1651012226592,MATH 109,B02,083216,Anzaldo; Leesa B,0,7,30,30
1651012232628,MATH 142A,A01,083219,Chow; Bennett,0,14,30,30
1651012232628,MATH 142A,A02,083220,Chow; Bennett,0,15,30,30
1651012232628,MATH 142A,B01,083221,Chow; Bennett,0,16,30,30
1651012232628,MATH 142A,B02,083222,Chow; Bennett,0,14,30,30
1651012238660,MATH 193A,A01,083224,Staff,0,7,30,30
1651012238660,MATH 193A,A02,083225,Staff,0,7,30,30
1651012238660,MATH 193A,A03,083781,Staff,0,7,30,30
1651012238660,MATH 193A,A04,083782,Staff,0,7,30,30
1651012244796,MATH 197,001,091859,McAuley; Julian John,9998,0,9999,1
1651012250853,COGS 9,A01,083615,Staff,0,19,60,60
1651012256888,COGS 11,A01,083617,Boyle; Mary E. T.,15,0,40,25
1651012262910,COGS 13,A01,083071,Staff,0,40,40,40
1651012268936,COGS 14A,A01,092681,Staff,0,40,100,100
1651012274961,COGS 14B,A01,083073,Cheng; Tzu-Han,0,13,50,50
1651012280985,COGS 17,A01,092677,Staff,7,0,75,68
1651012287011,COGS 100,A01,083619,Staff,0,30,60,60
1651012293038,COGS 101A,A01,083621,Davis; Joshua Daniel,0,30,60,60
1651012299072,COGS 101B,A01,091572,Staff,0,6,60,60
1651012305095,COGS 101C,A01,083625,Delgado; Tania,14,0,30,16
1651012311122,COGS 107A,A01,083627,Boyle; Mary E. T.,0,16,60,60
1651012317148,COGS 118A,A01,083075,Staff,0,10,60,60
1651012323173,CSE 3,A50,083646,Miranda; Gregory Joseph,15,0,38,23
1651012323173,CSE 3,A51,083647,Miranda; Gregory Joseph,36,0,37,1
1651012329204,CSE 8A,A50,083650,Miranda; Gregory Joseph,0,31,40,40
1651012335230,CSE 11,A01,083080,Cao; Yingjun,0,97,40,40
1651012341251,CSE 12,A01,083652,Staff,0,24,100,100
1651012347274,CSE 15L,A01,083654,Staff,0,3,50,50
1651012347274,CSE 15L,A02,083655,Staff,0,3,50,50
1651012353297,CSE 20,A01,083657,Staff,47,0,80,33
1651012359324,CSE 30,A01,083084,Eldon; John,1,39,80,79
1651012365345,CSE 100,A01,083659,Cao; Yingjun,0,72,50,50
1651012371367,CSE 134B,A01,083661,Powell; Thomas Allan,1,39,65,64
1651012377396,CSE 140,A01,083663,Staff,0,13,75,75
1651012383417,CSE 140L,A01,083088,Eldon; John,4,0,100,96
1651012389439,CSE 175,A01,083665,Kumar; Rakesh,0,0,25,25
1651012395465,CSE 190,A00,092507,Dubnov; Shlomo,9,0,20,11
1651012401488,ECE 45,A01,083139,Staff,0,7,60,60
1651012407524,ECE 65,A50,083695,Staff,0,7,30,30
1651012413546,ECE 109,A01,091882,Touri; Behrouz,32,0,70,38
1651012419572,ECE 180,A00,083140,Abi Samra; Nicholas Camill,17,0,30,13
1651012419572,ECE 180,B00,083141,Abi Samra; Nicholas Camill,0,0,30,30
1651012425631,MATH 10A,A01,083735,Patchell; Gregory David,1,0,30,29
1651012425631,MATH 10A,A02,083736,Patchell; Gregory David,27,0,30,3
1651012425631,MATH 10A,A03,083737,Patchell; Gregory David,23,0,30,7
1651012431656,MATH 10B,A01,083207,Staff,0,9,30,30
1651012431656,MATH 10B,A02,083208,Staff,0,5,30,30
1651012431656,MATH 10B,B01,083739,Staff,8,0,30,22
1651012431656,MATH 10B,B02,083740,Staff,28,0,30,2
1651012437773,MATH 18,A01,083743,Staff,0,0,30,30
1651012437773,MATH 18,A02,083744,Staff,23,0,30,7
1651012437773,MATH 18,A03,083745,Staff,19,0,30,11
1651012437773,MATH 18,A04,083746,Staff,26,0,30,4
1651012437773,MATH 18,B01,083748,Staff,0,16,30,30
1651012437773,MATH 18,B02,083749,Staff,0,14,30,30
1651012437773,MATH 18,B03,083750,Staff,0,14,30,30
1651012437773,MATH 18,B04,083751,Staff,0,13,30,30
1651012443800,MATH 20A,A01,083754,Staff,19,0,40,21
1651012449824,MATH 20B,A01,083756,Staff,0,14,30,30
1651012449824,MATH 20B,A02,083757,Staff,0,11,30,30
1651012455856,MATH 20C,A01,083760,Staff,0,17,30,30
1651012455856,MATH 20C,A02,083761,Staff,0,15,30,30
1651012455856,MATH 20C,B01,083762,Staff,9,0,30,21
1651012455856,MATH 20C,B02,083763,Staff,28,0,30,2
1651012461888,MATH 20D,A01,083765,Staff,3,1,30,27
1651012461888,MATH 20D,A02,083766,Staff,2,0,30,28
1651012461888,MATH 20D,A03,083767,Staff,22,0,30,8
1651012467910,MATH 20E,A01,083771,Staff,2,0,30,28
1651012467910,MATH 20E,A02,083772,Staff,12,0,30,18
1651012467910,MATH 20E,B01,083773,Staff,0,0,30,30
1651012467910,MATH 20E,B02,083774,Staff,1,0,30,29
1651012473940,MATH 103A,A01,083777,Staff,0,17,30,30
1651012473940,MATH 103A,A02,083778,Staff,0,15,30,30
1651012473940,MATH 103A,B01,083779,Staff,0,15,30,30
1651012473940,MATH 103A,B02,083780,Staff,0,14,30,30
1651012479963,MATH 105,A01,085443,Staff,0,23,30,30
1651012485998,MATH 109,A01,083213,Anzaldo; Leesa B,0,7,30,30
1651012485998,MATH 109,A02,083214,Anzaldo; Leesa B,0,7,30,30
1651012485998,MATH 109,B01,083215,Anzaldo; Leesa B,0,8,30,30
1651012485998,MATH 109,B02,083216,Anzaldo; Leesa B,0,7,30,30
1651012492026,MATH 142A,A01,083219,Chow; Bennett,0,14,30,30
1651012492026,MATH 142A,A02,083220,Chow; Bennett,0,15,30,30
1651012492026,MATH 142A,B01,083221,Chow; Bennett,0,16,30,30
1651012492026,MATH 142A,B02,083222,Chow; Bennett,0,14,30,30
1651012498050,MATH 193A,A01,083224,Staff,0,7,30,30
1651012498050,MATH 193A,A02,083225,Staff,0,7,30,30
1651012498050,MATH 193A,A03,083781,Staff,0,7,30,30
1651012498050,MATH 193A,A04,083782,Staff,0,7,30,30
1651012504072,MATH 197,001,091859,McAuley; Julian John,9998,0,9999,1
1651012510121,COGS 9,A01,083615,Staff,0,19,60,60
1651012516143,COGS 11,A01,083617,Boyle; Mary E. T.,15,0,40,25
1651012522168,COGS 13,A01,083071,Staff,0,40,40,40
1651012528192,COGS 14A,A01,092681,Staff,0,40,100,100
1651012534216,COGS 14B,A01,083073,Cheng; Tzu-Han,0,13,50,50
1651012540242,COGS 17,A01,092677,Staff,7,0,75,68
1651012546266,COGS 100,A01,083619,Staff,0,30,60,60
1651012552294,COGS 101A,A01,083621,Davis; Joshua Daniel,0,30,60,60
1651012558325,COGS 101B,A01,091572,Staff,0,6,60,60
1651012564350,COGS 101C,A01,083625,Delgado; Tania,14,0,30,16
1651012570376,COGS 107A,A01,083627,Boyle; Mary E. T.,0,16,60,60
1651012576398,COGS 118A,A01,083075,Staff,0,10,60,60
1651012582422,CSE 3,A50,083646,Miranda; Gregory Joseph,15,0,38,23
1651012582422,CSE 3,A51,083647,Miranda; Gregory Joseph,36,0,37,1
1651012588446,CSE 8A,A50,083650,Miranda; Gregory Joseph,0,31,40,40
1651012594470,CSE 11,A01,083080,Cao; Yingjun,0,97,40,40
1651012600496,CSE 12,A01,083652,Staff,0,24,100,100
1651012606522,CSE 15L,A01,083654,Staff,0,3,50,50
1651012606522,CSE 15L,A02,083655,Staff,0,3,50,50
1651012612548,CSE 20,A01,083657,Staff,47,0,80,33
1651012618574,CSE 30,A01,083084,Eldon; John,1,39,80,79
1651012624596,CSE 100,A01,083659,Cao; Yingjun,0,72,50,50
1651012630622,CSE 134B,A01,083661,Powell; Thomas Allan,1,39,65,64
1651012636648,CSE 140,A01,083663,Staff,0,13,75,75
1651012642670,CSE 140L,A01,083088,Eldon; John,4,0,100,96
1651012648695,CSE 175,A01,083665,Kumar; Rakesh,0,0,25,25
1651012654728,CSE 190,A00,092507,Dubnov; Shlomo,9,0,20,11
1651012660750,ECE 45,A01,083139,Staff,0,7,60,60
1651012666793,ECE 65,A50,083695,Staff,0,7,30,30
1651012672816,ECE 109,A01,091882,Touri; Behrouz,32,0,70,38
1651012678839,ECE 180,A00,083140,Abi Samra; Nicholas Camill,17,0,30,13
1651012678839,ECE 180,B00,083141,Abi Samra; Nicholas Camill,0,0,30,30
1651012684865,MATH 10A,A01,083735,Patchell; Gregory David,1,0,30,29
1651012684865,MATH 10A,A02,083736,Patchell; Gregory David,27,0,30,3
1651012684865,MATH 10A,A03,083737,Patchell; Gregory David,23,0,30,7
1651012690900,MATH 10B,A01,083207,Staff,0,9,30,30
1651012690900,MATH 10B,A02,083208,Staff,0,5,30,30
1651012690900,MATH 10B,B01,083739,Staff,8,0,30,22
1651012690900,MATH 10B,B02,083740,Staff,28,0,30,2
1651012696925,MATH 18,A01,083743,Staff,0,0,30,30
1651012696925,MATH 18,A02,083744,Staff,23,0,30,7
1651012696925,MATH 18,A03,083745,Staff,19,0,30,11
1651012696925,MATH 18,A04,083746,Staff,26,0,30,4
1651012696925,MATH 18,B01,083748,Staff,0,16,30,30
1651012696925,MATH 18,B02,083749,Staff,0,14,30,30
1651012696925,MATH 18,B03,083750,Staff,0,14,30,30
1651012696925,MATH 18,B04,083751,Staff,0,13,30,30
1651012702948,MATH 20A,A01,083754,Staff,19,0,40,21
1651012708972,MATH 20B,A01,083756,Staff,0,14,30,30
1651012708972,MATH 20B,A02,083757,Staff,0,11,30,30
1651012714998,MATH 20C,A01,083760,Staff,0,17,30,30
1651012714998,MATH 20C,A02,083761,Staff,0,15,30,30
1651012714998,MATH 20C,B01,083762,Staff,9,0,30,21
1651012714998,MATH 20C,B02,083763,Staff,28,0,30,2
1651012721020,MATH 20D,A01,083765,Staff,3,1,30,27
1651012721020,MATH 20D,A02,083766,Staff,2,0,30,28
1651012721020,MATH 20D,A03,083767,Staff,22,0,30,8
1651012727046,MATH 20E,A01,083771,Staff,2,0,30,28
1651012727046,MATH 20E,A02,083772,Staff,12,0,30,18
1651012727046,MATH 20E,B01,083773,Staff,0,0,30,30
1651012727046,MATH 20E,B02,083774,Staff,1,0,30,29
1651012733072,MATH 103A,A01,083777,Staff,0,17,30,30
1651012733072,MATH 103A,A02,083778,Staff,0,15,30,30
1651012733072,MATH 103A,B01,083779,Staff,0,15,30,30
1651012733072,MATH 103A,B02,083780,Staff,0,14,30,30
1651012739100,MATH 105,A01,085443,Staff,0,23,30,30
1651012745127,MATH 109,A01,083213,Anzaldo; Leesa B,0,7,30,30
1651012745127,MATH 109,A02,083214,Anzaldo; Leesa B,0,7,30,30
1651012745127,MATH 109,B01,083215,Anzaldo; Leesa B,0,8,30,30
1651012745127,MATH 109,B02,083216,Anzaldo; Leesa B,0,7,30,30
1651012751150,MATH 142A,A01,083219,Chow; Bennett,0,14,30,30
1651012751150,MATH 142A,A02,083220,Chow; Bennett,0,15,30,30
1651012751150,MATH 142A,B01,083221,Chow; Bennett,0,16,30,30
1651012751150,MATH 142A,B02,083222,Chow; Bennett,0,14,30,30
1651012757177,MATH 193A,A01,083224,Staff,0,7,30,30
1651012757177,MATH 193A,A02,083225,Staff,0,7,30,30
1651012757177,MATH 193A,A03,083781,Staff,0,7,30,30
1651012757177,MATH 193A,A04,083782,Staff,0,7,30,30
1651012763205,MATH 197,001,091859,McAuley; Julian John,9998,0,9999,1
1651012769269,COGS 9,A01,083615,Staff,0,19,60,60
1651012775292,COGS 11,A01,083617,Boyle; Mary E. T.,15,0,40,25
1651012781318,COGS 13,A01,083071,Staff,0,40,40,40
1651012787341,COGS 14A,A01,092681,Staff,0,40,100,100
1651012793369,COGS 14B,A01,083073,Cheng; Tzu-Han,0,13,50,50
1651012799398,COGS 17,A01,092677,Staff,7,0,75,68
1651012805424,COGS 100,A01,083619,Staff,0,30,60,60
1651012811453,COGS 101A,A01,083621,Davis; Joshua Daniel,0,30,60,60
1651012817481,COGS 101B,A01,091572,Staff,0,6,60,60
1651012823504,COGS 101C,A01,083625,Delgado; Tania,14,0,30,16
1651012829529,COGS 107A,A01,083627,Boyle; Mary E. T.,0,16,60,60
1651012835552,COGS 118A,A01,083075,Staff,0,10,60,60
1651012841578,CSE 3,A50,083646,Miranda; Gregory Joseph,15,0,38,23
1651012841578,CSE 3,A51,083647,Miranda; Gregory Joseph,36,0,37,1
1651012847616,CSE 8A,A50,083650,Miranda; Gregory Joseph,0,31,40,40
1651012853649,CSE 11,A01,083080,Cao; Yingjun,0,97,40,40
1651012859675,CSE 12,A01,083652,Staff,0,24,100,100
1651012865701,CSE 15L,A01,083654,Staff,0,3,50,50
1651012865701,CSE 15L,A02,083655,Staff,0,3,50,50
1651012871731,CSE 20,A01,083657,Staff,47,0,80,33
1651012877756,CSE 30,A01,083084,Eldon; John,1,39,80,79
1651012883784,CSE 100,A01,083659,Cao; Yingjun,0,72,50,50
1651012889808,CSE 134B,A01,083661,Powell; Thomas Allan,1,39,65,64
1651012895833,CSE 140,A01,083663,Staff,0,13,75,75
1651012901860,CSE 140L,A01,083088,Eldon; John,4,0,100,96
1651012907885,CSE 175,A01,083665,Kumar; Rakesh,0,0,25,25
1651012913908,CSE 190,A00,092507,Dubnov; Shlomo,9,0,20,11
1651012919940,ECE 45,A01,083139,Staff,0,7,60,60
1651012925966,ECE 65,A50,083695,Staff,0,7,30,30
1651012931991,ECE 109,A01,091882,Touri; Behrouz,32,0,70,38
1651012938015,ECE 180,A00,083140,Abi Samra; Nicholas Camill,17,0,30,13
1651012938015,ECE 180,B00,083141,Abi Samra; Nicholas Camill,0,0,30,30
1651012944044,MATH 10A,A01,083735,Patchell; Gregory David,1,0,30,29
1651012944044,MATH 10A,A02,083736,Patchell; Gregory David,27,0,30,3
1651012944044,MATH 10A,A03,083737,Patchell; Gregory David,23,0,30,7
1651012950067,MATH 10B,A01,083207,Staff,0,9,30,30
1651012950067,MATH 10B,A02,083208,Staff,0,5,30,30
1651012950067,MATH 10B,B01,083739,Staff,8,0,30,22
1651012950067,MATH 10B,B02,083740,Staff,28,0,30,2
1651012956095,MATH 18,A01,083743,Staff,0,0,30,30
1651012956095,MATH 18,A02,083744,Staff,23,0,30,7
1651012956095,MATH 18,A03,083745,Staff,19,0,30,11
1651012956095,MATH 18,A04,083746,Staff,26,0,30,4
1651012956095,MATH 18,B01,083748,Staff,0,16,30,30
1651012956095,MATH 18,B02,083749,Staff,0,14,30,30
1651012956095,MATH 18,B03,083750,Staff,0,14,30,30
1651012956095,MATH 18,B04,083751,Staff,0,13,30,30
1651012962118,MATH 20A,A01,083754,Staff,19,0,40,21
1651012968144,MATH 20B,A01,083756,Staff,0,14,30,30
1651012968144,MATH 20B,A02,083757,Staff,0,11,30,30
1651012974180,MATH 20C,A01,083760,Staff,0,17,30,30
1651012974180,MATH 20C,A02,083761,Staff,0,15,30,30
1651012974180,MATH 20C,B01,083762,Staff,9,0,30,21
1651012974180,MATH 20C,B02,083763,Staff,28,0,30,2
1651012980214,MATH 20D,A01,083765,Staff,3,1,30,27
1651012980214,MATH 20D,A02,083766,Staff,2,0,30,28
1651012980214,MATH 20D,A03,083767,Staff,22,0,30,8
1651012986242,MATH 20E,A01,083771,Staff,2,0,30,28
1651012986242,MATH 20E,A02,083772,Staff,12,0,30,18
1651012986242,MATH 20E,B01,083773,Staff,0,0,30,30
1651012986242,MATH 20E,B02,083774,Staff,1,0,30,29
1651012992266,MATH 103A,A01,083777,Staff,0,17,30,30
1651012992266,MATH 103A,A02,083778,Staff,0,15,30,30
1651012992266,MATH 103A,B01,083779,Staff,0,15,30,30
1651012992266,MATH 103A,B02,083780,Staff,0,14,30,30
1651012998290,MATH 105,A01,085443,Staff,0,23,30,30
1651013004324,MATH 109,A01,083213,Anzaldo; Leesa B,0,7,30,30
1651013004324,MATH 109,A02,083214,Anzaldo; Leesa B,0,7,30,30
1651013004324,MATH 109,B01,083215,Anzaldo; Leesa B,0,8,30,30
1651013004324,MATH 109,B02,083216,Anzaldo; Leesa B,0,7,30,30
1651013010353,MATH 142A,A01,083219,Chow; Bennett,0,14,30,30
1651013010353,MATH 142A,A02,083220,Chow; Bennett,0,15,30,30
1651013010353,MATH 142A,B01,083221,Chow; Bennett,0,16,30,30
1651013010353,MATH 142A,B02,083222,Chow; Bennett,0,14,30,30
1651013016377,MATH 193A,A01,083224,Staff,0,7,30,30
1651013016377,MATH 193A,A02,083225,Staff,0,7,30,30
1651013016377,MATH 193A,A03,083781,Staff,0,7,30,30
1651013016377,MATH 193A,A04,083782,Staff,0,7,30,30
1651013022402,MATH 197,001,091859,McAuley; Julian John,9998,0,9999,1
1651013028595,COGS 9,A01,083615,Staff,0,19,60,60
1651013034623,COGS 11,A01,083617,Boyle; Mary E. T.,15,0,40,25
1651013040654,COGS 13,A01,083071,Staff,0,40,40,40
1651013046681,COGS 14A,A01,092681,Staff,0,40,100,100
1651013052713,COGS 14B,A01,083073,Cheng; Tzu-Han,0,13,50,50
1651013058736,COGS 17,A01,092677,Staff,7,0,75,68
1651013064759,COGS 100,A01,083619,Staff,0,30,60,60
1651013070788,COGS 101A,A01,083621,Davis; Joshua Daniel,0,30,60,60
1651013076819,COGS 101B,A01,091572,Staff,0,6,60,60
1651013082855,COGS 101C,A01,083625,Delgado; Tania,14,0,30,16
1651013088879,COGS 107A,A01,083627,Boyle; Mary E. T.,0,16,60,60
1651013094904,COGS 118A,A01,083075,Staff,0,10,60,60
1651013100927,CSE 3,A50,083646,Miranda; Gregory Joseph,15,0,38,23
1651013100927,CSE 3,A51,083647,Miranda; Gregory Joseph,36,0,37,1
1651013106954,CSE 8A,A50,083650,Miranda; Gregory Joseph,0,31,40,40
1651013112977,CSE 11,A01,083080,Cao; Yingjun,0,97,40,40
1651013119001,CSE 12,A01,083652,Staff,0,24,100,100
1651013125034,CSE 15L,A01,083654,Staff,0,3,50,50
1651013125034,CSE 15L,A02,083655,Staff,0,3,50,50
1651013131056,CSE 20,A01,083657,Staff,47,0,80,33
1651013137083,CSE 30,A01,083084,Eldon; John,1,39,80,79
1651013143105,CSE 100,A01,083659,Cao; Yingjun,0,72,50,50
1651013149131,CSE 134B,A01,083661,Powell; Thomas Allan,1,39,65,64
1651013155158,CSE 140,A01,083663,Staff,0,13,75,75
1651013161184,CSE 140L,A01,083088,Eldon; John,4,0,100,96
1651013167214,CSE 175,A01,083665,Kumar; Rakesh,0,0,25,25
1651013173239,CSE 190,A00,092507,Dubnov; Shlomo,9,0,20,11
1651013179262,ECE 45,A01,083139,Staff,0,7,60,60
1651013185287,ECE 65,A50,083695,Staff,0,7,30,30
1651013191309,ECE 109,A01,091882,Touri; Behrouz,32,0,70,38
1651013197339,ECE 180,A00,083140,Abi Samra; Nicholas Camill,17,0,30,13
1651013197339,ECE 180,B00,083141,Abi Samra; Nicholas Camill,0,0,30,30
1651013203368,MATH 10A,A01,083735,Patchell; Gregory David,1,0,30,29
1651013203368,MATH 10A,A02,083736,Patchell; Gregory David,27,0,30,3
1651013203368,MATH 10A,A03,083737,Patchell; Gregory David,23,0,30,7
1651013209405,MATH 10B,A01,083207,Staff,0,9,30,30
1651013209405,MATH 10B,A02,083208,Staff,0,5,30,30
1651013209405,MATH 10B,B01,083739,Staff,8,0,30,22
1651013209405,MATH 10B,B02,083740,Staff,28,0,30,2
1651013215440,MATH 18,A01,083743,Staff,0,0,30,30
1651013215440,MATH 18,A02,083744,Staff,23,0,30,7
1651013215440,MATH 18,A03,083745,Staff,19,0,30,11
1651013215440,MATH 18,A04,083746,Staff,26,0,30,4
1651013215440,MATH 18,B01,083748,Staff,0,16,30,30
1651013215440,MATH 18,B02,083749,Staff,0,14,30,30
1651013215440,MATH 18,B03,083750,Staff,0,14,30,30
1651013215440,MATH 18,B04,083751,Staff,0,13,30,30
1651013221466,MATH 20A,A01,083754,Staff,19,0,40,21
1651013227505,MATH 20B,A01,083756,Staff,0,14,30,30
1651013227505,MATH 20B,A02,083757,Staff,0,11,30,30
1651013233541,MATH 20C,A01,083760,Staff,0,17,30,30
1651013233541,MATH 20C,A02,083761,Staff,0,15,30,30
1651013233541,MATH 20C,B01,083762,Staff,9,0,30,21
1651013233541,MATH 20C,B02,083763,Staff,28,0,30,2
1651013239564,MATH 20D,A01,083765,Staff,3,1,30,27
1651013239564,MATH 20D,A02,083766,Staff,2,0,30,28
1651013239564,MATH 20D,A03,083767,Staff,22,0,30,8
1651013245598,MATH 20E,A01,083771,Staff,2,0,30,28
1651013245598,MATH 20E,A02,083772,Staff,12,0,30,18
1651013245598,MATH 20E,B01,083773,Staff,0,0,30,30
1651013245598,MATH 20E,B02,083774,Staff,1,0,30,29
1651013251633,MATH 103A,A01,083777,Staff,0,17,30,30
1651013251633,MATH 103A,A02,083778,Staff,0,15,30,30
1651013251633,MATH 103A,B01,083779,Staff,0,15,30,30
1651013251633,MATH 103A,B02,083780,Staff,0,14,30,30
1651013257668,MATH 105,A01,085443,Staff,0,23,30,30
1651013263696,MATH 109,A01,083213,Anzaldo; Leesa B,0,7,30,30
1651013263696,MATH 109,A02,083214,Anzaldo; Leesa B,0,7,30,30
1651013263696,MATH 109,B01,083215,Anzaldo; Leesa B,0,8,30,30
1651013263696,MATH 109,B02,083216,Anzaldo; Leesa B,0,7,30,30
1651013269719,MATH 142A,A01,083219,Chow; Bennett,0,14,30,30
1651013269719,MATH 142A,A02,083220,Chow; Bennett,0,15,30,30
1651013269719,MATH 142A,B01,083221,Chow; Bennett,0,16,30,30
1651013269719,MATH 142A,B02,083222,Chow; Bennett,0,14,30,30
1651013275741,MATH 193A,A01,083224,Staff,0,7,30,30
1651013275741,MATH 193A,A02,083225,Staff,0,7,30,30
1651013275741,MATH 193A,A03,083781,Staff,0,7,30,30
1651013275741,MATH 193A,A04,083782,Staff,0,7,30,30
1651013281765,MATH 197,001,091859,McAuley; Julian John,9998,0,9999,1
1651013287815,COGS 9,A01,083615,Staff,0,19,60,60
1651013293844,COGS 11,A01,083617,Boyle; Mary E. T.,15,0,40,25
1651013299869,COGS 13,A01,083071,Staff,0,40,40,40
1651013305892,COGS 14A,A01,092681,Staff,0,40,100,100
1651013311940,COGS 14B,A01,083073,Cheng; Tzu-Han,0,13,50,50
1651013317967,COGS 17,A01,092677,Staff,7,0,75,68
1651013324001,COGS 100,A01,083619,Staff,0,30,60,60
1651013330035,COGS 101A,A01,083621,Davis; Joshua Daniel,0,30,60,60
1651013336057,COGS 101B,A01,091572,Staff,0,6,60,60
1651013342085,COGS 101C,A01,083625,Delgado; Tania,14,0,30,16
1651013348112,COGS 107A,A01,083627,Boyle; Mary E. T.,0,16,60,60
1651013354135,COGS 118A,A01,083075,Staff,0,10,60,60
1651013360163,CSE 3,A50,083646,Miranda; Gregory Joseph,15,0,38,23
1651013360163,CSE 3,A51,083647,Miranda; Gregory Joseph,36,0,37,1
1651013366197,CSE 8A,A50,083650,Miranda; Gregory Joseph,0,31,40,40
1651013372218,CSE 11,A01,083080,Cao; Yingjun,0,97,40,40
1651013378248,CSE 12,A01,083652,Staff,0,24,100,100
1651013384272,CSE 15L,A01,083654,Staff,0,3,50,50
1651013384272,CSE 15L,A02,083655,Staff,0,3,50,50
1651013390295,CSE 20,A01,083657,Staff,47,0,80,33
1651013396321,CSE 30,A01,083084,Eldon; John,1,39,80,79
1651013402344,CSE 100,A01,083659,Cao; Yingjun,0,72,50,50
1651013408373,CSE 134B,A01,083661,Powell; Thomas Allan,1,39,65,64
1651013414406,CSE 140,A01,083663,Staff,0,13,75,75
1651013420432,CSE 140L,A01,083088,Eldon; John,4,0,100,96
1651013426455,CSE 175,A01,083665,Kumar; Rakesh,0,0,25,25
1651013432488,CSE 190,A00,092507,Dubnov; Shlomo,9,0,20,11
1651013438511,ECE 45,A01,083139,Staff,0,7,60,60
1651013444539,ECE 65,A50,083695,Staff,0,7,30,30
1651013450570,ECE 109,A01,091882,Touri; Behrouz,32,0,70,38
1651013456596,ECE 180,A00,083140,Abi Samra; Nicholas Camill,17,0,30,13
1651013456596,ECE 180,B00,083141,Abi Samra; Nicholas Camill,0,0,30,30
1651013462621,MATH 10A,A01,083735,Patchell; Gregory David,1,0,30,29
1651013462621,MATH 10A,A02,083736,Patchell; Gregory David,27,0,30,3
1651013462621,MATH 10A,A03,083737,Patchell; Gregory David,23,0,30,7
1651013468649,MATH 10B,A01,083207,Staff,0,9,30,30
1651013468649,MATH 10B,A02,083208,Staff,0,5,30,30
1651013468649,MATH 10B,B01,083739,Staff,8,0,30,22
1651013468649,MATH 10B,B02,083740,Staff,28,0,30,2
1651013474679,MATH 18,A01,083743,Staff,0,0,30,30
1651013474679,MATH 18,A02,083744,Staff,23,0,30,7
1651013474679,MATH 18,A03,083745,Staff,19,0,30,11
1651013474679,MATH 18,A04,083746,Staff,26,0,30,4
1651013474679,MATH 18,B01,083748,Staff,0,16,30,30
1651013474679,MATH 18,B02,083749,Staff,0,14,30,30
1651013474679,MATH 18,B03,083750,Staff,0,14,30,30
1651013474679,MATH 18,B04,083751,Staff,0,13,30,30
1651013480712,MATH 20A,A01,083754,Staff,19,0,40,21
1651013486736,MATH 20B,A01,083756,Staff,0,14,30,30
1651013486736,MATH 20B,A02,083757,Staff,0,11,30,30
1651013492760,MATH 20C,A01,083760,Staff,0,17,30,30
1651013492760,MATH 20C,A02,083761,Staff,0,15,30,30
1651013492760,MATH 20C,B01,083762,Staff,9,0,30,21
1651013492760,MATH 20C,B02,083763,Staff,28,0,30,2
1651013498787,MATH 20D,A01,083765,Staff,3,1,30,27
1651013498787,MATH 20D,A02,083766,Staff,2,0,30,28
1651013498787,MATH 20D,A03,083767,Staff,22,0,30,8
1651013504815,MATH 20E,A01,083771,Staff,2,0,30,28
1651013504815,MATH 20E,A02,083772,Staff,12,0,30,18
1651013504815,MATH 20E,B01,083773,Staff,0,0,30,30
1651013504815,MATH 20E,B02,083774,Staff,1,0,30,29
1651013510843,MATH 103A,A01,083777,Staff,0,17,30,30
1651013510843,MATH 103A,A02,083778,Staff,0,15,30,30
1651013510843,MATH 103A,B01,083779,Staff,0,15,30,30
1651013510843,MATH 103A,B02,083780,Staff,0,14,30,30
1651013516874,MATH 105,A01,085443,Staff,0,23,30,30
1651013522898,MATH 109,A01,083213,Anzaldo; Leesa B,0,7,30,30
1651013522898,MATH 109,A02,083214,Anzaldo; Leesa B,0,7,30,30
1651013522898,MATH 109,B01,083215,Anzaldo; Leesa B,0,8,30,30
1651013522898,MATH 109,B02,083216,Anzaldo; Leesa B,0,7,30,30
1651013528923,MATH 142A,A01,083219,Chow; Bennett,0,14,30,30
1651013528923,MATH 142A,A02,083220,Chow; Bennett,0,15,30,30
1651013528923,MATH 142A,B01,083221,Chow; Bennett,0,16,30,30
1651013528923,MATH 142A,B02,083222,Chow; Bennett,0,14,30,30
1651013534951,MATH 193A,A01,083224,Staff,0,7,30,30
1651013534951,MATH 193A,A02,083225,Staff,0,7,30,30
1651013534951,MATH 193A,A03,083781,Staff,0,7,30,30
1651013534951,MATH 193A,A04,083782,Staff,0,7,30,30
1651013540976,MATH 197,001,091859,McAuley; Julian John,9998,0,9999,1
1651013547036,COGS 9,A01,083615,Staff,0,19,60,60
1651013553059,COGS 11,A01,083617,Boyle; Mary E. T.,15,0,40,25
1651013559085,COGS 13,A01,083071,Staff,0,40,40,40
1651013565113,COGS 14A,A01,092681,Staff,0,40,100,100
1651013571145,COGS 14B,A01,083073,Cheng; Tzu-Han,0,13,50,50
1651013577167,COGS 17,A01,092677,Staff,7,0,75,68
1651013583194,COGS 100,A01,083619,Staff,0,30,60,60
1651013589221,COGS 101A,A01,083621,Davis; Joshua Daniel,0,30,60,60
1651013595254,COGS 101B,A01,091572,Staff,0,6,60,60
1651013601280,COGS 101C,A01,083625,Delgado; Tania,14,0,30,16
1651013607305,COGS 107A,A01,083627,Boyle; Mary E. T.,0,16,60,60
1651013613330,COGS 118A,A01,083075,Staff,0,10,60,60
1651013619367,CSE 3,A50,083646,Miranda; Gregory Joseph,15,0,38,23
1651013619367,CSE 3,A51,083647,Miranda; Gregory Joseph,36,0,37,1
1651013625485,CSE 8A,A50,083650,Miranda; Gregory Joseph,0,31,40,40
1651013631514,CSE 11,A01,083080,Cao; Yingjun,0,97,40,40
1651013637540,CSE 12,A01,083652,Staff,0,24,100,100
1651013643567,CSE 15L,A01,083654,Staff,0,3,50,50
1651013643567,CSE 15L,A02,083655,Staff,0,3,50,50
1651013649603,CSE 20,A01,083657,Staff,47,0,80,33
1651013655629,CSE 30,A01,083084,Eldon; John,1,39,80,79
1651013661656,CSE 100,A01,083659,Cao; Yingjun,0,72,50,50
1651013667681,CSE 134B,A01,083661,Powell; Thomas Allan,1,39,65,64
1651013673704,CSE 140,A01,083663,Staff,0,13,75,75
1651013679727,CSE 140L,A01,083088,Eldon; John,4,0,100,96
1651013685749,CSE 175,A01,083665,Kumar; Rakesh,0,0,25,25
1651013691775,CSE 190,A00,092507,Dubnov; Shlomo,9,0,20,11
1651013697798,ECE 45,A01,083139,Staff,0,7,60,60
1651013703825,ECE 65,A50,083695,Staff,0,7,30,30
1651013709848,ECE 109,A01,091882,Touri; Behrouz,32,0,70,38
1651013715875,ECE 180,A00,083140,Abi Samra; Nicholas Camill,17,0,30,13
1651013715875,ECE 180,B00,083141,Abi Samra; Nicholas Camill,0,0,30,30
1651013721902,MATH 10A,A01,083735,Patchell; Gregory David,1,0,30,29
1651013721902,MATH 10A,A02,083736,Patchell; Gregory David,27,0,30,3
1651013721902,MATH 10A,A03,083737,Patchell; Gregory David,23,0,30,7
1651013727926,MATH 10B,A01,083207,Staff,0,9,30,30
1651013727926,MATH 10B,A02,083208,Staff,0,5,30,30
1651013727926,MATH 10B,B01,083739,Staff,8,0,30,22
1651013727926,MATH 10B,B02,083740,Staff,28,0,30,2
1651013733953,MATH 18,A01,083743,Staff,0,0,30,30
1651013733953,MATH 18,A02,083744,Staff,23,0,30,7
1651013733953,MATH 18,A03,083745,Staff,19,0,30,11
1651013733953,MATH 18,A04,083746,Staff,26,0,30,4
1651013733953,MATH 18,B01,083748,Staff,0,16,30,30
1651013733953,MATH 18,B02,083749,Staff,0,14,30,30
1651013733953,MATH 18,B03,083750,Staff,0,14,30,30
1651013733953,MATH 18,B04,083751,Staff,0,13,30,30
1651013739979,MATH 20A,A01,083754,Staff,19,0,40,21
1651013746005,MATH 20B,A01,083756,Staff,0,14,30,30
1651013746005,MATH 20B,A02,083757,Staff,0,11,30,30
1651013752030,MATH 20C,A01,083760,Staff,0,17,30,30
1651013752030,MATH 20C,A02,083761,Staff,0,15,30,30
1651013752030,MATH 20C,B01,083762,Staff,9,0,30,21
1651013752030,MATH 20C,B02,083763,Staff,28,0,30,2
1651013758056,MATH 20D,A01,083765,Staff,3,1,30,27
1651013758056,MATH 20D,A02,083766,Staff,2,0,30,28
1651013758056,MATH 20D,A03,083767,Staff,22,0,30,8
1651013764082,MATH 20E,A01,083771,Staff,2,0,30,28
1651013764082,MATH 20E,A02,083772,Staff,12,0,30,18
1651013764082,MATH 20E,B01,083773,Staff,0,0,30,30
1651013764082,MATH 20E,B02,083774,Staff,1,0,30,29
1651013770109,MATH 103A,A01,083777,Staff,0,17,30,30
1651013770109,MATH 103A,A02,083778,Staff,0,15,30,30
1651013770109,MATH 103A,B01,083779,Staff,0,15,30,30
1651013770109,MATH 103A,B02,083780,Staff,0,14,30,30
1651013776139,MATH 105,A01,085443,Staff,0,23,30,30
1651013782163,MATH 109,A01,083213,Anzaldo; Leesa B,0,7,30,30
1651013782163,MATH 109,A02,083214,Anzaldo; Leesa B,0,7,30,30
1651013782163,MATH 109,B01,083215,Anzaldo; Leesa B,0,8,30,30
1651013782163,MATH 109,B02,083216,Anzaldo; Leesa B,0,7,30,30
1651013788192,MATH 142A,A01,083219,Chow; Bennett,0,14,30,30
1651013788192,MATH 142A,A02,083220,Chow; Bennett,0,15,30,30
1651013788192,MATH 142A,B01,083221,Chow; Bennett,0,16,30,30
1651013788192,MATH 142A,B02,083222,Chow; Bennett,0,14,30,30
1651013794218,MATH 193A,A01,083224,Staff,0,7,30,30
1651013794218,MATH 193A,A02,083225,Staff,0,7,30,30
1651013794218,MATH 193A,A03,083781,Staff,0,7,30,30
1651013794218,MATH 193A,A04,083782,Staff,0,7,30,30
1651013800243,MATH 197,001,091859,McAuley; Julian John,9998,0,9999,1
1651013806296,COGS 9,A01,083615,Staff,0,19,60,60
1651013812320,COGS 11,A01,083617,Boyle; Mary E. T.,14,0,40,26
1651013818350,COGS 13,A01,083071,Staff,0,40,40,40
1651013824372,COGS 14A,A01,092681,Staff,0,40,100,100
1651013830396,COGS 14B,A01,083073,Cheng; Tzu-Han,0,13,50,50
1651013836421,COGS 17,A01,092677,Staff,7,0,75,68
1651013842443,COGS 100,A01,083619,Staff,0,30,60,60
1651013848470,COGS 101A,A01,083621,Davis; Joshua Daniel,0,30,60,60
1651013854495,COGS 101B,A01,091572,Staff,0,6,60,60
1651013860524,COGS 101C,A01,083625,Delgado; Tania,14,0,30,16
1651013866547,COGS 107A,A01,083627,Boyle; Mary E. T.,0,16,60,60
1651013872571,COGS 118A,A01,083075,Staff,0,10,60,60
1651013878594,CSE 3,A50,083646,Miranda; Gregory Joseph,15,0,38,23
1651013878594,CSE 3,A51,083647,Miranda; Gregory Joseph,36,0,37,1
1651013884624,CSE 8A,A50,083650,Miranda; Gregory Joseph,0,31,40,40
1651013890652,CSE 11,A01,083080,Cao; Yingjun,0,97,40,40
1651013896679,CSE 12,A01,083652,Staff,0,24,100,100
1651013902718,CSE 15L,A01,083654,Staff,0,3,50,50
1651013902718,CSE 15L,A02,083655,Staff,0,3,50,50
1651013908747,CSE 20,A01,083657,Staff,47,0,80,33
1651013914776,CSE 30,A01,083084,Eldon; John,1,39,80,79
1651013920800,CSE 100,A01,083659,Cao; Yingjun,0,72,50,50
1651013926830,CSE 134B,A01,083661,Powell; Thomas Allan,1,39,65,64
1651013932852,CSE 140,A01,083663,Staff,0,13,75,75
1651013938875,CSE 140L,A01,083088,Eldon; John,4,0,100,96
1651013944901,CSE 175,A01,083665,Kumar; Rakesh,0,0,25,25
1651013950928,CSE 190,A00,092507,Dubnov; Shlomo,9,0,20,11
1651013956953,ECE 45,A01,083139,Staff,0,7,60,60
1651013962992,ECE 65,A50,083695,Staff,0,7,30,30
1651013969015,ECE 109,A01,091882,Touri; Behrouz,32,0,70,38
1651013975046,ECE 180,A00,083140,Abi Samra; Nicholas Camill,17,0,30,13
1651013975046,ECE 180,B00,083141,Abi Samra; Nicholas Camill,0,0,30,30
1651013981069,MATH 10A,A01,083735,Patchell; Gregory David,1,0,30,29
1651013981069,MATH 10A,A02,083736,Patchell; Gregory David,27,0,30,3
1651013981069,MATH 10A,A03,083737,Patchell; Gregory David,23,0,30,7
1651013987096,MATH 10B,A01,083207,Staff,0,9,30,30
1651013987096,MATH 10B,A02,083208,Staff,0,5,30,30
1651013987096,MATH 10B,B01,083739,Staff,8,0,30,22
1651013987096,MATH 10B,B02,083740,Staff,28,0,30,2
1651013993143,MATH 18,A01,083743,Staff,0,0,30,30
1651013993143,MATH 18,A02,083744,Staff,23,0,30,7
1651013993143,MATH 18,A03,083745,Staff,19,0,30,11
1651013993143,MATH 18,A04,083746,Staff,26,0,30,4
1651013993143,MATH 18,B01,083748,Staff,0,16,30,30
1651013993143,MATH 18,B02,083749,Staff,0,14,30,30
1651013993143,MATH 18,B03,083750,Staff,0,14,30,30
1651013993143,MATH 18,B04,083751,Staff,0,13,30,30
1651013999164,MATH 20A,A01,083754,Staff,19,0,40,21
1651014005189,MATH 20B,A01,083756,Staff,0,14,30,30
1651014005189,MATH 20B,A02,083757,Staff,0,11,30,30
1651014011212,MATH 20C,A01,083760,Staff,0,17,30,30
1651014011212,MATH 20C,A02,083761,Staff,0,15,30,30
1651014011212,MATH 20C,B01,083762,Staff,9,0,30,21
1651014011212,MATH 20C,B02,083763,Staff,28,0,30,2
1651014017247,MATH 20D,A01,083765,Staff,3,1,30,27
1651014017247,MATH 20D,A02,083766,Staff,2,0,30,28
1651014017247,MATH 20D,A03,083767,Staff,22,0,30,8
1651014023279,MATH 20E,A01,083771,Staff,2,0,30,28
1651014023279,MATH 20E,A02,083772,Staff,12,0,30,18
1651014023279,MATH 20E,B01,083773,Staff,0,0,30,30
1651014023279,MATH 20E,B02,083774,Staff,1,0,30,29
1651014029307,MATH 103A,A01,083777,Staff,0,17,30,30
1651014029307,MATH 103A,A02,083778,Staff,0,15,30,30
1651014029307,MATH 103A,B01,083779,Staff,0,15,30,30
1651014029307,MATH 103A,B02,083780,Staff,0,14,30,30
1651014035336,MATH 105,A01,085443,Staff,0,23,30,30
1651014041358,MATH 109,A01,083213,Anzaldo; Leesa B,0,7,30,30
1651014041358,MATH 109,A02,083214,Anzaldo; Leesa B,0,7,30,30
1651014041358,MATH 109,B01,083215,Anzaldo; Leesa B,0,8,30,30
1651014041358,MATH 109,B02,083216,Anzaldo; Leesa B,0,7,30,30
1651014047386,MATH 142A,A01,083219,Chow; Bennett,0,14,30,30
1651014047386,MATH 142A,A02,083220,Chow; Bennett,0,15,30,30
1651014047386,MATH 142A,B01,083221,Chow; Bennett,0,16,30,30
1651014047386,MATH 142A,B02,083222,Chow; Bennett,0,14,30,30
1651014053413,MATH 193A,A01,083224,Staff,0,7,30,30
1651014053413,MATH 193A,A02,083225,Staff,0,7,30,30
1651014053413,MATH 193A,A03,083781,Staff,0,7,30,30
1651014053413,MATH 193A,A04,083782,Staff,0,7,30,30
1651014059444,MATH 197,001,091859,McAuley; Julian John,9998,0,9999,1
1651014065531,COGS 9,A01,083615,Staff,0,19,60,60
1651014071553,COGS 11,A01,083617,Boyle; Mary E. T.,14,0,40,26
1651014077574,COGS 13,A01,083071,Staff,0,40,40,40
1651014083597,COGS 14A,A01,092681,Staff,0,40,100,100
1651014089620,COGS 14B,A01,083073,Cheng; Tzu-Han,0,13,50,50
1651014095646,COGS 17,A01,092677,Staff,7,0,75,68
1651014101673,COGS 100,A01,083619,Staff,0,30,60,60
1651014107699,COGS 101A,A01,083621,Davis; Joshua Daniel,0,30,60,60
1651014113724,COGS 101B,A01,091572,Staff,0,6,60,60
1651014119755,COGS 101C,A01,083625,Delgado; Tania,14,0,30,16
1651014125779,COGS 107A,A01,083627,Boyle; Mary E. T.,0,16,60,60
1651014131801,COGS 118A,A01,083075,Staff,0,10,60,60
1651014137825,CSE 3,A50,083646,Miranda; Gregory Joseph,15,0,38,23
1651014137825,CSE 3,A51,083647,Miranda; Gregory Joseph,36,0,37,1
1651014143848,CSE 8A,A50,083650,Miranda; Gregory Joseph,0,31,40,40
1651014149875,CSE 11,A01,083080,Cao; Yingjun,0,97,40,40
1651014155900,CSE 12,A01,083652,Staff,0,24,100,100
1651014161924,CSE 15L,A01,083654,Staff,0,3,50,50
1651014161924,CSE 15L,A02,083655,Staff,0,3,50,50
1651014167949,CSE 20,A01,083657,Staff,47,0,80,33
1651014173981,CSE 30,A01,083084,Eldon; John,1,39,80,79
1651014180009,CSE 100,A01,083659,Cao; Yingjun,0,72,50,50
1651014186031,CSE 134B,A01,083661,Powell; Thomas Allan,1,39,65,64
1651014192057,CSE 140,A01,083663,Staff,0,13,75,75
1651014198080,CSE 140L,A01,083088,Eldon; John,4,0,100,96
1651014204105,CSE 175,A01,083665,Kumar; Rakesh,0,0,25,25
1651014210128,CSE 190,A00,092507,Dubnov; Shlomo,9,0,20,11
1651014216160,ECE 45,A01,083139,Staff,0,7,60,60
1651014222272,ECE 65,A50,083695,Staff,0,7,30,30
1651014228296,ECE 109,A01,091882,Touri; Behrouz,32,0,70,38
1651014234331,ECE 180,A00,083140,Abi Samra; Nicholas Camill,17,0,30,13
1651014234331,ECE 180,B00,083141,Abi Samra; Nicholas Camill,0,0,30,30
1651014240360,MATH 10A,A01,083735,Patchell; Gregory David,1,0,30,29
1651014240360,MATH 10A,A02,083736,Patchell; Gregory David,27,0,30,3
1651014240360,MATH 10A,A03,083737,Patchell; Gregory David,23,0,30,7
1651014246387,MATH 10B,A01,083207,Staff,0,9,30,30
1651014246387,MATH 10B,A02,083208,Staff,0,5,30,30
1651014246387,MATH 10B,B01,083739,Staff,8,0,30,22
1651014246387,MATH 10B,B02,083740,Staff,28,0,30,2
1651014252420,MATH 18,A01,083743,Staff,0,0,30,30
1651014252420,MATH 18,A02,083744,Staff,23,0,30,7
1651014252420,MATH 18,A03,083745,Staff,19,0,30,11
1651014252420,MATH 18,A04,083746,Staff,26,0,30,4
1651014252420,MATH 18,B01,083748,Staff,0,16,30,30
1651014252420,MATH 18,B02,083749,Staff,0,14,30,30
1651014252420,MATH 18,B03,083750,Staff,0,14,30,30
1651014252420,MATH 18,B04,083751,Staff,0,13,30,30
1651014258443,MATH 20A,A01,083754,Staff,19,0,40,21
1651014264467,MATH 20B,A01,083756,Staff,0,14,30,30
1651014264467,MATH 20B,A02,083757,Staff,0,11,30,30
1651014270492,MATH 20C,A01,083760,Staff,0,17,30,30
1651014270492,MATH 20C,A02,083761,Staff,0,15,30,30
1651014270492,MATH 20C,B01,083762,Staff,9,0,30,21
1651014270492,MATH 20C,B02,083763,Staff,28,0,30,2
1651014276518,MATH 20D,A01,083765,Staff,3,1,30,27
1651014276518,MATH 20D,A02,083766,Staff,2,0,30,28
1651014276518,MATH 20D,A03,083767,Staff,22,0,30,8
1651014282542,MATH 20E,A01,083771,Staff,2,0,30,28
1651014282542,MATH 20E,A02,083772,Staff,12,0,30,18
1651014282542,MATH 20E,B01,083773,Staff,0,0,30,30
1651014282542,MATH 20E,B02,083774,Staff,1,0,30,29
1651014288566,MATH 103A,A01,083777,Staff,0,17,30,30
1651014288566,MATH 103A,A02,083778,Staff,0,15,30,30
1651014288566,MATH 103A,B01,083779,Staff,0,14,30,30
1651014288566,MATH 103A,B02,083780,Staff,0,14,30,30
1651014294606,MATH 105,A01,085443,Staff,0,23,30,30
1651014300639,MATH 109,A01,083213,Anzaldo; Leesa B,0,7,30,30
1651014300639,MATH 109,A02,083214,Anzaldo; Leesa B,0,7,30,30
1651014300639,MATH 109,B01,083215,Anzaldo; Leesa B,0,8,30,30
1651014300639,MATH 109,B02,083216,Anzaldo; Leesa B,0,7,30,30
1651014306664,MATH 142A,A01,083219,Chow; Bennett,0,14,30,30
1651014306664,MATH 142A,A02,083220,Chow; Bennett,0,15,30,30
1651014306664,MATH 142A,B01,083221,Chow; Bennett,0,16,30,30
1651014306664,MATH 142A,B02,083222,Chow; Bennett,0,14,30,30
1651014312688,MATH 193A,A01,083224,Staff,0,7,30,30
1651014312688,MATH 193A,A02,083225,Staff,0,7,30,30
1651014312688,MATH 193A,A03,083781,Staff,0,7,30,30
1651014312688,MATH 193A,A04,083782,Staff,0,7,30,30
1651014318710,MATH 197,001,091859,McAuley; Julian John,9998,0,9999,1
1651014324760,COGS 9,A01,083615,Staff,0,19,60,60
1651014330788,COGS 11,A01,083617,Boyle; Mary E. T.,13,0,40,27
1651014336812,COGS 13,A01,083071,Staff,0,40,40,40
1651014342835,COGS 14A,A01,092681,Staff,0,40,100,100
1651014348860,COGS 14B,A01,083073,Cheng; Tzu-Han,0,13,50,50
1651014354898,COGS 17,A01,092677,Staff,7,0,75,68
1651014360932,COGS 100,A01,083619,Staff,0,30,60,60
1651014366956,COGS 101A,A01,083621,Davis; Joshua Daniel,0,30,60,60
1651014372991,COGS 101B,A01,091572,Staff,0,7,60,60
1651014379017,COGS 101C,A01,083625,Delgado; Tania,14,0,30,16
1651014385046,COGS 107A,A01,083627,Boyle; Mary E. T.,0,16,60,60
1651014391070,COGS 118A,A01,083075,Staff,0,10,60,60
1651014397102,CSE 3,A50,083646,Miranda; Gregory Joseph,15,0,38,23
1651014397102,CSE 3,A51,083647,Miranda; Gregory Joseph,36,0,37,1
1651014403130,CSE 8A,A50,083650,Miranda; Gregory Joseph,0,31,40,40
1651014409157,CSE 11,A01,083080,Cao; Yingjun,0,97,40,40
1651014415196,CSE 12,A01,083652,Staff,0,24,100,100
1651014421220,CSE 15L,A01,083654,Staff,0,3,50,50
1651014421220,CSE 15L,A02,083655,Staff,0,3,50,50
1651014427253,CSE 20,A01,083657,Staff,47,0,80,33
1651014433277,CSE 30,A01,083084,Eldon; John,1,39,80,79
1651014439301,CSE 100,A01,083659,Cao; Yingjun,0,72,50,50
1651014445323,CSE 134B,A01,083661,Powell; Thomas Allan,1,39,65,64
1651014451346,CSE 140,A01,083663,Staff,0,13,75,75
1651014457374,CSE 140L,A01,083088,Eldon; John,4,0,100,96
1651014463396,CSE 175,A01,083665,Kumar; Rakesh,0,0,25,25
1651014469420,CSE 190,A00,092507,Dubnov; Shlomo,9,0,20,11
1651014475445,ECE 45,A01,083139,Staff,0,7,60,60
1651014481472,ECE 65,A50,083695,Staff,0,7,30,30
1651014487507,ECE 109,A01,091882,Touri; Behrouz,32,0,70,38
1651014493534,ECE 180,A00,083140,Abi Samra; Nicholas Camill,17,0,30,13
1651014493534,ECE 180,B00,083141,Abi Samra; Nicholas Camill,0,0,30,30
1651014499559,MATH 10A,A01,083735,Patchell; Gregory David,1,0,30,29
1651014499559,MATH 10A,A02,083736,Patchell; Gregory David,27,0,30,3
1651014499559,MATH 10A,A03,083737,Patchell; Gregory David,23,0,30,7
1651014505584,MATH 10B,A01,083207,Staff,0,9,30,30
1651014505584,MATH 10B,A02,083208,Staff,0,5,30,30
1651014505584,MATH 10B,B01,083739,Staff,8,0,30,22
1651014505584,MATH 10B,B02,083740,Staff,28,0,30,2
1651014511623,MATH 18,A01,083743,Staff,0,0,30,30
1651014511623,MATH 18,A02,083744,Staff,23,0,30,7
1651014511623,MATH 18,A03,083745,Staff,19,0,30,11
1651014511623,MATH 18,A04,083746,Staff,26,0,30,4
1651014511623,MATH 18,B01,083748,Staff,0,16,30,30
1651014511623,MATH 18,B02,083749,Staff,0,14,30,30
1651014511623,MATH 18,B03,083750,Staff,0,14,30,30
1651014511623,MATH 18,B04,083751,Staff,0,13,30,30
1651014517647,MATH 20A,A01,083754,Staff,19,0,40,21
1651014523671,MATH 20B,A01,083756,Staff,0,14,30,30
1651014523671,MATH 20B,A02,083757,Staff,0,11,30,30
1651014529706,MATH 20C,A01,083760,Staff,0,17,30,30
1651014529706,MATH 20C,A02,083761,Staff,0,15,30,30
1651014529706,MATH 20C,B01,083762,Staff,9,0,30,21
1651014529706,MATH 20C,B02,083763,Staff,28,0,30,2
1651014535733,MATH 20D,A01,083765,Staff,3,1,30,27
1651014535733,MATH 20D,A02,083766,Staff,2,0,30,28
1651014535733,MATH 20D,A03,083767,Staff,22,0,30,8
1651014541760,MATH 20E,A01,083771,Staff,2,0,30,28
1651014541760,MATH 20E,A02,083772,Staff,12,0,30,18
1651014541760,MATH 20E,B01,083773,Staff,0,0,30,30
1651014541760,MATH 20E,B02,083774,Staff,1,0,30,29
1651014547784,MATH 103A,A01,083777,Staff,0,17,30,30
1651014547784,MATH 103A,A02,083778,Staff,0,15,30,30
1651014547784,MATH 103A,B01,083779,Staff,0,14,30,30
1651014547784,MATH 103A,B02,083780,Staff,0,14,30,30
1651014553817,MATH 105,A01,085443,Staff,0,23,30,30
1651014559844,MATH 109,A01,083213,Anzaldo; Leesa B,0,7,30,30
1651014559844,MATH 109,A02,083214,Anzaldo; Leesa B,0,7,30,30
1651014559844,MATH 109,B01,083215,Anzaldo; Leesa B,0,8,30,30
1651014559844,MATH 109,B02,083216,Anzaldo; Leesa B,0,7,30,30
1651014565872,MATH 142A,A01,083219,Chow; Bennett,0,14,30,30
1651014565872,MATH 142A,A02,083220,Chow; Bennett,0,15,30,30
1651014565872,MATH 142A,B01,083221,Chow; Bennett,0,16,30,30
1651014565872,MATH 142A,B02,083222,Chow; Bennett,0,14,30,30
1651014571899,MATH 193A,A01,083224,Staff,0,7,30,30
1651014571899,MATH 193A,A02,083225,Staff,0,7,30,30
1651014571899,MATH 193A,A03,083781,Staff,0,7,30,30
1651014571899,MATH 193A,A04,083782,Staff,0,7,30,30
1651014577925,MATH 197,001,091859,McAuley; Julian John,9998,0,9999,1
1651014583995,COGS 9,A01,083615,Staff,0,19,60,60
1651014590019,COGS 11,A01,083617,Boyle; Mary E. T.,13,0,40,27
1651014596046,COGS 13,A01,083071,Staff,0,40,40,40
1651014602072,COGS 14A,A01,092681,Staff,0,40,100,100
1651014608098,COGS 14B,A01,083073,Cheng; Tzu-Han,0,13,50,50
1651014614135,COGS 17,A01,092677,Staff,7,0,75,68
1651014620168,COGS 100,A01,083619,Staff,0,30,60,60
1651014626203,COGS 101A,A01,083621,Davis; Joshua Daniel,0,30,60,60
1651014632238,COGS 101B,A01,091572,Staff,0,7,60,60
1651014638264,COGS 101C,A01,083625,Delgado; Tania,14,0,30,16
1651014644291,COGS 107A,A01,083627,Boyle; Mary E. T.,0,16,60,60
1651014650318,COGS 118A,A01,083075,Staff,0,10,60,60
1651014656341,CSE 3,A50,083646,Miranda; Gregory Joseph,15,0,38,23
1651014656341,CSE 3,A51,083647,Miranda; Gregory Joseph,36,0,37,1
1651014662381,CSE 8A,A50,083650,Miranda; Gregory Joseph,0,31,40,40
1651014668403,CSE 11,A01,083080,Cao; Yingjun,0,97,40,40
1651014674428,CSE 12,A01,083652,Staff,0,24,100,100
1651014680452,CSE 15L,A01,083654,Staff,0,3,50,50
1651014680452,CSE 15L,A02,083655,Staff,0,3,50,50
1651014686482,CSE 20,A01,083657,Staff,47,0,80,33
1651014692507,CSE 30,A01,083084,Eldon; John,1,39,80,79
1651014698529,CSE 100,A01,083659,Cao; Yingjun,0,72,50,50
1651014704561,CSE 134B,A01,083661,Powell; Thomas Allan,1,39,65,64
1651014710586,CSE 140,A01,083663,Staff,0,13,75,75
1651014716612,CSE 140L,A01,083088,Eldon; John,4,0,100,96
1651014722639,CSE 175,A01,083665,Kumar; Rakesh,0,0,25,25
1651014728675,CSE 190,A00,092507,Dubnov; Shlomo,9,0,20,11
1651014734698,ECE 45,A01,083139,Staff,0,7,60,60
1651014740721,ECE 65,A50,083695,Staff,0,7,30,30
1651014746755,ECE 109,A01,091882,Touri; Behrouz,32,0,70,38
1651014752779,ECE 180,A00,083140,Abi Samra; Nicholas Camill,17,0,30,13
1651014752779,ECE 180,B00,083141,Abi Samra; Nicholas Camill,0,0,30,30
1651014758816,MATH 10A,A01,083735,Patchell; Gregory David,1,0,30,29
1651014758816,MATH 10A,A02,083736,Patchell; Gregory David,27,0,30,3
1651014758816,MATH 10A,A03,083737,Patchell; Gregory David,23,0,30,7
1651014764840,MATH 10B,A01,083207,Staff,0,9,30,30
1651014764840,MATH 10B,A02,083208,Staff,0,5,30,30
1651014764840,MATH 10B,B01,083739,Staff,8,0,30,22
1651014764840,MATH 10B,B02,083740,Staff,28,0,30,2
1651014770863,MATH 18,A01,083743,Staff,0,0,30,30
1651014770863,MATH 18,A02,083744,Staff,23,0,30,7
1651014770863,MATH 18,A03,083745,Staff,19,0,30,11
1651014770863,MATH 18,A04,083746,Staff,26,0,30,4
1651014770863,MATH 18,B01,083748,Staff,0,16,30,30
1651014770863,MATH 18,B02,083749,Staff,0,14,30,30
1651014770863,MATH 18,B03,083750,Staff,0,14,30,30
1651014770863,MATH 18,B04,083751,Staff,0,13,30,30
1651014776890,MATH 20A,A01,083754,Staff,19,0,40,21
1651014782917,MATH 20B,A01,083756,Staff,0,14,30,30
1651014782917,MATH 20B,A02,083757,Staff,0,11,30,30
1651014788940,MATH 20C,A01,083760,Staff,0,17,30,30
1651014788940,MATH 20C,A02,083761,Staff,0,15,30,30
1651014788940,MATH 20C,B01,083762,Staff,9,0,30,21
1651014788940,MATH 20C,B02,083763,Staff,28,0,30,2
1651014794970,MATH 20D,A01,083765,Staff,3,1,30,27
1651014794970,MATH 20D,A02,083766,Staff,2,0,30,28
1651014794970,MATH 20D,A03,083767,Staff,22,0,30,8
1651014801004,MATH 20E,A01,083771,Staff,2,0,30,28
1651014801004,MATH 20E,A02,083772,Staff,12,0,30,18
1651014801004,MATH 20E,B01,083773,Staff,0,0,30,30
1651014801004,MATH 20E,B02,083774,Staff,1,0,30,29
1651014807029,MATH 103A,A01,083777,Staff,0,17,30,30
1651014807029,MATH 103A,A02,083778,Staff,0,15,30,30
1651014807029,MATH 103A,B01,083779,Staff,0,14,30,30
1651014807029,MATH 103A,B02,083780,Staff,0,14,30,30
1651014813053,MATH 105,A01,085443,Staff,0,23,30,30
1651014819177,MATH 109,A01,083213,Anzaldo; Leesa B,0,7,30,30
1651014819177,MATH 109,A02,083214,Anzaldo; Leesa B,0,7,30,30
1651014819177,MATH 109,B01,083215,Anzaldo; Leesa B,0,8,30,30
1651014819177,MATH 109,B02,083216,Anzaldo; Leesa B,0,7,30,30
1651014825206,MATH 142A,A01,083219,Chow; Bennett,0,14,30,30
1651014825206,MATH 142A,A02,083220,Chow; Bennett,0,15,30,30
1651014825206,MATH 142A,B01,083221,Chow; Bennett,0,16,30,30
1651014825206,MATH 142A,B02,083222,Chow; Bennett,0,14,30,30
1651014831230,MATH 193A,A01,083224,Staff,0,7,30,30
1651014831230,MATH 193A,A02,083225,Staff,0,7,30,30
1651014831230,MATH 193A,A03,083781,Staff,0,7,30,30
1651014831230,MATH 193A,A04,083782,Staff,0,7,30,30
1651014837256,MATH 197,001,091859,McAuley; Julian John,9998,0,9999,1
1651014843315,COGS 9,A01,083615,Staff,0,19,60,60
1651014849338,COGS 11,A01,083617,Boyle; Mary E. T.,13,0,40,27
1651014855364,COGS 13,A01,083071,Staff,0,40,40,40
1651014861390,COGS 14A,A01,092681,Staff,0,40,100,100
1651014867419,COGS 14B,A01,083073,Cheng; Tzu-Han,0,13,50,50
1651014873452,COGS 17,A01,092677,Staff,7,0,75,68
1651014879479,COGS 100,A01,083619,Staff,0,30,60,60
1651014885506,COGS 101A,A01,083621,Davis; Joshua Daniel,0,30,60,60
1651014891532,COGS 101B,A01,091572,Staff,0,7,60,60
1651014897554,COGS 101C,A01,083625,Delgado; Tania,14,0,30,16
1651014903588,COGS 107A,A01,083627,Boyle; Mary E. T.,0,16,60,60
1651014909616,COGS 118A,A01,083075,Staff,0,10,60,60
1651014915661,CSE 3,A50,083646,Miranda; Gregory Joseph,15,0,38,23
1651014915661,CSE 3,A51,083647,Miranda; Gregory Joseph,36,0,37,1
1651014921688,CSE 8A,A50,083650,Miranda; Gregory Joseph,0,31,40,40
1651014927715,CSE 11,A01,083080,Cao; Yingjun,0,97,40,40
1651014933750,CSE 12,A01,083652,Staff,0,24,100,100
1651014939780,CSE 15L,A01,083654,Staff,0,3,50,50
1651014939780,CSE 15L,A02,083655,Staff,0,3,50,50
1651014945821,CSE 20,A01,083657,Staff,47,0,80,33
1651014951845,CSE 30,A01,083084,Eldon; John,1,39,80,79
1651014957869,CSE 100,A01,083659,Cao; Yingjun,0,72,50,50
1651014963892,CSE 134B,A01,083661,Powell; Thomas Allan,1,39,65,64
1651014969930,CSE 140,A01,083663,Staff,0,13,75,75
1651014975958,CSE 140L,A01,083088,Eldon; John,4,0,100,96
1651014981982,CSE 175,A01,083665,Kumar; Rakesh,0,0,25,25
1651014988007,CSE 190,A00,092507,Dubnov; Shlomo,9,0,20,11
1651014994034,ECE 45,A01,083139,Staff,0,7,60,60
1651015000057,ECE 65,A50,083695,Staff,0,7,30,30
1651015006084,ECE 109,A01,091882,Touri; Behrouz,32,0,70,38
1651015012108,ECE 180,A00,083140,Abi Samra; Nicholas Camill,17,0,30,13
1651015012108,ECE 180,B00,083141,Abi Samra; Nicholas Camill,0,0,30,30
1651015018132,MATH 10A,A01,083735,Patchell; Gregory David,1,0,30,29
1651015018132,MATH 10A,A02,083736,Patchell; Gregory David,27,0,30,3
1651015018132,MATH 10A,A03,083737,Patchell; Gregory David,23,0,30,7
1651015024156,MATH 10B,A01,083207,Staff,0,9,30,30
1651015024156,MATH 10B,A02,083208,Staff,0,5,30,30
1651015024156,MATH 10B,B01,083739,Staff,8,0,30,22
1651015024156,MATH 10B,B02,083740,Staff,28,0,30,2
1651015030184,MATH 18,A01,083743,Staff,0,0,30,30
1651015030184,MATH 18,A02,083744,Staff,23,0,30,7
1651015030184,MATH 18,A03,083745,Staff,19,0,30,11
1651015030184,MATH 18,A04,083746,Staff,26,0,30,4
1651015030184,MATH 18,B01,083748,Staff,0,16,30,30
1651015030184,MATH 18,B02,083749,Staff,0,14,30,30
1651015030184,MATH 18,B03,083750,Staff,0,14,30,30
1651015030184,MATH 18,B04,083751,Staff,0,13,30,30
1651015036211,MATH 20A,A01,083754,Staff,19,0,40,21
1651015042238,MATH 20B,A01,083756,Staff,0,14,30,30
1651015042238,MATH 20B,A02,083757,Staff,0,11,30,30
1651015048299,MATH 20C,A01,083760,Staff,0,17,30,30
1651015048299,MATH 20C,A02,083761,Staff,0,15,30,30
1651015048299,MATH 20C,B01,083762,Staff,9,0,30,21
1651015048299,MATH 20C,B02,083763,Staff,28,0,30,2
1651015054326,MATH 20D,A01,083765,Staff,3,1,30,27
1651015054326,MATH 20D,A02,083766,Staff,2,0,30,28
1651015054326,MATH 20D,A03,083767,Staff,22,0,30,8
1651015060350,MATH 20E,A01,083771,Staff,2,0,30,28
1651015060350,MATH 20E,A02,083772,Staff,12,0,30,18
1651015060350,MATH 20E,B01,083773,Staff,0,0,30,30
1651015060350,MATH 20E,B02,083774,Staff,1,0,30,29
1651015066374,MATH 103A,A01,083777,Staff,0,17,30,30
1651015066374,MATH 103A,A02,083778,Staff,0,15,30,30
1651015066374,MATH 103A,B01,083779,Staff,0,14,30,30
1651015066374,MATH 103A,B02,083780,Staff,0,14,30,30
1651015072397,MATH 105,A01,085443,Staff,0,23,30,30
1651015078420,MATH 109,A01,083213,Anzaldo; Leesa B,0,7,30,30
1651015078420,MATH 109,A02,083214,Anzaldo; Leesa B,0,7,30,30
1651015078420,MATH 109,B01,083215,Anzaldo; Leesa B,0,8,30,30
1651015078420,MATH 109,B02,083216,Anzaldo; Leesa B,0,7,30,30
1651015084444,MATH 142A,A01,083219,Chow; Bennett,0,14,30,30
1651015084444,MATH 142A,A02,083220,Chow; Bennett,0,15,30,30
1651015084444,MATH 142A,B01,083221,Chow; Bennett,0,16,30,30
1651015084444,MATH 142A,B02,083222,Chow; Bennett,0,14,30,30
1651015090470,MATH 193A,A01,083224,Staff,0,7,30,30
1651015090470,MATH 193A,A02,083225,Staff,0,7,30,30
1651015090470,MATH 193A,A03,083781,Staff,0,7,30,30
1651015090470,MATH 193A,A04,083782,Staff,0,7,30,30
1651015096496,MATH 197,001,091859,McAuley; Julian John,9998,0,9999,1
1651015102545,COGS 9,A01,083615,Staff,0,19,60,60
1651015108572,COGS 11,A01,083617,Boyle; Mary E. T.,13,0,40,27
1651015114599,COGS 13,A01,083071,Staff,0,40,40,40
1651015120626,COGS 14A,A01,092681,Staff,0,40,100,100
1651015126653,COGS 14B,A01,083073,Cheng; Tzu-Han,0,13,50,50
1651015132680,COGS 17,A01,092677,Staff,7,0,75,68
1651015138708,COGS 100,A01,083619,Staff,0,30,60,60
1651015144732,COGS 101A,A01,083621,Davis; Joshua Daniel,0,30,60,60
1651015150760,COGS 101B,A01,091572,Staff,0,7,60,60
1651015156787,COGS 101C,A01,083625,Delgado; Tania,14,0,30,16
1651015162809,COGS 107A,A01,083627,Boyle; Mary E. T.,0,16,60,60
1651015168833,COGS 118A,A01,083075,Staff,0,10,60,60
1651015174860,CSE 3,A50,083646,Miranda; Gregory Joseph,15,0,38,23
1651015174860,CSE 3,A51,083647,Miranda; Gregory Joseph,36,0,37,1
1651015180884,CSE 8A,A50,083650,Miranda; Gregory Joseph,0,31,40,40
1651015186916,CSE 11,A01,083080,Cao; Yingjun,0,97,40,40
1651015192942,CSE 12,A01,083652,Staff,0,24,100,100
1651015198965,CSE 15L,A01,083654,Staff,0,3,50,50
1651015198965,CSE 15L,A02,083655,Staff,0,3,50,50
1651015204989,CSE 20,A01,083657,Staff,47,0,80,33
1651015211013,CSE 30,A01,083084,Eldon; John,1,39,80,79
1651015217039,CSE 100,A01,083659,Cao; Yingjun,0,72,50,50
1651015223067,CSE 134B,A01,083661,Powell; Thomas Allan,1,39,65,64
1651015229091,CSE 140,A01,083663,Staff,0,13,75,75
1651015235117,CSE 140L,A01,083088,Eldon; John,4,0,100,96
1651015241140,CSE 175,A01,083665,Kumar; Rakesh,0,0,25,25
1651015247164,CSE 190,A00,092507,Dubnov; Shlomo,9,0,20,11
1651015253190,ECE 45,A01,083139,Staff,0,7,60,60
1651015259215,ECE 65,A50,083695,Staff,0,7,30,30
1651015265239,ECE 109,A01,091882,Touri; Behrouz,32,0,70,38
1651015271263,ECE 180,A00,083140,Abi Samra; Nicholas Camill,17,0,30,13
1651015271263,ECE 180,B00,083141,Abi Samra; Nicholas Camill,0,0,30,30
1651015277292,MATH 10A,A01,083735,Patchell; Gregory David,1,0,30,29
1651015277292,MATH 10A,A02,083736,Patchell; Gregory David,27,0,30,3
1651015277292,MATH 10A,A03,083737,Patchell; Gregory David,23,0,30,7
1651015283313,MATH 10B,A01,083207,Staff,0,9,30,30
1651015283313,MATH 10B,A02,083208,Staff,0,5,30,30
1651015283313,MATH 10B,B01,083739,Staff,8,0,30,22
1651015283313,MATH 10B,B02,083740,Staff,28,0,30,2
1651015289341,MATH 18,A01,083743,Staff,0,0,30,30
1651015289341,MATH 18,A02,083744,Staff,23,0,30,7
1651015289341,MATH 18,A03,083745,Staff,19,0,30,11
1651015289341,MATH 18,A04,083746,Staff,26,0,30,4
1651015289341,MATH 18,B01,083748,Staff,0,16,30,30
1651015289341,MATH 18,B02,083749,Staff,0,14,30,30
1651015289341,MATH 18,B03,083750,Staff,0,14,30,30
1651015289341,MATH 18,B04,083751,Staff,0,13,30,30
1651015295366,MATH 20A,A01,083754,Staff,19,0,40,21
1651015301390,MATH 20B,A01,083756,Staff,0,14,30,30
1651015301390,MATH 20B,A02,083757,Staff,0,11,30,30
1651015307413,MATH 20C,A01,083760,Staff,0,17,30,30
1651015307413,MATH 20C,A02,083761,Staff,0,15,30,30
1651015307413,MATH 20C,B01,083762,Staff,9,0,30,21
1651015307413,MATH 20C,B02,083763,Staff,28,0,30,2
1651015313435,MATH 20D,A01,083765,Staff,3,1,30,27
1651015313435,MATH 20D,A02,083766,Staff,2,0,30,28
1651015313435,MATH 20D,A03,083767,Staff,22,0,30,8
1651015319459,MATH 20E,A01,083771,Staff,2,0,30,28
1651015319459,MATH 20E,A02,083772,Staff,12,0,30,18
1651015319459,MATH 20E,B01,083773,Staff,0,0,30,30
1651015319459,MATH 20E,B02,083774,Staff,1,0,30,29
1651015325487,MATH 103A,A01,083777,Staff,0,17,30,30
1651015325487,MATH 103A,A02,083778,Staff,0,15,30,30
1651015325487,MATH 103A,B01,083779,Staff,0,15,30,30
1651015325487,MATH 103A,B02,083780,Staff,0,14,30,30
1651015331511,MATH 105,A01,085443,Staff,0,23,30,30
1651015337533,MATH 109,A01,083213,Anzaldo; Leesa B,0,7,30,30
1651015337533,MATH 109,A02,083214,Anzaldo; Leesa B,0,7,30,30
1651015337533,MATH 109,B01,083215,Anzaldo; Leesa B,0,8,30,30
1651015337533,MATH 109,B02,083216,Anzaldo; Leesa B,0,7,30,30
1651015343560,MATH 142A,A01,083219,Chow; Bennett,0,14,30,30
1651015343560,MATH 142A,A02,083220,Chow; Bennett,0,15,30,30
1651015343560,MATH 142A,B01,083221,Chow; Bennett,0,16,30,30
1651015343560,MATH 142A,B02,083222,Chow; Bennett,0,14,30,30
1651015349584,MATH 193A,A01,083224,Staff,0,7,30,30
1651015349584,MATH 193A,A02,083225,Staff,0,7,30,30
1651015349584,MATH 193A,A03,083781,Staff,0,7,30,30
1651015349584,MATH 193A,A04,083782,Staff,0,7,30,30
1651015355609,MATH 197,001,091859,McAuley; Julian John,9998,0,9999,1
1651015361663,COGS 9,A01,083615,Staff,0,19,60,60
1651015367687,COGS 11,A01,083617,Boyle; Mary E. T.,13,0,40,27
1651015373711,COGS 13,A01,083071,Staff,0,40,40,40
1651015379737,COGS 14A,A01,092681,Staff,0,40,100,100
1651015385761,COGS 14B,A01,083073,Cheng; Tzu-Han,0,13,50,50
1651015391785,COGS 17,A01,092677,Staff,7,0,75,68
1651015397814,COGS 100,A01,083619,Staff,0,30,60,60
1651015403841,COGS 101A,A01,083621,Davis; Joshua Daniel,0,30,60,60
1651015409986,COGS 101B,A01,091572,Staff,0,7,60,60
1651015416009,COGS 101C,A01,083625,Delgado; Tania,14,0,30,16
1651015422033,COGS 107A,A01,083627,Boyle; Mary E. T.,0,16,60,60
1651015428057,COGS 118A,A01,083075,Staff,0,10,60,60
1651015434079,CSE 3,A50,083646,Miranda; Gregory Joseph,15,0,38,23
1651015434079,CSE 3,A51,083647,Miranda; Gregory Joseph,36,0,37,1
1651015440114,CSE 8A,A50,083650,Miranda; Gregory Joseph,0,31,40,40
1651015446138,CSE 11,A01,083080,Cao; Yingjun,0,97,40,40
1651015452170,CSE 12,A01,083652,Staff,0,24,100,100
1651015458194,CSE 15L,A01,083654,Staff,0,3,50,50
1651015458194,CSE 15L,A02,083655,Staff,0,3,50,50
1651015464216,CSE 20,A01,083657,Staff,47,0,80,33
1651015470241,CSE 30,A01,083084,Eldon; John,1,39,80,79
1651015476269,CSE 100,A01,083659,Cao; Yingjun,0,72,50,50
1651015482298,CSE 134B,A01,083661,Powell; Thomas Allan,1,39,65,64
1651015488323,CSE 140,A01,083663,Staff,0,13,75,75
1651015494346,CSE 140L,A01,083088,Eldon; John,4,0,100,96
1651015500380,CSE 175,A01,083665,Kumar; Rakesh,0,0,25,25
1651015506405,CSE 190,A00,092507,Dubnov; Shlomo,9,0,20,11
1651015512431,ECE 45,A01,083139,Staff,0,7,60,60
1651015518459,ECE 65,A50,083695,Staff,0,7,30,30
1651015524482,ECE 109,A01,091882,Touri; Behrouz,32,0,70,38
1651015530519,ECE 180,A00,083140,Abi Samra; Nicholas Camill,17,0,30,13
1651015530519,ECE 180,B00,083141,Abi Samra; Nicholas Camill,0,0,30,30
1651015536545,MATH 10A,A01,083735,Patchell; Gregory David,1,0,30,29
1651015536545,MATH 10A,A02,083736,Patchell; Gregory David,27,0,30,3
1651015536545,MATH 10A,A03,083737,Patchell; Gregory David,23,0,30,7
1651015542572,MATH 10B,A01,083207,Staff,0,9,30,30
1651015542572,MATH 10B,A02,083208,Staff,0,5,30,30
1651015542572,MATH 10B,B01,083739,Staff,8,0,30,22
1651015542572,MATH 10B,B02,083740,Staff,28,0,30,2
1651015548609,MATH 18,A01,083743,Staff,0,0,30,30
1651015548609,MATH 18,A02,083744,Staff,23,0,30,7
1651015548609,MATH 18,A03,083745,Staff,19,0,30,11
1651015548609,MATH 18,A04,083746,Staff,26,0,30,4
1651015548609,MATH 18,B01,083748,Staff,0,16,30,30
1651015548609,MATH 18,B02,083749,Staff,0,14,30,30
1651015548609,MATH 18,B03,083750,Staff,0,14,30,30
1651015548609,MATH 18,B04,083751,Staff,0,13,30,30
1651015554639,MATH 20A,A01,083754,Staff,19,0,40,21
1651015560665,MATH 20B,A01,083756,Staff,0,14,30,30
1651015560665,MATH 20B,A02,083757,Staff,0,11,30,30
1651015566692,MATH 20C,A01,083760,Staff,0,17,30,30
1651015566692,MATH 20C,A02,083761,Staff,0,15,30,30
1651015566692,MATH 20C,B01,083762,Staff,9,0,30,21
1651015566692,MATH 20C,B02,083763,Staff,28,0,30,2
1651015572719,MATH 20D,A01,083765,Staff,3,1,30,27
1651015572719,MATH 20D,A02,083766,Staff,2,0,30,28
1651015572719,MATH 20D,A03,083767,Staff,22,0,30,8
1651015578743,MATH 20E,A01,083771,Staff,2,0,30,28
1651015578743,MATH 20E,A02,083772,Staff,12,0,30,18
1651015578743,MATH 20E,B01,083773,Staff,0,0,30,30
1651015578743,MATH 20E,B02,083774,Staff,1,0,30,29
1651015584781,MATH 103A,A01,083777,Staff,0,17,30,30
1651015584781,MATH 103A,A02,083778,Staff,0,15,30,30
1651015584781,MATH 103A,B01,083779,Staff,0,15,30,30
1651015584781,MATH 103A,B02,083780,Staff,0,14,30,30
1651015590804,MATH 105,A01,085443,Staff,0,23,30,30
1651015596832,MATH 109,A01,083213,Anzaldo; Leesa B,0,7,30,30
1651015596832,MATH 109,A02,083214,Anzaldo; Leesa B,0,7,30,30
1651015596832,MATH 109,B01,083215,Anzaldo; Leesa B,0,8,30,30
1651015596832,MATH 109,B02,083216,Anzaldo; Leesa B,0,7,30,30
1651015602857,MATH 142A,A01,083219,Chow; Bennett,0,14,30,30
1651015602857,MATH 142A,A02,083220,Chow; Bennett,0,15,30,30
1651015602857,MATH 142A,B01,083221,Chow; Bennett,0,16,30,30
1651015602857,MATH 142A,B02,083222,Chow; Bennett,0,14,30,30
1651015608881,MATH 193A,A01,083224,Staff,0,7,30,30
1651015608881,MATH 193A,A02,083225,Staff,0,7,30,30
1651015608881,MATH 193A,A03,083781,Staff,0,7,30,30
1651015608881,MATH 193A,A04,083782,Staff,0,7,30,30
1651015614903,MATH 197,001,091859,McAuley; Julian John,9998,0,9999,1
1651015620953,COGS 9,A01,083615,Staff,0,19,60,60
1651015626976,COGS 11,A01,083617,Boyle; Mary E. T.,13,0,40,27
1651015632999,COGS 13,A01,083071,Staff,0,40,40,40
1651015639021,COGS 14A,A01,092681,Staff,0,40,100,100
1651015645044,COGS 14B,A01,083073,Cheng; Tzu-Han,0,13,50,50
1651015651067,COGS 17,A01,092677,Staff,7,0,75,68
1651015657090,COGS 100,A01,083619,Staff,0,30,60,60
1651015663114,COGS 101A,A01,083621,Davis; Joshua Daniel,0,30,60,60
1651015669140,COGS 101B,A01,091572,Staff,0,7,60,60
1651015675164,COGS 101C,A01,083625,Delgado; Tania,14,0,30,16
1651015681187,COGS 107A,A01,083627,Boyle; Mary E. T.,0,16,60,60
1651015687213,COGS 118A,A01,083075,Staff,0,10,60,60
1651015693242,CSE 3,A50,083646,Miranda; Gregory Joseph,15,0,38,23
1651015693242,CSE 3,A51,083647,Miranda; Gregory Joseph,36,0,37,1
1651015699270,CSE 8A,A50,083650,Miranda; Gregory Joseph,0,31,40,40
1651015705296,CSE 11,A01,083080,Cao; Yingjun,0,97,40,40
1651015711319,CSE 12,A01,083652,Staff,0,24,100,100
1651015717347,CSE 15L,A01,083654,Staff,0,3,50,50
1651015717347,CSE 15L,A02,083655,Staff,0,3,50,50
1651015723374,CSE 20,A01,083657,Staff,47,0,80,33
1651015729398,CSE 30,A01,083084,Eldon; John,1,39,80,79
1651015735428,CSE 100,A01,083659,Cao; Yingjun,0,72,50,50
1651015741460,CSE 134B,A01,083661,Powell; Thomas Allan,1,39,65,64
1651015747484,CSE 140,A01,083663,Staff,0,13,75,75
1651015753512,CSE 140L,A01,083088,Eldon; John,4,0,100,96
1651015759534,CSE 175,A01,083665,Kumar; Rakesh,0,0,25,25
1651015765559,CSE 190,A00,092507,Dubnov; Shlomo,9,0,20,11
1651015771585,ECE 45,A01,083139,Staff,0,7,60,60
1651015777611,ECE 65,A50,083695,Staff,0,7,30,30
1651015783635,ECE 109,A01,091882,Touri; Behrouz,32,0,70,38
1651015789660,ECE 180,A00,083140,Abi Samra; Nicholas Camill,17,0,30,13
1651015789660,ECE 180,B00,083141,Abi Samra; Nicholas Camill,0,0,30,30
1651015795688,MATH 10A,A01,083735,Patchell; Gregory David,1,0,30,29
1651015795688,MATH 10A,A02,083736,Patchell; Gregory David,27,0,30,3
1651015795688,MATH 10A,A03,083737,Patchell; Gregory David,23,0,30,7
1651015801718,MATH 10B,A01,083207,Staff,0,9,30,30
1651015801718,MATH 10B,A02,083208,Staff,0,5,30,30
1651015801718,MATH 10B,B01,083739,Staff,8,0,30,22
1651015801718,MATH 10B,B02,083740,Staff,28,0,30,2
1651015807743,MATH 18,A01,083743,Staff,0,0,30,30
1651015807743,MATH 18,A02,083744,Staff,23,0,30,7
1651015807743,MATH 18,A03,083745,Staff,19,0,30,11
1651015807743,MATH 18,A04,083746,Staff,26,0,30,4
1651015807743,MATH 18,B01,083748,Staff,0,16,30,30
1651015807743,MATH 18,B02,083749,Staff,0,14,30,30
1651015807743,MATH 18,B03,083750,Staff,0,14,30,30
1651015807743,MATH 18,B04,083751,Staff,0,13,30,30
1651015813765,MATH 20A,A01,083754,Staff,19,0,40,21
1651015819788,MATH 20B,A01,083756,Staff,0,14,30,30
1651015819788,MATH 20B,A02,083757,Staff,0,11,30,30
1651015825818,MATH 20C,A01,083760,Staff,0,17,30,30
1651015825818,MATH 20C,A02,083761,Staff,0,15,30,30
1651015825818,MATH 20C,B01,083762,Staff,9,0,30,21
1651015825818,MATH 20C,B02,083763,Staff,28,0,30,2
1651015831842,MATH 20D,A01,083765,Staff,3,1,30,27
1651015831842,MATH 20D,A02,083766,Staff,2,0,30,28
1651015831842,MATH 20D,A03,083767,Staff,22,0,30,8
1651015837869,MATH 20E,A01,083771,Staff,2,0,30,28
1651015837869,MATH 20E,A02,083772,Staff,12,0,30,18
1651015837869,MATH 20E,B01,083773,Staff,0,0,30,30
1651015837869,MATH 20E,B02,083774,Staff,1,0,30,29
1651015843893,MATH 103A,A01,083777,Staff,0,17,30,30
1651015843893,MATH 103A,A02,083778,Staff,0,15,30,30
1651015843893,MATH 103A,B01,083779,Staff,0,15,30,30
1651015843893,MATH 103A,B02,083780,Staff,0,14,30,30
1651015849917,MATH 105,A01,085443,Staff,0,23,30,30
1651015855945,MATH 109,A01,083213,Anzaldo; Leesa B,0,7,30,30
1651015855945,MATH 109,A02,083214,Anzaldo; Leesa B,0,7,30,30
1651015855945,MATH 109,B01,083215,Anzaldo; Leesa B,0,8,30,30
1651015855945,MATH 109,B02,083216,Anzaldo; Leesa B,0,7,30,30
1651015861987,MATH 142A,A01,083219,Chow; Bennett,0,14,30,30
1651015861987,MATH 142A,A02,083220,Chow; Bennett,0,15,30,30
1651015861987,MATH 142A,B01,083221,Chow; Bennett,0,16,30,30
1651015861987,MATH 142A,B02,083222,Chow; Bennett,0,14,30,30
1651015868010,MATH 193A,A01,083224,Staff,0,7,30,30
1651015868010,MATH 193A,A02,083225,Staff,0,7,30,30
1651015868010,MATH 193A,A03,083781,Staff,0,7,30,30
1651015868010,MATH 193A,A04,083782,Staff,0,7,30,30
1651015874033,MATH 197,001,091859,McAuley; Julian John,9998,0,9999,1
1651015880095,COGS 9,A01,083615,Staff,0,19,60,60
1651015886120,COGS 11,A01,083617,Boyle; Mary E. T.,13,0,40,27
1651015892144,COGS 13,A01,083071,Staff,0,40,40,40
1651015898166,COGS 14A,A01,092681,Staff,0,40,100,100
1651015904196,COGS 14B,A01,083073,Cheng; Tzu-Han,0,13,50,50
1651015910219,COGS 17,A01,092677,Staff,7,0,75,68
1651015916246,COGS 100,A01,083619,Staff,0,30,60,60
1651015922273,COGS 101A,A01,083621,Davis; Joshua Daniel,0,30,60,60
1651015928303,COGS 101B,A01,091572,Staff,0,7,60,60
1651015934330,COGS 101C,A01,083625,Delgado; Tania,14,0,30,16
1651015940357,COGS 107A,A01,083627,Boyle; Mary E. T.,0,16,60,60
1651015946380,COGS 118A,A01,083075,Staff,0,10,60,60
1651015952404,CSE 3,A50,083646,Miranda; Gregory Joseph,15,0,38,23
1651015952404,CSE 3,A51,083647,Miranda; Gregory Joseph,36,0,37,1
1651015958432,CSE 8A,A50,083650,Miranda; Gregory Joseph,0,31,40,40
1651015964458,CSE 11,A01,083080,Cao; Yingjun,0,97,40,40
1651015970484,CSE 12,A01,083652,Staff,0,24,100,100
1651015976513,CSE 15L,A01,083654,Staff,0,3,50,50
1651015976513,CSE 15L,A02,083655,Staff,0,3,50,50
1651015982538,CSE 20,A01,083657,Staff,47,0,80,33
1651015988561,CSE 30,A01,083084,Eldon; John,1,39,80,79
1651015994583,CSE 100,A01,083659,Cao; Yingjun,0,72,50,50
1651016000608,CSE 134B,A01,083661,Powell; Thomas Allan,1,39,65,64
1651016006730,CSE 140,A01,083663,Staff,0,13,75,75
1651016012763,CSE 140L,A01,083088,Eldon; John,4,0,100,96
1651016018797,CSE 175,A01,083665,Kumar; Rakesh,0,0,25,25
1651016024822,CSE 190,A00,092507,Dubnov; Shlomo,9,0,20,11
1651016030845,ECE 45,A01,083139,Staff,0,7,60,60
1651016036869,ECE 65,A50,083695,Staff,0,7,30,30
1651016042905,ECE 109,A01,091882,Touri; Behrouz,32,0,70,38
1651016048930,ECE 180,A00,083140,Abi Samra; Nicholas Camill,17,0,30,13
1651016048930,ECE 180,B00,083141,Abi Samra; Nicholas Camill,0,0,30,30
1651016054957,MATH 10A,A01,083735,Patchell; Gregory David,1,0,30,29
1651016054957,MATH 10A,A02,083736,Patchell; Gregory David,27,0,30,3
1651016054957,MATH 10A,A03,083737,Patchell; Gregory David,23,0,30,7
1651016060979,MATH 10B,A01,083207,Staff,0,9,30,30
1651016060979,MATH 10B,A02,083208,Staff,0,6,30,30
1651016060979,MATH 10B,B01,083739,Staff,8,0,30,22
1651016060979,MATH 10B,B02,083740,Staff,28,0,30,2
1651016067004,MATH 18,A01,083743,Staff,0,0,30,30
1651016067004,MATH 18,A02,083744,Staff,23,0,30,7
1651016067004,MATH 18,A03,083745,Staff,19,0,30,11
1651016067004,MATH 18,A04,083746,Staff,26,0,30,4
1651016067004,MATH 18,B01,083748,Staff,0,16,30,30
1651016067004,MATH 18,B02,083749,Staff,0,14,30,30
1651016067004,MATH 18,B03,083750,Staff,0,14,30,30
1651016067004,MATH 18,B04,083751,Staff,0,13,30,30
1651016073027,MATH 20A,A01,083754,Staff,19,0,40,21
1651016079061,MATH 20B,A01,083756,Staff,0,14,30,30
1651016079061,MATH 20B,A02,083757,Staff,0,11,30,30
1651016085095,MATH 20C,A01,083760,Staff,0,17,30,30
1651016085095,MATH 20C,A02,083761,Staff,0,15,30,30
1651016085095,MATH 20C,B01,083762,Staff,9,0,30,21
1651016085095,MATH 20C,B02,083763,Staff,28,0,30,2
1651016091121,MATH 20D,A01,083765,Staff,3,1,30,27
1651016091121,MATH 20D,A02,083766,Staff,2,0,30,28
1651016091121,MATH 20D,A03,083767,Staff,22,0,30,8
1651016097150,MATH 20E,A01,083771,Staff,2,0,30,28
1651016097150,MATH 20E,A02,083772,Staff,12,0,30,18
1651016097150,MATH 20E,B01,083773,Staff,0,0,30,30
1651016097150,MATH 20E,B02,083774,Staff,1,0,30,29
1651016103178,MATH 103A,A01,083777,Staff,0,17,30,30
1651016103178,MATH 103A,A02,083778,Staff,0,15,30,30
1651016103178,MATH 103A,B01,083779,Staff,0,15,30,30
1651016103178,MATH 103A,B02,083780,Staff,0,14,30,30
1651016109202,MATH 105,A01,085443,Staff,0,23,30,30
1651016115232,MATH 109,A01,083213,Anzaldo; Leesa B,0,7,30,30
1651016115232,MATH 109,A02,083214,Anzaldo; Leesa B,0,7,30,30
1651016115232,MATH 109,B01,083215,Anzaldo; Leesa B,0,8,30,30
1651016115232,MATH 109,B02,083216,Anzaldo; Leesa B,0,7,30,30
1651016121257,MATH 142A,A01,083219,Chow; Bennett,0,14,30,30
1651016121257,MATH 142A,A02,083220,Chow; Bennett,0,15,30,30
1651016121257,MATH 142A,B01,083221,Chow; Bennett,0,16,30,30
1651016121257,MATH 142A,B02,083222,Chow; Bennett,0,14,30,30
1651016127283,MATH 193A,A01,083224,Staff,0,7,30,30
1651016127283,MATH 193A,A02,083225,Staff,0,7,30,30
1651016127283,MATH 193A,A03,083781,Staff,0,7,30,30
1651016127283,MATH 193A,A04,083782,Staff,0,7,30,30
1651016133306,MATH 197,001,091859,McAuley; Julian John,9998,0,9999,1
1651016139356,COGS 9,A01,083615,Staff,0,19,60,60
1651016145388,COGS 11,A01,083617,Boyle; Mary E. T.,13,0,40,27
1651016151413,COGS 13,A01,083071,Staff,0,40,40,40
1651016157440,COGS 14A,A01,092681,Staff,0,40,100,100
1651016163468,COGS 14B,A01,083073,Cheng; Tzu-Han,0,13,50,50
1651016169492,COGS 17,A01,092677,Staff,7,0,75,68
1651016175516,COGS 100,A01,083619,Staff,0,30,60,60
1651016181546,COGS 101A,A01,083621,Davis; Joshua Daniel,0,30,60,60
1651016187568,COGS 101B,A01,091572,Staff,0,7,60,60
1651016193592,COGS 101C,A01,083625,Delgado; Tania,14,0,30,16
1651016199615,COGS 107A,A01,083627,Boyle; Mary E. T.,0,16,60,60
1651016205641,COGS 118A,A01,083075,Staff,0,10,60,60
1651016211669,CSE 3,A50,083646,Miranda; Gregory Joseph,15,0,38,23
1651016211669,CSE 3,A51,083647,Miranda; Gregory Joseph,36,0,37,1
1651016217703,CSE 8A,A50,083650,Miranda; Gregory Joseph,0,31,40,40
1651016223725,CSE 11,A01,083080,Cao; Yingjun,0,97,40,40
1651016229751,CSE 12,A01,083652,Staff,0,24,100,100
1651016235773,CSE 15L,A01,083654,Staff,0,3,50,50
1651016235773,CSE 15L,A02,083655,Staff,0,3,50,50
1651016241804,CSE 20,A01,083657,Staff,47,0,80,33
1651016247839,CSE 30,A01,083084,Eldon; John,1,39,80,79
1651016253863,CSE 100,A01,083659,Cao; Yingjun,0,72,50,50
1651016259885,CSE 134B,A01,083661,Powell; Thomas Allan,1,39,65,64
1651016265909,CSE 140,A01,083663,Staff,0,13,75,75
1651016271934,CSE 140L,A01,083088,Eldon; John,4,0,100,96
1651016277957,CSE 175,A01,083665,Kumar; Rakesh,0,0,25,25
1651016283980,CSE 190,A00,092507,Dubnov; Shlomo,9,0,20,11
1651016290004,ECE 45,A01,083139,Staff,0,7,60,60
1651016296030,ECE 65,A50,083695,Staff,0,7,30,30
1651016302059,ECE 109,A01,091882,Touri; Behrouz,32,0,70,38
1651016308082,ECE 180,A00,083140,Abi Samra; Nicholas Camill,17,0,30,13
1651016308082,ECE 180,B00,083141,Abi Samra; Nicholas Camill,0,0,30,30
1651016314106,MATH 10A,A01,083735,Patchell; Gregory David,1,0,30,29
1651016314106,MATH 10A,A02,083736,Patchell; Gregory David,27,0,30,3
1651016314106,MATH 10A,A03,083737,Patchell; Gregory David,23,0,30,7
1651016320143,MATH 10B,A01,083207,Staff,0,9,30,30
1651016320143,MATH 10B,A02,083208,Staff,0,6,30,30
1651016320143,MATH 10B,B01,083739,Staff,8,0,30,22
1651016320143,MATH 10B,B02,083740,Staff,28,0,30,2
1651016326167,MATH 18,A01,083743,Staff,0,0,30,30
1651016326167,MATH 18,A02,083744,Staff,23,0,30,7
1651016326167,MATH 18,A03,083745,Staff,19,0,30,11
1651016326167,MATH 18,A04,083746,Staff,26,0,30,4
1651016326167,MATH 18,B01,083748,Staff,0,16,30,30
1651016326167,MATH 18,B02,083749,Staff,0,14,30,30
1651016326167,MATH 18,B03,083750,Staff,0,14,30,30
1651016326167,MATH 18,B04,083751,Staff,0,13,30,30
1651016332197,MATH 20A,A01,083754,Staff,19,0,40,21
1651016338223,MATH 20B,A01,083756,Staff,0,14,30,30
1651016338223,MATH 20B,A02,083757,Staff,0,11,30,30
1651016344251,MATH 20C,A01,083760,Staff,0,17,30,30
1651016344251,MATH 20C,A02,083761,Staff,0,15,30,30
1651016344251,MATH 20C,B01,083762,Staff,9,0,30,21
1651016344251,MATH 20C,B02,083763,Staff,28,0,30,2
1651016350277,MATH 20D,A01,083765,Staff,3,1,30,27
1651016350277,MATH 20D,A02,083766,Staff,2,0,30,28
1651016350277,MATH 20D,A03,083767,Staff,22,0,30,8
1651016356301,MATH 20E,A01,083771,Staff,2,0,30,28
1651016356301,MATH 20E,A02,083772,Staff,12,0,30,18
1651016356301,MATH 20E,B01,083773,Staff,0,0,30,30
1651016356301,MATH 20E,B02,083774,Staff,1,0,30,29
1651016362330,MATH 103A,A01,083777,Staff,0,17,30,30
1651016362330,MATH 103A,A02,083778,Staff,0,15,30,30
1651016362330,MATH 103A,B01,083779,Staff,0,15,30,30
1651016362330,MATH 103A,B02,083780,Staff,0,14,30,30
1651016368354,MATH 105,A01,085443,Staff,0,23,30,30
1651016374380,MATH 109,A01,083213,Anzaldo; Leesa B,0,7,30,30
1651016374380,MATH 109,A02,083214,Anzaldo; Leesa B,0,7,30,30
1651016374380,MATH 109,B01,083215,Anzaldo; Leesa B,0,8,30,30
1651016374380,MATH 109,B02,083216,Anzaldo; Leesa B,0,7,30,30
1651016380408,MATH 142A,A01,083219,Chow; Bennett,0,14,30,30
1651016380408,MATH 142A,A02,083220,Chow; Bennett,0,15,30,30
1651016380408,MATH 142A,B01,083221,Chow; Bennett,0,16,30,30
1651016380408,MATH 142A,B02,083222,Chow; Bennett,0,14,30,30
1651016386438,MATH 193A,A01,083224,Staff,0,7,30,30
1651016386438,MATH 193A,A02,083225,Staff,0,7,30,30
1651016386438,MATH 193A,A03,083781,Staff,0,7,30,30
1651016386438,MATH 193A,A04,083782,Staff,0,7,30,30
1651016392461,MATH 197,001,091859,McAuley; Julian John,9998,0,9999,1
1651016398517,COGS 9,A01,083615,Staff,0,19,60,60
1651016404541,COGS 11,A01,083617,Boyle; Mary E. T.,13,0,40,27
1651016410565,COGS 13,A01,083071,Staff,0,40,40,40
1651016416592,COGS 14A,A01,092681,Staff,0,40,100,100
1651016422616,COGS 14B,A01,083073,Cheng; Tzu-Han,0,13,50,50
1651016428658,COGS 17,A01,092677,Staff,7,0,75,68
1651016434684,COGS 100,A01,083619,Staff,0,30,60,60
1651016440707,COGS 101A,A01,083621,Davis; Joshua Daniel,0,30,60,60
1651016446730,COGS 101B,A01,091572,Staff,0,7,60,60
1651016452757,COGS 101C,A01,083625,Delgado; Tania,14,0,30,16
1651016458782,COGS 107A,A01,083627,Boyle; Mary E. T.,0,16,60,60
1651016464806,COGS 118A,A01,083075,Staff,0,10,60,60
1651016470830,CSE 3,A50,083646,Miranda; Gregory Joseph,15,0,38,23
1651016470830,CSE 3,A51,083647,Miranda; Gregory Joseph,36,0,37,1
1651016476869,CSE 8A,A50,083650,Miranda; Gregory Joseph,0,31,40,40
1651016482895,CSE 11,A01,083080,Cao; Yingjun,0,97,40,40
1651016488919,CSE 12,A01,083652,Staff,0,24,100,100
1651016494951,CSE 15L,A01,083654,Staff,0,3,50,50
1651016494951,CSE 15L,A02,083655,Staff,0,3,50,50
1651016500975,CSE 20,A01,083657,Staff,47,0,80,33
1651016507001,CSE 30,A01,083084,Eldon; John,1,39,80,79
1651016513032,CSE 100,A01,083659,Cao; Yingjun,0,72,50,50
1651016519057,CSE 134B,A01,083661,Powell; Thomas Allan,1,39,65,64
1651016525083,CSE 140,A01,083663,Staff,0,13,75,75
1651016531110,CSE 140L,A01,083088,Eldon; John,4,0,100,96
1651016537138,CSE 175,A01,083665,Kumar; Rakesh,0,0,25,25
1651016543165,CSE 190,A00,092507,Dubnov; Shlomo,9,0,20,11
1651016549197,ECE 45,A01,083139,Staff,0,7,60,60
1651016555222,ECE 65,A50,083695,Staff,0,7,30,30
1651016561246,ECE 109,A01,091882,Touri; Behrouz,32,0,70,38
1651016567274,ECE 180,A00,083140,Abi Samra; Nicholas Camill,17,0,30,13
1651016567274,ECE 180,B00,083141,Abi Samra; Nicholas Camill,0,0,30,30
1651016573298,MATH 10A,A01,083735,Patchell; Gregory David,1,0,30,29
1651016573298,MATH 10A,A02,083736,Patchell; Gregory David,27,0,30,3
1651016573298,MATH 10A,A03,083737,Patchell; Gregory David,23,0,30,7
1651016579321,MATH 10B,A01,083207,Staff,0,9,30,30
1651016579321,MATH 10B,A02,083208,Staff,0,6,30,30
1651016579321,MATH 10B,B01,083739,Staff,8,0,30,22
1651016579321,MATH 10B,B02,083740,Staff,28,0,30,2
1651016585359,MATH 18,A01,083743,Staff,0,0,30,30
1651016585359,MATH 18,A02,083744,Staff,23,0,30,7
1651016585359,MATH 18,A03,083745,Staff,19,0,30,11
1651016585359,MATH 18,A04,083746,Staff,26,0,30,4
1651016585359,MATH 18,B01,083748,Staff,0,16,30,30
1651016585359,MATH 18,B02,083749,Staff,0,14,30,30
1651016585359,MATH 18,B03,083750,Staff,0,14,30,30
1651016585359,MATH 18,B04,083751,Staff,0,13,30,30
1651016591383,MATH 20A,A01,083754,Staff,19,0,40,21
1651016597409,MATH 20B,A01,083756,Staff,0,14,30,30
1651016597409,MATH 20B,A02,083757,Staff,0,11,30,30
1651016603560,MATH 20C,A01,083760,Staff,0,17,30,30
1651016603560,MATH 20C,A02,083761,Staff,0,15,30,30
1651016603560,MATH 20C,B01,083762,Staff,9,0,30,21
1651016603560,MATH 20C,B02,083763,Staff,28,0,30,2
1651016609582,MATH 20D,A01,083765,Staff,3,1,30,27
1651016609582,MATH 20D,A02,083766,Staff,2,0,30,28
1651016609582,MATH 20D,A03,083767,Staff,22,0,30,8
1651016615610,MATH 20E,A01,083771,Staff,2,0,30,28
1651016615610,MATH 20E,A02,083772,Staff,12,0,30,18
1651016615610,MATH 20E,B01,083773,Staff,0,0,30,30
1651016615610,MATH 20E,B02,083774,Staff,1,0,30,29
1651016621637,MATH 103A,A01,083777,Staff,0,17,30,30
1651016621637,MATH 103A,A02,083778,Staff,0,15,30,30
1651016621637,MATH 103A,B01,083779,Staff,0,15,30,30
1651016621637,MATH 103A,B02,083780,Staff,0,14,30,30
1651016627661,MATH 105,A01,085443,Staff,0,23,30,30
1651016633686,MATH 109,A01,083213,Anzaldo; Leesa B,0,7,30,30
1651016633686,MATH 109,A02,083214,Anzaldo; Leesa B,0,7,30,30
1651016633686,MATH 109,B01,083215,Anzaldo; Leesa B,0,8,30,30
1651016633686,MATH 109,B02,083216,Anzaldo; Leesa B,0,7,30,30
1651016639724,MATH 142A,A01,083219,Chow; Bennett,0,14,30,30
1651016639724,MATH 142A,A02,083220,Chow; Bennett,0,15,30,30
1651016639724,MATH 142A,B01,083221,Chow; Bennett,0,16,30,30
1651016639724,MATH 142A,B02,083222,Chow; Bennett,0,14,30,30
1651016645747,MATH 193A,A01,083224,Staff,0,7,30,30
1651016645747,MATH 193A,A02,083225,Staff,0,7,30,30
1651016645747,MATH 193A,A03,083781,Staff,0,7,30,30
1651016645747,MATH 193A,A04,083782,Staff,0,7,30,30
1651016651772,MATH 197,001,091859,McAuley; Julian John,9998,0,9999,1
1651016657823,COGS 9,A01,083615,Staff,0,19,60,60
1651016663847,COGS 11,A01,083617,Boyle; Mary E. T.,13,0,40,27
1651016669869,COGS 13,A01,083071,Staff,0,40,40,40
1651016675895,COGS 14A,A01,092681,Staff,0,40,100,100
1651016681917,COGS 14B,A01,083073,Cheng; Tzu-Han,0,13,50,50
1651016687939,COGS 17,A01,092677,Staff,7,0,75,68
1651016693969,COGS 100,A01,083619,Staff,0,30,60,60
1651016699993,COGS 101A,A01,083621,Davis; Joshua Daniel,0,30,60,60
1651016706021,COGS 101B,A01,091572,Staff,0,7,60,60
1651016712053,COGS 101C,A01,083625,Delgado; Tania,14,0,30,16
1651016718080,COGS 107A,A01,083627,Boyle; Mary E. T.,0,16,60,60
1651016724103,COGS 118A,A01,083075,Staff,0,10,60,60
1651016730127,CSE 3,A50,083646,Miranda; Gregory Joseph,15,0,38,23
1651016730127,CSE 3,A51,083647,Miranda; Gregory Joseph,36,0,37,1
1651016736152,CSE 8A,A50,083650,Miranda; Gregory Joseph,0,31,40,40
1651016742180,CSE 11,A01,083080,Cao; Yingjun,0,97,40,40
1651016748204,CSE 12,A01,083652,Staff,0,24,100,100
1651016754226,CSE 15L,A01,083654,Staff,0,3,50,50
1651016754226,CSE 15L,A02,083655,Staff,0,3,50,50
1651016760252,CSE 20,A01,083657,Staff,47,0,80,33
1651016766275,CSE 30,A01,083084,Eldon; John,1,39,80,79
1651016772301,CSE 100,A01,083659,Cao; Yingjun,0,72,50,50
1651016778324,CSE 134B,A01,083661,Powell; Thomas Allan,1,39,65,64
1651016784347,CSE 140,A01,083663,Staff,0,13,75,75
1651016790374,CSE 140L,A01,083088,Eldon; John,4,0,100,96
1651016796397,CSE 175,A01,083665,Kumar; Rakesh,0,0,25,25
1651016802421,CSE 190,A00,092507,Dubnov; Shlomo,9,0,20,11
1651016808444,ECE 45,A01,083139,Staff,0,7,60,60
1651016814471,ECE 65,A50,083695,Staff,0,7,30,30
1651016820498,ECE 109,A01,091882,Touri; Behrouz,32,0,70,38
1651016826526,ECE 180,A00,083140,Abi Samra; Nicholas Camill,17,0,30,13
1651016826526,ECE 180,B00,083141,Abi Samra; Nicholas Camill,0,0,30,30
1651016832551,MATH 10A,A01,083735,Patchell; Gregory David,1,0,30,29
1651016832551,MATH 10A,A02,083736,Patchell; Gregory David,27,0,30,3
1651016832551,MATH 10A,A03,083737,Patchell; Gregory David,23,0,30,7
1651016838578,MATH 10B,A01,083207,Staff,0,9,30,30
1651016838578,MATH 10B,A02,083208,Staff,0,6,30,30
1651016838578,MATH 10B,B01,083739,Staff,8,0,30,22
1651016838578,MATH 10B,B02,083740,Staff,28,0,30,2
1651016844604,MATH 18,A01,083743,Staff,0,0,30,30
1651016844604,MATH 18,A02,083744,Staff,23,0,30,7
1651016844604,MATH 18,A03,083745,Staff,19,0,30,11
1651016844604,MATH 18,A04,083746,Staff,26,0,30,4
1651016844604,MATH 18,B01,083748,Staff,0,16,30,30
1651016844604,MATH 18,B02,083749,Staff,0,14,30,30
1651016844604,MATH 18,B03,083750,Staff,0,14,30,30
1651016844604,MATH 18,B04,083751,Staff,0,13,30,30
1651016850628,MATH 20A,A01,083754,Staff,19,0,40,21
1651016856662,MATH 20B,A01,083756,Staff,0,14,30,30
1651016856662,MATH 20B,A02,083757,Staff,0,11,30,30
1651016862688,MATH 20C,A01,083760,Staff,0,17,30,30
1651016862688,MATH 20C,A02,083761,Staff,0,15,30,30
1651016862688,MATH 20C,B01,083762,Staff,9,0,30,21
1651016862688,MATH 20C,B02,083763,Staff,28,0,30,2
1651016868725,MATH 20D,A01,083765,Staff,3,1,30,27
1651016868725,MATH 20D,A02,083766,Staff,2,0,30,28
1651016868725,MATH 20D,A03,083767,Staff,22,0,30,8
1651016874750,MATH 20E,A01,083771,Staff,2,0,30,28
1651016874750,MATH 20E,A02,083772,Staff,12,0,30,18
1651016874750,MATH 20E,B01,083773,Staff,0,0,30,30
1651016874750,MATH 20E,B02,083774,Staff,1,0,30,29
1651016880777,MATH 103A,A01,083777,Staff,0,17,30,30
1651016880777,MATH 103A,A02,083778,Staff,0,15,30,30
1651016880777,MATH 103A,B01,083779,Staff,0,15,30,30
1651016880777,MATH 103A,B02,083780,Staff,0,14,30,30
1651016886806,MATH 105,A01,085443,Staff,0,23,30,30
1651016892830,MATH 109,A01,083213,Anzaldo; Leesa B,0,7,30,30
1651016892830,MATH 109,A02,083214,Anzaldo; Leesa B,0,7,30,30
1651016892830,MATH 109,B01,083215,Anzaldo; Leesa B,0,8,30,30
1651016892830,MATH 109,B02,083216,Anzaldo; Leesa B,0,7,30,30
1651016898855,MATH 142A,A01,083219,Chow; Bennett,0,14,30,30
1651016898855,MATH 142A,A02,083220,Chow; Bennett,0,15,30,30
1651016898855,MATH 142A,B01,083221,Chow; Bennett,0,16,30,30
1651016898855,MATH 142A,B02,083222,Chow; Bennett,0,14,30,30
1651016904878,MATH 193A,A01,083224,Staff,0,7,30,30
1651016904878,MATH 193A,A02,083225,Staff,0,7,30,30
1651016904878,MATH 193A,A03,083781,Staff,0,7,30,30
1651016904878,MATH 193A,A04,083782,Staff,0,7,30,30
1651016910900,MATH 197,001,091859,McAuley; Julian John,9998,0,9999,1
1651016916949,COGS 9,A01,083615,Staff,0,19,60,60
1651016922972,COGS 11,A01,083617,Boyle; Mary E. T.,13,0,40,27
1651016928996,COGS 13,A01,083071,Staff,0,40,40,40
1651016935019,COGS 14A,A01,092681,Staff,0,40,100,100
1651016941043,COGS 14B,A01,083073,Cheng; Tzu-Han,0,13,50,50
1651016947067,COGS 17,A01,092677,Staff,7,0,75,68
1651016953090,COGS 100,A01,083619,Staff,0,30,60,60
1651016959117,COGS 101A,A01,083621,Davis; Joshua Daniel,0,30,60,60
1651016965145,COGS 101B,A01,091572,Staff,0,7,60,60
1651016971166,COGS 101C,A01,083625,Delgado; Tania,14,0,30,16
1651016977197,COGS 107A,A01,083627,Boyle; Mary E. T.,0,16,60,60
1651016983220,COGS 118A,A01,083075,Staff,0,10,60,60
1651016989250,CSE 3,A50,083646,Miranda; Gregory Joseph,15,0,38,23
1651016989250,CSE 3,A51,083647,Miranda; Gregory Joseph,36,0,37,1
1651016995274,CSE 8A,A50,083650,Miranda; Gregory Joseph,0,31,40,40
1651017001298,CSE 11,A01,083080,Cao; Yingjun,0,97,40,40
1651017007321,CSE 12,A01,083652,Staff,0,24,100,100
1651017013344,CSE 15L,A01,083654,Staff,0,3,50,50
1651017013344,CSE 15L,A02,083655,Staff,0,3,50,50
1651017019371,CSE 20,A01,083657,Staff,47,0,80,33
1651017025393,CSE 30,A01,083084,Eldon; John,1,39,80,79
1651017031415,CSE 100,A01,083659,Cao; Yingjun,0,72,50,50
1651017037438,CSE 134B,A01,083661,Powell; Thomas Allan,1,39,65,64
1651017043468,CSE 140,A01,083663,Staff,0,13,75,75
1651017049491,CSE 140L,A01,083088,Eldon; John,4,0,100,96
1651017055516,CSE 175,A01,083665,Kumar; Rakesh,0,0,25,25
1651017061540,CSE 190,A00,092507,Dubnov; Shlomo,9,0,20,11
1651017067566,ECE 45,A01,083139,Staff,0,7,60,60
1651017073598,ECE 65,A50,083695,Staff,0,7,30,30
1651017079631,ECE 109,A01,091882,Touri; Behrouz,32,0,70,38
1651017085660,ECE 180,A00,083140,Abi Samra; Nicholas Camill,17,0,30,13
1651017085660,ECE 180,B00,083141,Abi Samra; Nicholas Camill,0,0,30,30
1651017091684,MATH 10A,A01,083735,Patchell; Gregory David,1,0,30,29
1651017091684,MATH 10A,A02,083736,Patchell; Gregory David,27,0,30,3
1651017091684,MATH 10A,A03,083737,Patchell; Gregory David,23,0,30,7
1651017097710,MATH 10B,A01,083207,Staff,0,9,30,30
1651017097710,MATH 10B,A02,083208,Staff,0,6,30,30
1651017097710,MATH 10B,B01,083739,Staff,8,0,30,22
1651017097710,MATH 10B,B02,083740,Staff,28,0,30,2
1651017103735,MATH 18,A01,083743,Staff,0,0,30,30
1651017103735,MATH 18,A02,083744,Staff,23,0,30,7
1651017103735,MATH 18,A03,083745,Staff,19,0,30,11
1651017103735,MATH 18,A04,083746,Staff,26,0,30,4
1651017103735,MATH 18,B01,083748,Staff,0,16,30,30
1651017103735,MATH 18,B02,083749,Staff,0,14,30,30
1651017103735,MATH 18,B03,083750,Staff,0,14,30,30
1651017103735,MATH 18,B04,083751,Staff,0,13,30,30
1651017109757,MATH 20A,A01,083754,Staff,18,0,40,22
1651017115781,MATH 20B,A01,083756,Staff,0,14,30,30
1651017115781,MATH 20B,A02,083757,Staff,0,11,30,30
1651017121808,MATH 20C,A01,083760,Staff,0,17,30,30
1651017121808,MATH 20C,A02,083761,Staff,0,15,30,30
1651017121808,MATH 20C,B01,083762,Staff,9,0,30,21
1651017121808,MATH 20C,B02,083763,Staff,28,0,30,2
1651017127834,MATH 20D,A01,083765,Staff,3,1,30,27
1651017127834,MATH 20D,A02,083766,Staff,2,0,30,28
1651017127834,MATH 20D,A03,083767,Staff,22,0,30,8
1651017133865,MATH 20E,A01,083771,Staff,2,0,30,28
1651017133865,MATH 20E,A02,083772,Staff,12,0,30,18
1651017133865,MATH 20E,B01,083773,Staff,0,0,30,30
1651017133865,MATH 20E,B02,083774,Staff,1,0,30,29
1651017139897,MATH 103A,A01,083777,Staff,0,17,30,30
1651017139897,MATH 103A,A02,083778,Staff,0,15,30,30
1651017139897,MATH 103A,B01,083779,Staff,0,15,30,30
1651017139897,MATH 103A,B02,083780,Staff,0,14,30,30
1651017145922,MATH 105,A01,085443,Staff,0,23,30,30
1651017151947,MATH 109,A01,083213,Anzaldo; Leesa B,0,7,30,30
1651017151947,MATH 109,A02,083214,Anzaldo; Leesa B,0,7,30,30
1651017151947,MATH 109,B01,083215,Anzaldo; Leesa B,0,8,30,30
1651017151947,MATH 109,B02,083216,Anzaldo; Leesa B,0,7,30,30
1651017157984,MATH 142A,A01,083219,Chow; Bennett,0,14,30,30
1651017157984,MATH 142A,A02,083220,Chow; Bennett,0,15,30,30
1651017157984,MATH 142A,B01,083221,Chow; Bennett,0,16,30,30
1651017157984,MATH 142A,B02,083222,Chow; Bennett,0,14,30,30
1651017164011,MATH 193A,A01,083224,Staff,0,7,30,30
1651017164011,MATH 193A,A02,083225,Staff,0,7,30,30
1651017164011,MATH 193A,A03,083781,Staff,0,7,30,30
1651017164011,MATH 193A,A04,083782,Staff,0,7,30,30
1651017170033,MATH 197,001,091859,McAuley; Julian John,9998,0,9999,1
1651017176091,COGS 9,A01,083615,Staff,0,19,60,60
1651017182117,COGS 11,A01,083617,Boyle; Mary E. T.,13,0,40,27
1651017188139,COGS 13,A01,083071,Staff,0,40,40,40
1651017194252,COGS 14A,A01,092681,Staff,0,40,100,100
1651017200276,COGS 14B,A01,083073,Cheng; Tzu-Han,0,13,50,50
1651017206298,COGS 17,A01,092677,Staff,7,0,75,68
1651017212327,COGS 100,A01,083619,Staff,0,30,60,60
1651017218354,COGS 101A,A01,083621,Davis; Joshua Daniel,0,30,60,60
1651017224375,COGS 101B,A01,091572,Staff,0,7,60,60
1651017230397,COGS 101C,A01,083625,Delgado; Tania,14,0,30,16
1651017236431,COGS 107A,A01,083627,Boyle; Mary E. T.,0,16,60,60
1651017242454,COGS 118A,A01,083075,Staff,0,10,60,60
1651017248481,CSE 3,A50,083646,Miranda; Gregory Joseph,15,0,38,23
1651017248481,CSE 3,A51,083647,Miranda; Gregory Joseph,36,0,37,1
1651017254511,CSE 8A,A50,083650,Miranda; Gregory Joseph,0,31,40,40
1651017260536,CSE 11,A01,083080,Cao; Yingjun,0,97,40,40
1651017266562,CSE 12,A01,083652,Staff,0,24,100,100
1651017272593,CSE 15L,A01,083654,Staff,0,3,50,50
1651017272593,CSE 15L,A02,083655,Staff,0,3,50,50
1651017278627,CSE 20,A01,083657,Staff,47,0,80,33
1651017284650,CSE 30,A01,083084,Eldon; John,1,39,80,79
1651017290674,CSE 100,A01,083659,Cao; Yingjun,0,72,50,50
1651017296701,CSE 134B,A01,083661,Powell; Thomas Allan,1,39,65,64
1651017302724,CSE 140,A01,083663,Staff,0,13,75,75
1651017308750,CSE 140L,A01,083088,Eldon; John,4,0,100,96
1651017314771,CSE 175,A01,083665,Kumar; Rakesh,0,0,25,25
1651017320794,CSE 190,A00,092507,Dubnov; Shlomo,9,0,20,11
1651017326817,ECE 45,A01,083139,Staff,0,7,60,60
1651017332838,ECE 65,A50,083695,Staff,0,7,30,30
1651017338864,ECE 109,A01,091882,Touri; Behrouz,32,0,70,38
1651017344888,ECE 180,A00,083140,Abi Samra; Nicholas Camill,17,0,30,13
1651017344888,ECE 180,B00,083141,Abi Samra; Nicholas Camill,0,0,30,30
1651017350911,MATH 10A,A01,083735,Patchell; Gregory David,1,0,30,29
1651017350911,MATH 10A,A02,083736,Patchell; Gregory David,27,0,30,3
1651017350911,MATH 10A,A03,083737,Patchell; Gregory David,23,0,30,7
1651017356939,MATH 10B,A01,083207,Staff,0,9,30,30
1651017356939,MATH 10B,A02,083208,Staff,0,6,30,30
1651017356939,MATH 10B,B01,083739,Staff,8,0,30,22
1651017356939,MATH 10B,B02,083740,Staff,28,0,30,2
1651017362962,MATH 18,A01,083743,Staff,0,0,30,30
1651017362962,MATH 18,A02,083744,Staff,23,0,30,7
1651017362962,MATH 18,A03,083745,Staff,19,0,30,11
1651017362962,MATH 18,A04,083746,Staff,26,0,30,4
1651017362962,MATH 18,B01,083748,Staff,0,16,30,30
1651017362962,MATH 18,B02,083749,Staff,0,14,30,30
1651017362962,MATH 18,B03,083750,Staff,0,14,30,30
1651017362962,MATH 18,B04,083751,Staff,0,13,30,30
1651017368988,MATH 20A,A01,083754,Staff,18,0,40,22
1651017375015,MATH 20B,A01,083756,Staff,0,14,30,30
1651017375015,MATH 20B,A02,083757,Staff,0,11,30,30
1651017381050,MATH 20C,A01,083760,Staff,0,17,30,30
1651017381050,MATH 20C,A02,083761,Staff,0,15,30,30
1651017381050,MATH 20C,B01,083762,Staff,9,0,30,21
1651017381050,MATH 20C,B02,083763,Staff,28,0,30,2
1651017387075,MATH 20D,A01,083765,Staff,3,1,30,27
1651017387075,MATH 20D,A02,083766,Staff,2,0,30,28
1651017387075,MATH 20D,A03,083767,Staff,22,0,30,8
1651017393099,MATH 20E,A01,083771,Staff,2,0,30,28
1651017393099,MATH 20E,A02,083772,Staff,12,0,30,18
1651017393099,MATH 20E,B01,083773,Staff,0,0,30,30
1651017393099,MATH 20E,B02,083774,Staff,1,0,30,29
1651017399123,MATH 103A,A01,083777,Staff,0,17,30,30
1651017399123,MATH 103A,A02,083778,Staff,0,15,30,30
1651017399123,MATH 103A,B01,083779,Staff,0,15,30,30
1651017399123,MATH 103A,B02,083780,Staff,0,14,30,30
1651017405149,MATH 105,A01,085443,Staff,0,23,30,30
1651017411176,MATH 109,A01,083213,Anzaldo; Leesa B,0,7,30,30
1651017411176,MATH 109,A02,083214,Anzaldo; Leesa B,0,7,30,30
1651017411176,MATH 109,B01,083215,Anzaldo; Leesa B,0,8,30,30
1651017411176,MATH 109,B02,083216,Anzaldo; Leesa B,0,7,30,30
1651017417203,MATH 142A,A01,083219,Chow; Bennett,0,14,30,30
1651017417203,MATH 142A,A02,083220,Chow; Bennett,0,15,30,30
1651017417203,MATH 142A,B01,083221,Chow; Bennett,0,16,30,30
1651017417203,MATH 142A,B02,083222,Chow; Bennett,0,14,30,30
1651017423225,MATH 193A,A01,083224,Staff,0,7,30,30
1651017423225,MATH 193A,A02,083225,Staff,0,7,30,30
1651017423225,MATH 193A,A03,083781,Staff,0,7,30,30
1651017423225,MATH 193A,A04,083782,Staff,0,7,30,30
1651017429261,MATH 197,001,091859,McAuley; Julian John,9998,0,9999,1
1651017435325,COGS 9,A01,083615,Staff,0,19,60,60
1651017441348,COGS 11,A01,083617,Boyle; Mary E. T.,13,0,40,27
1651017447373,COGS 13,A01,083071,Staff,0,40,40,40
1651017453407,COGS 14A,A01,092681,Staff,0,40,100,100
1651017459446,COGS 14B,A01,083073,Cheng; Tzu-Han,0,13,50,50
1651017465481,COGS 17,A01,092677,Staff,7,0,75,68
1651017471503,COGS 100,A01,083619,Staff,0,30,60,60
1651017477533,COGS 101A,A01,083621,Davis; Joshua Daniel,0,30,60,60
1651017483558,COGS 101B,A01,091572,Staff,0,7,60,60
1651017489581,COGS 101C,A01,083625,Delgado; Tania,14,0,30,16
1651017495604,COGS 107A,A01,083627,Boyle; Mary E. T.,0,16,60,60
1651017501645,COGS 118A,A01,083075,Staff,0,10,60,60
1651017507670,CSE 3,A50,083646,Miranda; Gregory Joseph,15,0,38,23
1651017507670,CSE 3,A51,083647,Miranda; Gregory Joseph,36,0,37,1
1651017513707,CSE 8A,A50,083650,Miranda; Gregory Joseph,0,31,40,40
1651017519740,CSE 11,A01,083080,Cao; Yingjun,0,97,40,40
1651017525769,CSE 12,A01,083652,Staff,0,24,100,100
1651017531793,CSE 15L,A01,083654,Staff,0,3,50,50
1651017531793,CSE 15L,A02,083655,Staff,0,3,50,50
1651017537820,CSE 20,A01,083657,Staff,47,0,80,33
1651017543850,CSE 30,A01,083084,Eldon; John,1,39,80,79
1651017549874,CSE 100,A01,083659,Cao; Yingjun,0,72,50,50
1651017555901,CSE 134B,A01,083661,Powell; Thomas Allan,1,39,65,64
1651017561940,CSE 140,A01,083663,Staff,0,13,75,75
1651017567967,CSE 140L,A01,083088,Eldon; John,4,0,100,96
1651017573991,CSE 175,A01,083665,Kumar; Rakesh,0,0,25,25
1651017580022,CSE 190,A00,092507,Dubnov; Shlomo,9,0,20,11
1651017586050,ECE 45,A01,083139,Staff,0,7,60,60
1651017592084,ECE 65,A50,083695,Staff,0,7,30,30
1651017598110,ECE 109,A01,091882,Touri; Behrouz,32,0,70,38
1651017604134,ECE 180,A00,083140,Abi Samra; Nicholas Camill,17,0,30,13
1651017604134,ECE 180,B00,083141,Abi Samra; Nicholas Camill,0,0,30,30
1651017610160,MATH 10A,A01,083735,Patchell; Gregory David,1,0,30,29
1651017610160,MATH 10A,A02,083736,Patchell; Gregory David,27,0,30,3
1651017610160,MATH 10A,A03,083737,Patchell; Gregory David,23,0,30,7
1651017616187,MATH 10B,A01,083207,Staff,0,9,30,30
1651017616187,MATH 10B,A02,083208,Staff,0,6,30,30
1651017616187,MATH 10B,B01,083739,Staff,8,0,30,22
1651017616187,MATH 10B,B02,083740,Staff,28,0,30,2
1651017622216,MATH 18,A01,083743,Staff,0,0,30,30
1651017622216,MATH 18,A02,083744,Staff,23,0,30,7
1651017622216,MATH 18,A03,083745,Staff,19,0,30,11
1651017622216,MATH 18,A04,083746,Staff,26,0,30,4
1651017622216,MATH 18,B01,083748,Staff,0,16,30,30
1651017622216,MATH 18,B02,083749,Staff,0,14,30,30
1651017622216,MATH 18,B03,083750,Staff,0,14,30,30
1651017622216,MATH 18,B04,083751,Staff,0,13,30,30
1651017628273,MATH 20A,A01,083754,Staff,18,0,40,22
1651017634298,MATH 20B,A01,083756,Staff,0,14,30,30
1651017634298,MATH 20B,A02,083757,Staff,0,11,30,30
1651017640325,MATH 20C,A01,083760,Staff,0,17,30,30
1651017640325,MATH 20C,A02,083761,Staff,0,15,30,30
1651017640325,MATH 20C,B01,083762,Staff,9,0,30,21
1651017640325,MATH 20C,B02,083763,Staff,28,0,30,2
1651017646347,MATH 20D,A01,083765,Staff,3,1,30,27
1651017646347,MATH 20D,A02,083766,Staff,2,0,30,28
1651017646347,MATH 20D,A03,083767,Staff,22,0,30,8
1651017652379,MATH 20E,A01,083771,Staff,2,0,30,28
1651017652379,MATH 20E,A02,083772,Staff,12,0,30,18
1651017652379,MATH 20E,B01,083773,Staff,0,0,30,30
1651017652379,MATH 20E,B02,083774,Staff,1,0,30,29
1651017658406,MATH 103A,A01,083777,Staff,0,17,30,30
1651017658406,MATH 103A,A02,083778,Staff,0,15,30,30
1651017658406,MATH 103A,B01,083779,Staff,0,15,30,30
1651017658406,MATH 103A,B02,083780,Staff,0,14,30,30
1651017664437,MATH 105,A01,085443,Staff,0,23,30,30
1651017670461,MATH 109,A01,083213,Anzaldo; Leesa B,0,7,30,30
1651017670461,MATH 109,A02,083214,Anzaldo; Leesa B,0,7,30,30
1651017670461,MATH 109,B01,083215,Anzaldo; Leesa B,0,8,30,30
1651017670461,MATH 109,B02,083216,Anzaldo; Leesa B,0,7,30,30
1651017676490,MATH 142A,A01,083219,Chow; Bennett,0,14,30,30
1651017676490,MATH 142A,A02,083220,Chow; Bennett,0,15,30,30
1651017676490,MATH 142A,B01,083221,Chow; Bennett,0,16,30,30
1651017676490,MATH 142A,B02,083222,Chow; Bennett,0,14,30,30
1651017682518,MATH 193A,A01,083224,Staff,0,7,30,30
1651017682518,MATH 193A,A02,083225,Staff,0,7,30,30
1651017682518,MATH 193A,A03,083781,Staff,0,7,30,30
1651017682518,MATH 193A,A04,083782,Staff,0,7,30,30
1651017688548,MATH 197,001,091859,McAuley; Julian John,9998,0,9999,1
1651017694601,COGS 9,A01,083615,Staff,0,19,60,60
1651017700632,COGS 11,A01,083617,Boyle; Mary E. T.,13,0,40,27
1651017706660,COGS 13,A01,083071,Staff,0,40,40,40
1651017712682,COGS 14A,A01,092681,Staff,0,40,100,100
1651017718717,COGS 14B,A01,083073,Cheng; Tzu-Han,0,13,50,50
1651017724750,COGS 17,A01,092677,Staff,7,0,75,68
1651017730782,COGS 100,A01,083619,Staff,0,30,60,60
1651017736810,COGS 101A,A01,083621,Davis; Joshua Daniel,0,30,60,60
1651017742837,COGS 101B,A01,091572,Staff,0,7,60,60
1651017748860,COGS 101C,A01,083625,Delgado; Tania,14,0,30,16
1651017754898,COGS 107A,A01,083627,Boyle; Mary E. T.,0,16,60,60
1651017760925,COGS 118A,A01,083075,Staff,0,10,60,60
1651017766949,CSE 3,A50,083646,Miranda; Gregory Joseph,15,0,38,23
1651017766949,CSE 3,A51,083647,Miranda; Gregory Joseph,36,0,37,1
1651017772982,CSE 8A,A50,083650,Miranda; Gregory Joseph,0,31,40,40
1651017779009,CSE 11,A01,083080,Cao; Yingjun,0,97,40,40
1651017785033,CSE 12,A01,083652,Staff,0,24,100,100
1651017791166,CSE 15L,A01,083654,Staff,0,3,50,50
1651017791166,CSE 15L,A02,083655,Staff,0,3,50,50
1651017797196,CSE 20,A01,083657,Staff,47,0,80,33
1651017803219,CSE 30,A01,083084,Eldon; John,1,39,80,79
1651017809246,CSE 100,A01,083659,Cao; Yingjun,0,72,50,50
1651017815268,CSE 134B,A01,083661,Powell; Thomas Allan,1,39,65,64
1651017821304,CSE 140,A01,083663,Staff,0,13,75,75
1651017827337,CSE 140L,A01,083088,Eldon; John,4,0,100,96
1651017833360,CSE 175,A01,083665,Kumar; Rakesh,0,0,25,25
1651017839387,CSE 190,A00,092507,Dubnov; Shlomo,9,0,20,11
1651017845422,ECE 45,A01,083139,Staff,0,7,60,60
1651017851454,ECE 65,A50,083695,Staff,0,7,30,30
1651017857480,ECE 109,A01,091882,Touri; Behrouz,32,0,70,38
1651017863508,ECE 180,A00,083140,Abi Samra; Nicholas Camill,17,0,30,13
1651017863508,ECE 180,B00,083141,Abi Samra; Nicholas Camill,0,0,30,30
1651017869529,MATH 10A,A01,083735,Patchell; Gregory David,1,0,30,29
1651017869529,MATH 10A,A02,083736,Patchell; Gregory David,27,0,30,3
1651017869529,MATH 10A,A03,083737,Patchell; Gregory David,23,0,30,7
1651017875557,MATH 10B,A01,083207,Staff,0,9,30,30
1651017875557,MATH 10B,A02,083208,Staff,0,6,30,30
1651017875557,MATH 10B,B01,083739,Staff,8,0,30,22
1651017875557,MATH 10B,B02,083740,Staff,28,0,30,2
1651017881595,MATH 18,A01,083743,Staff,0,0,30,30
1651017881595,MATH 18,A02,083744,Staff,23,0,30,7
1651017881595,MATH 18,A03,083745,Staff,19,0,30,11
1651017881595,MATH 18,A04,083746,Staff,26,0,30,4
1651017881595,MATH 18,B01,083748,Staff,0,16,30,30
1651017881595,MATH 18,B02,083749,Staff,0,14,30,30
1651017881595,MATH 18,B03,083750,Staff,0,14,30,30
1651017881595,MATH 18,B04,083751,Staff,0,13,30,30
1651017887620,MATH 20A,A01,083754,Staff,18,0,40,22
1651017893646,MATH 20B,A01,083756,Staff,0,14,30,30
1651017893646,MATH 20B,A02,083757,Staff,0,11,30,30
1651017899673,MATH 20C,A01,083760,Staff,0,17,30,30
1651017899673,MATH 20C,A02,083761,Staff,0,15,30,30
1651017899673,MATH 20C,B01,083762,Staff,9,0,30,21
1651017899673,MATH 20C,B02,083763,Staff,28,0,30,2
1651017905697,MATH 20D,A01,083765,Staff,3,1,30,27
1651017905697,MATH 20D,A02,083766,Staff,2,0,30,28
1651017905697,MATH 20D,A03,083767,Staff,22,0,30,8
1651017911733,MATH 20E,A01,083771,Staff,2,0,30,28
1651017911733,MATH 20E,A02,083772,Staff,12,0,30,18
1651017911733,MATH 20E,B01,083773,Staff,0,0,30,30
1651017911733,MATH 20E,B02,083774,Staff,1,0,30,29
1651017917757,MATH 103A,A01,083777,Staff,0,17,30,30
1651017917757,MATH 103A,A02,083778,Staff,0,15,30,30
1651017917757,MATH 103A,B01,083779,Staff,0,15,30,30
1651017917757,MATH 103A,B02,083780,Staff,0,14,30,30
1651017923781,MATH 105,A01,085443,Staff,0,23,30,30
1651017929804,MATH 109,A01,083213,Anzaldo; Leesa B,0,7,30,30
1651017929804,MATH 109,A02,083214,Anzaldo; Leesa B,0,7,30,30
1651017929804,MATH 109,B01,083215,Anzaldo; Leesa B,0,8,30,30
1651017929804,MATH 109,B02,083216,Anzaldo; Leesa B,0,7,30,30
1651017935837,MATH 142A,A01,083219,Chow; Bennett,0,14,30,30
1651017935837,MATH 142A,A02,083220,Chow; Bennett,0,15,30,30
1651017935837,MATH 142A,B01,083221,Chow; Bennett,0,16,30,30
1651017935837,MATH 142A,B02,083222,Chow; Bennett,0,14,30,30
1651017941861,MATH 193A,A01,083224,Staff,0,7,30,30
1651017941861,MATH 193A,A02,083225,Staff,0,7,30,30
1651017941861,MATH 193A,A03,083781,Staff,0,7,30,30
1651017941861,MATH 193A,A04,083782,Staff,0,7,30,30
1651017947884,MATH 197,001,091859,McAuley; Julian John,9998,0,9999,1
1651017953935,COGS 9,A01,083615,Staff,0,19,60,60
1651017959959,COGS 11,A01,083617,Boyle; Mary E. T.,13,0,40,27
1651017965986,COGS 13,A01,083071,Staff,0,40,40,40
1651017972008,COGS 14A,A01,092681,Staff,0,40,100,100
1651017978037,COGS 14B,A01,083073,Cheng; Tzu-Han,0,13,50,50
1651017984064,COGS 17,A01,092677,Staff,7,0,75,68
1651017990091,COGS 100,A01,083619,Staff,0,30,60,60
1651017996115,COGS 101A,A01,083621,Davis; Joshua Daniel,0,30,60,60
1651018002145,COGS 101B,A01,091572,Staff,0,7,60,60
1651018008169,COGS 101C,A01,083625,Delgado; Tania,14,0,30,16
1651018014195,COGS 107A,A01,083627,Boyle; Mary E. T.,0,16,60,60
1651018020233,COGS 118A,A01,083075,Staff,0,10,60,60
1651018026262,CSE 3,A50,083646,Miranda; Gregory Joseph,15,0,38,23
1651018026262,CSE 3,A51,083647,Miranda; Gregory Joseph,36,0,37,1
1651018032304,CSE 8A,A50,083650,Miranda; Gregory Joseph,0,31,40,40
1651018038327,CSE 11,A01,083080,Cao; Yingjun,0,97,40,40
1651018044354,CSE 12,A01,083652,Staff,0,24,100,100
1651018050377,CSE 15L,A01,083654,Staff,0,3,50,50
1651018050377,CSE 15L,A02,083655,Staff,0,3,50,50
1651018056403,CSE 20,A01,083657,Staff,47,0,80,33
1651018062433,CSE 30,A01,083084,Eldon; John,1,39,80,79
1651018068457,CSE 100,A01,083659,Cao; Yingjun,0,72,50,50
1651018074484,CSE 134B,A01,083661,Powell; Thomas Allan,1,39,65,64
1651018080526,CSE 140,A01,083663,Staff,0,13,75,75
1651018086556,CSE 140L,A01,083088,Eldon; John,4,0,100,96
1651018092586,CSE 175,A01,083665,Kumar; Rakesh,0,0,25,25
1651018098610,CSE 190,A00,092507,Dubnov; Shlomo,9,0,20,11
1651018104640,ECE 45,A01,083139,Staff,0,7,60,60
1651018110667,ECE 65,A50,083695,Staff,0,7,30,30
1651018116689,ECE 109,A01,091882,Touri; Behrouz,32,0,70,38
1651018122713,ECE 180,A00,083140,Abi Samra; Nicholas Camill,17,0,30,13
1651018122713,ECE 180,B00,083141,Abi Samra; Nicholas Camill,0,0,30,30
1651018128734,MATH 10A,A01,083735,Patchell; Gregory David,1,0,30,29
1651018128734,MATH 10A,A02,083736,Patchell; Gregory David,27,0,30,3
1651018128734,MATH 10A,A03,083737,Patchell; Gregory David,23,0,30,7
1651018134765,MATH 10B,A01,083207,Staff,0,9,30,30
1651018134765,MATH 10B,A02,083208,Staff,0,6,30,30
1651018134765,MATH 10B,B01,083739,Staff,8,0,30,22
1651018134765,MATH 10B,B02,083740,Staff,28,0,30,2
1651018140805,MATH 18,A01,083743,Staff,0,0,30,30
1651018140805,MATH 18,A02,083744,Staff,23,0,30,7
1651018140805,MATH 18,A03,083745,Staff,19,0,30,11
1651018140805,MATH 18,A04,083746,Staff,26,0,30,4
1651018140805,MATH 18,B01,083748,Staff,0,16,30,30
1651018140805,MATH 18,B02,083749,Staff,0,14,30,30
1651018140805,MATH 18,B03,083750,Staff,0,14,30,30
1651018140805,MATH 18,B04,083751,Staff,0,13,30,30
1651018146836,MATH 20A,A01,083754,Staff,18,0,40,22
1651018152859,MATH 20B,A01,083756,Staff,0,14,30,30
1651018152859,MATH 20B,A02,083757,Staff,0,11,30,30
1651018158883,MATH 20C,A01,083760,Staff,0,17,30,30
1651018158883,MATH 20C,A02,083761,Staff,0,15,30,30
1651018158883,MATH 20C,B01,083762,Staff,9,0,30,21
1651018158883,MATH 20C,B02,083763,Staff,28,0,30,2
1651018164910,MATH 20D,A01,083765,Staff,3,1,30,27
1651018164910,MATH 20D,A02,083766,Staff,2,0,30,28
1651018164910,MATH 20D,A03,083767,Staff,22,0,30,8
1651018170943,MATH 20E,A01,083771,Staff,2,0,30,28
1651018170943,MATH 20E,A02,083772,Staff,12,0,30,18
1651018170943,MATH 20E,B01,083773,Staff,0,0,30,30
1651018170943,MATH 20E,B02,083774,Staff,1,0,30,29
1651018176973,MATH 103A,A01,083777,Staff,0,17,30,30
1651018176973,MATH 103A,A02,083778,Staff,0,15,30,30
1651018176973,MATH 103A,B01,083779,Staff,0,15,30,30
1651018176973,MATH 103A,B02,083780,Staff,0,14,30,30
1651018182997,MATH 105,A01,085443,Staff,0,23,30,30
1651018189026,MATH 109,A01,083213,Anzaldo; Leesa B,0,7,30,30
1651018189026,MATH 109,A02,083214,Anzaldo; Leesa B,0,7,30,30
1651018189026,MATH 109,B01,083215,Anzaldo; Leesa B,0,8,30,30
1651018189026,MATH 109,B02,083216,Anzaldo; Leesa B,0,7,30,30
1651018195055,MATH 142A,A01,083219,Chow; Bennett,0,14,30,30
1651018195055,MATH 142A,A02,083220,Chow; Bennett,0,15,30,30
1651018195055,MATH 142A,B01,083221,Chow; Bennett,0,16,30,30
1651018195055,MATH 142A,B02,083222,Chow; Bennett,0,14,30,30
1651018201077,MATH 193A,A01,083224,Staff,0,7,30,30
1651018201077,MATH 193A,A02,083225,Staff,0,7,30,30
1651018201077,MATH 193A,A03,083781,Staff,0,7,30,30
1651018201077,MATH 193A,A04,083782,Staff,0,7,30,30
1651018207100,MATH 197,001,091859,McAuley; Julian John,9998,0,9999,1
1651018213148,COGS 9,A01,083615,Staff,0,19,60,60
1651018219171,COGS 11,A01,083617,Boyle; Mary E. T.,13,0,40,27
1651018225195,COGS 13,A01,083071,Staff,0,40,40,40
1651018231221,COGS 14A,A01,092681,Staff,0,40,100,100
1651018237251,COGS 14B,A01,083073,Cheng; Tzu-Han,0,13,50,50
1651018243277,COGS 17,A01,092677,Staff,7,0,75,68
1651018249315,COGS 100,A01,083619,Staff,0,30,60,60
1651018255341,COGS 101A,A01,083621,Davis; Joshua Daniel,0,30,60,60
1651018261368,COGS 101B,A01,091572,Staff,0,7,60,60
1651018267391,COGS 101C,A01,083625,Delgado; Tania,14,0,30,16
1651018273415,COGS 107A,A01,083627,Boyle; Mary E. T.,0,16,60,60
1651018279440,COGS 118A,A01,083075,Staff,0,10,60,60
1651018285465,CSE 3,A50,083646,Miranda; Gregory Joseph,15,0,38,23
1651018285465,CSE 3,A51,083647,Miranda; Gregory Joseph,36,0,37,1
1651018291501,CSE 8A,A50,083650,Miranda; Gregory Joseph,0,31,40,40
1651018297524,CSE 11,A01,083080,Cao; Yingjun,0,97,40,40
1651018303551,CSE 12,A01,083652,Staff,0,24,100,100
1651018309575,CSE 15L,A01,083654,Staff,0,3,50,50
1651018309575,CSE 15L,A02,083655,Staff,0,3,50,50
1651018315598,CSE 20,A01,083657,Staff,47,0,80,33
1651018321621,CSE 30,A01,083084,Eldon; John,1,39,80,79
1651018327644,CSE 100,A01,083659,Cao; Yingjun,0,72,50,50
1651018333668,CSE 134B,A01,083661,Powell; Thomas Allan,1,39,65,64
1651018339692,CSE 140,A01,083663,Staff,0,13,75,75
1651018345715,CSE 140L,A01,083088,Eldon; John,4,0,100,96
1651018351740,CSE 175,A01,083665,Kumar; Rakesh,0,0,25,25
1651018357770,CSE 190,A00,092507,Dubnov; Shlomo,9,0,20,11
1651018363797,ECE 45,A01,083139,Staff,0,7,60,60
1651018369832,ECE 65,A50,083695,Staff,0,7,30,30
1651018375855,ECE 109,A01,091882,Touri; Behrouz,32,0,70,38
1651018381883,ECE 180,A00,083140,Abi Samra; Nicholas Camill,17,0,30,13
1651018381883,ECE 180,B00,083141,Abi Samra; Nicholas Camill,0,0,30,30
1651018387985,MATH 10A,A01,083735,Patchell; Gregory David,1,0,30,29
1651018387985,MATH 10A,A02,083736,Patchell; Gregory David,27,0,30,3
1651018387985,MATH 10A,A03,083737,Patchell; Gregory David,23,0,30,7
1651018394021,MATH 10B,A01,083207,Staff,0,9,30,30
1651018394021,MATH 10B,A02,083208,Staff,0,6,30,30
1651018394021,MATH 10B,B01,083739,Staff,8,0,30,22
1651018394021,MATH 10B,B02,083740,Staff,28,0,30,2
1651018400046,MATH 18,A01,083743,Staff,0,0,30,30
1651018400046,MATH 18,A02,083744,Staff,23,0,30,7
1651018400046,MATH 18,A03,083745,Staff,19,0,30,11
1651018400046,MATH 18,A04,083746,Staff,26,0,30,4
1651018400046,MATH 18,B01,083748,Staff,0,16,30,30
1651018400046,MATH 18,B02,083749,Staff,0,14,30,30
1651018400046,MATH 18,B03,083750,Staff,0,14,30,30
1651018400046,MATH 18,B04,083751,Staff,0,13,30,30
1651018406069,MATH 20A,A01,083754,Staff,18,0,40,22
1651018412095,MATH 20B,A01,083756,Staff,0,14,30,30
1651018412095,MATH 20B,A02,083757,Staff,0,11,30,30
1651018418118,MATH 20C,A01,083760,Staff,0,17,30,30
1651018418118,MATH 20C,A02,083761,Staff,0,15,30,30
1651018418118,MATH 20C,B01,083762,Staff,9,0,30,21
1651018418118,MATH 20C,B02,083763,Staff,28,0,30,2
1651018424146,MATH 20D,A01,083765,Staff,3,1,30,27
1651018424146,MATH 20D,A02,083766,Staff,2,0,30,28
1651018424146,MATH 20D,A03,083767,Staff,22,0,30,8
1651018430186,MATH 20E,A01,083771,Staff,2,0,30,28
1651018430186,MATH 20E,A02,083772,Staff,12,0,30,18
1651018430186,MATH 20E,B01,083773,Staff,0,0,30,30
1651018430186,MATH 20E,B02,083774,Staff,1,0,30,29
1651018436213,MATH 103A,A01,083777,Staff,0,17,30,30
1651018436213,MATH 103A,A02,083778,Staff,0,15,30,30
1651018436213,MATH 103A,B01,083779,Staff,0,15,30,30
1651018436213,MATH 103A,B02,083780,Staff,0,14,30,30
1651018442237,MATH 105,A01,085443,Staff,0,23,30,30
1651018448290,MATH 109,A01,083213,Anzaldo; Leesa B,0,7,30,30
1651018448290,MATH 109,A02,083214,Anzaldo; Leesa B,0,7,30,30
1651018448290,MATH 109,B01,083215,Anzaldo; Leesa B,0,8,30,30
1651018448290,MATH 109,B02,083216,Anzaldo; Leesa B,0,7,30,30
1651018454314,MATH 142A,A01,083219,Chow; Bennett,0,14,30,30
1651018454314,MATH 142A,A02,083220,Chow; Bennett,0,15,30,30
1651018454314,MATH 142A,B01,083221,Chow; Bennett,0,16,30,30
1651018454314,MATH 142A,B02,083222,Chow; Bennett,0,14,30,30
1651018460337,MATH 193A,A01,083224,Staff,0,7,30,30
1651018460337,MATH 193A,A02,083225,Staff,0,7,30,30
1651018460337,MATH 193A,A03,083781,Staff,0,7,30,30
1651018460337,MATH 193A,A04,083782,Staff,0,7,30,30
1651018466362,MATH 197,001,091859,McAuley; Julian John,9998,0,9999,1
1651018472412,COGS 9,A01,083615,Staff,0,19,60,60
1651018478435,COGS 11,A01,083617,Boyle; Mary E. T.,13,0,40,27
1651018484459,COGS 13,A01,083071,Staff,0,40,40,40
1651018490481,COGS 14A,A01,092681,Staff,0,40,100,100
1651018496502,COGS 14B,A01,083073,Cheng; Tzu-Han,0,13,50,50
1651018502524,COGS 17,A01,092677,Staff,7,0,75,68
1651018508553,COGS 100,A01,083619,Staff,0,30,60,60
1651018514579,COGS 101A,A01,083621,Davis; Joshua Daniel,0,30,60,60
1651018520604,COGS 101B,A01,091572,Staff,0,7,60,60
1651018526627,COGS 101C,A01,083625,Delgado; Tania,14,0,30,16
1651018532653,COGS 107A,A01,083627,Boyle; Mary E. T.,0,16,60,60
1651018538677,COGS 118A,A01,083075,Staff,0,10,60,60
1651018544712,CSE 3,A50,083646,Miranda; Gregory Joseph,15,0,38,23
1651018544712,CSE 3,A51,083647,Miranda; Gregory Joseph,36,0,37,1
1651018550755,CSE 8A,A50,083650,Miranda; Gregory Joseph,0,31,40,40
1651018556781,CSE 11,A01,083080,Cao; Yingjun,0,97,40,40
1651018562806,CSE 12,A01,083652,Staff,0,24,100,100
1651018568841,CSE 15L,A01,083654,Staff,0,3,50,50
1651018568841,CSE 15L,A02,083655,Staff,0,3,50,50
1651018574869,CSE 20,A01,083657,Staff,47,0,80,33
1651018580892,CSE 30,A01,083084,Eldon; John,1,39,80,79
1651018586920,CSE 100,A01,083659,Cao; Yingjun,0,72,50,50
1651018592944,CSE 134B,A01,083661,Powell; Thomas Allan,1,39,65,64
1651018598968,CSE 140,A01,083663,Staff,0,13,75,75
1651018604991,CSE 140L,A01,083088,Eldon; John,4,0,100,96
1651018611014,CSE 175,A01,083665,Kumar; Rakesh,0,0,25,25
1651018617040,CSE 190,A00,092507,Dubnov; Shlomo,9,0,20,11
1651018623064,ECE 45,A01,083139,Staff,0,7,60,60
1651018629090,ECE 65,A50,083695,Staff,0,7,30,30
1651018635116,ECE 109,A01,091882,Touri; Behrouz,32,0,70,38
1651018641140,ECE 180,A00,083140,Abi Samra; Nicholas Camill,17,0,30,13
1651018641140,ECE 180,B00,083141,Abi Samra; Nicholas Camill,0,0,30,30
1651018647166,MATH 10A,A01,083735,Patchell; Gregory David,1,0,30,29
1651018647166,MATH 10A,A02,083736,Patchell; Gregory David,27,0,30,3
1651018647166,MATH 10A,A03,083737,Patchell; Gregory David,23,0,30,7
1651018653194,MATH 10B,A01,083207,Staff,0,9,30,30
1651018653194,MATH 10B,A02,083208,Staff,0,6,30,30
1651018653194,MATH 10B,B01,083739,Staff,8,0,30,22
1651018653194,MATH 10B,B02,083740,Staff,28,0,30,2
1651018659220,MATH 18,A01,083743,Staff,0,0,30,30
1651018659220,MATH 18,A02,083744,Staff,23,0,30,7
1651018659220,MATH 18,A03,083745,Staff,19,0,30,11
1651018659220,MATH 18,A04,083746,Staff,26,0,30,4
1651018659220,MATH 18,B01,083748,Staff,0,16,30,30
1651018659220,MATH 18,B02,083749,Staff,0,14,30,30
1651018659220,MATH 18,B03,083750,Staff,0,14,30,30
1651018659220,MATH 18,B04,083751,Staff,0,13,30,30
1651018665243,MATH 20A,A01,083754,Staff,18,0,40,22
1651018671266,MATH 20B,A01,083756,Staff,0,14,30,30
1651018671266,MATH 20B,A02,083757,Staff,0,11,30,30
1651018677302,MATH 20C,A01,083760,Staff,0,17,30,30
1651018677302,MATH 20C,A02,083761,Staff,0,15,30,30
1651018677302,MATH 20C,B01,083762,Staff,9,0,30,21
1651018677302,MATH 20C,B02,083763,Staff,28,0,30,2
1651018683334,MATH 20D,A01,083765,Staff,3,1,30,27
1651018683334,MATH 20D,A02,083766,Staff,2,0,30,28
1651018683334,MATH 20D,A03,083767,Staff,22,0,30,8
1651018689358,MATH 20E,A01,083771,Staff,2,0,30,28
1651018689358,MATH 20E,A02,083772,Staff,12,0,30,18
1651018689358,MATH 20E,B01,083773,Staff,0,0,30,30
1651018689358,MATH 20E,B02,083774,Staff,1,0,30,29
1651018695382,MATH 103A,A01,083777,Staff,0,17,30,30
1651018695382,MATH 103A,A02,083778,Staff,0,15,30,30
1651018695382,MATH 103A,B01,083779,Staff,0,15,30,30
1651018695382,MATH 103A,B02,083780,Staff,0,14,30,30
1651018701409,MATH 105,A01,085443,Staff,0,23,30,30
1651018707432,MATH 109,A01,083213,Anzaldo; Leesa B,0,7,30,30
1651018707432,MATH 109,A02,083214,Anzaldo; Leesa B,0,7,30,30
1651018707432,MATH 109,B01,083215,Anzaldo; Leesa B,0,8,30,30
1651018707432,MATH 109,B02,083216,Anzaldo; Leesa B,0,7,30,30
1651018713468,MATH 142A,A01,083219,Chow; Bennett,0,14,30,30
1651018713468,MATH 142A,A02,083220,Chow; Bennett,0,15,30,30
1651018713468,MATH 142A,B01,083221,Chow; Bennett,0,16,30,30
1651018713468,MATH 142A,B02,083222,Chow; Bennett,0,14,30,30
1651018719492,MATH 193A,A01,083224,Staff,0,7,30,30
1651018719492,MATH 193A,A02,083225,Staff,0,7,30,30
1651018719492,MATH 193A,A03,083781,Staff,0,7,30,30
1651018719492,MATH 193A,A04,083782,Staff,0,7,30,30
1651018725519,MATH 197,001,091859,McAuley; Julian John,9998,0,9999,1
1651018731573,COGS 9,A01,083615,Staff,0,19,60,60
1651018737595,COGS 11,A01,083617,Boyle; Mary E. T.,13,0,40,27
1651018743619,COGS 13,A01,083071,Staff,0,40,40,40
1651018749648,COGS 14A,A01,092681,Staff,0,40,100,100
1651018755671,COGS 14B,A01,083073,Cheng; Tzu-Han,0,13,50,50
1651018761694,COGS 17,A01,092677,Staff,7,0,75,68
1651018767716,COGS 100,A01,083619,Staff,0,30,60,60
1651018773744,COGS 101A,A01,083621,Davis; Joshua Daniel,0,30,60,60
1651018779767,COGS 101B,A01,091572,Staff,0,7,60,60
1651018785796,COGS 101C,A01,083625,Delgado; Tania,14,0,30,16
1651018791819,COGS 107A,A01,083627,Boyle; Mary E. T.,0,16,60,60
1651018797849,COGS 118A,A01,083075,Staff,0,10,60,60
1651018803872,CSE 3,A50,083646,Miranda; Gregory Joseph,15,0,38,23
1651018803872,CSE 3,A51,083647,Miranda; Gregory Joseph,36,0,37,1
1651018809901,CSE 8A,A50,083650,Miranda; Gregory Joseph,0,31,40,40
1651018815935,CSE 11,A01,083080,Cao; Yingjun,0,97,40,40
1651018821958,CSE 12,A01,083652,Staff,0,24,100,100
1651018827990,CSE 15L,A01,083654,Staff,0,3,50,50
1651018827990,CSE 15L,A02,083655,Staff,0,3,50,50
1651018834017,CSE 20,A01,083657,Staff,47,0,80,33
1651018840042,CSE 30,A01,083084,Eldon; John,1,39,80,79
1651018846069,CSE 100,A01,083659,Cao; Yingjun,0,72,50,50
1651018852095,CSE 134B,A01,083661,Powell; Thomas Allan,1,39,65,64
1651018858121,CSE 140,A01,083663,Staff,0,13,75,75
1651018864148,CSE 140L,A01,083088,Eldon; John,4,0,100,96
1651018870171,CSE 175,A01,083665,Kumar; Rakesh,0,0,25,25
1651018876194,CSE 190,A00,092507,Dubnov; Shlomo,9,0,20,11
1651018882221,ECE 45,A01,083139,Staff,0,7,60,60
1651018888248,ECE 65,A50,083695,Staff,0,7,30,30
1651018894273,ECE 109,A01,091882,Touri; Behrouz,32,0,70,38
1651018900304,ECE 180,A00,083140,Abi Samra; Nicholas Camill,17,0,30,13
1651018900304,ECE 180,B00,083141,Abi Samra; Nicholas Camill,0,0,30,30
1651018906329,MATH 10A,A01,083735,Patchell; Gregory David,1,0,30,29
1651018906329,MATH 10A,A02,083736,Patchell; Gregory David,27,0,30,3
1651018906329,MATH 10A,A03,083737,Patchell; Gregory David,23,0,30,7
1651018912356,MATH 10B,A01,083207,Staff,0,9,30,30
1651018912356,MATH 10B,A02,083208,Staff,0,6,30,30
1651018912356,MATH 10B,B01,083739,Staff,8,0,30,22
1651018912356,MATH 10B,B02,083740,Staff,28,0,30,2
1651018918392,MATH 18,A01,083743,Staff,0,0,30,30
1651018918392,MATH 18,A02,083744,Staff,23,0,30,7
1651018918392,MATH 18,A03,083745,Staff,19,0,30,11
1651018918392,MATH 18,A04,083746,Staff,26,0,30,4
1651018918392,MATH 18,B01,083748,Staff,0,16,30,30
1651018918392,MATH 18,B02,083749,Staff,0,14,30,30
1651018918392,MATH 18,B03,083750,Staff,0,14,30,30
1651018918392,MATH 18,B04,083751,Staff,0,13,30,30
1651018924419,MATH 20A,A01,083754,Staff,18,0,40,22
1651018930447,MATH 20B,A01,083756,Staff,0,14,30,30
1651018930447,MATH 20B,A02,083757,Staff,0,11,30,30
1651018936490,MATH 20C,A01,083760,Staff,0,17,30,30
1651018936490,MATH 20C,A02,083761,Staff,0,15,30,30
1651018936490,MATH 20C,B01,083762,Staff,9,0,30,21
1651018936490,MATH 20C,B02,083763,Staff,28,0,30,2
1651018942513,MATH 20D,A01,083765,Staff,3,1,30,27
1651018942513,MATH 20D,A02,083766,Staff,2,0,30,28
1651018942513,MATH 20D,A03,083767,Staff,22,0,30,8
1651018948536,MATH 20E,A01,083771,Staff,2,0,30,28
1651018948536,MATH 20E,A02,083772,Staff,12,0,30,18
1651018948536,MATH 20E,B01,083773,Staff,0,0,30,30
1651018948536,MATH 20E,B02,083774,Staff,1,0,30,29
1651018954563,MATH 103A,A01,083777,Staff,0,17,30,30
1651018954563,MATH 103A,A02,083778,Staff,0,15,30,30
1651018954563,MATH 103A,B01,083779,Staff,0,15,30,30
1651018954563,MATH 103A,B02,083780,Staff,0,14,30,30
1651018960587,MATH 105,A01,085443,Staff,0,23,30,30
1651018966615,MATH 109,A01,083213,Anzaldo; Leesa B,0,7,30,30
1651018966615,MATH 109,A02,083214,Anzaldo; Leesa B,0,7,30,30
1651018966615,MATH 109,B01,083215,Anzaldo; Leesa B,0,8,30,30
1651018966615,MATH 109,B02,083216,Anzaldo; Leesa B,0,7,30,30
1651018972647,MATH 142A,A01,083219,Chow; Bennett,0,14,30,30
1651018972647,MATH 142A,A02,083220,Chow; Bennett,0,15,30,30
1651018972647,MATH 142A,B01,083221,Chow; Bennett,0,16,30,30
1651018972647,MATH 142A,B02,083222,Chow; Bennett,0,14,30,30
1651018978675,MATH 193A,A01,083224,Staff,0,7,30,30
1651018978675,MATH 193A,A02,083225,Staff,0,7,30,30
1651018978675,MATH 193A,A03,083781,Staff,0,7,30,30
1651018978675,MATH 193A,A04,083782,Staff,0,7,30,30
1651018984770,MATH 197,001,091859,McAuley; Julian John,9998,0,9999,1
1651018990832,COGS 9,A01,083615,Staff,0,19,60,60
1651018996858,COGS 11,A01,083617,Boyle; Mary E. T.,13,0,40,27
1651019002881,COGS 13,A01,083071,Staff,0,40,40,40
1651019008905,COGS 14A,A01,092681,Staff,0,40,100,100
1651019014933,COGS 14B,A01,083073,Cheng; Tzu-Han,0,13,50,50
1651019020956,COGS 17,A01,092677,Staff,7,0,75,68
1651019026979,COGS 100,A01,083619,Staff,0,30,60,60
1651019033005,COGS 101A,A01,083621,Davis; Joshua Daniel,0,30,60,60
1651019039031,COGS 101B,A01,091572,Staff,0,7,60,60
1651019045066,COGS 101C,A01,083625,Delgado; Tania,14,0,30,16
1651019051089,COGS 107A,A01,083627,Boyle; Mary E. T.,0,16,60,60
1651019057112,COGS 118A,A01,083075,Staff,0,10,60,60
1651019063135,CSE 3,A50,083646,Miranda; Gregory Joseph,15,0,38,23
1651019063135,CSE 3,A51,083647,Miranda; Gregory Joseph,36,0,37,1
1651019069159,CSE 8A,A50,083650,Miranda; Gregory Joseph,0,31,40,40
1651019075185,CSE 11,A01,083080,Cao; Yingjun,0,97,40,40
1651019081208,CSE 12,A01,083652,Staff,0,24,100,100
1651019087231,CSE 15L,A01,083654,Staff,0,3,50,50
1651019087231,CSE 15L,A02,083655,Staff,0,3,50,50
1651019102110,CSE 20,A01,083657,Staff,47,0,80,33
1651019108135,CSE 30,A01,083084,Eldon; John,1,39,80,79
1651019114158,CSE 100,A01,083659,Cao; Yingjun,0,72,50,50
1651019120184,CSE 134B,A01,083661,Powell; Thomas Allan,1,39,65,64
1651019126211,CSE 140,A01,083663,Staff,0,13,75,75
1651019132234,CSE 140L,A01,083088,Eldon; John,4,0,100,96
1651019138260,CSE 175,A01,083665,Kumar; Rakesh,0,0,25,25
1651019144288,CSE 190,A00,092507,Dubnov; Shlomo,9,0,20,11
1651019150311,ECE 45,A01,083139,Staff,0,7,60,60
1651019156338,ECE 65,A50,083695,Staff,0,7,30,30
1651019162364,ECE 109,A01,091882,Touri; Behrouz,32,0,70,38
1651019168394,ECE 180,A00,083140,Abi Samra; Nicholas Camill,17,0,30,13
1651019168394,ECE 180,B00,083141,Abi Samra; Nicholas Camill,0,0,30,30
1651019174423,MATH 10A,A01,083735,Patchell; Gregory David,1,0,30,29
1651019174423,MATH 10A,A02,083736,Patchell; Gregory David,27,0,30,3
1651019174423,MATH 10A,A03,083737,Patchell; Gregory David,23,0,30,7
1651019180447,MATH 10B,A01,083207,Staff,0,9,30,30
1651019180447,MATH 10B,A02,083208,Staff,0,6,30,30
1651019180447,MATH 10B,B01,083739,Staff,8,0,30,22
1651019180447,MATH 10B,B02,083740,Staff,28,0,30,2
1651019186477,MATH 18,A01,083743,Staff,0,0,30,30
1651019186477,MATH 18,A02,083744,Staff,23,0,30,7
1651019186477,MATH 18,A03,083745,Staff,19,0,30,11
1651019186477,MATH 18,A04,083746,Staff,26,0,30,4
1651019186477,MATH 18,B01,083748,Staff,0,16,30,30
1651019186477,MATH 18,B02,083749,Staff,0,14,30,30
1651019186477,MATH 18,B03,083750,Staff,0,14,30,30
1651019186477,MATH 18,B04,083751,Staff,0,13,30,30
1651019192503,MATH 20A,A01,083754,Staff,18,0,40,22
1651019198535,MATH 20B,A01,083756,Staff,0,14,30,30
1651019198535,MATH 20B,A02,083757,Staff,0,11,30,30
1651019204560,MATH 20C,A01,083760,Staff,0,17,30,30
1651019204560,MATH 20C,A02,083761,Staff,0,15,30,30
1651019204560,MATH 20C,B01,083762,Staff,9,0,30,21
1651019204560,MATH 20C,B02,083763,Staff,28,0,30,2
1651019210583,MATH 20D,A01,083765,Staff,3,1,30,27
1651019210583,MATH 20D,A02,083766,Staff,2,0,30,28
1651019210583,MATH 20D,A03,083767,Staff,22,0,30,8
1651019216611,MATH 20E,A01,083771,Staff,2,0,30,28
1651019216611,MATH 20E,A02,083772,Staff,12,0,30,18
1651019216611,MATH 20E,B01,083773,Staff,0,0,30,30
1651019216611,MATH 20E,B02,083774,Staff,1,0,30,29
1651019222634,MATH 103A,A01,083777,Staff,0,17,30,30
1651019222634,MATH 103A,A02,083778,Staff,0,15,30,30
1651019222634,MATH 103A,B01,083779,Staff,0,15,30,30
1651019222634,MATH 103A,B02,083780,Staff,0,14,30,30
1651019228662,MATH 105,A01,085443,Staff,0,23,30,30
1651019234685,MATH 109,A01,083213,Anzaldo; Leesa B,0,7,30,30
1651019234685,MATH 109,A02,083214,Anzaldo; Leesa B,0,7,30,30
1651019234685,MATH 109,B01,083215,Anzaldo; Leesa B,0,8,30,30
1651019234685,MATH 109,B02,083216,Anzaldo; Leesa B,0,7,30,30
1651019240714,MATH 142A,A01,083219,Chow; Bennett,0,14,30,30
1651019240714,MATH 142A,A02,083220,Chow; Bennett,0,15,30,30
1651019240714,MATH 142A,B01,083221,Chow; Bennett,0,16,30,30
1651019240714,MATH 142A,B02,083222,Chow; Bennett,0,14,30,30
1651019246738,MATH 193A,A01,083224,Staff,0,7,30,30
1651019246738,MATH 193A,A02,083225,Staff,0,7,30,30
1651019246738,MATH 193A,A03,083781,Staff,0,7,30,30
1651019246738,MATH 193A,A04,083782,Staff,0,7,30,30
1651019252763,MATH 197,001,091859,McAuley; Julian John,9998,0,9999,1
1651019258820,COGS 9,A01,083615,Staff,0,19,60,60
1651019264841,COGS 11,A01,083617,Boyle; Mary E. T.,13,0,40,27
1651019270866,COGS 13,A01,083071,Staff,0,40,40,40
1651019276891,COGS 14A,A01,092681,Staff,0,40,100,100
1651019282918,COGS 14B,A01,083073,Cheng; Tzu-Han,0,13,50,50
1651019288944,COGS 17,A01,092677,Staff,7,0,75,68
1651019294968,COGS 100,A01,083619,Staff,0,30,60,60
1651019300990,COGS 101A,A01,083621,Davis; Joshua Daniel,0,30,60,60
1651019307018,COGS 101B,A01,091572,Staff,0,7,60,60
1651019313043,COGS 101C,A01,083625,Delgado; Tania,14,0,30,16
1651019319074,COGS 107A,A01,083627,Boyle; Mary E. T.,0,16,60,60
1651019325098,COGS 118A,A01,083075,Staff,0,10,60,60
1651019331126,CSE 3,A50,083646,Miranda; Gregory Joseph,15,0,38,23
1651019331126,CSE 3,A51,083647,Miranda; Gregory Joseph,36,0,37,1
1651019337153,CSE 8A,A50,083650,Miranda; Gregory Joseph,0,31,40,40
1651019343178,CSE 11,A01,083080,Cao; Yingjun,0,97,40,40
1651019349200,CSE 12,A01,083652,Staff,0,24,100,100
1651019355222,CSE 15L,A01,083654,Staff,0,3,50,50
1651019355222,CSE 15L,A02,083655,Staff,0,3,50,50
1651019361248,CSE 20,A01,083657,Staff,47,0,80,33
1651019367270,CSE 30,A01,083084,Eldon; John,1,39,80,79
1651019373302,CSE 100,A01,083659,Cao; Yingjun,0,72,50,50
1651019379328,CSE 134B,A01,083661,Powell; Thomas Allan,1,39,65,64
1651019385352,CSE 140,A01,083663,Staff,0,13,75,75
1651019391379,CSE 140L,A01,083088,Eldon; John,4,0,100,96
1651019397404,CSE 175,A01,083665,Kumar; Rakesh,0,0,25,25
1651019403430,CSE 190,A00,092507,Dubnov; Shlomo,9,0,20,11
1651019409456,ECE 45,A01,083139,Staff,0,7,60,60
1651019415482,ECE 65,A50,083695,Staff,0,7,30,30
1651019421506,ECE 109,A01,091882,Touri; Behrouz,32,0,70,38
1651019427528,ECE 180,A00,083140,Abi Samra; Nicholas Camill,17,0,30,13
1651019427528,ECE 180,B00,083141,Abi Samra; Nicholas Camill,0,0,30,30
1651019433556,MATH 10A,A01,083735,Patchell; Gregory David,1,0,30,29
1651019433556,MATH 10A,A02,083736,Patchell; Gregory David,27,0,30,3
1651019433556,MATH 10A,A03,083737,Patchell; Gregory David,23,0,30,7
1651019439586,MATH 10B,A01,083207,Staff,0,9,30,30
1651019439586,MATH 10B,A02,083208,Staff,0,6,30,30
1651019439586,MATH 10B,B01,083739,Staff,8,0,30,22
1651019439586,MATH 10B,B02,083740,Staff,28,0,30,2
1651019445625,MATH 18,A01,083743,Staff,0,0,30,30
1651019445625,MATH 18,A02,083744,Staff,23,0,30,7
1651019445625,MATH 18,A03,083745,Staff,19,0,30,11
1651019445625,MATH 18,A04,083746,Staff,26,0,30,4
1651019445625,MATH 18,B01,083748,Staff,0,16,30,30
1651019445625,MATH 18,B02,083749,Staff,0,14,30,30
1651019445625,MATH 18,B03,083750,Staff,0,14,30,30
1651019445625,MATH 18,B04,083751,Staff,0,13,30,30
1651019451650,MATH 20A,A01,083754,Staff,18,0,40,22
1651019457674,MATH 20B,A01,083756,Staff,0,14,30,30
1651019457674,MATH 20B,A02,083757,Staff,0,11,30,30
1651019463706,MATH 20C,A01,083760,Staff,0,17,30,30
1651019463706,MATH 20C,A02,083761,Staff,0,15,30,30
1651019463706,MATH 20C,B01,083762,Staff,9,0,30,21
1651019463706,MATH 20C,B02,083763,Staff,28,0,30,2
1651019469728,MATH 20D,A01,083765,Staff,3,1,30,27
1651019469728,MATH 20D,A02,083766,Staff,2,0,30,28
1651019469728,MATH 20D,A03,083767,Staff,22,0,30,8
1651019475751,MATH 20E,A01,083771,Staff,2,0,30,28
1651019475751,MATH 20E,A02,083772,Staff,12,0,30,18
1651019475751,MATH 20E,B01,083773,Staff,0,0,30,30
1651019475751,MATH 20E,B02,083774,Staff,1,0,30,29
1651019481779,MATH 103A,A01,083777,Staff,0,17,30,30
1651019481779,MATH 103A,A02,083778,Staff,0,15,30,30
1651019481779,MATH 103A,B01,083779,Staff,0,15,30,30
1651019481779,MATH 103A,B02,083780,Staff,0,14,30,30
1651019487804,MATH 105,A01,085443,Staff,0,23,30,30
1651019493843,MATH 109,A01,083213,Anzaldo; Leesa B,0,7,30,30
1651019493843,MATH 109,A02,083214,Anzaldo; Leesa B,0,7,30,30
1651019493843,MATH 109,B01,083215,Anzaldo; Leesa B,0,8,30,30
1651019493843,MATH 109,B02,083216,Anzaldo; Leesa B,0,7,30,30
1651019499883,MATH 142A,A01,083219,Chow; Bennett,0,14,30,30
1651019499883,MATH 142A,A02,083220,Chow; Bennett,0,15,30,30
1651019499883,MATH 142A,B01,083221,Chow; Bennett,0,16,30,30
1651019499883,MATH 142A,B02,083222,Chow; Bennett,0,14,30,30
1651019505905,MATH 193A,A01,083224,Staff,0,7,30,30
1651019505905,MATH 193A,A02,083225,Staff,0,7,30,30
1651019505905,MATH 193A,A03,083781,Staff,0,7,30,30
1651019505905,MATH 193A,A04,083782,Staff,0,7,30,30
1651019511930,MATH 197,001,091859,McAuley; Julian John,9998,0,9999,1
1651019517990,COGS 9,A01,083615,Staff,0,19,60,60
1651019524029,COGS 11,A01,083617,Boyle; Mary E. T.,13,0,40,27
1651019530063,COGS 13,A01,083071,Staff,0,40,40,40
1651019536091,COGS 14A,A01,092681,Staff,0,40,100,100
1651019542114,COGS 14B,A01,083073,Cheng; Tzu-Han,0,13,50,50
1651019548136,COGS 17,A01,092677,Staff,7,0,75,68
1651019554158,COGS 100,A01,083619,Staff,0,30,60,60
1651019560180,COGS 101A,A01,083621,Davis; Joshua Daniel,0,30,60,60
1651019566212,COGS 101B,A01,091572,Staff,0,7,60,60
1651019572241,COGS 101C,A01,083625,Delgado; Tania,14,0,30,16
1651019578284,COGS 107A,A01,083627,Boyle; Mary E. T.,0,16,60,60
1651019584397,COGS 118A,A01,083075,Staff,0,10,60,60
1651019590422,CSE 3,A50,083646,Miranda; Gregory Joseph,15,0,38,23
1651019590422,CSE 3,A51,083647,Miranda; Gregory Joseph,36,0,37,1
1651019596449,CSE 8A,A50,083650,Miranda; Gregory Joseph,0,31,40,40
1651019602477,CSE 11,A01,083080,Cao; Yingjun,0,97,40,40
1651019608504,CSE 12,A01,083652,Staff,0,24,100,100
1651019614526,CSE 15L,A01,083654,Staff,0,3,50,50
1651019614526,CSE 15L,A02,083655,Staff,0,3,50,50
1651019620548,CSE 20,A01,083657,Staff,47,0,80,33
1651019626591,CSE 30,A01,083084,Eldon; John,1,39,80,79
1651019632614,CSE 100,A01,083659,Cao; Yingjun,0,72,50,50
1651019638639,CSE 134B,A01,083661,Powell; Thomas Allan,1,39,65,64
1651019644663,CSE 140,A01,083663,Staff,0,13,75,75
1651019650689,CSE 140L,A01,083088,Eldon; John,4,0,100,96
1651019656714,CSE 175,A01,083665,Kumar; Rakesh,0,0,25,25
1651019662736,CSE 190,A00,092507,Dubnov; Shlomo,9,0,20,11
1651019668763,ECE 45,A01,083139,Staff,0,7,60,60
1651019674787,ECE 65,A50,083695,Staff,0,7,30,30
1651019680814,ECE 109,A01,091882,Touri; Behrouz,32,0,70,38
1651019686841,ECE 180,A00,083140,Abi Samra; Nicholas Camill,17,0,30,13
1651019686841,ECE 180,B00,083141,Abi Samra; Nicholas Camill,0,0,30,30
1651019692865,MATH 10A,A01,083735,Patchell; Gregory David,1,0,30,29
1651019692865,MATH 10A,A02,083736,Patchell; Gregory David,27,0,30,3
1651019692865,MATH 10A,A03,083737,Patchell; Gregory David,23,0,30,7
1651019698888,MATH 10B,A01,083207,Staff,0,9,30,30
1651019698888,MATH 10B,A02,083208,Staff,0,6,30,30
1651019698888,MATH 10B,B01,083739,Staff,8,0,30,22
1651019698888,MATH 10B,B02,083740,Staff,28,0,30,2
1651019704916,MATH 18,A01,083743,Staff,0,0,30,30
1651019704916,MATH 18,A02,083744,Staff,23,0,30,7
1651019704916,MATH 18,A03,083745,Staff,19,0,30,11
1651019704916,MATH 18,A04,083746,Staff,26,0,30,4
1651019704916,MATH 18,B01,083748,Staff,0,16,30,30
1651019704916,MATH 18,B02,083749,Staff,0,14,30,30
1651019704916,MATH 18,B03,083750,Staff,0,14,30,30
1651019704916,MATH 18,B04,083751,Staff,0,13,30,30
1651019710951,MATH 20A,A01,083754,Staff,18,0,40,22
1651019716975,MATH 20B,A01,083756,Staff,0,14,30,30
1651019716975,MATH 20B,A02,083757,Staff,0,11,30,30
1651019723002,MATH 20C,A01,083760,Staff,0,17,30,30
1651019723002,MATH 20C,A02,083761,Staff,0,15,30,30
1651019723002,MATH 20C,B01,083762,Staff,9,0,30,21
1651019723002,MATH 20C,B02,083763,Staff,28,0,30,2
1651019729028,MATH 20D,A01,083765,Staff,3,1,30,27
1651019729028,MATH 20D,A02,083766,Staff,2,0,30,28
1651019729028,MATH 20D,A03,083767,Staff,22,0,30,8
1651019735049,MATH 20E,A01,083771,Staff,2,0,30,28
1651019735049,MATH 20E,A02,083772,Staff,12,0,30,18
1651019735049,MATH 20E,B01,083773,Staff,0,0,30,30
1651019735049,MATH 20E,B02,083774,Staff,1,0,30,29
1651019741072,MATH 103A,A01,083777,Staff,0,17,30,30
1651019741072,MATH 103A,A02,083778,Staff,0,15,30,30
1651019741072,MATH 103A,B01,083779,Staff,0,15,30,30
1651019741072,MATH 103A,B02,083780,Staff,0,14,30,30
1651019747096,MATH 105,A01,085443,Staff,0,23,30,30
1651019753122,MATH 109,A01,083213,Anzaldo; Leesa B,0,7,30,30
1651019753122,MATH 109,A02,083214,Anzaldo; Leesa B,0,7,30,30
1651019753122,MATH 109,B01,083215,Anzaldo; Leesa B,0,8,30,30
1651019753122,MATH 109,B02,083216,Anzaldo; Leesa B,0,7,30,30
1651019759149,MATH 142A,A01,083219,Chow; Bennett,0,14,30,30
1651019759149,MATH 142A,A02,083220,Chow; Bennett,0,15,30,30
1651019759149,MATH 142A,B01,083221,Chow; Bennett,0,16,30,30
1651019759149,MATH 142A,B02,083222,Chow; Bennett,0,14,30,30
1651019765177,MATH 193A,A01,083224,Staff,0,7,30,30
1651019765177,MATH 193A,A02,083225,Staff,0,7,30,30
1651019765177,MATH 193A,A03,083781,Staff,0,7,30,30
1651019765177,MATH 193A,A04,083782,Staff,0,7,30,30
1651019771210,MATH 197,001,091859,McAuley; Julian John,9998,0,9999,1
1651019777264,COGS 9,A01,083615,Staff,0,19,60,60
1651019783297,COGS 11,A01,083617,Boyle; Mary E. T.,13,0,40,27
1651019789324,COGS 13,A01,083071,Staff,0,40,40,40
1651019795346,COGS 14A,A01,092681,Staff,0,40,100,100
1651019801368,COGS 14B,A01,083073,Cheng; Tzu-Han,0,13,50,50
1651019807391,COGS 17,A01,092677,Staff,7,0,75,68
1651019813413,COGS 100,A01,083619,Staff,0,30,60,60
1651019819438,COGS 101A,A01,083621,Davis; Joshua Daniel,0,29,60,60
1651019825459,COGS 101B,A01,091572,Staff,0,7,60,60
1651019831493,COGS 101C,A01,083625,Delgado; Tania,14,0,30,16
1651019837518,COGS 107A,A01,083627,Boyle; Mary E. T.,0,17,60,60
1651019843543,COGS 118A,A01,083075,Staff,0,10,60,60
1651019849572,CSE 3,A50,083646,Miranda; Gregory Joseph,15,0,38,23
1651019849572,CSE 3,A51,083647,Miranda; Gregory Joseph,36,0,37,1
1651019855598,CSE 8A,A50,083650,Miranda; Gregory Joseph,0,31,40,40
1651019861619,CSE 11,A01,083080,Cao; Yingjun,0,97,40,40
1651019867648,CSE 12,A01,083652,Staff,0,24,100,100
1651019873682,CSE 15L,A01,083654,Staff,0,3,50,50
1651019873682,CSE 15L,A02,083655,Staff,0,3,50,50
1651019879709,CSE 20,A01,083657,Staff,47,0,80,33
1651019885732,CSE 30,A01,083084,Eldon; John,1,39,80,79
1651019891759,CSE 100,A01,083659,Cao; Yingjun,0,72,50,50
1651019897782,CSE 134B,A01,083661,Powell; Thomas Allan,1,39,65,64
1651019903809,CSE 140,A01,083663,Staff,0,13,75,75
1651019909832,CSE 140L,A01,083088,Eldon; John,4,0,100,96
1651019915856,CSE 175,A01,083665,Kumar; Rakesh,0,0,25,25
1651019921882,CSE 190,A00,092507,Dubnov; Shlomo,9,0,20,11
1651019927909,ECE 45,A01,083139,Staff,0,7,60,60
1651019933933,ECE 65,A50,083695,Staff,0,7,30,30
1651019939959,ECE 109,A01,091882,Touri; Behrouz,32,0,70,38
1651019945983,ECE 180,A00,083140,Abi Samra; Nicholas Camill,17,0,30,13
1651019945983,ECE 180,B00,083141,Abi Samra; Nicholas Camill,0,0,30,30
1651019952010,MATH 10A,A01,083735,Patchell; Gregory David,1,0,30,29
1651019952010,MATH 10A,A02,083736,Patchell; Gregory David,27,0,30,3
1651019952010,MATH 10A,A03,083737,Patchell; Gregory David,23,0,30,7
1651019958043,MATH 10B,A01,083207,Staff,0,9,30,30
1651019958043,MATH 10B,A02,083208,Staff,0,6,30,30
1651019958043,MATH 10B,B01,083739,Staff,8,0,30,22
1651019958043,MATH 10B,B02,083740,Staff,28,0,30,2
1651019964068,MATH 18,A01,083743,Staff,0,0,30,30
1651019964068,MATH 18,A02,083744,Staff,23,0,30,7
1651019964068,MATH 18,A03,083745,Staff,19,0,30,11
1651019964068,MATH 18,A04,083746,Staff,26,0,30,4
1651019964068,MATH 18,B01,083748,Staff,0,16,30,30
1651019964068,MATH 18,B02,083749,Staff,0,14,30,30
1651019964068,MATH 18,B03,083750,Staff,0,14,30,30
1651019964068,MATH 18,B04,083751,Staff,0,13,30,30
1651019970099,MATH 20A,A01,083754,Staff,18,0,40,22
1651019976128,MATH 20B,A01,083756,Staff,0,14,30,30
1651019976128,MATH 20B,A02,083757,Staff,0,11,30,30
1651019982152,MATH 20C,A01,083760,Staff,0,17,30,30
1651019982152,MATH 20C,A02,083761,Staff,0,15,30,30
1651019982152,MATH 20C,B01,083762,Staff,9,0,30,21
1651019982152,MATH 20C,B02,083763,Staff,28,0,30,2
1651019988176,MATH 20D,A01,083765,Staff,3,1,30,27
1651019988176,MATH 20D,A02,083766,Staff,2,0,30,28
1651019988176,MATH 20D,A03,083767,Staff,22,0,30,8
1651019994200,MATH 20E,A01,083771,Staff,2,0,30,28
1651019994200,MATH 20E,A02,083772,Staff,12,0,30,18
1651019994200,MATH 20E,B01,083773,Staff,0,0,30,30
1651019994200,MATH 20E,B02,083774,Staff,1,0,30,29
1651020000228,MATH 103A,A01,083777,Staff,0,17,30,30
1651020000228,MATH 103A,A02,083778,Staff,0,15,30,30
1651020000228,MATH 103A,B01,083779,Staff,0,15,30,30
1651020000228,MATH 103A,B02,083780,Staff,0,14,30,30
1651020006252,MATH 105,A01,085443,Staff,0,23,30,30
1651020012274,MATH 109,A01,083213,Anzaldo; Leesa B,0,7,30,30
1651020012274,MATH 109,A02,083214,Anzaldo; Leesa B,0,7,30,30
1651020012274,MATH 109,B01,083215,Anzaldo; Leesa B,0,8,30,30
1651020012274,MATH 109,B02,083216,Anzaldo; Leesa B,0,7,30,30
1651020018299,MATH 142A,A01,083219,Chow; Bennett,0,14,30,30
1651020018299,MATH 142A,A02,083220,Chow; Bennett,0,15,30,30
1651020018299,MATH 142A,B01,083221,Chow; Bennett,0,16,30,30
1651020018299,MATH 142A,B02,083222,Chow; Bennett,0,14,30,30
1651020024320,MATH 193A,A01,083224,Staff,0,7,30,30
1651020024320,MATH 193A,A02,083225,Staff,0,7,30,30
1651020024320,MATH 193A,A03,083781,Staff,0,7,30,30
1651020024320,MATH 193A,A04,083782,Staff,0,7,30,30
1651020030342,MATH 197,001,091859,McAuley; Julian John,9998,0,9999,1
1651020036401,COGS 9,A01,083615,Staff,0,19,60,60
1651020042425,COGS 11,A01,083617,Boyle; Mary E. T.,13,0,40,27
1651020048448,COGS 13,A01,083071,Staff,0,40,40,40
1651020054479,COGS 14A,A01,092681,Staff,0,40,100,100
1651020060503,COGS 14B,A01,083073,Cheng; Tzu-Han,0,13,50,50
1651020066527,COGS 17,A01,092677,Staff,7,0,75,68
1651020072553,COGS 100,A01,083619,Staff,0,30,60,60
1651020078577,COGS 101A,A01,083621,Davis; Joshua Daniel,0,29,60,60
1651020084604,COGS 101B,A01,091572,Staff,0,7,60,60
1651020090639,COGS 101C,A01,083625,Delgado; Tania,14,0,30,16
1651020096672,COGS 107A,A01,083627,Boyle; Mary E. T.,0,17,60,60
1651020102698,COGS 118A,A01,083075,Staff,0,10,60,60
1651020108720,CSE 3,A50,083646,Miranda; Gregory Joseph,15,0,38,23
1651020108720,CSE 3,A51,083647,Miranda; Gregory Joseph,36,0,37,1
1651020114747,CSE 8A,A50,083650,Miranda; Gregory Joseph,0,31,40,40
1651020120772,CSE 11,A01,083080,Cao; Yingjun,0,97,40,40
1651020126799,CSE 12,A01,083652,Staff,0,24,100,100
1651020132830,CSE 15L,A01,083654,Staff,0,3,50,50
1651020132830,CSE 15L,A02,083655,Staff,0,3,50,50
1651020138856,CSE 20,A01,083657,Staff,47,0,80,33
1651020144884,CSE 30,A01,083084,Eldon; John,1,39,80,79
1651020150923,CSE 100,A01,083659,Cao; Yingjun,0,72,50,50
1651020156953,CSE 134B,A01,083661,Powell; Thomas Allan,1,39,65,64
1651020162984,CSE 140,A01,083663,Staff,0,13,75,75
1651020169008,CSE 140L,A01,083088,Eldon; John,4,0,100,96
1651020175039,CSE 175,A01,083665,Kumar; Rakesh,0,0,25,25
1651020181138,CSE 190,A00,092507,Dubnov; Shlomo,9,0,20,11
1651020187174,ECE 45,A01,083139,Staff,0,7,60,60
1651020193200,ECE 65,A50,083695,Staff,0,7,30,30
1651020199226,ECE 109,A01,091882,Touri; Behrouz,32,0,70,38
1651020205251,ECE 180,A00,083140,Abi Samra; Nicholas Camill,17,0,30,13
1651020205251,ECE 180,B00,083141,Abi Samra; Nicholas Camill,0,0,30,30
1651020211274,MATH 10A,A01,083735,Patchell; Gregory David,1,0,30,29
1651020211274,MATH 10A,A02,083736,Patchell; Gregory David,27,0,30,3
1651020211274,MATH 10A,A03,083737,Patchell; Gregory David,23,0,30,7
1651020217297,MATH 10B,A01,083207,Staff,0,9,30,30
1651020217297,MATH 10B,A02,083208,Staff,0,6,30,30
1651020217297,MATH 10B,B01,083739,Staff,8,0,30,22
1651020217297,MATH 10B,B02,083740,Staff,28,0,30,2
1651020223329,MATH 18,A01,083743,Staff,0,0,30,30
1651020223329,MATH 18,A02,083744,Staff,23,0,30,7
1651020223329,MATH 18,A03,083745,Staff,19,0,30,11
1651020223329,MATH 18,A04,083746,Staff,26,0,30,4
1651020223329,MATH 18,B01,083748,Staff,0,16,30,30
1651020223329,MATH 18,B02,083749,Staff,0,14,30,30
1651020223329,MATH 18,B03,083750,Staff,0,14,30,30
1651020223329,MATH 18,B04,083751,Staff,0,13,30,30
1651020229352,MATH 20A,A01,083754,Staff,18,0,40,22
1651020235375,MATH 20B,A01,083756,Staff,0,14,30,30
1651020235375,MATH 20B,A02,083757,Staff,0,11,30,30
1651020241401,MATH 20C,A01,083760,Staff,0,17,30,30
1651020241401,MATH 20C,A02,083761,Staff,0,15,30,30
1651020241401,MATH 20C,B01,083762,Staff,9,0,30,21
1651020241401,MATH 20C,B02,083763,Staff,28,0,30,2
1651020247426,MATH 20D,A01,083765,Staff,3,1,30,27
1651020247426,MATH 20D,A02,083766,Staff,2,0,30,28
1651020247426,MATH 20D,A03,083767,Staff,22,0,30,8
1651020253447,MATH 20E,A01,083771,Staff,2,0,30,28
1651020253447,MATH 20E,A02,083772,Staff,12,0,30,18
1651020253447,MATH 20E,B01,083773,Staff,0,0,30,30
1651020253447,MATH 20E,B02,083774,Staff,1,0,30,29
1651020259474,MATH 103A,A01,083777,Staff,0,17,30,30
1651020259474,MATH 103A,A02,083778,Staff,0,15,30,30
1651020259474,MATH 103A,B01,083779,Staff,0,15,30,30
1651020259474,MATH 103A,B02,083780,Staff,0,14,30,30
1651020265498,MATH 105,A01,085443,Staff,0,23,30,30
1651020271521,MATH 109,A01,083213,Anzaldo; Leesa B,0,7,30,30
1651020271521,MATH 109,A02,083214,Anzaldo; Leesa B,0,7,30,30
1651020271521,MATH 109,B01,083215,Anzaldo; Leesa B,0,8,30,30
1651020271521,MATH 109,B02,083216,Anzaldo; Leesa B,0,7,30,30
1651020277549,MATH 142A,A01,083219,Chow; Bennett,0,14,30,30
1651020277549,MATH 142A,A02,083220,Chow; Bennett,0,15,30,30
1651020277549,MATH 142A,B01,083221,Chow; Bennett,0,16,30,30
1651020277549,MATH 142A,B02,083222,Chow; Bennett,0,14,30,30
1651020283573,MATH 193A,A01,083224,Staff,0,7,30,30
1651020283573,MATH 193A,A02,083225,Staff,0,7,30,30
1651020283573,MATH 193A,A03,083781,Staff,0,7,30,30
1651020283573,MATH 193A,A04,083782,Staff,0,7,30,30
1651020289598,MATH 197,001,091859,McAuley; Julian John,9998,0,9999,1
1651020295667,COGS 9,A01,083615,Staff,0,19,60,60
1651020301696,COGS 11,A01,083617,Boyle; Mary E. T.,13,0,40,27
1651020307723,COGS 13,A01,083071,Staff,0,40,40,40
1651020313760,COGS 14A,A01,092681,Staff,0,40,100,100
1651020319783,COGS 14B,A01,083073,Cheng; Tzu-Han,0,13,50,50
1651020325809,COGS 17,A01,092677,Staff,7,0,75,68
1651020331836,COGS 100,A01,083619,Staff,0,30,60,60
1651020337863,COGS 101A,A01,083621,Davis; Joshua Daniel,0,29,60,60
1651020343889,COGS 101B,A01,091572,Staff,0,7,60,60
1651020349912,COGS 101C,A01,083625,Delgado; Tania,14,0,30,16
1651020355954,COGS 107A,A01,083627,Boyle; Mary E. T.,0,17,60,60
1651020361986,COGS 118A,A01,083075,Staff,0,10,60,60
1651020368019,CSE 3,A50,083646,Miranda; Gregory Joseph,15,0,38,23
1651020368019,CSE 3,A51,083647,Miranda; Gregory Joseph,36,0,37,1
1651020374044,CSE 8A,A50,083650,Miranda; Gregory Joseph,0,31,40,40
1651020380069,CSE 11,A01,083080,Cao; Yingjun,0,97,40,40
1651020386096,CSE 12,A01,083652,Staff,0,24,100,100
1651020392120,CSE 15L,A01,083654,Staff,0,3,50,50
1651020392120,CSE 15L,A02,083655,Staff,0,3,50,50
1651020398151,CSE 20,A01,083657,Staff,47,0,80,33
1651020404175,CSE 30,A01,083084,Eldon; John,1,39,80,79
1651020410199,CSE 100,A01,083659,Cao; Yingjun,0,72,50,50
1651020416231,CSE 134B,A01,083661,Powell; Thomas Allan,1,39,65,64
1651020422264,CSE 140,A01,083663,Staff,0,13,75,75
1651020428299,CSE 140L,A01,083088,Eldon; John,4,0,100,96
1651020434326,CSE 175,A01,083665,Kumar; Rakesh,0,0,25,25
1651020440348,CSE 190,A00,092507,Dubnov; Shlomo,9,0,20,11
1651020446375,ECE 45,A01,083139,Staff,0,7,60,60
1651020452397,ECE 65,A50,083695,Staff,0,7,30,30
1651020458419,ECE 109,A01,091882,Touri; Behrouz,32,0,70,38
1651020464441,ECE 180,A00,083140,Abi Samra; Nicholas Camill,17,0,30,13
1651020464441,ECE 180,B00,083141,Abi Samra; Nicholas Camill,0,0,30,30
1651020470465,MATH 10A,A01,083735,Patchell; Gregory David,1,0,30,29
1651020470465,MATH 10A,A02,083736,Patchell; Gregory David,27,0,30,3
1651020470465,MATH 10A,A03,083737,Patchell; Gregory David,23,0,30,7
1651020476494,MATH 10B,A01,083207,Staff,0,9,30,30
1651020476494,MATH 10B,A02,083208,Staff,0,6,30,30
1651020476494,MATH 10B,B01,083739,Staff,8,0,30,22
1651020476494,MATH 10B,B02,083740,Staff,28,0,30,2
1651020482520,MATH 18,A01,083743,Staff,0,0,30,30
1651020482520,MATH 18,A02,083744,Staff,23,0,30,7
1651020482520,MATH 18,A03,083745,Staff,19,0,30,11
1651020482520,MATH 18,A04,083746,Staff,26,0,30,4
1651020482520,MATH 18,B01,083748,Staff,0,16,30,30
1651020482520,MATH 18,B02,083749,Staff,0,14,30,30
1651020482520,MATH 18,B03,083750,Staff,0,14,30,30
1651020482520,MATH 18,B04,083751,Staff,0,13,30,30
1651020488545,MATH 20A,A01,083754,Staff,18,0,40,22
1651020494568,MATH 20B,A01,083756,Staff,0,14,30,30
1651020494568,MATH 20B,A02,083757,Staff,0,11,30,30
1651020500591,MATH 20C,A01,083760,Staff,0,17,30,30
1651020500591,MATH 20C,A02,083761,Staff,0,15,30,30
1651020500591,MATH 20C,B01,083762,Staff,9,0,30,21
1651020500591,MATH 20C,B02,083763,Staff,28,0,30,2
1651020506613,MATH 20D,A01,083765,Staff,3,1,30,27
1651020506613,MATH 20D,A02,083766,Staff,2,0,30,28
1651020506613,MATH 20D,A03,083767,Staff,22,0,30,8
1651020512637,MATH 20E,A01,083771,Staff,2,0,30,28
1651020512637,MATH 20E,A02,083772,Staff,12,0,30,18
1651020512637,MATH 20E,B01,083773,Staff,0,0,30,30
1651020512637,MATH 20E,B02,083774,Staff,1,0,30,29
1651020518662,MATH 103A,A01,083777,Staff,0,17,30,30
1651020518662,MATH 103A,A02,083778,Staff,0,15,30,30
1651020518662,MATH 103A,B01,083779,Staff,0,15,30,30
1651020518662,MATH 103A,B02,083780,Staff,0,14,30,30
1651020524687,MATH 105,A01,085443,Staff,0,23,30,30
1651020530711,MATH 109,A01,083213,Anzaldo; Leesa B,0,7,30,30
1651020530711,MATH 109,A02,083214,Anzaldo; Leesa B,0,7,30,30
1651020530711,MATH 109,B01,083215,Anzaldo; Leesa B,0,8,30,30
1651020530711,MATH 109,B02,083216,Anzaldo; Leesa B,0,7,30,30
1651020536736,MATH 142A,A01,083219,Chow; Bennett,0,14,30,30
1651020536736,MATH 142A,A02,083220,Chow; Bennett,0,15,30,30
1651020536736,MATH 142A,B01,083221,Chow; Bennett,0,16,30,30
1651020536736,MATH 142A,B02,083222,Chow; Bennett,0,14,30,30
1651020542768,MATH 193A,A01,083224,Staff,0,7,30,30
1651020542768,MATH 193A,A02,083225,Staff,0,7,30,30
1651020542768,MATH 193A,A03,083781,Staff,0,7,30,30
1651020542768,MATH 193A,A04,083782,Staff,0,7,30,30
1651020548790,MATH 197,001,091859,McAuley; Julian John,9998,0,9999,1
1651020554845,COGS 9,A01,083615,Staff,0,19,60,60
1651020560867,COGS 11,A01,083617,Boyle; Mary E. T.,13,0,40,27
1651020566897,COGS 13,A01,083071,Staff,0,40,40,40
1651020572928,COGS 14A,A01,092681,Staff,0,40,100,100
1651020578951,COGS 14B,A01,083073,Cheng; Tzu-Han,0,13,50,50
1651020584976,COGS 17,A01,092677,Staff,7,0,75,68
1651020591000,COGS 100,A01,083619,Staff,0,30,60,60
1651020597037,COGS 101A,A01,083621,Davis; Joshua Daniel,0,29,60,60
1651020603062,COGS 101B,A01,091572,Staff,0,7,60,60
1651020609084,COGS 101C,A01,083625,Delgado; Tania,14,0,30,16
1651020615108,COGS 107A,A01,083627,Boyle; Mary E. T.,0,17,60,60
1651020621138,COGS 118A,A01,083075,Staff,0,10,60,60
1651020627162,CSE 3,A50,083646,Miranda; Gregory Joseph,15,0,38,23
1651020627162,CSE 3,A51,083647,Miranda; Gregory Joseph,36,0,37,1
1651020633194,CSE 8A,A50,083650,Miranda; Gregory Joseph,0,31,40,40
1651020639220,CSE 11,A01,083080,Cao; Yingjun,0,97,40,40
1651020645244,CSE 12,A01,083652,Staff,0,24,100,100
1651020651271,CSE 15L,A01,083654,Staff,0,3,50,50
1651020651271,CSE 15L,A02,083655,Staff,0,3,50,50
1651020657294,CSE 20,A01,083657,Staff,47,0,80,33
1651020663316,CSE 30,A01,083084,Eldon; John,1,39,80,79
1651020669346,CSE 100,A01,083659,Cao; Yingjun,0,72,50,50
1651020675371,CSE 134B,A01,083661,Powell; Thomas Allan,1,39,65,64
1651020681393,CSE 140,A01,083663,Staff,0,13,75,75
1651020687417,CSE 140L,A01,083088,Eldon; John,4,0,100,96
1651020693440,CSE 175,A01,083665,Kumar; Rakesh,0,0,25,25
1651020699463,CSE 190,A00,092507,Dubnov; Shlomo,9,0,20,11
1651020705486,ECE 45,A01,083139,Staff,0,7,60,60
1651020711512,ECE 65,A50,083695,Staff,0,7,30,30
1651020717538,ECE 109,A01,091882,Touri; Behrouz,32,0,70,38
1651020723561,ECE 180,A00,083140,Abi Samra; Nicholas Camill,17,0,30,13
1651020723561,ECE 180,B00,083141,Abi Samra; Nicholas Camill,0,0,30,30
1651020729582,MATH 10A,A01,083735,Patchell; Gregory David,1,0,30,29
1651020729582,MATH 10A,A02,083736,Patchell; Gregory David,27,0,30,3
1651020729582,MATH 10A,A03,083737,Patchell; Gregory David,23,0,30,7
1651020735606,MATH 10B,A01,083207,Staff,0,9,30,30
1651020735606,MATH 10B,A02,083208,Staff,0,6,30,30
1651020735606,MATH 10B,B01,083739,Staff,8,0,30,22
1651020735606,MATH 10B,B02,083740,Staff,28,0,30,2
1651020741632,MATH 18,A01,083743,Staff,0,0,30,30
1651020741632,MATH 18,A02,083744,Staff,23,0,30,7
1651020741632,MATH 18,A03,083745,Staff,19,0,30,11
1651020741632,MATH 18,A04,083746,Staff,26,0,30,4
1651020741632,MATH 18,B01,083748,Staff,0,16,30,30
1651020741632,MATH 18,B02,083749,Staff,0,14,30,30
1651020741632,MATH 18,B03,083750,Staff,0,14,30,30
1651020741632,MATH 18,B04,083751,Staff,0,13,30,30
1651020747665,MATH 20A,A01,083754,Staff,18,0,40,22
1651020753695,MATH 20B,A01,083756,Staff,0,14,30,30
1651020753695,MATH 20B,A02,083757,Staff,0,11,30,30
1651020759722,MATH 20C,A01,083760,Staff,0,17,30,30
1651020759722,MATH 20C,A02,083761,Staff,0,15,30,30
1651020759722,MATH 20C,B01,083762,Staff,9,0,30,21
1651020759722,MATH 20C,B02,083763,Staff,28,0,30,2
1651020765759,MATH 20D,A01,083765,Staff,3,1,30,27
1651020765759,MATH 20D,A02,083766,Staff,2,0,30,28
1651020765759,MATH 20D,A03,083767,Staff,22,0,30,8
1651020771788,MATH 20E,A01,083771,Staff,2,0,30,28
1651020771788,MATH 20E,A02,083772,Staff,12,0,30,18
1651020771788,MATH 20E,B01,083773,Staff,0,0,30,30
1651020771788,MATH 20E,B02,083774,Staff,1,0,30,29
1651020777909,MATH 103A,A01,083777,Staff,0,17,30,30
1651020777909,MATH 103A,A02,083778,Staff,0,15,30,30
1651020777909,MATH 103A,B01,083779,Staff,0,15,30,30
1651020777909,MATH 103A,B02,083780,Staff,0,14,30,30
1651020783935,MATH 105,A01,085443,Staff,0,23,30,30
1651020789963,MATH 109,A01,083213,Anzaldo; Leesa B,0,8,30,30
1651020789963,MATH 109,A02,083214,Anzaldo; Leesa B,0,7,30,30
1651020789963,MATH 109,B01,083215,Anzaldo; Leesa B,0,8,30,30
1651020789963,MATH 109,B02,083216,Anzaldo; Leesa B,0,7,30,30
1651020795995,MATH 142A,A01,083219,Chow; Bennett,0,14,30,30
1651020795995,MATH 142A,A02,083220,Chow; Bennett,0,15,30,30
1651020795995,MATH 142A,B01,083221,Chow; Bennett,0,16,30,30
1651020795995,MATH 142A,B02,083222,Chow; Bennett,0,14,30,30
1651020802017,MATH 193A,A01,083224,Staff,0,7,30,30
1651020802017,MATH 193A,A02,083225,Staff,0,7,30,30
1651020802017,MATH 193A,A03,083781,Staff,0,7,30,30
1651020802017,MATH 193A,A04,083782,Staff,0,7,30,30
1651020808042,MATH 197,001,091859,McAuley; Julian John,9998,0,9999,1
1651020814099,COGS 9,A01,083615,Staff,0,19,60,60
1651020820121,COGS 11,A01,083617,Boyle; Mary E. T.,13,0,40,27
1651020826159,COGS 13,A01,083071,Staff,0,40,40,40
1651020832183,COGS 14A,A01,092681,Staff,0,40,100,100
1651020838208,COGS 14B,A01,083073,Cheng; Tzu-Han,0,13,50,50
1651020844244,COGS 17,A01,092677,Staff,7,0,75,68
1651020850267,COGS 100,A01,083619,Staff,0,30,60,60
1651020856294,COGS 101A,A01,083621,Davis; Joshua Daniel,0,29,60,60
1651020862323,COGS 101B,A01,091572,Staff,0,7,60,60
1651020868348,COGS 101C,A01,083625,Delgado; Tania,14,0,30,16
1651020874373,COGS 107A,A01,083627,Boyle; Mary E. T.,0,17,60,60
1651020880398,COGS 118A,A01,083075,Staff,0,10,60,60
1651020886421,CSE 3,A50,083646,Miranda; Gregory Joseph,15,0,38,23
1651020886421,CSE 3,A51,083647,Miranda; Gregory Joseph,36,0,37,1
1651020892445,CSE 8A,A50,083650,Miranda; Gregory Joseph,0,31,40,40
1651020898473,CSE 11,A01,083080,Cao; Yingjun,0,97,40,40
1651020904504,CSE 12,A01,083652,Staff,0,24,100,100
1651020910528,CSE 15L,A01,083654,Staff,0,3,50,50
1651020910528,CSE 15L,A02,083655,Staff,0,3,50,50
1651020916552,CSE 20,A01,083657,Staff,47,0,80,33
1651020922575,CSE 30,A01,083084,Eldon; John,1,40,80,79
1651020928600,CSE 100,A01,083659,Cao; Yingjun,0,72,50,50
1651020934671,CSE 134B,A01,083661,Powell; Thomas Allan,1,39,65,64
1651020940695,CSE 140,A01,083663,Staff,0,13,75,75
1651020946719,CSE 140L,A01,083088,Eldon; John,4,0,100,96
1651020952751,CSE 175,A01,083665,Kumar; Rakesh,0,0,25,25
1651020958776,CSE 190,A00,092507,Dubnov; Shlomo,9,0,20,11
1651020964804,ECE 45,A01,083139,Staff,0,7,60,60
1651020970827,ECE 65,A50,083695,Staff,0,7,30,30
1651020976850,ECE 109,A01,091882,Touri; Behrouz,32,0,70,38
1651020982873,ECE 180,A00,083140,Abi Samra; Nicholas Camill,17,0,30,13
1651020982873,ECE 180,B00,083141,Abi Samra; Nicholas Camill,0,0,30,30
1651020988903,MATH 10A,A01,083735,Patchell; Gregory David,1,0,30,29
1651020988903,MATH 10A,A02,083736,Patchell; Gregory David,27,0,30,3
1651020988903,MATH 10A,A03,083737,Patchell; Gregory David,23,0,30,7
1651020994926,MATH 10B,A01,083207,Staff,0,9,30,30
1651020994926,MATH 10B,A02,083208,Staff,0,6,30,30
1651020994926,MATH 10B,B01,083739,Staff,8,0,30,22
1651020994926,MATH 10B,B02,083740,Staff,28,0,30,2
1651021000958,MATH 18,A01,083743,Staff,0,0,30,30
1651021000958,MATH 18,A02,083744,Staff,23,0,30,7
1651021000958,MATH 18,A03,083745,Staff,19,0,30,11
1651021000958,MATH 18,A04,083746,Staff,26,0,30,4
1651021000958,MATH 18,B01,083748,Staff,0,16,30,30
1651021000958,MATH 18,B02,083749,Staff,0,14,30,30
1651021000958,MATH 18,B03,083750,Staff,0,14,30,30
1651021000958,MATH 18,B04,083751,Staff,0,13,30,30
1651021006979,MATH 20A,A01,083754,Staff,18,0,40,22
1651021013006,MATH 20B,A01,083756,Staff,0,14,30,30
1651021013006,MATH 20B,A02,083757,Staff,0,11,30,30
1651021019028,MATH 20C,A01,083760,Staff,0,17,30,30
1651021019028,MATH 20C,A02,083761,Staff,0,15,30,30
1651021019028,MATH 20C,B01,083762,Staff,9,0,30,21
1651021019028,MATH 20C,B02,083763,Staff,28,0,30,2
1651021025053,MATH 20D,A01,083765,Staff,3,1,30,27
1651021025053,MATH 20D,A02,083766,Staff,2,0,30,28
1651021025053,MATH 20D,A03,083767,Staff,22,0,30,8
1651021031079,MATH 20E,A01,083771,Staff,2,0,30,28
1651021031079,MATH 20E,A02,083772,Staff,12,0,30,18
1651021031079,MATH 20E,B01,083773,Staff,0,0,30,30
1651021031079,MATH 20E,B02,083774,Staff,1,0,30,29
1651021037103,MATH 103A,A01,083777,Staff,0,17,30,30
1651021037103,MATH 103A,A02,083778,Staff,0,15,30,30
1651021037103,MATH 103A,B01,083779,Staff,0,15,30,30
1651021037103,MATH 103A,B02,083780,Staff,0,14,30,30
1651021043128,MATH 105,A01,085443,Staff,0,23,30,30
1651021049157,MATH 109,A01,083213,Anzaldo; Leesa B,0,8,30,30
1651021049157,MATH 109,A02,083214,Anzaldo; Leesa B,0,7,30,30
1651021049157,MATH 109,B01,083215,Anzaldo; Leesa B,0,8,30,30
1651021049157,MATH 109,B02,083216,Anzaldo; Leesa B,0,7,30,30
1651021055181,MATH 142A,A01,083219,Chow; Bennett,0,14,30,30
1651021055181,MATH 142A,A02,083220,Chow; Bennett,0,15,30,30
1651021055181,MATH 142A,B01,083221,Chow; Bennett,0,16,30,30
1651021055181,MATH 142A,B02,083222,Chow; Bennett,0,14,30,30
1651021061205,MATH 193A,A01,083224,Staff,0,7,30,30
1651021061205,MATH 193A,A02,083225,Staff,0,7,30,30
1651021061205,MATH 193A,A03,083781,Staff,0,7,30,30
1651021061205,MATH 193A,A04,083782,Staff,0,7,30,30
1651021067229,MATH 197,001,091859,McAuley; Julian John,9998,0,9999,1
1651021073293,COGS 9,A01,083615,Staff,0,19,60,60
1651021079316,COGS 11,A01,083617,Boyle; Mary E. T.,13,0,40,27
1651021085337,COGS 13,A01,083071,Staff,0,40,40,40
1651021091364,COGS 14A,A01,092681,Staff,0,40,100,100
1651021097398,COGS 14B,A01,083073,Cheng; Tzu-Han,0,13,50,50
1651021103425,COGS 17,A01,092677,Staff,7,0,75,68
1651021109451,COGS 100,A01,083619,Staff,0,30,60,60
1651021115478,COGS 101A,A01,083621,Davis; Joshua Daniel,0,29,60,60
1651021121503,COGS 101B,A01,091572,Staff,0,7,60,60
1651021127529,COGS 101C,A01,083625,Delgado; Tania,14,0,30,16
1651021133555,COGS 107A,A01,083627,Boyle; Mary E. T.,0,17,60,60
1651021139584,COGS 118A,A01,083075,Staff,0,10,60,60
1651021145611,CSE 3,A50,083646,Miranda; Gregory Joseph,15,0,38,23
1651021145611,CSE 3,A51,083647,Miranda; Gregory Joseph,36,0,37,1
1651021151643,CSE 8A,A50,083650,Miranda; Gregory Joseph,0,31,40,40
1651021157664,CSE 11,A01,083080,Cao; Yingjun,0,97,40,40
1651021163696,CSE 12,A01,083652,Staff,0,24,100,100
1651021169722,CSE 15L,A01,083654,Staff,0,3,50,50
1651021169722,CSE 15L,A02,083655,Staff,0,3,50,50
1651021175748,CSE 20,A01,083657,Staff,47,0,80,33
1651021181770,CSE 30,A01,083084,Eldon; John,1,40,80,79
1651021187799,CSE 100,A01,083659,Cao; Yingjun,0,72,50,50
1651021193822,CSE 134B,A01,083661,Powell; Thomas Allan,1,39,65,64
1651021199846,CSE 140,A01,083663,Staff,0,14,75,75
1651021205869,CSE 140L,A01,083088,Eldon; John,4,0,100,96
1651021211891,CSE 175,A01,083665,Kumar; Rakesh,0,0,25,25
1651021217916,CSE 190,A00,092507,Dubnov; Shlomo,9,0,20,11
1651021223942,ECE 45,A01,083139,Staff,0,7,60,60
1651021229968,ECE 65,A50,083695,Staff,0,7,30,30
1651021235994,ECE 109,A01,091882,Touri; Behrouz,32,0,70,38
1651021242021,ECE 180,A00,083140,Abi Samra; Nicholas Camill,17,0,30,13
1651021242021,ECE 180,B00,083141,Abi Samra; Nicholas Camill,0,0,30,30
1651021248046,MATH 10A,A01,083735,Patchell; Gregory David,1,0,30,29
1651021248046,MATH 10A,A02,083736,Patchell; Gregory David,27,0,30,3
1651021248046,MATH 10A,A03,083737,Patchell; Gregory David,23,0,30,7
1651021254074,MATH 10B,A01,083207,Staff,0,9,30,30
1651021254074,MATH 10B,A02,083208,Staff,0,6,30,30
1651021254074,MATH 10B,B01,083739,Staff,8,0,30,22
1651021254074,MATH 10B,B02,083740,Staff,28,0,30,2
1651021260096,MATH 18,A01,083743,Staff,0,0,30,30
1651021260096,MATH 18,A02,083744,Staff,23,0,30,7
1651021260096,MATH 18,A03,083745,Staff,19,0,30,11
1651021260096,MATH 18,A04,083746,Staff,26,0,30,4
1651021260096,MATH 18,B01,083748,Staff,0,16,30,30
1651021260096,MATH 18,B02,083749,Staff,0,14,30,30
1651021260096,MATH 18,B03,083750,Staff,0,14,30,30
1651021260096,MATH 18,B04,083751,Staff,0,13,30,30
1651021266120,MATH 20A,A01,083754,Staff,18,0,40,22
1651021272144,MATH 20B,A01,083756,Staff,0,14,30,30
1651021272144,MATH 20B,A02,083757,Staff,0,11,30,30
1651021278171,MATH 20C,A01,083760,Staff,0,17,30,30
1651021278171,MATH 20C,A02,083761,Staff,0,15,30,30
1651021278171,MATH 20C,B01,083762,Staff,9,0,30,21
1651021278171,MATH 20C,B02,083763,Staff,28,0,30,2
1651021284194,MATH 20D,A01,083765,Staff,3,1,30,27
1651021284194,MATH 20D,A02,083766,Staff,2,0,30,28
1651021284194,MATH 20D,A03,083767,Staff,22,0,30,8
1651021290228,MATH 20E,A01,083771,Staff,2,0,30,28
1651021290228,MATH 20E,A02,083772,Staff,12,0,30,18
1651021290228,MATH 20E,B01,083773,Staff,0,0,30,30
1651021290228,MATH 20E,B02,083774,Staff,1,0,30,29
1651021296255,MATH 103A,A01,083777,Staff,0,17,30,30
1651021296255,MATH 103A,A02,083778,Staff,0,15,30,30
1651021296255,MATH 103A,B01,083779,Staff,0,15,30,30
1651021296255,MATH 103A,B02,083780,Staff,0,14,30,30
1651021302278,MATH 105,A01,085443,Staff,0,23,30,30
1651021308303,MATH 109,A01,083213,Anzaldo; Leesa B,0,8,30,30
1651021308303,MATH 109,A02,083214,Anzaldo; Leesa B,0,7,30,30
1651021308303,MATH 109,B01,083215,Anzaldo; Leesa B,0,8,30,30
1651021308303,MATH 109,B02,083216,Anzaldo; Leesa B,0,7,30,30
1651021314337,MATH 142A,A01,083219,Chow; Bennett,0,14,30,30
1651021314337,MATH 142A,A02,083220,Chow; Bennett,0,15,30,30
1651021314337,MATH 142A,B01,083221,Chow; Bennett,0,16,30,30
1651021314337,MATH 142A,B02,083222,Chow; Bennett,0,14,30,30
1651021320365,MATH 193A,A01,083224,Staff,0,7,30,30
1651021320365,MATH 193A,A02,083225,Staff,0,7,30,30
1651021320365,MATH 193A,A03,083781,Staff,0,7,30,30
1651021320365,MATH 193A,A04,083782,Staff,0,7,30,30
1651021326389,MATH 197,001,091859,McAuley; Julian John,9998,0,9999,1
1651021332461,COGS 9,A01,083615,Staff,0,19,60,60
1651021338487,COGS 11,A01,083617,Boyle; Mary E. T.,13,0,40,27
1651021344511,COGS 13,A01,083071,Staff,0,40,40,40
1651021350539,COGS 14A,A01,092681,Staff,0,40,100,100
1651021356564,COGS 14B,A01,083073,Cheng; Tzu-Han,0,13,50,50
1651021362588,COGS 17,A01,092677,Staff,7,0,75,68
1651021368692,COGS 100,A01,083619,Staff,0,30,60,60
1651021374719,COGS 101A,A01,083621,Davis; Joshua Daniel,0,29,60,60
1651021380745,COGS 101B,A01,091572,Staff,0,7,60,60
1651021386772,COGS 101C,A01,083625,Delgado; Tania,14,0,30,16
1651021392798,COGS 107A,A01,083627,Boyle; Mary E. T.,0,17,60,60
1651021398825,COGS 118A,A01,083075,Staff,0,10,60,60
1651021404849,CSE 3,A50,083646,Miranda; Gregory Joseph,15,0,38,23
1651021404849,CSE 3,A51,083647,Miranda; Gregory Joseph,36,0,37,1
1651021410871,CSE 8A,A50,083650,Miranda; Gregory Joseph,0,31,40,40
1651021416896,CSE 11,A01,083080,Cao; Yingjun,0,97,40,40
1651021422920,CSE 12,A01,083652,Staff,0,24,100,100
1651021428943,CSE 15L,A01,083654,Staff,0,3,50,50
1651021428943,CSE 15L,A02,083655,Staff,0,3,50,50
1651021434974,CSE 20,A01,083657,Staff,47,0,80,33
1651021441000,CSE 30,A01,083084,Eldon; John,1,40,80,79
1651021447023,CSE 100,A01,083659,Cao; Yingjun,0,72,50,50
1651021453046,CSE 134B,A01,083661,Powell; Thomas Allan,1,39,65,64
1651021459070,CSE 140,A01,083663,Staff,0,14,75,75
1651021465110,CSE 140L,A01,083088,Eldon; John,4,0,100,96
1651021471132,CSE 175,A01,083665,Kumar; Rakesh,0,0,25,25
1651021477155,CSE 190,A00,092507,Dubnov; Shlomo,9,0,20,11
1651021483182,ECE 45,A01,083139,Staff,0,7,60,60
1651021489205,ECE 65,A50,083695,Staff,0,7,30,30
1651021495229,ECE 109,A01,091882,Touri; Behrouz,32,0,70,38
1651021501253,ECE 180,A00,083140,Abi Samra; Nicholas Camill,17,0,30,13
1651021501253,ECE 180,B00,083141,Abi Samra; Nicholas Camill,0,0,30,30
1651021507276,MATH 10A,A01,083735,Patchell; Gregory David,1,0,30,29
1651021507276,MATH 10A,A02,083736,Patchell; Gregory David,27,0,30,3
1651021507276,MATH 10A,A03,083737,Patchell; Gregory David,23,0,30,7
1651021513320,MATH 10B,A01,083207,Staff,0,9,30,30
1651021513320,MATH 10B,A02,083208,Staff,0,6,30,30
1651021513320,MATH 10B,B01,083739,Staff,8,0,30,22
1651021513320,MATH 10B,B02,083740,Staff,28,0,30,2
1651021519347,MATH 18,A01,083743,Staff,0,0,30,30
1651021519347,MATH 18,A02,083744,Staff,23,0,30,7
1651021519347,MATH 18,A03,083745,Staff,19,0,30,11
1651021519347,MATH 18,A04,083746,Staff,26,0,30,4
1651021519347,MATH 18,B01,083748,Staff,0,16,30,30
1651021519347,MATH 18,B02,083749,Staff,0,14,30,30
1651021519347,MATH 18,B03,083750,Staff,0,14,30,30
1651021519347,MATH 18,B04,083751,Staff,0,13,30,30
1651021525374,MATH 20A,A01,083754,Staff,18,0,40,22
1651021531397,MATH 20B,A01,083756,Staff,0,14,30,30
1651021531397,MATH 20B,A02,083757,Staff,0,11,30,30
1651021537421,MATH 20C,A01,083760,Staff,0,17,30,30
1651021537421,MATH 20C,A02,083761,Staff,0,15,30,30
1651021537421,MATH 20C,B01,083762,Staff,9,0,30,21
1651021537421,MATH 20C,B02,083763,Staff,28,0,30,2
1651021543444,MATH 20D,A01,083765,Staff,3,1,30,27
1651021543444,MATH 20D,A02,083766,Staff,2,0,30,28
1651021543444,MATH 20D,A03,083767,Staff,22,0,30,8
1651021549469,MATH 20E,A01,083771,Staff,2,0,30,28
1651021549469,MATH 20E,A02,083772,Staff,12,0,30,18
1651021549469,MATH 20E,B01,083773,Staff,0,0,30,30
1651021549469,MATH 20E,B02,083774,Staff,1,0,30,29
1651021555491,MATH 103A,A01,083777,Staff,0,17,30,30
1651021555491,MATH 103A,A02,083778,Staff,0,15,30,30
1651021555491,MATH 103A,B01,083779,Staff,0,15,30,30
1651021555491,MATH 103A,B02,083780,Staff,0,14,30,30
1651021561525,MATH 105,A01,085443,Staff,0,23,30,30
1651021567548,MATH 109,A01,083213,Anzaldo; Leesa B,0,8,30,30
1651021567548,MATH 109,A02,083214,Anzaldo; Leesa B,0,7,30,30
1651021567548,MATH 109,B01,083215,Anzaldo; Leesa B,0,8,30,30
1651021567548,MATH 109,B02,083216,Anzaldo; Leesa B,0,7,30,30
1651021573577,MATH 142A,A01,083219,Chow; Bennett,0,14,30,30
1651021573577,MATH 142A,A02,083220,Chow; Bennett,0,15,30,30
1651021573577,MATH 142A,B01,083221,Chow; Bennett,0,16,30,30
1651021573577,MATH 142A,B02,083222,Chow; Bennett,0,14,30,30
1651021579602,MATH 193A,A01,083224,Staff,0,7,30,30
1651021579602,MATH 193A,A02,083225,Staff,0,7,30,30
1651021579602,MATH 193A,A03,083781,Staff,0,7,30,30
1651021579602,MATH 193A,A04,083782,Staff,0,7,30,30
1651021585631,MATH 197,001,091859,McAuley; Julian John,9998,0,9999,1
1651021591682,COGS 9,A01,083615,Staff,0,19,60,60
1651021597712,COGS 11,A01,083617,Boyle; Mary E. T.,13,0,40,27
1651021603739,COGS 13,A01,083071,Staff,0,40,40,40
1651021609764,COGS 14A,A01,092681,Staff,0,40,100,100
1651021615795,COGS 14B,A01,083073,Cheng; Tzu-Han,0,13,50,50
1651021621832,COGS 17,A01,092677,Staff,7,0,75,68
1651021627856,COGS 100,A01,083619,Staff,0,30,60,60
1651021633883,COGS 101A,A01,083621,Davis; Joshua Daniel,0,29,60,60
1651021639907,COGS 101B,A01,091572,Staff,0,7,60,60
1651021645930,COGS 101C,A01,083625,Delgado; Tania,14,0,30,16
1651021651955,COGS 107A,A01,083627,Boyle; Mary E. T.,0,17,60,60
1651021657985,COGS 118A,A01,083075,Staff,0,10,60,60
1651021664013,CSE 3,A50,083646,Miranda; Gregory Joseph,15,0,38,23
1651021664013,CSE 3,A51,083647,Miranda; Gregory Joseph,36,0,37,1
1651021670037,CSE 8A,A50,083650,Miranda; Gregory Joseph,0,31,40,40
1651021676062,CSE 11,A01,083080,Cao; Yingjun,0,97,40,40
1651021682088,CSE 12,A01,083652,Staff,0,24,100,100
1651021688117,CSE 15L,A01,083654,Staff,0,3,50,50
1651021688117,CSE 15L,A02,083655,Staff,0,3,50,50
1651021694140,CSE 20,A01,083657,Staff,47,0,80,33
1651021700165,CSE 30,A01,083084,Eldon; John,1,40,80,79
1651021706188,CSE 100,A01,083659,Cao; Yingjun,0,72,50,50
1651021712213,CSE 134B,A01,083661,Powell; Thomas Allan,1,39,65,64
1651021718238,CSE 140,A01,083663,Staff,0,14,75,75
1651021724266,CSE 140L,A01,083088,Eldon; John,4,0,100,96
1651021730291,CSE 175,A01,083665,Kumar; Rakesh,0,0,25,25
1651021736314,CSE 190,A00,092507,Dubnov; Shlomo,9,0,20,11
1651021742336,ECE 45,A01,083139,Staff,0,7,60,60
1651021748361,ECE 65,A50,083695,Staff,0,7,30,30
1651021754385,ECE 109,A01,091882,Touri; Behrouz,32,0,70,38
1651021760406,ECE 180,A00,083140,Abi Samra; Nicholas Camill,17,0,30,13
1651021760406,ECE 180,B00,083141,Abi Samra; Nicholas Camill,0,0,30,30
1651021766433,MATH 10A,A01,083735,Patchell; Gregory David,1,0,30,29
1651021766433,MATH 10A,A02,083736,Patchell; Gregory David,27,0,30,3
1651021766433,MATH 10A,A03,083737,Patchell; Gregory David,23,0,30,7
1651021772462,MATH 10B,A01,083207,Staff,0,9,30,30
1651021772462,MATH 10B,A02,083208,Staff,0,6,30,30
1651021772462,MATH 10B,B01,083739,Staff,8,0,30,22
1651021772462,MATH 10B,B02,083740,Staff,28,0,30,2
1651021778489,MATH 18,A01,083743,Staff,0,0,30,30
1651021778489,MATH 18,A02,083744,Staff,23,0,30,7
1651021778489,MATH 18,A03,083745,Staff,19,0,30,11
1651021778489,MATH 18,A04,083746,Staff,26,0,30,4
1651021778489,MATH 18,B01,083748,Staff,0,16,30,30
1651021778489,MATH 18,B02,083749,Staff,0,14,30,30
1651021778489,MATH 18,B03,083750,Staff,0,14,30,30
1651021778489,MATH 18,B04,083751,Staff,0,13,30,30
1651021784510,MATH 20A,A01,083754,Staff,18,0,40,22
1651021790536,MATH 20B,A01,083756,Staff,0,14,30,30
1651021790536,MATH 20B,A02,083757,Staff,0,11,30,30
1651021796558,MATH 20C,A01,083760,Staff,0,17,30,30
1651021796558,MATH 20C,A02,083761,Staff,0,15,30,30
1651021796558,MATH 20C,B01,083762,Staff,9,0,30,21
1651021796558,MATH 20C,B02,083763,Staff,28,0,30,2
1651021802587,MATH 20D,A01,083765,Staff,3,1,30,27
1651021802587,MATH 20D,A02,083766,Staff,2,0,30,28
1651021802587,MATH 20D,A03,083767,Staff,22,0,30,8
1651021808608,MATH 20E,A01,083771,Staff,2,0,30,28
1651021808608,MATH 20E,A02,083772,Staff,12,0,30,18
1651021808608,MATH 20E,B01,083773,Staff,0,0,30,30
1651021808608,MATH 20E,B02,083774,Staff,1,0,30,29
1651021814636,MATH 103A,A01,083777,Staff,0,17,30,30
1651021814636,MATH 103A,A02,083778,Staff,0,15,30,30
1651021814636,MATH 103A,B01,083779,Staff,0,15,30,30
1651021814636,MATH 103A,B02,083780,Staff,0,14,30,30
1651021820662,MATH 105,A01,085443,Staff,0,23,30,30
1651021826689,MATH 109,A01,083213,Anzaldo; Leesa B,0,8,30,30
1651021826689,MATH 109,A02,083214,Anzaldo; Leesa B,0,7,30,30
1651021826689,MATH 109,B01,083215,Anzaldo; Leesa B,0,8,30,30
1651021826689,MATH 109,B02,083216,Anzaldo; Leesa B,0,7,30,30
1651021832712,MATH 142A,A01,083219,Chow; Bennett,0,14,30,30
1651021832712,MATH 142A,A02,083220,Chow; Bennett,0,15,30,30
1651021832712,MATH 142A,B01,083221,Chow; Bennett,0,16,30,30
1651021832712,MATH 142A,B02,083222,Chow; Bennett,0,14,30,30
1651021838738,MATH 193A,A01,083224,Staff,0,7,30,30
1651021838738,MATH 193A,A02,083225,Staff,0,7,30,30
1651021838738,MATH 193A,A03,083781,Staff,0,7,30,30
1651021838738,MATH 193A,A04,083782,Staff,0,7,30,30
1651021844765,MATH 197,001,091859,McAuley; Julian John,9998,0,9999,1
1651021850830,COGS 9,A01,083615,Staff,0,19,60,60
1651021856851,COGS 11,A01,083617,Boyle; Mary E. T.,13,0,40,27
1651021862875,COGS 13,A01,083071,Staff,0,40,40,40
1651021868901,COGS 14A,A01,092681,Staff,0,40,100,100
1651021874923,COGS 14B,A01,083073,Cheng; Tzu-Han,0,13,50,50
1651021880947,COGS 17,A01,092677,Staff,7,0,75,68
1651021886971,COGS 100,A01,083619,Staff,0,30,60,60
1651021892998,COGS 101A,A01,083621,Davis; Joshua Daniel,0,29,60,60
1651021899020,COGS 101B,A01,091572,Staff,0,7,60,60
1651021905043,COGS 101C,A01,083625,Delgado; Tania,14,0,30,16
1651021911068,COGS 107A,A01,083627,Boyle; Mary E. T.,0,17,60,60
1651021917092,COGS 118A,A01,083075,Staff,0,10,60,60
1651021923115,CSE 3,A50,083646,Miranda; Gregory Joseph,15,0,38,23
1651021923115,CSE 3,A51,083647,Miranda; Gregory Joseph,36,0,37,1
1651021929138,CSE 8A,A50,083650,Miranda; Gregory Joseph,0,31,40,40
1651021935162,CSE 11,A01,083080,Cao; Yingjun,0,97,40,40
1651021941184,CSE 12,A01,083652,Staff,0,24,100,100
1651021947210,CSE 15L,A01,083654,Staff,0,3,50,50
1651021947210,CSE 15L,A02,083655,Staff,0,3,50,50
1651021953236,CSE 20,A01,083657,Staff,47,0,80,33
1651021959276,CSE 30,A01,083084,Eldon; John,1,40,80,79
1651021965377,CSE 100,A01,083659,Cao; Yingjun,0,72,50,50
1651021971403,CSE 134B,A01,083661,Powell; Thomas Allan,1,39,65,64
1651021977436,CSE 140,A01,083663,Staff,0,14,75,75
1651021983463,CSE 140L,A01,083088,Eldon; John,4,0,100,96
1651021989489,CSE 175,A01,083665,Kumar; Rakesh,0,0,25,25
1651021995513,CSE 190,A00,092507,Dubnov; Shlomo,9,0,20,11
1651022001536,ECE 45,A01,083139,Staff,0,7,60,60
1651022007566,ECE 65,A50,083695,Staff,0,7,30,30
1651022013588,ECE 109,A01,091882,Touri; Behrouz,32,0,70,38
1651022019613,ECE 180,A00,083140,Abi Samra; Nicholas Camill,17,0,30,13
1651022019613,ECE 180,B00,083141,Abi Samra; Nicholas Camill,0,0,30,30
1651022025637,MATH 10A,A01,083735,Patchell; Gregory David,1,0,30,29
1651022025637,MATH 10A,A02,083736,Patchell; Gregory David,27,0,30,3
1651022025637,MATH 10A,A03,083737,Patchell; Gregory David,23,0,30,7
1651022031664,MATH 10B,A01,083207,Staff,0,9,30,30
1651022031664,MATH 10B,A02,083208,Staff,0,6,30,30
1651022031664,MATH 10B,B01,083739,Staff,8,0,30,22
1651022031664,MATH 10B,B02,083740,Staff,28,0,30,2
1651022037691,MATH 18,A01,083743,Staff,0,0,30,30
1651022037691,MATH 18,A02,083744,Staff,23,0,30,7
1651022037691,MATH 18,A03,083745,Staff,19,0,30,11
1651022037691,MATH 18,A04,083746,Staff,26,0,30,4
1651022037691,MATH 18,B01,083748,Staff,0,16,30,30
1651022037691,MATH 18,B02,083749,Staff,0,14,30,30
1651022037691,MATH 18,B03,083750,Staff,0,14,30,30
1651022037691,MATH 18,B04,083751,Staff,0,13,30,30
1651022043712,MATH 20A,A01,083754,Staff,18,0,40,22
1651022049738,MATH 20B,A01,083756,Staff,0,14,30,30
1651022049738,MATH 20B,A02,083757,Staff,0,11,30,30
1651022055765,MATH 20C,A01,083760,Staff,0,17,30,30
1651022055765,MATH 20C,A02,083761,Staff,0,15,30,30
1651022055765,MATH 20C,B01,083762,Staff,9,0,30,21
1651022055765,MATH 20C,B02,083763,Staff,28,0,30,2
1651022061786,MATH 20D,A01,083765,Staff,3,1,30,27
1651022061786,MATH 20D,A02,083766,Staff,1,0,30,29
1651022061786,MATH 20D,A03,083767,Staff,22,0,30,8
1651022067810,MATH 20E,A01,083771,Staff,2,0,30,28
1651022067810,MATH 20E,A02,083772,Staff,12,0,30,18
1651022067810,MATH 20E,B01,083773,Staff,0,0,30,30
1651022067810,MATH 20E,B02,083774,Staff,1,0,30,29
1651022073846,MATH 103A,A01,083777,Staff,0,17,30,30
1651022073846,MATH 103A,A02,083778,Staff,0,15,30,30
1651022073846,MATH 103A,B01,083779,Staff,0,15,30,30
1651022073846,MATH 103A,B02,083780,Staff,0,14,30,30
1651022079870,MATH 105,A01,085443,Staff,0,23,30,30
1651022085893,MATH 109,A01,083213,Anzaldo; Leesa B,0,8,30,30
1651022085893,MATH 109,A02,083214,Anzaldo; Leesa B,0,7,30,30
1651022085893,MATH 109,B01,083215,Anzaldo; Leesa B,0,8,30,30
1651022085893,MATH 109,B02,083216,Anzaldo; Leesa B,0,7,30,30
1651022091928,MATH 142A,A01,083219,Chow; Bennett,0,14,30,30
1651022091928,MATH 142A,A02,083220,Chow; Bennett,0,15,30,30
1651022091928,MATH 142A,B01,083221,Chow; Bennett,0,16,30,30
1651022091928,MATH 142A,B02,083222,Chow; Bennett,0,14,30,30
1651022097955,MATH 193A,A01,083224,Staff,0,7,30,30
1651022097955,MATH 193A,A02,083225,Staff,0,7,30,30
1651022097955,MATH 193A,A03,083781,Staff,0,7,30,30
1651022097955,MATH 193A,A04,083782,Staff,0,7,30,30
1651022103981,MATH 197,001,091859,McAuley; Julian John,9998,0,9999,1
1651022110043,COGS 9,A01,083615,Staff,0,19,60,60
1651022116069,COGS 11,A01,083617,Boyle; Mary E. T.,13,0,40,27
1651022122093,COGS 13,A01,083071,Staff,0,40,40,40
1651022128122,COGS 14A,A01,092681,Staff,0,40,100,100
1651022134145,COGS 14B,A01,083073,Cheng; Tzu-Han,0,13,50,50
1651022140167,COGS 17,A01,092677,Staff,7,0,75,68
1651022146190,COGS 100,A01,083619,Staff,0,30,60,60
1651022152216,COGS 101A,A01,083621,Davis; Joshua Daniel,0,29,60,60
1651022158251,COGS 101B,A01,091572,Staff,0,7,60,60
1651022164277,COGS 101C,A01,083625,Delgado; Tania,14,0,30,16
1651022170300,COGS 107A,A01,083627,Boyle; Mary E. T.,0,17,60,60
1651022176326,COGS 118A,A01,083075,Staff,0,10,60,60
1651022182349,CSE 3,A50,083646,Miranda; Gregory Joseph,15,0,38,23
1651022182349,CSE 3,A51,083647,Miranda; Gregory Joseph,36,0,37,1
1651022188376,CSE 8A,A50,083650,Miranda; Gregory Joseph,0,31,40,40
1651022194399,CSE 11,A01,083080,Cao; Yingjun,0,97,40,40
1651022200422,CSE 12,A01,083652,Staff,0,24,100,100
1651022206449,CSE 15L,A01,083654,Staff,0,3,50,50
1651022206449,CSE 15L,A02,083655,Staff,0,3,50,50
1651022212475,CSE 20,A01,083657,Staff,47,0,80,33
1651022218498,CSE 30,A01,083084,Eldon; John,1,40,80,79
1651022224525,CSE 100,A01,083659,Cao; Yingjun,0,72,50,50
1651022230549,CSE 134B,A01,083661,Powell; Thomas Allan,1,39,65,64
1651022236572,CSE 140,A01,083663,Staff,0,14,75,75
1651022242597,CSE 140L,A01,083088,Eldon; John,4,0,100,96
1651022248619,CSE 175,A01,083665,Kumar; Rakesh,0,0,25,25
1651022254645,CSE 190,A00,092507,Dubnov; Shlomo,9,0,20,11
1651022260672,ECE 45,A01,083139,Staff,0,7,60,60
1651022266699,ECE 65,A50,083695,Staff,0,7,30,30
1651022272725,ECE 109,A01,091882,Touri; Behrouz,32,0,70,38
1651022278756,ECE 180,A00,083140,Abi Samra; Nicholas Camill,17,0,30,13
1651022278756,ECE 180,B00,083141,Abi Samra; Nicholas Camill,0,0,30,30
1651022284780,MATH 10A,A01,083735,Patchell; Gregory David,1,0,30,29
1651022284780,MATH 10A,A02,083736,Patchell; Gregory David,27,0,30,3
1651022284780,MATH 10A,A03,083737,Patchell; Gregory David,23,0,30,7
1651022290805,MATH 10B,A01,083207,Staff,0,9,30,30
1651022290805,MATH 10B,A02,083208,Staff,0,6,30,30
1651022290805,MATH 10B,B01,083739,Staff,8,0,30,22
1651022290805,MATH 10B,B02,083740,Staff,28,0,30,2
1651022296836,MATH 18,A01,083743,Staff,0,0,30,30
1651022296836,MATH 18,A02,083744,Staff,23,0,30,7
1651022296836,MATH 18,A03,083745,Staff,19,0,30,11
1651022296836,MATH 18,A04,083746,Staff,26,0,30,4
1651022296836,MATH 18,B01,083748,Staff,0,16,30,30
1651022296836,MATH 18,B02,083749,Staff,0,14,30,30
1651022296836,MATH 18,B03,083750,Staff,0,14,30,30
1651022296836,MATH 18,B04,083751,Staff,0,13,30,30
1651022302860,MATH 20A,A01,083754,Staff,18,0,40,22
1651022308881,MATH 20B,A01,083756,Staff,0,14,30,30
1651022308881,MATH 20B,A02,083757,Staff,0,11,30,30
1651022314905,MATH 20C,A01,083760,Staff,0,17,30,30
1651022314905,MATH 20C,A02,083761,Staff,0,15,30,30
1651022314905,MATH 20C,B01,083762,Staff,9,0,30,21
1651022314905,MATH 20C,B02,083763,Staff,28,0,30,2
1651022320930,MATH 20D,A01,083765,Staff,3,1,30,27
1651022320930,MATH 20D,A02,083766,Staff,1,0,30,29
1651022320930,MATH 20D,A03,083767,Staff,22,0,30,8
1651022326954,MATH 20E,A01,083771,Staff,2,0,30,28
1651022326954,MATH 20E,A02,083772,Staff,12,0,30,18
1651022326954,MATH 20E,B01,083773,Staff,0,0,30,30
1651022326954,MATH 20E,B02,083774,Staff,1,0,30,29
1651022332977,MATH 103A,A01,083777,Staff,0,17,30,30
1651022332977,MATH 103A,A02,083778,Staff,0,15,30,30
1651022332977,MATH 103A,B01,083779,Staff,0,15,30,30
1651022332977,MATH 103A,B02,083780,Staff,0,14,30,30
1651022339002,MATH 105,A01,085443,Staff,0,23,30,30
1651022345031,MATH 109,A01,083213,Anzaldo; Leesa B,0,8,30,30
1651022345031,MATH 109,A02,083214,Anzaldo; Leesa B,0,7,30,30
1651022345031,MATH 109,B01,083215,Anzaldo; Leesa B,0,8,30,30
1651022345031,MATH 109,B02,083216,Anzaldo; Leesa B,0,7,30,30
1651022351054,MATH 142A,A01,083219,Chow; Bennett,0,14,30,30
1651022351054,MATH 142A,A02,083220,Chow; Bennett,0,15,30,30
1651022351054,MATH 142A,B01,083221,Chow; Bennett,0,16,30,30
1651022351054,MATH 142A,B02,083222,Chow; Bennett,0,14,30,30
1651022357079,MATH 193A,A01,083224,Staff,0,7,30,30
1651022357079,MATH 193A,A02,083225,Staff,0,7,30,30
1651022357079,MATH 193A,A03,083781,Staff,0,7,30,30
1651022357079,MATH 193A,A04,083782,Staff,0,7,30,30
1651022363117,MATH 197,001,091859,McAuley; Julian John,9998,0,9999,1
1651022369185,COGS 9,A01,083615,Staff,0,19,60,60
1651022375208,COGS 11,A01,083617,Boyle; Mary E. T.,13,0,40,27
1651022381237,COGS 13,A01,083071,Staff,0,40,40,40
1651022387266,COGS 14A,A01,092681,Staff,0,40,100,100
1651022393291,COGS 14B,A01,083073,Cheng; Tzu-Han,0,13,50,50
1651022399317,COGS 17,A01,092677,Staff,7,0,75,68
1651022405343,COGS 100,A01,083619,Staff,0,30,60,60
1651022411365,COGS 101A,A01,083621,Davis; Joshua Daniel,0,29,60,60
1651022417397,COGS 101B,A01,091572,Staff,0,7,60,60
1651022423421,COGS 101C,A01,083625,Delgado; Tania,14,0,30,16
1651022429447,COGS 107A,A01,083627,Boyle; Mary E. T.,0,17,60,60
1651022435470,COGS 118A,A01,083075,Staff,0,10,60,60
1651022441499,CSE 3,A50,083646,Miranda; Gregory Joseph,15,0,38,23
1651022441499,CSE 3,A51,083647,Miranda; Gregory Joseph,36,0,37,1
1651022447521,CSE 8A,A50,083650,Miranda; Gregory Joseph,0,31,40,40
1651022453543,CSE 11,A01,083080,Cao; Yingjun,0,97,40,40
1651022459570,CSE 12,A01,083652,Staff,0,24,100,100
1651022465591,CSE 15L,A01,083654,Staff,0,3,50,50
1651022465591,CSE 15L,A02,083655,Staff,0,3,50,50
1651022471616,CSE 20,A01,083657,Staff,47,0,80,33
1651022477638,CSE 30,A01,083084,Eldon; John,1,40,80,79
1651022483667,CSE 100,A01,083659,Cao; Yingjun,0,72,50,50
1651022489690,CSE 134B,A01,083661,Powell; Thomas Allan,1,39,65,64
1651022495713,CSE 140,A01,083663,Staff,0,14,75,75
1651022501749,CSE 140L,A01,083088,Eldon; John,4,0,100,96
1651022507776,CSE 175,A01,083665,Kumar; Rakesh,0,0,25,25
1651022513798,CSE 190,A00,092507,Dubnov; Shlomo,9,0,20,11
1651022519822,ECE 45,A01,083139,Staff,0,7,60,60
1651022525845,ECE 65,A50,083695,Staff,0,7,30,30
1651022531872,ECE 109,A01,091882,Touri; Behrouz,32,0,70,38
1651022537899,ECE 180,A00,083140,Abi Samra; Nicholas Camill,17,0,30,13
1651022537899,ECE 180,B00,083141,Abi Samra; Nicholas Camill,0,0,30,30
1651022543922,MATH 10A,A01,083735,Patchell; Gregory David,1,0,30,29
1651022543922,MATH 10A,A02,083736,Patchell; Gregory David,27,0,30,3
1651022543922,MATH 10A,A03,083737,Patchell; Gregory David,23,0,30,7
1651022549949,MATH 10B,A01,083207,Staff,0,9,30,30
1651022549949,MATH 10B,A02,083208,Staff,0,6,30,30
1651022549949,MATH 10B,B01,083739,Staff,8,0,30,22
1651022549949,MATH 10B,B02,083740,Staff,28,0,30,2
1651022555972,MATH 18,A01,083743,Staff,0,0,30,30
1651022555972,MATH 18,A02,083744,Staff,23,0,30,7
1651022555972,MATH 18,A03,083745,Staff,19,0,30,11
1651022555972,MATH 18,A04,083746,Staff,26,0,30,4
1651022555972,MATH 18,B01,083748,Staff,0,16,30,30
1651022555972,MATH 18,B02,083749,Staff,0,14,30,30
1651022555972,MATH 18,B03,083750,Staff,0,14,30,30
1651022555972,MATH 18,B04,083751,Staff,0,13,30,30
1651022562085,MATH 20A,A01,083754,Staff,18,0,40,22
1651022568113,MATH 20B,A01,083756,Staff,0,14,30,30
1651022568113,MATH 20B,A02,083757,Staff,0,11,30,30
1651022574137,MATH 20C,A01,083760,Staff,0,17,30,30
1651022574137,MATH 20C,A02,083761,Staff,0,15,30,30
1651022574137,MATH 20C,B01,083762,Staff,9,0,30,21
1651022574137,MATH 20C,B02,083763,Staff,28,0,30,2
1651022580160,MATH 20D,A01,083765,Staff,3,1,30,27
1651022580160,MATH 20D,A02,083766,Staff,1,0,30,29
1651022580160,MATH 20D,A03,083767,Staff,22,0,30,8
1651022586183,MATH 20E,A01,083771,Staff,2,0,30,28
1651022586183,MATH 20E,A02,083772,Staff,12,0,30,18
1651022586183,MATH 20E,B01,083773,Staff,0,0,30,30
1651022586183,MATH 20E,B02,083774,Staff,1,0,30,29
1651022592217,MATH 103A,A01,083777,Staff,0,17,30,30
1651022592217,MATH 103A,A02,083778,Staff,0,15,30,30
1651022592217,MATH 103A,B01,083779,Staff,0,15,30,30
1651022592217,MATH 103A,B02,083780,Staff,0,14,30,30
1651022598244,MATH 105,A01,085443,Staff,0,23,30,30
1651022604269,MATH 109,A01,083213,Anzaldo; Leesa B,0,8,30,30
1651022604269,MATH 109,A02,083214,Anzaldo; Leesa B,0,7,30,30
1651022604269,MATH 109,B01,083215,Anzaldo; Leesa B,0,8,30,30
1651022604269,MATH 109,B02,083216,Anzaldo; Leesa B,0,7,30,30
1651022610301,MATH 142A,A01,083219,Chow; Bennett,0,14,30,30
1651022610301,MATH 142A,A02,083220,Chow; Bennett,0,15,30,30
1651022610301,MATH 142A,B01,083221,Chow; Bennett,0,16,30,30
1651022610301,MATH 142A,B02,083222,Chow; Bennett,0,14,30,30
1651022616326,MATH 193A,A01,083224,Staff,0,7,30,30
1651022616326,MATH 193A,A02,083225,Staff,0,7,30,30
1651022616326,MATH 193A,A03,083781,Staff,0,7,30,30
1651022616326,MATH 193A,A04,083782,Staff,0,7,30,30
1651022622358,MATH 197,001,091859,McAuley; Julian John,9998,0,9999,1
1651022628418,COGS 9,A01,083615,Staff,0,19,60,60
1651022634441,COGS 11,A01,083617,Boyle; Mary E. T.,13,0,40,27
1651022640463,COGS 13,A01,083071,Staff,0,40,40,40
1651022646490,COGS 14A,A01,092681,Staff,0,40,100,100
1651022652513,COGS 14B,A01,083073,Cheng; Tzu-Han,0,13,50,50
1651022658540,COGS 17,A01,092677,Staff,7,0,75,68
1651022664566,COGS 100,A01,083619,Staff,0,30,60,60
1651022670592,COGS 101A,A01,083621,Davis; Joshua Daniel,0,29,60,60
1651022676619,COGS 101B,A01,091572,Staff,0,7,60,60
1651022682642,COGS 101C,A01,083625,Delgado; Tania,14,0,30,16
1651022688670,COGS 107A,A01,083627,Boyle; Mary E. T.,0,17,60,60
1651022694693,COGS 118A,A01,083075,Staff,0,10,60,60
1651022700717,CSE 3,A50,083646,Miranda; Gregory Joseph,15,0,38,23
1651022700717,CSE 3,A51,083647,Miranda; Gregory Joseph,36,0,37,1
1651022706739,CSE 8A,A50,083650,Miranda; Gregory Joseph,0,31,40,40
1651022712763,CSE 11,A01,083080,Cao; Yingjun,0,97,40,40
1651022718789,CSE 12,A01,083652,Staff,0,24,100,100
1651022724812,CSE 15L,A01,083654,Staff,0,3,50,50
1651022724812,CSE 15L,A02,083655,Staff,0,3,50,50
1651022730835,CSE 20,A01,083657,Staff,47,0,80,33
1651022736862,CSE 30,A01,083084,Eldon; John,1,40,80,79
1651022742886,CSE 100,A01,083659,Cao; Yingjun,0,72,50,50
1651022748915,CSE 134B,A01,083661,Powell; Thomas Allan,1,39,65,64
1651022754942,CSE 140,A01,083663,Staff,0,14,75,75
1651022760985,CSE 140L,A01,083088,Eldon; John,4,0,100,96
1651022767011,CSE 175,A01,083665,Kumar; Rakesh,0,0,25,25
1651022773040,CSE 190,A00,092507,Dubnov; Shlomo,9,0,20,11
1651022779063,ECE 45,A01,083139,Staff,0,7,60,60
1651022785089,ECE 65,A50,083695,Staff,0,7,30,30
1651022791113,ECE 109,A01,091882,Touri; Behrouz,32,0,70,38
1651022797136,ECE 180,A00,083140,Abi Samra; Nicholas Camill,17,0,30,13
1651022797136,ECE 180,B00,083141,Abi Samra; Nicholas Camill,0,0,30,30
1651022803163,MATH 10A,A01,083735,Patchell; Gregory David,1,0,30,29
1651022803163,MATH 10A,A02,083736,Patchell; Gregory David,27,0,30,3
1651022803163,MATH 10A,A03,083737,Patchell; Gregory David,23,0,30,7
1651022809187,MATH 10B,A01,083207,Staff,0,9,30,30
1651022809187,MATH 10B,A02,083208,Staff,0,6,30,30
1651022809187,MATH 10B,B01,083739,Staff,8,0,30,22
1651022809187,MATH 10B,B02,083740,Staff,28,0,30,2
1651022815211,MATH 18,A01,083743,Staff,0,0,30,30
1651022815211,MATH 18,A02,083744,Staff,23,0,30,7
1651022815211,MATH 18,A03,083745,Staff,19,0,30,11
1651022815211,MATH 18,A04,083746,Staff,26,0,30,4
1651022815211,MATH 18,B01,083748,Staff,0,16,30,30
1651022815211,MATH 18,B02,083749,Staff,0,14,30,30
1651022815211,MATH 18,B03,083750,Staff,0,14,30,30
1651022815211,MATH 18,B04,083751,Staff,0,13,30,30
1651022821238,MATH 20A,A01,083754,Staff,18,0,40,22
1651022827261,MATH 20B,A01,083756,Staff,0,14,30,30
1651022827261,MATH 20B,A02,083757,Staff,0,11,30,30
1651022833288,MATH 20C,A01,083760,Staff,0,17,30,30
1651022833288,MATH 20C,A02,083761,Staff,0,15,30,30
1651022833288,MATH 20C,B01,083762,Staff,9,0,30,21
1651022833288,MATH 20C,B02,083763,Staff,28,0,30,2
1651022839311,MATH 20D,A01,083765,Staff,3,1,30,27
1651022839311,MATH 20D,A02,083766,Staff,1,0,30,29
1651022839311,MATH 20D,A03,083767,Staff,22,0,30,8
1651022845334,MATH 20E,A01,083771,Staff,2,0,30,28
1651022845334,MATH 20E,A02,083772,Staff,12,0,30,18
1651022845334,MATH 20E,B01,083773,Staff,0,0,30,30
1651022845334,MATH 20E,B02,083774,Staff,1,0,30,29
1651022851370,MATH 103A,A01,083777,Staff,0,17,30,30
1651022851370,MATH 103A,A02,083778,Staff,0,15,30,30
1651022851370,MATH 103A,B01,083779,Staff,0,15,30,30
1651022851370,MATH 103A,B02,083780,Staff,0,14,30,30
1651022857401,MATH 105,A01,085443,Staff,0,23,30,30
1651022863429,MATH 109,A01,083213,Anzaldo; Leesa B,0,8,30,30
1651022863429,MATH 109,A02,083214,Anzaldo; Leesa B,0,7,30,30
1651022863429,MATH 109,B01,083215,Anzaldo; Leesa B,0,8,30,30
1651022863429,MATH 109,B02,083216,Anzaldo; Leesa B,0,7,30,30
1651022869453,MATH 142A,A01,083219,Chow; Bennett,0,14,30,30
1651022869453,MATH 142A,A02,083220,Chow; Bennett,0,15,30,30
1651022869453,MATH 142A,B01,083221,Chow; Bennett,0,16,30,30
1651022869453,MATH 142A,B02,083222,Chow; Bennett,0,14,30,30
1651022875476,MATH 193A,A01,083224,Staff,0,7,30,30
1651022875476,MATH 193A,A02,083225,Staff,0,7,30,30
1651022875476,MATH 193A,A03,083781,Staff,0,7,30,30
1651022875476,MATH 193A,A04,083782,Staff,0,7,30,30
1651022881500,MATH 197,001,091859,McAuley; Julian John,9998,0,9999,1
1651022887555,COGS 9,A01,083615,Staff,0,19,60,60
1651022893583,COGS 11,A01,083617,Boyle; Mary E. T.,13,0,40,27
1651022899607,COGS 13,A01,083071,Staff,0,40,40,40
1651022905633,COGS 14A,A01,092681,Staff,0,40,100,100
1651022911658,COGS 14B,A01,083073,Cheng; Tzu-Han,0,13,50,50
1651022917681,COGS 17,A01,092677,Staff,7,0,75,68
1651022923705,COGS 100,A01,083619,Staff,0,30,60,60
1651022929728,COGS 101A,A01,083621,Davis; Joshua Daniel,0,29,60,60
1651022935754,COGS 101B,A01,091572,Staff,0,7,60,60
1651022941780,COGS 101C,A01,083625,Delgado; Tania,14,0,30,16
1651022947803,COGS 107A,A01,083627,Boyle; Mary E. T.,0,17,60,60
1651022953828,COGS 118A,A01,083075,Staff,0,10,60,60
1651022959852,CSE 3,A50,083646,Miranda; Gregory Joseph,15,0,38,23
1651022959852,CSE 3,A51,083647,Miranda; Gregory Joseph,36,0,37,1
1651022965879,CSE 8A,A50,083650,Miranda; Gregory Joseph,0,31,40,40
1651022971906,CSE 11,A01,083080,Cao; Yingjun,0,97,40,40
1651022977931,CSE 12,A01,083652,Staff,0,24,100,100
1651022983955,CSE 15L,A01,083654,Staff,0,3,50,50
1651022983955,CSE 15L,A02,083655,Staff,0,3,50,50
1651022989983,CSE 20,A01,083657,Staff,47,0,80,33
1651022996009,CSE 30,A01,083084,Eldon; John,1,40,80,79
1651023002033,CSE 100,A01,083659,Cao; Yingjun,0,72,50,50
1651023008061,CSE 134B,A01,083661,Powell; Thomas Allan,1,39,65,64
1651023014083,CSE 140,A01,083663,Staff,0,14,75,75
1651023020110,CSE 140L,A01,083088,Eldon; John,4,0,100,96
1651023026141,CSE 175,A01,083665,Kumar; Rakesh,0,0,25,25
1651023032165,CSE 190,A00,092507,Dubnov; Shlomo,9,0,20,11
1651023038194,ECE 45,A01,083139,Staff,0,7,60,60
1651023044226,ECE 65,A50,083695,Staff,0,7,30,30
1651023050249,ECE 109,A01,091882,Touri; Behrouz,32,0,70,38
1651023056297,ECE 180,A00,083140,Abi Samra; Nicholas Camill,17,0,30,13
1651023056297,ECE 180,B00,083141,Abi Samra; Nicholas Camill,0,0,30,30
1651023062333,MATH 10A,A01,083735,Patchell; Gregory David,1,0,30,29
1651023062333,MATH 10A,A02,083736,Patchell; Gregory David,27,0,30,3
1651023062333,MATH 10A,A03,083737,Patchell; Gregory David,23,0,30,7
1651023068365,MATH 10B,A01,083207,Staff,0,9,30,30
1651023068365,MATH 10B,A02,083208,Staff,0,6,30,30
1651023068365,MATH 10B,B01,083739,Staff,8,0,30,22
1651023068365,MATH 10B,B02,083740,Staff,28,0,30,2
1651023074389,MATH 18,A01,083743,Staff,0,0,30,30
1651023074389,MATH 18,A02,083744,Staff,23,0,30,7
1651023074389,MATH 18,A03,083745,Staff,19,0,30,11
1651023074389,MATH 18,A04,083746,Staff,26,0,30,4
1651023074389,MATH 18,B01,083748,Staff,0,16,30,30
1651023074389,MATH 18,B02,083749,Staff,0,14,30,30
1651023074389,MATH 18,B03,083750,Staff,0,14,30,30
1651023074389,MATH 18,B04,083751,Staff,0,13,30,30
1651023080412,MATH 20A,A01,083754,Staff,18,0,40,22
1651023086439,MATH 20B,A01,083756,Staff,0,14,30,30
1651023086439,MATH 20B,A02,083757,Staff,0,11,30,30
1651023092460,MATH 20C,A01,083760,Staff,0,17,30,30
1651023092460,MATH 20C,A02,083761,Staff,0,15,30,30
1651023092460,MATH 20C,B01,083762,Staff,9,0,30,21
1651023092460,MATH 20C,B02,083763,Staff,28,0,30,2
1651023098483,MATH 20D,A01,083765,Staff,3,1,30,27
1651023098483,MATH 20D,A02,083766,Staff,1,0,30,29
1651023098483,MATH 20D,A03,083767,Staff,22,0,30,8
1651023104506,MATH 20E,A01,083771,Staff,2,0,30,28
1651023104506,MATH 20E,A02,083772,Staff,12,0,30,18
1651023104506,MATH 20E,B01,083773,Staff,0,0,30,30
1651023104506,MATH 20E,B02,083774,Staff,1,0,30,29
1651023110529,MATH 103A,A01,083777,Staff,0,17,30,30
1651023110529,MATH 103A,A02,083778,Staff,0,15,30,30
1651023110529,MATH 103A,B01,083779,Staff,0,15,30,30
1651023110529,MATH 103A,B02,083780,Staff,0,14,30,30
1651023116554,MATH 105,A01,085443,Staff,0,23,30,30
1651023122586,MATH 109,A01,083213,Anzaldo; Leesa B,0,8,30,30
1651023122586,MATH 109,A02,083214,Anzaldo; Leesa B,0,7,30,30
1651023122586,MATH 109,B01,083215,Anzaldo; Leesa B,0,8,30,30
1651023122586,MATH 109,B02,083216,Anzaldo; Leesa B,0,7,30,30
1651023128612,MATH 142A,A01,083219,Chow; Bennett,0,14,30,30
1651023128612,MATH 142A,A02,083220,Chow; Bennett,0,15,30,30
1651023128612,MATH 142A,B01,083221,Chow; Bennett,0,16,30,30
1651023128612,MATH 142A,B02,083222,Chow; Bennett,0,14,30,30
1651023134650,MATH 193A,A01,083224,Staff,0,7,30,30
1651023134650,MATH 193A,A02,083225,Staff,0,7,30,30
1651023134650,MATH 193A,A03,083781,Staff,0,7,30,30
1651023134650,MATH 193A,A04,083782,Staff,0,7,30,30
1651023140672,MATH 197,001,091859,McAuley; Julian John,9998,0,9999,1
1651023146727,COGS 9,A01,083615,Staff,0,19,60,60
1651023152831,COGS 11,A01,083617,Boyle; Mary E. T.,13,0,40,27
1651023158854,COGS 13,A01,083071,Staff,0,40,40,40
1651023164877,COGS 14A,A01,092681,Staff,0,40,100,100
1651023170899,COGS 14B,A01,083073,Cheng; Tzu-Han,0,13,50,50
1651023176926,COGS 17,A01,092677,Staff,7,0,75,68
1651023182955,COGS 100,A01,083619,Staff,0,30,60,60
1651023188979,COGS 101A,A01,083621,Davis; Joshua Daniel,0,29,60,60
1651023195006,COGS 101B,A01,091572,Staff,0,7,60,60
1651023201027,COGS 101C,A01,083625,Delgado; Tania,14,0,30,16
1651023207051,COGS 107A,A01,083627,Boyle; Mary E. T.,0,17,60,60
1651023213073,COGS 118A,A01,083075,Staff,0,10,60,60
1651023219107,CSE 3,A50,083646,Miranda; Gregory Joseph,15,0,38,23
1651023219107,CSE 3,A51,083647,Miranda; Gregory Joseph,36,0,37,1
1651023225131,CSE 8A,A50,083650,Miranda; Gregory Joseph,0,31,40,40
1651023231154,CSE 11,A01,083080,Cao; Yingjun,0,97,40,40
1651023237177,CSE 12,A01,083652,Staff,0,24,100,100
1651023243201,CSE 15L,A01,083654,Staff,0,3,50,50
1651023243201,CSE 15L,A02,083655,Staff,0,3,50,50
1651023249238,CSE 20,A01,083657,Staff,47,0,80,33
1651023255265,CSE 30,A01,083084,Eldon; John,1,40,80,79
1651023261290,CSE 100,A01,083659,Cao; Yingjun,0,72,50,50
1651023267313,CSE 134B,A01,083661,Powell; Thomas Allan,1,39,65,64
1651023273339,CSE 140,A01,083663,Staff,0,14,75,75
1651023279363,CSE 140L,A01,083088,Eldon; John,4,0,100,96
1651023285385,CSE 175,A01,083665,Kumar; Rakesh,0,0,25,25
1651023291410,CSE 190,A00,092507,Dubnov; Shlomo,9,0,20,11
1651023297438,ECE 45,A01,083139,Staff,0,7,60,60
1651023303467,ECE 65,A50,083695,Staff,0,7,30,30
1651023309493,ECE 109,A01,091882,Touri; Behrouz,32,0,70,38
1651023315517,ECE 180,A00,083140,Abi Samra; Nicholas Camill,17,0,30,13
1651023315517,ECE 180,B00,083141,Abi Samra; Nicholas Camill,0,0,30,30
1651023321541,MATH 10A,A01,083735,Patchell; Gregory David,1,0,30,29
1651023321541,MATH 10A,A02,083736,Patchell; Gregory David,27,0,30,3
1651023321541,MATH 10A,A03,083737,Patchell; Gregory David,23,0,30,7
1651023327565,MATH 10B,A01,083207,Staff,0,9,30,30
1651023327565,MATH 10B,A02,083208,Staff,0,6,30,30
1651023327565,MATH 10B,B01,083739,Staff,8,0,30,22
1651023327565,MATH 10B,B02,083740,Staff,28,0,30,2
1651023333596,MATH 18,A01,083743,Staff,0,0,30,30
1651023333596,MATH 18,A02,083744,Staff,23,0,30,7
1651023333596,MATH 18,A03,083745,Staff,19,0,30,11
1651023333596,MATH 18,A04,083746,Staff,26,0,30,4
1651023333596,MATH 18,B01,083748,Staff,0,16,30,30
1651023333596,MATH 18,B02,083749,Staff,0,14,30,30
1651023333596,MATH 18,B03,083750,Staff,0,14,30,30
1651023333596,MATH 18,B04,083751,Staff,0,13,30,30
1651023339618,MATH 20A,A01,083754,Staff,18,0,40,22
1651023345641,MATH 20B,A01,083756,Staff,0,14,30,30
1651023345641,MATH 20B,A02,083757,Staff,0,11,30,30
1651023351665,MATH 20C,A01,083760,Staff,0,17,30,30
1651023351665,MATH 20C,A02,083761,Staff,0,15,30,30
1651023351665,MATH 20C,B01,083762,Staff,9,0,30,21
1651023351665,MATH 20C,B02,083763,Staff,28,0,30,2
1651023357689,MATH 20D,A01,083765,Staff,3,1,30,27
1651023357689,MATH 20D,A02,083766,Staff,1,0,30,29
1651023357689,MATH 20D,A03,083767,Staff,22,0,30,8
1651023363715,MATH 20E,A01,083771,Staff,2,0,30,28
1651023363715,MATH 20E,A02,083772,Staff,12,0,30,18
1651023363715,MATH 20E,B01,083773,Staff,0,0,30,30
1651023363715,MATH 20E,B02,083774,Staff,1,0,30,29
1651023369739,MATH 103A,A01,083777,Staff,0,17,30,30
1651023369739,MATH 103A,A02,083778,Staff,0,15,30,30
1651023369739,MATH 103A,B01,083779,Staff,0,15,30,30
1651023369739,MATH 103A,B02,083780,Staff,0,14,30,30
1651023375768,MATH 105,A01,085443,Staff,0,23,30,30
1651023381795,MATH 109,A01,083213,Anzaldo; Leesa B,0,8,30,30
1651023381795,MATH 109,A02,083214,Anzaldo; Leesa B,0,7,30,30
1651023381795,MATH 109,B01,083215,Anzaldo; Leesa B,0,8,30,30
1651023381795,MATH 109,B02,083216,Anzaldo; Leesa B,0,7,30,30
1651023387818,MATH 142A,A01,083219,Chow; Bennett,0,14,30,30
1651023387818,MATH 142A,A02,083220,Chow; Bennett,0,15,30,30
1651023387818,MATH 142A,B01,083221,Chow; Bennett,0,16,30,30
1651023387818,MATH 142A,B02,083222,Chow; Bennett,0,14,30,30
1651023393845,MATH 193A,A01,083224,Staff,0,7,30,30
1651023393845,MATH 193A,A02,083225,Staff,0,7,30,30
1651023393845,MATH 193A,A03,083781,Staff,0,7,30,30
1651023393845,MATH 193A,A04,083782,Staff,0,7,30,30
1651023399867,MATH 197,001,091859,McAuley; Julian John,9998,0,9999,1
1651023405926,COGS 9,A01,083615,Staff,0,19,60,60
1651023411955,COGS 11,A01,083617,Boyle; Mary E. T.,13,0,40,27
1651023417982,COGS 13,A01,083071,Staff,0,40,40,40
1651023424017,COGS 14A,A01,092681,Staff,0,40,100,100
1651023430046,COGS 14B,A01,083073,Cheng; Tzu-Han,0,13,50,50
1651023436070,COGS 17,A01,092677,Staff,7,0,75,68
1651023442093,COGS 100,A01,083619,Staff,0,30,60,60
1651023448120,COGS 101A,A01,083621,Davis; Joshua Daniel,0,29,60,60
1651023454154,COGS 101B,A01,091572,Staff,0,7,60,60
1651023460176,COGS 101C,A01,083625,Delgado; Tania,14,0,30,16
1651023466203,COGS 107A,A01,083627,Boyle; Mary E. T.,0,17,60,60
1651023472228,COGS 118A,A01,083075,Staff,0,10,60,60
1651023478252,CSE 3,A50,083646,Miranda; Gregory Joseph,15,0,38,23
1651023478252,CSE 3,A51,083647,Miranda; Gregory Joseph,36,0,37,1
1651023484275,CSE 8A,A50,083650,Miranda; Gregory Joseph,0,31,40,40
1651023490304,CSE 11,A01,083080,Cao; Yingjun,0,97,40,40
1651023496328,CSE 12,A01,083652,Staff,0,24,100,100
1651023502352,CSE 15L,A01,083654,Staff,0,3,50,50
1651023502352,CSE 15L,A02,083655,Staff,0,3,50,50
1651023508376,CSE 20,A01,083657,Staff,47,0,80,33
1651023514400,CSE 30,A01,083084,Eldon; John,1,40,80,79
1651023520422,CSE 100,A01,083659,Cao; Yingjun,0,72,50,50
1651023526449,CSE 134B,A01,083661,Powell; Thomas Allan,1,39,65,64
1651023532473,CSE 140,A01,083663,Staff,0,14,75,75
1651023538498,CSE 140L,A01,083088,Eldon; John,4,0,100,96
1651023544520,CSE 175,A01,083665,Kumar; Rakesh,0,0,25,25
1651023550543,CSE 190,A00,092507,Dubnov; Shlomo,9,0,20,11
1651023556566,ECE 45,A01,083139,Staff,0,7,60,60
1651023562596,ECE 65,A50,083695,Staff,0,7,30,30
1651023568635,ECE 109,A01,091882,Touri; Behrouz,32,0,70,38
1651023574662,ECE 180,A00,083140,Abi Samra; Nicholas Camill,17,0,30,13
1651023574662,ECE 180,B00,083141,Abi Samra; Nicholas Camill,0,0,30,30
1651023580694,MATH 10A,A01,083735,Patchell; Gregory David,1,0,30,29
1651023580694,MATH 10A,A02,083736,Patchell; Gregory David,27,0,30,3
1651023580694,MATH 10A,A03,083737,Patchell; Gregory David,23,0,30,7
1651023586716,MATH 10B,A01,083207,Staff,0,9,30,30
1651023586716,MATH 10B,A02,083208,Staff,0,6,30,30
1651023586716,MATH 10B,B01,083739,Staff,8,0,30,22
1651023586716,MATH 10B,B02,083740,Staff,28,0,30,2
1651023592747,MATH 18,A01,083743,Staff,0,0,30,30
1651023592747,MATH 18,A02,083744,Staff,23,0,30,7
1651023592747,MATH 18,A03,083745,Staff,19,0,30,11
1651023592747,MATH 18,A04,083746,Staff,26,0,30,4
1651023592747,MATH 18,B01,083748,Staff,0,16,30,30
1651023592747,MATH 18,B02,083749,Staff,0,14,30,30
1651023592747,MATH 18,B03,083750,Staff,0,14,30,30
1651023592747,MATH 18,B04,083751,Staff,0,13,30,30
1651023598772,MATH 20A,A01,083754,Staff,18,0,40,22
1651023604798,MATH 20B,A01,083756,Staff,0,14,30,30
1651023604798,MATH 20B,A02,083757,Staff,0,11,30,30
1651023610837,MATH 20C,A01,083760,Staff,0,17,30,30
1651023610837,MATH 20C,A02,083761,Staff,0,15,30,30
1651023610837,MATH 20C,B01,083762,Staff,9,0,30,21
1651023610837,MATH 20C,B02,083763,Staff,28,0,30,2
1651023616867,MATH 20D,A01,083765,Staff,3,1,30,27
1651023616867,MATH 20D,A02,083766,Staff,1,0,30,29
1651023616867,MATH 20D,A03,083767,Staff,22,0,30,8
1651023622892,MATH 20E,A01,083771,Staff,2,0,30,28
1651023622892,MATH 20E,A02,083772,Staff,12,0,30,18
1651023622892,MATH 20E,B01,083773,Staff,0,0,30,30
1651023622892,MATH 20E,B02,083774,Staff,1,0,30,29
1651023628916,MATH 103A,A01,083777,Staff,0,17,30,30
1651023628916,MATH 103A,A02,083778,Staff,0,15,30,30
1651023628916,MATH 103A,B01,083779,Staff,0,15,30,30
1651023628916,MATH 103A,B02,083780,Staff,0,14,30,30
1651023634947,MATH 105,A01,085443,Staff,0,23,30,30
1651023640984,MATH 109,A01,083213,Anzaldo; Leesa B,0,8,30,30
1651023640984,MATH 109,A02,083214,Anzaldo; Leesa B,0,7,30,30
1651023640984,MATH 109,B01,083215,Anzaldo; Leesa B,0,8,30,30
1651023640984,MATH 109,B02,083216,Anzaldo; Leesa B,0,7,30,30
1651023647010,MATH 142A,A01,083219,Chow; Bennett,0,14,30,30
1651023647010,MATH 142A,A02,083220,Chow; Bennett,0,15,30,30
1651023647010,MATH 142A,B01,083221,Chow; Bennett,0,16,30,30
1651023647010,MATH 142A,B02,083222,Chow; Bennett,0,14,30,30
1651023653047,MATH 193A,A01,083224,Staff,0,7,30,30
1651023653047,MATH 193A,A02,083225,Staff,0,7,30,30
1651023653047,MATH 193A,A03,083781,Staff,0,7,30,30
1651023653047,MATH 193A,A04,083782,Staff,0,7,30,30
1651023659072,MATH 197,001,091859,McAuley; Julian John,9998,0,9999,1
1651023665126,COGS 9,A01,083615,Staff,0,19,60,60
1651023671153,COGS 11,A01,083617,Boyle; Mary E. T.,13,0,40,27
1651023677179,COGS 13,A01,083071,Staff,0,40,40,40
1651023683204,COGS 14A,A01,092681,Staff,0,40,100,100
1651023689227,COGS 14B,A01,083073,Cheng; Tzu-Han,0,13,50,50
1651023695253,COGS 17,A01,092677,Staff,8,0,75,67
1651023701275,COGS 100,A01,083619,Staff,0,30,60,60
1651023707297,COGS 101A,A01,083621,Davis; Joshua Daniel,0,29,60,60
1651023713323,COGS 101B,A01,091572,Staff,0,7,60,60
1651023719347,COGS 101C,A01,083625,Delgado; Tania,14,0,30,16
1651023725374,COGS 107A,A01,083627,Boyle; Mary E. T.,0,17,60,60
1651023731396,COGS 118A,A01,083075,Staff,0,10,60,60
1651023737422,CSE 3,A50,083646,Miranda; Gregory Joseph,15,0,38,23
1651023737422,CSE 3,A51,083647,Miranda; Gregory Joseph,36,0,37,1
1651023743449,CSE 8A,A50,083650,Miranda; Gregory Joseph,0,31,40,40
1651023749563,CSE 11,A01,083080,Cao; Yingjun,0,98,40,40
1651023755589,CSE 12,A01,083652,Staff,0,24,100,100
1651023761617,CSE 15L,A01,083654,Staff,0,3,50,50
1651023761617,CSE 15L,A02,083655,Staff,0,3,50,50
1651023767640,CSE 20,A01,083657,Staff,47,0,80,33
1651023773663,CSE 30,A01,083084,Eldon; John,1,40,80,79
1651023779688,CSE 100,A01,083659,Cao; Yingjun,0,72,50,50
1651023785715,CSE 134B,A01,083661,Powell; Thomas Allan,1,39,65,64
1651023791736,CSE 140,A01,083663,Staff,0,14,75,75
1651023797758,CSE 140L,A01,083088,Eldon; John,4,0,100,96
1651023803781,CSE 175,A01,083665,Kumar; Rakesh,0,0,25,25
1651023809805,CSE 190,A00,092507,Dubnov; Shlomo,9,0,20,11
1651023815832,ECE 45,A01,083139,Staff,0,7,60,60
1651023821854,ECE 65,A50,083695,Staff,0,7,30,30
1651023827881,ECE 109,A01,091882,Touri; Behrouz,32,0,70,38
1651023833909,ECE 180,A00,083140,Abi Samra; Nicholas Camill,17,0,30,13
1651023833909,ECE 180,B00,083141,Abi Samra; Nicholas Camill,0,0,30,30
1651023839939,MATH 10A,A01,083735,Patchell; Gregory David,1,0,30,29
1651023839939,MATH 10A,A02,083736,Patchell; Gregory David,27,0,30,3
1651023839939,MATH 10A,A03,083737,Patchell; Gregory David,23,0,30,7
1651023845962,MATH 10B,A01,083207,Staff,0,9,30,30
1651023845962,MATH 10B,A02,083208,Staff,0,6,30,30
1651023845962,MATH 10B,B01,083739,Staff,8,0,30,22
1651023845962,MATH 10B,B02,083740,Staff,28,0,30,2
1651023851989,MATH 18,A01,083743,Staff,0,0,30,30
1651023851989,MATH 18,A02,083744,Staff,23,0,30,7
1651023851989,MATH 18,A03,083745,Staff,19,0,30,11
1651023851989,MATH 18,A04,083746,Staff,26,0,30,4
1651023851989,MATH 18,B01,083748,Staff,0,16,30,30
1651023851989,MATH 18,B02,083749,Staff,0,14,30,30
1651023851989,MATH 18,B03,083750,Staff,0,14,30,30
1651023851989,MATH 18,B04,083751,Staff,0,13,30,30
1651023858012,MATH 20A,A01,083754,Staff,18,0,40,22
1651023864038,MATH 20B,A01,083756,Staff,0,14,30,30
1651023864038,MATH 20B,A02,083757,Staff,0,11,30,30
1651023870061,MATH 20C,A01,083760,Staff,0,17,30,30
1651023870061,MATH 20C,A02,083761,Staff,0,15,30,30
1651023870061,MATH 20C,B01,083762,Staff,9,0,30,21
1651023870061,MATH 20C,B02,083763,Staff,28,0,30,2
1651023876084,MATH 20D,A01,083765,Staff,3,1,30,27
1651023876084,MATH 20D,A02,083766,Staff,1,0,30,29
1651023876084,MATH 20D,A03,083767,Staff,22,0,30,8
1651023882110,MATH 20E,A01,083771,Staff,2,0,30,28
1651023882110,MATH 20E,A02,083772,Staff,12,0,30,18
1651023882110,MATH 20E,B01,083773,Staff,0,0,30,30
1651023882110,MATH 20E,B02,083774,Staff,1,0,30,29
1651023888134,MATH 103A,A01,083777,Staff,0,17,30,30
1651023888134,MATH 103A,A02,083778,Staff,0,15,30,30
1651023888134,MATH 103A,B01,083779,Staff,0,15,30,30
1651023888134,MATH 103A,B02,083780,Staff,0,14,30,30
1651023894163,MATH 105,A01,085443,Staff,0,23,30,30
1651023900190,MATH 109,A01,083213,Anzaldo; Leesa B,0,8,30,30
1651023900190,MATH 109,A02,083214,Anzaldo; Leesa B,0,7,30,30
1651023900190,MATH 109,B01,083215,Anzaldo; Leesa B,0,8,30,30
1651023900190,MATH 109,B02,083216,Anzaldo; Leesa B,0,7,30,30
1651023906233,MATH 142A,A01,083219,Chow; Bennett,0,14,30,30
1651023906233,MATH 142A,A02,083220,Chow; Bennett,0,15,30,30
1651023906233,MATH 142A,B01,083221,Chow; Bennett,0,16,30,30
1651023906233,MATH 142A,B02,083222,Chow; Bennett,0,14,30,30
1651023912256,MATH 193A,A01,083224,Staff,0,8,30,30
1651023912256,MATH 193A,A02,083225,Staff,0,7,30,30
1651023912256,MATH 193A,A03,083781,Staff,0,7,30,30
1651023912256,MATH 193A,A04,083782,Staff,0,7,30,30
1651023918281,MATH 197,001,091859,McAuley; Julian John,9998,0,9999,1
1651023924345,COGS 9,A01,083615,Staff,0,19,60,60
1651023930371,COGS 11,A01,083617,Boyle; Mary E. T.,13,0,40,27
1651023936395,COGS 13,A01,083071,Staff,0,40,40,40
1651023942416,COGS 14A,A01,092681,Staff,0,40,100,100
1651023948443,COGS 14B,A01,083073,Cheng; Tzu-Han,0,13,50,50
1651023954470,COGS 17,A01,092677,Staff,8,0,75,67
1651023960498,COGS 100,A01,083619,Staff,0,30,60,60
1651023966524,COGS 101A,A01,083621,Davis; Joshua Daniel,0,29,60,60
1651023972553,COGS 101B,A01,091572,Staff,0,7,60,60
1651023978585,COGS 101C,A01,083625,Delgado; Tania,14,0,30,16
1651023984609,COGS 107A,A01,083627,Boyle; Mary E. T.,0,17,60,60
1651023990634,COGS 118A,A01,083075,Staff,0,10,60,60
1651023996658,CSE 3,A50,083646,Miranda; Gregory Joseph,15,0,38,23
1651023996658,CSE 3,A51,083647,Miranda; Gregory Joseph,36,0,37,1
1651024002683,CSE 8A,A50,083650,Miranda; Gregory Joseph,0,31,40,40
1651024008708,CSE 11,A01,083080,Cao; Yingjun,0,98,40,40
1651024014732,CSE 12,A01,083652,Staff,0,24,100,100
1651024020755,CSE 15L,A01,083654,Staff,0,3,50,50
1651024020755,CSE 15L,A02,083655,Staff,0,3,50,50
1651024026802,CSE 20,A01,083657,Staff,47,0,80,33
1651024032830,CSE 30,A01,083084,Eldon; John,1,40,80,79
1651024038854,CSE 100,A01,083659,Cao; Yingjun,0,72,50,50
1651024044876,CSE 134B,A01,083661,Powell; Thomas Allan,1,39,65,64
1651024050914,CSE 140,A01,083663,Staff,0,14,75,75
1651024056937,CSE 140L,A01,083088,Eldon; John,4,0,100,96
1651024062961,CSE 175,A01,083665,Kumar; Rakesh,0,0,25,25
1651024068984,CSE 190,A00,092507,Dubnov; Shlomo,9,0,20,11
1651024075007,ECE 45,A01,083139,Staff,0,7,60,60
1651024081031,ECE 65,A50,083695,Staff,0,7,30,30
1651024087055,ECE 109,A01,091882,Touri; Behrouz,32,0,70,38
1651024093078,ECE 180,A00,083140,Abi Samra; Nicholas Camill,17,0,30,13
1651024093078,ECE 180,B00,083141,Abi Samra; Nicholas Camill,0,0,30,30
1651024099103,MATH 10A,A01,083735,Patchell; Gregory David,1,0,30,29
1651024099103,MATH 10A,A02,083736,Patchell; Gregory David,27,0,30,3
1651024099103,MATH 10A,A03,083737,Patchell; Gregory David,23,0,30,7
1651024105134,MATH 10B,A01,083207,Staff,0,9,30,30
1651024105134,MATH 10B,A02,083208,Staff,0,6,30,30
1651024105134,MATH 10B,B01,083739,Staff,8,0,30,22
1651024105134,MATH 10B,B02,083740,Staff,28,0,30,2
1651024111164,MATH 18,A01,083743,Staff,0,0,30,30
1651024111164,MATH 18,A02,083744,Staff,23,0,30,7
1651024111164,MATH 18,A03,083745,Staff,19,0,30,11
1651024111164,MATH 18,A04,083746,Staff,26,0,30,4
1651024111164,MATH 18,B01,083748,Staff,0,16,30,30
1651024111164,MATH 18,B02,083749,Staff,0,14,30,30
1651024111164,MATH 18,B03,083750,Staff,0,14,30,30
1651024111164,MATH 18,B04,083751,Staff,0,13,30,30
1651024117189,MATH 20A,A01,083754,Staff,18,0,40,22
1651024123216,MATH 20B,A01,083756,Staff,0,14,30,30
1651024123216,MATH 20B,A02,083757,Staff,0,11,30,30
1651024129246,MATH 20C,A01,083760,Staff,0,17,30,30
1651024129246,MATH 20C,A02,083761,Staff,0,15,30,30
1651024129246,MATH 20C,B01,083762,Staff,9,0,30,21
1651024129246,MATH 20C,B02,083763,Staff,28,0,30,2
1651024135276,MATH 20D,A01,083765,Staff,3,1,30,27
1651024135276,MATH 20D,A02,083766,Staff,1,0,30,29
1651024135276,MATH 20D,A03,083767,Staff,22,0,30,8
1651024141299,MATH 20E,A01,083771,Staff,2,0,30,28
1651024141299,MATH 20E,A02,083772,Staff,12,0,30,18
1651024141299,MATH 20E,B01,083773,Staff,0,0,30,30
1651024141299,MATH 20E,B02,083774,Staff,1,0,30,29
1651024147341,MATH 103A,A01,083777,Staff,0,17,30,30
1651024147341,MATH 103A,A02,083778,Staff,0,15,30,30
1651024147341,MATH 103A,B01,083779,Staff,0,15,30,30
1651024147341,MATH 103A,B02,083780,Staff,0,14,30,30
1651024153363,MATH 105,A01,085443,Staff,0,23,30,30
1651024159388,MATH 109,A01,083213,Anzaldo; Leesa B,0,8,30,30
1651024159388,MATH 109,A02,083214,Anzaldo; Leesa B,0,7,30,30
1651024159388,MATH 109,B01,083215,Anzaldo; Leesa B,0,8,30,30
1651024159388,MATH 109,B02,083216,Anzaldo; Leesa B,0,7,30,30
1651024165415,MATH 142A,A01,083219,Chow; Bennett,0,14,30,30
1651024165415,MATH 142A,A02,083220,Chow; Bennett,0,15,30,30
1651024165415,MATH 142A,B01,083221,Chow; Bennett,0,16,30,30
1651024165415,MATH 142A,B02,083222,Chow; Bennett,0,14,30,30
1651024171442,MATH 193A,A01,083224,Staff,0,8,30,30
1651024171442,MATH 193A,A02,083225,Staff,0,7,30,30
1651024171442,MATH 193A,A03,083781,Staff,0,7,30,30
1651024171442,MATH 193A,A04,083782,Staff,0,7,30,30
1651024177465,MATH 197,001,091859,McAuley; Julian John,9998,0,9999,1
1651024183530,COGS 9,A01,083615,Staff,0,19,60,60
1651024189552,COGS 11,A01,083617,Boyle; Mary E. T.,13,0,40,27
1651024195575,COGS 13,A01,083071,Staff,0,40,40,40
1651024201598,COGS 14A,A01,092681,Staff,0,40,100,100
1651024207625,COGS 14B,A01,083073,Cheng; Tzu-Han,0,13,50,50
1651024213652,COGS 17,A01,092677,Staff,8,0,75,67
1651024219682,COGS 100,A01,083619,Staff,0,30,60,60
1651024225708,COGS 101A,A01,083621,Davis; Joshua Daniel,0,29,60,60
1651024231733,COGS 101B,A01,091572,Staff,0,7,60,60
1651024237755,COGS 101C,A01,083625,Delgado; Tania,14,0,30,16
1651024243777,COGS 107A,A01,083627,Boyle; Mary E. T.,0,17,60,60
1651024249800,COGS 118A,A01,083075,Staff,0,10,60,60
1651024255827,CSE 3,A50,083646,Miranda; Gregory Joseph,15,0,38,23
1651024255827,CSE 3,A51,083647,Miranda; Gregory Joseph,36,0,37,1
1651024261850,CSE 8A,A50,083650,Miranda; Gregory Joseph,0,31,40,40
1651024267871,CSE 11,A01,083080,Cao; Yingjun,0,98,40,40
1651024273895,CSE 12,A01,083652,Staff,0,24,100,100
1651024279919,CSE 15L,A01,083654,Staff,0,3,50,50
1651024279919,CSE 15L,A02,083655,Staff,0,3,50,50
1651024285942,CSE 20,A01,083657,Staff,47,0,80,33
1651024291965,CSE 30,A01,083084,Eldon; John,1,40,80,79
1651024297989,CSE 100,A01,083659,Cao; Yingjun,0,72,50,50
1651024304011,CSE 134B,A01,083661,Powell; Thomas Allan,1,39,65,64
1651024310036,CSE 140,A01,083663,Staff,0,14,75,75
1651024316063,CSE 140L,A01,083088,Eldon; John,4,0,100,96
1651024322086,CSE 175,A01,083665,Kumar; Rakesh,0,0,25,25
1651024328118,CSE 190,A00,092507,Dubnov; Shlomo,9,0,20,11
1651024334145,ECE 45,A01,083139,Staff,0,7,60,60
1651024340169,ECE 65,A50,083695,Staff,0,7,30,30
1651024346298,ECE 109,A01,091882,Touri; Behrouz,32,0,70,38
1651024352335,ECE 180,A00,083140,Abi Samra; Nicholas Camill,17,0,30,13
1651024352335,ECE 180,B00,083141,Abi Samra; Nicholas Camill,0,0,30,30
1651024358364,MATH 10A,A01,083735,Patchell; Gregory David,1,0,30,29
1651024358364,MATH 10A,A02,083736,Patchell; Gregory David,27,0,30,3
1651024358364,MATH 10A,A03,083737,Patchell; Gregory David,23,0,30,7
1651024364392,MATH 10B,A01,083207,Staff,0,9,30,30
1651024364392,MATH 10B,A02,083208,Staff,0,6,30,30
1651024364392,MATH 10B,B01,083739,Staff,8,0,30,22
1651024364392,MATH 10B,B02,083740,Staff,28,0,30,2
1651024370423,MATH 18,A01,083743,Staff,0,0,30,30
1651024370423,MATH 18,A02,083744,Staff,23,0,30,7
1651024370423,MATH 18,A03,083745,Staff,19,0,30,11
1651024370423,MATH 18,A04,083746,Staff,26,0,30,4
1651024370423,MATH 18,B01,083748,Staff,0,16,30,30
1651024370423,MATH 18,B02,083749,Staff,0,14,30,30
1651024370423,MATH 18,B03,083750,Staff,0,14,30,30
1651024370423,MATH 18,B04,083751,Staff,0,13,30,30
1651024376447,MATH 20A,A01,083754,Staff,18,0,40,22
1651024382477,MATH 20B,A01,083756,Staff,0,14,30,30
1651024382477,MATH 20B,A02,083757,Staff,0,11,30,30
1651024388504,MATH 20C,A01,083760,Staff,0,17,30,30
1651024388504,MATH 20C,A02,083761,Staff,0,15,30,30
1651024388504,MATH 20C,B01,083762,Staff,9,0,30,21
1651024388504,MATH 20C,B02,083763,Staff,28,0,30,2
1651024394530,MATH 20D,A01,083765,Staff,3,1,30,27
1651024394530,MATH 20D,A02,083766,Staff,1,0,30,29
1651024394530,MATH 20D,A03,083767,Staff,22,0,30,8
1651024400553,MATH 20E,A01,083771,Staff,2,0,30,28
1651024400553,MATH 20E,A02,083772,Staff,12,0,30,18
1651024400553,MATH 20E,B01,083773,Staff,0,0,30,30
1651024400553,MATH 20E,B02,083774,Staff,1,0,30,29
1651024406580,MATH 103A,A01,083777,Staff,0,17,30,30
1651024406580,MATH 103A,A02,083778,Staff,0,15,30,30
1651024406580,MATH 103A,B01,083779,Staff,0,15,30,30
1651024406580,MATH 103A,B02,083780,Staff,0,14,30,30
1651024412611,MATH 105,A01,085443,Staff,0,23,30,30
1651024418644,MATH 109,A01,083213,Anzaldo; Leesa B,0,8,30,30
1651024418644,MATH 109,A02,083214,Anzaldo; Leesa B,0,7,30,30
1651024418644,MATH 109,B01,083215,Anzaldo; Leesa B,0,8,30,30
1651024418644,MATH 109,B02,083216,Anzaldo; Leesa B,0,7,30,30
1651024424675,MATH 142A,A01,083219,Chow; Bennett,0,14,30,30
1651024424675,MATH 142A,A02,083220,Chow; Bennett,0,15,30,30
1651024424675,MATH 142A,B01,083221,Chow; Bennett,0,16,30,30
1651024424675,MATH 142A,B02,083222,Chow; Bennett,0,14,30,30
1651024430700,MATH 193A,A01,083224,Staff,0,8,30,30
1651024430700,MATH 193A,A02,083225,Staff,0,7,30,30
1651024430700,MATH 193A,A03,083781,Staff,0,7,30,30
1651024430700,MATH 193A,A04,083782,Staff,0,7,30,30
1651024436722,MATH 197,001,091859,McAuley; Julian John,9998,0,9999,1
1651024442784,COGS 9,A01,083615,Staff,0,19,60,60
1651024448812,COGS 11,A01,083617,Boyle; Mary E. T.,13,0,40,27
1651024454834,COGS 13,A01,083071,Staff,0,40,40,40
1651024460858,COGS 14A,A01,092681,Staff,0,40,100,100
1651024466882,COGS 14B,A01,083073,Cheng; Tzu-Han,0,13,50,50
1651024472905,COGS 17,A01,092677,Staff,8,0,75,67
1651024478934,COGS 100,A01,083619,Staff,0,30,60,60
1651024484958,COGS 101A,A01,083621,Davis; Joshua Daniel,0,29,60,60
1651024490981,COGS 101B,A01,091572,Staff,0,7,60,60
1651024497008,COGS 101C,A01,083625,Delgado; Tania,14,0,30,16
1651024503040,COGS 107A,A01,083627,Boyle; Mary E. T.,0,17,60,60
1651024509067,COGS 118A,A01,083075,Staff,0,10,60,60
1651024515095,CSE 3,A50,083646,Miranda; Gregory Joseph,15,0,38,23
1651024515095,CSE 3,A51,083647,Miranda; Gregory Joseph,36,0,37,1
1651024521125,CSE 8A,A50,083650,Miranda; Gregory Joseph,0,31,40,40
1651024527156,CSE 11,A01,083080,Cao; Yingjun,0,98,40,40
1651024533182,CSE 12,A01,083652,Staff,0,24,100,100
1651024539208,CSE 15L,A01,083654,Staff,0,3,50,50
1651024539208,CSE 15L,A02,083655,Staff,0,3,50,50
1651024545232,CSE 20,A01,083657,Staff,47,0,80,33
1651024551262,CSE 30,A01,083084,Eldon; John,1,40,80,79
1651024557295,CSE 100,A01,083659,Cao; Yingjun,0,72,50,50
1651024563319,CSE 134B,A01,083661,Powell; Thomas Allan,1,39,65,64
1651024569344,CSE 140,A01,083663,Staff,0,14,75,75
1651024575368,CSE 140L,A01,083088,Eldon; John,4,0,100,96
1651024581391,CSE 175,A01,083665,Kumar; Rakesh,0,0,25,25
1651024587415,CSE 190,A00,092507,Dubnov; Shlomo,9,0,20,11
1651024593438,ECE 45,A01,083139,Staff,0,7,60,60
1651024599462,ECE 65,A50,083695,Staff,0,7,30,30
1651024605486,ECE 109,A01,091882,Touri; Behrouz,32,0,70,38
1651024611513,ECE 180,A00,083140,Abi Samra; Nicholas Camill,17,0,30,13
1651024611513,ECE 180,B00,083141,Abi Samra; Nicholas Camill,0,0,30,30
1651024617538,MATH 10A,A01,083735,Patchell; Gregory David,1,0,30,29
1651024617538,MATH 10A,A02,083736,Patchell; Gregory David,27,0,30,3
1651024617538,MATH 10A,A03,083737,Patchell; Gregory David,23,0,30,7
1651024623563,MATH 10B,A01,083207,Staff,0,9,30,30
1651024623563,MATH 10B,A02,083208,Staff,0,6,30,30
1651024623563,MATH 10B,B01,083739,Staff,8,0,30,22
1651024623563,MATH 10B,B02,083740,Staff,28,0,30,2
1651024629606,MATH 18,A01,083743,Staff,0,0,30,30
1651024629606,MATH 18,A02,083744,Staff,23,0,30,7
1651024629606,MATH 18,A03,083745,Staff,19,0,30,11
1651024629606,MATH 18,A04,083746,Staff,26,0,30,4
1651024629606,MATH 18,B01,083748,Staff,0,16,30,30
1651024629606,MATH 18,B02,083749,Staff,0,14,30,30
1651024629606,MATH 18,B03,083750,Staff,0,14,30,30
1651024629606,MATH 18,B04,083751,Staff,0,13,30,30
1651024635631,MATH 20A,A01,083754,Staff,18,0,40,22
1651024641654,MATH 20B,A01,083756,Staff,0,14,30,30
1651024641654,MATH 20B,A02,083757,Staff,0,11,30,30
1651024647678,MATH 20C,A01,083760,Staff,0,17,30,30
1651024647678,MATH 20C,A02,083761,Staff,0,15,30,30
1651024647678,MATH 20C,B01,083762,Staff,9,0,30,21
1651024647678,MATH 20C,B02,083763,Staff,28,0,30,2
1651024653706,MATH 20D,A01,083765,Staff,3,1,30,27
1651024653706,MATH 20D,A02,083766,Staff,1,0,30,29
1651024653706,MATH 20D,A03,083767,Staff,22,0,30,8
1651024659730,MATH 20E,A01,083771,Staff,2,0,30,28
1651024659730,MATH 20E,A02,083772,Staff,12,0,30,18
1651024659730,MATH 20E,B01,083773,Staff,0,0,30,30
1651024659730,MATH 20E,B02,083774,Staff,1,0,30,29
1651024665759,MATH 103A,A01,083777,Staff,0,17,30,30
1651024665759,MATH 103A,A02,083778,Staff,0,15,30,30
1651024665759,MATH 103A,B01,083779,Staff,0,15,30,30
1651024665759,MATH 103A,B02,083780,Staff,0,14,30,30
1651024671787,MATH 105,A01,085443,Staff,0,23,30,30
1651024677811,MATH 109,A01,083213,Anzaldo; Leesa B,0,8,30,30
1651024677811,MATH 109,A02,083214,Anzaldo; Leesa B,0,7,30,30
1651024677811,MATH 109,B01,083215,Anzaldo; Leesa B,0,8,30,30
1651024677811,MATH 109,B02,083216,Anzaldo; Leesa B,0,7,30,30
1651024683840,MATH 142A,A01,083219,Chow; Bennett,0,14,30,30
1651024683840,MATH 142A,A02,083220,Chow; Bennett,0,15,30,30
1651024683840,MATH 142A,B01,083221,Chow; Bennett,0,16,30,30
1651024683840,MATH 142A,B02,083222,Chow; Bennett,0,14,30,30
1651024689864,MATH 193A,A01,083224,Staff,0,8,30,30
1651024689864,MATH 193A,A02,083225,Staff,0,7,30,30
1651024689864,MATH 193A,A03,083781,Staff,0,7,30,30
1651024689864,MATH 193A,A04,083782,Staff,0,7,30,30
1651024695890,MATH 197,001,091859,McAuley; Julian John,9998,0,9999,1
1651024701947,COGS 9,A01,083615,Staff,0,19,60,60
1651024707971,COGS 11,A01,083617,Boyle; Mary E. T.,13,0,40,27
1651024713994,COGS 13,A01,083071,Staff,0,40,40,40
1651024720018,COGS 14A,A01,092681,Staff,0,40,100,100
1651024726042,COGS 14B,A01,083073,Cheng; Tzu-Han,0,13,50,50
1651024732068,COGS 17,A01,092677,Staff,8,0,75,67
1651024738091,COGS 100,A01,083619,Staff,0,30,60,60
1651024744115,COGS 101A,A01,083621,Davis; Joshua Daniel,0,29,60,60
1651024750141,COGS 101B,A01,091572,Staff,0,7,60,60
1651024756163,COGS 101C,A01,083625,Delgado; Tania,14,0,30,16
1651024762187,COGS 107A,A01,083627,Boyle; Mary E. T.,0,17,60,60
1651024768210,COGS 118A,A01,083075,Staff,0,10,60,60
1651024774233,CSE 3,A50,083646,Miranda; Gregory Joseph,15,0,38,23
1651024774233,CSE 3,A51,083647,Miranda; Gregory Joseph,36,0,37,1
1651024780257,CSE 8A,A50,083650,Miranda; Gregory Joseph,0,31,40,40
1651024786280,CSE 11,A01,083080,Cao; Yingjun,0,98,40,40
1651024792307,CSE 12,A01,083652,Staff,0,24,100,100
1651024798334,CSE 15L,A01,083654,Staff,0,3,50,50
1651024798334,CSE 15L,A02,083655,Staff,0,3,50,50
1651024804357,CSE 20,A01,083657,Staff,47,0,80,33
1651024810384,CSE 30,A01,083084,Eldon; John,1,40,80,79
1651024816410,CSE 100,A01,083659,Cao; Yingjun,0,72,50,50
1651024822433,CSE 134B,A01,083661,Powell; Thomas Allan,1,39,65,64
1651024828455,CSE 140,A01,083663,Staff,0,14,75,75
1651024834482,CSE 140L,A01,083088,Eldon; John,4,0,100,96
1651024840513,CSE 175,A01,083665,Kumar; Rakesh,0,0,25,25
1651024846540,CSE 190,A00,092507,Dubnov; Shlomo,9,0,20,11
1651024852572,ECE 45,A01,083139,Staff,0,7,60,60
1651024858602,ECE 65,A50,083695,Staff,0,7,30,30
1651024864626,ECE 109,A01,091882,Touri; Behrouz,32,0,70,38
1651024870656,ECE 180,A00,083140,Abi Samra; Nicholas Camill,17,0,30,13
1651024870656,ECE 180,B00,083141,Abi Samra; Nicholas Camill,0,0,30,30
1651024876685,MATH 10A,A01,083735,Patchell; Gregory David,1,0,30,29
1651024876685,MATH 10A,A02,083736,Patchell; Gregory David,27,0,30,3
1651024876685,MATH 10A,A03,083737,Patchell; Gregory David,23,0,30,7
1651024882712,MATH 10B,A01,083207,Staff,0,9,30,30
1651024882712,MATH 10B,A02,083208,Staff,0,6,30,30
1651024882712,MATH 10B,B01,083739,Staff,8,0,30,22
1651024882712,MATH 10B,B02,083740,Staff,28,0,30,2
1651024888741,MATH 18,A01,083743,Staff,0,0,30,30
1651024888741,MATH 18,A02,083744,Staff,23,0,30,7
1651024888741,MATH 18,A03,083745,Staff,19,0,30,11
1651024888741,MATH 18,A04,083746,Staff,26,0,30,4
1651024888741,MATH 18,B01,083748,Staff,0,16,30,30
1651024888741,MATH 18,B02,083749,Staff,0,14,30,30
1651024888741,MATH 18,B03,083750,Staff,0,14,30,30
1651024888741,MATH 18,B04,083751,Staff,0,13,30,30
1651024894768,MATH 20A,A01,083754,Staff,18,0,40,22
1651024900796,MATH 20B,A01,083756,Staff,0,14,30,30
1651024900796,MATH 20B,A02,083757,Staff,0,11,30,30
1651024906824,MATH 20C,A01,083760,Staff,0,17,30,30
1651024906824,MATH 20C,A02,083761,Staff,0,15,30,30
1651024906824,MATH 20C,B01,083762,Staff,9,0,30,21
1651024906824,MATH 20C,B02,083763,Staff,28,0,30,2
1651024912851,MATH 20D,A01,083765,Staff,3,1,30,27
1651024912851,MATH 20D,A02,083766,Staff,1,0,30,29
1651024912851,MATH 20D,A03,083767,Staff,22,0,30,8
1651024918882,MATH 20E,A01,083771,Staff,2,0,30,28
1651024918882,MATH 20E,A02,083772,Staff,12,0,30,18
1651024918882,MATH 20E,B01,083773,Staff,0,0,30,30
1651024918882,MATH 20E,B02,083774,Staff,1,0,30,29
1651024924907,MATH 103A,A01,083777,Staff,0,17,30,30
1651024924907,MATH 103A,A02,083778,Staff,0,15,30,30
1651024924907,MATH 103A,B01,083779,Staff,0,15,30,30
1651024924907,MATH 103A,B02,083780,Staff,0,14,30,30
1651024930933,MATH 105,A01,085443,Staff,0,23,30,30
1651024936959,MATH 109,A01,083213,Anzaldo; Leesa B,0,8,30,30
1651024936959,MATH 109,A02,083214,Anzaldo; Leesa B,0,7,30,30
1651024936959,MATH 109,B01,083215,Anzaldo; Leesa B,0,8,30,30
1651024936959,MATH 109,B02,083216,Anzaldo; Leesa B,0,7,30,30
1651024943077,MATH 142A,A01,083219,Chow; Bennett,0,14,30,30
1651024943077,MATH 142A,A02,083220,Chow; Bennett,0,15,30,30
1651024943077,MATH 142A,B01,083221,Chow; Bennett,0,16,30,30
1651024943077,MATH 142A,B02,083222,Chow; Bennett,0,14,30,30
1651024949103,MATH 193A,A01,083224,Staff,0,8,30,30
1651024949103,MATH 193A,A02,083225,Staff,0,7,30,30
1651024949103,MATH 193A,A03,083781,Staff,0,7,30,30
1651024949103,MATH 193A,A04,083782,Staff,0,7,30,30
1651024955125,MATH 197,001,091859,McAuley; Julian John,9998,0,9999,1
1651024961176,COGS 9,A01,083615,Staff,0,19,60,60
1651024967202,COGS 11,A01,083617,Boyle; Mary E. T.,13,0,40,27
1651024973226,COGS 13,A01,083071,Staff,0,40,40,40
1651024979256,COGS 14A,A01,092681,Staff,0,40,100,100
1651024985283,COGS 14B,A01,083073,Cheng; Tzu-Han,0,13,50,50
1651024991307,COGS 17,A01,092677,Staff,8,0,75,67
1651024997331,COGS 100,A01,083619,Staff,0,30,60,60
1651025003359,COGS 101A,A01,083621,Davis; Joshua Daniel,0,29,60,60
1651025009382,COGS 101B,A01,091572,Staff,0,7,60,60
1651025015406,COGS 101C,A01,083625,Delgado; Tania,14,0,30,16
1651025021430,COGS 107A,A01,083627,Boyle; Mary E. T.,0,17,60,60
1651025027452,COGS 118A,A01,083075,Staff,0,10,60,60
1651025033478,CSE 3,A50,083646,Miranda; Gregory Joseph,15,0,38,23
1651025033478,CSE 3,A51,083647,Miranda; Gregory Joseph,36,0,37,1
1651025039514,CSE 8A,A50,083650,Miranda; Gregory Joseph,0,31,40,40
1651025045535,CSE 11,A01,083080,Cao; Yingjun,0,98,40,40
1651025051561,CSE 12,A01,083652,Staff,0,24,100,100
1651025057587,CSE 15L,A01,083654,Staff,0,3,50,50
1651025057587,CSE 15L,A02,083655,Staff,0,3,50,50
1651025063611,CSE 20,A01,083657,Staff,47,0,80,33
1651025069636,CSE 30,A01,083084,Eldon; John,1,40,80,79
1651025075660,CSE 100,A01,083659,Cao; Yingjun,0,72,50,50
1651025081682,CSE 134B,A01,083661,Powell; Thomas Allan,1,39,65,64
1651025087705,CSE 140,A01,083663,Staff,0,14,75,75
1651025093730,CSE 140L,A01,083088,Eldon; John,4,0,100,96
1651025099753,CSE 175,A01,083665,Kumar; Rakesh,0,0,25,25
1651025105776,CSE 190,A00,092507,Dubnov; Shlomo,9,0,20,11
1651025111804,ECE 45,A01,083139,Staff,0,7,60,60
1651025117842,ECE 65,A50,083695,Staff,0,7,30,30
1651025123868,ECE 109,A01,091882,Touri; Behrouz,32,0,70,38
1651025129895,ECE 180,A00,083140,Abi Samra; Nicholas Camill,17,0,30,13
1651025129895,ECE 180,B00,083141,Abi Samra; Nicholas Camill,0,0,30,30
1651025135929,MATH 10A,A01,083735,Patchell; Gregory David,1,0,30,29
1651025135929,MATH 10A,A02,083736,Patchell; Gregory David,27,0,30,3
1651025135929,MATH 10A,A03,083737,Patchell; Gregory David,23,0,30,7
1651025141953,MATH 10B,A01,083207,Staff,0,9,30,30
1651025141953,MATH 10B,A02,083208,Staff,0,6,30,30
1651025141953,MATH 10B,B01,083739,Staff,8,0,30,22
1651025141953,MATH 10B,B02,083740,Staff,28,0,30,2
1651025147983,MATH 18,A01,083743,Staff,0,0,30,30
1651025147983,MATH 18,A02,083744,Staff,23,0,30,7
1651025147983,MATH 18,A03,083745,Staff,19,0,30,11
1651025147983,MATH 18,A04,083746,Staff,26,0,30,4
1651025147983,MATH 18,B01,083748,Staff,0,16,30,30
1651025147983,MATH 18,B02,083749,Staff,0,14,30,30
1651025147983,MATH 18,B03,083750,Staff,0,14,30,30
1651025147983,MATH 18,B04,083751,Staff,0,13,30,30
1651025154007,MATH 20A,A01,083754,Staff,18,0,40,22
1651025160031,MATH 20B,A01,083756,Staff,0,14,30,30
1651025160031,MATH 20B,A02,083757,Staff,0,11,30,30
1651025166061,MATH 20C,A01,083760,Staff,0,17,30,30
1651025166061,MATH 20C,A02,083761,Staff,0,15,30,30
1651025166061,MATH 20C,B01,083762,Staff,9,0,30,21
1651025166061,MATH 20C,B02,083763,Staff,28,0,30,2
1651025172084,MATH 20D,A01,083765,Staff,3,1,30,27
1651025172084,MATH 20D,A02,083766,Staff,1,0,30,29
1651025172084,MATH 20D,A03,083767,Staff,22,0,30,8
1651025178112,MATH 20E,A01,083771,Staff,2,0,30,28
1651025178112,MATH 20E,A02,083772,Staff,12,0,30,18
1651025178112,MATH 20E,B01,083773,Staff,0,0,30,30
1651025178112,MATH 20E,B02,083774,Staff,1,0,30,29
1651025184139,MATH 103A,A01,083777,Staff,0,17,30,30
1651025184139,MATH 103A,A02,083778,Staff,0,15,30,30
1651025184139,MATH 103A,B01,083779,Staff,0,15,30,30
1651025184139,MATH 103A,B02,083780,Staff,0,14,30,30
1651025190170,MATH 105,A01,085443,Staff,0,23,30,30
1651025196195,MATH 109,A01,083213,Anzaldo; Leesa B,0,8,30,30
1651025196195,MATH 109,A02,083214,Anzaldo; Leesa B,0,7,30,30
1651025196195,MATH 109,B01,083215,Anzaldo; Leesa B,0,8,30,30
1651025196195,MATH 109,B02,083216,Anzaldo; Leesa B,0,7,30,30
1651025202218,MATH 142A,A01,083219,Chow; Bennett,0,14,30,30
1651025202218,MATH 142A,A02,083220,Chow; Bennett,0,15,30,30
1651025202218,MATH 142A,B01,083221,Chow; Bennett,0,16,30,30
1651025202218,MATH 142A,B02,083222,Chow; Bennett,0,14,30,30
1651025208252,MATH 193A,A01,083224,Staff,0,8,30,30
1651025208252,MATH 193A,A02,083225,Staff,0,7,30,30
1651025208252,MATH 193A,A03,083781,Staff,0,7,30,30
1651025208252,MATH 193A,A04,083782,Staff,0,7,30,30
1651025214275,MATH 197,001,091859,McAuley; Julian John,9998,0,9999,1
1651025220336,COGS 9,A01,083615,Staff,0,19,60,60
1651025226362,COGS 11,A01,083617,Boyle; Mary E. T.,13,0,40,27
1651025232395,COGS 13,A01,083071,Staff,0,40,40,40
1651025238420,COGS 14A,A01,092681,Staff,0,40,100,100
1651025244441,COGS 14B,A01,083073,Cheng; Tzu-Han,0,13,50,50
1651025250464,COGS 17,A01,092677,Staff,8,0,75,67
1651025256505,COGS 100,A01,083619,Staff,0,30,60,60
1651025262529,COGS 101A,A01,083621,Davis; Joshua Daniel,0,29,60,60
1651025268551,COGS 101B,A01,091572,Staff,0,7,60,60
1651025274575,COGS 101C,A01,083625,Delgado; Tania,14,0,30,16
1651025280609,COGS 107A,A01,083627,Boyle; Mary E. T.,0,17,60,60
1651025286639,COGS 118A,A01,083075,Staff,0,10,60,60
1651025292668,CSE 3,A50,083646,Miranda; Gregory Joseph,15,0,38,23
1651025292668,CSE 3,A51,083647,Miranda; Gregory Joseph,36,0,37,1
1651025298690,CSE 8A,A50,083650,Miranda; Gregory Joseph,0,31,40,40
1651025304714,CSE 11,A01,083080,Cao; Yingjun,0,98,40,40
1651025310738,CSE 12,A01,083652,Staff,0,24,100,100
1651025316762,CSE 15L,A01,083654,Staff,0,3,50,50
1651025316762,CSE 15L,A02,083655,Staff,0,3,50,50
1651025322786,CSE 20,A01,083657,Staff,47,0,80,33
1651025334293,CSE 30,A01,083084,Eldon; John,1,40,80,79
1651025340328,CSE 100,A01,083659,Cao; Yingjun,0,72,50,50
1651025346354,CSE 134B,A01,083661,Powell; Thomas Allan,1,39,65,64
1651025352383,CSE 140,A01,083663,Staff,0,14,75,75
1651025358407,CSE 140L,A01,083088,Eldon; John,4,0,100,96
1651025364433,CSE 175,A01,083665,Kumar; Rakesh,0,0,25,25
1651025370460,CSE 190,A00,092507,Dubnov; Shlomo,9,0,20,11
1651025376484,ECE 45,A01,083139,Staff,0,7,60,60
1651025382510,ECE 65,A50,083695,Staff,0,7,30,30
1651025388534,ECE 109,A01,091882,Touri; Behrouz,32,0,70,38
1651025394563,ECE 180,A00,083140,Abi Samra; Nicholas Camill,17,0,30,13
1651025394563,ECE 180,B00,083141,Abi Samra; Nicholas Camill,0,0,30,30
1651025400587,MATH 10A,A01,083735,Patchell; Gregory David,1,0,30,29
1651025400587,MATH 10A,A02,083736,Patchell; Gregory David,27,0,30,3
1651025400587,MATH 10A,A03,083737,Patchell; Gregory David,23,0,30,7
1651025406611,MATH 10B,A01,083207,Staff,0,9,30,30
1651025406611,MATH 10B,A02,083208,Staff,0,6,30,30
1651025406611,MATH 10B,B01,083739,Staff,8,0,30,22
1651025406611,MATH 10B,B02,083740,Staff,28,0,30,2
1651025412637,MATH 18,A01,083743,Staff,0,0,30,30
1651025412637,MATH 18,A02,083744,Staff,23,0,30,7
1651025412637,MATH 18,A03,083745,Staff,19,0,30,11
1651025412637,MATH 18,A04,083746,Staff,26,0,30,4
1651025412637,MATH 18,B01,083748,Staff,0,16,30,30
1651025412637,MATH 18,B02,083749,Staff,0,14,30,30
1651025412637,MATH 18,B03,083750,Staff,0,14,30,30
1651025412637,MATH 18,B04,083751,Staff,0,13,30,30
1651025418673,MATH 20A,A01,083754,Staff,18,0,40,22
1651025424697,MATH 20B,A01,083756,Staff,0,14,30,30
1651025424697,MATH 20B,A02,083757,Staff,0,11,30,30
1651025430729,MATH 20C,A01,083760,Staff,0,17,30,30
1651025430729,MATH 20C,A02,083761,Staff,0,15,30,30
1651025430729,MATH 20C,B01,083762,Staff,8,0,30,22
1651025430729,MATH 20C,B02,083763,Staff,28,0,30,2
1651025436753,MATH 20D,A01,083765,Staff,3,1,30,27
1651025436753,MATH 20D,A02,083766,Staff,1,0,30,29
1651025436753,MATH 20D,A03,083767,Staff,22,0,30,8
1651025442776,MATH 20E,A01,083771,Staff,2,0,30,28
1651025442776,MATH 20E,A02,083772,Staff,12,0,30,18
1651025442776,MATH 20E,B01,083773,Staff,0,0,30,30
1651025442776,MATH 20E,B02,083774,Staff,1,0,30,29
1651025448804,MATH 103A,A01,083777,Staff,0,17,30,30
1651025448804,MATH 103A,A02,083778,Staff,0,15,30,30
1651025448804,MATH 103A,B01,083779,Staff,0,15,30,30
1651025448804,MATH 103A,B02,083780,Staff,0,14,30,30
1651025454831,MATH 105,A01,085443,Staff,0,23,30,30
1651025460860,MATH 109,A01,083213,Anzaldo; Leesa B,0,8,30,30
1651025460860,MATH 109,A02,083214,Anzaldo; Leesa B,0,7,30,30
1651025460860,MATH 109,B01,083215,Anzaldo; Leesa B,0,8,30,30
1651025460860,MATH 109,B02,083216,Anzaldo; Leesa B,0,7,30,30
1651025466885,MATH 142A,A01,083219,Chow; Bennett,0,14,30,30
1651025466885,MATH 142A,A02,083220,Chow; Bennett,0,15,30,30
1651025466885,MATH 142A,B01,083221,Chow; Bennett,0,16,30,30
1651025466885,MATH 142A,B02,083222,Chow; Bennett,0,14,30,30
1651025472914,MATH 193A,A01,083224,Staff,0,8,30,30
1651025472914,MATH 193A,A02,083225,Staff,0,7,30,30
1651025472914,MATH 193A,A03,083781,Staff,0,7,30,30
1651025472914,MATH 193A,A04,083782,Staff,0,7,30,30
1651025478937,MATH 197,001,091859,McAuley; Julian John,9998,0,9999,1
1651025484985,COGS 9,A01,083615,Staff,0,19,60,60
1651025491019,COGS 11,A01,083617,Boyle; Mary E. T.,13,0,40,27
1651025497042,COGS 13,A01,083071,Staff,0,40,40,40
1651025503066,COGS 14A,A01,092681,Staff,0,40,100,100
1651025509090,COGS 14B,A01,083073,Cheng; Tzu-Han,0,13,50,50
1651025515123,COGS 17,A01,092677,Staff,8,0,75,67
1651025521146,COGS 100,A01,083619,Staff,0,30,60,60
1651025527174,COGS 101A,A01,083621,Davis; Joshua Daniel,0,29,60,60
1651025533200,COGS 101B,A01,091572,Staff,0,7,60,60
1651025539311,COGS 101C,A01,083625,Delgado; Tania,14,0,30,16
1651025545334,COGS 107A,A01,083627,Boyle; Mary E. T.,0,17,60,60
1651025551360,COGS 118A,A01,083075,Staff,0,10,60,60
1651025557383,CSE 3,A50,083646,Miranda; Gregory Joseph,15,0,38,23
1651025557383,CSE 3,A51,083647,Miranda; Gregory Joseph,36,0,37,1
1651025563411,CSE 8A,A50,083650,Miranda; Gregory Joseph,0,31,40,40
1651025569436,CSE 11,A01,083080,Cao; Yingjun,0,98,40,40
1651025575459,CSE 12,A01,083652,Staff,0,24,100,100
1651025581488,CSE 15L,A01,083654,Staff,0,3,50,50
1651025581488,CSE 15L,A02,083655,Staff,0,3,50,50
1651025587512,CSE 20,A01,083657,Staff,47,0,80,33
1651025593538,CSE 30,A01,083084,Eldon; John,1,40,80,79
1651025599571,CSE 100,A01,083659,Cao; Yingjun,0,72,50,50
1651025605595,CSE 134B,A01,083661,Powell; Thomas Allan,1,39,65,64
1651025611620,CSE 140,A01,083663,Staff,0,14,75,75
1651025617646,CSE 140L,A01,083088,Eldon; John,4,0,100,96
1651025623672,CSE 175,A01,083665,Kumar; Rakesh,0,0,25,25
1651025629706,CSE 190,A00,092507,Dubnov; Shlomo,9,0,20,11
1651025635729,ECE 45,A01,083139,Staff,0,7,60,60
1651025641777,ECE 65,A50,083695,Staff,0,7,30,30
1651025647807,ECE 109,A01,091882,Touri; Behrouz,32,0,70,38
1651025653829,ECE 180,A00,083140,Abi Samra; Nicholas Camill,17,0,30,13
1651025653829,ECE 180,B00,083141,Abi Samra; Nicholas Camill,0,0,30,30
1651025659867,MATH 10A,A01,083735,Patchell; Gregory David,1,0,30,29
1651025659867,MATH 10A,A02,083736,Patchell; Gregory David,27,0,30,3
1651025659867,MATH 10A,A03,083737,Patchell; Gregory David,23,0,30,7
1651025665890,MATH 10B,A01,083207,Staff,0,9,30,30
1651025665890,MATH 10B,A02,083208,Staff,0,6,30,30
1651025665890,MATH 10B,B01,083739,Staff,8,0,30,22
1651025665890,MATH 10B,B02,083740,Staff,28,0,30,2
1651025671920,MATH 18,A01,083743,Staff,0,0,30,30
1651025671920,MATH 18,A02,083744,Staff,23,0,30,7
1651025671920,MATH 18,A03,083745,Staff,19,0,30,11
1651025671920,MATH 18,A04,083746,Staff,26,0,30,4
1651025671920,MATH 18,B01,083748,Staff,0,16,30,30
1651025671920,MATH 18,B02,083749,Staff,0,14,30,30
1651025671920,MATH 18,B03,083750,Staff,0,14,30,30
1651025671920,MATH 18,B04,083751,Staff,0,13,30,30
1651025677946,MATH 20A,A01,083754,Staff,18,0,40,22
1651025683968,MATH 20B,A01,083756,Staff,0,14,30,30
1651025683968,MATH 20B,A02,083757,Staff,0,11,30,30
1651025689995,MATH 20C,A01,083760,Staff,0,17,30,30
1651025689995,MATH 20C,A02,083761,Staff,0,15,30,30
1651025689995,MATH 20C,B01,083762,Staff,8,0,30,22
1651025689995,MATH 20C,B02,083763,Staff,28,0,30,2
1651025696021,MATH 20D,A01,083765,Staff,3,1,30,27
1651025696021,MATH 20D,A02,083766,Staff,1,0,30,29
1651025696021,MATH 20D,A03,083767,Staff,22,0,30,8
1651025702055,MATH 20E,A01,083771,Staff,2,0,30,28
1651025702055,MATH 20E,A02,083772,Staff,12,0,30,18
1651025702055,MATH 20E,B01,083773,Staff,0,0,30,30
1651025702055,MATH 20E,B02,083774,Staff,1,0,30,29
1651025708084,MATH 103A,A01,083777,Staff,0,17,30,30
1651025708084,MATH 103A,A02,083778,Staff,0,15,30,30
1651025708084,MATH 103A,B01,083779,Staff,0,15,30,30
1651025708084,MATH 103A,B02,083780,Staff,0,14,30,30
1651025714123,MATH 105,A01,085443,Staff,0,23,30,30
1651025720146,MATH 109,A01,083213,Anzaldo; Leesa B,0,8,30,30
1651025720146,MATH 109,A02,083214,Anzaldo; Leesa B,0,7,30,30
1651025720146,MATH 109,B01,083215,Anzaldo; Leesa B,0,8,30,30
1651025720146,MATH 109,B02,083216,Anzaldo; Leesa B,0,7,30,30
1651025726175,MATH 142A,A01,083219,Chow; Bennett,0,14,30,30
1651025726175,MATH 142A,A02,083220,Chow; Bennett,0,15,30,30
1651025726175,MATH 142A,B01,083221,Chow; Bennett,0,16,30,30
1651025726175,MATH 142A,B02,083222,Chow; Bennett,0,14,30,30
1651025732201,MATH 193A,A01,083224,Staff,0,8,30,30
1651025732201,MATH 193A,A02,083225,Staff,0,7,30,30
1651025732201,MATH 193A,A03,083781,Staff,0,7,30,30
1651025732201,MATH 193A,A04,083782,Staff,0,7,30,30
1651025738230,MATH 197,001,091859,McAuley; Julian John,9998,0,9999,1
1651025744290,COGS 9,A01,083615,Staff,0,19,60,60
1651025750314,COGS 11,A01,083617,Boyle; Mary E. T.,13,0,40,27
1651025756338,COGS 13,A01,083071,Staff,0,40,40,40
1651025762366,COGS 14A,A01,092681,Staff,0,40,100,100
1651025768389,COGS 14B,A01,083073,Cheng; Tzu-Han,0,13,50,50
1651025774416,COGS 17,A01,092677,Staff,8,0,75,67
1651025780439,COGS 100,A01,083619,Staff,0,30,60,60
1651025786465,COGS 101A,A01,083621,Davis; Joshua Daniel,0,29,60,60
1651025792487,COGS 101B,A01,091572,Staff,0,7,60,60
1651025798520,COGS 101C,A01,083625,Delgado; Tania,14,0,30,16
1651025804545,COGS 107A,A01,083627,Boyle; Mary E. T.,0,17,60,60
1651025810567,COGS 118A,A01,083075,Staff,0,10,60,60
1651025816595,CSE 3,A50,083646,Miranda; Gregory Joseph,15,0,38,23
1651025816595,CSE 3,A51,083647,Miranda; Gregory Joseph,36,0,37,1
1651025822635,CSE 8A,A50,083650,Miranda; Gregory Joseph,0,31,40,40
1651025828662,CSE 11,A01,083080,Cao; Yingjun,0,98,40,40
1651025834689,CSE 12,A01,083652,Staff,0,24,100,100
1651025840712,CSE 15L,A01,083654,Staff,0,3,50,50
1651025840712,CSE 15L,A02,083655,Staff,0,3,50,50
1651025846743,CSE 20,A01,083657,Staff,47,0,80,33
1651025852767,CSE 30,A01,083084,Eldon; John,1,40,80,79
1651025858794,CSE 100,A01,083659,Cao; Yingjun,0,72,50,50
1651025864820,CSE 134B,A01,083661,Powell; Thomas Allan,1,39,65,64
1651025870846,CSE 140,A01,083663,Staff,0,14,75,75
1651025876870,CSE 140L,A01,083088,Eldon; John,4,0,100,96
1651025882897,CSE 175,A01,083665,Kumar; Rakesh,0,0,25,25
1651025888928,CSE 190,A00,092507,Dubnov; Shlomo,9,0,20,11
1651025894955,ECE 45,A01,083139,Staff,0,7,60,60
1651025900979,ECE 65,A50,083695,Staff,0,7,30,30
1651025907006,ECE 109,A01,091882,Touri; Behrouz,32,0,70,38
1651025913030,ECE 180,A00,083140,Abi Samra; Nicholas Camill,17,0,30,13
1651025913030,ECE 180,B00,083141,Abi Samra; Nicholas Camill,0,0,30,30
1651025919062,MATH 10A,A01,083735,Patchell; Gregory David,1,0,30,29
1651025919062,MATH 10A,A02,083736,Patchell; Gregory David,27,0,30,3
1651025919062,MATH 10A,A03,083737,Patchell; Gregory David,23,0,30,7
1651025925089,MATH 10B,A01,083207,Staff,0,9,30,30
1651025925089,MATH 10B,A02,083208,Staff,0,6,30,30
1651025925089,MATH 10B,B01,083739,Staff,8,0,30,22
1651025925089,MATH 10B,B02,083740,Staff,28,0,30,2
1651025931115,MATH 18,A01,083743,Staff,0,0,30,30
1651025931115,MATH 18,A02,083744,Staff,23,0,30,7
1651025931115,MATH 18,A03,083745,Staff,19,0,30,11
1651025931115,MATH 18,A04,083746,Staff,26,0,30,4
1651025931115,MATH 18,B01,083748,Staff,0,16,30,30
1651025931115,MATH 18,B02,083749,Staff,0,14,30,30
1651025931115,MATH 18,B03,083750,Staff,0,14,30,30
1651025931115,MATH 18,B04,083751,Staff,0,13,30,30
1651025937141,MATH 20A,A01,083754,Staff,18,0,40,22
1651025943165,MATH 20B,A01,083756,Staff,0,14,30,30
1651025943165,MATH 20B,A02,083757,Staff,0,11,30,30
1651025949189,MATH 20C,A01,083760,Staff,0,17,30,30
1651025949189,MATH 20C,A02,083761,Staff,0,15,30,30
1651025949189,MATH 20C,B01,083762,Staff,8,0,30,22
1651025949189,MATH 20C,B02,083763,Staff,28,0,30,2
1651025955217,MATH 20D,A01,083765,Staff,3,1,30,27
1651025955217,MATH 20D,A02,083766,Staff,1,0,30,29
1651025955217,MATH 20D,A03,083767,Staff,22,0,30,8
1651025961241,MATH 20E,A01,083771,Staff,2,0,30,28
1651025961241,MATH 20E,A02,083772,Staff,12,0,30,18
1651025961241,MATH 20E,B01,083773,Staff,0,0,30,30
1651025961241,MATH 20E,B02,083774,Staff,1,0,30,29
1651025967269,MATH 103A,A01,083777,Staff,0,17,30,30
1651025967269,MATH 103A,A02,083778,Staff,0,15,30,30
1651025967269,MATH 103A,B01,083779,Staff,0,15,30,30
1651025967269,MATH 103A,B02,083780,Staff,0,14,30,30
1651025973293,MATH 105,A01,085443,Staff,0,23,30,30
1651025979321,MATH 109,A01,083213,Anzaldo; Leesa B,0,8,30,30
1651025979321,MATH 109,A02,083214,Anzaldo; Leesa B,0,7,30,30
1651025979321,MATH 109,B01,083215,Anzaldo; Leesa B,0,8,30,30
1651025979321,MATH 109,B02,083216,Anzaldo; Leesa B,0,7,30,30
1651025985348,MATH 142A,A01,083219,Chow; Bennett,0,14,30,30
1651025985348,MATH 142A,A02,083220,Chow; Bennett,0,15,30,30
1651025985348,MATH 142A,B01,083221,Chow; Bennett,0,16,30,30
1651025985348,MATH 142A,B02,083222,Chow; Bennett,0,14,30,30
1651025991373,MATH 193A,A01,083224,Staff,0,8,30,30
1651025991373,MATH 193A,A02,083225,Staff,0,7,30,30
1651025991373,MATH 193A,A03,083781,Staff,0,7,30,30
1651025991373,MATH 193A,A04,083782,Staff,0,7,30,30
1651025997395,MATH 197,001,091859,McAuley; Julian John,9998,0,9999,1
1651026003466,COGS 9,A01,083615,Staff,0,19,60,60
1651026009496,COGS 11,A01,083617,Boyle; Mary E. T.,13,0,40,27
1651026015527,COGS 13,A01,083071,Staff,0,40,40,40
1651026021553,COGS 14A,A01,092681,Staff,0,40,100,100
1651026027577,COGS 14B,A01,083073,Cheng; Tzu-Han,0,13,50,50
1651026033603,COGS 17,A01,092677,Staff,8,0,75,67
1651026039635,COGS 100,A01,083619,Staff,0,30,60,60
1651026045659,COGS 101A,A01,083621,Davis; Joshua Daniel,0,29,60,60
1651026051683,COGS 101B,A01,091572,Staff,0,7,60,60
1651026057708,COGS 101C,A01,083625,Delgado; Tania,14,0,30,16
1651026063734,COGS 107A,A01,083627,Boyle; Mary E. T.,0,17,60,60
1651026069762,COGS 118A,A01,083075,Staff,0,10,60,60
1651026075791,CSE 3,A50,083646,Miranda; Gregory Joseph,15,0,38,23
1651026075791,CSE 3,A51,083647,Miranda; Gregory Joseph,36,0,37,1
1651026081816,CSE 8A,A50,083650,Miranda; Gregory Joseph,0,31,40,40
1651026087845,CSE 11,A01,083080,Cao; Yingjun,0,98,40,40
1651026093876,CSE 12,A01,083652,Staff,0,24,100,100
1651026099903,CSE 15L,A01,083654,Staff,0,3,50,50
1651026099903,CSE 15L,A02,083655,Staff,0,3,50,50
1651026105935,CSE 20,A01,083657,Staff,47,0,80,33
1651026111962,CSE 30,A01,083084,Eldon; John,1,40,80,79
1651026117986,CSE 100,A01,083659,Cao; Yingjun,0,72,50,50
1651026124010,CSE 134B,A01,083661,Powell; Thomas Allan,1,39,65,64
1651026130034,CSE 140,A01,083663,Staff,0,14,75,75
1651026136149,CSE 140L,A01,083088,Eldon; John,4,0,100,96
1651026142176,CSE 175,A01,083665,Kumar; Rakesh,0,0,25,25
1651026148200,CSE 190,A00,092507,Dubnov; Shlomo,9,0,20,11
1651026154232,ECE 45,A01,083139,Staff,0,7,60,60
1651026160256,ECE 65,A50,083695,Staff,0,7,30,30
1651026166293,ECE 109,A01,091882,Touri; Behrouz,32,0,70,38
1651026172317,ECE 180,A00,083140,Abi Samra; Nicholas Camill,17,0,30,13
1651026172317,ECE 180,B00,083141,Abi Samra; Nicholas Camill,0,0,30,30
1651026178343,MATH 10A,A01,083735,Patchell; Gregory David,1,0,30,29
1651026178343,MATH 10A,A02,083736,Patchell; Gregory David,27,0,30,3
1651026178343,MATH 10A,A03,083737,Patchell; Gregory David,23,0,30,7
1651026184383,MATH 10B,A01,083207,Staff,0,9,30,30
1651026184383,MATH 10B,A02,083208,Staff,0,6,30,30
1651026184383,MATH 10B,B01,083739,Staff,8,0,30,22
1651026184383,MATH 10B,B02,083740,Staff,28,0,30,2
1651026190410,MATH 18,A01,083743,Staff,0,0,30,30
1651026190410,MATH 18,A02,083744,Staff,23,0,30,7
1651026190410,MATH 18,A03,083745,Staff,19,0,30,11
1651026190410,MATH 18,A04,083746,Staff,26,0,30,4
1651026190410,MATH 18,B01,083748,Staff,0,16,30,30
1651026190410,MATH 18,B02,083749,Staff,0,14,30,30
1651026190410,MATH 18,B03,083750,Staff,0,14,30,30
1651026190410,MATH 18,B04,083751,Staff,0,13,30,30
1651026196433,MATH 20A,A01,083754,Staff,18,0,40,22
1651026202474,MATH 20B,A01,083756,Staff,0,14,30,30
1651026202474,MATH 20B,A02,083757,Staff,0,11,30,30
1651026208499,MATH 20C,A01,083760,Staff,0,17,30,30
1651026208499,MATH 20C,A02,083761,Staff,0,15,30,30
1651026208499,MATH 20C,B01,083762,Staff,8,0,30,22
1651026208499,MATH 20C,B02,083763,Staff,28,0,30,2
1651026214522,MATH 20D,A01,083765,Staff,3,1,30,27
1651026214522,MATH 20D,A02,083766,Staff,1,0,30,29
1651026214522,MATH 20D,A03,083767,Staff,22,0,30,8
1651026220547,MATH 20E,A01,083771,Staff,2,0,30,28
1651026220547,MATH 20E,A02,083772,Staff,12,0,30,18
1651026220547,MATH 20E,B01,083773,Staff,0,0,30,30
1651026220547,MATH 20E,B02,083774,Staff,1,0,30,29
1651026226571,MATH 103A,A01,083777,Staff,0,17,30,30
1651026226571,MATH 103A,A02,083778,Staff,0,15,30,30
1651026226571,MATH 103A,B01,083779,Staff,0,15,30,30
1651026226571,MATH 103A,B02,083780,Staff,0,14,30,30
1651026232594,MATH 105,A01,085443,Staff,0,23,30,30
1651026238626,MATH 109,A01,083213,Anzaldo; Leesa B,0,8,30,30
1651026238626,MATH 109,A02,083214,Anzaldo; Leesa B,0,7,30,30
1651026238626,MATH 109,B01,083215,Anzaldo; Leesa B,0,8,30,30
1651026238626,MATH 109,B02,083216,Anzaldo; Leesa B,0,7,30,30
1651026244650,MATH 142A,A01,083219,Chow; Bennett,0,14,30,30
1651026244650,MATH 142A,A02,083220,Chow; Bennett,0,15,30,30
1651026244650,MATH 142A,B01,083221,Chow; Bennett,0,16,30,30
1651026244650,MATH 142A,B02,083222,Chow; Bennett,0,14,30,30
1651026250682,MATH 193A,A01,083224,Staff,0,8,30,30
1651026250682,MATH 193A,A02,083225,Staff,0,7,30,30
1651026250682,MATH 193A,A03,083781,Staff,0,7,30,30
1651026250682,MATH 193A,A04,083782,Staff,0,7,30,30
1651026256704,MATH 197,001,091859,McAuley; Julian John,9998,0,9999,1
1651026262759,COGS 9,A01,083615,Staff,0,19,60,60
1651026268786,COGS 11,A01,083617,Boyle; Mary E. T.,13,0,40,27
1651026274812,COGS 13,A01,083071,Staff,0,40,40,40
1651026280836,COGS 14A,A01,092681,Staff,0,40,100,100
1651026286859,COGS 14B,A01,083073,Cheng; Tzu-Han,0,13,50,50
1651026292882,COGS 17,A01,092677,Staff,8,0,75,67
1651026298919,COGS 100,A01,083619,Staff,0,30,60,60
1651026304943,COGS 101A,A01,083621,Davis; Joshua Daniel,0,29,60,60
1651026310973,COGS 101B,A01,091572,Staff,0,7,60,60
1651026317000,COGS 101C,A01,083625,Delgado; Tania,14,0,30,16
1651026323024,COGS 107A,A01,083627,Boyle; Mary E. T.,0,17,60,60
1651026329050,COGS 118A,A01,083075,Staff,0,10,60,60
1651026335083,CSE 3,A50,083646,Miranda; Gregory Joseph,15,0,38,23
1651026335083,CSE 3,A51,083647,Miranda; Gregory Joseph,36,0,37,1
1651026341111,CSE 8A,A50,083650,Miranda; Gregory Joseph,0,31,40,40
1651026347136,CSE 11,A01,083080,Cao; Yingjun,0,98,40,40
1651026353164,CSE 12,A01,083652,Staff,0,24,100,100
1651026359196,CSE 15L,A01,083654,Staff,0,3,50,50
1651026359196,CSE 15L,A02,083655,Staff,0,3,50,50
1651026365222,CSE 20,A01,083657,Staff,47,0,80,33
1651026371249,CSE 30,A01,083084,Eldon; John,1,40,80,79
1651026377272,CSE 100,A01,083659,Cao; Yingjun,0,72,50,50
1651026383298,CSE 134B,A01,083661,Powell; Thomas Allan,1,39,65,64
1651026389321,CSE 140,A01,083663,Staff,0,14,75,75
1651026395348,CSE 140L,A01,083088,Eldon; John,4,0,100,96
1651026401400,CSE 175,A01,083665,Kumar; Rakesh,0,0,25,25
1651026407424,CSE 190,A00,092507,Dubnov; Shlomo,9,0,20,11
1651026413449,ECE 45,A01,083139,Staff,0,7,60,60
1651026419471,ECE 65,A50,083695,Staff,0,7,30,30
1651026425494,ECE 109,A01,091882,Touri; Behrouz,32,0,70,38
1651026431517,ECE 180,A00,083140,Abi Samra; Nicholas Camill,17,0,30,13
1651026431517,ECE 180,B00,083141,Abi Samra; Nicholas Camill,0,0,30,30
1651026437543,MATH 10A,A01,083735,Patchell; Gregory David,1,0,30,29
1651026437543,MATH 10A,A02,083736,Patchell; Gregory David,27,0,30,3
1651026437543,MATH 10A,A03,083737,Patchell; Gregory David,23,0,30,7
1651026443567,MATH 10B,A01,083207,Staff,0,9,30,30
1651026443567,MATH 10B,A02,083208,Staff,0,6,30,30
1651026443567,MATH 10B,B01,083739,Staff,8,0,30,22
1651026443567,MATH 10B,B02,083740,Staff,28,0,30,2
1651026449610,MATH 18,A01,083743,Staff,0,0,30,30
1651026449610,MATH 18,A02,083744,Staff,23,0,30,7
1651026449610,MATH 18,A03,083745,Staff,19,0,30,11
1651026449610,MATH 18,A04,083746,Staff,26,0,30,4
1651026449610,MATH 18,B01,083748,Staff,0,16,30,30
1651026449610,MATH 18,B02,083749,Staff,0,14,30,30
1651026449610,MATH 18,B03,083750,Staff,0,14,30,30
1651026449610,MATH 18,B04,083751,Staff,0,13,30,30
1651026455639,MATH 20A,A01,083754,Staff,18,0,40,22
1651026461661,MATH 20B,A01,083756,Staff,0,14,30,30
1651026461661,MATH 20B,A02,083757,Staff,0,11,30,30
1651026467689,MATH 20C,A01,083760,Staff,0,17,30,30
1651026467689,MATH 20C,A02,083761,Staff,0,15,30,30
1651026467689,MATH 20C,B01,083762,Staff,8,0,30,22
1651026467689,MATH 20C,B02,083763,Staff,28,0,30,2
1651026473713,MATH 20D,A01,083765,Staff,3,1,30,27
1651026473713,MATH 20D,A02,083766,Staff,1,0,30,29
1651026473713,MATH 20D,A03,083767,Staff,22,0,30,8
1651026479744,MATH 20E,A01,083771,Staff,2,0,30,28
1651026479744,MATH 20E,A02,083772,Staff,12,0,30,18
1651026479744,MATH 20E,B01,083773,Staff,0,0,30,30
1651026479744,MATH 20E,B02,083774,Staff,1,0,30,29
1651026485784,MATH 103A,A01,083777,Staff,0,17,30,30
1651026485784,MATH 103A,A02,083778,Staff,0,15,30,30
1651026485784,MATH 103A,B01,083779,Staff,0,15,30,30
1651026485784,MATH 103A,B02,083780,Staff,0,14,30,30
1651026491814,MATH 105,A01,085443,Staff,0,23,30,30
1651026497851,MATH 109,A01,083213,Anzaldo; Leesa B,0,8,30,30
1651026497851,MATH 109,A02,083214,Anzaldo; Leesa B,0,7,30,30
1651026497851,MATH 109,B01,083215,Anzaldo; Leesa B,0,8,30,30
1651026497851,MATH 109,B02,083216,Anzaldo; Leesa B,0,7,30,30
1651026503875,MATH 142A,A01,083219,Chow; Bennett,0,14,30,30
1651026503875,MATH 142A,A02,083220,Chow; Bennett,0,15,30,30
1651026503875,MATH 142A,B01,083221,Chow; Bennett,0,16,30,30
1651026503875,MATH 142A,B02,083222,Chow; Bennett,0,14,30,30
1651026509903,MATH 193A,A01,083224,Staff,0,8,30,30
1651026509903,MATH 193A,A02,083225,Staff,0,7,30,30
1651026509903,MATH 193A,A03,083781,Staff,0,7,30,30
1651026509903,MATH 193A,A04,083782,Staff,0,7,30,30
1651026515925,MATH 197,001,091859,McAuley; Julian John,9998,0,9999,1
1651026521993,COGS 9,A01,083615,Staff,0,19,60,60
1651026528021,COGS 11,A01,083617,Boyle; Mary E. T.,13,0,40,27
1651026534048,COGS 13,A01,083071,Staff,0,40,40,40
1651026540072,COGS 14A,A01,092681,Staff,0,40,100,100
1651026546096,COGS 14B,A01,083073,Cheng; Tzu-Han,0,13,50,50
1651026552118,COGS 17,A01,092677,Staff,8,0,75,67
1651026558144,COGS 100,A01,083619,Staff,0,30,60,60
1651026564171,COGS 101A,A01,083621,Davis; Joshua Daniel,0,29,60,60
1651026570204,COGS 101B,A01,091572,Staff,0,7,60,60
1651026576229,COGS 101C,A01,083625,Delgado; Tania,14,0,30,16
1651026582254,COGS 107A,A01,083627,Boyle; Mary E. T.,0,17,60,60
1651026588281,COGS 118A,A01,083075,Staff,0,10,60,60
1651026594306,CSE 3,A50,083646,Miranda; Gregory Joseph,15,0,38,23
1651026594306,CSE 3,A51,083647,Miranda; Gregory Joseph,36,0,37,1
1651026600334,CSE 8A,A50,083650,Miranda; Gregory Joseph,0,31,40,40
1651026606360,CSE 11,A01,083080,Cao; Yingjun,0,98,40,40
1651026612384,CSE 12,A01,083652,Staff,0,24,100,100
1651026618418,CSE 15L,A01,083654,Staff,0,3,50,50
1651026618418,CSE 15L,A02,083655,Staff,0,3,50,50
1651026624448,CSE 20,A01,083657,Staff,47,0,80,33
1651026630472,CSE 30,A01,083084,Eldon; John,1,40,80,79
1651026636496,CSE 100,A01,083659,Cao; Yingjun,0,72,50,50
1651026642523,CSE 134B,A01,083661,Powell; Thomas Allan,1,39,65,64
1651026648545,CSE 140,A01,083663,Staff,0,14,75,75
1651026654573,CSE 140L,A01,083088,Eldon; John,4,0,100,96
1651026660599,CSE 175,A01,083665,Kumar; Rakesh,0,0,25,25
1651026666621,CSE 190,A00,092507,Dubnov; Shlomo,9,0,20,11
1651026672647,ECE 45,A01,083139,Staff,0,7,60,60
1651026678673,ECE 65,A50,083695,Staff,0,7,30,30
1651026684695,ECE 109,A01,091882,Touri; Behrouz,32,0,70,38
1651026690726,ECE 180,A00,083140,Abi Samra; Nicholas Camill,17,0,30,13
1651026690726,ECE 180,B00,083141,Abi Samra; Nicholas Camill,0,0,30,30
1651026696750,MATH 10A,A01,083735,Patchell; Gregory David,1,0,30,29
1651026696750,MATH 10A,A02,083736,Patchell; Gregory David,27,0,30,3
1651026696750,MATH 10A,A03,083737,Patchell; Gregory David,23,0,30,7
1651026702777,MATH 10B,A01,083207,Staff,0,9,30,30
1651026702777,MATH 10B,A02,083208,Staff,0,6,30,30
1651026702777,MATH 10B,B01,083739,Staff,8,0,30,22
1651026702777,MATH 10B,B02,083740,Staff,28,0,30,2
1651026708814,MATH 18,A01,083743,Staff,0,0,30,30
1651026708814,MATH 18,A02,083744,Staff,23,0,30,7
1651026708814,MATH 18,A03,083745,Staff,19,0,30,11
1651026708814,MATH 18,A04,083746,Staff,26,0,30,4
1651026708814,MATH 18,B01,083748,Staff,0,16,30,30
1651026708814,MATH 18,B02,083749,Staff,0,14,30,30
1651026708814,MATH 18,B03,083750,Staff,0,14,30,30
1651026708814,MATH 18,B04,083751,Staff,0,13,30,30
1651026714836,MATH 20A,A01,083754,Staff,18,0,40,22
1651026720863,MATH 20B,A01,083756,Staff,0,14,30,30
1651026720863,MATH 20B,A02,083757,Staff,0,11,30,30
1651026726899,MATH 20C,A01,083760,Staff,0,17,30,30
1651026726899,MATH 20C,A02,083761,Staff,0,15,30,30
1651026726899,MATH 20C,B01,083762,Staff,8,0,30,22
1651026726899,MATH 20C,B02,083763,Staff,28,0,30,2
1651026733021,MATH 20D,A01,083765,Staff,3,1,30,27
1651026733021,MATH 20D,A02,083766,Staff,1,0,30,29
1651026733021,MATH 20D,A03,083767,Staff,22,0,30,8
1651026739050,MATH 20E,A01,083771,Staff,2,0,30,28
1651026739050,MATH 20E,A02,083772,Staff,12,0,30,18
1651026739050,MATH 20E,B01,083773,Staff,0,0,30,30
1651026739050,MATH 20E,B02,083774,Staff,1,0,30,29
1651026745078,MATH 103A,A01,083777,Staff,0,17,30,30
1651026745078,MATH 103A,A02,083778,Staff,0,15,30,30
1651026745078,MATH 103A,B01,083779,Staff,0,15,30,30
1651026745078,MATH 103A,B02,083780,Staff,0,14,30,30
1651026751104,MATH 105,A01,085443,Staff,0,23,30,30
1651026757132,MATH 109,A01,083213,Anzaldo; Leesa B,0,8,30,30
1651026757132,MATH 109,A02,083214,Anzaldo; Leesa B,0,7,30,30
1651026757132,MATH 109,B01,083215,Anzaldo; Leesa B,0,8,30,30
1651026757132,MATH 109,B02,083216,Anzaldo; Leesa B,0,7,30,30
1651026763161,MATH 142A,A01,083219,Chow; Bennett,0,14,30,30
1651026763161,MATH 142A,A02,083220,Chow; Bennett,0,15,30,30
1651026763161,MATH 142A,B01,083221,Chow; Bennett,0,16,30,30
1651026763161,MATH 142A,B02,083222,Chow; Bennett,0,14,30,30
1651026769187,MATH 193A,A01,083224,Staff,0,8,30,30
1651026769187,MATH 193A,A02,083225,Staff,0,7,30,30
1651026769187,MATH 193A,A03,083781,Staff,0,7,30,30
1651026769187,MATH 193A,A04,083782,Staff,0,7,30,30
1651026775209,MATH 197,001,091859,McAuley; Julian John,9998,0,9999,1
1651026781260,COGS 9,A01,083615,Staff,0,19,60,60
1651026787284,COGS 11,A01,083617,Boyle; Mary E. T.,13,0,40,27
1651026793324,COGS 13,A01,083071,Staff,0,40,40,40
1651026799348,COGS 14A,A01,092681,Staff,0,40,100,100
1651026805373,COGS 14B,A01,083073,Cheng; Tzu-Han,0,13,50,50
1651026811399,COGS 17,A01,092677,Staff,8,0,75,67
1651026817424,COGS 100,A01,083619,Staff,0,30,60,60
1651026823449,COGS 101A,A01,083621,Davis; Joshua Daniel,0,29,60,60
1651026829472,COGS 101B,A01,091572,Staff,0,7,60,60
1651026835495,COGS 101C,A01,083625,Delgado; Tania,14,0,30,16
1651026841521,COGS 107A,A01,083627,Boyle; Mary E. T.,0,17,60,60
1651026847545,COGS 118A,A01,083075,Staff,0,10,60,60
1651026853569,CSE 3,A50,083646,Miranda; Gregory Joseph,15,0,38,23
1651026853569,CSE 3,A51,083647,Miranda; Gregory Joseph,36,0,37,1
1651026859593,CSE 8A,A50,083650,Miranda; Gregory Joseph,0,31,40,40
1651026865617,CSE 11,A01,083080,Cao; Yingjun,0,98,40,40
1651026871641,CSE 12,A01,083652,Staff,0,24,100,100
1651026877668,CSE 15L,A01,083654,Staff,0,3,50,50
1651026877668,CSE 15L,A02,083655,Staff,0,3,50,50
1651026883695,CSE 20,A01,083657,Staff,47,0,80,33
1651026889718,CSE 30,A01,083084,Eldon; John,1,40,80,79
1651026895742,CSE 100,A01,083659,Cao; Yingjun,0,72,50,50
1651026901768,CSE 134B,A01,083661,Powell; Thomas Allan,1,39,65,64
1651026907791,CSE 140,A01,083663,Staff,0,14,75,75
1651026913814,CSE 140L,A01,083088,Eldon; John,4,0,100,96
1651026919840,CSE 175,A01,083665,Kumar; Rakesh,0,0,25,25
1651026925866,CSE 190,A00,092507,Dubnov; Shlomo,9,0,20,11
1651026931889,ECE 45,A01,083139,Staff,0,7,60,60
1651026937913,ECE 65,A50,083695,Staff,0,7,30,30
1651026943937,ECE 109,A01,091882,Touri; Behrouz,32,0,70,38
1651026949965,ECE 180,A00,083140,Abi Samra; Nicholas Camill,17,0,30,13
1651026949965,ECE 180,B00,083141,Abi Samra; Nicholas Camill,0,0,30,30
1651026955987,MATH 10A,A01,083735,Patchell; Gregory David,1,0,30,29
1651026955987,MATH 10A,A02,083736,Patchell; Gregory David,27,0,30,3
1651026955987,MATH 10A,A03,083737,Patchell; Gregory David,23,0,30,7
1651026962025,MATH 10B,A01,083207,Staff,0,9,30,30
1651026962025,MATH 10B,A02,083208,Staff,0,6,30,30
1651026962025,MATH 10B,B01,083739,Staff,8,0,30,22
1651026962025,MATH 10B,B02,083740,Staff,28,0,30,2
1651026968056,MATH 18,A01,083743,Staff,0,0,30,30
1651026968056,MATH 18,A02,083744,Staff,23,0,30,7
1651026968056,MATH 18,A03,083745,Staff,19,0,30,11
1651026968056,MATH 18,A04,083746,Staff,26,0,30,4
1651026968056,MATH 18,B01,083748,Staff,0,16,30,30
1651026968056,MATH 18,B02,083749,Staff,0,14,30,30
1651026968056,MATH 18,B03,083750,Staff,0,14,30,30
1651026968056,MATH 18,B04,083751,Staff,0,13,30,30
1651026974093,MATH 20A,A01,083754,Staff,18,0,40,22
1651026980120,MATH 20B,A01,083756,Staff,0,14,30,30
1651026980120,MATH 20B,A02,083757,Staff,0,11,30,30
1651026986147,MATH 20C,A01,083760,Staff,0,17,30,30
1651026986147,MATH 20C,A02,083761,Staff,0,15,30,30
1651026986147,MATH 20C,B01,083762,Staff,8,0,30,22
1651026986147,MATH 20C,B02,083763,Staff,28,0,30,2
1651026992169,MATH 20D,A01,083765,Staff,3,1,30,27
1651026992169,MATH 20D,A02,083766,Staff,1,0,30,29
1651026992169,MATH 20D,A03,083767,Staff,22,0,30,8
1651026998197,MATH 20E,A01,083771,Staff,2,0,30,28
1651026998197,MATH 20E,A02,083772,Staff,12,0,30,18
1651026998197,MATH 20E,B01,083773,Staff,0,0,30,30
1651026998197,MATH 20E,B02,083774,Staff,1,0,30,29
1651027004226,MATH 103A,A01,083777,Staff,0,17,30,30
1651027004226,MATH 103A,A02,083778,Staff,0,15,30,30
1651027004226,MATH 103A,B01,083779,Staff,0,15,30,30
1651027004226,MATH 103A,B02,083780,Staff,0,14,30,30
1651027010253,MATH 105,A01,085443,Staff,0,23,30,30
1651027016280,MATH 109,A01,083213,Anzaldo; Leesa B,0,8,30,30
1651027016280,MATH 109,A02,083214,Anzaldo; Leesa B,0,7,30,30
1651027016280,MATH 109,B01,083215,Anzaldo; Leesa B,0,8,30,30
1651027016280,MATH 109,B02,083216,Anzaldo; Leesa B,0,7,30,30
1651027022304,MATH 142A,A01,083219,Chow; Bennett,0,14,30,30
1651027022304,MATH 142A,A02,083220,Chow; Bennett,0,15,30,30
1651027022304,MATH 142A,B01,083221,Chow; Bennett,0,16,30,30
1651027022304,MATH 142A,B02,083222,Chow; Bennett,0,14,30,30
1651027028327,MATH 193A,A01,083224,Staff,0,8,30,30
1651027028327,MATH 193A,A02,083225,Staff,0,7,30,30
1651027028327,MATH 193A,A03,083781,Staff,0,7,30,30
1651027028327,MATH 193A,A04,083782,Staff,0,7,30,30
1651027034351,MATH 197,001,091859,McAuley; Julian John,9998,0,9999,1
1651027040413,COGS 9,A01,083615,Staff,0,19,60,60
1651027046435,COGS 11,A01,083617,Boyle; Mary E. T.,13,0,40,27
1651027052458,COGS 13,A01,083071,Staff,0,40,40,40
1651027058484,COGS 14A,A01,092681,Staff,0,40,100,100
1651027064510,COGS 14B,A01,083073,Cheng; Tzu-Han,0,13,50,50
1651027070532,COGS 17,A01,092677,Staff,8,0,75,67
1651027076558,COGS 100,A01,083619,Staff,0,30,60,60
1651027082590,COGS 101A,A01,083621,Davis; Joshua Daniel,0,29,60,60
1651027088618,COGS 101B,A01,091572,Staff,0,7,60,60
1651027094650,COGS 101C,A01,083625,Delgado; Tania,14,0,30,16
1651027100679,COGS 107A,A01,083627,Boyle; Mary E. T.,0,17,60,60
1651027106701,COGS 118A,A01,083075,Staff,0,10,60,60
1651027112727,CSE 3,A50,083646,Miranda; Gregory Joseph,15,0,38,23
1651027112727,CSE 3,A51,083647,Miranda; Gregory Joseph,36,0,37,1
1651027118756,CSE 8A,A50,083650,Miranda; Gregory Joseph,0,31,40,40
1651027124779,CSE 11,A01,083080,Cao; Yingjun,0,98,40,40
1651027130805,CSE 12,A01,083652,Staff,0,24,100,100
1651027136829,CSE 15L,A01,083654,Staff,0,3,50,50
1651027136829,CSE 15L,A02,083655,Staff,0,3,50,50
1651027142862,CSE 20,A01,083657,Staff,47,0,80,33
1651027148887,CSE 30,A01,083084,Eldon; John,1,40,80,79
1651027154913,CSE 100,A01,083659,Cao; Yingjun,0,72,50,50
1651027160939,CSE 134B,A01,083661,Powell; Thomas Allan,1,39,65,64
1651027166960,CSE 140,A01,083663,Staff,0,14,75,75
1651027172986,CSE 140L,A01,083088,Eldon; John,4,0,100,96
1651027179007,CSE 175,A01,083665,Kumar; Rakesh,0,0,25,25
1651027185043,CSE 190,A00,092507,Dubnov; Shlomo,9,0,20,11
1651027191069,ECE 45,A01,083139,Staff,0,7,60,60
1651027197093,ECE 65,A50,083695,Staff,0,7,30,30
1651027203120,ECE 109,A01,091882,Touri; Behrouz,32,0,70,38
1651027209144,ECE 180,A00,083140,Abi Samra; Nicholas Camill,17,0,30,13
1651027209144,ECE 180,B00,083141,Abi Samra; Nicholas Camill,0,0,30,30
1651027215174,MATH 10A,A01,083735,Patchell; Gregory David,1,0,30,29
1651027215174,MATH 10A,A02,083736,Patchell; Gregory David,27,0,30,3
1651027215174,MATH 10A,A03,083737,Patchell; Gregory David,23,0,30,7
1651027221203,MATH 10B,A01,083207,Staff,0,9,30,30
1651027221203,MATH 10B,A02,083208,Staff,0,6,30,30
1651027221203,MATH 10B,B01,083739,Staff,8,0,30,22
1651027221203,MATH 10B,B02,083740,Staff,28,0,30,2
1651027227235,MATH 18,A01,083743,Staff,0,0,30,30
1651027227235,MATH 18,A02,083744,Staff,23,0,30,7
1651027227235,MATH 18,A03,083745,Staff,19,0,30,11
1651027227235,MATH 18,A04,083746,Staff,26,0,30,4
1651027227235,MATH 18,B01,083748,Staff,0,16,30,30
1651027227235,MATH 18,B02,083749,Staff,0,14,30,30
1651027227235,MATH 18,B03,083750,Staff,0,14,30,30
1651027227235,MATH 18,B04,083751,Staff,0,13,30,30
1651027233257,MATH 20A,A01,083754,Staff,18,0,40,22
1651027239283,MATH 20B,A01,083756,Staff,0,14,30,30
1651027239283,MATH 20B,A02,083757,Staff,0,11,30,30
1651027245314,MATH 20C,A01,083760,Staff,0,17,30,30
1651027245314,MATH 20C,A02,083761,Staff,0,15,30,30
1651027245314,MATH 20C,B01,083762,Staff,8,0,30,22
1651027245314,MATH 20C,B02,083763,Staff,28,0,30,2
1651027251342,MATH 20D,A01,083765,Staff,3,1,30,27
1651027251342,MATH 20D,A02,083766,Staff,1,0,30,29
1651027251342,MATH 20D,A03,083767,Staff,22,0,30,8
1651027257367,MATH 20E,A01,083771,Staff,2,0,30,28
1651027257367,MATH 20E,A02,083772,Staff,12,0,30,18
1651027257367,MATH 20E,B01,083773,Staff,0,0,30,30
1651027257367,MATH 20E,B02,083774,Staff,1,0,30,29
1651027263392,MATH 103A,A01,083777,Staff,0,17,30,30
1651027263392,MATH 103A,A02,083778,Staff,0,15,30,30
1651027263392,MATH 103A,B01,083779,Staff,0,15,30,30
1651027263392,MATH 103A,B02,083780,Staff,0,14,30,30
1651027269418,MATH 105,A01,085443,Staff,0,23,30,30
1651027275449,MATH 109,A01,083213,Anzaldo; Leesa B,0,8,30,30
1651027275449,MATH 109,A02,083214,Anzaldo; Leesa B,0,7,30,30
1651027275449,MATH 109,B01,083215,Anzaldo; Leesa B,0,8,30,30
1651027275449,MATH 109,B02,083216,Anzaldo; Leesa B,0,7,30,30
1651027281473,MATH 142A,A01,083219,Chow; Bennett,0,14,30,30
1651027281473,MATH 142A,A02,083220,Chow; Bennett,0,15,30,30
1651027281473,MATH 142A,B01,083221,Chow; Bennett,0,16,30,30
1651027281473,MATH 142A,B02,083222,Chow; Bennett,0,14,30,30
1651027287497,MATH 193A,A01,083224,Staff,0,8,30,30
1651027287497,MATH 193A,A02,083225,Staff,0,7,30,30
1651027287497,MATH 193A,A03,083781,Staff,0,7,30,30
1651027287497,MATH 193A,A04,083782,Staff,0,7,30,30
1651027293524,MATH 197,001,091859,McAuley; Julian John,9998,0,9999,1
1651027299573,COGS 9,A01,083615,Staff,0,19,60,60
1651027305597,COGS 11,A01,083617,Boyle; Mary E. T.,13,0,40,27
1651027311621,COGS 13,A01,083071,Staff,0,40,40,40
1651027317647,COGS 14A,A01,092681,Staff,0,40,100,100
1651027323767,COGS 14B,A01,083073,Cheng; Tzu-Han,0,13,50,50
1651027329796,COGS 17,A01,092677,Staff,8,0,75,67
1651027335823,COGS 100,A01,083619,Staff,0,30,60,60
1651027341847,COGS 101A,A01,083621,Davis; Joshua Daniel,0,29,60,60
1651027347871,COGS 101B,A01,091572,Staff,0,7,60,60
1651027353895,COGS 101C,A01,083625,Delgado; Tania,14,0,30,16
1651027359922,COGS 107A,A01,083627,Boyle; Mary E. T.,0,17,60,60
1651027365946,COGS 118A,A01,083075,Staff,0,10,60,60
1651027371974,CSE 3,A50,083646,Miranda; Gregory Joseph,15,0,38,23
1651027371974,CSE 3,A51,083647,Miranda; Gregory Joseph,36,0,37,1
1651027377999,CSE 8A,A50,083650,Miranda; Gregory Joseph,0,31,40,40
1651027384026,CSE 11,A01,083080,Cao; Yingjun,0,98,40,40
1651027390070,CSE 12,A01,083652,Staff,0,24,100,100
1651027396094,CSE 15L,A01,083654,Staff,0,3,50,50
1651027396094,CSE 15L,A02,083655,Staff,0,3,50,50
1651027402128,CSE 20,A01,083657,Staff,47,0,80,33
1651027408150,CSE 30,A01,083084,Eldon; John,1,40,80,79
1651027414174,CSE 100,A01,083659,Cao; Yingjun,0,72,50,50
1651027420197,CSE 134B,A01,083661,Powell; Thomas Allan,1,39,65,64
1651027426225,CSE 140,A01,083663,Staff,0,14,75,75
1651027432257,CSE 140L,A01,083088,Eldon; John,4,0,100,96
1651027438286,CSE 175,A01,083665,Kumar; Rakesh,0,0,25,25
1651027444312,CSE 190,A00,092507,Dubnov; Shlomo,9,0,20,11
1651027450345,ECE 45,A01,083139,Staff,0,7,60,60
1651027456368,ECE 65,A50,083695,Staff,0,7,30,30
1651027462393,ECE 109,A01,091882,Touri; Behrouz,32,0,70,38
1651027468428,ECE 180,A00,083140,Abi Samra; Nicholas Camill,17,0,30,13
1651027468428,ECE 180,B00,083141,Abi Samra; Nicholas Camill,0,0,30,30
1651027474459,MATH 10A,A01,083735,Patchell; Gregory David,1,0,30,29
1651027474459,MATH 10A,A02,083736,Patchell; Gregory David,27,0,30,3
1651027474459,MATH 10A,A03,083737,Patchell; Gregory David,23,0,30,7
1651027480507,MATH 10B,A01,083207,Staff,0,9,30,30
1651027480507,MATH 10B,A02,083208,Staff,0,6,30,30
1651027480507,MATH 10B,B01,083739,Staff,8,0,30,22
1651027480507,MATH 10B,B02,083740,Staff,28,0,30,2
1651027486531,MATH 18,A01,083743,Staff,0,0,30,30
1651027486531,MATH 18,A02,083744,Staff,23,0,30,7
1651027486531,MATH 18,A03,083745,Staff,19,0,30,11
1651027486531,MATH 18,A04,083746,Staff,26,0,30,4
1651027486531,MATH 18,B01,083748,Staff,0,16,30,30
1651027486531,MATH 18,B02,083749,Staff,0,14,30,30
1651027486531,MATH 18,B03,083750,Staff,0,14,30,30
1651027486531,MATH 18,B04,083751,Staff,0,13,30,30
1651027492558,MATH 20A,A01,083754,Staff,18,0,40,22
1651027498586,MATH 20B,A01,083756,Staff,0,14,30,30
1651027498586,MATH 20B,A02,083757,Staff,0,11,30,30
1651027504610,MATH 20C,A01,083760,Staff,0,17,30,30
1651027504610,MATH 20C,A02,083761,Staff,0,15,30,30
1651027504610,MATH 20C,B01,083762,Staff,8,0,30,22
1651027504610,MATH 20C,B02,083763,Staff,28,0,30,2
1651027510637,MATH 20D,A01,083765,Staff,3,1,30,27
1651027510637,MATH 20D,A02,083766,Staff,1,0,30,29
1651027510637,MATH 20D,A03,083767,Staff,22,0,30,8
1651027516660,MATH 20E,A01,083771,Staff,2,0,30,28
1651027516660,MATH 20E,A02,083772,Staff,12,0,30,18
1651027516660,MATH 20E,B01,083773,Staff,0,0,30,30
1651027516660,MATH 20E,B02,083774,Staff,1,0,30,29
1651027522684,MATH 103A,A01,083777,Staff,0,17,30,30
1651027522684,MATH 103A,A02,083778,Staff,0,15,30,30
1651027522684,MATH 103A,B01,083779,Staff,0,15,30,30
1651027522684,MATH 103A,B02,083780,Staff,0,14,30,30
1651027528717,MATH 105,A01,085443,Staff,0,23,30,30
1651027534742,MATH 109,A01,083213,Anzaldo; Leesa B,0,8,30,30
1651027534742,MATH 109,A02,083214,Anzaldo; Leesa B,0,7,30,30
1651027534742,MATH 109,B01,083215,Anzaldo; Leesa B,0,8,30,30
1651027534742,MATH 109,B02,083216,Anzaldo; Leesa B,0,7,30,30
1651027540770,MATH 142A,A01,083219,Chow; Bennett,0,14,30,30
1651027540770,MATH 142A,A02,083220,Chow; Bennett,0,15,30,30
1651027540770,MATH 142A,B01,083221,Chow; Bennett,0,16,30,30
1651027540770,MATH 142A,B02,083222,Chow; Bennett,0,14,30,30
1651027546793,MATH 193A,A01,083224,Staff,0,8,30,30
1651027546793,MATH 193A,A02,083225,Staff,0,7,30,30
1651027546793,MATH 193A,A03,083781,Staff,0,7,30,30
1651027546793,MATH 193A,A04,083782,Staff,0,7,30,30
1651027552816,MATH 197,001,091859,McAuley; Julian John,9998,0,9999,1
1651027558877,COGS 9,A01,083615,Staff,0,19,60,60
1651027564903,COGS 11,A01,083617,Boyle; Mary E. T.,13,0,40,27
1651027570931,COGS 13,A01,083071,Staff,0,40,40,40
1651027576954,COGS 14A,A01,092681,Staff,0,40,100,100
1651027582981,COGS 14B,A01,083073,Cheng; Tzu-Han,0,13,50,50
1651027589005,COGS 17,A01,092677,Staff,8,0,75,67
1651027595029,COGS 100,A01,083619,Staff,0,30,60,60
1651027601055,COGS 101A,A01,083621,Davis; Joshua Daniel,0,29,60,60
1651027607080,COGS 101B,A01,091572,Staff,0,7,60,60
1651027613103,COGS 101C,A01,083625,Delgado; Tania,14,0,30,16
1651027619127,COGS 107A,A01,083627,Boyle; Mary E. T.,0,17,60,60
1651027625151,COGS 118A,A01,083075,Staff,0,10,60,60
1651027631180,CSE 3,A50,083646,Miranda; Gregory Joseph,15,0,38,23
1651027631180,CSE 3,A51,083647,Miranda; Gregory Joseph,36,0,37,1
1651027637216,CSE 8A,A50,083650,Miranda; Gregory Joseph,0,31,40,40
1651027643243,CSE 11,A01,083080,Cao; Yingjun,0,98,40,40
1651027649277,CSE 12,A01,083652,Staff,0,24,100,100
1651027655302,CSE 15L,A01,083654,Staff,0,3,50,50
1651027655302,CSE 15L,A02,083655,Staff,0,3,50,50
1651027661330,CSE 20,A01,083657,Staff,47,0,80,33
1651027667356,CSE 30,A01,083084,Eldon; John,1,40,80,79
1651027673381,CSE 100,A01,083659,Cao; Yingjun,0,72,50,50
1651027679404,CSE 134B,A01,083661,Powell; Thomas Allan,1,39,65,64
1651027685429,CSE 140,A01,083663,Staff,0,14,75,75
1651027691463,CSE 140L,A01,083088,Eldon; John,4,0,100,96
1651027697490,CSE 175,A01,083665,Kumar; Rakesh,0,0,25,25
1651027703526,CSE 190,A00,092507,Dubnov; Shlomo,9,0,20,11
1651027709553,ECE 45,A01,083139,Staff,0,7,60,60
1651027715577,ECE 65,A50,083695,Staff,0,7,30,30
1651027721604,ECE 109,A01,091882,Touri; Behrouz,32,0,70,38
1651027727629,ECE 180,A00,083140,Abi Samra; Nicholas Camill,17,0,30,13
1651027727629,ECE 180,B00,083141,Abi Samra; Nicholas Camill,0,0,30,30
1651027733655,MATH 10A,A01,083735,Patchell; Gregory David,1,0,30,29
1651027733655,MATH 10A,A02,083736,Patchell; Gregory David,27,0,30,3
1651027733655,MATH 10A,A03,083737,Patchell; Gregory David,23,0,30,7
1651027739683,MATH 10B,A01,083207,Staff,0,9,30,30
1651027739683,MATH 10B,A02,083208,Staff,0,6,30,30
1651027739683,MATH 10B,B01,083739,Staff,8,0,30,22
1651027739683,MATH 10B,B02,083740,Staff,28,0,30,2
1651027745717,MATH 18,A01,083743,Staff,0,0,30,30
1651027745717,MATH 18,A02,083744,Staff,23,0,30,7
1651027745717,MATH 18,A03,083745,Staff,19,0,30,11
1651027745717,MATH 18,A04,083746,Staff,26,0,30,4
1651027745717,MATH 18,B01,083748,Staff,0,16,30,30
1651027745717,MATH 18,B02,083749,Staff,0,14,30,30
1651027745717,MATH 18,B03,083750,Staff,0,14,30,30
1651027745717,MATH 18,B04,083751,Staff,0,13,30,30
1651027751744,MATH 20A,A01,083754,Staff,18,0,40,22
1651027757774,MATH 20B,A01,083756,Staff,0,14,30,30
1651027757774,MATH 20B,A02,083757,Staff,0,11,30,30
1651027763802,MATH 20C,A01,083760,Staff,0,17,30,30
1651027763802,MATH 20C,A02,083761,Staff,0,15,30,30
1651027763802,MATH 20C,B01,083762,Staff,8,0,30,22
1651027763802,MATH 20C,B02,083763,Staff,28,0,30,2
1651027769823,MATH 20D,A01,083765,Staff,3,1,30,27
1651027769823,MATH 20D,A02,083766,Staff,1,0,30,29
1651027769823,MATH 20D,A03,083767,Staff,22,0,30,8
1651027775852,MATH 20E,A01,083771,Staff,2,0,30,28
1651027775852,MATH 20E,A02,083772,Staff,12,0,30,18
1651027775852,MATH 20E,B01,083773,Staff,0,0,30,30
1651027775852,MATH 20E,B02,083774,Staff,1,0,30,29
1651027781875,MATH 103A,A01,083777,Staff,0,17,30,30
1651027781875,MATH 103A,A02,083778,Staff,0,15,30,30
1651027781875,MATH 103A,B01,083779,Staff,0,15,30,30
1651027781875,MATH 103A,B02,083780,Staff,0,14,30,30
1651027787901,MATH 105,A01,085443,Staff,0,23,30,30
1651027793931,MATH 109,A01,083213,Anzaldo; Leesa B,0,8,30,30
1651027793931,MATH 109,A02,083214,Anzaldo; Leesa B,0,7,30,30
1651027793931,MATH 109,B01,083215,Anzaldo; Leesa B,0,8,30,30
1651027793931,MATH 109,B02,083216,Anzaldo; Leesa B,0,7,30,30
1651027799956,MATH 142A,A01,083219,Chow; Bennett,0,14,30,30
1651027799956,MATH 142A,A02,083220,Chow; Bennett,0,15,30,30
1651027799956,MATH 142A,B01,083221,Chow; Bennett,0,16,30,30
1651027799956,MATH 142A,B02,083222,Chow; Bennett,0,14,30,30
1651027805980,MATH 193A,A01,083224,Staff,0,8,30,30
1651027805980,MATH 193A,A02,083225,Staff,0,7,30,30
1651027805980,MATH 193A,A03,083781,Staff,0,7,30,30
1651027805980,MATH 193A,A04,083782,Staff,0,7,30,30
1651027812003,MATH 197,001,091859,McAuley; Julian John,9998,0,9999,1
1651027818056,COGS 9,A01,083615,Staff,0,19,60,60
1651027824081,COGS 11,A01,083617,Boyle; Mary E. T.,13,0,40,27
1651027830104,COGS 13,A01,083071,Staff,0,40,40,40
1651027836129,COGS 14A,A01,092681,Staff,0,40,100,100
1651027842156,COGS 14B,A01,083073,Cheng; Tzu-Han,0,13,50,50
1651027848179,COGS 17,A01,092677,Staff,8,0,75,67
1651027854208,COGS 100,A01,083619,Staff,0,30,60,60
1651027860233,COGS 101A,A01,083621,Davis; Joshua Daniel,0,29,60,60
1651027866261,COGS 101B,A01,091572,Staff,0,7,60,60
1651027872284,COGS 101C,A01,083625,Delgado; Tania,14,0,30,16
1651027878308,COGS 107A,A01,083627,Boyle; Mary E. T.,0,17,60,60
1651027884333,COGS 118A,A01,083075,Staff,0,10,60,60
1651027890359,CSE 3,A50,083646,Miranda; Gregory Joseph,15,0,38,23
1651027890359,CSE 3,A51,083647,Miranda; Gregory Joseph,36,0,37,1
1651027896382,CSE 8A,A50,083650,Miranda; Gregory Joseph,0,31,40,40
1651027902405,CSE 11,A01,083080,Cao; Yingjun,0,98,40,40
1651027908431,CSE 12,A01,083652,Staff,0,24,100,100
1651027914458,CSE 15L,A01,083654,Staff,0,3,50,50
1651027914458,CSE 15L,A02,083655,Staff,0,3,50,50
1651027920589,CSE 20,A01,083657,Staff,47,0,80,33
1651027926623,CSE 30,A01,083084,Eldon; John,1,40,80,79
1651027932647,CSE 100,A01,083659,Cao; Yingjun,0,72,50,50
1651027938675,CSE 134B,A01,083661,Powell; Thomas Allan,1,39,65,64
1651027944701,CSE 140,A01,083663,Staff,0,14,75,75
1651027950734,CSE 140L,A01,083088,Eldon; John,4,0,100,96
1651027956760,CSE 175,A01,083665,Kumar; Rakesh,0,0,25,25
1651027962784,CSE 190,A00,092507,Dubnov; Shlomo,9,0,20,11
1651027968816,ECE 45,A01,083139,Staff,0,7,60,60
1651027974842,ECE 65,A50,083695,Staff,0,7,30,30
1651027980868,ECE 109,A01,091882,Touri; Behrouz,32,0,70,38
1651027986892,ECE 180,A00,083140,Abi Samra; Nicholas Camill,17,0,30,13
1651027986892,ECE 180,B00,083141,Abi Samra; Nicholas Camill,0,0,30,30
1651027992919,MATH 10A,A01,083735,Patchell; Gregory David,1,0,30,29
1651027992919,MATH 10A,A02,083736,Patchell; Gregory David,27,0,30,3
1651027992919,MATH 10A,A03,083737,Patchell; Gregory David,23,0,30,7
1651027998942,MATH 10B,A01,083207,Staff,0,9,30,30
1651027998942,MATH 10B,A02,083208,Staff,0,6,30,30
1651027998942,MATH 10B,B01,083739,Staff,8,0,30,22
1651027998942,MATH 10B,B02,083740,Staff,28,0,30,2
1651028004971,MATH 18,A01,083743,Staff,0,0,30,30
1651028004971,MATH 18,A02,083744,Staff,23,0,30,7
1651028004971,MATH 18,A03,083745,Staff,19,0,30,11
1651028004971,MATH 18,A04,083746,Staff,26,0,30,4
1651028004971,MATH 18,B01,083748,Staff,0,16,30,30
1651028004971,MATH 18,B02,083749,Staff,0,14,30,30
1651028004971,MATH 18,B03,083750,Staff,0,14,30,30
1651028004971,MATH 18,B04,083751,Staff,0,13,30,30
1651028010995,MATH 20A,A01,083754,Staff,18,0,40,22
1651028017018,MATH 20B,A01,083756,Staff,0,14,30,30
1651028017018,MATH 20B,A02,083757,Staff,0,11,30,30
1651028023047,MATH 20C,A01,083760,Staff,0,17,30,30
1651028023047,MATH 20C,A02,083761,Staff,0,15,30,30
1651028023047,MATH 20C,B01,083762,Staff,8,0,30,22
1651028023047,MATH 20C,B02,083763,Staff,28,0,30,2
1651028029075,MATH 20D,A01,083765,Staff,3,1,30,27
1651028029075,MATH 20D,A02,083766,Staff,1,0,30,29
1651028029075,MATH 20D,A03,083767,Staff,22,0,30,8
1651028035103,MATH 20E,A01,083771,Staff,2,0,30,28
1651028035103,MATH 20E,A02,083772,Staff,12,0,30,18
1651028035103,MATH 20E,B01,083773,Staff,0,0,30,30
1651028035103,MATH 20E,B02,083774,Staff,1,0,30,29
1651028041133,MATH 103A,A01,083777,Staff,0,17,30,30
1651028041133,MATH 103A,A02,083778,Staff,0,15,30,30
1651028041133,MATH 103A,B01,083779,Staff,0,15,30,30
1651028041133,MATH 103A,B02,083780,Staff,0,14,30,30
1651028047174,MATH 105,A01,085443,Staff,0,23,30,30
1651028053198,MATH 109,A01,083213,Anzaldo; Leesa B,0,8,30,30
1651028053198,MATH 109,A02,083214,Anzaldo; Leesa B,0,7,30,30
1651028053198,MATH 109,B01,083215,Anzaldo; Leesa B,0,8,30,30
1651028053198,MATH 109,B02,083216,Anzaldo; Leesa B,0,7,30,30
1651028059232,MATH 142A,A01,083219,Chow; Bennett,0,14,30,30
1651028059232,MATH 142A,A02,083220,Chow; Bennett,0,15,30,30
1651028059232,MATH 142A,B01,083221,Chow; Bennett,0,16,30,30
1651028059232,MATH 142A,B02,083222,Chow; Bennett,0,14,30,30
1651028065256,MATH 193A,A01,083224,Staff,0,8,30,30
1651028065256,MATH 193A,A02,083225,Staff,0,7,30,30
1651028065256,MATH 193A,A03,083781,Staff,0,7,30,30
1651028065256,MATH 193A,A04,083782,Staff,0,7,30,30
1651028071282,MATH 197,001,091859,McAuley; Julian John,9998,0,9999,1
1651028077333,COGS 9,A01,083615,Staff,0,19,60,60
1651028083356,COGS 11,A01,083617,Boyle; Mary E. T.,13,0,40,27
1651028089381,COGS 13,A01,083071,Staff,0,40,40,40
1651028095407,COGS 14A,A01,092681,Staff,0,40,100,100
1651028101434,COGS 14B,A01,083073,Cheng; Tzu-Han,0,13,50,50
1651028107457,COGS 17,A01,092677,Staff,8,0,75,67
1651028113484,COGS 100,A01,083619,Staff,0,30,60,60
1651028119516,COGS 101A,A01,083621,Davis; Joshua Daniel,0,29,60,60
1651028125543,COGS 101B,A01,091572,Staff,0,7,60,60
1651028131567,COGS 101C,A01,083625,Delgado; Tania,14,0,30,16
1651028137593,COGS 107A,A01,083627,Boyle; Mary E. T.,0,17,60,60
1651028143615,COGS 118A,A01,083075,Staff,0,10,60,60
1651028149639,CSE 3,A50,083646,Miranda; Gregory Joseph,15,0,38,23
1651028149639,CSE 3,A51,083647,Miranda; Gregory Joseph,36,0,37,1
1651028155663,CSE 8A,A50,083650,Miranda; Gregory Joseph,0,31,40,40
1651028161695,CSE 11,A01,083080,Cao; Yingjun,0,98,40,40
1651028167719,CSE 12,A01,083652,Staff,0,24,100,100
1651028173743,CSE 15L,A01,083654,Staff,0,3,50,50
1651028173743,CSE 15L,A02,083655,Staff,0,3,50,50
1651028179765,CSE 20,A01,083657,Staff,47,0,80,33
1651028185791,CSE 30,A01,083084,Eldon; John,1,40,80,79
1651028191817,CSE 100,A01,083659,Cao; Yingjun,0,72,50,50
1651028197849,CSE 134B,A01,083661,Powell; Thomas Allan,1,39,65,64
1651028203874,CSE 140,A01,083663,Staff,0,14,75,75
1651028209898,CSE 140L,A01,083088,Eldon; John,4,0,100,96
1651028215922,CSE 175,A01,083665,Kumar; Rakesh,0,0,25,25
1651028221945,CSE 190,A00,092507,Dubnov; Shlomo,9,0,20,11
1651028227967,ECE 45,A01,083139,Staff,0,7,60,60
1651028233995,ECE 65,A50,083695,Staff,0,7,30,30
1651028240025,ECE 109,A01,091882,Touri; Behrouz,32,0,70,38
1651028246048,ECE 180,A00,083140,Abi Samra; Nicholas Camill,17,0,30,13
1651028246048,ECE 180,B00,083141,Abi Samra; Nicholas Camill,0,0,30,30
1651028252072,MATH 10A,A01,083735,Patchell; Gregory David,1,0,30,29
1651028252072,MATH 10A,A02,083736,Patchell; Gregory David,27,0,30,3
1651028252072,MATH 10A,A03,083737,Patchell; Gregory David,23,0,30,7
1651028258097,MATH 10B,A01,083207,Staff,0,9,30,30
1651028258097,MATH 10B,A02,083208,Staff,0,6,30,30
1651028258097,MATH 10B,B01,083739,Staff,8,0,30,22
1651028258097,MATH 10B,B02,083740,Staff,28,0,30,2
1651028264121,MATH 18,A01,083743,Staff,0,0,30,30
1651028264121,MATH 18,A02,083744,Staff,23,0,30,7
1651028264121,MATH 18,A03,083745,Staff,19,0,30,11
1651028264121,MATH 18,A04,083746,Staff,26,0,30,4
1651028264121,MATH 18,B01,083748,Staff,0,16,30,30
1651028264121,MATH 18,B02,083749,Staff,0,14,30,30
1651028264121,MATH 18,B03,083750,Staff,0,14,30,30
1651028264121,MATH 18,B04,083751,Staff,0,13,30,30
1651028270147,MATH 20A,A01,083754,Staff,18,0,40,22
1651028276170,MATH 20B,A01,083756,Staff,0,14,30,30
1651028276170,MATH 20B,A02,083757,Staff,0,11,30,30
1651028282205,MATH 20C,A01,083760,Staff,0,17,30,30
1651028282205,MATH 20C,A02,083761,Staff,0,15,30,30
1651028282205,MATH 20C,B01,083762,Staff,8,0,30,22
1651028282205,MATH 20C,B02,083763,Staff,28,0,30,2
1651028288229,MATH 20D,A01,083765,Staff,3,1,30,27
1651028288229,MATH 20D,A02,083766,Staff,1,0,30,29
1651028288229,MATH 20D,A03,083767,Staff,22,0,30,8
1651028294258,MATH 20E,A01,083771,Staff,2,0,30,28
1651028294258,MATH 20E,A02,083772,Staff,12,0,30,18
1651028294258,MATH 20E,B01,083773,Staff,0,0,30,30
1651028294258,MATH 20E,B02,083774,Staff,1,0,30,29
1651028300286,MATH 103A,A01,083777,Staff,0,17,30,30
1651028300286,MATH 103A,A02,083778,Staff,0,15,30,30
1651028300286,MATH 103A,B01,083779,Staff,0,15,30,30
1651028300286,MATH 103A,B02,083780,Staff,0,14,30,30
1651028306310,MATH 105,A01,085443,Staff,0,23,30,30
1651028312336,MATH 109,A01,083213,Anzaldo; Leesa B,0,8,30,30
1651028312336,MATH 109,A02,083214,Anzaldo; Leesa B,0,7,30,30
1651028312336,MATH 109,B01,083215,Anzaldo; Leesa B,0,8,30,30
1651028312336,MATH 109,B02,083216,Anzaldo; Leesa B,0,7,30,30
1651028318358,MATH 142A,A01,083219,Chow; Bennett,0,14,30,30
1651028318358,MATH 142A,A02,083220,Chow; Bennett,0,15,30,30
1651028318358,MATH 142A,B01,083221,Chow; Bennett,0,16,30,30
1651028318358,MATH 142A,B02,083222,Chow; Bennett,0,14,30,30
1651028324389,MATH 193A,A01,083224,Staff,0,8,30,30
1651028324389,MATH 193A,A02,083225,Staff,0,7,30,30
1651028324389,MATH 193A,A03,083781,Staff,0,7,30,30
1651028324389,MATH 193A,A04,083782,Staff,0,7,30,30
1651028330413,MATH 197,001,091859,McAuley; Julian John,9998,0,9999,1
1651028336478,COGS 9,A01,083615,Staff,0,19,60,60
1651028342505,COGS 11,A01,083617,Boyle; Mary E. T.,13,0,40,27
1651028348538,COGS 13,A01,083071,Staff,0,40,40,40
1651028354564,COGS 14A,A01,092681,Staff,0,40,100,100
1651028360588,COGS 14B,A01,083073,Cheng; Tzu-Han,0,13,50,50
1651028366611,COGS 17,A01,092677,Staff,8,0,75,67
1651028372635,COGS 100,A01,083619,Staff,0,30,60,60
1651028378658,COGS 101A,A01,083621,Davis; Joshua Daniel,0,29,60,60
1651028384684,COGS 101B,A01,091572,Staff,0,7,60,60
1651028390710,COGS 101C,A01,083625,Delgado; Tania,14,0,30,16
1651028396737,COGS 107A,A01,083627,Boyle; Mary E. T.,0,17,60,60
1651028402759,COGS 118A,A01,083075,Staff,0,10,60,60
1651028408786,CSE 3,A50,083646,Miranda; Gregory Joseph,15,0,38,23
1651028408786,CSE 3,A51,083647,Miranda; Gregory Joseph,36,0,37,1
1651028414813,CSE 8A,A50,083650,Miranda; Gregory Joseph,0,31,40,40
1651028420836,CSE 11,A01,083080,Cao; Yingjun,0,98,40,40
1651028426863,CSE 12,A01,083652,Staff,0,24,100,100
1651028432889,CSE 15L,A01,083654,Staff,0,3,50,50
1651028432889,CSE 15L,A02,083655,Staff,0,3,50,50
1651028438912,CSE 20,A01,083657,Staff,47,0,80,33
1651028444936,CSE 30,A01,083084,Eldon; John,1,40,80,79
1651028450960,CSE 100,A01,083659,Cao; Yingjun,0,72,50,50
1651028456984,CSE 134B,A01,083661,Powell; Thomas Allan,1,39,65,64
1651028463018,CSE 140,A01,083663,Staff,0,14,75,75
1651028469041,CSE 140L,A01,083088,Eldon; John,4,0,100,96
1651028475068,CSE 175,A01,083665,Kumar; Rakesh,0,0,25,25
1651028481098,CSE 190,A00,092507,Dubnov; Shlomo,9,0,20,11
1651028487125,ECE 45,A01,083139,Staff,0,7,60,60
1651028493152,ECE 65,A50,083695,Staff,0,7,30,30
1651028499176,ECE 109,A01,091882,Touri; Behrouz,32,0,70,38
1651028505203,ECE 180,A00,083140,Abi Samra; Nicholas Camill,17,0,30,13
1651028505203,ECE 180,B00,083141,Abi Samra; Nicholas Camill,0,0,30,30
1651028511231,MATH 10A,A01,083735,Patchell; Gregory David,1,0,30,29
1651028511231,MATH 10A,A02,083736,Patchell; Gregory David,27,0,30,3
1651028511231,MATH 10A,A03,083737,Patchell; Gregory David,23,0,30,7
1651028517351,MATH 10B,A01,083207,Staff,0,8,30,30
1651028517351,MATH 10B,A02,083208,Staff,0,6,30,30
1651028517351,MATH 10B,B01,083739,Staff,8,0,30,22
1651028517351,MATH 10B,B02,083740,Staff,28,0,30,2
1651028523383,MATH 18,A01,083743,Staff,0,0,30,30
1651028523383,MATH 18,A02,083744,Staff,23,0,30,7
1651028523383,MATH 18,A03,083745,Staff,19,0,30,11
1651028523383,MATH 18,A04,083746,Staff,26,0,30,4
1651028523383,MATH 18,B01,083748,Staff,0,16,30,30
1651028523383,MATH 18,B02,083749,Staff,0,14,30,30
1651028523383,MATH 18,B03,083750,Staff,0,14,30,30
1651028523383,MATH 18,B04,083751,Staff,0,13,30,30
1651028529409,MATH 20A,A01,083754,Staff,18,0,40,22
1651028535436,MATH 20B,A01,083756,Staff,0,14,30,30
1651028535436,MATH 20B,A02,083757,Staff,0,11,30,30
1651028541461,MATH 20C,A01,083760,Staff,0,17,30,30
1651028541461,MATH 20C,A02,083761,Staff,0,15,30,30
1651028541461,MATH 20C,B01,083762,Staff,8,0,30,22
1651028541461,MATH 20C,B02,083763,Staff,28,0,30,2
1651028547486,MATH 20D,A01,083765,Staff,3,1,30,27
1651028547486,MATH 20D,A02,083766,Staff,1,0,30,29
1651028547486,MATH 20D,A03,083767,Staff,22,0,30,8
1651028553509,MATH 20E,A01,083771,Staff,2,0,30,28
1651028553509,MATH 20E,A02,083772,Staff,12,0,30,18
1651028553509,MATH 20E,B01,083773,Staff,0,0,30,30
1651028553509,MATH 20E,B02,083774,Staff,1,0,30,29
1651028559540,MATH 103A,A01,083777,Staff,0,17,30,30
1651028559540,MATH 103A,A02,083778,Staff,0,15,30,30
1651028559540,MATH 103A,B01,083779,Staff,0,15,30,30
1651028559540,MATH 103A,B02,083780,Staff,0,14,30,30
1651028565573,MATH 105,A01,085443,Staff,0,23,30,30
1651028571607,MATH 109,A01,083213,Anzaldo; Leesa B,0,8,30,30
1651028571607,MATH 109,A02,083214,Anzaldo; Leesa B,0,7,30,30
1651028571607,MATH 109,B01,083215,Anzaldo; Leesa B,0,8,30,30
1651028571607,MATH 109,B02,083216,Anzaldo; Leesa B,0,7,30,30
1651028577635,MATH 142A,A01,083219,Chow; Bennett,0,14,30,30
1651028577635,MATH 142A,A02,083220,Chow; Bennett,0,15,30,30
1651028577635,MATH 142A,B01,083221,Chow; Bennett,0,16,30,30
1651028577635,MATH 142A,B02,083222,Chow; Bennett,0,14,30,30
1651028583663,MATH 193A,A01,083224,Staff,0,8,30,30
1651028583663,MATH 193A,A02,083225,Staff,0,7,30,30
1651028583663,MATH 193A,A03,083781,Staff,0,7,30,30
1651028583663,MATH 193A,A04,083782,Staff,0,7,30,30
1651028589686,MATH 197,001,091859,McAuley; Julian John,9998,0,9999,1
1651028595746,COGS 9,A01,083615,Staff,0,19,60,60
1651028601770,COGS 11,A01,083617,Boyle; Mary E. T.,13,0,40,27
1651028608014,COGS 13,A01,083071,Staff,0,40,40,40
1651028614043,COGS 14A,A01,092681,Staff,0,40,100,100
1651028620070,COGS 14B,A01,083073,Cheng; Tzu-Han,0,13,50,50
1651028626095,COGS 17,A01,092677,Staff,8,0,75,67
1651028632118,COGS 100,A01,083619,Staff,0,30,60,60
1651028638146,COGS 101A,A01,083621,Davis; Joshua Daniel,0,29,60,60
1651028644175,COGS 101B,A01,091572,Staff,0,7,60,60
1651028650199,COGS 101C,A01,083625,Delgado; Tania,14,0,30,16
1651028656221,COGS 107A,A01,083627,Boyle; Mary E. T.,0,17,60,60
1651028662248,COGS 118A,A01,083075,Staff,0,10,60,60
1651028668276,CSE 3,A50,083646,Miranda; Gregory Joseph,15,0,38,23
1651028668276,CSE 3,A51,083647,Miranda; Gregory Joseph,36,0,37,1
1651028674300,CSE 8A,A50,083650,Miranda; Gregory Joseph,0,31,40,40
1651028680327,CSE 11,A01,083080,Cao; Yingjun,0,98,40,40
1651028686350,CSE 12,A01,083652,Staff,0,25,100,100
1651028692373,CSE 15L,A01,083654,Staff,0,3,50,50
1651028692373,CSE 15L,A02,083655,Staff,0,3,50,50
1651028698400,CSE 20,A01,083657,Staff,47,0,80,33
1651028704426,CSE 30,A01,083084,Eldon; John,1,39,80,79
1651028710452,CSE 100,A01,083659,Cao; Yingjun,0,72,50,50
1651028716484,CSE 134B,A01,083661,Powell; Thomas Allan,1,39,65,64
1651028722507,CSE 140,A01,083663,Staff,0,14,75,75
1651028728541,CSE 140L,A01,083088,Eldon; John,4,0,100,96
1651028734567,CSE 175,A01,083665,Kumar; Rakesh,0,0,25,25
1651028740604,CSE 190,A00,092507,Dubnov; Shlomo,9,0,20,11
1651028746628,ECE 45,A01,083139,Staff,0,7,60,60
1651028752657,ECE 65,A50,083695,Staff,0,7,30,30
1651028758694,ECE 109,A01,091882,Touri; Behrouz,32,0,70,38
1651028764722,ECE 180,A00,083140,Abi Samra; Nicholas Camill,17,0,30,13
1651028764722,ECE 180,B00,083141,Abi Samra; Nicholas Camill,0,0,30,30
1651028770749,MATH 10A,A01,083735,Patchell; Gregory David,1,0,30,29
1651028770749,MATH 10A,A02,083736,Patchell; Gregory David,27,0,30,3
1651028770749,MATH 10A,A03,083737,Patchell; Gregory David,23,0,30,7
1651028776774,MATH 10B,A01,083207,Staff,0,8,30,30
1651028776774,MATH 10B,A02,083208,Staff,0,6,30,30
1651028776774,MATH 10B,B01,083739,Staff,8,0,30,22
1651028776774,MATH 10B,B02,083740,Staff,28,0,30,2
1651028782806,MATH 18,A01,083743,Staff,0,0,30,30
1651028782806,MATH 18,A02,083744,Staff,23,0,30,7
1651028782806,MATH 18,A03,083745,Staff,19,0,30,11
1651028782806,MATH 18,A04,083746,Staff,26,0,30,4
1651028782806,MATH 18,B01,083748,Staff,0,16,30,30
1651028782806,MATH 18,B02,083749,Staff,0,14,30,30
1651028782806,MATH 18,B03,083750,Staff,0,14,30,30
1651028782806,MATH 18,B04,083751,Staff,0,13,30,30
1651028788831,MATH 20A,A01,083754,Staff,18,0,40,22
1651028794858,MATH 20B,A01,083756,Staff,0,14,30,30
1651028794858,MATH 20B,A02,083757,Staff,0,11,30,30
1651028800886,MATH 20C,A01,083760,Staff,0,17,30,30
1651028800886,MATH 20C,A02,083761,Staff,0,15,30,30
1651028800886,MATH 20C,B01,083762,Staff,8,0,30,22
1651028800886,MATH 20C,B02,083763,Staff,28,0,30,2
1651028806916,MATH 20D,A01,083765,Staff,3,1,30,27
1651028806916,MATH 20D,A02,083766,Staff,1,0,30,29
1651028806916,MATH 20D,A03,083767,Staff,22,0,30,8
1651028812944,MATH 20E,A01,083771,Staff,2,0,30,28
1651028812944,MATH 20E,A02,083772,Staff,12,0,30,18
1651028812944,MATH 20E,B01,083773,Staff,0,0,30,30
1651028812944,MATH 20E,B02,083774,Staff,1,0,30,29
1651028818968,MATH 103A,A01,083777,Staff,0,17,30,30
1651028818968,MATH 103A,A02,083778,Staff,0,16,30,30
1651028818968,MATH 103A,B01,083779,Staff,0,15,30,30
1651028818968,MATH 103A,B02,083780,Staff,0,13,30,30
1651028824992,MATH 105,A01,085443,Staff,0,23,30,30
1651028831024,MATH 109,A01,083213,Anzaldo; Leesa B,0,8,30,30
1651028831024,MATH 109,A02,083214,Anzaldo; Leesa B,0,7,30,30
1651028831024,MATH 109,B01,083215,Anzaldo; Leesa B,0,8,30,30
1651028831024,MATH 109,B02,083216,Anzaldo; Leesa B,0,7,30,30
1651028837054,MATH 142A,A01,083219,Chow; Bennett,0,14,30,30
1651028837054,MATH 142A,A02,083220,Chow; Bennett,0,15,30,30
1651028837054,MATH 142A,B01,083221,Chow; Bennett,0,16,30,30
1651028837054,MATH 142A,B02,083222,Chow; Bennett,0,14,30,30
1651028843083,MATH 193A,A01,083224,Staff,0,8,30,30
1651028843083,MATH 193A,A02,083225,Staff,0,7,30,30
1651028843083,MATH 193A,A03,083781,Staff,0,7,30,30
1651028843083,MATH 193A,A04,083782,Staff,0,7,30,30
1651028849110,MATH 197,001,091859,McAuley; Julian John,9998,0,9999,1
1651028855172,COGS 9,A01,083615,Staff,0,19,60,60
1651028861199,COGS 11,A01,083617,Boyle; Mary E. T.,13,0,40,27
1651028867241,COGS 13,A01,083071,Staff,0,40,40,40
1651028873270,COGS 14A,A01,092681,Staff,0,40,100,100
1651028879297,COGS 14B,A01,083073,Cheng; Tzu-Han,0,13,50,50
1651028885320,COGS 17,A01,092677,Staff,8,0,75,67
1651028891342,COGS 100,A01,083619,Staff,0,30,60,60
1651028897371,COGS 101A,A01,083621,Davis; Joshua Daniel,0,29,60,60
1651028903395,COGS 101B,A01,091572,Staff,0,7,60,60
1651028909422,COGS 101C,A01,083625,Delgado; Tania,14,0,30,16
1651028915446,COGS 107A,A01,083627,Boyle; Mary E. T.,0,17,60,60
1651028921470,COGS 118A,A01,083075,Staff,0,10,60,60
1651028927496,CSE 3,A50,083646,Miranda; Gregory Joseph,15,0,38,23
1651028927496,CSE 3,A51,083647,Miranda; Gregory Joseph,36,0,37,1
1651028933518,CSE 8A,A50,083650,Miranda; Gregory Joseph,0,31,40,40
1651028939544,CSE 11,A01,083080,Cao; Yingjun,0,98,40,40
1651028945567,CSE 12,A01,083652,Staff,0,25,100,100
1651028951590,CSE 15L,A01,083654,Staff,0,3,50,50
1651028951590,CSE 15L,A02,083655,Staff,0,3,50,50
1651028957614,CSE 20,A01,083657,Staff,47,0,80,33
1651028963637,CSE 30,A01,083084,Eldon; John,1,39,80,79
1651028969661,CSE 100,A01,083659,Cao; Yingjun,0,72,50,50
1651028975687,CSE 134B,A01,083661,Powell; Thomas Allan,1,39,65,64
1651028981717,CSE 140,A01,083663,Staff,0,14,75,75
1651028987744,CSE 140L,A01,083088,Eldon; John,4,0,100,96
1651028993770,CSE 175,A01,083665,Kumar; Rakesh,0,0,25,25
1651028999793,CSE 190,A00,092507,Dubnov; Shlomo,9,0,20,11
1651029005820,ECE 45,A01,083139,Staff,0,7,60,60
1651029011844,ECE 65,A50,083695,Staff,0,7,30,30
1651029017870,ECE 109,A01,091882,Touri; Behrouz,32,0,70,38
1651029023894,ECE 180,A00,083140,Abi Samra; Nicholas Camill,17,0,30,13
1651029023894,ECE 180,B00,083141,Abi Samra; Nicholas Camill,0,0,30,30
1651029029919,MATH 10A,A01,083735,Patchell; Gregory David,1,0,30,29
1651029029919,MATH 10A,A02,083736,Patchell; Gregory David,27,0,30,3
1651029029919,MATH 10A,A03,083737,Patchell; Gregory David,23,0,30,7
1651029035943,MATH 10B,A01,083207,Staff,0,8,30,30
1651029035943,MATH 10B,A02,083208,Staff,0,6,30,30
1651029035943,MATH 10B,B01,083739,Staff,8,0,30,22
1651029035943,MATH 10B,B02,083740,Staff,28,0,30,2
1651029041967,MATH 18,A01,083743,Staff,0,0,30,30
1651029041967,MATH 18,A02,083744,Staff,23,0,30,7
1651029041967,MATH 18,A03,083745,Staff,19,0,30,11
1651029041967,MATH 18,A04,083746,Staff,26,0,30,4
1651029041967,MATH 18,B01,083748,Staff,0,16,30,30
1651029041967,MATH 18,B02,083749,Staff,0,14,30,30
1651029041967,MATH 18,B03,083750,Staff,0,14,30,30
1651029041967,MATH 18,B04,083751,Staff,0,13,30,30
1651029047991,MATH 20A,A01,083754,Staff,18,0,40,22
1651029054015,MATH 20B,A01,083756,Staff,0,14,30,30
1651029054015,MATH 20B,A02,083757,Staff,0,11,30,30
1651029060045,MATH 20C,A01,083760,Staff,0,17,30,30
1651029060045,MATH 20C,A02,083761,Staff,0,15,30,30
1651029060045,MATH 20C,B01,083762,Staff,8,0,30,22
1651029060045,MATH 20C,B02,083763,Staff,28,0,30,2
1651029066075,MATH 20D,A01,083765,Staff,3,1,30,27
1651029066075,MATH 20D,A02,083766,Staff,1,0,30,29
1651029066075,MATH 20D,A03,083767,Staff,22,0,30,8
1651029072104,MATH 20E,A01,083771,Staff,2,0,30,28
1651029072104,MATH 20E,A02,083772,Staff,12,0,30,18
1651029072104,MATH 20E,B01,083773,Staff,0,0,30,30
1651029072104,MATH 20E,B02,083774,Staff,1,0,30,29
1651029078129,MATH 103A,A01,083777,Staff,0,17,30,30
1651029078129,MATH 103A,A02,083778,Staff,0,16,30,30
1651029078129,MATH 103A,B01,083779,Staff,0,15,30,30
1651029078129,MATH 103A,B02,083780,Staff,0,13,30,30
1651029084161,MATH 105,A01,085443,Staff,0,23,30,30
1651029090191,MATH 109,A01,083213,Anzaldo; Leesa B,0,8,30,30
1651029090191,MATH 109,A02,083214,Anzaldo; Leesa B,0,7,30,30
1651029090191,MATH 109,B01,083215,Anzaldo; Leesa B,0,8,30,30
1651029090191,MATH 109,B02,083216,Anzaldo; Leesa B,0,7,30,30
1651029096221,MATH 142A,A01,083219,Chow; Bennett,0,14,30,30
1651029096221,MATH 142A,A02,083220,Chow; Bennett,0,15,30,30
1651029096221,MATH 142A,B01,083221,Chow; Bennett,0,16,30,30
1651029096221,MATH 142A,B02,083222,Chow; Bennett,0,14,30,30
1651029102244,MATH 193A,A01,083224,Staff,0,8,30,30
1651029102244,MATH 193A,A02,083225,Staff,0,7,30,30
1651029102244,MATH 193A,A03,083781,Staff,0,7,30,30
1651029102244,MATH 193A,A04,083782,Staff,0,7,30,30
1651029108268,MATH 197,001,091859,McAuley; Julian John,9998,0,9999,1
1651029114412,COGS 9,A01,083615,Staff,0,19,60,60
1651029120436,COGS 11,A01,083617,Boyle; Mary E. T.,13,0,40,27
1651029126459,COGS 13,A01,083071,Staff,0,40,40,40
1651029132482,COGS 14A,A01,092681,Staff,0,40,100,100
1651029138506,COGS 14B,A01,083073,Cheng; Tzu-Han,0,13,50,50
1651029144538,COGS 17,A01,092677,Staff,8,0,75,67
1651029150567,COGS 100,A01,083619,Staff,0,30,60,60
1651029156590,COGS 101A,A01,083621,Davis; Joshua Daniel,0,29,60,60
1651029162614,COGS 101B,A01,091572,Staff,0,7,60,60
1651029168638,COGS 101C,A01,083625,Delgado; Tania,14,0,30,16
1651029174665,COGS 107A,A01,083627,Boyle; Mary E. T.,0,17,60,60
1651029180702,COGS 118A,A01,083075,Staff,0,10,60,60
1651029186726,CSE 3,A50,083646,Miranda; Gregory Joseph,15,0,38,23
1651029186726,CSE 3,A51,083647,Miranda; Gregory Joseph,36,0,37,1
1651029192749,CSE 8A,A50,083650,Miranda; Gregory Joseph,0,31,40,40
1651029198777,CSE 11,A01,083080,Cao; Yingjun,0,98,40,40
1651029204802,CSE 12,A01,083652,Staff,0,25,100,100
1651029210829,CSE 15L,A01,083654,Staff,0,3,50,50
1651029210829,CSE 15L,A02,083655,Staff,0,3,50,50
1651029216854,CSE 20,A01,083657,Staff,47,0,80,33
1651029222881,CSE 30,A01,083084,Eldon; John,1,39,80,79
1651029228904,CSE 100,A01,083659,Cao; Yingjun,0,72,50,50
1651029234929,CSE 134B,A01,083661,Powell; Thomas Allan,1,39,65,64
1651029240953,CSE 140,A01,083663,Staff,0,14,75,75
1651029246985,CSE 140L,A01,083088,Eldon; John,4,0,100,96
1651029253010,CSE 175,A01,083665,Kumar; Rakesh,0,0,25,25
1651029259034,CSE 190,A00,092507,Dubnov; Shlomo,9,0,20,11
1651029265059,ECE 45,A01,083139,Staff,0,7,60,60
1651029271087,ECE 65,A50,083695,Staff,0,7,30,30
1651029277111,ECE 109,A01,091882,Touri; Behrouz,32,0,70,38
1651029283134,ECE 180,A00,083140,Abi Samra; Nicholas Camill,17,0,30,13
1651029283134,ECE 180,B00,083141,Abi Samra; Nicholas Camill,0,0,30,30
1651029289168,MATH 10A,A01,083735,Patchell; Gregory David,1,0,30,29
1651029289168,MATH 10A,A02,083736,Patchell; Gregory David,27,0,30,3
1651029289168,MATH 10A,A03,083737,Patchell; Gregory David,23,0,30,7
1651029295196,MATH 10B,A01,083207,Staff,0,8,30,30
1651029295196,MATH 10B,A02,083208,Staff,0,6,30,30
1651029295196,MATH 10B,B01,083739,Staff,8,0,30,22
1651029295196,MATH 10B,B02,083740,Staff,28,0,30,2
1651029301238,MATH 18,A01,083743,Staff,0,0,30,30
1651029301238,MATH 18,A02,083744,Staff,23,0,30,7
1651029301238,MATH 18,A03,083745,Staff,19,0,30,11
1651029301238,MATH 18,A04,083746,Staff,26,0,30,4
1651029301238,MATH 18,B01,083748,Staff,0,16,30,30
1651029301238,MATH 18,B02,083749,Staff,0,14,30,30
1651029301238,MATH 18,B03,083750,Staff,0,14,30,30
1651029301238,MATH 18,B04,083751,Staff,0,13,30,30
1651029307261,MATH 20A,A01,083754,Staff,18,0,40,22
1651029313286,MATH 20B,A01,083756,Staff,0,14,30,30
1651029313286,MATH 20B,A02,083757,Staff,0,11,30,30
1651029319310,MATH 20C,A01,083760,Staff,0,17,30,30
1651029319310,MATH 20C,A02,083761,Staff,0,15,30,30
1651029319310,MATH 20C,B01,083762,Staff,8,0,30,22
1651029319310,MATH 20C,B02,083763,Staff,28,0,30,2
1651029325334,MATH 20D,A01,083765,Staff,3,1,30,27
1651029325334,MATH 20D,A02,083766,Staff,1,0,30,29
1651029325334,MATH 20D,A03,083767,Staff,22,0,30,8
1651029331361,MATH 20E,A01,083771,Staff,2,0,30,28
1651029331361,MATH 20E,A02,083772,Staff,12,0,30,18
1651029331361,MATH 20E,B01,083773,Staff,0,0,30,30
1651029331361,MATH 20E,B02,083774,Staff,1,0,30,29
1651029337390,MATH 103A,A01,083777,Staff,0,17,30,30
1651029337390,MATH 103A,A02,083778,Staff,0,16,30,30
1651029337390,MATH 103A,B01,083779,Staff,0,15,30,30
1651029337390,MATH 103A,B02,083780,Staff,0,13,30,30
1651029343413,MATH 105,A01,085443,Staff,0,23,30,30
1651029349437,MATH 109,A01,083213,Anzaldo; Leesa B,0,8,30,30
1651029349437,MATH 109,A02,083214,Anzaldo; Leesa B,0,7,30,30
1651029349437,MATH 109,B01,083215,Anzaldo; Leesa B,0,8,30,30
1651029349437,MATH 109,B02,083216,Anzaldo; Leesa B,0,7,30,30
1651029355461,MATH 142A,A01,083219,Chow; Bennett,0,14,30,30
1651029355461,MATH 142A,A02,083220,Chow; Bennett,0,15,30,30
1651029355461,MATH 142A,B01,083221,Chow; Bennett,0,16,30,30
1651029355461,MATH 142A,B02,083222,Chow; Bennett,0,14,30,30
1651029361494,MATH 193A,A01,083224,Staff,0,8,30,30
1651029361494,MATH 193A,A02,083225,Staff,0,7,30,30
1651029361494,MATH 193A,A03,083781,Staff,0,7,30,30
1651029361494,MATH 193A,A04,083782,Staff,0,7,30,30
1651029367522,MATH 197,001,091859,McAuley; Julian John,9998,0,9999,1
1651029373576,COGS 9,A01,083615,Staff,0,19,60,60
1651029379607,COGS 11,A01,083617,Boyle; Mary E. T.,13,0,40,27
1651029385633,COGS 13,A01,083071,Staff,0,40,40,40
1651029391661,COGS 14A,A01,092681,Staff,0,40,100,100
1651029397689,COGS 14B,A01,083073,Cheng; Tzu-Han,0,13,50,50
1651029403713,COGS 17,A01,092677,Staff,8,0,75,67
1651029409737,COGS 100,A01,083619,Staff,0,30,60,60
1651029415763,COGS 101A,A01,083621,Davis; Joshua Daniel,0,29,60,60
1651029421789,COGS 101B,A01,091572,Staff,0,7,60,60
1651029427820,COGS 101C,A01,083625,Delgado; Tania,14,0,30,16
1651029433844,COGS 107A,A01,083627,Boyle; Mary E. T.,0,17,60,60
1651029439872,COGS 118A,A01,083075,Staff,0,10,60,60
1651029445906,CSE 3,A50,083646,Miranda; Gregory Joseph,15,0,38,23
1651029445906,CSE 3,A51,083647,Miranda; Gregory Joseph,36,0,37,1
1651029451933,CSE 8A,A50,083650,Miranda; Gregory Joseph,0,31,40,40
1651029457956,CSE 11,A01,083080,Cao; Yingjun,0,98,40,40
1651029463980,CSE 12,A01,083652,Staff,0,25,100,100
1651029470005,CSE 15L,A01,083654,Staff,0,3,50,50
1651029470005,CSE 15L,A02,083655,Staff,0,3,50,50
1651029476032,CSE 20,A01,083657,Staff,47,0,80,33
1651029482056,CSE 30,A01,083084,Eldon; John,1,39,80,79
1651029488081,CSE 100,A01,083659,Cao; Yingjun,0,72,50,50
1651029494106,CSE 134B,A01,083661,Powell; Thomas Allan,1,39,65,64
1651029500133,CSE 140,A01,083663,Staff,0,14,75,75
1651029506159,CSE 140L,A01,083088,Eldon; John,4,0,100,96
1651029512189,CSE 175,A01,083665,Kumar; Rakesh,0,0,25,25
1651029518214,CSE 190,A00,092507,Dubnov; Shlomo,9,0,20,11
1651029524241,ECE 45,A01,083139,Staff,0,7,60,60
1651029530268,ECE 65,A50,083695,Staff,0,7,30,30
1651029536298,ECE 109,A01,091882,Touri; Behrouz,32,0,70,38
1651029542321,ECE 180,A00,083140,Abi Samra; Nicholas Camill,17,0,30,13
1651029542321,ECE 180,B00,083141,Abi Samra; Nicholas Camill,0,0,30,30
1651029548343,MATH 10A,A01,083735,Patchell; Gregory David,1,0,30,29
1651029548343,MATH 10A,A02,083736,Patchell; Gregory David,27,0,30,3
1651029548343,MATH 10A,A03,083737,Patchell; Gregory David,23,0,30,7
1651029554367,MATH 10B,A01,083207,Staff,0,8,30,30
1651029554367,MATH 10B,A02,083208,Staff,0,6,30,30
1651029554367,MATH 10B,B01,083739,Staff,8,0,30,22
1651029554367,MATH 10B,B02,083740,Staff,28,0,30,2
1651029560396,MATH 18,A01,083743,Staff,0,0,30,30
1651029560396,MATH 18,A02,083744,Staff,23,0,30,7
1651029560396,MATH 18,A03,083745,Staff,19,0,30,11
1651029560396,MATH 18,A04,083746,Staff,26,0,30,4
1651029560396,MATH 18,B01,083748,Staff,0,16,30,30
1651029560396,MATH 18,B02,083749,Staff,0,14,30,30
1651029560396,MATH 18,B03,083750,Staff,0,14,30,30
1651029560396,MATH 18,B04,083751,Staff,0,13,30,30
1651029566422,MATH 20A,A01,083754,Staff,18,0,40,22
1651029572445,MATH 20B,A01,083756,Staff,0,14,30,30
1651029572445,MATH 20B,A02,083757,Staff,0,11,30,30
1651029578468,MATH 20C,A01,083760,Staff,0,17,30,30
1651029578468,MATH 20C,A02,083761,Staff,0,15,30,30
1651029578468,MATH 20C,B01,083762,Staff,8,0,30,22
1651029578468,MATH 20C,B02,083763,Staff,28,0,30,2
1651029584493,MATH 20D,A01,083765,Staff,3,1,30,27
1651029584493,MATH 20D,A02,083766,Staff,1,0,30,29
1651029584493,MATH 20D,A03,083767,Staff,22,0,30,8
1651029590518,MATH 20E,A01,083771,Staff,2,0,30,28
1651029590518,MATH 20E,A02,083772,Staff,12,0,30,18
1651029590518,MATH 20E,B01,083773,Staff,0,0,30,30
1651029590518,MATH 20E,B02,083774,Staff,1,0,30,29
1651029596552,MATH 103A,A01,083777,Staff,0,17,30,30
1651029596552,MATH 103A,A02,083778,Staff,0,16,30,30
1651029596552,MATH 103A,B01,083779,Staff,0,15,30,30
1651029596552,MATH 103A,B02,083780,Staff,0,13,30,30
1651029602580,MATH 105,A01,085443,Staff,0,23,30,30
1651029608608,MATH 109,A01,083213,Anzaldo; Leesa B,0,8,30,30
1651029608608,MATH 109,A02,083214,Anzaldo; Leesa B,0,7,30,30
1651029608608,MATH 109,B01,083215,Anzaldo; Leesa B,0,8,30,30
1651029608608,MATH 109,B02,083216,Anzaldo; Leesa B,0,7,30,30
1651029614637,MATH 142A,A01,083219,Chow; Bennett,0,14,30,30
1651029614637,MATH 142A,A02,083220,Chow; Bennett,0,15,30,30
1651029614637,MATH 142A,B01,083221,Chow; Bennett,0,16,30,30
1651029614637,MATH 142A,B02,083222,Chow; Bennett,0,14,30,30
1651029620664,MATH 193A,A01,083224,Staff,0,8,30,30
1651029620664,MATH 193A,A02,083225,Staff,0,7,30,30
1651029620664,MATH 193A,A03,083781,Staff,0,7,30,30
1651029620664,MATH 193A,A04,083782,Staff,0,7,30,30
1651029626687,MATH 197,001,091859,McAuley; Julian John,9998,0,9999,1
1651029632740,COGS 9,A01,083615,Staff,0,19,60,60
1651029638763,COGS 11,A01,083617,Boyle; Mary E. T.,13,0,40,27
1651029644789,COGS 13,A01,083071,Staff,0,40,40,40
1651029650818,COGS 14A,A01,092681,Staff,0,40,100,100
1651029656845,COGS 14B,A01,083073,Cheng; Tzu-Han,0,13,50,50
1651029662872,COGS 17,A01,092677,Staff,8,0,75,67
1651029668896,COGS 100,A01,083619,Staff,0,30,60,60
1651029674923,COGS 101A,A01,083621,Davis; Joshua Daniel,0,29,60,60
1651029680953,COGS 101B,A01,091572,Staff,0,7,60,60
1651029686988,COGS 101C,A01,083625,Delgado; Tania,14,0,30,16
1651029693013,COGS 107A,A01,083627,Boyle; Mary E. T.,0,17,60,60
1651029699036,COGS 118A,A01,083075,Staff,0,10,60,60
1651029705139,CSE 3,A50,083646,Miranda; Gregory Joseph,15,0,38,23
1651029705139,CSE 3,A51,083647,Miranda; Gregory Joseph,36,0,37,1
1651029711163,CSE 8A,A50,083650,Miranda; Gregory Joseph,0,31,40,40
1651029717190,CSE 11,A01,083080,Cao; Yingjun,0,98,40,40
1651029723214,CSE 12,A01,083652,Staff,0,25,100,100
1651029729242,CSE 15L,A01,083654,Staff,0,3,50,50
1651029729242,CSE 15L,A02,083655,Staff,0,3,50,50
1651029735269,CSE 20,A01,083657,Staff,47,0,80,33
1651029741295,CSE 30,A01,083084,Eldon; John,1,39,80,79
1651029747318,CSE 100,A01,083659,Cao; Yingjun,0,72,50,50
1651029753342,CSE 134B,A01,083661,Powell; Thomas Allan,1,39,65,64
1651029759365,CSE 140,A01,083663,Staff,0,14,75,75
1651029765388,CSE 140L,A01,083088,Eldon; John,4,0,100,96
1651029771419,CSE 175,A01,083665,Kumar; Rakesh,0,0,25,25
1651029777443,CSE 190,A00,092507,Dubnov; Shlomo,9,0,20,11
1651029783466,ECE 45,A01,083139,Staff,0,7,60,60
1651029789491,ECE 65,A50,083695,Staff,0,7,30,30
1651029795517,ECE 109,A01,091882,Touri; Behrouz,32,0,70,38
1651029801541,ECE 180,A00,083140,Abi Samra; Nicholas Camill,17,0,30,13
1651029801541,ECE 180,B00,083141,Abi Samra; Nicholas Camill,0,0,30,30
1651029807578,MATH 10A,A01,083735,Patchell; Gregory David,1,0,30,29
1651029807578,MATH 10A,A02,083736,Patchell; Gregory David,27,0,30,3
1651029807578,MATH 10A,A03,083737,Patchell; Gregory David,23,0,30,7
1651029813606,MATH 10B,A01,083207,Staff,0,8,30,30
1651029813606,MATH 10B,A02,083208,Staff,0,6,30,30
1651029813606,MATH 10B,B01,083739,Staff,8,0,30,22
1651029813606,MATH 10B,B02,083740,Staff,28,0,30,2
1651029819636,MATH 18,A01,083743,Staff,0,0,30,30
1651029819636,MATH 18,A02,083744,Staff,23,0,30,7
1651029819636,MATH 18,A03,083745,Staff,19,0,30,11
1651029819636,MATH 18,A04,083746,Staff,26,0,30,4
1651029819636,MATH 18,B01,083748,Staff,0,16,30,30
1651029819636,MATH 18,B02,083749,Staff,0,14,30,30
1651029819636,MATH 18,B03,083750,Staff,0,14,30,30
1651029819636,MATH 18,B04,083751,Staff,0,13,30,30
1651029825660,MATH 20A,A01,083754,Staff,18,0,40,22
1651029831684,MATH 20B,A01,083756,Staff,0,14,30,30
1651029831684,MATH 20B,A02,083757,Staff,0,11,30,30
1651029837709,MATH 20C,A01,083760,Staff,0,17,30,30
1651029837709,MATH 20C,A02,083761,Staff,0,15,30,30
1651029837709,MATH 20C,B01,083762,Staff,8,0,30,22
1651029837709,MATH 20C,B02,083763,Staff,28,0,30,2
1651029843744,MATH 20D,A01,083765,Staff,3,1,30,27
1651029843744,MATH 20D,A02,083766,Staff,1,0,30,29
1651029843744,MATH 20D,A03,083767,Staff,22,0,30,8
1651029849775,MATH 20E,A01,083771,Staff,2,0,30,28
1651029849775,MATH 20E,A02,083772,Staff,12,0,30,18
1651029849775,MATH 20E,B01,083773,Staff,0,0,30,30
1651029849775,MATH 20E,B02,083774,Staff,1,0,30,29
1651029855798,MATH 103A,A01,083777,Staff,0,17,30,30
1651029855798,MATH 103A,A02,083778,Staff,0,16,30,30
1651029855798,MATH 103A,B01,083779,Staff,0,15,30,30
1651029855798,MATH 103A,B02,083780,Staff,0,13,30,30
1651029861823,MATH 105,A01,085443,Staff,0,23,30,30
1651029867848,MATH 109,A01,083213,Anzaldo; Leesa B,0,8,30,30
1651029867848,MATH 109,A02,083214,Anzaldo; Leesa B,0,7,30,30
1651029867848,MATH 109,B01,083215,Anzaldo; Leesa B,0,8,30,30
1651029867848,MATH 109,B02,083216,Anzaldo; Leesa B,0,7,30,30
1651029873873,MATH 142A,A01,083219,Chow; Bennett,0,14,30,30
1651029873873,MATH 142A,A02,083220,Chow; Bennett,0,15,30,30
1651029873873,MATH 142A,B01,083221,Chow; Bennett,0,16,30,30
1651029873873,MATH 142A,B02,083222,Chow; Bennett,0,14,30,30
1651029879897,MATH 193A,A01,083224,Staff,0,8,30,30
1651029879897,MATH 193A,A02,083225,Staff,0,7,30,30
1651029879897,MATH 193A,A03,083781,Staff,0,7,30,30
1651029879897,MATH 193A,A04,083782,Staff,0,7,30,30
1651029885919,MATH 197,001,091859,McAuley; Julian John,9998,0,9999,1
1651029891970,COGS 9,A01,083615,Staff,0,19,60,60
1651029897993,COGS 11,A01,083617,Boyle; Mary E. T.,13,0,40,27
1651029904019,COGS 13,A01,083071,Staff,0,40,40,40
1651029910045,COGS 14A,A01,092681,Staff,0,40,100,100
1651029916070,COGS 14B,A01,083073,Cheng; Tzu-Han,0,13,50,50
1651029922106,COGS 17,A01,092677,Staff,8,0,75,67
1651029928128,COGS 100,A01,083619,Staff,0,30,60,60
1651029934156,COGS 101A,A01,083621,Davis; Joshua Daniel,0,29,60,60
1651029940180,COGS 101B,A01,091572,Staff,0,7,60,60
1651029946203,COGS 101C,A01,083625,Delgado; Tania,14,0,30,16
1651029952227,COGS 107A,A01,083627,Boyle; Mary E. T.,0,17,60,60
1651029958251,COGS 118A,A01,083075,Staff,0,10,60,60
1651029964275,CSE 3,A50,083646,Miranda; Gregory Joseph,15,0,38,23
1651029964275,CSE 3,A51,083647,Miranda; Gregory Joseph,36,0,37,1
1651029970305,CSE 8A,A50,083650,Miranda; Gregory Joseph,0,31,40,40
1651029976333,CSE 11,A01,083080,Cao; Yingjun,0,98,40,40
1651029982360,CSE 12,A01,083652,Staff,0,25,100,100
1651029988391,CSE 15L,A01,083654,Staff,0,3,50,50
1651029988391,CSE 15L,A02,083655,Staff,0,3,50,50
1651029994423,CSE 20,A01,083657,Staff,47,0,80,33
1651030000449,CSE 30,A01,083084,Eldon; John,1,39,80,79
1651030006473,CSE 100,A01,083659,Cao; Yingjun,0,72,50,50
1651030012496,CSE 134B,A01,083661,Powell; Thomas Allan,1,39,65,64
1651030018520,CSE 140,A01,083663,Staff,0,14,75,75
1651030024544,CSE 140L,A01,083088,Eldon; John,4,0,100,96
1651030030571,CSE 175,A01,083665,Kumar; Rakesh,0,0,25,25
1651030036597,CSE 190,A00,092507,Dubnov; Shlomo,9,0,20,11
1651030042621,ECE 45,A01,083139,Staff,0,7,60,60
1651030048645,ECE 65,A50,083695,Staff,0,7,30,30
1651030054676,ECE 109,A01,091882,Touri; Behrouz,32,0,70,38
1651030060704,ECE 180,A00,083140,Abi Samra; Nicholas Camill,17,0,30,13
1651030060704,ECE 180,B00,083141,Abi Samra; Nicholas Camill,0,0,30,30
1651030066729,MATH 10A,A01,083735,Patchell; Gregory David,1,0,30,29
1651030066729,MATH 10A,A02,083736,Patchell; Gregory David,27,0,30,3
1651030066729,MATH 10A,A03,083737,Patchell; Gregory David,23,0,30,7
1651030072754,MATH 10B,A01,083207,Staff,0,8,30,30
1651030072754,MATH 10B,A02,083208,Staff,0,6,30,30
1651030072754,MATH 10B,B01,083739,Staff,8,0,30,22
1651030072754,MATH 10B,B02,083740,Staff,28,0,30,2
1651030078783,MATH 18,A01,083743,Staff,0,0,30,30
1651030078783,MATH 18,A02,083744,Staff,23,0,30,7
1651030078783,MATH 18,A03,083745,Staff,19,0,30,11
1651030078783,MATH 18,A04,083746,Staff,26,0,30,4
1651030078783,MATH 18,B01,083748,Staff,0,16,30,30
1651030078783,MATH 18,B02,083749,Staff,0,14,30,30
1651030078783,MATH 18,B03,083750,Staff,0,14,30,30
1651030078783,MATH 18,B04,083751,Staff,0,13,30,30
1651030084810,MATH 20A,A01,083754,Staff,18,0,40,22
1651030090834,MATH 20B,A01,083756,Staff,0,14,30,30
1651030090834,MATH 20B,A02,083757,Staff,0,11,30,30
1651030096862,MATH 20C,A01,083760,Staff,0,17,30,30
1651030096862,MATH 20C,A02,083761,Staff,0,15,30,30
1651030096862,MATH 20C,B01,083762,Staff,8,0,30,22
1651030096862,MATH 20C,B02,083763,Staff,28,0,30,2
1651030102895,MATH 20D,A01,083765,Staff,3,1,30,27
1651030102895,MATH 20D,A02,083766,Staff,1,0,30,29
1651030102895,MATH 20D,A03,083767,Staff,22,0,30,8
1651030108920,MATH 20E,A01,083771,Staff,2,0,30,28
1651030108920,MATH 20E,A02,083772,Staff,12,0,30,18
1651030108920,MATH 20E,B01,083773,Staff,0,0,30,30
1651030108920,MATH 20E,B02,083774,Staff,1,0,30,29
1651030114951,MATH 103A,A01,083777,Staff,0,17,30,30
1651030114951,MATH 103A,A02,083778,Staff,0,16,30,30
1651030114951,MATH 103A,B01,083779,Staff,0,15,30,30
1651030114951,MATH 103A,B02,083780,Staff,0,13,30,30
1651030120975,MATH 105,A01,085443,Staff,0,23,30,30
1651030127000,MATH 109,A01,083213,Anzaldo; Leesa B,0,8,30,30
1651030127000,MATH 109,A02,083214,Anzaldo; Leesa B,0,7,30,30
1651030127000,MATH 109,B01,083215,Anzaldo; Leesa B,0,8,30,30
1651030127000,MATH 109,B02,083216,Anzaldo; Leesa B,0,7,30,30
1651030133023,MATH 142A,A01,083219,Chow; Bennett,0,14,30,30
1651030133023,MATH 142A,A02,083220,Chow; Bennett,0,15,30,30
1651030133023,MATH 142A,B01,083221,Chow; Bennett,0,16,30,30
1651030133023,MATH 142A,B02,083222,Chow; Bennett,0,14,30,30
1651030139047,MATH 193A,A01,083224,Staff,0,8,30,30
1651030139047,MATH 193A,A02,083225,Staff,0,7,30,30
1651030139047,MATH 193A,A03,083781,Staff,0,7,30,30
1651030139047,MATH 193A,A04,083782,Staff,0,7,30,30
1651030145075,MATH 197,001,091859,McAuley; Julian John,9998,0,9999,1
1651030151134,COGS 9,A01,083615,Staff,0,19,60,60
1651030157161,COGS 11,A01,083617,Boyle; Mary E. T.,13,0,40,27
1651030163184,COGS 13,A01,083071,Staff,0,40,40,40
1651030169207,COGS 14A,A01,092681,Staff,0,40,100,100
1651030175232,COGS 14B,A01,083073,Cheng; Tzu-Han,0,13,50,50
1651030181258,COGS 17,A01,092677,Staff,8,0,75,67
1651030187284,COGS 100,A01,083619,Staff,0,30,60,60
1651030193314,COGS 101A,A01,083621,Davis; Joshua Daniel,0,29,60,60
1651030199342,COGS 101B,A01,091572,Staff,0,7,60,60
1651030205370,COGS 101C,A01,083625,Delgado; Tania,14,0,30,16
1651030211403,COGS 107A,A01,083627,Boyle; Mary E. T.,0,17,60,60
1651030217426,COGS 118A,A01,083075,Staff,0,10,60,60
1651030223451,CSE 3,A50,083646,Miranda; Gregory Joseph,15,0,38,23
1651030223451,CSE 3,A51,083647,Miranda; Gregory Joseph,36,0,37,1
1651030229474,CSE 8A,A50,083650,Miranda; Gregory Joseph,0,31,40,40
1651030235498,CSE 11,A01,083080,Cao; Yingjun,0,98,40,40
1651030241528,CSE 12,A01,083652,Staff,0,25,100,100
1651030247551,CSE 15L,A01,083654,Staff,0,3,50,50
1651030247551,CSE 15L,A02,083655,Staff,0,3,50,50
1651030253582,CSE 20,A01,083657,Staff,47,0,80,33
1651030259606,CSE 30,A01,083084,Eldon; John,1,39,80,79
1651030265637,CSE 100,A01,083659,Cao; Yingjun,0,72,50,50
1651030271664,CSE 134B,A01,083661,Powell; Thomas Allan,1,39,65,64
1651030277688,CSE 140,A01,083663,Staff,0,14,75,75
1651030283715,CSE 140L,A01,083088,Eldon; John,4,0,100,96
1651030289740,CSE 175,A01,083665,Kumar; Rakesh,0,0,25,25
1651030295778,CSE 190,A00,092507,Dubnov; Shlomo,9,0,20,11
1651030301891,ECE 45,A01,083139,Staff,0,7,60,60
1651030307913,ECE 65,A50,083695,Staff,0,7,30,30
1651030313939,ECE 109,A01,091882,Touri; Behrouz,32,0,70,38
1651030319962,ECE 180,A00,083140,Abi Samra; Nicholas Camill,17,0,30,13
1651030319962,ECE 180,B00,083141,Abi Samra; Nicholas Camill,0,0,30,30
1651030325985,MATH 10A,A01,083735,Patchell; Gregory David,1,0,30,29
1651030325985,MATH 10A,A02,083736,Patchell; Gregory David,27,0,30,3
1651030325985,MATH 10A,A03,083737,Patchell; Gregory David,23,0,30,7
1651030332013,MATH 10B,A01,083207,Staff,0,8,30,30
1651030332013,MATH 10B,A02,083208,Staff,0,6,30,30
1651030332013,MATH 10B,B01,083739,Staff,7,0,30,23
1651030332013,MATH 10B,B02,083740,Staff,28,0,30,2
1651030338037,MATH 18,A01,083743,Staff,0,0,30,30
1651030338037,MATH 18,A02,083744,Staff,23,0,30,7
1651030338037,MATH 18,A03,083745,Staff,19,0,30,11
1651030338037,MATH 18,A04,083746,Staff,26,0,30,4
1651030338037,MATH 18,B01,083748,Staff,0,16,30,30
1651030338037,MATH 18,B02,083749,Staff,0,14,30,30
1651030338037,MATH 18,B03,083750,Staff,0,14,30,30
1651030338037,MATH 18,B04,083751,Staff,0,13,30,30
1651030344062,MATH 20A,A01,083754,Staff,18,0,40,22
1651030350089,MATH 20B,A01,083756,Staff,0,14,30,30
1651030350089,MATH 20B,A02,083757,Staff,0,11,30,30
1651030356112,MATH 20C,A01,083760,Staff,0,17,30,30
1651030356112,MATH 20C,A02,083761,Staff,0,15,30,30
1651030356112,MATH 20C,B01,083762,Staff,8,0,30,22
1651030356112,MATH 20C,B02,083763,Staff,28,0,30,2
1651030362140,MATH 20D,A01,083765,Staff,3,1,30,27
1651030362140,MATH 20D,A02,083766,Staff,1,0,30,29
1651030362140,MATH 20D,A03,083767,Staff,22,0,30,8
1651030368182,MATH 20E,A01,083771,Staff,2,0,30,28
1651030368182,MATH 20E,A02,083772,Staff,12,0,30,18
1651030368182,MATH 20E,B01,083773,Staff,0,0,30,30
1651030368182,MATH 20E,B02,083774,Staff,1,0,30,29
1651030374220,MATH 103A,A01,083777,Staff,0,17,30,30
1651030374220,MATH 103A,A02,083778,Staff,0,16,30,30
1651030374220,MATH 103A,B01,083779,Staff,0,15,30,30
1651030374220,MATH 103A,B02,083780,Staff,0,13,30,30
1651030380252,MATH 105,A01,085443,Staff,0,23,30,30
1651030386276,MATH 109,A01,083213,Anzaldo; Leesa B,0,8,30,30
1651030386276,MATH 109,A02,083214,Anzaldo; Leesa B,0,7,30,30
1651030386276,MATH 109,B01,083215,Anzaldo; Leesa B,0,8,30,30
1651030386276,MATH 109,B02,083216,Anzaldo; Leesa B,0,7,30,30
1651030392304,MATH 142A,A01,083219,Chow; Bennett,0,14,30,30
1651030392304,MATH 142A,A02,083220,Chow; Bennett,0,15,30,30
1651030392304,MATH 142A,B01,083221,Chow; Bennett,0,16,30,30
1651030392304,MATH 142A,B02,083222,Chow; Bennett,0,14,30,30
1651030398332,MATH 193A,A01,083224,Staff,0,8,30,30
1651030398332,MATH 193A,A02,083225,Staff,0,7,30,30
1651030398332,MATH 193A,A03,083781,Staff,0,7,30,30
1651030398332,MATH 193A,A04,083782,Staff,0,7,30,30
1651030404362,MATH 197,001,091859,McAuley; Julian John,9998,0,9999,1
1651030410427,COGS 9,A01,083615,Staff,0,19,60,60
1651030416451,COGS 11,A01,083617,Boyle; Mary E. T.,13,0,40,27
1651030422475,COGS 13,A01,083071,Staff,0,40,40,40
1651030428501,COGS 14A,A01,092681,Staff,0,40,100,100
1651030434524,COGS 14B,A01,083073,Cheng; Tzu-Han,0,13,50,50
1651030440547,COGS 17,A01,092677,Staff,8,0,75,67
1651030446571,COGS 100,A01,083619,Staff,0,30,60,60
1651030452598,COGS 101A,A01,083621,Davis; Joshua Daniel,0,29,60,60
1651030458621,COGS 101B,A01,091572,Staff,0,7,60,60
1651030464648,COGS 101C,A01,083625,Delgado; Tania,14,0,30,16
1651030470673,COGS 107A,A01,083627,Boyle; Mary E. T.,0,17,60,60
1651030476700,COGS 118A,A01,083075,Staff,0,10,60,60
1651030482727,CSE 3,A50,083646,Miranda; Gregory Joseph,15,0,38,23
1651030482727,CSE 3,A51,083647,Miranda; Gregory Joseph,36,0,37,1
1651030488750,CSE 8A,A50,083650,Miranda; Gregory Joseph,0,31,40,40
1651030494776,CSE 11,A01,083080,Cao; Yingjun,0,98,40,40
1651030500804,CSE 12,A01,083652,Staff,0,25,100,100
1651030506825,CSE 15L,A01,083654,Staff,0,3,50,50
1651030506825,CSE 15L,A02,083655,Staff,0,3,50,50
1651030512849,CSE 20,A01,083657,Staff,47,0,80,33
1651030518872,CSE 30,A01,083084,Eldon; John,1,39,80,79
1651030524898,CSE 100,A01,083659,Cao; Yingjun,0,72,50,50
1651030530921,CSE 134B,A01,083661,Powell; Thomas Allan,1,39,65,64
1651030536947,CSE 140,A01,083663,Staff,0,14,75,75
1651030542983,CSE 140L,A01,083088,Eldon; John,4,0,100,96
1651030549020,CSE 175,A01,083665,Kumar; Rakesh,0,0,25,25
1651030555043,CSE 190,A00,092507,Dubnov; Shlomo,9,0,20,11
1651030561066,ECE 45,A01,083139,Staff,0,7,60,60
1651030567093,ECE 65,A50,083695,Staff,0,7,30,30
1651030573118,ECE 109,A01,091882,Touri; Behrouz,32,0,70,38
1651030579142,ECE 180,A00,083140,Abi Samra; Nicholas Camill,17,0,30,13
1651030579142,ECE 180,B00,083141,Abi Samra; Nicholas Camill,0,0,30,30
1651030585166,MATH 10A,A01,083735,Patchell; Gregory David,1,0,30,29
1651030585166,MATH 10A,A02,083736,Patchell; Gregory David,27,0,30,3
1651030585166,MATH 10A,A03,083737,Patchell; Gregory David,23,0,30,7
1651030591189,MATH 10B,A01,083207,Staff,0,8,30,30
1651030591189,MATH 10B,A02,083208,Staff,0,6,30,30
1651030591189,MATH 10B,B01,083739,Staff,7,0,30,23
1651030591189,MATH 10B,B02,083740,Staff,28,0,30,2
1651030597219,MATH 18,A01,083743,Staff,0,0,30,30
1651030597219,MATH 18,A02,083744,Staff,23,0,30,7
1651030597219,MATH 18,A03,083745,Staff,19,0,30,11
1651030597219,MATH 18,A04,083746,Staff,26,0,30,4
1651030597219,MATH 18,B01,083748,Staff,0,16,30,30
1651030597219,MATH 18,B02,083749,Staff,0,14,30,30
1651030597219,MATH 18,B03,083750,Staff,0,14,30,30
1651030597219,MATH 18,B04,083751,Staff,0,13,30,30
1651030603243,MATH 20A,A01,083754,Staff,18,0,40,22
1651030609265,MATH 20B,A01,083756,Staff,0,14,30,30
1651030609265,MATH 20B,A02,083757,Staff,0,11,30,30
1651030615288,MATH 20C,A01,083760,Staff,0,16,30,30
1651030615288,MATH 20C,A02,083761,Staff,0,15,30,30
1651030615288,MATH 20C,B01,083762,Staff,8,0,30,22
1651030615288,MATH 20C,B02,083763,Staff,28,0,30,2
1651030621314,MATH 20D,A01,083765,Staff,3,1,30,27
1651030621314,MATH 20D,A02,083766,Staff,1,0,30,29
1651030621314,MATH 20D,A03,083767,Staff,22,0,30,8
1651030627338,MATH 20E,A01,083771,Staff,2,0,30,28
1651030627338,MATH 20E,A02,083772,Staff,12,0,30,18
1651030627338,MATH 20E,B01,083773,Staff,0,0,30,30
1651030627338,MATH 20E,B02,083774,Staff,1,0,30,29
1651030633362,MATH 103A,A01,083777,Staff,0,17,30,30
1651030633362,MATH 103A,A02,083778,Staff,0,16,30,30
1651030633362,MATH 103A,B01,083779,Staff,0,15,30,30
1651030633362,MATH 103A,B02,083780,Staff,0,13,30,30
1651030639390,MATH 105,A01,085443,Staff,0,23,30,30
1651030645422,MATH 109,A01,083213,Anzaldo; Leesa B,0,8,30,30
1651030645422,MATH 109,A02,083214,Anzaldo; Leesa B,0,7,30,30
1651030645422,MATH 109,B01,083215,Anzaldo; Leesa B,0,8,30,30
1651030645422,MATH 109,B02,083216,Anzaldo; Leesa B,0,7,30,30
1651030651450,MATH 142A,A01,083219,Chow; Bennett,0,14,30,30
1651030651450,MATH 142A,A02,083220,Chow; Bennett,0,15,30,30
1651030651450,MATH 142A,B01,083221,Chow; Bennett,0,16,30,30
1651030651450,MATH 142A,B02,083222,Chow; Bennett,0,14,30,30
1651030657477,MATH 193A,A01,083224,Staff,0,8,30,30
1651030657477,MATH 193A,A02,083225,Staff,0,7,30,30
1651030657477,MATH 193A,A03,083781,Staff,0,7,30,30
1651030657477,MATH 193A,A04,083782,Staff,0,7,30,30
1651030663507,MATH 197,001,091859,McAuley; Julian John,9998,0,9999,1
1651030669563,COGS 9,A01,083615,Staff,0,19,60,60
1651030675589,COGS 11,A01,083617,Boyle; Mary E. T.,13,0,40,27
1651030681613,COGS 13,A01,083071,Staff,0,40,40,40
1651030687637,COGS 14A,A01,092681,Staff,0,40,100,100
1651030693664,COGS 14B,A01,083073,Cheng; Tzu-Han,0,13,50,50
1651030699695,COGS 17,A01,092677,Staff,8,0,75,67
1651030705718,COGS 100,A01,083619,Staff,0,30,60,60
1651030711742,COGS 101A,A01,083621,Davis; Joshua Daniel,0,29,60,60
1651030717769,COGS 101B,A01,091572,Staff,0,7,60,60
1651030723792,COGS 101C,A01,083625,Delgado; Tania,14,0,30,16
1651030729814,COGS 107A,A01,083627,Boyle; Mary E. T.,0,17,60,60
1651030735838,COGS 118A,A01,083075,Staff,0,10,60,60
1651030741868,CSE 3,A50,083646,Miranda; Gregory Joseph,15,0,38,23
1651030741868,CSE 3,A51,083647,Miranda; Gregory Joseph,36,0,37,1
1651030747891,CSE 8A,A50,083650,Miranda; Gregory Joseph,0,31,40,40
1651030753913,CSE 11,A01,083080,Cao; Yingjun,0,98,40,40
1651030759935,CSE 12,A01,083652,Staff,0,25,100,100
1651030765959,CSE 15L,A01,083654,Staff,0,3,50,50
1651030765959,CSE 15L,A02,083655,Staff,0,3,50,50
1651030771984,CSE 20,A01,083657,Staff,47,0,80,33
1651030778011,CSE 30,A01,083084,Eldon; John,1,39,80,79
1651030784037,CSE 100,A01,083659,Cao; Yingjun,0,72,50,50
1651030790064,CSE 134B,A01,083661,Powell; Thomas Allan,1,39,65,64
1651030796088,CSE 140,A01,083663,Staff,0,14,75,75
1651030802111,CSE 140L,A01,083088,Eldon; John,4,0,100,96
1651030808135,CSE 175,A01,083665,Kumar; Rakesh,0,0,25,25
1651030814160,CSE 190,A00,092507,Dubnov; Shlomo,9,0,20,11
1651030820184,ECE 45,A01,083139,Staff,0,7,60,60
1651030826212,ECE 65,A50,083695,Staff,0,7,30,30
1651030832236,ECE 109,A01,091882,Touri; Behrouz,32,0,70,38
1651030838263,ECE 180,A00,083140,Abi Samra; Nicholas Camill,17,0,30,13
1651030838263,ECE 180,B00,083141,Abi Samra; Nicholas Camill,0,0,30,30
1651030844287,MATH 10A,A01,083735,Patchell; Gregory David,1,0,30,29
1651030844287,MATH 10A,A02,083736,Patchell; Gregory David,27,0,30,3
1651030844287,MATH 10A,A03,083737,Patchell; Gregory David,23,0,30,7
1651030850314,MATH 10B,A01,083207,Staff,0,8,30,30
1651030850314,MATH 10B,A02,083208,Staff,0,6,30,30
1651030850314,MATH 10B,B01,083739,Staff,7,0,30,23
1651030850314,MATH 10B,B02,083740,Staff,28,0,30,2
1651030856343,MATH 18,A01,083743,Staff,0,0,30,30
1651030856343,MATH 18,A02,083744,Staff,23,0,30,7
1651030856343,MATH 18,A03,083745,Staff,19,0,30,11
1651030856343,MATH 18,A04,083746,Staff,26,0,30,4
1651030856343,MATH 18,B01,083748,Staff,0,16,30,30
1651030856343,MATH 18,B02,083749,Staff,0,14,30,30
1651030856343,MATH 18,B03,083750,Staff,0,14,30,30
1651030856343,MATH 18,B04,083751,Staff,0,13,30,30
1651030862367,MATH 20A,A01,083754,Staff,18,0,40,22
1651030868393,MATH 20B,A01,083756,Staff,0,14,30,30
1651030868393,MATH 20B,A02,083757,Staff,0,11,30,30
1651030874417,MATH 20C,A01,083760,Staff,0,16,30,30
1651030874417,MATH 20C,A02,083761,Staff,0,15,30,30
1651030874417,MATH 20C,B01,083762,Staff,8,0,30,22
1651030874417,MATH 20C,B02,083763,Staff,28,0,30,2
1651030880441,MATH 20D,A01,083765,Staff,3,1,30,27
1651030880441,MATH 20D,A02,083766,Staff,1,0,30,29
1651030880441,MATH 20D,A03,083767,Staff,22,0,30,8
1651030886467,MATH 20E,A01,083771,Staff,2,0,30,28
1651030886467,MATH 20E,A02,083772,Staff,12,0,30,18
1651030886467,MATH 20E,B01,083773,Staff,0,0,30,30
1651030886467,MATH 20E,B02,083774,Staff,1,0,30,29
1651030892490,MATH 103A,A01,083777,Staff,0,17,30,30
1651030892490,MATH 103A,A02,083778,Staff,0,16,30,30
1651030892490,MATH 103A,B01,083779,Staff,0,15,30,30
1651030892490,MATH 103A,B02,083780,Staff,0,13,30,30
1651030898605,MATH 105,A01,085443,Staff,0,23,30,30
1651030904778,MATH 109,A01,083213,Anzaldo; Leesa B,0,8,30,30
1651030904778,MATH 109,A02,083214,Anzaldo; Leesa B,0,7,30,30
1651030904778,MATH 109,B01,083215,Anzaldo; Leesa B,0,8,30,30
1651030904778,MATH 109,B02,083216,Anzaldo; Leesa B,0,7,30,30
1651030910806,MATH 142A,A01,083219,Chow; Bennett,0,14,30,30
1651030910806,MATH 142A,A02,083220,Chow; Bennett,0,15,30,30
1651030910806,MATH 142A,B01,083221,Chow; Bennett,0,16,30,30
1651030910806,MATH 142A,B02,083222,Chow; Bennett,0,14,30,30
1651030916829,MATH 193A,A01,083224,Staff,0,8,30,30
1651030916829,MATH 193A,A02,083225,Staff,0,7,30,30
1651030916829,MATH 193A,A03,083781,Staff,0,7,30,30
1651030916829,MATH 193A,A04,083782,Staff,0,7,30,30
1651030922854,MATH 197,001,091859,McAuley; Julian John,9998,0,9999,1
1651030928910,COGS 9,A01,083615,Staff,0,19,60,60
1651030934935,COGS 11,A01,083617,Boyle; Mary E. T.,13,0,40,27
1651030940966,COGS 13,A01,083071,Staff,0,40,40,40
1651030946990,COGS 14A,A01,092681,Staff,0,40,100,100
1651030953016,COGS 14B,A01,083073,Cheng; Tzu-Han,0,13,50,50
1651030959041,COGS 17,A01,092677,Staff,8,0,75,67
1651030965065,COGS 100,A01,083619,Staff,0,30,60,60
1651030971098,COGS 101A,A01,083621,Davis; Joshua Daniel,0,29,60,60
1651030977122,COGS 101B,A01,091572,Staff,0,7,60,60
1651030983148,COGS 101C,A01,083625,Delgado; Tania,14,0,30,16
1651030989171,COGS 107A,A01,083627,Boyle; Mary E. T.,0,17,60,60
1651030995196,COGS 118A,A01,083075,Staff,0,10,60,60
1651031001219,CSE 3,A50,083646,Miranda; Gregory Joseph,15,0,38,23
1651031001219,CSE 3,A51,083647,Miranda; Gregory Joseph,36,0,37,1
1651031007249,CSE 8A,A50,083650,Miranda; Gregory Joseph,0,31,40,40
1651031013274,CSE 11,A01,083080,Cao; Yingjun,0,98,40,40
1651031019302,CSE 12,A01,083652,Staff,0,25,100,100
1651031025329,CSE 15L,A01,083654,Staff,0,3,50,50
1651031025329,CSE 15L,A02,083655,Staff,0,3,50,50
1651031031354,CSE 20,A01,083657,Staff,47,0,80,33
1651031037390,CSE 30,A01,083084,Eldon; John,1,39,80,79
1651031043413,CSE 100,A01,083659,Cao; Yingjun,0,72,50,50
1651031049439,CSE 134B,A01,083661,Powell; Thomas Allan,1,39,65,64
1651031055463,CSE 140,A01,083663,Staff,0,14,75,75
1651031061487,CSE 140L,A01,083088,Eldon; John,4,0,100,96
1651031067511,CSE 175,A01,083665,Kumar; Rakesh,0,0,25,25
1651031073535,CSE 190,A00,092507,Dubnov; Shlomo,9,0,20,11
1651031079561,ECE 45,A01,083139,Staff,0,7,60,60
1651031085584,ECE 65,A50,083695,Staff,0,7,30,30
1651031091606,ECE 109,A01,091882,Touri; Behrouz,32,0,70,38
1651031097631,ECE 180,A00,083140,Abi Samra; Nicholas Camill,17,0,30,13
1651031097631,ECE 180,B00,083141,Abi Samra; Nicholas Camill,0,0,30,30
1651031103655,MATH 10A,A01,083735,Patchell; Gregory David,1,0,30,29
1651031103655,MATH 10A,A02,083736,Patchell; Gregory David,27,0,30,3
1651031103655,MATH 10A,A03,083737,Patchell; Gregory David,23,0,30,7
1651031109679,MATH 10B,A01,083207,Staff,0,8,30,30
1651031109679,MATH 10B,A02,083208,Staff,0,6,30,30
1651031109679,MATH 10B,B01,083739,Staff,7,0,30,23
1651031109679,MATH 10B,B02,083740,Staff,28,0,30,2
1651031115702,MATH 18,A01,083743,Staff,0,0,30,30
1651031115702,MATH 18,A02,083744,Staff,23,0,30,7
1651031115702,MATH 18,A03,083745,Staff,19,0,30,11
1651031115702,MATH 18,A04,083746,Staff,26,0,30,4
1651031115702,MATH 18,B01,083748,Staff,0,16,30,30
1651031115702,MATH 18,B02,083749,Staff,0,14,30,30
1651031115702,MATH 18,B03,083750,Staff,0,14,30,30
1651031115702,MATH 18,B04,083751,Staff,0,13,30,30
1651031121725,MATH 20A,A01,083754,Staff,18,0,40,22
1651031127748,MATH 20B,A01,083756,Staff,0,14,30,30
1651031127748,MATH 20B,A02,083757,Staff,0,11,30,30
1651031133772,MATH 20C,A01,083760,Staff,0,16,30,30
1651031133772,MATH 20C,A02,083761,Staff,0,15,30,30
1651031133772,MATH 20C,B01,083762,Staff,8,0,30,22
1651031133772,MATH 20C,B02,083763,Staff,28,0,30,2
1651031139800,MATH 20D,A01,083765,Staff,3,1,30,27
1651031139800,MATH 20D,A02,083766,Staff,1,0,30,29
1651031139800,MATH 20D,A03,083767,Staff,22,0,30,8
1651031145833,MATH 20E,A01,083771,Staff,2,0,30,28
1651031145833,MATH 20E,A02,083772,Staff,12,0,30,18
1651031145833,MATH 20E,B01,083773,Staff,0,0,30,30
1651031145833,MATH 20E,B02,083774,Staff,1,0,30,29
1651031151856,MATH 103A,A01,083777,Staff,0,17,30,30
1651031151856,MATH 103A,A02,083778,Staff,0,16,30,30
1651031151856,MATH 103A,B01,083779,Staff,0,15,30,30
1651031151856,MATH 103A,B02,083780,Staff,0,13,30,30
1651031157879,MATH 105,A01,085443,Staff,0,23,30,30
1651031163923,MATH 109,A01,083213,Anzaldo; Leesa B,0,8,30,30
1651031163923,MATH 109,A02,083214,Anzaldo; Leesa B,0,7,30,30
1651031163923,MATH 109,B01,083215,Anzaldo; Leesa B,0,8,30,30
1651031163923,MATH 109,B02,083216,Anzaldo; Leesa B,0,7,30,30
1651031169950,MATH 142A,A01,083219,Chow; Bennett,0,14,30,30
1651031169950,MATH 142A,A02,083220,Chow; Bennett,0,15,30,30
1651031169950,MATH 142A,B01,083221,Chow; Bennett,0,16,30,30
1651031169950,MATH 142A,B02,083222,Chow; Bennett,0,14,30,30
1651031175979,MATH 193A,A01,083224,Staff,0,8,30,30
1651031175979,MATH 193A,A02,083225,Staff,0,7,30,30
1651031175979,MATH 193A,A03,083781,Staff,0,7,30,30
1651031175979,MATH 193A,A04,083782,Staff,0,7,30,30
1651031182002,MATH 197,001,091859,McAuley; Julian John,9998,0,9999,1
1651031188059,COGS 9,A01,083615,Staff,0,19,60,60
1651031194091,COGS 11,A01,083617,Boyle; Mary E. T.,13,0,40,27
1651031200114,COGS 13,A01,083071,Staff,0,40,40,40
1651031206138,COGS 14A,A01,092681,Staff,0,40,100,100
1651031212163,COGS 14B,A01,083073,Cheng; Tzu-Han,0,13,50,50
1651031218195,COGS 17,A01,092677,Staff,8,0,75,67
1651031224218,COGS 100,A01,083619,Staff,0,30,60,60
1651031230242,COGS 101A,A01,083621,Davis; Joshua Daniel,0,29,60,60
1651031236266,COGS 101B,A01,091572,Staff,0,7,60,60
1651031242309,COGS 101C,A01,083625,Delgado; Tania,14,0,30,16
1651031248336,COGS 107A,A01,083627,Boyle; Mary E. T.,0,17,60,60
1651031254360,COGS 118A,A01,083075,Staff,0,10,60,60
1651031260385,CSE 3,A50,083646,Miranda; Gregory Joseph,15,0,38,23
1651031260385,CSE 3,A51,083647,Miranda; Gregory Joseph,36,0,37,1
1651031266408,CSE 8A,A50,083650,Miranda; Gregory Joseph,0,31,40,40
1651031272435,CSE 11,A01,083080,Cao; Yingjun,0,98,40,40
1651031278458,CSE 12,A01,083652,Staff,0,25,100,100
1651031284484,CSE 15L,A01,083654,Staff,0,3,50,50
1651031284484,CSE 15L,A02,083655,Staff,0,3,50,50
1651031290513,CSE 20,A01,083657,Staff,47,0,80,33
1651031296547,CSE 30,A01,083084,Eldon; John,1,39,80,79
1651031302570,CSE 100,A01,083659,Cao; Yingjun,0,72,50,50
1651031308593,CSE 134B,A01,083661,Powell; Thomas Allan,1,39,65,64
1651031314627,CSE 140,A01,083663,Staff,0,14,75,75
1651031320664,CSE 140L,A01,083088,Eldon; John,4,0,100,96
1651031326688,CSE 175,A01,083665,Kumar; Rakesh,0,0,25,25
1651031332712,CSE 190,A00,092507,Dubnov; Shlomo,9,0,20,11
1651031338734,ECE 45,A01,083139,Staff,0,7,60,60
1651031344760,ECE 65,A50,083695,Staff,0,7,30,30
1651031350795,ECE 109,A01,091882,Touri; Behrouz,32,0,70,38
1651031356817,ECE 180,A00,083140,Abi Samra; Nicholas Camill,17,0,30,13
1651031356817,ECE 180,B00,083141,Abi Samra; Nicholas Camill,0,0,30,30
1651031362841,MATH 10A,A01,083735,Patchell; Gregory David,1,0,30,29
1651031362841,MATH 10A,A02,083736,Patchell; Gregory David,27,0,30,3
1651031362841,MATH 10A,A03,083737,Patchell; Gregory David,23,0,30,7
1651031368864,MATH 10B,A01,083207,Staff,0,8,30,30
1651031368864,MATH 10B,A02,083208,Staff,0,6,30,30
1651031368864,MATH 10B,B01,083739,Staff,8,0,30,22
1651031368864,MATH 10B,B02,083740,Staff,28,0,30,2
1651031374894,MATH 18,A01,083743,Staff,0,0,30,30
1651031374894,MATH 18,A02,083744,Staff,23,0,30,7
1651031374894,MATH 18,A03,083745,Staff,19,0,30,11
1651031374894,MATH 18,A04,083746,Staff,26,0,30,4
1651031374894,MATH 18,B01,083748,Staff,0,16,30,30
1651031374894,MATH 18,B02,083749,Staff,0,14,30,30
1651031374894,MATH 18,B03,083750,Staff,0,14,30,30
1651031374894,MATH 18,B04,083751,Staff,0,13,30,30
1651031380917,MATH 20A,A01,083754,Staff,18,0,40,22
1651031386940,MATH 20B,A01,083756,Staff,0,14,30,30
1651031386940,MATH 20B,A02,083757,Staff,0,11,30,30
1651031392966,MATH 20C,A01,083760,Staff,0,16,30,30
1651031392966,MATH 20C,A02,083761,Staff,0,15,30,30
1651031392966,MATH 20C,B01,083762,Staff,8,0,30,22
1651031392966,MATH 20C,B02,083763,Staff,28,0,30,2
1651031398993,MATH 20D,A01,083765,Staff,3,1,30,27
1651031398993,MATH 20D,A02,083766,Staff,1,0,30,29
1651031398993,MATH 20D,A03,083767,Staff,22,0,30,8
1651031405016,MATH 20E,A01,083771,Staff,2,0,30,28
1651031405016,MATH 20E,A02,083772,Staff,12,0,30,18
1651031405016,MATH 20E,B01,083773,Staff,0,0,30,30
1651031405016,MATH 20E,B02,083774,Staff,0,0,30,30
1651031411040,MATH 103A,A01,083777,Staff,0,17,30,30
1651031411040,MATH 103A,A02,083778,Staff,0,16,30,30
1651031411040,MATH 103A,B01,083779,Staff,0,15,30,30
1651031411040,MATH 103A,B02,083780,Staff,0,13,30,30
1651031417063,MATH 105,A01,085443,Staff,0,23,30,30
1651031423090,MATH 109,A01,083213,Anzaldo; Leesa B,0,8,30,30
1651031423090,MATH 109,A02,083214,Anzaldo; Leesa B,0,7,30,30
1651031423090,MATH 109,B01,083215,Anzaldo; Leesa B,0,8,30,30
1651031423090,MATH 109,B02,083216,Anzaldo; Leesa B,0,7,30,30
1651031429121,MATH 142A,A01,083219,Chow; Bennett,0,14,30,30
1651031429121,MATH 142A,A02,083220,Chow; Bennett,0,15,30,30
1651031429121,MATH 142A,B01,083221,Chow; Bennett,0,16,30,30
1651031429121,MATH 142A,B02,083222,Chow; Bennett,0,14,30,30
1651031435144,MATH 193A,A01,083224,Staff,0,8,30,30
1651031435144,MATH 193A,A02,083225,Staff,0,7,30,30
1651031435144,MATH 193A,A03,083781,Staff,0,7,30,30
1651031435144,MATH 193A,A04,083782,Staff,0,7,30,30
1651031441170,MATH 197,001,091859,McAuley; Julian John,9998,0,9999,1
1651031447243,COGS 9,A01,083615,Staff,0,19,60,60
1651031453266,COGS 11,A01,083617,Boyle; Mary E. T.,13,0,40,27
1651031459288,COGS 13,A01,083071,Staff,0,40,40,40
1651031465314,COGS 14A,A01,092681,Staff,0,40,100,100
1651031471348,COGS 14B,A01,083073,Cheng; Tzu-Han,0,13,50,50
1651031477375,COGS 17,A01,092677,Staff,8,0,75,67
1651031483412,COGS 100,A01,083619,Staff,0,30,60,60
1651031489526,COGS 101A,A01,083621,Davis; Joshua Daniel,0,29,60,60
1651031495552,COGS 101B,A01,091572,Staff,0,7,60,60
1651031501573,COGS 101C,A01,083625,Delgado; Tania,14,0,30,16
1651031507595,COGS 107A,A01,083627,Boyle; Mary E. T.,0,17,60,60
1651031513623,COGS 118A,A01,083075,Staff,0,10,60,60
1651031519660,CSE 3,A50,083646,Miranda; Gregory Joseph,15,0,38,23
1651031519660,CSE 3,A51,083647,Miranda; Gregory Joseph,36,0,37,1
1651031525681,CSE 8A,A50,083650,Miranda; Gregory Joseph,0,31,40,40
1651031531713,CSE 11,A01,083080,Cao; Yingjun,0,98,40,40
1651031537736,CSE 12,A01,083652,Staff,0,25,100,100
1651031543760,CSE 15L,A01,083654,Staff,0,3,50,50
1651031543760,CSE 15L,A02,083655,Staff,0,3,50,50
1651031549784,CSE 20,A01,083657,Staff,47,0,80,33
1651031555809,CSE 30,A01,083084,Eldon; John,1,39,80,79
1651031561836,CSE 100,A01,083659,Cao; Yingjun,0,72,50,50
1651031567859,CSE 134B,A01,083661,Powell; Thomas Allan,1,39,65,64
1651031573883,CSE 140,A01,083663,Staff,0,14,75,75
1651031579911,CSE 140L,A01,083088,Eldon; John,4,0,100,96
1651031585940,CSE 175,A01,083665,Kumar; Rakesh,0,0,25,25
1651031591962,CSE 190,A00,092507,Dubnov; Shlomo,9,0,20,11
1651031597987,ECE 45,A01,083139,Staff,0,7,60,60
1651031604010,ECE 65,A50,083695,Staff,0,7,30,30
1651031610032,ECE 109,A01,091882,Touri; Behrouz,32,0,70,38
1651031616056,ECE 180,A00,083140,Abi Samra; Nicholas Camill,17,0,30,13
1651031616056,ECE 180,B00,083141,Abi Samra; Nicholas Camill,0,0,30,30
1651031622078,MATH 10A,A01,083735,Patchell; Gregory David,1,0,30,29
1651031622078,MATH 10A,A02,083736,Patchell; Gregory David,27,0,30,3
1651031622078,MATH 10A,A03,083737,Patchell; Gregory David,23,0,30,7
1651031628102,MATH 10B,A01,083207,Staff,0,8,30,30
1651031628102,MATH 10B,A02,083208,Staff,0,6,30,30
1651031628102,MATH 10B,B01,083739,Staff,8,0,30,22
1651031628102,MATH 10B,B02,083740,Staff,28,0,30,2
1651031634137,MATH 18,A01,083743,Staff,0,0,30,30
1651031634137,MATH 18,A02,083744,Staff,23,0,30,7
1651031634137,MATH 18,A03,083745,Staff,19,0,30,11
1651031634137,MATH 18,A04,083746,Staff,26,0,30,4
1651031634137,MATH 18,B01,083748,Staff,0,16,30,30
1651031634137,MATH 18,B02,083749,Staff,0,14,30,30
1651031634137,MATH 18,B03,083750,Staff,0,14,30,30
1651031634137,MATH 18,B04,083751,Staff,0,13,30,30
1651031640163,MATH 20A,A01,083754,Staff,18,0,40,22
1651031646186,MATH 20B,A01,083756,Staff,0,14,30,30
1651031646186,MATH 20B,A02,083757,Staff,0,11,30,30
1651031652213,MATH 20C,A01,083760,Staff,0,16,30,30
1651031652213,MATH 20C,A02,083761,Staff,0,15,30,30
1651031652213,MATH 20C,B01,083762,Staff,8,0,30,22
1651031652213,MATH 20C,B02,083763,Staff,28,0,30,2
1651031658243,MATH 20D,A01,083765,Staff,3,1,30,27
1651031658243,MATH 20D,A02,083766,Staff,1,0,30,29
1651031658243,MATH 20D,A03,083767,Staff,22,0,30,8
1651031664266,MATH 20E,A01,083771,Staff,2,0,30,28
1651031664266,MATH 20E,A02,083772,Staff,12,0,30,18
1651031664266,MATH 20E,B01,083773,Staff,0,0,30,30
1651031664266,MATH 20E,B02,083774,Staff,0,0,30,30
1651031670289,MATH 103A,A01,083777,Staff,0,17,30,30
1651031670289,MATH 103A,A02,083778,Staff,0,16,30,30
1651031670289,MATH 103A,B01,083779,Staff,0,15,30,30
1651031670289,MATH 103A,B02,083780,Staff,0,13,30,30
1651031676313,MATH 105,A01,085443,Staff,0,23,30,30
1651031682336,MATH 109,A01,083213,Anzaldo; Leesa B,0,8,30,30
1651031682336,MATH 109,A02,083214,Anzaldo; Leesa B,0,7,30,30
1651031682336,MATH 109,B01,083215,Anzaldo; Leesa B,0,8,30,30
1651031682336,MATH 109,B02,083216,Anzaldo; Leesa B,0,7,30,30
1651031688365,MATH 142A,A01,083219,Chow; Bennett,0,14,30,30
1651031688365,MATH 142A,A02,083220,Chow; Bennett,0,15,30,30
1651031688365,MATH 142A,B01,083221,Chow; Bennett,0,16,30,30
1651031688365,MATH 142A,B02,083222,Chow; Bennett,0,14,30,30
1651031694392,MATH 193A,A01,083224,Staff,0,8,30,30
1651031694392,MATH 193A,A02,083225,Staff,0,7,30,30
1651031694392,MATH 193A,A03,083781,Staff,0,7,30,30
1651031694392,MATH 193A,A04,083782,Staff,0,7,30,30
1651031700414,MATH 197,001,091859,McAuley; Julian John,9998,0,9999,1
1651031706477,COGS 9,A01,083615,Staff,0,19,60,60
1651031712501,COGS 11,A01,083617,Boyle; Mary E. T.,13,0,40,27
1651031718524,COGS 13,A01,083071,Staff,0,40,40,40
1651031724547,COGS 14A,A01,092681,Staff,0,40,100,100
1651031730570,COGS 14B,A01,083073,Cheng; Tzu-Han,0,13,50,50
1651031736596,COGS 17,A01,092677,Staff,8,0,75,67
1651031742621,COGS 100,A01,083619,Staff,0,30,60,60
1651031748644,COGS 101A,A01,083621,Davis; Joshua Daniel,0,29,60,60
1651031754666,COGS 101B,A01,091572,Staff,0,7,60,60
1651031760689,COGS 101C,A01,083625,Delgado; Tania,14,0,30,16
1651031766715,COGS 107A,A01,083627,Boyle; Mary E. T.,0,17,60,60
1651031772742,COGS 118A,A01,083075,Staff,0,10,60,60
1651031778766,CSE 3,A50,083646,Miranda; Gregory Joseph,15,0,38,23
1651031778766,CSE 3,A51,083647,Miranda; Gregory Joseph,36,0,37,1
1651031784793,CSE 8A,A50,083650,Miranda; Gregory Joseph,0,31,40,40
1651031790819,CSE 11,A01,083080,Cao; Yingjun,0,98,40,40
1651031796842,CSE 12,A01,083652,Staff,0,25,100,100
1651031802868,CSE 15L,A01,083654,Staff,0,3,50,50
1651031802868,CSE 15L,A02,083655,Staff,0,3,50,50
1651031808890,CSE 20,A01,083657,Staff,47,0,80,33
1651031814915,CSE 30,A01,083084,Eldon; John,1,39,80,79
1651031824163,CSE 100,A01,083659,Cao; Yingjun,0,72,50,50
1651031830186,CSE 134B,A01,083661,Powell; Thomas Allan,1,39,65,64
1651031836210,CSE 140,A01,083663,Staff,0,14,75,75
1651031842233,CSE 140L,A01,083088,Eldon; John,4,0,100,96
1651031848255,CSE 175,A01,083665,Kumar; Rakesh,0,0,25,25
1651031854287,CSE 190,A00,092507,Dubnov; Shlomo,9,0,20,11
1651031860309,ECE 45,A01,083139,Staff,0,7,60,60
1651031866332,ECE 65,A50,083695,Staff,0,7,30,30
1651031872359,ECE 109,A01,091882,Touri; Behrouz,32,0,70,38
1651031878382,ECE 180,A00,083140,Abi Samra; Nicholas Camill,17,0,30,13
1651031878382,ECE 180,B00,083141,Abi Samra; Nicholas Camill,0,0,30,30
1651031884406,MATH 10A,A01,083735,Patchell; Gregory David,1,0,30,29
1651031884406,MATH 10A,A02,083736,Patchell; Gregory David,27,0,30,3
1651031884406,MATH 10A,A03,083737,Patchell; Gregory David,23,0,30,7
1651031890433,MATH 10B,A01,083207,Staff,0,8,30,30
1651031890433,MATH 10B,A02,083208,Staff,0,7,30,30
1651031890433,MATH 10B,B01,083739,Staff,8,0,30,22
1651031890433,MATH 10B,B02,083740,Staff,28,0,30,2
1651031896464,MATH 18,A01,083743,Staff,0,0,30,30
1651031896464,MATH 18,A02,083744,Staff,23,0,30,7
1651031896464,MATH 18,A03,083745,Staff,19,0,30,11
1651031896464,MATH 18,A04,083746,Staff,26,0,30,4
1651031896464,MATH 18,B01,083748,Staff,0,16,30,30
1651031896464,MATH 18,B02,083749,Staff,0,14,30,30
1651031896464,MATH 18,B03,083750,Staff,0,14,30,30
1651031896464,MATH 18,B04,083751,Staff,0,13,30,30
1651031902489,MATH 20A,A01,083754,Staff,18,0,40,22
1651031908512,MATH 20B,A01,083756,Staff,0,14,30,30
1651031908512,MATH 20B,A02,083757,Staff,0,11,30,30
1651031914535,MATH 20C,A01,083760,Staff,0,16,30,30
1651031914535,MATH 20C,A02,083761,Staff,0,15,30,30
1651031914535,MATH 20C,B01,083762,Staff,8,0,30,22
1651031914535,MATH 20C,B02,083763,Staff,28,0,30,2
1651031920558,MATH 20D,A01,083765,Staff,3,1,30,27
1651031920558,MATH 20D,A02,083766,Staff,1,0,30,29
1651031920558,MATH 20D,A03,083767,Staff,22,0,30,8
1651031926585,MATH 20E,A01,083771,Staff,2,0,30,28
1651031926585,MATH 20E,A02,083772,Staff,12,0,30,18
1651031926585,MATH 20E,B01,083773,Staff,0,0,30,30
1651031926585,MATH 20E,B02,083774,Staff,0,0,30,30
1651031932610,MATH 103A,A01,083777,Staff,0,17,30,30
1651031932610,MATH 103A,A02,083778,Staff,0,16,30,30
1651031932610,MATH 103A,B01,083779,Staff,0,15,30,30
1651031932610,MATH 103A,B02,083780,Staff,0,13,30,30
1651031938641,MATH 105,A01,085443,Staff,0,23,30,30
1651031944664,MATH 109,A01,083213,Anzaldo; Leesa B,0,8,30,30
1651031944664,MATH 109,A02,083214,Anzaldo; Leesa B,0,7,30,30
1651031944664,MATH 109,B01,083215,Anzaldo; Leesa B,0,8,30,30
1651031944664,MATH 109,B02,083216,Anzaldo; Leesa B,0,7,30,30
1651031950693,MATH 142A,A01,083219,Chow; Bennett,0,15,30,30
1651031950693,MATH 142A,A02,083220,Chow; Bennett,0,15,30,30
1651031950693,MATH 142A,B01,083221,Chow; Bennett,0,16,30,30
1651031950693,MATH 142A,B02,083222,Chow; Bennett,0,14,30,30
1651031956728,MATH 193A,A01,083224,Staff,0,8,30,30
1651031956728,MATH 193A,A02,083225,Staff,0,7,30,30
1651031956728,MATH 193A,A03,083781,Staff,0,7,30,30
1651031956728,MATH 193A,A04,083782,Staff,0,7,30,30
1651031962751,MATH 197,001,091859,McAuley; Julian John,9998,0,9999,1
1651031968811,COGS 9,A01,083615,Staff,0,19,60,60
1651031974836,COGS 11,A01,083617,Boyle; Mary E. T.,13,0,40,27
1651031980863,COGS 13,A01,083071,Staff,0,40,40,40
1651031986888,COGS 14A,A01,092681,Staff,0,40,100,100
1651031992914,COGS 14B,A01,083073,Cheng; Tzu-Han,0,13,50,50
1651031998937,COGS 17,A01,092677,Staff,8,0,75,67
1651032004965,COGS 100,A01,083619,Staff,0,30,60,60
1651032010987,COGS 101A,A01,083621,Davis; Joshua Daniel,0,29,60,60
1651032017014,COGS 101B,A01,091572,Staff,0,7,60,60
1651032023036,COGS 101C,A01,083625,Delgado; Tania,14,0,30,16
1651032029063,COGS 107A,A01,083627,Boyle; Mary E. T.,0,17,60,60
1651032035089,COGS 118A,A01,083075,Staff,0,10,60,60
1651032041116,CSE 3,A50,083646,Miranda; Gregory Joseph,15,0,38,23
1651032041116,CSE 3,A51,083647,Miranda; Gregory Joseph,36,0,37,1
1651032047150,CSE 8A,A50,083650,Miranda; Gregory Joseph,0,31,40,40
1651032053172,CSE 11,A01,083080,Cao; Yingjun,0,98,40,40
1651032059196,CSE 12,A01,083652,Staff,0,25,100,100
1651032065223,CSE 15L,A01,083654,Staff,0,3,50,50
1651032065223,CSE 15L,A02,083655,Staff,0,3,50,50
1651032071248,CSE 20,A01,083657,Staff,47,0,80,33
1651032077272,CSE 30,A01,083084,Eldon; John,1,39,80,79
1651032083299,CSE 100,A01,083659,Cao; Yingjun,0,72,50,50
1651032089432,CSE 134B,A01,083661,Powell; Thomas Allan,1,39,65,64
1651032095455,CSE 140,A01,083663,Staff,0,14,75,75
1651032101478,CSE 140L,A01,083088,Eldon; John,4,0,100,96
1651032107500,CSE 175,A01,083665,Kumar; Rakesh,0,0,25,25
1651032113531,CSE 190,A00,092507,Dubnov; Shlomo,9,0,20,11
1651032119553,ECE 45,A01,083139,Staff,0,7,60,60
1651032125574,ECE 65,A50,083695,Staff,0,7,30,30
1651032131599,ECE 109,A01,091882,Touri; Behrouz,32,0,70,38
1651032137620,ECE 180,A00,083140,Abi Samra; Nicholas Camill,17,0,30,13
1651032137620,ECE 180,B00,083141,Abi Samra; Nicholas Camill,0,0,30,30
1651032143646,MATH 10A,A01,083735,Patchell; Gregory David,1,0,30,29
1651032143646,MATH 10A,A02,083736,Patchell; Gregory David,27,0,30,3
1651032143646,MATH 10A,A03,083737,Patchell; Gregory David,23,0,30,7
1651032149674,MATH 10B,A01,083207,Staff,0,8,30,30
1651032149674,MATH 10B,A02,083208,Staff,0,7,30,30
1651032149674,MATH 10B,B01,083739,Staff,8,0,30,22
1651032149674,MATH 10B,B02,083740,Staff,28,0,30,2
1651032155703,MATH 18,A01,083743,Staff,0,0,30,30
1651032155703,MATH 18,A02,083744,Staff,23,0,30,7
1651032155703,MATH 18,A03,083745,Staff,19,0,30,11
1651032155703,MATH 18,A04,083746,Staff,26,0,30,4
1651032155703,MATH 18,B01,083748,Staff,0,16,30,30
1651032155703,MATH 18,B02,083749,Staff,0,14,30,30
1651032155703,MATH 18,B03,083750,Staff,0,14,30,30
1651032155703,MATH 18,B04,083751,Staff,0,13,30,30
1651032161726,MATH 20A,A01,083754,Staff,18,0,40,22
1651032167753,MATH 20B,A01,083756,Staff,0,14,30,30
1651032167753,MATH 20B,A02,083757,Staff,0,11,30,30
1651032173775,MATH 20C,A01,083760,Staff,0,16,30,30
1651032173775,MATH 20C,A02,083761,Staff,0,15,30,30
1651032173775,MATH 20C,B01,083762,Staff,8,0,30,22
1651032173775,MATH 20C,B02,083763,Staff,28,0,30,2
1651032179815,MATH 20D,A01,083765,Staff,3,1,30,27
1651032179815,MATH 20D,A02,083766,Staff,1,0,30,29
1651032179815,MATH 20D,A03,083767,Staff,22,0,30,8
1651032185838,MATH 20E,A01,083771,Staff,2,0,30,28
1651032185838,MATH 20E,A02,083772,Staff,12,0,30,18
1651032185838,MATH 20E,B01,083773,Staff,0,0,30,30
1651032185838,MATH 20E,B02,083774,Staff,0,0,30,30
1651032191861,MATH 103A,A01,083777,Staff,0,17,30,30
1651032191861,MATH 103A,A02,083778,Staff,0,16,30,30
1651032191861,MATH 103A,B01,083779,Staff,0,15,30,30
1651032191861,MATH 103A,B02,083780,Staff,0,13,30,30
1651032197884,MATH 105,A01,085443,Staff,0,23,30,30
1651032203917,MATH 109,A01,083213,Anzaldo; Leesa B,0,8,30,30
1651032203917,MATH 109,A02,083214,Anzaldo; Leesa B,0,7,30,30
1651032203917,MATH 109,B01,083215,Anzaldo; Leesa B,0,8,30,30
1651032203917,MATH 109,B02,083216,Anzaldo; Leesa B,0,7,30,30
1651032209944,MATH 142A,A01,083219,Chow; Bennett,0,15,30,30
1651032209944,MATH 142A,A02,083220,Chow; Bennett,0,15,30,30
1651032209944,MATH 142A,B01,083221,Chow; Bennett,0,16,30,30
1651032209944,MATH 142A,B02,083222,Chow; Bennett,0,14,30,30
1651032215975,MATH 193A,A01,083224,Staff,0,8,30,30
1651032215975,MATH 193A,A02,083225,Staff,0,7,30,30
1651032215975,MATH 193A,A03,083781,Staff,0,7,30,30
1651032215975,MATH 193A,A04,083782,Staff,0,7,30,30
1651032221998,MATH 197,001,091859,McAuley; Julian John,9998,0,9999,1
1651032228051,COGS 9,A01,083615,Staff,0,19,60,60
1651032234074,COGS 11,A01,083617,Boyle; Mary E. T.,13,0,40,27
1651032240112,COGS 13,A01,083071,Staff,0,40,40,40
1651032246145,COGS 14A,A01,092681,Staff,0,40,100,100
1651032252169,COGS 14B,A01,083073,Cheng; Tzu-Han,0,13,50,50
1651032258196,COGS 17,A01,092677,Staff,8,0,75,67
1651032264220,COGS 100,A01,083619,Staff,0,30,60,60
1651032270246,COGS 101A,A01,083621,Davis; Joshua Daniel,0,29,60,60
1651032276277,COGS 101B,A01,091572,Staff,0,7,60,60
1651032282299,COGS 101C,A01,083625,Delgado; Tania,14,0,30,16
1651032288327,COGS 107A,A01,083627,Boyle; Mary E. T.,0,17,60,60
1651032294353,COGS 118A,A01,083075,Staff,0,10,60,60
1651032300376,CSE 3,A50,083646,Miranda; Gregory Joseph,15,0,38,23
1651032300376,CSE 3,A51,083647,Miranda; Gregory Joseph,36,0,37,1
1651032306406,CSE 8A,A50,083650,Miranda; Gregory Joseph,0,31,40,40
1651032312429,CSE 11,A01,083080,Cao; Yingjun,0,98,40,40
1651032318462,CSE 12,A01,083652,Staff,0,25,100,100
1651032324485,CSE 15L,A01,083654,Staff,0,3,50,50
1651032324485,CSE 15L,A02,083655,Staff,0,3,50,50
1651032330512,CSE 20,A01,083657,Staff,47,0,80,33
1651032336533,CSE 30,A01,083084,Eldon; John,1,39,80,79
1651032342555,CSE 100,A01,083659,Cao; Yingjun,0,72,50,50
1651032348582,CSE 134B,A01,083661,Powell; Thomas Allan,1,39,65,64
1651032354606,CSE 140,A01,083663,Staff,0,14,75,75
1651032360630,CSE 140L,A01,083088,Eldon; John,4,0,100,96
1651032366656,CSE 175,A01,083665,Kumar; Rakesh,0,0,25,25
1651032372682,CSE 190,A00,092507,Dubnov; Shlomo,9,0,20,11
1651032378706,ECE 45,A01,083139,Staff,0,7,60,60
1651032384730,ECE 65,A50,083695,Staff,0,7,30,30
1651032390752,ECE 109,A01,091882,Touri; Behrouz,32,0,70,38
1651032396778,ECE 180,A00,083140,Abi Samra; Nicholas Camill,17,0,30,13
1651032396778,ECE 180,B00,083141,Abi Samra; Nicholas Camill,0,0,30,30
1651032402813,MATH 10A,A01,083735,Patchell; Gregory David,1,0,30,29
1651032402813,MATH 10A,A02,083736,Patchell; Gregory David,27,0,30,3
1651032402813,MATH 10A,A03,083737,Patchell; Gregory David,23,0,30,7
1651032408842,MATH 10B,A01,083207,Staff,0,8,30,30
1651032408842,MATH 10B,A02,083208,Staff,0,7,30,30
1651032408842,MATH 10B,B01,083739,Staff,8,0,30,22
1651032408842,MATH 10B,B02,083740,Staff,28,0,30,2
1651032414870,MATH 18,A01,083743,Staff,0,0,30,30
1651032414870,MATH 18,A02,083744,Staff,23,0,30,7
1651032414870,MATH 18,A03,083745,Staff,19,0,30,11
1651032414870,MATH 18,A04,083746,Staff,26,0,30,4
1651032414870,MATH 18,B01,083748,Staff,0,16,30,30
1651032414870,MATH 18,B02,083749,Staff,0,14,30,30
1651032414870,MATH 18,B03,083750,Staff,0,14,30,30
1651032414870,MATH 18,B04,083751,Staff,0,13,30,30
1651032420893,MATH 20A,A01,083754,Staff,18,0,40,22
1651032426916,MATH 20B,A01,083756,Staff,0,14,30,30
1651032426916,MATH 20B,A02,083757,Staff,0,11,30,30
1651032432939,MATH 20C,A01,083760,Staff,0,16,30,30
1651032432939,MATH 20C,A02,083761,Staff,0,15,30,30
1651032432939,MATH 20C,B01,083762,Staff,8,0,30,22
1651032432939,MATH 20C,B02,083763,Staff,28,0,30,2
1651032438966,MATH 20D,A01,083765,Staff,3,1,30,27
1651032438966,MATH 20D,A02,083766,Staff,1,0,30,29
1651032438966,MATH 20D,A03,083767,Staff,22,0,30,8
1651032444989,MATH 20E,A01,083771,Staff,2,0,30,28
1651032444989,MATH 20E,A02,083772,Staff,12,0,30,18
1651032444989,MATH 20E,B01,083773,Staff,0,0,30,30
1651032444989,MATH 20E,B02,083774,Staff,0,0,30,30
1651032451011,MATH 103A,A01,083777,Staff,0,17,30,30
1651032451011,MATH 103A,A02,083778,Staff,0,16,30,30
1651032451011,MATH 103A,B01,083779,Staff,0,15,30,30
1651032451011,MATH 103A,B02,083780,Staff,0,13,30,30
1651032457035,MATH 105,A01,085443,Staff,0,23,30,30
1651032463062,MATH 109,A01,083213,Anzaldo; Leesa B,0,8,30,30
1651032463062,MATH 109,A02,083214,Anzaldo; Leesa B,0,7,30,30
1651032463062,MATH 109,B01,083215,Anzaldo; Leesa B,0,8,30,30
1651032463062,MATH 109,B02,083216,Anzaldo; Leesa B,0,7,30,30
1651032469087,MATH 142A,A01,083219,Chow; Bennett,0,15,30,30
1651032469087,MATH 142A,A02,083220,Chow; Bennett,0,15,30,30
1651032469087,MATH 142A,B01,083221,Chow; Bennett,0,16,30,30
1651032469087,MATH 142A,B02,083222,Chow; Bennett,0,14,30,30
1651032475113,MATH 193A,A01,083224,Staff,0,8,30,30
1651032475113,MATH 193A,A02,083225,Staff,0,7,30,30
1651032475113,MATH 193A,A03,083781,Staff,0,7,30,30
1651032475113,MATH 193A,A04,083782,Staff,0,7,30,30
1651032481136,MATH 197,001,091859,McAuley; Julian John,9998,0,9999,1
1651032487185,COGS 9,A01,083615,Staff,0,19,60,60
1651032493220,COGS 11,A01,083617,Boyle; Mary E. T.,13,0,40,27
1651032499244,COGS 13,A01,083071,Staff,0,40,40,40
1651032505270,COGS 14A,A01,092681,Staff,0,40,100,100
1651032511293,COGS 14B,A01,083073,Cheng; Tzu-Han,0,13,50,50
1651032517319,COGS 17,A01,092677,Staff,8,0,75,67
1651032523344,COGS 100,A01,083619,Staff,0,30,60,60
1651032529377,COGS 101A,A01,083621,Davis; Joshua Daniel,0,29,60,60
1651032535399,COGS 101B,A01,091572,Staff,0,7,60,60
1651032541420,COGS 101C,A01,083625,Delgado; Tania,14,0,30,16
1651032547444,COGS 107A,A01,083627,Boyle; Mary E. T.,0,17,60,60
1651032553467,COGS 118A,A01,083075,Staff,0,10,60,60
1651032559491,CSE 3,A50,083646,Miranda; Gregory Joseph,15,0,38,23
1651032559491,CSE 3,A51,083647,Miranda; Gregory Joseph,36,0,37,1
1651032565515,CSE 8A,A50,083650,Miranda; Gregory Joseph,0,31,40,40
1651032571540,CSE 11,A01,083080,Cao; Yingjun,0,98,40,40
1651032577566,CSE 12,A01,083652,Staff,0,25,100,100
1651032583589,CSE 15L,A01,083654,Staff,0,3,50,50
1651032583589,CSE 15L,A02,083655,Staff,0,3,50,50
1651032589619,CSE 20,A01,083657,Staff,47,0,80,33
1651032595641,CSE 30,A01,083084,Eldon; John,1,39,80,79
1651032601668,CSE 100,A01,083659,Cao; Yingjun,0,72,50,50
1651032607700,CSE 134B,A01,083661,Powell; Thomas Allan,1,39,65,64
1651032613726,CSE 140,A01,083663,Staff,0,14,75,75
1651032619753,CSE 140L,A01,083088,Eldon; John,4,0,100,96
1651032625778,CSE 175,A01,083665,Kumar; Rakesh,0,0,25,25
1651032631805,CSE 190,A00,092507,Dubnov; Shlomo,9,0,20,11
1651032637832,ECE 45,A01,083139,Staff,0,7,60,60
1651032643857,ECE 65,A50,083695,Staff,0,7,30,30
1651032649879,ECE 109,A01,091882,Touri; Behrouz,32,0,70,38
1651032655905,ECE 180,A00,083140,Abi Samra; Nicholas Camill,17,0,30,13
1651032655905,ECE 180,B00,083141,Abi Samra; Nicholas Camill,0,0,30,30
1651032661932,MATH 10A,A01,083735,Patchell; Gregory David,1,0,30,29
1651032661932,MATH 10A,A02,083736,Patchell; Gregory David,27,0,30,3
1651032661932,MATH 10A,A03,083737,Patchell; Gregory David,23,0,30,7
1651032667959,MATH 10B,A01,083207,Staff,0,8,30,30
1651032667959,MATH 10B,A02,083208,Staff,0,7,30,30
1651032667959,MATH 10B,B01,083739,Staff,8,0,30,22
1651032667959,MATH 10B,B02,083740,Staff,28,0,30,2
1651032673987,MATH 18,A01,083743,Staff,0,0,30,30
1651032673987,MATH 18,A02,083744,Staff,23,0,30,7
1651032673987,MATH 18,A03,083745,Staff,19,0,30,11
1651032673987,MATH 18,A04,083746,Staff,26,0,30,4
1651032673987,MATH 18,B01,083748,Staff,0,16,30,30
1651032673987,MATH 18,B02,083749,Staff,0,14,30,30
1651032673987,MATH 18,B03,083750,Staff,0,14,30,30
1651032673987,MATH 18,B04,083751,Staff,0,13,30,30
1651032680012,MATH 20A,A01,083754,Staff,18,0,40,22
1651032686135,MATH 20B,A01,083756,Staff,0,14,30,30
1651032686135,MATH 20B,A02,083757,Staff,0,11,30,30
1651032692162,MATH 20C,A01,083760,Staff,0,16,30,30
1651032692162,MATH 20C,A02,083761,Staff,0,15,30,30
1651032692162,MATH 20C,B01,083762,Staff,8,0,30,22
1651032692162,MATH 20C,B02,083763,Staff,28,0,30,2
1651032698189,MATH 20D,A01,083765,Staff,3,1,30,27
1651032698189,MATH 20D,A02,083766,Staff,1,0,30,29
1651032698189,MATH 20D,A03,083767,Staff,22,0,30,8
1651032704212,MATH 20E,A01,083771,Staff,2,0,30,28
1651032704212,MATH 20E,A02,083772,Staff,12,0,30,18
1651032704212,MATH 20E,B01,083773,Staff,0,0,30,30
1651032704212,MATH 20E,B02,083774,Staff,0,0,30,30
1651032710239,MATH 103A,A01,083777,Staff,0,17,30,30
1651032710239,MATH 103A,A02,083778,Staff,0,16,30,30
1651032710239,MATH 103A,B01,083779,Staff,0,15,30,30
1651032710239,MATH 103A,B02,083780,Staff,0,13,30,30
1651032716265,MATH 105,A01,085443,Staff,0,23,30,30
1651032722293,MATH 109,A01,083213,Anzaldo; Leesa B,0,8,30,30
1651032722293,MATH 109,A02,083214,Anzaldo; Leesa B,0,7,30,30
1651032722293,MATH 109,B01,083215,Anzaldo; Leesa B,0,8,30,30
1651032722293,MATH 109,B02,083216,Anzaldo; Leesa B,0,7,30,30
1651032728322,MATH 142A,A01,083219,Chow; Bennett,0,15,30,30
1651032728322,MATH 142A,A02,083220,Chow; Bennett,0,15,30,30
1651032728322,MATH 142A,B01,083221,Chow; Bennett,0,16,30,30
1651032728322,MATH 142A,B02,083222,Chow; Bennett,0,14,30,30
1651032734351,MATH 193A,A01,083224,Staff,0,8,30,30
1651032734351,MATH 193A,A02,083225,Staff,0,7,30,30
1651032734351,MATH 193A,A03,083781,Staff,0,7,30,30
1651032734351,MATH 193A,A04,083782,Staff,0,7,30,30
1651032740373,MATH 197,001,091859,McAuley; Julian John,9998,0,9999,1
1651032746430,COGS 9,A01,083615,Staff,0,19,60,60
1651032752451,COGS 11,A01,083617,Boyle; Mary E. T.,13,0,40,27
1651032758474,COGS 13,A01,083071,Staff,0,40,40,40
1651032764497,COGS 14A,A01,092681,Staff,0,40,100,100
1651032770519,COGS 14B,A01,083073,Cheng; Tzu-Han,0,13,50,50
1651032776550,COGS 17,A01,092677,Staff,8,0,75,67
1651032782572,COGS 100,A01,083619,Staff,0,30,60,60
1651032788598,COGS 101A,A01,083621,Davis; Joshua Daniel,0,29,60,60
1651032794624,COGS 101B,A01,091572,Staff,0,7,60,60
1651032800650,COGS 101C,A01,083625,Delgado; Tania,14,0,30,16
1651032806681,COGS 107A,A01,083627,Boyle; Mary E. T.,0,17,60,60
1651032812707,COGS 118A,A01,083075,Staff,0,10,60,60
1651032818732,CSE 3,A50,083646,Miranda; Gregory Joseph,15,0,38,23
1651032818732,CSE 3,A51,083647,Miranda; Gregory Joseph,36,0,37,1
1651032824760,CSE 8A,A50,083650,Miranda; Gregory Joseph,0,31,40,40
1651032830784,CSE 11,A01,083080,Cao; Yingjun,0,98,40,40
1651032836807,CSE 12,A01,083652,Staff,0,25,100,100
1651032842830,CSE 15L,A01,083654,Staff,0,3,50,50
1651032842830,CSE 15L,A02,083655,Staff,0,3,50,50
1651032848852,CSE 20,A01,083657,Staff,47,0,80,33
1651032854883,CSE 30,A01,083084,Eldon; John,1,39,80,79
1651032860907,CSE 100,A01,083659,Cao; Yingjun,0,72,50,50
1651032866930,CSE 134B,A01,083661,Powell; Thomas Allan,1,39,65,64
1651032872954,CSE 140,A01,083663,Staff,0,14,75,75
1651032878979,CSE 140L,A01,083088,Eldon; John,4,0,100,96
1651032885002,CSE 175,A01,083665,Kumar; Rakesh,0,0,25,25
1651032891025,CSE 190,A00,092507,Dubnov; Shlomo,9,0,20,11
1651032897047,ECE 45,A01,083139,Staff,0,7,60,60
1651032903070,ECE 65,A50,083695,Staff,0,7,30,30
1651032909093,ECE 109,A01,091882,Touri; Behrouz,32,0,70,38
1651032915119,ECE 180,A00,083140,Abi Samra; Nicholas Camill,17,0,30,13
1651032915119,ECE 180,B00,083141,Abi Samra; Nicholas Camill,0,0,30,30
1651032921145,MATH 10A,A01,083735,Patchell; Gregory David,1,0,30,29
1651032921145,MATH 10A,A02,083736,Patchell; Gregory David,27,0,30,3
1651032921145,MATH 10A,A03,083737,Patchell; Gregory David,23,0,30,7
1651032927181,MATH 10B,A01,083207,Staff,0,8,30,30
1651032927181,MATH 10B,A02,083208,Staff,0,7,30,30
1651032927181,MATH 10B,B01,083739,Staff,8,0,30,22
1651032927181,MATH 10B,B02,083740,Staff,28,0,30,2
1651032933205,MATH 18,A01,083743,Staff,0,0,30,30
1651032933205,MATH 18,A02,083744,Staff,23,0,30,7
1651032933205,MATH 18,A03,083745,Staff,19,0,30,11
1651032933205,MATH 18,A04,083746,Staff,26,0,30,4
1651032933205,MATH 18,B01,083748,Staff,0,16,30,30
1651032933205,MATH 18,B02,083749,Staff,0,14,30,30
1651032933205,MATH 18,B03,083750,Staff,0,14,30,30
1651032933205,MATH 18,B04,083751,Staff,0,13,30,30
1651032939230,MATH 20A,A01,083754,Staff,18,0,40,22
1651032945253,MATH 20B,A01,083756,Staff,0,14,30,30
1651032945253,MATH 20B,A02,083757,Staff,0,11,30,30
1651032951280,MATH 20C,A01,083760,Staff,0,16,30,30
1651032951280,MATH 20C,A02,083761,Staff,0,15,30,30
1651032951280,MATH 20C,B01,083762,Staff,8,0,30,22
1651032951280,MATH 20C,B02,083763,Staff,28,0,30,2
1651032957303,MATH 20D,A01,083765,Staff,3,1,30,27
1651032957303,MATH 20D,A02,083766,Staff,1,0,30,29
1651032957303,MATH 20D,A03,083767,Staff,22,0,30,8
1651032963328,MATH 20E,A01,083771,Staff,2,0,30,28
1651032963328,MATH 20E,A02,083772,Staff,12,0,30,18
1651032963328,MATH 20E,B01,083773,Staff,0,0,30,30
1651032963328,MATH 20E,B02,083774,Staff,0,0,30,30
1651032969358,MATH 103A,A01,083777,Staff,0,17,30,30
1651032969358,MATH 103A,A02,083778,Staff,0,16,30,30
1651032969358,MATH 103A,B01,083779,Staff,0,15,30,30
1651032969358,MATH 103A,B02,083780,Staff,0,13,30,30
1651032975385,MATH 105,A01,085443,Staff,0,23,30,30
1651032981410,MATH 109,A01,083213,Anzaldo; Leesa B,0,8,30,30
1651032981410,MATH 109,A02,083214,Anzaldo; Leesa B,0,7,30,30
1651032981410,MATH 109,B01,083215,Anzaldo; Leesa B,0,8,30,30
1651032981410,MATH 109,B02,083216,Anzaldo; Leesa B,0,7,30,30
1651032987449,MATH 142A,A01,083219,Chow; Bennett,0,15,30,30
1651032987449,MATH 142A,A02,083220,Chow; Bennett,0,15,30,30
1651032987449,MATH 142A,B01,083221,Chow; Bennett,0,16,30,30
1651032987449,MATH 142A,B02,083222,Chow; Bennett,0,14,30,30
1651032993479,MATH 193A,A01,083224,Staff,0,8,30,30
1651032993479,MATH 193A,A02,083225,Staff,0,7,30,30
1651032993479,MATH 193A,A03,083781,Staff,0,7,30,30
1651032993479,MATH 193A,A04,083782,Staff,0,7,30,30
1651032999501,MATH 197,001,091859,McAuley; Julian John,9998,0,9999,1
1651033005559,COGS 9,A01,083615,Staff,0,19,60,60
1651033011603,COGS 11,A01,083617,Boyle; Mary E. T.,13,0,40,27
1651033017626,COGS 13,A01,083071,Staff,0,40,40,40
1651033023652,COGS 14A,A01,092681,Staff,0,40,100,100
1651033029677,COGS 14B,A01,083073,Cheng; Tzu-Han,0,13,50,50
1651033035700,COGS 17,A01,092677,Staff,8,0,75,67
1651033041724,COGS 100,A01,083619,Staff,0,30,60,60
1651033047747,COGS 101A,A01,083621,Davis; Joshua Daniel,0,29,60,60
1651033053776,COGS 101B,A01,091572,Staff,0,7,60,60
1651033059798,COGS 101C,A01,083625,Delgado; Tania,14,0,30,16
1651033065821,COGS 107A,A01,083627,Boyle; Mary E. T.,0,17,60,60
1651033071845,COGS 118A,A01,083075,Staff,0,10,60,60
1651033077866,CSE 3,A50,083646,Miranda; Gregory Joseph,15,0,38,23
1651033077866,CSE 3,A51,083647,Miranda; Gregory Joseph,36,0,37,1
1651033083893,CSE 8A,A50,083650,Miranda; Gregory Joseph,0,31,40,40
1651033089917,CSE 11,A01,083080,Cao; Yingjun,0,98,40,40
1651033095941,CSE 12,A01,083652,Staff,0,25,100,100
1651033101962,CSE 15L,A01,083654,Staff,0,3,50,50
1651033101962,CSE 15L,A02,083655,Staff,0,3,50,50
1651033107985,CSE 20,A01,083657,Staff,47,0,80,33
1651033114009,CSE 30,A01,083084,Eldon; John,1,39,80,79
1651033120038,CSE 100,A01,083659,Cao; Yingjun,0,72,50,50
1651033126071,CSE 134B,A01,083661,Powell; Thomas Allan,1,39,65,64
1651033132094,CSE 140,A01,083663,Staff,0,14,75,75
1651033138134,CSE 140L,A01,083088,Eldon; John,4,0,100,96
1651033144160,CSE 175,A01,083665,Kumar; Rakesh,0,0,25,25
1651033150183,CSE 190,A00,092507,Dubnov; Shlomo,9,0,20,11
1651033156205,ECE 45,A01,083139,Staff,0,7,60,60
1651033162230,ECE 65,A50,083695,Staff,0,7,30,30
1651033168254,ECE 109,A01,091882,Touri; Behrouz,32,0,70,38
1651033174281,ECE 180,A00,083140,Abi Samra; Nicholas Camill,17,0,30,13
1651033174281,ECE 180,B00,083141,Abi Samra; Nicholas Camill,0,0,30,30
1651033180307,MATH 10A,A01,083735,Patchell; Gregory David,1,0,30,29
1651033180307,MATH 10A,A02,083736,Patchell; Gregory David,27,0,30,3
1651033180307,MATH 10A,A03,083737,Patchell; Gregory David,23,0,30,7
1651033186335,MATH 10B,A01,083207,Staff,0,8,30,30
1651033186335,MATH 10B,A02,083208,Staff,0,7,30,30
1651033186335,MATH 10B,B01,083739,Staff,8,0,30,22
1651033186335,MATH 10B,B02,083740,Staff,28,0,30,2
1651033192374,MATH 18,A01,083743,Staff,0,0,30,30
1651033192374,MATH 18,A02,083744,Staff,23,0,30,7
1651033192374,MATH 18,A03,083745,Staff,19,0,30,11
1651033192374,MATH 18,A04,083746,Staff,26,0,30,4
1651033192374,MATH 18,B01,083748,Staff,0,16,30,30
1651033192374,MATH 18,B02,083749,Staff,0,14,30,30
1651033192374,MATH 18,B03,083750,Staff,0,14,30,30
1651033192374,MATH 18,B04,083751,Staff,0,13,30,30
1651033198397,MATH 20A,A01,083754,Staff,18,0,40,22
1651033204430,MATH 20B,A01,083756,Staff,0,14,30,30
1651033204430,MATH 20B,A02,083757,Staff,0,11,30,30
1651033210462,MATH 20C,A01,083760,Staff,0,16,30,30
1651033210462,MATH 20C,A02,083761,Staff,0,15,30,30
1651033210462,MATH 20C,B01,083762,Staff,8,0,30,22
1651033210462,MATH 20C,B02,083763,Staff,28,0,30,2
1651033216495,MATH 20D,A01,083765,Staff,3,1,30,27
1651033216495,MATH 20D,A02,083766,Staff,1,0,30,29
1651033216495,MATH 20D,A03,083767,Staff,22,0,30,8
1651033222518,MATH 20E,A01,083771,Staff,2,0,30,28
1651033222518,MATH 20E,A02,083772,Staff,12,0,30,18
1651033222518,MATH 20E,B01,083773,Staff,0,0,30,30
1651033222518,MATH 20E,B02,083774,Staff,0,0,30,30
1651033228551,MATH 103A,A01,083777,Staff,0,17,30,30
1651033228551,MATH 103A,A02,083778,Staff,0,16,30,30
1651033228551,MATH 103A,B01,083779,Staff,0,15,30,30
1651033228551,MATH 103A,B02,083780,Staff,0,13,30,30
1651033234575,MATH 105,A01,085443,Staff,0,23,30,30
1651033240601,MATH 109,A01,083213,Anzaldo; Leesa B,0,8,30,30
1651033240601,MATH 109,A02,083214,Anzaldo; Leesa B,0,7,30,30
1651033240601,MATH 109,B01,083215,Anzaldo; Leesa B,0,8,30,30
1651033240601,MATH 109,B02,083216,Anzaldo; Leesa B,0,7,30,30
1651033246625,MATH 142A,A01,083219,Chow; Bennett,0,15,30,30
1651033246625,MATH 142A,A02,083220,Chow; Bennett,0,15,30,30
1651033246625,MATH 142A,B01,083221,Chow; Bennett,0,16,30,30
1651033246625,MATH 142A,B02,083222,Chow; Bennett,0,14,30,30
1651033252646,MATH 193A,A01,083224,Staff,0,8,30,30
1651033252646,MATH 193A,A02,083225,Staff,0,7,30,30
1651033252646,MATH 193A,A03,083781,Staff,0,7,30,30
1651033252646,MATH 193A,A04,083782,Staff,0,7,30,30
1651033258669,MATH 197,001,091859,McAuley; Julian John,9998,0,9999,1
1651033264729,COGS 9,A01,083615,Staff,0,19,60,60
1651033270754,COGS 11,A01,083617,Boyle; Mary E. T.,13,0,40,27
1651033276869,COGS 13,A01,083071,Staff,0,40,40,40
1651033282902,COGS 14A,A01,092681,Staff,0,40,100,100
1651033288933,COGS 14B,A01,083073,Cheng; Tzu-Han,0,13,50,50
1651033294956,COGS 17,A01,092677,Staff,8,0,75,67
1651033300980,COGS 100,A01,083619,Staff,0,30,60,60
1651033307006,COGS 101A,A01,083621,Davis; Joshua Daniel,0,29,60,60
1651033313028,COGS 101B,A01,091572,Staff,0,7,60,60
1651033319056,COGS 101C,A01,083625,Delgado; Tania,14,0,30,16
1651033325083,COGS 107A,A01,083627,Boyle; Mary E. T.,0,17,60,60
1651033331109,COGS 118A,A01,083075,Staff,0,10,60,60
1651033337141,CSE 3,A50,083646,Miranda; Gregory Joseph,15,0,38,23
1651033337141,CSE 3,A51,083647,Miranda; Gregory Joseph,36,0,37,1
1651033343164,CSE 8A,A50,083650,Miranda; Gregory Joseph,0,31,40,40
1651033349190,CSE 11,A01,083080,Cao; Yingjun,0,98,40,40
1651033355213,CSE 12,A01,083652,Staff,0,25,100,100
1651033361239,CSE 15L,A01,083654,Staff,0,3,50,50
1651033361239,CSE 15L,A02,083655,Staff,0,3,50,50
1651033367264,CSE 20,A01,083657,Staff,47,0,80,33
1651033373287,CSE 30,A01,083084,Eldon; John,1,39,80,79
1651033379313,CSE 100,A01,083659,Cao; Yingjun,0,72,50,50
1651033385335,CSE 134B,A01,083661,Powell; Thomas Allan,1,39,65,64
1651033391357,CSE 140,A01,083663,Staff,0,14,75,75
1651033397383,CSE 140L,A01,083088,Eldon; John,4,0,100,96
1651033403406,CSE 175,A01,083665,Kumar; Rakesh,0,0,25,25
1651033409433,CSE 190,A00,092507,Dubnov; Shlomo,9,0,20,11
1651033415455,ECE 45,A01,083139,Staff,0,7,60,60
1651033421479,ECE 65,A50,083695,Staff,0,7,30,30
1651033427502,ECE 109,A01,091882,Touri; Behrouz,32,0,70,38
1651033433528,ECE 180,A00,083140,Abi Samra; Nicholas Camill,17,0,30,13
1651033433528,ECE 180,B00,083141,Abi Samra; Nicholas Camill,0,0,30,30
1651033439563,MATH 10A,A01,083735,Patchell; Gregory David,1,0,30,29
1651033439563,MATH 10A,A02,083736,Patchell; Gregory David,27,0,30,3
1651033439563,MATH 10A,A03,083737,Patchell; Gregory David,23,0,30,7
1651033445589,MATH 10B,A01,083207,Staff,0,8,30,30
1651033445589,MATH 10B,A02,083208,Staff,0,7,30,30
1651033445589,MATH 10B,B01,083739,Staff,8,0,30,22
1651033445589,MATH 10B,B02,083740,Staff,28,0,30,2
1651033451614,MATH 18,A01,083743,Staff,0,0,30,30
1651033451614,MATH 18,A02,083744,Staff,23,0,30,7
1651033451614,MATH 18,A03,083745,Staff,19,0,30,11
1651033451614,MATH 18,A04,083746,Staff,26,0,30,4
1651033451614,MATH 18,B01,083748,Staff,0,16,30,30
1651033451614,MATH 18,B02,083749,Staff,0,14,30,30
1651033451614,MATH 18,B03,083750,Staff,0,14,30,30
1651033451614,MATH 18,B04,083751,Staff,0,13,30,30
1651033457641,MATH 20A,A01,083754,Staff,18,0,40,22
1651033463668,MATH 20B,A01,083756,Staff,0,14,30,30
1651033463668,MATH 20B,A02,083757,Staff,0,11,30,30
1651033469695,MATH 20C,A01,083760,Staff,0,16,30,30
1651033469695,MATH 20C,A02,083761,Staff,0,15,30,30
1651033469695,MATH 20C,B01,083762,Staff,8,0,30,22
1651033469695,MATH 20C,B02,083763,Staff,28,0,30,2
1651033475720,MATH 20D,A01,083765,Staff,3,1,30,27
1651033475720,MATH 20D,A02,083766,Staff,1,0,30,29
1651033475720,MATH 20D,A03,083767,Staff,22,0,30,8
1651033481746,MATH 20E,A01,083771,Staff,2,0,30,28
1651033481746,MATH 20E,A02,083772,Staff,12,0,30,18
1651033481746,MATH 20E,B01,083773,Staff,0,0,30,30
1651033481746,MATH 20E,B02,083774,Staff,0,0,30,30
1651033487774,MATH 103A,A01,083777,Staff,0,17,30,30
1651033487774,MATH 103A,A02,083778,Staff,0,16,30,30
1651033487774,MATH 103A,B01,083779,Staff,0,15,30,30
1651033487774,MATH 103A,B02,083780,Staff,0,13,30,30
1651033493816,MATH 105,A01,085443,Staff,0,23,30,30
1651033499854,MATH 109,A01,083213,Anzaldo; Leesa B,0,8,30,30
1651033499854,MATH 109,A02,083214,Anzaldo; Leesa B,0,7,30,30
1651033499854,MATH 109,B01,083215,Anzaldo; Leesa B,0,8,30,30
1651033499854,MATH 109,B02,083216,Anzaldo; Leesa B,0,7,30,30
1651033505885,MATH 142A,A01,083219,Chow; Bennett,0,15,30,30
1651033505885,MATH 142A,A02,083220,Chow; Bennett,0,15,30,30
1651033505885,MATH 142A,B01,083221,Chow; Bennett,0,16,30,30
1651033505885,MATH 142A,B02,083222,Chow; Bennett,0,14,30,30
1651033511911,MATH 193A,A01,083224,Staff,0,8,30,30
1651033511911,MATH 193A,A02,083225,Staff,0,7,30,30
1651033511911,MATH 193A,A03,083781,Staff,0,7,30,30
1651033511911,MATH 193A,A04,083782,Staff,0,7,30,30
1651033517935,MATH 197,001,091859,McAuley; Julian John,9998,0,9999,1
1651033523983,COGS 9,A01,083615,Staff,0,19,60,60
1651033530009,COGS 11,A01,083617,Boyle; Mary E. T.,13,0,40,27
1651033536037,COGS 13,A01,083071,Staff,0,40,40,40
1651033542064,COGS 14A,A01,092681,Staff,0,40,100,100
1651033548089,COGS 14B,A01,083073,Cheng; Tzu-Han,0,13,50,50
1651033554112,COGS 17,A01,092677,Staff,8,0,75,67
1651033560136,COGS 100,A01,083619,Staff,0,30,60,60
1651033566162,COGS 101A,A01,083621,Davis; Joshua Daniel,0,29,60,60
1651033572184,COGS 101B,A01,091572,Staff,0,7,60,60
1651033578205,COGS 101C,A01,083625,Delgado; Tania,14,0,30,16
1651033584228,COGS 107A,A01,083627,Boyle; Mary E. T.,0,17,60,60
1651033590256,COGS 118A,A01,083075,Staff,0,10,60,60
1651033596282,CSE 3,A50,083646,Miranda; Gregory Joseph,15,0,38,23
1651033596282,CSE 3,A51,083647,Miranda; Gregory Joseph,36,0,37,1
1651033602310,CSE 8A,A50,083650,Miranda; Gregory Joseph,0,31,40,40
1651033608335,CSE 11,A01,083080,Cao; Yingjun,0,98,40,40
1651033614361,CSE 12,A01,083652,Staff,0,25,100,100
1651033620386,CSE 15L,A01,083654,Staff,0,3,50,50
1651033620386,CSE 15L,A02,083655,Staff,0,3,50,50
1651033626408,CSE 20,A01,083657,Staff,47,0,80,33
1651033632433,CSE 30,A01,083084,Eldon; John,1,39,80,79
1651033638461,CSE 100,A01,083659,Cao; Yingjun,0,72,50,50
1651033644484,CSE 134B,A01,083661,Powell; Thomas Allan,1,39,65,64
1651033650507,CSE 140,A01,083663,Staff,0,14,75,75
1651033656531,CSE 140L,A01,083088,Eldon; John,4,0,100,96
1651033662557,CSE 175,A01,083665,Kumar; Rakesh,0,0,25,25
1651033668580,CSE 190,A00,092507,Dubnov; Shlomo,9,0,20,11
1651033674603,ECE 45,A01,083139,Staff,0,7,60,60
1651033680629,ECE 65,A50,083695,Staff,0,7,30,30
1651033686682,ECE 109,A01,091882,Touri; Behrouz,32,0,70,38
1651033692715,ECE 180,A00,083140,Abi Samra; Nicholas Camill,17,0,30,13
1651033692715,ECE 180,B00,083141,Abi Samra; Nicholas Camill,0,0,30,30
1651033698746,MATH 10A,A01,083735,Patchell; Gregory David,1,0,30,29
1651033698746,MATH 10A,A02,083736,Patchell; Gregory David,27,0,30,3
1651033698746,MATH 10A,A03,083737,Patchell; Gregory David,23,0,30,7
1651033704775,MATH 10B,A01,083207,Staff,0,8,30,30
1651033704775,MATH 10B,A02,083208,Staff,0,7,30,30
1651033704775,MATH 10B,B01,083739,Staff,8,0,30,22
1651033704775,MATH 10B,B02,083740,Staff,28,0,30,2
1651033710809,MATH 18,A01,083743,Staff,0,0,30,30
1651033710809,MATH 18,A02,083744,Staff,23,0,30,7
1651033710809,MATH 18,A03,083745,Staff,19,0,30,11
1651033710809,MATH 18,A04,083746,Staff,26,0,30,4
1651033710809,MATH 18,B01,083748,Staff,0,16,30,30
1651033710809,MATH 18,B02,083749,Staff,0,14,30,30
1651033710809,MATH 18,B03,083750,Staff,0,14,30,30
1651033710809,MATH 18,B04,083751,Staff,0,13,30,30
1651033716851,MATH 20A,A01,083754,Staff,18,0,40,22
1651033722891,MATH 20B,A01,083756,Staff,0,14,30,30
1651033722891,MATH 20B,A02,083757,Staff,0,11,30,30
1651033728930,MATH 20C,A01,083760,Staff,0,16,30,30
1651033728930,MATH 20C,A02,083761,Staff,0,15,30,30
1651033728930,MATH 20C,B01,083762,Staff,8,0,30,22
1651033728930,MATH 20C,B02,083763,Staff,28,0,30,2
1651033734954,MATH 20D,A01,083765,Staff,3,1,30,27
1651033734954,MATH 20D,A02,083766,Staff,1,0,30,29
1651033734954,MATH 20D,A03,083767,Staff,22,0,30,8
1651033740982,MATH 20E,A01,083771,Staff,2,0,30,28
1651033740982,MATH 20E,A02,083772,Staff,12,0,30,18
1651033740982,MATH 20E,B01,083773,Staff,0,0,30,30
1651033740982,MATH 20E,B02,083774,Staff,0,0,30,30
1651033747009,MATH 103A,A01,083777,Staff,0,17,30,30
1651033747009,MATH 103A,A02,083778,Staff,0,16,30,30
1651033747009,MATH 103A,B01,083779,Staff,0,15,30,30
1651033747009,MATH 103A,B02,083780,Staff,0,13,30,30
1651033753038,MATH 105,A01,085443,Staff,0,23,30,30
1651033759062,MATH 109,A01,083213,Anzaldo; Leesa B,0,8,30,30
1651033759062,MATH 109,A02,083214,Anzaldo; Leesa B,0,7,30,30
1651033759062,MATH 109,B01,083215,Anzaldo; Leesa B,0,8,30,30
1651033759062,MATH 109,B02,083216,Anzaldo; Leesa B,0,7,30,30
1651033765084,MATH 142A,A01,083219,Chow; Bennett,0,15,30,30
1651033765084,MATH 142A,A02,083220,Chow; Bennett,0,15,30,30
1651033765084,MATH 142A,B01,083221,Chow; Bennett,0,16,30,30
1651033765084,MATH 142A,B02,083222,Chow; Bennett,0,14,30,30
1651033771107,MATH 193A,A01,083224,Staff,0,8,30,30
1651033771107,MATH 193A,A02,083225,Staff,0,7,30,30
1651033771107,MATH 193A,A03,083781,Staff,0,7,30,30
1651033771107,MATH 193A,A04,083782,Staff,0,7,30,30
1651033777133,MATH 197,001,091859,McAuley; Julian John,9998,0,9999,1
1651033783182,COGS 9,A01,083615,Staff,0,19,60,60
1651033789209,COGS 11,A01,083617,Boyle; Mary E. T.,13,0,40,27
1651033795232,COGS 13,A01,083071,Staff,0,40,40,40
1651033801261,COGS 14A,A01,092681,Staff,0,40,100,100
1651033807287,COGS 14B,A01,083073,Cheng; Tzu-Han,0,13,50,50
1651033813312,COGS 17,A01,092677,Staff,8,0,75,67
1651033819335,COGS 100,A01,083619,Staff,0,30,60,60
1651033825360,COGS 101A,A01,083621,Davis; Joshua Daniel,0,29,60,60
1651033831389,COGS 101B,A01,091572,Staff,0,7,60,60
1651033837423,COGS 101C,A01,083625,Delgado; Tania,14,0,30,16
1651033843446,COGS 107A,A01,083627,Boyle; Mary E. T.,0,17,60,60
1651033849469,COGS 118A,A01,083075,Staff,0,10,60,60
1651033855495,CSE 3,A50,083646,Miranda; Gregory Joseph,15,0,38,23
1651033855495,CSE 3,A51,083647,Miranda; Gregory Joseph,36,0,37,1
1651033861519,CSE 8A,A50,083650,Miranda; Gregory Joseph,0,31,40,40
1651033867542,CSE 11,A01,083080,Cao; Yingjun,0,97,40,40
1651033873661,CSE 12,A01,083652,Staff,0,25,100,100
1651033879683,CSE 15L,A01,083654,Staff,0,3,50,50
1651033879683,CSE 15L,A02,083655,Staff,0,3,50,50
1651033885710,CSE 20,A01,083657,Staff,47,0,80,33
1651033891738,CSE 30,A01,083084,Eldon; John,1,39,80,79
1651033897766,CSE 100,A01,083659,Cao; Yingjun,0,72,50,50
1651033903790,CSE 134B,A01,083661,Powell; Thomas Allan,1,39,65,64
1651033909815,CSE 140,A01,083663,Staff,0,14,75,75
1651033915843,CSE 140L,A01,083088,Eldon; John,4,0,100,96
1651033921865,CSE 175,A01,083665,Kumar; Rakesh,0,0,25,25
1651033927888,CSE 190,A00,092507,Dubnov; Shlomo,9,0,20,11
1651033933911,ECE 45,A01,083139,Staff,0,7,60,60
1651033939936,ECE 65,A50,083695,Staff,0,7,30,30
1651033945966,ECE 109,A01,091882,Touri; Behrouz,32,0,70,38
1651033951988,ECE 180,A00,083140,Abi Samra; Nicholas Camill,17,0,30,13
1651033951988,ECE 180,B00,083141,Abi Samra; Nicholas Camill,0,0,30,30
1651033958013,MATH 10A,A01,083735,Patchell; Gregory David,1,0,30,29
1651033958013,MATH 10A,A02,083736,Patchell; Gregory David,27,0,30,3
1651033958013,MATH 10A,A03,083737,Patchell; Gregory David,23,0,30,7
1651033964042,MATH 10B,A01,083207,Staff,0,8,30,30
1651033964042,MATH 10B,A02,083208,Staff,0,7,30,30
1651033964042,MATH 10B,B01,083739,Staff,8,0,30,22
1651033964042,MATH 10B,B02,083740,Staff,28,0,30,2
1651033970072,MATH 18,A01,083743,Staff,0,0,30,30
1651033970072,MATH 18,A02,083744,Staff,23,0,30,7
1651033970072,MATH 18,A03,083745,Staff,19,0,30,11
1651033970072,MATH 18,A04,083746,Staff,26,0,30,4
1651033970072,MATH 18,B01,083748,Staff,0,16,30,30
1651033970072,MATH 18,B02,083749,Staff,0,14,30,30
1651033970072,MATH 18,B03,083750,Staff,0,14,30,30
1651033970072,MATH 18,B04,083751,Staff,0,13,30,30
1651033976095,MATH 20A,A01,083754,Staff,18,0,40,22
1651033982124,MATH 20B,A01,083756,Staff,0,14,30,30
1651033982124,MATH 20B,A02,083757,Staff,0,11,30,30
1651033988148,MATH 20C,A01,083760,Staff,0,16,30,30
1651033988148,MATH 20C,A02,083761,Staff,0,15,30,30
1651033988148,MATH 20C,B01,083762,Staff,8,0,30,22
1651033988148,MATH 20C,B02,083763,Staff,28,0,30,2
1651033994173,MATH 20D,A01,083765,Staff,3,1,30,27
1651033994173,MATH 20D,A02,083766,Staff,1,0,30,29
1651033994173,MATH 20D,A03,083767,Staff,22,0,30,8
1651034000201,MATH 20E,A01,083771,Staff,2,0,30,28
1651034000201,MATH 20E,A02,083772,Staff,12,0,30,18
1651034000201,MATH 20E,B01,083773,Staff,0,0,30,30
1651034000201,MATH 20E,B02,083774,Staff,0,0,30,30
1651034006223,MATH 103A,A01,083777,Staff,0,17,30,30
1651034006223,MATH 103A,A02,083778,Staff,0,16,30,30
1651034006223,MATH 103A,B01,083779,Staff,0,15,30,30
1651034006223,MATH 103A,B02,083780,Staff,0,13,30,30
1651034012246,MATH 105,A01,085443,Staff,0,23,30,30
1651034018274,MATH 109,A01,083213,Anzaldo; Leesa B,0,8,30,30
1651034018274,MATH 109,A02,083214,Anzaldo; Leesa B,0,7,30,30
1651034018274,MATH 109,B01,083215,Anzaldo; Leesa B,0,8,30,30
1651034018274,MATH 109,B02,083216,Anzaldo; Leesa B,0,7,30,30
1651034024304,MATH 142A,A01,083219,Chow; Bennett,0,15,30,30
1651034024304,MATH 142A,A02,083220,Chow; Bennett,0,15,30,30
1651034024304,MATH 142A,B01,083221,Chow; Bennett,0,16,30,30
1651034024304,MATH 142A,B02,083222,Chow; Bennett,0,14,30,30
1651034030327,MATH 193A,A01,083224,Staff,0,8,30,30
1651034030327,MATH 193A,A02,083225,Staff,0,7,30,30
1651034030327,MATH 193A,A03,083781,Staff,0,7,30,30
1651034030327,MATH 193A,A04,083782,Staff,0,7,30,30
1651034036363,MATH 197,001,091859,McAuley; Julian John,9998,0,9999,1
1651034042427,COGS 9,A01,083615,Staff,0,19,60,60
1651034048451,COGS 11,A01,083617,Boyle; Mary E. T.,13,0,40,27
1651034054477,COGS 13,A01,083071,Staff,0,40,40,40
1651034060504,COGS 14A,A01,092681,Staff,0,40,100,100
1651034066525,COGS 14B,A01,083073,Cheng; Tzu-Han,0,13,50,50
1651034072551,COGS 17,A01,092677,Staff,8,0,75,67
1651034078576,COGS 100,A01,083619,Staff,0,30,60,60
1651034084603,COGS 101A,A01,083621,Davis; Joshua Daniel,0,29,60,60
1651034090624,COGS 101B,A01,091572,Staff,0,7,60,60
1651034096648,COGS 101C,A01,083625,Delgado; Tania,14,0,30,16
1651034102672,COGS 107A,A01,083627,Boyle; Mary E. T.,0,17,60,60
1651034108695,COGS 118A,A01,083075,Staff,0,10,60,60
1651034114721,CSE 3,A50,083646,Miranda; Gregory Joseph,15,0,38,23
1651034114721,CSE 3,A51,083647,Miranda; Gregory Joseph,36,0,37,1
1651034120744,CSE 8A,A50,083650,Miranda; Gregory Joseph,0,31,40,40
1651034126767,CSE 11,A01,083080,Cao; Yingjun,0,97,40,40
1651034132789,CSE 12,A01,083652,Staff,0,25,100,100
1651034138813,CSE 15L,A01,083654,Staff,1,3,50,49
1651034138813,CSE 15L,A02,083655,Staff,0,3,50,50
1651034144840,CSE 20,A01,083657,Staff,47,0,80,33
1651034150862,CSE 30,A01,083084,Eldon; John,1,39,80,79
1651034156886,CSE 100,A01,083659,Cao; Yingjun,0,72,50,50
1651034162908,CSE 134B,A01,083661,Powell; Thomas Allan,1,39,65,64
1651034168931,CSE 140,A01,083663,Staff,0,14,75,75
1651034174956,CSE 140L,A01,083088,Eldon; John,4,0,100,96
1651034180983,CSE 175,A01,083665,Kumar; Rakesh,0,0,25,25
1651034187016,CSE 190,A00,092507,Dubnov; Shlomo,9,0,20,11
1651034193045,ECE 45,A01,083139,Staff,0,7,60,60
1651034199070,ECE 65,A50,083695,Staff,0,7,30,30
1651034205096,ECE 109,A01,091882,Touri; Behrouz,32,0,70,38
1651034211118,ECE 180,A00,083140,Abi Samra; Nicholas Camill,17,0,30,13
1651034211118,ECE 180,B00,083141,Abi Samra; Nicholas Camill,0,0,30,30
1651034217150,MATH 10A,A01,083735,Patchell; Gregory David,1,0,30,29
1651034217150,MATH 10A,A02,083736,Patchell; Gregory David,27,0,30,3
1651034217150,MATH 10A,A03,083737,Patchell; Gregory David,23,0,30,7
1651034223184,MATH 10B,A01,083207,Staff,0,8,30,30
1651034223184,MATH 10B,A02,083208,Staff,0,7,30,30
1651034223184,MATH 10B,B01,083739,Staff,8,0,30,22
1651034223184,MATH 10B,B02,083740,Staff,28,0,30,2
1651034229211,MATH 18,A01,083743,Staff,0,0,30,30
1651034229211,MATH 18,A02,083744,Staff,23,0,30,7
1651034229211,MATH 18,A03,083745,Staff,19,0,30,11
1651034229211,MATH 18,A04,083746,Staff,26,0,30,4
1651034229211,MATH 18,B01,083748,Staff,0,16,30,30
1651034229211,MATH 18,B02,083749,Staff,0,14,30,30
1651034229211,MATH 18,B03,083750,Staff,0,14,30,30
1651034229211,MATH 18,B04,083751,Staff,0,13,30,30
1651034235234,MATH 20A,A01,083754,Staff,18,0,40,22
1651034241258,MATH 20B,A01,083756,Staff,0,14,30,30
1651034241258,MATH 20B,A02,083757,Staff,0,11,30,30
1651034247282,MATH 20C,A01,083760,Staff,0,16,30,30
1651034247282,MATH 20C,A02,083761,Staff,0,15,30,30
1651034247282,MATH 20C,B01,083762,Staff,8,0,30,22
1651034247282,MATH 20C,B02,083763,Staff,28,0,30,2
1651034253308,MATH 20D,A01,083765,Staff,3,1,30,27
1651034253308,MATH 20D,A02,083766,Staff,1,0,30,29
1651034253308,MATH 20D,A03,083767,Staff,22,0,30,8
1651034259337,MATH 20E,A01,083771,Staff,2,0,30,28
1651034259337,MATH 20E,A02,083772,Staff,11,0,30,19
1651034259337,MATH 20E,B01,083773,Staff,0,0,30,30
1651034259337,MATH 20E,B02,083774,Staff,0,0,30,30
1651034265362,MATH 103A,A01,083777,Staff,0,17,30,30
1651034265362,MATH 103A,A02,083778,Staff,0,16,30,30
1651034265362,MATH 103A,B01,083779,Staff,0,15,30,30
1651034265362,MATH 103A,B02,083780,Staff,0,13,30,30
1651034271397,MATH 105,A01,085443,Staff,0,23,30,30
1651034277421,MATH 109,A01,083213,Anzaldo; Leesa B,0,8,30,30
1651034277421,MATH 109,A02,083214,Anzaldo; Leesa B,0,7,30,30
1651034277421,MATH 109,B01,083215,Anzaldo; Leesa B,0,8,30,30
1651034277421,MATH 109,B02,083216,Anzaldo; Leesa B,0,7,30,30
1651034283445,MATH 142A,A01,083219,Chow; Bennett,0,15,30,30
1651034283445,MATH 142A,A02,083220,Chow; Bennett,0,15,30,30
1651034283445,MATH 142A,B01,083221,Chow; Bennett,0,16,30,30
1651034283445,MATH 142A,B02,083222,Chow; Bennett,0,14,30,30
1651034289475,MATH 193A,A01,083224,Staff,0,8,30,30
1651034289475,MATH 193A,A02,083225,Staff,0,7,30,30
1651034289475,MATH 193A,A03,083781,Staff,0,7,30,30
1651034289475,MATH 193A,A04,083782,Staff,0,7,30,30
1651034295498,MATH 197,001,091859,McAuley; Julian John,9998,0,9999,1
1651034301549,COGS 9,A01,083615,Staff,0,19,60,60
1651034307573,COGS 11,A01,083617,Boyle; Mary E. T.,13,0,40,27
1651034313605,COGS 13,A01,083071,Staff,0,40,40,40
1651034319627,COGS 14A,A01,092681,Staff,0,40,100,100
1651034325649,COGS 14B,A01,083073,Cheng; Tzu-Han,0,13,50,50
1651034331672,COGS 17,A01,092677,Staff,8,0,75,67
1651034337696,COGS 100,A01,083619,Staff,0,30,60,60
1651034343719,COGS 101A,A01,083621,Davis; Joshua Daniel,0,29,60,60
1651034349742,COGS 101B,A01,091572,Staff,0,7,60,60
1651034355768,COGS 101C,A01,083625,Delgado; Tania,14,0,30,16
1651034361795,COGS 107A,A01,083627,Boyle; Mary E. T.,0,17,60,60
1651034367821,COGS 118A,A01,083075,Staff,0,10,60,60
1651034373846,CSE 3,A50,083646,Miranda; Gregory Joseph,15,0,38,23
1651034373846,CSE 3,A51,083647,Miranda; Gregory Joseph,36,0,37,1
1651034379873,CSE 8A,A50,083650,Miranda; Gregory Joseph,0,31,40,40
1651034385897,CSE 11,A01,083080,Cao; Yingjun,0,97,40,40
1651034391928,CSE 12,A01,083652,Staff,0,25,100,100
1651034397952,CSE 15L,A01,083654,Staff,1,3,50,49
1651034397952,CSE 15L,A02,083655,Staff,0,3,50,50
1651034403985,CSE 20,A01,083657,Staff,47,0,80,33
1651034410008,CSE 30,A01,083084,Eldon; John,1,39,80,79
1651034416040,CSE 100,A01,083659,Cao; Yingjun,0,72,50,50
1651034422063,CSE 134B,A01,083661,Powell; Thomas Allan,1,39,65,64
1651034428086,CSE 140,A01,083663,Staff,0,14,75,75
1651034434109,CSE 140L,A01,083088,Eldon; John,4,0,100,96
1651034440138,CSE 175,A01,083665,Kumar; Rakesh,0,0,25,25
1651034446162,CSE 190,A00,092507,Dubnov; Shlomo,9,0,20,11
1651034452186,ECE 45,A01,083139,Staff,0,7,60,60
1651034458215,ECE 65,A50,083695,Staff,0,7,30,30
1651034464244,ECE 109,A01,091882,Touri; Behrouz,32,0,70,38
1651034470360,ECE 180,A00,083140,Abi Samra; Nicholas Camill,17,0,30,13
1651034470360,ECE 180,B00,083141,Abi Samra; Nicholas Camill,0,0,30,30
1651034476383,MATH 10A,A01,083735,Patchell; Gregory David,1,0,30,29
1651034476383,MATH 10A,A02,083736,Patchell; Gregory David,27,0,30,3
1651034476383,MATH 10A,A03,083737,Patchell; Gregory David,23,0,30,7
1651034482407,MATH 10B,A01,083207,Staff,0,8,30,30
1651034482407,MATH 10B,A02,083208,Staff,0,7,30,30
1651034482407,MATH 10B,B01,083739,Staff,8,0,30,22
1651034482407,MATH 10B,B02,083740,Staff,28,0,30,2
1651034488436,MATH 18,A01,083743,Staff,0,0,30,30
1651034488436,MATH 18,A02,083744,Staff,23,0,30,7
1651034488436,MATH 18,A03,083745,Staff,19,0,30,11
1651034488436,MATH 18,A04,083746,Staff,26,0,30,4
1651034488436,MATH 18,B01,083748,Staff,0,16,30,30
1651034488436,MATH 18,B02,083749,Staff,0,14,30,30
1651034488436,MATH 18,B03,083750,Staff,0,14,30,30
1651034488436,MATH 18,B04,083751,Staff,0,13,30,30
1651034494470,MATH 20A,A01,083754,Staff,18,0,40,22
1651034500493,MATH 20B,A01,083756,Staff,0,14,30,30
1651034500493,MATH 20B,A02,083757,Staff,0,11,30,30
1651034506517,MATH 20C,A01,083760,Staff,0,16,30,30
1651034506517,MATH 20C,A02,083761,Staff,0,15,30,30
1651034506517,MATH 20C,B01,083762,Staff,8,0,30,22
1651034506517,MATH 20C,B02,083763,Staff,28,0,30,2
1651034512540,MATH 20D,A01,083765,Staff,3,1,30,27
1651034512540,MATH 20D,A02,083766,Staff,1,0,30,29
1651034512540,MATH 20D,A03,083767,Staff,22,0,30,8
1651034518582,MATH 20E,A01,083771,Staff,2,0,30,28
1651034518582,MATH 20E,A02,083772,Staff,11,0,30,19
1651034518582,MATH 20E,B01,083773,Staff,0,0,30,30
1651034518582,MATH 20E,B02,083774,Staff,0,0,30,30
1651034524610,MATH 103A,A01,083777,Staff,0,17,30,30
1651034524610,MATH 103A,A02,083778,Staff,0,16,30,30
1651034524610,MATH 103A,B01,083779,Staff,0,15,30,30
1651034524610,MATH 103A,B02,083780,Staff,0,13,30,30
1651034530634,MATH 105,A01,085443,Staff,0,23,30,30
1651034536662,MATH 109,A01,083213,Anzaldo; Leesa B,0,8,30,30
1651034536662,MATH 109,A02,083214,Anzaldo; Leesa B,0,7,30,30
1651034536662,MATH 109,B01,083215,Anzaldo; Leesa B,0,8,30,30
1651034536662,MATH 109,B02,083216,Anzaldo; Leesa B,0,7,30,30
1651034542686,MATH 142A,A01,083219,Chow; Bennett,0,15,30,30
1651034542686,MATH 142A,A02,083220,Chow; Bennett,0,15,30,30
1651034542686,MATH 142A,B01,083221,Chow; Bennett,0,16,30,30
1651034542686,MATH 142A,B02,083222,Chow; Bennett,0,14,30,30
1651034548710,MATH 193A,A01,083224,Staff,0,8,30,30
1651034548710,MATH 193A,A02,083225,Staff,0,7,30,30
1651034548710,MATH 193A,A03,083781,Staff,0,7,30,30
1651034548710,MATH 193A,A04,083782,Staff,0,7,30,30
1651034554732,MATH 197,001,091859,McAuley; Julian John,9998,0,9999,1
1651034560790,COGS 9,A01,083615,Staff,0,19,60,60
1651034566831,COGS 11,A01,083617,Boyle; Mary E. T.,13,0,40,27
1651034572856,COGS 13,A01,083071,Staff,0,40,40,40
1651034578879,COGS 14A,A01,092681,Staff,0,40,100,100
1651034584905,COGS 14B,A01,083073,Cheng; Tzu-Han,0,13,50,50
1651034590934,COGS 17,A01,092677,Staff,8,0,75,67
1651034596958,COGS 100,A01,083619,Staff,0,30,60,60
1651034602980,COGS 101A,A01,083621,Davis; Joshua Daniel,0,29,60,60
1651034609003,COGS 101B,A01,091572,Staff,0,7,60,60
1651034615031,COGS 101C,A01,083625,Delgado; Tania,14,0,30,16
1651034621059,COGS 107A,A01,083627,Boyle; Mary E. T.,0,17,60,60
1651034627083,COGS 118A,A01,083075,Staff,0,10,60,60
1651034633107,CSE 3,A50,083646,Miranda; Gregory Joseph,15,0,38,23
1651034633107,CSE 3,A51,083647,Miranda; Gregory Joseph,36,0,37,1
1651034639143,CSE 8A,A50,083650,Miranda; Gregory Joseph,0,31,40,40
1651034645170,CSE 11,A01,083080,Cao; Yingjun,0,97,40,40
1651034651196,CSE 12,A01,083652,Staff,0,25,100,100
1651034657219,CSE 15L,A01,083654,Staff,1,3,50,49
1651034657219,CSE 15L,A02,083655,Staff,0,3,50,50
1651034663242,CSE 20,A01,083657,Staff,47,0,80,33
1651034669269,CSE 30,A01,083084,Eldon; John,1,39,80,79
1651034675292,CSE 100,A01,083659,Cao; Yingjun,0,72,50,50
1651034681318,CSE 134B,A01,083661,Powell; Thomas Allan,1,39,65,64
1651034687344,CSE 140,A01,083663,Staff,0,14,75,75
1651034693367,CSE 140L,A01,083088,Eldon; John,4,0,100,96
1651034699387,CSE 175,A01,083665,Kumar; Rakesh,0,0,25,25
1651034705413,CSE 190,A00,092507,Dubnov; Shlomo,9,0,20,11
1651034711436,ECE 45,A01,083139,Staff,0,7,60,60
1651034717464,ECE 65,A50,083695,Staff,0,7,30,30
1651034723487,ECE 109,A01,091882,Touri; Behrouz,32,0,70,38
1651034729510,ECE 180,A00,083140,Abi Samra; Nicholas Camill,17,0,30,13
1651034729510,ECE 180,B00,083141,Abi Samra; Nicholas Camill,0,0,30,30
1651034735533,MATH 10A,A01,083735,Patchell; Gregory David,1,0,30,29
1651034735533,MATH 10A,A02,083736,Patchell; Gregory David,27,0,30,3
1651034735533,MATH 10A,A03,083737,Patchell; Gregory David,23,0,30,7
1651034741554,MATH 10B,A01,083207,Staff,0,8,30,30
1651034741554,MATH 10B,A02,083208,Staff,0,7,30,30
1651034741554,MATH 10B,B01,083739,Staff,8,0,30,22
1651034741554,MATH 10B,B02,083740,Staff,28,0,30,2
1651034747581,MATH 18,A01,083743,Staff,0,0,30,30
1651034747581,MATH 18,A02,083744,Staff,23,0,30,7
1651034747581,MATH 18,A03,083745,Staff,19,0,30,11
1651034747581,MATH 18,A04,083746,Staff,26,0,30,4
1651034747581,MATH 18,B01,083748,Staff,0,16,30,30
1651034747581,MATH 18,B02,083749,Staff,0,14,30,30
1651034747581,MATH 18,B03,083750,Staff,0,14,30,30
1651034747581,MATH 18,B04,083751,Staff,0,13,30,30
1651034753605,MATH 20A,A01,083754,Staff,18,0,40,22
1651034759628,MATH 20B,A01,083756,Staff,0,14,30,30
1651034759628,MATH 20B,A02,083757,Staff,0,11,30,30
1651034765650,MATH 20C,A01,083760,Staff,0,16,30,30
1651034765650,MATH 20C,A02,083761,Staff,0,15,30,30
1651034765650,MATH 20C,B01,083762,Staff,8,0,30,22
1651034765650,MATH 20C,B02,083763,Staff,28,0,30,2
1651034771674,MATH 20D,A01,083765,Staff,3,1,30,27
1651034771674,MATH 20D,A02,083766,Staff,1,0,30,29
1651034771674,MATH 20D,A03,083767,Staff,22,0,30,8
1651034777702,MATH 20E,A01,083771,Staff,2,0,30,28
1651034777702,MATH 20E,A02,083772,Staff,11,0,30,19
1651034777702,MATH 20E,B01,083773,Staff,0,0,30,30
1651034777702,MATH 20E,B02,083774,Staff,0,0,30,30
1651034783726,MATH 103A,A01,083777,Staff,0,17,30,30
1651034783726,MATH 103A,A02,083778,Staff,0,16,30,30
1651034783726,MATH 103A,B01,083779,Staff,0,15,30,30
1651034783726,MATH 103A,B02,083780,Staff,0,13,30,30
1651034789754,MATH 105,A01,085443,Staff,0,23,30,30
1651034795778,MATH 109,A01,083213,Anzaldo; Leesa B,0,8,30,30
1651034795778,MATH 109,A02,083214,Anzaldo; Leesa B,0,7,30,30
1651034795778,MATH 109,B01,083215,Anzaldo; Leesa B,0,8,30,30
1651034795778,MATH 109,B02,083216,Anzaldo; Leesa B,0,7,30,30
1651034801806,MATH 142A,A01,083219,Chow; Bennett,0,15,30,30
1651034801806,MATH 142A,A02,083220,Chow; Bennett,0,15,30,30
1651034801806,MATH 142A,B01,083221,Chow; Bennett,0,16,30,30
1651034801806,MATH 142A,B02,083222,Chow; Bennett,0,14,30,30
1651034807830,MATH 193A,A01,083224,Staff,0,8,30,30
1651034807830,MATH 193A,A02,083225,Staff,0,7,30,30
1651034807830,MATH 193A,A03,083781,Staff,0,7,30,30
1651034807830,MATH 193A,A04,083782,Staff,0,7,30,30
1651034813854,MATH 197,001,091859,McAuley; Julian John,9998,0,9999,1
1651034819911,COGS 9,A01,083615,Staff,0,19,60,60
1651034825934,COGS 11,A01,083617,Boyle; Mary E. T.,13,0,40,27
1651034831957,COGS 13,A01,083071,Staff,0,40,40,40
1651034837980,COGS 14A,A01,092681,Staff,0,40,100,100
1651034844004,COGS 14B,A01,083073,Cheng; Tzu-Han,0,13,50,50
1651034850027,COGS 17,A01,092677,Staff,8,0,75,67
1651034856056,COGS 100,A01,083619,Staff,0,30,60,60
1651034862082,COGS 101A,A01,083621,Davis; Joshua Daniel,0,29,60,60
1651034868106,COGS 101B,A01,091572,Staff,0,7,60,60
1651034874129,COGS 101C,A01,083625,Delgado; Tania,14,0,30,16
1651034880156,COGS 107A,A01,083627,Boyle; Mary E. T.,0,17,60,60
1651034886178,COGS 118A,A01,083075,Staff,0,10,60,60
1651034892202,CSE 3,A50,083646,Miranda; Gregory Joseph,15,0,38,23
1651034892202,CSE 3,A51,083647,Miranda; Gregory Joseph,36,0,37,1
1651034898224,CSE 8A,A50,083650,Miranda; Gregory Joseph,0,31,40,40
1651034904255,CSE 11,A01,083080,Cao; Yingjun,0,97,40,40
1651034910294,CSE 12,A01,083652,Staff,0,25,100,100
1651034916335,CSE 15L,A01,083654,Staff,1,3,50,49
1651034916335,CSE 15L,A02,083655,Staff,0,3,50,50
1651034922364,CSE 20,A01,083657,Staff,47,0,80,33
1651034928390,CSE 30,A01,083084,Eldon; John,1,39,80,79
1651034934413,CSE 100,A01,083659,Cao; Yingjun,0,72,50,50
1651034940437,CSE 134B,A01,083661,Powell; Thomas Allan,1,39,65,64
1651034946463,CSE 140,A01,083663,Staff,0,14,75,75
1651034952494,CSE 140L,A01,083088,Eldon; John,4,0,100,96
1651034958518,CSE 175,A01,083665,Kumar; Rakesh,0,0,25,25
1651034964555,CSE 190,A00,092507,Dubnov; Shlomo,9,0,20,11
1651034970578,ECE 45,A01,083139,Staff,0,7,60,60
1651034976606,ECE 65,A50,083695,Staff,0,7,30,30
1651034982630,ECE 109,A01,091882,Touri; Behrouz,32,0,70,38
1651034988665,ECE 180,A00,083140,Abi Samra; Nicholas Camill,17,0,30,13
1651034988665,ECE 180,B00,083141,Abi Samra; Nicholas Camill,0,0,30,30
1651034994689,MATH 10A,A01,083735,Patchell; Gregory David,1,0,30,29
1651034994689,MATH 10A,A02,083736,Patchell; Gregory David,27,0,30,3
1651034994689,MATH 10A,A03,083737,Patchell; Gregory David,23,0,30,7
1651035000725,MATH 10B,A01,083207,Staff,0,8,30,30
1651035000725,MATH 10B,A02,083208,Staff,0,7,30,30
1651035000725,MATH 10B,B01,083739,Staff,8,0,30,22
1651035000725,MATH 10B,B02,083740,Staff,28,0,30,2
1651035006749,MATH 18,A01,083743,Staff,0,0,30,30
1651035006749,MATH 18,A02,083744,Staff,23,0,30,7
1651035006749,MATH 18,A03,083745,Staff,19,0,30,11
1651035006749,MATH 18,A04,083746,Staff,26,0,30,4
1651035006749,MATH 18,B01,083748,Staff,0,16,30,30
1651035006749,MATH 18,B02,083749,Staff,0,14,30,30
1651035006749,MATH 18,B03,083750,Staff,0,14,30,30
1651035006749,MATH 18,B04,083751,Staff,0,13,30,30
1651035012777,MATH 20A,A01,083754,Staff,18,0,40,22
1651035018800,MATH 20B,A01,083756,Staff,0,14,30,30
1651035018800,MATH 20B,A02,083757,Staff,0,11,30,30
1651035024824,MATH 20C,A01,083760,Staff,0,16,30,30
1651035024824,MATH 20C,A02,083761,Staff,0,15,30,30
1651035024824,MATH 20C,B01,083762,Staff,8,0,30,22
1651035024824,MATH 20C,B02,083763,Staff,28,0,30,2
1651035030850,MATH 20D,A01,083765,Staff,3,1,30,27
1651035030850,MATH 20D,A02,083766,Staff,1,0,30,29
1651035030850,MATH 20D,A03,083767,Staff,22,0,30,8
1651035036882,MATH 20E,A01,083771,Staff,2,0,30,28
1651035036882,MATH 20E,A02,083772,Staff,11,0,30,19
1651035036882,MATH 20E,B01,083773,Staff,0,0,30,30
1651035036882,MATH 20E,B02,083774,Staff,0,0,30,30
1651035042906,MATH 103A,A01,083777,Staff,0,17,30,30
1651035042906,MATH 103A,A02,083778,Staff,0,16,30,30
1651035042906,MATH 103A,B01,083779,Staff,0,15,30,30
1651035042906,MATH 103A,B02,083780,Staff,0,13,30,30
1651035048935,MATH 105,A01,085443,Staff,0,23,30,30
1651035054959,MATH 109,A01,083213,Anzaldo; Leesa B,0,8,30,30
1651035054959,MATH 109,A02,083214,Anzaldo; Leesa B,0,7,30,30
1651035054959,MATH 109,B01,083215,Anzaldo; Leesa B,0,8,30,30
1651035054959,MATH 109,B02,083216,Anzaldo; Leesa B,0,7,30,30
1651035060993,MATH 142A,A01,083219,Chow; Bennett,0,15,30,30
1651035060993,MATH 142A,A02,083220,Chow; Bennett,0,15,30,30
1651035060993,MATH 142A,B01,083221,Chow; Bennett,0,16,30,30
1651035060993,MATH 142A,B02,083222,Chow; Bennett,0,14,30,30
1651035067091,MATH 193A,A01,083224,Staff,0,8,30,30
1651035067091,MATH 193A,A02,083225,Staff,0,7,30,30
1651035067091,MATH 193A,A03,083781,Staff,0,7,30,30
1651035067091,MATH 193A,A04,083782,Staff,0,7,30,30
1651035073112,MATH 197,001,091859,McAuley; Julian John,9998,0,9999,1
1651035079162,COGS 9,A01,083615,Staff,0,19,60,60
1651035085188,COGS 11,A01,083617,Boyle; Mary E. T.,13,0,40,27
1651035091212,COGS 13,A01,083071,Staff,0,40,40,40
1651035097237,COGS 14A,A01,092681,Staff,0,40,100,100
1651035103261,COGS 14B,A01,083073,Cheng; Tzu-Han,0,13,50,50
1651035109287,COGS 17,A01,092677,Staff,8,0,75,67
1651035115310,COGS 100,A01,083619,Staff,0,30,60,60
1651035121338,COGS 101A,A01,083621,Davis; Joshua Daniel,0,29,60,60
1651035127407,COGS 101B,A01,091572,Staff,0,7,60,60
1651035133432,COGS 101C,A01,083625,Delgado; Tania,14,0,30,16
1651035139456,COGS 107A,A01,083627,Boyle; Mary E. T.,0,17,60,60
1651035145481,COGS 118A,A01,083075,Staff,0,10,60,60
1651035151505,CSE 3,A50,083646,Miranda; Gregory Joseph,15,0,38,23
1651035151505,CSE 3,A51,083647,Miranda; Gregory Joseph,36,0,37,1
1651035157532,CSE 8A,A50,083650,Miranda; Gregory Joseph,0,31,40,40
1651035163558,CSE 11,A01,083080,Cao; Yingjun,0,97,40,40
1651035169581,CSE 12,A01,083652,Staff,0,25,100,100
1651035175605,CSE 15L,A01,083654,Staff,1,3,50,49
1651035175605,CSE 15L,A02,083655,Staff,0,3,50,50
1651035181628,CSE 20,A01,083657,Staff,47,0,80,33
1651035187651,CSE 30,A01,083084,Eldon; John,1,39,80,79
1651035193675,CSE 100,A01,083659,Cao; Yingjun,0,72,50,50
1651035199712,CSE 134B,A01,083661,Powell; Thomas Allan,1,39,65,64
1651035205736,CSE 140,A01,083663,Staff,0,14,75,75
1651035211761,CSE 140L,A01,083088,Eldon; John,4,0,100,96
1651035217788,CSE 175,A01,083665,Kumar; Rakesh,0,0,25,25
1651035223813,CSE 190,A00,092507,Dubnov; Shlomo,9,0,20,11
1651035229836,ECE 45,A01,083139,Staff,0,7,60,60
1651035235859,ECE 65,A50,083695,Staff,0,7,30,30
1651035241883,ECE 109,A01,091882,Touri; Behrouz,32,0,70,38
1651035247923,ECE 180,A00,083140,Abi Samra; Nicholas Camill,17,0,30,13
1651035247923,ECE 180,B00,083141,Abi Samra; Nicholas Camill,0,0,30,30
1651035253951,MATH 10A,A01,083735,Patchell; Gregory David,1,0,30,29
1651035253951,MATH 10A,A02,083736,Patchell; Gregory David,27,0,30,3
1651035253951,MATH 10A,A03,083737,Patchell; Gregory David,23,0,30,7
1651035259976,MATH 10B,A01,083207,Staff,0,8,30,30
1651035259976,MATH 10B,A02,083208,Staff,0,7,30,30
1651035259976,MATH 10B,B01,083739,Staff,8,0,30,22
1651035259976,MATH 10B,B02,083740,Staff,28,0,30,2
1651035266006,MATH 18,A01,083743,Staff,0,0,30,30
1651035266006,MATH 18,A02,083744,Staff,23,0,30,7
1651035266006,MATH 18,A03,083745,Staff,19,0,30,11
1651035266006,MATH 18,A04,083746,Staff,26,0,30,4
1651035266006,MATH 18,B01,083748,Staff,0,16,30,30
1651035266006,MATH 18,B02,083749,Staff,0,14,30,30
1651035266006,MATH 18,B03,083750,Staff,0,14,30,30
1651035266006,MATH 18,B04,083751,Staff,0,13,30,30
1651035272029,MATH 20A,A01,083754,Staff,18,0,40,22
1651035278053,MATH 20B,A01,083756,Staff,0,14,30,30
1651035278053,MATH 20B,A02,083757,Staff,0,11,30,30
1651035284081,MATH 20C,A01,083760,Staff,0,16,30,30
1651035284081,MATH 20C,A02,083761,Staff,0,15,30,30
1651035284081,MATH 20C,B01,083762,Staff,8,0,30,22
1651035284081,MATH 20C,B02,083763,Staff,28,0,30,2
1651035290105,MATH 20D,A01,083765,Staff,3,1,30,27
1651035290105,MATH 20D,A02,083766,Staff,1,0,30,29
1651035290105,MATH 20D,A03,083767,Staff,22,0,30,8
1651035296129,MATH 20E,A01,083771,Staff,2,0,30,28
1651035296129,MATH 20E,A02,083772,Staff,11,0,30,19
1651035296129,MATH 20E,B01,083773,Staff,0,0,30,30
1651035296129,MATH 20E,B02,083774,Staff,0,0,30,30
1651035302153,MATH 103A,A01,083777,Staff,0,17,30,30
1651035302153,MATH 103A,A02,083778,Staff,0,16,30,30
1651035302153,MATH 103A,B01,083779,Staff,0,15,30,30
1651035302153,MATH 103A,B02,083780,Staff,0,13,30,30
1651035308180,MATH 105,A01,085443,Staff,0,23,30,30
1651035314207,MATH 109,A01,083213,Anzaldo; Leesa B,0,8,30,30
1651035314207,MATH 109,A02,083214,Anzaldo; Leesa B,0,7,30,30
1651035314207,MATH 109,B01,083215,Anzaldo; Leesa B,0,8,30,30
1651035314207,MATH 109,B02,083216,Anzaldo; Leesa B,0,7,30,30
1651035320232,MATH 142A,A01,083219,Chow; Bennett,0,15,30,30
1651035320232,MATH 142A,A02,083220,Chow; Bennett,0,15,30,30
1651035320232,MATH 142A,B01,083221,Chow; Bennett,0,16,30,30
1651035320232,MATH 142A,B02,083222,Chow; Bennett,0,14,30,30
1651035326260,MATH 193A,A01,083224,Staff,0,8,30,30
1651035326260,MATH 193A,A02,083225,Staff,0,7,30,30
1651035326260,MATH 193A,A03,083781,Staff,0,7,30,30
1651035326260,MATH 193A,A04,083782,Staff,0,7,30,30
1651035332284,MATH 197,001,091859,McAuley; Julian John,9998,0,9999,1
1651035338340,COGS 9,A01,083615,Staff,0,19,60,60
1651035344364,COGS 11,A01,083617,Boyle; Mary E. T.,13,0,40,27
1651035350387,COGS 13,A01,083071,Staff,0,40,40,40
1651035356413,COGS 14A,A01,092681,Staff,0,40,100,100
1651035362437,COGS 14B,A01,083073,Cheng; Tzu-Han,0,13,50,50
1651035368459,COGS 17,A01,092677,Staff,8,0,75,67
1651035374486,COGS 100,A01,083619,Staff,0,30,60,60
1651035380509,COGS 101A,A01,083621,Davis; Joshua Daniel,0,29,60,60
1651035386541,COGS 101B,A01,091572,Staff,0,7,60,60
1651035392567,COGS 101C,A01,083625,Delgado; Tania,14,0,30,16
1651035398594,COGS 107A,A01,083627,Boyle; Mary E. T.,0,17,60,60
1651035404617,COGS 118A,A01,083075,Staff,0,10,60,60
1651035410640,CSE 3,A50,083646,Miranda; Gregory Joseph,15,0,38,23
1651035410640,CSE 3,A51,083647,Miranda; Gregory Joseph,36,0,37,1
1651035416664,CSE 8A,A50,083650,Miranda; Gregory Joseph,0,31,40,40
1651035422687,CSE 11,A01,083080,Cao; Yingjun,0,97,40,40
1651035428712,CSE 12,A01,083652,Staff,0,25,100,100
1651035434736,CSE 15L,A01,083654,Staff,1,3,50,49
1651035434736,CSE 15L,A02,083655,Staff,0,3,50,50
1651035440758,CSE 20,A01,083657,Staff,47,0,80,33
1651035446785,CSE 30,A01,083084,Eldon; John,1,39,80,79
1651035452808,CSE 100,A01,083659,Cao; Yingjun,0,72,50,50
1651035458832,CSE 134B,A01,083661,Powell; Thomas Allan,1,39,65,64
1651035464858,CSE 140,A01,083663,Staff,0,14,75,75
1651035470889,CSE 140L,A01,083088,Eldon; John,4,0,100,96
1651035476914,CSE 175,A01,083665,Kumar; Rakesh,0,0,25,25
1651035482938,CSE 190,A00,092507,Dubnov; Shlomo,9,0,20,11
1651035488962,ECE 45,A01,083139,Staff,0,7,60,60
1651035494989,ECE 65,A50,083695,Staff,0,7,30,30
1651035501014,ECE 109,A01,091882,Touri; Behrouz,32,0,70,38
1651035507053,ECE 180,A00,083140,Abi Samra; Nicholas Camill,17,0,30,13
1651035507053,ECE 180,B00,083141,Abi Samra; Nicholas Camill,0,0,30,30
1651035513081,MATH 10A,A01,083735,Patchell; Gregory David,1,0,30,29
1651035513081,MATH 10A,A02,083736,Patchell; Gregory David,27,0,30,3
1651035513081,MATH 10A,A03,083737,Patchell; Gregory David,23,0,30,7
1651035519109,MATH 10B,A01,083207,Staff,0,8,30,30
1651035519109,MATH 10B,A02,083208,Staff,0,7,30,30
1651035519109,MATH 10B,B01,083739,Staff,8,0,30,22
1651035519109,MATH 10B,B02,083740,Staff,28,0,30,2
1651035525134,MATH 18,A01,083743,Staff,0,0,30,30
1651035525134,MATH 18,A02,083744,Staff,23,0,30,7
1651035525134,MATH 18,A03,083745,Staff,19,0,30,11
1651035525134,MATH 18,A04,083746,Staff,26,0,30,4
1651035525134,MATH 18,B01,083748,Staff,0,16,30,30
1651035525134,MATH 18,B02,083749,Staff,0,14,30,30
1651035525134,MATH 18,B03,083750,Staff,0,14,30,30
1651035525134,MATH 18,B04,083751,Staff,0,13,30,30
1651035531160,MATH 20A,A01,083754,Staff,18,0,40,22
1651035537186,MATH 20B,A01,083756,Staff,0,14,30,30
1651035537186,MATH 20B,A02,083757,Staff,0,11,30,30
1651035543211,MATH 20C,A01,083760,Staff,0,16,30,30
1651035543211,MATH 20C,A02,083761,Staff,0,15,30,30
1651035543211,MATH 20C,B01,083762,Staff,8,0,30,22
1651035543211,MATH 20C,B02,083763,Staff,28,0,30,2
1651035549235,MATH 20D,A01,083765,Staff,3,1,30,27
1651035549235,MATH 20D,A02,083766,Staff,1,0,30,29
1651035549235,MATH 20D,A03,083767,Staff,22,0,30,8
1651035555268,MATH 20E,A01,083771,Staff,2,0,30,28
1651035555268,MATH 20E,A02,083772,Staff,11,0,30,19
1651035555268,MATH 20E,B01,083773,Staff,0,0,30,30
1651035555268,MATH 20E,B02,083774,Staff,0,0,30,30
1651035561293,MATH 103A,A01,083777,Staff,0,17,30,30
1651035561293,MATH 103A,A02,083778,Staff,0,16,30,30
1651035561293,MATH 103A,B01,083779,Staff,0,15,30,30
1651035561293,MATH 103A,B02,083780,Staff,0,13,30,30
1651035567319,MATH 105,A01,085443,Staff,0,23,30,30
1651035573343,MATH 109,A01,083213,Anzaldo; Leesa B,0,8,30,30
1651035573343,MATH 109,A02,083214,Anzaldo; Leesa B,0,7,30,30
1651035573343,MATH 109,B01,083215,Anzaldo; Leesa B,0,8,30,30
1651035573343,MATH 109,B02,083216,Anzaldo; Leesa B,0,7,30,30
1651035579367,MATH 142A,A01,083219,Chow; Bennett,0,15,30,30
1651035579367,MATH 142A,A02,083220,Chow; Bennett,0,15,30,30
1651035579367,MATH 142A,B01,083221,Chow; Bennett,0,16,30,30
1651035579367,MATH 142A,B02,083222,Chow; Bennett,0,14,30,30
1651035585405,MATH 193A,A01,083224,Staff,0,8,30,30
1651035585405,MATH 193A,A02,083225,Staff,0,7,30,30
1651035585405,MATH 193A,A03,083781,Staff,0,7,30,30
1651035585405,MATH 193A,A04,083782,Staff,0,7,30,30
1651035591429,MATH 197,001,091859,McAuley; Julian John,9998,0,9999,1
1651035597483,COGS 9,A01,083615,Staff,0,19,60,60
1651035603511,COGS 11,A01,083617,Boyle; Mary E. T.,13,0,40,27
1651035609539,COGS 13,A01,083071,Staff,0,40,40,40
1651035615562,COGS 14A,A01,092681,Staff,0,40,100,100
1651035621586,COGS 14B,A01,083073,Cheng; Tzu-Han,0,13,50,50
1651035627609,COGS 17,A01,092677,Staff,8,0,75,67
1651035633635,COGS 100,A01,083619,Staff,0,30,60,60
1651035639658,COGS 101A,A01,083621,Davis; Joshua Daniel,0,29,60,60
1651035645682,COGS 101B,A01,091572,Staff,0,7,60,60
1651035651706,COGS 101C,A01,083625,Delgado; Tania,14,0,30,16
1651035657802,COGS 107A,A01,083627,Boyle; Mary E. T.,0,17,60,60
1651035663827,COGS 118A,A01,083075,Staff,0,10,60,60
1651035669852,CSE 3,A50,083646,Miranda; Gregory Joseph,15,0,38,23
1651035669852,CSE 3,A51,083647,Miranda; Gregory Joseph,36,0,37,1
1651035675883,CSE 8A,A50,083650,Miranda; Gregory Joseph,0,31,40,40
1651035681906,CSE 11,A01,083080,Cao; Yingjun,0,97,40,40
1651035687934,CSE 12,A01,083652,Staff,0,25,100,100
1651035693965,CSE 15L,A01,083654,Staff,1,3,50,49
1651035693965,CSE 15L,A02,083655,Staff,0,3,50,50
1651035699988,CSE 20,A01,083657,Staff,47,0,80,33
1651035706018,CSE 30,A01,083084,Eldon; John,1,39,80,79
1651035712044,CSE 100,A01,083659,Cao; Yingjun,0,72,50,50
1651035718071,CSE 134B,A01,083661,Powell; Thomas Allan,1,39,65,64
1651035724095,CSE 140,A01,083663,Staff,0,14,75,75
1651035730121,CSE 140L,A01,083088,Eldon; John,4,0,100,96
1651035736147,CSE 175,A01,083665,Kumar; Rakesh,0,0,25,25
1651035742174,CSE 190,A00,092507,Dubnov; Shlomo,9,0,20,11
1651035748200,ECE 45,A01,083139,Staff,0,7,60,60
1651035754224,ECE 65,A50,083695,Staff,0,7,30,30
1651035760258,ECE 109,A01,091882,Touri; Behrouz,32,0,70,38
1651035766288,ECE 180,A00,083140,Abi Samra; Nicholas Camill,17,0,30,13
1651035766288,ECE 180,B00,083141,Abi Samra; Nicholas Camill,0,0,30,30
1651035772320,MATH 10A,A01,083735,Patchell; Gregory David,1,0,30,29
1651035772320,MATH 10A,A02,083736,Patchell; Gregory David,27,0,30,3
1651035772320,MATH 10A,A03,083737,Patchell; Gregory David,23,0,30,7
1651035778348,MATH 10B,A01,083207,Staff,0,8,30,30
1651035778348,MATH 10B,A02,083208,Staff,0,7,30,30
1651035778348,MATH 10B,B01,083739,Staff,8,0,30,22
1651035778348,MATH 10B,B02,083740,Staff,28,0,30,2
1651035784376,MATH 18,A01,083743,Staff,0,0,30,30
1651035784376,MATH 18,A02,083744,Staff,23,0,30,7
1651035784376,MATH 18,A03,083745,Staff,19,0,30,11
1651035784376,MATH 18,A04,083746,Staff,26,0,30,4
1651035784376,MATH 18,B01,083748,Staff,0,16,30,30
1651035784376,MATH 18,B02,083749,Staff,0,14,30,30
1651035784376,MATH 18,B03,083750,Staff,0,14,30,30
1651035784376,MATH 18,B04,083751,Staff,0,13,30,30
1651035790400,MATH 20A,A01,083754,Staff,18,0,40,22
1651035796428,MATH 20B,A01,083756,Staff,0,14,30,30
1651035796428,MATH 20B,A02,083757,Staff,0,11,30,30
1651035802455,MATH 20C,A01,083760,Staff,0,16,30,30
1651035802455,MATH 20C,A02,083761,Staff,0,15,30,30
1651035802455,MATH 20C,B01,083762,Staff,8,0,30,22
1651035802455,MATH 20C,B02,083763,Staff,28,0,30,2
1651035808478,MATH 20D,A01,083765,Staff,3,1,30,27
1651035808478,MATH 20D,A02,083766,Staff,1,0,30,29
1651035808478,MATH 20D,A03,083767,Staff,22,0,30,8
1651035814504,MATH 20E,A01,083771,Staff,2,0,30,28
1651035814504,MATH 20E,A02,083772,Staff,11,0,30,19
1651035814504,MATH 20E,B01,083773,Staff,0,0,30,30
1651035814504,MATH 20E,B02,083774,Staff,0,0,30,30
1651035820532,MATH 103A,A01,083777,Staff,0,17,30,30
1651035820532,MATH 103A,A02,083778,Staff,0,16,30,30
1651035820532,MATH 103A,B01,083779,Staff,0,15,30,30
1651035820532,MATH 103A,B02,083780,Staff,0,13,30,30
1651035826555,MATH 105,A01,085443,Staff,0,23,30,30
1651035832583,MATH 109,A01,083213,Anzaldo; Leesa B,0,8,30,30
1651035832583,MATH 109,A02,083214,Anzaldo; Leesa B,0,7,30,30
1651035832583,MATH 109,B01,083215,Anzaldo; Leesa B,0,8,30,30
1651035832583,MATH 109,B02,083216,Anzaldo; Leesa B,0,7,30,30
1651035838607,MATH 142A,A01,083219,Chow; Bennett,0,15,30,30
1651035838607,MATH 142A,A02,083220,Chow; Bennett,0,15,30,30
1651035838607,MATH 142A,B01,083221,Chow; Bennett,0,16,30,30
1651035838607,MATH 142A,B02,083222,Chow; Bennett,0,14,30,30
1651035844630,MATH 193A,A01,083224,Staff,0,8,30,30
1651035844630,MATH 193A,A02,083225,Staff,0,7,30,30
1651035844630,MATH 193A,A03,083781,Staff,0,7,30,30
1651035844630,MATH 193A,A04,083782,Staff,0,7,30,30
1651035850653,MATH 197,001,091859,McAuley; Julian John,9998,0,9999,1
1651035856705,COGS 9,A01,083615,Staff,0,19,60,60
1651035862734,COGS 11,A01,083617,Boyle; Mary E. T.,13,0,40,27
1651035868771,COGS 13,A01,083071,Staff,0,40,40,40
1651035874794,COGS 14A,A01,092681,Staff,0,40,100,100
1651035880818,COGS 14B,A01,083073,Cheng; Tzu-Han,0,13,50,50
1651035886842,COGS 17,A01,092677,Staff,8,0,75,67
1651035892864,COGS 100,A01,083619,Staff,0,30,60,60
1651035898888,COGS 101A,A01,083621,Davis; Joshua Daniel,0,29,60,60
1651035904911,COGS 101B,A01,091572,Staff,0,7,60,60
1651035910935,COGS 101C,A01,083625,Delgado; Tania,14,0,30,16
1651035916960,COGS 107A,A01,083627,Boyle; Mary E. T.,0,17,60,60
1651035922986,COGS 118A,A01,083075,Staff,0,10,60,60
1651035929015,CSE 3,A50,083646,Miranda; Gregory Joseph,15,0,38,23
1651035929015,CSE 3,A51,083647,Miranda; Gregory Joseph,36,0,37,1
1651035935038,CSE 8A,A50,083650,Miranda; Gregory Joseph,0,31,40,40
1651035941063,CSE 11,A01,083080,Cao; Yingjun,0,97,40,40
1651035947085,CSE 12,A01,083652,Staff,0,25,100,100
1651035953110,CSE 15L,A01,083654,Staff,1,3,50,49
1651035953110,CSE 15L,A02,083655,Staff,0,3,50,50
1651035959136,CSE 20,A01,083657,Staff,47,0,80,33
1651035965167,CSE 30,A01,083084,Eldon; John,1,39,80,79
1651035971191,CSE 100,A01,083659,Cao; Yingjun,0,72,50,50
1651035977215,CSE 134B,A01,083661,Powell; Thomas Allan,1,39,65,64
1651035983238,CSE 140,A01,083663,Staff,0,14,75,75
1651035989265,CSE 140L,A01,083088,Eldon; John,4,0,100,96
1651035995290,CSE 175,A01,083665,Kumar; Rakesh,0,0,25,25
1651036001321,CSE 190,A00,092507,Dubnov; Shlomo,9,0,20,11
1651036007344,ECE 45,A01,083139,Staff,0,7,60,60
1651036013366,ECE 65,A50,083695,Staff,0,7,30,30
1651036019392,ECE 109,A01,091882,Touri; Behrouz,32,0,70,38
1651036025431,ECE 180,A00,083140,Abi Samra; Nicholas Camill,17,0,30,13
1651036025431,ECE 180,B00,083141,Abi Samra; Nicholas Camill,0,0,30,30
1651036031455,MATH 10A,A01,083735,Patchell; Gregory David,0,0,30,30
1651036031455,MATH 10A,A02,083736,Patchell; Gregory David,27,0,30,3
1651036031455,MATH 10A,A03,083737,Patchell; Gregory David,23,0,30,7
1651036037478,MATH 10B,A01,083207,Staff,0,8,30,30
1651036037478,MATH 10B,A02,083208,Staff,0,7,30,30
1651036037478,MATH 10B,B01,083739,Staff,8,0,30,22
1651036037478,MATH 10B,B02,083740,Staff,28,0,30,2
1651036043505,MATH 18,A01,083743,Staff,0,0,30,30
1651036043505,MATH 18,A02,083744,Staff,23,0,30,7
1651036043505,MATH 18,A03,083745,Staff,19,0,30,11
1651036043505,MATH 18,A04,083746,Staff,26,0,30,4
1651036043505,MATH 18,B01,083748,Staff,0,16,30,30
1651036043505,MATH 18,B02,083749,Staff,0,14,30,30
1651036043505,MATH 18,B03,083750,Staff,0,14,30,30
1651036043505,MATH 18,B04,083751,Staff,0,13,30,30
1651036049530,MATH 20A,A01,083754,Staff,18,0,40,22
1651036055553,MATH 20B,A01,083756,Staff,0,14,30,30
1651036055553,MATH 20B,A02,083757,Staff,0,11,30,30
1651036061578,MATH 20C,A01,083760,Staff,0,16,30,30
1651036061578,MATH 20C,A02,083761,Staff,0,15,30,30
1651036061578,MATH 20C,B01,083762,Staff,8,0,30,22
1651036061578,MATH 20C,B02,083763,Staff,28,0,30,2
1651036067600,MATH 20D,A01,083765,Staff,3,1,30,27
1651036067600,MATH 20D,A02,083766,Staff,1,0,30,29
1651036067600,MATH 20D,A03,083767,Staff,22,0,30,8
1651036073627,MATH 20E,A01,083771,Staff,2,0,30,28
1651036073627,MATH 20E,A02,083772,Staff,11,0,30,19
1651036073627,MATH 20E,B01,083773,Staff,0,0,30,30
1651036073627,MATH 20E,B02,083774,Staff,0,0,30,30
1651036079660,MATH 103A,A01,083777,Staff,0,17,30,30
1651036079660,MATH 103A,A02,083778,Staff,0,16,30,30
1651036079660,MATH 103A,B01,083779,Staff,0,15,30,30
1651036079660,MATH 103A,B02,083780,Staff,0,13,30,30
1651036085744,MATH 105,A01,085443,Staff,0,23,30,30
1651036091769,MATH 109,A01,083213,Anzaldo; Leesa B,0,8,30,30
1651036091769,MATH 109,A02,083214,Anzaldo; Leesa B,0,7,30,30
1651036091769,MATH 109,B01,083215,Anzaldo; Leesa B,0,8,30,30
1651036091769,MATH 109,B02,083216,Anzaldo; Leesa B,0,7,30,30
1651036097792,MATH 142A,A01,083219,Chow; Bennett,0,15,30,30
1651036097792,MATH 142A,A02,083220,Chow; Bennett,0,15,30,30
1651036097792,MATH 142A,B01,083221,Chow; Bennett,0,16,30,30
1651036097792,MATH 142A,B02,083222,Chow; Bennett,0,14,30,30
1651036103833,MATH 193A,A01,083224,Staff,0,8,30,30
1651036103833,MATH 193A,A02,083225,Staff,0,7,30,30
1651036103833,MATH 193A,A03,083781,Staff,0,7,30,30
1651036103833,MATH 193A,A04,083782,Staff,0,7,30,30
1651036109859,MATH 197,001,091859,McAuley; Julian John,9998,0,9999,1
1651036115914,COGS 9,A01,083615,Staff,0,19,60,60
1651036121944,COGS 11,A01,083617,Boyle; Mary E. T.,13,0,40,27
1651036127980,COGS 13,A01,083071,Staff,0,40,40,40
1651036134009,COGS 14A,A01,092681,Staff,0,40,100,100
1651036140036,COGS 14B,A01,083073,Cheng; Tzu-Han,0,13,50,50
1651036146064,COGS 17,A01,092677,Staff,8,0,75,67
1651036152089,COGS 100,A01,083619,Staff,0,30,60,60
1651036158113,COGS 101A,A01,083621,Davis; Joshua Daniel,0,29,60,60
1651036164137,COGS 101B,A01,091572,Staff,0,7,60,60
1651036170161,COGS 101C,A01,083625,Delgado; Tania,14,0,30,16
1651036176185,COGS 107A,A01,083627,Boyle; Mary E. T.,0,17,60,60
1651036182209,COGS 118A,A01,083075,Staff,0,10,60,60
1651036188235,CSE 3,A50,083646,Miranda; Gregory Joseph,15,0,38,23
1651036188235,CSE 3,A51,083647,Miranda; Gregory Joseph,36,0,37,1
1651036194263,CSE 8A,A50,083650,Miranda; Gregory Joseph,0,31,40,40
1651036200304,CSE 11,A01,083080,Cao; Yingjun,0,97,40,40
1651036206330,CSE 12,A01,083652,Staff,0,25,100,100
1651036212354,CSE 15L,A01,083654,Staff,1,3,50,49
1651036212354,CSE 15L,A02,083655,Staff,0,3,50,50
1651036218378,CSE 20,A01,083657,Staff,47,0,80,33
1651036224403,CSE 30,A01,083084,Eldon; John,1,39,80,79
1651036230426,CSE 100,A01,083659,Cao; Yingjun,0,72,50,50
1651036236455,CSE 134B,A01,083661,Powell; Thomas Allan,1,39,65,64
1651036242482,CSE 140,A01,083663,Staff,0,14,75,75
1651036248508,CSE 140L,A01,083088,Eldon; John,4,0,100,96
1651036254641,CSE 175,A01,083665,Kumar; Rakesh,0,0,25,25
1651036260664,CSE 190,A00,092507,Dubnov; Shlomo,9,0,20,11
1651036266687,ECE 45,A01,083139,Staff,0,7,60,60
1651036272714,ECE 65,A50,083695,Staff,0,7,30,30
1651036278738,ECE 109,A01,091882,Touri; Behrouz,32,0,70,38
1651036284762,ECE 180,A00,083140,Abi Samra; Nicholas Camill,17,0,30,13
1651036284762,ECE 180,B00,083141,Abi Samra; Nicholas Camill,0,0,30,30
1651036290787,MATH 10A,A01,083735,Patchell; Gregory David,0,0,30,30
1651036290787,MATH 10A,A02,083736,Patchell; Gregory David,27,0,30,3
1651036290787,MATH 10A,A03,083737,Patchell; Gregory David,23,0,30,7
1651036296812,MATH 10B,A01,083207,Staff,0,8,30,30
1651036296812,MATH 10B,A02,083208,Staff,0,7,30,30
1651036296812,MATH 10B,B01,083739,Staff,8,0,30,22
1651036296812,MATH 10B,B02,083740,Staff,28,0,30,2
1651036302839,MATH 18,A01,083743,Staff,0,0,30,30
1651036302839,MATH 18,A02,083744,Staff,23,0,30,7
1651036302839,MATH 18,A03,083745,Staff,19,0,30,11
1651036302839,MATH 18,A04,083746,Staff,26,0,30,4
1651036302839,MATH 18,B01,083748,Staff,0,16,30,30
1651036302839,MATH 18,B02,083749,Staff,0,14,30,30
1651036302839,MATH 18,B03,083750,Staff,0,14,30,30
1651036302839,MATH 18,B04,083751,Staff,0,13,30,30
1651036308866,MATH 20A,A01,083754,Staff,18,0,40,22
1651036314888,MATH 20B,A01,083756,Staff,0,14,30,30
1651036314888,MATH 20B,A02,083757,Staff,0,11,30,30
1651036320912,MATH 20C,A01,083760,Staff,0,16,30,30
1651036320912,MATH 20C,A02,083761,Staff,0,15,30,30
1651036320912,MATH 20C,B01,083762,Staff,8,0,30,22
1651036320912,MATH 20C,B02,083763,Staff,28,0,30,2
1651036326934,MATH 20D,A01,083765,Staff,3,1,30,27
1651036326934,MATH 20D,A02,083766,Staff,1,0,30,29
1651036326934,MATH 20D,A03,083767,Staff,22,0,30,8
1651036332973,MATH 20E,A01,083771,Staff,2,0,30,28
1651036332973,MATH 20E,A02,083772,Staff,11,0,30,19
1651036332973,MATH 20E,B01,083773,Staff,0,0,30,30
1651036332973,MATH 20E,B02,083774,Staff,0,0,30,30
1651036339000,MATH 103A,A01,083777,Staff,0,17,30,30
1651036339000,MATH 103A,A02,083778,Staff,0,16,30,30
1651036339000,MATH 103A,B01,083779,Staff,0,15,30,30
1651036339000,MATH 103A,B02,083780,Staff,0,13,30,30
1651036345025,MATH 105,A01,085443,Staff,0,23,30,30
1651036351049,MATH 109,A01,083213,Anzaldo; Leesa B,0,8,30,30
1651036351049,MATH 109,A02,083214,Anzaldo; Leesa B,0,7,30,30
1651036351049,MATH 109,B01,083215,Anzaldo; Leesa B,0,8,30,30
1651036351049,MATH 109,B02,083216,Anzaldo; Leesa B,0,7,30,30
1651036357073,MATH 142A,A01,083219,Chow; Bennett,0,15,30,30
1651036357073,MATH 142A,A02,083220,Chow; Bennett,0,15,30,30
1651036357073,MATH 142A,B01,083221,Chow; Bennett,0,16,30,30
1651036357073,MATH 142A,B02,083222,Chow; Bennett,0,14,30,30
1651036363100,MATH 193A,A01,083224,Staff,0,8,30,30
1651036363100,MATH 193A,A02,083225,Staff,0,7,30,30
1651036363100,MATH 193A,A03,083781,Staff,0,7,30,30
1651036363100,MATH 193A,A04,083782,Staff,0,7,30,30
1651036369124,MATH 197,001,091859,McAuley; Julian John,9998,0,9999,1
1651036375185,COGS 9,A01,083615,Staff,0,19,60,60
1651036381208,COGS 11,A01,083617,Boyle; Mary E. T.,13,0,40,27
1651036387232,COGS 13,A01,083071,Staff,0,40,40,40
1651036393257,COGS 14A,A01,092681,Staff,0,40,100,100
1651036399280,COGS 14B,A01,083073,Cheng; Tzu-Han,0,13,50,50
1651036405304,COGS 17,A01,092677,Staff,8,0,75,67
1651036411329,COGS 100,A01,083619,Staff,0,30,60,60
1651036417352,COGS 101A,A01,083621,Davis; Joshua Daniel,0,29,60,60
1651036423376,COGS 101B,A01,091572,Staff,0,7,60,60
1651036429404,COGS 101C,A01,083625,Delgado; Tania,14,0,30,16
1651036435430,COGS 107A,A01,083627,Boyle; Mary E. T.,0,17,60,60
1651036441456,COGS 118A,A01,083075,Staff,0,10,60,60
1651036447481,CSE 3,A50,083646,Miranda; Gregory Joseph,15,0,38,23
1651036447481,CSE 3,A51,083647,Miranda; Gregory Joseph,36,0,37,1
1651036453505,CSE 8A,A50,083650,Miranda; Gregory Joseph,0,31,40,40
1651036459529,CSE 11,A01,083080,Cao; Yingjun,0,97,40,40
1651036465555,CSE 12,A01,083652,Staff,0,25,100,100
1651036471584,CSE 15L,A01,083654,Staff,1,3,50,49
1651036471584,CSE 15L,A02,083655,Staff,0,3,50,50
1651036477606,CSE 20,A01,083657,Staff,47,0,80,33
1651036483633,CSE 30,A01,083084,Eldon; John,1,39,80,79
1651036489662,CSE 100,A01,083659,Cao; Yingjun,0,72,50,50
1651036495688,CSE 134B,A01,083661,Powell; Thomas Allan,1,39,65,64
1651036501712,CSE 140,A01,083663,Staff,0,14,75,75
1651036507753,CSE 140L,A01,083088,Eldon; John,4,0,100,96
1651036513774,CSE 175,A01,083665,Kumar; Rakesh,0,0,25,25
1651036519800,CSE 190,A00,092507,Dubnov; Shlomo,9,0,20,11
1651036525823,ECE 45,A01,083139,Staff,0,7,60,60
1651036531846,ECE 65,A50,083695,Staff,0,7,30,30
1651036537871,ECE 109,A01,091882,Touri; Behrouz,32,0,70,38
1651036543893,ECE 180,A00,083140,Abi Samra; Nicholas Camill,17,0,30,13
1651036543893,ECE 180,B00,083141,Abi Samra; Nicholas Camill,0,0,30,30
1651036549920,MATH 10A,A01,083735,Patchell; Gregory David,0,0,30,30
1651036549920,MATH 10A,A02,083736,Patchell; Gregory David,27,0,30,3
1651036549920,MATH 10A,A03,083737,Patchell; Gregory David,23,0,30,7
1651036555970,MATH 10B,A01,083207,Staff,0,8,30,30
1651036555970,MATH 10B,A02,083208,Staff,0,7,30,30
1651036555970,MATH 10B,B01,083739,Staff,8,0,30,22
1651036555970,MATH 10B,B02,083740,Staff,28,0,30,2
1651036562001,MATH 18,A01,083743,Staff,0,0,30,30
1651036562001,MATH 18,A02,083744,Staff,23,0,30,7
1651036562001,MATH 18,A03,083745,Staff,19,0,30,11
1651036562001,MATH 18,A04,083746,Staff,26,0,30,4
1651036562001,MATH 18,B01,083748,Staff,0,16,30,30
1651036562001,MATH 18,B02,083749,Staff,0,14,30,30
1651036562001,MATH 18,B03,083750,Staff,0,14,30,30
1651036562001,MATH 18,B04,083751,Staff,0,13,30,30
1651036568039,MATH 20A,A01,083754,Staff,18,0,40,22
1651036574070,MATH 20B,A01,083756,Staff,0,14,30,30
1651036574070,MATH 20B,A02,083757,Staff,0,11,30,30
1651036580094,MATH 20C,A01,083760,Staff,0,16,30,30
1651036580094,MATH 20C,A02,083761,Staff,0,15,30,30
1651036580094,MATH 20C,B01,083762,Staff,8,0,30,22
1651036580094,MATH 20C,B02,083763,Staff,28,0,30,2
1651036586123,MATH 20D,A01,083765,Staff,3,1,30,27
1651036586123,MATH 20D,A02,083766,Staff,1,0,30,29
1651036586123,MATH 20D,A03,083767,Staff,22,0,30,8
1651036592148,MATH 20E,A01,083771,Staff,2,0,30,28
1651036592148,MATH 20E,A02,083772,Staff,11,0,30,19
1651036592148,MATH 20E,B01,083773,Staff,0,0,30,30
1651036592148,MATH 20E,B02,083774,Staff,0,0,30,30
1651036598172,MATH 103A,A01,083777,Staff,0,17,30,30
1651036598172,MATH 103A,A02,083778,Staff,0,16,30,30
1651036598172,MATH 103A,B01,083779,Staff,0,15,30,30
1651036598172,MATH 103A,B02,083780,Staff,0,13,30,30
1651036604196,MATH 105,A01,085443,Staff,0,23,30,30
1651036610230,MATH 109,A01,083213,Anzaldo; Leesa B,0,8,30,30
1651036610230,MATH 109,A02,083214,Anzaldo; Leesa B,0,7,30,30
1651036610230,MATH 109,B01,083215,Anzaldo; Leesa B,0,8,30,30
1651036610230,MATH 109,B02,083216,Anzaldo; Leesa B,0,8,30,30
1651036616256,MATH 142A,A01,083219,Chow; Bennett,0,15,30,30
1651036616256,MATH 142A,A02,083220,Chow; Bennett,0,15,30,30
1651036616256,MATH 142A,B01,083221,Chow; Bennett,0,16,30,30
1651036616256,MATH 142A,B02,083222,Chow; Bennett,0,14,30,30
1651036622283,MATH 193A,A01,083224,Staff,0,8,30,30
1651036622283,MATH 193A,A02,083225,Staff,0,7,30,30
1651036622283,MATH 193A,A03,083781,Staff,0,7,30,30
1651036622283,MATH 193A,A04,083782,Staff,0,7,30,30
1651036628305,MATH 197,001,091859,McAuley; Julian John,9998,0,9999,1
1651036634363,COGS 9,A01,083615,Staff,0,19,60,60
1651036640388,COGS 11,A01,083617,Boyle; Mary E. T.,13,0,40,27
1651036646414,COGS 13,A01,083071,Staff,0,40,40,40
1651036652437,COGS 14A,A01,092681,Staff,0,40,100,100
1651036658459,COGS 14B,A01,083073,Cheng; Tzu-Han,0,13,50,50
1651036664482,COGS 17,A01,092677,Staff,9,0,75,66
1651036670504,COGS 100,A01,083619,Staff,0,30,60,60
1651036676526,COGS 101A,A01,083621,Davis; Joshua Daniel,0,29,60,60
1651036682551,COGS 101B,A01,091572,Staff,0,7,60,60
1651036688575,COGS 101C,A01,083625,Delgado; Tania,14,0,30,16
1651036694600,COGS 107A,A01,083627,Boyle; Mary E. T.,0,17,60,60
1651036700622,COGS 118A,A01,083075,Staff,0,10,60,60
1651036706646,CSE 3,A50,083646,Miranda; Gregory Joseph,15,0,38,23
1651036706646,CSE 3,A51,083647,Miranda; Gregory Joseph,36,0,37,1
1651036712670,CSE 8A,A50,083650,Miranda; Gregory Joseph,0,31,40,40
1651036718699,CSE 11,A01,083080,Cao; Yingjun,0,97,40,40
1651036724726,CSE 12,A01,083652,Staff,0,25,100,100
1651036730752,CSE 15L,A01,083654,Staff,1,3,50,49
1651036730752,CSE 15L,A02,083655,Staff,0,3,50,50
1651036736783,CSE 20,A01,083657,Staff,47,0,80,33
1651036742813,CSE 30,A01,083084,Eldon; John,1,39,80,79
1651036748837,CSE 100,A01,083659,Cao; Yingjun,0,72,50,50
1651036754862,CSE 134B,A01,083661,Powell; Thomas Allan,1,39,65,64
1651036760885,CSE 140,A01,083663,Staff,0,14,75,75
1651036766909,CSE 140L,A01,083088,Eldon; John,4,0,100,96
1651036772931,CSE 175,A01,083665,Kumar; Rakesh,0,0,25,25
1651036778954,CSE 190,A00,092507,Dubnov; Shlomo,9,0,20,11
1651036784981,ECE 45,A01,083139,Staff,0,7,60,60
1651036791004,ECE 65,A50,083695,Staff,0,7,30,30
1651036797036,ECE 109,A01,091882,Touri; Behrouz,32,0,70,38
1651036803063,ECE 180,A00,083140,Abi Samra; Nicholas Camill,17,0,30,13
1651036803063,ECE 180,B00,083141,Abi Samra; Nicholas Camill,0,0,30,30
1651036809088,MATH 10A,A01,083735,Patchell; Gregory David,0,0,30,30
1651036809088,MATH 10A,A02,083736,Patchell; Gregory David,27,0,30,3
1651036809088,MATH 10A,A03,083737,Patchell; Gregory David,23,0,30,7
1651036815113,MATH 10B,A01,083207,Staff,0,8,30,30
1651036815113,MATH 10B,A02,083208,Staff,0,7,30,30
1651036815113,MATH 10B,B01,083739,Staff,8,0,30,22
1651036815113,MATH 10B,B02,083740,Staff,28,0,30,2
1651036821138,MATH 18,A01,083743,Staff,0,0,30,30
1651036821138,MATH 18,A02,083744,Staff,23,0,30,7
1651036821138,MATH 18,A03,083745,Staff,19,0,30,11
1651036821138,MATH 18,A04,083746,Staff,26,0,30,4
1651036821138,MATH 18,B01,083748,Staff,0,16,30,30
1651036821138,MATH 18,B02,083749,Staff,0,14,30,30
1651036821138,MATH 18,B03,083750,Staff,0,14,30,30
1651036821138,MATH 18,B04,083751,Staff,0,13,30,30
1651036827167,MATH 20A,A01,083754,Staff,18,0,40,22
1651036833195,MATH 20B,A01,083756,Staff,0,14,30,30
1651036833195,MATH 20B,A02,083757,Staff,0,11,30,30
1651036839218,MATH 20C,A01,083760,Staff,0,16,30,30
1651036839218,MATH 20C,A02,083761,Staff,0,15,30,30
1651036839218,MATH 20C,B01,083762,Staff,8,0,30,22
1651036839218,MATH 20C,B02,083763,Staff,28,0,30,2
1651036845241,MATH 20D,A01,083765,Staff,3,1,30,27
1651036845241,MATH 20D,A02,083766,Staff,1,0,30,29
1651036845241,MATH 20D,A03,083767,Staff,22,0,30,8
1651036851370,MATH 20E,A01,083771,Staff,2,0,30,28
1651036851370,MATH 20E,A02,083772,Staff,11,0,30,19
1651036851370,MATH 20E,B01,083773,Staff,0,0,30,30
1651036851370,MATH 20E,B02,083774,Staff,0,0,30,30
1651036857394,MATH 103A,A01,083777,Staff,0,17,30,30
1651036857394,MATH 103A,A02,083778,Staff,0,16,30,30
1651036857394,MATH 103A,B01,083779,Staff,0,15,30,30
1651036857394,MATH 103A,B02,083780,Staff,0,13,30,30
1651036863421,MATH 105,A01,085443,Staff,0,23,30,30
1651036869450,MATH 109,A01,083213,Anzaldo; Leesa B,0,8,30,30
1651036869450,MATH 109,A02,083214,Anzaldo; Leesa B,0,7,30,30
1651036869450,MATH 109,B01,083215,Anzaldo; Leesa B,0,8,30,30
1651036869450,MATH 109,B02,083216,Anzaldo; Leesa B,0,8,30,30
1651036875474,MATH 142A,A01,083219,Chow; Bennett,0,15,30,30
1651036875474,MATH 142A,A02,083220,Chow; Bennett,0,15,30,30
1651036875474,MATH 142A,B01,083221,Chow; Bennett,0,16,30,30
1651036875474,MATH 142A,B02,083222,Chow; Bennett,0,14,30,30
1651036881498,MATH 193A,A01,083224,Staff,0,8,30,30
1651036881498,MATH 193A,A02,083225,Staff,0,7,30,30
1651036881498,MATH 193A,A03,083781,Staff,0,7,30,30
1651036881498,MATH 193A,A04,083782,Staff,0,7,30,30
1651036887522,MATH 197,001,091859,McAuley; Julian John,9998,0,9999,1
1651036893584,COGS 9,A01,083615,Staff,0,19,60,60
1651036899606,COGS 11,A01,083617,Boyle; Mary E. T.,13,0,40,27
1651036905629,COGS 13,A01,083071,Staff,0,40,40,40
1651036911662,COGS 14A,A01,092681,Staff,0,40,100,100
1651036917685,COGS 14B,A01,083073,Cheng; Tzu-Han,0,13,50,50
1651036923711,COGS 17,A01,092677,Staff,9,0,75,66
1651036929740,COGS 100,A01,083619,Staff,0,30,60,60
1651036935766,COGS 101A,A01,083621,Davis; Joshua Daniel,0,29,60,60
1651036941790,COGS 101B,A01,091572,Staff,0,7,60,60
1651036947817,COGS 101C,A01,083625,Delgado; Tania,14,0,30,16
1651036953840,COGS 107A,A01,083627,Boyle; Mary E. T.,0,17,60,60
1651036959863,COGS 118A,A01,083075,Staff,0,10,60,60
1651036965889,CSE 3,A50,083646,Miranda; Gregory Joseph,15,0,38,23
1651036965889,CSE 3,A51,083647,Miranda; Gregory Joseph,36,0,37,1
1651036971917,CSE 8A,A50,083650,Miranda; Gregory Joseph,0,31,40,40
1651036977939,CSE 11,A01,083080,Cao; Yingjun,0,97,40,40
1651036983963,CSE 12,A01,083652,Staff,0,25,100,100
1651036989996,CSE 15L,A01,083654,Staff,1,3,50,49
1651036989996,CSE 15L,A02,083655,Staff,0,3,50,50
1651036996022,CSE 20,A01,083657,Staff,47,0,80,33
1651037002046,CSE 30,A01,083084,Eldon; John,1,39,80,79
1651037008068,CSE 100,A01,083659,Cao; Yingjun,0,72,50,50
1651037014093,CSE 134B,A01,083661,Powell; Thomas Allan,1,39,65,64
1651037020119,CSE 140,A01,083663,Staff,0,14,75,75
1651037026145,CSE 140L,A01,083088,Eldon; John,4,0,100,96
1651037032168,CSE 175,A01,083665,Kumar; Rakesh,0,0,25,25
1651037038192,CSE 190,A00,092507,Dubnov; Shlomo,9,0,20,11
1651037044230,ECE 45,A01,083139,Staff,0,7,60,60
1651037050253,ECE 65,A50,083695,Staff,0,7,30,30
1651037056289,ECE 109,A01,091882,Touri; Behrouz,32,0,70,38
1651037062315,ECE 180,A00,083140,Abi Samra; Nicholas Camill,17,0,30,13
1651037062315,ECE 180,B00,083141,Abi Samra; Nicholas Camill,0,0,30,30
1651037068342,MATH 10A,A01,083735,Patchell; Gregory David,0,0,30,30
1651037068342,MATH 10A,A02,083736,Patchell; Gregory David,27,0,30,3
1651037068342,MATH 10A,A03,083737,Patchell; Gregory David,23,0,30,7
1651037074370,MATH 10B,A01,083207,Staff,0,8,30,30
1651037074370,MATH 10B,A02,083208,Staff,0,7,30,30
1651037074370,MATH 10B,B01,083739,Staff,8,0,30,22
1651037074370,MATH 10B,B02,083740,Staff,28,0,30,2
1651037080396,MATH 18,A01,083743,Staff,0,0,30,30
1651037080396,MATH 18,A02,083744,Staff,23,0,30,7
1651037080396,MATH 18,A03,083745,Staff,19,0,30,11
1651037080396,MATH 18,A04,083746,Staff,26,0,30,4
1651037080396,MATH 18,B01,083748,Staff,0,16,30,30
1651037080396,MATH 18,B02,083749,Staff,0,14,30,30
1651037080396,MATH 18,B03,083750,Staff,0,14,30,30
1651037080396,MATH 18,B04,083751,Staff,0,13,30,30
1651037086420,MATH 20A,A01,083754,Staff,18,0,40,22
1651037092446,MATH 20B,A01,083756,Staff,0,14,30,30
1651037092446,MATH 20B,A02,083757,Staff,0,11,30,30
1651037098472,MATH 20C,A01,083760,Staff,0,16,30,30
1651037098472,MATH 20C,A02,083761,Staff,0,15,30,30
1651037098472,MATH 20C,B01,083762,Staff,8,0,30,22
1651037098472,MATH 20C,B02,083763,Staff,28,0,30,2
1651037104496,MATH 20D,A01,083765,Staff,3,1,30,27
1651037104496,MATH 20D,A02,083766,Staff,1,0,30,29
1651037104496,MATH 20D,A03,083767,Staff,22,0,30,8
1651037110520,MATH 20E,A01,083771,Staff,2,0,30,28
1651037110520,MATH 20E,A02,083772,Staff,11,0,30,19
1651037110520,MATH 20E,B01,083773,Staff,0,0,30,30
1651037110520,MATH 20E,B02,083774,Staff,0,0,30,30
1651037116549,MATH 103A,A01,083777,Staff,0,17,30,30
1651037116549,MATH 103A,A02,083778,Staff,0,16,30,30
1651037116549,MATH 103A,B01,083779,Staff,0,15,30,30
1651037116549,MATH 103A,B02,083780,Staff,0,13,30,30
1651037122573,MATH 105,A01,085443,Staff,0,23,30,30
1651037128597,MATH 109,A01,083213,Anzaldo; Leesa B,0,8,30,30
1651037128597,MATH 109,A02,083214,Anzaldo; Leesa B,0,7,30,30
1651037128597,MATH 109,B01,083215,Anzaldo; Leesa B,0,8,30,30
1651037128597,MATH 109,B02,083216,Anzaldo; Leesa B,0,8,30,30
1651037134628,MATH 142A,A01,083219,Chow; Bennett,0,15,30,30
1651037134628,MATH 142A,A02,083220,Chow; Bennett,0,15,30,30
1651037134628,MATH 142A,B01,083221,Chow; Bennett,0,16,30,30
1651037134628,MATH 142A,B02,083222,Chow; Bennett,0,14,30,30
1651037140651,MATH 193A,A01,083224,Staff,0,8,30,30
1651037140651,MATH 193A,A02,083225,Staff,0,7,30,30
1651037140651,MATH 193A,A03,083781,Staff,0,7,30,30
1651037140651,MATH 193A,A04,083782,Staff,0,7,30,30
1651037146673,MATH 197,001,091859,McAuley; Julian John,9998,0,9999,1
1651037152722,COGS 9,A01,083615,Staff,0,19,60,60
1651037158749,COGS 11,A01,083617,Boyle; Mary E. T.,13,0,40,27
1651037164772,COGS 13,A01,083071,Staff,0,40,40,40
1651037170795,COGS 14A,A01,092681,Staff,0,40,100,100
1651037176818,COGS 14B,A01,083073,Cheng; Tzu-Han,0,13,50,50
1651037182845,COGS 17,A01,092677,Staff,9,0,75,66
1651037188871,COGS 100,A01,083619,Staff,0,30,60,60
1651037194894,COGS 101A,A01,083621,Davis; Joshua Daniel,0,29,60,60
1651037200924,COGS 101B,A01,091572,Staff,0,7,60,60
1651037206947,COGS 101C,A01,083625,Delgado; Tania,14,0,30,16
1651037212971,COGS 107A,A01,083627,Boyle; Mary E. T.,0,17,60,60
1651037218993,COGS 118A,A01,083075,Staff,0,10,60,60
1651037225017,CSE 3,A50,083646,Miranda; Gregory Joseph,15,0,38,23
1651037225017,CSE 3,A51,083647,Miranda; Gregory Joseph,36,0,37,1
1651037231042,CSE 8A,A50,083650,Miranda; Gregory Joseph,0,31,40,40
1651037237065,CSE 11,A01,083080,Cao; Yingjun,0,97,40,40
1651037243090,CSE 12,A01,083652,Staff,0,25,100,100
1651037249116,CSE 15L,A01,083654,Staff,0,2,50,50
1651037249116,CSE 15L,A02,083655,Staff,0,3,50,50
1651037255140,CSE 20,A01,083657,Staff,47,0,80,33
1651037261166,CSE 30,A01,083084,Eldon; John,0,38,80,80
1651037267192,CSE 100,A01,083659,Cao; Yingjun,0,72,50,50
1651037273217,CSE 134B,A01,083661,Powell; Thomas Allan,0,38,65,65
1651037279240,CSE 140,A01,083663,Staff,0,14,75,75
1651037285265,CSE 140L,A01,083088,Eldon; John,4,0,100,96
1651037291288,CSE 175,A01,083665,Kumar; Rakesh,0,0,25,25
1651037297318,CSE 190,A00,092507,Dubnov; Shlomo,9,0,20,11
1651037303344,ECE 45,A01,083139,Staff,0,7,60,60
1651037309366,ECE 65,A50,083695,Staff,0,7,30,30
1651037315389,ECE 109,A01,091882,Touri; Behrouz,32,0,70,38
1651037321411,ECE 180,A00,083140,Abi Samra; Nicholas Camill,17,0,30,13
1651037321411,ECE 180,B00,083141,Abi Samra; Nicholas Camill,0,0,30,30
1651037327432,MATH 10A,A01,083735,Patchell; Gregory David,0,0,30,30
1651037327432,MATH 10A,A02,083736,Patchell; Gregory David,27,0,30,3
1651037327432,MATH 10A,A03,083737,Patchell; Gregory David,23,0,30,7
1651037333459,MATH 10B,A01,083207,Staff,0,8,30,30
1651037333459,MATH 10B,A02,083208,Staff,0,7,30,30
1651037333459,MATH 10B,B01,083739,Staff,8,0,30,22
1651037333459,MATH 10B,B02,083740,Staff,28,0,30,2
1651037339483,MATH 18,A01,083743,Staff,0,0,30,30
1651037339483,MATH 18,A02,083744,Staff,23,0,30,7
1651037339483,MATH 18,A03,083745,Staff,19,0,30,11
1651037339483,MATH 18,A04,083746,Staff,26,0,30,4
1651037339483,MATH 18,B01,083748,Staff,0,16,30,30
1651037339483,MATH 18,B02,083749,Staff,0,14,30,30
1651037339483,MATH 18,B03,083750,Staff,0,14,30,30
1651037339483,MATH 18,B04,083751,Staff,0,13,30,30
1651037345514,MATH 20A,A01,083754,Staff,18,0,40,22
1651037351536,MATH 20B,A01,083756,Staff,0,14,30,30
1651037351536,MATH 20B,A02,083757,Staff,0,11,30,30
1651037357558,MATH 20C,A01,083760,Staff,0,16,30,30
1651037357558,MATH 20C,A02,083761,Staff,0,15,30,30
1651037357558,MATH 20C,B01,083762,Staff,8,0,30,22
1651037357558,MATH 20C,B02,083763,Staff,28,0,30,2
1651037363583,MATH 20D,A01,083765,Staff,3,1,30,27
1651037363583,MATH 20D,A02,083766,Staff,1,0,30,29
1651037363583,MATH 20D,A03,083767,Staff,22,0,30,8
1651037369606,MATH 20E,A01,083771,Staff,2,0,30,28
1651037369606,MATH 20E,A02,083772,Staff,11,0,30,19
1651037369606,MATH 20E,B01,083773,Staff,0,0,30,30
1651037369606,MATH 20E,B02,083774,Staff,0,0,30,30
1651037375630,MATH 103A,A01,083777,Staff,0,17,30,30
1651037375630,MATH 103A,A02,083778,Staff,0,16,30,30
1651037375630,MATH 103A,B01,083779,Staff,0,15,30,30
1651037375630,MATH 103A,B02,083780,Staff,0,13,30,30
1651037381655,MATH 105,A01,085443,Staff,0,23,30,30
1651037387679,MATH 109,A01,083213,Anzaldo; Leesa B,0,8,30,30
1651037387679,MATH 109,A02,083214,Anzaldo; Leesa B,0,7,30,30
1651037387679,MATH 109,B01,083215,Anzaldo; Leesa B,0,8,30,30
1651037387679,MATH 109,B02,083216,Anzaldo; Leesa B,0,8,30,30
1651037393704,MATH 142A,A01,083219,Chow; Bennett,0,15,30,30
1651037393704,MATH 142A,A02,083220,Chow; Bennett,0,15,30,30
1651037393704,MATH 142A,B01,083221,Chow; Bennett,0,16,30,30
1651037393704,MATH 142A,B02,083222,Chow; Bennett,0,14,30,30
1651037399745,MATH 193A,A01,083224,Staff,0,8,30,30
1651037399745,MATH 193A,A02,083225,Staff,0,7,30,30
1651037399745,MATH 193A,A03,083781,Staff,0,7,30,30
1651037399745,MATH 193A,A04,083782,Staff,0,7,30,30
1651037405774,MATH 197,001,091859,McAuley; Julian John,9998,0,9999,1
1651037411825,COGS 9,A01,083615,Staff,0,19,60,60
1651037417852,COGS 11,A01,083617,Boyle; Mary E. T.,13,0,40,27
1651037423878,COGS 13,A01,083071,Staff,0,40,40,40
1651037429902,COGS 14A,A01,092681,Staff,0,40,100,100
1651037435930,COGS 14B,A01,083073,Cheng; Tzu-Han,0,13,50,50
1651037442043,COGS 17,A01,092677,Staff,9,0,75,66
1651037448068,COGS 100,A01,083619,Staff,0,30,60,60
1651037454092,COGS 101A,A01,083621,Davis; Joshua Daniel,0,29,60,60
1651037460116,COGS 101B,A01,091572,Staff,0,7,60,60
1651037466141,COGS 101C,A01,083625,Delgado; Tania,14,0,30,16
1651037472164,COGS 107A,A01,083627,Boyle; Mary E. T.,0,17,60,60
1651037478187,COGS 118A,A01,083075,Staff,0,10,60,60
1651037484211,CSE 3,A50,083646,Miranda; Gregory Joseph,15,0,38,23
1651037484211,CSE 3,A51,083647,Miranda; Gregory Joseph,36,0,37,1
1651037490242,CSE 8A,A50,083650,Miranda; Gregory Joseph,0,31,40,40
1651037496269,CSE 11,A01,083080,Cao; Yingjun,0,97,40,40
1651037502302,CSE 12,A01,083652,Staff,0,25,100,100
1651037508331,CSE 15L,A01,083654,Staff,0,2,50,50
1651037508331,CSE 15L,A02,083655,Staff,0,3,50,50
1651037514356,CSE 20,A01,083657,Staff,47,0,80,33
1651037520383,CSE 30,A01,083084,Eldon; John,0,38,80,80
1651037526408,CSE 100,A01,083659,Cao; Yingjun,0,72,50,50
1651037532432,CSE 134B,A01,083661,Powell; Thomas Allan,0,38,65,65
1651037538460,CSE 140,A01,083663,Staff,0,14,75,75
1651037544486,CSE 140L,A01,083088,Eldon; John,4,0,100,96
1651037550513,CSE 175,A01,083665,Kumar; Rakesh,0,0,25,25
1651037556536,CSE 190,A00,092507,Dubnov; Shlomo,9,0,20,11
1651037562562,ECE 45,A01,083139,Staff,0,7,60,60
1651037568586,ECE 65,A50,083695,Staff,0,7,30,30
1651037574610,ECE 109,A01,091882,Touri; Behrouz,32,0,70,38
1651037580634,ECE 180,A00,083140,Abi Samra; Nicholas Camill,17,0,30,13
1651037580634,ECE 180,B00,083141,Abi Samra; Nicholas Camill,0,0,30,30
1651037586659,MATH 10A,A01,083735,Patchell; Gregory David,0,0,30,30
1651037586659,MATH 10A,A02,083736,Patchell; Gregory David,27,0,30,3
1651037586659,MATH 10A,A03,083737,Patchell; Gregory David,23,0,30,7
1651037592694,MATH 10B,A01,083207,Staff,0,8,30,30
1651037592694,MATH 10B,A02,083208,Staff,0,7,30,30
1651037592694,MATH 10B,B01,083739,Staff,8,0,30,22
1651037592694,MATH 10B,B02,083740,Staff,28,0,30,2
1651037598725,MATH 18,A01,083743,Staff,0,0,30,30
1651037598725,MATH 18,A02,083744,Staff,23,0,30,7
1651037598725,MATH 18,A03,083745,Staff,19,0,30,11
1651037598725,MATH 18,A04,083746,Staff,26,0,30,4
1651037598725,MATH 18,B01,083748,Staff,0,16,30,30
1651037598725,MATH 18,B02,083749,Staff,0,14,30,30
1651037598725,MATH 18,B03,083750,Staff,0,14,30,30
1651037598725,MATH 18,B04,083751,Staff,0,13,30,30
1651037604750,MATH 20A,A01,083754,Staff,18,0,40,22
1651037610780,MATH 20B,A01,083756,Staff,0,14,30,30
1651037610780,MATH 20B,A02,083757,Staff,0,11,30,30
1651037616804,MATH 20C,A01,083760,Staff,0,16,30,30
1651037616804,MATH 20C,A02,083761,Staff,0,15,30,30
1651037616804,MATH 20C,B01,083762,Staff,8,0,30,22
1651037616804,MATH 20C,B02,083763,Staff,28,0,30,2
1651037622828,MATH 20D,A01,083765,Staff,3,1,30,27
1651037622828,MATH 20D,A02,083766,Staff,1,0,30,29
1651037622828,MATH 20D,A03,083767,Staff,22,0,30,8
1651037628852,MATH 20E,A01,083771,Staff,2,0,30,28
1651037628852,MATH 20E,A02,083772,Staff,11,0,30,19
1651037628852,MATH 20E,B01,083773,Staff,0,0,30,30
1651037628852,MATH 20E,B02,083774,Staff,0,0,30,30
1651037634887,MATH 103A,A01,083777,Staff,0,17,30,30
1651037634887,MATH 103A,A02,083778,Staff,0,16,30,30
1651037634887,MATH 103A,B01,083779,Staff,0,15,30,30
1651037634887,MATH 103A,B02,083780,Staff,0,13,30,30
1651037640917,MATH 105,A01,085443,Staff,0,23,30,30
1651037646940,MATH 109,A01,083213,Anzaldo; Leesa B,0,8,30,30
1651037646940,MATH 109,A02,083214,Anzaldo; Leesa B,0,7,30,30
1651037646940,MATH 109,B01,083215,Anzaldo; Leesa B,0,8,30,30
1651037646940,MATH 109,B02,083216,Anzaldo; Leesa B,0,8,30,30
1651037652967,MATH 142A,A01,083219,Chow; Bennett,0,15,30,30
1651037652967,MATH 142A,A02,083220,Chow; Bennett,0,15,30,30
1651037652967,MATH 142A,B01,083221,Chow; Bennett,0,16,30,30
1651037652967,MATH 142A,B02,083222,Chow; Bennett,0,14,30,30
1651037658993,MATH 193A,A01,083224,Staff,0,8,30,30
1651037658993,MATH 193A,A02,083225,Staff,0,7,30,30
1651037658993,MATH 193A,A03,083781,Staff,0,7,30,30
1651037658993,MATH 193A,A04,083782,Staff,0,7,30,30
1651037665017,MATH 197,001,091859,McAuley; Julian John,9998,0,9999,1
1651037671068,COGS 9,A01,083615,Staff,0,19,60,60
1651037677091,COGS 11,A01,083617,Boyle; Mary E. T.,13,0,40,27
1651037683115,COGS 13,A01,083071,Staff,0,40,40,40
1651037689138,COGS 14A,A01,092681,Staff,0,40,100,100
1651037695161,COGS 14B,A01,083073,Cheng; Tzu-Han,0,13,50,50
1651037701187,COGS 17,A01,092677,Staff,9,0,75,66
1651037707213,COGS 100,A01,083619,Staff,0,30,60,60
1651037713236,COGS 101A,A01,083621,Davis; Joshua Daniel,0,29,60,60
1651037719261,COGS 101B,A01,091572,Staff,0,7,60,60
1651037725285,COGS 101C,A01,083625,Delgado; Tania,14,0,30,16
1651037731310,COGS 107A,A01,083627,Boyle; Mary E. T.,0,17,60,60
1651037737333,COGS 118A,A01,083075,Staff,0,10,60,60
1651037743356,CSE 3,A50,083646,Miranda; Gregory Joseph,15,0,38,23
1651037743356,CSE 3,A51,083647,Miranda; Gregory Joseph,36,0,37,1
1651037749380,CSE 8A,A50,083650,Miranda; Gregory Joseph,0,31,40,40
1651037755404,CSE 11,A01,083080,Cao; Yingjun,0,97,40,40
1651037761427,CSE 12,A01,083652,Staff,0,25,100,100
1651037767451,CSE 15L,A01,083654,Staff,0,2,50,50
1651037767451,CSE 15L,A02,083655,Staff,0,3,50,50
1651037773479,CSE 20,A01,083657,Staff,47,0,80,33
1651037779503,CSE 30,A01,083084,Eldon; John,0,38,80,80
1651037785530,CSE 100,A01,083659,Cao; Yingjun,0,72,50,50
1651037791555,CSE 134B,A01,083661,Powell; Thomas Allan,0,38,65,65
1651037797579,CSE 140,A01,083663,Staff,0,14,75,75
1651037803605,CSE 140L,A01,083088,Eldon; John,4,0,100,96
1651037809637,CSE 175,A01,083665,Kumar; Rakesh,0,0,25,25
1651037815662,CSE 190,A00,092507,Dubnov; Shlomo,9,0,20,11
1651037821691,ECE 45,A01,083139,Staff,0,7,60,60
1651037827722,ECE 65,A50,083695,Staff,0,7,30,30
1651037833749,ECE 109,A01,091882,Touri; Behrouz,32,0,70,38
1651037839783,ECE 180,A00,083140,Abi Samra; Nicholas Camill,17,0,30,13
1651037839783,ECE 180,B00,083141,Abi Samra; Nicholas Camill,0,0,30,30
1651037845811,MATH 10A,A01,083735,Patchell; Gregory David,0,0,30,30
1651037845811,MATH 10A,A02,083736,Patchell; Gregory David,27,0,30,3
1651037845811,MATH 10A,A03,083737,Patchell; Gregory David,23,0,30,7
1651037851838,MATH 10B,A01,083207,Staff,0,8,30,30
1651037851838,MATH 10B,A02,083208,Staff,0,7,30,30
1651037851838,MATH 10B,B01,083739,Staff,8,0,30,22
1651037851838,MATH 10B,B02,083740,Staff,28,0,30,2
1651037857867,MATH 18,A01,083743,Staff,0,0,30,30
1651037857867,MATH 18,A02,083744,Staff,23,0,30,7
1651037857867,MATH 18,A03,083745,Staff,19,0,30,11
1651037857867,MATH 18,A04,083746,Staff,26,0,30,4
1651037857867,MATH 18,B01,083748,Staff,0,16,30,30
1651037857867,MATH 18,B02,083749,Staff,0,14,30,30
1651037857867,MATH 18,B03,083750,Staff,0,14,30,30
1651037857867,MATH 18,B04,083751,Staff,0,13,30,30
1651037863890,MATH 20A,A01,083754,Staff,18,0,40,22
1651037869917,MATH 20B,A01,083756,Staff,0,14,30,30
1651037869917,MATH 20B,A02,083757,Staff,0,11,30,30
1651037875940,MATH 20C,A01,083760,Staff,0,16,30,30
1651037875940,MATH 20C,A02,083761,Staff,0,15,30,30
1651037875940,MATH 20C,B01,083762,Staff,8,0,30,22
1651037875940,MATH 20C,B02,083763,Staff,28,0,30,2
1651037881975,MATH 20D,A01,083765,Staff,3,1,30,27
1651037881975,MATH 20D,A02,083766,Staff,1,0,30,29
1651037881975,MATH 20D,A03,083767,Staff,22,0,30,8
1651037888002,MATH 20E,A01,083771,Staff,2,0,30,28
1651037888002,MATH 20E,A02,083772,Staff,11,0,30,19
1651037888002,MATH 20E,B01,083773,Staff,0,0,30,30
1651037888002,MATH 20E,B02,083774,Staff,0,0,30,30
1651037894032,MATH 103A,A01,083777,Staff,0,17,30,30
1651037894032,MATH 103A,A02,083778,Staff,0,16,30,30
1651037894032,MATH 103A,B01,083779,Staff,0,15,30,30
1651037894032,MATH 103A,B02,083780,Staff,0,13,30,30
1651037900059,MATH 105,A01,085443,Staff,0,23,30,30
1651037906082,MATH 109,A01,083213,Anzaldo; Leesa B,0,8,30,30
1651037906082,MATH 109,A02,083214,Anzaldo; Leesa B,0,7,30,30
1651037906082,MATH 109,B01,083215,Anzaldo; Leesa B,0,8,30,30
1651037906082,MATH 109,B02,083216,Anzaldo; Leesa B,0,8,30,30
1651037912109,MATH 142A,A01,083219,Chow; Bennett,0,15,30,30
1651037912109,MATH 142A,A02,083220,Chow; Bennett,0,15,30,30
1651037912109,MATH 142A,B01,083221,Chow; Bennett,0,16,30,30
1651037912109,MATH 142A,B02,083222,Chow; Bennett,0,14,30,30
1651037918132,MATH 193A,A01,083224,Staff,0,8,30,30
1651037918132,MATH 193A,A02,083225,Staff,0,7,30,30
1651037918132,MATH 193A,A03,083781,Staff,0,7,30,30
1651037918132,MATH 193A,A04,083782,Staff,0,7,30,30
1651037924156,MATH 197,001,091859,McAuley; Julian John,9998,0,9999,1
1651037930214,COGS 9,A01,083615,Staff,0,19,60,60
1651037936242,COGS 11,A01,083617,Boyle; Mary E. T.,13,0,40,27
1651037942271,COGS 13,A01,083071,Staff,0,40,40,40
1651037948297,COGS 14A,A01,092681,Staff,0,40,100,100
1651037954324,COGS 14B,A01,083073,Cheng; Tzu-Han,0,13,50,50
1651037960346,COGS 17,A01,092677,Staff,9,0,75,66
1651037966373,COGS 100,A01,083619,Staff,0,30,60,60
1651037972398,COGS 101A,A01,083621,Davis; Joshua Daniel,0,29,60,60
1651037978426,COGS 101B,A01,091572,Staff,0,7,60,60
1651037984450,COGS 101C,A01,083625,Delgado; Tania,14,0,30,16
1651037990490,COGS 107A,A01,083627,Boyle; Mary E. T.,0,17,60,60
1651037996527,COGS 118A,A01,083075,Staff,0,10,60,60
1651038002554,CSE 3,A50,083646,Miranda; Gregory Joseph,15,0,38,23
1651038002554,CSE 3,A51,083647,Miranda; Gregory Joseph,36,0,37,1
1651038008576,CSE 8A,A50,083650,Miranda; Gregory Joseph,0,31,40,40
1651038014604,CSE 11,A01,083080,Cao; Yingjun,0,97,40,40
1651038020629,CSE 12,A01,083652,Staff,0,25,100,100
1651038026652,CSE 15L,A01,083654,Staff,0,2,50,50
1651038026652,CSE 15L,A02,083655,Staff,0,3,50,50
1651038032675,CSE 20,A01,083657,Staff,47,0,80,33
1651038038797,CSE 30,A01,083084,Eldon; John,0,38,80,80
1651038044828,CSE 100,A01,083659,Cao; Yingjun,0,72,50,50
1651038050854,CSE 134B,A01,083661,Powell; Thomas Allan,0,38,65,65
1651038056877,CSE 140,A01,083663,Staff,0,14,75,75
1651038062901,CSE 140L,A01,083088,Eldon; John,4,0,100,96
1651038068927,CSE 175,A01,083665,Kumar; Rakesh,0,0,25,25
1651038074953,CSE 190,A00,092507,Dubnov; Shlomo,9,0,20,11
1651038080975,ECE 45,A01,083139,Staff,0,7,60,60
1651038086998,ECE 65,A50,083695,Staff,0,7,30,30
1651038093032,ECE 109,A01,091882,Touri; Behrouz,32,0,70,38
1651038099056,ECE 180,A00,083140,Abi Samra; Nicholas Camill,17,0,30,13
1651038099056,ECE 180,B00,083141,Abi Samra; Nicholas Camill,0,0,30,30
1651038105082,MATH 10A,A01,083735,Patchell; Gregory David,0,0,30,30
1651038105082,MATH 10A,A02,083736,Patchell; Gregory David,27,0,30,3
1651038105082,MATH 10A,A03,083737,Patchell; Gregory David,23,0,30,7
1651038111118,MATH 10B,A01,083207,Staff,0,8,30,30
1651038111118,MATH 10B,A02,083208,Staff,0,7,30,30
1651038111118,MATH 10B,B01,083739,Staff,8,0,30,22
1651038111118,MATH 10B,B02,083740,Staff,28,0,30,2
1651038117141,MATH 18,A01,083743,Staff,0,0,30,30
1651038117141,MATH 18,A02,083744,Staff,23,0,30,7
1651038117141,MATH 18,A03,083745,Staff,19,0,30,11
1651038117141,MATH 18,A04,083746,Staff,26,0,30,4
1651038117141,MATH 18,B01,083748,Staff,0,16,30,30
1651038117141,MATH 18,B02,083749,Staff,0,14,30,30
1651038117141,MATH 18,B03,083750,Staff,0,14,30,30
1651038117141,MATH 18,B04,083751,Staff,0,13,30,30
1651038123165,MATH 20A,A01,083754,Staff,18,0,40,22
1651038129194,MATH 20B,A01,083756,Staff,0,14,30,30
1651038129194,MATH 20B,A02,083757,Staff,0,11,30,30
1651038135217,MATH 20C,A01,083760,Staff,0,16,30,30
1651038135217,MATH 20C,A02,083761,Staff,0,15,30,30
1651038135217,MATH 20C,B01,083762,Staff,8,0,30,22
1651038135217,MATH 20C,B02,083763,Staff,28,0,30,2
1651038141241,MATH 20D,A01,083765,Staff,3,1,30,27
1651038141241,MATH 20D,A02,083766,Staff,1,0,30,29
1651038141241,MATH 20D,A03,083767,Staff,22,0,30,8
1651038147268,MATH 20E,A01,083771,Staff,2,0,30,28
1651038147268,MATH 20E,A02,083772,Staff,11,0,30,19
1651038147268,MATH 20E,B01,083773,Staff,0,0,30,30
1651038147268,MATH 20E,B02,083774,Staff,0,0,30,30
1651038153296,MATH 103A,A01,083777,Staff,0,17,30,30
1651038153296,MATH 103A,A02,083778,Staff,0,16,30,30
1651038153296,MATH 103A,B01,083779,Staff,0,15,30,30
1651038153296,MATH 103A,B02,083780,Staff,0,13,30,30
1651038159319,MATH 105,A01,085443,Staff,0,23,30,30
1651038165343,MATH 109,A01,083213,Anzaldo; Leesa B,0,8,30,30
1651038165343,MATH 109,A02,083214,Anzaldo; Leesa B,0,7,30,30
1651038165343,MATH 109,B01,083215,Anzaldo; Leesa B,0,8,30,30
1651038165343,MATH 109,B02,083216,Anzaldo; Leesa B,0,8,30,30
1651038171379,MATH 142A,A01,083219,Chow; Bennett,0,15,30,30
1651038171379,MATH 142A,A02,083220,Chow; Bennett,0,15,30,30
1651038171379,MATH 142A,B01,083221,Chow; Bennett,0,16,30,30
1651038171379,MATH 142A,B02,083222,Chow; Bennett,0,14,30,30
1651038177403,MATH 193A,A01,083224,Staff,0,8,30,30
1651038177403,MATH 193A,A02,083225,Staff,0,7,30,30
1651038177403,MATH 193A,A03,083781,Staff,0,7,30,30
1651038177403,MATH 193A,A04,083782,Staff,0,7,30,30
1651038183424,MATH 197,001,091859,McAuley; Julian John,9998,0,9999,1
1651038189481,COGS 9,A01,083615,Staff,0,19,60,60
1651038195507,COGS 11,A01,083617,Boyle; Mary E. T.,13,0,40,27
1651038201536,COGS 13,A01,083071,Staff,0,40,40,40
1651038207558,COGS 14A,A01,092681,Staff,0,40,100,100
1651038213595,COGS 14B,A01,083073,Cheng; Tzu-Han,0,13,50,50
1651038219618,COGS 17,A01,092677,Staff,9,0,75,66
1651038225641,COGS 100,A01,083619,Staff,0,30,60,60
1651038231664,COGS 101A,A01,083621,Davis; Joshua Daniel,0,29,60,60
1651038237703,COGS 101B,A01,091572,Staff,0,7,60,60
1651038243735,COGS 101C,A01,083625,Delgado; Tania,14,0,30,16
1651038249760,COGS 107A,A01,083627,Boyle; Mary E. T.,0,17,60,60
1651038255782,COGS 118A,A01,083075,Staff,0,10,60,60
1651038261806,CSE 3,A50,083646,Miranda; Gregory Joseph,15,0,38,23
1651038261806,CSE 3,A51,083647,Miranda; Gregory Joseph,36,0,37,1
1651038267831,CSE 8A,A50,083650,Miranda; Gregory Joseph,0,31,40,40
1651038273856,CSE 11,A01,083080,Cao; Yingjun,0,97,40,40
1651038279890,CSE 12,A01,083652,Staff,0,25,100,100
1651038285927,CSE 15L,A01,083654,Staff,0,2,50,50
1651038285927,CSE 15L,A02,083655,Staff,0,3,50,50
1651038291950,CSE 20,A01,083657,Staff,47,0,80,33
1651038297975,CSE 30,A01,083084,Eldon; John,0,38,80,80
1651038304004,CSE 100,A01,083659,Cao; Yingjun,0,72,50,50
1651038310035,CSE 134B,A01,083661,Powell; Thomas Allan,0,38,65,65
1651038316062,CSE 140,A01,083663,Staff,0,14,75,75
1651038322088,CSE 140L,A01,083088,Eldon; John,4,0,100,96
1651038328115,CSE 175,A01,083665,Kumar; Rakesh,0,0,25,25
1651038334146,CSE 190,A00,092507,Dubnov; Shlomo,9,0,20,11
1651038340169,ECE 45,A01,083139,Staff,0,7,60,60
1651038346193,ECE 65,A50,083695,Staff,0,7,30,30
1651038352217,ECE 109,A01,091882,Touri; Behrouz,32,0,70,38
1651038358257,ECE 180,A00,083140,Abi Samra; Nicholas Camill,17,0,30,13
1651038358257,ECE 180,B00,083141,Abi Samra; Nicholas Camill,0,0,30,30
1651038364297,MATH 10A,A01,083735,Patchell; Gregory David,0,0,30,30
1651038364297,MATH 10A,A02,083736,Patchell; Gregory David,27,0,30,3
1651038364297,MATH 10A,A03,083737,Patchell; Gregory David,23,0,30,7
1651038370324,MATH 10B,A01,083207,Staff,0,8,30,30
1651038370324,MATH 10B,A02,083208,Staff,0,6,30,30
1651038370324,MATH 10B,B01,083739,Staff,8,0,30,22
1651038370324,MATH 10B,B02,083740,Staff,28,0,30,2
1651038376355,MATH 18,A01,083743,Staff,0,0,30,30
1651038376355,MATH 18,A02,083744,Staff,23,0,30,7
1651038376355,MATH 18,A03,083745,Staff,19,0,30,11
1651038376355,MATH 18,A04,083746,Staff,26,0,30,4
1651038376355,MATH 18,B01,083748,Staff,0,16,30,30
1651038376355,MATH 18,B02,083749,Staff,0,14,30,30
1651038376355,MATH 18,B03,083750,Staff,0,14,30,30
1651038376355,MATH 18,B04,083751,Staff,0,13,30,30
1651038382378,MATH 20A,A01,083754,Staff,18,0,40,22
1651038388404,MATH 20B,A01,083756,Staff,0,14,30,30
1651038388404,MATH 20B,A02,083757,Staff,0,11,30,30
1651038394431,MATH 20C,A01,083760,Staff,0,16,30,30
1651038394431,MATH 20C,A02,083761,Staff,0,15,30,30
1651038394431,MATH 20C,B01,083762,Staff,8,0,30,22
1651038394431,MATH 20C,B02,083763,Staff,28,0,30,2
1651038400455,MATH 20D,A01,083765,Staff,3,1,30,27
1651038400455,MATH 20D,A02,083766,Staff,1,0,30,29
1651038400455,MATH 20D,A03,083767,Staff,22,0,30,8
1651038406481,MATH 20E,A01,083771,Staff,2,0,30,28
1651038406481,MATH 20E,A02,083772,Staff,11,0,30,19
1651038406481,MATH 20E,B01,083773,Staff,0,0,30,30
1651038406481,MATH 20E,B02,083774,Staff,0,0,30,30
1651038412509,MATH 103A,A01,083777,Staff,0,17,30,30
1651038412509,MATH 103A,A02,083778,Staff,0,16,30,30
1651038412509,MATH 103A,B01,083779,Staff,0,15,30,30
1651038412509,MATH 103A,B02,083780,Staff,0,13,30,30
1651038418539,MATH 105,A01,085443,Staff,0,23,30,30
1651038424563,MATH 109,A01,083213,Anzaldo; Leesa B,0,8,30,30
1651038424563,MATH 109,A02,083214,Anzaldo; Leesa B,0,7,30,30
1651038424563,MATH 109,B01,083215,Anzaldo; Leesa B,0,8,30,30
1651038424563,MATH 109,B02,083216,Anzaldo; Leesa B,0,8,30,30
1651038430591,MATH 142A,A01,083219,Chow; Bennett,0,15,30,30
1651038430591,MATH 142A,A02,083220,Chow; Bennett,0,15,30,30
1651038430591,MATH 142A,B01,083221,Chow; Bennett,0,16,30,30
1651038430591,MATH 142A,B02,083222,Chow; Bennett,0,14,30,30
1651038436620,MATH 193A,A01,083224,Staff,0,8,30,30
1651038436620,MATH 193A,A02,083225,Staff,0,7,30,30
1651038436620,MATH 193A,A03,083781,Staff,0,7,30,30
1651038436620,MATH 193A,A04,083782,Staff,0,7,30,30
1651038442643,MATH 197,001,091859,McAuley; Julian John,9998,0,9999,1
1651038448702,COGS 9,A01,083615,Staff,0,19,60,60
1651038454726,COGS 11,A01,083617,Boyle; Mary E. T.,13,0,40,27
1651038460749,COGS 13,A01,083071,Staff,0,40,40,40
1651038466773,COGS 14A,A01,092681,Staff,0,40,100,100
1651038472805,COGS 14B,A01,083073,Cheng; Tzu-Han,0,13,50,50
1651038478829,COGS 17,A01,092677,Staff,9,0,75,66
1651038484856,COGS 100,A01,083619,Staff,0,30,60,60
1651038490880,COGS 101A,A01,083621,Davis; Joshua Daniel,0,29,60,60
1651038496907,COGS 101B,A01,091572,Staff,0,7,60,60
1651038502939,COGS 101C,A01,083625,Delgado; Tania,14,0,30,16
1651038508962,COGS 107A,A01,083627,Boyle; Mary E. T.,0,17,60,60
1651038514986,COGS 118A,A01,083075,Staff,0,10,60,60
1651038521010,CSE 3,A50,083646,Miranda; Gregory Joseph,15,0,38,23
1651038521010,CSE 3,A51,083647,Miranda; Gregory Joseph,36,0,37,1
1651038527038,CSE 8A,A50,083650,Miranda; Gregory Joseph,0,31,40,40
1651038533061,CSE 11,A01,083080,Cao; Yingjun,0,97,40,40
1651038539087,CSE 12,A01,083652,Staff,0,25,100,100
1651038545113,CSE 15L,A01,083654,Staff,0,2,50,50
1651038545113,CSE 15L,A02,083655,Staff,0,3,50,50
1651038551146,CSE 20,A01,083657,Staff,47,0,80,33
1651038557173,CSE 30,A01,083084,Eldon; John,0,38,80,80
1651038563198,CSE 100,A01,083659,Cao; Yingjun,0,72,50,50
1651038569222,CSE 134B,A01,083661,Powell; Thomas Allan,0,38,65,65
1651038575246,CSE 140,A01,083663,Staff,0,14,75,75
1651038581271,CSE 140L,A01,083088,Eldon; John,4,0,100,96
1651038587295,CSE 175,A01,083665,Kumar; Rakesh,0,0,25,25
1651038593325,CSE 190,A00,092507,Dubnov; Shlomo,9,0,20,11
1651038599350,ECE 45,A01,083139,Staff,0,7,60,60
1651038614874,ECE 65,A50,083695,Staff,0,7,30,30
1651038620896,ECE 109,A01,091882,Touri; Behrouz,33,0,70,37
1651038626922,ECE 180,A00,083140,Abi Samra; Nicholas Camill,17,0,30,13
1651038626922,ECE 180,B00,083141,Abi Samra; Nicholas Camill,0,0,30,30
1651038632949,MATH 10A,A01,083735,Patchell; Gregory David,0,0,30,30
1651038632949,MATH 10A,A02,083736,Patchell; Gregory David,27,0,30,3
1651038632949,MATH 10A,A03,083737,Patchell; Gregory David,23,0,30,7
1651038638976,MATH 10B,A01,083207,Staff,0,8,30,30
1651038638976,MATH 10B,A02,083208,Staff,0,6,30,30
1651038638976,MATH 10B,B01,083739,Staff,8,0,30,22
1651038638976,MATH 10B,B02,083740,Staff,28,0,30,2
1651038645088,MATH 18,A01,083743,Staff,0,0,30,30
1651038645088,MATH 18,A02,083744,Staff,23,0,30,7
1651038645088,MATH 18,A03,083745,Staff,19,0,30,11
1651038645088,MATH 18,A04,083746,Staff,26,0,30,4
1651038645088,MATH 18,B01,083748,Staff,0,16,30,30
1651038645088,MATH 18,B02,083749,Staff,0,14,30,30
1651038645088,MATH 18,B03,083750,Staff,0,14,30,30
1651038645088,MATH 18,B04,083751,Staff,0,13,30,30
1651038651113,MATH 20A,A01,083754,Staff,18,0,40,22
1651038657147,MATH 20B,A01,083756,Staff,0,14,30,30
1651038657147,MATH 20B,A02,083757,Staff,0,11,30,30
1651038663171,MATH 20C,A01,083760,Staff,0,16,30,30
1651038663171,MATH 20C,A02,083761,Staff,0,15,30,30
1651038663171,MATH 20C,B01,083762,Staff,8,0,30,22
1651038663171,MATH 20C,B02,083763,Staff,28,0,30,2
1651038669193,MATH 20D,A01,083765,Staff,3,1,30,27
1651038669193,MATH 20D,A02,083766,Staff,1,0,30,29
1651038669193,MATH 20D,A03,083767,Staff,22,0,30,8
1651038675220,MATH 20E,A01,083771,Staff,2,0,30,28
1651038675220,MATH 20E,A02,083772,Staff,11,0,30,19
1651038675220,MATH 20E,B01,083773,Staff,0,0,30,30
1651038675220,MATH 20E,B02,083774,Staff,0,0,30,30
1651038681244,MATH 103A,A01,083777,Staff,0,17,30,30
1651038681244,MATH 103A,A02,083778,Staff,0,16,30,30
1651038681244,MATH 103A,B01,083779,Staff,0,15,30,30
1651038681244,MATH 103A,B02,083780,Staff,0,13,30,30
1651038687273,MATH 105,A01,085443,Staff,0,23,30,30
1651038693301,MATH 109,A01,083213,Anzaldo; Leesa B,0,8,30,30
1651038693301,MATH 109,A02,083214,Anzaldo; Leesa B,0,7,30,30
1651038693301,MATH 109,B01,083215,Anzaldo; Leesa B,0,8,30,30
1651038693301,MATH 109,B02,083216,Anzaldo; Leesa B,0,8,30,30
1651038699326,MATH 142A,A01,083219,Chow; Bennett,0,15,30,30
1651038699326,MATH 142A,A02,083220,Chow; Bennett,0,15,30,30
1651038699326,MATH 142A,B01,083221,Chow; Bennett,0,16,30,30
1651038699326,MATH 142A,B02,083222,Chow; Bennett,0,14,30,30
1651038705351,MATH 193A,A01,083224,Staff,0,8,30,30
1651038705351,MATH 193A,A02,083225,Staff,0,7,30,30
1651038705351,MATH 193A,A03,083781,Staff,0,7,30,30
1651038705351,MATH 193A,A04,083782,Staff,0,7,30,30
1651038711374,MATH 197,001,091859,McAuley; Julian John,9998,0,9999,1
1651038717424,COGS 9,A01,083615,Staff,0,19,60,60
1651038723448,COGS 11,A01,083617,Boyle; Mary E. T.,13,0,40,27
1651038729474,COGS 13,A01,083071,Staff,0,40,40,40
1651038735500,COGS 14A,A01,092681,Staff,0,40,100,100
1651038741534,COGS 14B,A01,083073,Cheng; Tzu-Han,0,13,50,50
1651038747557,COGS 17,A01,092677,Staff,9,0,75,66
1651038753583,COGS 100,A01,083619,Staff,0,30,60,60
1651038759607,COGS 101A,A01,083621,Davis; Joshua Daniel,0,29,60,60
1651038765630,COGS 101B,A01,091572,Staff,0,7,60,60
1651038771653,COGS 101C,A01,083625,Delgado; Tania,14,0,30,16
1651038777694,COGS 107A,A01,083627,Boyle; Mary E. T.,0,17,60,60
1651038783718,COGS 118A,A01,083075,Staff,0,10,60,60
1651038789741,CSE 3,A50,083646,Miranda; Gregory Joseph,15,0,38,23
1651038789741,CSE 3,A51,083647,Miranda; Gregory Joseph,36,0,37,1
1651038795767,CSE 8A,A50,083650,Miranda; Gregory Joseph,0,31,40,40
1651038801794,CSE 11,A01,083080,Cao; Yingjun,0,97,40,40
1651038807828,CSE 12,A01,083652,Staff,0,25,100,100
1651038813852,CSE 15L,A01,083654,Staff,0,2,50,50
1651038813852,CSE 15L,A02,083655,Staff,0,3,50,50
1651038819878,CSE 20,A01,083657,Staff,47,0,80,33
1651038825908,CSE 30,A01,083084,Eldon; John,0,38,80,80
1651038831935,CSE 100,A01,083659,Cao; Yingjun,0,72,50,50
1651038837959,CSE 134B,A01,083661,Powell; Thomas Allan,0,38,65,65
1651038843985,CSE 140,A01,083663,Staff,0,14,75,75
1651038850009,CSE 140L,A01,083088,Eldon; John,4,0,100,96
1651038856036,CSE 175,A01,083665,Kumar; Rakesh,0,0,25,25
1651038862060,CSE 190,A00,092507,Dubnov; Shlomo,9,0,20,11
1651038868084,ECE 45,A01,083139,Staff,0,7,60,60
1651038874108,ECE 65,A50,083695,Staff,0,7,30,30
1651038880137,ECE 109,A01,091882,Touri; Behrouz,33,0,70,37
1651038886163,ECE 180,A00,083140,Abi Samra; Nicholas Camill,17,0,30,13
1651038886163,ECE 180,B00,083141,Abi Samra; Nicholas Camill,0,0,30,30
1651038892191,MATH 10A,A01,083735,Patchell; Gregory David,0,0,30,30
1651038892191,MATH 10A,A02,083736,Patchell; Gregory David,27,0,30,3
1651038892191,MATH 10A,A03,083737,Patchell; Gregory David,23,0,30,7
1651038898215,MATH 10B,A01,083207,Staff,0,8,30,30
1651038898215,MATH 10B,A02,083208,Staff,0,6,30,30
1651038898215,MATH 10B,B01,083739,Staff,8,0,30,22
1651038898215,MATH 10B,B02,083740,Staff,28,0,30,2
1651038904239,MATH 18,A01,083743,Staff,0,0,30,30
1651038904239,MATH 18,A02,083744,Staff,23,0,30,7
1651038904239,MATH 18,A03,083745,Staff,19,0,30,11
1651038904239,MATH 18,A04,083746,Staff,26,0,30,4
1651038904239,MATH 18,B01,083748,Staff,0,16,30,30
1651038904239,MATH 18,B02,083749,Staff,0,14,30,30
1651038904239,MATH 18,B03,083750,Staff,0,14,30,30
1651038904239,MATH 18,B04,083751,Staff,0,13,30,30
1651038910266,MATH 20A,A01,083754,Staff,18,0,40,22
1651038916289,MATH 20B,A01,083756,Staff,0,14,30,30
1651038916289,MATH 20B,A02,083757,Staff,0,11,30,30
1651038922311,MATH 20C,A01,083760,Staff,0,16,30,30
1651038922311,MATH 20C,A02,083761,Staff,0,15,30,30
1651038922311,MATH 20C,B01,083762,Staff,8,0,30,22
1651038922311,MATH 20C,B02,083763,Staff,28,0,30,2
1651038928339,MATH 20D,A01,083765,Staff,3,1,30,27
1651038928339,MATH 20D,A02,083766,Staff,1,0,30,29
1651038928339,MATH 20D,A03,083767,Staff,22,0,30,8
1651038934363,MATH 20E,A01,083771,Staff,2,0,30,28
1651038934363,MATH 20E,A02,083772,Staff,11,0,30,19
1651038934363,MATH 20E,B01,083773,Staff,0,0,30,30
1651038934363,MATH 20E,B02,083774,Staff,0,0,30,30
1651038940390,MATH 103A,A01,083777,Staff,0,17,30,30
1651038940390,MATH 103A,A02,083778,Staff,0,16,30,30
1651038940390,MATH 103A,B01,083779,Staff,0,15,30,30
1651038940390,MATH 103A,B02,083780,Staff,0,13,30,30
1651038946416,MATH 105,A01,085443,Staff,0,23,30,30
1651038952448,MATH 109,A01,083213,Anzaldo; Leesa B,0,8,30,30
1651038952448,MATH 109,A02,083214,Anzaldo; Leesa B,0,7,30,30
1651038952448,MATH 109,B01,083215,Anzaldo; Leesa B,0,8,30,30
1651038952448,MATH 109,B02,083216,Anzaldo; Leesa B,0,8,30,30
1651038958472,MATH 142A,A01,083219,Chow; Bennett,0,15,30,30
1651038958472,MATH 142A,A02,083220,Chow; Bennett,0,15,30,30
1651038958472,MATH 142A,B01,083221,Chow; Bennett,0,16,30,30
1651038958472,MATH 142A,B02,083222,Chow; Bennett,0,14,30,30
1651038964496,MATH 193A,A01,083224,Staff,0,8,30,30
1651038964496,MATH 193A,A02,083225,Staff,0,7,30,30
1651038964496,MATH 193A,A03,083781,Staff,0,7,30,30
1651038964496,MATH 193A,A04,083782,Staff,0,7,30,30
1651038970519,MATH 197,001,091859,McAuley; Julian John,9998,0,9999,1
1651038976574,COGS 9,A01,083615,Staff,0,20,60,60
1651038982598,COGS 11,A01,083617,Boyle; Mary E. T.,13,0,40,27
1651038988620,COGS 13,A01,083071,Staff,0,40,40,40
1651038994649,COGS 14A,A01,092681,Staff,0,40,100,100
1651039000672,COGS 14B,A01,083073,Cheng; Tzu-Han,0,13,50,50
1651039006696,COGS 17,A01,092677,Staff,9,0,75,66
1651039012723,COGS 100,A01,083619,Staff,0,30,60,60
1651039018759,COGS 101A,A01,083621,Davis; Joshua Daniel,0,29,60,60
1651039024785,COGS 101B,A01,091572,Staff,0,7,60,60
1651039030809,COGS 101C,A01,083625,Delgado; Tania,14,0,30,16
1651039036834,COGS 107A,A01,083627,Boyle; Mary E. T.,0,17,60,60
1651039042859,COGS 118A,A01,083075,Staff,0,10,60,60
1651039048883,CSE 3,A50,083646,Miranda; Gregory Joseph,15,0,38,23
1651039048883,CSE 3,A51,083647,Miranda; Gregory Joseph,36,0,37,1
1651039054907,CSE 8A,A50,083650,Miranda; Gregory Joseph,0,31,40,40
1651039060934,CSE 11,A01,083080,Cao; Yingjun,0,97,40,40
1651039066958,CSE 12,A01,083652,Staff,0,25,100,100
1651039072986,CSE 15L,A01,083654,Staff,0,2,50,50
1651039072986,CSE 15L,A02,083655,Staff,0,3,50,50
1651039079012,CSE 20,A01,083657,Staff,47,0,80,33
1651039085048,CSE 30,A01,083084,Eldon; John,0,38,80,80
1651039091076,CSE 100,A01,083659,Cao; Yingjun,0,72,50,50
1651039097112,CSE 134B,A01,083661,Powell; Thomas Allan,0,38,65,65
1651039103135,CSE 140,A01,083663,Staff,0,14,75,75
1651039109158,CSE 140L,A01,083088,Eldon; John,4,0,100,96
1651039115182,CSE 175,A01,083665,Kumar; Rakesh,0,0,25,25
1651039121208,CSE 190,A00,092507,Dubnov; Shlomo,9,0,20,11
1651039127234,ECE 45,A01,083139,Staff,0,7,60,60
1651039133261,ECE 65,A50,083695,Staff,0,7,30,30
1651039139284,ECE 109,A01,091882,Touri; Behrouz,33,0,70,37
1651039145308,ECE 180,A00,083140,Abi Samra; Nicholas Camill,17,0,30,13
1651039145308,ECE 180,B00,083141,Abi Samra; Nicholas Camill,0,0,30,30
1651039151333,MATH 10A,A01,083735,Patchell; Gregory David,0,0,30,30
1651039151333,MATH 10A,A02,083736,Patchell; Gregory David,27,0,30,3
1651039151333,MATH 10A,A03,083737,Patchell; Gregory David,23,0,30,7
1651039157358,MATH 10B,A01,083207,Staff,0,8,30,30
1651039157358,MATH 10B,A02,083208,Staff,0,6,30,30
1651039157358,MATH 10B,B01,083739,Staff,8,0,30,22
1651039157358,MATH 10B,B02,083740,Staff,28,0,30,2
1651039163394,MATH 18,A01,083743,Staff,0,0,30,30
1651039163394,MATH 18,A02,083744,Staff,23,0,30,7
1651039163394,MATH 18,A03,083745,Staff,19,0,30,11
1651039163394,MATH 18,A04,083746,Staff,26,0,30,4
1651039163394,MATH 18,B01,083748,Staff,0,16,30,30
1651039163394,MATH 18,B02,083749,Staff,0,14,30,30
1651039163394,MATH 18,B03,083750,Staff,0,14,30,30
1651039163394,MATH 18,B04,083751,Staff,0,13,30,30
1651039169416,MATH 20A,A01,083754,Staff,18,0,40,22
1651039175440,MATH 20B,A01,083756,Staff,0,14,30,30
1651039175440,MATH 20B,A02,083757,Staff,0,11,30,30
1651039181465,MATH 20C,A01,083760,Staff,0,16,30,30
1651039181465,MATH 20C,A02,083761,Staff,0,15,30,30
1651039181465,MATH 20C,B01,083762,Staff,8,0,30,22
1651039181465,MATH 20C,B02,083763,Staff,28,0,30,2
1651039187490,MATH 20D,A01,083765,Staff,3,1,30,27
1651039187490,MATH 20D,A02,083766,Staff,1,0,30,29
1651039187490,MATH 20D,A03,083767,Staff,22,0,30,8
1651039193512,MATH 20E,A01,083771,Staff,2,0,30,28
1651039193512,MATH 20E,A02,083772,Staff,11,0,30,19
1651039193512,MATH 20E,B01,083773,Staff,0,0,30,30
1651039193512,MATH 20E,B02,083774,Staff,0,0,30,30
1651039199533,MATH 103A,A01,083777,Staff,0,17,30,30
1651039199533,MATH 103A,A02,083778,Staff,0,16,30,30
1651039199533,MATH 103A,B01,083779,Staff,0,15,30,30
1651039199533,MATH 103A,B02,083780,Staff,0,13,30,30
1651039205556,MATH 105,A01,085443,Staff,0,23,30,30
1651039211578,MATH 109,A01,083213,Anzaldo; Leesa B,0,8,30,30
1651039211578,MATH 109,A02,083214,Anzaldo; Leesa B,0,7,30,30
1651039211578,MATH 109,B01,083215,Anzaldo; Leesa B,0,8,30,30
1651039211578,MATH 109,B02,083216,Anzaldo; Leesa B,0,8,30,30
1651039217606,MATH 142A,A01,083219,Chow; Bennett,0,15,30,30
1651039217606,MATH 142A,A02,083220,Chow; Bennett,0,15,30,30
1651039217606,MATH 142A,B01,083221,Chow; Bennett,0,16,30,30
1651039217606,MATH 142A,B02,083222,Chow; Bennett,0,14,30,30
1651039223633,MATH 193A,A01,083224,Staff,0,8,30,30
1651039223633,MATH 193A,A02,083225,Staff,0,7,30,30
1651039223633,MATH 193A,A03,083781,Staff,0,7,30,30
1651039223633,MATH 193A,A04,083782,Staff,0,7,30,30
1651039229694,MATH 197,001,091859,McAuley; Julian John,9998,0,9999,1
1651039235840,COGS 9,A01,083615,Staff,0,20,60,60
1651039241863,COGS 11,A01,083617,Boyle; Mary E. T.,13,0,40,27
1651039247888,COGS 13,A01,083071,Staff,0,40,40,40
1651039253911,COGS 14A,A01,092681,Staff,0,40,100,100
1651039259935,COGS 14B,A01,083073,Cheng; Tzu-Han,0,13,50,50
1651039265959,COGS 17,A01,092677,Staff,9,0,75,66
1651039271983,COGS 100,A01,083619,Staff,0,30,60,60
1651039278009,COGS 101A,A01,083621,Davis; Joshua Daniel,0,29,60,60
1651039284033,COGS 101B,A01,091572,Staff,0,7,60,60
1651039290058,COGS 101C,A01,083625,Delgado; Tania,14,0,30,16
1651039296081,COGS 107A,A01,083627,Boyle; Mary E. T.,0,17,60,60
1651039302106,COGS 118A,A01,083075,Staff,0,10,60,60
1651039308133,CSE 3,A50,083646,Miranda; Gregory Joseph,15,0,38,23
1651039308133,CSE 3,A51,083647,Miranda; Gregory Joseph,36,0,37,1
1651039314163,CSE 8A,A50,083650,Miranda; Gregory Joseph,0,31,40,40
1651039320186,CSE 11,A01,083080,Cao; Yingjun,0,97,40,40
1651039326210,CSE 12,A01,083652,Staff,0,25,100,100
1651039332241,CSE 15L,A01,083654,Staff,0,2,50,50
1651039332241,CSE 15L,A02,083655,Staff,0,3,50,50
1651039338267,CSE 20,A01,083657,Staff,47,0,80,33
1651039344296,CSE 30,A01,083084,Eldon; John,0,38,80,80
1651039350339,CSE 100,A01,083659,Cao; Yingjun,0,72,50,50
1651039356363,CSE 134B,A01,083661,Powell; Thomas Allan,0,38,65,65
1651039362387,CSE 140,A01,083663,Staff,0,14,75,75
1651039368410,CSE 140L,A01,083088,Eldon; John,4,0,100,96
1651039374444,CSE 175,A01,083665,Kumar; Rakesh,0,0,25,25
1651039380467,CSE 190,A00,092507,Dubnov; Shlomo,9,0,20,11
1651039386491,ECE 45,A01,083139,Staff,0,7,60,60
1651039392515,ECE 65,A50,083695,Staff,0,7,30,30
1651039398538,ECE 109,A01,091882,Touri; Behrouz,33,0,70,37
1651039404564,ECE 180,A00,083140,Abi Samra; Nicholas Camill,17,0,30,13
1651039404564,ECE 180,B00,083141,Abi Samra; Nicholas Camill,0,0,30,30
1651039410601,MATH 10A,A01,083735,Patchell; Gregory David,0,0,30,30
1651039410601,MATH 10A,A02,083736,Patchell; Gregory David,27,0,30,3
1651039410601,MATH 10A,A03,083737,Patchell; Gregory David,23,0,30,7
1651039416623,MATH 10B,A01,083207,Staff,0,8,30,30
1651039416623,MATH 10B,A02,083208,Staff,0,6,30,30
1651039416623,MATH 10B,B01,083739,Staff,8,0,30,22
1651039416623,MATH 10B,B02,083740,Staff,28,0,30,2
1651039422651,MATH 18,A01,083743,Staff,0,0,30,30
1651039422651,MATH 18,A02,083744,Staff,23,0,30,7
1651039422651,MATH 18,A03,083745,Staff,19,0,30,11
1651039422651,MATH 18,A04,083746,Staff,26,0,30,4
1651039422651,MATH 18,B01,083748,Staff,0,16,30,30
1651039422651,MATH 18,B02,083749,Staff,0,14,30,30
1651039422651,MATH 18,B03,083750,Staff,0,14,30,30
1651039422651,MATH 18,B04,083751,Staff,0,13,30,30
1651039428675,MATH 20A,A01,083754,Staff,18,0,40,22
1651039434699,MATH 20B,A01,083756,Staff,0,14,30,30
1651039434699,MATH 20B,A02,083757,Staff,0,11,30,30
1651039440723,MATH 20C,A01,083760,Staff,0,16,30,30
1651039440723,MATH 20C,A02,083761,Staff,0,15,30,30
1651039440723,MATH 20C,B01,083762,Staff,8,0,30,22
1651039440723,MATH 20C,B02,083763,Staff,28,0,30,2
1651039446747,MATH 20D,A01,083765,Staff,3,1,30,27
1651039446747,MATH 20D,A02,083766,Staff,1,0,30,29
1651039446747,MATH 20D,A03,083767,Staff,22,0,30,8
1651039452770,MATH 20E,A01,083771,Staff,2,0,30,28
1651039452770,MATH 20E,A02,083772,Staff,11,0,30,19
1651039452770,MATH 20E,B01,083773,Staff,0,0,30,30
1651039452770,MATH 20E,B02,083774,Staff,0,0,30,30
1651039458806,MATH 103A,A01,083777,Staff,0,17,30,30
1651039458806,MATH 103A,A02,083778,Staff,0,16,30,30
1651039458806,MATH 103A,B01,083779,Staff,0,15,30,30
1651039458806,MATH 103A,B02,083780,Staff,0,13,30,30
1651039464844,MATH 105,A01,085443,Staff,0,23,30,30
1651039470867,MATH 109,A01,083213,Anzaldo; Leesa B,0,8,30,30
1651039470867,MATH 109,A02,083214,Anzaldo; Leesa B,0,7,30,30
1651039470867,MATH 109,B01,083215,Anzaldo; Leesa B,0,8,30,30
1651039470867,MATH 109,B02,083216,Anzaldo; Leesa B,0,8,30,30
1651039476902,MATH 142A,A01,083219,Chow; Bennett,0,15,30,30
1651039476902,MATH 142A,A02,083220,Chow; Bennett,0,15,30,30
1651039476902,MATH 142A,B01,083221,Chow; Bennett,0,16,30,30
1651039476902,MATH 142A,B02,083222,Chow; Bennett,0,14,30,30
1651039482932,MATH 193A,A01,083224,Staff,0,8,30,30
1651039482932,MATH 193A,A02,083225,Staff,0,7,30,30
1651039482932,MATH 193A,A03,083781,Staff,0,7,30,30
1651039482932,MATH 193A,A04,083782,Staff,0,7,30,30
1651039488955,MATH 197,001,091859,McAuley; Julian John,9998,0,9999,1
1651039495028,COGS 9,A01,083615,Staff,0,20,60,60
1651039501052,COGS 11,A01,083617,Boyle; Mary E. T.,13,0,40,27
1651039507080,COGS 13,A01,083071,Staff,0,40,40,40
1651039513113,COGS 14A,A01,092681,Staff,0,40,100,100
1651039519138,COGS 14B,A01,083073,Cheng; Tzu-Han,0,13,50,50
1651039525173,COGS 17,A01,092677,Staff,9,0,75,66
1651039531199,COGS 100,A01,083619,Staff,0,30,60,60
1651039537221,COGS 101A,A01,083621,Davis; Joshua Daniel,0,29,60,60
1651039543245,COGS 101B,A01,091572,Staff,0,7,60,60
1651039549274,COGS 101C,A01,083625,Delgado; Tania,14,0,30,16
1651039555300,COGS 107A,A01,083627,Boyle; Mary E. T.,0,17,60,60
1651039561328,COGS 118A,A01,083075,Staff,0,10,60,60
1651039567360,CSE 3,A50,083646,Miranda; Gregory Joseph,15,0,38,23
1651039567360,CSE 3,A51,083647,Miranda; Gregory Joseph,36,0,37,1
1651039573383,CSE 8A,A50,083650,Miranda; Gregory Joseph,0,31,40,40
1651039579409,CSE 11,A01,083080,Cao; Yingjun,0,97,40,40
1651039585436,CSE 12,A01,083652,Staff,0,25,100,100
1651039591460,CSE 15L,A01,083654,Staff,0,2,50,50
1651039591460,CSE 15L,A02,083655,Staff,0,3,50,50
1651039597484,CSE 20,A01,083657,Staff,47,0,80,33
1651039603507,CSE 30,A01,083084,Eldon; John,0,38,80,80
1651039609531,CSE 100,A01,083659,Cao; Yingjun,0,72,50,50
1651039615566,CSE 134B,A01,083661,Powell; Thomas Allan,0,38,65,65
1651039621592,CSE 140,A01,083663,Staff,0,14,75,75
1651039627626,CSE 140L,A01,083088,Eldon; John,4,0,100,96
1651039633649,CSE 175,A01,083665,Kumar; Rakesh,0,0,25,25
1651039639675,CSE 190,A00,092507,Dubnov; Shlomo,9,0,20,11
1651039645699,ECE 45,A01,083139,Staff,0,7,60,60
1651039651727,ECE 65,A50,083695,Staff,0,7,30,30
1651039657753,ECE 109,A01,091882,Touri; Behrouz,33,0,70,37
1651039663777,ECE 180,A00,083140,Abi Samra; Nicholas Camill,17,0,30,13
1651039663777,ECE 180,B00,083141,Abi Samra; Nicholas Camill,0,0,30,30
1651039669807,MATH 10A,A01,083735,Patchell; Gregory David,0,0,30,30
1651039669807,MATH 10A,A02,083736,Patchell; Gregory David,27,0,30,3
1651039669807,MATH 10A,A03,083737,Patchell; Gregory David,23,0,30,7
1651039675830,MATH 10B,A01,083207,Staff,0,8,30,30
1651039675830,MATH 10B,A02,083208,Staff,0,6,30,30
1651039675830,MATH 10B,B01,083739,Staff,8,0,30,22
1651039675830,MATH 10B,B02,083740,Staff,28,0,30,2
1651039681861,MATH 18,A01,083743,Staff,0,0,30,30
1651039681861,MATH 18,A02,083744,Staff,23,0,30,7
1651039681861,MATH 18,A03,083745,Staff,19,0,30,11
1651039681861,MATH 18,A04,083746,Staff,26,0,30,4
1651039681861,MATH 18,B01,083748,Staff,0,16,30,30
1651039681861,MATH 18,B02,083749,Staff,0,14,30,30
1651039681861,MATH 18,B03,083750,Staff,0,14,30,30
1651039681861,MATH 18,B04,083751,Staff,0,13,30,30
1651039687886,MATH 20A,A01,083754,Staff,18,0,40,22
1651039693910,MATH 20B,A01,083756,Staff,0,14,30,30
1651039693910,MATH 20B,A02,083757,Staff,0,11,30,30
1651039699934,MATH 20C,A01,083760,Staff,0,16,30,30
1651039699934,MATH 20C,A02,083761,Staff,0,15,30,30
1651039699934,MATH 20C,B01,083762,Staff,8,0,30,22
1651039699934,MATH 20C,B02,083763,Staff,28,0,30,2
1651039705959,MATH 20D,A01,083765,Staff,3,1,30,27
1651039705959,MATH 20D,A02,083766,Staff,1,0,30,29
1651039705959,MATH 20D,A03,083767,Staff,22,0,30,8
1651039711986,MATH 20E,A01,083771,Staff,2,0,30,28
1651039711986,MATH 20E,A02,083772,Staff,11,0,30,19
1651039711986,MATH 20E,B01,083773,Staff,0,0,30,30
1651039711986,MATH 20E,B02,083774,Staff,0,0,30,30
1651039718019,MATH 103A,A01,083777,Staff,0,17,30,30
1651039718019,MATH 103A,A02,083778,Staff,0,16,30,30
1651039718019,MATH 103A,B01,083779,Staff,0,15,30,30
1651039718019,MATH 103A,B02,083780,Staff,0,13,30,30
1651039724045,MATH 105,A01,085443,Staff,0,23,30,30
1651039730068,MATH 109,A01,083213,Anzaldo; Leesa B,0,8,30,30
1651039730068,MATH 109,A02,083214,Anzaldo; Leesa B,0,7,30,30
1651039730068,MATH 109,B01,083215,Anzaldo; Leesa B,0,8,30,30
1651039730068,MATH 109,B02,083216,Anzaldo; Leesa B,0,8,30,30
1651039736104,MATH 142A,A01,083219,Chow; Bennett,0,15,30,30
1651039736104,MATH 142A,A02,083220,Chow; Bennett,0,15,30,30
1651039736104,MATH 142A,B01,083221,Chow; Bennett,0,16,30,30
1651039736104,MATH 142A,B02,083222,Chow; Bennett,0,14,30,30
1651039742132,MATH 193A,A01,083224,Staff,0,8,30,30
1651039742132,MATH 193A,A02,083225,Staff,0,7,30,30
1651039742132,MATH 193A,A03,083781,Staff,0,7,30,30
1651039742132,MATH 193A,A04,083782,Staff,0,7,30,30
1651039748155,MATH 197,001,091859,McAuley; Julian John,9998,0,9999,1
1651039754213,COGS 9,A01,083615,Staff,0,20,60,60
1651039760237,COGS 11,A01,083617,Boyle; Mary E. T.,13,0,40,27
1651039766260,COGS 13,A01,083071,Staff,0,40,40,40
1651039772284,COGS 14A,A01,092681,Staff,0,40,100,100
1651039778308,COGS 14B,A01,083073,Cheng; Tzu-Han,0,13,50,50
1651039784330,COGS 17,A01,092677,Staff,9,0,75,66
1651039790354,COGS 100,A01,083619,Staff,0,30,60,60
1651039796381,COGS 101A,A01,083621,Davis; Joshua Daniel,0,29,60,60
1651039802406,COGS 101B,A01,091572,Staff,0,7,60,60
1651039808436,COGS 101C,A01,083625,Delgado; Tania,14,0,30,16
1651039814458,COGS 107A,A01,083627,Boyle; Mary E. T.,0,17,60,60
1651039820482,COGS 118A,A01,083075,Staff,0,10,60,60
1651039826516,CSE 3,A50,083646,Miranda; Gregory Joseph,15,0,38,23
1651039826516,CSE 3,A51,083647,Miranda; Gregory Joseph,36,0,37,1
1651039832635,CSE 8A,A50,083650,Miranda; Gregory Joseph,0,31,40,40
1651039838672,CSE 11,A01,083080,Cao; Yingjun,0,97,40,40
1651039844700,CSE 12,A01,083652,Staff,0,25,100,100
1651039850727,CSE 15L,A01,083654,Staff,0,2,50,50
1651039850727,CSE 15L,A02,083655,Staff,0,3,50,50
1651039856756,CSE 20,A01,083657,Staff,47,0,80,33
1651039862780,CSE 30,A01,083084,Eldon; John,0,38,80,80
1651039868805,CSE 100,A01,083659,Cao; Yingjun,0,72,50,50
1651039874829,CSE 134B,A01,083661,Powell; Thomas Allan,0,38,65,65
1651039880852,CSE 140,A01,083663,Staff,0,14,75,75
1651039886878,CSE 140L,A01,083088,Eldon; John,4,0,100,96
1651039892903,CSE 175,A01,083665,Kumar; Rakesh,0,0,25,25
1651039898927,CSE 190,A00,092507,Dubnov; Shlomo,9,0,20,11
1651039904963,ECE 45,A01,083139,Staff,0,7,60,60
1651039910989,ECE 65,A50,083695,Staff,0,7,30,30
1651039917019,ECE 109,A01,091882,Touri; Behrouz,33,0,70,37
1651039923043,ECE 180,A00,083140,Abi Samra; Nicholas Camill,17,0,30,13
1651039923043,ECE 180,B00,083141,Abi Samra; Nicholas Camill,0,0,30,30
1651039929076,MATH 10A,A01,083735,Patchell; Gregory David,0,0,30,30
1651039929076,MATH 10A,A02,083736,Patchell; Gregory David,27,0,30,3
1651039929076,MATH 10A,A03,083737,Patchell; Gregory David,23,0,30,7
1651039935099,MATH 10B,A01,083207,Staff,0,8,30,30
1651039935099,MATH 10B,A02,083208,Staff,0,6,30,30
1651039935099,MATH 10B,B01,083739,Staff,8,0,30,22
1651039935099,MATH 10B,B02,083740,Staff,28,0,30,2
1651039941128,MATH 18,A01,083743,Staff,0,0,30,30
1651039941128,MATH 18,A02,083744,Staff,23,0,30,7
1651039941128,MATH 18,A03,083745,Staff,19,0,30,11
1651039941128,MATH 18,A04,083746,Staff,26,0,30,4
1651039941128,MATH 18,B01,083748,Staff,0,16,30,30
1651039941128,MATH 18,B02,083749,Staff,0,14,30,30
1651039941128,MATH 18,B03,083750,Staff,0,14,30,30
1651039941128,MATH 18,B04,083751,Staff,0,13,30,30
1651039947154,MATH 20A,A01,083754,Staff,18,0,40,22
1651039953179,MATH 20B,A01,083756,Staff,0,14,30,30
1651039953179,MATH 20B,A02,083757,Staff,0,11,30,30
1651039959207,MATH 20C,A01,083760,Staff,0,16,30,30
1651039959207,MATH 20C,A02,083761,Staff,0,15,30,30
1651039959207,MATH 20C,B01,083762,Staff,8,0,30,22
1651039959207,MATH 20C,B02,083763,Staff,28,0,30,2
1651039965233,MATH 20D,A01,083765,Staff,3,1,30,27
1651039965233,MATH 20D,A02,083766,Staff,1,0,30,29
1651039965233,MATH 20D,A03,083767,Staff,22,0,30,8
1651039971257,MATH 20E,A01,083771,Staff,2,0,30,28
1651039971257,MATH 20E,A02,083772,Staff,11,0,30,19
1651039971257,MATH 20E,B01,083773,Staff,0,0,30,30
1651039971257,MATH 20E,B02,083774,Staff,0,0,30,30
1651039977282,MATH 103A,A01,083777,Staff,0,17,30,30
1651039977282,MATH 103A,A02,083778,Staff,0,16,30,30
1651039977282,MATH 103A,B01,083779,Staff,0,15,30,30
1651039977282,MATH 103A,B02,083780,Staff,0,13,30,30
1651039983304,MATH 105,A01,085443,Staff,0,23,30,30
1651039989332,MATH 109,A01,083213,Anzaldo; Leesa B,0,8,30,30
1651039989332,MATH 109,A02,083214,Anzaldo; Leesa B,0,7,30,30
1651039989332,MATH 109,B01,083215,Anzaldo; Leesa B,0,8,30,30
1651039989332,MATH 109,B02,083216,Anzaldo; Leesa B,0,8,30,30
1651039995357,MATH 142A,A01,083219,Chow; Bennett,0,15,30,30
1651039995357,MATH 142A,A02,083220,Chow; Bennett,0,15,30,30
1651039995357,MATH 142A,B01,083221,Chow; Bennett,0,16,30,30
1651039995357,MATH 142A,B02,083222,Chow; Bennett,0,14,30,30
1651040001380,MATH 193A,A01,083224,Staff,0,8,30,30
1651040001380,MATH 193A,A02,083225,Staff,0,7,30,30
1651040001380,MATH 193A,A03,083781,Staff,0,7,30,30
1651040001380,MATH 193A,A04,083782,Staff,0,7,30,30
1651040007402,MATH 197,001,091859,McAuley; Julian John,9998,0,9999,1
1651040013453,COGS 9,A01,083615,Staff,0,20,60,60
1651040019484,COGS 11,A01,083617,Boyle; Mary E. T.,13,0,40,27
1651040025507,COGS 13,A01,083071,Staff,0,40,40,40
1651040031532,COGS 14A,A01,092681,Staff,0,40,100,100
1651040037559,COGS 14B,A01,083073,Cheng; Tzu-Han,0,13,50,50
1651040043583,COGS 17,A01,092677,Staff,9,0,75,66
1651040049608,COGS 100,A01,083619,Staff,0,30,60,60
1651040055636,COGS 101A,A01,083621,Davis; Joshua Daniel,0,29,60,60
1651040061659,COGS 101B,A01,091572,Staff,0,7,60,60
1651040067690,COGS 101C,A01,083625,Delgado; Tania,14,0,30,16
1651040073713,COGS 107A,A01,083627,Boyle; Mary E. T.,0,17,60,60
1651040079740,COGS 118A,A01,083075,Staff,0,10,60,60
1651040085775,CSE 3,A50,083646,Miranda; Gregory Joseph,15,0,38,23
1651040085775,CSE 3,A51,083647,Miranda; Gregory Joseph,36,0,37,1
1651040091802,CSE 8A,A50,083650,Miranda; Gregory Joseph,0,31,40,40
1651040097837,CSE 11,A01,083080,Cao; Yingjun,0,97,40,40
1651040103864,CSE 12,A01,083652,Staff,0,25,100,100
1651040109889,CSE 15L,A01,083654,Staff,0,2,50,50
1651040109889,CSE 15L,A02,083655,Staff,0,3,50,50
1651040115914,CSE 20,A01,083657,Staff,46,0,80,34
1651040121942,CSE 30,A01,083084,Eldon; John,0,38,80,80
1651040127966,CSE 100,A01,083659,Cao; Yingjun,0,72,50,50
1651040133991,CSE 134B,A01,083661,Powell; Thomas Allan,0,38,65,65
1651040140019,CSE 140,A01,083663,Staff,0,14,75,75
1651040146042,CSE 140L,A01,083088,Eldon; John,4,0,100,96
1651040152067,CSE 175,A01,083665,Kumar; Rakesh,0,0,25,25
1651040158092,CSE 190,A00,092507,Dubnov; Shlomo,9,0,20,11
1651040164116,ECE 45,A01,083139,Staff,0,7,60,60
1651040170138,ECE 65,A50,083695,Staff,0,7,30,30
1651040176162,ECE 109,A01,091882,Touri; Behrouz,33,0,70,37
1651040182190,ECE 180,A00,083140,Abi Samra; Nicholas Camill,17,0,30,13
1651040182190,ECE 180,B00,083141,Abi Samra; Nicholas Camill,0,0,30,30
1651040188218,MATH 10A,A01,083735,Patchell; Gregory David,0,0,30,30
1651040188218,MATH 10A,A02,083736,Patchell; Gregory David,27,0,30,3
1651040188218,MATH 10A,A03,083737,Patchell; Gregory David,23,0,30,7
1651040194247,MATH 10B,A01,083207,Staff,0,8,30,30
1651040194247,MATH 10B,A02,083208,Staff,0,6,30,30
1651040194247,MATH 10B,B01,083739,Staff,8,0,30,22
1651040194247,MATH 10B,B02,083740,Staff,28,0,30,2
1651040200272,MATH 18,A01,083743,Staff,0,0,30,30
1651040200272,MATH 18,A02,083744,Staff,23,0,30,7
1651040200272,MATH 18,A03,083745,Staff,19,0,30,11
1651040200272,MATH 18,A04,083746,Staff,26,0,30,4
1651040200272,MATH 18,B01,083748,Staff,0,16,30,30
1651040200272,MATH 18,B02,083749,Staff,0,14,30,30
1651040200272,MATH 18,B03,083750,Staff,0,14,30,30
1651040200272,MATH 18,B04,083751,Staff,0,13,30,30
1651040206305,MATH 20A,A01,083754,Staff,18,0,40,22
1651040212329,MATH 20B,A01,083756,Staff,0,14,30,30
1651040212329,MATH 20B,A02,083757,Staff,0,11,30,30
1651040218352,MATH 20C,A01,083760,Staff,0,16,30,30
1651040218352,MATH 20C,A02,083761,Staff,0,15,30,30
1651040218352,MATH 20C,B01,083762,Staff,8,0,30,22
1651040218352,MATH 20C,B02,083763,Staff,28,0,30,2
1651040224377,MATH 20D,A01,083765,Staff,3,1,30,27
1651040224377,MATH 20D,A02,083766,Staff,1,0,30,29
1651040224377,MATH 20D,A03,083767,Staff,22,0,30,8
1651040230402,MATH 20E,A01,083771,Staff,1,0,30,29
1651040230402,MATH 20E,A02,083772,Staff,11,0,30,19
1651040230402,MATH 20E,B01,083773,Staff,0,0,30,30
1651040230402,MATH 20E,B02,083774,Staff,0,0,30,30
1651040236430,MATH 103A,A01,083777,Staff,0,17,30,30
1651040236430,MATH 103A,A02,083778,Staff,0,16,30,30
1651040236430,MATH 103A,B01,083779,Staff,0,15,30,30
1651040236430,MATH 103A,B02,083780,Staff,0,13,30,30
1651040242453,MATH 105,A01,085443,Staff,0,23,30,30
1651040248481,MATH 109,A01,083213,Anzaldo; Leesa B,0,8,30,30
1651040248481,MATH 109,A02,083214,Anzaldo; Leesa B,0,7,30,30
1651040248481,MATH 109,B01,083215,Anzaldo; Leesa B,0,8,30,30
1651040248481,MATH 109,B02,083216,Anzaldo; Leesa B,0,8,30,30
1651040254514,MATH 142A,A01,083219,Chow; Bennett,0,15,30,30
1651040254514,MATH 142A,A02,083220,Chow; Bennett,0,15,30,30
1651040254514,MATH 142A,B01,083221,Chow; Bennett,0,16,30,30
1651040254514,MATH 142A,B02,083222,Chow; Bennett,0,14,30,30
1651040260543,MATH 193A,A01,083224,Staff,0,8,30,30
1651040260543,MATH 193A,A02,083225,Staff,0,7,30,30
1651040260543,MATH 193A,A03,083781,Staff,0,7,30,30
1651040260543,MATH 193A,A04,083782,Staff,0,7,30,30
1651040266567,MATH 197,001,091859,McAuley; Julian John,9998,0,9999,1
1651040272630,COGS 9,A01,083615,Staff,0,20,60,60
1651040278655,COGS 11,A01,083617,Boyle; Mary E. T.,13,0,40,27
1651040284687,COGS 13,A01,083071,Staff,0,40,40,40
1651040290714,COGS 14A,A01,092681,Staff,0,40,100,100
1651040296738,COGS 14B,A01,083073,Cheng; Tzu-Han,0,13,50,50
1651040302763,COGS 17,A01,092677,Staff,9,0,75,66
1651040308785,COGS 100,A01,083619,Staff,0,30,60,60
1651040314809,COGS 101A,A01,083621,Davis; Joshua Daniel,0,29,60,60
1651040320833,COGS 101B,A01,091572,Staff,0,7,60,60
1651040326863,COGS 101C,A01,083625,Delgado; Tania,14,0,30,16
1651040332898,COGS 107A,A01,083627,Boyle; Mary E. T.,0,17,60,60
1651040338925,COGS 118A,A01,083075,Staff,0,10,60,60
1651040344956,CSE 3,A50,083646,Miranda; Gregory Joseph,15,0,38,23
1651040344956,CSE 3,A51,083647,Miranda; Gregory Joseph,36,0,37,1
1651040350986,CSE 8A,A50,083650,Miranda; Gregory Joseph,0,31,40,40
1651040357008,CSE 11,A01,083080,Cao; Yingjun,0,97,40,40
1651040363032,CSE 12,A01,083652,Staff,0,25,100,100
1651040369058,CSE 15L,A01,083654,Staff,0,2,50,50
1651040369058,CSE 15L,A02,083655,Staff,0,3,50,50
1651040375087,CSE 20,A01,083657,Staff,46,0,80,34
1651040381110,CSE 30,A01,083084,Eldon; John,0,38,80,80
1651040387133,CSE 100,A01,083659,Cao; Yingjun,0,72,50,50
1651040393155,CSE 134B,A01,083661,Powell; Thomas Allan,0,38,65,65
1651040399179,CSE 140,A01,083663,Staff,0,14,75,75
1651040405202,CSE 140L,A01,083088,Eldon; John,4,0,100,96
1651040411229,CSE 175,A01,083665,Kumar; Rakesh,0,0,25,25
1651040417253,CSE 190,A00,092507,Dubnov; Shlomo,9,0,20,11
1651040423277,ECE 45,A01,083139,Staff,0,7,60,60
1651040429395,ECE 65,A50,083695,Staff,0,7,30,30
1651040435429,ECE 109,A01,091882,Touri; Behrouz,33,0,70,37
1651040441454,ECE 180,A00,083140,Abi Samra; Nicholas Camill,17,0,30,13
1651040441454,ECE 180,B00,083141,Abi Samra; Nicholas Camill,0,0,30,30
1651040447480,MATH 10A,A01,083735,Patchell; Gregory David,0,0,30,30
1651040447480,MATH 10A,A02,083736,Patchell; Gregory David,27,0,30,3
1651040447480,MATH 10A,A03,083737,Patchell; Gregory David,23,0,30,7
1651040453507,MATH 10B,A01,083207,Staff,0,8,30,30
1651040453507,MATH 10B,A02,083208,Staff,0,6,30,30
1651040453507,MATH 10B,B01,083739,Staff,8,0,30,22
1651040453507,MATH 10B,B02,083740,Staff,28,0,30,2
1651040459532,MATH 18,A01,083743,Staff,0,0,30,30
1651040459532,MATH 18,A02,083744,Staff,23,0,30,7
1651040459532,MATH 18,A03,083745,Staff,19,0,30,11
1651040459532,MATH 18,A04,083746,Staff,26,0,30,4
1651040459532,MATH 18,B01,083748,Staff,0,16,30,30
1651040459532,MATH 18,B02,083749,Staff,0,14,30,30
1651040459532,MATH 18,B03,083750,Staff,0,14,30,30
1651040459532,MATH 18,B04,083751,Staff,0,13,30,30
1651040465563,MATH 20A,A01,083754,Staff,18,0,40,22
1651040471585,MATH 20B,A01,083756,Staff,0,14,30,30
1651040471585,MATH 20B,A02,083757,Staff,0,11,30,30
1651040477612,MATH 20C,A01,083760,Staff,0,16,30,30
1651040477612,MATH 20C,A02,083761,Staff,0,15,30,30
1651040477612,MATH 20C,B01,083762,Staff,8,0,30,22
1651040477612,MATH 20C,B02,083763,Staff,28,0,30,2
1651040483647,MATH 20D,A01,083765,Staff,3,1,30,27
1651040483647,MATH 20D,A02,083766,Staff,1,0,30,29
1651040483647,MATH 20D,A03,083767,Staff,22,0,30,8
1651040489696,MATH 20E,A01,083771,Staff,2,0,30,28
1651040489696,MATH 20E,A02,083772,Staff,10,0,30,20
1651040489696,MATH 20E,B01,083773,Staff,0,0,30,30
1651040489696,MATH 20E,B02,083774,Staff,0,0,30,30
1651040495722,MATH 103A,A01,083777,Staff,0,17,30,30
1651040495722,MATH 103A,A02,083778,Staff,0,16,30,30
1651040495722,MATH 103A,B01,083779,Staff,0,15,30,30
1651040495722,MATH 103A,B02,083780,Staff,0,13,30,30
1651040501745,MATH 105,A01,085443,Staff,0,23,30,30
1651040507774,MATH 109,A01,083213,Anzaldo; Leesa B,0,8,30,30
1651040507774,MATH 109,A02,083214,Anzaldo; Leesa B,0,7,30,30
1651040507774,MATH 109,B01,083215,Anzaldo; Leesa B,0,8,30,30
1651040507774,MATH 109,B02,083216,Anzaldo; Leesa B,0,8,30,30
1651040513802,MATH 142A,A01,083219,Chow; Bennett,0,15,30,30
1651040513802,MATH 142A,A02,083220,Chow; Bennett,0,15,30,30
1651040513802,MATH 142A,B01,083221,Chow; Bennett,0,16,30,30
1651040513802,MATH 142A,B02,083222,Chow; Bennett,0,14,30,30
1651040519825,MATH 193A,A01,083224,Staff,0,8,30,30
1651040519825,MATH 193A,A02,083225,Staff,0,7,30,30
1651040519825,MATH 193A,A03,083781,Staff,0,7,30,30
1651040519825,MATH 193A,A04,083782,Staff,0,7,30,30
1651040525861,MATH 197,001,091859,McAuley; Julian John,9998,0,9999,1
1651040531918,COGS 9,A01,083615,Staff,0,20,60,60
1651040537948,COGS 11,A01,083617,Boyle; Mary E. T.,13,0,40,27
1651040543972,COGS 13,A01,083071,Staff,0,40,40,40
1651040549997,COGS 14A,A01,092681,Staff,0,40,100,100
1651040556019,COGS 14B,A01,083073,Cheng; Tzu-Han,0,13,50,50
1651040562050,COGS 17,A01,092677,Staff,9,0,75,66
1651040568077,COGS 100,A01,083619,Staff,0,30,60,60
1651040574101,COGS 101A,A01,083621,Davis; Joshua Daniel,0,29,60,60
1651040580132,COGS 101B,A01,091572,Staff,0,7,60,60
1651040586158,COGS 101C,A01,083625,Delgado; Tania,14,0,30,16
1651040592181,COGS 107A,A01,083627,Boyle; Mary E. T.,0,17,60,60
1651040598205,COGS 118A,A01,083075,Staff,0,10,60,60
1651040604232,CSE 3,A50,083646,Miranda; Gregory Joseph,15,0,38,23
1651040604232,CSE 3,A51,083647,Miranda; Gregory Joseph,36,0,37,1
1651040610271,CSE 8A,A50,083650,Miranda; Gregory Joseph,0,31,40,40
1651040616294,CSE 11,A01,083080,Cao; Yingjun,0,97,40,40
1651040622319,CSE 12,A01,083652,Staff,0,25,100,100
1651040628341,CSE 15L,A01,083654,Staff,0,2,50,50
1651040628341,CSE 15L,A02,083655,Staff,0,3,50,50
1651040634366,CSE 20,A01,083657,Staff,46,0,80,34
1651040640391,CSE 30,A01,083084,Eldon; John,0,38,80,80
1651040646418,CSE 100,A01,083659,Cao; Yingjun,0,72,50,50
1651040652442,CSE 134B,A01,083661,Powell; Thomas Allan,0,38,65,65
1651040658468,CSE 140,A01,083663,Staff,0,14,75,75
1651040664492,CSE 140L,A01,083088,Eldon; John,4,0,100,96
1651040670518,CSE 175,A01,083665,Kumar; Rakesh,0,0,25,25
1651040676547,CSE 190,A00,092507,Dubnov; Shlomo,9,0,20,11
1651040682572,ECE 45,A01,083139,Staff,0,7,60,60
1651040688597,ECE 65,A50,083695,Staff,0,7,30,30
1651040694621,ECE 109,A01,091882,Touri; Behrouz,33,0,70,37
1651040700646,ECE 180,A00,083140,Abi Samra; Nicholas Camill,17,0,30,13
1651040700646,ECE 180,B00,083141,Abi Samra; Nicholas Camill,0,0,30,30
1651040706685,MATH 10A,A01,083735,Patchell; Gregory David,0,0,30,30
1651040706685,MATH 10A,A02,083736,Patchell; Gregory David,27,0,30,3
1651040706685,MATH 10A,A03,083737,Patchell; Gregory David,23,0,30,7
1651040712727,MATH 10B,A01,083207,Staff,0,8,30,30
1651040712727,MATH 10B,A02,083208,Staff,0,6,30,30
1651040712727,MATH 10B,B01,083739,Staff,8,0,30,22
1651040712727,MATH 10B,B02,083740,Staff,28,0,30,2
1651040718753,MATH 18,A01,083743,Staff,0,0,30,30
1651040718753,MATH 18,A02,083744,Staff,23,0,30,7
1651040718753,MATH 18,A03,083745,Staff,19,0,30,11
1651040718753,MATH 18,A04,083746,Staff,26,0,30,4
1651040718753,MATH 18,B01,083748,Staff,0,16,30,30
1651040718753,MATH 18,B02,083749,Staff,0,14,30,30
1651040718753,MATH 18,B03,083750,Staff,0,14,30,30
1651040718753,MATH 18,B04,083751,Staff,0,13,30,30
1651040724788,MATH 20A,A01,083754,Staff,18,0,40,22
1651040730812,MATH 20B,A01,083756,Staff,0,14,30,30
1651040730812,MATH 20B,A02,083757,Staff,0,11,30,30
1651040736836,MATH 20C,A01,083760,Staff,0,16,30,30
1651040736836,MATH 20C,A02,083761,Staff,0,15,30,30
1651040736836,MATH 20C,B01,083762,Staff,8,0,30,22
1651040736836,MATH 20C,B02,083763,Staff,28,0,30,2
1651040742865,MATH 20D,A01,083765,Staff,3,1,30,27
1651040742865,MATH 20D,A02,083766,Staff,1,0,30,29
1651040742865,MATH 20D,A03,083767,Staff,22,0,30,8
1651040748893,MATH 20E,A01,083771,Staff,2,0,30,28
1651040748893,MATH 20E,A02,083772,Staff,10,0,30,20
1651040748893,MATH 20E,B01,083773,Staff,0,0,30,30
1651040748893,MATH 20E,B02,083774,Staff,0,0,30,30
1651040754922,MATH 103A,A01,083777,Staff,0,17,30,30
1651040754922,MATH 103A,A02,083778,Staff,0,16,30,30
1651040754922,MATH 103A,B01,083779,Staff,0,15,30,30
1651040754922,MATH 103A,B02,083780,Staff,0,13,30,30
1651040760949,MATH 105,A01,085443,Staff,0,23,30,30
1651040766973,MATH 109,A01,083213,Anzaldo; Leesa B,0,8,30,30
1651040766973,MATH 109,A02,083214,Anzaldo; Leesa B,0,7,30,30
1651040766973,MATH 109,B01,083215,Anzaldo; Leesa B,0,8,30,30
1651040766973,MATH 109,B02,083216,Anzaldo; Leesa B,0,8,30,30
1651040773003,MATH 142A,A01,083219,Chow; Bennett,0,15,30,30
1651040773003,MATH 142A,A02,083220,Chow; Bennett,0,15,30,30
1651040773003,MATH 142A,B01,083221,Chow; Bennett,0,16,30,30
1651040773003,MATH 142A,B02,083222,Chow; Bennett,0,14,30,30
1651040779030,MATH 193A,A01,083224,Staff,0,8,30,30
1651040779030,MATH 193A,A02,083225,Staff,0,7,30,30
1651040779030,MATH 193A,A03,083781,Staff,0,7,30,30
1651040779030,MATH 193A,A04,083782,Staff,0,7,30,30
1651040785063,MATH 197,001,091859,McAuley; Julian John,9998,0,9999,1
1651040791114,COGS 9,A01,083615,Staff,0,20,60,60
1651040797140,COGS 11,A01,083617,Boyle; Mary E. T.,13,0,40,27
1651040803165,COGS 13,A01,083071,Staff,0,40,40,40
1651040809188,COGS 14A,A01,092681,Staff,0,40,100,100
1651040815212,COGS 14B,A01,083073,Cheng; Tzu-Han,0,13,50,50
1651040821240,COGS 17,A01,092677,Staff,9,0,75,66
1651040827265,COGS 100,A01,083619,Staff,0,30,60,60
1651040833289,COGS 101A,A01,083621,Davis; Joshua Daniel,0,29,60,60
1651040839316,COGS 101B,A01,091572,Staff,0,7,60,60
1651040845344,COGS 101C,A01,083625,Delgado; Tania,14,0,30,16
1651040851368,COGS 107A,A01,083627,Boyle; Mary E. T.,0,17,60,60
1651040857390,COGS 118A,A01,083075,Staff,0,10,60,60
1651040863417,CSE 3,A50,083646,Miranda; Gregory Joseph,15,0,38,23
1651040863417,CSE 3,A51,083647,Miranda; Gregory Joseph,36,0,37,1
1651040869442,CSE 8A,A50,083650,Miranda; Gregory Joseph,0,31,40,40
1651040875464,CSE 11,A01,083080,Cao; Yingjun,0,97,40,40
1651040881491,CSE 12,A01,083652,Staff,0,25,100,100
1651040887515,CSE 15L,A01,083654,Staff,0,2,50,50
1651040887515,CSE 15L,A02,083655,Staff,0,3,50,50
1651040893540,CSE 20,A01,083657,Staff,46,0,80,34
1651040899562,CSE 30,A01,083084,Eldon; John,0,38,80,80
1651040905590,CSE 100,A01,083659,Cao; Yingjun,0,72,50,50
1651040911613,CSE 134B,A01,083661,Powell; Thomas Allan,0,38,65,65
1651040917639,CSE 140,A01,083663,Staff,0,14,75,75
1651040923668,CSE 140L,A01,083088,Eldon; John,4,0,100,96
1651040929693,CSE 175,A01,083665,Kumar; Rakesh,0,0,25,25
1651040935719,CSE 190,A00,092507,Dubnov; Shlomo,9,0,20,11
1651040941745,ECE 45,A01,083139,Staff,0,7,60,60
1651040947770,ECE 65,A50,083695,Staff,0,7,30,30
1651040953794,ECE 109,A01,091882,Touri; Behrouz,33,0,70,37
1651040959818,ECE 180,A00,083140,Abi Samra; Nicholas Camill,17,0,30,13
1651040959818,ECE 180,B00,083141,Abi Samra; Nicholas Camill,0,0,30,30
1651040965847,MATH 10A,A01,083735,Patchell; Gregory David,0,0,30,30
1651040965847,MATH 10A,A02,083736,Patchell; Gregory David,27,0,30,3
1651040965847,MATH 10A,A03,083737,Patchell; Gregory David,23,0,30,7
1651040971871,MATH 10B,A01,083207,Staff,0,7,30,30
1651040971871,MATH 10B,A02,083208,Staff,0,6,30,30
1651040971871,MATH 10B,B01,083739,Staff,8,0,30,22
1651040971871,MATH 10B,B02,083740,Staff,28,0,30,2
1651040977896,MATH 18,A01,083743,Staff,0,0,30,30
1651040977896,MATH 18,A02,083744,Staff,23,0,30,7
1651040977896,MATH 18,A03,083745,Staff,19,0,30,11
1651040977896,MATH 18,A04,083746,Staff,26,0,30,4
1651040977896,MATH 18,B01,083748,Staff,0,16,30,30
1651040977896,MATH 18,B02,083749,Staff,0,14,30,30
1651040977896,MATH 18,B03,083750,Staff,0,14,30,30
1651040977896,MATH 18,B04,083751,Staff,0,13,30,30
1651040983920,MATH 20A,A01,083754,Staff,18,0,40,22
1651040989945,MATH 20B,A01,083756,Staff,0,14,30,30
1651040989945,MATH 20B,A02,083757,Staff,0,11,30,30
1651040995971,MATH 20C,A01,083760,Staff,0,16,30,30
1651040995971,MATH 20C,A02,083761,Staff,0,15,30,30
1651040995971,MATH 20C,B01,083762,Staff,8,0,30,22
1651040995971,MATH 20C,B02,083763,Staff,28,0,30,2
1651041001999,MATH 20D,A01,083765,Staff,3,1,30,27
1651041001999,MATH 20D,A02,083766,Staff,1,0,30,29
1651041001999,MATH 20D,A03,083767,Staff,22,0,30,8
1651041008025,MATH 20E,A01,083771,Staff,2,0,30,28
1651041008025,MATH 20E,A02,083772,Staff,10,0,30,20
1651041008025,MATH 20E,B01,083773,Staff,0,0,30,30
1651041008025,MATH 20E,B02,083774,Staff,0,0,30,30
1651041014053,MATH 103A,A01,083777,Staff,0,17,30,30
1651041014053,MATH 103A,A02,083778,Staff,0,16,30,30
1651041014053,MATH 103A,B01,083779,Staff,0,15,30,30
1651041014053,MATH 103A,B02,083780,Staff,0,13,30,30
1651041020080,MATH 105,A01,085443,Staff,0,23,30,30
1651041026186,MATH 109,A01,083213,Anzaldo; Leesa B,0,8,30,30
1651041026186,MATH 109,A02,083214,Anzaldo; Leesa B,0,7,30,30
1651041026186,MATH 109,B01,083215,Anzaldo; Leesa B,0,8,30,30
1651041026186,MATH 109,B02,083216,Anzaldo; Leesa B,0,8,30,30
1651041032236,MATH 142A,A01,083219,Chow; Bennett,0,15,30,30
1651041032236,MATH 142A,A02,083220,Chow; Bennett,0,15,30,30
1651041032236,MATH 142A,B01,083221,Chow; Bennett,0,16,30,30
1651041032236,MATH 142A,B02,083222,Chow; Bennett,0,14,30,30
1651041038259,MATH 193A,A01,083224,Staff,0,8,30,30
1651041038259,MATH 193A,A02,083225,Staff,0,7,30,30
1651041038259,MATH 193A,A03,083781,Staff,0,7,30,30
1651041038259,MATH 193A,A04,083782,Staff,0,7,30,30
1651041044285,MATH 197,001,091859,McAuley; Julian John,9998,0,9999,1
1651041050344,COGS 9,A01,083615,Staff,0,20,60,60
1651041056365,COGS 11,A01,083617,Boyle; Mary E. T.,13,0,40,27
1651041062404,COGS 13,A01,083071,Staff,0,40,40,40
1651041068426,COGS 14A,A01,092681,Staff,0,40,100,100
1651041074458,COGS 14B,A01,083073,Cheng; Tzu-Han,0,13,50,50
1651041080480,COGS 17,A01,092677,Staff,9,0,75,66
1651041086502,COGS 100,A01,083619,Staff,0,30,60,60
1651041092524,COGS 101A,A01,083621,Davis; Joshua Daniel,0,29,60,60
1651041098560,COGS 101B,A01,091572,Staff,0,7,60,60
1651041104587,COGS 101C,A01,083625,Delgado; Tania,14,0,30,16
1651041110613,COGS 107A,A01,083627,Boyle; Mary E. T.,0,17,60,60
1651041116635,COGS 118A,A01,083075,Staff,0,10,60,60
1651041122664,CSE 3,A50,083646,Miranda; Gregory Joseph,15,0,38,23
1651041122664,CSE 3,A51,083647,Miranda; Gregory Joseph,36,0,37,1
1651041128690,CSE 8A,A50,083650,Miranda; Gregory Joseph,0,31,40,40
1651041134718,CSE 11,A01,083080,Cao; Yingjun,0,97,40,40
1651041140741,CSE 12,A01,083652,Staff,0,25,100,100
1651041146768,CSE 15L,A01,083654,Staff,0,2,50,50
1651041146768,CSE 15L,A02,083655,Staff,0,3,50,50
1651041152792,CSE 20,A01,083657,Staff,46,0,80,34
1651041158819,CSE 30,A01,083084,Eldon; John,0,38,80,80
1651041164843,CSE 100,A01,083659,Cao; Yingjun,0,72,50,50
1651041170866,CSE 134B,A01,083661,Powell; Thomas Allan,0,38,65,65
1651041176892,CSE 140,A01,083663,Staff,0,15,75,75
1651041182917,CSE 140L,A01,083088,Eldon; John,3,0,100,97
1651041188940,CSE 175,A01,083665,Kumar; Rakesh,0,0,25,25
1651041194966,CSE 190,A00,092507,Dubnov; Shlomo,9,0,20,11
1651041200989,ECE 45,A01,083139,Staff,0,7,60,60
1651041207015,ECE 65,A50,083695,Staff,0,7,30,30
1651041213041,ECE 109,A01,091882,Touri; Behrouz,33,0,70,37
1651041219066,ECE 180,A00,083140,Abi Samra; Nicholas Camill,17,0,30,13
1651041219066,ECE 180,B00,083141,Abi Samra; Nicholas Camill,0,0,30,30
1651041225089,MATH 10A,A01,083735,Patchell; Gregory David,0,0,30,30
1651041225089,MATH 10A,A02,083736,Patchell; Gregory David,27,0,30,3
1651041225089,MATH 10A,A03,083737,Patchell; Gregory David,23,0,30,7
1651041231112,MATH 10B,A01,083207,Staff,0,7,30,30
1651041231112,MATH 10B,A02,083208,Staff,0,6,30,30
1651041231112,MATH 10B,B01,083739,Staff,8,0,30,22
1651041231112,MATH 10B,B02,083740,Staff,28,0,30,2
1651041237143,MATH 18,A01,083743,Staff,0,0,30,30
1651041237143,MATH 18,A02,083744,Staff,23,0,30,7
1651041237143,MATH 18,A03,083745,Staff,19,0,30,11
1651041237143,MATH 18,A04,083746,Staff,26,0,30,4
1651041237143,MATH 18,B01,083748,Staff,0,16,30,30
1651041237143,MATH 18,B02,083749,Staff,0,14,30,30
1651041237143,MATH 18,B03,083750,Staff,0,14,30,30
1651041237143,MATH 18,B04,083751,Staff,0,13,30,30
1651041243167,MATH 20A,A01,083754,Staff,18,0,40,22
1651041249194,MATH 20B,A01,083756,Staff,0,14,30,30
1651041249194,MATH 20B,A02,083757,Staff,0,11,30,30
1651041255222,MATH 20C,A01,083760,Staff,0,16,30,30
1651041255222,MATH 20C,A02,083761,Staff,0,15,30,30
1651041255222,MATH 20C,B01,083762,Staff,8,0,30,22
1651041255222,MATH 20C,B02,083763,Staff,28,0,30,2
1651041261246,MATH 20D,A01,083765,Staff,3,1,30,27
1651041261246,MATH 20D,A02,083766,Staff,1,0,30,29
1651041261246,MATH 20D,A03,083767,Staff,22,0,30,8
1651041267274,MATH 20E,A01,083771,Staff,2,0,30,28
1651041267274,MATH 20E,A02,083772,Staff,10,0,30,20
1651041267274,MATH 20E,B01,083773,Staff,0,0,30,30
1651041267274,MATH 20E,B02,083774,Staff,0,0,30,30
1651041273299,MATH 103A,A01,083777,Staff,0,17,30,30
1651041273299,MATH 103A,A02,083778,Staff,0,16,30,30
1651041273299,MATH 103A,B01,083779,Staff,0,15,30,30
1651041273299,MATH 103A,B02,083780,Staff,0,13,30,30
1651041279326,MATH 105,A01,085443,Staff,0,23,30,30
1651041285351,MATH 109,A01,083213,Anzaldo; Leesa B,0,8,30,30
1651041285351,MATH 109,A02,083214,Anzaldo; Leesa B,0,7,30,30
1651041285351,MATH 109,B01,083215,Anzaldo; Leesa B,0,8,30,30
1651041285351,MATH 109,B02,083216,Anzaldo; Leesa B,0,8,30,30
1651041291378,MATH 142A,A01,083219,Chow; Bennett,0,15,30,30
1651041291378,MATH 142A,A02,083220,Chow; Bennett,0,15,30,30
1651041291378,MATH 142A,B01,083221,Chow; Bennett,0,16,30,30
1651041291378,MATH 142A,B02,083222,Chow; Bennett,0,14,30,30
1651041297403,MATH 193A,A01,083224,Staff,0,8,30,30
1651041297403,MATH 193A,A02,083225,Staff,0,7,30,30
1651041297403,MATH 193A,A03,083781,Staff,0,7,30,30
1651041297403,MATH 193A,A04,083782,Staff,0,7,30,30
1651041303428,MATH 197,001,091859,McAuley; Julian John,9998,0,9999,1
1651041309480,COGS 9,A01,083615,Staff,0,20,60,60
1651041315502,COGS 11,A01,083617,Boyle; Mary E. T.,13,0,40,27
1651041321525,COGS 13,A01,083071,Staff,0,40,40,40
1651041327551,COGS 14A,A01,092681,Staff,0,40,100,100
1651041333576,COGS 14B,A01,083073,Cheng; Tzu-Han,0,13,50,50
1651041339603,COGS 17,A01,092677,Staff,9,0,75,66
1651041345631,COGS 100,A01,083619,Staff,0,30,60,60
1651041351658,COGS 101A,A01,083621,Davis; Joshua Daniel,0,29,60,60
1651041357684,COGS 101B,A01,091572,Staff,0,7,60,60
1651041363708,COGS 101C,A01,083625,Delgado; Tania,14,0,30,16
1651041369742,COGS 107A,A01,083627,Boyle; Mary E. T.,0,17,60,60
1651041375769,COGS 118A,A01,083075,Staff,0,10,60,60
1651041381795,CSE 3,A50,083646,Miranda; Gregory Joseph,15,0,38,23
1651041381795,CSE 3,A51,083647,Miranda; Gregory Joseph,36,0,37,1
1651041387818,CSE 8A,A50,083650,Miranda; Gregory Joseph,0,31,40,40
1651041393841,CSE 11,A01,083080,Cao; Yingjun,0,97,40,40
1651041399864,CSE 12,A01,083652,Staff,0,25,100,100
1651041405890,CSE 15L,A01,083654,Staff,0,2,50,50
1651041405890,CSE 15L,A02,083655,Staff,0,3,50,50
1651041411914,CSE 20,A01,083657,Staff,46,0,80,34
1651041417937,CSE 30,A01,083084,Eldon; John,0,38,80,80
1651041423965,CSE 100,A01,083659,Cao; Yingjun,0,72,50,50
1651041429987,CSE 134B,A01,083661,Powell; Thomas Allan,0,38,65,65
1651041436010,CSE 140,A01,083663,Staff,0,15,75,75
1651041442038,CSE 140L,A01,083088,Eldon; John,3,0,100,97
1651041448064,CSE 175,A01,083665,Kumar; Rakesh,0,0,25,25
1651041454090,CSE 190,A00,092507,Dubnov; Shlomo,9,0,20,11
1651041460121,ECE 45,A01,083139,Staff,0,7,60,60
1651041466143,ECE 65,A50,083695,Staff,0,7,30,30
1651041472170,ECE 109,A01,091882,Touri; Behrouz,33,0,70,37
1651041478194,ECE 180,A00,083140,Abi Samra; Nicholas Camill,17,0,30,13
1651041478194,ECE 180,B00,083141,Abi Samra; Nicholas Camill,0,0,30,30
1651041484216,MATH 10A,A01,083735,Patchell; Gregory David,0,0,30,30
1651041484216,MATH 10A,A02,083736,Patchell; Gregory David,27,0,30,3
1651041484216,MATH 10A,A03,083737,Patchell; Gregory David,23,0,30,7
1651041490240,MATH 10B,A01,083207,Staff,0,7,30,30
1651041490240,MATH 10B,A02,083208,Staff,0,6,30,30
1651041490240,MATH 10B,B01,083739,Staff,8,0,30,22
1651041490240,MATH 10B,B02,083740,Staff,28,0,30,2
1651041496276,MATH 18,A01,083743,Staff,0,0,30,30
1651041496276,MATH 18,A02,083744,Staff,23,0,30,7
1651041496276,MATH 18,A03,083745,Staff,19,0,30,11
1651041496276,MATH 18,A04,083746,Staff,26,0,30,4
1651041496276,MATH 18,B01,083748,Staff,0,16,30,30
1651041496276,MATH 18,B02,083749,Staff,0,14,30,30
1651041496276,MATH 18,B03,083750,Staff,0,14,30,30
1651041496276,MATH 18,B04,083751,Staff,0,13,30,30
1651041502299,MATH 20A,A01,083754,Staff,18,0,40,22
1651041508326,MATH 20B,A01,083756,Staff,0,14,30,30
1651041508326,MATH 20B,A02,083757,Staff,0,11,30,30
1651041514350,MATH 20C,A01,083760,Staff,0,16,30,30
1651041514350,MATH 20C,A02,083761,Staff,0,15,30,30
1651041514350,MATH 20C,B01,083762,Staff,8,0,30,22
1651041514350,MATH 20C,B02,083763,Staff,28,0,30,2
1651041520375,MATH 20D,A01,083765,Staff,3,1,30,27
1651041520375,MATH 20D,A02,083766,Staff,1,0,30,29
1651041520375,MATH 20D,A03,083767,Staff,22,0,30,8
1651041526398,MATH 20E,A01,083771,Staff,2,0,30,28
1651041526398,MATH 20E,A02,083772,Staff,10,0,30,20
1651041526398,MATH 20E,B01,083773,Staff,0,0,30,30
1651041526398,MATH 20E,B02,083774,Staff,0,0,30,30
1651041532425,MATH 103A,A01,083777,Staff,0,17,30,30
1651041532425,MATH 103A,A02,083778,Staff,0,16,30,30
1651041532425,MATH 103A,B01,083779,Staff,0,15,30,30
1651041532425,MATH 103A,B02,083780,Staff,0,13,30,30
1651041538449,MATH 105,A01,085443,Staff,0,23,30,30
1651041544477,MATH 109,A01,083213,Anzaldo; Leesa B,0,8,30,30
1651041544477,MATH 109,A02,083214,Anzaldo; Leesa B,0,7,30,30
1651041544477,MATH 109,B01,083215,Anzaldo; Leesa B,0,8,30,30
1651041544477,MATH 109,B02,083216,Anzaldo; Leesa B,0,8,30,30
1651041550502,MATH 142A,A01,083219,Chow; Bennett,0,15,30,30
1651041550502,MATH 142A,A02,083220,Chow; Bennett,0,15,30,30
1651041550502,MATH 142A,B01,083221,Chow; Bennett,0,16,30,30
1651041550502,MATH 142A,B02,083222,Chow; Bennett,0,14,30,30
1651041556532,MATH 193A,A01,083224,Staff,0,8,30,30
1651041556532,MATH 193A,A02,083225,Staff,0,7,30,30
1651041556532,MATH 193A,A03,083781,Staff,0,7,30,30
1651041556532,MATH 193A,A04,083782,Staff,0,7,30,30
1651041562555,MATH 197,001,091859,McAuley; Julian John,9998,0,9999,1
1651041568617,COGS 9,A01,083615,Staff,0,20,60,60
1651041574641,COGS 11,A01,083617,Boyle; Mary E. T.,13,0,40,27
1651041580668,COGS 13,A01,083071,Staff,0,40,40,40
1651041586695,COGS 14A,A01,092681,Staff,0,40,100,100
1651041592721,COGS 14B,A01,083073,Cheng; Tzu-Han,0,13,50,50
1651041598744,COGS 17,A01,092677,Staff,9,0,75,66
1651041604780,COGS 100,A01,083619,Staff,0,30,60,60
1651041610807,COGS 101A,A01,083621,Davis; Joshua Daniel,0,29,60,60
1651041616906,COGS 101B,A01,091572,Staff,0,7,60,60
1651041622928,COGS 101C,A01,083625,Delgado; Tania,14,0,30,16
1651041628951,COGS 107A,A01,083627,Boyle; Mary E. T.,0,17,60,60
1651041635078,COGS 118A,A01,083075,Staff,0,10,60,60
1651041641109,CSE 3,A50,083646,Miranda; Gregory Joseph,15,0,38,23
1651041641109,CSE 3,A51,083647,Miranda; Gregory Joseph,36,0,37,1
1651041647136,CSE 8A,A50,083650,Miranda; Gregory Joseph,0,31,40,40
1651041653160,CSE 11,A01,083080,Cao; Yingjun,0,97,40,40
1651041659182,CSE 12,A01,083652,Staff,0,25,100,100
1651041665205,CSE 15L,A01,083654,Staff,0,2,50,50
1651041665205,CSE 15L,A02,083655,Staff,0,3,50,50
1651041671229,CSE 20,A01,083657,Staff,46,0,80,34
1651041677258,CSE 30,A01,083084,Eldon; John,0,38,80,80
1651041683285,CSE 100,A01,083659,Cao; Yingjun,0,72,50,50
1651041689312,CSE 134B,A01,083661,Powell; Thomas Allan,0,38,65,65
1651041695340,CSE 140,A01,083663,Staff,0,15,75,75
1651041701364,CSE 140L,A01,083088,Eldon; John,3,0,100,97
1651041707390,CSE 175,A01,083665,Kumar; Rakesh,0,0,25,25
1651041713414,CSE 190,A00,092507,Dubnov; Shlomo,9,0,20,11
1651041719440,ECE 45,A01,083139,Staff,0,7,60,60
1651041725464,ECE 65,A50,083695,Staff,0,7,30,30
1651041731485,ECE 109,A01,091882,Touri; Behrouz,33,0,70,37
1651041737506,ECE 180,A00,083140,Abi Samra; Nicholas Camill,17,0,30,13
1651041737506,ECE 180,B00,083141,Abi Samra; Nicholas Camill,0,0,30,30
1651041743532,MATH 10A,A01,083735,Patchell; Gregory David,0,0,30,30
1651041743532,MATH 10A,A02,083736,Patchell; Gregory David,27,0,30,3
1651041743532,MATH 10A,A03,083737,Patchell; Gregory David,23,0,30,7
1651041749559,MATH 10B,A01,083207,Staff,0,7,30,30
1651041749559,MATH 10B,A02,083208,Staff,0,6,30,30
1651041749559,MATH 10B,B01,083739,Staff,8,0,30,22
1651041749559,MATH 10B,B02,083740,Staff,28,0,30,2
1651041755585,MATH 18,A01,083743,Staff,0,0,30,30
1651041755585,MATH 18,A02,083744,Staff,23,0,30,7
1651041755585,MATH 18,A03,083745,Staff,19,0,30,11
1651041755585,MATH 18,A04,083746,Staff,26,0,30,4
1651041755585,MATH 18,B01,083748,Staff,0,16,30,30
1651041755585,MATH 18,B02,083749,Staff,0,14,30,30
1651041755585,MATH 18,B03,083750,Staff,0,14,30,30
1651041755585,MATH 18,B04,083751,Staff,0,13,30,30
1651041761607,MATH 20A,A01,083754,Staff,18,0,40,22
1651041767629,MATH 20B,A01,083756,Staff,0,14,30,30
1651041767629,MATH 20B,A02,083757,Staff,0,11,30,30
1651041773657,MATH 20C,A01,083760,Staff,0,16,30,30
1651041773657,MATH 20C,A02,083761,Staff,0,15,30,30
1651041773657,MATH 20C,B01,083762,Staff,8,0,30,22
1651041773657,MATH 20C,B02,083763,Staff,28,0,30,2
1651041779685,MATH 20D,A01,083765,Staff,3,1,30,27
1651041779685,MATH 20D,A02,083766,Staff,1,0,30,29
1651041779685,MATH 20D,A03,083767,Staff,22,0,30,8
1651041785709,MATH 20E,A01,083771,Staff,2,0,30,28
1651041785709,MATH 20E,A02,083772,Staff,10,0,30,20
1651041785709,MATH 20E,B01,083773,Staff,0,0,30,30
1651041785709,MATH 20E,B02,083774,Staff,0,0,30,30
1651041791732,MATH 103A,A01,083777,Staff,0,17,30,30
1651041791732,MATH 103A,A02,083778,Staff,0,16,30,30
1651041791732,MATH 103A,B01,083779,Staff,0,15,30,30
1651041791732,MATH 103A,B02,083780,Staff,0,13,30,30
1651041797758,MATH 105,A01,085443,Staff,0,23,30,30
1651041803782,MATH 109,A01,083213,Anzaldo; Leesa B,0,8,30,30
1651041803782,MATH 109,A02,083214,Anzaldo; Leesa B,0,7,30,30
1651041803782,MATH 109,B01,083215,Anzaldo; Leesa B,0,8,30,30
1651041803782,MATH 109,B02,083216,Anzaldo; Leesa B,0,8,30,30
1651041809808,MATH 142A,A01,083219,Chow; Bennett,0,15,30,30
1651041809808,MATH 142A,A02,083220,Chow; Bennett,0,15,30,30
1651041809808,MATH 142A,B01,083221,Chow; Bennett,0,16,30,30
1651041809808,MATH 142A,B02,083222,Chow; Bennett,0,14,30,30
1651041815835,MATH 193A,A01,083224,Staff,0,8,30,30
1651041815835,MATH 193A,A02,083225,Staff,0,7,30,30
1651041815835,MATH 193A,A03,083781,Staff,0,7,30,30
1651041815835,MATH 193A,A04,083782,Staff,0,7,30,30
1651041821862,MATH 197,001,091859,McAuley; Julian John,9998,0,9999,1
1651041827919,COGS 9,A01,083615,Staff,0,20,60,60
1651041833943,COGS 11,A01,083617,Boyle; Mary E. T.,13,0,40,27
1651041839965,COGS 13,A01,083071,Staff,0,40,40,40
1651041846000,COGS 14A,A01,092681,Staff,0,40,100,100
1651041852025,COGS 14B,A01,083073,Cheng; Tzu-Han,0,13,50,50
1651041858047,COGS 17,A01,092677,Staff,9,0,75,66
1651041864070,COGS 100,A01,083619,Staff,0,30,60,60
1651041870098,COGS 101A,A01,083621,Davis; Joshua Daniel,0,29,60,60
1651041876122,COGS 101B,A01,091572,Staff,0,7,60,60
1651041882145,COGS 101C,A01,083625,Delgado; Tania,14,0,30,16
1651041888174,COGS 107A,A01,083627,Boyle; Mary E. T.,0,17,60,60
1651041894202,COGS 118A,A01,083075,Staff,0,10,60,60
1651041900225,CSE 3,A50,083646,Miranda; Gregory Joseph,15,0,38,23
1651041900225,CSE 3,A51,083647,Miranda; Gregory Joseph,36,0,37,1
1651041906255,CSE 8A,A50,083650,Miranda; Gregory Joseph,0,31,40,40
1651041912285,CSE 11,A01,083080,Cao; Yingjun,0,97,40,40
1651041918311,CSE 12,A01,083652,Staff,0,25,100,100
1651041924335,CSE 15L,A01,083654,Staff,0,2,50,50
1651041924335,CSE 15L,A02,083655,Staff,0,3,50,50
1651041930359,CSE 20,A01,083657,Staff,46,0,80,34
1651041936389,CSE 30,A01,083084,Eldon; John,0,38,80,80
1651041942413,CSE 100,A01,083659,Cao; Yingjun,0,72,50,50
1651041948436,CSE 134B,A01,083661,Powell; Thomas Allan,0,38,65,65
1651041954458,CSE 140,A01,083663,Staff,0,15,75,75
1651041960481,CSE 140L,A01,083088,Eldon; John,3,0,100,97
1651041966505,CSE 175,A01,083665,Kumar; Rakesh,0,0,25,25
1651041972527,CSE 190,A00,092507,Dubnov; Shlomo,9,0,20,11
1651041978554,ECE 45,A01,083139,Staff,0,7,60,60
1651041984580,ECE 65,A50,083695,Staff,0,7,30,30
1651041990603,ECE 109,A01,091882,Touri; Behrouz,33,0,70,37
1651041996631,ECE 180,A00,083140,Abi Samra; Nicholas Camill,17,0,30,13
1651041996631,ECE 180,B00,083141,Abi Samra; Nicholas Camill,0,0,30,30
1651042002657,MATH 10A,A01,083735,Patchell; Gregory David,0,0,30,30
1651042002657,MATH 10A,A02,083736,Patchell; Gregory David,27,0,30,3
1651042002657,MATH 10A,A03,083737,Patchell; Gregory David,23,0,30,7
1651042008681,MATH 10B,A01,083207,Staff,0,7,30,30
1651042008681,MATH 10B,A02,083208,Staff,0,6,30,30
1651042008681,MATH 10B,B01,083739,Staff,8,0,30,22
1651042008681,MATH 10B,B02,083740,Staff,28,0,30,2
1651042014707,MATH 18,A01,083743,Staff,0,0,30,30
1651042014707,MATH 18,A02,083744,Staff,23,0,30,7
1651042014707,MATH 18,A03,083745,Staff,19,0,30,11
1651042014707,MATH 18,A04,083746,Staff,26,0,30,4
1651042014707,MATH 18,B01,083748,Staff,0,16,30,30
1651042014707,MATH 18,B02,083749,Staff,0,14,30,30
1651042014707,MATH 18,B03,083750,Staff,0,14,30,30
1651042014707,MATH 18,B04,083751,Staff,0,13,30,30
1651042020730,MATH 20A,A01,083754,Staff,18,0,40,22
1651042026761,MATH 20B,A01,083756,Staff,0,14,30,30
1651042026761,MATH 20B,A02,083757,Staff,0,11,30,30
1651042032788,MATH 20C,A01,083760,Staff,0,16,30,30
1651042032788,MATH 20C,A02,083761,Staff,0,15,30,30
1651042032788,MATH 20C,B01,083762,Staff,8,0,30,22
1651042032788,MATH 20C,B02,083763,Staff,28,0,30,2
1651042038814,MATH 20D,A01,083765,Staff,3,1,30,27
1651042038814,MATH 20D,A02,083766,Staff,1,0,30,29
1651042038814,MATH 20D,A03,083767,Staff,22,0,30,8
1651042044842,MATH 20E,A01,083771,Staff,2,0,30,28
1651042044842,MATH 20E,A02,083772,Staff,10,0,30,20
1651042044842,MATH 20E,B01,083773,Staff,0,0,30,30
1651042044842,MATH 20E,B02,083774,Staff,0,0,30,30
1651042050876,MATH 103A,A01,083777,Staff,0,17,30,30
1651042050876,MATH 103A,A02,083778,Staff,0,16,30,30
1651042050876,MATH 103A,B01,083779,Staff,0,15,30,30
1651042050876,MATH 103A,B02,083780,Staff,0,13,30,30
1651042056900,MATH 105,A01,085443,Staff,0,23,30,30
1651042062925,MATH 109,A01,083213,Anzaldo; Leesa B,0,8,30,30
1651042062925,MATH 109,A02,083214,Anzaldo; Leesa B,0,7,30,30
1651042062925,MATH 109,B01,083215,Anzaldo; Leesa B,0,8,30,30
1651042062925,MATH 109,B02,083216,Anzaldo; Leesa B,0,8,30,30
1651042068952,MATH 142A,A01,083219,Chow; Bennett,0,15,30,30
1651042068952,MATH 142A,A02,083220,Chow; Bennett,0,15,30,30
1651042068952,MATH 142A,B01,083221,Chow; Bennett,0,16,30,30
1651042068952,MATH 142A,B02,083222,Chow; Bennett,0,14,30,30
1651042074979,MATH 193A,A01,083224,Staff,0,8,30,30
1651042074979,MATH 193A,A02,083225,Staff,0,7,30,30
1651042074979,MATH 193A,A03,083781,Staff,0,7,30,30
1651042074979,MATH 193A,A04,083782,Staff,0,7,30,30
1651042081016,MATH 197,001,091859,McAuley; Julian John,9998,0,9999,1
1651042087076,COGS 9,A01,083615,Staff,0,20,60,60
1651042093099,COGS 11,A01,083617,Boyle; Mary E. T.,13,0,40,27
1651042099125,COGS 13,A01,083071,Staff,0,40,40,40
1651042105148,COGS 14A,A01,092681,Staff,0,40,100,100
1651042111175,COGS 14B,A01,083073,Cheng; Tzu-Han,0,13,50,50
1651042117198,COGS 17,A01,092677,Staff,9,0,75,66
1651042123224,COGS 100,A01,083619,Staff,0,30,60,60
1651042129248,COGS 101A,A01,083621,Davis; Joshua Daniel,0,29,60,60
1651042135271,COGS 101B,A01,091572,Staff,0,7,60,60
1651042141302,COGS 101C,A01,083625,Delgado; Tania,14,0,30,16
1651042147329,COGS 107A,A01,083627,Boyle; Mary E. T.,0,17,60,60
1651042153353,COGS 118A,A01,083075,Staff,0,10,60,60
1651042159381,CSE 3,A50,083646,Miranda; Gregory Joseph,15,0,38,23
1651042159381,CSE 3,A51,083647,Miranda; Gregory Joseph,36,0,37,1
1651042165405,CSE 8A,A50,083650,Miranda; Gregory Joseph,0,31,40,40
1651042171428,CSE 11,A01,083080,Cao; Yingjun,0,97,40,40
1651042177450,CSE 12,A01,083652,Staff,0,25,100,100
1651042183481,CSE 15L,A01,083654,Staff,0,2,50,50
1651042183481,CSE 15L,A02,083655,Staff,0,3,50,50
1651042189503,CSE 20,A01,083657,Staff,46,0,80,34
1651042195527,CSE 30,A01,083084,Eldon; John,0,38,80,80
1651042201551,CSE 100,A01,083659,Cao; Yingjun,0,72,50,50
1651042207575,CSE 134B,A01,083661,Powell; Thomas Allan,0,38,65,65
1651042213711,CSE 140,A01,083663,Staff,0,15,75,75
1651042219736,CSE 140L,A01,083088,Eldon; John,3,0,100,97
1651042225760,CSE 175,A01,083665,Kumar; Rakesh,0,0,25,25
1651042231782,CSE 190,A00,092507,Dubnov; Shlomo,9,0,20,11
1651042237805,ECE 45,A01,083139,Staff,0,7,60,60
1651042243828,ECE 65,A50,083695,Staff,0,7,30,30
1651042249851,ECE 109,A01,091882,Touri; Behrouz,33,0,70,37
1651042255877,ECE 180,A00,083140,Abi Samra; Nicholas Camill,17,0,30,13
1651042255877,ECE 180,B00,083141,Abi Samra; Nicholas Camill,0,0,30,30
1651042261900,MATH 10A,A01,083735,Patchell; Gregory David,0,0,30,30
1651042261900,MATH 10A,A02,083736,Patchell; Gregory David,27,0,30,3
1651042261900,MATH 10A,A03,083737,Patchell; Gregory David,23,0,30,7
1651042267928,MATH 10B,A01,083207,Staff,0,7,30,30
1651042267928,MATH 10B,A02,083208,Staff,0,6,30,30
1651042267928,MATH 10B,B01,083739,Staff,8,0,30,22
1651042267928,MATH 10B,B02,083740,Staff,28,0,30,2
1651042273962,MATH 18,A01,083743,Staff,0,0,30,30
1651042273962,MATH 18,A02,083744,Staff,23,0,30,7
1651042273962,MATH 18,A03,083745,Staff,19,0,30,11
1651042273962,MATH 18,A04,083746,Staff,26,0,30,4
1651042273962,MATH 18,B01,083748,Staff,0,16,30,30
1651042273962,MATH 18,B02,083749,Staff,0,14,30,30
1651042273962,MATH 18,B03,083750,Staff,0,14,30,30
1651042273962,MATH 18,B04,083751,Staff,0,13,30,30
1651042279986,MATH 20A,A01,083754,Staff,18,0,40,22
1651042286008,MATH 20B,A01,083756,Staff,0,14,30,30
1651042286008,MATH 20B,A02,083757,Staff,0,11,30,30
1651042292033,MATH 20C,A01,083760,Staff,0,16,30,30
1651042292033,MATH 20C,A02,083761,Staff,0,15,30,30
1651042292033,MATH 20C,B01,083762,Staff,8,0,30,22
1651042292033,MATH 20C,B02,083763,Staff,28,0,30,2
1651042298055,MATH 20D,A01,083765,Staff,3,1,30,27
1651042298055,MATH 20D,A02,083766,Staff,1,0,30,29
1651042298055,MATH 20D,A03,083767,Staff,22,0,30,8
1651042304079,MATH 20E,A01,083771,Staff,2,0,30,28
1651042304079,MATH 20E,A02,083772,Staff,10,0,30,20
1651042304079,MATH 20E,B01,083773,Staff,0,0,30,30
1651042304079,MATH 20E,B02,083774,Staff,0,0,30,30
1651042310113,MATH 103A,A01,083777,Staff,0,17,30,30
1651042310113,MATH 103A,A02,083778,Staff,0,16,30,30
1651042310113,MATH 103A,B01,083779,Staff,0,15,30,30
1651042310113,MATH 103A,B02,083780,Staff,0,13,30,30
1651042316137,MATH 105,A01,085443,Staff,0,23,30,30
1651042322170,MATH 109,A01,083213,Anzaldo; Leesa B,0,8,30,30
1651042322170,MATH 109,A02,083214,Anzaldo; Leesa B,0,7,30,30
1651042322170,MATH 109,B01,083215,Anzaldo; Leesa B,0,8,30,30
1651042322170,MATH 109,B02,083216,Anzaldo; Leesa B,0,8,30,30
1651042328201,MATH 142A,A01,083219,Chow; Bennett,0,15,30,30
1651042328201,MATH 142A,A02,083220,Chow; Bennett,0,15,30,30
1651042328201,MATH 142A,B01,083221,Chow; Bennett,0,16,30,30
1651042328201,MATH 142A,B02,083222,Chow; Bennett,0,14,30,30
1651042334223,MATH 193A,A01,083224,Staff,0,8,30,30
1651042334223,MATH 193A,A02,083225,Staff,0,7,30,30
1651042334223,MATH 193A,A03,083781,Staff,0,7,30,30
1651042334223,MATH 193A,A04,083782,Staff,0,7,30,30
1651042340247,MATH 197,001,091859,McAuley; Julian John,9998,0,9999,1
1651042346295,COGS 9,A01,083615,Staff,0,20,60,60
1651042352328,COGS 11,A01,083617,Boyle; Mary E. T.,13,0,40,27
1651042358353,COGS 13,A01,083071,Staff,0,40,40,40
1651042364379,COGS 14A,A01,092681,Staff,0,40,100,100
1651042370402,COGS 14B,A01,083073,Cheng; Tzu-Han,0,13,50,50
1651042376425,COGS 17,A01,092677,Staff,9,0,75,66
1651042382451,COGS 100,A01,083619,Staff,0,30,60,60
1651042388476,COGS 101A,A01,083621,Davis; Joshua Daniel,0,29,60,60
1651042394501,COGS 101B,A01,091572,Staff,0,7,60,60
1651042400526,COGS 101C,A01,083625,Delgado; Tania,14,0,30,16
1651042406550,COGS 107A,A01,083627,Boyle; Mary E. T.,0,17,60,60
1651042412573,COGS 118A,A01,083075,Staff,0,10,60,60
1651042418597,CSE 3,A50,083646,Miranda; Gregory Joseph,15,0,38,23
1651042418597,CSE 3,A51,083647,Miranda; Gregory Joseph,36,0,37,1
1651042424624,CSE 8A,A50,083650,Miranda; Gregory Joseph,0,31,40,40
1651042430646,CSE 11,A01,083080,Cao; Yingjun,0,97,40,40
1651042436673,CSE 12,A01,083652,Staff,0,25,100,100
1651042442697,CSE 15L,A01,083654,Staff,0,2,50,50
1651042442697,CSE 15L,A02,083655,Staff,0,3,50,50
1651042448724,CSE 20,A01,083657,Staff,46,0,80,34
1651042454749,CSE 30,A01,083084,Eldon; John,0,38,80,80
1651042460775,CSE 100,A01,083659,Cao; Yingjun,0,72,50,50
1651042466799,CSE 134B,A01,083661,Powell; Thomas Allan,0,38,65,65
1651042472827,CSE 140,A01,083663,Staff,0,15,75,75
1651042478851,CSE 140L,A01,083088,Eldon; John,3,0,100,97
1651042484876,CSE 175,A01,083665,Kumar; Rakesh,0,0,25,25
1651042490902,CSE 190,A00,092507,Dubnov; Shlomo,9,0,20,11
1651042496925,ECE 45,A01,083139,Staff,0,7,60,60
1651042502952,ECE 65,A50,083695,Staff,0,7,30,30
1651042508977,ECE 109,A01,091882,Touri; Behrouz,33,0,70,37
1651042515003,ECE 180,A00,083140,Abi Samra; Nicholas Camill,17,0,30,13
1651042515003,ECE 180,B00,083141,Abi Samra; Nicholas Camill,0,0,30,30
1651042521030,MATH 10A,A01,083735,Patchell; Gregory David,0,0,30,30
1651042521030,MATH 10A,A02,083736,Patchell; Gregory David,27,0,30,3
1651042521030,MATH 10A,A03,083737,Patchell; Gregory David,23,0,30,7
1651042527070,MATH 10B,A01,083207,Staff,0,7,30,30
1651042527070,MATH 10B,A02,083208,Staff,0,6,30,30
1651042527070,MATH 10B,B01,083739,Staff,8,0,30,22
1651042527070,MATH 10B,B02,083740,Staff,28,0,30,2
1651042533097,MATH 18,A01,083743,Staff,0,0,30,30
1651042533097,MATH 18,A02,083744,Staff,23,0,30,7
1651042533097,MATH 18,A03,083745,Staff,19,0,30,11
1651042533097,MATH 18,A04,083746,Staff,26,0,30,4
1651042533097,MATH 18,B01,083748,Staff,0,16,30,30
1651042533097,MATH 18,B02,083749,Staff,0,14,30,30
1651042533097,MATH 18,B03,083750,Staff,0,14,30,30
1651042533097,MATH 18,B04,083751,Staff,0,13,30,30
1651042539130,MATH 20A,A01,083754,Staff,18,0,40,22
1651042545156,MATH 20B,A01,083756,Staff,0,14,30,30
1651042545156,MATH 20B,A02,083757,Staff,0,11,30,30
1651042551179,MATH 20C,A01,083760,Staff,0,16,30,30
1651042551179,MATH 20C,A02,083761,Staff,0,15,30,30
1651042551179,MATH 20C,B01,083762,Staff,8,0,30,22
1651042551179,MATH 20C,B02,083763,Staff,28,0,30,2
1651042557214,MATH 20D,A01,083765,Staff,3,1,30,27
1651042557214,MATH 20D,A02,083766,Staff,1,0,30,29
1651042557214,MATH 20D,A03,083767,Staff,22,0,30,8
1651042563248,MATH 20E,A01,083771,Staff,2,0,30,28
1651042563248,MATH 20E,A02,083772,Staff,10,0,30,20
1651042563248,MATH 20E,B01,083773,Staff,0,0,30,30
1651042563248,MATH 20E,B02,083774,Staff,0,0,30,30
1651042569276,MATH 103A,A01,083777,Staff,0,17,30,30
1651042569276,MATH 103A,A02,083778,Staff,0,16,30,30
1651042569276,MATH 103A,B01,083779,Staff,0,15,30,30
1651042569276,MATH 103A,B02,083780,Staff,0,13,30,30
1651042575300,MATH 105,A01,085443,Staff,0,23,30,30
1651042581327,MATH 109,A01,083213,Anzaldo; Leesa B,0,8,30,30
1651042581327,MATH 109,A02,083214,Anzaldo; Leesa B,0,7,30,30
1651042581327,MATH 109,B01,083215,Anzaldo; Leesa B,0,8,30,30
1651042581327,MATH 109,B02,083216,Anzaldo; Leesa B,0,8,30,30
1651042587357,MATH 142A,A01,083219,Chow; Bennett,0,15,30,30
1651042587357,MATH 142A,A02,083220,Chow; Bennett,0,15,30,30
1651042587357,MATH 142A,B01,083221,Chow; Bennett,0,16,30,30
1651042587357,MATH 142A,B02,083222,Chow; Bennett,0,14,30,30
1651042593381,MATH 193A,A01,083224,Staff,0,8,30,30
1651042593381,MATH 193A,A02,083225,Staff,0,7,30,30
1651042593381,MATH 193A,A03,083781,Staff,0,7,30,30
1651042593381,MATH 193A,A04,083782,Staff,0,7,30,30
1651042599413,MATH 197,001,091859,McAuley; Julian John,9998,0,9999,1
1651042605472,COGS 9,A01,083615,Staff,0,20,60,60
1651042611510,COGS 11,A01,083617,Boyle; Mary E. T.,13,0,40,27
1651042617533,COGS 13,A01,083071,Staff,0,40,40,40
1651042623556,COGS 14A,A01,092681,Staff,0,40,100,100
1651042629582,COGS 14B,A01,083073,Cheng; Tzu-Han,0,13,50,50
1651042635604,COGS 17,A01,092677,Staff,9,0,75,66
1651042641627,COGS 100,A01,083619,Staff,0,30,60,60
1651042647654,COGS 101A,A01,083621,Davis; Joshua Daniel,0,29,60,60
1651042653679,COGS 101B,A01,091572,Staff,0,7,60,60
1651042659705,COGS 101C,A01,083625,Delgado; Tania,14,0,30,16
1651042665732,COGS 107A,A01,083627,Boyle; Mary E. T.,0,17,60,60
1651042671758,COGS 118A,A01,083075,Staff,0,10,60,60
1651042677782,CSE 3,A50,083646,Miranda; Gregory Joseph,15,0,38,23
1651042677782,CSE 3,A51,083647,Miranda; Gregory Joseph,36,0,37,1
1651042683806,CSE 8A,A50,083650,Miranda; Gregory Joseph,0,31,40,40
1651042689829,CSE 11,A01,083080,Cao; Yingjun,0,97,40,40
1651042695859,CSE 12,A01,083652,Staff,0,25,100,100
1651042701882,CSE 15L,A01,083654,Staff,0,2,50,50
1651042701882,CSE 15L,A02,083655,Staff,0,3,50,50
1651042707906,CSE 20,A01,083657,Staff,46,0,80,34
1651042713940,CSE 30,A01,083084,Eldon; John,0,38,80,80
1651042719964,CSE 100,A01,083659,Cao; Yingjun,0,72,50,50
1651042726001,CSE 134B,A01,083661,Powell; Thomas Allan,0,38,65,65
1651042732032,CSE 140,A01,083663,Staff,0,15,75,75
1651042738059,CSE 140L,A01,083088,Eldon; John,3,0,100,97
1651042744085,CSE 175,A01,083665,Kumar; Rakesh,0,0,25,25
1651042750110,CSE 190,A00,092507,Dubnov; Shlomo,9,0,20,11
1651042756141,ECE 45,A01,083139,Staff,0,7,60,60
1651042762165,ECE 65,A50,083695,Staff,0,7,30,30
1651042768188,ECE 109,A01,091882,Touri; Behrouz,33,0,70,37
1651042774224,ECE 180,A00,083140,Abi Samra; Nicholas Camill,17,0,30,13
1651042774224,ECE 180,B00,083141,Abi Samra; Nicholas Camill,0,0,30,30
1651042780251,MATH 10A,A01,083735,Patchell; Gregory David,0,0,30,30
1651042780251,MATH 10A,A02,083736,Patchell; Gregory David,27,0,30,3
1651042780251,MATH 10A,A03,083737,Patchell; Gregory David,23,0,30,7
1651042786274,MATH 10B,A01,083207,Staff,0,7,30,30
1651042786274,MATH 10B,A02,083208,Staff,0,6,30,30
1651042786274,MATH 10B,B01,083739,Staff,8,0,30,22
1651042786274,MATH 10B,B02,083740,Staff,28,0,30,2
1651042792309,MATH 18,A01,083743,Staff,0,0,30,30
1651042792309,MATH 18,A02,083744,Staff,23,0,30,7
1651042792309,MATH 18,A03,083745,Staff,19,0,30,11
1651042792309,MATH 18,A04,083746,Staff,26,0,30,4
1651042792309,MATH 18,B01,083748,Staff,0,16,30,30
1651042792309,MATH 18,B02,083749,Staff,0,14,30,30
1651042792309,MATH 18,B03,083750,Staff,0,14,30,30
1651042792309,MATH 18,B04,083751,Staff,0,13,30,30
1651042798332,MATH 20A,A01,083754,Staff,18,0,40,22
1651042804359,MATH 20B,A01,083756,Staff,0,14,30,30
1651042804359,MATH 20B,A02,083757,Staff,0,11,30,30
1651042810489,MATH 20C,A01,083760,Staff,0,16,30,30
1651042810489,MATH 20C,A02,083761,Staff,0,15,30,30
1651042810489,MATH 20C,B01,083762,Staff,8,0,30,22
1651042810489,MATH 20C,B02,083763,Staff,28,0,30,2
1651042816512,MATH 20D,A01,083765,Staff,3,1,30,27
1651042816512,MATH 20D,A02,083766,Staff,1,0,30,29
1651042816512,MATH 20D,A03,083767,Staff,22,0,30,8
1651042822539,MATH 20E,A01,083771,Staff,2,0,30,28
1651042822539,MATH 20E,A02,083772,Staff,10,0,30,20
1651042822539,MATH 20E,B01,083773,Staff,0,0,30,30
1651042822539,MATH 20E,B02,083774,Staff,0,0,30,30
1651042828563,MATH 103A,A01,083777,Staff,0,17,30,30
1651042828563,MATH 103A,A02,083778,Staff,0,16,30,30
1651042828563,MATH 103A,B01,083779,Staff,0,15,30,30
1651042828563,MATH 103A,B02,083780,Staff,0,13,30,30
1651042834587,MATH 105,A01,085443,Staff,0,23,30,30
1651042840614,MATH 109,A01,083213,Anzaldo; Leesa B,0,8,30,30
1651042840614,MATH 109,A02,083214,Anzaldo; Leesa B,0,7,30,30
1651042840614,MATH 109,B01,083215,Anzaldo; Leesa B,0,8,30,30
1651042840614,MATH 109,B02,083216,Anzaldo; Leesa B,0,8,30,30
1651042846637,MATH 142A,A01,083219,Chow; Bennett,0,15,30,30
1651042846637,MATH 142A,A02,083220,Chow; Bennett,0,15,30,30
1651042846637,MATH 142A,B01,083221,Chow; Bennett,0,16,30,30
1651042846637,MATH 142A,B02,083222,Chow; Bennett,0,14,30,30
1651042852665,MATH 193A,A01,083224,Staff,0,8,30,30
1651042852665,MATH 193A,A02,083225,Staff,0,7,30,30
1651042852665,MATH 193A,A03,083781,Staff,0,7,30,30
1651042852665,MATH 193A,A04,083782,Staff,0,7,30,30
1651042858688,MATH 197,001,091859,McAuley; Julian John,9998,0,9999,1
1651042864751,COGS 9,A01,083615,Staff,0,20,60,60
1651042870779,COGS 11,A01,083617,Boyle; Mary E. T.,13,0,40,27
1651042876811,COGS 13,A01,083071,Staff,0,40,40,40
1651042882838,COGS 14A,A01,092681,Staff,0,40,100,100
1651042888861,COGS 14B,A01,083073,Cheng; Tzu-Han,0,13,50,50
1651042894885,COGS 17,A01,092677,Staff,9,0,75,66
1651042900909,COGS 100,A01,083619,Staff,0,30,60,60
1651042906932,COGS 101A,A01,083621,Davis; Joshua Daniel,0,29,60,60
1651042912960,COGS 101B,A01,091572,Staff,0,7,60,60
1651042918985,COGS 101C,A01,083625,Delgado; Tania,14,0,30,16
1651042925011,COGS 107A,A01,083627,Boyle; Mary E. T.,0,17,60,60
1651042931036,COGS 118A,A01,083075,Staff,0,10,60,60
1651042937070,CSE 3,A50,083646,Miranda; Gregory Joseph,15,0,38,23
1651042937070,CSE 3,A51,083647,Miranda; Gregory Joseph,36,0,37,1
1651042943097,CSE 8A,A50,083650,Miranda; Gregory Joseph,0,31,40,40
1651042949126,CSE 11,A01,083080,Cao; Yingjun,0,97,40,40
1651042955157,CSE 12,A01,083652,Staff,0,25,100,100
1651042961181,CSE 15L,A01,083654,Staff,0,2,50,50
1651042961181,CSE 15L,A02,083655,Staff,0,3,50,50
1651042967210,CSE 20,A01,083657,Staff,46,0,80,34
1651042973239,CSE 30,A01,083084,Eldon; John,0,38,80,80
1651042979263,CSE 100,A01,083659,Cao; Yingjun,0,72,50,50
1651042985286,CSE 134B,A01,083661,Powell; Thomas Allan,0,38,65,65
1651042991315,CSE 140,A01,083663,Staff,0,15,75,75
1651042997343,CSE 140L,A01,083088,Eldon; John,3,0,100,97
1651043003367,CSE 175,A01,083665,Kumar; Rakesh,0,0,25,25
1651043009396,CSE 190,A00,092507,Dubnov; Shlomo,9,0,20,11
1651043015425,ECE 45,A01,083139,Staff,0,7,60,60
1651043021448,ECE 65,A50,083695,Staff,0,7,30,30
1651043027469,ECE 109,A01,091882,Touri; Behrouz,33,0,70,37
1651043033491,ECE 180,A00,083140,Abi Samra; Nicholas Camill,17,0,30,13
1651043033491,ECE 180,B00,083141,Abi Samra; Nicholas Camill,0,0,30,30
1651043039517,MATH 10A,A01,083735,Patchell; Gregory David,0,0,30,30
1651043039517,MATH 10A,A02,083736,Patchell; Gregory David,27,0,30,3
1651043039517,MATH 10A,A03,083737,Patchell; Gregory David,23,0,30,7
1651043045540,MATH 10B,A01,083207,Staff,0,7,30,30
1651043045540,MATH 10B,A02,083208,Staff,0,6,30,30
1651043045540,MATH 10B,B01,083739,Staff,8,0,30,22
1651043045540,MATH 10B,B02,083740,Staff,28,0,30,2
1651043051571,MATH 18,A01,083743,Staff,0,0,30,30
1651043051571,MATH 18,A02,083744,Staff,23,0,30,7
1651043051571,MATH 18,A03,083745,Staff,19,0,30,11
1651043051571,MATH 18,A04,083746,Staff,26,0,30,4
1651043051571,MATH 18,B01,083748,Staff,0,16,30,30
1651043051571,MATH 18,B02,083749,Staff,0,14,30,30
1651043051571,MATH 18,B03,083750,Staff,0,14,30,30
1651043051571,MATH 18,B04,083751,Staff,0,13,30,30
1651043057594,MATH 20A,A01,083754,Staff,18,0,40,22
1651043063619,MATH 20B,A01,083756,Staff,0,14,30,30
1651043063619,MATH 20B,A02,083757,Staff,0,11,30,30
1651043069653,MATH 20C,A01,083760,Staff,0,16,30,30
1651043069653,MATH 20C,A02,083761,Staff,0,15,30,30
1651043069653,MATH 20C,B01,083762,Staff,8,0,30,22
1651043069653,MATH 20C,B02,083763,Staff,28,0,30,2
1651043075678,MATH 20D,A01,083765,Staff,3,1,30,27
1651043075678,MATH 20D,A02,083766,Staff,1,0,30,29
1651043075678,MATH 20D,A03,083767,Staff,22,0,30,8
1651043081712,MATH 20E,A01,083771,Staff,2,0,30,28
1651043081712,MATH 20E,A02,083772,Staff,10,0,30,20
1651043081712,MATH 20E,B01,083773,Staff,0,0,30,30
1651043081712,MATH 20E,B02,083774,Staff,0,0,30,30
1651043087736,MATH 103A,A01,083777,Staff,0,17,30,30
1651043087736,MATH 103A,A02,083778,Staff,0,16,30,30
1651043087736,MATH 103A,B01,083779,Staff,0,15,30,30
1651043087736,MATH 103A,B02,083780,Staff,0,13,30,30
1651043093760,MATH 105,A01,085443,Staff,0,23,30,30
1651043099791,MATH 109,A01,083213,Anzaldo; Leesa B,0,8,30,30
1651043099791,MATH 109,A02,083214,Anzaldo; Leesa B,0,7,30,30
1651043099791,MATH 109,B01,083215,Anzaldo; Leesa B,0,8,30,30
1651043099791,MATH 109,B02,083216,Anzaldo; Leesa B,0,8,30,30
1651043105812,MATH 142A,A01,083219,Chow; Bennett,0,15,30,30
1651043105812,MATH 142A,A02,083220,Chow; Bennett,0,15,30,30
1651043105812,MATH 142A,B01,083221,Chow; Bennett,0,16,30,30
1651043105812,MATH 142A,B02,083222,Chow; Bennett,0,14,30,30
1651043111842,MATH 193A,A01,083224,Staff,0,8,30,30
1651043111842,MATH 193A,A02,083225,Staff,0,7,30,30
1651043111842,MATH 193A,A03,083781,Staff,0,7,30,30
1651043111842,MATH 193A,A04,083782,Staff,0,7,30,30
1651043117865,MATH 197,001,091859,McAuley; Julian John,9998,0,9999,1
1651043123925,COGS 9,A01,083615,Staff,0,20,60,60
1651043129948,COGS 11,A01,083617,Boyle; Mary E. T.,13,0,40,27
1651043135973,COGS 13,A01,083071,Staff,0,40,40,40
1651043142020,COGS 14A,A01,092681,Staff,0,40,100,100
1651043148059,COGS 14B,A01,083073,Cheng; Tzu-Han,0,13,50,50
1651043154086,COGS 17,A01,092677,Staff,9,0,75,66
1651043160135,COGS 100,A01,083619,Staff,0,30,60,60
1651043166158,COGS 101A,A01,083621,Davis; Joshua Daniel,0,29,60,60
1651043172186,COGS 101B,A01,091572,Staff,0,7,60,60
1651043178217,COGS 101C,A01,083625,Delgado; Tania,14,0,30,16
1651043184247,COGS 107A,A01,083627,Boyle; Mary E. T.,0,17,60,60
1651043190275,COGS 118A,A01,083075,Staff,0,10,60,60
1651043196304,CSE 3,A50,083646,Miranda; Gregory Joseph,15,0,38,23
1651043196304,CSE 3,A51,083647,Miranda; Gregory Joseph,36,0,37,1
1651043202334,CSE 8A,A50,083650,Miranda; Gregory Joseph,0,31,40,40
1651043208358,CSE 11,A01,083080,Cao; Yingjun,0,97,40,40
1651043214381,CSE 12,A01,083652,Staff,0,25,100,100
1651043220406,CSE 15L,A01,083654,Staff,0,2,50,50
1651043220406,CSE 15L,A02,083655,Staff,0,3,50,50
1651043226429,CSE 20,A01,083657,Staff,46,0,80,34
1651043232456,CSE 30,A01,083084,Eldon; John,0,38,80,80
1651043238488,CSE 100,A01,083659,Cao; Yingjun,0,72,50,50
1651043244517,CSE 134B,A01,083661,Powell; Thomas Allan,0,38,65,65
1651043250540,CSE 140,A01,083663,Staff,0,15,75,75
1651043256568,CSE 140L,A01,083088,Eldon; John,3,0,100,97
1651043262594,CSE 175,A01,083665,Kumar; Rakesh,0,0,25,25
1651043268622,CSE 190,A00,092507,Dubnov; Shlomo,9,0,20,11
1651043274646,ECE 45,A01,083139,Staff,0,7,60,60
1651043280673,ECE 65,A50,083695,Staff,0,7,30,30
1651043286698,ECE 109,A01,091882,Touri; Behrouz,33,0,70,37
1651043292726,ECE 180,A00,083140,Abi Samra; Nicholas Camill,17,0,30,13
1651043292726,ECE 180,B00,083141,Abi Samra; Nicholas Camill,0,0,30,30
1651043298750,MATH 10A,A01,083735,Patchell; Gregory David,0,0,30,30
1651043298750,MATH 10A,A02,083736,Patchell; Gregory David,27,0,30,3
1651043298750,MATH 10A,A03,083737,Patchell; Gregory David,23,0,30,7
1651043304774,MATH 10B,A01,083207,Staff,0,7,30,30
1651043304774,MATH 10B,A02,083208,Staff,0,6,30,30
1651043304774,MATH 10B,B01,083739,Staff,8,0,30,22
1651043304774,MATH 10B,B02,083740,Staff,28,0,30,2
1651043310805,MATH 18,A01,083743,Staff,0,0,30,30
1651043310805,MATH 18,A02,083744,Staff,23,0,30,7
1651043310805,MATH 18,A03,083745,Staff,19,0,30,11
1651043310805,MATH 18,A04,083746,Staff,26,0,30,4
1651043310805,MATH 18,B01,083748,Staff,0,16,30,30
1651043310805,MATH 18,B02,083749,Staff,0,14,30,30
1651043310805,MATH 18,B03,083750,Staff,0,14,30,30
1651043310805,MATH 18,B04,083751,Staff,0,13,30,30
1651043316829,MATH 20A,A01,083754,Staff,18,0,40,22
1651043322858,MATH 20B,A01,083756,Staff,0,14,30,30
1651043322858,MATH 20B,A02,083757,Staff,0,11,30,30
1651043328882,MATH 20C,A01,083760,Staff,0,16,30,30
1651043328882,MATH 20C,A02,083761,Staff,0,15,30,30
1651043328882,MATH 20C,B01,083762,Staff,8,0,30,22
1651043328882,MATH 20C,B02,083763,Staff,28,0,30,2
1651043334907,MATH 20D,A01,083765,Staff,3,1,30,27
1651043334907,MATH 20D,A02,083766,Staff,1,0,30,29
1651043334907,MATH 20D,A03,083767,Staff,22,0,30,8
1651043340931,MATH 20E,A01,083771,Staff,2,0,30,28
1651043340931,MATH 20E,A02,083772,Staff,10,0,30,20
1651043340931,MATH 20E,B01,083773,Staff,0,0,30,30
1651043340931,MATH 20E,B02,083774,Staff,0,0,30,30
1651043346961,MATH 103A,A01,083777,Staff,0,17,30,30
1651043346961,MATH 103A,A02,083778,Staff,0,16,30,30
1651043346961,MATH 103A,B01,083779,Staff,0,15,30,30
1651043346961,MATH 103A,B02,083780,Staff,0,13,30,30
1651043352988,MATH 105,A01,085443,Staff,0,23,30,30
1651043359012,MATH 109,A01,083213,Anzaldo; Leesa B,0,8,30,30
1651043359012,MATH 109,A02,083214,Anzaldo; Leesa B,0,7,30,30
1651043359012,MATH 109,B01,083215,Anzaldo; Leesa B,0,8,30,30
1651043359012,MATH 109,B02,083216,Anzaldo; Leesa B,0,8,30,30
1651043365036,MATH 142A,A01,083219,Chow; Bennett,0,15,30,30
1651043365036,MATH 142A,A02,083220,Chow; Bennett,0,15,30,30
1651043365036,MATH 142A,B01,083221,Chow; Bennett,0,16,30,30
1651043365036,MATH 142A,B02,083222,Chow; Bennett,0,14,30,30
1651043371065,MATH 193A,A01,083224,Staff,0,8,30,30
1651043371065,MATH 193A,A02,083225,Staff,0,7,30,30
1651043371065,MATH 193A,A03,083781,Staff,0,7,30,30
1651043371065,MATH 193A,A04,083782,Staff,0,7,30,30
1651043377092,MATH 197,001,091859,McAuley; Julian John,9998,0,9999,1
1651043383163,COGS 9,A01,083615,Staff,0,20,60,60
1651043389186,COGS 11,A01,083617,Boyle; Mary E. T.,13,0,40,27
1651043395209,COGS 13,A01,083071,Staff,0,40,40,40
1651043401328,COGS 14A,A01,092681,Staff,0,40,100,100
1651043407354,COGS 14B,A01,083073,Cheng; Tzu-Han,0,13,50,50
1651043413381,COGS 17,A01,092677,Staff,9,0,75,66
1651043419405,COGS 100,A01,083619,Staff,0,30,60,60
1651043425427,COGS 101A,A01,083621,Davis; Joshua Daniel,0,29,60,60
1651043431455,COGS 101B,A01,091572,Staff,0,7,60,60
1651043437482,COGS 101C,A01,083625,Delgado; Tania,14,0,30,16
1651043443506,COGS 107A,A01,083627,Boyle; Mary E. T.,0,17,60,60
1651043449530,COGS 118A,A01,083075,Staff,0,10,60,60
1651043455561,CSE 3,A50,083646,Miranda; Gregory Joseph,15,0,38,23
1651043455561,CSE 3,A51,083647,Miranda; Gregory Joseph,36,0,37,1
1651043461584,CSE 8A,A50,083650,Miranda; Gregory Joseph,0,31,40,40
1651043467614,CSE 11,A01,083080,Cao; Yingjun,0,97,40,40
1651043473657,CSE 12,A01,083652,Staff,0,25,100,100
1651043479688,CSE 15L,A01,083654,Staff,0,2,50,50
1651043479688,CSE 15L,A02,083655,Staff,0,3,50,50
1651043485720,CSE 20,A01,083657,Staff,46,0,80,34
1651043491746,CSE 30,A01,083084,Eldon; John,0,38,80,80
1651043497781,CSE 100,A01,083659,Cao; Yingjun,0,72,50,50
1651043503812,CSE 134B,A01,083661,Powell; Thomas Allan,0,38,65,65
1651043509852,CSE 140,A01,083663,Staff,0,15,75,75
1651043515875,CSE 140L,A01,083088,Eldon; John,3,0,100,97
1651043521901,CSE 175,A01,083665,Kumar; Rakesh,0,0,25,25
1651043527934,CSE 190,A00,092507,Dubnov; Shlomo,9,0,20,11
1651043533964,ECE 45,A01,083139,Staff,0,7,60,60
1651043539991,ECE 65,A50,083695,Staff,0,7,30,30
1651043546015,ECE 109,A01,091882,Touri; Behrouz,33,0,70,37
1651043552047,ECE 180,A00,083140,Abi Samra; Nicholas Camill,17,0,30,13
1651043552047,ECE 180,B00,083141,Abi Samra; Nicholas Camill,0,0,30,30
1651043558076,MATH 10A,A01,083735,Patchell; Gregory David,0,0,30,30
1651043558076,MATH 10A,A02,083736,Patchell; Gregory David,27,0,30,3
1651043558076,MATH 10A,A03,083737,Patchell; Gregory David,23,0,30,7
1651043564102,MATH 10B,A01,083207,Staff,0,7,30,30
1651043564102,MATH 10B,A02,083208,Staff,0,6,30,30
1651043564102,MATH 10B,B01,083739,Staff,8,0,30,22
1651043564102,MATH 10B,B02,083740,Staff,28,0,30,2
1651043570136,MATH 18,A01,083743,Staff,0,0,30,30
1651043570136,MATH 18,A02,083744,Staff,23,0,30,7
1651043570136,MATH 18,A03,083745,Staff,19,0,30,11
1651043570136,MATH 18,A04,083746,Staff,26,0,30,4
1651043570136,MATH 18,B01,083748,Staff,0,16,30,30
1651043570136,MATH 18,B02,083749,Staff,0,14,30,30
1651043570136,MATH 18,B03,083750,Staff,0,14,30,30
1651043570136,MATH 18,B04,083751,Staff,0,13,30,30
1651043576162,MATH 20A,A01,083754,Staff,18,0,40,22
1651043582185,MATH 20B,A01,083756,Staff,0,14,30,30
1651043582185,MATH 20B,A02,083757,Staff,0,11,30,30
1651043588211,MATH 20C,A01,083760,Staff,0,16,30,30
1651043588211,MATH 20C,A02,083761,Staff,0,15,30,30
1651043588211,MATH 20C,B01,083762,Staff,8,0,30,22
1651043588211,MATH 20C,B02,083763,Staff,28,0,30,2
1651043594249,MATH 20D,A01,083765,Staff,3,1,30,27
1651043594249,MATH 20D,A02,083766,Staff,1,0,30,29
1651043594249,MATH 20D,A03,083767,Staff,22,0,30,8
1651043600275,MATH 20E,A01,083771,Staff,2,0,30,28
1651043600275,MATH 20E,A02,083772,Staff,10,0,30,20
1651043600275,MATH 20E,B01,083773,Staff,0,0,30,30
1651043600275,MATH 20E,B02,083774,Staff,0,0,30,30
1651043606299,MATH 103A,A01,083777,Staff,0,17,30,30
1651043606299,MATH 103A,A02,083778,Staff,0,16,30,30
1651043606299,MATH 103A,B01,083779,Staff,0,15,30,30
1651043606299,MATH 103A,B02,083780,Staff,0,13,30,30
1651043612327,MATH 105,A01,085443,Staff,0,23,30,30
1651043618373,MATH 109,A01,083213,Anzaldo; Leesa B,0,8,30,30
1651043618373,MATH 109,A02,083214,Anzaldo; Leesa B,0,7,30,30
1651043618373,MATH 109,B01,083215,Anzaldo; Leesa B,0,8,30,30
1651043618373,MATH 109,B02,083216,Anzaldo; Leesa B,0,8,30,30
1651043624400,MATH 142A,A01,083219,Chow; Bennett,0,15,30,30
1651043624400,MATH 142A,A02,083220,Chow; Bennett,0,15,30,30
1651043624400,MATH 142A,B01,083221,Chow; Bennett,0,16,30,30
1651043624400,MATH 142A,B02,083222,Chow; Bennett,0,14,30,30
1651043630437,MATH 193A,A01,083224,Staff,0,8,30,30
1651043630437,MATH 193A,A02,083225,Staff,0,7,30,30
1651043630437,MATH 193A,A03,083781,Staff,0,7,30,30
1651043630437,MATH 193A,A04,083782,Staff,0,7,30,30
1651043636484,MATH 197,001,091859,McAuley; Julian John,9998,0,9999,1
1651043642555,COGS 9,A01,083615,Staff,0,20,60,60
1651043648589,COGS 11,A01,083617,Boyle; Mary E. T.,13,0,40,27
1651043654626,COGS 13,A01,083071,Staff,0,40,40,40
1651043660651,COGS 14A,A01,092681,Staff,0,40,100,100
1651043666683,COGS 14B,A01,083073,Cheng; Tzu-Han,0,13,50,50
1651043672726,COGS 17,A01,092677,Staff,9,0,75,66
1651043678807,COGS 100,A01,083619,Staff,0,30,60,60
1651043684869,COGS 101A,A01,083621,Davis; Joshua Daniel,0,29,60,60
1651043690903,COGS 101B,A01,091572,Staff,0,7,60,60
1651043696935,COGS 101C,A01,083625,Delgado; Tania,14,0,30,16
1651043702964,COGS 107A,A01,083627,Boyle; Mary E. T.,0,17,60,60
1651043708988,COGS 118A,A01,083075,Staff,0,10,60,60
1651043715056,CSE 3,A50,083646,Miranda; Gregory Joseph,15,0,38,23
1651043715056,CSE 3,A51,083647,Miranda; Gregory Joseph,36,0,37,1
1651043721087,CSE 8A,A50,083650,Miranda; Gregory Joseph,0,31,40,40
1651043727121,CSE 11,A01,083080,Cao; Yingjun,0,97,40,40
1651043733145,CSE 12,A01,083652,Staff,0,25,100,100
1651043739169,CSE 15L,A01,083654,Staff,0,2,50,50
1651043739169,CSE 15L,A02,083655,Staff,0,3,50,50
1651043745232,CSE 20,A01,083657,Staff,46,0,80,34
1651043751276,CSE 30,A01,083084,Eldon; John,0,38,80,80
1651043757306,CSE 100,A01,083659,Cao; Yingjun,0,72,50,50
1651043763339,CSE 134B,A01,083661,Powell; Thomas Allan,0,38,65,65
1651043769364,CSE 140,A01,083663,Staff,0,15,75,75
1651043775396,CSE 140L,A01,083088,Eldon; John,3,0,100,97
1651043781420,CSE 175,A01,083665,Kumar; Rakesh,0,0,25,25
1651043787452,CSE 190,A00,092507,Dubnov; Shlomo,9,0,20,11
1651043793480,ECE 45,A01,083139,Staff,0,7,60,60
1651043799516,ECE 65,A50,083695,Staff,0,7,30,30
1651043805546,ECE 109,A01,091882,Touri; Behrouz,33,0,70,37
1651043811572,ECE 180,A00,083140,Abi Samra; Nicholas Camill,17,0,30,13
1651043811572,ECE 180,B00,083141,Abi Samra; Nicholas Camill,0,0,30,30
1651043817596,MATH 10A,A01,083735,Patchell; Gregory David,0,0,30,30
1651043817596,MATH 10A,A02,083736,Patchell; Gregory David,27,0,30,3
1651043817596,MATH 10A,A03,083737,Patchell; Gregory David,23,0,30,7
1651043823622,MATH 10B,A01,083207,Staff,0,7,30,30
1651043823622,MATH 10B,A02,083208,Staff,0,6,30,30
1651043823622,MATH 10B,B01,083739,Staff,8,0,30,22
1651043823622,MATH 10B,B02,083740,Staff,28,0,30,2
1651043829654,MATH 18,A01,083743,Staff,0,0,30,30
1651043829654,MATH 18,A02,083744,Staff,23,0,30,7
1651043829654,MATH 18,A03,083745,Staff,19,0,30,11
1651043829654,MATH 18,A04,083746,Staff,26,0,30,4
1651043829654,MATH 18,B01,083748,Staff,0,16,30,30
1651043829654,MATH 18,B02,083749,Staff,0,14,30,30
1651043829654,MATH 18,B03,083750,Staff,0,14,30,30
1651043829654,MATH 18,B04,083751,Staff,0,13,30,30
1651043835687,MATH 20A,A01,083754,Staff,18,0,40,22
1651043841711,MATH 20B,A01,083756,Staff,0,14,30,30
1651043841711,MATH 20B,A02,083757,Staff,0,11,30,30
1651043847735,MATH 20C,A01,083760,Staff,0,16,30,30
1651043847735,MATH 20C,A02,083761,Staff,0,15,30,30
1651043847735,MATH 20C,B01,083762,Staff,8,0,30,22
1651043847735,MATH 20C,B02,083763,Staff,28,0,30,2
1651043853764,MATH 20D,A01,083765,Staff,3,1,30,27
1651043853764,MATH 20D,A02,083766,Staff,1,0,30,29
1651043853764,MATH 20D,A03,083767,Staff,22,0,30,8
1651043859788,MATH 20E,A01,083771,Staff,2,0,30,28
1651043859788,MATH 20E,A02,083772,Staff,10,0,30,20
1651043859788,MATH 20E,B01,083773,Staff,0,0,30,30
1651043859788,MATH 20E,B02,083774,Staff,0,0,30,30
1651043865818,MATH 103A,A01,083777,Staff,0,17,30,30
1651043865818,MATH 103A,A02,083778,Staff,0,16,30,30
1651043865818,MATH 103A,B01,083779,Staff,0,15,30,30
1651043865818,MATH 103A,B02,083780,Staff,0,13,30,30
1651043871849,MATH 105,A01,085443,Staff,0,23,30,30
1651043877891,MATH 109,A01,083213,Anzaldo; Leesa B,0,8,30,30
1651043877891,MATH 109,A02,083214,Anzaldo; Leesa B,0,7,30,30
1651043877891,MATH 109,B01,083215,Anzaldo; Leesa B,0,8,30,30
1651043877891,MATH 109,B02,083216,Anzaldo; Leesa B,0,8,30,30
1651043883963,MATH 142A,A01,083219,Chow; Bennett,0,15,30,30
1651043883963,MATH 142A,A02,083220,Chow; Bennett,0,15,30,30
1651043883963,MATH 142A,B01,083221,Chow; Bennett,0,16,30,30
1651043883963,MATH 142A,B02,083222,Chow; Bennett,0,14,30,30
1651043889987,MATH 193A,A01,083224,Staff,0,8,30,30
1651043889987,MATH 193A,A02,083225,Staff,0,7,30,30
1651043889987,MATH 193A,A03,083781,Staff,0,7,30,30
1651043889987,MATH 193A,A04,083782,Staff,0,7,30,30
1651043896012,MATH 197,001,091859,McAuley; Julian John,9998,0,9999,1
1651043902064,COGS 9,A01,083615,Staff,0,20,60,60
1651043908089,COGS 11,A01,083617,Boyle; Mary E. T.,13,0,40,27
1651043914115,COGS 13,A01,083071,Staff,0,40,40,40
1651043920139,COGS 14A,A01,092681,Staff,0,40,100,100
1651043926164,COGS 14B,A01,083073,Cheng; Tzu-Han,0,13,50,50
1651043932187,COGS 17,A01,092677,Staff,9,0,75,66
1651043938215,COGS 100,A01,083619,Staff,0,30,60,60
1651043944245,COGS 101A,A01,083621,Davis; Joshua Daniel,0,29,60,60
1651043950280,COGS 101B,A01,091572,Staff,0,7,60,60
1651043956312,COGS 101C,A01,083625,Delgado; Tania,14,0,30,16
1651043962336,COGS 107A,A01,083627,Boyle; Mary E. T.,0,17,60,60
1651043968363,COGS 118A,A01,083075,Staff,0,10,60,60
1651043974394,CSE 3,A50,083646,Miranda; Gregory Joseph,15,0,38,23
1651043974394,CSE 3,A51,083647,Miranda; Gregory Joseph,36,0,37,1
1651043980423,CSE 8A,A50,083650,Miranda; Gregory Joseph,0,31,40,40
1651043986447,CSE 11,A01,083080,Cao; Yingjun,1,97,40,39
1651043992475,CSE 12,A01,083652,Staff,0,25,100,100
1651043998606,CSE 15L,A01,083654,Staff,0,2,50,50
1651043998606,CSE 15L,A02,083655,Staff,0,3,50,50
1651044004629,CSE 20,A01,083657,Staff,46,0,80,34
1651044010652,CSE 30,A01,083084,Eldon; John,0,38,80,80
1651044016681,CSE 100,A01,083659,Cao; Yingjun,0,72,50,50
1651044022708,CSE 134B,A01,083661,Powell; Thomas Allan,0,38,65,65
1651044028732,CSE 140,A01,083663,Staff,0,15,75,75
1651044034754,CSE 140L,A01,083088,Eldon; John,3,0,100,97
1651044040779,CSE 175,A01,083665,Kumar; Rakesh,0,0,25,25
1651044046803,CSE 190,A00,092507,Dubnov; Shlomo,9,0,20,11
1651044052830,ECE 45,A01,083139,Staff,0,7,60,60
1651044058855,ECE 65,A50,083695,Staff,0,7,30,30
1651044064878,ECE 109,A01,091882,Touri; Behrouz,33,0,70,37
1651044070921,ECE 180,A00,083140,Abi Samra; Nicholas Camill,17,0,30,13
1651044070921,ECE 180,B00,083141,Abi Samra; Nicholas Camill,0,0,30,30
1651044076948,MATH 10A,A01,083735,Patchell; Gregory David,0,0,30,30
1651044076948,MATH 10A,A02,083736,Patchell; Gregory David,27,0,30,3
1651044076948,MATH 10A,A03,083737,Patchell; Gregory David,23,0,30,7
1651044082977,MATH 10B,A01,083207,Staff,0,7,30,30
1651044082977,MATH 10B,A02,083208,Staff,0,6,30,30
1651044082977,MATH 10B,B01,083739,Staff,8,0,30,22
1651044082977,MATH 10B,B02,083740,Staff,28,0,30,2
1651044089005,MATH 18,A01,083743,Staff,0,0,30,30
1651044089005,MATH 18,A02,083744,Staff,23,0,30,7
1651044089005,MATH 18,A03,083745,Staff,19,0,30,11
1651044089005,MATH 18,A04,083746,Staff,26,0,30,4
1651044089005,MATH 18,B01,083748,Staff,0,16,30,30
1651044089005,MATH 18,B02,083749,Staff,0,14,30,30
1651044089005,MATH 18,B03,083750,Staff,0,14,30,30
1651044089005,MATH 18,B04,083751,Staff,0,13,30,30
1651044095031,MATH 20A,A01,083754,Staff,18,0,40,22
1651044101057,MATH 20B,A01,083756,Staff,0,14,30,30
1651044101057,MATH 20B,A02,083757,Staff,0,11,30,30
1651044107082,MATH 20C,A01,083760,Staff,0,16,30,30
1651044107082,MATH 20C,A02,083761,Staff,0,15,30,30
1651044107082,MATH 20C,B01,083762,Staff,8,0,30,22
1651044107082,MATH 20C,B02,083763,Staff,28,0,30,2
1651044113108,MATH 20D,A01,083765,Staff,3,1,30,27
1651044113108,MATH 20D,A02,083766,Staff,1,0,30,29
1651044113108,MATH 20D,A03,083767,Staff,22,0,30,8
1651044119144,MATH 20E,A01,083771,Staff,2,0,30,28
1651044119144,MATH 20E,A02,083772,Staff,10,0,30,20
1651044119144,MATH 20E,B01,083773,Staff,0,0,30,30
1651044119144,MATH 20E,B02,083774,Staff,0,0,30,30
1651044125170,MATH 103A,A01,083777,Staff,0,17,30,30
1651044125170,MATH 103A,A02,083778,Staff,0,16,30,30
1651044125170,MATH 103A,B01,083779,Staff,0,15,30,30
1651044125170,MATH 103A,B02,083780,Staff,0,13,30,30
1651044131197,MATH 105,A01,085443,Staff,0,23,30,30
1651044137225,MATH 109,A01,083213,Anzaldo; Leesa B,0,8,30,30
1651044137225,MATH 109,A02,083214,Anzaldo; Leesa B,0,7,30,30
1651044137225,MATH 109,B01,083215,Anzaldo; Leesa B,0,8,30,30
1651044137225,MATH 109,B02,083216,Anzaldo; Leesa B,0,8,30,30
1651044143253,MATH 142A,A01,083219,Chow; Bennett,0,15,30,30
1651044143253,MATH 142A,A02,083220,Chow; Bennett,0,15,30,30
1651044143253,MATH 142A,B01,083221,Chow; Bennett,0,16,30,30
1651044143253,MATH 142A,B02,083222,Chow; Bennett,0,14,30,30
1651044149278,MATH 193A,A01,083224,Staff,0,8,30,30
1651044149278,MATH 193A,A02,083225,Staff,0,7,30,30
1651044149278,MATH 193A,A03,083781,Staff,0,7,30,30
1651044149278,MATH 193A,A04,083782,Staff,0,7,30,30
1651044155303,MATH 197,001,091859,McAuley; Julian John,9998,0,9999,1
1651044161371,COGS 9,A01,083615,Staff,0,20,60,60
1651044167396,COGS 11,A01,083617,Boyle; Mary E. T.,13,0,40,27
1651044173419,COGS 13,A01,083071,Staff,0,40,40,40
1651044179442,COGS 14A,A01,092681,Staff,0,40,100,100
1651044185469,COGS 14B,A01,083073,Cheng; Tzu-Han,0,13,50,50
1651044191491,COGS 17,A01,092677,Staff,9,0,75,66
1651044197517,COGS 100,A01,083619,Staff,0,30,60,60
1651044203546,COGS 101A,A01,083621,Davis; Joshua Daniel,0,29,60,60
1651044209570,COGS 101B,A01,091572,Staff,0,7,60,60
1651044215594,COGS 101C,A01,083625,Delgado; Tania,14,0,30,16
1651044221615,COGS 107A,A01,083627,Boyle; Mary E. T.,0,17,60,60
1651044227642,COGS 118A,A01,083075,Staff,0,10,60,60
1651044233665,CSE 3,A50,083646,Miranda; Gregory Joseph,15,0,38,23
1651044233665,CSE 3,A51,083647,Miranda; Gregory Joseph,36,0,37,1
1651044239687,CSE 8A,A50,083650,Miranda; Gregory Joseph,0,31,40,40
1651044245711,CSE 11,A01,083080,Cao; Yingjun,1,97,40,39
1651044251733,CSE 12,A01,083652,Staff,0,25,100,100
1651044257757,CSE 15L,A01,083654,Staff,0,2,50,50
1651044257757,CSE 15L,A02,083655,Staff,0,3,50,50
1651044263780,CSE 20,A01,083657,Staff,46,0,80,34
1651044269808,CSE 30,A01,083084,Eldon; John,0,38,80,80
1651044275832,CSE 100,A01,083659,Cao; Yingjun,0,72,50,50
1651044281861,CSE 134B,A01,083661,Powell; Thomas Allan,0,38,65,65
1651044287887,CSE 140,A01,083663,Staff,0,15,75,75
1651044293911,CSE 140L,A01,083088,Eldon; John,3,0,100,97
1651044299939,CSE 175,A01,083665,Kumar; Rakesh,0,0,25,25
1651044305965,CSE 190,A00,092507,Dubnov; Shlomo,9,0,20,11
1651044311989,ECE 45,A01,083139,Staff,0,7,60,60
1651044318013,ECE 65,A50,083695,Staff,0,7,30,30
1651044324040,ECE 109,A01,091882,Touri; Behrouz,33,0,70,37
1651044330064,ECE 180,A00,083140,Abi Samra; Nicholas Camill,17,0,30,13
1651044330064,ECE 180,B00,083141,Abi Samra; Nicholas Camill,0,0,30,30
1651044336090,MATH 10A,A01,083735,Patchell; Gregory David,0,0,30,30
1651044336090,MATH 10A,A02,083736,Patchell; Gregory David,27,0,30,3
1651044336090,MATH 10A,A03,083737,Patchell; Gregory David,23,0,30,7
1651044342115,MATH 10B,A01,083207,Staff,0,7,30,30
1651044342115,MATH 10B,A02,083208,Staff,0,6,30,30
1651044342115,MATH 10B,B01,083739,Staff,8,0,30,22
1651044342115,MATH 10B,B02,083740,Staff,28,0,30,2
1651044348146,MATH 18,A01,083743,Staff,0,0,30,30
1651044348146,MATH 18,A02,083744,Staff,23,0,30,7
1651044348146,MATH 18,A03,083745,Staff,19,0,30,11
1651044348146,MATH 18,A04,083746,Staff,26,0,30,4
1651044348146,MATH 18,B01,083748,Staff,0,16,30,30
1651044348146,MATH 18,B02,083749,Staff,0,14,30,30
1651044348146,MATH 18,B03,083750,Staff,0,14,30,30
1651044348146,MATH 18,B04,083751,Staff,0,13,30,30
1651044354169,MATH 20A,A01,083754,Staff,18,0,40,22
1651044360193,MATH 20B,A01,083756,Staff,0,14,30,30
1651044360193,MATH 20B,A02,083757,Staff,0,11,30,30
1651044366221,MATH 20C,A01,083760,Staff,0,16,30,30
1651044366221,MATH 20C,A02,083761,Staff,0,15,30,30
1651044366221,MATH 20C,B01,083762,Staff,8,0,30,22
1651044366221,MATH 20C,B02,083763,Staff,28,0,30,2
1651044372246,MATH 20D,A01,083765,Staff,3,1,30,27
1651044372246,MATH 20D,A02,083766,Staff,1,0,30,29
1651044372246,MATH 20D,A03,083767,Staff,22,0,30,8
1651044378270,MATH 20E,A01,083771,Staff,2,0,30,28
1651044378270,MATH 20E,A02,083772,Staff,10,0,30,20
1651044378270,MATH 20E,B01,083773,Staff,0,0,30,30
1651044378270,MATH 20E,B02,083774,Staff,0,0,30,30
1651044384297,MATH 103A,A01,083777,Staff,0,17,30,30
1651044384297,MATH 103A,A02,083778,Staff,0,16,30,30
1651044384297,MATH 103A,B01,083779,Staff,0,15,30,30
1651044384297,MATH 103A,B02,083780,Staff,0,13,30,30
1651044390321,MATH 105,A01,085443,Staff,0,23,30,30
1651044396345,MATH 109,A01,083213,Anzaldo; Leesa B,0,8,30,30
1651044396345,MATH 109,A02,083214,Anzaldo; Leesa B,0,7,30,30
1651044396345,MATH 109,B01,083215,Anzaldo; Leesa B,0,8,30,30
1651044396345,MATH 109,B02,083216,Anzaldo; Leesa B,0,8,30,30
1651044402374,MATH 142A,A01,083219,Chow; Bennett,0,15,30,30
1651044402374,MATH 142A,A02,083220,Chow; Bennett,0,15,30,30
1651044402374,MATH 142A,B01,083221,Chow; Bennett,0,16,30,30
1651044402374,MATH 142A,B02,083222,Chow; Bennett,0,14,30,30
1651044408397,MATH 193A,A01,083224,Staff,0,8,30,30
1651044408397,MATH 193A,A02,083225,Staff,0,7,30,30
1651044408397,MATH 193A,A03,083781,Staff,0,7,30,30
1651044408397,MATH 193A,A04,083782,Staff,0,7,30,30
1651044414445,MATH 197,001,091859,McAuley; Julian John,9998,0,9999,1
1651044420513,COGS 9,A01,083615,Staff,0,20,60,60
1651044426539,COGS 11,A01,083617,Boyle; Mary E. T.,13,0,40,27
1651044432562,COGS 13,A01,083071,Staff,0,40,40,40
1651044438584,COGS 14A,A01,092681,Staff,0,40,100,100
1651044444608,COGS 14B,A01,083073,Cheng; Tzu-Han,0,13,50,50
1651044450637,COGS 17,A01,092677,Staff,9,0,75,66
1651044456662,COGS 100,A01,083619,Staff,0,30,60,60
1651044462687,COGS 101A,A01,083621,Davis; Joshua Daniel,0,29,60,60
1651044468715,COGS 101B,A01,091572,Staff,0,7,60,60
1651044474742,COGS 101C,A01,083625,Delgado; Tania,14,0,30,16
1651044480766,COGS 107A,A01,083627,Boyle; Mary E. T.,0,17,60,60
1651044486797,COGS 118A,A01,083075,Staff,0,10,60,60
1651044492822,CSE 3,A50,083646,Miranda; Gregory Joseph,15,0,38,23
1651044492822,CSE 3,A51,083647,Miranda; Gregory Joseph,36,0,37,1
1651044498847,CSE 8A,A50,083650,Miranda; Gregory Joseph,0,31,40,40
1651044504873,CSE 11,A01,083080,Cao; Yingjun,1,97,40,39
1651044510896,CSE 12,A01,083652,Staff,0,25,100,100
1651044516923,CSE 15L,A01,083654,Staff,0,2,50,50
1651044516923,CSE 15L,A02,083655,Staff,0,3,50,50
1651044522948,CSE 20,A01,083657,Staff,46,0,80,34
1651044528974,CSE 30,A01,083084,Eldon; John,0,38,80,80
1651044535000,CSE 100,A01,083659,Cao; Yingjun,0,72,50,50
1651044541029,CSE 134B,A01,083661,Powell; Thomas Allan,0,38,65,65
1651044547056,CSE 140,A01,083663,Staff,0,15,75,75
1651044553078,CSE 140L,A01,083088,Eldon; John,3,0,100,97
1651044559105,CSE 175,A01,083665,Kumar; Rakesh,0,0,25,25
1651044565129,CSE 190,A00,092507,Dubnov; Shlomo,9,0,20,11
1651044571155,ECE 45,A01,083139,Staff,0,7,60,60
1651044577179,ECE 65,A50,083695,Staff,0,7,30,30
1651044583202,ECE 109,A01,091882,Touri; Behrouz,33,0,70,37
1651044589228,ECE 180,A00,083140,Abi Samra; Nicholas Camill,17,0,30,13
1651044589228,ECE 180,B00,083141,Abi Samra; Nicholas Camill,0,0,30,30
1651044595346,MATH 10A,A01,083735,Patchell; Gregory David,0,0,30,30
1651044595346,MATH 10A,A02,083736,Patchell; Gregory David,27,0,30,3
1651044595346,MATH 10A,A03,083737,Patchell; Gregory David,23,0,30,7
1651044601375,MATH 10B,A01,083207,Staff,0,7,30,30
1651044601375,MATH 10B,A02,083208,Staff,0,6,30,30
1651044601375,MATH 10B,B01,083739,Staff,8,0,30,22
1651044601375,MATH 10B,B02,083740,Staff,28,0,30,2
1651044607407,MATH 18,A01,083743,Staff,0,0,30,30
1651044607407,MATH 18,A02,083744,Staff,23,0,30,7
1651044607407,MATH 18,A03,083745,Staff,19,0,30,11
1651044607407,MATH 18,A04,083746,Staff,26,0,30,4
1651044607407,MATH 18,B01,083748,Staff,0,16,30,30
1651044607407,MATH 18,B02,083749,Staff,0,14,30,30
1651044607407,MATH 18,B03,083750,Staff,0,14,30,30
1651044607407,MATH 18,B04,083751,Staff,0,13,30,30
1651044613432,MATH 20A,A01,083754,Staff,18,0,40,22
1651044619460,MATH 20B,A01,083756,Staff,0,14,30,30
1651044619460,MATH 20B,A02,083757,Staff,0,11,30,30
1651044625485,MATH 20C,A01,083760,Staff,0,16,30,30
1651044625485,MATH 20C,A02,083761,Staff,0,15,30,30
1651044625485,MATH 20C,B01,083762,Staff,8,0,30,22
1651044625485,MATH 20C,B02,083763,Staff,28,0,30,2
1651044631508,MATH 20D,A01,083765,Staff,3,1,30,27
1651044631508,MATH 20D,A02,083766,Staff,1,0,30,29
1651044631508,MATH 20D,A03,083767,Staff,22,0,30,8
1651044637538,MATH 20E,A01,083771,Staff,2,0,30,28
1651044637538,MATH 20E,A02,083772,Staff,10,0,30,20
1651044637538,MATH 20E,B01,083773,Staff,0,0,30,30
1651044637538,MATH 20E,B02,083774,Staff,0,0,30,30
1651044643563,MATH 103A,A01,083777,Staff,0,17,30,30
1651044643563,MATH 103A,A02,083778,Staff,0,16,30,30
1651044643563,MATH 103A,B01,083779,Staff,0,15,30,30
1651044643563,MATH 103A,B02,083780,Staff,0,13,30,30
1651044649587,MATH 105,A01,085443,Staff,0,23,30,30
1651044655611,MATH 109,A01,083213,Anzaldo; Leesa B,0,8,30,30
1651044655611,MATH 109,A02,083214,Anzaldo; Leesa B,0,7,30,30
1651044655611,MATH 109,B01,083215,Anzaldo; Leesa B,0,8,30,30
1651044655611,MATH 109,B02,083216,Anzaldo; Leesa B,0,8,30,30
1651044661639,MATH 142A,A01,083219,Chow; Bennett,0,15,30,30
1651044661639,MATH 142A,A02,083220,Chow; Bennett,0,15,30,30
1651044661639,MATH 142A,B01,083221,Chow; Bennett,0,16,30,30
1651044661639,MATH 142A,B02,083222,Chow; Bennett,0,14,30,30
1651044667662,MATH 193A,A01,083224,Staff,0,8,30,30
1651044667662,MATH 193A,A02,083225,Staff,0,7,30,30
1651044667662,MATH 193A,A03,083781,Staff,0,7,30,30
1651044667662,MATH 193A,A04,083782,Staff,0,7,30,30
1651044673689,MATH 197,001,091859,McAuley; Julian John,9998,0,9999,1
1651044679745,COGS 9,A01,083615,Staff,0,20,60,60
1651044685772,COGS 11,A01,083617,Boyle; Mary E. T.,13,0,40,27
1651044691799,COGS 13,A01,083071,Staff,0,40,40,40
1651044697823,COGS 14A,A01,092681,Staff,0,40,100,100
1651044703850,COGS 14B,A01,083073,Cheng; Tzu-Han,0,13,50,50
1651044709875,COGS 17,A01,092677,Staff,9,0,75,66
1651044715901,COGS 100,A01,083619,Staff,0,30,60,60
1651044721925,COGS 101A,A01,083621,Davis; Joshua Daniel,0,29,60,60
1651044727950,COGS 101B,A01,091572,Staff,0,7,60,60
1651044733977,COGS 101C,A01,083625,Delgado; Tania,14,0,30,16
1651044740001,COGS 107A,A01,083627,Boyle; Mary E. T.,0,17,60,60
1651044746023,COGS 118A,A01,083075,Staff,0,10,60,60
1651044752062,CSE 3,A50,083646,Miranda; Gregory Joseph,15,0,38,23
1651044752062,CSE 3,A51,083647,Miranda; Gregory Joseph,36,0,37,1
1651044758097,CSE 8A,A50,083650,Miranda; Gregory Joseph,0,31,40,40
1651044764128,CSE 11,A01,083080,Cao; Yingjun,1,97,40,39
1651044770156,CSE 12,A01,083652,Staff,0,25,100,100
1651044776180,CSE 15L,A01,083654,Staff,0,2,50,50
1651044776180,CSE 15L,A02,083655,Staff,0,3,50,50
1651044782204,CSE 20,A01,083657,Staff,46,0,80,34
1651044788228,CSE 30,A01,083084,Eldon; John,0,38,80,80
1651044794252,CSE 100,A01,083659,Cao; Yingjun,0,72,50,50
1651044800281,CSE 134B,A01,083661,Powell; Thomas Allan,0,38,65,65
1651044806305,CSE 140,A01,083663,Staff,0,15,75,75
1651044812330,CSE 140L,A01,083088,Eldon; John,3,0,100,97
1651044818368,CSE 175,A01,083665,Kumar; Rakesh,0,0,25,25
1651044824393,CSE 190,A00,092507,Dubnov; Shlomo,9,0,20,11
1651044830421,ECE 45,A01,083139,Staff,0,7,60,60
1651044836453,ECE 65,A50,083695,Staff,0,7,30,30
1651044842485,ECE 109,A01,091882,Touri; Behrouz,33,0,70,37
1651044848517,ECE 180,A00,083140,Abi Samra; Nicholas Camill,17,0,30,13
1651044848517,ECE 180,B00,083141,Abi Samra; Nicholas Camill,0,0,30,30
1651044854540,MATH 10A,A01,083735,Patchell; Gregory David,0,0,30,30
1651044854540,MATH 10A,A02,083736,Patchell; Gregory David,27,0,30,3
1651044854540,MATH 10A,A03,083737,Patchell; Gregory David,23,0,30,7
1651044860570,MATH 10B,A01,083207,Staff,0,7,30,30
1651044860570,MATH 10B,A02,083208,Staff,0,6,30,30
1651044860570,MATH 10B,B01,083739,Staff,8,0,30,22
1651044860570,MATH 10B,B02,083740,Staff,28,0,30,2
1651044866610,MATH 18,A01,083743,Staff,0,0,30,30
1651044866610,MATH 18,A02,083744,Staff,23,0,30,7
1651044866610,MATH 18,A03,083745,Staff,19,0,30,11
1651044866610,MATH 18,A04,083746,Staff,26,0,30,4
1651044866610,MATH 18,B01,083748,Staff,0,16,30,30
1651044866610,MATH 18,B02,083749,Staff,0,14,30,30
1651044866610,MATH 18,B03,083750,Staff,0,14,30,30
1651044866610,MATH 18,B04,083751,Staff,0,13,30,30
1651044872636,MATH 20A,A01,083754,Staff,18,0,40,22
1651044878660,MATH 20B,A01,083756,Staff,0,14,30,30
1651044878660,MATH 20B,A02,083757,Staff,0,11,30,30
1651044884689,MATH 20C,A01,083760,Staff,0,16,30,30
1651044884689,MATH 20C,A02,083761,Staff,0,15,30,30
1651044884689,MATH 20C,B01,083762,Staff,8,0,30,22
1651044884689,MATH 20C,B02,083763,Staff,28,0,30,2
1651044890715,MATH 20D,A01,083765,Staff,3,1,30,27
1651044890715,MATH 20D,A02,083766,Staff,1,0,30,29
1651044890715,MATH 20D,A03,083767,Staff,22,0,30,8
1651044896745,MATH 20E,A01,083771,Staff,2,0,30,28
1651044896745,MATH 20E,A02,083772,Staff,10,0,30,20
1651044896745,MATH 20E,B01,083773,Staff,0,0,30,30
1651044896745,MATH 20E,B02,083774,Staff,0,0,30,30
1651044902775,MATH 103A,A01,083777,Staff,0,17,30,30
1651044902775,MATH 103A,A02,083778,Staff,0,16,30,30
1651044902775,MATH 103A,B01,083779,Staff,0,15,30,30
1651044902775,MATH 103A,B02,083780,Staff,0,13,30,30
1651044908801,MATH 105,A01,085443,Staff,0,23,30,30
1651044914826,MATH 109,A01,083213,Anzaldo; Leesa B,0,8,30,30
1651044914826,MATH 109,A02,083214,Anzaldo; Leesa B,0,7,30,30
1651044914826,MATH 109,B01,083215,Anzaldo; Leesa B,0,8,30,30
1651044914826,MATH 109,B02,083216,Anzaldo; Leesa B,0,8,30,30
1651044920862,MATH 142A,A01,083219,Chow; Bennett,0,15,30,30
1651044920862,MATH 142A,A02,083220,Chow; Bennett,0,15,30,30
1651044920862,MATH 142A,B01,083221,Chow; Bennett,0,16,30,30
1651044920862,MATH 142A,B02,083222,Chow; Bennett,0,14,30,30
1651044926889,MATH 193A,A01,083224,Staff,0,8,30,30
1651044926889,MATH 193A,A02,083225,Staff,0,7,30,30
1651044926889,MATH 193A,A03,083781,Staff,0,7,30,30
1651044926889,MATH 193A,A04,083782,Staff,0,7,30,30
1651044932915,MATH 197,001,091859,McAuley; Julian John,9998,0,9999,1
1651044938983,COGS 9,A01,083615,Staff,0,20,60,60
1651044945018,COGS 11,A01,083617,Boyle; Mary E. T.,13,0,40,27
1651044951058,COGS 13,A01,083071,Staff,0,40,40,40
1651044957090,COGS 14A,A01,092681,Staff,0,40,100,100
1651044963115,COGS 14B,A01,083073,Cheng; Tzu-Han,0,13,50,50
1651044969142,COGS 17,A01,092677,Staff,9,0,75,66
1651044975166,COGS 100,A01,083619,Staff,0,30,60,60
1651044981192,COGS 101A,A01,083621,Davis; Joshua Daniel,0,29,60,60
1651044987216,COGS 101B,A01,091572,Staff,0,7,60,60
1651044993241,COGS 101C,A01,083625,Delgado; Tania,14,0,30,16
1651044999271,COGS 107A,A01,083627,Boyle; Mary E. T.,0,17,60,60
1651045005295,COGS 118A,A01,083075,Staff,0,10,60,60
1651045011324,CSE 3,A50,083646,Miranda; Gregory Joseph,15,0,38,23
1651045011324,CSE 3,A51,083647,Miranda; Gregory Joseph,36,0,37,1
1651045017347,CSE 8A,A50,083650,Miranda; Gregory Joseph,0,31,40,40
1651045023370,CSE 11,A01,083080,Cao; Yingjun,1,97,40,39
1651045029401,CSE 12,A01,083652,Staff,0,25,100,100
1651045035425,CSE 15L,A01,083654,Staff,0,2,50,50
1651045035425,CSE 15L,A02,083655,Staff,0,3,50,50
1651045041458,CSE 20,A01,083657,Staff,46,0,80,34
1651045047483,CSE 30,A01,083084,Eldon; John,0,38,80,80
1651045053515,CSE 100,A01,083659,Cao; Yingjun,0,72,50,50
1651045059539,CSE 134B,A01,083661,Powell; Thomas Allan,0,38,65,65
1651045065562,CSE 140,A01,083663,Staff,0,15,75,75
1651045071596,CSE 140L,A01,083088,Eldon; John,3,0,100,97
1651045077621,CSE 175,A01,083665,Kumar; Rakesh,0,0,25,25
1651045083648,CSE 190,A00,092507,Dubnov; Shlomo,9,0,20,11
1651045089673,ECE 45,A01,083139,Staff,0,7,60,60
1651045095697,ECE 65,A50,083695,Staff,0,7,30,30
1651045101727,ECE 109,A01,091882,Touri; Behrouz,33,0,70,37
1651045107756,ECE 180,A00,083140,Abi Samra; Nicholas Camill,17,0,30,13
1651045107756,ECE 180,B00,083141,Abi Samra; Nicholas Camill,0,0,30,30
1651045113793,MATH 10A,A01,083735,Patchell; Gregory David,0,0,30,30
1651045113793,MATH 10A,A02,083736,Patchell; Gregory David,27,0,30,3
1651045113793,MATH 10A,A03,083737,Patchell; Gregory David,23,0,30,7
1651045119824,MATH 10B,A01,083207,Staff,0,7,30,30
1651045119824,MATH 10B,A02,083208,Staff,0,6,30,30
1651045119824,MATH 10B,B01,083739,Staff,8,0,30,22
1651045119824,MATH 10B,B02,083740,Staff,28,0,30,2
1651045125858,MATH 18,A01,083743,Staff,0,0,30,30
1651045125858,MATH 18,A02,083744,Staff,23,0,30,7
1651045125858,MATH 18,A03,083745,Staff,19,0,30,11
1651045125858,MATH 18,A04,083746,Staff,26,0,30,4
1651045125858,MATH 18,B01,083748,Staff,0,16,30,30
1651045125858,MATH 18,B02,083749,Staff,0,14,30,30
1651045125858,MATH 18,B03,083750,Staff,0,14,30,30
1651045125858,MATH 18,B04,083751,Staff,0,13,30,30
1651045131886,MATH 20A,A01,083754,Staff,18,0,40,22
1651045137912,MATH 20B,A01,083756,Staff,0,14,30,30
1651045137912,MATH 20B,A02,083757,Staff,0,11,30,30
1651045143942,MATH 20C,A01,083760,Staff,0,16,30,30
1651045143942,MATH 20C,A02,083761,Staff,0,15,30,30
1651045143942,MATH 20C,B01,083762,Staff,8,0,30,22
1651045143942,MATH 20C,B02,083763,Staff,28,0,30,2
1651045149975,MATH 20D,A01,083765,Staff,3,1,30,27
1651045149975,MATH 20D,A02,083766,Staff,1,0,30,29
1651045149975,MATH 20D,A03,083767,Staff,22,0,30,8
1651045156000,MATH 20E,A01,083771,Staff,2,0,30,28
1651045156000,MATH 20E,A02,083772,Staff,10,0,30,20
1651045156000,MATH 20E,B01,083773,Staff,0,0,30,30
1651045156000,MATH 20E,B02,083774,Staff,0,0,30,30
1651045162032,MATH 103A,A01,083777,Staff,0,17,30,30
1651045162032,MATH 103A,A02,083778,Staff,0,16,30,30
1651045162032,MATH 103A,B01,083779,Staff,0,15,30,30
1651045162032,MATH 103A,B02,083780,Staff,0,13,30,30
1651045168057,MATH 105,A01,085443,Staff,0,23,30,30
1651045174113,MATH 109,A01,083213,Anzaldo; Leesa B,0,7,30,30
1651045174113,MATH 109,A02,083214,Anzaldo; Leesa B,0,7,30,30
1651045174113,MATH 109,B01,083215,Anzaldo; Leesa B,0,8,30,30
1651045174113,MATH 109,B02,083216,Anzaldo; Leesa B,0,8,30,30
1651045180138,MATH 142A,A01,083219,Chow; Bennett,0,15,30,30
1651045180138,MATH 142A,A02,083220,Chow; Bennett,0,15,30,30
1651045180138,MATH 142A,B01,083221,Chow; Bennett,0,16,30,30
1651045180138,MATH 142A,B02,083222,Chow; Bennett,0,14,30,30
1651045186163,MATH 193A,A01,083224,Staff,0,8,30,30
1651045186163,MATH 193A,A02,083225,Staff,0,7,30,30
1651045186163,MATH 193A,A03,083781,Staff,0,7,30,30
1651045186163,MATH 193A,A04,083782,Staff,0,7,30,30
1651045192281,MATH 197,001,091859,McAuley; Julian John,9998,0,9999,1
1651045198348,COGS 9,A01,083615,Staff,0,20,60,60
1651045204379,COGS 11,A01,083617,Boyle; Mary E. T.,13,0,40,27
1651045210406,COGS 13,A01,083071,Staff,0,40,40,40
1651045216437,COGS 14A,A01,092681,Staff,0,40,100,100
1651045222462,COGS 14B,A01,083073,Cheng; Tzu-Han,0,13,50,50
1651045228485,COGS 17,A01,092677,Staff,9,0,75,66
1651045234514,COGS 100,A01,083619,Staff,0,30,60,60
1651045240539,COGS 101A,A01,083621,Davis; Joshua Daniel,0,29,60,60
1651045246574,COGS 101B,A01,091572,Staff,0,7,60,60
1651045252618,COGS 101C,A01,083625,Delgado; Tania,14,0,30,16
1651045258649,COGS 107A,A01,083627,Boyle; Mary E. T.,0,17,60,60
1651045264674,COGS 118A,A01,083075,Staff,0,10,60,60
1651045270708,CSE 3,A50,083646,Miranda; Gregory Joseph,15,0,38,23
1651045270708,CSE 3,A51,083647,Miranda; Gregory Joseph,36,0,37,1
1651045276731,CSE 8A,A50,083650,Miranda; Gregory Joseph,0,31,40,40
1651045282756,CSE 11,A01,083080,Cao; Yingjun,1,97,40,39
1651045288786,CSE 12,A01,083652,Staff,0,25,100,100
1651045294809,CSE 15L,A01,083654,Staff,0,2,50,50
1651045294809,CSE 15L,A02,083655,Staff,0,3,50,50
1651045300833,CSE 20,A01,083657,Staff,46,0,80,34
1651045306858,CSE 30,A01,083084,Eldon; John,0,38,80,80
1651045312884,CSE 100,A01,083659,Cao; Yingjun,0,72,50,50
1651045318913,CSE 134B,A01,083661,Powell; Thomas Allan,0,38,65,65
1651045324942,CSE 140,A01,083663,Staff,0,15,75,75
1651045330976,CSE 140L,A01,083088,Eldon; John,3,0,100,97
1651045337002,CSE 175,A01,083665,Kumar; Rakesh,0,0,25,25
1651045343026,CSE 190,A00,092507,Dubnov; Shlomo,9,0,20,11
1651045349053,ECE 45,A01,083139,Staff,0,7,60,60
1651045355083,ECE 65,A50,083695,Staff,0,7,30,30
1651045361114,ECE 109,A01,091882,Touri; Behrouz,33,0,70,37
1651045367145,ECE 180,A00,083140,Abi Samra; Nicholas Camill,17,0,30,13
1651045367145,ECE 180,B00,083141,Abi Samra; Nicholas Camill,0,0,30,30
1651045373172,MATH 10A,A01,083735,Patchell; Gregory David,0,0,30,30
1651045373172,MATH 10A,A02,083736,Patchell; Gregory David,27,0,30,3
1651045373172,MATH 10A,A03,083737,Patchell; Gregory David,23,0,30,7
1651045379205,MATH 10B,A01,083207,Staff,0,7,30,30
1651045379205,MATH 10B,A02,083208,Staff,0,6,30,30
1651045379205,MATH 10B,B01,083739,Staff,8,0,30,22
1651045379205,MATH 10B,B02,083740,Staff,28,0,30,2
1651045385233,MATH 18,A01,083743,Staff,0,0,30,30
1651045385233,MATH 18,A02,083744,Staff,23,0,30,7
1651045385233,MATH 18,A03,083745,Staff,19,0,30,11
1651045385233,MATH 18,A04,083746,Staff,26,0,30,4
1651045385233,MATH 18,B01,083748,Staff,0,16,30,30
1651045385233,MATH 18,B02,083749,Staff,0,14,30,30
1651045385233,MATH 18,B03,083750,Staff,0,14,30,30
1651045385233,MATH 18,B04,083751,Staff,0,13,30,30
1651045391261,MATH 20A,A01,083754,Staff,18,0,40,22
1651045397291,MATH 20B,A01,083756,Staff,0,14,30,30
1651045397291,MATH 20B,A02,083757,Staff,0,11,30,30
1651045403316,MATH 20C,A01,083760,Staff,0,16,30,30
1651045403316,MATH 20C,A02,083761,Staff,0,15,30,30
1651045403316,MATH 20C,B01,083762,Staff,8,0,30,22
1651045403316,MATH 20C,B02,083763,Staff,28,0,30,2
1651045409341,MATH 20D,A01,083765,Staff,3,1,30,27
1651045409341,MATH 20D,A02,083766,Staff,1,0,30,29
1651045409341,MATH 20D,A03,083767,Staff,22,0,30,8
1651045415368,MATH 20E,A01,083771,Staff,2,0,30,28
1651045415368,MATH 20E,A02,083772,Staff,10,0,30,20
1651045415368,MATH 20E,B01,083773,Staff,0,0,30,30
1651045415368,MATH 20E,B02,083774,Staff,0,0,30,30
1651045421392,MATH 103A,A01,083777,Staff,0,17,30,30
1651045421392,MATH 103A,A02,083778,Staff,0,16,30,30
1651045421392,MATH 103A,B01,083779,Staff,0,15,30,30
1651045421392,MATH 103A,B02,083780,Staff,0,13,30,30
1651045427421,MATH 105,A01,085443,Staff,0,23,30,30
1651045433456,MATH 109,A01,083213,Anzaldo; Leesa B,0,7,30,30
1651045433456,MATH 109,A02,083214,Anzaldo; Leesa B,0,7,30,30
1651045433456,MATH 109,B01,083215,Anzaldo; Leesa B,0,8,30,30
1651045433456,MATH 109,B02,083216,Anzaldo; Leesa B,0,8,30,30
1651045439479,MATH 142A,A01,083219,Chow; Bennett,0,15,30,30
1651045439479,MATH 142A,A02,083220,Chow; Bennett,0,15,30,30
1651045439479,MATH 142A,B01,083221,Chow; Bennett,0,16,30,30
1651045439479,MATH 142A,B02,083222,Chow; Bennett,0,14,30,30
1651045445511,MATH 193A,A01,083224,Staff,0,8,30,30
1651045445511,MATH 193A,A02,083225,Staff,0,7,30,30
1651045445511,MATH 193A,A03,083781,Staff,0,7,30,30
1651045445511,MATH 193A,A04,083782,Staff,0,7,30,30
1651045451533,MATH 197,001,091859,McAuley; Julian John,9998,0,9999,1
1651045457616,COGS 9,A01,083615,Staff,0,20,60,60
1651045463642,COGS 11,A01,083617,Boyle; Mary E. T.,13,0,40,27
1651045469669,COGS 13,A01,083071,Staff,0,40,40,40
1651045475698,COGS 14A,A01,092681,Staff,0,40,100,100
1651045481726,COGS 14B,A01,083073,Cheng; Tzu-Han,0,13,50,50
1651045487754,COGS 17,A01,092677,Staff,9,0,75,66
1651045493780,COGS 100,A01,083619,Staff,0,30,60,60
1651045499812,COGS 101A,A01,083621,Davis; Joshua Daniel,0,29,60,60
1651045505842,COGS 101B,A01,091572,Staff,0,7,60,60
1651045511879,COGS 101C,A01,083625,Delgado; Tania,14,0,30,16
1651045517908,COGS 107A,A01,083627,Boyle; Mary E. T.,0,17,60,60
1651045523936,COGS 118A,A01,083075,Staff,0,10,60,60
1651045529962,CSE 3,A50,083646,Miranda; Gregory Joseph,15,0,38,23
1651045529962,CSE 3,A51,083647,Miranda; Gregory Joseph,36,0,37,1
1651045535991,CSE 8A,A50,083650,Miranda; Gregory Joseph,0,31,40,40
1651045542020,CSE 11,A01,083080,Cao; Yingjun,1,97,40,39
1651045548045,CSE 12,A01,083652,Staff,0,25,100,100
1651045554069,CSE 15L,A01,083654,Staff,0,2,50,50
1651045554069,CSE 15L,A02,083655,Staff,0,3,50,50
1651045560096,CSE 20,A01,083657,Staff,46,0,80,34
1651045566125,CSE 30,A01,083084,Eldon; John,0,38,80,80
1651045572152,CSE 100,A01,083659,Cao; Yingjun,0,72,50,50
1651045578182,CSE 134B,A01,083661,Powell; Thomas Allan,0,38,65,65
1651045584207,CSE 140,A01,083663,Staff,0,15,75,75
1651045590235,CSE 140L,A01,083088,Eldon; John,3,0,100,97
1651045596265,CSE 175,A01,083665,Kumar; Rakesh,0,0,25,25
1651045602300,CSE 190,A00,092507,Dubnov; Shlomo,9,0,20,11
1651045608329,ECE 45,A01,083139,Staff,0,7,60,60
1651045614360,ECE 65,A50,083695,Staff,0,7,30,30
1651045620387,ECE 109,A01,091882,Touri; Behrouz,33,0,70,37
1651045626421,ECE 180,A00,083140,Abi Samra; Nicholas Camill,17,0,30,13
1651045626421,ECE 180,B00,083141,Abi Samra; Nicholas Camill,0,0,30,30
1651045632448,MATH 10A,A01,083735,Patchell; Gregory David,0,0,30,30
1651045632448,MATH 10A,A02,083736,Patchell; Gregory David,27,0,30,3
1651045632448,MATH 10A,A03,083737,Patchell; Gregory David,23,0,30,7
1651045638473,MATH 10B,A01,083207,Staff,0,7,30,30
1651045638473,MATH 10B,A02,083208,Staff,0,6,30,30
1651045638473,MATH 10B,B01,083739,Staff,8,0,30,22
1651045638473,MATH 10B,B02,083740,Staff,28,0,30,2
1651045644508,MATH 18,A01,083743,Staff,0,0,30,30
1651045644508,MATH 18,A02,083744,Staff,23,0,30,7
1651045644508,MATH 18,A03,083745,Staff,19,0,30,11
1651045644508,MATH 18,A04,083746,Staff,26,0,30,4
1651045644508,MATH 18,B01,083748,Staff,0,16,30,30
1651045644508,MATH 18,B02,083749,Staff,0,14,30,30
1651045644508,MATH 18,B03,083750,Staff,0,14,30,30
1651045644508,MATH 18,B04,083751,Staff,0,13,30,30
1651045650547,MATH 20A,A01,083754,Staff,18,0,40,22
1651045656578,MATH 20B,A01,083756,Staff,0,14,30,30
1651045656578,MATH 20B,A02,083757,Staff,0,11,30,30
1651045662610,MATH 20C,A01,083760,Staff,0,16,30,30
1651045662610,MATH 20C,A02,083761,Staff,0,15,30,30
1651045662610,MATH 20C,B01,083762,Staff,8,0,30,22
1651045662610,MATH 20C,B02,083763,Staff,28,0,30,2
1651045668641,MATH 20D,A01,083765,Staff,3,1,30,27
1651045668641,MATH 20D,A02,083766,Staff,1,0,30,29
1651045668641,MATH 20D,A03,083767,Staff,22,0,30,8
1651045674667,MATH 20E,A01,083771,Staff,2,0,30,28
1651045674667,MATH 20E,A02,083772,Staff,10,0,30,20
1651045674667,MATH 20E,B01,083773,Staff,0,0,30,30
1651045674667,MATH 20E,B02,083774,Staff,0,0,30,30
1651045680695,MATH 103A,A01,083777,Staff,0,17,30,30
1651045680695,MATH 103A,A02,083778,Staff,0,16,30,30
1651045680695,MATH 103A,B01,083779,Staff,0,15,30,30
1651045680695,MATH 103A,B02,083780,Staff,0,13,30,30
1651045686721,MATH 105,A01,085443,Staff,0,23,30,30
1651045692748,MATH 109,A01,083213,Anzaldo; Leesa B,0,7,30,30
1651045692748,MATH 109,A02,083214,Anzaldo; Leesa B,0,7,30,30
1651045692748,MATH 109,B01,083215,Anzaldo; Leesa B,0,8,30,30
1651045692748,MATH 109,B02,083216,Anzaldo; Leesa B,0,8,30,30
1651045698780,MATH 142A,A01,083219,Chow; Bennett,0,15,30,30
1651045698780,MATH 142A,A02,083220,Chow; Bennett,0,15,30,30
1651045698780,MATH 142A,B01,083221,Chow; Bennett,0,16,30,30
1651045698780,MATH 142A,B02,083222,Chow; Bennett,0,14,30,30
1651045704813,MATH 193A,A01,083224,Staff,0,8,30,30
1651045704813,MATH 193A,A02,083225,Staff,0,7,30,30
1651045704813,MATH 193A,A03,083781,Staff,0,7,30,30
1651045704813,MATH 193A,A04,083782,Staff,0,7,30,30
1651045710839,MATH 197,001,091859,McAuley; Julian John,9998,0,9999,1
1651045716946,COGS 9,A01,083615,Staff,0,20,60,60
1651045722971,COGS 11,A01,083617,Boyle; Mary E. T.,13,0,40,27
1651045728997,COGS 13,A01,083071,Staff,0,40,40,40
1651045735022,COGS 14A,A01,092681,Staff,0,40,100,100
1651045741047,COGS 14B,A01,083073,Cheng; Tzu-Han,0,13,50,50
1651045747071,COGS 17,A01,092677,Staff,9,0,75,66
1651045753098,COGS 100,A01,083619,Staff,0,30,60,60
1651045759126,COGS 101A,A01,083621,Davis; Joshua Daniel,0,29,60,60
1651045765155,COGS 101B,A01,091572,Staff,0,7,60,60
1651045771180,COGS 101C,A01,083625,Delgado; Tania,14,0,30,16
1651045777208,COGS 107A,A01,083627,Boyle; Mary E. T.,0,17,60,60
1651045783326,COGS 118A,A01,083075,Staff,0,10,60,60
1651045789352,CSE 3,A50,083646,Miranda; Gregory Joseph,15,0,38,23
1651045789352,CSE 3,A51,083647,Miranda; Gregory Joseph,36,0,37,1
1651045795383,CSE 8A,A50,083650,Miranda; Gregory Joseph,0,31,40,40
1651045801409,CSE 11,A01,083080,Cao; Yingjun,1,97,40,39
1651045807436,CSE 12,A01,083652,Staff,0,25,100,100
1651045813463,CSE 15L,A01,083654,Staff,0,2,50,50
1651045813463,CSE 15L,A02,083655,Staff,0,3,50,50
1651045819487,CSE 20,A01,083657,Staff,46,0,80,34
1651045825514,CSE 30,A01,083084,Eldon; John,0,38,80,80
1651045831544,CSE 100,A01,083659,Cao; Yingjun,0,72,50,50
1651045837572,CSE 134B,A01,083661,Powell; Thomas Allan,0,38,65,65
1651045843599,CSE 140,A01,083663,Staff,0,15,75,75
1651045849624,CSE 140L,A01,083088,Eldon; John,3,0,100,97
1651045855655,CSE 175,A01,083665,Kumar; Rakesh,0,0,25,25
1651045861685,CSE 190,A00,092507,Dubnov; Shlomo,9,0,20,11
1651045867711,ECE 45,A01,083139,Staff,0,7,60,60
1651045873735,ECE 65,A50,083695,Staff,0,7,30,30
1651045879759,ECE 109,A01,091882,Touri; Behrouz,33,0,70,37
1651045885784,ECE 180,A00,083140,Abi Samra; Nicholas Camill,17,0,30,13
1651045885784,ECE 180,B00,083141,Abi Samra; Nicholas Camill,0,0,30,30
1651045891811,MATH 10A,A01,083735,Patchell; Gregory David,0,0,30,30
1651045891811,MATH 10A,A02,083736,Patchell; Gregory David,27,0,30,3
1651045891811,MATH 10A,A03,083737,Patchell; Gregory David,23,0,30,7
1651045897837,MATH 10B,A01,083207,Staff,0,7,30,30
1651045897837,MATH 10B,A02,083208,Staff,0,6,30,30
1651045897837,MATH 10B,B01,083739,Staff,8,0,30,22
1651045897837,MATH 10B,B02,083740,Staff,28,0,30,2
1651045903892,MATH 18,A01,083743,Staff,0,0,30,30
1651045903892,MATH 18,A02,083744,Staff,23,0,30,7
1651045903892,MATH 18,A03,083745,Staff,19,0,30,11
1651045903892,MATH 18,A04,083746,Staff,26,0,30,4
1651045903892,MATH 18,B01,083748,Staff,0,16,30,30
1651045903892,MATH 18,B02,083749,Staff,0,14,30,30
1651045903892,MATH 18,B03,083750,Staff,0,14,30,30
1651045903892,MATH 18,B04,083751,Staff,0,13,30,30
1651045909917,MATH 20A,A01,083754,Staff,18,0,40,22
1651045915942,MATH 20B,A01,083756,Staff,0,14,30,30
1651045915942,MATH 20B,A02,083757,Staff,0,11,30,30
1651045921968,MATH 20C,A01,083760,Staff,0,16,30,30
1651045921968,MATH 20C,A02,083761,Staff,0,15,30,30
1651045921968,MATH 20C,B01,083762,Staff,8,0,30,22
1651045921968,MATH 20C,B02,083763,Staff,28,0,30,2
1651045927994,MATH 20D,A01,083765,Staff,3,1,30,27
1651045927994,MATH 20D,A02,083766,Staff,1,0,30,29
1651045927994,MATH 20D,A03,083767,Staff,22,0,30,8
1651045934023,MATH 20E,A01,083771,Staff,2,0,30,28
1651045934023,MATH 20E,A02,083772,Staff,10,0,30,20
1651045934023,MATH 20E,B01,083773,Staff,0,0,30,30
1651045934023,MATH 20E,B02,083774,Staff,0,0,30,30
1651045940049,MATH 103A,A01,083777,Staff,0,17,30,30
1651045940049,MATH 103A,A02,083778,Staff,0,16,30,30
1651045940049,MATH 103A,B01,083779,Staff,0,15,30,30
1651045940049,MATH 103A,B02,083780,Staff,0,13,30,30
1651045946074,MATH 105,A01,085443,Staff,0,23,30,30
1651045952100,MATH 109,A01,083213,Anzaldo; Leesa B,0,7,30,30
1651045952100,MATH 109,A02,083214,Anzaldo; Leesa B,0,7,30,30
1651045952100,MATH 109,B01,083215,Anzaldo; Leesa B,0,8,30,30
1651045952100,MATH 109,B02,083216,Anzaldo; Leesa B,0,8,30,30
1651045958142,MATH 142A,A01,083219,Chow; Bennett,0,15,30,30
1651045958142,MATH 142A,A02,083220,Chow; Bennett,0,15,30,30
1651045958142,MATH 142A,B01,083221,Chow; Bennett,0,16,30,30
1651045958142,MATH 142A,B02,083222,Chow; Bennett,0,14,30,30
1651045964167,MATH 193A,A01,083224,Staff,0,8,30,30
1651045964167,MATH 193A,A02,083225,Staff,0,7,30,30
1651045964167,MATH 193A,A03,083781,Staff,0,7,30,30
1651045964167,MATH 193A,A04,083782,Staff,0,7,30,30
1651045970195,MATH 197,001,091859,McAuley; Julian John,9998,0,9999,1
1651045976254,COGS 9,A01,083615,Staff,0,20,60,60
1651045982279,COGS 11,A01,083617,Boyle; Mary E. T.,13,0,40,27
1651045988309,COGS 13,A01,083071,Staff,0,40,40,40
1651045994334,COGS 14A,A01,092681,Staff,0,40,100,100
1651046000360,COGS 14B,A01,083073,Cheng; Tzu-Han,0,13,50,50
1651046006391,COGS 17,A01,092677,Staff,9,0,75,66
1651046012426,COGS 100,A01,083619,Staff,0,30,60,60
1651046018452,COGS 101A,A01,083621,Davis; Joshua Daniel,0,29,60,60
1651046024477,COGS 101B,A01,091572,Staff,0,7,60,60
1651046030502,COGS 101C,A01,083625,Delgado; Tania,14,0,30,16
1651046036525,COGS 107A,A01,083627,Boyle; Mary E. T.,0,17,60,60
1651046042560,COGS 118A,A01,083075,Staff,0,10,60,60
1651046048586,CSE 3,A50,083646,Miranda; Gregory Joseph,15,0,38,23
1651046048586,CSE 3,A51,083647,Miranda; Gregory Joseph,36,0,37,1
1651046054611,CSE 8A,A50,083650,Miranda; Gregory Joseph,0,31,40,40
1651046060637,CSE 11,A01,083080,Cao; Yingjun,1,97,40,39
1651046066665,CSE 12,A01,083652,Staff,0,25,100,100
1651046072689,CSE 15L,A01,083654,Staff,0,2,50,50
1651046072689,CSE 15L,A02,083655,Staff,0,3,50,50
1651046078715,CSE 20,A01,083657,Staff,46,0,80,34
1651046084741,CSE 30,A01,083084,Eldon; John,0,38,80,80
1651046090772,CSE 100,A01,083659,Cao; Yingjun,0,72,50,50
1651046096794,CSE 134B,A01,083661,Powell; Thomas Allan,0,38,65,65
1651046102843,CSE 140,A01,083663,Staff,0,15,75,75
1651046108870,CSE 140L,A01,083088,Eldon; John,3,0,100,97
1651046114897,CSE 175,A01,083665,Kumar; Rakesh,0,0,25,25
1651046120927,CSE 190,A00,092507,Dubnov; Shlomo,9,0,20,11
1651046126951,ECE 45,A01,083139,Staff,0,7,60,60
1651046132975,ECE 65,A50,083695,Staff,0,7,30,30
1651046139003,ECE 109,A01,091882,Touri; Behrouz,33,0,70,37
1651046145027,ECE 180,A00,083140,Abi Samra; Nicholas Camill,17,0,30,13
1651046145027,ECE 180,B00,083141,Abi Samra; Nicholas Camill,0,0,30,30
1651046151051,MATH 10A,A01,083735,Patchell; Gregory David,0,0,30,30
1651046151051,MATH 10A,A02,083736,Patchell; Gregory David,27,0,30,3
1651046151051,MATH 10A,A03,083737,Patchell; Gregory David,23,0,30,7
1651046157076,MATH 10B,A01,083207,Staff,0,7,30,30
1651046157076,MATH 10B,A02,083208,Staff,0,6,30,30
1651046157076,MATH 10B,B01,083739,Staff,8,0,30,22
1651046157076,MATH 10B,B02,083740,Staff,28,0,30,2
1651046163106,MATH 18,A01,083743,Staff,0,0,30,30
1651046163106,MATH 18,A02,083744,Staff,23,0,30,7
1651046163106,MATH 18,A03,083745,Staff,19,0,30,11
1651046163106,MATH 18,A04,083746,Staff,26,0,30,4
1651046163106,MATH 18,B01,083748,Staff,0,16,30,30
1651046163106,MATH 18,B02,083749,Staff,0,14,30,30
1651046163106,MATH 18,B03,083750,Staff,0,14,30,30
1651046163106,MATH 18,B04,083751,Staff,0,13,30,30
1651046169131,MATH 20A,A01,083754,Staff,18,0,40,22
1651046175160,MATH 20B,A01,083756,Staff,0,14,30,30
1651046175160,MATH 20B,A02,083757,Staff,0,11,30,30
1651046181189,MATH 20C,A01,083760,Staff,0,16,30,30
1651046181189,MATH 20C,A02,083761,Staff,0,15,30,30
1651046181189,MATH 20C,B01,083762,Staff,8,0,30,22
1651046181189,MATH 20C,B02,083763,Staff,28,0,30,2
1651046187228,MATH 20D,A01,083765,Staff,3,1,30,27
1651046187228,MATH 20D,A02,083766,Staff,1,0,30,29
1651046187228,MATH 20D,A03,083767,Staff,22,0,30,8
1651046193260,MATH 20E,A01,083771,Staff,2,0,30,28
1651046193260,MATH 20E,A02,083772,Staff,10,0,30,20
1651046193260,MATH 20E,B01,083773,Staff,0,0,30,30
1651046193260,MATH 20E,B02,083774,Staff,0,0,30,30
1651046199285,MATH 103A,A01,083777,Staff,0,17,30,30
1651046199285,MATH 103A,A02,083778,Staff,0,16,30,30
1651046199285,MATH 103A,B01,083779,Staff,0,15,30,30
1651046199285,MATH 103A,B02,083780,Staff,0,13,30,30
1651046205311,MATH 105,A01,085443,Staff,0,23,30,30
1651046211343,MATH 109,A01,083213,Anzaldo; Leesa B,0,7,30,30
1651046211343,MATH 109,A02,083214,Anzaldo; Leesa B,0,7,30,30
1651046211343,MATH 109,B01,083215,Anzaldo; Leesa B,0,8,30,30
1651046211343,MATH 109,B02,083216,Anzaldo; Leesa B,0,8,30,30
1651046217370,MATH 142A,A01,083219,Chow; Bennett,0,15,30,30
1651046217370,MATH 142A,A02,083220,Chow; Bennett,0,15,30,30
1651046217370,MATH 142A,B01,083221,Chow; Bennett,0,16,30,30
1651046217370,MATH 142A,B02,083222,Chow; Bennett,0,14,30,30
1651046223400,MATH 193A,A01,083224,Staff,0,8,30,30
1651046223400,MATH 193A,A02,083225,Staff,0,7,30,30
1651046223400,MATH 193A,A03,083781,Staff,0,7,30,30
1651046223400,MATH 193A,A04,083782,Staff,0,7,30,30
1651046229423,MATH 197,001,091859,McAuley; Julian John,9998,0,9999,1
1651046235507,COGS 9,A01,083615,Staff,0,20,60,60
1651046241535,COGS 11,A01,083617,Boyle; Mary E. T.,13,0,40,27
1651046247560,COGS 13,A01,083071,Staff,0,40,40,40
1651046253585,COGS 14A,A01,092681,Staff,0,40,100,100
1651046259610,COGS 14B,A01,083073,Cheng; Tzu-Han,0,13,50,50
1651046265633,COGS 17,A01,092677,Staff,9,0,75,66
1651046271660,COGS 100,A01,083619,Staff,0,30,60,60
1651046277685,COGS 101A,A01,083621,Davis; Joshua Daniel,0,29,60,60
1651046283718,COGS 101B,A01,091572,Staff,0,7,60,60
1651046289748,COGS 101C,A01,083625,Delgado; Tania,14,0,30,16
1651046295776,COGS 107A,A01,083627,Boyle; Mary E. T.,0,17,60,60
1651046301805,COGS 118A,A01,083075,Staff,0,10,60,60
1651046307835,CSE 3,A50,083646,Miranda; Gregory Joseph,15,0,38,23
1651046307835,CSE 3,A51,083647,Miranda; Gregory Joseph,36,0,37,1
1651046313863,CSE 8A,A50,083650,Miranda; Gregory Joseph,0,31,40,40
1651046319886,CSE 11,A01,083080,Cao; Yingjun,1,97,40,39
1651046325910,CSE 12,A01,083652,Staff,0,25,100,100
1651046331937,CSE 15L,A01,083654,Staff,0,2,50,50
1651046331937,CSE 15L,A02,083655,Staff,0,3,50,50
1651046337960,CSE 20,A01,083657,Staff,46,0,80,34
1651046343983,CSE 30,A01,083084,Eldon; John,0,38,80,80
1651046350008,CSE 100,A01,083659,Cao; Yingjun,0,72,50,50
1651046356044,CSE 134B,A01,083661,Powell; Thomas Allan,0,38,65,65
1651046362071,CSE 140,A01,083663,Staff,0,15,75,75
1651046368098,CSE 140L,A01,083088,Eldon; John,3,0,100,97
1651046374135,CSE 175,A01,083665,Kumar; Rakesh,0,0,25,25
1651046380253,CSE 190,A00,092507,Dubnov; Shlomo,9,0,20,11
1651046386277,ECE 45,A01,083139,Staff,0,7,60,60
1651046392303,ECE 65,A50,083695,Staff,0,7,30,30
1651046398328,ECE 109,A01,091882,Touri; Behrouz,33,0,70,37
1651046404353,ECE 180,A00,083140,Abi Samra; Nicholas Camill,17,0,30,13
1651046404353,ECE 180,B00,083141,Abi Samra; Nicholas Camill,0,0,30,30
1651046410381,MATH 10A,A01,083735,Patchell; Gregory David,0,0,30,30
1651046410381,MATH 10A,A02,083736,Patchell; Gregory David,27,0,30,3
1651046410381,MATH 10A,A03,083737,Patchell; Gregory David,23,0,30,7
1651046435538,MATH 10B,A01,083207,Staff,0,7,30,30
1651046435538,MATH 10B,A02,083208,Staff,0,6,30,30
1651046435538,MATH 10B,B01,083739,Staff,8,0,30,22
1651046435538,MATH 10B,B02,083740,Staff,28,0,30,2
1651046441588,MATH 18,A01,083743,Staff,0,0,30,30
1651046441588,MATH 18,A02,083744,Staff,23,0,30,7
1651046441588,MATH 18,A03,083745,Staff,19,0,30,11
1651046441588,MATH 18,A04,083746,Staff,26,0,30,4
1651046441588,MATH 18,B01,083748,Staff,0,16,30,30
1651046441588,MATH 18,B02,083749,Staff,0,14,30,30
1651046441588,MATH 18,B03,083750,Staff,0,14,30,30
1651046441588,MATH 18,B04,083751,Staff,0,13,30,30
1651046447619,MATH 20A,A01,083754,Staff,18,0,40,22
1651046453644,MATH 20B,A01,083756,Staff,0,14,30,30
1651046453644,MATH 20B,A02,083757,Staff,0,11,30,30
1651046459668,MATH 20C,A01,083760,Staff,0,16,30,30
1651046459668,MATH 20C,A02,083761,Staff,0,15,30,30
1651046459668,MATH 20C,B01,083762,Staff,8,0,30,22
1651046459668,MATH 20C,B02,083763,Staff,28,0,30,2
1651046465692,MATH 20D,A01,083765,Staff,3,1,30,27
1651046465692,MATH 20D,A02,083766,Staff,1,0,30,29
1651046465692,MATH 20D,A03,083767,Staff,22,0,30,8
1651046471718,MATH 20E,A01,083771,Staff,2,0,30,28
1651046471718,MATH 20E,A02,083772,Staff,10,0,30,20
1651046471718,MATH 20E,B01,083773,Staff,0,0,30,30
1651046471718,MATH 20E,B02,083774,Staff,0,0,30,30
1651046477744,MATH 103A,A01,083777,Staff,0,17,30,30
1651046477744,MATH 103A,A02,083778,Staff,0,16,30,30
1651046477744,MATH 103A,B01,083779,Staff,0,15,30,30
1651046477744,MATH 103A,B02,083780,Staff,0,13,30,30
1651046483773,MATH 105,A01,085443,Staff,0,23,30,30
1651046489798,MATH 109,A01,083213,Anzaldo; Leesa B,0,7,30,30
1651046489798,MATH 109,A02,083214,Anzaldo; Leesa B,0,7,30,30
1651046489798,MATH 109,B01,083215,Anzaldo; Leesa B,0,8,30,30
1651046489798,MATH 109,B02,083216,Anzaldo; Leesa B,0,8,30,30
1651046495829,MATH 142A,A01,083219,Chow; Bennett,0,15,30,30
1651046495829,MATH 142A,A02,083220,Chow; Bennett,0,15,30,30
1651046495829,MATH 142A,B01,083221,Chow; Bennett,0,16,30,30
1651046495829,MATH 142A,B02,083222,Chow; Bennett,0,14,30,30
1651046501853,MATH 193A,A01,083224,Staff,0,8,30,30
1651046501853,MATH 193A,A02,083225,Staff,0,7,30,30
1651046501853,MATH 193A,A03,083781,Staff,0,7,30,30
1651046501853,MATH 193A,A04,083782,Staff,0,7,30,30
1651046507879,MATH 197,001,091859,McAuley; Julian John,9998,0,9999,1
1651046513940,COGS 9,A01,083615,Staff,0,20,60,60
1651046519970,COGS 11,A01,083617,Boyle; Mary E. T.,13,0,40,27
1651046526000,COGS 13,A01,083071,Staff,0,40,40,40
1651046532026,COGS 14A,A01,092681,Staff,0,40,100,100
1651046538050,COGS 14B,A01,083073,Cheng; Tzu-Han,0,13,50,50
1651046544076,COGS 17,A01,092677,Staff,9,0,75,66
1651046550100,COGS 100,A01,083619,Staff,0,30,60,60
1651046556124,COGS 101A,A01,083621,Davis; Joshua Daniel,0,29,60,60
1651046562148,COGS 101B,A01,091572,Staff,0,7,60,60
1651046568177,COGS 101C,A01,083625,Delgado; Tania,14,0,30,16
1651046574203,COGS 107A,A01,083627,Boyle; Mary E. T.,0,17,60,60
1651046580247,COGS 118A,A01,083075,Staff,0,10,60,60
1651046586280,CSE 3,A50,083646,Miranda; Gregory Joseph,15,0,38,23
1651046586280,CSE 3,A51,083647,Miranda; Gregory Joseph,36,0,37,1
1651046592319,CSE 8A,A50,083650,Miranda; Gregory Joseph,0,31,40,40
1651046598349,CSE 11,A01,083080,Cao; Yingjun,1,97,40,39
1651046604379,CSE 12,A01,083652,Staff,0,25,100,100
1651046610409,CSE 15L,A01,083654,Staff,0,2,50,50
1651046610409,CSE 15L,A02,083655,Staff,0,3,50,50
1651046616433,CSE 20,A01,083657,Staff,46,0,80,34
1651046622461,CSE 30,A01,083084,Eldon; John,0,38,80,80
1651046628490,CSE 100,A01,083659,Cao; Yingjun,0,72,50,50
1651046634518,CSE 134B,A01,083661,Powell; Thomas Allan,0,38,65,65
1651046640548,CSE 140,A01,083663,Staff,0,15,75,75
1651046646572,CSE 140L,A01,083088,Eldon; John,3,0,100,97
1651046652598,CSE 175,A01,083665,Kumar; Rakesh,0,0,25,25
1651046658623,CSE 190,A00,092507,Dubnov; Shlomo,9,0,20,11
1651046664649,ECE 45,A01,083139,Staff,0,7,60,60
1651046670675,ECE 65,A50,083695,Staff,0,7,30,30
1651046676700,ECE 109,A01,091882,Touri; Behrouz,33,0,70,37
1651046682727,ECE 180,A00,083140,Abi Samra; Nicholas Camill,17,0,30,13
1651046682727,ECE 180,B00,083141,Abi Samra; Nicholas Camill,0,0,30,30
1651046688760,MATH 10A,A01,083735,Patchell; Gregory David,0,0,30,30
1651046688760,MATH 10A,A02,083736,Patchell; Gregory David,27,0,30,3
1651046688760,MATH 10A,A03,083737,Patchell; Gregory David,23,0,30,7
1651046694792,MATH 10B,A01,083207,Staff,0,7,30,30
1651046694792,MATH 10B,A02,083208,Staff,0,6,30,30
1651046694792,MATH 10B,B01,083739,Staff,8,0,30,22
1651046694792,MATH 10B,B02,083740,Staff,28,0,30,2
1651046700838,MATH 18,A01,083743,Staff,0,0,30,30
1651046700838,MATH 18,A02,083744,Staff,23,0,30,7
1651046700838,MATH 18,A03,083745,Staff,19,0,30,11
1651046700838,MATH 18,A04,083746,Staff,26,0,30,4
1651046700838,MATH 18,B01,083748,Staff,0,16,30,30
1651046700838,MATH 18,B02,083749,Staff,0,14,30,30
1651046700838,MATH 18,B03,083750,Staff,0,14,30,30
1651046700838,MATH 18,B04,083751,Staff,0,13,30,30
1651046706861,MATH 20A,A01,083754,Staff,18,0,40,22
1651046712886,MATH 20B,A01,083756,Staff,0,14,30,30
1651046712886,MATH 20B,A02,083757,Staff,0,11,30,30
1651046718915,MATH 20C,A01,083760,Staff,0,16,30,30
1651046718915,MATH 20C,A02,083761,Staff,0,15,30,30
1651046718915,MATH 20C,B01,083762,Staff,8,0,30,22
1651046718915,MATH 20C,B02,083763,Staff,28,0,30,2
1651046724939,MATH 20D,A01,083765,Staff,3,1,30,27
1651046724939,MATH 20D,A02,083766,Staff,1,0,30,29
1651046724939,MATH 20D,A03,083767,Staff,22,0,30,8
1651046730968,MATH 20E,A01,083771,Staff,2,0,30,28
1651046730968,MATH 20E,A02,083772,Staff,10,0,30,20
1651046730968,MATH 20E,B01,083773,Staff,0,0,30,30
1651046730968,MATH 20E,B02,083774,Staff,0,0,30,30
1651046736994,MATH 103A,A01,083777,Staff,0,17,30,30
1651046736994,MATH 103A,A02,083778,Staff,0,16,30,30
1651046736994,MATH 103A,B01,083779,Staff,0,15,30,30
1651046736994,MATH 103A,B02,083780,Staff,0,13,30,30
1651046743019,MATH 105,A01,085443,Staff,0,23,30,30
1651046749049,MATH 109,A01,083213,Anzaldo; Leesa B,0,7,30,30
1651046749049,MATH 109,A02,083214,Anzaldo; Leesa B,0,7,30,30
1651046749049,MATH 109,B01,083215,Anzaldo; Leesa B,0,8,30,30
1651046749049,MATH 109,B02,083216,Anzaldo; Leesa B,0,8,30,30
1651046755074,MATH 142A,A01,083219,Chow; Bennett,0,15,30,30
1651046755074,MATH 142A,A02,083220,Chow; Bennett,0,15,30,30
1651046755074,MATH 142A,B01,083221,Chow; Bennett,0,16,30,30
1651046755074,MATH 142A,B02,083222,Chow; Bennett,0,14,30,30
1651046761099,MATH 193A,A01,083224,Staff,0,8,30,30
1651046761099,MATH 193A,A02,083225,Staff,0,7,30,30
1651046761099,MATH 193A,A03,083781,Staff,0,7,30,30
1651046761099,MATH 193A,A04,083782,Staff,0,7,30,30
1651046767126,MATH 197,001,091859,McAuley; Julian John,9998,0,9999,1
1651046773213,COGS 9,A01,083615,Staff,0,20,60,60
1651046779245,COGS 11,A01,083617,Boyle; Mary E. T.,13,0,40,27
1651046785269,COGS 13,A01,083071,Staff,0,40,40,40
1651046791293,COGS 14A,A01,092681,Staff,0,40,100,100
1651046797316,COGS 14B,A01,083073,Cheng; Tzu-Han,0,13,50,50
1651046803422,COGS 17,A01,092677,Staff,9,0,75,66
1651046809449,COGS 100,A01,083619,Staff,0,30,60,60
1651046815475,COGS 101A,A01,083621,Davis; Joshua Daniel,0,29,60,60
1651046821500,COGS 101B,A01,091572,Staff,0,7,60,60
1651046827523,COGS 101C,A01,083625,Delgado; Tania,14,0,30,16
1651046833550,COGS 107A,A01,083627,Boyle; Mary E. T.,0,17,60,60
1651046839575,COGS 118A,A01,083075,Staff,0,10,60,60
1651046845599,CSE 3,A50,083646,Miranda; Gregory Joseph,15,0,38,23
1651046845599,CSE 3,A51,083647,Miranda; Gregory Joseph,36,0,37,1
1651046851635,CSE 8A,A50,083650,Miranda; Gregory Joseph,0,31,40,40
1651046857658,CSE 11,A01,083080,Cao; Yingjun,1,97,40,39
1651046863681,CSE 12,A01,083652,Staff,0,25,100,100
1651046869705,CSE 15L,A01,083654,Staff,0,2,50,50
1651046869705,CSE 15L,A02,083655,Staff,0,3,50,50
1651046875733,CSE 20,A01,083657,Staff,46,0,80,34
1651046881758,CSE 30,A01,083084,Eldon; John,0,38,80,80
1651046887782,CSE 100,A01,083659,Cao; Yingjun,0,72,50,50
1651046893814,CSE 134B,A01,083661,Powell; Thomas Allan,0,38,65,65
1651046899838,CSE 140,A01,083663,Staff,0,15,75,75
1651046905863,CSE 140L,A01,083088,Eldon; John,3,0,100,97
1651046911889,CSE 175,A01,083665,Kumar; Rakesh,0,0,25,25
1651046917917,CSE 190,A00,092507,Dubnov; Shlomo,9,0,20,11
1651046923945,ECE 45,A01,083139,Staff,0,7,60,60
1651046929972,ECE 65,A50,083695,Staff,0,7,30,30
1651046935996,ECE 109,A01,091882,Touri; Behrouz,33,0,70,37
1651046942020,ECE 180,A00,083140,Abi Samra; Nicholas Camill,17,0,30,13
1651046942020,ECE 180,B00,083141,Abi Samra; Nicholas Camill,0,0,30,30
1651046948054,MATH 10A,A01,083735,Patchell; Gregory David,0,0,30,30
1651046948054,MATH 10A,A02,083736,Patchell; Gregory David,27,0,30,3
1651046948054,MATH 10A,A03,083737,Patchell; Gregory David,23,0,30,7
1651046954079,MATH 10B,A01,083207,Staff,0,7,30,30
1651046954079,MATH 10B,A02,083208,Staff,0,6,30,30
1651046954079,MATH 10B,B01,083739,Staff,8,0,30,22
1651046954079,MATH 10B,B02,083740,Staff,28,0,30,2
1651046960110,MATH 18,A01,083743,Staff,0,0,30,30
1651046960110,MATH 18,A02,083744,Staff,23,0,30,7
1651046960110,MATH 18,A03,083745,Staff,19,0,30,11
1651046960110,MATH 18,A04,083746,Staff,26,0,30,4
1651046960110,MATH 18,B01,083748,Staff,0,16,30,30
1651046960110,MATH 18,B02,083749,Staff,0,14,30,30
1651046960110,MATH 18,B03,083750,Staff,0,14,30,30
1651046960110,MATH 18,B04,083751,Staff,0,13,30,30
1651046966137,MATH 20A,A01,083754,Staff,18,0,40,22
1651046972161,MATH 20B,A01,083756,Staff,0,14,30,30
1651046972161,MATH 20B,A02,083757,Staff,0,11,30,30
1651046978186,MATH 20C,A01,083760,Staff,0,16,30,30
1651046978186,MATH 20C,A02,083761,Staff,0,15,30,30
1651046978186,MATH 20C,B01,083762,Staff,8,0,30,22
1651046978186,MATH 20C,B02,083763,Staff,28,0,30,2
1651046984214,MATH 20D,A01,083765,Staff,3,1,30,27
1651046984214,MATH 20D,A02,083766,Staff,1,0,30,29
1651046984214,MATH 20D,A03,083767,Staff,22,0,30,8
1651046990240,MATH 20E,A01,083771,Staff,2,0,30,28
1651046990240,MATH 20E,A02,083772,Staff,10,0,30,20
1651046990240,MATH 20E,B01,083773,Staff,0,0,30,30
1651046990240,MATH 20E,B02,083774,Staff,0,0,30,30
1651046996335,MATH 103A,A01,083777,Staff,0,17,30,30
1651046996335,MATH 103A,A02,083778,Staff,0,16,30,30
1651046996335,MATH 103A,B01,083779,Staff,0,15,30,30
1651046996335,MATH 103A,B02,083780,Staff,0,13,30,30
1651047002360,MATH 105,A01,085443,Staff,0,23,30,30
1651047008386,MATH 109,A01,083213,Anzaldo; Leesa B,0,7,30,30
1651047008386,MATH 109,A02,083214,Anzaldo; Leesa B,0,7,30,30
1651047008386,MATH 109,B01,083215,Anzaldo; Leesa B,0,8,30,30
1651047008386,MATH 109,B02,083216,Anzaldo; Leesa B,0,8,30,30
1651047014411,MATH 142A,A01,083219,Chow; Bennett,0,15,30,30
1651047014411,MATH 142A,A02,083220,Chow; Bennett,0,15,30,30
1651047014411,MATH 142A,B01,083221,Chow; Bennett,0,16,30,30
1651047014411,MATH 142A,B02,083222,Chow; Bennett,0,14,30,30
1651047020435,MATH 193A,A01,083224,Staff,0,8,30,30
1651047020435,MATH 193A,A02,083225,Staff,0,7,30,30
1651047020435,MATH 193A,A03,083781,Staff,0,7,30,30
1651047020435,MATH 193A,A04,083782,Staff,0,7,30,30
1651047026461,MATH 197,001,091859,McAuley; Julian John,9998,0,9999,1
1651047032519,COGS 9,A01,083615,Staff,0,20,60,60
1651047038546,COGS 11,A01,083617,Boyle; Mary E. T.,13,0,40,27
1651047044587,COGS 13,A01,083071,Staff,0,40,40,40
1651047050613,COGS 14A,A01,092681,Staff,0,40,100,100
1651047056644,COGS 14B,A01,083073,Cheng; Tzu-Han,0,13,50,50
1651047062667,COGS 17,A01,092677,Staff,9,0,75,66
1651047068693,COGS 100,A01,083619,Staff,0,30,60,60
1651047074721,COGS 101A,A01,083621,Davis; Joshua Daniel,0,29,60,60
1651047080750,COGS 101B,A01,091572,Staff,0,7,60,60
1651047086774,COGS 101C,A01,083625,Delgado; Tania,14,0,30,16
1651047092798,COGS 107A,A01,083627,Boyle; Mary E. T.,0,17,60,60
1651047098823,COGS 118A,A01,083075,Staff,0,10,60,60
1651047104865,CSE 3,A50,083646,Miranda; Gregory Joseph,15,0,38,23
1651047104865,CSE 3,A51,083647,Miranda; Gregory Joseph,36,0,37,1
1651047110894,CSE 8A,A50,083650,Miranda; Gregory Joseph,0,31,40,40
1651047116919,CSE 11,A01,083080,Cao; Yingjun,1,97,40,39
1651047122947,CSE 12,A01,083652,Staff,0,25,100,100
1651047128970,CSE 15L,A01,083654,Staff,0,2,50,50
1651047128970,CSE 15L,A02,083655,Staff,0,3,50,50
1651047134996,CSE 20,A01,083657,Staff,46,0,80,34
1651047141026,CSE 30,A01,083084,Eldon; John,0,38,80,80
1651047147060,CSE 100,A01,083659,Cao; Yingjun,0,72,50,50
1651047153083,CSE 134B,A01,083661,Powell; Thomas Allan,0,38,65,65
1651047159108,CSE 140,A01,083663,Staff,0,15,75,75
1651047165131,CSE 140L,A01,083088,Eldon; John,3,0,100,97
1651047171154,CSE 175,A01,083665,Kumar; Rakesh,0,0,25,25
1651047177178,CSE 190,A00,092507,Dubnov; Shlomo,9,0,20,11
1651047183207,ECE 45,A01,083139,Staff,0,7,60,60
1651047189237,ECE 65,A50,083695,Staff,0,7,30,30
1651047195267,ECE 109,A01,091882,Touri; Behrouz,33,0,70,37
1651047201293,ECE 180,A00,083140,Abi Samra; Nicholas Camill,17,0,30,13
1651047201293,ECE 180,B00,083141,Abi Samra; Nicholas Camill,0,0,30,30
1651047207327,MATH 10A,A01,083735,Patchell; Gregory David,0,0,30,30
1651047207327,MATH 10A,A02,083736,Patchell; Gregory David,27,0,30,3
1651047207327,MATH 10A,A03,083737,Patchell; Gregory David,23,0,30,7
1651047213352,MATH 10B,A01,083207,Staff,0,7,30,30
1651047213352,MATH 10B,A02,083208,Staff,0,6,30,30
1651047213352,MATH 10B,B01,083739,Staff,8,0,30,22
1651047213352,MATH 10B,B02,083740,Staff,28,0,30,2
1651047219384,MATH 18,A01,083743,Staff,0,0,30,30
1651047219384,MATH 18,A02,083744,Staff,23,0,30,7
1651047219384,MATH 18,A03,083745,Staff,19,0,30,11
1651047219384,MATH 18,A04,083746,Staff,26,0,30,4
1651047219384,MATH 18,B01,083748,Staff,0,16,30,30
1651047219384,MATH 18,B02,083749,Staff,0,14,30,30
1651047219384,MATH 18,B03,083750,Staff,0,14,30,30
1651047219384,MATH 18,B04,083751,Staff,0,13,30,30
1651047225414,MATH 20A,A01,083754,Staff,18,0,40,22
1651047231442,MATH 20B,A01,083756,Staff,0,14,30,30
1651047231442,MATH 20B,A02,083757,Staff,0,11,30,30
1651047237467,MATH 20C,A01,083760,Staff,0,16,30,30
1651047237467,MATH 20C,A02,083761,Staff,0,15,30,30
1651047237467,MATH 20C,B01,083762,Staff,8,0,30,22
1651047237467,MATH 20C,B02,083763,Staff,28,0,30,2
1651047243491,MATH 20D,A01,083765,Staff,3,1,30,27
1651047243491,MATH 20D,A02,083766,Staff,1,0,30,29
1651047243491,MATH 20D,A03,083767,Staff,22,0,30,8
1651047249519,MATH 20E,A01,083771,Staff,2,0,30,28
1651047249519,MATH 20E,A02,083772,Staff,10,0,30,20
1651047249519,MATH 20E,B01,083773,Staff,0,0,30,30
1651047249519,MATH 20E,B02,083774,Staff,0,0,30,30
1651047255557,MATH 103A,A01,083777,Staff,0,17,30,30
1651047255557,MATH 103A,A02,083778,Staff,0,16,30,30
1651047255557,MATH 103A,B01,083779,Staff,0,15,30,30
1651047255557,MATH 103A,B02,083780,Staff,0,13,30,30
1651047261580,MATH 105,A01,085443,Staff,0,23,30,30
1651047267611,MATH 109,A01,083213,Anzaldo; Leesa B,0,7,30,30
1651047267611,MATH 109,A02,083214,Anzaldo; Leesa B,0,7,30,30
1651047267611,MATH 109,B01,083215,Anzaldo; Leesa B,0,8,30,30
1651047267611,MATH 109,B02,083216,Anzaldo; Leesa B,0,8,30,30
1651047273635,MATH 142A,A01,083219,Chow; Bennett,0,15,30,30
1651047273635,MATH 142A,A02,083220,Chow; Bennett,0,15,30,30
1651047273635,MATH 142A,B01,083221,Chow; Bennett,0,16,30,30
1651047273635,MATH 142A,B02,083222,Chow; Bennett,0,14,30,30
1651047279664,MATH 193A,A01,083224,Staff,0,8,30,30
1651047279664,MATH 193A,A02,083225,Staff,0,7,30,30
1651047279664,MATH 193A,A03,083781,Staff,0,7,30,30
1651047279664,MATH 193A,A04,083782,Staff,0,7,30,30
1651047285700,MATH 197,001,091859,McAuley; Julian John,9998,0,9999,1
1651047291765,COGS 9,A01,083615,Staff,0,20,60,60
1651047297794,COGS 11,A01,083617,Boyle; Mary E. T.,13,0,40,27
1651047303821,COGS 13,A01,083071,Staff,0,40,40,40
1651047309845,COGS 14A,A01,092681,Staff,0,40,100,100
1651047315868,COGS 14B,A01,083073,Cheng; Tzu-Han,0,13,50,50
1651047321891,COGS 17,A01,092677,Staff,9,0,75,66
1651047327921,COGS 100,A01,083619,Staff,0,30,60,60
1651047333960,COGS 101A,A01,083621,Davis; Joshua Daniel,0,29,60,60
1651047339985,COGS 101B,A01,091572,Staff,0,7,60,60
1651047346009,COGS 101C,A01,083625,Delgado; Tania,14,0,30,16
1651047352035,COGS 107A,A01,083627,Boyle; Mary E. T.,0,17,60,60
1651047358067,COGS 118A,A01,083075,Staff,0,10,60,60
1651047364104,CSE 3,A50,083646,Miranda; Gregory Joseph,15,0,38,23
1651047364104,CSE 3,A51,083647,Miranda; Gregory Joseph,36,0,37,1
1651047370129,CSE 8A,A50,083650,Miranda; Gregory Joseph,0,31,40,40
1651047376155,CSE 11,A01,083080,Cao; Yingjun,1,97,40,39
1651047382179,CSE 12,A01,083652,Staff,0,26,100,100
1651047388207,CSE 15L,A01,083654,Staff,0,3,50,50
1651047388207,CSE 15L,A02,083655,Staff,0,3,50,50
1651047394233,CSE 20,A01,083657,Staff,46,0,80,34
1651047400257,CSE 30,A01,083084,Eldon; John,0,38,80,80
1651047406282,CSE 100,A01,083659,Cao; Yingjun,0,72,50,50
1651047412312,CSE 134B,A01,083661,Powell; Thomas Allan,0,38,65,65
1651047418336,CSE 140,A01,083663,Staff,0,15,75,75
1651047424358,CSE 140L,A01,083088,Eldon; John,3,0,100,97
1651047430382,CSE 175,A01,083665,Kumar; Rakesh,0,0,25,25
1651047436420,CSE 190,A00,092507,Dubnov; Shlomo,9,0,20,11
1651047442444,ECE 45,A01,083139,Staff,0,7,60,60
1651047448471,ECE 65,A50,083695,Staff,0,7,30,30
1651047454494,ECE 109,A01,091882,Touri; Behrouz,33,0,70,37
1651047460518,ECE 180,A00,083140,Abi Samra; Nicholas Camill,17,0,30,13
1651047460518,ECE 180,B00,083141,Abi Samra; Nicholas Camill,0,0,30,30
1651047466543,MATH 10A,A01,083735,Patchell; Gregory David,0,0,30,30
1651047466543,MATH 10A,A02,083736,Patchell; Gregory David,27,0,30,3
1651047466543,MATH 10A,A03,083737,Patchell; Gregory David,23,0,30,7
1651047472567,MATH 10B,A01,083207,Staff,0,7,30,30
1651047472567,MATH 10B,A02,083208,Staff,0,6,30,30
1651047472567,MATH 10B,B01,083739,Staff,8,0,30,22
1651047472567,MATH 10B,B02,083740,Staff,28,0,30,2
1651047478601,MATH 18,A01,083743,Staff,0,0,30,30
1651047478601,MATH 18,A02,083744,Staff,23,0,30,7
1651047478601,MATH 18,A03,083745,Staff,19,0,30,11
1651047478601,MATH 18,A04,083746,Staff,26,0,30,4
1651047478601,MATH 18,B01,083748,Staff,0,16,30,30
1651047478601,MATH 18,B02,083749,Staff,0,14,30,30
1651047478601,MATH 18,B03,083750,Staff,0,14,30,30
1651047478601,MATH 18,B04,083751,Staff,0,13,30,30
1651047484626,MATH 20A,A01,083754,Staff,18,0,40,22
1651047490653,MATH 20B,A01,083756,Staff,0,14,30,30
1651047490653,MATH 20B,A02,083757,Staff,0,11,30,30
1651047496684,MATH 20C,A01,083760,Staff,0,16,30,30
1651047496684,MATH 20C,A02,083761,Staff,0,15,30,30
1651047496684,MATH 20C,B01,083762,Staff,8,0,30,22
1651047496684,MATH 20C,B02,083763,Staff,28,0,30,2
1651047502716,MATH 20D,A01,083765,Staff,3,1,30,27
1651047502716,MATH 20D,A02,083766,Staff,1,0,30,29
1651047502716,MATH 20D,A03,083767,Staff,22,0,30,8
1651047508748,MATH 20E,A01,083771,Staff,2,0,30,28
1651047508748,MATH 20E,A02,083772,Staff,10,0,30,20
1651047508748,MATH 20E,B01,083773,Staff,0,0,30,30
1651047508748,MATH 20E,B02,083774,Staff,0,0,30,30
1651047514771,MATH 103A,A01,083777,Staff,0,17,30,30
1651047514771,MATH 103A,A02,083778,Staff,0,16,30,30
1651047514771,MATH 103A,B01,083779,Staff,0,15,30,30
1651047514771,MATH 103A,B02,083780,Staff,0,13,30,30
1651047520797,MATH 105,A01,085443,Staff,0,23,30,30
1651047526821,MATH 109,A01,083213,Anzaldo; Leesa B,0,7,30,30
1651047526821,MATH 109,A02,083214,Anzaldo; Leesa B,0,7,30,30
1651047526821,MATH 109,B01,083215,Anzaldo; Leesa B,0,8,30,30
1651047526821,MATH 109,B02,083216,Anzaldo; Leesa B,0,8,30,30
1651047532851,MATH 142A,A01,083219,Chow; Bennett,0,15,30,30
1651047532851,MATH 142A,A02,083220,Chow; Bennett,0,15,30,30
1651047532851,MATH 142A,B01,083221,Chow; Bennett,0,16,30,30
1651047532851,MATH 142A,B02,083222,Chow; Bennett,0,14,30,30
1651047538875,MATH 193A,A01,083224,Staff,0,8,30,30
1651047538875,MATH 193A,A02,083225,Staff,0,7,30,30
1651047538875,MATH 193A,A03,083781,Staff,0,7,30,30
1651047538875,MATH 193A,A04,083782,Staff,0,7,30,30
1651047544898,MATH 197,001,091859,McAuley; Julian John,9998,0,9999,1
1651047550950,COGS 9,A01,083615,Staff,0,20,60,60
1651047556974,COGS 11,A01,083617,Boyle; Mary E. T.,13,0,40,27
1651047563001,COGS 13,A01,083071,Staff,0,40,40,40
1651047569025,COGS 14A,A01,092681,Staff,0,40,100,100
1651047575049,COGS 14B,A01,083073,Cheng; Tzu-Han,0,13,50,50
1651047581073,COGS 17,A01,092677,Staff,9,0,75,66
1651047587171,COGS 100,A01,083619,Staff,0,30,60,60
1651047593195,COGS 101A,A01,083621,Davis; Joshua Daniel,0,29,60,60
1651047599219,COGS 101B,A01,091572,Staff,0,7,60,60
1651047605246,COGS 101C,A01,083625,Delgado; Tania,14,0,30,16
1651047611270,COGS 107A,A01,083627,Boyle; Mary E. T.,0,17,60,60
1651047617292,COGS 118A,A01,083075,Staff,0,10,60,60
1651047623322,CSE 3,A50,083646,Miranda; Gregory Joseph,15,0,38,23
1651047623322,CSE 3,A51,083647,Miranda; Gregory Joseph,36,0,37,1
1651047629350,CSE 8A,A50,083650,Miranda; Gregory Joseph,0,31,40,40
1651047635374,CSE 11,A01,083080,Cao; Yingjun,1,97,40,39
1651047641398,CSE 12,A01,083652,Staff,0,26,100,100
1651047647423,CSE 15L,A01,083654,Staff,0,3,50,50
1651047647423,CSE 15L,A02,083655,Staff,0,3,50,50
1651047653447,CSE 20,A01,083657,Staff,46,0,80,34
1651047659474,CSE 30,A01,083084,Eldon; John,0,38,80,80
1651047665516,CSE 100,A01,083659,Cao; Yingjun,0,72,50,50
1651047671537,CSE 134B,A01,083661,Powell; Thomas Allan,0,38,65,65
1651047677561,CSE 140,A01,083663,Staff,0,15,75,75
1651047683585,CSE 140L,A01,083088,Eldon; John,3,0,100,97
1651047689608,CSE 175,A01,083665,Kumar; Rakesh,0,0,25,25
1651047695634,CSE 190,A00,092507,Dubnov; Shlomo,9,0,20,11
1651047701657,ECE 45,A01,083139,Staff,0,7,60,60
1651047707684,ECE 65,A50,083695,Staff,0,7,30,30
1651047713710,ECE 109,A01,091882,Touri; Behrouz,33,0,70,37
1651047719738,ECE 180,A00,083140,Abi Samra; Nicholas Camill,17,0,30,13
1651047719738,ECE 180,B00,083141,Abi Samra; Nicholas Camill,0,0,30,30
1651047725768,MATH 10A,A01,083735,Patchell; Gregory David,0,0,30,30
1651047725768,MATH 10A,A02,083736,Patchell; Gregory David,27,0,30,3
1651047725768,MATH 10A,A03,083737,Patchell; Gregory David,23,0,30,7
1651047731801,MATH 10B,A01,083207,Staff,0,7,30,30
1651047731801,MATH 10B,A02,083208,Staff,0,6,30,30
1651047731801,MATH 10B,B01,083739,Staff,8,0,30,22
1651047731801,MATH 10B,B02,083740,Staff,28,0,30,2
1651047737839,MATH 18,A01,083743,Staff,0,0,30,30
1651047737839,MATH 18,A02,083744,Staff,23,0,30,7
1651047737839,MATH 18,A03,083745,Staff,19,0,30,11
1651047737839,MATH 18,A04,083746,Staff,26,0,30,4
1651047737839,MATH 18,B01,083748,Staff,0,16,30,30
1651047737839,MATH 18,B02,083749,Staff,0,14,30,30
1651047737839,MATH 18,B03,083750,Staff,0,14,30,30
1651047737839,MATH 18,B04,083751,Staff,0,13,30,30
1651047743861,MATH 20A,A01,083754,Staff,18,0,40,22
1651047749888,MATH 20B,A01,083756,Staff,0,14,30,30
1651047749888,MATH 20B,A02,083757,Staff,0,11,30,30
1651047755912,MATH 20C,A01,083760,Staff,0,16,30,30
1651047755912,MATH 20C,A02,083761,Staff,0,15,30,30
1651047755912,MATH 20C,B01,083762,Staff,8,0,30,22
1651047755912,MATH 20C,B02,083763,Staff,28,0,30,2
1651047761940,MATH 20D,A01,083765,Staff,3,1,30,27
1651047761940,MATH 20D,A02,083766,Staff,1,0,30,29
1651047761940,MATH 20D,A03,083767,Staff,22,0,30,8
1651047767964,MATH 20E,A01,083771,Staff,2,0,30,28
1651047767964,MATH 20E,A02,083772,Staff,10,0,30,20
1651047767964,MATH 20E,B01,083773,Staff,0,0,30,30
1651047767964,MATH 20E,B02,083774,Staff,0,0,30,30
1651047773993,MATH 103A,A01,083777,Staff,0,17,30,30
1651047773993,MATH 103A,A02,083778,Staff,0,16,30,30
1651047773993,MATH 103A,B01,083779,Staff,0,15,30,30
1651047773993,MATH 103A,B02,083780,Staff,0,13,30,30
1651047780021,MATH 105,A01,085443,Staff,0,23,30,30
1651047786046,MATH 109,A01,083213,Anzaldo; Leesa B,0,7,30,30
1651047786046,MATH 109,A02,083214,Anzaldo; Leesa B,0,7,30,30
1651047786046,MATH 109,B01,083215,Anzaldo; Leesa B,0,8,30,30
1651047786046,MATH 109,B02,083216,Anzaldo; Leesa B,0,8,30,30
1651047792070,MATH 142A,A01,083219,Chow; Bennett,0,15,30,30
1651047792070,MATH 142A,A02,083220,Chow; Bennett,0,15,30,30
1651047792070,MATH 142A,B01,083221,Chow; Bennett,0,16,30,30
1651047792070,MATH 142A,B02,083222,Chow; Bennett,0,14,30,30
1651047798093,MATH 193A,A01,083224,Staff,0,8,30,30
1651047798093,MATH 193A,A02,083225,Staff,0,7,30,30
1651047798093,MATH 193A,A03,083781,Staff,0,7,30,30
1651047798093,MATH 193A,A04,083782,Staff,0,7,30,30
1651047804115,MATH 197,001,091859,McAuley; Julian John,9998,0,9999,1
1651047810182,COGS 9,A01,083615,Staff,0,20,60,60
1651047816206,COGS 11,A01,083617,Boyle; Mary E. T.,13,0,40,27
1651047822235,COGS 13,A01,083071,Staff,0,40,40,40
1651047828258,COGS 14A,A01,092681,Staff,0,40,100,100
1651047834287,COGS 14B,A01,083073,Cheng; Tzu-Han,0,13,50,50
1651047840312,COGS 17,A01,092677,Staff,9,0,75,66
1651047846338,COGS 100,A01,083619,Staff,0,30,60,60
1651047852363,COGS 101A,A01,083621,Davis; Joshua Daniel,0,29,60,60
1651047858390,COGS 101B,A01,091572,Staff,0,7,60,60
1651047864414,COGS 101C,A01,083625,Delgado; Tania,14,0,30,16
1651047870436,COGS 107A,A01,083627,Boyle; Mary E. T.,0,17,60,60
1651047876458,COGS 118A,A01,083075,Staff,0,10,60,60
1651047882486,CSE 3,A50,083646,Miranda; Gregory Joseph,15,0,38,23
1651047882486,CSE 3,A51,083647,Miranda; Gregory Joseph,36,0,37,1
1651047888510,CSE 8A,A50,083650,Miranda; Gregory Joseph,0,31,40,40
1651047894538,CSE 11,A01,083080,Cao; Yingjun,1,97,40,39
1651047900579,CSE 12,A01,083652,Staff,0,26,100,100
1651047906608,CSE 15L,A01,083654,Staff,0,3,50,50
1651047906608,CSE 15L,A02,083655,Staff,0,3,50,50
1651047912631,CSE 20,A01,083657,Staff,46,0,80,34
1651047918654,CSE 30,A01,083084,Eldon; John,0,38,80,80
1651047924681,CSE 100,A01,083659,Cao; Yingjun,0,72,50,50
1651047930705,CSE 134B,A01,083661,Powell; Thomas Allan,0,38,65,65
1651047936732,CSE 140,A01,083663,Staff,0,15,75,75
1651047942755,CSE 140L,A01,083088,Eldon; John,3,0,100,97
1651047948787,CSE 175,A01,083665,Kumar; Rakesh,0,0,25,25
1651047954814,CSE 190,A00,092507,Dubnov; Shlomo,9,0,20,11
1651047960838,ECE 45,A01,083139,Staff,0,7,60,60
1651047966864,ECE 65,A50,083695,Staff,0,7,30,30
1651047972891,ECE 109,A01,091882,Touri; Behrouz,33,0,70,37
1651047978915,ECE 180,A00,083140,Abi Samra; Nicholas Camill,17,0,30,13
1651047978915,ECE 180,B00,083141,Abi Samra; Nicholas Camill,0,0,30,30
1651047984939,MATH 10A,A01,083735,Patchell; Gregory David,0,0,30,30
1651047984939,MATH 10A,A02,083736,Patchell; Gregory David,27,0,30,3
1651047984939,MATH 10A,A03,083737,Patchell; Gregory David,23,0,30,7
1651047990963,MATH 10B,A01,083207,Staff,0,7,30,30
1651047990963,MATH 10B,A02,083208,Staff,0,6,30,30
1651047990963,MATH 10B,B01,083739,Staff,8,0,30,22
1651047990963,MATH 10B,B02,083740,Staff,28,0,30,2
1651047996988,MATH 18,A01,083743,Staff,0,0,30,30
1651047996988,MATH 18,A02,083744,Staff,23,0,30,7
1651047996988,MATH 18,A03,083745,Staff,19,0,30,11
1651047996988,MATH 18,A04,083746,Staff,26,0,30,4
1651047996988,MATH 18,B01,083748,Staff,0,16,30,30
1651047996988,MATH 18,B02,083749,Staff,0,14,30,30
1651047996988,MATH 18,B03,083750,Staff,0,14,30,30
1651047996988,MATH 18,B04,083751,Staff,0,13,30,30
1651048003014,MATH 20A,A01,083754,Staff,18,0,40,22
1651048009048,MATH 20B,A01,083756,Staff,0,14,30,30
1651048009048,MATH 20B,A02,083757,Staff,0,11,30,30
1651048015089,MATH 20C,A01,083760,Staff,0,16,30,30
1651048015089,MATH 20C,A02,083761,Staff,0,15,30,30
1651048015089,MATH 20C,B01,083762,Staff,8,0,30,22
1651048015089,MATH 20C,B02,083763,Staff,28,0,30,2
1651048021114,MATH 20D,A01,083765,Staff,3,1,30,27
1651048021114,MATH 20D,A02,083766,Staff,1,0,30,29
1651048021114,MATH 20D,A03,083767,Staff,22,0,30,8
1651048027139,MATH 20E,A01,083771,Staff,2,0,30,28
1651048027139,MATH 20E,A02,083772,Staff,10,0,30,20
1651048027139,MATH 20E,B01,083773,Staff,0,0,30,30
1651048027139,MATH 20E,B02,083774,Staff,0,0,30,30
1651048033164,MATH 103A,A01,083777,Staff,0,17,30,30
1651048033164,MATH 103A,A02,083778,Staff,0,16,30,30
1651048033164,MATH 103A,B01,083779,Staff,0,15,30,30
1651048033164,MATH 103A,B02,083780,Staff,0,13,30,30
1651048039189,MATH 105,A01,085443,Staff,0,23,30,30
1651048045216,MATH 109,A01,083213,Anzaldo; Leesa B,0,7,30,30
1651048045216,MATH 109,A02,083214,Anzaldo; Leesa B,0,7,30,30
1651048045216,MATH 109,B01,083215,Anzaldo; Leesa B,0,8,30,30
1651048045216,MATH 109,B02,083216,Anzaldo; Leesa B,0,8,30,30
1651048051242,MATH 142A,A01,083219,Chow; Bennett,0,15,30,30
1651048051242,MATH 142A,A02,083220,Chow; Bennett,0,15,30,30
1651048051242,MATH 142A,B01,083221,Chow; Bennett,0,16,30,30
1651048051242,MATH 142A,B02,083222,Chow; Bennett,0,14,30,30
1651048057267,MATH 193A,A01,083224,Staff,0,8,30,30
1651048057267,MATH 193A,A02,083225,Staff,0,7,30,30
1651048057267,MATH 193A,A03,083781,Staff,0,7,30,30
1651048057267,MATH 193A,A04,083782,Staff,0,7,30,30
1651048063291,MATH 197,001,091859,McAuley; Julian John,9998,0,9999,1
1651048069348,COGS 9,A01,083615,Staff,0,20,60,60
1651048075383,COGS 11,A01,083617,Boyle; Mary E. T.,13,0,40,27
1651048081414,COGS 13,A01,083071,Staff,0,40,40,40
1651048087442,COGS 14A,A01,092681,Staff,0,40,100,100
1651048093469,COGS 14B,A01,083073,Cheng; Tzu-Han,0,13,50,50
1651048099493,COGS 17,A01,092677,Staff,9,0,75,66
1651048105517,COGS 100,A01,083619,Staff,0,30,60,60
1651048111541,COGS 101A,A01,083621,Davis; Joshua Daniel,0,29,60,60
1651048117567,COGS 101B,A01,091572,Staff,0,7,60,60
1651048123595,COGS 101C,A01,083625,Delgado; Tania,14,0,30,16
1651048129624,COGS 107A,A01,083627,Boyle; Mary E. T.,0,17,60,60
1651048135646,COGS 118A,A01,083075,Staff,0,10,60,60
1651048141674,CSE 3,A50,083646,Miranda; Gregory Joseph,15,0,38,23
1651048141674,CSE 3,A51,083647,Miranda; Gregory Joseph,36,0,37,1
1651048147707,CSE 8A,A50,083650,Miranda; Gregory Joseph,0,31,40,40
1651048153729,CSE 11,A01,083080,Cao; Yingjun,1,97,40,39
1651048159752,CSE 12,A01,083652,Staff,0,26,100,100
1651048165784,CSE 15L,A01,083654,Staff,0,3,50,50
1651048165784,CSE 15L,A02,083655,Staff,0,3,50,50
1651048171811,CSE 20,A01,083657,Staff,46,0,80,34
1651048177836,CSE 30,A01,083084,Eldon; John,0,38,80,80
1651048183956,CSE 100,A01,083659,Cao; Yingjun,0,72,50,50
1651048189982,CSE 134B,A01,083661,Powell; Thomas Allan,0,38,65,65
1651048196006,CSE 140,A01,083663,Staff,0,15,75,75
1651048202028,CSE 140L,A01,083088,Eldon; John,3,0,100,97
1651048208054,CSE 175,A01,083665,Kumar; Rakesh,0,0,25,25
1651048214084,CSE 190,A00,092507,Dubnov; Shlomo,9,0,20,11
1651048220111,ECE 45,A01,083139,Staff,0,7,60,60
1651048226136,ECE 65,A50,083695,Staff,0,7,30,30
1651048232165,ECE 109,A01,091882,Touri; Behrouz,33,0,70,37
1651048238190,ECE 180,A00,083140,Abi Samra; Nicholas Camill,17,0,30,13
1651048238190,ECE 180,B00,083141,Abi Samra; Nicholas Camill,0,0,30,30
1651048244215,MATH 10A,A01,083735,Patchell; Gregory David,0,0,30,30
1651048244215,MATH 10A,A02,083736,Patchell; Gregory David,27,0,30,3
1651048244215,MATH 10A,A03,083737,Patchell; Gregory David,23,0,30,7
1651048250240,MATH 10B,A01,083207,Staff,0,7,30,30
1651048250240,MATH 10B,A02,083208,Staff,0,6,30,30
1651048250240,MATH 10B,B01,083739,Staff,8,0,30,22
1651048250240,MATH 10B,B02,083740,Staff,28,0,30,2
1651048256264,MATH 18,A01,083743,Staff,0,0,30,30
1651048256264,MATH 18,A02,083744,Staff,23,0,30,7
1651048256264,MATH 18,A03,083745,Staff,19,0,30,11
1651048256264,MATH 18,A04,083746,Staff,26,0,30,4
1651048256264,MATH 18,B01,083748,Staff,0,16,30,30
1651048256264,MATH 18,B02,083749,Staff,0,14,30,30
1651048256264,MATH 18,B03,083750,Staff,0,14,30,30
1651048256264,MATH 18,B04,083751,Staff,0,13,30,30
1651048262294,MATH 20A,A01,083754,Staff,18,0,40,22
1651048268319,MATH 20B,A01,083756,Staff,0,14,30,30
1651048268319,MATH 20B,A02,083757,Staff,0,11,30,30
1651048274344,MATH 20C,A01,083760,Staff,0,16,30,30
1651048274344,MATH 20C,A02,083761,Staff,0,15,30,30
1651048274344,MATH 20C,B01,083762,Staff,8,0,30,22
1651048274344,MATH 20C,B02,083763,Staff,28,0,30,2
1651048280373,MATH 20D,A01,083765,Staff,3,1,30,27
1651048280373,MATH 20D,A02,083766,Staff,1,0,30,29
1651048280373,MATH 20D,A03,083767,Staff,22,0,30,8
1651048286402,MATH 20E,A01,083771,Staff,2,0,30,28
1651048286402,MATH 20E,A02,083772,Staff,10,0,30,20
1651048286402,MATH 20E,B01,083773,Staff,0,0,30,30
1651048286402,MATH 20E,B02,083774,Staff,0,0,30,30
1651048292433,MATH 103A,A01,083777,Staff,0,17,30,30
1651048292433,MATH 103A,A02,083778,Staff,0,16,30,30
1651048292433,MATH 103A,B01,083779,Staff,0,15,30,30
1651048292433,MATH 103A,B02,083780,Staff,0,13,30,30
1651048298462,MATH 105,A01,085443,Staff,0,23,30,30
1651048304486,MATH 109,A01,083213,Anzaldo; Leesa B,0,7,30,30
1651048304486,MATH 109,A02,083214,Anzaldo; Leesa B,0,7,30,30
1651048304486,MATH 109,B01,083215,Anzaldo; Leesa B,0,8,30,30
1651048304486,MATH 109,B02,083216,Anzaldo; Leesa B,0,8,30,30
1651048310514,MATH 142A,A01,083219,Chow; Bennett,0,15,30,30
1651048310514,MATH 142A,A02,083220,Chow; Bennett,0,15,30,30
1651048310514,MATH 142A,B01,083221,Chow; Bennett,0,16,30,30
1651048310514,MATH 142A,B02,083222,Chow; Bennett,0,14,30,30
1651048316544,MATH 193A,A01,083224,Staff,0,8,30,30
1651048316544,MATH 193A,A02,083225,Staff,0,7,30,30
1651048316544,MATH 193A,A03,083781,Staff,0,7,30,30
1651048316544,MATH 193A,A04,083782,Staff,0,7,30,30
1651048322569,MATH 197,001,091859,McAuley; Julian John,9998,0,9999,1
1651048328631,COGS 9,A01,083615,Staff,0,20,60,60
1651048334659,COGS 11,A01,083617,Boyle; Mary E. T.,13,0,40,27
1651048340685,COGS 13,A01,083071,Staff,0,40,40,40
1651048346707,COGS 14A,A01,092681,Staff,0,40,100,100
1651048352734,COGS 14B,A01,083073,Cheng; Tzu-Han,0,13,50,50
1651048358757,COGS 17,A01,092677,Staff,9,0,75,66
1651048364781,COGS 100,A01,083619,Staff,0,30,60,60
1651048370806,COGS 101A,A01,083621,Davis; Joshua Daniel,0,29,60,60
1651048376830,COGS 101B,A01,091572,Staff,0,7,60,60
1651048382861,COGS 101C,A01,083625,Delgado; Tania,14,0,30,16
1651048388885,COGS 107A,A01,083627,Boyle; Mary E. T.,0,17,60,60
1651048394909,COGS 118A,A01,083075,Staff,0,10,60,60
1651048400934,CSE 3,A50,083646,Miranda; Gregory Joseph,15,0,38,23
1651048400934,CSE 3,A51,083647,Miranda; Gregory Joseph,36,0,37,1
1651048406965,CSE 8A,A50,083650,Miranda; Gregory Joseph,0,31,40,40
1651048412987,CSE 11,A01,083080,Cao; Yingjun,1,97,40,39
1651048419011,CSE 12,A01,083652,Staff,0,26,100,100
1651048425034,CSE 15L,A01,083654,Staff,0,3,50,50
1651048425034,CSE 15L,A02,083655,Staff,0,3,50,50
1651048431061,CSE 20,A01,083657,Staff,46,0,80,34
1651048437091,CSE 30,A01,083084,Eldon; John,0,38,80,80
1651048443118,CSE 100,A01,083659,Cao; Yingjun,0,72,50,50
1651048449143,CSE 134B,A01,083661,Powell; Thomas Allan,0,38,65,65
1651048455168,CSE 140,A01,083663,Staff,0,15,75,75
1651048461192,CSE 140L,A01,083088,Eldon; John,3,0,100,97
1651048467216,CSE 175,A01,083665,Kumar; Rakesh,0,0,25,25
1651048473245,CSE 190,A00,092507,Dubnov; Shlomo,9,0,20,11
1651048479271,ECE 45,A01,083139,Staff,0,7,60,60
1651048485296,ECE 65,A50,083695,Staff,0,7,30,30
1651048491323,ECE 109,A01,091882,Touri; Behrouz,33,0,70,37
1651048497348,ECE 180,A00,083140,Abi Samra; Nicholas Camill,17,0,30,13
1651048497348,ECE 180,B00,083141,Abi Samra; Nicholas Camill,0,0,30,30
1651048503373,MATH 10A,A01,083735,Patchell; Gregory David,0,0,30,30
1651048503373,MATH 10A,A02,083736,Patchell; Gregory David,27,0,30,3
1651048503373,MATH 10A,A03,083737,Patchell; Gregory David,23,0,30,7
1651048509399,MATH 10B,A01,083207,Staff,0,7,30,30
1651048509399,MATH 10B,A02,083208,Staff,0,6,30,30
1651048509399,MATH 10B,B01,083739,Staff,8,0,30,22
1651048509399,MATH 10B,B02,083740,Staff,28,0,30,2
1651048515431,MATH 18,A01,083743,Staff,0,0,30,30
1651048515431,MATH 18,A02,083744,Staff,23,0,30,7
1651048515431,MATH 18,A03,083745,Staff,19,0,30,11
1651048515431,MATH 18,A04,083746,Staff,26,0,30,4
1651048515431,MATH 18,B01,083748,Staff,0,16,30,30
1651048515431,MATH 18,B02,083749,Staff,0,14,30,30
1651048515431,MATH 18,B03,083750,Staff,0,14,30,30
1651048515431,MATH 18,B04,083751,Staff,0,13,30,30
1651048521457,MATH 20A,A01,083754,Staff,18,0,40,22
1651048527480,MATH 20B,A01,083756,Staff,0,14,30,30
1651048527480,MATH 20B,A02,083757,Staff,0,11,30,30
1651048533509,MATH 20C,A01,083760,Staff,0,16,30,30
1651048533509,MATH 20C,A02,083761,Staff,0,15,30,30
1651048533509,MATH 20C,B01,083762,Staff,8,0,30,22
1651048533509,MATH 20C,B02,083763,Staff,28,0,30,2
1651048539536,MATH 20D,A01,083765,Staff,3,1,30,27
1651048539536,MATH 20D,A02,083766,Staff,1,0,30,29
1651048539536,MATH 20D,A03,083767,Staff,22,0,30,8
1651048545561,MATH 20E,A01,083771,Staff,2,0,30,28
1651048545561,MATH 20E,A02,083772,Staff,10,0,30,20
1651048545561,MATH 20E,B01,083773,Staff,0,0,30,30
1651048545561,MATH 20E,B02,083774,Staff,0,0,30,30
1651048551589,MATH 103A,A01,083777,Staff,0,17,30,30
1651048551589,MATH 103A,A02,083778,Staff,0,16,30,30
1651048551589,MATH 103A,B01,083779,Staff,0,15,30,30
1651048551589,MATH 103A,B02,083780,Staff,0,13,30,30
1651048557619,MATH 105,A01,085443,Staff,0,23,30,30
1651048563648,MATH 109,A01,083213,Anzaldo; Leesa B,0,7,30,30
1651048563648,MATH 109,A02,083214,Anzaldo; Leesa B,0,7,30,30
1651048563648,MATH 109,B01,083215,Anzaldo; Leesa B,0,8,30,30
1651048563648,MATH 109,B02,083216,Anzaldo; Leesa B,0,8,30,30
1651048569687,MATH 142A,A01,083219,Chow; Bennett,0,15,30,30
1651048569687,MATH 142A,A02,083220,Chow; Bennett,0,15,30,30
1651048569687,MATH 142A,B01,083221,Chow; Bennett,0,16,30,30
1651048569687,MATH 142A,B02,083222,Chow; Bennett,0,14,30,30
1651048575712,MATH 193A,A01,083224,Staff,0,8,30,30
1651048575712,MATH 193A,A02,083225,Staff,0,7,30,30
1651048575712,MATH 193A,A03,083781,Staff,0,7,30,30
1651048575712,MATH 193A,A04,083782,Staff,0,7,30,30
1651048581736,MATH 197,001,091859,McAuley; Julian John,9998,0,9999,1
1651048587798,COGS 9,A01,083615,Staff,0,20,60,60
1651048593822,COGS 11,A01,083617,Boyle; Mary E. T.,13,0,40,27
1651048599851,COGS 13,A01,083071,Staff,0,40,40,40
1651048605879,COGS 14A,A01,092681,Staff,0,40,100,100
1651048611904,COGS 14B,A01,083073,Cheng; Tzu-Han,0,13,50,50
1651048617931,COGS 17,A01,092677,Staff,9,0,75,66
1651048623955,COGS 100,A01,083619,Staff,0,30,60,60
1651048629978,COGS 101A,A01,083621,Davis; Joshua Daniel,0,29,60,60
1651048636002,COGS 101B,A01,091572,Staff,0,7,60,60
1651048642029,COGS 101C,A01,083625,Delgado; Tania,14,0,30,16
1651048648054,COGS 107A,A01,083627,Boyle; Mary E. T.,0,17,60,60
1651048654077,COGS 118A,A01,083075,Staff,0,10,60,60
1651048660101,CSE 3,A50,083646,Miranda; Gregory Joseph,15,0,38,23
1651048660101,CSE 3,A51,083647,Miranda; Gregory Joseph,36,0,37,1
1651048666129,CSE 8A,A50,083650,Miranda; Gregory Joseph,0,31,40,40
1651048672156,CSE 11,A01,083080,Cao; Yingjun,1,97,40,39
1651048678180,CSE 12,A01,083652,Staff,0,26,100,100
1651048684205,CSE 15L,A01,083654,Staff,0,3,50,50
1651048684205,CSE 15L,A02,083655,Staff,0,3,50,50
1651048690231,CSE 20,A01,083657,Staff,46,0,80,34
1651048696259,CSE 30,A01,083084,Eldon; John,0,38,80,80
1651048702291,CSE 100,A01,083659,Cao; Yingjun,0,72,50,50
1651048708316,CSE 134B,A01,083661,Powell; Thomas Allan,0,38,65,65
1651048714341,CSE 140,A01,083663,Staff,0,15,75,75
1651048720364,CSE 140L,A01,083088,Eldon; John,3,0,100,97
1651048726387,CSE 175,A01,083665,Kumar; Rakesh,0,0,25,25
1651048732411,CSE 190,A00,092507,Dubnov; Shlomo,9,0,20,11
1651048738435,ECE 45,A01,083139,Staff,0,7,60,60
1651048744460,ECE 65,A50,083695,Staff,0,7,30,30
1651048750483,ECE 109,A01,091882,Touri; Behrouz,33,0,70,37
1651048756508,ECE 180,A00,083140,Abi Samra; Nicholas Camill,17,0,30,13
1651048756508,ECE 180,B00,083141,Abi Samra; Nicholas Camill,0,0,30,30
1651048762535,MATH 10A,A01,083735,Patchell; Gregory David,0,0,30,30
1651048762535,MATH 10A,A02,083736,Patchell; Gregory David,27,0,30,3
1651048762535,MATH 10A,A03,083737,Patchell; Gregory David,23,0,30,7
1651048768565,MATH 10B,A01,083207,Staff,0,7,30,30
1651048768565,MATH 10B,A02,083208,Staff,0,6,30,30
1651048768565,MATH 10B,B01,083739,Staff,8,0,30,22
1651048768565,MATH 10B,B02,083740,Staff,28,0,30,2
1651048774598,MATH 18,A01,083743,Staff,0,0,30,30
1651048774598,MATH 18,A02,083744,Staff,23,0,30,7
1651048774598,MATH 18,A03,083745,Staff,19,0,30,11
1651048774598,MATH 18,A04,083746,Staff,26,0,30,4
1651048774598,MATH 18,B01,083748,Staff,0,16,30,30
1651048774598,MATH 18,B02,083749,Staff,0,14,30,30
1651048774598,MATH 18,B03,083750,Staff,0,14,30,30
1651048774598,MATH 18,B04,083751,Staff,0,13,30,30
1651048780717,MATH 20A,A01,083754,Staff,18,0,40,22
1651048786741,MATH 20B,A01,083756,Staff,0,14,30,30
1651048786741,MATH 20B,A02,083757,Staff,0,11,30,30
1651048792770,MATH 20C,A01,083760,Staff,0,16,30,30
1651048792770,MATH 20C,A02,083761,Staff,0,15,30,30
1651048792770,MATH 20C,B01,083762,Staff,8,0,30,22
1651048792770,MATH 20C,B02,083763,Staff,28,0,30,2
1651048798797,MATH 20D,A01,083765,Staff,3,1,30,27
1651048798797,MATH 20D,A02,083766,Staff,1,0,30,29
1651048798797,MATH 20D,A03,083767,Staff,22,0,30,8
1651048804822,MATH 20E,A01,083771,Staff,2,0,30,28
1651048804822,MATH 20E,A02,083772,Staff,10,0,30,20
1651048804822,MATH 20E,B01,083773,Staff,0,0,30,30
1651048804822,MATH 20E,B02,083774,Staff,0,0,30,30
1651048810851,MATH 103A,A01,083777,Staff,0,17,30,30
1651048810851,MATH 103A,A02,083778,Staff,0,16,30,30
1651048810851,MATH 103A,B01,083779,Staff,0,15,30,30
1651048810851,MATH 103A,B02,083780,Staff,0,13,30,30
1651048816882,MATH 105,A01,085443,Staff,0,23,30,30
1651048822906,MATH 109,A01,083213,Anzaldo; Leesa B,0,7,30,30
1651048822906,MATH 109,A02,083214,Anzaldo; Leesa B,0,7,30,30
1651048822906,MATH 109,B01,083215,Anzaldo; Leesa B,0,8,30,30
1651048822906,MATH 109,B02,083216,Anzaldo; Leesa B,0,8,30,30
1651048828930,MATH 142A,A01,083219,Chow; Bennett,0,15,30,30
1651048828930,MATH 142A,A02,083220,Chow; Bennett,0,15,30,30
1651048828930,MATH 142A,B01,083221,Chow; Bennett,0,16,30,30
1651048828930,MATH 142A,B02,083222,Chow; Bennett,0,14,30,30
1651048834954,MATH 193A,A01,083224,Staff,0,8,30,30
1651048834954,MATH 193A,A02,083225,Staff,0,7,30,30
1651048834954,MATH 193A,A03,083781,Staff,0,7,30,30
1651048834954,MATH 193A,A04,083782,Staff,0,7,30,30
1651048840977,MATH 197,001,091859,McAuley; Julian John,9998,0,9999,1
1651048847037,COGS 9,A01,083615,Staff,0,20,60,60
1651048853070,COGS 11,A01,083617,Boyle; Mary E. T.,13,0,40,27
1651048859098,COGS 13,A01,083071,Staff,0,40,40,40
1651048865125,COGS 14A,A01,092681,Staff,0,40,100,100
1651048871150,COGS 14B,A01,083073,Cheng; Tzu-Han,0,13,50,50
1651048877175,COGS 17,A01,092677,Staff,9,0,75,66
1651048883200,COGS 100,A01,083619,Staff,0,30,60,60
1651048889227,COGS 101A,A01,083621,Davis; Joshua Daniel,0,29,60,60
1651048895251,COGS 101B,A01,091572,Staff,0,7,60,60
1651048901279,COGS 101C,A01,083625,Delgado; Tania,14,0,30,16
1651048907304,COGS 107A,A01,083627,Boyle; Mary E. T.,0,17,60,60
1651048913327,COGS 118A,A01,083075,Staff,0,10,60,60
1651048919352,CSE 3,A50,083646,Miranda; Gregory Joseph,15,0,38,23
1651048919352,CSE 3,A51,083647,Miranda; Gregory Joseph,36,0,37,1
1651048925376,CSE 8A,A50,083650,Miranda; Gregory Joseph,0,31,40,40
1651048931402,CSE 11,A01,083080,Cao; Yingjun,1,97,40,39
1651048937437,CSE 12,A01,083652,Staff,0,26,100,100
1651048943462,CSE 15L,A01,083654,Staff,0,3,50,50
1651048943462,CSE 15L,A02,083655,Staff,0,3,50,50
1651048949491,CSE 20,A01,083657,Staff,46,0,80,34
1651048955514,CSE 30,A01,083084,Eldon; John,0,38,80,80
1651048961539,CSE 100,A01,083659,Cao; Yingjun,0,72,50,50
1651048967564,CSE 134B,A01,083661,Powell; Thomas Allan,0,38,65,65
1651048973588,CSE 140,A01,083663,Staff,0,15,75,75
1651048979613,CSE 140L,A01,083088,Eldon; John,3,0,100,97
1651048985636,CSE 175,A01,083665,Kumar; Rakesh,0,0,25,25
1651048991664,CSE 190,A00,092507,Dubnov; Shlomo,9,0,20,11
1651048997688,ECE 45,A01,083139,Staff,0,7,60,60
1651049003724,ECE 65,A50,083695,Staff,0,7,30,30
1651049009748,ECE 109,A01,091882,Touri; Behrouz,33,0,70,37
1651049015779,ECE 180,A00,083140,Abi Samra; Nicholas Camill,17,0,30,13
1651049015779,ECE 180,B00,083141,Abi Samra; Nicholas Camill,0,0,30,30
1651049021809,MATH 10A,A01,083735,Patchell; Gregory David,0,0,30,30
1651049021809,MATH 10A,A02,083736,Patchell; Gregory David,27,0,30,3
1651049021809,MATH 10A,A03,083737,Patchell; Gregory David,23,0,30,7
1651049027836,MATH 10B,A01,083207,Staff,0,7,30,30
1651049027836,MATH 10B,A02,083208,Staff,0,6,30,30
1651049027836,MATH 10B,B01,083739,Staff,8,0,30,22
1651049027836,MATH 10B,B02,083740,Staff,28,0,30,2
1651049033868,MATH 18,A01,083743,Staff,0,0,30,30
1651049033868,MATH 18,A02,083744,Staff,23,0,30,7
1651049033868,MATH 18,A03,083745,Staff,19,0,30,11
1651049033868,MATH 18,A04,083746,Staff,26,0,30,4
1651049033868,MATH 18,B01,083748,Staff,0,16,30,30
1651049033868,MATH 18,B02,083749,Staff,0,14,30,30
1651049033868,MATH 18,B03,083750,Staff,0,14,30,30
1651049033868,MATH 18,B04,083751,Staff,0,13,30,30
1651049039899,MATH 20A,A01,083754,Staff,18,0,40,22
1651049045922,MATH 20B,A01,083756,Staff,0,14,30,30
1651049045922,MATH 20B,A02,083757,Staff,0,11,30,30
1651049051950,MATH 20C,A01,083760,Staff,0,16,30,30
1651049051950,MATH 20C,A02,083761,Staff,0,15,30,30
1651049051950,MATH 20C,B01,083762,Staff,8,0,30,22
1651049051950,MATH 20C,B02,083763,Staff,28,0,30,2
1651049057978,MATH 20D,A01,083765,Staff,3,1,30,27
1651049057978,MATH 20D,A02,083766,Staff,1,0,30,29
1651049057978,MATH 20D,A03,083767,Staff,22,0,30,8
1651049064002,MATH 20E,A01,083771,Staff,2,0,30,28
1651049064002,MATH 20E,A02,083772,Staff,10,0,30,20
1651049064002,MATH 20E,B01,083773,Staff,0,0,30,30
1651049064002,MATH 20E,B02,083774,Staff,0,0,30,30
1651049070039,MATH 103A,A01,083777,Staff,0,17,30,30
1651049070039,MATH 103A,A02,083778,Staff,0,16,30,30
1651049070039,MATH 103A,B01,083779,Staff,0,15,30,30
1651049070039,MATH 103A,B02,083780,Staff,0,13,30,30
1651049076064,MATH 105,A01,085443,Staff,0,23,30,30
1651049082091,MATH 109,A01,083213,Anzaldo; Leesa B,0,7,30,30
1651049082091,MATH 109,A02,083214,Anzaldo; Leesa B,0,7,30,30
1651049082091,MATH 109,B01,083215,Anzaldo; Leesa B,0,8,30,30
1651049082091,MATH 109,B02,083216,Anzaldo; Leesa B,0,8,30,30
1651049088119,MATH 142A,A01,083219,Chow; Bennett,0,15,30,30
1651049088119,MATH 142A,A02,083220,Chow; Bennett,0,15,30,30
1651049088119,MATH 142A,B01,083221,Chow; Bennett,0,16,30,30
1651049088119,MATH 142A,B02,083222,Chow; Bennett,0,14,30,30
1651049094147,MATH 193A,A01,083224,Staff,0,8,30,30
1651049094147,MATH 193A,A02,083225,Staff,0,7,30,30
1651049094147,MATH 193A,A03,083781,Staff,0,7,30,30
1651049094147,MATH 193A,A04,083782,Staff,0,7,30,30
1651049100168,MATH 197,001,091859,McAuley; Julian John,9998,0,9999,1
1651049106244,COGS 9,A01,083615,Staff,0,20,60,60
1651049112268,COGS 11,A01,083617,Boyle; Mary E. T.,13,0,40,27
1651049118291,COGS 13,A01,083071,Staff,0,40,40,40
1651049124314,COGS 14A,A01,092681,Staff,0,40,100,100
1651049130337,COGS 14B,A01,083073,Cheng; Tzu-Han,0,13,50,50
1651049136363,COGS 17,A01,092677,Staff,9,0,75,66
1651049142389,COGS 100,A01,083619,Staff,0,30,60,60
1651049148427,COGS 101A,A01,083621,Davis; Joshua Daniel,0,29,60,60
1651049154454,COGS 101B,A01,091572,Staff,0,7,60,60
1651049160478,COGS 101C,A01,083625,Delgado; Tania,14,0,30,16
1651049166504,COGS 107A,A01,083627,Boyle; Mary E. T.,0,17,60,60
1651049172529,COGS 118A,A01,083075,Staff,0,10,60,60
1651049178555,CSE 3,A50,083646,Miranda; Gregory Joseph,15,0,38,23
1651049178555,CSE 3,A51,083647,Miranda; Gregory Joseph,36,0,37,1
1651049184583,CSE 8A,A50,083650,Miranda; Gregory Joseph,0,31,40,40
1651049190611,CSE 11,A01,083080,Cao; Yingjun,1,97,40,39
1651049196635,CSE 12,A01,083652,Staff,0,26,100,100
1651049202662,CSE 15L,A01,083654,Staff,0,3,50,50
1651049202662,CSE 15L,A02,083655,Staff,0,3,50,50
1651049208692,CSE 20,A01,083657,Staff,46,0,80,34
1651049214723,CSE 30,A01,083084,Eldon; John,0,38,80,80
1651049220747,CSE 100,A01,083659,Cao; Yingjun,0,72,50,50
1651049226778,CSE 134B,A01,083661,Powell; Thomas Allan,0,38,65,65
1651049232800,CSE 140,A01,083663,Staff,0,15,75,75
1651049238823,CSE 140L,A01,083088,Eldon; John,3,0,100,97
1651049244847,CSE 175,A01,083665,Kumar; Rakesh,0,0,25,25
1651049250870,CSE 190,A00,092507,Dubnov; Shlomo,9,0,20,11
1651049256894,ECE 45,A01,083139,Staff,0,7,60,60
1651049262917,ECE 65,A50,083695,Staff,0,7,30,30
1651049268941,ECE 109,A01,091882,Touri; Behrouz,33,0,70,37
1651049274966,ECE 180,A00,083140,Abi Samra; Nicholas Camill,17,0,30,13
1651049274966,ECE 180,B00,083141,Abi Samra; Nicholas Camill,0,0,30,30
1651049280990,MATH 10A,A01,083735,Patchell; Gregory David,0,0,30,30
1651049280990,MATH 10A,A02,083736,Patchell; Gregory David,27,0,30,3
1651049280990,MATH 10A,A03,083737,Patchell; Gregory David,23,0,30,7
1651049287020,MATH 10B,A01,083207,Staff,0,7,30,30
1651049287020,MATH 10B,A02,083208,Staff,0,6,30,30
1651049287020,MATH 10B,B01,083739,Staff,8,0,30,22
1651049287020,MATH 10B,B02,083740,Staff,28,0,30,2
1651049293052,MATH 18,A01,083743,Staff,0,0,30,30
1651049293052,MATH 18,A02,083744,Staff,23,0,30,7
1651049293052,MATH 18,A03,083745,Staff,19,0,30,11
1651049293052,MATH 18,A04,083746,Staff,26,0,30,4
1651049293052,MATH 18,B01,083748,Staff,0,16,30,30
1651049293052,MATH 18,B02,083749,Staff,0,14,30,30
1651049293052,MATH 18,B03,083750,Staff,0,14,30,30
1651049293052,MATH 18,B04,083751,Staff,0,13,30,30
1651049299076,MATH 20A,A01,083754,Staff,18,0,40,22
1651049305101,MATH 20B,A01,083756,Staff,0,14,30,30
1651049305101,MATH 20B,A02,083757,Staff,0,11,30,30
1651049311125,MATH 20C,A01,083760,Staff,0,16,30,30
1651049311125,MATH 20C,A02,083761,Staff,0,15,30,30
1651049311125,MATH 20C,B01,083762,Staff,8,0,30,22
1651049311125,MATH 20C,B02,083763,Staff,28,0,30,2
1651049317152,MATH 20D,A01,083765,Staff,3,1,30,27
1651049317152,MATH 20D,A02,083766,Staff,1,0,30,29
1651049317152,MATH 20D,A03,083767,Staff,22,0,30,8
1651049323176,MATH 20E,A01,083771,Staff,2,0,30,28
1651049323176,MATH 20E,A02,083772,Staff,10,0,30,20
1651049323176,MATH 20E,B01,083773,Staff,0,0,30,30
1651049323176,MATH 20E,B02,083774,Staff,0,0,30,30
1651049329200,MATH 103A,A01,083777,Staff,0,17,30,30
1651049329200,MATH 103A,A02,083778,Staff,0,16,30,30
1651049329200,MATH 103A,B01,083779,Staff,0,15,30,30
1651049329200,MATH 103A,B02,083780,Staff,0,13,30,30
1651049335226,MATH 105,A01,085443,Staff,0,23,30,30
1651049341251,MATH 109,A01,083213,Anzaldo; Leesa B,0,7,30,30
1651049341251,MATH 109,A02,083214,Anzaldo; Leesa B,0,7,30,30
1651049341251,MATH 109,B01,083215,Anzaldo; Leesa B,0,8,30,30
1651049341251,MATH 109,B02,083216,Anzaldo; Leesa B,0,8,30,30
1651049347280,MATH 142A,A01,083219,Chow; Bennett,0,15,30,30
1651049347280,MATH 142A,A02,083220,Chow; Bennett,0,15,30,30
1651049347280,MATH 142A,B01,083221,Chow; Bennett,0,16,30,30
1651049347280,MATH 142A,B02,083222,Chow; Bennett,0,14,30,30
1651049353308,MATH 193A,A01,083224,Staff,0,8,30,30
1651049353308,MATH 193A,A02,083225,Staff,0,7,30,30
1651049353308,MATH 193A,A03,083781,Staff,0,7,30,30
1651049353308,MATH 193A,A04,083782,Staff,0,7,30,30
1651049359335,MATH 197,001,091859,McAuley; Julian John,9998,0,9999,1
1651049365389,COGS 9,A01,083615,Staff,0,20,60,60
1651049371501,COGS 11,A01,083617,Boyle; Mary E. T.,13,0,40,27
1651049377525,COGS 13,A01,083071,Staff,0,40,40,40
1651049383550,COGS 14A,A01,092681,Staff,0,40,100,100
1651049389581,COGS 14B,A01,083073,Cheng; Tzu-Han,0,13,50,50
1651049395605,COGS 17,A01,092677,Staff,9,0,75,66
1651049401635,COGS 100,A01,083619,Staff,0,30,60,60
1651049407661,COGS 101A,A01,083621,Davis; Joshua Daniel,0,29,60,60
1651049413686,COGS 101B,A01,091572,Staff,0,7,60,60
1651049419712,COGS 101C,A01,083625,Delgado; Tania,14,0,30,16
1651049425746,COGS 107A,A01,083627,Boyle; Mary E. T.,0,17,60,60
1651049431770,COGS 118A,A01,083075,Staff,0,10,60,60
1651049437795,CSE 3,A50,083646,Miranda; Gregory Joseph,15,0,38,23
1651049437795,CSE 3,A51,083647,Miranda; Gregory Joseph,36,0,37,1
1651049443819,CSE 8A,A50,083650,Miranda; Gregory Joseph,0,31,40,40
1651049449846,CSE 11,A01,083080,Cao; Yingjun,1,97,40,39
1651049455869,CSE 12,A01,083652,Staff,0,26,100,100
1651049461893,CSE 15L,A01,083654,Staff,0,3,50,50
1651049461893,CSE 15L,A02,083655,Staff,0,3,50,50
1651049467918,CSE 20,A01,083657,Staff,46,0,80,34
1651049473945,CSE 30,A01,083084,Eldon; John,0,38,80,80
1651049479972,CSE 100,A01,083659,Cao; Yingjun,0,72,50,50
1651049485997,CSE 134B,A01,083661,Powell; Thomas Allan,0,38,65,65
1651049492026,CSE 140,A01,083663,Staff,0,15,75,75
1651049498050,CSE 140L,A01,083088,Eldon; John,3,0,100,97
1651049504075,CSE 175,A01,083665,Kumar; Rakesh,0,0,25,25
1651049510103,CSE 190,A00,092507,Dubnov; Shlomo,9,0,20,11
1651049516127,ECE 45,A01,083139,Staff,0,7,60,60
1651049522156,ECE 65,A50,083695,Staff,0,7,30,30
1651049528185,ECE 109,A01,091882,Touri; Behrouz,33,0,70,37
1651049534213,ECE 180,A00,083140,Abi Samra; Nicholas Camill,17,0,30,13
1651049534213,ECE 180,B00,083141,Abi Samra; Nicholas Camill,0,0,30,30
1651049540238,MATH 10A,A01,083735,Patchell; Gregory David,0,0,30,30
1651049540238,MATH 10A,A02,083736,Patchell; Gregory David,27,0,30,3
1651049540238,MATH 10A,A03,083737,Patchell; Gregory David,23,0,30,7
1651049546265,MATH 10B,A01,083207,Staff,0,7,30,30
1651049546265,MATH 10B,A02,083208,Staff,0,6,30,30
1651049546265,MATH 10B,B01,083739,Staff,8,0,30,22
1651049546265,MATH 10B,B02,083740,Staff,28,0,30,2
1651049552292,MATH 18,A01,083743,Staff,0,0,30,30
1651049552292,MATH 18,A02,083744,Staff,23,0,30,7
1651049552292,MATH 18,A03,083745,Staff,19,0,30,11
1651049552292,MATH 18,A04,083746,Staff,26,0,30,4
1651049552292,MATH 18,B01,083748,Staff,0,16,30,30
1651049552292,MATH 18,B02,083749,Staff,0,14,30,30
1651049552292,MATH 18,B03,083750,Staff,0,14,30,30
1651049552292,MATH 18,B04,083751,Staff,0,13,30,30
1651049558319,MATH 20A,A01,083754,Staff,18,0,40,22
1651049564346,MATH 20B,A01,083756,Staff,0,14,30,30
1651049564346,MATH 20B,A02,083757,Staff,0,11,30,30
1651049570375,MATH 20C,A01,083760,Staff,0,16,30,30
1651049570375,MATH 20C,A02,083761,Staff,0,15,30,30
1651049570375,MATH 20C,B01,083762,Staff,8,0,30,22
1651049570375,MATH 20C,B02,083763,Staff,28,0,30,2
1651049576401,MATH 20D,A01,083765,Staff,3,1,30,27
1651049576401,MATH 20D,A02,083766,Staff,1,0,30,29
1651049576401,MATH 20D,A03,083767,Staff,22,0,30,8
1651049582427,MATH 20E,A01,083771,Staff,2,0,30,28
1651049582427,MATH 20E,A02,083772,Staff,10,0,30,20
1651049582427,MATH 20E,B01,083773,Staff,0,0,30,30
1651049582427,MATH 20E,B02,083774,Staff,0,0,30,30
1651049588452,MATH 103A,A01,083777,Staff,0,17,30,30
1651049588452,MATH 103A,A02,083778,Staff,0,16,30,30
1651049588452,MATH 103A,B01,083779,Staff,0,15,30,30
1651049588452,MATH 103A,B02,083780,Staff,0,13,30,30
1651049594476,MATH 105,A01,085443,Staff,0,23,30,30
1651049600498,MATH 109,A01,083213,Anzaldo; Leesa B,0,7,30,30
1651049600498,MATH 109,A02,083214,Anzaldo; Leesa B,0,7,30,30
1651049600498,MATH 109,B01,083215,Anzaldo; Leesa B,0,8,30,30
1651049600498,MATH 109,B02,083216,Anzaldo; Leesa B,0,8,30,30
1651049606525,MATH 142A,A01,083219,Chow; Bennett,0,15,30,30
1651049606525,MATH 142A,A02,083220,Chow; Bennett,0,15,30,30
1651049606525,MATH 142A,B01,083221,Chow; Bennett,0,16,30,30
1651049606525,MATH 142A,B02,083222,Chow; Bennett,0,14,30,30
1651049612550,MATH 193A,A01,083224,Staff,0,8,30,30
1651049612550,MATH 193A,A02,083225,Staff,0,7,30,30
1651049612550,MATH 193A,A03,083781,Staff,0,7,30,30
1651049612550,MATH 193A,A04,083782,Staff,0,7,30,30
1651049618576,MATH 197,001,091859,McAuley; Julian John,9998,0,9999,1
1651049624632,COGS 9,A01,083615,Staff,0,20,60,60
1651049630656,COGS 11,A01,083617,Boyle; Mary E. T.,13,0,40,27
1651049636682,COGS 13,A01,083071,Staff,0,40,40,40
1651049642711,COGS 14A,A01,092681,Staff,0,40,100,100
1651049648735,COGS 14B,A01,083073,Cheng; Tzu-Han,0,13,50,50
1651049654760,COGS 17,A01,092677,Staff,9,0,75,66
1651049660784,COGS 100,A01,083619,Staff,0,30,60,60
1651049666811,COGS 101A,A01,083621,Davis; Joshua Daniel,0,29,60,60
1651049672834,COGS 101B,A01,091572,Staff,0,7,60,60
1651049678859,COGS 101C,A01,083625,Delgado; Tania,14,0,30,16
1651049684886,COGS 107A,A01,083627,Boyle; Mary E. T.,0,17,60,60
1651049690910,COGS 118A,A01,083075,Staff,0,10,60,60
1651049696936,CSE 3,A50,083646,Miranda; Gregory Joseph,15,0,38,23
1651049696936,CSE 3,A51,083647,Miranda; Gregory Joseph,36,0,37,1
1651049702966,CSE 8A,A50,083650,Miranda; Gregory Joseph,0,31,40,40
1651049708990,CSE 11,A01,083080,Cao; Yingjun,1,97,40,39
1651049715017,CSE 12,A01,083652,Staff,0,26,100,100
1651049721042,CSE 15L,A01,083654,Staff,0,3,50,50
1651049721042,CSE 15L,A02,083655,Staff,0,3,50,50
1651049727066,CSE 20,A01,083657,Staff,46,0,80,34
1651049733091,CSE 30,A01,083084,Eldon; John,0,38,80,80
1651049739114,CSE 100,A01,083659,Cao; Yingjun,0,72,50,50
1651049745142,CSE 134B,A01,083661,Powell; Thomas Allan,0,38,65,65
1651049751168,CSE 140,A01,083663,Staff,0,15,75,75
1651049757192,CSE 140L,A01,083088,Eldon; John,3,0,100,97
1651049763217,CSE 175,A01,083665,Kumar; Rakesh,0,0,25,25
1651049769250,CSE 190,A00,092507,Dubnov; Shlomo,9,0,20,11
1651049775274,ECE 45,A01,083139,Staff,0,7,60,60
1651049781301,ECE 65,A50,083695,Staff,0,7,30,30
1651049787326,ECE 109,A01,091882,Touri; Behrouz,33,0,70,37
1651049793349,ECE 180,A00,083140,Abi Samra; Nicholas Camill,17,0,30,13
1651049793349,ECE 180,B00,083141,Abi Samra; Nicholas Camill,0,0,30,30
1651049799376,MATH 10A,A01,083735,Patchell; Gregory David,0,0,30,30
1651049799376,MATH 10A,A02,083736,Patchell; Gregory David,27,0,30,3
1651049799376,MATH 10A,A03,083737,Patchell; Gregory David,23,0,30,7
1651049805401,MATH 10B,A01,083207,Staff,0,7,30,30
1651049805401,MATH 10B,A02,083208,Staff,0,6,30,30
1651049805401,MATH 10B,B01,083739,Staff,8,0,30,22
1651049805401,MATH 10B,B02,083740,Staff,28,0,30,2
1651049811425,MATH 18,A01,083743,Staff,0,0,30,30
1651049811425,MATH 18,A02,083744,Staff,23,0,30,7
1651049811425,MATH 18,A03,083745,Staff,19,0,30,11
1651049811425,MATH 18,A04,083746,Staff,26,0,30,4
1651049811425,MATH 18,B01,083748,Staff,0,16,30,30
1651049811425,MATH 18,B02,083749,Staff,0,14,30,30
1651049811425,MATH 18,B03,083750,Staff,0,14,30,30
1651049811425,MATH 18,B04,083751,Staff,0,13,30,30
1651049817451,MATH 20A,A01,083754,Staff,18,0,40,22
1651049823474,MATH 20B,A01,083756,Staff,0,14,30,30
1651049823474,MATH 20B,A02,083757,Staff,0,11,30,30
1651049829499,MATH 20C,A01,083760,Staff,0,16,30,30
1651049829499,MATH 20C,A02,083761,Staff,0,15,30,30
1651049829499,MATH 20C,B01,083762,Staff,8,0,30,22
1651049829499,MATH 20C,B02,083763,Staff,28,0,30,2
1651049835522,MATH 20D,A01,083765,Staff,3,1,30,27
1651049835522,MATH 20D,A02,083766,Staff,1,0,30,29
1651049835522,MATH 20D,A03,083767,Staff,22,0,30,8
1651049841547,MATH 20E,A01,083771,Staff,2,0,30,28
1651049841547,MATH 20E,A02,083772,Staff,10,0,30,20
1651049841547,MATH 20E,B01,083773,Staff,0,0,30,30
1651049841547,MATH 20E,B02,083774,Staff,0,0,30,30
1651049847588,MATH 103A,A01,083777,Staff,0,17,30,30
1651049847588,MATH 103A,A02,083778,Staff,0,16,30,30
1651049847588,MATH 103A,B01,083779,Staff,0,15,30,30
1651049847588,MATH 103A,B02,083780,Staff,0,13,30,30
1651049853613,MATH 105,A01,085443,Staff,0,23,30,30
1651049859637,MATH 109,A01,083213,Anzaldo; Leesa B,0,7,30,30
1651049859637,MATH 109,A02,083214,Anzaldo; Leesa B,0,7,30,30
1651049859637,MATH 109,B01,083215,Anzaldo; Leesa B,0,8,30,30
1651049859637,MATH 109,B02,083216,Anzaldo; Leesa B,0,8,30,30
1651049865662,MATH 142A,A01,083219,Chow; Bennett,0,15,30,30
1651049865662,MATH 142A,A02,083220,Chow; Bennett,0,15,30,30
1651049865662,MATH 142A,B01,083221,Chow; Bennett,0,16,30,30
1651049865662,MATH 142A,B02,083222,Chow; Bennett,0,14,30,30
1651049871687,MATH 193A,A01,083224,Staff,0,8,30,30
1651049871687,MATH 193A,A02,083225,Staff,0,7,30,30
1651049871687,MATH 193A,A03,083781,Staff,0,7,30,30
1651049871687,MATH 193A,A04,083782,Staff,0,7,30,30
1651049877712,MATH 197,001,091859,McAuley; Julian John,9998,0,9999,1
1651049883775,COGS 9,A01,083615,Staff,0,20,60,60
1651049889802,COGS 11,A01,083617,Boyle; Mary E. T.,13,0,40,27
1651049895826,COGS 13,A01,083071,Staff,0,40,40,40
1651049901854,COGS 14A,A01,092681,Staff,0,40,100,100
1651049907880,COGS 14B,A01,083073,Cheng; Tzu-Han,0,13,50,50
1651049913904,COGS 17,A01,092677,Staff,9,0,75,66
1651049919934,COGS 100,A01,083619,Staff,0,30,60,60
1651049925959,COGS 101A,A01,083621,Davis; Joshua Daniel,0,29,60,60
1651049931983,COGS 101B,A01,091572,Staff,0,7,60,60
1651049938017,COGS 101C,A01,083625,Delgado; Tania,14,0,30,16
1651049944041,COGS 107A,A01,083627,Boyle; Mary E. T.,0,17,60,60
1651049950081,COGS 118A,A01,083075,Staff,0,10,60,60
1651049956107,CSE 3,A50,083646,Miranda; Gregory Joseph,15,0,38,23
1651049956107,CSE 3,A51,083647,Miranda; Gregory Joseph,36,0,37,1
1651049962130,CSE 8A,A50,083650,Miranda; Gregory Joseph,0,31,40,40
1651049968248,CSE 11,A01,083080,Cao; Yingjun,1,97,40,39
1651049974271,CSE 12,A01,083652,Staff,0,26,100,100
1651049980310,CSE 15L,A01,083654,Staff,0,3,50,50
1651049980310,CSE 15L,A02,083655,Staff,0,3,50,50
1651049986338,CSE 20,A01,083657,Staff,46,0,80,34
1651049992364,CSE 30,A01,083084,Eldon; John,0,38,80,80
1651049998388,CSE 100,A01,083659,Cao; Yingjun,0,72,50,50
1651050004414,CSE 134B,A01,083661,Powell; Thomas Allan,0,38,65,65
1651050010442,CSE 140,A01,083663,Staff,0,15,75,75
1651050016468,CSE 140L,A01,083088,Eldon; John,3,0,100,97
1651050022495,CSE 175,A01,083665,Kumar; Rakesh,0,0,25,25
1651050028519,CSE 190,A00,092507,Dubnov; Shlomo,9,0,20,11
1651050034547,ECE 45,A01,083139,Staff,0,7,60,60
1651050040577,ECE 65,A50,083695,Staff,0,7,30,30
1651050046600,ECE 109,A01,091882,Touri; Behrouz,33,0,70,37
1651050052639,ECE 180,A00,083140,Abi Samra; Nicholas Camill,17,0,30,13
1651050052639,ECE 180,B00,083141,Abi Samra; Nicholas Camill,0,0,30,30
1651050058670,MATH 10A,A01,083735,Patchell; Gregory David,0,0,30,30
1651050058670,MATH 10A,A02,083736,Patchell; Gregory David,27,0,30,3
1651050058670,MATH 10A,A03,083737,Patchell; Gregory David,23,0,30,7
1651050064701,MATH 10B,A01,083207,Staff,0,7,30,30
1651050064701,MATH 10B,A02,083208,Staff,0,6,30,30
1651050064701,MATH 10B,B01,083739,Staff,8,0,30,22
1651050064701,MATH 10B,B02,083740,Staff,28,0,30,2
1651050070727,MATH 18,A01,083743,Staff,0,0,30,30
1651050070727,MATH 18,A02,083744,Staff,23,0,30,7
1651050070727,MATH 18,A03,083745,Staff,19,0,30,11
1651050070727,MATH 18,A04,083746,Staff,26,0,30,4
1651050070727,MATH 18,B01,083748,Staff,0,16,30,30
1651050070727,MATH 18,B02,083749,Staff,0,14,30,30
1651050070727,MATH 18,B03,083750,Staff,0,14,30,30
1651050070727,MATH 18,B04,083751,Staff,0,13,30,30
1651050076754,MATH 20A,A01,083754,Staff,18,0,40,22
1651050082778,MATH 20B,A01,083756,Staff,0,14,30,30
1651050082778,MATH 20B,A02,083757,Staff,0,11,30,30
1651050088802,MATH 20C,A01,083760,Staff,0,16,30,30
1651050088802,MATH 20C,A02,083761,Staff,0,15,30,30
1651050088802,MATH 20C,B01,083762,Staff,8,0,30,22
1651050088802,MATH 20C,B02,083763,Staff,28,0,30,2
1651050094827,MATH 20D,A01,083765,Staff,3,1,30,27
1651050094827,MATH 20D,A02,083766,Staff,1,0,30,29
1651050094827,MATH 20D,A03,083767,Staff,22,0,30,8
1651050100856,MATH 20E,A01,083771,Staff,2,0,30,28
1651050100856,MATH 20E,A02,083772,Staff,10,0,30,20
1651050100856,MATH 20E,B01,083773,Staff,0,0,30,30
1651050100856,MATH 20E,B02,083774,Staff,0,0,30,30
1651050106887,MATH 103A,A01,083777,Staff,0,17,30,30
1651050106887,MATH 103A,A02,083778,Staff,0,16,30,30
1651050106887,MATH 103A,B01,083779,Staff,0,15,30,30
1651050106887,MATH 103A,B02,083780,Staff,0,13,30,30
1651050112915,MATH 105,A01,085443,Staff,0,23,30,30
1651050118939,MATH 109,A01,083213,Anzaldo; Leesa B,0,7,30,30
1651050118939,MATH 109,A02,083214,Anzaldo; Leesa B,0,7,30,30
1651050118939,MATH 109,B01,083215,Anzaldo; Leesa B,0,8,30,30
1651050118939,MATH 109,B02,083216,Anzaldo; Leesa B,0,8,30,30
1651050124964,MATH 142A,A01,083219,Chow; Bennett,0,15,30,30
1651050124964,MATH 142A,A02,083220,Chow; Bennett,0,15,30,30
1651050124964,MATH 142A,B01,083221,Chow; Bennett,0,16,30,30
1651050124964,MATH 142A,B02,083222,Chow; Bennett,0,14,30,30
1651050130989,MATH 193A,A01,083224,Staff,0,8,30,30
1651050130989,MATH 193A,A02,083225,Staff,0,7,30,30
1651050130989,MATH 193A,A03,083781,Staff,0,7,30,30
1651050130989,MATH 193A,A04,083782,Staff,0,7,30,30
1651050137016,MATH 197,001,091859,McAuley; Julian John,9998,0,9999,1
1651050143079,COGS 9,A01,083615,Staff,0,20,60,60
1651050149105,COGS 11,A01,083617,Boyle; Mary E. T.,13,0,40,27
1651050155131,COGS 13,A01,083071,Staff,0,40,40,40
1651050161160,COGS 14A,A01,092681,Staff,0,40,100,100
1651050167189,COGS 14B,A01,083073,Cheng; Tzu-Han,0,13,50,50
1651050173215,COGS 17,A01,092677,Staff,9,0,75,66
1651050179241,COGS 100,A01,083619,Staff,0,30,60,60
1651050185265,COGS 101A,A01,083621,Davis; Joshua Daniel,0,29,60,60
1651050191289,COGS 101B,A01,091572,Staff,0,7,60,60
1651050197317,COGS 101C,A01,083625,Delgado; Tania,14,0,30,16
1651050203340,COGS 107A,A01,083627,Boyle; Mary E. T.,0,17,60,60
1651050209365,COGS 118A,A01,083075,Staff,0,10,60,60
1651050215388,CSE 3,A50,083646,Miranda; Gregory Joseph,15,0,38,23
1651050215388,CSE 3,A51,083647,Miranda; Gregory Joseph,36,0,37,1
1651050221413,CSE 8A,A50,083650,Miranda; Gregory Joseph,0,31,40,40
1651050227436,CSE 11,A01,083080,Cao; Yingjun,1,97,40,39
1651050233463,CSE 12,A01,083652,Staff,0,26,100,100
1651050239489,CSE 15L,A01,083654,Staff,0,3,50,50
1651050239489,CSE 15L,A02,083655,Staff,0,3,50,50
1651050245511,CSE 20,A01,083657,Staff,46,0,80,34
1651050251533,CSE 30,A01,083084,Eldon; John,0,38,80,80
1651050257556,CSE 100,A01,083659,Cao; Yingjun,0,72,50,50
1651050263585,CSE 134B,A01,083661,Powell; Thomas Allan,0,38,65,65
1651050269609,CSE 140,A01,083663,Staff,0,15,75,75
1651050275632,CSE 140L,A01,083088,Eldon; John,3,0,100,97
1651050281655,CSE 175,A01,083665,Kumar; Rakesh,0,0,25,25
1651050287685,CSE 190,A00,092507,Dubnov; Shlomo,9,0,20,11
1651050293724,ECE 45,A01,083139,Staff,0,7,60,60
1651050299749,ECE 65,A50,083695,Staff,0,7,30,30
1651050305781,ECE 109,A01,091882,Touri; Behrouz,33,0,70,37
1651050311809,ECE 180,A00,083140,Abi Samra; Nicholas Camill,17,0,30,13
1651050311809,ECE 180,B00,083141,Abi Samra; Nicholas Camill,0,0,30,30
1651050317836,MATH 10A,A01,083735,Patchell; Gregory David,0,0,30,30
1651050317836,MATH 10A,A02,083736,Patchell; Gregory David,27,0,30,3
1651050317836,MATH 10A,A03,083737,Patchell; Gregory David,23,0,30,7
1651050323863,MATH 10B,A01,083207,Staff,0,7,30,30
1651050323863,MATH 10B,A02,083208,Staff,0,6,30,30
1651050323863,MATH 10B,B01,083739,Staff,8,0,30,22
1651050323863,MATH 10B,B02,083740,Staff,28,0,30,2
1651050329889,MATH 18,A01,083743,Staff,0,0,30,30
1651050329889,MATH 18,A02,083744,Staff,23,0,30,7
1651050329889,MATH 18,A03,083745,Staff,19,0,30,11
1651050329889,MATH 18,A04,083746,Staff,26,0,30,4
1651050329889,MATH 18,B01,083748,Staff,0,16,30,30
1651050329889,MATH 18,B02,083749,Staff,0,14,30,30
1651050329889,MATH 18,B03,083750,Staff,0,14,30,30
1651050329889,MATH 18,B04,083751,Staff,0,13,30,30
1651050335916,MATH 20A,A01,083754,Staff,18,0,40,22
1651050341940,MATH 20B,A01,083756,Staff,0,14,30,30
1651050341940,MATH 20B,A02,083757,Staff,0,11,30,30
1651050347968,MATH 20C,A01,083760,Staff,0,16,30,30
1651050347968,MATH 20C,A02,083761,Staff,0,15,30,30
1651050347968,MATH 20C,B01,083762,Staff,8,0,30,22
1651050347968,MATH 20C,B02,083763,Staff,28,0,30,2
1651050353996,MATH 20D,A01,083765,Staff,3,1,30,27
1651050353996,MATH 20D,A02,083766,Staff,1,0,30,29
1651050353996,MATH 20D,A03,083767,Staff,22,0,30,8
1651050360021,MATH 20E,A01,083771,Staff,2,0,30,28
1651050360021,MATH 20E,A02,083772,Staff,10,0,30,20
1651050360021,MATH 20E,B01,083773,Staff,0,0,30,30
1651050360021,MATH 20E,B02,083774,Staff,0,0,30,30
1651050366052,MATH 103A,A01,083777,Staff,0,17,30,30
1651050366052,MATH 103A,A02,083778,Staff,0,16,30,30
1651050366052,MATH 103A,B01,083779,Staff,0,15,30,30
1651050366052,MATH 103A,B02,083780,Staff,0,13,30,30
1651050372077,MATH 105,A01,085443,Staff,0,23,30,30
1651050378104,MATH 109,A01,083213,Anzaldo; Leesa B,0,7,30,30
1651050378104,MATH 109,A02,083214,Anzaldo; Leesa B,0,7,30,30
1651050378104,MATH 109,B01,083215,Anzaldo; Leesa B,0,8,30,30
1651050378104,MATH 109,B02,083216,Anzaldo; Leesa B,0,8,30,30
1651050384136,MATH 142A,A01,083219,Chow; Bennett,0,15,30,30
1651050384136,MATH 142A,A02,083220,Chow; Bennett,0,15,30,30
1651050384136,MATH 142A,B01,083221,Chow; Bennett,0,16,30,30
1651050384136,MATH 142A,B02,083222,Chow; Bennett,0,14,30,30
1651050390164,MATH 193A,A01,083224,Staff,0,8,30,30
1651050390164,MATH 193A,A02,083225,Staff,0,7,30,30
1651050390164,MATH 193A,A03,083781,Staff,0,7,30,30
1651050390164,MATH 193A,A04,083782,Staff,0,7,30,30
1651050396186,MATH 197,001,091859,McAuley; Julian John,9998,0,9999,1
1651050402248,COGS 9,A01,083615,Staff,0,20,60,60
1651050408271,COGS 11,A01,083617,Boyle; Mary E. T.,13,0,40,27
1651050414295,COGS 13,A01,083071,Staff,0,40,40,40
1651050420317,COGS 14A,A01,092681,Staff,0,40,100,100
1651050426360,COGS 14B,A01,083073,Cheng; Tzu-Han,0,13,50,50
1651050432384,COGS 17,A01,092677,Staff,9,0,75,66
1651050438411,COGS 100,A01,083619,Staff,0,30,60,60
1651050444434,COGS 101A,A01,083621,Davis; Joshua Daniel,0,29,60,60
1651050450457,COGS 101B,A01,091572,Staff,0,7,60,60
1651050456485,COGS 101C,A01,083625,Delgado; Tania,14,0,30,16
1651050462520,COGS 107A,A01,083627,Boyle; Mary E. T.,0,17,60,60
1651050468544,COGS 118A,A01,083075,Staff,0,10,60,60
1651050474574,CSE 3,A50,083646,Miranda; Gregory Joseph,15,0,38,23
1651050474574,CSE 3,A51,083647,Miranda; Gregory Joseph,36,0,37,1
1651050480601,CSE 8A,A50,083650,Miranda; Gregory Joseph,0,31,40,40
1651050486626,CSE 11,A01,083080,Cao; Yingjun,1,97,40,39
1651050492650,CSE 12,A01,083652,Staff,0,26,100,100
1651050498674,CSE 15L,A01,083654,Staff,0,3,50,50
1651050498674,CSE 15L,A02,083655,Staff,0,3,50,50
1651050504698,CSE 20,A01,083657,Staff,46,0,80,34
1651050510726,CSE 30,A01,083084,Eldon; John,0,38,80,80
1651050516750,CSE 100,A01,083659,Cao; Yingjun,0,72,50,50
1651050522774,CSE 134B,A01,083661,Powell; Thomas Allan,0,38,65,65
1651050528798,CSE 140,A01,083663,Staff,0,15,75,75
1651050534825,CSE 140L,A01,083088,Eldon; John,3,0,100,97
1651050540853,CSE 175,A01,083665,Kumar; Rakesh,0,0,25,25
1651050546877,CSE 190,A00,092507,Dubnov; Shlomo,9,0,20,11
1651050552902,ECE 45,A01,083139,Staff,0,7,60,60
1651050558927,ECE 65,A50,083695,Staff,0,7,30,30
1651050565077,ECE 109,A01,091882,Touri; Behrouz,33,0,70,37
1651050571102,ECE 180,A00,083140,Abi Samra; Nicholas Camill,17,0,30,13
1651050571102,ECE 180,B00,083141,Abi Samra; Nicholas Camill,0,0,30,30
1651050577129,MATH 10A,A01,083735,Patchell; Gregory David,0,0,30,30
1651050577129,MATH 10A,A02,083736,Patchell; Gregory David,27,0,30,3
1651050577129,MATH 10A,A03,083737,Patchell; Gregory David,23,0,30,7
1651050583152,MATH 10B,A01,083207,Staff,0,7,30,30
1651050583152,MATH 10B,A02,083208,Staff,0,6,30,30
1651050583152,MATH 10B,B01,083739,Staff,8,0,30,22
1651050583152,MATH 10B,B02,083740,Staff,28,0,30,2
1651050589178,MATH 18,A01,083743,Staff,0,0,30,30
1651050589178,MATH 18,A02,083744,Staff,23,0,30,7
1651050589178,MATH 18,A03,083745,Staff,19,0,30,11
1651050589178,MATH 18,A04,083746,Staff,26,0,30,4
1651050589178,MATH 18,B01,083748,Staff,0,16,30,30
1651050589178,MATH 18,B02,083749,Staff,0,14,30,30
1651050589178,MATH 18,B03,083750,Staff,0,14,30,30
1651050589178,MATH 18,B04,083751,Staff,0,13,30,30
1651050595200,MATH 20A,A01,083754,Staff,18,0,40,22
1651050601224,MATH 20B,A01,083756,Staff,0,14,30,30
1651050601224,MATH 20B,A02,083757,Staff,0,11,30,30
1651050607248,MATH 20C,A01,083760,Staff,0,16,30,30
1651050607248,MATH 20C,A02,083761,Staff,0,15,30,30
1651050607248,MATH 20C,B01,083762,Staff,8,0,30,22
1651050607248,MATH 20C,B02,083763,Staff,28,0,30,2
1651050613278,MATH 20D,A01,083765,Staff,3,1,30,27
1651050613278,MATH 20D,A02,083766,Staff,1,0,30,29
1651050613278,MATH 20D,A03,083767,Staff,22,0,30,8
1651050619314,MATH 20E,A01,083771,Staff,2,0,30,28
1651050619314,MATH 20E,A02,083772,Staff,10,0,30,20
1651050619314,MATH 20E,B01,083773,Staff,0,0,30,30
1651050619314,MATH 20E,B02,083774,Staff,0,0,30,30
1651050625358,MATH 103A,A01,083777,Staff,0,17,30,30
1651050625358,MATH 103A,A02,083778,Staff,0,16,30,30
1651050625358,MATH 103A,B01,083779,Staff,0,15,30,30
1651050625358,MATH 103A,B02,083780,Staff,0,13,30,30
1651050631389,MATH 105,A01,085443,Staff,0,23,30,30
1651050637416,MATH 109,A01,083213,Anzaldo; Leesa B,0,7,30,30
1651050637416,MATH 109,A02,083214,Anzaldo; Leesa B,0,7,30,30
1651050637416,MATH 109,B01,083215,Anzaldo; Leesa B,0,8,30,30
1651050637416,MATH 109,B02,083216,Anzaldo; Leesa B,0,8,30,30
1651050643444,MATH 142A,A01,083219,Chow; Bennett,0,15,30,30
1651050643444,MATH 142A,A02,083220,Chow; Bennett,0,15,30,30
1651050643444,MATH 142A,B01,083221,Chow; Bennett,0,16,30,30
1651050643444,MATH 142A,B02,083222,Chow; Bennett,0,14,30,30
1651050649468,MATH 193A,A01,083224,Staff,0,8,30,30
1651050649468,MATH 193A,A02,083225,Staff,0,7,30,30
1651050649468,MATH 193A,A03,083781,Staff,0,7,30,30
1651050649468,MATH 193A,A04,083782,Staff,0,7,30,30
1651050655492,MATH 197,001,091859,McAuley; Julian John,9998,0,9999,1
1651050661549,COGS 9,A01,083615,Staff,0,20,60,60
1651050667574,COGS 11,A01,083617,Boyle; Mary E. T.,13,0,40,27
1651050673601,COGS 13,A01,083071,Staff,0,40,40,40
1651050679629,COGS 14A,A01,092681,Staff,0,40,100,100
1651050685653,COGS 14B,A01,083073,Cheng; Tzu-Han,0,13,50,50
1651050691679,COGS 17,A01,092677,Staff,9,0,75,66
1651050697704,COGS 100,A01,083619,Staff,0,30,60,60
1651050703733,COGS 101A,A01,083621,Davis; Joshua Daniel,0,29,60,60
1651050709763,COGS 101B,A01,091572,Staff,0,7,60,60
1651050715791,COGS 101C,A01,083625,Delgado; Tania,14,0,30,16
1651050721814,COGS 107A,A01,083627,Boyle; Mary E. T.,0,17,60,60
1651050727837,COGS 118A,A01,083075,Staff,0,10,60,60
1651050733866,CSE 3,A50,083646,Miranda; Gregory Joseph,15,0,38,23
1651050733866,CSE 3,A51,083647,Miranda; Gregory Joseph,36,0,37,1
1651050739894,CSE 8A,A50,083650,Miranda; Gregory Joseph,0,31,40,40
1651050745919,CSE 11,A01,083080,Cao; Yingjun,1,97,40,39
1651050751947,CSE 12,A01,083652,Staff,0,26,100,100
1651050757979,CSE 15L,A01,083654,Staff,0,3,50,50
1651050757979,CSE 15L,A02,083655,Staff,0,3,50,50
1651050764003,CSE 20,A01,083657,Staff,46,0,80,34
1651050770027,CSE 30,A01,083084,Eldon; John,0,38,80,80
1651050776054,CSE 100,A01,083659,Cao; Yingjun,0,72,50,50
1651050782079,CSE 134B,A01,083661,Powell; Thomas Allan,0,38,65,65
1651050788104,CSE 140,A01,083663,Staff,0,15,75,75
1651050794131,CSE 140L,A01,083088,Eldon; John,3,0,100,97
1651050800158,CSE 175,A01,083665,Kumar; Rakesh,0,0,25,25
1651050806184,CSE 190,A00,092507,Dubnov; Shlomo,9,0,20,11
1651050812208,ECE 45,A01,083139,Staff,0,7,60,60
1651050818231,ECE 65,A50,083695,Staff,0,7,30,30
1651050824264,ECE 109,A01,091882,Touri; Behrouz,33,0,70,37
1651050830287,ECE 180,A00,083140,Abi Samra; Nicholas Camill,17,0,30,13
1651050830287,ECE 180,B00,083141,Abi Samra; Nicholas Camill,0,0,30,30
1651050836318,MATH 10A,A01,083735,Patchell; Gregory David,0,0,30,30
1651050836318,MATH 10A,A02,083736,Patchell; Gregory David,27,0,30,3
1651050836318,MATH 10A,A03,083737,Patchell; Gregory David,23,0,30,7
1651050842343,MATH 10B,A01,083207,Staff,0,7,30,30
1651050842343,MATH 10B,A02,083208,Staff,0,6,30,30
1651050842343,MATH 10B,B01,083739,Staff,8,0,30,22
1651050842343,MATH 10B,B02,083740,Staff,28,0,30,2
1651050848371,MATH 18,A01,083743,Staff,0,0,30,30
1651050848371,MATH 18,A02,083744,Staff,23,0,30,7
1651050848371,MATH 18,A03,083745,Staff,19,0,30,11
1651050848371,MATH 18,A04,083746,Staff,26,0,30,4
1651050848371,MATH 18,B01,083748,Staff,0,16,30,30
1651050848371,MATH 18,B02,083749,Staff,0,14,30,30
1651050848371,MATH 18,B03,083750,Staff,0,14,30,30
1651050848371,MATH 18,B04,083751,Staff,0,13,30,30
1651050854395,MATH 20A,A01,083754,Staff,18,0,40,22
1651050860423,MATH 20B,A01,083756,Staff,0,14,30,30
1651050860423,MATH 20B,A02,083757,Staff,0,11,30,30
1651050866445,MATH 20C,A01,083760,Staff,0,16,30,30
1651050866445,MATH 20C,A02,083761,Staff,0,15,30,30
1651050866445,MATH 20C,B01,083762,Staff,8,0,30,22
1651050866445,MATH 20C,B02,083763,Staff,28,0,30,2
1651050872468,MATH 20D,A01,083765,Staff,3,1,30,27
1651050872468,MATH 20D,A02,083766,Staff,1,0,30,29
1651050872468,MATH 20D,A03,083767,Staff,22,0,30,8
1651050878498,MATH 20E,A01,083771,Staff,2,0,30,28
1651050878498,MATH 20E,A02,083772,Staff,10,0,30,20
1651050878498,MATH 20E,B01,083773,Staff,0,0,30,30
1651050878498,MATH 20E,B02,083774,Staff,0,0,30,30
1651050884539,MATH 103A,A01,083777,Staff,0,17,30,30
1651050884539,MATH 103A,A02,083778,Staff,0,16,30,30
1651050884539,MATH 103A,B01,083779,Staff,0,15,30,30
1651050884539,MATH 103A,B02,083780,Staff,0,13,30,30
1651050890569,MATH 105,A01,085443,Staff,0,23,30,30
1651050896593,MATH 109,A01,083213,Anzaldo; Leesa B,0,7,30,30
1651050896593,MATH 109,A02,083214,Anzaldo; Leesa B,0,7,30,30
1651050896593,MATH 109,B01,083215,Anzaldo; Leesa B,0,8,30,30
1651050896593,MATH 109,B02,083216,Anzaldo; Leesa B,0,8,30,30
1651050902616,MATH 142A,A01,083219,Chow; Bennett,0,15,30,30
1651050902616,MATH 142A,A02,083220,Chow; Bennett,0,15,30,30
1651050902616,MATH 142A,B01,083221,Chow; Bennett,0,16,30,30
1651050902616,MATH 142A,B02,083222,Chow; Bennett,0,14,30,30
1651050908653,MATH 193A,A01,083224,Staff,0,8,30,30
1651050908653,MATH 193A,A02,083225,Staff,0,7,30,30
1651050908653,MATH 193A,A03,083781,Staff,0,7,30,30
1651050908653,MATH 193A,A04,083782,Staff,0,7,30,30
1651050914678,MATH 197,001,091859,McAuley; Julian John,9998,0,9999,1
1651050920741,COGS 9,A01,083615,Staff,0,20,60,60
1651050926847,COGS 11,A01,083617,Boyle; Mary E. T.,13,0,40,27
1651050932874,COGS 13,A01,083071,Staff,0,40,40,40
1651050938898,COGS 14A,A01,092681,Staff,0,40,100,100
1651050944922,COGS 14B,A01,083073,Cheng; Tzu-Han,0,13,50,50
1651050950945,COGS 17,A01,092677,Staff,9,0,75,66
1651050956969,COGS 100,A01,083619,Staff,0,30,60,60
1651050963002,COGS 101A,A01,083621,Davis; Joshua Daniel,0,29,60,60
1651050969029,COGS 101B,A01,091572,Staff,0,7,60,60
1651050975054,COGS 101C,A01,083625,Delgado; Tania,14,0,30,16
1651050981078,COGS 107A,A01,083627,Boyle; Mary E. T.,0,17,60,60
1651050987100,COGS 118A,A01,083075,Staff,0,10,60,60
1651050993129,CSE 3,A50,083646,Miranda; Gregory Joseph,15,0,38,23
1651050993129,CSE 3,A51,083647,Miranda; Gregory Joseph,36,0,37,1
1651050999153,CSE 8A,A50,083650,Miranda; Gregory Joseph,0,31,40,40
1651051005176,CSE 11,A01,083080,Cao; Yingjun,1,97,40,39
1651051011200,CSE 12,A01,083652,Staff,0,26,100,100
1651051017224,CSE 15L,A01,083654,Staff,0,3,50,50
1651051017224,CSE 15L,A02,083655,Staff,0,3,50,50
1651051023250,CSE 20,A01,083657,Staff,46,0,80,34
1651051029273,CSE 30,A01,083084,Eldon; John,0,38,80,80
1651051035297,CSE 100,A01,083659,Cao; Yingjun,0,72,50,50
1651051041323,CSE 134B,A01,083661,Powell; Thomas Allan,0,38,65,65
1651051047356,CSE 140,A01,083663,Staff,0,15,75,75
1651051053380,CSE 140L,A01,083088,Eldon; John,3,0,100,97
1651051059408,CSE 175,A01,083665,Kumar; Rakesh,0,0,25,25
1651051065432,CSE 190,A00,092507,Dubnov; Shlomo,9,0,20,11
1651051071455,ECE 45,A01,083139,Staff,0,7,60,60
1651051077482,ECE 65,A50,083695,Staff,0,7,30,30
1651051083510,ECE 109,A01,091882,Touri; Behrouz,33,0,70,37
1651051089545,ECE 180,A00,083140,Abi Samra; Nicholas Camill,17,0,30,13
1651051089545,ECE 180,B00,083141,Abi Samra; Nicholas Camill,0,0,30,30
1651051095570,MATH 10A,A01,083735,Patchell; Gregory David,0,0,30,30
1651051095570,MATH 10A,A02,083736,Patchell; Gregory David,27,0,30,3
1651051095570,MATH 10A,A03,083737,Patchell; Gregory David,23,0,30,7
1651051101593,MATH 10B,A01,083207,Staff,0,7,30,30
1651051101593,MATH 10B,A02,083208,Staff,0,6,30,30
1651051101593,MATH 10B,B01,083739,Staff,8,0,30,22
1651051101593,MATH 10B,B02,083740,Staff,28,0,30,2
1651051107618,MATH 18,A01,083743,Staff,0,0,30,30
1651051107618,MATH 18,A02,083744,Staff,23,0,30,7
1651051107618,MATH 18,A03,083745,Staff,19,0,30,11
1651051107618,MATH 18,A04,083746,Staff,26,0,30,4
1651051107618,MATH 18,B01,083748,Staff,0,16,30,30
1651051107618,MATH 18,B02,083749,Staff,0,14,30,30
1651051107618,MATH 18,B03,083750,Staff,0,14,30,30
1651051107618,MATH 18,B04,083751,Staff,0,13,30,30
1651051113647,MATH 20A,A01,083754,Staff,18,0,40,22
1651051119673,MATH 20B,A01,083756,Staff,0,14,30,30
1651051119673,MATH 20B,A02,083757,Staff,0,11,30,30
1651051125701,MATH 20C,A01,083760,Staff,0,16,30,30
1651051125701,MATH 20C,A02,083761,Staff,0,15,30,30
1651051125701,MATH 20C,B01,083762,Staff,8,0,30,22
1651051125701,MATH 20C,B02,083763,Staff,28,0,30,2
1651051131728,MATH 20D,A01,083765,Staff,3,1,30,27
1651051131728,MATH 20D,A02,083766,Staff,1,0,30,29
1651051131728,MATH 20D,A03,083767,Staff,22,0,30,8
1651051137752,MATH 20E,A01,083771,Staff,2,0,30,28
1651051137752,MATH 20E,A02,083772,Staff,10,0,30,20
1651051137752,MATH 20E,B01,083773,Staff,0,0,30,30
1651051137752,MATH 20E,B02,083774,Staff,0,0,30,30
1651051143777,MATH 103A,A01,083777,Staff,0,17,30,30
1651051143777,MATH 103A,A02,083778,Staff,0,16,30,30
1651051143777,MATH 103A,B01,083779,Staff,0,15,30,30
1651051143777,MATH 103A,B02,083780,Staff,0,13,30,30
1651051149799,MATH 105,A01,085443,Staff,0,23,30,30
1651051155825,MATH 109,A01,083213,Anzaldo; Leesa B,0,7,30,30
1651051155825,MATH 109,A02,083214,Anzaldo; Leesa B,0,7,30,30
1651051155825,MATH 109,B01,083215,Anzaldo; Leesa B,0,8,30,30
1651051155825,MATH 109,B02,083216,Anzaldo; Leesa B,0,8,30,30
1651051161946,MATH 142A,A01,083219,Chow; Bennett,0,15,30,30
1651051161946,MATH 142A,A02,083220,Chow; Bennett,0,15,30,30
1651051161946,MATH 142A,B01,083221,Chow; Bennett,0,16,30,30
1651051161946,MATH 142A,B02,083222,Chow; Bennett,0,14,30,30
1651051167970,MATH 193A,A01,083224,Staff,0,8,30,30
1651051167970,MATH 193A,A02,083225,Staff,0,7,30,30
1651051167970,MATH 193A,A03,083781,Staff,0,7,30,30
1651051167970,MATH 193A,A04,083782,Staff,0,7,30,30
1651051173997,MATH 197,001,091859,McAuley; Julian John,9998,0,9999,1
1651051180069,COGS 9,A01,083615,Staff,0,20,60,60
1651051186119,COGS 11,A01,083617,Boyle; Mary E. T.,13,0,40,27
1651051192142,COGS 13,A01,083071,Staff,0,40,40,40
1651051198166,COGS 14A,A01,092681,Staff,0,40,100,100
1651051204193,COGS 14B,A01,083073,Cheng; Tzu-Han,0,13,50,50
1651051210215,COGS 17,A01,092677,Staff,9,0,75,66
1651051216239,COGS 100,A01,083619,Staff,0,30,60,60
1651051222264,COGS 101A,A01,083621,Davis; Joshua Daniel,0,29,60,60
1651051228292,COGS 101B,A01,091572,Staff,0,7,60,60
1651051234318,COGS 101C,A01,083625,Delgado; Tania,14,0,30,16
1651051240344,COGS 107A,A01,083627,Boyle; Mary E. T.,0,17,60,60
1651051246370,COGS 118A,A01,083075,Staff,0,10,60,60
1651051252402,CSE 3,A50,083646,Miranda; Gregory Joseph,15,0,38,23
1651051252402,CSE 3,A51,083647,Miranda; Gregory Joseph,36,0,37,1
1651051258425,CSE 8A,A50,083650,Miranda; Gregory Joseph,0,31,40,40
1651051264450,CSE 11,A01,083080,Cao; Yingjun,1,97,40,39
1651051270475,CSE 12,A01,083652,Staff,0,26,100,100
1651051276499,CSE 15L,A01,083654,Staff,0,3,50,50
1651051276499,CSE 15L,A02,083655,Staff,0,3,50,50
1651051282522,CSE 20,A01,083657,Staff,46,0,80,34
1651051288546,CSE 30,A01,083084,Eldon; John,0,38,80,80
1651051294569,CSE 100,A01,083659,Cao; Yingjun,0,72,50,50
1651051300598,CSE 134B,A01,083661,Powell; Thomas Allan,0,38,65,65
1651051306623,CSE 140,A01,083663,Staff,0,15,75,75
1651051312650,CSE 140L,A01,083088,Eldon; John,3,0,100,97
1651051318674,CSE 175,A01,083665,Kumar; Rakesh,0,0,25,25
1651051324697,CSE 190,A00,092507,Dubnov; Shlomo,9,0,20,11
1651051330723,ECE 45,A01,083139,Staff,0,7,60,60
1651051336751,ECE 65,A50,083695,Staff,0,7,30,30
1651051342778,ECE 109,A01,091882,Touri; Behrouz,33,0,70,37
1651051348806,ECE 180,A00,083140,Abi Samra; Nicholas Camill,17,0,30,13
1651051348806,ECE 180,B00,083141,Abi Samra; Nicholas Camill,0,0,30,30
1651051354839,MATH 10A,A01,083735,Patchell; Gregory David,0,0,30,30
1651051354839,MATH 10A,A02,083736,Patchell; Gregory David,27,0,30,3
1651051354839,MATH 10A,A03,083737,Patchell; Gregory David,23,0,30,7
1651051360871,MATH 10B,A01,083207,Staff,0,7,30,30
1651051360871,MATH 10B,A02,083208,Staff,0,6,30,30
1651051360871,MATH 10B,B01,083739,Staff,8,0,30,22
1651051360871,MATH 10B,B02,083740,Staff,28,0,30,2
1651051366898,MATH 18,A01,083743,Staff,0,0,30,30
1651051366898,MATH 18,A02,083744,Staff,23,0,30,7
1651051366898,MATH 18,A03,083745,Staff,19,0,30,11
1651051366898,MATH 18,A04,083746,Staff,26,0,30,4
1651051366898,MATH 18,B01,083748,Staff,0,16,30,30
1651051366898,MATH 18,B02,083749,Staff,0,14,30,30
1651051366898,MATH 18,B03,083750,Staff,0,14,30,30
1651051366898,MATH 18,B04,083751,Staff,0,13,30,30
1651051372922,MATH 20A,A01,083754,Staff,18,0,40,22
1651051378945,MATH 20B,A01,083756,Staff,0,14,30,30
1651051378945,MATH 20B,A02,083757,Staff,0,11,30,30
1651051384973,MATH 20C,A01,083760,Staff,0,16,30,30
1651051384973,MATH 20C,A02,083761,Staff,0,15,30,30
1651051384973,MATH 20C,B01,083762,Staff,8,0,30,22
1651051384973,MATH 20C,B02,083763,Staff,28,0,30,2
1651051390998,MATH 20D,A01,083765,Staff,3,1,30,27
1651051390998,MATH 20D,A02,083766,Staff,1,0,30,29
1651051390998,MATH 20D,A03,083767,Staff,22,0,30,8
1651051397029,MATH 20E,A01,083771,Staff,2,0,30,28
1651051397029,MATH 20E,A02,083772,Staff,10,0,30,20
1651051397029,MATH 20E,B01,083773,Staff,0,0,30,30
1651051397029,MATH 20E,B02,083774,Staff,0,0,30,30
1651051403057,MATH 103A,A01,083777,Staff,0,17,30,30
1651051403057,MATH 103A,A02,083778,Staff,0,16,30,30
1651051403057,MATH 103A,B01,083779,Staff,0,15,30,30
1651051403057,MATH 103A,B02,083780,Staff,0,13,30,30
1651051409080,MATH 105,A01,085443,Staff,0,23,30,30
1651051415106,MATH 109,A01,083213,Anzaldo; Leesa B,0,7,30,30
1651051415106,MATH 109,A02,083214,Anzaldo; Leesa B,0,7,30,30
1651051415106,MATH 109,B01,083215,Anzaldo; Leesa B,0,8,30,30
1651051415106,MATH 109,B02,083216,Anzaldo; Leesa B,0,8,30,30
1651051421132,MATH 142A,A01,083219,Chow; Bennett,0,15,30,30
1651051421132,MATH 142A,A02,083220,Chow; Bennett,0,15,30,30
1651051421132,MATH 142A,B01,083221,Chow; Bennett,0,16,30,30
1651051421132,MATH 142A,B02,083222,Chow; Bennett,0,14,30,30
1651051427161,MATH 193A,A01,083224,Staff,0,8,30,30
1651051427161,MATH 193A,A02,083225,Staff,0,7,30,30
1651051427161,MATH 193A,A03,083781,Staff,0,7,30,30
1651051427161,MATH 193A,A04,083782,Staff,0,7,30,30
1651051433193,MATH 197,001,091859,McAuley; Julian John,9998,0,9999,1
1651051439262,COGS 9,A01,083615,Staff,0,20,60,60
1651051445324,COGS 11,A01,083617,Boyle; Mary E. T.,13,0,40,27
1651051451362,COGS 13,A01,083071,Staff,0,40,40,40
1651051457390,COGS 14A,A01,092681,Staff,0,40,100,100
1651051463414,COGS 14B,A01,083073,Cheng; Tzu-Han,0,13,50,50
1651051469440,COGS 17,A01,092677,Staff,9,0,75,66
1651051475467,COGS 100,A01,083619,Staff,0,30,60,60
1651051481497,COGS 101A,A01,083621,Davis; Joshua Daniel,0,29,60,60
1651051487525,COGS 101B,A01,091572,Staff,0,7,60,60
1651051493561,COGS 101C,A01,083625,Delgado; Tania,14,0,30,16
1651051499586,COGS 107A,A01,083627,Boyle; Mary E. T.,0,17,60,60
1651051505616,COGS 118A,A01,083075,Staff,0,10,60,60
1651051511641,CSE 3,A50,083646,Miranda; Gregory Joseph,15,0,38,23
1651051511641,CSE 3,A51,083647,Miranda; Gregory Joseph,36,0,37,1
1651051517666,CSE 8A,A50,083650,Miranda; Gregory Joseph,0,31,40,40
1651051523690,CSE 11,A01,083080,Cao; Yingjun,1,97,40,39
1651051529715,CSE 12,A01,083652,Staff,0,26,100,100
1651051535739,CSE 15L,A01,083654,Staff,0,3,50,50
1651051535739,CSE 15L,A02,083655,Staff,0,3,50,50
1651051541764,CSE 20,A01,083657,Staff,46,0,80,34
1651051547794,CSE 30,A01,083084,Eldon; John,0,38,80,80
1651051553822,CSE 100,A01,083659,Cao; Yingjun,0,72,50,50
1651051559853,CSE 134B,A01,083661,Powell; Thomas Allan,0,38,65,65
1651051565877,CSE 140,A01,083663,Staff,0,15,75,75
1651051571906,CSE 140L,A01,083088,Eldon; John,3,0,100,97
1651051577935,CSE 175,A01,083665,Kumar; Rakesh,0,0,25,25
1651051583961,CSE 190,A00,092507,Dubnov; Shlomo,9,0,20,11
1651051590001,ECE 45,A01,083139,Staff,0,7,60,60
1651051596039,ECE 65,A50,083695,Staff,0,7,30,30
1651051602065,ECE 109,A01,091882,Touri; Behrouz,33,0,70,37
1651051608089,ECE 180,A00,083140,Abi Samra; Nicholas Camill,17,0,30,13
1651051608089,ECE 180,B00,083141,Abi Samra; Nicholas Camill,0,0,30,30
1651051614124,MATH 10A,A01,083735,Patchell; Gregory David,0,0,30,30
1651051614124,MATH 10A,A02,083736,Patchell; Gregory David,27,0,30,3
1651051614124,MATH 10A,A03,083737,Patchell; Gregory David,23,0,30,7
1651051620151,MATH 10B,A01,083207,Staff,0,7,30,30
1651051620151,MATH 10B,A02,083208,Staff,0,6,30,30
1651051620151,MATH 10B,B01,083739,Staff,8,0,30,22
1651051620151,MATH 10B,B02,083740,Staff,28,0,30,2
1651051626177,MATH 18,A01,083743,Staff,0,0,30,30
1651051626177,MATH 18,A02,083744,Staff,23,0,30,7
1651051626177,MATH 18,A03,083745,Staff,19,0,30,11
1651051626177,MATH 18,A04,083746,Staff,26,0,30,4
1651051626177,MATH 18,B01,083748,Staff,0,16,30,30
1651051626177,MATH 18,B02,083749,Staff,0,14,30,30
1651051626177,MATH 18,B03,083750,Staff,0,14,30,30
1651051626177,MATH 18,B04,083751,Staff,0,13,30,30
1651051632202,MATH 20A,A01,083754,Staff,18,0,40,22
1651051638228,MATH 20B,A01,083756,Staff,0,14,30,30
1651051638228,MATH 20B,A02,083757,Staff,0,11,30,30
1651051644257,MATH 20C,A01,083760,Staff,0,16,30,30
1651051644257,MATH 20C,A02,083761,Staff,0,15,30,30
1651051644257,MATH 20C,B01,083762,Staff,8,0,30,22
1651051644257,MATH 20C,B02,083763,Staff,28,0,30,2
1651051650281,MATH 20D,A01,083765,Staff,3,1,30,27
1651051650281,MATH 20D,A02,083766,Staff,1,0,30,29
1651051650281,MATH 20D,A03,083767,Staff,22,0,30,8
1651051656307,MATH 20E,A01,083771,Staff,2,0,30,28
1651051656307,MATH 20E,A02,083772,Staff,10,0,30,20
1651051656307,MATH 20E,B01,083773,Staff,0,0,30,30
1651051656307,MATH 20E,B02,083774,Staff,0,0,30,30
1651051662334,MATH 103A,A01,083777,Staff,0,17,30,30
1651051662334,MATH 103A,A02,083778,Staff,0,16,30,30
1651051662334,MATH 103A,B01,083779,Staff,0,15,30,30
1651051662334,MATH 103A,B02,083780,Staff,0,13,30,30
1651051668360,MATH 105,A01,085443,Staff,0,23,30,30
1651051674386,MATH 109,A01,083213,Anzaldo; Leesa B,0,7,30,30
1651051674386,MATH 109,A02,083214,Anzaldo; Leesa B,0,7,30,30
1651051674386,MATH 109,B01,083215,Anzaldo; Leesa B,0,8,30,30
1651051674386,MATH 109,B02,083216,Anzaldo; Leesa B,0,8,30,30
1651051680419,MATH 142A,A01,083219,Chow; Bennett,0,15,30,30
1651051680419,MATH 142A,A02,083220,Chow; Bennett,0,15,30,30
1651051680419,MATH 142A,B01,083221,Chow; Bennett,0,16,30,30
1651051680419,MATH 142A,B02,083222,Chow; Bennett,0,14,30,30
1651051686444,MATH 193A,A01,083224,Staff,0,8,30,30
1651051686444,MATH 193A,A02,083225,Staff,0,7,30,30
1651051686444,MATH 193A,A03,083781,Staff,0,7,30,30
1651051686444,MATH 193A,A04,083782,Staff,0,7,30,30
1651051692470,MATH 197,001,091859,McAuley; Julian John,9998,0,9999,1
1651051698537,COGS 9,A01,083615,Staff,0,20,60,60
1651051704577,COGS 11,A01,083617,Boyle; Mary E. T.,13,0,40,27
1651051710607,COGS 13,A01,083071,Staff,0,40,40,40
1651051716634,COGS 14A,A01,092681,Staff,0,40,100,100
1651051722657,COGS 14B,A01,083073,Cheng; Tzu-Han,0,13,50,50
1651051728685,COGS 17,A01,092677,Staff,9,0,75,66
1651051734728,COGS 100,A01,083619,Staff,0,30,60,60
1651051740759,COGS 101A,A01,083621,Davis; Joshua Daniel,0,29,60,60
1651051746784,COGS 101B,A01,091572,Staff,0,7,60,60
1651051752904,COGS 101C,A01,083625,Delgado; Tania,14,0,30,16
1651051758930,COGS 107A,A01,083627,Boyle; Mary E. T.,0,17,60,60
1651051764954,COGS 118A,A01,083075,Staff,0,10,60,60
1651051770981,CSE 3,A50,083646,Miranda; Gregory Joseph,15,0,38,23
1651051770981,CSE 3,A51,083647,Miranda; Gregory Joseph,36,0,37,1
1651051777010,CSE 8A,A50,083650,Miranda; Gregory Joseph,0,31,40,40
1651051783034,CSE 11,A01,083080,Cao; Yingjun,1,97,40,39
1651051789059,CSE 12,A01,083652,Staff,0,26,100,100
1651051795085,CSE 15L,A01,083654,Staff,0,3,50,50
1651051795085,CSE 15L,A02,083655,Staff,0,3,50,50
1651051801114,CSE 20,A01,083657,Staff,46,0,80,34
1651051807142,CSE 30,A01,083084,Eldon; John,0,38,80,80
1651051813173,CSE 100,A01,083659,Cao; Yingjun,0,72,50,50
1651051819200,CSE 134B,A01,083661,Powell; Thomas Allan,0,38,65,65
1651051825227,CSE 140,A01,083663,Staff,0,15,75,75
1651051831258,CSE 140L,A01,083088,Eldon; John,3,0,100,97
1651051837287,CSE 175,A01,083665,Kumar; Rakesh,0,0,25,25
1651051843313,CSE 190,A00,092507,Dubnov; Shlomo,9,0,20,11
1651051849341,ECE 45,A01,083139,Staff,0,7,60,60
1651051855369,ECE 65,A50,083695,Staff,0,7,30,30
1651051861401,ECE 109,A01,091882,Touri; Behrouz,33,0,70,37
1651051867424,ECE 180,A00,083140,Abi Samra; Nicholas Camill,17,0,30,13
1651051867424,ECE 180,B00,083141,Abi Samra; Nicholas Camill,0,0,30,30
1651051873451,MATH 10A,A01,083735,Patchell; Gregory David,0,0,30,30
1651051873451,MATH 10A,A02,083736,Patchell; Gregory David,27,0,30,3
1651051873451,MATH 10A,A03,083737,Patchell; Gregory David,23,0,30,7
1651051879483,MATH 10B,A01,083207,Staff,0,7,30,30
1651051879483,MATH 10B,A02,083208,Staff,0,6,30,30
1651051879483,MATH 10B,B01,083739,Staff,8,0,30,22
1651051879483,MATH 10B,B02,083740,Staff,28,0,30,2
1651051885513,MATH 18,A01,083743,Staff,0,0,30,30
1651051885513,MATH 18,A02,083744,Staff,23,0,30,7
1651051885513,MATH 18,A03,083745,Staff,19,0,30,11
1651051885513,MATH 18,A04,083746,Staff,26,0,30,4
1651051885513,MATH 18,B01,083748,Staff,0,16,30,30
1651051885513,MATH 18,B02,083749,Staff,0,14,30,30
1651051885513,MATH 18,B03,083750,Staff,0,14,30,30
1651051885513,MATH 18,B04,083751,Staff,0,13,30,30
1651051891537,MATH 20A,A01,083754,Staff,18,0,40,22
1651051897562,MATH 20B,A01,083756,Staff,0,14,30,30
1651051897562,MATH 20B,A02,083757,Staff,0,11,30,30
1651051903599,MATH 20C,A01,083760,Staff,0,16,30,30
1651051903599,MATH 20C,A02,083761,Staff,0,15,30,30
1651051903599,MATH 20C,B01,083762,Staff,8,0,30,22
1651051903599,MATH 20C,B02,083763,Staff,28,0,30,2
1651051909623,MATH 20D,A01,083765,Staff,3,1,30,27
1651051909623,MATH 20D,A02,083766,Staff,1,0,30,29
1651051909623,MATH 20D,A03,083767,Staff,22,0,30,8
1651051915667,MATH 20E,A01,083771,Staff,2,0,30,28
1651051915667,MATH 20E,A02,083772,Staff,10,0,30,20
1651051915667,MATH 20E,B01,083773,Staff,0,0,30,30
1651051915667,MATH 20E,B02,083774,Staff,0,0,30,30
1651051921692,MATH 103A,A01,083777,Staff,0,17,30,30
1651051921692,MATH 103A,A02,083778,Staff,0,16,30,30
1651051921692,MATH 103A,B01,083779,Staff,0,15,30,30
1651051921692,MATH 103A,B02,083780,Staff,0,13,30,30
1651051927721,MATH 105,A01,085443,Staff,0,23,30,30
1651051933746,MATH 109,A01,083213,Anzaldo; Leesa B,0,7,30,30
1651051933746,MATH 109,A02,083214,Anzaldo; Leesa B,0,7,30,30
1651051933746,MATH 109,B01,083215,Anzaldo; Leesa B,0,8,30,30
1651051933746,MATH 109,B02,083216,Anzaldo; Leesa B,0,8,30,30
1651051939776,MATH 142A,A01,083219,Chow; Bennett,0,15,30,30
1651051939776,MATH 142A,A02,083220,Chow; Bennett,0,15,30,30
1651051939776,MATH 142A,B01,083221,Chow; Bennett,0,16,30,30
1651051939776,MATH 142A,B02,083222,Chow; Bennett,0,14,30,30
1651051945800,MATH 193A,A01,083224,Staff,0,8,30,30
1651051945800,MATH 193A,A02,083225,Staff,0,7,30,30
1651051945800,MATH 193A,A03,083781,Staff,0,7,30,30
1651051945800,MATH 193A,A04,083782,Staff,0,7,30,30
1651051951825,MATH 197,001,091859,McAuley; Julian John,9998,0,9999,1
1651051957898,COGS 9,A01,083615,Staff,0,20,60,60
1651051963926,COGS 11,A01,083617,Boyle; Mary E. T.,13,0,40,27
1651051969954,COGS 13,A01,083071,Staff,0,40,40,40
1651051975981,COGS 14A,A01,092681,Staff,0,40,100,100
1651051982018,COGS 14B,A01,083073,Cheng; Tzu-Han,0,13,50,50
1651051988041,COGS 17,A01,092677,Staff,9,0,75,66
1651051994066,COGS 100,A01,083619,Staff,0,30,60,60
1651052000091,COGS 101A,A01,083621,Davis; Joshua Daniel,0,29,60,60
1651052006117,COGS 101B,A01,091572,Staff,0,7,60,60
1651052012140,COGS 101C,A01,083625,Delgado; Tania,14,0,30,16
1651052018164,COGS 107A,A01,083627,Boyle; Mary E. T.,0,17,60,60
1651052024195,COGS 118A,A01,083075,Staff,0,10,60,60
1651052030227,CSE 3,A50,083646,Miranda; Gregory Joseph,15,0,38,23
1651052030227,CSE 3,A51,083647,Miranda; Gregory Joseph,36,0,37,1
1651052036251,CSE 8A,A50,083650,Miranda; Gregory Joseph,0,31,40,40
1651052042275,CSE 11,A01,083080,Cao; Yingjun,1,97,40,39
1651052048302,CSE 12,A01,083652,Staff,0,26,100,100
1651052054327,CSE 15L,A01,083654,Staff,0,3,50,50
1651052054327,CSE 15L,A02,083655,Staff,0,3,50,50
1651052060351,CSE 20,A01,083657,Staff,46,0,80,34
1651052066376,CSE 30,A01,083084,Eldon; John,0,38,80,80
1651052072408,CSE 100,A01,083659,Cao; Yingjun,0,72,50,50
1651052078437,CSE 134B,A01,083661,Powell; Thomas Allan,0,38,65,65
1651052084461,CSE 140,A01,083663,Staff,0,15,75,75
1651052090485,CSE 140L,A01,083088,Eldon; John,3,0,100,97
1651052096515,CSE 175,A01,083665,Kumar; Rakesh,0,0,25,25
1651052102538,CSE 190,A00,092507,Dubnov; Shlomo,9,0,20,11
1651052108566,ECE 45,A01,083139,Staff,0,7,60,60
1651052114589,ECE 65,A50,083695,Staff,0,7,30,30
1651052120621,ECE 109,A01,091882,Touri; Behrouz,33,0,70,37
1651052126644,ECE 180,A00,083140,Abi Samra; Nicholas Camill,17,0,30,13
1651052126644,ECE 180,B00,083141,Abi Samra; Nicholas Camill,0,0,30,30
1651052132668,MATH 10A,A01,083735,Patchell; Gregory David,0,0,30,30
1651052132668,MATH 10A,A02,083736,Patchell; Gregory David,27,0,30,3
1651052132668,MATH 10A,A03,083737,Patchell; Gregory David,23,0,30,7
1651052138693,MATH 10B,A01,083207,Staff,0,7,30,30
1651052138693,MATH 10B,A02,083208,Staff,0,6,30,30
1651052138693,MATH 10B,B01,083739,Staff,8,0,30,22
1651052138693,MATH 10B,B02,083740,Staff,28,0,30,2
1651052144721,MATH 18,A01,083743,Staff,0,0,30,30
1651052144721,MATH 18,A02,083744,Staff,23,0,30,7
1651052144721,MATH 18,A03,083745,Staff,19,0,30,11
1651052144721,MATH 18,A04,083746,Staff,26,0,30,4
1651052144721,MATH 18,B01,083748,Staff,0,16,30,30
1651052144721,MATH 18,B02,083749,Staff,0,14,30,30
1651052144721,MATH 18,B03,083750,Staff,0,14,30,30
1651052144721,MATH 18,B04,083751,Staff,0,13,30,30
1651052150745,MATH 20A,A01,083754,Staff,18,0,40,22
1651052156771,MATH 20B,A01,083756,Staff,0,14,30,30
1651052156771,MATH 20B,A02,083757,Staff,0,11,30,30
1651052162800,MATH 20C,A01,083760,Staff,0,16,30,30
1651052162800,MATH 20C,A02,083761,Staff,0,15,30,30
1651052162800,MATH 20C,B01,083762,Staff,8,0,30,22
1651052162800,MATH 20C,B02,083763,Staff,28,0,30,2
1651052168828,MATH 20D,A01,083765,Staff,3,1,30,27
1651052168828,MATH 20D,A02,083766,Staff,1,0,30,29
1651052168828,MATH 20D,A03,083767,Staff,22,0,30,8
1651052174853,MATH 20E,A01,083771,Staff,2,0,30,28
1651052174853,MATH 20E,A02,083772,Staff,10,0,30,20
1651052174853,MATH 20E,B01,083773,Staff,0,0,30,30
1651052174853,MATH 20E,B02,083774,Staff,0,0,30,30
1651052180877,MATH 103A,A01,083777,Staff,0,17,30,30
1651052180877,MATH 103A,A02,083778,Staff,0,16,30,30
1651052180877,MATH 103A,B01,083779,Staff,0,15,30,30
1651052180877,MATH 103A,B02,083780,Staff,0,13,30,30
1651052186901,MATH 105,A01,085443,Staff,0,23,30,30
1651052192927,MATH 109,A01,083213,Anzaldo; Leesa B,0,7,30,30
1651052192927,MATH 109,A02,083214,Anzaldo; Leesa B,0,7,30,30
1651052192927,MATH 109,B01,083215,Anzaldo; Leesa B,0,8,30,30
1651052192927,MATH 109,B02,083216,Anzaldo; Leesa B,0,8,30,30
1651052198954,MATH 142A,A01,083219,Chow; Bennett,0,15,30,30
1651052198954,MATH 142A,A02,083220,Chow; Bennett,0,15,30,30
1651052198954,MATH 142A,B01,083221,Chow; Bennett,0,16,30,30
1651052198954,MATH 142A,B02,083222,Chow; Bennett,0,14,30,30
1651052204980,MATH 193A,A01,083224,Staff,0,8,30,30
1651052204980,MATH 193A,A02,083225,Staff,0,7,30,30
1651052204980,MATH 193A,A03,083781,Staff,0,7,30,30
1651052204980,MATH 193A,A04,083782,Staff,0,7,30,30
1651052211006,MATH 197,001,091859,McAuley; Julian John,9998,0,9999,1
1651052217076,COGS 9,A01,083615,Staff,0,20,60,60
1651052223102,COGS 11,A01,083617,Boyle; Mary E. T.,13,0,40,27
1651052229127,COGS 13,A01,083071,Staff,0,40,40,40
1651052235151,COGS 14A,A01,092681,Staff,0,40,100,100
1651052241174,COGS 14B,A01,083073,Cheng; Tzu-Han,0,13,50,50
1651052247199,COGS 17,A01,092677,Staff,9,0,75,66
1651052253223,COGS 100,A01,083619,Staff,0,30,60,60
1651052259252,COGS 101A,A01,083621,Davis; Joshua Daniel,0,29,60,60
1651052265275,COGS 101B,A01,091572,Staff,0,7,60,60
1651052271300,COGS 101C,A01,083625,Delgado; Tania,14,0,30,16
1651052277327,COGS 107A,A01,083627,Boyle; Mary E. T.,0,17,60,60
1651052283352,COGS 118A,A01,083075,Staff,0,10,60,60
1651052289376,CSE 3,A50,083646,Miranda; Gregory Joseph,15,0,38,23
1651052289376,CSE 3,A51,083647,Miranda; Gregory Joseph,36,0,37,1
1651052295401,CSE 8A,A50,083650,Miranda; Gregory Joseph,0,31,40,40
1651052301438,CSE 11,A01,083080,Cao; Yingjun,1,97,40,39
1651052307462,CSE 12,A01,083652,Staff,0,26,100,100
1651052313489,CSE 15L,A01,083654,Staff,0,3,50,50
1651052313489,CSE 15L,A02,083655,Staff,0,3,50,50
1651052319517,CSE 20,A01,083657,Staff,46,0,80,34
1651052325542,CSE 30,A01,083084,Eldon; John,0,38,80,80
1651052331567,CSE 100,A01,083659,Cao; Yingjun,0,72,50,50
1651052337610,CSE 134B,A01,083661,Powell; Thomas Allan,0,38,65,65
1651052343638,CSE 140,A01,083663,Staff,0,15,75,75
1651052349781,CSE 140L,A01,083088,Eldon; John,3,0,100,97
1651052355813,CSE 175,A01,083665,Kumar; Rakesh,0,0,25,25
1651052361839,CSE 190,A00,092507,Dubnov; Shlomo,9,0,20,11
1651052367870,ECE 45,A01,083139,Staff,0,7,60,60
1651052373905,ECE 65,A50,083695,Staff,0,7,30,30
1651052379935,ECE 109,A01,091882,Touri; Behrouz,33,0,70,37
1651052385960,ECE 180,A00,083140,Abi Samra; Nicholas Camill,17,0,30,13
1651052385960,ECE 180,B00,083141,Abi Samra; Nicholas Camill,0,0,30,30
1651052392001,MATH 10A,A01,083735,Patchell; Gregory David,0,0,30,30
1651052392001,MATH 10A,A02,083736,Patchell; Gregory David,27,0,30,3
1651052392001,MATH 10A,A03,083737,Patchell; Gregory David,23,0,30,7
1651052398027,MATH 10B,A01,083207,Staff,0,7,30,30
1651052398027,MATH 10B,A02,083208,Staff,0,6,30,30
1651052398027,MATH 10B,B01,083739,Staff,8,0,30,22
1651052398027,MATH 10B,B02,083740,Staff,28,0,30,2
1651052404056,MATH 18,A01,083743,Staff,0,0,30,30
1651052404056,MATH 18,A02,083744,Staff,23,0,30,7
1651052404056,MATH 18,A03,083745,Staff,19,0,30,11
1651052404056,MATH 18,A04,083746,Staff,26,0,30,4
1651052404056,MATH 18,B01,083748,Staff,0,16,30,30
1651052404056,MATH 18,B02,083749,Staff,0,14,30,30
1651052404056,MATH 18,B03,083750,Staff,0,14,30,30
1651052404056,MATH 18,B04,083751,Staff,0,13,30,30
1651052410081,MATH 20A,A01,083754,Staff,18,0,40,22
1651052416107,MATH 20B,A01,083756,Staff,0,14,30,30
1651052416107,MATH 20B,A02,083757,Staff,0,11,30,30
1651052422145,MATH 20C,A01,083760,Staff,0,16,30,30
1651052422145,MATH 20C,A02,083761,Staff,0,15,30,30
1651052422145,MATH 20C,B01,083762,Staff,8,0,30,22
1651052422145,MATH 20C,B02,083763,Staff,28,0,30,2
1651052428170,MATH 20D,A01,083765,Staff,3,1,30,27
1651052428170,MATH 20D,A02,083766,Staff,1,0,30,29
1651052428170,MATH 20D,A03,083767,Staff,22,0,30,8
1651052434203,MATH 20E,A01,083771,Staff,2,0,30,28
1651052434203,MATH 20E,A02,083772,Staff,10,0,30,20
1651052434203,MATH 20E,B01,083773,Staff,0,0,30,30
1651052434203,MATH 20E,B02,083774,Staff,0,0,30,30
1651052440232,MATH 103A,A01,083777,Staff,0,17,30,30
1651052440232,MATH 103A,A02,083778,Staff,0,16,30,30
1651052440232,MATH 103A,B01,083779,Staff,0,15,30,30
1651052440232,MATH 103A,B02,083780,Staff,0,13,30,30
1651052446256,MATH 105,A01,085443,Staff,0,23,30,30
1651052452286,MATH 109,A01,083213,Anzaldo; Leesa B,0,7,30,30
1651052452286,MATH 109,A02,083214,Anzaldo; Leesa B,0,7,30,30
1651052452286,MATH 109,B01,083215,Anzaldo; Leesa B,0,8,30,30
1651052452286,MATH 109,B02,083216,Anzaldo; Leesa B,0,8,30,30
1651052458318,MATH 142A,A01,083219,Chow; Bennett,0,15,30,30
1651052458318,MATH 142A,A02,083220,Chow; Bennett,0,15,30,30
1651052458318,MATH 142A,B01,083221,Chow; Bennett,0,16,30,30
1651052458318,MATH 142A,B02,083222,Chow; Bennett,0,14,30,30
1651052464342,MATH 193A,A01,083224,Staff,0,8,30,30
1651052464342,MATH 193A,A02,083225,Staff,0,7,30,30
1651052464342,MATH 193A,A03,083781,Staff,0,7,30,30
1651052464342,MATH 193A,A04,083782,Staff,0,7,30,30
1651052470368,MATH 197,001,091859,McAuley; Julian John,9998,0,9999,1
1651052476434,COGS 9,A01,083615,Staff,0,20,60,60
1651052482523,COGS 11,A01,083617,Boyle; Mary E. T.,13,0,40,27
1651052488552,COGS 13,A01,083071,Staff,0,40,40,40
1651052494582,COGS 14A,A01,092681,Staff,0,40,100,100
1651052500614,COGS 14B,A01,083073,Cheng; Tzu-Han,0,13,50,50
1651052506638,COGS 17,A01,092677,Staff,9,0,75,66
1651052512665,COGS 100,A01,083619,Staff,0,30,60,60
1651052518691,COGS 101A,A01,083621,Davis; Joshua Daniel,0,29,60,60
1651052524716,COGS 101B,A01,091572,Staff,0,7,60,60
1651052530748,COGS 101C,A01,083625,Delgado; Tania,14,0,30,16
1651052536781,COGS 107A,A01,083627,Boyle; Mary E. T.,0,17,60,60
1651052542805,COGS 118A,A01,083075,Staff,0,10,60,60
1651052548840,CSE 3,A50,083646,Miranda; Gregory Joseph,15,0,38,23
1651052548840,CSE 3,A51,083647,Miranda; Gregory Joseph,36,0,37,1
1651052554867,CSE 8A,A50,083650,Miranda; Gregory Joseph,0,31,40,40
1651052560910,CSE 11,A01,083080,Cao; Yingjun,1,97,40,39
1651052566939,CSE 12,A01,083652,Staff,0,26,100,100
1651052572967,CSE 15L,A01,083654,Staff,0,3,50,50
1651052572967,CSE 15L,A02,083655,Staff,0,3,50,50
1651052578992,CSE 20,A01,083657,Staff,46,0,80,34
1651052585018,CSE 30,A01,083084,Eldon; John,0,38,80,80
1651052591043,CSE 100,A01,083659,Cao; Yingjun,0,72,50,50
1651052597078,CSE 134B,A01,083661,Powell; Thomas Allan,0,38,65,65
1651052603106,CSE 140,A01,083663,Staff,0,15,75,75
1651052609134,CSE 140L,A01,083088,Eldon; John,3,0,100,97
1651052615158,CSE 175,A01,083665,Kumar; Rakesh,0,0,25,25
1651052621182,CSE 190,A00,092507,Dubnov; Shlomo,9,0,20,11
1651052627206,ECE 45,A01,083139,Staff,0,7,60,60
1651052633233,ECE 65,A50,083695,Staff,0,7,30,30
1651052639256,ECE 109,A01,091882,Touri; Behrouz,33,0,70,37
1651052645281,ECE 180,A00,083140,Abi Samra; Nicholas Camill,17,0,30,13
1651052645281,ECE 180,B00,083141,Abi Samra; Nicholas Camill,0,0,30,30
1651052651307,MATH 10A,A01,083735,Patchell; Gregory David,0,0,30,30
1651052651307,MATH 10A,A02,083736,Patchell; Gregory David,27,0,30,3
1651052651307,MATH 10A,A03,083737,Patchell; Gregory David,23,0,30,7
1651052657340,MATH 10B,A01,083207,Staff,0,7,30,30
1651052657340,MATH 10B,A02,083208,Staff,0,6,30,30
1651052657340,MATH 10B,B01,083739,Staff,8,0,30,22
1651052657340,MATH 10B,B02,083740,Staff,28,0,30,2
1651052663371,MATH 18,A01,083743,Staff,0,0,30,30
1651052663371,MATH 18,A02,083744,Staff,23,0,30,7
1651052663371,MATH 18,A03,083745,Staff,19,0,30,11
1651052663371,MATH 18,A04,083746,Staff,26,0,30,4
1651052663371,MATH 18,B01,083748,Staff,0,16,30,30
1651052663371,MATH 18,B02,083749,Staff,0,14,30,30
1651052663371,MATH 18,B03,083750,Staff,0,14,30,30
1651052663371,MATH 18,B04,083751,Staff,0,13,30,30
1651052669395,MATH 20A,A01,083754,Staff,18,0,40,22
1651052675426,MATH 20B,A01,083756,Staff,0,14,30,30
1651052675426,MATH 20B,A02,083757,Staff,0,11,30,30
1651052681454,MATH 20C,A01,083760,Staff,0,16,30,30
1651052681454,MATH 20C,A02,083761,Staff,0,15,30,30
1651052681454,MATH 20C,B01,083762,Staff,8,0,30,22
1651052681454,MATH 20C,B02,083763,Staff,28,0,30,2
1651052687478,MATH 20D,A01,083765,Staff,3,1,30,27
1651052687478,MATH 20D,A02,083766,Staff,1,0,30,29
1651052687478,MATH 20D,A03,083767,Staff,22,0,30,8
1651052693503,MATH 20E,A01,083771,Staff,2,0,30,28
1651052693503,MATH 20E,A02,083772,Staff,10,0,30,20
1651052693503,MATH 20E,B01,083773,Staff,0,0,30,30
1651052693503,MATH 20E,B02,083774,Staff,0,0,30,30
1651052699531,MATH 103A,A01,083777,Staff,0,17,30,30
1651052699531,MATH 103A,A02,083778,Staff,0,16,30,30
1651052699531,MATH 103A,B01,083779,Staff,0,15,30,30
1651052699531,MATH 103A,B02,083780,Staff,0,13,30,30
1651052705562,MATH 105,A01,085443,Staff,0,23,30,30
1651052711588,MATH 109,A01,083213,Anzaldo; Leesa B,0,7,30,30
1651052711588,MATH 109,A02,083214,Anzaldo; Leesa B,0,7,30,30
1651052711588,MATH 109,B01,083215,Anzaldo; Leesa B,0,8,30,30
1651052711588,MATH 109,B02,083216,Anzaldo; Leesa B,0,8,30,30
1651052717629,MATH 142A,A01,083219,Chow; Bennett,0,15,30,30
1651052717629,MATH 142A,A02,083220,Chow; Bennett,0,15,30,30
1651052717629,MATH 142A,B01,083221,Chow; Bennett,0,16,30,30
1651052717629,MATH 142A,B02,083222,Chow; Bennett,0,14,30,30
1651052723654,MATH 193A,A01,083224,Staff,0,8,30,30
1651052723654,MATH 193A,A02,083225,Staff,0,7,30,30
1651052723654,MATH 193A,A03,083781,Staff,0,7,30,30
1651052723654,MATH 193A,A04,083782,Staff,0,7,30,30
1651052729682,MATH 197,001,091859,McAuley; Julian John,9998,0,9999,1
1651052735756,COGS 9,A01,083615,Staff,0,20,60,60
1651052741784,COGS 11,A01,083617,Boyle; Mary E. T.,13,0,40,27
1651052747813,COGS 13,A01,083071,Staff,0,40,40,40
1651052753840,COGS 14A,A01,092681,Staff,0,40,100,100
1651052759865,COGS 14B,A01,083073,Cheng; Tzu-Han,0,13,50,50
1651052765893,COGS 17,A01,092677,Staff,9,0,75,66
1651052771919,COGS 100,A01,083619,Staff,0,30,60,60
1651052777950,COGS 101A,A01,083621,Davis; Joshua Daniel,0,29,60,60
1651052783979,COGS 101B,A01,091572,Staff,0,7,60,60
1651052790011,COGS 101C,A01,083625,Delgado; Tania,14,0,30,16
1651052796035,COGS 107A,A01,083627,Boyle; Mary E. T.,0,17,60,60
1651052802059,COGS 118A,A01,083075,Staff,0,10,60,60
1651052808093,CSE 3,A50,083646,Miranda; Gregory Joseph,15,0,38,23
1651052808093,CSE 3,A51,083647,Miranda; Gregory Joseph,36,0,37,1
1651052814121,CSE 8A,A50,083650,Miranda; Gregory Joseph,0,31,40,40
1651052820145,CSE 11,A01,083080,Cao; Yingjun,1,97,40,39
1651052826172,CSE 12,A01,083652,Staff,0,26,100,100
1651052832198,CSE 15L,A01,083654,Staff,0,3,50,50
1651052832198,CSE 15L,A02,083655,Staff,0,3,50,50
1651052838223,CSE 20,A01,083657,Staff,46,0,80,34
1651052844252,CSE 30,A01,083084,Eldon; John,0,38,80,80
1651052850277,CSE 100,A01,083659,Cao; Yingjun,0,72,50,50
1651052856306,CSE 134B,A01,083661,Powell; Thomas Allan,0,38,65,65
1651052862332,CSE 140,A01,083663,Staff,0,15,75,75
1651052868364,CSE 140L,A01,083088,Eldon; John,3,0,100,97
1651052874387,CSE 175,A01,083665,Kumar; Rakesh,0,0,25,25
1651052880417,CSE 190,A00,092507,Dubnov; Shlomo,9,0,20,11
1651052886439,ECE 45,A01,083139,Staff,0,7,60,60
1651052892464,ECE 65,A50,083695,Staff,0,7,30,30
1651052898490,ECE 109,A01,091882,Touri; Behrouz,33,0,70,37
1651052904517,ECE 180,A00,083140,Abi Samra; Nicholas Camill,17,0,30,13
1651052904517,ECE 180,B00,083141,Abi Samra; Nicholas Camill,0,0,30,30
1651052910543,MATH 10A,A01,083735,Patchell; Gregory David,0,0,30,30
1651052910543,MATH 10A,A02,083736,Patchell; Gregory David,27,0,30,3
1651052910543,MATH 10A,A03,083737,Patchell; Gregory David,23,0,30,7
1651052916571,MATH 10B,A01,083207,Staff,0,7,30,30
1651052916571,MATH 10B,A02,083208,Staff,0,6,30,30
1651052916571,MATH 10B,B01,083739,Staff,8,0,30,22
1651052916571,MATH 10B,B02,083740,Staff,28,0,30,2
1651052922604,MATH 18,A01,083743,Staff,0,0,30,30
1651052922604,MATH 18,A02,083744,Staff,23,0,30,7
1651052922604,MATH 18,A03,083745,Staff,19,0,30,11
1651052922604,MATH 18,A04,083746,Staff,26,0,30,4
1651052922604,MATH 18,B01,083748,Staff,0,16,30,30
1651052922604,MATH 18,B02,083749,Staff,0,14,30,30
1651052922604,MATH 18,B03,083750,Staff,0,14,30,30
1651052922604,MATH 18,B04,083751,Staff,0,13,30,30
1651052928628,MATH 20A,A01,083754,Staff,18,0,40,22
1651052934661,MATH 20B,A01,083756,Staff,0,14,30,30
1651052934661,MATH 20B,A02,083757,Staff,0,11,30,30
1651052940686,MATH 20C,A01,083760,Staff,0,16,30,30
1651052940686,MATH 20C,A02,083761,Staff,0,15,30,30
1651052940686,MATH 20C,B01,083762,Staff,8,0,30,22
1651052940686,MATH 20C,B02,083763,Staff,28,0,30,2
1651052946828,MATH 20D,A01,083765,Staff,3,1,30,27
1651052946828,MATH 20D,A02,083766,Staff,1,0,30,29
1651052946828,MATH 20D,A03,083767,Staff,22,0,30,8
1651052952866,MATH 20E,A01,083771,Staff,2,0,30,28
1651052952866,MATH 20E,A02,083772,Staff,10,0,30,20
1651052952866,MATH 20E,B01,083773,Staff,0,0,30,30
1651052952866,MATH 20E,B02,083774,Staff,0,0,30,30
1651052958892,MATH 103A,A01,083777,Staff,0,17,30,30
1651052958892,MATH 103A,A02,083778,Staff,0,16,30,30
1651052958892,MATH 103A,B01,083779,Staff,0,15,30,30
1651052958892,MATH 103A,B02,083780,Staff,0,13,30,30
1651052964921,MATH 105,A01,085443,Staff,0,23,30,30
1651052970946,MATH 109,A01,083213,Anzaldo; Leesa B,0,7,30,30
1651052970946,MATH 109,A02,083214,Anzaldo; Leesa B,0,7,30,30
1651052970946,MATH 109,B01,083215,Anzaldo; Leesa B,0,8,30,30
1651052970946,MATH 109,B02,083216,Anzaldo; Leesa B,0,8,30,30
1651052976972,MATH 142A,A01,083219,Chow; Bennett,0,15,30,30
1651052976972,MATH 142A,A02,083220,Chow; Bennett,0,15,30,30
1651052976972,MATH 142A,B01,083221,Chow; Bennett,0,16,30,30
1651052976972,MATH 142A,B02,083222,Chow; Bennett,0,14,30,30
1651052983002,MATH 193A,A01,083224,Staff,0,8,30,30
1651052983002,MATH 193A,A02,083225,Staff,0,7,30,30
1651052983002,MATH 193A,A03,083781,Staff,0,7,30,30
1651052983002,MATH 193A,A04,083782,Staff,0,7,30,30
1651052989038,MATH 197,001,091859,McAuley; Julian John,9998,0,9999,1
1651052995105,COGS 9,A01,083615,Staff,0,20,60,60
1651053001134,COGS 11,A01,083617,Boyle; Mary E. T.,13,0,40,27
1651053007161,COGS 13,A01,083071,Staff,0,40,40,40
1651053013193,COGS 14A,A01,092681,Staff,0,40,100,100
1651053019229,COGS 14B,A01,083073,Cheng; Tzu-Han,0,13,50,50
1651053025256,COGS 17,A01,092677,Staff,9,0,75,66
1651053031286,COGS 100,A01,083619,Staff,0,30,60,60
1651053037311,COGS 101A,A01,083621,Davis; Joshua Daniel,0,29,60,60
1651053043336,COGS 101B,A01,091572,Staff,0,7,60,60
1651053049367,COGS 101C,A01,083625,Delgado; Tania,14,0,30,16
1651053055392,COGS 107A,A01,083627,Boyle; Mary E. T.,0,17,60,60
1651053061415,COGS 118A,A01,083075,Staff,0,10,60,60
1651053067441,CSE 3,A50,083646,Miranda; Gregory Joseph,15,0,38,23
1651053067441,CSE 3,A51,083647,Miranda; Gregory Joseph,36,0,37,1
1651053073465,CSE 8A,A50,083650,Miranda; Gregory Joseph,0,31,40,40
1651053079495,CSE 11,A01,083080,Cao; Yingjun,1,97,40,39
1651053085518,CSE 12,A01,083652,Staff,0,26,100,100
1651053091554,CSE 15L,A01,083654,Staff,0,3,50,50
1651053091554,CSE 15L,A02,083655,Staff,0,3,50,50
1651053097579,CSE 20,A01,083657,Staff,46,0,80,34
1651053103607,CSE 30,A01,083084,Eldon; John,0,38,80,80
1651053109630,CSE 100,A01,083659,Cao; Yingjun,0,72,50,50
1651053115654,CSE 134B,A01,083661,Powell; Thomas Allan,0,38,65,65
1651053121678,CSE 140,A01,083663,Staff,0,15,75,75
1651053127700,CSE 140L,A01,083088,Eldon; John,3,0,100,97
1651053133725,CSE 175,A01,083665,Kumar; Rakesh,0,0,25,25
1651053139758,CSE 190,A00,092507,Dubnov; Shlomo,9,0,20,11
1651053145783,ECE 45,A01,083139,Staff,0,7,60,60
1651053151812,ECE 65,A50,083695,Staff,0,7,30,30
1651053157836,ECE 109,A01,091882,Touri; Behrouz,33,0,70,37
1651053163864,ECE 180,A00,083140,Abi Samra; Nicholas Camill,17,0,30,13
1651053163864,ECE 180,B00,083141,Abi Samra; Nicholas Camill,0,0,30,30
1651053169890,MATH 10A,A01,083735,Patchell; Gregory David,0,0,30,30
1651053169890,MATH 10A,A02,083736,Patchell; Gregory David,27,0,30,3
1651053169890,MATH 10A,A03,083737,Patchell; Gregory David,23,0,30,7
1651053175943,MATH 10B,A01,083207,Staff,0,7,30,30
1651053175943,MATH 10B,A02,083208,Staff,0,6,30,30
1651053175943,MATH 10B,B01,083739,Staff,8,0,30,22
1651053175943,MATH 10B,B02,083740,Staff,28,0,30,2
1651053181989,MATH 18,A01,083743,Staff,0,0,30,30
1651053181989,MATH 18,A02,083744,Staff,23,0,30,7
1651053181989,MATH 18,A03,083745,Staff,19,0,30,11
1651053181989,MATH 18,A04,083746,Staff,26,0,30,4
1651053181989,MATH 18,B01,083748,Staff,0,16,30,30
1651053181989,MATH 18,B02,083749,Staff,0,14,30,30
1651053181989,MATH 18,B03,083750,Staff,0,14,30,30
1651053181989,MATH 18,B04,083751,Staff,0,13,30,30
1651053188016,MATH 20A,A01,083754,Staff,18,0,40,22
1651053194045,MATH 20B,A01,083756,Staff,0,14,30,30
1651053194045,MATH 20B,A02,083757,Staff,0,11,30,30
1651053200073,MATH 20C,A01,083760,Staff,0,16,30,30
1651053200073,MATH 20C,A02,083761,Staff,0,15,30,30
1651053200073,MATH 20C,B01,083762,Staff,8,0,30,22
1651053200073,MATH 20C,B02,083763,Staff,28,0,30,2
1651053206098,MATH 20D,A01,083765,Staff,3,1,30,27
1651053206098,MATH 20D,A02,083766,Staff,1,0,30,29
1651053206098,MATH 20D,A03,083767,Staff,22,0,30,8
1651053212132,MATH 20E,A01,083771,Staff,2,0,30,28
1651053212132,MATH 20E,A02,083772,Staff,10,0,30,20
1651053212132,MATH 20E,B01,083773,Staff,0,0,30,30
1651053212132,MATH 20E,B02,083774,Staff,0,0,30,30
1651053218157,MATH 103A,A01,083777,Staff,0,17,30,30
1651053218157,MATH 103A,A02,083778,Staff,0,16,30,30
1651053218157,MATH 103A,B01,083779,Staff,0,15,30,30
1651053218157,MATH 103A,B02,083780,Staff,0,13,30,30
1651053224181,MATH 105,A01,085443,Staff,0,23,30,30
1651053230213,MATH 109,A01,083213,Anzaldo; Leesa B,0,7,30,30
1651053230213,MATH 109,A02,083214,Anzaldo; Leesa B,0,7,30,30
1651053230213,MATH 109,B01,083215,Anzaldo; Leesa B,0,8,30,30
1651053230213,MATH 109,B02,083216,Anzaldo; Leesa B,0,8,30,30
1651053236237,MATH 142A,A01,083219,Chow; Bennett,0,15,30,30
1651053236237,MATH 142A,A02,083220,Chow; Bennett,0,15,30,30
1651053236237,MATH 142A,B01,083221,Chow; Bennett,0,16,30,30
1651053236237,MATH 142A,B02,083222,Chow; Bennett,0,14,30,30
1651053242262,MATH 193A,A01,083224,Staff,0,8,30,30
1651053242262,MATH 193A,A02,083225,Staff,0,7,30,30
1651053242262,MATH 193A,A03,083781,Staff,0,7,30,30
1651053242262,MATH 193A,A04,083782,Staff,0,7,30,30
1651053248293,MATH 197,001,091859,McAuley; Julian John,9998,0,9999,1
1651053254366,COGS 9,A01,083615,Staff,0,20,60,60
1651053260391,COGS 11,A01,083617,Boyle; Mary E. T.,13,0,40,27
1651053266414,COGS 13,A01,083071,Staff,0,40,40,40
1651053272440,COGS 14A,A01,092681,Staff,0,40,100,100
1651053278461,COGS 14B,A01,083073,Cheng; Tzu-Han,0,13,50,50
1651053284501,COGS 17,A01,092677,Staff,9,0,75,66
1651053290522,COGS 100,A01,083619,Staff,0,30,60,60
1651053296550,COGS 101A,A01,083621,Davis; Joshua Daniel,0,29,60,60
1651053302586,COGS 101B,A01,091572,Staff,0,7,60,60
1651053308611,COGS 101C,A01,083625,Delgado; Tania,14,0,30,16
1651053314635,COGS 107A,A01,083627,Boyle; Mary E. T.,0,17,60,60
1651053320659,COGS 118A,A01,083075,Staff,0,10,60,60
1651053326684,CSE 3,A50,083646,Miranda; Gregory Joseph,15,0,38,23
1651053326684,CSE 3,A51,083647,Miranda; Gregory Joseph,36,0,37,1
1651053332708,CSE 8A,A50,083650,Miranda; Gregory Joseph,0,31,40,40
1651053338745,CSE 11,A01,083080,Cao; Yingjun,1,97,40,39
1651053344768,CSE 12,A01,083652,Staff,0,26,100,100
1651053350793,CSE 15L,A01,083654,Staff,0,3,50,50
1651053350793,CSE 15L,A02,083655,Staff,0,3,50,50
1651053356815,CSE 20,A01,083657,Staff,46,0,80,34
1651053362839,CSE 30,A01,083084,Eldon; John,0,38,80,80
1651053368863,CSE 100,A01,083659,Cao; Yingjun,0,72,50,50
1651053374890,CSE 134B,A01,083661,Powell; Thomas Allan,0,38,65,65
1651053380916,CSE 140,A01,083663,Staff,0,15,75,75
1651053386940,CSE 140L,A01,083088,Eldon; John,3,0,100,97
1651053392966,CSE 175,A01,083665,Kumar; Rakesh,0,0,25,25
1651053398989,CSE 190,A00,092507,Dubnov; Shlomo,9,0,20,11
1651053405014,ECE 45,A01,083139,Staff,0,7,60,60
1651053411038,ECE 65,A50,083695,Staff,0,7,30,30
1651053417070,ECE 109,A01,091882,Touri; Behrouz,33,0,70,37
1651053423099,ECE 180,A00,083140,Abi Samra; Nicholas Camill,17,0,30,13
1651053423099,ECE 180,B00,083141,Abi Samra; Nicholas Camill,0,0,30,30
1651053429123,MATH 10A,A01,083735,Patchell; Gregory David,0,0,30,30
1651053429123,MATH 10A,A02,083736,Patchell; Gregory David,27,0,30,3
1651053429123,MATH 10A,A03,083737,Patchell; Gregory David,23,0,30,7
1651053435148,MATH 10B,A01,083207,Staff,0,7,30,30
1651053435148,MATH 10B,A02,083208,Staff,0,6,30,30
1651053435148,MATH 10B,B01,083739,Staff,8,0,30,22
1651053435148,MATH 10B,B02,083740,Staff,28,0,30,2
1651053441176,MATH 18,A01,083743,Staff,0,0,30,30
1651053441176,MATH 18,A02,083744,Staff,23,0,30,7
1651053441176,MATH 18,A03,083745,Staff,19,0,30,11
1651053441176,MATH 18,A04,083746,Staff,26,0,30,4
1651053441176,MATH 18,B01,083748,Staff,0,16,30,30
1651053441176,MATH 18,B02,083749,Staff,0,14,30,30
1651053441176,MATH 18,B03,083750,Staff,0,14,30,30
1651053441176,MATH 18,B04,083751,Staff,0,13,30,30
1651053447201,MATH 20A,A01,083754,Staff,18,0,40,22
1651053453226,MATH 20B,A01,083756,Staff,0,14,30,30
1651053453226,MATH 20B,A02,083757,Staff,0,11,30,30
1651053459268,MATH 20C,A01,083760,Staff,0,16,30,30
1651053459268,MATH 20C,A02,083761,Staff,0,15,30,30
1651053459268,MATH 20C,B01,083762,Staff,8,0,30,22
1651053459268,MATH 20C,B02,083763,Staff,28,0,30,2
1651053465298,MATH 20D,A01,083765,Staff,3,1,30,27
1651053465298,MATH 20D,A02,083766,Staff,1,0,30,29
1651053465298,MATH 20D,A03,083767,Staff,22,0,30,8
1651053471328,MATH 20E,A01,083771,Staff,2,0,30,28
1651053471328,MATH 20E,A02,083772,Staff,10,0,30,20
1651053471328,MATH 20E,B01,083773,Staff,0,0,30,30
1651053471328,MATH 20E,B02,083774,Staff,0,0,30,30
1651053477356,MATH 103A,A01,083777,Staff,0,17,30,30
1651053477356,MATH 103A,A02,083778,Staff,0,16,30,30
1651053477356,MATH 103A,B01,083779,Staff,0,15,30,30
1651053477356,MATH 103A,B02,083780,Staff,0,13,30,30
1651053483384,MATH 105,A01,085443,Staff,0,23,30,30
1651053489409,MATH 109,A01,083213,Anzaldo; Leesa B,0,7,30,30
1651053489409,MATH 109,A02,083214,Anzaldo; Leesa B,0,7,30,30
1651053489409,MATH 109,B01,083215,Anzaldo; Leesa B,0,8,30,30
1651053489409,MATH 109,B02,083216,Anzaldo; Leesa B,0,8,30,30
1651053495435,MATH 142A,A01,083219,Chow; Bennett,0,15,30,30
1651053495435,MATH 142A,A02,083220,Chow; Bennett,0,15,30,30
1651053495435,MATH 142A,B01,083221,Chow; Bennett,0,16,30,30
1651053495435,MATH 142A,B02,083222,Chow; Bennett,0,14,30,30
1651053501459,MATH 193A,A01,083224,Staff,0,8,30,30
1651053501459,MATH 193A,A02,083225,Staff,0,7,30,30
1651053501459,MATH 193A,A03,083781,Staff,0,7,30,30
1651053501459,MATH 193A,A04,083782,Staff,0,7,30,30
1651053507485,MATH 197,001,091859,McAuley; Julian John,9998,0,9999,1
1651053513546,COGS 9,A01,083615,Staff,0,20,60,60
1651053519571,COGS 11,A01,083617,Boyle; Mary E. T.,13,0,40,27
1651053525596,COGS 13,A01,083071,Staff,0,40,40,40
1651053531629,COGS 14A,A01,092681,Staff,0,40,100,100
1651053537730,COGS 14B,A01,083073,Cheng; Tzu-Han,0,13,50,50
1651053543755,COGS 17,A01,092677,Staff,9,0,75,66
1651053549779,COGS 100,A01,083619,Staff,0,30,60,60
1651053555804,COGS 101A,A01,083621,Davis; Joshua Daniel,0,29,60,60
1651053561828,COGS 101B,A01,091572,Staff,0,7,60,60
1651053567853,COGS 101C,A01,083625,Delgado; Tania,14,0,30,16
1651053573883,COGS 107A,A01,083627,Boyle; Mary E. T.,0,17,60,60
1651053579908,COGS 118A,A01,083075,Staff,0,10,60,60
1651053585934,CSE 3,A50,083646,Miranda; Gregory Joseph,15,0,38,23
1651053585934,CSE 3,A51,083647,Miranda; Gregory Joseph,36,0,37,1
1651053591957,CSE 8A,A50,083650,Miranda; Gregory Joseph,0,31,40,40
1651053597982,CSE 11,A01,083080,Cao; Yingjun,1,97,40,39
1651053604009,CSE 12,A01,083652,Staff,0,26,100,100
1651053610050,CSE 15L,A01,083654,Staff,0,3,50,50
1651053610050,CSE 15L,A02,083655,Staff,0,3,50,50
1651053616077,CSE 20,A01,083657,Staff,46,0,80,34
1651053622105,CSE 30,A01,083084,Eldon; John,0,38,80,80
1651053628136,CSE 100,A01,083659,Cao; Yingjun,0,72,50,50
1651053634162,CSE 134B,A01,083661,Powell; Thomas Allan,0,38,65,65
1651053640190,CSE 140,A01,083663,Staff,0,15,75,75
1651053646223,CSE 140L,A01,083088,Eldon; John,3,0,100,97
1651053652249,CSE 175,A01,083665,Kumar; Rakesh,0,0,25,25
1651053658273,CSE 190,A00,092507,Dubnov; Shlomo,9,0,20,11
1651053664297,ECE 45,A01,083139,Staff,0,7,60,60
1651053670321,ECE 65,A50,083695,Staff,0,7,30,30
1651053676346,ECE 109,A01,091882,Touri; Behrouz,33,0,70,37
1651053682371,ECE 180,A00,083140,Abi Samra; Nicholas Camill,17,0,30,13
1651053682371,ECE 180,B00,083141,Abi Samra; Nicholas Camill,0,0,30,30
1651053688396,MATH 10A,A01,083735,Patchell; Gregory David,0,0,30,30
1651053688396,MATH 10A,A02,083736,Patchell; Gregory David,27,0,30,3
1651053688396,MATH 10A,A03,083737,Patchell; Gregory David,23,0,30,7
1651053694419,MATH 10B,A01,083207,Staff,0,7,30,30
1651053694419,MATH 10B,A02,083208,Staff,0,6,30,30
1651053694419,MATH 10B,B01,083739,Staff,8,0,30,22
1651053694419,MATH 10B,B02,083740,Staff,28,0,30,2
1651053700445,MATH 18,A01,083743,Staff,0,0,30,30
1651053700445,MATH 18,A02,083744,Staff,23,0,30,7
1651053700445,MATH 18,A03,083745,Staff,19,0,30,11
1651053700445,MATH 18,A04,083746,Staff,26,0,30,4
1651053700445,MATH 18,B01,083748,Staff,0,16,30,30
1651053700445,MATH 18,B02,083749,Staff,0,14,30,30
1651053700445,MATH 18,B03,083750,Staff,0,14,30,30
1651053700445,MATH 18,B04,083751,Staff,0,13,30,30
1651053706471,MATH 20A,A01,083754,Staff,18,0,40,22
1651053712495,MATH 20B,A01,083756,Staff,0,14,30,30
1651053712495,MATH 20B,A02,083757,Staff,0,11,30,30
1651053718519,MATH 20C,A01,083760,Staff,0,16,30,30
1651053718519,MATH 20C,A02,083761,Staff,0,15,30,30
1651053718519,MATH 20C,B01,083762,Staff,8,0,30,22
1651053718519,MATH 20C,B02,083763,Staff,28,0,30,2
1651053724554,MATH 20D,A01,083765,Staff,3,1,30,27
1651053724554,MATH 20D,A02,083766,Staff,1,0,30,29
1651053724554,MATH 20D,A03,083767,Staff,22,0,30,8
1651053730581,MATH 20E,A01,083771,Staff,2,0,30,28
1651053730581,MATH 20E,A02,083772,Staff,10,0,30,20
1651053730581,MATH 20E,B01,083773,Staff,0,0,30,30
1651053730581,MATH 20E,B02,083774,Staff,0,0,30,30
1651053736610,MATH 103A,A01,083777,Staff,0,17,30,30
1651053736610,MATH 103A,A02,083778,Staff,0,16,30,30
1651053736610,MATH 103A,B01,083779,Staff,0,15,30,30
1651053736610,MATH 103A,B02,083780,Staff,0,13,30,30
1651053742638,MATH 105,A01,085443,Staff,0,23,30,30
1651053748664,MATH 109,A01,083213,Anzaldo; Leesa B,0,7,30,30
1651053748664,MATH 109,A02,083214,Anzaldo; Leesa B,0,7,30,30
1651053748664,MATH 109,B01,083215,Anzaldo; Leesa B,0,8,30,30
1651053748664,MATH 109,B02,083216,Anzaldo; Leesa B,0,8,30,30
1651053754689,MATH 142A,A01,083219,Chow; Bennett,0,15,30,30
1651053754689,MATH 142A,A02,083220,Chow; Bennett,0,15,30,30
1651053754689,MATH 142A,B01,083221,Chow; Bennett,0,16,30,30
1651053754689,MATH 142A,B02,083222,Chow; Bennett,0,14,30,30
1651053760712,MATH 193A,A01,083224,Staff,0,8,30,30
1651053760712,MATH 193A,A02,083225,Staff,0,7,30,30
1651053760712,MATH 193A,A03,083781,Staff,0,7,30,30
1651053760712,MATH 193A,A04,083782,Staff,0,7,30,30
1651053766738,MATH 197,001,091859,McAuley; Julian John,9998,0,9999,1
1651053772795,COGS 9,A01,083615,Staff,0,20,60,60
1651053778823,COGS 11,A01,083617,Boyle; Mary E. T.,13,0,40,27
1651053784853,COGS 13,A01,083071,Staff,0,40,40,40
1651053790879,COGS 14A,A01,092681,Staff,0,40,100,100
1651053796906,COGS 14B,A01,083073,Cheng; Tzu-Han,0,13,50,50
1651053802928,COGS 17,A01,092677,Staff,9,0,75,66
1651053808953,COGS 100,A01,083619,Staff,0,30,60,60
1651053814978,COGS 101A,A01,083621,Davis; Joshua Daniel,0,29,60,60
1651053821004,COGS 101B,A01,091572,Staff,0,7,60,60
1651053827030,COGS 101C,A01,083625,Delgado; Tania,14,0,30,16
1651053833053,COGS 107A,A01,083627,Boyle; Mary E. T.,0,17,60,60
1651053839076,COGS 118A,A01,083075,Staff,0,10,60,60
1651053845112,CSE 3,A50,083646,Miranda; Gregory Joseph,15,0,38,23
1651053845112,CSE 3,A51,083647,Miranda; Gregory Joseph,36,0,37,1
1651053851136,CSE 8A,A50,083650,Miranda; Gregory Joseph,0,31,40,40
1651053857159,CSE 11,A01,083080,Cao; Yingjun,1,97,40,39
1651053863181,CSE 12,A01,083652,Staff,0,26,100,100
1651053869205,CSE 15L,A01,083654,Staff,0,3,50,50
1651053869205,CSE 15L,A02,083655,Staff,0,3,50,50
1651053875228,CSE 20,A01,083657,Staff,46,0,80,34
1651053881264,CSE 30,A01,083084,Eldon; John,0,38,80,80
1651053887287,CSE 100,A01,083659,Cao; Yingjun,0,72,50,50
1651053893315,CSE 134B,A01,083661,Powell; Thomas Allan,0,38,65,65
1651053899339,CSE 140,A01,083663,Staff,0,15,75,75
1651053905361,CSE 140L,A01,083088,Eldon; John,3,0,100,97
1651053911389,CSE 175,A01,083665,Kumar; Rakesh,0,0,25,25
1651053917417,CSE 190,A00,092507,Dubnov; Shlomo,9,0,20,11
1651053923442,ECE 45,A01,083139,Staff,0,7,60,60
1651053929464,ECE 65,A50,083695,Staff,0,7,30,30
1651053935486,ECE 109,A01,091882,Touri; Behrouz,33,0,70,37
1651053941508,ECE 180,A00,083140,Abi Samra; Nicholas Camill,17,0,30,13
1651053941508,ECE 180,B00,083141,Abi Samra; Nicholas Camill,0,0,30,30
1651053947532,MATH 10A,A01,083735,Patchell; Gregory David,0,0,30,30
1651053947532,MATH 10A,A02,083736,Patchell; Gregory David,27,0,30,3
1651053947532,MATH 10A,A03,083737,Patchell; Gregory David,23,0,30,7
1651053953556,MATH 10B,A01,083207,Staff,0,7,30,30
1651053953556,MATH 10B,A02,083208,Staff,0,6,30,30
1651053953556,MATH 10B,B01,083739,Staff,8,0,30,22
1651053953556,MATH 10B,B02,083740,Staff,28,0,30,2
1651053959583,MATH 18,A01,083743,Staff,0,0,30,30
1651053959583,MATH 18,A02,083744,Staff,23,0,30,7
1651053959583,MATH 18,A03,083745,Staff,19,0,30,11
1651053959583,MATH 18,A04,083746,Staff,26,0,30,4
1651053959583,MATH 18,B01,083748,Staff,0,16,30,30
1651053959583,MATH 18,B02,083749,Staff,0,14,30,30
1651053959583,MATH 18,B03,083750,Staff,0,14,30,30
1651053959583,MATH 18,B04,083751,Staff,0,13,30,30
1651053965606,MATH 20A,A01,083754,Staff,18,0,40,22
1651053971628,MATH 20B,A01,083756,Staff,0,14,30,30
1651053971628,MATH 20B,A02,083757,Staff,0,11,30,30
1651053977661,MATH 20C,A01,083760,Staff,0,16,30,30
1651053977661,MATH 20C,A02,083761,Staff,0,15,30,30
1651053977661,MATH 20C,B01,083762,Staff,8,0,30,22
1651053977661,MATH 20C,B02,083763,Staff,28,0,30,2
1651053983689,MATH 20D,A01,083765,Staff,3,1,30,27
1651053983689,MATH 20D,A02,083766,Staff,1,0,30,29
1651053983689,MATH 20D,A03,083767,Staff,22,0,30,8
1651053989718,MATH 20E,A01,083771,Staff,2,0,30,28
1651053989718,MATH 20E,A02,083772,Staff,10,0,30,20
1651053989718,MATH 20E,B01,083773,Staff,0,0,30,30
1651053989718,MATH 20E,B02,083774,Staff,0,0,30,30
1651053995747,MATH 103A,A01,083777,Staff,0,17,30,30
1651053995747,MATH 103A,A02,083778,Staff,0,16,30,30
1651053995747,MATH 103A,B01,083779,Staff,0,15,30,30
1651053995747,MATH 103A,B02,083780,Staff,0,13,30,30
1651054001770,MATH 105,A01,085443,Staff,0,23,30,30
1651054007796,MATH 109,A01,083213,Anzaldo; Leesa B,0,7,30,30
1651054007796,MATH 109,A02,083214,Anzaldo; Leesa B,0,7,30,30
1651054007796,MATH 109,B01,083215,Anzaldo; Leesa B,0,8,30,30
1651054007796,MATH 109,B02,083216,Anzaldo; Leesa B,0,8,30,30
1651054013822,MATH 142A,A01,083219,Chow; Bennett,0,15,30,30
1651054013822,MATH 142A,A02,083220,Chow; Bennett,0,15,30,30
1651054013822,MATH 142A,B01,083221,Chow; Bennett,0,16,30,30
1651054013822,MATH 142A,B02,083222,Chow; Bennett,0,14,30,30
1651054019852,MATH 193A,A01,083224,Staff,0,8,30,30
1651054019852,MATH 193A,A02,083225,Staff,0,7,30,30
1651054019852,MATH 193A,A03,083781,Staff,0,7,30,30
1651054019852,MATH 193A,A04,083782,Staff,0,7,30,30
1651054025874,MATH 197,001,091859,McAuley; Julian John,9998,0,9999,1
1651054031933,COGS 9,A01,083615,Staff,0,20,60,60
1651054037958,COGS 11,A01,083617,Boyle; Mary E. T.,13,0,40,27
1651054043985,COGS 13,A01,083071,Staff,0,40,40,40
1651054050014,COGS 14A,A01,092681,Staff,0,40,100,100
1651054056039,COGS 14B,A01,083073,Cheng; Tzu-Han,0,13,50,50
1651054062064,COGS 17,A01,092677,Staff,9,0,75,66
1651054068088,COGS 100,A01,083619,Staff,0,30,60,60
1651054074117,COGS 101A,A01,083621,Davis; Joshua Daniel,0,29,60,60
1651054080145,COGS 101B,A01,091572,Staff,0,7,60,60
1651054086168,COGS 101C,A01,083625,Delgado; Tania,14,0,30,16
1651054092193,COGS 107A,A01,083627,Boyle; Mary E. T.,0,17,60,60
1651054098217,COGS 118A,A01,083075,Staff,0,10,60,60
1651054104247,CSE 3,A50,083646,Miranda; Gregory Joseph,15,0,38,23
1651054104247,CSE 3,A51,083647,Miranda; Gregory Joseph,36,0,37,1
1651054110275,CSE 8A,A50,083650,Miranda; Gregory Joseph,0,31,40,40
1651054116300,CSE 11,A01,083080,Cao; Yingjun,1,97,40,39
1651054122329,CSE 12,A01,083652,Staff,0,26,100,100
1651054128354,CSE 15L,A01,083654,Staff,0,3,50,50
1651054128354,CSE 15L,A02,083655,Staff,0,3,50,50
1651054134469,CSE 20,A01,083657,Staff,46,0,80,34
1651054140508,CSE 30,A01,083084,Eldon; John,0,38,80,80
1651054146532,CSE 100,A01,083659,Cao; Yingjun,0,72,50,50
1651054152556,CSE 134B,A01,083661,Powell; Thomas Allan,0,38,65,65
1651054158582,CSE 140,A01,083663,Staff,0,15,75,75
1651054164606,CSE 140L,A01,083088,Eldon; John,3,0,100,97
1651054170631,CSE 175,A01,083665,Kumar; Rakesh,0,0,25,25
1651054176660,CSE 190,A00,092507,Dubnov; Shlomo,9,0,20,11
1651054182685,ECE 45,A01,083139,Staff,0,7,60,60
1651054188714,ECE 65,A50,083695,Staff,0,7,30,30
1651054194737,ECE 109,A01,091882,Touri; Behrouz,33,0,70,37
1651054200762,ECE 180,A00,083140,Abi Samra; Nicholas Camill,17,0,30,13
1651054200762,ECE 180,B00,083141,Abi Samra; Nicholas Camill,0,0,30,30
1651054206787,MATH 10A,A01,083735,Patchell; Gregory David,0,0,30,30
1651054206787,MATH 10A,A02,083736,Patchell; Gregory David,27,0,30,3
1651054206787,MATH 10A,A03,083737,Patchell; Gregory David,23,0,30,7
1651054212815,MATH 10B,A01,083207,Staff,0,7,30,30
1651054212815,MATH 10B,A02,083208,Staff,0,6,30,30
1651054212815,MATH 10B,B01,083739,Staff,8,0,30,22
1651054212815,MATH 10B,B02,083740,Staff,28,0,30,2
1651054218841,MATH 18,A01,083743,Staff,0,0,30,30
1651054218841,MATH 18,A02,083744,Staff,23,0,30,7
1651054218841,MATH 18,A03,083745,Staff,19,0,30,11
1651054218841,MATH 18,A04,083746,Staff,26,0,30,4
1651054218841,MATH 18,B01,083748,Staff,0,16,30,30
1651054218841,MATH 18,B02,083749,Staff,0,14,30,30
1651054218841,MATH 18,B03,083750,Staff,0,14,30,30
1651054218841,MATH 18,B04,083751,Staff,0,13,30,30
1651054224867,MATH 20A,A01,083754,Staff,18,0,40,22
1651054230891,MATH 20B,A01,083756,Staff,0,14,30,30
1651054230891,MATH 20B,A02,083757,Staff,0,11,30,30
1651054236916,MATH 20C,A01,083760,Staff,0,16,30,30
1651054236916,MATH 20C,A02,083761,Staff,0,15,30,30
1651054236916,MATH 20C,B01,083762,Staff,8,0,30,22
1651054236916,MATH 20C,B02,083763,Staff,28,0,30,2
1651054242939,MATH 20D,A01,083765,Staff,3,1,30,27
1651054242939,MATH 20D,A02,083766,Staff,1,0,30,29
1651054242939,MATH 20D,A03,083767,Staff,22,0,30,8
1651054248971,MATH 20E,A01,083771,Staff,2,0,30,28
1651054248971,MATH 20E,A02,083772,Staff,10,0,30,20
1651054248971,MATH 20E,B01,083773,Staff,0,0,30,30
1651054248971,MATH 20E,B02,083774,Staff,0,0,30,30
1651054255000,MATH 103A,A01,083777,Staff,0,17,30,30
1651054255000,MATH 103A,A02,083778,Staff,0,16,30,30
1651054255000,MATH 103A,B01,083779,Staff,0,15,30,30
1651054255000,MATH 103A,B02,083780,Staff,0,13,30,30
1651054261028,MATH 105,A01,085443,Staff,0,23,30,30
1651054267057,MATH 109,A01,083213,Anzaldo; Leesa B,0,7,30,30
1651054267057,MATH 109,A02,083214,Anzaldo; Leesa B,0,7,30,30
1651054267057,MATH 109,B01,083215,Anzaldo; Leesa B,0,8,30,30
1651054267057,MATH 109,B02,083216,Anzaldo; Leesa B,0,8,30,30
1651054273082,MATH 142A,A01,083219,Chow; Bennett,0,15,30,30
1651054273082,MATH 142A,A02,083220,Chow; Bennett,0,15,30,30
1651054273082,MATH 142A,B01,083221,Chow; Bennett,0,16,30,30
1651054273082,MATH 142A,B02,083222,Chow; Bennett,0,14,30,30
1651054279105,MATH 193A,A01,083224,Staff,0,8,30,30
1651054279105,MATH 193A,A02,083225,Staff,0,7,30,30
1651054279105,MATH 193A,A03,083781,Staff,0,7,30,30
1651054279105,MATH 193A,A04,083782,Staff,0,7,30,30
1651054285137,MATH 197,001,091859,McAuley; Julian John,9998,0,9999,1
1651054291197,COGS 9,A01,083615,Staff,0,20,60,60
1651054297224,COGS 11,A01,083617,Boyle; Mary E. T.,13,0,40,27
1651054303247,COGS 13,A01,083071,Staff,0,40,40,40
1651054309269,COGS 14A,A01,092681,Staff,0,40,100,100
1651054315298,COGS 14B,A01,083073,Cheng; Tzu-Han,0,13,50,50
1651054321321,COGS 17,A01,092677,Staff,9,0,75,66
1651054327346,COGS 100,A01,083619,Staff,0,30,60,60
1651054333370,COGS 101A,A01,083621,Davis; Joshua Daniel,0,29,60,60
1651054339394,COGS 101B,A01,091572,Staff,0,7,60,60
1651054345417,COGS 101C,A01,083625,Delgado; Tania,14,0,30,16
1651054351442,COGS 107A,A01,083627,Boyle; Mary E. T.,0,17,60,60
1651054357466,COGS 118A,A01,083075,Staff,0,10,60,60
1651054363498,CSE 3,A50,083646,Miranda; Gregory Joseph,15,0,38,23
1651054363498,CSE 3,A51,083647,Miranda; Gregory Joseph,36,0,37,1
1651054369527,CSE 8A,A50,083650,Miranda; Gregory Joseph,0,31,40,40
1651054375551,CSE 11,A01,083080,Cao; Yingjun,1,97,40,39
1651054381573,CSE 12,A01,083652,Staff,0,26,100,100
1651054387603,CSE 15L,A01,083654,Staff,0,3,50,50
1651054387603,CSE 15L,A02,083655,Staff,0,3,50,50
1651054393629,CSE 20,A01,083657,Staff,46,0,80,34
1651054399653,CSE 30,A01,083084,Eldon; John,0,38,80,80
1651054405675,CSE 100,A01,083659,Cao; Yingjun,0,72,50,50
1651054411700,CSE 134B,A01,083661,Powell; Thomas Allan,0,38,65,65
1651054417722,CSE 140,A01,083663,Staff,0,15,75,75
1651054423749,CSE 140L,A01,083088,Eldon; John,3,0,100,97
1651054429777,CSE 175,A01,083665,Kumar; Rakesh,0,0,25,25
1651054435799,CSE 190,A00,092507,Dubnov; Shlomo,9,0,20,11
1651054441823,ECE 45,A01,083139,Staff,0,7,60,60
1651054447851,ECE 65,A50,083695,Staff,0,7,30,30
1651054453878,ECE 109,A01,091882,Touri; Behrouz,33,0,70,37
1651054459905,ECE 180,A00,083140,Abi Samra; Nicholas Camill,17,0,30,13
1651054459905,ECE 180,B00,083141,Abi Samra; Nicholas Camill,0,0,30,30
1651054465929,MATH 10A,A01,083735,Patchell; Gregory David,0,0,30,30
1651054465929,MATH 10A,A02,083736,Patchell; Gregory David,27,0,30,3
1651054465929,MATH 10A,A03,083737,Patchell; Gregory David,23,0,30,7
1651054471954,MATH 10B,A01,083207,Staff,0,7,30,30
1651054471954,MATH 10B,A02,083208,Staff,0,6,30,30
1651054471954,MATH 10B,B01,083739,Staff,8,0,30,22
1651054471954,MATH 10B,B02,083740,Staff,28,0,30,2
1651054477985,MATH 18,A01,083743,Staff,0,0,30,30
1651054477985,MATH 18,A02,083744,Staff,23,0,30,7
1651054477985,MATH 18,A03,083745,Staff,19,0,30,11
1651054477985,MATH 18,A04,083746,Staff,26,0,30,4
1651054477985,MATH 18,B01,083748,Staff,0,16,30,30
1651054477985,MATH 18,B02,083749,Staff,0,14,30,30
1651054477985,MATH 18,B03,083750,Staff,0,14,30,30
1651054477985,MATH 18,B04,083751,Staff,0,13,30,30
1651054484014,MATH 20A,A01,083754,Staff,18,0,40,22
1651054490053,MATH 20B,A01,083756,Staff,0,14,30,30
1651054490053,MATH 20B,A02,083757,Staff,0,11,30,30
1651054496081,MATH 20C,A01,083760,Staff,0,16,30,30
1651054496081,MATH 20C,A02,083761,Staff,0,15,30,30
1651054496081,MATH 20C,B01,083762,Staff,8,0,30,22
1651054496081,MATH 20C,B02,083763,Staff,28,0,30,2
1651054502106,MATH 20D,A01,083765,Staff,3,1,30,27
1651054502106,MATH 20D,A02,083766,Staff,1,0,30,29
1651054502106,MATH 20D,A03,083767,Staff,22,0,30,8
1651054508131,MATH 20E,A01,083771,Staff,2,0,30,28
1651054508131,MATH 20E,A02,083772,Staff,10,0,30,20
1651054508131,MATH 20E,B01,083773,Staff,0,0,30,30
1651054508131,MATH 20E,B02,083774,Staff,0,0,30,30
1651054514159,MATH 103A,A01,083777,Staff,0,17,30,30
1651054514159,MATH 103A,A02,083778,Staff,0,16,30,30
1651054514159,MATH 103A,B01,083779,Staff,0,15,30,30
1651054514159,MATH 103A,B02,083780,Staff,0,13,30,30
1651054520186,MATH 105,A01,085443,Staff,0,23,30,30
1651054526211,MATH 109,A01,083213,Anzaldo; Leesa B,0,7,30,30
1651054526211,MATH 109,A02,083214,Anzaldo; Leesa B,0,7,30,30
1651054526211,MATH 109,B01,083215,Anzaldo; Leesa B,0,8,30,30
1651054526211,MATH 109,B02,083216,Anzaldo; Leesa B,0,8,30,30
1651054532235,MATH 142A,A01,083219,Chow; Bennett,0,15,30,30
1651054532235,MATH 142A,A02,083220,Chow; Bennett,0,15,30,30
1651054532235,MATH 142A,B01,083221,Chow; Bennett,0,16,30,30
1651054532235,MATH 142A,B02,083222,Chow; Bennett,0,14,30,30
1651054538259,MATH 193A,A01,083224,Staff,0,8,30,30
1651054538259,MATH 193A,A02,083225,Staff,0,7,30,30
1651054538259,MATH 193A,A03,083781,Staff,0,7,30,30
1651054538259,MATH 193A,A04,083782,Staff,0,7,30,30
1651054544301,MATH 197,001,091859,McAuley; Julian John,9998,0,9999,1
1651054550357,COGS 9,A01,083615,Staff,0,20,60,60
1651054556384,COGS 11,A01,083617,Boyle; Mary E. T.,13,0,40,27
1651054562412,COGS 13,A01,083071,Staff,0,40,40,40
1651054568434,COGS 14A,A01,092681,Staff,0,40,100,100
1651054574462,COGS 14B,A01,083073,Cheng; Tzu-Han,0,13,50,50
1651054580489,COGS 17,A01,092677,Staff,9,0,75,66
1651054586514,COGS 100,A01,083619,Staff,0,30,60,60
1651054592542,COGS 101A,A01,083621,Davis; Joshua Daniel,0,29,60,60
1651054598570,COGS 101B,A01,091572,Staff,0,7,60,60
1651054604598,COGS 101C,A01,083625,Delgado; Tania,14,0,30,16
1651054610620,COGS 107A,A01,083627,Boyle; Mary E. T.,0,17,60,60
1651054616643,COGS 118A,A01,083075,Staff,0,10,60,60
1651054622669,CSE 3,A50,083646,Miranda; Gregory Joseph,15,0,38,23
1651054622669,CSE 3,A51,083647,Miranda; Gregory Joseph,36,0,37,1
1651054628696,CSE 8A,A50,083650,Miranda; Gregory Joseph,0,31,40,40
1651054634723,CSE 11,A01,083080,Cao; Yingjun,1,97,40,39
1651054640745,CSE 12,A01,083652,Staff,0,26,100,100
1651054646773,CSE 15L,A01,083654,Staff,0,3,50,50
1651054646773,CSE 15L,A02,083655,Staff,0,3,50,50
1651054652796,CSE 20,A01,083657,Staff,46,0,80,34
1651054658824,CSE 30,A01,083084,Eldon; John,0,38,80,80
1651054664848,CSE 100,A01,083659,Cao; Yingjun,0,72,50,50
1651054670873,CSE 134B,A01,083661,Powell; Thomas Allan,0,38,65,65
1651054676894,CSE 140,A01,083663,Staff,0,15,75,75
1651054682921,CSE 140L,A01,083088,Eldon; John,3,0,100,97
1651054688943,CSE 175,A01,083665,Kumar; Rakesh,0,0,25,25
1651054694969,CSE 190,A00,092507,Dubnov; Shlomo,9,0,20,11
1651054700992,ECE 45,A01,083139,Staff,0,7,60,60
1651054707017,ECE 65,A50,083695,Staff,0,7,30,30
1651054713039,ECE 109,A01,091882,Touri; Behrouz,33,0,70,37
1651054719063,ECE 180,A00,083140,Abi Samra; Nicholas Camill,17,0,30,13
1651054719063,ECE 180,B00,083141,Abi Samra; Nicholas Camill,0,0,30,30
1651054725085,MATH 10A,A01,083735,Patchell; Gregory David,0,0,30,30
1651054725085,MATH 10A,A02,083736,Patchell; Gregory David,27,0,30,3
1651054725085,MATH 10A,A03,083737,Patchell; Gregory David,23,0,30,7
1651054731181,MATH 10B,A01,083207,Staff,0,7,30,30
1651054731181,MATH 10B,A02,083208,Staff,0,6,30,30
1651054731181,MATH 10B,B01,083739,Staff,8,0,30,22
1651054731181,MATH 10B,B02,083740,Staff,28,0,30,2
1651054737204,MATH 18,A01,083743,Staff,0,0,30,30
1651054737204,MATH 18,A02,083744,Staff,23,0,30,7
1651054737204,MATH 18,A03,083745,Staff,19,0,30,11
1651054737204,MATH 18,A04,083746,Staff,26,0,30,4
1651054737204,MATH 18,B01,083748,Staff,0,16,30,30
1651054737204,MATH 18,B02,083749,Staff,0,14,30,30
1651054737204,MATH 18,B03,083750,Staff,0,14,30,30
1651054737204,MATH 18,B04,083751,Staff,0,13,30,30
1651054743227,MATH 20A,A01,083754,Staff,18,0,40,22
1651054749249,MATH 20B,A01,083756,Staff,0,14,30,30
1651054749249,MATH 20B,A02,083757,Staff,0,11,30,30
1651054755272,MATH 20C,A01,083760,Staff,0,16,30,30
1651054755272,MATH 20C,A02,083761,Staff,0,15,30,30
1651054755272,MATH 20C,B01,083762,Staff,8,0,30,22
1651054755272,MATH 20C,B02,083763,Staff,28,0,30,2
1651054761296,MATH 20D,A01,083765,Staff,3,1,30,27
1651054761296,MATH 20D,A02,083766,Staff,1,0,30,29
1651054761296,MATH 20D,A03,083767,Staff,22,0,30,8
1651054767321,MATH 20E,A01,083771,Staff,2,0,30,28
1651054767321,MATH 20E,A02,083772,Staff,10,0,30,20
1651054767321,MATH 20E,B01,083773,Staff,0,0,30,30
1651054767321,MATH 20E,B02,083774,Staff,0,0,30,30
1651054773345,MATH 103A,A01,083777,Staff,0,17,30,30
1651054773345,MATH 103A,A02,083778,Staff,0,16,30,30
1651054773345,MATH 103A,B01,083779,Staff,0,15,30,30
1651054773345,MATH 103A,B02,083780,Staff,0,13,30,30
1651054779368,MATH 105,A01,085443,Staff,0,23,30,30
1651054785392,MATH 109,A01,083213,Anzaldo; Leesa B,0,7,30,30
1651054785392,MATH 109,A02,083214,Anzaldo; Leesa B,0,7,30,30
1651054785392,MATH 109,B01,083215,Anzaldo; Leesa B,0,8,30,30
1651054785392,MATH 109,B02,083216,Anzaldo; Leesa B,0,8,30,30
1651054791419,MATH 142A,A01,083219,Chow; Bennett,0,15,30,30
1651054791419,MATH 142A,A02,083220,Chow; Bennett,0,15,30,30
1651054791419,MATH 142A,B01,083221,Chow; Bennett,0,16,30,30
1651054791419,MATH 142A,B02,083222,Chow; Bennett,0,14,30,30
1651054797446,MATH 193A,A01,083224,Staff,0,8,30,30
1651054797446,MATH 193A,A02,083225,Staff,0,7,30,30
1651054797446,MATH 193A,A03,083781,Staff,0,7,30,30
1651054797446,MATH 193A,A04,083782,Staff,0,7,30,30
1651054803473,MATH 197,001,091859,McAuley; Julian John,9998,0,9999,1
1651054809540,COGS 9,A01,083615,Staff,0,20,60,60
1651054815562,COGS 11,A01,083617,Boyle; Mary E. T.,13,0,40,27
1651054821586,COGS 13,A01,083071,Staff,0,40,40,40
1651054827609,COGS 14A,A01,092681,Staff,0,40,100,100
1651054833636,COGS 14B,A01,083073,Cheng; Tzu-Han,0,13,50,50
1651054839660,COGS 17,A01,092677,Staff,9,0,75,66
1651054845682,COGS 100,A01,083619,Staff,0,30,60,60
1651054851711,COGS 101A,A01,083621,Davis; Joshua Daniel,0,29,60,60
1651054857738,COGS 101B,A01,091572,Staff,0,7,60,60
1651054863762,COGS 101C,A01,083625,Delgado; Tania,14,0,30,16
1651054869785,COGS 107A,A01,083627,Boyle; Mary E. T.,0,17,60,60
1651054875810,COGS 118A,A01,083075,Staff,0,10,60,60
1651054881833,CSE 3,A50,083646,Miranda; Gregory Joseph,15,0,38,23
1651054881833,CSE 3,A51,083647,Miranda; Gregory Joseph,36,0,37,1
1651054887858,CSE 8A,A50,083650,Miranda; Gregory Joseph,0,31,40,40
1651054893891,CSE 11,A01,083080,Cao; Yingjun,1,97,40,39
1651054899914,CSE 12,A01,083652,Staff,0,26,100,100
1651054905942,CSE 15L,A01,083654,Staff,0,3,50,50
1651054905942,CSE 15L,A02,083655,Staff,0,3,50,50
1651054911964,CSE 20,A01,083657,Staff,46,0,80,34
1651054917991,CSE 30,A01,083084,Eldon; John,0,38,80,80
1651054924016,CSE 100,A01,083659,Cao; Yingjun,0,72,50,50
1651054930043,CSE 134B,A01,083661,Powell; Thomas Allan,0,38,65,65
1651054936066,CSE 140,A01,083663,Staff,0,15,75,75
1651054942094,CSE 140L,A01,083088,Eldon; John,3,0,100,97
1651054948121,CSE 175,A01,083665,Kumar; Rakesh,0,0,25,25
1651054954146,CSE 190,A00,092507,Dubnov; Shlomo,9,0,20,11
1651054960173,ECE 45,A01,083139,Staff,0,7,60,60
1651054966199,ECE 65,A50,083695,Staff,0,7,30,30
1651054972223,ECE 109,A01,091882,Touri; Behrouz,33,0,70,37
1651054978249,ECE 180,A00,083140,Abi Samra; Nicholas Camill,17,0,30,13
1651054978249,ECE 180,B00,083141,Abi Samra; Nicholas Camill,0,0,30,30
1651054984276,MATH 10A,A01,083735,Patchell; Gregory David,0,0,30,30
1651054984276,MATH 10A,A02,083736,Patchell; Gregory David,27,0,30,3
1651054984276,MATH 10A,A03,083737,Patchell; Gregory David,23,0,30,7
1651054990301,MATH 10B,A01,083207,Staff,0,7,30,30
1651054990301,MATH 10B,A02,083208,Staff,0,6,30,30
1651054990301,MATH 10B,B01,083739,Staff,8,0,30,22
1651054990301,MATH 10B,B02,083740,Staff,28,0,30,2
1651054996327,MATH 18,A01,083743,Staff,0,0,30,30
1651054996327,MATH 18,A02,083744,Staff,23,0,30,7
1651054996327,MATH 18,A03,083745,Staff,19,0,30,11
1651054996327,MATH 18,A04,083746,Staff,26,0,30,4
1651054996327,MATH 18,B01,083748,Staff,0,16,30,30
1651054996327,MATH 18,B02,083749,Staff,0,14,30,30
1651054996327,MATH 18,B03,083750,Staff,0,14,30,30
1651054996327,MATH 18,B04,083751,Staff,0,13,30,30
1651055002353,MATH 20A,A01,083754,Staff,18,0,40,22
1651055008374,MATH 20B,A01,083756,Staff,0,14,30,30
1651055008374,MATH 20B,A02,083757,Staff,0,11,30,30
1651055014407,MATH 20C,A01,083760,Staff,0,16,30,30
1651055014407,MATH 20C,A02,083761,Staff,0,15,30,30
1651055014407,MATH 20C,B01,083762,Staff,8,0,30,22
1651055014407,MATH 20C,B02,083763,Staff,28,0,30,2
1651055020434,MATH 20D,A01,083765,Staff,3,1,30,27
1651055020434,MATH 20D,A02,083766,Staff,1,0,30,29
1651055020434,MATH 20D,A03,083767,Staff,22,0,30,8
1651055026461,MATH 20E,A01,083771,Staff,2,0,30,28
1651055026461,MATH 20E,A02,083772,Staff,10,0,30,20
1651055026461,MATH 20E,B01,083773,Staff,0,0,30,30
1651055026461,MATH 20E,B02,083774,Staff,0,0,30,30
1651055032485,MATH 103A,A01,083777,Staff,0,17,30,30
1651055032485,MATH 103A,A02,083778,Staff,0,16,30,30
1651055032485,MATH 103A,B01,083779,Staff,0,15,30,30
1651055032485,MATH 103A,B02,083780,Staff,0,13,30,30
1651055038511,MATH 105,A01,085443,Staff,0,23,30,30
1651055044537,MATH 109,A01,083213,Anzaldo; Leesa B,0,7,30,30
1651055044537,MATH 109,A02,083214,Anzaldo; Leesa B,0,7,30,30
1651055044537,MATH 109,B01,083215,Anzaldo; Leesa B,0,8,30,30
1651055044537,MATH 109,B02,083216,Anzaldo; Leesa B,0,8,30,30
1651055050567,MATH 142A,A01,083219,Chow; Bennett,0,15,30,30
1651055050567,MATH 142A,A02,083220,Chow; Bennett,0,15,30,30
1651055050567,MATH 142A,B01,083221,Chow; Bennett,0,16,30,30
1651055050567,MATH 142A,B02,083222,Chow; Bennett,0,14,30,30
1651055056594,MATH 193A,A01,083224,Staff,0,8,30,30
1651055056594,MATH 193A,A02,083225,Staff,0,7,30,30
1651055056594,MATH 193A,A03,083781,Staff,0,7,30,30
1651055056594,MATH 193A,A04,083782,Staff,0,7,30,30
1651055062618,MATH 197,001,091859,McAuley; Julian John,9998,0,9999,1
1651055068675,COGS 9,A01,083615,Staff,0,20,60,60
1651055074701,COGS 11,A01,083617,Boyle; Mary E. T.,13,0,40,27
1651055080728,COGS 13,A01,083071,Staff,0,40,40,40
1651055086753,COGS 14A,A01,092681,Staff,0,40,100,100
1651055092777,COGS 14B,A01,083073,Cheng; Tzu-Han,0,13,50,50
1651055098803,COGS 17,A01,092677,Staff,9,0,75,66
1651055104827,COGS 100,A01,083619,Staff,0,30,60,60
1651055110855,COGS 101A,A01,083621,Davis; Joshua Daniel,0,29,60,60
1651055116878,COGS 101B,A01,091572,Staff,0,7,60,60
1651055122904,COGS 101C,A01,083625,Delgado; Tania,14,0,30,16
1651055128927,COGS 107A,A01,083627,Boyle; Mary E. T.,0,17,60,60
1651055134951,COGS 118A,A01,083075,Staff,0,10,60,60
1651055140980,CSE 3,A50,083646,Miranda; Gregory Joseph,15,0,38,23
1651055140980,CSE 3,A51,083647,Miranda; Gregory Joseph,36,0,37,1
1651055147007,CSE 8A,A50,083650,Miranda; Gregory Joseph,0,31,40,40
1651055153034,CSE 11,A01,083080,Cao; Yingjun,1,97,40,39
1651055159057,CSE 12,A01,083652,Staff,0,26,100,100
1651055165081,CSE 15L,A01,083654,Staff,0,3,50,50
1651055165081,CSE 15L,A02,083655,Staff,0,3,50,50
1651055171112,CSE 20,A01,083657,Staff,46,0,80,34
1651055177136,CSE 30,A01,083084,Eldon; John,0,38,80,80
1651055183163,CSE 100,A01,083659,Cao; Yingjun,0,72,50,50
1651055189190,CSE 134B,A01,083661,Powell; Thomas Allan,0,38,65,65
1651055195216,CSE 140,A01,083663,Staff,0,15,75,75
1651055201241,CSE 140L,A01,083088,Eldon; John,3,0,100,97
1651055207265,CSE 175,A01,083665,Kumar; Rakesh,0,0,25,25
1651055213288,CSE 190,A00,092507,Dubnov; Shlomo,9,0,20,11
1651055219311,ECE 45,A01,083139,Staff,0,7,60,60
1651055225335,ECE 65,A50,083695,Staff,0,7,30,30
1651055231364,ECE 109,A01,091882,Touri; Behrouz,33,0,70,37
1651055237387,ECE 180,A00,083140,Abi Samra; Nicholas Camill,17,0,30,13
1651055237387,ECE 180,B00,083141,Abi Samra; Nicholas Camill,0,0,30,30
1651055243410,MATH 10A,A01,083735,Patchell; Gregory David,0,0,30,30
1651055243410,MATH 10A,A02,083736,Patchell; Gregory David,27,0,30,3
1651055243410,MATH 10A,A03,083737,Patchell; Gregory David,23,0,30,7
1651055249435,MATH 10B,A01,083207,Staff,0,7,30,30
1651055249435,MATH 10B,A02,083208,Staff,0,6,30,30
1651055249435,MATH 10B,B01,083739,Staff,8,0,30,22
1651055249435,MATH 10B,B02,083740,Staff,28,0,30,2
1651055255460,MATH 18,A01,083743,Staff,0,0,30,30
1651055255460,MATH 18,A02,083744,Staff,23,0,30,7
1651055255460,MATH 18,A03,083745,Staff,19,0,30,11
1651055255460,MATH 18,A04,083746,Staff,26,0,30,4
1651055255460,MATH 18,B01,083748,Staff,0,16,30,30
1651055255460,MATH 18,B02,083749,Staff,0,14,30,30
1651055255460,MATH 18,B03,083750,Staff,0,14,30,30
1651055255460,MATH 18,B04,083751,Staff,0,13,30,30
1651055261483,MATH 20A,A01,083754,Staff,18,0,40,22
1651055267507,MATH 20B,A01,083756,Staff,0,14,30,30
1651055267507,MATH 20B,A02,083757,Staff,0,11,30,30
1651055273536,MATH 20C,A01,083760,Staff,0,16,30,30
1651055273536,MATH 20C,A02,083761,Staff,0,15,30,30
1651055273536,MATH 20C,B01,083762,Staff,8,0,30,22
1651055273536,MATH 20C,B02,083763,Staff,28,0,30,2
1651055279563,MATH 20D,A01,083765,Staff,3,1,30,27
1651055279563,MATH 20D,A02,083766,Staff,1,0,30,29
1651055279563,MATH 20D,A03,083767,Staff,22,0,30,8
1651055285587,MATH 20E,A01,083771,Staff,2,0,30,28
1651055285587,MATH 20E,A02,083772,Staff,10,0,30,20
1651055285587,MATH 20E,B01,083773,Staff,0,0,30,30
1651055285587,MATH 20E,B02,083774,Staff,0,0,30,30
1651055291615,MATH 103A,A01,083777,Staff,0,17,30,30
1651055291615,MATH 103A,A02,083778,Staff,0,16,30,30
1651055291615,MATH 103A,B01,083779,Staff,0,15,30,30
1651055291615,MATH 103A,B02,083780,Staff,0,13,30,30
1651055297643,MATH 105,A01,085443,Staff,0,23,30,30
1651055303679,MATH 109,A01,083213,Anzaldo; Leesa B,0,7,30,30
1651055303679,MATH 109,A02,083214,Anzaldo; Leesa B,0,7,30,30
1651055303679,MATH 109,B01,083215,Anzaldo; Leesa B,0,8,30,30
1651055303679,MATH 109,B02,083216,Anzaldo; Leesa B,0,8,30,30
1651055309705,MATH 142A,A01,083219,Chow; Bennett,0,15,30,30
1651055309705,MATH 142A,A02,083220,Chow; Bennett,0,15,30,30
1651055309705,MATH 142A,B01,083221,Chow; Bennett,0,16,30,30
1651055309705,MATH 142A,B02,083222,Chow; Bennett,0,14,30,30
1651055315730,MATH 193A,A01,083224,Staff,0,8,30,30
1651055315730,MATH 193A,A02,083225,Staff,0,7,30,30
1651055315730,MATH 193A,A03,083781,Staff,0,7,30,30
1651055315730,MATH 193A,A04,083782,Staff,0,7,30,30
1651055321753,MATH 197,001,091859,McAuley; Julian John,9998,0,9999,1
1651055327882,COGS 9,A01,083615,Staff,0,20,60,60
1651055333906,COGS 11,A01,083617,Boyle; Mary E. T.,13,0,40,27
1651055339929,COGS 13,A01,083071,Staff,0,40,40,40
1651055345956,COGS 14A,A01,092681,Staff,0,40,100,100
1651055351982,COGS 14B,A01,083073,Cheng; Tzu-Han,0,13,50,50
1651055358007,COGS 17,A01,092677,Staff,9,0,75,66
1651055364034,COGS 100,A01,083619,Staff,0,30,60,60
1651055370058,COGS 101A,A01,083621,Davis; Joshua Daniel,0,29,60,60
1651055376081,COGS 101B,A01,091572,Staff,0,7,60,60
1651055382104,COGS 101C,A01,083625,Delgado; Tania,14,0,30,16
1651055388128,COGS 107A,A01,083627,Boyle; Mary E. T.,0,17,60,60
1651055394152,COGS 118A,A01,083075,Staff,0,10,60,60
1651055400183,CSE 3,A50,083646,Miranda; Gregory Joseph,15,0,38,23
1651055400183,CSE 3,A51,083647,Miranda; Gregory Joseph,36,0,37,1
1651055406214,CSE 8A,A50,083650,Miranda; Gregory Joseph,0,31,40,40
1651055412237,CSE 11,A01,083080,Cao; Yingjun,1,97,40,39
1651055418263,CSE 12,A01,083652,Staff,0,26,100,100
1651055424287,CSE 15L,A01,083654,Staff,0,3,50,50
1651055424287,CSE 15L,A02,083655,Staff,0,3,50,50
1651055430309,CSE 20,A01,083657,Staff,46,0,80,34
1651055436335,CSE 30,A01,083084,Eldon; John,0,38,80,80
1651055442363,CSE 100,A01,083659,Cao; Yingjun,0,72,50,50
1651055448386,CSE 134B,A01,083661,Powell; Thomas Allan,0,38,65,65
1651055454409,CSE 140,A01,083663,Staff,0,15,75,75
1651055460433,CSE 140L,A01,083088,Eldon; John,3,0,100,97
1651055466457,CSE 175,A01,083665,Kumar; Rakesh,0,0,25,25
1651055472484,CSE 190,A00,092507,Dubnov; Shlomo,9,0,20,11
1651055478508,ECE 45,A01,083139,Staff,0,7,60,60
1651055484534,ECE 65,A50,083695,Staff,0,7,30,30
1651055490558,ECE 109,A01,091882,Touri; Behrouz,33,0,70,37
1651055496586,ECE 180,A00,083140,Abi Samra; Nicholas Camill,17,0,30,13
1651055496586,ECE 180,B00,083141,Abi Samra; Nicholas Camill,0,0,30,30
1651055502608,MATH 10A,A01,083735,Patchell; Gregory David,0,0,30,30
1651055502608,MATH 10A,A02,083736,Patchell; Gregory David,27,0,30,3
1651055502608,MATH 10A,A03,083737,Patchell; Gregory David,23,0,30,7
1651055508632,MATH 10B,A01,083207,Staff,0,7,30,30
1651055508632,MATH 10B,A02,083208,Staff,0,6,30,30
1651055508632,MATH 10B,B01,083739,Staff,8,0,30,22
1651055508632,MATH 10B,B02,083740,Staff,28,0,30,2
1651055514662,MATH 18,A01,083743,Staff,0,0,30,30
1651055514662,MATH 18,A02,083744,Staff,23,0,30,7
1651055514662,MATH 18,A03,083745,Staff,19,0,30,11
1651055514662,MATH 18,A04,083746,Staff,26,0,30,4
1651055514662,MATH 18,B01,083748,Staff,0,16,30,30
1651055514662,MATH 18,B02,083749,Staff,0,14,30,30
1651055514662,MATH 18,B03,083750,Staff,0,14,30,30
1651055514662,MATH 18,B04,083751,Staff,0,13,30,30
1651055520686,MATH 20A,A01,083754,Staff,18,0,40,22
1651055526719,MATH 20B,A01,083756,Staff,0,14,30,30
1651055526719,MATH 20B,A02,083757,Staff,0,11,30,30
1651055532747,MATH 20C,A01,083760,Staff,0,16,30,30
1651055532747,MATH 20C,A02,083761,Staff,0,15,30,30
1651055532747,MATH 20C,B01,083762,Staff,8,0,30,22
1651055532747,MATH 20C,B02,083763,Staff,28,0,30,2
1651055538770,MATH 20D,A01,083765,Staff,3,1,30,27
1651055538770,MATH 20D,A02,083766,Staff,1,0,30,29
1651055538770,MATH 20D,A03,083767,Staff,22,0,30,8
1651055544793,MATH 20E,A01,083771,Staff,2,0,30,28
1651055544793,MATH 20E,A02,083772,Staff,10,0,30,20
1651055544793,MATH 20E,B01,083773,Staff,0,0,30,30
1651055544793,MATH 20E,B02,083774,Staff,0,0,30,30
1651055550824,MATH 103A,A01,083777,Staff,0,17,30,30
1651055550824,MATH 103A,A02,083778,Staff,0,16,30,30
1651055550824,MATH 103A,B01,083779,Staff,0,15,30,30
1651055550824,MATH 103A,B02,083780,Staff,0,13,30,30
1651055556854,MATH 105,A01,085443,Staff,0,23,30,30
1651055562883,MATH 109,A01,083213,Anzaldo; Leesa B,0,7,30,30
1651055562883,MATH 109,A02,083214,Anzaldo; Leesa B,0,7,30,30
1651055562883,MATH 109,B01,083215,Anzaldo; Leesa B,0,8,30,30
1651055562883,MATH 109,B02,083216,Anzaldo; Leesa B,0,8,30,30
1651055568917,MATH 142A,A01,083219,Chow; Bennett,0,15,30,30
1651055568917,MATH 142A,A02,083220,Chow; Bennett,0,15,30,30
1651055568917,MATH 142A,B01,083221,Chow; Bennett,0,16,30,30
1651055568917,MATH 142A,B02,083222,Chow; Bennett,0,14,30,30
1651055574942,MATH 193A,A01,083224,Staff,0,8,30,30
1651055574942,MATH 193A,A02,083225,Staff,0,7,30,30
1651055574942,MATH 193A,A03,083781,Staff,0,7,30,30
1651055574942,MATH 193A,A04,083782,Staff,0,7,30,30
1651055580969,MATH 197,001,091859,McAuley; Julian John,9998,0,9999,1
1651055587063,COGS 9,A01,083615,Staff,0,20,60,60
1651055593091,COGS 11,A01,083617,Boyle; Mary E. T.,13,0,40,27
1651055599112,COGS 13,A01,083071,Staff,0,40,40,40
1651055605140,COGS 14A,A01,092681,Staff,0,40,100,100
1651055611162,COGS 14B,A01,083073,Cheng; Tzu-Han,0,13,50,50
1651055617185,COGS 17,A01,092677,Staff,9,0,75,66
1651055623221,COGS 100,A01,083619,Staff,0,30,60,60
1651055629250,COGS 101A,A01,083621,Davis; Joshua Daniel,0,29,60,60
1651055635276,COGS 101B,A01,091572,Staff,0,7,60,60
1651055641302,COGS 101C,A01,083625,Delgado; Tania,14,0,30,16
1651055647329,COGS 107A,A01,083627,Boyle; Mary E. T.,0,17,60,60
1651055653353,COGS 118A,A01,083075,Staff,0,10,60,60
1651055659377,CSE 3,A50,083646,Miranda; Gregory Joseph,15,0,38,23
1651055659377,CSE 3,A51,083647,Miranda; Gregory Joseph,36,0,37,1
1651055665401,CSE 8A,A50,083650,Miranda; Gregory Joseph,0,31,40,40
1651055671430,CSE 11,A01,083080,Cao; Yingjun,1,97,40,39
1651055677452,CSE 12,A01,083652,Staff,0,26,100,100
1651055683479,CSE 15L,A01,083654,Staff,0,3,50,50
1651055683479,CSE 15L,A02,083655,Staff,0,3,50,50
1651055689503,CSE 20,A01,083657,Staff,46,0,80,34
1651055695527,CSE 30,A01,083084,Eldon; John,0,38,80,80
1651055701561,CSE 100,A01,083659,Cao; Yingjun,0,72,50,50
1651055707586,CSE 134B,A01,083661,Powell; Thomas Allan,0,38,65,65
1651055713610,CSE 140,A01,083663,Staff,0,15,75,75
1651055719641,CSE 140L,A01,083088,Eldon; John,3,0,100,97
1651055725666,CSE 175,A01,083665,Kumar; Rakesh,0,0,25,25
1651055731696,CSE 190,A00,092507,Dubnov; Shlomo,9,0,20,11
1651055737720,ECE 45,A01,083139,Staff,0,7,60,60
1651055743755,ECE 65,A50,083695,Staff,0,7,30,30
1651055749783,ECE 109,A01,091882,Touri; Behrouz,33,0,70,37
1651055755807,ECE 180,A00,083140,Abi Samra; Nicholas Camill,17,0,30,13
1651055755807,ECE 180,B00,083141,Abi Samra; Nicholas Camill,0,0,30,30
1651055761841,MATH 10A,A01,083735,Patchell; Gregory David,0,0,30,30
1651055761841,MATH 10A,A02,083736,Patchell; Gregory David,27,0,30,3
1651055761841,MATH 10A,A03,083737,Patchell; Gregory David,23,0,30,7
1651055767879,MATH 10B,A01,083207,Staff,0,7,30,30
1651055767879,MATH 10B,A02,083208,Staff,0,6,30,30
1651055767879,MATH 10B,B01,083739,Staff,8,0,30,22
1651055767879,MATH 10B,B02,083740,Staff,28,0,30,2
1651055773905,MATH 18,A01,083743,Staff,0,0,30,30
1651055773905,MATH 18,A02,083744,Staff,23,0,30,7
1651055773905,MATH 18,A03,083745,Staff,19,0,30,11
1651055773905,MATH 18,A04,083746,Staff,26,0,30,4
1651055773905,MATH 18,B01,083748,Staff,0,16,30,30
1651055773905,MATH 18,B02,083749,Staff,0,14,30,30
1651055773905,MATH 18,B03,083750,Staff,0,14,30,30
1651055773905,MATH 18,B04,083751,Staff,0,13,30,30
1651055779928,MATH 20A,A01,083754,Staff,18,0,40,22
1651055785955,MATH 20B,A01,083756,Staff,0,14,30,30
1651055785955,MATH 20B,A02,083757,Staff,0,11,30,30
1651055791979,MATH 20C,A01,083760,Staff,0,16,30,30
1651055791979,MATH 20C,A02,083761,Staff,0,15,30,30
1651055791979,MATH 20C,B01,083762,Staff,8,0,30,22
1651055791979,MATH 20C,B02,083763,Staff,28,0,30,2
1651055798009,MATH 20D,A01,083765,Staff,3,1,30,27
1651055798009,MATH 20D,A02,083766,Staff,1,0,30,29
1651055798009,MATH 20D,A03,083767,Staff,22,0,30,8
1651055804034,MATH 20E,A01,083771,Staff,2,0,30,28
1651055804034,MATH 20E,A02,083772,Staff,10,0,30,20
1651055804034,MATH 20E,B01,083773,Staff,0,0,30,30
1651055804034,MATH 20E,B02,083774,Staff,0,0,30,30
1651055810067,MATH 103A,A01,083777,Staff,0,17,30,30
1651055810067,MATH 103A,A02,083778,Staff,0,16,30,30
1651055810067,MATH 103A,B01,083779,Staff,0,15,30,30
1651055810067,MATH 103A,B02,083780,Staff,0,13,30,30
1651055816097,MATH 105,A01,085443,Staff,0,23,30,30
1651055822127,MATH 109,A01,083213,Anzaldo; Leesa B,0,7,30,30
1651055822127,MATH 109,A02,083214,Anzaldo; Leesa B,0,7,30,30
1651055822127,MATH 109,B01,083215,Anzaldo; Leesa B,0,8,30,30
1651055822127,MATH 109,B02,083216,Anzaldo; Leesa B,0,8,30,30
1651055828156,MATH 142A,A01,083219,Chow; Bennett,0,15,30,30
1651055828156,MATH 142A,A02,083220,Chow; Bennett,0,15,30,30
1651055828156,MATH 142A,B01,083221,Chow; Bennett,0,16,30,30
1651055828156,MATH 142A,B02,083222,Chow; Bennett,0,14,30,30
1651055834181,MATH 193A,A01,083224,Staff,0,8,30,30
1651055834181,MATH 193A,A02,083225,Staff,0,7,30,30
1651055834181,MATH 193A,A03,083781,Staff,0,7,30,30
1651055834181,MATH 193A,A04,083782,Staff,0,7,30,30
1651055840208,MATH 197,001,091859,McAuley; Julian John,9998,0,9999,1
1651055846285,COGS 9,A01,083615,Staff,0,20,60,60
1651055852314,COGS 11,A01,083617,Boyle; Mary E. T.,13,0,40,27
1651055858338,COGS 13,A01,083071,Staff,0,40,40,40
1651055864370,COGS 14A,A01,092681,Staff,0,40,100,100
1651055870400,COGS 14B,A01,083073,Cheng; Tzu-Han,0,13,50,50
1651055876437,COGS 17,A01,092677,Staff,9,0,75,66
1651055882482,COGS 100,A01,083619,Staff,0,30,60,60
1651055888510,COGS 101A,A01,083621,Davis; Joshua Daniel,0,29,60,60
1651055894539,COGS 101B,A01,091572,Staff,0,7,60,60
1651055900573,COGS 101C,A01,083625,Delgado; Tania,14,0,30,16
1651055906606,COGS 107A,A01,083627,Boyle; Mary E. T.,0,17,60,60
1651055912630,COGS 118A,A01,083075,Staff,0,10,60,60
1651055918741,CSE 3,A50,083646,Miranda; Gregory Joseph,15,0,38,23
1651055918741,CSE 3,A51,083647,Miranda; Gregory Joseph,36,0,37,1
1651055924767,CSE 8A,A50,083650,Miranda; Gregory Joseph,0,31,40,40
1651055930804,CSE 11,A01,083080,Cao; Yingjun,1,97,40,39
1651055936827,CSE 12,A01,083652,Staff,0,26,100,100
1651055942853,CSE 15L,A01,083654,Staff,0,3,50,50
1651055942853,CSE 15L,A02,083655,Staff,0,3,50,50
1651055948878,CSE 20,A01,083657,Staff,46,0,80,34
1651055954903,CSE 30,A01,083084,Eldon; John,0,38,80,80
1651055960931,CSE 100,A01,083659,Cao; Yingjun,0,72,50,50
1651055966956,CSE 134B,A01,083661,Powell; Thomas Allan,0,38,65,65
1651055972980,CSE 140,A01,083663,Staff,0,15,75,75
1651055979014,CSE 140L,A01,083088,Eldon; John,3,0,100,97
1651055985048,CSE 175,A01,083665,Kumar; Rakesh,0,0,25,25
1651055991092,CSE 190,A00,092507,Dubnov; Shlomo,9,0,20,11
1651055997118,ECE 45,A01,083139,Staff,0,7,60,60
1651056003143,ECE 65,A50,083695,Staff,0,7,30,30
1651056009170,ECE 109,A01,091882,Touri; Behrouz,33,0,70,37
1651056015196,ECE 180,A00,083140,Abi Samra; Nicholas Camill,17,0,30,13
1651056015196,ECE 180,B00,083141,Abi Samra; Nicholas Camill,0,0,30,30
1651056021231,MATH 10A,A01,083735,Patchell; Gregory David,0,0,30,30
1651056021231,MATH 10A,A02,083736,Patchell; Gregory David,27,0,30,3
1651056021231,MATH 10A,A03,083737,Patchell; Gregory David,23,0,30,7
1651056027258,MATH 10B,A01,083207,Staff,0,7,30,30
1651056027258,MATH 10B,A02,083208,Staff,0,6,30,30
1651056027258,MATH 10B,B01,083739,Staff,8,0,30,22
1651056027258,MATH 10B,B02,083740,Staff,28,0,30,2
1651056033288,MATH 18,A01,083743,Staff,0,0,30,30
1651056033288,MATH 18,A02,083744,Staff,23,0,30,7
1651056033288,MATH 18,A03,083745,Staff,19,0,30,11
1651056033288,MATH 18,A04,083746,Staff,26,0,30,4
1651056033288,MATH 18,B01,083748,Staff,0,16,30,30
1651056033288,MATH 18,B02,083749,Staff,0,14,30,30
1651056033288,MATH 18,B03,083750,Staff,0,14,30,30
1651056033288,MATH 18,B04,083751,Staff,0,13,30,30
1651056039314,MATH 20A,A01,083754,Staff,18,0,40,22
1651056045340,MATH 20B,A01,083756,Staff,0,14,30,30
1651056045340,MATH 20B,A02,083757,Staff,0,11,30,30
1651056051367,MATH 20C,A01,083760,Staff,0,16,30,30
1651056051367,MATH 20C,A02,083761,Staff,0,15,30,30
1651056051367,MATH 20C,B01,083762,Staff,8,0,30,22
1651056051367,MATH 20C,B02,083763,Staff,28,0,30,2
1651056057392,MATH 20D,A01,083765,Staff,3,1,30,27
1651056057392,MATH 20D,A02,083766,Staff,1,0,30,29
1651056057392,MATH 20D,A03,083767,Staff,22,0,30,8
1651056063420,MATH 20E,A01,083771,Staff,2,0,30,28
1651056063420,MATH 20E,A02,083772,Staff,10,0,30,20
1651056063420,MATH 20E,B01,083773,Staff,0,0,30,30
1651056063420,MATH 20E,B02,083774,Staff,0,0,30,30
1651056069453,MATH 103A,A01,083777,Staff,0,17,30,30
1651056069453,MATH 103A,A02,083778,Staff,0,16,30,30
1651056069453,MATH 103A,B01,083779,Staff,0,15,30,30
1651056069453,MATH 103A,B02,083780,Staff,0,13,30,30
1651056075492,MATH 105,A01,085443,Staff,0,23,30,30
1651056081521,MATH 109,A01,083213,Anzaldo; Leesa B,0,7,30,30
1651056081521,MATH 109,A02,083214,Anzaldo; Leesa B,0,7,30,30
1651056081521,MATH 109,B01,083215,Anzaldo; Leesa B,0,8,30,30
1651056081521,MATH 109,B02,083216,Anzaldo; Leesa B,0,8,30,30
1651056087556,MATH 142A,A01,083219,Chow; Bennett,0,15,30,30
1651056087556,MATH 142A,A02,083220,Chow; Bennett,0,15,30,30
1651056087556,MATH 142A,B01,083221,Chow; Bennett,0,16,30,30
1651056087556,MATH 142A,B02,083222,Chow; Bennett,0,14,30,30
1651056093583,MATH 193A,A01,083224,Staff,0,8,30,30
1651056093583,MATH 193A,A02,083225,Staff,0,7,30,30
1651056093583,MATH 193A,A03,083781,Staff,0,7,30,30
1651056093583,MATH 193A,A04,083782,Staff,0,7,30,30
1651056099608,MATH 197,001,091859,McAuley; Julian John,9998,0,9999,1
1651056105674,COGS 9,A01,083615,Staff,0,20,60,60
1651056111702,COGS 11,A01,083617,Boyle; Mary E. T.,13,0,40,27
1651056117728,COGS 13,A01,083071,Staff,0,40,40,40
1651056123755,COGS 14A,A01,092681,Staff,0,40,100,100
1651056129784,COGS 14B,A01,083073,Cheng; Tzu-Han,0,13,50,50
1651056135812,COGS 17,A01,092677,Staff,9,0,75,66
1651056141840,COGS 100,A01,083619,Staff,0,30,60,60
1651056147867,COGS 101A,A01,083621,Davis; Joshua Daniel,0,29,60,60
1651056153899,COGS 101B,A01,091572,Staff,0,7,60,60
1651056159924,COGS 101C,A01,083625,Delgado; Tania,14,0,30,16
1651056165952,COGS 107A,A01,083627,Boyle; Mary E. T.,0,17,60,60
1651056171980,COGS 118A,A01,083075,Staff,0,10,60,60
1651056178005,CSE 3,A50,083646,Miranda; Gregory Joseph,15,0,38,23
1651056178005,CSE 3,A51,083647,Miranda; Gregory Joseph,36,0,37,1
1651056184033,CSE 8A,A50,083650,Miranda; Gregory Joseph,0,31,40,40
1651056190058,CSE 11,A01,083080,Cao; Yingjun,1,97,40,39
1651056196087,CSE 12,A01,083652,Staff,0,26,100,100
1651056202111,CSE 15L,A01,083654,Staff,0,3,50,50
1651056202111,CSE 15L,A02,083655,Staff,0,3,50,50
1651056208134,CSE 20,A01,083657,Staff,46,0,80,34
1651056214158,CSE 30,A01,083084,Eldon; John,0,38,80,80
1651056220189,CSE 100,A01,083659,Cao; Yingjun,0,72,50,50
1651056226213,CSE 134B,A01,083661,Powell; Thomas Allan,0,38,65,65
1651056232240,CSE 140,A01,083663,Staff,0,15,75,75
1651056238270,CSE 140L,A01,083088,Eldon; John,3,0,100,97
1651056244293,CSE 175,A01,083665,Kumar; Rakesh,0,0,25,25
1651056250318,CSE 190,A00,092507,Dubnov; Shlomo,9,0,20,11
1651056256348,ECE 45,A01,083139,Staff,0,7,60,60
1651056262373,ECE 65,A50,083695,Staff,0,7,30,30
1651056268403,ECE 109,A01,091882,Touri; Behrouz,33,0,70,37
1651056274428,ECE 180,A00,083140,Abi Samra; Nicholas Camill,17,0,30,13
1651056274428,ECE 180,B00,083141,Abi Samra; Nicholas Camill,0,0,30,30
1651056280453,MATH 10A,A01,083735,Patchell; Gregory David,0,0,30,30
1651056280453,MATH 10A,A02,083736,Patchell; Gregory David,27,0,30,3
1651056280453,MATH 10A,A03,083737,Patchell; Gregory David,23,0,30,7
1651056286486,MATH 10B,A01,083207,Staff,0,7,30,30
1651056286486,MATH 10B,A02,083208,Staff,0,6,30,30
1651056286486,MATH 10B,B01,083739,Staff,8,0,30,22
1651056286486,MATH 10B,B02,083740,Staff,28,0,30,2
1651056292521,MATH 18,A01,083743,Staff,0,0,30,30
1651056292521,MATH 18,A02,083744,Staff,23,0,30,7
1651056292521,MATH 18,A03,083745,Staff,19,0,30,11
1651056292521,MATH 18,A04,083746,Staff,26,0,30,4
1651056292521,MATH 18,B01,083748,Staff,0,16,30,30
1651056292521,MATH 18,B02,083749,Staff,0,14,30,30
1651056292521,MATH 18,B03,083750,Staff,0,14,30,30
1651056292521,MATH 18,B04,083751,Staff,0,13,30,30
1651056298549,MATH 20A,A01,083754,Staff,18,0,40,22
1651056304577,MATH 20B,A01,083756,Staff,0,14,30,30
1651056304577,MATH 20B,A02,083757,Staff,0,11,30,30
1651056310602,MATH 20C,A01,083760,Staff,0,16,30,30
1651056310602,MATH 20C,A02,083761,Staff,0,15,30,30
1651056310602,MATH 20C,B01,083762,Staff,8,0,30,22
1651056310602,MATH 20C,B02,083763,Staff,28,0,30,2
1651056316633,MATH 20D,A01,083765,Staff,3,1,30,27
1651056316633,MATH 20D,A02,083766,Staff,1,0,30,29
1651056316633,MATH 20D,A03,083767,Staff,22,0,30,8
1651056322658,MATH 20E,A01,083771,Staff,2,0,30,28
1651056322658,MATH 20E,A02,083772,Staff,10,0,30,20
1651056322658,MATH 20E,B01,083773,Staff,0,0,30,30
1651056322658,MATH 20E,B02,083774,Staff,0,0,30,30
1651056328685,MATH 103A,A01,083777,Staff,0,17,30,30
1651056328685,MATH 103A,A02,083778,Staff,0,16,30,30
1651056328685,MATH 103A,B01,083779,Staff,0,15,30,30
1651056328685,MATH 103A,B02,083780,Staff,0,13,30,30
1651056334714,MATH 105,A01,085443,Staff,0,23,30,30
1651056340740,MATH 109,A01,083213,Anzaldo; Leesa B,0,7,30,30
1651056340740,MATH 109,A02,083214,Anzaldo; Leesa B,0,7,30,30
1651056340740,MATH 109,B01,083215,Anzaldo; Leesa B,0,8,30,30
1651056340740,MATH 109,B02,083216,Anzaldo; Leesa B,0,8,30,30
1651056346767,MATH 142A,A01,083219,Chow; Bennett,0,15,30,30
1651056346767,MATH 142A,A02,083220,Chow; Bennett,0,15,30,30
1651056346767,MATH 142A,B01,083221,Chow; Bennett,0,16,30,30
1651056346767,MATH 142A,B02,083222,Chow; Bennett,0,14,30,30
1651056352793,MATH 193A,A01,083224,Staff,0,8,30,30
1651056352793,MATH 193A,A02,083225,Staff,0,7,30,30
1651056352793,MATH 193A,A03,083781,Staff,0,7,30,30
1651056352793,MATH 193A,A04,083782,Staff,0,7,30,30
1651056358819,MATH 197,001,091859,McAuley; Julian John,9998,0,9999,1
1651056364882,COGS 9,A01,083615,Staff,0,20,60,60
1651056370906,COGS 11,A01,083617,Boyle; Mary E. T.,13,0,40,27
1651056376935,COGS 13,A01,083071,Staff,0,40,40,40
1651056382959,COGS 14A,A01,092681,Staff,0,40,100,100
1651056388985,COGS 14B,A01,083073,Cheng; Tzu-Han,0,13,50,50
1651056395011,COGS 17,A01,092677,Staff,9,0,75,66
1651056401038,COGS 100,A01,083619,Staff,0,30,60,60
1651056407062,COGS 101A,A01,083621,Davis; Joshua Daniel,0,29,60,60
1651056413087,COGS 101B,A01,091572,Staff,0,7,60,60
1651056419112,COGS 101C,A01,083625,Delgado; Tania,14,0,30,16
1651056425136,COGS 107A,A01,083627,Boyle; Mary E. T.,0,17,60,60
1651056431160,COGS 118A,A01,083075,Staff,0,10,60,60
1651056437186,CSE 3,A50,083646,Miranda; Gregory Joseph,15,0,38,23
1651056437186,CSE 3,A51,083647,Miranda; Gregory Joseph,36,0,37,1
1651056443209,CSE 8A,A50,083650,Miranda; Gregory Joseph,0,31,40,40
1651056449246,CSE 11,A01,083080,Cao; Yingjun,1,97,40,39
1651056455271,CSE 12,A01,083652,Staff,0,26,100,100
1651056461299,CSE 15L,A01,083654,Staff,0,3,50,50
1651056461299,CSE 15L,A02,083655,Staff,0,3,50,50
1651056467325,CSE 20,A01,083657,Staff,46,0,80,34
1651056473348,CSE 30,A01,083084,Eldon; John,0,38,80,80
1651056479373,CSE 100,A01,083659,Cao; Yingjun,0,72,50,50
1651056485397,CSE 134B,A01,083661,Powell; Thomas Allan,0,38,65,65
1651056491422,CSE 140,A01,083663,Staff,0,15,75,75
1651056497447,CSE 140L,A01,083088,Eldon; John,3,0,100,97
1651056503469,CSE 175,A01,083665,Kumar; Rakesh,0,0,25,25
1651056509492,CSE 190,A00,092507,Dubnov; Shlomo,9,0,20,11
1651056515608,ECE 45,A01,083139,Staff,0,7,60,60
1651056521633,ECE 65,A50,083695,Staff,0,7,30,30
1651056527657,ECE 109,A01,091882,Touri; Behrouz,33,0,70,37
1651056533681,ECE 180,A00,083140,Abi Samra; Nicholas Camill,17,0,30,13
1651056533681,ECE 180,B00,083141,Abi Samra; Nicholas Camill,0,0,30,30
1651056539714,MATH 10A,A01,083735,Patchell; Gregory David,0,0,30,30
1651056539714,MATH 10A,A02,083736,Patchell; Gregory David,27,0,30,3
1651056539714,MATH 10A,A03,083737,Patchell; Gregory David,23,0,30,7
1651056545740,MATH 10B,A01,083207,Staff,0,7,30,30
1651056545740,MATH 10B,A02,083208,Staff,0,6,30,30
1651056545740,MATH 10B,B01,083739,Staff,8,0,30,22
1651056545740,MATH 10B,B02,083740,Staff,28,0,30,2
1651056551770,MATH 18,A01,083743,Staff,0,0,30,30
1651056551770,MATH 18,A02,083744,Staff,23,0,30,7
1651056551770,MATH 18,A03,083745,Staff,19,0,30,11
1651056551770,MATH 18,A04,083746,Staff,26,0,30,4
1651056551770,MATH 18,B01,083748,Staff,0,16,30,30
1651056551770,MATH 18,B02,083749,Staff,0,14,30,30
1651056551770,MATH 18,B03,083750,Staff,0,14,30,30
1651056551770,MATH 18,B04,083751,Staff,0,13,30,30
1651056557795,MATH 20A,A01,083754,Staff,18,0,40,22
1651056563820,MATH 20B,A01,083756,Staff,0,14,30,30
1651056563820,MATH 20B,A02,083757,Staff,0,11,30,30
1651056569850,MATH 20C,A01,083760,Staff,0,16,30,30
1651056569850,MATH 20C,A02,083761,Staff,0,15,30,30
1651056569850,MATH 20C,B01,083762,Staff,8,0,30,22
1651056569850,MATH 20C,B02,083763,Staff,28,0,30,2
1651056575874,MATH 20D,A01,083765,Staff,3,1,30,27
1651056575874,MATH 20D,A02,083766,Staff,1,0,30,29
1651056575874,MATH 20D,A03,083767,Staff,22,0,30,8
1651056581905,MATH 20E,A01,083771,Staff,2,0,30,28
1651056581905,MATH 20E,A02,083772,Staff,10,0,30,20
1651056581905,MATH 20E,B01,083773,Staff,0,0,30,30
1651056581905,MATH 20E,B02,083774,Staff,0,0,30,30
1651056587931,MATH 103A,A01,083777,Staff,0,17,30,30
1651056587931,MATH 103A,A02,083778,Staff,0,16,30,30
1651056587931,MATH 103A,B01,083779,Staff,0,15,30,30
1651056587931,MATH 103A,B02,083780,Staff,0,13,30,30
1651056593956,MATH 105,A01,085443,Staff,0,23,30,30
1651056599981,MATH 109,A01,083213,Anzaldo; Leesa B,0,7,30,30
1651056599981,MATH 109,A02,083214,Anzaldo; Leesa B,0,7,30,30
1651056599981,MATH 109,B01,083215,Anzaldo; Leesa B,0,8,30,30
1651056599981,MATH 109,B02,083216,Anzaldo; Leesa B,0,8,30,30
1651056606005,MATH 142A,A01,083219,Chow; Bennett,0,15,30,30
1651056606005,MATH 142A,A02,083220,Chow; Bennett,0,15,30,30
1651056606005,MATH 142A,B01,083221,Chow; Bennett,0,16,30,30
1651056606005,MATH 142A,B02,083222,Chow; Bennett,0,14,30,30
1651056612033,MATH 193A,A01,083224,Staff,0,8,30,30
1651056612033,MATH 193A,A02,083225,Staff,0,7,30,30
1651056612033,MATH 193A,A03,083781,Staff,0,7,30,30
1651056612033,MATH 193A,A04,083782,Staff,0,7,30,30
1651056618056,MATH 197,001,091859,McAuley; Julian John,9998,0,9999,1
1651056624133,COGS 9,A01,083615,Staff,0,20,60,60
1651056630157,COGS 11,A01,083617,Boyle; Mary E. T.,13,0,40,27
1651056636184,COGS 13,A01,083071,Staff,0,40,40,40
1651056642208,COGS 14A,A01,092681,Staff,0,40,100,100
1651056648236,COGS 14B,A01,083073,Cheng; Tzu-Han,0,13,50,50
1651056654262,COGS 17,A01,092677,Staff,9,0,75,66
1651056660295,COGS 100,A01,083619,Staff,0,30,60,60
1651056666319,COGS 101A,A01,083621,Davis; Joshua Daniel,0,29,60,60
1651056672348,COGS 101B,A01,091572,Staff,0,7,60,60
1651056678377,COGS 101C,A01,083625,Delgado; Tania,14,0,30,16
1651056684411,COGS 107A,A01,083627,Boyle; Mary E. T.,0,17,60,60
1651056690439,COGS 118A,A01,083075,Staff,0,10,60,60
1651056696471,CSE 3,A50,083646,Miranda; Gregory Joseph,15,0,38,23
1651056696471,CSE 3,A51,083647,Miranda; Gregory Joseph,36,0,37,1
1651056702494,CSE 8A,A50,083650,Miranda; Gregory Joseph,0,31,40,40
1651056708521,CSE 11,A01,083080,Cao; Yingjun,1,97,40,39
1651056714544,CSE 12,A01,083652,Staff,0,26,100,100
1651056720587,CSE 15L,A01,083654,Staff,0,3,50,50
1651056720587,CSE 15L,A02,083655,Staff,0,3,50,50
1651056726613,CSE 20,A01,083657,Staff,46,0,80,34
1651056732639,CSE 30,A01,083084,Eldon; John,0,38,80,80
1651056738666,CSE 100,A01,083659,Cao; Yingjun,0,72,50,50
1651056744695,CSE 134B,A01,083661,Powell; Thomas Allan,0,38,65,65
1651056750718,CSE 140,A01,083663,Staff,0,15,75,75
1651056756743,CSE 140L,A01,083088,Eldon; John,3,0,100,97
1651056762772,CSE 175,A01,083665,Kumar; Rakesh,0,0,25,25
1651056768798,CSE 190,A00,092507,Dubnov; Shlomo,9,0,20,11
1651056774828,ECE 45,A01,083139,Staff,0,7,60,60
1651056780855,ECE 65,A50,083695,Staff,0,7,30,30
1651056786880,ECE 109,A01,091882,Touri; Behrouz,33,0,70,37
1651056792904,ECE 180,A00,083140,Abi Samra; Nicholas Camill,17,0,30,13
1651056792904,ECE 180,B00,083141,Abi Samra; Nicholas Camill,0,0,30,30
1651056798931,MATH 10A,A01,083735,Patchell; Gregory David,0,0,30,30
1651056798931,MATH 10A,A02,083736,Patchell; Gregory David,27,0,30,3
1651056798931,MATH 10A,A03,083737,Patchell; Gregory David,23,0,30,7
1651056804961,MATH 10B,A01,083207,Staff,0,7,30,30
1651056804961,MATH 10B,A02,083208,Staff,0,6,30,30
1651056804961,MATH 10B,B01,083739,Staff,8,0,30,22
1651056804961,MATH 10B,B02,083740,Staff,28,0,30,2
1651056810994,MATH 18,A01,083743,Staff,0,0,30,30
1651056810994,MATH 18,A02,083744,Staff,23,0,30,7
1651056810994,MATH 18,A03,083745,Staff,19,0,30,11
1651056810994,MATH 18,A04,083746,Staff,26,0,30,4
1651056810994,MATH 18,B01,083748,Staff,0,16,30,30
1651056810994,MATH 18,B02,083749,Staff,0,14,30,30
1651056810994,MATH 18,B03,083750,Staff,0,14,30,30
1651056810994,MATH 18,B04,083751,Staff,0,13,30,30
1651056817020,MATH 20A,A01,083754,Staff,18,0,40,22
1651056823050,MATH 20B,A01,083756,Staff,0,14,30,30
1651056823050,MATH 20B,A02,083757,Staff,0,11,30,30
1651056829075,MATH 20C,A01,083760,Staff,0,16,30,30
1651056829075,MATH 20C,A02,083761,Staff,0,15,30,30
1651056829075,MATH 20C,B01,083762,Staff,8,0,30,22
1651056829075,MATH 20C,B02,083763,Staff,28,0,30,2
1651056835100,MATH 20D,A01,083765,Staff,3,1,30,27
1651056835100,MATH 20D,A02,083766,Staff,1,0,30,29
1651056835100,MATH 20D,A03,083767,Staff,22,0,30,8
1651056841126,MATH 20E,A01,083771,Staff,2,0,30,28
1651056841126,MATH 20E,A02,083772,Staff,10,0,30,20
1651056841126,MATH 20E,B01,083773,Staff,0,0,30,30
1651056841126,MATH 20E,B02,083774,Staff,0,0,30,30
1651056847159,MATH 103A,A01,083777,Staff,0,17,30,30
1651056847159,MATH 103A,A02,083778,Staff,0,16,30,30
1651056847159,MATH 103A,B01,083779,Staff,0,15,30,30
1651056847159,MATH 103A,B02,083780,Staff,0,13,30,30
1651056853193,MATH 105,A01,085443,Staff,0,23,30,30
1651056859220,MATH 109,A01,083213,Anzaldo; Leesa B,0,7,30,30
1651056859220,MATH 109,A02,083214,Anzaldo; Leesa B,0,7,30,30
1651056859220,MATH 109,B01,083215,Anzaldo; Leesa B,0,8,30,30
1651056859220,MATH 109,B02,083216,Anzaldo; Leesa B,0,8,30,30
1651056865247,MATH 142A,A01,083219,Chow; Bennett,0,15,30,30
1651056865247,MATH 142A,A02,083220,Chow; Bennett,0,15,30,30
1651056865247,MATH 142A,B01,083221,Chow; Bennett,0,16,30,30
1651056865247,MATH 142A,B02,083222,Chow; Bennett,0,14,30,30
1651056871276,MATH 193A,A01,083224,Staff,0,8,30,30
1651056871276,MATH 193A,A02,083225,Staff,0,7,30,30
1651056871276,MATH 193A,A03,083781,Staff,0,7,30,30
1651056871276,MATH 193A,A04,083782,Staff,0,7,30,30
1651056877303,MATH 197,001,091859,McAuley; Julian John,9998,0,9999,1
1651056883368,COGS 9,A01,083615,Staff,0,20,60,60
1651056889392,COGS 11,A01,083617,Boyle; Mary E. T.,13,0,40,27
1651056895420,COGS 13,A01,083071,Staff,0,40,40,40
1651056901451,COGS 14A,A01,092681,Staff,0,40,100,100
1651056907482,COGS 14B,A01,083073,Cheng; Tzu-Han,0,13,50,50
1651056913509,COGS 17,A01,092677,Staff,9,0,75,66
1651056919534,COGS 100,A01,083619,Staff,0,30,60,60
1651056925558,COGS 101A,A01,083621,Davis; Joshua Daniel,0,29,60,60
1651056931581,COGS 101B,A01,091572,Staff,0,7,60,60
1651056937604,COGS 101C,A01,083625,Delgado; Tania,14,0,30,16
1651056943632,COGS 107A,A01,083627,Boyle; Mary E. T.,0,17,60,60
1651056949661,COGS 118A,A01,083075,Staff,0,10,60,60
1651056955686,CSE 3,A50,083646,Miranda; Gregory Joseph,15,0,38,23
1651056955686,CSE 3,A51,083647,Miranda; Gregory Joseph,36,0,37,1
1651056961715,CSE 8A,A50,083650,Miranda; Gregory Joseph,0,31,40,40
1651056967738,CSE 11,A01,083080,Cao; Yingjun,1,97,40,39
1651056973767,CSE 12,A01,083652,Staff,0,26,100,100
1651056979793,CSE 15L,A01,083654,Staff,0,3,50,50
1651056979793,CSE 15L,A02,083655,Staff,0,3,50,50
1651056985819,CSE 20,A01,083657,Staff,46,0,80,34
1651056991844,CSE 30,A01,083084,Eldon; John,0,38,80,80
1651056997868,CSE 100,A01,083659,Cao; Yingjun,0,72,50,50
1651057003899,CSE 134B,A01,083661,Powell; Thomas Allan,0,38,65,65
1651057009927,CSE 140,A01,083663,Staff,0,15,75,75
1651057015955,CSE 140L,A01,083088,Eldon; John,3,0,100,97
1651057021990,CSE 175,A01,083665,Kumar; Rakesh,0,0,25,25
1651057028015,CSE 190,A00,092507,Dubnov; Shlomo,9,0,20,11
1651057034045,ECE 45,A01,083139,Staff,0,7,60,60
1651057040077,ECE 65,A50,083695,Staff,0,7,30,30
1651057046104,ECE 109,A01,091882,Touri; Behrouz,33,0,70,37
1651057052136,ECE 180,A00,083140,Abi Samra; Nicholas Camill,17,0,30,13
1651057052136,ECE 180,B00,083141,Abi Samra; Nicholas Camill,0,0,30,30
1651057058164,MATH 10A,A01,083735,Patchell; Gregory David,0,0,30,30
1651057058164,MATH 10A,A02,083736,Patchell; Gregory David,27,0,30,3
1651057058164,MATH 10A,A03,083737,Patchell; Gregory David,23,0,30,7
1651057064190,MATH 10B,A01,083207,Staff,0,7,30,30
1651057064190,MATH 10B,A02,083208,Staff,0,6,30,30
1651057064190,MATH 10B,B01,083739,Staff,8,0,30,22
1651057064190,MATH 10B,B02,083740,Staff,28,0,30,2
1651057070225,MATH 18,A01,083743,Staff,0,0,30,30
1651057070225,MATH 18,A02,083744,Staff,23,0,30,7
1651057070225,MATH 18,A03,083745,Staff,19,0,30,11
1651057070225,MATH 18,A04,083746,Staff,26,0,30,4
1651057070225,MATH 18,B01,083748,Staff,0,16,30,30
1651057070225,MATH 18,B02,083749,Staff,0,14,30,30
1651057070225,MATH 18,B03,083750,Staff,0,14,30,30
1651057070225,MATH 18,B04,083751,Staff,0,13,30,30
1651057076252,MATH 20A,A01,083754,Staff,18,0,40,22
1651057082276,MATH 20B,A01,083756,Staff,0,14,30,30
1651057082276,MATH 20B,A02,083757,Staff,0,11,30,30
1651057088307,MATH 20C,A01,083760,Staff,0,16,30,30
1651057088307,MATH 20C,A02,083761,Staff,0,15,30,30
1651057088307,MATH 20C,B01,083762,Staff,8,0,30,22
1651057088307,MATH 20C,B02,083763,Staff,28,0,30,2
1651057094332,MATH 20D,A01,083765,Staff,3,1,30,27
1651057094332,MATH 20D,A02,083766,Staff,1,0,30,29
1651057094332,MATH 20D,A03,083767,Staff,22,0,30,8
1651057100359,MATH 20E,A01,083771,Staff,2,0,30,28
1651057100359,MATH 20E,A02,083772,Staff,10,0,30,20
1651057100359,MATH 20E,B01,083773,Staff,0,0,30,30
1651057100359,MATH 20E,B02,083774,Staff,0,0,30,30
1651057106386,MATH 103A,A01,083777,Staff,0,17,30,30
1651057106386,MATH 103A,A02,083778,Staff,0,16,30,30
1651057106386,MATH 103A,B01,083779,Staff,0,15,30,30
1651057106386,MATH 103A,B02,083780,Staff,0,13,30,30
1651057112480,MATH 105,A01,085443,Staff,0,23,30,30
1651057118511,MATH 109,A01,083213,Anzaldo; Leesa B,0,7,30,30
1651057118511,MATH 109,A02,083214,Anzaldo; Leesa B,0,7,30,30
1651057118511,MATH 109,B01,083215,Anzaldo; Leesa B,0,8,30,30
1651057118511,MATH 109,B02,083216,Anzaldo; Leesa B,0,8,30,30
1651057124542,MATH 142A,A01,083219,Chow; Bennett,0,15,30,30
1651057124542,MATH 142A,A02,083220,Chow; Bennett,0,15,30,30
1651057124542,MATH 142A,B01,083221,Chow; Bennett,0,16,30,30
1651057124542,MATH 142A,B02,083222,Chow; Bennett,0,14,30,30
1651057130571,MATH 193A,A01,083224,Staff,0,8,30,30
1651057130571,MATH 193A,A02,083225,Staff,0,7,30,30
1651057130571,MATH 193A,A03,083781,Staff,0,7,30,30
1651057130571,MATH 193A,A04,083782,Staff,0,7,30,30
1651057136598,MATH 197,001,091859,McAuley; Julian John,9998,0,9999,1
1651057142661,COGS 9,A01,083615,Staff,0,20,60,60
1651057148686,COGS 11,A01,083617,Boyle; Mary E. T.,13,0,40,27
1651057154721,COGS 13,A01,083071,Staff,0,40,40,40
1651057160748,COGS 14A,A01,092681,Staff,0,40,100,100
1651057166773,COGS 14B,A01,083073,Cheng; Tzu-Han,0,13,50,50
1651057172796,COGS 17,A01,092677,Staff,9,0,75,66
1651057178823,COGS 100,A01,083619,Staff,0,30,60,60
1651057184848,COGS 101A,A01,083621,Davis; Joshua Daniel,0,29,60,60
1651057190887,COGS 101B,A01,091572,Staff,0,7,60,60
1651057196911,COGS 101C,A01,083625,Delgado; Tania,14,0,30,16
1651057202934,COGS 107A,A01,083627,Boyle; Mary E. T.,0,17,60,60
1651057208961,COGS 118A,A01,083075,Staff,0,10,60,60
1651057214993,CSE 3,A50,083646,Miranda; Gregory Joseph,15,0,38,23
1651057214993,CSE 3,A51,083647,Miranda; Gregory Joseph,36,0,37,1
1651057221022,CSE 8A,A50,083650,Miranda; Gregory Joseph,0,31,40,40
1651057227049,CSE 11,A01,083080,Cao; Yingjun,1,97,40,39
1651057233076,CSE 12,A01,083652,Staff,0,26,100,100
1651057239101,CSE 15L,A01,083654,Staff,0,3,50,50
1651057239101,CSE 15L,A02,083655,Staff,0,3,50,50
1651057245129,CSE 20,A01,083657,Staff,46,0,80,34
1651057251156,CSE 30,A01,083084,Eldon; John,0,38,80,80
1651057257187,CSE 100,A01,083659,Cao; Yingjun,0,72,50,50
1651057263225,CSE 134B,A01,083661,Powell; Thomas Allan,0,38,65,65
1651057269252,CSE 140,A01,083663,Staff,0,15,75,75
1651057275275,CSE 140L,A01,083088,Eldon; John,3,0,100,97
1651057281301,CSE 175,A01,083665,Kumar; Rakesh,0,0,25,25
1651057287326,CSE 190,A00,092507,Dubnov; Shlomo,9,0,20,11
1651057293363,ECE 45,A01,083139,Staff,0,7,60,60
1651057299394,ECE 65,A50,083695,Staff,0,7,30,30
1651057305425,ECE 109,A01,091882,Touri; Behrouz,33,0,70,37
1651057311453,ECE 180,A00,083140,Abi Samra; Nicholas Camill,17,0,30,13
1651057311453,ECE 180,B00,083141,Abi Samra; Nicholas Camill,0,0,30,30
1651057317479,MATH 10A,A01,083735,Patchell; Gregory David,0,0,30,30
1651057317479,MATH 10A,A02,083736,Patchell; Gregory David,27,0,30,3
1651057317479,MATH 10A,A03,083737,Patchell; Gregory David,23,0,30,7
1651057323504,MATH 10B,A01,083207,Staff,0,7,30,30
1651057323504,MATH 10B,A02,083208,Staff,0,6,30,30
1651057323504,MATH 10B,B01,083739,Staff,8,0,30,22
1651057323504,MATH 10B,B02,083740,Staff,28,0,30,2
1651057329531,MATH 18,A01,083743,Staff,0,0,30,30
1651057329531,MATH 18,A02,083744,Staff,23,0,30,7
1651057329531,MATH 18,A03,083745,Staff,19,0,30,11
1651057329531,MATH 18,A04,083746,Staff,26,0,30,4
1651057329531,MATH 18,B01,083748,Staff,0,16,30,30
1651057329531,MATH 18,B02,083749,Staff,0,14,30,30
1651057329531,MATH 18,B03,083750,Staff,0,14,30,30
1651057329531,MATH 18,B04,083751,Staff,0,13,30,30
1651057335558,MATH 20A,A01,083754,Staff,18,0,40,22
1651057341593,MATH 20B,A01,083756,Staff,0,14,30,30
1651057341593,MATH 20B,A02,083757,Staff,0,11,30,30
1651057347620,MATH 20C,A01,083760,Staff,0,16,30,30
1651057347620,MATH 20C,A02,083761,Staff,0,15,30,30
1651057347620,MATH 20C,B01,083762,Staff,8,0,30,22
1651057347620,MATH 20C,B02,083763,Staff,28,0,30,2
1651057353647,MATH 20D,A01,083765,Staff,3,1,30,27
1651057353647,MATH 20D,A02,083766,Staff,1,0,30,29
1651057353647,MATH 20D,A03,083767,Staff,22,0,30,8
1651057359672,MATH 20E,A01,083771,Staff,2,0,30,28
1651057359672,MATH 20E,A02,083772,Staff,10,0,30,20
1651057359672,MATH 20E,B01,083773,Staff,0,0,30,30
1651057359672,MATH 20E,B02,083774,Staff,0,0,30,30
1651057365696,MATH 103A,A01,083777,Staff,0,17,30,30
1651057365696,MATH 103A,A02,083778,Staff,0,16,30,30
1651057365696,MATH 103A,B01,083779,Staff,0,15,30,30
1651057365696,MATH 103A,B02,083780,Staff,0,13,30,30
1651057371729,MATH 105,A01,085443,Staff,0,23,30,30
1651057377761,MATH 109,A01,083213,Anzaldo; Leesa B,0,7,30,30
1651057377761,MATH 109,A02,083214,Anzaldo; Leesa B,0,7,30,30
1651057377761,MATH 109,B01,083215,Anzaldo; Leesa B,0,8,30,30
1651057377761,MATH 109,B02,083216,Anzaldo; Leesa B,0,8,30,30
1651057383796,MATH 142A,A01,083219,Chow; Bennett,0,15,30,30
1651057383796,MATH 142A,A02,083220,Chow; Bennett,0,15,30,30
1651057383796,MATH 142A,B01,083221,Chow; Bennett,0,16,30,30
1651057383796,MATH 142A,B02,083222,Chow; Bennett,0,14,30,30
1651057389825,MATH 193A,A01,083224,Staff,0,8,30,30
1651057389825,MATH 193A,A02,083225,Staff,0,7,30,30
1651057389825,MATH 193A,A03,083781,Staff,0,7,30,30
1651057389825,MATH 193A,A04,083782,Staff,0,7,30,30
1651057395851,MATH 197,001,091859,McAuley; Julian John,9998,0,9999,1
1651057401925,COGS 9,A01,083615,Staff,0,20,60,60
1651057407957,COGS 11,A01,083617,Boyle; Mary E. T.,13,0,40,27
1651057413982,COGS 13,A01,083071,Staff,0,40,40,40
1651057420013,COGS 14A,A01,092681,Staff,0,40,100,100
1651057426131,COGS 14B,A01,083073,Cheng; Tzu-Han,0,13,50,50
1651057432155,COGS 17,A01,092677,Staff,9,0,75,66
1651057438183,COGS 100,A01,083619,Staff,0,30,60,60
1651057444212,COGS 101A,A01,083621,Davis; Joshua Daniel,0,29,60,60
1651057450236,COGS 101B,A01,091572,Staff,0,7,60,60
1651057456260,COGS 101C,A01,083625,Delgado; Tania,14,0,30,16
1651057462311,COGS 107A,A01,083627,Boyle; Mary E. T.,0,17,60,60
1651057468337,COGS 118A,A01,083075,Staff,0,10,60,60
1651057474379,CSE 3,A50,083646,Miranda; Gregory Joseph,15,0,38,23
1651057474379,CSE 3,A51,083647,Miranda; Gregory Joseph,36,0,37,1
1651057480402,CSE 8A,A50,083650,Miranda; Gregory Joseph,0,31,40,40
1651057486427,CSE 11,A01,083080,Cao; Yingjun,1,97,40,39
1651057492453,CSE 12,A01,083652,Staff,0,26,100,100
1651057498475,CSE 15L,A01,083654,Staff,0,3,50,50
1651057498475,CSE 15L,A02,083655,Staff,0,3,50,50
1651057504502,CSE 20,A01,083657,Staff,46,0,80,34
1651057510538,CSE 30,A01,083084,Eldon; John,0,38,80,80
1651057516567,CSE 100,A01,083659,Cao; Yingjun,0,72,50,50
1651057522599,CSE 134B,A01,083661,Powell; Thomas Allan,0,38,65,65
1651057528623,CSE 140,A01,083663,Staff,0,15,75,75
1651057534645,CSE 140L,A01,083088,Eldon; John,3,0,100,97
1651057540675,CSE 175,A01,083665,Kumar; Rakesh,0,0,25,25
1651057546701,CSE 190,A00,092507,Dubnov; Shlomo,9,0,20,11
1651057552726,ECE 45,A01,083139,Staff,0,7,60,60
1651057558763,ECE 65,A50,083695,Staff,0,7,30,30
1651057564790,ECE 109,A01,091882,Touri; Behrouz,33,0,70,37
1651057570820,ECE 180,A00,083140,Abi Samra; Nicholas Camill,17,0,30,13
1651057570820,ECE 180,B00,083141,Abi Samra; Nicholas Camill,0,0,30,30
1651057576848,MATH 10A,A01,083735,Patchell; Gregory David,0,0,30,30
1651057576848,MATH 10A,A02,083736,Patchell; Gregory David,27,0,30,3
1651057576848,MATH 10A,A03,083737,Patchell; Gregory David,23,0,30,7
1651057582877,MATH 10B,A01,083207,Staff,0,7,30,30
1651057582877,MATH 10B,A02,083208,Staff,0,6,30,30
1651057582877,MATH 10B,B01,083739,Staff,8,0,30,22
1651057582877,MATH 10B,B02,083740,Staff,28,0,30,2
1651057588904,MATH 18,A01,083743,Staff,0,0,30,30
1651057588904,MATH 18,A02,083744,Staff,23,0,30,7
1651057588904,MATH 18,A03,083745,Staff,19,0,30,11
1651057588904,MATH 18,A04,083746,Staff,26,0,30,4
1651057588904,MATH 18,B01,083748,Staff,0,16,30,30
1651057588904,MATH 18,B02,083749,Staff,0,14,30,30
1651057588904,MATH 18,B03,083750,Staff,0,14,30,30
1651057588904,MATH 18,B04,083751,Staff,0,13,30,30
1651057594933,MATH 20A,A01,083754,Staff,18,0,40,22
1651057600961,MATH 20B,A01,083756,Staff,0,14,30,30
1651057600961,MATH 20B,A02,083757,Staff,0,11,30,30
1651057606992,MATH 20C,A01,083760,Staff,0,16,30,30
1651057606992,MATH 20C,A02,083761,Staff,0,15,30,30
1651057606992,MATH 20C,B01,083762,Staff,8,0,30,22
1651057606992,MATH 20C,B02,083763,Staff,28,0,30,2
1651057613016,MATH 20D,A01,083765,Staff,3,1,30,27
1651057613016,MATH 20D,A02,083766,Staff,1,0,30,29
1651057613016,MATH 20D,A03,083767,Staff,22,0,30,8
1651057619040,MATH 20E,A01,083771,Staff,2,0,30,28
1651057619040,MATH 20E,A02,083772,Staff,10,0,30,20
1651057619040,MATH 20E,B01,083773,Staff,0,0,30,30
1651057619040,MATH 20E,B02,083774,Staff,0,0,30,30
1651057625065,MATH 103A,A01,083777,Staff,0,17,30,30
1651057625065,MATH 103A,A02,083778,Staff,0,16,30,30
1651057625065,MATH 103A,B01,083779,Staff,0,15,30,30
1651057625065,MATH 103A,B02,083780,Staff,0,13,30,30
1651057631093,MATH 105,A01,085443,Staff,0,23,30,30
1651057637118,MATH 109,A01,083213,Anzaldo; Leesa B,0,7,30,30
1651057637118,MATH 109,A02,083214,Anzaldo; Leesa B,0,7,30,30
1651057637118,MATH 109,B01,083215,Anzaldo; Leesa B,0,8,30,30
1651057637118,MATH 109,B02,083216,Anzaldo; Leesa B,0,8,30,30
1651057643150,MATH 142A,A01,083219,Chow; Bennett,0,15,30,30
1651057643150,MATH 142A,A02,083220,Chow; Bennett,0,15,30,30
1651057643150,MATH 142A,B01,083221,Chow; Bennett,0,16,30,30
1651057643150,MATH 142A,B02,083222,Chow; Bennett,0,14,30,30
1651057649176,MATH 193A,A01,083224,Staff,0,8,30,30
1651057649176,MATH 193A,A02,083225,Staff,0,7,30,30
1651057649176,MATH 193A,A03,083781,Staff,0,7,30,30
1651057649176,MATH 193A,A04,083782,Staff,0,7,30,30
1651057655199,MATH 197,001,091859,McAuley; Julian John,9998,0,9999,1
1651057661260,COGS 9,A01,083615,Staff,0,20,60,60
1651057667284,COGS 11,A01,083617,Boyle; Mary E. T.,13,0,40,27
1651057673313,COGS 13,A01,083071,Staff,0,40,40,40
1651057679341,COGS 14A,A01,092681,Staff,0,40,100,100
1651057685365,COGS 14B,A01,083073,Cheng; Tzu-Han,0,13,50,50
1651057691387,COGS 17,A01,092677,Staff,9,0,75,66
1651057697425,COGS 100,A01,083619,Staff,0,30,60,60
1651057703454,COGS 101A,A01,083621,Davis; Joshua Daniel,0,29,60,60
1651057709481,COGS 101B,A01,091572,Staff,0,7,60,60
1651057715508,COGS 101C,A01,083625,Delgado; Tania,14,0,30,16
1651057721532,COGS 107A,A01,083627,Boyle; Mary E. T.,0,17,60,60
1651057727555,COGS 118A,A01,083075,Staff,0,10,60,60
1651057733588,CSE 3,A50,083646,Miranda; Gregory Joseph,15,0,38,23
1651057733588,CSE 3,A51,083647,Miranda; Gregory Joseph,36,0,37,1
1651057739613,CSE 8A,A50,083650,Miranda; Gregory Joseph,0,31,40,40
1651057745640,CSE 11,A01,083080,Cao; Yingjun,1,97,40,39
1651057751668,CSE 12,A01,083652,Staff,0,26,100,100
1651057757692,CSE 15L,A01,083654,Staff,0,3,50,50
1651057757692,CSE 15L,A02,083655,Staff,0,3,50,50
1651057763715,CSE 20,A01,083657,Staff,46,0,80,34
1651057769741,CSE 30,A01,083084,Eldon; John,0,38,80,80
1651057775766,CSE 100,A01,083659,Cao; Yingjun,0,72,50,50
1651057781795,CSE 134B,A01,083661,Powell; Thomas Allan,0,38,65,65
1651057787823,CSE 140,A01,083663,Staff,0,15,75,75
1651057793851,CSE 140L,A01,083088,Eldon; John,3,0,100,97
1651057799879,CSE 175,A01,083665,Kumar; Rakesh,0,0,25,25
1651057805911,CSE 190,A00,092507,Dubnov; Shlomo,9,0,20,11
1651057811936,ECE 45,A01,083139,Staff,0,7,60,60
1651057817964,ECE 65,A50,083695,Staff,0,7,30,30
