time,subj_course_id,sec_code,sec_id,prof,available,waitlist,total,enrolled_ct
1656242028558,COGS 9,A01,083615,Shannon; Kyle Michael,3,0,75,72
1656242034604,COGS 11,A01,083617,Boyle; Mary E. T.,14,0,48,34
1656242040642,COGS 13,A01,083071,Bastos; Amalia Pinkusfeld,4,0,71,67
1656242046677,COGS 14A,A01,092681,Semenuks; Arturs,1,12,100,99
1656242052717,COGS 14B,A01,083073,Cheng; Tzu-Han,7,0,63,56
1656242058750,COGS 17,A01,092677,Semenuks; Arturs,7,0,81,74
1656242064779,COGS 100,A01,083619,Allen; Michael Gordon,2,0,70,68
1656242070807,COGS 101A,A01,083621,Davis; Joshua Daniel,4,0,68,64
1656242076837,COGS 101B,A01,091572,Allen; Michael Gordon,4,0,65,61
1656242082870,COGS 101C,A01,083625,Delgado; Tania,10,0,35,25
1656242088907,COGS 107A,A01,083627,Boyle; Mary E. T.,0,0,60,60
1656242094940,COGS 118A,A01,083075,Gupta; Anjum,8,0,76,68
1656242100971,CSE 3,A50,083646,Miranda; Gregory Joseph,18,0,50,32
1656242107007,CSE 8A,A50,083650,Miranda; Gregory Joseph,2,2,56,54
1656242113041,CSE 11,A01,083080,Cao; Yingjun,0,49,40,40
1656242119077,CSE 12,A01,083652,Krause-Levy; Sophia Louisa,5,1,120,115
1656242125111,CSE 15L,A01,083654,Morris; Justin Loren,2,0,50,48
1656242125111,CSE 15L,A02,083655,Morris; Justin Loren,4,0,50,46
1656242131146,CSE 20,A01,083657,Tran; Khoa Dang,30,0,80,50
1656242137180,CSE 21,A01,095574,Bach; Quang Tran,23,0,48,25
1656242143214,CSE 30,A01,083084,Eldon; John,2,6,80,78
1656242143214,CSE 30,B01,095061,Bhaskar; Nishant,0,1,50,50
1656242149246,CSE 100,A01,083659,Cao; Yingjun,1,18,70,69
1656242155279,CSE 134B,A01,083661,Powell; Thomas Allan,5,0,100,95
1656242161316,CSE 140,A01,083663,Gungor; Onat,9,0,85,76
1656242167346,CSE 140L,A01,083088,Eldon; John,8,0,100,92
1656242173381,CSE 175,A01,083665,Kumar; Rakesh,0,0,25,25
1656242179412,CSE 190,A00,092507,Dubnov; Shlomo,3,0,20,17
1656242185446,ECE 45,A01,083139,Congero; Spencer William,1,0,75,74
1656242191484,ECE 65,A50,083695,Saad; Andrew S,9,0,30,21
1656242191484,ECE 65,A51,095125,Staff,24,0,26,2
1656242197511,ECE 109,A01,091882,Touri; Behrouz,0,1,70,70
1656242203543,ECE 180,A00,083140,Abi Samra; Nicholas Camill,1,0,30,29
1656242203543,ECE 180,B00,083141,Abi Samra; Nicholas Camill,0,4,30,30
1656242209583,MATH 10A,A01,083735,Patchell; Gregory David,0,0,30,30
1656242209583,MATH 10A,A02,083736,Patchell; Gregory David,22,0,30,8
1656242209583,MATH 10A,A03,083737,Patchell; Gregory David,16,0,30,14
1656242215630,MATH 10B,A01,083207,Lim; Seonhee,0,0,34,34
1656242215630,MATH 10B,A02,083208,Lim; Seonhee,7,0,35,28
1656242215630,MATH 10B,A03,093472,Staff,1,0,34,33
1656242215630,MATH 10B,B01,083739,Sinha; Shubham,11,0,30,19
1656242221670,MATH 18,A01,083743,Cinel; Cameron Alexander,7,0,30,23
1656242221670,MATH 18,A02,083744,Cinel; Cameron Alexander,9,0,30,21
1656242221670,MATH 18,A03,083745,Cinel; Cameron Alexander,5,0,30,25
1656242221670,MATH 18,B01,083748,Rideout; David Porter,1,0,36,35
1656242221670,MATH 18,B02,083749,Rideout; David Porter,0,0,36,36
1656242221670,MATH 18,B03,083750,Rideout; David Porter,0,0,36,36
1656242221670,MATH 18,B04,083751,Rideout; David Porter,0,1,36,36
1656242221670,MATH 18,B05,093473,Rideout; David Porter,0,0,36,36
1656242221670,MATH 18,B06,093474,Rideout; David Porter,3,0,36,33
1656242227706,MATH 20A,A01,083754,Zheng; Zequn,11,0,40,29
1656242233737,MATH 20B,A01,083756,Briones; Jor-el Thomas Caparas,0,0,36,36
1656242233737,MATH 20B,A02,083757,Briones; Jor-el Thomas Caparas,0,0,36,36
1656242233737,MATH 20B,A03,093475,Staff,0,0,36,36
1656242239766,MATH 20C,A01,083760,Briones; Jor-el Thomas Caparas,0,0,35,35
1656242239766,MATH 20C,A02,083761,Briones; Jor-el Thomas Caparas,9,1,35,26
1656242239766,MATH 20C,A03,093476,Staff,0,0,35,35
1656242239766,MATH 20C,B01,083762,Bach; Quang Tran,1,0,30,29
1656242245799,MATH 20D,A01,083765,Tran; Brian Kha,1,0,30,29
1656242245799,MATH 20D,A02,083766,Tran; Brian Kha,0,1,30,30
1656242245799,MATH 20D,A03,083767,Tran; Brian Kha,2,0,30,28
1656242251840,MATH 20E,A01,083771,Ganguly; Soumya,3,0,32,29
1656242251840,MATH 20E,A02,083772,Ganguly; Soumya,0,0,32,32
1656242251840,MATH 20E,B01,083773,Ciotti; Benjamin,16,0,35,19
1656242251840,MATH 20E,B02,083774,Ciotti; Benjamin,15,0,35,20
1656242257880,MATH 103A,A01,083777,Greenfeld; Be'Eri,1,0,36,35
1656242257880,MATH 103A,A02,083778,Greenfeld; Be'Eri,1,0,36,35
1656242257880,MATH 103A,A03,093561,Staff,5,0,36,31
1656242257880,MATH 103A,B01,083779,Greenfeld; Be'Eri,8,0,36,28
1656242257880,MATH 103A,B02,083780,Greenfeld; Be'Eri,1,0,36,35
1656242257880,MATH 103A,B03,093562,Staff,0,0,36,36
1656242263922,MATH 105,A01,085443,Carter; Anne Toulson,5,0,35,30
1656242263922,MATH 105,A02,093477,Staff,14,0,35,21
1656242269955,MATH 109,A01,083213,Ganzberger; Geoffrey Michael,0,0,34,34
1656242269955,MATH 109,A02,083214,Ganzberger; Geoffrey Michael,0,0,34,34
1656242269955,MATH 109,A03,093478,Staff,1,0,34,33
1656242269955,MATH 109,B01,083215,Ganzberger; Geoffrey Michael,4,0,32,28
1656242269955,MATH 109,B02,083216,Ganzberger; Geoffrey Michael,1,0,32,31
1656242269955,MATH 109,B03,093479,Staff,3,0,32,29
1656242275987,MATH 142A,A01,083219,Chow; Bennett,2,0,32,30
1656242275987,MATH 142A,A02,083220,Chow; Bennett,8,0,32,24
1656242275987,MATH 142A,A03,093480,Staff,5,0,32,27
1656242275987,MATH 142A,B03,093481,Staff,3,0,32,29
1656242275987,MATH 142A,B04,093558,Staff,6,0,32,26
1656242275987,MATH 142A,B05,093559,Staff,0,0,32,32
1656242282026,MATH 193A,A01,083224,Rotar; Vladimir,0,1,34,34
1656242282026,MATH 193A,A02,083225,Rotar; Vladimir,0,0,34,34
1656242282026,MATH 193A,A03,083781,Rotar; Vladimir,0,0,34,34
1656242282026,MATH 193A,A04,083782,Rotar; Vladimir,6,0,34,28
1656242282026,MATH 193A,A05,093482,Rotar; Vladimir,0,0,34,34
1656242288063,MATH 197,001,091859,McAuley; Julian John,9999,0,9999,0
1656242288063,MATH 197,002,095566,Kedlaya; Kiran S.,9997,0,9999,2
1656242288063,MATH 197,003,095567,Xiao; Ming,9999,0,9999,0
1656242288063,MATH 197,004,095571,Perols; Johan Lars,9998,0,9999,1
1656242295146,COGS 9,A01,083615,Shannon; Kyle Michael,3,0,75,72
1656242301175,COGS 11,A01,083617,Boyle; Mary E. T.,14,0,48,34
1656242307208,COGS 13,A01,083071,Bastos; Amalia Pinkusfeld,4,0,71,67
1656242313241,COGS 14A,A01,092681,Semenuks; Arturs,1,12,100,99
1656242319269,COGS 14B,A01,083073,Cheng; Tzu-Han,7,0,63,56
1656242325297,COGS 17,A01,092677,Semenuks; Arturs,7,0,81,74
1656242331326,COGS 100,A01,083619,Allen; Michael Gordon,2,0,70,68
1656242337367,COGS 101A,A01,083621,Davis; Joshua Daniel,4,0,68,64
1656242343397,COGS 101B,A01,091572,Allen; Michael Gordon,4,0,65,61
1656242349424,COGS 101C,A01,083625,Delgado; Tania,10,0,35,25
1656242355457,COGS 107A,A01,083627,Boyle; Mary E. T.,0,0,60,60
1656242361486,COGS 118A,A01,083075,Gupta; Anjum,8,0,76,68
1656242367517,CSE 3,A50,083646,Miranda; Gregory Joseph,18,0,50,32
1656242373543,CSE 8A,A50,083650,Miranda; Gregory Joseph,2,2,56,54
1656242379575,CSE 11,A01,083080,Cao; Yingjun,0,49,40,40
1656242385612,CSE 12,A01,083652,Krause-Levy; Sophia Louisa,5,1,120,115
1656242391641,CSE 15L,A01,083654,Morris; Justin Loren,2,0,50,48
1656242391641,CSE 15L,A02,083655,Morris; Justin Loren,4,0,50,46
1656242397668,CSE 20,A01,083657,Tran; Khoa Dang,30,0,80,50
1656242403701,CSE 21,A01,095574,Bach; Quang Tran,23,0,48,25
1656242409732,CSE 30,A01,083084,Eldon; John,2,6,80,78
1656242409732,CSE 30,B01,095061,Bhaskar; Nishant,0,1,50,50
1656242415771,CSE 100,A01,083659,Cao; Yingjun,1,18,70,69
1656242421803,CSE 134B,A01,083661,Powell; Thomas Allan,5,0,100,95
1656242427831,CSE 140,A01,083663,Gungor; Onat,9,0,85,76
1656242433868,CSE 140L,A01,083088,Eldon; John,8,0,100,92
1656242439896,CSE 175,A01,083665,Kumar; Rakesh,0,0,25,25
1656242445930,CSE 190,A00,092507,Dubnov; Shlomo,3,0,20,17
1656242451961,ECE 45,A01,083139,Congero; Spencer William,1,0,75,74
1656242457990,ECE 65,A50,083695,Saad; Andrew S,9,0,30,21
1656242457990,ECE 65,A51,095125,Staff,24,0,26,2
1656242464022,ECE 109,A01,091882,Touri; Behrouz,0,1,70,70
1656242470050,ECE 180,A00,083140,Abi Samra; Nicholas Camill,1,0,30,29
1656242470050,ECE 180,B00,083141,Abi Samra; Nicholas Camill,0,4,30,30
1656242476089,MATH 10A,A01,083735,Patchell; Gregory David,0,0,30,30
1656242476089,MATH 10A,A02,083736,Patchell; Gregory David,22,0,30,8
1656242476089,MATH 10A,A03,083737,Patchell; Gregory David,16,0,30,14
1656242482121,MATH 10B,A01,083207,Lim; Seonhee,0,0,34,34
1656242482121,MATH 10B,A02,083208,Lim; Seonhee,7,0,35,28
1656242482121,MATH 10B,A03,093472,Staff,1,0,34,33
1656242482121,MATH 10B,B01,083739,Sinha; Shubham,11,0,30,19
1656242488154,MATH 18,A01,083743,Cinel; Cameron Alexander,7,0,30,23
1656242488154,MATH 18,A02,083744,Cinel; Cameron Alexander,9,0,30,21
1656242488154,MATH 18,A03,083745,Cinel; Cameron Alexander,5,0,30,25
1656242488154,MATH 18,B01,083748,Rideout; David Porter,1,0,36,35
1656242488154,MATH 18,B02,083749,Rideout; David Porter,0,0,36,36
1656242488154,MATH 18,B03,083750,Rideout; David Porter,0,0,36,36
1656242488154,MATH 18,B04,083751,Rideout; David Porter,0,1,36,36
1656242488154,MATH 18,B05,093473,Rideout; David Porter,0,0,36,36
1656242488154,MATH 18,B06,093474,Rideout; David Porter,3,0,36,33
1656242494187,MATH 20A,A01,083754,Zheng; Zequn,11,0,40,29
1656242500216,MATH 20B,A01,083756,Briones; Jor-el Thomas Caparas,0,0,36,36
1656242500216,MATH 20B,A02,083757,Briones; Jor-el Thomas Caparas,0,0,36,36
1656242500216,MATH 20B,A03,093475,Staff,0,0,36,36
1656242506251,MATH 20C,A01,083760,Briones; Jor-el Thomas Caparas,0,0,35,35
1656242506251,MATH 20C,A02,083761,Briones; Jor-el Thomas Caparas,9,1,35,26
1656242506251,MATH 20C,A03,093476,Staff,0,0,35,35
1656242506251,MATH 20C,B01,083762,Bach; Quang Tran,1,0,30,29
1656242512285,MATH 20D,A01,083765,Tran; Brian Kha,1,0,30,29
1656242512285,MATH 20D,A02,083766,Tran; Brian Kha,0,1,30,30
1656242512285,MATH 20D,A03,083767,Tran; Brian Kha,2,0,30,28
1656242518314,MATH 20E,A01,083771,Ganguly; Soumya,3,0,32,29
1656242518314,MATH 20E,A02,083772,Ganguly; Soumya,0,0,32,32
1656242518314,MATH 20E,B01,083773,Ciotti; Benjamin,16,0,35,19
1656242518314,MATH 20E,B02,083774,Ciotti; Benjamin,15,0,35,20
1656242524355,MATH 103A,A01,083777,Greenfeld; Be'Eri,1,0,36,35
1656242524355,MATH 103A,A02,083778,Greenfeld; Be'Eri,1,0,36,35
1656242524355,MATH 103A,A03,093561,Staff,5,0,36,31
1656242524355,MATH 103A,B01,083779,Greenfeld; Be'Eri,8,0,36,28
1656242524355,MATH 103A,B02,083780,Greenfeld; Be'Eri,1,0,36,35
1656242524355,MATH 103A,B03,093562,Staff,0,0,36,36
1656242530384,MATH 105,A01,085443,Carter; Anne Toulson,5,0,35,30
1656242530384,MATH 105,A02,093477,Staff,14,0,35,21
1656242536416,MATH 109,A01,083213,Ganzberger; Geoffrey Michael,0,0,34,34
1656242536416,MATH 109,A02,083214,Ganzberger; Geoffrey Michael,0,0,34,34
1656242536416,MATH 109,A03,093478,Staff,1,0,34,33
1656242536416,MATH 109,B01,083215,Ganzberger; Geoffrey Michael,4,0,32,28
1656242536416,MATH 109,B02,083216,Ganzberger; Geoffrey Michael,1,0,32,31
1656242536416,MATH 109,B03,093479,Staff,3,0,32,29
1656242542443,MATH 142A,A01,083219,Chow; Bennett,2,0,32,30
1656242542443,MATH 142A,A02,083220,Chow; Bennett,8,0,32,24
1656242542443,MATH 142A,A03,093480,Staff,5,0,32,27
1656242542443,MATH 142A,B03,093481,Staff,3,0,32,29
1656242542443,MATH 142A,B04,093558,Staff,6,0,32,26
1656242542443,MATH 142A,B05,093559,Staff,0,0,32,32
1656242548473,MATH 193A,A01,083224,Rotar; Vladimir,0,1,34,34
1656242548473,MATH 193A,A02,083225,Rotar; Vladimir,0,0,34,34
1656242548473,MATH 193A,A03,083781,Rotar; Vladimir,0,0,34,34
1656242548473,MATH 193A,A04,083782,Rotar; Vladimir,6,0,34,28
1656242548473,MATH 193A,A05,093482,Rotar; Vladimir,0,0,34,34
1656242554499,MATH 197,001,091859,McAuley; Julian John,9999,0,9999,0
1656242554499,MATH 197,002,095566,Kedlaya; Kiran S.,9997,0,9999,2
1656242554499,MATH 197,003,095567,Xiao; Ming,9999,0,9999,0
1656242554499,MATH 197,004,095571,Perols; Johan Lars,9998,0,9999,1
1656242561565,COGS 9,A01,083615,Shannon; Kyle Michael,3,0,75,72
1656242567594,COGS 11,A01,083617,Boyle; Mary E. T.,14,0,48,34
1656242573621,COGS 13,A01,083071,Bastos; Amalia Pinkusfeld,4,0,71,67
1656242579658,COGS 14A,A01,092681,Semenuks; Arturs,1,12,100,99
1656242585684,COGS 14B,A01,083073,Cheng; Tzu-Han,7,0,63,56
1656242591715,COGS 17,A01,092677,Semenuks; Arturs,7,0,81,74
1656242597742,COGS 100,A01,083619,Allen; Michael Gordon,2,0,70,68
1656242603857,COGS 101A,A01,083621,Davis; Joshua Daniel,4,0,68,64
1656242609892,COGS 101B,A01,091572,Allen; Michael Gordon,4,0,65,61
1656242615918,COGS 101C,A01,083625,Delgado; Tania,10,0,35,25
1656242621946,COGS 107A,A01,083627,Boyle; Mary E. T.,0,0,60,60
1656242627982,COGS 118A,A01,083075,Gupta; Anjum,8,0,76,68
1656242634016,CSE 3,A50,083646,Miranda; Gregory Joseph,18,0,50,32
1656242640046,CSE 8A,A50,083650,Miranda; Gregory Joseph,2,2,56,54
1656242646079,CSE 11,A01,083080,Cao; Yingjun,0,49,40,40
1656242652110,CSE 12,A01,083652,Krause-Levy; Sophia Louisa,5,1,120,115
1656242658138,CSE 15L,A01,083654,Morris; Justin Loren,2,0,50,48
1656242658138,CSE 15L,A02,083655,Morris; Justin Loren,4,0,50,46
1656242664162,CSE 20,A01,083657,Tran; Khoa Dang,30,0,80,50
1656242670193,CSE 21,A01,095574,Bach; Quang Tran,23,0,48,25
1656242676228,CSE 30,A01,083084,Eldon; John,2,6,80,78
1656242676228,CSE 30,B01,095061,Bhaskar; Nishant,0,1,50,50
1656242682257,CSE 100,A01,083659,Cao; Yingjun,1,18,70,69
1656242688297,CSE 134B,A01,083661,Powell; Thomas Allan,5,0,100,95
1656242694327,CSE 140,A01,083663,Gungor; Onat,9,0,85,76
1656242700362,CSE 140L,A01,083088,Eldon; John,8,0,100,92
1656242706396,CSE 175,A01,083665,Kumar; Rakesh,0,0,25,25
1656242718334,CSE 190,A00,092507,Dubnov; Shlomo,3,0,20,17
1656242724448,ECE 45,A01,083139,Congero; Spencer William,1,0,75,74
1656242739812,ECE 65,A50,083695,Saad; Andrew S,9,0,30,21
1656242739812,ECE 65,A51,095125,Staff,24,0,26,2
1656242745848,ECE 109,A01,091882,Touri; Behrouz,0,1,70,70
1656242761505,ECE 180,A00,083140,Abi Samra; Nicholas Camill,1,0,30,29
1656242761505,ECE 180,B00,083141,Abi Samra; Nicholas Camill,0,4,30,30
1656242767542,MATH 10A,A01,083735,Patchell; Gregory David,0,0,30,30
1656242767542,MATH 10A,A02,083736,Patchell; Gregory David,22,0,30,8
1656242767542,MATH 10A,A03,083737,Patchell; Gregory David,16,0,30,14
1656242783023,MATH 10B,A01,083207,Lim; Seonhee,0,0,34,34
1656242783023,MATH 10B,A02,083208,Lim; Seonhee,7,0,35,28
1656242783023,MATH 10B,A03,093472,Staff,1,0,34,33
1656242783023,MATH 10B,B01,083739,Sinha; Shubham,11,0,30,19
1656242789059,MATH 18,A01,083743,Cinel; Cameron Alexander,7,0,30,23
1656242789059,MATH 18,A02,083744,Cinel; Cameron Alexander,9,0,30,21
1656242789059,MATH 18,A03,083745,Cinel; Cameron Alexander,5,0,30,25
1656242789059,MATH 18,B01,083748,Rideout; David Porter,1,0,36,35
1656242789059,MATH 18,B02,083749,Rideout; David Porter,0,0,36,36
1656242789059,MATH 18,B03,083750,Rideout; David Porter,0,0,36,36
1656242789059,MATH 18,B04,083751,Rideout; David Porter,0,1,36,36
1656242789059,MATH 18,B05,093473,Rideout; David Porter,0,0,36,36
1656242789059,MATH 18,B06,093474,Rideout; David Porter,3,0,36,33
1656242804726,MATH 20A,A01,083754,Zheng; Zequn,11,0,40,29
1656242810757,MATH 20B,A01,083756,Briones; Jor-el Thomas Caparas,0,0,36,36
1656242810757,MATH 20B,A02,083757,Briones; Jor-el Thomas Caparas,0,0,36,36
1656242810757,MATH 20B,A03,093475,Staff,0,0,36,36
1656242826280,MATH 20C,A01,083760,Briones; Jor-el Thomas Caparas,0,0,35,35
1656242826280,MATH 20C,A02,083761,Briones; Jor-el Thomas Caparas,9,1,35,26
1656242826280,MATH 20C,A03,093476,Staff,0,0,35,35
1656242826280,MATH 20C,B01,083762,Bach; Quang Tran,1,0,30,29
1656242832310,MATH 20D,A01,083765,Tran; Brian Kha,1,0,30,29
1656242832310,MATH 20D,A02,083766,Tran; Brian Kha,0,1,30,30
1656242832310,MATH 20D,A03,083767,Tran; Brian Kha,2,0,30,28
1656242848012,MATH 20E,A01,083771,Ganguly; Soumya,3,0,32,29
1656242848012,MATH 20E,A02,083772,Ganguly; Soumya,0,0,32,32
1656242848012,MATH 20E,B01,083773,Ciotti; Benjamin,16,0,35,19
1656242848012,MATH 20E,B02,083774,Ciotti; Benjamin,15,0,35,20
1656242854045,MATH 103A,A01,083777,Greenfeld; Be'Eri,1,0,36,35
1656242854045,MATH 103A,A02,083778,Greenfeld; Be'Eri,1,0,36,35
1656242854045,MATH 103A,A03,093561,Staff,5,0,36,31
1656242854045,MATH 103A,B01,083779,Greenfeld; Be'Eri,8,0,36,28
1656242854045,MATH 103A,B02,083780,Greenfeld; Be'Eri,1,0,36,35
1656242854045,MATH 103A,B03,093562,Staff,0,0,36,36
1656242860114,MATH 105,A01,085443,Carter; Anne Toulson,5,0,35,30
1656242860114,MATH 105,A02,093477,Staff,14,0,35,21
1656242866150,MATH 109,A01,083213,Ganzberger; Geoffrey Michael,0,0,34,34
1656242866150,MATH 109,A02,083214,Ganzberger; Geoffrey Michael,0,0,34,34
1656242866150,MATH 109,A03,093478,Staff,1,0,34,33
1656242866150,MATH 109,B01,083215,Ganzberger; Geoffrey Michael,4,0,32,28
1656242866150,MATH 109,B02,083216,Ganzberger; Geoffrey Michael,1,0,32,31
1656242866150,MATH 109,B03,093479,Staff,3,0,32,29
1656242872237,MATH 142A,A01,083219,Chow; Bennett,2,0,32,30
1656242872237,MATH 142A,A02,083220,Chow; Bennett,8,0,32,24
1656242872237,MATH 142A,A03,093480,Staff,5,0,32,27
1656242872237,MATH 142A,B03,093481,Staff,3,0,32,29
1656242872237,MATH 142A,B04,093558,Staff,6,0,32,26
1656242872237,MATH 142A,B05,093559,Staff,0,0,32,32
1656242878268,MATH 193A,A01,083224,Rotar; Vladimir,0,1,34,34
1656242878268,MATH 193A,A02,083225,Rotar; Vladimir,0,0,34,34
1656242878268,MATH 193A,A03,083781,Rotar; Vladimir,0,0,34,34
1656242878268,MATH 193A,A04,083782,Rotar; Vladimir,6,0,34,28
1656242878268,MATH 193A,A05,093482,Rotar; Vladimir,0,0,34,34
1656242884300,MATH 197,001,091859,McAuley; Julian John,9999,0,9999,0
1656242884300,MATH 197,002,095566,Kedlaya; Kiran S.,9997,0,9999,2
1656242884300,MATH 197,003,095567,Xiao; Ming,9999,0,9999,0
1656242884300,MATH 197,004,095571,Perols; Johan Lars,9998,0,9999,1
1656242891389,COGS 9,A01,083615,Shannon; Kyle Michael,3,0,75,72
1656242897417,COGS 11,A01,083617,Boyle; Mary E. T.,14,0,48,34
1656242903446,COGS 13,A01,083071,Bastos; Amalia Pinkusfeld,4,0,71,67
1656242909476,COGS 14A,A01,092681,Semenuks; Arturs,1,12,100,99
1656242915504,COGS 14B,A01,083073,Cheng; Tzu-Han,7,0,63,56
1656242921537,COGS 17,A01,092677,Semenuks; Arturs,7,0,81,74
1656242927574,COGS 100,A01,083619,Allen; Michael Gordon,2,0,70,68
1656242933604,COGS 101A,A01,083621,Davis; Joshua Daniel,4,0,68,64
1656242939634,COGS 101B,A01,091572,Allen; Michael Gordon,4,0,65,61
1656242945664,COGS 101C,A01,083625,Delgado; Tania,10,0,35,25
1656242951692,COGS 107A,A01,083627,Boyle; Mary E. T.,0,0,60,60
1656242957725,COGS 118A,A01,083075,Gupta; Anjum,8,0,76,68
1656242963756,CSE 3,A50,083646,Miranda; Gregory Joseph,18,0,50,32
1656242969783,CSE 8A,A50,083650,Miranda; Gregory Joseph,2,2,56,54
1656242975810,CSE 11,A01,083080,Cao; Yingjun,0,49,40,40
1656242981845,CSE 12,A01,083652,Krause-Levy; Sophia Louisa,5,1,120,115
1656242987877,CSE 15L,A01,083654,Morris; Justin Loren,2,0,50,48
1656242987877,CSE 15L,A02,083655,Morris; Justin Loren,4,0,50,46
1656242993911,CSE 20,A01,083657,Tran; Khoa Dang,30,0,80,50
1656242999940,CSE 21,A01,095574,Bach; Quang Tran,23,0,48,25
1656243005968,CSE 30,A01,083084,Eldon; John,2,6,80,78
1656243005968,CSE 30,B01,095061,Bhaskar; Nishant,0,1,50,50
1656243011999,CSE 100,A01,083659,Cao; Yingjun,1,18,70,69
1656243018031,CSE 134B,A01,083661,Powell; Thomas Allan,5,0,100,95
1656243024064,CSE 140,A01,083663,Gungor; Onat,9,0,85,76
1656243030093,CSE 140L,A01,083088,Eldon; John,8,0,100,92
1656243036126,CSE 175,A01,083665,Kumar; Rakesh,0,0,25,25
1656243042157,CSE 190,A00,092507,Dubnov; Shlomo,3,0,20,17
1656243048196,ECE 45,A01,083139,Congero; Spencer William,1,0,75,74
1656243054235,ECE 65,A50,083695,Saad; Andrew S,9,0,30,21
1656243054235,ECE 65,A51,095125,Staff,24,0,26,2
1656243060265,ECE 109,A01,091882,Touri; Behrouz,0,1,70,70
1656243066292,ECE 180,A00,083140,Abi Samra; Nicholas Camill,1,0,30,29
1656243066292,ECE 180,B00,083141,Abi Samra; Nicholas Camill,0,4,30,30
1656243072320,MATH 10A,A01,083735,Patchell; Gregory David,0,0,30,30
1656243072320,MATH 10A,A02,083736,Patchell; Gregory David,22,0,30,8
1656243072320,MATH 10A,A03,083737,Patchell; Gregory David,16,0,30,14
1656243078357,MATH 10B,A01,083207,Lim; Seonhee,0,0,34,34
1656243078357,MATH 10B,A02,083208,Lim; Seonhee,7,0,35,28
1656243078357,MATH 10B,A03,093472,Staff,1,0,34,33
1656243078357,MATH 10B,B01,083739,Sinha; Shubham,11,0,30,19
1656243084389,MATH 18,A01,083743,Cinel; Cameron Alexander,7,0,30,23
1656243084389,MATH 18,A02,083744,Cinel; Cameron Alexander,9,0,30,21
1656243084389,MATH 18,A03,083745,Cinel; Cameron Alexander,5,0,30,25
1656243084389,MATH 18,B01,083748,Rideout; David Porter,1,0,36,35
1656243084389,MATH 18,B02,083749,Rideout; David Porter,0,0,36,36
1656243084389,MATH 18,B03,083750,Rideout; David Porter,0,0,36,36
1656243084389,MATH 18,B04,083751,Rideout; David Porter,0,1,36,36
1656243084389,MATH 18,B05,093473,Rideout; David Porter,0,0,36,36
1656243084389,MATH 18,B06,093474,Rideout; David Porter,3,0,36,33
1656243090417,MATH 20A,A01,083754,Zheng; Zequn,11,0,40,29
1656243096447,MATH 20B,A01,083756,Briones; Jor-el Thomas Caparas,0,0,36,36
1656243096447,MATH 20B,A02,083757,Briones; Jor-el Thomas Caparas,0,0,36,36
1656243096447,MATH 20B,A03,093475,Staff,0,0,36,36
1656243102476,MATH 20C,A01,083760,Briones; Jor-el Thomas Caparas,0,0,35,35
1656243102476,MATH 20C,A02,083761,Briones; Jor-el Thomas Caparas,9,1,35,26
1656243102476,MATH 20C,A03,093476,Staff,0,0,35,35
1656243102476,MATH 20C,B01,083762,Bach; Quang Tran,1,0,30,29
1656243108509,MATH 20D,A01,083765,Tran; Brian Kha,1,0,30,29
1656243108509,MATH 20D,A02,083766,Tran; Brian Kha,0,1,30,30
1656243108509,MATH 20D,A03,083767,Tran; Brian Kha,2,0,30,28
1656243114539,MATH 20E,A01,083771,Ganguly; Soumya,3,0,32,29
1656243114539,MATH 20E,A02,083772,Ganguly; Soumya,0,0,32,32
1656243114539,MATH 20E,B01,083773,Ciotti; Benjamin,16,0,35,19
1656243114539,MATH 20E,B02,083774,Ciotti; Benjamin,15,0,35,20
1656243120573,MATH 103A,A01,083777,Greenfeld; Be'Eri,1,0,36,35
1656243120573,MATH 103A,A02,083778,Greenfeld; Be'Eri,1,0,36,35
1656243120573,MATH 103A,A03,093561,Staff,5,0,36,31
1656243120573,MATH 103A,B01,083779,Greenfeld; Be'Eri,8,0,36,28
1656243120573,MATH 103A,B02,083780,Greenfeld; Be'Eri,1,0,36,35
1656243120573,MATH 103A,B03,093562,Staff,0,0,36,36
1656243126603,MATH 105,A01,085443,Carter; Anne Toulson,5,0,35,30
1656243126603,MATH 105,A02,093477,Staff,14,0,35,21
1656243132632,MATH 109,A01,083213,Ganzberger; Geoffrey Michael,0,0,34,34
1656243132632,MATH 109,A02,083214,Ganzberger; Geoffrey Michael,0,0,34,34
1656243132632,MATH 109,A03,093478,Staff,1,0,34,33
1656243132632,MATH 109,B01,083215,Ganzberger; Geoffrey Michael,4,0,32,28
1656243132632,MATH 109,B02,083216,Ganzberger; Geoffrey Michael,1,0,32,31
1656243132632,MATH 109,B03,093479,Staff,3,0,32,29
1656243138663,MATH 142A,A01,083219,Chow; Bennett,2,0,32,30
1656243138663,MATH 142A,A02,083220,Chow; Bennett,8,0,32,24
1656243138663,MATH 142A,A03,093480,Staff,5,0,32,27
1656243138663,MATH 142A,B03,093481,Staff,3,0,32,29
1656243138663,MATH 142A,B04,093558,Staff,6,0,32,26
1656243138663,MATH 142A,B05,093559,Staff,0,0,32,32
1656243144702,MATH 193A,A01,083224,Rotar; Vladimir,0,1,34,34
1656243144702,MATH 193A,A02,083225,Rotar; Vladimir,0,0,34,34
1656243144702,MATH 193A,A03,083781,Rotar; Vladimir,0,0,34,34
1656243144702,MATH 193A,A04,083782,Rotar; Vladimir,6,0,34,28
1656243144702,MATH 193A,A05,093482,Rotar; Vladimir,0,0,34,34
1656243150727,MATH 197,001,091859,McAuley; Julian John,9999,0,9999,0
1656243150727,MATH 197,002,095566,Kedlaya; Kiran S.,9997,0,9999,2
1656243150727,MATH 197,003,095567,Xiao; Ming,9999,0,9999,0
1656243150727,MATH 197,004,095571,Perols; Johan Lars,9998,0,9999,1
1656243157810,COGS 9,A01,083615,Shannon; Kyle Michael,3,0,75,72
1656243163837,COGS 11,A01,083617,Boyle; Mary E. T.,14,0,48,34
1656243169868,COGS 13,A01,083071,Bastos; Amalia Pinkusfeld,4,0,71,67
1656243175900,COGS 14A,A01,092681,Semenuks; Arturs,1,12,100,99
1656243181929,COGS 14B,A01,083073,Cheng; Tzu-Han,7,0,63,56
1656243187960,COGS 17,A01,092677,Semenuks; Arturs,7,0,81,74
1656243193988,COGS 100,A01,083619,Allen; Michael Gordon,2,0,70,68
1656243200021,COGS 101A,A01,083621,Davis; Joshua Daniel,4,0,68,64
1656243206048,COGS 101B,A01,091572,Allen; Michael Gordon,4,0,65,61
1656243212077,COGS 101C,A01,083625,Delgado; Tania,10,0,35,25
1656243218104,COGS 107A,A01,083627,Boyle; Mary E. T.,0,0,60,60
1656243224137,COGS 118A,A01,083075,Gupta; Anjum,8,0,76,68
1656243230172,CSE 3,A50,083646,Miranda; Gregory Joseph,18,0,50,32
1656243236197,CSE 8A,A50,083650,Miranda; Gregory Joseph,2,2,56,54
1656243242228,CSE 11,A01,083080,Cao; Yingjun,0,49,40,40
1656243248265,CSE 12,A01,083652,Krause-Levy; Sophia Louisa,5,1,120,115
1656243265014,CSE 15L,A01,083654,Morris; Justin Loren,2,0,50,48
1656243265014,CSE 15L,A02,083655,Morris; Justin Loren,4,0,50,46
1656243271046,CSE 20,A01,083657,Tran; Khoa Dang,30,0,80,50
1656243281213,CSE 21,A01,095574,Bach; Quang Tran,23,0,48,25
1656243287249,CSE 30,A01,083084,Eldon; John,2,6,80,78
1656243287249,CSE 30,B01,095061,Bhaskar; Nishant,0,1,50,50
1656243293278,CSE 100,A01,083659,Cao; Yingjun,1,18,70,69
1656243299305,CSE 134B,A01,083661,Powell; Thomas Allan,5,0,100,95
1656243305334,CSE 140,A01,083663,Gungor; Onat,9,0,85,76
1656243311439,CSE 140L,A01,083088,Eldon; John,8,0,100,92
1656243317467,CSE 175,A01,083665,Kumar; Rakesh,0,0,25,25
1656243323497,CSE 190,A00,092507,Dubnov; Shlomo,3,0,20,17
1656243329528,ECE 45,A01,083139,Congero; Spencer William,1,0,75,74
1656243335557,ECE 65,A50,083695,Saad; Andrew S,9,0,30,21
1656243335557,ECE 65,A51,095125,Staff,24,0,26,2
1656243341594,ECE 109,A01,091882,Touri; Behrouz,0,1,70,70
1656243347622,ECE 180,A00,083140,Abi Samra; Nicholas Camill,1,0,30,29
1656243347622,ECE 180,B00,083141,Abi Samra; Nicholas Camill,0,4,30,30
1656243353652,MATH 10A,A01,083735,Patchell; Gregory David,0,0,30,30
1656243353652,MATH 10A,A02,083736,Patchell; Gregory David,22,0,30,8
1656243353652,MATH 10A,A03,083737,Patchell; Gregory David,16,0,30,14
1656243359683,MATH 10B,A01,083207,Lim; Seonhee,0,0,34,34
1656243359683,MATH 10B,A02,083208,Lim; Seonhee,7,0,35,28
1656243359683,MATH 10B,A03,093472,Staff,1,0,34,33
1656243359683,MATH 10B,B01,083739,Sinha; Shubham,11,0,30,19
1656243365717,MATH 18,A01,083743,Cinel; Cameron Alexander,7,0,30,23
1656243365717,MATH 18,A02,083744,Cinel; Cameron Alexander,9,0,30,21
1656243365717,MATH 18,A03,083745,Cinel; Cameron Alexander,5,0,30,25
1656243365717,MATH 18,B01,083748,Rideout; David Porter,1,0,36,35
1656243365717,MATH 18,B02,083749,Rideout; David Porter,0,0,36,36
1656243365717,MATH 18,B03,083750,Rideout; David Porter,0,0,36,36
1656243365717,MATH 18,B04,083751,Rideout; David Porter,0,1,36,36
1656243365717,MATH 18,B05,093473,Rideout; David Porter,0,0,36,36
1656243365717,MATH 18,B06,093474,Rideout; David Porter,3,0,36,33
1656243371750,MATH 20A,A01,083754,Zheng; Zequn,11,0,40,29
1656243377786,MATH 20B,A01,083756,Briones; Jor-el Thomas Caparas,0,0,36,36
1656243377786,MATH 20B,A02,083757,Briones; Jor-el Thomas Caparas,0,0,36,36
1656243377786,MATH 20B,A03,093475,Staff,0,0,36,36
1656243383821,MATH 20C,A01,083760,Briones; Jor-el Thomas Caparas,0,0,35,35
1656243383821,MATH 20C,A02,083761,Briones; Jor-el Thomas Caparas,9,1,35,26
1656243383821,MATH 20C,A03,093476,Staff,0,0,35,35
1656243383821,MATH 20C,B01,083762,Bach; Quang Tran,1,0,30,29
1656243389851,MATH 20D,A01,083765,Tran; Brian Kha,1,0,30,29
1656243389851,MATH 20D,A02,083766,Tran; Brian Kha,0,1,30,30
1656243389851,MATH 20D,A03,083767,Tran; Brian Kha,2,0,30,28
1656243395881,MATH 20E,A01,083771,Ganguly; Soumya,3,0,32,29
1656243395881,MATH 20E,A02,083772,Ganguly; Soumya,0,0,32,32
1656243395881,MATH 20E,B01,083773,Ciotti; Benjamin,16,0,35,19
1656243395881,MATH 20E,B02,083774,Ciotti; Benjamin,15,0,35,20
1656243401912,MATH 103A,A01,083777,Greenfeld; Be'Eri,1,0,36,35
1656243401912,MATH 103A,A02,083778,Greenfeld; Be'Eri,1,0,36,35
1656243401912,MATH 103A,A03,093561,Staff,5,0,36,31
1656243401912,MATH 103A,B01,083779,Greenfeld; Be'Eri,8,0,36,28
1656243401912,MATH 103A,B02,083780,Greenfeld; Be'Eri,1,0,36,35
1656243401912,MATH 103A,B03,093562,Staff,0,0,36,36
1656243407940,MATH 105,A01,085443,Carter; Anne Toulson,5,0,35,30
1656243407940,MATH 105,A02,093477,Staff,14,0,35,21
1656243413969,MATH 109,A01,083213,Ganzberger; Geoffrey Michael,0,0,34,34
1656243413969,MATH 109,A02,083214,Ganzberger; Geoffrey Michael,0,0,34,34
1656243413969,MATH 109,A03,093478,Staff,1,0,34,33
1656243413969,MATH 109,B01,083215,Ganzberger; Geoffrey Michael,4,0,32,28
1656243413969,MATH 109,B02,083216,Ganzberger; Geoffrey Michael,1,0,32,31
1656243413969,MATH 109,B03,093479,Staff,3,0,32,29
1656243420014,MATH 142A,A01,083219,Chow; Bennett,2,0,32,30
1656243420014,MATH 142A,A02,083220,Chow; Bennett,8,0,32,24
1656243420014,MATH 142A,A03,093480,Staff,5,0,32,27
1656243420014,MATH 142A,B03,093481,Staff,3,0,32,29
1656243420014,MATH 142A,B04,093558,Staff,6,0,32,26
1656243420014,MATH 142A,B05,093559,Staff,0,0,32,32
1656243426042,MATH 193A,A01,083224,Rotar; Vladimir,0,1,34,34
1656243426042,MATH 193A,A02,083225,Rotar; Vladimir,0,0,34,34
1656243426042,MATH 193A,A03,083781,Rotar; Vladimir,0,0,34,34
1656243426042,MATH 193A,A04,083782,Rotar; Vladimir,6,0,34,28
1656243426042,MATH 193A,A05,093482,Rotar; Vladimir,0,0,34,34
1656243432069,MATH 197,001,091859,McAuley; Julian John,9999,0,9999,0
1656243432069,MATH 197,002,095566,Kedlaya; Kiran S.,9997,0,9999,2
1656243432069,MATH 197,003,095567,Xiao; Ming,9999,0,9999,0
1656243432069,MATH 197,004,095571,Perols; Johan Lars,9998,0,9999,1
1656243439152,COGS 9,A01,083615,Shannon; Kyle Michael,3,0,75,72
1656243445185,COGS 11,A01,083617,Boyle; Mary E. T.,14,0,48,34
1656243451220,COGS 13,A01,083071,Bastos; Amalia Pinkusfeld,4,0,71,67
1656243457248,COGS 14A,A01,092681,Semenuks; Arturs,1,12,100,99
1656243463275,COGS 14B,A01,083073,Cheng; Tzu-Han,7,0,63,56
1656243469304,COGS 17,A01,092677,Semenuks; Arturs,7,0,81,74
1656243475332,COGS 100,A01,083619,Allen; Michael Gordon,2,0,70,68
1656243481358,COGS 101A,A01,083621,Davis; Joshua Daniel,4,0,68,64
1656243487387,COGS 101B,A01,091572,Allen; Michael Gordon,4,0,65,61
1656243493414,COGS 101C,A01,083625,Delgado; Tania,10,0,35,25
1656243499445,COGS 107A,A01,083627,Boyle; Mary E. T.,0,0,60,60
1656243505475,COGS 118A,A01,083075,Gupta; Anjum,8,0,76,68
1656243511510,CSE 3,A50,083646,Miranda; Gregory Joseph,18,0,50,32
1656243517533,CSE 8A,A50,083650,Miranda; Gregory Joseph,2,2,56,54
1656243523559,CSE 11,A01,083080,Cao; Yingjun,0,49,40,40
1656243529586,CSE 12,A01,083652,Krause-Levy; Sophia Louisa,5,1,120,115
1656243535614,CSE 15L,A01,083654,Morris; Justin Loren,2,0,50,48
1656243535614,CSE 15L,A02,083655,Morris; Justin Loren,4,0,50,46
1656243541648,CSE 20,A01,083657,Tran; Khoa Dang,30,0,80,50
1656243547675,CSE 21,A01,095574,Bach; Quang Tran,23,0,48,25
1656243553713,CSE 30,A01,083084,Eldon; John,2,6,80,78
1656243553713,CSE 30,B01,095061,Bhaskar; Nishant,0,1,50,50
1656243559746,CSE 100,A01,083659,Cao; Yingjun,1,18,70,69
1656243565779,CSE 134B,A01,083661,Powell; Thomas Allan,5,0,100,95
1656243571813,CSE 140,A01,083663,Gungor; Onat,9,0,85,76
1656243577843,CSE 140L,A01,083088,Eldon; John,8,0,100,92
1656243583870,CSE 175,A01,083665,Kumar; Rakesh,0,0,25,25
1656243589901,CSE 190,A00,092507,Dubnov; Shlomo,3,0,20,17
1656243595931,ECE 45,A01,083139,Congero; Spencer William,1,0,75,74
1656243601964,ECE 65,A50,083695,Saad; Andrew S,9,0,30,21
1656243601964,ECE 65,A51,095125,Staff,24,0,26,2
1656243607994,ECE 109,A01,091882,Touri; Behrouz,0,1,70,70
1656243614029,ECE 180,A00,083140,Abi Samra; Nicholas Camill,1,0,30,29
1656243614029,ECE 180,B00,083141,Abi Samra; Nicholas Camill,0,4,30,30
1656243620064,MATH 10A,A01,083735,Patchell; Gregory David,0,0,30,30
1656243620064,MATH 10A,A02,083736,Patchell; Gregory David,22,0,30,8
1656243620064,MATH 10A,A03,083737,Patchell; Gregory David,16,0,30,14
1656243626095,MATH 10B,A01,083207,Lim; Seonhee,0,0,34,34
1656243626095,MATH 10B,A02,083208,Lim; Seonhee,7,0,35,28
1656243626095,MATH 10B,A03,093472,Staff,1,0,34,33
1656243626095,MATH 10B,B01,083739,Sinha; Shubham,11,0,30,19
1656243632132,MATH 18,A01,083743,Cinel; Cameron Alexander,7,0,30,23
1656243632132,MATH 18,A02,083744,Cinel; Cameron Alexander,9,0,30,21
1656243632132,MATH 18,A03,083745,Cinel; Cameron Alexander,5,0,30,25
1656243632132,MATH 18,B01,083748,Rideout; David Porter,1,0,36,35
1656243632132,MATH 18,B02,083749,Rideout; David Porter,0,0,36,36
1656243632132,MATH 18,B03,083750,Rideout; David Porter,0,0,36,36
1656243632132,MATH 18,B04,083751,Rideout; David Porter,0,1,36,36
1656243632132,MATH 18,B05,093473,Rideout; David Porter,0,0,36,36
1656243632132,MATH 18,B06,093474,Rideout; David Porter,3,0,36,33
1656243638163,MATH 20A,A01,083754,Zheng; Zequn,11,0,40,29
1656243644191,MATH 20B,A01,083756,Briones; Jor-el Thomas Caparas,0,0,36,36
1656243644191,MATH 20B,A02,083757,Briones; Jor-el Thomas Caparas,0,0,36,36
1656243644191,MATH 20B,A03,093475,Staff,0,0,36,36
1656243650230,MATH 20C,A01,083760,Briones; Jor-el Thomas Caparas,0,0,35,35
1656243650230,MATH 20C,A02,083761,Briones; Jor-el Thomas Caparas,9,1,35,26
1656243650230,MATH 20C,A03,093476,Staff,0,0,35,35
1656243650230,MATH 20C,B01,083762,Bach; Quang Tran,1,0,30,29
1656243656261,MATH 20D,A01,083765,Tran; Brian Kha,1,0,30,29
1656243656261,MATH 20D,A02,083766,Tran; Brian Kha,0,1,30,30
1656243656261,MATH 20D,A03,083767,Tran; Brian Kha,2,0,30,28
1656243662290,MATH 20E,A01,083771,Ganguly; Soumya,3,0,32,29
1656243662290,MATH 20E,A02,083772,Ganguly; Soumya,0,0,32,32
1656243662290,MATH 20E,B01,083773,Ciotti; Benjamin,16,0,35,19
1656243662290,MATH 20E,B02,083774,Ciotti; Benjamin,15,0,35,20
1656243668320,MATH 103A,A01,083777,Greenfeld; Be'Eri,1,0,36,35
1656243668320,MATH 103A,A02,083778,Greenfeld; Be'Eri,1,0,36,35
1656243668320,MATH 103A,A03,093561,Staff,5,0,36,31
1656243668320,MATH 103A,B01,083779,Greenfeld; Be'Eri,8,0,36,28
1656243668320,MATH 103A,B02,083780,Greenfeld; Be'Eri,1,0,36,35
1656243668320,MATH 103A,B03,093562,Staff,0,0,36,36
1656243674354,MATH 105,A01,085443,Carter; Anne Toulson,5,0,35,30
1656243674354,MATH 105,A02,093477,Staff,14,0,35,21
1656243680388,MATH 109,A01,083213,Ganzberger; Geoffrey Michael,0,0,34,34
1656243680388,MATH 109,A02,083214,Ganzberger; Geoffrey Michael,0,0,34,34
1656243680388,MATH 109,A03,093478,Staff,1,0,34,33
1656243680388,MATH 109,B01,083215,Ganzberger; Geoffrey Michael,4,0,32,28
1656243680388,MATH 109,B02,083216,Ganzberger; Geoffrey Michael,1,0,32,31
1656243680388,MATH 109,B03,093479,Staff,3,0,32,29
1656243686419,MATH 142A,A01,083219,Chow; Bennett,2,0,32,30
1656243686419,MATH 142A,A02,083220,Chow; Bennett,8,0,32,24
1656243686419,MATH 142A,A03,093480,Staff,5,0,32,27
1656243686419,MATH 142A,B03,093481,Staff,3,0,32,29
1656243686419,MATH 142A,B04,093558,Staff,6,0,32,26
1656243686419,MATH 142A,B05,093559,Staff,0,0,32,32
1656243692450,MATH 193A,A01,083224,Rotar; Vladimir,0,1,34,34
1656243692450,MATH 193A,A02,083225,Rotar; Vladimir,0,0,34,34
1656243692450,MATH 193A,A03,083781,Rotar; Vladimir,0,0,34,34
1656243692450,MATH 193A,A04,083782,Rotar; Vladimir,6,0,34,28
1656243692450,MATH 193A,A05,093482,Rotar; Vladimir,0,0,34,34
1656243698480,MATH 197,001,091859,McAuley; Julian John,9999,0,9999,0
1656243698480,MATH 197,002,095566,Kedlaya; Kiran S.,9997,0,9999,2
1656243698480,MATH 197,003,095567,Xiao; Ming,9999,0,9999,0
1656243698480,MATH 197,004,095571,Perols; Johan Lars,9998,0,9999,1
1656243705557,COGS 9,A01,083615,Shannon; Kyle Michael,3,0,75,72
1656243711583,COGS 11,A01,083617,Boyle; Mary E. T.,14,0,48,34
1656243717612,COGS 13,A01,083071,Bastos; Amalia Pinkusfeld,4,0,71,67
1656243723645,COGS 14A,A01,092681,Semenuks; Arturs,1,12,100,99
1656243729676,COGS 14B,A01,083073,Cheng; Tzu-Han,7,0,63,56
1656243735707,COGS 17,A01,092677,Semenuks; Arturs,7,0,81,74
1656243741738,COGS 100,A01,083619,Allen; Michael Gordon,2,0,70,68
1656243747765,COGS 101A,A01,083621,Davis; Joshua Daniel,4,0,68,64
1656243753792,COGS 101B,A01,091572,Allen; Michael Gordon,4,0,65,61
1656243759824,COGS 101C,A01,083625,Delgado; Tania,10,0,35,25
1656243765849,COGS 107A,A01,083627,Boyle; Mary E. T.,0,0,60,60
1656243771875,COGS 118A,A01,083075,Gupta; Anjum,8,0,76,68
1656243777905,CSE 3,A50,083646,Miranda; Gregory Joseph,18,0,50,32
1656243783936,CSE 8A,A50,083650,Miranda; Gregory Joseph,2,2,56,54
1656243789963,CSE 11,A01,083080,Cao; Yingjun,0,49,40,40
1656243795996,CSE 12,A01,083652,Krause-Levy; Sophia Louisa,5,1,120,115
1656243802024,CSE 15L,A01,083654,Morris; Justin Loren,2,0,50,48
1656243802024,CSE 15L,A02,083655,Morris; Justin Loren,4,0,50,46
1656243808051,CSE 20,A01,083657,Tran; Khoa Dang,30,0,80,50
1656243814085,CSE 21,A01,095574,Bach; Quang Tran,23,0,48,25
1656243820112,CSE 30,A01,083084,Eldon; John,2,6,80,78
1656243820112,CSE 30,B01,095061,Bhaskar; Nishant,0,1,50,50
1656243826142,CSE 100,A01,083659,Cao; Yingjun,1,18,70,69
1656243832170,CSE 134B,A01,083661,Powell; Thomas Allan,5,0,100,95
1656243838198,CSE 140,A01,083663,Gungor; Onat,9,0,85,76
1656243844232,CSE 140L,A01,083088,Eldon; John,8,0,100,92
1656243850261,CSE 175,A01,083665,Kumar; Rakesh,0,0,25,25
1656243856298,CSE 190,A00,092507,Dubnov; Shlomo,3,0,20,17
1656243862327,ECE 45,A01,083139,Congero; Spencer William,1,0,75,74
1656243868355,ECE 65,A50,083695,Saad; Andrew S,9,0,30,21
1656243868355,ECE 65,A51,095125,Staff,24,0,26,2
1656243874382,ECE 109,A01,091882,Touri; Behrouz,0,1,70,70
1656243880483,ECE 180,A00,083140,Abi Samra; Nicholas Camill,1,0,30,29
1656243880483,ECE 180,B00,083141,Abi Samra; Nicholas Camill,0,4,30,30
1656243886516,MATH 10A,A01,083735,Patchell; Gregory David,0,0,30,30
1656243886516,MATH 10A,A02,083736,Patchell; Gregory David,22,0,30,8
1656243886516,MATH 10A,A03,083737,Patchell; Gregory David,16,0,30,14
1656243892553,MATH 10B,A01,083207,Lim; Seonhee,0,0,34,34
1656243892553,MATH 10B,A02,083208,Lim; Seonhee,7,0,35,28
1656243892553,MATH 10B,A03,093472,Staff,1,0,34,33
1656243892553,MATH 10B,B01,083739,Sinha; Shubham,11,0,30,19
1656243898598,MATH 18,A01,083743,Cinel; Cameron Alexander,7,0,30,23
1656243898598,MATH 18,A02,083744,Cinel; Cameron Alexander,9,0,30,21
1656243898598,MATH 18,A03,083745,Cinel; Cameron Alexander,5,0,30,25
1656243898598,MATH 18,B01,083748,Rideout; David Porter,1,0,36,35
1656243898598,MATH 18,B02,083749,Rideout; David Porter,0,0,36,36
1656243898598,MATH 18,B03,083750,Rideout; David Porter,0,0,36,36
1656243898598,MATH 18,B04,083751,Rideout; David Porter,0,1,36,36
1656243898598,MATH 18,B05,093473,Rideout; David Porter,0,0,36,36
1656243898598,MATH 18,B06,093474,Rideout; David Porter,3,0,36,33
1656243904627,MATH 20A,A01,083754,Zheng; Zequn,11,0,40,29
1656243910656,MATH 20B,A01,083756,Briones; Jor-el Thomas Caparas,0,0,36,36
1656243910656,MATH 20B,A02,083757,Briones; Jor-el Thomas Caparas,0,0,36,36
1656243910656,MATH 20B,A03,093475,Staff,0,0,36,36
1656243916689,MATH 20C,A01,083760,Briones; Jor-el Thomas Caparas,0,0,35,35
1656243916689,MATH 20C,A02,083761,Briones; Jor-el Thomas Caparas,9,1,35,26
1656243916689,MATH 20C,A03,093476,Staff,0,0,35,35
1656243916689,MATH 20C,B01,083762,Bach; Quang Tran,1,0,30,29
1656243922722,MATH 20D,A01,083765,Tran; Brian Kha,1,0,30,29
1656243922722,MATH 20D,A02,083766,Tran; Brian Kha,0,1,30,30
1656243922722,MATH 20D,A03,083767,Tran; Brian Kha,2,0,30,28
1656243928758,MATH 20E,A01,083771,Ganguly; Soumya,3,0,32,29
1656243928758,MATH 20E,A02,083772,Ganguly; Soumya,0,0,32,32
1656243928758,MATH 20E,B01,083773,Ciotti; Benjamin,16,0,35,19
1656243928758,MATH 20E,B02,083774,Ciotti; Benjamin,15,0,35,20
1656243934795,MATH 103A,A01,083777,Greenfeld; Be'Eri,1,0,36,35
1656243934795,MATH 103A,A02,083778,Greenfeld; Be'Eri,1,0,36,35
1656243934795,MATH 103A,A03,093561,Staff,5,0,36,31
1656243934795,MATH 103A,B01,083779,Greenfeld; Be'Eri,8,0,36,28
1656243934795,MATH 103A,B02,083780,Greenfeld; Be'Eri,1,0,36,35
1656243934795,MATH 103A,B03,093562,Staff,0,0,36,36
1656243940828,MATH 105,A01,085443,Carter; Anne Toulson,5,0,35,30
1656243940828,MATH 105,A02,093477,Staff,14,0,35,21
1656243946865,MATH 109,A01,083213,Ganzberger; Geoffrey Michael,0,0,34,34
1656243946865,MATH 109,A02,083214,Ganzberger; Geoffrey Michael,0,0,34,34
1656243946865,MATH 109,A03,093478,Staff,1,0,34,33
1656243946865,MATH 109,B01,083215,Ganzberger; Geoffrey Michael,4,0,32,28
1656243946865,MATH 109,B02,083216,Ganzberger; Geoffrey Michael,1,0,32,31
1656243946865,MATH 109,B03,093479,Staff,3,0,32,29
1656243952896,MATH 142A,A01,083219,Chow; Bennett,2,0,32,30
1656243952896,MATH 142A,A02,083220,Chow; Bennett,8,0,32,24
1656243952896,MATH 142A,A03,093480,Staff,5,0,32,27
1656243952896,MATH 142A,B03,093481,Staff,3,0,32,29
1656243952896,MATH 142A,B04,093558,Staff,6,0,32,26
1656243952896,MATH 142A,B05,093559,Staff,0,0,32,32
1656243958925,MATH 193A,A01,083224,Rotar; Vladimir,0,1,34,34
1656243958925,MATH 193A,A02,083225,Rotar; Vladimir,0,0,34,34
1656243958925,MATH 193A,A03,083781,Rotar; Vladimir,0,0,34,34
1656243958925,MATH 193A,A04,083782,Rotar; Vladimir,6,0,34,28
1656243958925,MATH 193A,A05,093482,Rotar; Vladimir,0,0,34,34
1656243964956,MATH 197,001,091859,McAuley; Julian John,9999,0,9999,0
1656243964956,MATH 197,002,095566,Kedlaya; Kiran S.,9997,0,9999,2
1656243964956,MATH 197,003,095567,Xiao; Ming,9999,0,9999,0
1656243964956,MATH 197,004,095571,Perols; Johan Lars,9998,0,9999,1
1656243972026,COGS 9,A01,083615,Shannon; Kyle Michael,3,0,75,72
1656243978054,COGS 11,A01,083617,Boyle; Mary E. T.,14,0,48,34
1656243984084,COGS 13,A01,083071,Bastos; Amalia Pinkusfeld,4,0,71,67
1656243990113,COGS 14A,A01,092681,Semenuks; Arturs,1,12,100,99
1656243996145,COGS 14B,A01,083073,Cheng; Tzu-Han,7,0,63,56
1656244002193,COGS 17,A01,092677,Semenuks; Arturs,7,0,81,74
1656244008226,COGS 100,A01,083619,Allen; Michael Gordon,2,0,70,68
1656244014256,COGS 101A,A01,083621,Davis; Joshua Daniel,4,0,68,64
1656244020286,COGS 101B,A01,091572,Allen; Michael Gordon,4,0,65,61
1656244026314,COGS 101C,A01,083625,Delgado; Tania,10,0,35,25
1656244032344,COGS 107A,A01,083627,Boyle; Mary E. T.,0,0,60,60
1656244038376,COGS 118A,A01,083075,Gupta; Anjum,8,0,76,68
1656244044408,CSE 3,A50,083646,Miranda; Gregory Joseph,18,0,50,32
1656244050436,CSE 8A,A50,083650,Miranda; Gregory Joseph,2,2,56,54
1656244056461,CSE 11,A01,083080,Cao; Yingjun,0,49,40,40
1656244062490,CSE 12,A01,083652,Krause-Levy; Sophia Louisa,5,1,120,115
1656244068519,CSE 15L,A01,083654,Morris; Justin Loren,2,0,50,48
1656244068519,CSE 15L,A02,083655,Morris; Justin Loren,4,0,50,46
1656244074550,CSE 20,A01,083657,Tran; Khoa Dang,30,0,80,50
1656244080578,CSE 21,A01,095574,Bach; Quang Tran,23,0,48,25
1656244086614,CSE 30,A01,083084,Eldon; John,2,6,80,78
1656244086614,CSE 30,B01,095061,Bhaskar; Nishant,0,1,50,50
1656244092642,CSE 100,A01,083659,Cao; Yingjun,1,18,70,69
1656244098669,CSE 134B,A01,083661,Powell; Thomas Allan,5,0,100,95
1656244104700,CSE 140,A01,083663,Gungor; Onat,9,0,85,76
1656244110735,CSE 140L,A01,083088,Eldon; John,8,0,100,92
1656244116762,CSE 175,A01,083665,Kumar; Rakesh,0,0,25,25
1656244122790,CSE 190,A00,092507,Dubnov; Shlomo,3,0,20,17
1656244128823,ECE 45,A01,083139,Congero; Spencer William,1,0,75,74
1656244134857,ECE 65,A50,083695,Saad; Andrew S,9,0,30,21
1656244134857,ECE 65,A51,095125,Staff,24,0,26,2
1656244140886,ECE 109,A01,091882,Touri; Behrouz,0,1,70,70
1656244146913,ECE 180,A00,083140,Abi Samra; Nicholas Camill,1,0,30,29
1656244146913,ECE 180,B00,083141,Abi Samra; Nicholas Camill,0,4,30,30
1656244152951,MATH 10A,A01,083735,Patchell; Gregory David,0,0,30,30
1656244152951,MATH 10A,A02,083736,Patchell; Gregory David,22,0,30,8
1656244152951,MATH 10A,A03,083737,Patchell; Gregory David,16,0,30,14
1656244159077,MATH 10B,A01,083207,Lim; Seonhee,0,0,34,34
1656244159077,MATH 10B,A02,083208,Lim; Seonhee,7,0,35,28
1656244159077,MATH 10B,A03,093472,Staff,1,0,34,33
1656244159077,MATH 10B,B01,083739,Sinha; Shubham,11,0,30,19
1656244165115,MATH 18,A01,083743,Cinel; Cameron Alexander,7,0,30,23
1656244165115,MATH 18,A02,083744,Cinel; Cameron Alexander,9,0,30,21
1656244165115,MATH 18,A03,083745,Cinel; Cameron Alexander,5,0,30,25
1656244165115,MATH 18,B01,083748,Rideout; David Porter,1,0,36,35
1656244165115,MATH 18,B02,083749,Rideout; David Porter,0,0,36,36
1656244165115,MATH 18,B03,083750,Rideout; David Porter,0,0,36,36
1656244165115,MATH 18,B04,083751,Rideout; David Porter,0,1,36,36
1656244165115,MATH 18,B05,093473,Rideout; David Porter,0,0,36,36
1656244165115,MATH 18,B06,093474,Rideout; David Porter,3,0,36,33
1656244171148,MATH 20A,A01,083754,Zheng; Zequn,11,0,40,29
1656244177183,MATH 20B,A01,083756,Briones; Jor-el Thomas Caparas,0,0,36,36
1656244177183,MATH 20B,A02,083757,Briones; Jor-el Thomas Caparas,0,0,36,36
1656244177183,MATH 20B,A03,093475,Staff,0,0,36,36
1656244183210,MATH 20C,A01,083760,Briones; Jor-el Thomas Caparas,0,0,35,35
1656244183210,MATH 20C,A02,083761,Briones; Jor-el Thomas Caparas,9,1,35,26
1656244183210,MATH 20C,A03,093476,Staff,0,0,35,35
1656244183210,MATH 20C,B01,083762,Bach; Quang Tran,1,0,30,29
1656244189243,MATH 20D,A01,083765,Tran; Brian Kha,1,0,30,29
1656244189243,MATH 20D,A02,083766,Tran; Brian Kha,0,1,30,30
1656244189243,MATH 20D,A03,083767,Tran; Brian Kha,2,0,30,28
1656244195272,MATH 20E,A01,083771,Ganguly; Soumya,3,0,32,29
1656244195272,MATH 20E,A02,083772,Ganguly; Soumya,0,0,32,32
1656244195272,MATH 20E,B01,083773,Ciotti; Benjamin,16,0,35,19
1656244195272,MATH 20E,B02,083774,Ciotti; Benjamin,15,0,35,20
1656244201310,MATH 103A,A01,083777,Greenfeld; Be'Eri,1,0,36,35
1656244201310,MATH 103A,A02,083778,Greenfeld; Be'Eri,1,0,36,35
1656244201310,MATH 103A,A03,093561,Staff,5,0,36,31
1656244201310,MATH 103A,B01,083779,Greenfeld; Be'Eri,8,0,36,28
1656244201310,MATH 103A,B02,083780,Greenfeld; Be'Eri,1,0,36,35
1656244201310,MATH 103A,B03,093562,Staff,0,0,36,36
1656244207333,MATH 105,A01,085443,Carter; Anne Toulson,5,0,35,30
1656244207333,MATH 105,A02,093477,Staff,14,0,35,21
1656244213359,MATH 109,A01,083213,Ganzberger; Geoffrey Michael,0,0,34,34
1656244213359,MATH 109,A02,083214,Ganzberger; Geoffrey Michael,0,0,34,34
1656244213359,MATH 109,A03,093478,Staff,1,0,34,33
1656244213359,MATH 109,B01,083215,Ganzberger; Geoffrey Michael,4,0,32,28
1656244213359,MATH 109,B02,083216,Ganzberger; Geoffrey Michael,1,0,32,31
1656244213359,MATH 109,B03,093479,Staff,3,0,32,29
1656244219387,MATH 142A,A01,083219,Chow; Bennett,2,0,32,30
1656244219387,MATH 142A,A02,083220,Chow; Bennett,8,0,32,24
1656244219387,MATH 142A,A03,093480,Staff,5,0,32,27
1656244219387,MATH 142A,B03,093481,Staff,3,0,32,29
1656244219387,MATH 142A,B04,093558,Staff,6,0,32,26
1656244219387,MATH 142A,B05,093559,Staff,0,0,32,32
1656244225422,MATH 193A,A01,083224,Rotar; Vladimir,0,1,34,34
1656244225422,MATH 193A,A02,083225,Rotar; Vladimir,0,0,34,34
1656244225422,MATH 193A,A03,083781,Rotar; Vladimir,0,0,34,34
1656244225422,MATH 193A,A04,083782,Rotar; Vladimir,6,0,34,28
1656244225422,MATH 193A,A05,093482,Rotar; Vladimir,0,0,34,34
1656244231447,MATH 197,001,091859,McAuley; Julian John,9999,0,9999,0
1656244231447,MATH 197,002,095566,Kedlaya; Kiran S.,9997,0,9999,2
1656244231447,MATH 197,003,095567,Xiao; Ming,9999,0,9999,0
1656244231447,MATH 197,004,095571,Perols; Johan Lars,9998,0,9999,1
1656244238529,COGS 9,A01,083615,Shannon; Kyle Michael,3,0,75,72
1656244244564,COGS 11,A01,083617,Boyle; Mary E. T.,14,0,48,34
1656244250596,COGS 13,A01,083071,Bastos; Amalia Pinkusfeld,4,0,71,67
1656244256629,COGS 14A,A01,092681,Semenuks; Arturs,1,12,100,99
1656244262654,COGS 14B,A01,083073,Cheng; Tzu-Han,7,0,63,56
1656244268685,COGS 17,A01,092677,Semenuks; Arturs,7,0,81,74
1656244274711,COGS 100,A01,083619,Allen; Michael Gordon,2,0,70,68
1656244280745,COGS 101A,A01,083621,Davis; Joshua Daniel,4,0,68,64
1656244286773,COGS 101B,A01,091572,Allen; Michael Gordon,4,0,65,61
1656244292804,COGS 101C,A01,083625,Delgado; Tania,10,0,35,25
1656244298853,COGS 107A,A01,083627,Boyle; Mary E. T.,0,0,60,60
1656244304879,COGS 118A,A01,083075,Gupta; Anjum,8,0,76,68
1656244310907,CSE 3,A50,083646,Miranda; Gregory Joseph,18,0,50,32
1656244316938,CSE 8A,A50,083650,Miranda; Gregory Joseph,2,2,56,54
1656244322970,CSE 11,A01,083080,Cao; Yingjun,0,49,40,40
1656244328998,CSE 12,A01,083652,Krause-Levy; Sophia Louisa,5,1,120,115
1656244335037,CSE 15L,A01,083654,Morris; Justin Loren,2,0,50,48
1656244335037,CSE 15L,A02,083655,Morris; Justin Loren,4,0,50,46
1656244341067,CSE 20,A01,083657,Tran; Khoa Dang,30,0,80,50
1656244347099,CSE 21,A01,095574,Bach; Quang Tran,23,0,48,25
1656244353134,CSE 30,A01,083084,Eldon; John,2,6,80,78
1656244353134,CSE 30,B01,095061,Bhaskar; Nishant,0,1,50,50
1656244359169,CSE 100,A01,083659,Cao; Yingjun,1,18,70,69
1656244365200,CSE 134B,A01,083661,Powell; Thomas Allan,5,0,100,95
1656244371231,CSE 140,A01,083663,Gungor; Onat,9,0,85,76
1656244377261,CSE 140L,A01,083088,Eldon; John,8,0,100,92
1656244383288,CSE 175,A01,083665,Kumar; Rakesh,0,0,25,25
1656244389317,CSE 190,A00,092507,Dubnov; Shlomo,3,0,20,17
1656244395346,ECE 45,A01,083139,Congero; Spencer William,1,0,75,74
1656244401380,ECE 65,A50,083695,Saad; Andrew S,9,0,30,21
1656244401380,ECE 65,A51,095125,Staff,24,0,26,2
1656244407411,ECE 109,A01,091882,Touri; Behrouz,0,1,70,70
1656244413437,ECE 180,A00,083140,Abi Samra; Nicholas Camill,1,0,30,29
1656244413437,ECE 180,B00,083141,Abi Samra; Nicholas Camill,0,4,30,30
1656244419468,MATH 10A,A01,083735,Patchell; Gregory David,0,0,30,30
1656244419468,MATH 10A,A02,083736,Patchell; Gregory David,22,0,30,8
1656244419468,MATH 10A,A03,083737,Patchell; Gregory David,16,0,30,14
1656244425497,MATH 10B,A01,083207,Lim; Seonhee,0,0,34,34
1656244425497,MATH 10B,A02,083208,Lim; Seonhee,7,0,35,28
1656244425497,MATH 10B,A03,093472,Staff,1,0,34,33
1656244425497,MATH 10B,B01,083739,Sinha; Shubham,11,0,30,19
1656244431530,MATH 18,A01,083743,Cinel; Cameron Alexander,7,0,30,23
1656244431530,MATH 18,A02,083744,Cinel; Cameron Alexander,9,0,30,21
1656244431530,MATH 18,A03,083745,Cinel; Cameron Alexander,5,0,30,25
1656244431530,MATH 18,B01,083748,Rideout; David Porter,1,0,36,35
1656244431530,MATH 18,B02,083749,Rideout; David Porter,0,0,36,36
1656244431530,MATH 18,B03,083750,Rideout; David Porter,0,0,36,36
1656244431530,MATH 18,B04,083751,Rideout; David Porter,0,1,36,36
1656244431530,MATH 18,B05,093473,Rideout; David Porter,0,0,36,36
1656244431530,MATH 18,B06,093474,Rideout; David Porter,3,0,36,33
1656244437563,MATH 20A,A01,083754,Zheng; Zequn,11,0,40,29
1656244443598,MATH 20B,A01,083756,Briones; Jor-el Thomas Caparas,0,0,36,36
1656244443598,MATH 20B,A02,083757,Briones; Jor-el Thomas Caparas,0,0,36,36
1656244443598,MATH 20B,A03,093475,Staff,0,0,36,36
1656244449626,MATH 20C,A01,083760,Briones; Jor-el Thomas Caparas,0,0,35,35
1656244449626,MATH 20C,A02,083761,Briones; Jor-el Thomas Caparas,9,1,35,26
1656244449626,MATH 20C,A03,093476,Staff,0,0,35,35
1656244449626,MATH 20C,B01,083762,Bach; Quang Tran,1,0,30,29
1656244455660,MATH 20D,A01,083765,Tran; Brian Kha,1,0,30,29
1656244455660,MATH 20D,A02,083766,Tran; Brian Kha,0,1,30,30
1656244455660,MATH 20D,A03,083767,Tran; Brian Kha,2,0,30,28
1656244461689,MATH 20E,A01,083771,Ganguly; Soumya,3,0,32,29
1656244461689,MATH 20E,A02,083772,Ganguly; Soumya,0,0,32,32
1656244461689,MATH 20E,B01,083773,Ciotti; Benjamin,16,0,35,19
1656244461689,MATH 20E,B02,083774,Ciotti; Benjamin,15,0,35,20
1656244467718,MATH 103A,A01,083777,Greenfeld; Be'Eri,1,0,36,35
1656244467718,MATH 103A,A02,083778,Greenfeld; Be'Eri,1,0,36,35
1656244467718,MATH 103A,A03,093561,Staff,5,0,36,31
1656244467718,MATH 103A,B01,083779,Greenfeld; Be'Eri,8,0,36,28
1656244467718,MATH 103A,B02,083780,Greenfeld; Be'Eri,1,0,36,35
1656244467718,MATH 103A,B03,093562,Staff,0,0,36,36
1656244473746,MATH 105,A01,085443,Carter; Anne Toulson,5,0,35,30
1656244473746,MATH 105,A02,093477,Staff,14,0,35,21
1656244479868,MATH 109,A01,083213,Ganzberger; Geoffrey Michael,0,0,34,34
1656244479868,MATH 109,A02,083214,Ganzberger; Geoffrey Michael,0,0,34,34
1656244479868,MATH 109,A03,093478,Staff,1,0,34,33
1656244479868,MATH 109,B01,083215,Ganzberger; Geoffrey Michael,4,0,32,28
1656244479868,MATH 109,B02,083216,Ganzberger; Geoffrey Michael,1,0,32,31
1656244479868,MATH 109,B03,093479,Staff,3,0,32,29
1656244485908,MATH 142A,A01,083219,Chow; Bennett,2,0,32,30
1656244485908,MATH 142A,A02,083220,Chow; Bennett,8,0,32,24
1656244485908,MATH 142A,A03,093480,Staff,5,0,32,27
1656244485908,MATH 142A,B03,093481,Staff,3,0,32,29
1656244485908,MATH 142A,B04,093558,Staff,6,0,32,26
1656244485908,MATH 142A,B05,093559,Staff,0,0,32,32
1656244491936,MATH 193A,A01,083224,Rotar; Vladimir,0,1,34,34
1656244491936,MATH 193A,A02,083225,Rotar; Vladimir,0,0,34,34
1656244491936,MATH 193A,A03,083781,Rotar; Vladimir,0,0,34,34
1656244491936,MATH 193A,A04,083782,Rotar; Vladimir,6,0,34,28
1656244491936,MATH 193A,A05,093482,Rotar; Vladimir,0,0,34,34
1656244497969,MATH 197,001,091859,McAuley; Julian John,9999,0,9999,0
1656244497969,MATH 197,002,095566,Kedlaya; Kiran S.,9997,0,9999,2
1656244497969,MATH 197,003,095567,Xiao; Ming,9999,0,9999,0
1656244497969,MATH 197,004,095571,Perols; Johan Lars,9998,0,9999,1
1656244505062,COGS 9,A01,083615,Shannon; Kyle Michael,3,0,75,72
1656244511094,COGS 11,A01,083617,Boyle; Mary E. T.,14,0,48,34
1656244517124,COGS 13,A01,083071,Bastos; Amalia Pinkusfeld,4,0,71,67
1656244523161,COGS 14A,A01,092681,Semenuks; Arturs,1,12,100,99
1656244529187,COGS 14B,A01,083073,Cheng; Tzu-Han,7,0,63,56
1656244535214,COGS 17,A01,092677,Semenuks; Arturs,7,0,81,74
1656244541244,COGS 100,A01,083619,Allen; Michael Gordon,2,0,70,68
1656244547279,COGS 101A,A01,083621,Davis; Joshua Daniel,4,0,68,64
1656244553306,COGS 101B,A01,091572,Allen; Michael Gordon,4,0,65,61
1656244559343,COGS 101C,A01,083625,Delgado; Tania,10,0,35,25
1656244565369,COGS 107A,A01,083627,Boyle; Mary E. T.,0,0,60,60
1656244571405,COGS 118A,A01,083075,Gupta; Anjum,8,0,76,68
1656244577433,CSE 3,A50,083646,Miranda; Gregory Joseph,18,0,50,32
1656244583464,CSE 8A,A50,083650,Miranda; Gregory Joseph,2,2,56,54
1656244589492,CSE 11,A01,083080,Cao; Yingjun,0,49,40,40
1656244595524,CSE 12,A01,083652,Krause-Levy; Sophia Louisa,5,1,120,115
1656244601557,CSE 15L,A01,083654,Morris; Justin Loren,2,0,50,48
1656244601557,CSE 15L,A02,083655,Morris; Justin Loren,4,0,50,46
1656244607584,CSE 20,A01,083657,Tran; Khoa Dang,30,0,80,50
1656244613611,CSE 21,A01,095574,Bach; Quang Tran,23,0,48,25
1656244619648,CSE 30,A01,083084,Eldon; John,2,6,80,78
1656244619648,CSE 30,B01,095061,Bhaskar; Nishant,0,1,50,50
1656244625673,CSE 100,A01,083659,Cao; Yingjun,1,18,70,69
1656244631699,CSE 134B,A01,083661,Powell; Thomas Allan,5,0,100,95
1656244637732,CSE 140,A01,083663,Gungor; Onat,9,0,85,76
1656244643759,CSE 140L,A01,083088,Eldon; John,8,0,100,92
1656244649788,CSE 175,A01,083665,Kumar; Rakesh,0,0,25,25
1656244655816,CSE 190,A00,092507,Dubnov; Shlomo,3,0,20,17
1656244661850,ECE 45,A01,083139,Congero; Spencer William,1,0,75,74
1656244667883,ECE 65,A50,083695,Saad; Andrew S,9,0,30,21
1656244667883,ECE 65,A51,095125,Staff,24,0,26,2
1656244673914,ECE 109,A01,091882,Touri; Behrouz,0,1,70,70
1656244679951,ECE 180,A00,083140,Abi Samra; Nicholas Camill,1,0,30,29
1656244679951,ECE 180,B00,083141,Abi Samra; Nicholas Camill,0,4,30,30
1656244685986,MATH 10A,A01,083735,Patchell; Gregory David,0,0,30,30
1656244685986,MATH 10A,A02,083736,Patchell; Gregory David,22,0,30,8
1656244685986,MATH 10A,A03,083737,Patchell; Gregory David,16,0,30,14
1656244692020,MATH 10B,A01,083207,Lim; Seonhee,0,0,34,34
1656244692020,MATH 10B,A02,083208,Lim; Seonhee,7,0,35,28
1656244692020,MATH 10B,A03,093472,Staff,1,0,34,33
1656244692020,MATH 10B,B01,083739,Sinha; Shubham,11,0,30,19
1656244698060,MATH 18,A01,083743,Cinel; Cameron Alexander,7,0,30,23
1656244698060,MATH 18,A02,083744,Cinel; Cameron Alexander,9,0,30,21
1656244698060,MATH 18,A03,083745,Cinel; Cameron Alexander,5,0,30,25
1656244698060,MATH 18,B01,083748,Rideout; David Porter,1,0,36,35
1656244698060,MATH 18,B02,083749,Rideout; David Porter,0,0,36,36
1656244698060,MATH 18,B03,083750,Rideout; David Porter,0,0,36,36
1656244698060,MATH 18,B04,083751,Rideout; David Porter,0,1,36,36
1656244698060,MATH 18,B05,093473,Rideout; David Porter,0,0,36,36
1656244698060,MATH 18,B06,093474,Rideout; David Porter,3,0,36,33
1656244704094,MATH 20A,A01,083754,Zheng; Zequn,11,0,40,29
1656244710129,MATH 20B,A01,083756,Briones; Jor-el Thomas Caparas,0,0,36,36
1656244710129,MATH 20B,A02,083757,Briones; Jor-el Thomas Caparas,0,0,36,36
1656244710129,MATH 20B,A03,093475,Staff,0,0,36,36
1656244716167,MATH 20C,A01,083760,Briones; Jor-el Thomas Caparas,0,0,35,35
1656244716167,MATH 20C,A02,083761,Briones; Jor-el Thomas Caparas,9,1,35,26
1656244716167,MATH 20C,A03,093476,Staff,0,0,35,35
1656244716167,MATH 20C,B01,083762,Bach; Quang Tran,1,0,30,29
1656244722202,MATH 20D,A01,083765,Tran; Brian Kha,1,0,30,29
1656244722202,MATH 20D,A02,083766,Tran; Brian Kha,0,1,30,30
1656244722202,MATH 20D,A03,083767,Tran; Brian Kha,2,0,30,28
1656244728231,MATH 20E,A01,083771,Ganguly; Soumya,3,0,32,29
1656244728231,MATH 20E,A02,083772,Ganguly; Soumya,0,0,32,32
1656244728231,MATH 20E,B01,083773,Ciotti; Benjamin,16,0,35,19
1656244728231,MATH 20E,B02,083774,Ciotti; Benjamin,15,0,35,20
1656244734269,MATH 103A,A01,083777,Greenfeld; Be'Eri,1,0,36,35
1656244734269,MATH 103A,A02,083778,Greenfeld; Be'Eri,1,0,36,35
1656244734269,MATH 103A,A03,093561,Staff,5,0,36,31
1656244734269,MATH 103A,B01,083779,Greenfeld; Be'Eri,8,0,36,28
1656244734269,MATH 103A,B02,083780,Greenfeld; Be'Eri,1,0,36,35
1656244734269,MATH 103A,B03,093562,Staff,0,0,36,36
1656244740302,MATH 105,A01,085443,Carter; Anne Toulson,5,0,35,30
1656244740302,MATH 105,A02,093477,Staff,14,0,35,21
1656244746331,MATH 109,A01,083213,Ganzberger; Geoffrey Michael,0,0,34,34
1656244746331,MATH 109,A02,083214,Ganzberger; Geoffrey Michael,0,0,34,34
1656244746331,MATH 109,A03,093478,Staff,1,0,34,33
1656244746331,MATH 109,B01,083215,Ganzberger; Geoffrey Michael,4,0,32,28
1656244746331,MATH 109,B02,083216,Ganzberger; Geoffrey Michael,1,0,32,31
1656244746331,MATH 109,B03,093479,Staff,3,0,32,29
1656244752368,MATH 142A,A01,083219,Chow; Bennett,2,0,32,30
1656244752368,MATH 142A,A02,083220,Chow; Bennett,8,0,32,24
1656244752368,MATH 142A,A03,093480,Staff,5,0,32,27
1656244752368,MATH 142A,B03,093481,Staff,3,0,32,29
1656244752368,MATH 142A,B04,093558,Staff,6,0,32,26
1656244752368,MATH 142A,B05,093559,Staff,0,0,32,32
1656244758396,MATH 193A,A01,083224,Rotar; Vladimir,0,1,34,34
1656244758396,MATH 193A,A02,083225,Rotar; Vladimir,0,0,34,34
1656244758396,MATH 193A,A03,083781,Rotar; Vladimir,0,0,34,34
1656244758396,MATH 193A,A04,083782,Rotar; Vladimir,6,0,34,28
1656244758396,MATH 193A,A05,093482,Rotar; Vladimir,0,0,34,34
1656244764425,MATH 197,001,091859,McAuley; Julian John,9999,0,9999,0
1656244764425,MATH 197,002,095566,Kedlaya; Kiran S.,9997,0,9999,2
1656244764425,MATH 197,003,095567,Xiao; Ming,9999,0,9999,0
1656244764425,MATH 197,004,095571,Perols; Johan Lars,9998,0,9999,1
1656244771505,COGS 9,A01,083615,Shannon; Kyle Michael,3,0,75,72
1656244777529,COGS 11,A01,083617,Boyle; Mary E. T.,14,0,48,34
1656244783555,COGS 13,A01,083071,Bastos; Amalia Pinkusfeld,4,0,71,67
1656244789583,COGS 14A,A01,092681,Semenuks; Arturs,1,12,100,99
1656244795615,COGS 14B,A01,083073,Cheng; Tzu-Han,7,0,63,56
1656244801644,COGS 17,A01,092677,Semenuks; Arturs,7,0,81,74
1656244807670,COGS 100,A01,083619,Allen; Michael Gordon,2,0,70,68
1656244813695,COGS 101A,A01,083621,Davis; Joshua Daniel,4,0,68,64
1656244819719,COGS 101B,A01,091572,Allen; Michael Gordon,4,0,65,61
1656244825831,COGS 101C,A01,083625,Delgado; Tania,10,0,35,25
1656244831853,COGS 107A,A01,083627,Boyle; Mary E. T.,0,0,60,60
1656244837878,COGS 118A,A01,083075,Gupta; Anjum,8,0,76,68
1656244843909,CSE 3,A50,083646,Miranda; Gregory Joseph,18,0,50,32
1656244849935,CSE 8A,A50,083650,Miranda; Gregory Joseph,2,2,56,54
1656244855962,CSE 11,A01,083080,Cao; Yingjun,0,49,40,40
1656244861990,CSE 12,A01,083652,Krause-Levy; Sophia Louisa,5,1,120,115
1656244868021,CSE 15L,A01,083654,Morris; Justin Loren,2,0,50,48
1656244868021,CSE 15L,A02,083655,Morris; Justin Loren,4,0,50,46
1656244874049,CSE 20,A01,083657,Tran; Khoa Dang,30,0,80,50
1656244880078,CSE 21,A01,095574,Bach; Quang Tran,23,0,48,25
1656244886109,CSE 30,A01,083084,Eldon; John,2,6,80,78
1656244886109,CSE 30,B01,095061,Bhaskar; Nishant,0,1,50,50
1656244892134,CSE 100,A01,083659,Cao; Yingjun,1,18,70,69
1656244898159,CSE 134B,A01,083661,Powell; Thomas Allan,5,0,100,95
1656244904185,CSE 140,A01,083663,Gungor; Onat,9,0,85,76
1656244910225,CSE 140L,A01,083088,Eldon; John,8,0,100,92
1656244916253,CSE 175,A01,083665,Kumar; Rakesh,0,0,25,25
1656244922284,CSE 190,A00,092507,Dubnov; Shlomo,3,0,20,17
1656244928349,ECE 45,A01,083139,Congero; Spencer William,1,0,75,74
1656244934377,ECE 65,A50,083695,Saad; Andrew S,9,0,30,21
1656244934377,ECE 65,A51,095125,Staff,24,0,26,2
1656244940404,ECE 109,A01,091882,Touri; Behrouz,0,1,70,70
1656244946484,ECE 180,A00,083140,Abi Samra; Nicholas Camill,1,0,30,29
1656244946484,ECE 180,B00,083141,Abi Samra; Nicholas Camill,0,4,30,30
1656244952518,MATH 10A,A01,083735,Patchell; Gregory David,0,0,30,30
1656244952518,MATH 10A,A02,083736,Patchell; Gregory David,22,0,30,8
1656244952518,MATH 10A,A03,083737,Patchell; Gregory David,16,0,30,14
1656244958545,MATH 10B,A01,083207,Lim; Seonhee,0,0,34,34
1656244958545,MATH 10B,A02,083208,Lim; Seonhee,7,0,35,28
1656244958545,MATH 10B,A03,093472,Staff,1,0,34,33
1656244958545,MATH 10B,B01,083739,Sinha; Shubham,11,0,30,19
1656244964583,MATH 18,A01,083743,Cinel; Cameron Alexander,7,0,30,23
1656244964583,MATH 18,A02,083744,Cinel; Cameron Alexander,9,0,30,21
1656244964583,MATH 18,A03,083745,Cinel; Cameron Alexander,5,0,30,25
1656244964583,MATH 18,B01,083748,Rideout; David Porter,1,0,36,35
1656244964583,MATH 18,B02,083749,Rideout; David Porter,0,0,36,36
1656244964583,MATH 18,B03,083750,Rideout; David Porter,0,0,36,36
1656244964583,MATH 18,B04,083751,Rideout; David Porter,0,1,36,36
1656244964583,MATH 18,B05,093473,Rideout; David Porter,0,0,36,36
1656244964583,MATH 18,B06,093474,Rideout; David Porter,3,0,36,33
1656244970607,MATH 20A,A01,083754,Zheng; Zequn,11,0,40,29
1656244976645,MATH 20B,A01,083756,Briones; Jor-el Thomas Caparas,0,0,36,36
1656244976645,MATH 20B,A02,083757,Briones; Jor-el Thomas Caparas,0,0,36,36
1656244976645,MATH 20B,A03,093475,Staff,0,0,36,36
1656244982669,MATH 20C,A01,083760,Briones; Jor-el Thomas Caparas,0,0,35,35
1656244982669,MATH 20C,A02,083761,Briones; Jor-el Thomas Caparas,9,1,35,26
1656244982669,MATH 20C,A03,093476,Staff,0,0,35,35
1656244982669,MATH 20C,B01,083762,Bach; Quang Tran,1,0,30,29
1656244988699,MATH 20D,A01,083765,Tran; Brian Kha,1,0,30,29
1656244988699,MATH 20D,A02,083766,Tran; Brian Kha,0,1,30,30
1656244988699,MATH 20D,A03,083767,Tran; Brian Kha,2,0,30,28
1656244994732,MATH 20E,A01,083771,Ganguly; Soumya,3,0,32,29
1656244994732,MATH 20E,A02,083772,Ganguly; Soumya,0,0,32,32
1656244994732,MATH 20E,B01,083773,Ciotti; Benjamin,16,0,35,19
1656244994732,MATH 20E,B02,083774,Ciotti; Benjamin,15,0,35,20
1656245000761,MATH 103A,A01,083777,Greenfeld; Be'Eri,1,0,36,35
1656245000761,MATH 103A,A02,083778,Greenfeld; Be'Eri,1,0,36,35
1656245000761,MATH 103A,A03,093561,Staff,5,0,36,31
1656245000761,MATH 103A,B01,083779,Greenfeld; Be'Eri,8,0,36,28
1656245000761,MATH 103A,B02,083780,Greenfeld; Be'Eri,1,0,36,35
1656245000761,MATH 103A,B03,093562,Staff,0,0,36,36
1656245006792,MATH 105,A01,085443,Carter; Anne Toulson,5,0,35,30
1656245006792,MATH 105,A02,093477,Staff,14,0,35,21
1656245012818,MATH 109,A01,083213,Ganzberger; Geoffrey Michael,0,0,34,34
1656245012818,MATH 109,A02,083214,Ganzberger; Geoffrey Michael,0,0,34,34
1656245012818,MATH 109,A03,093478,Staff,1,0,34,33
1656245012818,MATH 109,B01,083215,Ganzberger; Geoffrey Michael,4,0,32,28
1656245012818,MATH 109,B02,083216,Ganzberger; Geoffrey Michael,1,0,32,31
1656245012818,MATH 109,B03,093479,Staff,3,0,32,29
1656245018846,MATH 142A,A01,083219,Chow; Bennett,2,0,32,30
1656245018846,MATH 142A,A02,083220,Chow; Bennett,8,0,32,24
1656245018846,MATH 142A,A03,093480,Staff,5,0,32,27
1656245018846,MATH 142A,B03,093481,Staff,3,0,32,29
1656245018846,MATH 142A,B04,093558,Staff,6,0,32,26
1656245018846,MATH 142A,B05,093559,Staff,0,0,32,32
1656245024896,MATH 193A,A01,083224,Rotar; Vladimir,0,1,34,34
1656245024896,MATH 193A,A02,083225,Rotar; Vladimir,0,0,34,34
1656245024896,MATH 193A,A03,083781,Rotar; Vladimir,0,0,34,34
1656245024896,MATH 193A,A04,083782,Rotar; Vladimir,6,0,34,28
1656245024896,MATH 193A,A05,093482,Rotar; Vladimir,0,0,34,34
1656245030922,MATH 197,001,091859,McAuley; Julian John,9999,0,9999,0
1656245030922,MATH 197,002,095566,Kedlaya; Kiran S.,9997,0,9999,2
1656245030922,MATH 197,003,095567,Xiao; Ming,9999,0,9999,0
1656245030922,MATH 197,004,095571,Perols; Johan Lars,9998,0,9999,1
1656245038009,COGS 9,A01,083615,Shannon; Kyle Michael,3,0,75,72
1656245044035,COGS 11,A01,083617,Boyle; Mary E. T.,14,0,48,34
1656245050066,COGS 13,A01,083071,Bastos; Amalia Pinkusfeld,4,0,71,67
1656245056100,COGS 14A,A01,092681,Semenuks; Arturs,1,12,100,99
1656245062153,COGS 14B,A01,083073,Cheng; Tzu-Han,7,0,63,56
1656245068181,COGS 17,A01,092677,Semenuks; Arturs,7,0,81,74
1656245074278,COGS 100,A01,083619,Allen; Michael Gordon,2,0,70,68
1656245080303,COGS 101A,A01,083621,Davis; Joshua Daniel,4,0,68,64
1656245086328,COGS 101B,A01,091572,Allen; Michael Gordon,4,0,65,61
1656245092351,COGS 101C,A01,083625,Delgado; Tania,10,0,35,25
1656245098374,COGS 107A,A01,083627,Boyle; Mary E. T.,0,0,60,60
1656245104402,COGS 118A,A01,083075,Gupta; Anjum,8,0,76,68
1656245110432,CSE 3,A50,083646,Miranda; Gregory Joseph,18,0,50,32
1656245116463,CSE 8A,A50,083650,Miranda; Gregory Joseph,2,2,56,54
1656245122488,CSE 11,A01,083080,Cao; Yingjun,0,49,40,40
1656245128519,CSE 12,A01,083652,Krause-Levy; Sophia Louisa,5,1,120,115
1656245134545,CSE 15L,A01,083654,Morris; Justin Loren,2,0,50,48
1656245134545,CSE 15L,A02,083655,Morris; Justin Loren,4,0,50,46
1656245140577,CSE 20,A01,083657,Tran; Khoa Dang,30,0,80,50
1656245146614,CSE 21,A01,095574,Bach; Quang Tran,23,0,48,25
1656245152647,CSE 30,A01,083084,Eldon; John,2,6,80,78
1656245152647,CSE 30,B01,095061,Bhaskar; Nishant,0,1,50,50
1656245158680,CSE 100,A01,083659,Cao; Yingjun,1,18,70,69
1656245164708,CSE 134B,A01,083661,Powell; Thomas Allan,5,0,100,95
1656245170735,CSE 140,A01,083663,Gungor; Onat,9,0,85,76
1656245176760,CSE 140L,A01,083088,Eldon; John,8,0,100,92
1656245182791,CSE 175,A01,083665,Kumar; Rakesh,0,0,25,25
1656245188816,CSE 190,A00,092507,Dubnov; Shlomo,3,0,20,17
1656245194845,ECE 45,A01,083139,Congero; Spencer William,1,0,75,74
1656245200882,ECE 65,A50,083695,Saad; Andrew S,9,0,30,21
1656245200882,ECE 65,A51,095125,Staff,24,0,26,2
1656245206915,ECE 109,A01,091882,Touri; Behrouz,0,1,70,70
1656245212942,ECE 180,A00,083140,Abi Samra; Nicholas Camill,1,0,30,29
1656245212942,ECE 180,B00,083141,Abi Samra; Nicholas Camill,0,4,30,30
1656245218984,MATH 10A,A01,083735,Patchell; Gregory David,0,0,30,30
1656245218984,MATH 10A,A02,083736,Patchell; Gregory David,22,0,30,8
1656245218984,MATH 10A,A03,083737,Patchell; Gregory David,16,0,30,14
1656245225014,MATH 10B,A01,083207,Lim; Seonhee,0,0,34,34
1656245225014,MATH 10B,A02,083208,Lim; Seonhee,7,0,35,28
1656245225014,MATH 10B,A03,093472,Staff,1,0,34,33
1656245225014,MATH 10B,B01,083739,Sinha; Shubham,11,0,30,19
1656245231065,MATH 18,A01,083743,Cinel; Cameron Alexander,7,0,30,23
1656245231065,MATH 18,A02,083744,Cinel; Cameron Alexander,9,0,30,21
1656245231065,MATH 18,A03,083745,Cinel; Cameron Alexander,5,0,30,25
1656245231065,MATH 18,B01,083748,Rideout; David Porter,1,0,36,35
1656245231065,MATH 18,B02,083749,Rideout; David Porter,0,0,36,36
1656245231065,MATH 18,B03,083750,Rideout; David Porter,0,0,36,36
1656245231065,MATH 18,B04,083751,Rideout; David Porter,0,1,36,36
1656245231065,MATH 18,B05,093473,Rideout; David Porter,0,0,36,36
1656245231065,MATH 18,B06,093474,Rideout; David Porter,3,0,36,33
1656245237101,MATH 20A,A01,083754,Zheng; Zequn,11,0,40,29
1656245243134,MATH 20B,A01,083756,Briones; Jor-el Thomas Caparas,0,0,36,36
1656245243134,MATH 20B,A02,083757,Briones; Jor-el Thomas Caparas,0,0,36,36
1656245243134,MATH 20B,A03,093475,Staff,0,0,36,36
1656245249161,MATH 20C,A01,083760,Briones; Jor-el Thomas Caparas,0,0,35,35
1656245249161,MATH 20C,A02,083761,Briones; Jor-el Thomas Caparas,9,1,35,26
1656245249161,MATH 20C,A03,093476,Staff,0,0,35,35
1656245249161,MATH 20C,B01,083762,Bach; Quang Tran,1,0,30,29
1656245255194,MATH 20D,A01,083765,Tran; Brian Kha,1,0,30,29
1656245255194,MATH 20D,A02,083766,Tran; Brian Kha,0,1,30,30
1656245255194,MATH 20D,A03,083767,Tran; Brian Kha,2,0,30,28
1656245261223,MATH 20E,A01,083771,Ganguly; Soumya,3,0,32,29
1656245261223,MATH 20E,A02,083772,Ganguly; Soumya,0,0,32,32
1656245261223,MATH 20E,B01,083773,Ciotti; Benjamin,16,0,35,19
1656245261223,MATH 20E,B02,083774,Ciotti; Benjamin,15,0,35,20
1656245267253,MATH 103A,A01,083777,Greenfeld; Be'Eri,1,0,36,35
1656245267253,MATH 103A,A02,083778,Greenfeld; Be'Eri,1,0,36,35
1656245267253,MATH 103A,A03,093561,Staff,5,0,36,31
1656245267253,MATH 103A,B01,083779,Greenfeld; Be'Eri,8,0,36,28
1656245267253,MATH 103A,B02,083780,Greenfeld; Be'Eri,1,0,36,35
1656245267253,MATH 103A,B03,093562,Staff,0,0,36,36
1656245273290,MATH 105,A01,085443,Carter; Anne Toulson,5,0,35,30
1656245273290,MATH 105,A02,093477,Staff,14,0,35,21
1656245279319,MATH 109,A01,083213,Ganzberger; Geoffrey Michael,0,0,34,34
1656245279319,MATH 109,A02,083214,Ganzberger; Geoffrey Michael,0,0,34,34
1656245279319,MATH 109,A03,093478,Staff,1,0,34,33
1656245279319,MATH 109,B01,083215,Ganzberger; Geoffrey Michael,4,0,32,28
1656245279319,MATH 109,B02,083216,Ganzberger; Geoffrey Michael,1,0,32,31
1656245279319,MATH 109,B03,093479,Staff,3,0,32,29
1656245285370,MATH 142A,A01,083219,Chow; Bennett,2,0,32,30
1656245285370,MATH 142A,A02,083220,Chow; Bennett,8,0,32,24
1656245285370,MATH 142A,A03,093480,Staff,5,0,32,27
1656245285370,MATH 142A,B03,093481,Staff,3,0,32,29
1656245285370,MATH 142A,B04,093558,Staff,6,0,32,26
1656245285370,MATH 142A,B05,093559,Staff,0,0,32,32
1656245291400,MATH 193A,A01,083224,Rotar; Vladimir,0,1,34,34
1656245291400,MATH 193A,A02,083225,Rotar; Vladimir,0,0,34,34
1656245291400,MATH 193A,A03,083781,Rotar; Vladimir,0,0,34,34
1656245291400,MATH 193A,A04,083782,Rotar; Vladimir,6,0,34,28
1656245291400,MATH 193A,A05,093482,Rotar; Vladimir,0,0,34,34
1656245297426,MATH 197,001,091859,McAuley; Julian John,9999,0,9999,0
1656245297426,MATH 197,002,095566,Kedlaya; Kiran S.,9997,0,9999,2
1656245297426,MATH 197,003,095567,Xiao; Ming,9999,0,9999,0
1656245297426,MATH 197,004,095571,Perols; Johan Lars,9998,0,9999,1
1656245304488,COGS 9,A01,083615,Shannon; Kyle Michael,3,0,75,72
1656245310521,COGS 11,A01,083617,Boyle; Mary E. T.,14,0,48,34
1656245316548,COGS 13,A01,083071,Bastos; Amalia Pinkusfeld,4,0,71,67
1656245322581,COGS 14A,A01,092681,Semenuks; Arturs,1,12,100,99
1656245328615,COGS 14B,A01,083073,Cheng; Tzu-Han,7,0,63,56
1656245334654,COGS 17,A01,092677,Semenuks; Arturs,7,0,81,74
1656245340687,COGS 100,A01,083619,Allen; Michael Gordon,2,0,70,68
1656245346725,COGS 101A,A01,083621,Davis; Joshua Daniel,4,0,68,64
1656245352757,COGS 101B,A01,091572,Allen; Michael Gordon,4,0,65,61
1656245358802,COGS 101C,A01,083625,Delgado; Tania,10,0,35,25
1656245364828,COGS 107A,A01,083627,Boyle; Mary E. T.,0,0,60,60
1656245370853,COGS 118A,A01,083075,Gupta; Anjum,8,0,76,68
1656245376888,CSE 3,A50,083646,Miranda; Gregory Joseph,18,0,50,32
1656245382921,CSE 8A,A50,083650,Miranda; Gregory Joseph,2,2,56,54
1656245388946,CSE 11,A01,083080,Cao; Yingjun,0,49,40,40
1656245394972,CSE 12,A01,083652,Krause-Levy; Sophia Louisa,5,1,120,115
1656245401004,CSE 15L,A01,083654,Morris; Justin Loren,2,0,50,48
1656245401004,CSE 15L,A02,083655,Morris; Justin Loren,4,0,50,46
1656245407033,CSE 20,A01,083657,Tran; Khoa Dang,30,0,80,50
1656245413064,CSE 21,A01,095574,Bach; Quang Tran,23,0,48,25
1656245419095,CSE 30,A01,083084,Eldon; John,2,6,80,78
1656245419095,CSE 30,B01,095061,Bhaskar; Nishant,0,1,50,50
1656245425124,CSE 100,A01,083659,Cao; Yingjun,1,18,70,69
1656245431152,CSE 134B,A01,083661,Powell; Thomas Allan,5,0,100,95
1656245437185,CSE 140,A01,083663,Gungor; Onat,9,0,85,76
1656245443212,CSE 140L,A01,083088,Eldon; John,8,0,100,92
1656245449248,CSE 175,A01,083665,Kumar; Rakesh,0,0,25,25
1656245455275,CSE 190,A00,092507,Dubnov; Shlomo,3,0,20,17
1656245461308,ECE 45,A01,083139,Congero; Spencer William,1,0,75,74
1656245467338,ECE 65,A50,083695,Saad; Andrew S,9,0,30,21
1656245467338,ECE 65,A51,095125,Staff,24,0,26,2
1656245473370,ECE 109,A01,091882,Touri; Behrouz,0,1,70,70
1656245479394,ECE 180,A00,083140,Abi Samra; Nicholas Camill,1,0,30,29
1656245479394,ECE 180,B00,083141,Abi Samra; Nicholas Camill,0,4,30,30
1656245485422,MATH 10A,A01,083735,Patchell; Gregory David,0,0,30,30
1656245485422,MATH 10A,A02,083736,Patchell; Gregory David,22,0,30,8
1656245485422,MATH 10A,A03,083737,Patchell; Gregory David,16,0,30,14
1656245491456,MATH 10B,A01,083207,Lim; Seonhee,0,0,34,34
1656245491456,MATH 10B,A02,083208,Lim; Seonhee,7,0,35,28
1656245491456,MATH 10B,A03,093472,Staff,1,0,34,33
1656245491456,MATH 10B,B01,083739,Sinha; Shubham,11,0,30,19
1656245497485,MATH 18,A01,083743,Cinel; Cameron Alexander,7,0,30,23
1656245497485,MATH 18,A02,083744,Cinel; Cameron Alexander,9,0,30,21
1656245497485,MATH 18,A03,083745,Cinel; Cameron Alexander,5,0,30,25
1656245497485,MATH 18,B01,083748,Rideout; David Porter,1,0,36,35
1656245497485,MATH 18,B02,083749,Rideout; David Porter,0,0,36,36
1656245497485,MATH 18,B03,083750,Rideout; David Porter,0,0,36,36
1656245497485,MATH 18,B04,083751,Rideout; David Porter,0,1,36,36
1656245497485,MATH 18,B05,093473,Rideout; David Porter,0,0,36,36
1656245497485,MATH 18,B06,093474,Rideout; David Porter,3,0,36,33
1656245503509,MATH 20A,A01,083754,Zheng; Zequn,11,0,40,29
1656245509535,MATH 20B,A01,083756,Briones; Jor-el Thomas Caparas,0,0,36,36
1656245509535,MATH 20B,A02,083757,Briones; Jor-el Thomas Caparas,0,0,36,36
1656245509535,MATH 20B,A03,093475,Staff,0,0,36,36
1656245515561,MATH 20C,A01,083760,Briones; Jor-el Thomas Caparas,0,0,35,35
1656245515561,MATH 20C,A02,083761,Briones; Jor-el Thomas Caparas,9,1,35,26
1656245515561,MATH 20C,A03,093476,Staff,0,0,35,35
1656245515561,MATH 20C,B01,083762,Bach; Quang Tran,1,0,30,29
1656245521593,MATH 20D,A01,083765,Tran; Brian Kha,1,0,30,29
1656245521593,MATH 20D,A02,083766,Tran; Brian Kha,0,1,30,30
1656245521593,MATH 20D,A03,083767,Tran; Brian Kha,2,0,30,28
1656245527619,MATH 20E,A01,083771,Ganguly; Soumya,3,0,32,29
1656245527619,MATH 20E,A02,083772,Ganguly; Soumya,0,0,32,32
1656245527619,MATH 20E,B01,083773,Ciotti; Benjamin,16,0,35,19
1656245527619,MATH 20E,B02,083774,Ciotti; Benjamin,15,0,35,20
1656245533655,MATH 103A,A01,083777,Greenfeld; Be'Eri,1,0,36,35
1656245533655,MATH 103A,A02,083778,Greenfeld; Be'Eri,1,0,36,35
1656245533655,MATH 103A,A03,093561,Staff,5,0,36,31
1656245533655,MATH 103A,B01,083779,Greenfeld; Be'Eri,8,0,36,28
1656245533655,MATH 103A,B02,083780,Greenfeld; Be'Eri,1,0,36,35
1656245533655,MATH 103A,B03,093562,Staff,0,0,36,36
1656245539681,MATH 105,A01,085443,Carter; Anne Toulson,5,0,35,30
1656245539681,MATH 105,A02,093477,Staff,14,0,35,21
1656245545708,MATH 109,A01,083213,Ganzberger; Geoffrey Michael,0,0,34,34
1656245545708,MATH 109,A02,083214,Ganzberger; Geoffrey Michael,0,0,34,34
1656245545708,MATH 109,A03,093478,Staff,1,0,34,33
1656245545708,MATH 109,B01,083215,Ganzberger; Geoffrey Michael,4,0,32,28
1656245545708,MATH 109,B02,083216,Ganzberger; Geoffrey Michael,1,0,32,31
1656245545708,MATH 109,B03,093479,Staff,3,0,32,29
1656245551747,MATH 142A,A01,083219,Chow; Bennett,2,0,32,30
1656245551747,MATH 142A,A02,083220,Chow; Bennett,8,0,32,24
1656245551747,MATH 142A,A03,093480,Staff,5,0,32,27
1656245551747,MATH 142A,B03,093481,Staff,3,0,32,29
1656245551747,MATH 142A,B04,093558,Staff,6,0,32,26
1656245551747,MATH 142A,B05,093559,Staff,0,0,32,32
1656245557773,MATH 193A,A01,083224,Rotar; Vladimir,0,1,34,34
1656245557773,MATH 193A,A02,083225,Rotar; Vladimir,0,0,34,34
1656245557773,MATH 193A,A03,083781,Rotar; Vladimir,0,0,34,34
1656245557773,MATH 193A,A04,083782,Rotar; Vladimir,6,0,34,28
1656245557773,MATH 193A,A05,093482,Rotar; Vladimir,0,0,34,34
1656245563799,MATH 197,001,091859,McAuley; Julian John,9999,0,9999,0
1656245563799,MATH 197,002,095566,Kedlaya; Kiran S.,9997,0,9999,2
1656245563799,MATH 197,003,095567,Xiao; Ming,9999,0,9999,0
1656245563799,MATH 197,004,095571,Perols; Johan Lars,9998,0,9999,1
1656245570875,COGS 9,A01,083615,Shannon; Kyle Michael,3,0,75,72
1656245576902,COGS 11,A01,083617,Boyle; Mary E. T.,14,0,48,34
1656245582931,COGS 13,A01,083071,Bastos; Amalia Pinkusfeld,4,0,71,67
1656245588965,COGS 14A,A01,092681,Semenuks; Arturs,1,12,100,99
1656245594989,COGS 14B,A01,083073,Cheng; Tzu-Han,7,0,63,56
1656245601020,COGS 17,A01,092677,Semenuks; Arturs,7,0,81,74
1656245607045,COGS 100,A01,083619,Allen; Michael Gordon,2,0,70,68
1656245613078,COGS 101A,A01,083621,Davis; Joshua Daniel,4,0,68,64
1656245619107,COGS 101B,A01,091572,Allen; Michael Gordon,4,0,65,61
1656245625135,COGS 101C,A01,083625,Delgado; Tania,10,0,35,25
1656245631160,COGS 107A,A01,083627,Boyle; Mary E. T.,0,0,60,60
1656245637186,COGS 118A,A01,083075,Gupta; Anjum,8,0,76,68
1656245643215,CSE 3,A50,083646,Miranda; Gregory Joseph,18,0,50,32
1656245649245,CSE 8A,A50,083650,Miranda; Gregory Joseph,2,2,56,54
1656245655283,CSE 11,A01,083080,Cao; Yingjun,0,49,40,40
1656245661309,CSE 12,A01,083652,Krause-Levy; Sophia Louisa,5,1,120,115
1656245667340,CSE 15L,A01,083654,Morris; Justin Loren,2,0,50,48
1656245667340,CSE 15L,A02,083655,Morris; Justin Loren,4,0,50,46
1656245673464,CSE 20,A01,083657,Tran; Khoa Dang,30,0,80,50
1656245679498,CSE 21,A01,095574,Bach; Quang Tran,23,0,48,25
1656245685524,CSE 30,A01,083084,Eldon; John,2,6,80,78
1656245685524,CSE 30,B01,095061,Bhaskar; Nishant,0,1,50,50
1656245691550,CSE 100,A01,083659,Cao; Yingjun,1,18,70,69
1656245697576,CSE 134B,A01,083661,Powell; Thomas Allan,5,0,100,95
1656245703607,CSE 140,A01,083663,Gungor; Onat,9,0,85,76
1656245709636,CSE 140L,A01,083088,Eldon; John,8,0,100,92
1656245715667,CSE 175,A01,083665,Kumar; Rakesh,0,0,25,25
1656245721694,CSE 190,A00,092507,Dubnov; Shlomo,3,0,20,17
1656245727722,ECE 45,A01,083139,Congero; Spencer William,1,0,75,74
1656245733758,ECE 65,A50,083695,Saad; Andrew S,9,0,30,21
1656245733758,ECE 65,A51,095125,Staff,24,0,26,2
1656245739784,ECE 109,A01,091882,Touri; Behrouz,0,1,70,70
1656245745825,ECE 180,A00,083140,Abi Samra; Nicholas Camill,1,0,30,29
1656245745825,ECE 180,B00,083141,Abi Samra; Nicholas Camill,0,4,30,30
1656245751868,MATH 10A,A01,083735,Patchell; Gregory David,0,0,30,30
1656245751868,MATH 10A,A02,083736,Patchell; Gregory David,22,0,30,8
1656245751868,MATH 10A,A03,083737,Patchell; Gregory David,16,0,30,14
1656245757911,MATH 10B,A01,083207,Lim; Seonhee,0,0,34,34
1656245757911,MATH 10B,A02,083208,Lim; Seonhee,7,0,35,28
1656245757911,MATH 10B,A03,093472,Staff,1,0,34,33
1656245757911,MATH 10B,B01,083739,Sinha; Shubham,11,0,30,19
1656245763955,MATH 18,A01,083743,Cinel; Cameron Alexander,7,0,30,23
1656245763955,MATH 18,A02,083744,Cinel; Cameron Alexander,9,0,30,21
1656245763955,MATH 18,A03,083745,Cinel; Cameron Alexander,5,0,30,25
1656245763955,MATH 18,B01,083748,Rideout; David Porter,1,0,36,35
1656245763955,MATH 18,B02,083749,Rideout; David Porter,0,0,36,36
1656245763955,MATH 18,B03,083750,Rideout; David Porter,0,0,36,36
1656245763955,MATH 18,B04,083751,Rideout; David Porter,0,1,36,36
1656245763955,MATH 18,B05,093473,Rideout; David Porter,0,0,36,36
1656245763955,MATH 18,B06,093474,Rideout; David Porter,3,0,36,33
1656245769986,MATH 20A,A01,083754,Zheng; Zequn,11,0,40,29
1656245776016,MATH 20B,A01,083756,Briones; Jor-el Thomas Caparas,0,0,36,36
1656245776016,MATH 20B,A02,083757,Briones; Jor-el Thomas Caparas,0,0,36,36
1656245776016,MATH 20B,A03,093475,Staff,0,0,36,36
1656245782043,MATH 20C,A01,083760,Briones; Jor-el Thomas Caparas,0,0,35,35
1656245782043,MATH 20C,A02,083761,Briones; Jor-el Thomas Caparas,9,1,35,26
1656245782043,MATH 20C,A03,093476,Staff,0,0,35,35
1656245782043,MATH 20C,B01,083762,Bach; Quang Tran,1,0,30,29
1656245788069,MATH 20D,A01,083765,Tran; Brian Kha,1,0,30,29
1656245788069,MATH 20D,A02,083766,Tran; Brian Kha,0,1,30,30
1656245788069,MATH 20D,A03,083767,Tran; Brian Kha,2,0,30,28
1656245794097,MATH 20E,A01,083771,Ganguly; Soumya,3,0,32,29
1656245794097,MATH 20E,A02,083772,Ganguly; Soumya,0,0,32,32
1656245794097,MATH 20E,B01,083773,Ciotti; Benjamin,16,0,35,19
1656245794097,MATH 20E,B02,083774,Ciotti; Benjamin,15,0,35,20
1656245800132,MATH 103A,A01,083777,Greenfeld; Be'Eri,1,0,36,35
1656245800132,MATH 103A,A02,083778,Greenfeld; Be'Eri,1,0,36,35
1656245800132,MATH 103A,A03,093561,Staff,5,0,36,31
1656245800132,MATH 103A,B01,083779,Greenfeld; Be'Eri,8,0,36,28
1656245800132,MATH 103A,B02,083780,Greenfeld; Be'Eri,1,0,36,35
1656245800132,MATH 103A,B03,093562,Staff,0,0,36,36
1656245806171,MATH 105,A01,085443,Carter; Anne Toulson,5,0,35,30
1656245806171,MATH 105,A02,093477,Staff,14,0,35,21
1656245812208,MATH 109,A01,083213,Ganzberger; Geoffrey Michael,0,0,34,34
1656245812208,MATH 109,A02,083214,Ganzberger; Geoffrey Michael,0,0,34,34
1656245812208,MATH 109,A03,093478,Staff,1,0,34,33
1656245812208,MATH 109,B01,083215,Ganzberger; Geoffrey Michael,4,0,32,28
1656245812208,MATH 109,B02,083216,Ganzberger; Geoffrey Michael,1,0,32,31
1656245812208,MATH 109,B03,093479,Staff,3,0,32,29
1656245818235,MATH 142A,A01,083219,Chow; Bennett,2,0,32,30
1656245818235,MATH 142A,A02,083220,Chow; Bennett,8,0,32,24
1656245818235,MATH 142A,A03,093480,Staff,5,0,32,27
1656245818235,MATH 142A,B03,093481,Staff,3,0,32,29
1656245818235,MATH 142A,B04,093558,Staff,6,0,32,26
1656245818235,MATH 142A,B05,093559,Staff,0,0,32,32
1656245824262,MATH 193A,A01,083224,Rotar; Vladimir,0,1,34,34
1656245824262,MATH 193A,A02,083225,Rotar; Vladimir,0,0,34,34
1656245824262,MATH 193A,A03,083781,Rotar; Vladimir,0,0,34,34
1656245824262,MATH 193A,A04,083782,Rotar; Vladimir,6,0,34,28
1656245824262,MATH 193A,A05,093482,Rotar; Vladimir,0,0,34,34
1656245830290,MATH 197,001,091859,McAuley; Julian John,9999,0,9999,0
1656245830290,MATH 197,002,095566,Kedlaya; Kiran S.,9997,0,9999,2
1656245830290,MATH 197,003,095567,Xiao; Ming,9999,0,9999,0
1656245830290,MATH 197,004,095571,Perols; Johan Lars,9998,0,9999,1
1656245837364,COGS 9,A01,083615,Shannon; Kyle Michael,3,0,75,72
1656245843389,COGS 11,A01,083617,Boyle; Mary E. T.,14,0,48,34
1656245849416,COGS 13,A01,083071,Bastos; Amalia Pinkusfeld,4,0,71,67
1656245855443,COGS 14A,A01,092681,Semenuks; Arturs,1,12,100,99
1656245861469,COGS 14B,A01,083073,Cheng; Tzu-Han,7,0,63,56
1656245867497,COGS 17,A01,092677,Semenuks; Arturs,7,0,81,74
1656245873529,COGS 100,A01,083619,Allen; Michael Gordon,2,0,70,68
1656245879555,COGS 101A,A01,083621,Davis; Joshua Daniel,4,0,68,64
1656245885593,COGS 101B,A01,091572,Allen; Michael Gordon,4,0,65,61
1656245891620,COGS 101C,A01,083625,Delgado; Tania,10,0,35,25
1656245897648,COGS 107A,A01,083627,Boyle; Mary E. T.,0,0,60,60
1656245903675,COGS 118A,A01,083075,Gupta; Anjum,8,0,76,68
1656245909703,CSE 3,A50,083646,Miranda; Gregory Joseph,18,0,50,32
1656245915728,CSE 8A,A50,083650,Miranda; Gregory Joseph,2,2,56,54
1656245921753,CSE 11,A01,083080,Cao; Yingjun,0,49,40,40
1656245927779,CSE 12,A01,083652,Krause-Levy; Sophia Louisa,5,1,120,115
1656245933806,CSE 15L,A01,083654,Morris; Justin Loren,2,0,50,48
1656245933806,CSE 15L,A02,083655,Morris; Justin Loren,4,0,50,46
1656245939848,CSE 20,A01,083657,Tran; Khoa Dang,30,0,80,50
1656245945879,CSE 21,A01,095574,Bach; Quang Tran,23,0,48,25
1656245951913,CSE 30,A01,083084,Eldon; John,2,6,80,78
1656245951913,CSE 30,B01,095061,Bhaskar; Nishant,0,1,50,50
1656245957944,CSE 100,A01,083659,Cao; Yingjun,1,18,70,69
1656245963975,CSE 134B,A01,083661,Powell; Thomas Allan,5,0,100,95
1656245970006,CSE 140,A01,083663,Gungor; Onat,9,0,85,76
1656245976038,CSE 140L,A01,083088,Eldon; John,8,0,100,92
1656245982065,CSE 175,A01,083665,Kumar; Rakesh,0,0,25,25
1656245988091,CSE 190,A00,092507,Dubnov; Shlomo,3,0,20,17
1656245994123,ECE 45,A01,083139,Congero; Spencer William,1,0,75,74
1656246000157,ECE 65,A50,083695,Saad; Andrew S,9,0,30,21
1656246000157,ECE 65,A51,095125,Staff,24,0,26,2
1656246006189,ECE 109,A01,091882,Touri; Behrouz,0,1,70,70
1656246012222,ECE 180,A00,083140,Abi Samra; Nicholas Camill,1,0,30,29
1656246012222,ECE 180,B00,083141,Abi Samra; Nicholas Camill,0,4,30,30
1656246018250,MATH 10A,A01,083735,Patchell; Gregory David,0,0,30,30
1656246018250,MATH 10A,A02,083736,Patchell; Gregory David,22,0,30,8
1656246018250,MATH 10A,A03,083737,Patchell; Gregory David,16,0,30,14
1656246024279,MATH 10B,A01,083207,Lim; Seonhee,0,0,34,34
1656246024279,MATH 10B,A02,083208,Lim; Seonhee,7,0,35,28
1656246024279,MATH 10B,A03,093472,Staff,1,0,34,33
1656246024279,MATH 10B,B01,083739,Sinha; Shubham,11,0,30,19
1656246030312,MATH 18,A01,083743,Cinel; Cameron Alexander,7,0,30,23
1656246030312,MATH 18,A02,083744,Cinel; Cameron Alexander,9,0,30,21
1656246030312,MATH 18,A03,083745,Cinel; Cameron Alexander,5,0,30,25
1656246030312,MATH 18,B01,083748,Rideout; David Porter,1,0,36,35
1656246030312,MATH 18,B02,083749,Rideout; David Porter,0,0,36,36
1656246030312,MATH 18,B03,083750,Rideout; David Porter,0,0,36,36
1656246030312,MATH 18,B04,083751,Rideout; David Porter,0,1,36,36
1656246030312,MATH 18,B05,093473,Rideout; David Porter,0,0,36,36
1656246030312,MATH 18,B06,093474,Rideout; David Porter,3,0,36,33
1656246036341,MATH 20A,A01,083754,Zheng; Zequn,11,0,40,29
1656246042375,MATH 20B,A01,083756,Briones; Jor-el Thomas Caparas,0,0,36,36
1656246042375,MATH 20B,A02,083757,Briones; Jor-el Thomas Caparas,0,0,36,36
1656246042375,MATH 20B,A03,093475,Staff,0,0,36,36
1656246048409,MATH 20C,A01,083760,Briones; Jor-el Thomas Caparas,0,0,35,35
1656246048409,MATH 20C,A02,083761,Briones; Jor-el Thomas Caparas,9,1,35,26
1656246048409,MATH 20C,A03,093476,Staff,0,0,35,35
1656246048409,MATH 20C,B01,083762,Bach; Quang Tran,1,0,30,29
1656246054435,MATH 20D,A01,083765,Tran; Brian Kha,1,0,30,29
1656246054435,MATH 20D,A02,083766,Tran; Brian Kha,0,1,30,30
1656246054435,MATH 20D,A03,083767,Tran; Brian Kha,2,0,30,28
1656246060474,MATH 20E,A01,083771,Ganguly; Soumya,3,0,32,29
1656246060474,MATH 20E,A02,083772,Ganguly; Soumya,0,0,32,32
1656246060474,MATH 20E,B01,083773,Ciotti; Benjamin,16,0,35,19
1656246060474,MATH 20E,B02,083774,Ciotti; Benjamin,15,0,35,20
1656246066509,MATH 103A,A01,083777,Greenfeld; Be'Eri,1,0,36,35
1656246066509,MATH 103A,A02,083778,Greenfeld; Be'Eri,1,0,36,35
1656246066509,MATH 103A,A03,093561,Staff,5,0,36,31
1656246066509,MATH 103A,B01,083779,Greenfeld; Be'Eri,8,0,36,28
1656246066509,MATH 103A,B02,083780,Greenfeld; Be'Eri,1,0,36,35
1656246066509,MATH 103A,B03,093562,Staff,0,0,36,36
1656246072541,MATH 105,A01,085443,Carter; Anne Toulson,5,0,35,30
1656246072541,MATH 105,A02,093477,Staff,14,0,35,21
1656246078579,MATH 109,A01,083213,Ganzberger; Geoffrey Michael,0,0,34,34
1656246078579,MATH 109,A02,083214,Ganzberger; Geoffrey Michael,0,0,34,34
1656246078579,MATH 109,A03,093478,Staff,1,0,34,33
1656246078579,MATH 109,B01,083215,Ganzberger; Geoffrey Michael,4,0,32,28
1656246078579,MATH 109,B02,083216,Ganzberger; Geoffrey Michael,1,0,32,31
1656246078579,MATH 109,B03,093479,Staff,3,0,32,29
1656246084607,MATH 142A,A01,083219,Chow; Bennett,2,0,32,30
1656246084607,MATH 142A,A02,083220,Chow; Bennett,8,0,32,24
1656246084607,MATH 142A,A03,093480,Staff,5,0,32,27
1656246084607,MATH 142A,B03,093481,Staff,3,0,32,29
1656246084607,MATH 142A,B04,093558,Staff,6,0,32,26
1656246084607,MATH 142A,B05,093559,Staff,0,0,32,32
1656246090644,MATH 193A,A01,083224,Rotar; Vladimir,0,1,34,34
1656246090644,MATH 193A,A02,083225,Rotar; Vladimir,0,0,34,34
1656246090644,MATH 193A,A03,083781,Rotar; Vladimir,0,0,34,34
1656246090644,MATH 193A,A04,083782,Rotar; Vladimir,6,0,34,28
1656246090644,MATH 193A,A05,093482,Rotar; Vladimir,0,0,34,34
1656246096670,MATH 197,001,091859,McAuley; Julian John,9999,0,9999,0
1656246096670,MATH 197,002,095566,Kedlaya; Kiran S.,9997,0,9999,2
1656246096670,MATH 197,003,095567,Xiao; Ming,9999,0,9999,0
1656246096670,MATH 197,004,095571,Perols; Johan Lars,9998,0,9999,1
1656246103734,COGS 9,A01,083615,Shannon; Kyle Michael,3,0,75,72
1656246109761,COGS 11,A01,083617,Boyle; Mary E. T.,14,0,48,34
1656246115787,COGS 13,A01,083071,Bastos; Amalia Pinkusfeld,4,0,71,67
1656246121818,COGS 14A,A01,092681,Semenuks; Arturs,1,12,100,99
1656246127847,COGS 14B,A01,083073,Cheng; Tzu-Han,7,0,63,56
1656246133874,COGS 17,A01,092677,Semenuks; Arturs,7,0,81,74
1656246139901,COGS 100,A01,083619,Allen; Michael Gordon,2,0,70,68
1656246145936,COGS 101A,A01,083621,Davis; Joshua Daniel,4,0,68,64
1656246151967,COGS 101B,A01,091572,Allen; Michael Gordon,4,0,65,61
1656246157994,COGS 101C,A01,083625,Delgado; Tania,10,0,35,25
1656246164020,COGS 107A,A01,083627,Boyle; Mary E. T.,0,0,60,60
1656246170046,COGS 118A,A01,083075,Gupta; Anjum,8,0,76,68
1656246176073,CSE 3,A50,083646,Miranda; Gregory Joseph,18,0,50,32
1656246182099,CSE 8A,A50,083650,Miranda; Gregory Joseph,2,2,56,54
1656246188130,CSE 11,A01,083080,Cao; Yingjun,0,49,40,40
1656246194160,CSE 12,A01,083652,Krause-Levy; Sophia Louisa,5,1,120,115
1656246200189,CSE 15L,A01,083654,Morris; Justin Loren,2,0,50,48
1656246200189,CSE 15L,A02,083655,Morris; Justin Loren,4,0,50,46
1656246206213,CSE 20,A01,083657,Tran; Khoa Dang,30,0,80,50
1656246212239,CSE 21,A01,095574,Bach; Quang Tran,23,0,48,25
1656246218266,CSE 30,A01,083084,Eldon; John,2,6,80,78
1656246218266,CSE 30,B01,095061,Bhaskar; Nishant,0,1,50,50
1656246224291,CSE 100,A01,083659,Cao; Yingjun,1,18,70,69
1656246230316,CSE 134B,A01,083661,Powell; Thomas Allan,5,0,100,95
1656246236341,CSE 140,A01,083663,Gungor; Onat,9,0,85,76
1656246242366,CSE 140L,A01,083088,Eldon; John,8,0,100,92
1656246248393,CSE 175,A01,083665,Kumar; Rakesh,0,0,25,25
1656246254420,CSE 190,A00,092507,Dubnov; Shlomo,3,0,20,17
1656246260449,ECE 45,A01,083139,Congero; Spencer William,1,0,75,74
1656246266480,ECE 65,A50,083695,Saad; Andrew S,9,0,30,21
1656246266480,ECE 65,A51,095125,Staff,24,0,26,2
1656246272594,ECE 109,A01,091882,Touri; Behrouz,0,1,70,70
1656246278623,ECE 180,A00,083140,Abi Samra; Nicholas Camill,1,0,30,29
1656246278623,ECE 180,B00,083141,Abi Samra; Nicholas Camill,0,4,30,30
1656246284657,MATH 10A,A01,083735,Patchell; Gregory David,0,0,30,30
1656246284657,MATH 10A,A02,083736,Patchell; Gregory David,22,0,30,8
1656246284657,MATH 10A,A03,083737,Patchell; Gregory David,16,0,30,14
1656246290685,MATH 10B,A01,083207,Lim; Seonhee,0,0,34,34
1656246290685,MATH 10B,A02,083208,Lim; Seonhee,7,0,35,28
1656246290685,MATH 10B,A03,093472,Staff,1,0,34,33
1656246290685,MATH 10B,B01,083739,Sinha; Shubham,11,0,30,19
1656246296712,MATH 18,A01,083743,Cinel; Cameron Alexander,7,0,30,23
1656246296712,MATH 18,A02,083744,Cinel; Cameron Alexander,9,0,30,21
1656246296712,MATH 18,A03,083745,Cinel; Cameron Alexander,5,0,30,25
1656246296712,MATH 18,B01,083748,Rideout; David Porter,1,0,36,35
1656246296712,MATH 18,B02,083749,Rideout; David Porter,0,0,36,36
1656246296712,MATH 18,B03,083750,Rideout; David Porter,0,0,36,36
1656246296712,MATH 18,B04,083751,Rideout; David Porter,0,1,36,36
1656246296712,MATH 18,B05,093473,Rideout; David Porter,0,0,36,36
1656246296712,MATH 18,B06,093474,Rideout; David Porter,3,0,36,33
1656246302735,MATH 20A,A01,083754,Zheng; Zequn,11,0,40,29
1656246308769,MATH 20B,A01,083756,Briones; Jor-el Thomas Caparas,0,0,36,36
1656246308769,MATH 20B,A02,083757,Briones; Jor-el Thomas Caparas,0,0,36,36
1656246308769,MATH 20B,A03,093475,Staff,0,0,36,36
1656246314805,MATH 20C,A01,083760,Briones; Jor-el Thomas Caparas,0,0,35,35
1656246314805,MATH 20C,A02,083761,Briones; Jor-el Thomas Caparas,9,1,35,26
1656246314805,MATH 20C,A03,093476,Staff,0,0,35,35
1656246314805,MATH 20C,B01,083762,Bach; Quang Tran,1,0,30,29
1656246320830,MATH 20D,A01,083765,Tran; Brian Kha,1,0,30,29
1656246320830,MATH 20D,A02,083766,Tran; Brian Kha,0,1,30,30
1656246320830,MATH 20D,A03,083767,Tran; Brian Kha,2,0,30,28
1656246326867,MATH 20E,A01,083771,Ganguly; Soumya,3,0,32,29
1656246326867,MATH 20E,A02,083772,Ganguly; Soumya,0,0,32,32
1656246326867,MATH 20E,B01,083773,Ciotti; Benjamin,16,0,35,19
1656246326867,MATH 20E,B02,083774,Ciotti; Benjamin,15,0,35,20
1656246332902,MATH 103A,A01,083777,Greenfeld; Be'Eri,1,0,36,35
1656246332902,MATH 103A,A02,083778,Greenfeld; Be'Eri,1,0,36,35
1656246332902,MATH 103A,A03,093561,Staff,5,0,36,31
1656246332902,MATH 103A,B01,083779,Greenfeld; Be'Eri,8,0,36,28
1656246332902,MATH 103A,B02,083780,Greenfeld; Be'Eri,1,0,36,35
1656246332902,MATH 103A,B03,093562,Staff,0,0,36,36
1656246338928,MATH 105,A01,085443,Carter; Anne Toulson,5,0,35,30
1656246338928,MATH 105,A02,093477,Staff,14,0,35,21
1656246344954,MATH 109,A01,083213,Ganzberger; Geoffrey Michael,0,0,34,34
1656246344954,MATH 109,A02,083214,Ganzberger; Geoffrey Michael,0,0,34,34
1656246344954,MATH 109,A03,093478,Staff,1,0,34,33
1656246344954,MATH 109,B01,083215,Ganzberger; Geoffrey Michael,4,0,32,28
1656246344954,MATH 109,B02,083216,Ganzberger; Geoffrey Michael,1,0,32,31
1656246344954,MATH 109,B03,093479,Staff,3,0,32,29
1656246350979,MATH 142A,A01,083219,Chow; Bennett,2,0,32,30
1656246350979,MATH 142A,A02,083220,Chow; Bennett,8,0,32,24
1656246350979,MATH 142A,A03,093480,Staff,5,0,32,27
1656246350979,MATH 142A,B03,093481,Staff,3,0,32,29
1656246350979,MATH 142A,B04,093558,Staff,6,0,32,26
1656246350979,MATH 142A,B05,093559,Staff,0,0,32,32
1656246357004,MATH 193A,A01,083224,Rotar; Vladimir,0,1,34,34
1656246357004,MATH 193A,A02,083225,Rotar; Vladimir,0,0,34,34
1656246357004,MATH 193A,A03,083781,Rotar; Vladimir,0,0,34,34
1656246357004,MATH 193A,A04,083782,Rotar; Vladimir,6,0,34,28
1656246357004,MATH 193A,A05,093482,Rotar; Vladimir,0,0,34,34
1656246363028,MATH 197,001,091859,McAuley; Julian John,9999,0,9999,0
1656246363028,MATH 197,002,095566,Kedlaya; Kiran S.,9997,0,9999,2
1656246363028,MATH 197,003,095567,Xiao; Ming,9999,0,9999,0
1656246363028,MATH 197,004,095571,Perols; Johan Lars,9998,0,9999,1
1656246370094,COGS 9,A01,083615,Shannon; Kyle Michael,3,0,75,72
1656246376119,COGS 11,A01,083617,Boyle; Mary E. T.,14,0,48,34
1656246382144,COGS 13,A01,083071,Bastos; Amalia Pinkusfeld,4,0,71,67
1656246388171,COGS 14A,A01,092681,Semenuks; Arturs,1,12,100,99
1656246394206,COGS 14B,A01,083073,Cheng; Tzu-Han,7,0,63,56
1656246400230,COGS 17,A01,092677,Semenuks; Arturs,7,0,81,74
1656246406260,COGS 100,A01,083619,Allen; Michael Gordon,2,0,70,68
1656246412289,COGS 101A,A01,083621,Davis; Joshua Daniel,4,0,68,64
1656246418315,COGS 101B,A01,091572,Allen; Michael Gordon,4,0,65,61
1656246424341,COGS 101C,A01,083625,Delgado; Tania,10,0,35,25
1656246430364,COGS 107A,A01,083627,Boyle; Mary E. T.,0,0,60,60
1656246436390,COGS 118A,A01,083075,Gupta; Anjum,8,0,76,68
1656246442414,CSE 3,A50,083646,Miranda; Gregory Joseph,18,0,50,32
1656246448436,CSE 8A,A50,083650,Miranda; Gregory Joseph,2,2,56,54
1656246454464,CSE 11,A01,083080,Cao; Yingjun,0,49,40,40
1656246460488,CSE 12,A01,083652,Krause-Levy; Sophia Louisa,5,1,120,115
1656246466516,CSE 15L,A01,083654,Morris; Justin Loren,2,0,50,48
1656246466516,CSE 15L,A02,083655,Morris; Justin Loren,4,0,50,46
1656246472540,CSE 20,A01,083657,Tran; Khoa Dang,30,0,80,50
1656246478564,CSE 21,A01,095574,Bach; Quang Tran,23,0,48,25
1656246484593,CSE 30,A01,083084,Eldon; John,2,6,80,78
1656246484593,CSE 30,B01,095061,Bhaskar; Nishant,0,1,50,50
1656246490622,CSE 100,A01,083659,Cao; Yingjun,1,18,70,69
1656246496647,CSE 134B,A01,083661,Powell; Thomas Allan,5,0,100,95
1656246502671,CSE 140,A01,083663,Gungor; Onat,9,0,85,76
1656246508708,CSE 140L,A01,083088,Eldon; John,8,0,100,92
1656246514738,CSE 175,A01,083665,Kumar; Rakesh,0,0,25,25
1656246520767,CSE 190,A00,092507,Dubnov; Shlomo,3,0,20,17
1656246526795,ECE 45,A01,083139,Congero; Spencer William,1,0,75,74
1656246532820,ECE 65,A50,083695,Saad; Andrew S,9,0,30,21
1656246532820,ECE 65,A51,095125,Staff,24,0,26,2
1656246538850,ECE 109,A01,091882,Touri; Behrouz,0,1,70,70
1656246544875,ECE 180,A00,083140,Abi Samra; Nicholas Camill,1,0,30,29
1656246544875,ECE 180,B00,083141,Abi Samra; Nicholas Camill,0,4,30,30
1656246550903,MATH 10A,A01,083735,Patchell; Gregory David,0,0,30,30
1656246550903,MATH 10A,A02,083736,Patchell; Gregory David,22,0,30,8
1656246550903,MATH 10A,A03,083737,Patchell; Gregory David,16,0,30,14
1656246556941,MATH 10B,A01,083207,Lim; Seonhee,0,0,34,34
1656246556941,MATH 10B,A02,083208,Lim; Seonhee,7,0,35,28
1656246556941,MATH 10B,A03,093472,Staff,1,0,34,33
1656246556941,MATH 10B,B01,083739,Sinha; Shubham,11,0,30,19
1656246562969,MATH 18,A01,083743,Cinel; Cameron Alexander,7,0,30,23
1656246562969,MATH 18,A02,083744,Cinel; Cameron Alexander,9,0,30,21
1656246562969,MATH 18,A03,083745,Cinel; Cameron Alexander,5,0,30,25
1656246562969,MATH 18,B01,083748,Rideout; David Porter,1,0,36,35
1656246562969,MATH 18,B02,083749,Rideout; David Porter,0,0,36,36
1656246562969,MATH 18,B03,083750,Rideout; David Porter,0,0,36,36
1656246562969,MATH 18,B04,083751,Rideout; David Porter,0,1,36,36
1656246562969,MATH 18,B05,093473,Rideout; David Porter,0,0,36,36
1656246562969,MATH 18,B06,093474,Rideout; David Porter,3,0,36,33
1656246568995,MATH 20A,A01,083754,Zheng; Zequn,11,0,40,29
1656246575026,MATH 20B,A01,083756,Briones; Jor-el Thomas Caparas,0,0,36,36
1656246575026,MATH 20B,A02,083757,Briones; Jor-el Thomas Caparas,0,0,36,36
1656246575026,MATH 20B,A03,093475,Staff,0,0,36,36
1656246581050,MATH 20C,A01,083760,Briones; Jor-el Thomas Caparas,0,0,35,35
1656246581050,MATH 20C,A02,083761,Briones; Jor-el Thomas Caparas,9,1,35,26
1656246581050,MATH 20C,A03,093476,Staff,0,0,35,35
1656246581050,MATH 20C,B01,083762,Bach; Quang Tran,1,0,30,29
1656246587077,MATH 20D,A01,083765,Tran; Brian Kha,1,0,30,29
1656246587077,MATH 20D,A02,083766,Tran; Brian Kha,0,1,30,30
1656246587077,MATH 20D,A03,083767,Tran; Brian Kha,2,0,30,28
1656246593101,MATH 20E,A01,083771,Ganguly; Soumya,3,0,32,29
1656246593101,MATH 20E,A02,083772,Ganguly; Soumya,0,0,32,32
1656246593101,MATH 20E,B01,083773,Ciotti; Benjamin,16,0,35,19
1656246593101,MATH 20E,B02,083774,Ciotti; Benjamin,15,0,35,20
1656246599127,MATH 103A,A01,083777,Greenfeld; Be'Eri,1,0,36,35
1656246599127,MATH 103A,A02,083778,Greenfeld; Be'Eri,1,0,36,35
1656246599127,MATH 103A,A03,093561,Staff,5,0,36,31
1656246599127,MATH 103A,B01,083779,Greenfeld; Be'Eri,8,0,36,28
1656246599127,MATH 103A,B02,083780,Greenfeld; Be'Eri,1,0,36,35
1656246599127,MATH 103A,B03,093562,Staff,0,0,36,36
1656246605155,MATH 105,A01,085443,Carter; Anne Toulson,5,0,35,30
1656246605155,MATH 105,A02,093477,Staff,14,0,35,21
1656246611185,MATH 109,A01,083213,Ganzberger; Geoffrey Michael,0,0,34,34
1656246611185,MATH 109,A02,083214,Ganzberger; Geoffrey Michael,0,0,34,34
1656246611185,MATH 109,A03,093478,Staff,1,0,34,33
1656246611185,MATH 109,B01,083215,Ganzberger; Geoffrey Michael,4,0,32,28
1656246611185,MATH 109,B02,083216,Ganzberger; Geoffrey Michael,1,0,32,31
1656246611185,MATH 109,B03,093479,Staff,3,0,32,29
1656246617215,MATH 142A,A01,083219,Chow; Bennett,2,0,32,30
1656246617215,MATH 142A,A02,083220,Chow; Bennett,8,0,32,24
1656246617215,MATH 142A,A03,093480,Staff,5,0,32,27
1656246617215,MATH 142A,B03,093481,Staff,3,0,32,29
1656246617215,MATH 142A,B04,093558,Staff,6,0,32,26
1656246617215,MATH 142A,B05,093559,Staff,0,0,32,32
1656246623240,MATH 193A,A01,083224,Rotar; Vladimir,0,1,34,34
1656246623240,MATH 193A,A02,083225,Rotar; Vladimir,0,0,34,34
1656246623240,MATH 193A,A03,083781,Rotar; Vladimir,0,0,34,34
1656246623240,MATH 193A,A04,083782,Rotar; Vladimir,6,0,34,28
1656246623240,MATH 193A,A05,093482,Rotar; Vladimir,0,0,34,34
1656246629267,MATH 197,001,091859,McAuley; Julian John,9999,0,9999,0
1656246629267,MATH 197,002,095566,Kedlaya; Kiran S.,9997,0,9999,2
1656246629267,MATH 197,003,095567,Xiao; Ming,9999,0,9999,0
1656246629267,MATH 197,004,095571,Perols; Johan Lars,9998,0,9999,1
1656246636337,COGS 9,A01,083615,Shannon; Kyle Michael,3,0,75,72
1656246642365,COGS 11,A01,083617,Boyle; Mary E. T.,14,0,48,34
1656246648390,COGS 13,A01,083071,Bastos; Amalia Pinkusfeld,4,0,71,67
1656246654414,COGS 14A,A01,092681,Semenuks; Arturs,1,12,100,99
1656246660443,COGS 14B,A01,083073,Cheng; Tzu-Han,7,0,63,56
1656246666468,COGS 17,A01,092677,Semenuks; Arturs,7,0,81,74
1656246672493,COGS 100,A01,083619,Allen; Michael Gordon,2,0,70,68
1656246678519,COGS 101A,A01,083621,Davis; Joshua Daniel,4,0,68,64
1656246684545,COGS 101B,A01,091572,Allen; Michael Gordon,4,0,65,61
1656246690570,COGS 101C,A01,083625,Delgado; Tania,10,0,35,25
1656246696599,COGS 107A,A01,083627,Boyle; Mary E. T.,0,0,60,60
1656246702627,COGS 118A,A01,083075,Gupta; Anjum,8,0,76,68
1656246708655,CSE 3,A50,083646,Miranda; Gregory Joseph,18,0,50,32
1656246714678,CSE 8A,A50,083650,Miranda; Gregory Joseph,2,2,56,54
1656246720707,CSE 11,A01,083080,Cao; Yingjun,0,49,40,40
1656246726733,CSE 12,A01,083652,Krause-Levy; Sophia Louisa,5,1,120,115
1656246732757,CSE 15L,A01,083654,Morris; Justin Loren,2,0,50,48
1656246732757,CSE 15L,A02,083655,Morris; Justin Loren,4,0,50,46
1656246738782,CSE 20,A01,083657,Tran; Khoa Dang,30,0,80,50
1656246744815,CSE 21,A01,095574,Bach; Quang Tran,23,0,48,25
1656246750844,CSE 30,A01,083084,Eldon; John,2,6,80,78
1656246750844,CSE 30,B01,095061,Bhaskar; Nishant,0,1,50,50
1656246756875,CSE 100,A01,083659,Cao; Yingjun,1,18,70,69
1656246762899,CSE 134B,A01,083661,Powell; Thomas Allan,5,0,100,95
1656246768927,CSE 140,A01,083663,Gungor; Onat,9,0,85,76
1656246774954,CSE 140L,A01,083088,Eldon; John,8,0,100,92
1656246780978,CSE 175,A01,083665,Kumar; Rakesh,0,0,25,25
1656246787003,CSE 190,A00,092507,Dubnov; Shlomo,3,0,20,17
1656246793033,ECE 45,A01,083139,Congero; Spencer William,1,0,75,74
1656246799058,ECE 65,A50,083695,Saad; Andrew S,9,0,30,21
1656246799058,ECE 65,A51,095125,Staff,24,0,26,2
1656246805084,ECE 109,A01,091882,Touri; Behrouz,0,1,70,70
1656246811108,ECE 180,A00,083140,Abi Samra; Nicholas Camill,1,0,30,29
1656246811108,ECE 180,B00,083141,Abi Samra; Nicholas Camill,0,4,30,30
1656246817133,MATH 10A,A01,083735,Patchell; Gregory David,0,0,30,30
1656246817133,MATH 10A,A02,083736,Patchell; Gregory David,22,0,30,8
1656246817133,MATH 10A,A03,083737,Patchell; Gregory David,16,0,30,14
1656246823174,MATH 10B,A01,083207,Lim; Seonhee,0,0,34,34
1656246823174,MATH 10B,A02,083208,Lim; Seonhee,7,0,35,28
1656246823174,MATH 10B,A03,093472,Staff,1,0,34,33
1656246823174,MATH 10B,B01,083739,Sinha; Shubham,11,0,30,19
1656246829205,MATH 18,A01,083743,Cinel; Cameron Alexander,7,0,30,23
1656246829205,MATH 18,A02,083744,Cinel; Cameron Alexander,9,0,30,21
1656246829205,MATH 18,A03,083745,Cinel; Cameron Alexander,5,0,30,25
1656246829205,MATH 18,B01,083748,Rideout; David Porter,1,0,36,35
1656246829205,MATH 18,B02,083749,Rideout; David Porter,0,0,36,36
1656246829205,MATH 18,B03,083750,Rideout; David Porter,0,0,36,36
1656246829205,MATH 18,B04,083751,Rideout; David Porter,0,1,36,36
1656246829205,MATH 18,B05,093473,Rideout; David Porter,0,0,36,36
1656246829205,MATH 18,B06,093474,Rideout; David Porter,3,0,36,33
1656246835231,MATH 20A,A01,083754,Zheng; Zequn,11,0,40,29
1656246841262,MATH 20B,A01,083756,Briones; Jor-el Thomas Caparas,0,0,36,36
1656246841262,MATH 20B,A02,083757,Briones; Jor-el Thomas Caparas,0,0,36,36
1656246841262,MATH 20B,A03,093475,Staff,0,0,36,36
1656246847292,MATH 20C,A01,083760,Briones; Jor-el Thomas Caparas,0,0,35,35
1656246847292,MATH 20C,A02,083761,Briones; Jor-el Thomas Caparas,9,1,35,26
1656246847292,MATH 20C,A03,093476,Staff,0,0,35,35
1656246847292,MATH 20C,B01,083762,Bach; Quang Tran,1,0,30,29
1656246853322,MATH 20D,A01,083765,Tran; Brian Kha,1,0,30,29
1656246853322,MATH 20D,A02,083766,Tran; Brian Kha,0,1,30,30
1656246853322,MATH 20D,A03,083767,Tran; Brian Kha,2,0,30,28
1656246859350,MATH 20E,A01,083771,Ganguly; Soumya,3,0,32,29
1656246859350,MATH 20E,A02,083772,Ganguly; Soumya,0,0,32,32
1656246859350,MATH 20E,B01,083773,Ciotti; Benjamin,16,0,35,19
1656246859350,MATH 20E,B02,083774,Ciotti; Benjamin,15,0,35,20
1656246865388,MATH 103A,A01,083777,Greenfeld; Be'Eri,1,0,36,35
1656246865388,MATH 103A,A02,083778,Greenfeld; Be'Eri,1,0,36,35
1656246865388,MATH 103A,A03,093561,Staff,5,0,36,31
1656246865388,MATH 103A,B01,083779,Greenfeld; Be'Eri,8,0,36,28
1656246865388,MATH 103A,B02,083780,Greenfeld; Be'Eri,1,0,36,35
1656246865388,MATH 103A,B03,093562,Staff,0,0,36,36
1656246871502,MATH 105,A01,085443,Carter; Anne Toulson,5,0,35,30
1656246871502,MATH 105,A02,093477,Staff,14,0,35,21
1656246877528,MATH 109,A01,083213,Ganzberger; Geoffrey Michael,0,0,34,34
1656246877528,MATH 109,A02,083214,Ganzberger; Geoffrey Michael,0,0,34,34
1656246877528,MATH 109,A03,093478,Staff,1,0,34,33
1656246877528,MATH 109,B01,083215,Ganzberger; Geoffrey Michael,4,0,32,28
1656246877528,MATH 109,B02,083216,Ganzberger; Geoffrey Michael,1,0,32,31
1656246877528,MATH 109,B03,093479,Staff,3,0,32,29
1656246883554,MATH 142A,A01,083219,Chow; Bennett,2,0,32,30
1656246883554,MATH 142A,A02,083220,Chow; Bennett,8,0,32,24
1656246883554,MATH 142A,A03,093480,Staff,5,0,32,27
1656246883554,MATH 142A,B03,093481,Staff,3,0,32,29
1656246883554,MATH 142A,B04,093558,Staff,6,0,32,26
1656246883554,MATH 142A,B05,093559,Staff,0,0,32,32
1656246889590,MATH 193A,A01,083224,Rotar; Vladimir,0,1,34,34
1656246889590,MATH 193A,A02,083225,Rotar; Vladimir,0,0,34,34
1656246889590,MATH 193A,A03,083781,Rotar; Vladimir,0,0,34,34
1656246889590,MATH 193A,A04,083782,Rotar; Vladimir,6,0,34,28
1656246889590,MATH 193A,A05,093482,Rotar; Vladimir,0,0,34,34
1656246895617,MATH 197,001,091859,McAuley; Julian John,9999,0,9999,0
1656246895617,MATH 197,002,095566,Kedlaya; Kiran S.,9997,0,9999,2
1656246895617,MATH 197,003,095567,Xiao; Ming,9999,0,9999,0
1656246895617,MATH 197,004,095571,Perols; Johan Lars,9998,0,9999,1
1656246902734,COGS 9,A01,083615,Shannon; Kyle Michael,3,0,75,72
1656246908767,COGS 11,A01,083617,Boyle; Mary E. T.,14,0,48,34
1656246914806,COGS 13,A01,083071,Bastos; Amalia Pinkusfeld,4,0,71,67
1656246920833,COGS 14A,A01,092681,Semenuks; Arturs,1,12,100,99
1656246926866,COGS 14B,A01,083073,Cheng; Tzu-Han,7,0,63,56
1656246932891,COGS 17,A01,092677,Semenuks; Arturs,7,0,81,74
1656246938923,COGS 100,A01,083619,Allen; Michael Gordon,2,0,70,68
1656246944948,COGS 101A,A01,083621,Davis; Joshua Daniel,4,0,68,64
1656246950973,COGS 101B,A01,091572,Allen; Michael Gordon,4,0,65,61
1656246957000,COGS 101C,A01,083625,Delgado; Tania,10,0,35,25
1656246963026,COGS 107A,A01,083627,Boyle; Mary E. T.,0,0,60,60
1656246969052,COGS 118A,A01,083075,Gupta; Anjum,8,0,76,68
1656246975080,CSE 3,A50,083646,Miranda; Gregory Joseph,18,0,50,32
1656246981109,CSE 8A,A50,083650,Miranda; Gregory Joseph,2,2,56,54
1656246987137,CSE 11,A01,083080,Cao; Yingjun,0,49,40,40
1656246993163,CSE 12,A01,083652,Krause-Levy; Sophia Louisa,5,1,120,115
1656246999195,CSE 15L,A01,083654,Morris; Justin Loren,2,0,50,48
1656246999195,CSE 15L,A02,083655,Morris; Justin Loren,4,0,50,46
1656247005227,CSE 20,A01,083657,Tran; Khoa Dang,30,0,80,50
1656247011254,CSE 21,A01,095574,Bach; Quang Tran,23,0,48,25
1656247017284,CSE 30,A01,083084,Eldon; John,2,6,80,78
1656247017284,CSE 30,B01,095061,Bhaskar; Nishant,0,1,50,50
1656247023309,CSE 100,A01,083659,Cao; Yingjun,1,18,70,69
1656247029335,CSE 134B,A01,083661,Powell; Thomas Allan,5,0,100,95
1656247035363,CSE 140,A01,083663,Gungor; Onat,9,0,85,76
1656247041397,CSE 140L,A01,083088,Eldon; John,8,0,100,92
1656247047428,CSE 175,A01,083665,Kumar; Rakesh,0,0,25,25
1656247053460,CSE 190,A00,092507,Dubnov; Shlomo,3,0,20,17
1656247059487,ECE 45,A01,083139,Congero; Spencer William,1,0,75,74
1656247065522,ECE 65,A50,083695,Saad; Andrew S,9,0,30,21
1656247065522,ECE 65,A51,095125,Staff,24,0,26,2
1656247071554,ECE 109,A01,091882,Touri; Behrouz,0,1,70,70
1656247077578,ECE 180,A00,083140,Abi Samra; Nicholas Camill,1,0,30,29
1656247077578,ECE 180,B00,083141,Abi Samra; Nicholas Camill,0,4,30,30
1656247083611,MATH 10A,A01,083735,Patchell; Gregory David,0,0,30,30
1656247083611,MATH 10A,A02,083736,Patchell; Gregory David,22,0,30,8
1656247083611,MATH 10A,A03,083737,Patchell; Gregory David,16,0,30,14
1656247089650,MATH 10B,A01,083207,Lim; Seonhee,0,0,34,34
1656247089650,MATH 10B,A02,083208,Lim; Seonhee,7,0,35,28
1656247089650,MATH 10B,A03,093472,Staff,1,0,34,33
1656247089650,MATH 10B,B01,083739,Sinha; Shubham,11,0,30,19
1656247095690,MATH 18,A01,083743,Cinel; Cameron Alexander,7,0,30,23
1656247095690,MATH 18,A02,083744,Cinel; Cameron Alexander,9,0,30,21
1656247095690,MATH 18,A03,083745,Cinel; Cameron Alexander,5,0,30,25
1656247095690,MATH 18,B01,083748,Rideout; David Porter,1,0,36,35
1656247095690,MATH 18,B02,083749,Rideout; David Porter,0,0,36,36
1656247095690,MATH 18,B03,083750,Rideout; David Porter,0,0,36,36
1656247095690,MATH 18,B04,083751,Rideout; David Porter,0,1,36,36
1656247095690,MATH 18,B05,093473,Rideout; David Porter,0,0,36,36
1656247095690,MATH 18,B06,093474,Rideout; David Porter,3,0,36,33
1656247101716,MATH 20A,A01,083754,Zheng; Zequn,11,0,40,29
1656247107746,MATH 20B,A01,083756,Briones; Jor-el Thomas Caparas,0,0,36,36
1656247107746,MATH 20B,A02,083757,Briones; Jor-el Thomas Caparas,0,0,36,36
1656247107746,MATH 20B,A03,093475,Staff,0,0,36,36
1656247113780,MATH 20C,A01,083760,Briones; Jor-el Thomas Caparas,0,0,35,35
1656247113780,MATH 20C,A02,083761,Briones; Jor-el Thomas Caparas,9,1,35,26
1656247113780,MATH 20C,A03,093476,Staff,0,0,35,35
1656247113780,MATH 20C,B01,083762,Bach; Quang Tran,1,0,30,29
1656247119810,MATH 20D,A01,083765,Tran; Brian Kha,1,0,30,29
1656247119810,MATH 20D,A02,083766,Tran; Brian Kha,0,1,30,30
1656247119810,MATH 20D,A03,083767,Tran; Brian Kha,2,0,30,28
1656247125841,MATH 20E,A01,083771,Ganguly; Soumya,3,0,32,29
1656247125841,MATH 20E,A02,083772,Ganguly; Soumya,0,0,32,32
1656247125841,MATH 20E,B01,083773,Ciotti; Benjamin,16,0,35,19
1656247125841,MATH 20E,B02,083774,Ciotti; Benjamin,15,0,35,20
1656247131869,MATH 103A,A01,083777,Greenfeld; Be'Eri,1,0,36,35
1656247131869,MATH 103A,A02,083778,Greenfeld; Be'Eri,1,0,36,35
1656247131869,MATH 103A,A03,093561,Staff,5,0,36,31
1656247131869,MATH 103A,B01,083779,Greenfeld; Be'Eri,8,0,36,28
1656247131869,MATH 103A,B02,083780,Greenfeld; Be'Eri,1,0,36,35
1656247131869,MATH 103A,B03,093562,Staff,0,0,36,36
1656247137895,MATH 105,A01,085443,Carter; Anne Toulson,5,0,35,30
1656247137895,MATH 105,A02,093477,Staff,14,0,35,21
1656247143927,MATH 109,A01,083213,Ganzberger; Geoffrey Michael,0,0,34,34
1656247143927,MATH 109,A02,083214,Ganzberger; Geoffrey Michael,0,0,34,34
1656247143927,MATH 109,A03,093478,Staff,1,0,34,33
1656247143927,MATH 109,B01,083215,Ganzberger; Geoffrey Michael,4,0,32,28
1656247143927,MATH 109,B02,083216,Ganzberger; Geoffrey Michael,1,0,32,31
1656247143927,MATH 109,B03,093479,Staff,3,0,32,29
1656247149953,MATH 142A,A01,083219,Chow; Bennett,2,0,32,30
1656247149953,MATH 142A,A02,083220,Chow; Bennett,8,0,32,24
1656247149953,MATH 142A,A03,093480,Staff,5,0,32,27
1656247149953,MATH 142A,B03,093481,Staff,3,0,32,29
1656247149953,MATH 142A,B04,093558,Staff,6,0,32,26
1656247149953,MATH 142A,B05,093559,Staff,0,0,32,32
1656247155981,MATH 193A,A01,083224,Rotar; Vladimir,0,1,34,34
1656247155981,MATH 193A,A02,083225,Rotar; Vladimir,0,0,34,34
1656247155981,MATH 193A,A03,083781,Rotar; Vladimir,0,0,34,34
1656247155981,MATH 193A,A04,083782,Rotar; Vladimir,6,0,34,28
1656247155981,MATH 193A,A05,093482,Rotar; Vladimir,0,0,34,34
1656247162012,MATH 197,001,091859,McAuley; Julian John,9999,0,9999,0
1656247162012,MATH 197,002,095566,Kedlaya; Kiran S.,9997,0,9999,2
1656247162012,MATH 197,003,095567,Xiao; Ming,9999,0,9999,0
1656247162012,MATH 197,004,095571,Perols; Johan Lars,9998,0,9999,1
1656247169074,COGS 9,A01,083615,Shannon; Kyle Michael,3,0,75,72
1656247175100,COGS 11,A01,083617,Boyle; Mary E. T.,14,0,48,34
1656247181135,COGS 13,A01,083071,Bastos; Amalia Pinkusfeld,4,0,71,67
1656247187161,COGS 14A,A01,092681,Semenuks; Arturs,1,12,100,99
1656247193191,COGS 14B,A01,083073,Cheng; Tzu-Han,7,0,63,56
1656247199219,COGS 17,A01,092677,Semenuks; Arturs,7,0,81,74
1656247205243,COGS 100,A01,083619,Allen; Michael Gordon,2,0,70,68
1656247211283,COGS 101A,A01,083621,Davis; Joshua Daniel,4,0,68,64
1656247217329,COGS 101B,A01,091572,Allen; Michael Gordon,4,0,65,61
1656247223358,COGS 101C,A01,083625,Delgado; Tania,10,0,35,25
1656247229387,COGS 107A,A01,083627,Boyle; Mary E. T.,0,0,60,60
1656247235417,COGS 118A,A01,083075,Gupta; Anjum,8,0,76,68
1656247241447,CSE 3,A50,083646,Miranda; Gregory Joseph,18,0,50,32
1656247247470,CSE 8A,A50,083650,Miranda; Gregory Joseph,2,2,56,54
1656247253494,CSE 11,A01,083080,Cao; Yingjun,0,49,40,40
1656247259520,CSE 12,A01,083652,Krause-Levy; Sophia Louisa,5,1,120,115
1656247265557,CSE 15L,A01,083654,Morris; Justin Loren,2,0,50,48
1656247265557,CSE 15L,A02,083655,Morris; Justin Loren,4,0,50,46
1656247271582,CSE 20,A01,083657,Tran; Khoa Dang,30,0,80,50
1656247277607,CSE 21,A01,095574,Bach; Quang Tran,23,0,48,25
1656247283641,CSE 30,A01,083084,Eldon; John,2,6,80,78
1656247283641,CSE 30,B01,095061,Bhaskar; Nishant,0,1,50,50
1656247289673,CSE 100,A01,083659,Cao; Yingjun,1,18,70,69
1656247295703,CSE 134B,A01,083661,Powell; Thomas Allan,5,0,100,95
1656247301730,CSE 140,A01,083663,Gungor; Onat,9,0,85,76
1656247307757,CSE 140L,A01,083088,Eldon; John,8,0,100,92
1656247313787,CSE 175,A01,083665,Kumar; Rakesh,0,0,25,25
1656247319811,CSE 190,A00,092507,Dubnov; Shlomo,3,0,20,17
1656247325845,ECE 45,A01,083139,Congero; Spencer William,1,0,75,74
1656247331877,ECE 65,A50,083695,Saad; Andrew S,9,0,30,21
1656247331877,ECE 65,A51,095125,Staff,24,0,26,2
1656247337903,ECE 109,A01,091882,Touri; Behrouz,0,1,70,70
1656247343929,ECE 180,A00,083140,Abi Samra; Nicholas Camill,1,0,30,29
1656247343929,ECE 180,B00,083141,Abi Samra; Nicholas Camill,0,4,30,30
1656247349961,MATH 10A,A01,083735,Patchell; Gregory David,0,0,30,30
1656247349961,MATH 10A,A02,083736,Patchell; Gregory David,22,0,30,8
1656247349961,MATH 10A,A03,083737,Patchell; Gregory David,16,0,30,14
1656247355998,MATH 10B,A01,083207,Lim; Seonhee,0,0,34,34
1656247355998,MATH 10B,A02,083208,Lim; Seonhee,7,0,35,28
1656247355998,MATH 10B,A03,093472,Staff,1,0,34,33
1656247355998,MATH 10B,B01,083739,Sinha; Shubham,11,0,30,19
1656247362034,MATH 18,A01,083743,Cinel; Cameron Alexander,7,0,30,23
1656247362034,MATH 18,A02,083744,Cinel; Cameron Alexander,9,0,30,21
1656247362034,MATH 18,A03,083745,Cinel; Cameron Alexander,5,0,30,25
1656247362034,MATH 18,B01,083748,Rideout; David Porter,1,0,36,35
1656247362034,MATH 18,B02,083749,Rideout; David Porter,0,0,36,36
1656247362034,MATH 18,B03,083750,Rideout; David Porter,0,0,36,36
1656247362034,MATH 18,B04,083751,Rideout; David Porter,0,1,36,36
1656247362034,MATH 18,B05,093473,Rideout; David Porter,0,0,36,36
1656247362034,MATH 18,B06,093474,Rideout; David Porter,3,0,36,33
1656247368059,MATH 20A,A01,083754,Zheng; Zequn,11,0,40,29
1656247374091,MATH 20B,A01,083756,Briones; Jor-el Thomas Caparas,0,0,36,36
1656247374091,MATH 20B,A02,083757,Briones; Jor-el Thomas Caparas,0,0,36,36
1656247374091,MATH 20B,A03,093475,Staff,0,0,36,36
1656247380117,MATH 20C,A01,083760,Briones; Jor-el Thomas Caparas,0,0,35,35
1656247380117,MATH 20C,A02,083761,Briones; Jor-el Thomas Caparas,9,1,35,26
1656247380117,MATH 20C,A03,093476,Staff,0,0,35,35
1656247380117,MATH 20C,B01,083762,Bach; Quang Tran,1,0,30,29
1656247386143,MATH 20D,A01,083765,Tran; Brian Kha,1,0,30,29
1656247386143,MATH 20D,A02,083766,Tran; Brian Kha,0,1,30,30
1656247386143,MATH 20D,A03,083767,Tran; Brian Kha,2,0,30,28
1656247392179,MATH 20E,A01,083771,Ganguly; Soumya,3,0,32,29
1656247392179,MATH 20E,A02,083772,Ganguly; Soumya,0,0,32,32
1656247392179,MATH 20E,B01,083773,Ciotti; Benjamin,16,0,35,19
1656247392179,MATH 20E,B02,083774,Ciotti; Benjamin,15,0,35,20
1656247398205,MATH 103A,A01,083777,Greenfeld; Be'Eri,1,0,36,35
1656247398205,MATH 103A,A02,083778,Greenfeld; Be'Eri,1,0,36,35
1656247398205,MATH 103A,A03,093561,Staff,5,0,36,31
1656247398205,MATH 103A,B01,083779,Greenfeld; Be'Eri,8,0,36,28
1656247398205,MATH 103A,B02,083780,Greenfeld; Be'Eri,1,0,36,35
1656247398205,MATH 103A,B03,093562,Staff,0,0,36,36
1656247404231,MATH 105,A01,085443,Carter; Anne Toulson,5,0,35,30
1656247404231,MATH 105,A02,093477,Staff,14,0,35,21
1656247410257,MATH 109,A01,083213,Ganzberger; Geoffrey Michael,0,0,34,34
1656247410257,MATH 109,A02,083214,Ganzberger; Geoffrey Michael,0,0,34,34
1656247410257,MATH 109,A03,093478,Staff,1,0,34,33
1656247410257,MATH 109,B01,083215,Ganzberger; Geoffrey Michael,4,0,32,28
1656247410257,MATH 109,B02,083216,Ganzberger; Geoffrey Michael,1,0,32,31
1656247410257,MATH 109,B03,093479,Staff,3,0,32,29
1656247416284,MATH 142A,A01,083219,Chow; Bennett,2,0,32,30
1656247416284,MATH 142A,A02,083220,Chow; Bennett,8,0,32,24
1656247416284,MATH 142A,A03,093480,Staff,5,0,32,27
1656247416284,MATH 142A,B03,093481,Staff,3,0,32,29
1656247416284,MATH 142A,B04,093558,Staff,6,0,32,26
1656247416284,MATH 142A,B05,093559,Staff,0,0,32,32
1656247422316,MATH 193A,A01,083224,Rotar; Vladimir,0,1,34,34
1656247422316,MATH 193A,A02,083225,Rotar; Vladimir,0,0,34,34
1656247422316,MATH 193A,A03,083781,Rotar; Vladimir,0,0,34,34
1656247422316,MATH 193A,A04,083782,Rotar; Vladimir,6,0,34,28
1656247422316,MATH 193A,A05,093482,Rotar; Vladimir,0,0,34,34
1656247428347,MATH 197,001,091859,McAuley; Julian John,9999,0,9999,0
1656247428347,MATH 197,002,095566,Kedlaya; Kiran S.,9997,0,9999,2
1656247428347,MATH 197,003,095567,Xiao; Ming,9999,0,9999,0
1656247428347,MATH 197,004,095571,Perols; Johan Lars,9998,0,9999,1
1656247435416,COGS 9,A01,083615,Shannon; Kyle Michael,3,0,75,72
1656247441439,COGS 11,A01,083617,Boyle; Mary E. T.,14,0,48,34
1656247447462,COGS 13,A01,083071,Bastos; Amalia Pinkusfeld,4,0,71,67
1656247453490,COGS 14A,A01,092681,Semenuks; Arturs,1,12,100,99
1656247459515,COGS 14B,A01,083073,Cheng; Tzu-Han,7,0,63,56
1656247465616,COGS 17,A01,092677,Semenuks; Arturs,7,0,81,74
1656247471647,COGS 100,A01,083619,Allen; Michael Gordon,2,0,70,68
1656247477671,COGS 101A,A01,083621,Davis; Joshua Daniel,4,0,68,64
1656247483697,COGS 101B,A01,091572,Allen; Michael Gordon,4,0,65,61
1656247489730,COGS 101C,A01,083625,Delgado; Tania,10,0,35,25
1656247495758,COGS 107A,A01,083627,Boyle; Mary E. T.,0,0,60,60
1656247501785,COGS 118A,A01,083075,Gupta; Anjum,8,0,76,68
1656247507813,CSE 3,A50,083646,Miranda; Gregory Joseph,18,0,50,32
1656247513837,CSE 8A,A50,083650,Miranda; Gregory Joseph,2,2,56,54
1656247519861,CSE 11,A01,083080,Cao; Yingjun,0,49,40,40
1656247525890,CSE 12,A01,083652,Krause-Levy; Sophia Louisa,5,1,120,115
1656247531917,CSE 15L,A01,083654,Morris; Justin Loren,2,0,50,48
1656247531917,CSE 15L,A02,083655,Morris; Justin Loren,4,0,50,46
1656247537946,CSE 20,A01,083657,Tran; Khoa Dang,30,0,80,50
1656247543974,CSE 21,A01,095574,Bach; Quang Tran,23,0,48,25
1656247550007,CSE 30,A01,083084,Eldon; John,2,6,80,78
1656247550007,CSE 30,B01,095061,Bhaskar; Nishant,0,1,50,50
1656247556039,CSE 100,A01,083659,Cao; Yingjun,1,18,70,69
1656247562066,CSE 134B,A01,083661,Powell; Thomas Allan,5,0,100,95
1656247568098,CSE 140,A01,083663,Gungor; Onat,9,0,85,76
1656247574129,CSE 140L,A01,083088,Eldon; John,8,0,100,92
1656247580154,CSE 175,A01,083665,Kumar; Rakesh,0,0,25,25
1656247586179,CSE 190,A00,092507,Dubnov; Shlomo,3,0,20,17
1656247592217,ECE 45,A01,083139,Congero; Spencer William,1,0,75,74
1656247598250,ECE 65,A50,083695,Saad; Andrew S,9,0,30,21
1656247598250,ECE 65,A51,095125,Staff,24,0,26,2
1656247604276,ECE 109,A01,091882,Touri; Behrouz,0,1,70,70
1656247610306,ECE 180,A00,083140,Abi Samra; Nicholas Camill,1,0,30,29
1656247610306,ECE 180,B00,083141,Abi Samra; Nicholas Camill,0,4,30,30
1656247616333,MATH 10A,A01,083735,Patchell; Gregory David,0,0,30,30
1656247616333,MATH 10A,A02,083736,Patchell; Gregory David,22,0,30,8
1656247616333,MATH 10A,A03,083737,Patchell; Gregory David,16,0,30,14
1656247622374,MATH 10B,A01,083207,Lim; Seonhee,0,0,34,34
1656247622374,MATH 10B,A02,083208,Lim; Seonhee,7,0,35,28
1656247622374,MATH 10B,A03,093472,Staff,1,0,34,33
1656247622374,MATH 10B,B01,083739,Sinha; Shubham,11,0,30,19
1656247628404,MATH 18,A01,083743,Cinel; Cameron Alexander,7,0,30,23
1656247628404,MATH 18,A02,083744,Cinel; Cameron Alexander,9,0,30,21
1656247628404,MATH 18,A03,083745,Cinel; Cameron Alexander,5,0,30,25
1656247628404,MATH 18,B01,083748,Rideout; David Porter,1,0,36,35
1656247628404,MATH 18,B02,083749,Rideout; David Porter,0,0,36,36
1656247628404,MATH 18,B03,083750,Rideout; David Porter,0,0,36,36
1656247628404,MATH 18,B04,083751,Rideout; David Porter,0,1,36,36
1656247628404,MATH 18,B05,093473,Rideout; David Porter,0,0,36,36
1656247628404,MATH 18,B06,093474,Rideout; David Porter,3,0,36,33
1656247634429,MATH 20A,A01,083754,Zheng; Zequn,11,0,40,29
1656247640463,MATH 20B,A01,083756,Briones; Jor-el Thomas Caparas,0,0,36,36
1656247640463,MATH 20B,A02,083757,Briones; Jor-el Thomas Caparas,0,0,36,36
1656247640463,MATH 20B,A03,093475,Staff,0,0,36,36
1656247646497,MATH 20C,A01,083760,Briones; Jor-el Thomas Caparas,0,0,35,35
1656247646497,MATH 20C,A02,083761,Briones; Jor-el Thomas Caparas,9,1,35,26
1656247646497,MATH 20C,A03,093476,Staff,0,0,35,35
1656247646497,MATH 20C,B01,083762,Bach; Quang Tran,1,0,30,29
1656247652532,MATH 20D,A01,083765,Tran; Brian Kha,1,0,30,29
1656247652532,MATH 20D,A02,083766,Tran; Brian Kha,0,1,30,30
1656247652532,MATH 20D,A03,083767,Tran; Brian Kha,2,0,30,28
1656247658588,MATH 20E,A01,083771,Ganguly; Soumya,3,0,32,29
1656247658588,MATH 20E,A02,083772,Ganguly; Soumya,0,0,32,32
1656247658588,MATH 20E,B01,083773,Ciotti; Benjamin,16,0,35,19
1656247658588,MATH 20E,B02,083774,Ciotti; Benjamin,15,0,35,20
1656247664617,MATH 103A,A01,083777,Greenfeld; Be'Eri,1,0,36,35
1656247664617,MATH 103A,A02,083778,Greenfeld; Be'Eri,1,0,36,35
1656247664617,MATH 103A,A03,093561,Staff,5,0,36,31
1656247664617,MATH 103A,B01,083779,Greenfeld; Be'Eri,8,0,36,28
1656247664617,MATH 103A,B02,083780,Greenfeld; Be'Eri,1,0,36,35
1656247664617,MATH 103A,B03,093562,Staff,0,0,36,36
1656247670643,MATH 105,A01,085443,Carter; Anne Toulson,5,0,35,30
1656247670643,MATH 105,A02,093477,Staff,14,0,35,21
1656247676670,MATH 109,A01,083213,Ganzberger; Geoffrey Michael,0,0,34,34
1656247676670,MATH 109,A02,083214,Ganzberger; Geoffrey Michael,0,0,34,34
1656247676670,MATH 109,A03,093478,Staff,1,0,34,33
1656247676670,MATH 109,B01,083215,Ganzberger; Geoffrey Michael,4,0,32,28
1656247676670,MATH 109,B02,083216,Ganzberger; Geoffrey Michael,1,0,32,31
1656247676670,MATH 109,B03,093479,Staff,3,0,32,29
1656247682701,MATH 142A,A01,083219,Chow; Bennett,2,0,32,30
1656247682701,MATH 142A,A02,083220,Chow; Bennett,8,0,32,24
1656247682701,MATH 142A,A03,093480,Staff,5,0,32,27
1656247682701,MATH 142A,B03,093481,Staff,3,0,32,29
1656247682701,MATH 142A,B04,093558,Staff,6,0,32,26
1656247682701,MATH 142A,B05,093559,Staff,0,0,32,32
1656247688737,MATH 193A,A01,083224,Rotar; Vladimir,0,1,34,34
1656247688737,MATH 193A,A02,083225,Rotar; Vladimir,0,0,34,34
1656247688737,MATH 193A,A03,083781,Rotar; Vladimir,0,0,34,34
1656247688737,MATH 193A,A04,083782,Rotar; Vladimir,6,0,34,28
1656247688737,MATH 193A,A05,093482,Rotar; Vladimir,0,0,34,34
1656247694764,MATH 197,001,091859,McAuley; Julian John,9999,0,9999,0
1656247694764,MATH 197,002,095566,Kedlaya; Kiran S.,9997,0,9999,2
1656247694764,MATH 197,003,095567,Xiao; Ming,9999,0,9999,0
1656247694764,MATH 197,004,095571,Perols; Johan Lars,9998,0,9999,1
1656247701847,COGS 9,A01,083615,Shannon; Kyle Michael,3,0,75,72
1656247707873,COGS 11,A01,083617,Boyle; Mary E. T.,14,0,48,34
1656247713900,COGS 13,A01,083071,Bastos; Amalia Pinkusfeld,4,0,71,67
1656247719927,COGS 14A,A01,092681,Semenuks; Arturs,1,12,100,99
1656247725953,COGS 14B,A01,083073,Cheng; Tzu-Han,7,0,63,56
1656247731979,COGS 17,A01,092677,Semenuks; Arturs,7,0,81,74
1656247738004,COGS 100,A01,083619,Allen; Michael Gordon,2,0,70,68
1656247744029,COGS 101A,A01,083621,Davis; Joshua Daniel,4,0,68,64
1656247750058,COGS 101B,A01,091572,Allen; Michael Gordon,4,0,65,61
1656247756086,COGS 101C,A01,083625,Delgado; Tania,10,0,35,25
1656247762112,COGS 107A,A01,083627,Boyle; Mary E. T.,0,0,60,60
1656247768141,COGS 118A,A01,083075,Gupta; Anjum,8,0,76,68
1656247774169,CSE 3,A50,083646,Miranda; Gregory Joseph,18,0,50,32
1656247780195,CSE 8A,A50,083650,Miranda; Gregory Joseph,2,2,56,54
1656247786227,CSE 11,A01,083080,Cao; Yingjun,0,49,40,40
1656247792253,CSE 12,A01,083652,Krause-Levy; Sophia Louisa,5,1,120,115
1656247798279,CSE 15L,A01,083654,Morris; Justin Loren,2,0,50,48
1656247798279,CSE 15L,A02,083655,Morris; Justin Loren,4,0,50,46
1656247804304,CSE 20,A01,083657,Tran; Khoa Dang,30,0,80,50
1656247810336,CSE 21,A01,095574,Bach; Quang Tran,23,0,48,25
1656247816369,CSE 30,A01,083084,Eldon; John,2,6,80,78
1656247816369,CSE 30,B01,095061,Bhaskar; Nishant,0,1,50,50
1656247822401,CSE 100,A01,083659,Cao; Yingjun,1,18,70,69
1656247828430,CSE 134B,A01,083661,Powell; Thomas Allan,5,0,100,95
1656247834454,CSE 140,A01,083663,Gungor; Onat,9,0,85,76
1656247840476,CSE 140L,A01,083088,Eldon; John,8,0,100,92
1656247846501,CSE 175,A01,083665,Kumar; Rakesh,0,0,25,25
1656247852524,CSE 190,A00,092507,Dubnov; Shlomo,3,0,20,17
1656247858551,ECE 45,A01,083139,Congero; Spencer William,1,0,75,74
1656247864578,ECE 65,A50,083695,Saad; Andrew S,9,0,30,21
1656247864578,ECE 65,A51,095125,Staff,24,0,26,2
1656247870608,ECE 109,A01,091882,Touri; Behrouz,0,1,70,70
1656247876641,ECE 180,A00,083140,Abi Samra; Nicholas Camill,1,0,30,29
1656247876641,ECE 180,B00,083141,Abi Samra; Nicholas Camill,0,4,30,30
1656247882670,MATH 10A,A01,083735,Patchell; Gregory David,0,0,30,30
1656247882670,MATH 10A,A02,083736,Patchell; Gregory David,22,0,30,8
1656247882670,MATH 10A,A03,083737,Patchell; Gregory David,16,0,30,14
1656247888699,MATH 10B,A01,083207,Lim; Seonhee,0,0,34,34
1656247888699,MATH 10B,A02,083208,Lim; Seonhee,7,0,35,28
1656247888699,MATH 10B,A03,093472,Staff,1,0,34,33
1656247888699,MATH 10B,B01,083739,Sinha; Shubham,11,0,30,19
1656247894728,MATH 18,A01,083743,Cinel; Cameron Alexander,7,0,30,23
1656247894728,MATH 18,A02,083744,Cinel; Cameron Alexander,9,0,30,21
1656247894728,MATH 18,A03,083745,Cinel; Cameron Alexander,5,0,30,25
1656247894728,MATH 18,B01,083748,Rideout; David Porter,1,0,36,35
1656247894728,MATH 18,B02,083749,Rideout; David Porter,0,0,36,36
1656247894728,MATH 18,B03,083750,Rideout; David Porter,0,0,36,36
1656247894728,MATH 18,B04,083751,Rideout; David Porter,0,1,36,36
1656247894728,MATH 18,B05,093473,Rideout; David Porter,0,0,36,36
1656247894728,MATH 18,B06,093474,Rideout; David Porter,3,0,36,33
1656247900758,MATH 20A,A01,083754,Zheng; Zequn,11,0,40,29
1656247906784,MATH 20B,A01,083756,Briones; Jor-el Thomas Caparas,0,0,36,36
1656247906784,MATH 20B,A02,083757,Briones; Jor-el Thomas Caparas,0,0,36,36
1656247906784,MATH 20B,A03,093475,Staff,0,0,36,36
1656247912809,MATH 20C,A01,083760,Briones; Jor-el Thomas Caparas,0,0,35,35
1656247912809,MATH 20C,A02,083761,Briones; Jor-el Thomas Caparas,9,1,35,26
1656247912809,MATH 20C,A03,093476,Staff,0,0,35,35
1656247912809,MATH 20C,B01,083762,Bach; Quang Tran,1,0,30,29
1656247918835,MATH 20D,A01,083765,Tran; Brian Kha,1,0,30,29
1656247918835,MATH 20D,A02,083766,Tran; Brian Kha,0,1,30,30
1656247918835,MATH 20D,A03,083767,Tran; Brian Kha,2,0,30,28
1656247924871,MATH 20E,A01,083771,Ganguly; Soumya,3,0,32,29
1656247924871,MATH 20E,A02,083772,Ganguly; Soumya,0,0,32,32
1656247924871,MATH 20E,B01,083773,Ciotti; Benjamin,16,0,35,19
1656247924871,MATH 20E,B02,083774,Ciotti; Benjamin,15,0,35,20
1656247930908,MATH 103A,A01,083777,Greenfeld; Be'Eri,1,0,36,35
1656247930908,MATH 103A,A02,083778,Greenfeld; Be'Eri,1,0,36,35
1656247930908,MATH 103A,A03,093561,Staff,5,0,36,31
1656247930908,MATH 103A,B01,083779,Greenfeld; Be'Eri,8,0,36,28
1656247930908,MATH 103A,B02,083780,Greenfeld; Be'Eri,1,0,36,35
1656247930908,MATH 103A,B03,093562,Staff,0,0,36,36
1656247936935,MATH 105,A01,085443,Carter; Anne Toulson,5,0,35,30
1656247936935,MATH 105,A02,093477,Staff,14,0,35,21
1656247942961,MATH 109,A01,083213,Ganzberger; Geoffrey Michael,0,0,34,34
1656247942961,MATH 109,A02,083214,Ganzberger; Geoffrey Michael,0,0,34,34
1656247942961,MATH 109,A03,093478,Staff,1,0,34,33
1656247942961,MATH 109,B01,083215,Ganzberger; Geoffrey Michael,4,0,32,28
1656247942961,MATH 109,B02,083216,Ganzberger; Geoffrey Michael,1,0,32,31
1656247942961,MATH 109,B03,093479,Staff,3,0,32,29
1656247948998,MATH 142A,A01,083219,Chow; Bennett,2,0,32,30
1656247948998,MATH 142A,A02,083220,Chow; Bennett,8,0,32,24
1656247948998,MATH 142A,A03,093480,Staff,5,0,32,27
1656247948998,MATH 142A,B03,093481,Staff,3,0,32,29
1656247948998,MATH 142A,B04,093558,Staff,6,0,32,26
1656247948998,MATH 142A,B05,093559,Staff,0,0,32,32
1656247955031,MATH 193A,A01,083224,Rotar; Vladimir,0,1,34,34
1656247955031,MATH 193A,A02,083225,Rotar; Vladimir,0,0,34,34
1656247955031,MATH 193A,A03,083781,Rotar; Vladimir,0,0,34,34
1656247955031,MATH 193A,A04,083782,Rotar; Vladimir,6,0,34,28
1656247955031,MATH 193A,A05,093482,Rotar; Vladimir,0,0,34,34
1656247961056,MATH 197,001,091859,McAuley; Julian John,9999,0,9999,0
1656247961056,MATH 197,002,095566,Kedlaya; Kiran S.,9997,0,9999,2
1656247961056,MATH 197,003,095567,Xiao; Ming,9999,0,9999,0
1656247961056,MATH 197,004,095571,Perols; Johan Lars,9998,0,9999,1
1656247968135,COGS 9,A01,083615,Shannon; Kyle Michael,3,0,75,72
1656247974159,COGS 11,A01,083617,Boyle; Mary E. T.,14,0,48,34
1656247980196,COGS 13,A01,083071,Bastos; Amalia Pinkusfeld,4,0,71,67
1656247986225,COGS 14A,A01,092681,Semenuks; Arturs,1,12,100,99
1656247992252,COGS 14B,A01,083073,Cheng; Tzu-Han,7,0,63,56
1656247998279,COGS 17,A01,092677,Semenuks; Arturs,7,0,81,74
1656248004311,COGS 100,A01,083619,Allen; Michael Gordon,2,0,70,68
1656248010338,COGS 101A,A01,083621,Davis; Joshua Daniel,4,0,68,64
1656248016368,COGS 101B,A01,091572,Allen; Michael Gordon,4,0,65,61
1656248022399,COGS 101C,A01,083625,Delgado; Tania,10,0,35,25
1656248028425,COGS 107A,A01,083627,Boyle; Mary E. T.,0,0,60,60
1656248034450,COGS 118A,A01,083075,Gupta; Anjum,8,0,76,68
1656248040486,CSE 3,A50,083646,Miranda; Gregory Joseph,18,0,50,32
1656248046515,CSE 8A,A50,083650,Miranda; Gregory Joseph,2,2,56,54
1656248052541,CSE 11,A01,083080,Cao; Yingjun,0,49,40,40
1656248058568,CSE 12,A01,083652,Krause-Levy; Sophia Louisa,5,1,120,115
1656248064664,CSE 15L,A01,083654,Morris; Justin Loren,2,0,50,48
1656248064664,CSE 15L,A02,083655,Morris; Justin Loren,4,0,50,46
1656248070693,CSE 20,A01,083657,Tran; Khoa Dang,30,0,80,50
1656248076718,CSE 21,A01,095574,Bach; Quang Tran,23,0,48,25
1656248082747,CSE 30,A01,083084,Eldon; John,2,6,80,78
1656248082747,CSE 30,B01,095061,Bhaskar; Nishant,0,1,50,50
1656248088779,CSE 100,A01,083659,Cao; Yingjun,1,18,70,69
1656248094805,CSE 134B,A01,083661,Powell; Thomas Allan,5,0,100,95
1656248100839,CSE 140,A01,083663,Gungor; Onat,9,0,85,76
1656248106883,CSE 140L,A01,083088,Eldon; John,8,0,100,92
1656248112915,CSE 175,A01,083665,Kumar; Rakesh,0,0,25,25
1656248118944,CSE 190,A00,092507,Dubnov; Shlomo,3,0,20,17
1656248124978,ECE 45,A01,083139,Congero; Spencer William,1,0,75,74
1656248131004,ECE 65,A50,083695,Saad; Andrew S,9,0,30,21
1656248131004,ECE 65,A51,095125,Staff,24,0,26,2
1656248137037,ECE 109,A01,091882,Touri; Behrouz,0,1,70,70
1656248143068,ECE 180,A00,083140,Abi Samra; Nicholas Camill,1,0,30,29
1656248143068,ECE 180,B00,083141,Abi Samra; Nicholas Camill,0,4,30,30
1656248149104,MATH 10A,A01,083735,Patchell; Gregory David,0,0,30,30
1656248149104,MATH 10A,A02,083736,Patchell; Gregory David,22,0,30,8
1656248149104,MATH 10A,A03,083737,Patchell; Gregory David,16,0,30,14
1656248155131,MATH 10B,A01,083207,Lim; Seonhee,0,0,34,34
1656248155131,MATH 10B,A02,083208,Lim; Seonhee,7,0,35,28
1656248155131,MATH 10B,A03,093472,Staff,1,0,34,33
1656248155131,MATH 10B,B01,083739,Sinha; Shubham,11,0,30,19
1656248161162,MATH 18,A01,083743,Cinel; Cameron Alexander,7,0,30,23
1656248161162,MATH 18,A02,083744,Cinel; Cameron Alexander,9,0,30,21
1656248161162,MATH 18,A03,083745,Cinel; Cameron Alexander,5,0,30,25
1656248161162,MATH 18,B01,083748,Rideout; David Porter,1,0,36,35
1656248161162,MATH 18,B02,083749,Rideout; David Porter,0,0,36,36
1656248161162,MATH 18,B03,083750,Rideout; David Porter,0,0,36,36
1656248161162,MATH 18,B04,083751,Rideout; David Porter,0,1,36,36
1656248161162,MATH 18,B05,093473,Rideout; David Porter,0,0,36,36
1656248161162,MATH 18,B06,093474,Rideout; David Porter,3,0,36,33
1656248167189,MATH 20A,A01,083754,Zheng; Zequn,11,0,40,29
1656248173223,MATH 20B,A01,083756,Briones; Jor-el Thomas Caparas,0,0,36,36
1656248173223,MATH 20B,A02,083757,Briones; Jor-el Thomas Caparas,0,0,36,36
1656248173223,MATH 20B,A03,093475,Staff,0,0,36,36
1656248179249,MATH 20C,A01,083760,Briones; Jor-el Thomas Caparas,0,0,35,35
1656248179249,MATH 20C,A02,083761,Briones; Jor-el Thomas Caparas,9,1,35,26
1656248179249,MATH 20C,A03,093476,Staff,0,0,35,35
1656248179249,MATH 20C,B01,083762,Bach; Quang Tran,1,0,30,29
1656248185275,MATH 20D,A01,083765,Tran; Brian Kha,1,0,30,29
1656248185275,MATH 20D,A02,083766,Tran; Brian Kha,0,1,30,30
1656248185275,MATH 20D,A03,083767,Tran; Brian Kha,2,0,30,28
1656248191310,MATH 20E,A01,083771,Ganguly; Soumya,3,0,32,29
1656248191310,MATH 20E,A02,083772,Ganguly; Soumya,0,0,32,32
1656248191310,MATH 20E,B01,083773,Ciotti; Benjamin,16,0,35,19
1656248191310,MATH 20E,B02,083774,Ciotti; Benjamin,15,0,35,20
1656248197352,MATH 103A,A01,083777,Greenfeld; Be'Eri,1,0,36,35
1656248197352,MATH 103A,A02,083778,Greenfeld; Be'Eri,1,0,36,35
1656248197352,MATH 103A,A03,093561,Staff,5,0,36,31
1656248197352,MATH 103A,B01,083779,Greenfeld; Be'Eri,8,0,36,28
1656248197352,MATH 103A,B02,083780,Greenfeld; Be'Eri,1,0,36,35
1656248197352,MATH 103A,B03,093562,Staff,0,0,36,36
1656248203382,MATH 105,A01,085443,Carter; Anne Toulson,5,0,35,30
1656248203382,MATH 105,A02,093477,Staff,14,0,35,21
1656248209412,MATH 109,A01,083213,Ganzberger; Geoffrey Michael,0,0,34,34
1656248209412,MATH 109,A02,083214,Ganzberger; Geoffrey Michael,0,0,34,34
1656248209412,MATH 109,A03,093478,Staff,1,0,34,33
1656248209412,MATH 109,B01,083215,Ganzberger; Geoffrey Michael,4,0,32,28
1656248209412,MATH 109,B02,083216,Ganzberger; Geoffrey Michael,1,0,32,31
1656248209412,MATH 109,B03,093479,Staff,3,0,32,29
1656248215445,MATH 142A,A01,083219,Chow; Bennett,2,0,32,30
1656248215445,MATH 142A,A02,083220,Chow; Bennett,8,0,32,24
1656248215445,MATH 142A,A03,093480,Staff,5,0,32,27
1656248215445,MATH 142A,B03,093481,Staff,3,0,32,29
1656248215445,MATH 142A,B04,093558,Staff,6,0,32,26
1656248215445,MATH 142A,B05,093559,Staff,0,0,32,32
1656248221477,MATH 193A,A01,083224,Rotar; Vladimir,0,1,34,34
1656248221477,MATH 193A,A02,083225,Rotar; Vladimir,0,0,34,34
1656248221477,MATH 193A,A03,083781,Rotar; Vladimir,0,0,34,34
1656248221477,MATH 193A,A04,083782,Rotar; Vladimir,6,0,34,28
1656248221477,MATH 193A,A05,093482,Rotar; Vladimir,0,0,34,34
1656248227507,MATH 197,001,091859,McAuley; Julian John,9999,0,9999,0
1656248227507,MATH 197,002,095566,Kedlaya; Kiran S.,9997,0,9999,2
1656248227507,MATH 197,003,095567,Xiao; Ming,9999,0,9999,0
1656248227507,MATH 197,004,095571,Perols; Johan Lars,9998,0,9999,1
1656248234585,COGS 9,A01,083615,Shannon; Kyle Michael,3,0,75,72
1656248240617,COGS 11,A01,083617,Boyle; Mary E. T.,14,0,48,34
1656248246644,COGS 13,A01,083071,Bastos; Amalia Pinkusfeld,4,0,71,67
1656248252676,COGS 14A,A01,092681,Semenuks; Arturs,1,12,100,99
1656248258708,COGS 14B,A01,083073,Cheng; Tzu-Han,7,0,63,56
1656248264734,COGS 17,A01,092677,Semenuks; Arturs,7,0,81,74
1656248270761,COGS 100,A01,083619,Allen; Michael Gordon,2,0,70,68
1656248276785,COGS 101A,A01,083621,Davis; Joshua Daniel,4,0,68,64
1656248282810,COGS 101B,A01,091572,Allen; Michael Gordon,4,0,65,61
1656248288841,COGS 101C,A01,083625,Delgado; Tania,10,0,35,25
1656248294867,COGS 107A,A01,083627,Boyle; Mary E. T.,0,0,60,60
1656248300892,COGS 118A,A01,083075,Gupta; Anjum,8,0,76,68
1656248306920,CSE 3,A50,083646,Miranda; Gregory Joseph,18,0,50,32
1656248312950,CSE 8A,A50,083650,Miranda; Gregory Joseph,2,2,56,54
1656248318975,CSE 11,A01,083080,Cao; Yingjun,0,49,40,40
1656248325001,CSE 12,A01,083652,Krause-Levy; Sophia Louisa,5,1,120,115
1656248331027,CSE 15L,A01,083654,Morris; Justin Loren,2,0,50,48
1656248331027,CSE 15L,A02,083655,Morris; Justin Loren,4,0,50,46
1656248337052,CSE 20,A01,083657,Tran; Khoa Dang,30,0,80,50
1656248343083,CSE 21,A01,095574,Bach; Quang Tran,23,0,48,25
1656248349110,CSE 30,A01,083084,Eldon; John,2,6,80,78
1656248349110,CSE 30,B01,095061,Bhaskar; Nishant,0,1,50,50
1656248355153,CSE 100,A01,083659,Cao; Yingjun,1,18,70,69
1656248361179,CSE 134B,A01,083661,Powell; Thomas Allan,5,0,100,95
1656248367205,CSE 140,A01,083663,Gungor; Onat,9,0,85,76
1656248373232,CSE 140L,A01,083088,Eldon; John,8,0,100,92
1656248379264,CSE 175,A01,083665,Kumar; Rakesh,0,0,25,25
1656248385291,CSE 190,A00,092507,Dubnov; Shlomo,3,0,20,17
1656248391318,ECE 45,A01,083139,Congero; Spencer William,1,0,75,74
1656248397351,ECE 65,A50,083695,Saad; Andrew S,9,0,30,21
1656248397351,ECE 65,A51,095125,Staff,24,0,26,2
1656248403377,ECE 109,A01,091882,Touri; Behrouz,0,1,70,70
1656248409403,ECE 180,A00,083140,Abi Samra; Nicholas Camill,1,0,30,29
1656248409403,ECE 180,B00,083141,Abi Samra; Nicholas Camill,0,4,30,30
1656248415430,MATH 10A,A01,083735,Patchell; Gregory David,0,0,30,30
1656248415430,MATH 10A,A02,083736,Patchell; Gregory David,22,0,30,8
1656248415430,MATH 10A,A03,083737,Patchell; Gregory David,16,0,30,14
1656248421466,MATH 10B,A01,083207,Lim; Seonhee,0,0,34,34
1656248421466,MATH 10B,A02,083208,Lim; Seonhee,7,0,35,28
1656248421466,MATH 10B,A03,093472,Staff,1,0,34,33
1656248421466,MATH 10B,B01,083739,Sinha; Shubham,11,0,30,19
1656248427497,MATH 18,A01,083743,Cinel; Cameron Alexander,7,0,30,23
1656248427497,MATH 18,A02,083744,Cinel; Cameron Alexander,9,0,30,21
1656248427497,MATH 18,A03,083745,Cinel; Cameron Alexander,5,0,30,25
1656248427497,MATH 18,B01,083748,Rideout; David Porter,1,0,36,35
1656248427497,MATH 18,B02,083749,Rideout; David Porter,0,0,36,36
1656248427497,MATH 18,B03,083750,Rideout; David Porter,0,0,36,36
1656248427497,MATH 18,B04,083751,Rideout; David Porter,0,1,36,36
1656248427497,MATH 18,B05,093473,Rideout; David Porter,0,0,36,36
1656248427497,MATH 18,B06,093474,Rideout; David Porter,3,0,36,33
1656248433529,MATH 20A,A01,083754,Zheng; Zequn,11,0,40,29
1656248439559,MATH 20B,A01,083756,Briones; Jor-el Thomas Caparas,0,0,36,36
1656248439559,MATH 20B,A02,083757,Briones; Jor-el Thomas Caparas,0,0,36,36
1656248439559,MATH 20B,A03,093475,Staff,0,0,36,36
1656248445590,MATH 20C,A01,083760,Briones; Jor-el Thomas Caparas,0,0,35,35
1656248445590,MATH 20C,A02,083761,Briones; Jor-el Thomas Caparas,9,1,35,26
1656248445590,MATH 20C,A03,093476,Staff,0,0,35,35
1656248445590,MATH 20C,B01,083762,Bach; Quang Tran,1,0,30,29
1656248451618,MATH 20D,A01,083765,Tran; Brian Kha,1,0,30,29
1656248451618,MATH 20D,A02,083766,Tran; Brian Kha,0,1,30,30
1656248451618,MATH 20D,A03,083767,Tran; Brian Kha,2,0,30,28
1656248457646,MATH 20E,A01,083771,Ganguly; Soumya,3,0,32,29
1656248457646,MATH 20E,A02,083772,Ganguly; Soumya,0,0,32,32
1656248457646,MATH 20E,B01,083773,Ciotti; Benjamin,16,0,35,19
1656248457646,MATH 20E,B02,083774,Ciotti; Benjamin,15,0,35,20
1656248463672,MATH 103A,A01,083777,Greenfeld; Be'Eri,1,0,36,35
1656248463672,MATH 103A,A02,083778,Greenfeld; Be'Eri,1,0,36,35
1656248463672,MATH 103A,A03,093561,Staff,5,0,36,31
1656248463672,MATH 103A,B01,083779,Greenfeld; Be'Eri,8,0,36,28
1656248463672,MATH 103A,B02,083780,Greenfeld; Be'Eri,1,0,36,35
1656248463672,MATH 103A,B03,093562,Staff,0,0,36,36
1656248469704,MATH 105,A01,085443,Carter; Anne Toulson,5,0,35,30
1656248469704,MATH 105,A02,093477,Staff,14,0,35,21
1656248475736,MATH 109,A01,083213,Ganzberger; Geoffrey Michael,0,0,34,34
1656248475736,MATH 109,A02,083214,Ganzberger; Geoffrey Michael,0,0,34,34
1656248475736,MATH 109,A03,093478,Staff,1,0,34,33
1656248475736,MATH 109,B01,083215,Ganzberger; Geoffrey Michael,4,0,32,28
1656248475736,MATH 109,B02,083216,Ganzberger; Geoffrey Michael,1,0,32,31
1656248475736,MATH 109,B03,093479,Staff,3,0,32,29
1656248481764,MATH 142A,A01,083219,Chow; Bennett,2,0,32,30
1656248481764,MATH 142A,A02,083220,Chow; Bennett,8,0,32,24
1656248481764,MATH 142A,A03,093480,Staff,5,0,32,27
1656248481764,MATH 142A,B03,093481,Staff,3,0,32,29
1656248481764,MATH 142A,B04,093558,Staff,6,0,32,26
1656248481764,MATH 142A,B05,093559,Staff,0,0,32,32
1656248487792,MATH 193A,A01,083224,Rotar; Vladimir,0,1,34,34
1656248487792,MATH 193A,A02,083225,Rotar; Vladimir,0,0,34,34
1656248487792,MATH 193A,A03,083781,Rotar; Vladimir,0,0,34,34
1656248487792,MATH 193A,A04,083782,Rotar; Vladimir,6,0,34,28
1656248487792,MATH 193A,A05,093482,Rotar; Vladimir,0,0,34,34
1656248493816,MATH 197,001,091859,McAuley; Julian John,9999,0,9999,0
1656248493816,MATH 197,002,095566,Kedlaya; Kiran S.,9997,0,9999,2
1656248493816,MATH 197,003,095567,Xiao; Ming,9999,0,9999,0
1656248493816,MATH 197,004,095571,Perols; Johan Lars,9998,0,9999,1
1656248500895,COGS 9,A01,083615,Shannon; Kyle Michael,3,0,75,72
1656248506922,COGS 11,A01,083617,Boyle; Mary E. T.,14,0,48,34
1656248512949,COGS 13,A01,083071,Bastos; Amalia Pinkusfeld,4,0,71,67
1656248518976,COGS 14A,A01,092681,Semenuks; Arturs,1,12,100,99
1656248525003,COGS 14B,A01,083073,Cheng; Tzu-Han,7,0,63,56
1656248531028,COGS 17,A01,092677,Semenuks; Arturs,7,0,81,74
1656248537053,COGS 100,A01,083619,Allen; Michael Gordon,2,0,70,68
1656248543083,COGS 101A,A01,083621,Davis; Joshua Daniel,4,0,68,64
1656248549109,COGS 101B,A01,091572,Allen; Michael Gordon,4,0,65,61
1656248555140,COGS 101C,A01,083625,Delgado; Tania,10,0,35,25
1656248561163,COGS 107A,A01,083627,Boyle; Mary E. T.,0,0,60,60
1656248567194,COGS 118A,A01,083075,Gupta; Anjum,8,0,76,68
1656248573220,CSE 3,A50,083646,Miranda; Gregory Joseph,18,0,50,32
1656248579246,CSE 8A,A50,083650,Miranda; Gregory Joseph,2,2,56,54
1656248585272,CSE 11,A01,083080,Cao; Yingjun,0,49,40,40
1656248591299,CSE 12,A01,083652,Krause-Levy; Sophia Louisa,5,1,120,115
1656248597329,CSE 15L,A01,083654,Morris; Justin Loren,2,0,50,48
1656248597329,CSE 15L,A02,083655,Morris; Justin Loren,4,0,50,46
1656248603365,CSE 20,A01,083657,Tran; Khoa Dang,30,0,80,50
1656248609390,CSE 21,A01,095574,Bach; Quang Tran,23,0,48,25
1656248615418,CSE 30,A01,083084,Eldon; John,2,6,80,78
1656248615418,CSE 30,B01,095061,Bhaskar; Nishant,0,1,50,50
1656248621448,CSE 100,A01,083659,Cao; Yingjun,1,18,70,69
1656248627475,CSE 134B,A01,083661,Powell; Thomas Allan,5,0,100,95
1656248633500,CSE 140,A01,083663,Gungor; Onat,9,0,85,76
1656248639522,CSE 140L,A01,083088,Eldon; John,8,0,100,92
1656248645550,CSE 175,A01,083665,Kumar; Rakesh,0,0,25,25
1656248651575,CSE 190,A00,092507,Dubnov; Shlomo,3,0,20,17
1656248657607,ECE 45,A01,083139,Congero; Spencer William,1,0,75,74
1656248663714,ECE 65,A50,083695,Saad; Andrew S,9,0,30,21
1656248663714,ECE 65,A51,095125,Staff,24,0,26,2
1656248669738,ECE 109,A01,091882,Touri; Behrouz,0,1,70,70
1656248675765,ECE 180,A00,083140,Abi Samra; Nicholas Camill,1,0,30,29
1656248675765,ECE 180,B00,083141,Abi Samra; Nicholas Camill,0,4,30,30
1656248681792,MATH 10A,A01,083735,Patchell; Gregory David,0,0,30,30
1656248681792,MATH 10A,A02,083736,Patchell; Gregory David,22,0,30,8
1656248681792,MATH 10A,A03,083737,Patchell; Gregory David,16,0,30,14
1656248687821,MATH 10B,A01,083207,Lim; Seonhee,0,0,34,34
1656248687821,MATH 10B,A02,083208,Lim; Seonhee,7,0,35,28
1656248687821,MATH 10B,A03,093472,Staff,1,0,34,33
1656248687821,MATH 10B,B01,083739,Sinha; Shubham,11,0,30,19
1656248693853,MATH 18,A01,083743,Cinel; Cameron Alexander,7,0,30,23
1656248693853,MATH 18,A02,083744,Cinel; Cameron Alexander,9,0,30,21
1656248693853,MATH 18,A03,083745,Cinel; Cameron Alexander,5,0,30,25
1656248693853,MATH 18,B01,083748,Rideout; David Porter,1,0,36,35
1656248693853,MATH 18,B02,083749,Rideout; David Porter,0,0,36,36
1656248693853,MATH 18,B03,083750,Rideout; David Porter,0,0,36,36
1656248693853,MATH 18,B04,083751,Rideout; David Porter,0,1,36,36
1656248693853,MATH 18,B05,093473,Rideout; David Porter,0,0,36,36
1656248693853,MATH 18,B06,093474,Rideout; David Porter,3,0,36,33
1656248699881,MATH 20A,A01,083754,Zheng; Zequn,11,0,40,29
1656248705909,MATH 20B,A01,083756,Briones; Jor-el Thomas Caparas,0,0,36,36
1656248705909,MATH 20B,A02,083757,Briones; Jor-el Thomas Caparas,0,0,36,36
1656248705909,MATH 20B,A03,093475,Staff,0,0,36,36
1656248711937,MATH 20C,A01,083760,Briones; Jor-el Thomas Caparas,0,0,35,35
1656248711937,MATH 20C,A02,083761,Briones; Jor-el Thomas Caparas,9,1,35,26
1656248711937,MATH 20C,A03,093476,Staff,0,0,35,35
1656248711937,MATH 20C,B01,083762,Bach; Quang Tran,1,0,30,29
1656248717962,MATH 20D,A01,083765,Tran; Brian Kha,1,0,30,29
1656248717962,MATH 20D,A02,083766,Tran; Brian Kha,0,1,30,30
1656248717962,MATH 20D,A03,083767,Tran; Brian Kha,2,0,30,28
1656248723991,MATH 20E,A01,083771,Ganguly; Soumya,3,0,32,29
1656248723991,MATH 20E,A02,083772,Ganguly; Soumya,0,0,32,32
1656248723991,MATH 20E,B01,083773,Ciotti; Benjamin,16,0,35,19
1656248723991,MATH 20E,B02,083774,Ciotti; Benjamin,15,0,35,20
1656248730026,MATH 103A,A01,083777,Greenfeld; Be'Eri,1,0,36,35
1656248730026,MATH 103A,A02,083778,Greenfeld; Be'Eri,1,0,36,35
1656248730026,MATH 103A,A03,093561,Staff,5,0,36,31
1656248730026,MATH 103A,B01,083779,Greenfeld; Be'Eri,8,0,36,28
1656248730026,MATH 103A,B02,083780,Greenfeld; Be'Eri,1,0,36,35
1656248730026,MATH 103A,B03,093562,Staff,0,0,36,36
1656248736054,MATH 105,A01,085443,Carter; Anne Toulson,5,0,35,30
1656248736054,MATH 105,A02,093477,Staff,14,0,35,21
1656248742080,MATH 109,A01,083213,Ganzberger; Geoffrey Michael,0,0,34,34
1656248742080,MATH 109,A02,083214,Ganzberger; Geoffrey Michael,0,0,34,34
1656248742080,MATH 109,A03,093478,Staff,1,0,34,33
1656248742080,MATH 109,B01,083215,Ganzberger; Geoffrey Michael,4,0,32,28
1656248742080,MATH 109,B02,083216,Ganzberger; Geoffrey Michael,1,0,32,31
1656248742080,MATH 109,B03,093479,Staff,3,0,32,29
1656248748114,MATH 142A,A01,083219,Chow; Bennett,2,0,32,30
1656248748114,MATH 142A,A02,083220,Chow; Bennett,8,0,32,24
1656248748114,MATH 142A,A03,093480,Staff,5,0,32,27
1656248748114,MATH 142A,B03,093481,Staff,3,0,32,29
1656248748114,MATH 142A,B04,093558,Staff,6,0,32,26
1656248748114,MATH 142A,B05,093559,Staff,0,0,32,32
1656248754147,MATH 193A,A01,083224,Rotar; Vladimir,0,1,34,34
1656248754147,MATH 193A,A02,083225,Rotar; Vladimir,0,0,34,34
1656248754147,MATH 193A,A03,083781,Rotar; Vladimir,0,0,34,34
1656248754147,MATH 193A,A04,083782,Rotar; Vladimir,6,0,34,28
1656248754147,MATH 193A,A05,093482,Rotar; Vladimir,0,0,34,34
1656248760181,MATH 197,001,091859,McAuley; Julian John,9999,0,9999,0
1656248760181,MATH 197,002,095566,Kedlaya; Kiran S.,9997,0,9999,2
1656248760181,MATH 197,003,095567,Xiao; Ming,9999,0,9999,0
1656248760181,MATH 197,004,095571,Perols; Johan Lars,9998,0,9999,1
1656248767239,COGS 9,A01,083615,Shannon; Kyle Michael,3,0,75,72
1656248773269,COGS 11,A01,083617,Boyle; Mary E. T.,14,0,48,34
1656248779300,COGS 13,A01,083071,Bastos; Amalia Pinkusfeld,4,0,71,67
1656248785326,COGS 14A,A01,092681,Semenuks; Arturs,1,12,100,99
1656248791356,COGS 14B,A01,083073,Cheng; Tzu-Han,7,0,63,56
1656248797381,COGS 17,A01,092677,Semenuks; Arturs,7,0,81,74
1656248803405,COGS 100,A01,083619,Allen; Michael Gordon,2,0,70,68
1656248809427,COGS 101A,A01,083621,Davis; Joshua Daniel,4,0,68,64
1656248815455,COGS 101B,A01,091572,Allen; Michael Gordon,4,0,65,61
1656248821484,COGS 101C,A01,083625,Delgado; Tania,10,0,35,25
1656248827510,COGS 107A,A01,083627,Boyle; Mary E. T.,0,0,60,60
1656248833536,COGS 118A,A01,083075,Gupta; Anjum,8,0,76,68
1656248839564,CSE 3,A50,083646,Miranda; Gregory Joseph,18,0,50,32
1656248845589,CSE 8A,A50,083650,Miranda; Gregory Joseph,2,2,56,54
1656248851614,CSE 11,A01,083080,Cao; Yingjun,0,49,40,40
1656248857643,CSE 12,A01,083652,Krause-Levy; Sophia Louisa,5,1,120,115
1656248863668,CSE 15L,A01,083654,Morris; Justin Loren,2,0,50,48
1656248863668,CSE 15L,A02,083655,Morris; Justin Loren,4,0,50,46
1656248869692,CSE 20,A01,083657,Tran; Khoa Dang,30,0,80,50
1656248875717,CSE 21,A01,095574,Bach; Quang Tran,23,0,48,25
1656248881750,CSE 30,A01,083084,Eldon; John,2,6,80,78
1656248881750,CSE 30,B01,095061,Bhaskar; Nishant,0,1,50,50
1656248887775,CSE 100,A01,083659,Cao; Yingjun,1,18,70,69
1656248893800,CSE 134B,A01,083661,Powell; Thomas Allan,5,0,100,95
1656248899827,CSE 140,A01,083663,Gungor; Onat,9,0,85,76
1656248905856,CSE 140L,A01,083088,Eldon; John,8,0,100,92
1656248911890,CSE 175,A01,083665,Kumar; Rakesh,0,0,25,25
1656248917918,CSE 190,A00,092507,Dubnov; Shlomo,3,0,20,17
1656248923944,ECE 45,A01,083139,Congero; Spencer William,1,0,75,74
1656248929970,ECE 65,A50,083695,Saad; Andrew S,9,0,30,21
1656248929970,ECE 65,A51,095125,Staff,24,0,26,2
1656248935993,ECE 109,A01,091882,Touri; Behrouz,0,1,70,70
1656248942024,ECE 180,A00,083140,Abi Samra; Nicholas Camill,1,0,30,29
1656248942024,ECE 180,B00,083141,Abi Samra; Nicholas Camill,0,4,30,30
1656248948051,MATH 10A,A01,083735,Patchell; Gregory David,0,0,30,30
1656248948051,MATH 10A,A02,083736,Patchell; Gregory David,22,0,30,8
1656248948051,MATH 10A,A03,083737,Patchell; Gregory David,16,0,30,14
1656248954077,MATH 10B,A01,083207,Lim; Seonhee,0,0,34,34
1656248954077,MATH 10B,A02,083208,Lim; Seonhee,7,0,35,28
1656248954077,MATH 10B,A03,093472,Staff,1,0,34,33
1656248954077,MATH 10B,B01,083739,Sinha; Shubham,11,0,30,19
1656248960107,MATH 18,A01,083743,Cinel; Cameron Alexander,7,0,30,23
1656248960107,MATH 18,A02,083744,Cinel; Cameron Alexander,9,0,30,21
1656248960107,MATH 18,A03,083745,Cinel; Cameron Alexander,5,0,30,25
1656248960107,MATH 18,B01,083748,Rideout; David Porter,1,0,36,35
1656248960107,MATH 18,B02,083749,Rideout; David Porter,0,0,36,36
1656248960107,MATH 18,B03,083750,Rideout; David Porter,0,0,36,36
1656248960107,MATH 18,B04,083751,Rideout; David Porter,0,1,36,36
1656248960107,MATH 18,B05,093473,Rideout; David Porter,0,0,36,36
1656248960107,MATH 18,B06,093474,Rideout; David Porter,3,0,36,33
1656248966131,MATH 20A,A01,083754,Zheng; Zequn,11,0,40,29
1656248972158,MATH 20B,A01,083756,Briones; Jor-el Thomas Caparas,0,0,36,36
1656248972158,MATH 20B,A02,083757,Briones; Jor-el Thomas Caparas,0,0,36,36
1656248972158,MATH 20B,A03,093475,Staff,0,0,36,36
1656248978188,MATH 20C,A01,083760,Briones; Jor-el Thomas Caparas,0,0,35,35
1656248978188,MATH 20C,A02,083761,Briones; Jor-el Thomas Caparas,9,1,35,26
1656248978188,MATH 20C,A03,093476,Staff,0,0,35,35
1656248978188,MATH 20C,B01,083762,Bach; Quang Tran,1,0,30,29
1656248984215,MATH 20D,A01,083765,Tran; Brian Kha,1,0,30,29
1656248984215,MATH 20D,A02,083766,Tran; Brian Kha,0,1,30,30
1656248984215,MATH 20D,A03,083767,Tran; Brian Kha,2,0,30,28
1656248990242,MATH 20E,A01,083771,Ganguly; Soumya,3,0,32,29
1656248990242,MATH 20E,A02,083772,Ganguly; Soumya,0,0,32,32
1656248990242,MATH 20E,B01,083773,Ciotti; Benjamin,16,0,35,19
1656248990242,MATH 20E,B02,083774,Ciotti; Benjamin,15,0,35,20
1656248996269,MATH 103A,A01,083777,Greenfeld; Be'Eri,1,0,36,35
1656248996269,MATH 103A,A02,083778,Greenfeld; Be'Eri,1,0,36,35
1656248996269,MATH 103A,A03,093561,Staff,5,0,36,31
1656248996269,MATH 103A,B01,083779,Greenfeld; Be'Eri,8,0,36,28
1656248996269,MATH 103A,B02,083780,Greenfeld; Be'Eri,1,0,36,35
1656248996269,MATH 103A,B03,093562,Staff,0,0,36,36
1656249002305,MATH 105,A01,085443,Carter; Anne Toulson,5,0,35,30
1656249002305,MATH 105,A02,093477,Staff,14,0,35,21
1656249008332,MATH 109,A01,083213,Ganzberger; Geoffrey Michael,0,0,34,34
1656249008332,MATH 109,A02,083214,Ganzberger; Geoffrey Michael,0,0,34,34
1656249008332,MATH 109,A03,093478,Staff,1,0,34,33
1656249008332,MATH 109,B01,083215,Ganzberger; Geoffrey Michael,4,0,32,28
1656249008332,MATH 109,B02,083216,Ganzberger; Geoffrey Michael,1,0,32,31
1656249008332,MATH 109,B03,093479,Staff,3,0,32,29
1656249014361,MATH 142A,A01,083219,Chow; Bennett,2,0,32,30
1656249014361,MATH 142A,A02,083220,Chow; Bennett,8,0,32,24
1656249014361,MATH 142A,A03,093480,Staff,5,0,32,27
1656249014361,MATH 142A,B03,093481,Staff,3,0,32,29
1656249014361,MATH 142A,B04,093558,Staff,6,0,32,26
1656249014361,MATH 142A,B05,093559,Staff,0,0,32,32
1656249020386,MATH 193A,A01,083224,Rotar; Vladimir,0,1,34,34
1656249020386,MATH 193A,A02,083225,Rotar; Vladimir,0,0,34,34
1656249020386,MATH 193A,A03,083781,Rotar; Vladimir,0,0,34,34
1656249020386,MATH 193A,A04,083782,Rotar; Vladimir,6,0,34,28
1656249020386,MATH 193A,A05,093482,Rotar; Vladimir,0,0,34,34
1656249026412,MATH 197,001,091859,McAuley; Julian John,9999,0,9999,0
1656249026412,MATH 197,002,095566,Kedlaya; Kiran S.,9997,0,9999,2
1656249026412,MATH 197,003,095567,Xiao; Ming,9999,0,9999,0
1656249026412,MATH 197,004,095571,Perols; Johan Lars,9998,0,9999,1
1656249033488,COGS 9,A01,083615,Shannon; Kyle Michael,3,0,75,72
1656249039512,COGS 11,A01,083617,Boyle; Mary E. T.,14,0,48,34
1656249045538,COGS 13,A01,083071,Bastos; Amalia Pinkusfeld,4,0,71,67
1656249051563,COGS 14A,A01,092681,Semenuks; Arturs,1,12,100,99
1656249057588,COGS 14B,A01,083073,Cheng; Tzu-Han,7,0,63,56
1656249063612,COGS 17,A01,092677,Semenuks; Arturs,7,0,81,74
1656249069638,COGS 100,A01,083619,Allen; Michael Gordon,2,0,70,68
1656249075668,COGS 101A,A01,083621,Davis; Joshua Daniel,4,0,68,64
1656249081697,COGS 101B,A01,091572,Allen; Michael Gordon,4,0,65,61
1656249087729,COGS 101C,A01,083625,Delgado; Tania,10,0,35,25
1656249093756,COGS 107A,A01,083627,Boyle; Mary E. T.,0,0,60,60
1656249099787,COGS 118A,A01,083075,Gupta; Anjum,8,0,76,68
1656249105814,CSE 3,A50,083646,Miranda; Gregory Joseph,18,0,50,32
1656249111837,CSE 8A,A50,083650,Miranda; Gregory Joseph,2,2,56,54
1656249117862,CSE 11,A01,083080,Cao; Yingjun,0,49,40,40
1656249123892,CSE 12,A01,083652,Krause-Levy; Sophia Louisa,5,1,120,115
1656249129918,CSE 15L,A01,083654,Morris; Justin Loren,2,0,50,48
1656249129918,CSE 15L,A02,083655,Morris; Justin Loren,4,0,50,46
1656249135947,CSE 20,A01,083657,Tran; Khoa Dang,30,0,80,50
1656249141973,CSE 21,A01,095574,Bach; Quang Tran,23,0,48,25
1656249148003,CSE 30,A01,083084,Eldon; John,2,6,80,78
1656249148003,CSE 30,B01,095061,Bhaskar; Nishant,0,1,50,50
1656249154028,CSE 100,A01,083659,Cao; Yingjun,1,18,70,69
1656249160054,CSE 134B,A01,083661,Powell; Thomas Allan,5,0,100,95
1656249166079,CSE 140,A01,083663,Gungor; Onat,9,0,85,76
1656249172110,CSE 140L,A01,083088,Eldon; John,8,0,100,92
1656249178141,CSE 175,A01,083665,Kumar; Rakesh,0,0,25,25
1656249184167,CSE 190,A00,092507,Dubnov; Shlomo,3,0,20,17
1656249190194,ECE 45,A01,083139,Congero; Spencer William,1,0,75,74
1656249196226,ECE 65,A50,083695,Saad; Andrew S,9,0,30,21
1656249196226,ECE 65,A51,095125,Staff,24,0,26,2
1656249202252,ECE 109,A01,091882,Touri; Behrouz,0,1,70,70
1656249208281,ECE 180,A00,083140,Abi Samra; Nicholas Camill,1,0,30,29
1656249208281,ECE 180,B00,083141,Abi Samra; Nicholas Camill,0,4,30,30
1656249214307,MATH 10A,A01,083735,Patchell; Gregory David,0,0,30,30
1656249214307,MATH 10A,A02,083736,Patchell; Gregory David,22,0,30,8
1656249214307,MATH 10A,A03,083737,Patchell; Gregory David,16,0,30,14
1656249220335,MATH 10B,A01,083207,Lim; Seonhee,0,0,34,34
1656249220335,MATH 10B,A02,083208,Lim; Seonhee,7,0,35,28
1656249220335,MATH 10B,A03,093472,Staff,1,0,34,33
1656249220335,MATH 10B,B01,083739,Sinha; Shubham,11,0,30,19
1656249226375,MATH 18,A01,083743,Cinel; Cameron Alexander,7,0,30,23
1656249226375,MATH 18,A02,083744,Cinel; Cameron Alexander,9,0,30,21
1656249226375,MATH 18,A03,083745,Cinel; Cameron Alexander,5,0,30,25
1656249226375,MATH 18,B01,083748,Rideout; David Porter,1,0,36,35
1656249226375,MATH 18,B02,083749,Rideout; David Porter,0,0,36,36
1656249226375,MATH 18,B03,083750,Rideout; David Porter,0,0,36,36
1656249226375,MATH 18,B04,083751,Rideout; David Porter,0,1,36,36
1656249226375,MATH 18,B05,093473,Rideout; David Porter,0,0,36,36
1656249226375,MATH 18,B06,093474,Rideout; David Porter,3,0,36,33
1656249232402,MATH 20A,A01,083754,Zheng; Zequn,11,0,40,29
1656249238427,MATH 20B,A01,083756,Briones; Jor-el Thomas Caparas,0,0,36,36
1656249238427,MATH 20B,A02,083757,Briones; Jor-el Thomas Caparas,0,0,36,36
1656249238427,MATH 20B,A03,093475,Staff,0,0,36,36
1656249244470,MATH 20C,A01,083760,Briones; Jor-el Thomas Caparas,0,0,35,35
1656249244470,MATH 20C,A02,083761,Briones; Jor-el Thomas Caparas,9,1,35,26
1656249244470,MATH 20C,A03,093476,Staff,0,0,35,35
1656249244470,MATH 20C,B01,083762,Bach; Quang Tran,1,0,30,29
1656249250495,MATH 20D,A01,083765,Tran; Brian Kha,1,0,30,29
1656249250495,MATH 20D,A02,083766,Tran; Brian Kha,0,1,30,30
1656249250495,MATH 20D,A03,083767,Tran; Brian Kha,2,0,30,28
1656249256529,MATH 20E,A01,083771,Ganguly; Soumya,3,0,32,29
1656249256529,MATH 20E,A02,083772,Ganguly; Soumya,0,0,32,32
1656249256529,MATH 20E,B01,083773,Ciotti; Benjamin,16,0,35,19
1656249256529,MATH 20E,B02,083774,Ciotti; Benjamin,15,0,35,20
1656249262645,MATH 103A,A01,083777,Greenfeld; Be'Eri,1,0,36,35
1656249262645,MATH 103A,A02,083778,Greenfeld; Be'Eri,1,0,36,35
1656249262645,MATH 103A,A03,093561,Staff,5,0,36,31
1656249262645,MATH 103A,B01,083779,Greenfeld; Be'Eri,8,0,36,28
1656249262645,MATH 103A,B02,083780,Greenfeld; Be'Eri,1,0,36,35
1656249262645,MATH 103A,B03,093562,Staff,0,0,36,36
1656249268675,MATH 105,A01,085443,Carter; Anne Toulson,5,0,35,30
1656249268675,MATH 105,A02,093477,Staff,14,0,35,21
1656249274701,MATH 109,A01,083213,Ganzberger; Geoffrey Michael,0,0,34,34
1656249274701,MATH 109,A02,083214,Ganzberger; Geoffrey Michael,0,0,34,34
1656249274701,MATH 109,A03,093478,Staff,1,0,34,33
1656249274701,MATH 109,B01,083215,Ganzberger; Geoffrey Michael,4,0,32,28
1656249274701,MATH 109,B02,083216,Ganzberger; Geoffrey Michael,1,0,32,31
1656249274701,MATH 109,B03,093479,Staff,3,0,32,29
1656249280729,MATH 142A,A01,083219,Chow; Bennett,2,0,32,30
1656249280729,MATH 142A,A02,083220,Chow; Bennett,8,0,32,24
1656249280729,MATH 142A,A03,093480,Staff,5,0,32,27
1656249280729,MATH 142A,B03,093481,Staff,3,0,32,29
1656249280729,MATH 142A,B04,093558,Staff,6,0,32,26
1656249280729,MATH 142A,B05,093559,Staff,0,0,32,32
1656249286754,MATH 193A,A01,083224,Rotar; Vladimir,0,1,34,34
1656249286754,MATH 193A,A02,083225,Rotar; Vladimir,0,0,34,34
1656249286754,MATH 193A,A03,083781,Rotar; Vladimir,0,0,34,34
1656249286754,MATH 193A,A04,083782,Rotar; Vladimir,6,0,34,28
1656249286754,MATH 193A,A05,093482,Rotar; Vladimir,0,0,34,34
1656249292784,MATH 197,001,091859,McAuley; Julian John,9999,0,9999,0
1656249292784,MATH 197,002,095566,Kedlaya; Kiran S.,9997,0,9999,2
1656249292784,MATH 197,003,095567,Xiao; Ming,9999,0,9999,0
1656249292784,MATH 197,004,095571,Perols; Johan Lars,9998,0,9999,1
1656249299843,COGS 9,A01,083615,Shannon; Kyle Michael,3,0,75,72
1656249305875,COGS 11,A01,083617,Boyle; Mary E. T.,14,0,48,34
1656249311909,COGS 13,A01,083071,Bastos; Amalia Pinkusfeld,4,0,71,67
1656249317941,COGS 14A,A01,092681,Semenuks; Arturs,1,12,100,99
1656249323967,COGS 14B,A01,083073,Cheng; Tzu-Han,7,0,63,56
1656249329992,COGS 17,A01,092677,Semenuks; Arturs,7,0,81,74
1656249336019,COGS 100,A01,083619,Allen; Michael Gordon,2,0,70,68
1656249342045,COGS 101A,A01,083621,Davis; Joshua Daniel,4,0,68,64
1656249348070,COGS 101B,A01,091572,Allen; Michael Gordon,4,0,65,61
1656249354101,COGS 101C,A01,083625,Delgado; Tania,10,0,35,25
1656249360126,COGS 107A,A01,083627,Boyle; Mary E. T.,0,0,60,60
1656249366152,COGS 118A,A01,083075,Gupta; Anjum,8,0,76,68
1656249372178,CSE 3,A50,083646,Miranda; Gregory Joseph,18,0,50,32
1656249378204,CSE 8A,A50,083650,Miranda; Gregory Joseph,2,2,56,54
1656249384229,CSE 11,A01,083080,Cao; Yingjun,0,49,40,40
1656249390261,CSE 12,A01,083652,Krause-Levy; Sophia Louisa,5,1,120,115
1656249396289,CSE 15L,A01,083654,Morris; Justin Loren,2,0,50,48
1656249396289,CSE 15L,A02,083655,Morris; Justin Loren,4,0,50,46
1656249402322,CSE 20,A01,083657,Tran; Khoa Dang,30,0,80,50
1656249408349,CSE 21,A01,095574,Bach; Quang Tran,23,0,48,25
1656249414376,CSE 30,A01,083084,Eldon; John,2,6,80,78
1656249414376,CSE 30,B01,095061,Bhaskar; Nishant,0,1,50,50
1656249420402,CSE 100,A01,083659,Cao; Yingjun,1,18,70,69
1656249426427,CSE 134B,A01,083661,Powell; Thomas Allan,5,0,100,95
1656249432460,CSE 140,A01,083663,Gungor; Onat,9,0,85,76
1656249438484,CSE 140L,A01,083088,Eldon; John,8,0,100,92
1656249444509,CSE 175,A01,083665,Kumar; Rakesh,0,0,25,25
1656249450537,CSE 190,A00,092507,Dubnov; Shlomo,3,0,20,17
1656249456563,ECE 45,A01,083139,Congero; Spencer William,1,0,75,74
1656249462591,ECE 65,A50,083695,Saad; Andrew S,9,0,30,21
1656249462591,ECE 65,A51,095125,Staff,24,0,26,2
1656249468617,ECE 109,A01,091882,Touri; Behrouz,0,1,70,70
1656249474643,ECE 180,A00,083140,Abi Samra; Nicholas Camill,1,0,30,29
1656249474643,ECE 180,B00,083141,Abi Samra; Nicholas Camill,0,4,30,30
1656249480672,MATH 10A,A01,083735,Patchell; Gregory David,0,0,30,30
1656249480672,MATH 10A,A02,083736,Patchell; Gregory David,22,0,30,8
1656249480672,MATH 10A,A03,083737,Patchell; Gregory David,16,0,30,14
1656249486701,MATH 10B,A01,083207,Lim; Seonhee,0,0,34,34
1656249486701,MATH 10B,A02,083208,Lim; Seonhee,7,0,35,28
1656249486701,MATH 10B,A03,093472,Staff,1,0,34,33
1656249486701,MATH 10B,B01,083739,Sinha; Shubham,11,0,30,19
1656249492730,MATH 18,A01,083743,Cinel; Cameron Alexander,7,0,30,23
1656249492730,MATH 18,A02,083744,Cinel; Cameron Alexander,9,0,30,21
1656249492730,MATH 18,A03,083745,Cinel; Cameron Alexander,5,0,30,25
1656249492730,MATH 18,B01,083748,Rideout; David Porter,1,0,36,35
1656249492730,MATH 18,B02,083749,Rideout; David Porter,0,0,36,36
1656249492730,MATH 18,B03,083750,Rideout; David Porter,0,0,36,36
1656249492730,MATH 18,B04,083751,Rideout; David Porter,0,1,36,36
1656249492730,MATH 18,B05,093473,Rideout; David Porter,0,0,36,36
1656249492730,MATH 18,B06,093474,Rideout; David Porter,3,0,36,33
1656249498763,MATH 20A,A01,083754,Zheng; Zequn,11,0,40,29
1656249504797,MATH 20B,A01,083756,Briones; Jor-el Thomas Caparas,0,0,36,36
1656249504797,MATH 20B,A02,083757,Briones; Jor-el Thomas Caparas,0,0,36,36
1656249504797,MATH 20B,A03,093475,Staff,0,0,36,36
1656249510823,MATH 20C,A01,083760,Briones; Jor-el Thomas Caparas,0,0,35,35
1656249510823,MATH 20C,A02,083761,Briones; Jor-el Thomas Caparas,9,1,35,26
1656249510823,MATH 20C,A03,093476,Staff,0,0,35,35
1656249510823,MATH 20C,B01,083762,Bach; Quang Tran,1,0,30,29
1656249516857,MATH 20D,A01,083765,Tran; Brian Kha,1,0,30,29
1656249516857,MATH 20D,A02,083766,Tran; Brian Kha,0,1,30,30
1656249516857,MATH 20D,A03,083767,Tran; Brian Kha,2,0,30,28
1656249522886,MATH 20E,A01,083771,Ganguly; Soumya,3,0,32,29
1656249522886,MATH 20E,A02,083772,Ganguly; Soumya,0,0,32,32
1656249522886,MATH 20E,B01,083773,Ciotti; Benjamin,16,0,35,19
1656249522886,MATH 20E,B02,083774,Ciotti; Benjamin,15,0,35,20
1656249528915,MATH 103A,A01,083777,Greenfeld; Be'Eri,1,0,36,35
1656249528915,MATH 103A,A02,083778,Greenfeld; Be'Eri,1,0,36,35
1656249528915,MATH 103A,A03,093561,Staff,5,0,36,31
1656249528915,MATH 103A,B01,083779,Greenfeld; Be'Eri,8,0,36,28
1656249528915,MATH 103A,B02,083780,Greenfeld; Be'Eri,1,0,36,35
1656249528915,MATH 103A,B03,093562,Staff,0,0,36,36
1656249534942,MATH 105,A01,085443,Carter; Anne Toulson,5,0,35,30
1656249534942,MATH 105,A02,093477,Staff,14,0,35,21
1656249540970,MATH 109,A01,083213,Ganzberger; Geoffrey Michael,0,0,34,34
1656249540970,MATH 109,A02,083214,Ganzberger; Geoffrey Michael,0,0,34,34
1656249540970,MATH 109,A03,093478,Staff,1,0,34,33
1656249540970,MATH 109,B01,083215,Ganzberger; Geoffrey Michael,4,0,32,28
1656249540970,MATH 109,B02,083216,Ganzberger; Geoffrey Michael,1,0,32,31
1656249540970,MATH 109,B03,093479,Staff,3,0,32,29
1656249546998,MATH 142A,A01,083219,Chow; Bennett,2,0,32,30
1656249546998,MATH 142A,A02,083220,Chow; Bennett,8,0,32,24
1656249546998,MATH 142A,A03,093480,Staff,5,0,32,27
1656249546998,MATH 142A,B03,093481,Staff,3,0,32,29
1656249546998,MATH 142A,B04,093558,Staff,6,0,32,26
1656249546998,MATH 142A,B05,093559,Staff,0,0,32,32
1656249553025,MATH 193A,A01,083224,Rotar; Vladimir,0,1,34,34
1656249553025,MATH 193A,A02,083225,Rotar; Vladimir,0,0,34,34
1656249553025,MATH 193A,A03,083781,Rotar; Vladimir,0,0,34,34
1656249553025,MATH 193A,A04,083782,Rotar; Vladimir,6,0,34,28
1656249553025,MATH 193A,A05,093482,Rotar; Vladimir,0,0,34,34
1656249559062,MATH 197,001,091859,McAuley; Julian John,9999,0,9999,0
1656249559062,MATH 197,002,095566,Kedlaya; Kiran S.,9997,0,9999,2
1656249559062,MATH 197,003,095567,Xiao; Ming,9999,0,9999,0
1656249559062,MATH 197,004,095571,Perols; Johan Lars,9998,0,9999,1
1656249566125,COGS 9,A01,083615,Shannon; Kyle Michael,3,0,75,72
1656249572156,COGS 11,A01,083617,Boyle; Mary E. T.,14,0,48,34
1656249578191,COGS 13,A01,083071,Bastos; Amalia Pinkusfeld,4,0,71,67
1656249584221,COGS 14A,A01,092681,Semenuks; Arturs,1,12,100,99
1656249590247,COGS 14B,A01,083073,Cheng; Tzu-Han,7,0,63,56
1656249596274,COGS 17,A01,092677,Semenuks; Arturs,7,0,81,74
1656249602298,COGS 100,A01,083619,Allen; Michael Gordon,2,0,70,68
1656249608323,COGS 101A,A01,083621,Davis; Joshua Daniel,4,0,68,64
1656249614352,COGS 101B,A01,091572,Allen; Michael Gordon,4,0,65,61
1656249620384,COGS 101C,A01,083625,Delgado; Tania,10,0,35,25
1656249626416,COGS 107A,A01,083627,Boyle; Mary E. T.,0,0,60,60
1656249632442,COGS 118A,A01,083075,Gupta; Anjum,8,0,76,68
1656249638471,CSE 3,A50,083646,Miranda; Gregory Joseph,18,0,50,32
1656249644502,CSE 8A,A50,083650,Miranda; Gregory Joseph,2,2,56,54
1656249650527,CSE 11,A01,083080,Cao; Yingjun,0,49,40,40
1656249656554,CSE 12,A01,083652,Krause-Levy; Sophia Louisa,5,1,120,115
1656249662579,CSE 15L,A01,083654,Morris; Justin Loren,2,0,50,48
1656249662579,CSE 15L,A02,083655,Morris; Justin Loren,4,0,50,46
1656249668610,CSE 20,A01,083657,Tran; Khoa Dang,30,0,80,50
1656249674636,CSE 21,A01,095574,Bach; Quang Tran,23,0,48,25
1656249680669,CSE 30,A01,083084,Eldon; John,2,6,80,78
1656249680669,CSE 30,B01,095061,Bhaskar; Nishant,0,1,50,50
1656249686695,CSE 100,A01,083659,Cao; Yingjun,1,18,70,69
1656249692721,CSE 134B,A01,083661,Powell; Thomas Allan,5,0,100,95
1656249698746,CSE 140,A01,083663,Gungor; Onat,9,0,85,76
1656249704775,CSE 140L,A01,083088,Eldon; John,8,0,100,92
1656249710805,CSE 175,A01,083665,Kumar; Rakesh,0,0,25,25
1656249716831,CSE 190,A00,092507,Dubnov; Shlomo,3,0,20,17
1656249722858,ECE 45,A01,083139,Congero; Spencer William,1,0,75,74
1656249728883,ECE 65,A50,083695,Saad; Andrew S,9,0,30,21
1656249728883,ECE 65,A51,095125,Staff,24,0,26,2
1656249734914,ECE 109,A01,091882,Touri; Behrouz,0,1,70,70
1656249740946,ECE 180,A00,083140,Abi Samra; Nicholas Camill,1,0,30,29
1656249740946,ECE 180,B00,083141,Abi Samra; Nicholas Camill,0,4,30,30
1656249746975,MATH 10A,A01,083735,Patchell; Gregory David,0,0,30,30
1656249746975,MATH 10A,A02,083736,Patchell; Gregory David,22,0,30,8
1656249746975,MATH 10A,A03,083737,Patchell; Gregory David,16,0,30,14
1656249753001,MATH 10B,A01,083207,Lim; Seonhee,0,0,34,34
1656249753001,MATH 10B,A02,083208,Lim; Seonhee,7,0,35,28
1656249753001,MATH 10B,A03,093472,Staff,1,0,34,33
1656249753001,MATH 10B,B01,083739,Sinha; Shubham,11,0,30,19
1656249759041,MATH 18,A01,083743,Cinel; Cameron Alexander,7,0,30,23
1656249759041,MATH 18,A02,083744,Cinel; Cameron Alexander,9,0,30,21
1656249759041,MATH 18,A03,083745,Cinel; Cameron Alexander,5,0,30,25
1656249759041,MATH 18,B01,083748,Rideout; David Porter,1,0,36,35
1656249759041,MATH 18,B02,083749,Rideout; David Porter,0,0,36,36
1656249759041,MATH 18,B03,083750,Rideout; David Porter,0,0,36,36
1656249759041,MATH 18,B04,083751,Rideout; David Porter,0,1,36,36
1656249759041,MATH 18,B05,093473,Rideout; David Porter,0,0,36,36
1656249759041,MATH 18,B06,093474,Rideout; David Porter,3,0,36,33
1656249765079,MATH 20A,A01,083754,Zheng; Zequn,11,0,40,29
1656249771106,MATH 20B,A01,083756,Briones; Jor-el Thomas Caparas,0,0,36,36
1656249771106,MATH 20B,A02,083757,Briones; Jor-el Thomas Caparas,0,0,36,36
1656249771106,MATH 20B,A03,093475,Staff,0,0,36,36
1656249777133,MATH 20C,A01,083760,Briones; Jor-el Thomas Caparas,0,0,35,35
1656249777133,MATH 20C,A02,083761,Briones; Jor-el Thomas Caparas,9,1,35,26
1656249777133,MATH 20C,A03,093476,Staff,0,0,35,35
1656249777133,MATH 20C,B01,083762,Bach; Quang Tran,1,0,30,29
1656249783173,MATH 20D,A01,083765,Tran; Brian Kha,1,0,30,29
1656249783173,MATH 20D,A02,083766,Tran; Brian Kha,0,1,30,30
1656249783173,MATH 20D,A03,083767,Tran; Brian Kha,2,0,30,28
1656249789200,MATH 20E,A01,083771,Ganguly; Soumya,3,0,32,29
1656249789200,MATH 20E,A02,083772,Ganguly; Soumya,0,0,32,32
1656249789200,MATH 20E,B01,083773,Ciotti; Benjamin,16,0,35,19
1656249789200,MATH 20E,B02,083774,Ciotti; Benjamin,15,0,35,20
1656249795240,MATH 103A,A01,083777,Greenfeld; Be'Eri,1,0,36,35
1656249795240,MATH 103A,A02,083778,Greenfeld; Be'Eri,1,0,36,35
1656249795240,MATH 103A,A03,093561,Staff,5,0,36,31
1656249795240,MATH 103A,B01,083779,Greenfeld; Be'Eri,8,0,36,28
1656249795240,MATH 103A,B02,083780,Greenfeld; Be'Eri,1,0,36,35
1656249795240,MATH 103A,B03,093562,Staff,0,0,36,36
1656249801273,MATH 105,A01,085443,Carter; Anne Toulson,5,0,35,30
1656249801273,MATH 105,A02,093477,Staff,14,0,35,21
1656249807301,MATH 109,A01,083213,Ganzberger; Geoffrey Michael,0,0,34,34
1656249807301,MATH 109,A02,083214,Ganzberger; Geoffrey Michael,0,0,34,34
1656249807301,MATH 109,A03,093478,Staff,1,0,34,33
1656249807301,MATH 109,B01,083215,Ganzberger; Geoffrey Michael,4,0,32,28
1656249807301,MATH 109,B02,083216,Ganzberger; Geoffrey Michael,1,0,32,31
1656249807301,MATH 109,B03,093479,Staff,3,0,32,29
1656249813330,MATH 142A,A01,083219,Chow; Bennett,2,0,32,30
1656249813330,MATH 142A,A02,083220,Chow; Bennett,8,0,32,24
1656249813330,MATH 142A,A03,093480,Staff,5,0,32,27
1656249813330,MATH 142A,B03,093481,Staff,3,0,32,29
1656249813330,MATH 142A,B04,093558,Staff,6,0,32,26
1656249813330,MATH 142A,B05,093559,Staff,0,0,32,32
1656249819360,MATH 193A,A01,083224,Rotar; Vladimir,0,1,34,34
1656249819360,MATH 193A,A02,083225,Rotar; Vladimir,0,0,34,34
1656249819360,MATH 193A,A03,083781,Rotar; Vladimir,0,0,34,34
1656249819360,MATH 193A,A04,083782,Rotar; Vladimir,6,0,34,28
1656249819360,MATH 193A,A05,093482,Rotar; Vladimir,0,0,34,34
1656249825392,MATH 197,001,091859,McAuley; Julian John,9999,0,9999,0
1656249825392,MATH 197,002,095566,Kedlaya; Kiran S.,9997,0,9999,2
1656249825392,MATH 197,003,095567,Xiao; Ming,9999,0,9999,0
1656249825392,MATH 197,004,095571,Perols; Johan Lars,9998,0,9999,1
1656249832486,COGS 9,A01,083615,Shannon; Kyle Michael,3,0,75,72
1656249838516,COGS 11,A01,083617,Boyle; Mary E. T.,14,0,48,34
1656249844546,COGS 13,A01,083071,Bastos; Amalia Pinkusfeld,4,0,71,67
1656249850579,COGS 14A,A01,092681,Semenuks; Arturs,1,12,100,99
1656249856690,COGS 14B,A01,083073,Cheng; Tzu-Han,7,0,63,56
1656249862716,COGS 17,A01,092677,Semenuks; Arturs,7,0,81,74
1656249868741,COGS 100,A01,083619,Allen; Michael Gordon,2,0,70,68
1656249874769,COGS 101A,A01,083621,Davis; Joshua Daniel,4,0,68,64
1656249880796,COGS 101B,A01,091572,Allen; Michael Gordon,4,0,65,61
1656249886823,COGS 101C,A01,083625,Delgado; Tania,10,0,35,25
1656249892853,COGS 107A,A01,083627,Boyle; Mary E. T.,0,0,60,60
1656249898880,COGS 118A,A01,083075,Gupta; Anjum,8,0,76,68
1656249904908,CSE 3,A50,083646,Miranda; Gregory Joseph,18,0,50,32
1656249910938,CSE 8A,A50,083650,Miranda; Gregory Joseph,2,2,56,54
1656249916968,CSE 11,A01,083080,Cao; Yingjun,0,49,40,40
1656249922995,CSE 12,A01,083652,Krause-Levy; Sophia Louisa,5,1,120,115
1656249929024,CSE 15L,A01,083654,Morris; Justin Loren,2,0,50,48
1656249929024,CSE 15L,A02,083655,Morris; Justin Loren,4,0,50,46
1656249935054,CSE 20,A01,083657,Tran; Khoa Dang,30,0,80,50
1656249941094,CSE 21,A01,095574,Bach; Quang Tran,23,0,48,25
1656249947128,CSE 30,A01,083084,Eldon; John,2,6,80,78
1656249947128,CSE 30,B01,095061,Bhaskar; Nishant,0,1,50,50
1656249953154,CSE 100,A01,083659,Cao; Yingjun,1,18,70,69
1656249959186,CSE 134B,A01,083661,Powell; Thomas Allan,5,0,100,95
1656249965213,CSE 140,A01,083663,Gungor; Onat,9,0,85,76
1656249971240,CSE 140L,A01,083088,Eldon; John,8,0,100,92
1656249977266,CSE 175,A01,083665,Kumar; Rakesh,0,0,25,25
1656249983292,CSE 190,A00,092507,Dubnov; Shlomo,3,0,20,17
1656249989318,ECE 45,A01,083139,Congero; Spencer William,1,0,75,74
1656249995353,ECE 65,A50,083695,Saad; Andrew S,9,0,30,21
1656249995353,ECE 65,A51,095125,Staff,24,0,26,2
1656250001379,ECE 109,A01,091882,Touri; Behrouz,0,1,70,70
1656250007406,ECE 180,A00,083140,Abi Samra; Nicholas Camill,1,0,30,29
1656250007406,ECE 180,B00,083141,Abi Samra; Nicholas Camill,0,4,30,30
1656250013443,MATH 10A,A01,083735,Patchell; Gregory David,0,0,30,30
1656250013443,MATH 10A,A02,083736,Patchell; Gregory David,22,0,30,8
1656250013443,MATH 10A,A03,083737,Patchell; Gregory David,16,0,30,14
1656250019472,MATH 10B,A01,083207,Lim; Seonhee,0,0,34,34
1656250019472,MATH 10B,A02,083208,Lim; Seonhee,7,0,35,28
1656250019472,MATH 10B,A03,093472,Staff,1,0,34,33
1656250019472,MATH 10B,B01,083739,Sinha; Shubham,11,0,30,19
1656250025517,MATH 18,A01,083743,Cinel; Cameron Alexander,7,0,30,23
1656250025517,MATH 18,A02,083744,Cinel; Cameron Alexander,9,0,30,21
1656250025517,MATH 18,A03,083745,Cinel; Cameron Alexander,5,0,30,25
1656250025517,MATH 18,B01,083748,Rideout; David Porter,1,0,36,35
1656250025517,MATH 18,B02,083749,Rideout; David Porter,0,0,36,36
1656250025517,MATH 18,B03,083750,Rideout; David Porter,0,0,36,36
1656250025517,MATH 18,B04,083751,Rideout; David Porter,0,1,36,36
1656250025517,MATH 18,B05,093473,Rideout; David Porter,0,0,36,36
1656250025517,MATH 18,B06,093474,Rideout; David Porter,3,0,36,33
1656250031549,MATH 20A,A01,083754,Zheng; Zequn,11,0,40,29
1656250037584,MATH 20B,A01,083756,Briones; Jor-el Thomas Caparas,0,0,36,36
1656250037584,MATH 20B,A02,083757,Briones; Jor-el Thomas Caparas,0,0,36,36
1656250037584,MATH 20B,A03,093475,Staff,0,0,36,36
1656250043610,MATH 20C,A01,083760,Briones; Jor-el Thomas Caparas,0,0,35,35
1656250043610,MATH 20C,A02,083761,Briones; Jor-el Thomas Caparas,9,1,35,26
1656250043610,MATH 20C,A03,093476,Staff,0,0,35,35
1656250043610,MATH 20C,B01,083762,Bach; Quang Tran,1,0,30,29
1656250049635,MATH 20D,A01,083765,Tran; Brian Kha,1,0,30,29
1656250049635,MATH 20D,A02,083766,Tran; Brian Kha,0,1,30,30
1656250049635,MATH 20D,A03,083767,Tran; Brian Kha,2,0,30,28
1656250055665,MATH 20E,A01,083771,Ganguly; Soumya,3,0,32,29
1656250055665,MATH 20E,A02,083772,Ganguly; Soumya,0,0,32,32
1656250055665,MATH 20E,B01,083773,Ciotti; Benjamin,16,0,35,19
1656250055665,MATH 20E,B02,083774,Ciotti; Benjamin,15,0,35,20
1656250061704,MATH 103A,A01,083777,Greenfeld; Be'Eri,1,0,36,35
1656250061704,MATH 103A,A02,083778,Greenfeld; Be'Eri,1,0,36,35
1656250061704,MATH 103A,A03,093561,Staff,5,0,36,31
1656250061704,MATH 103A,B01,083779,Greenfeld; Be'Eri,8,0,36,28
1656250061704,MATH 103A,B02,083780,Greenfeld; Be'Eri,1,0,36,35
1656250061704,MATH 103A,B03,093562,Staff,0,0,36,36
1656250067731,MATH 105,A01,085443,Carter; Anne Toulson,5,0,35,30
1656250067731,MATH 105,A02,093477,Staff,14,0,35,21
1656250073764,MATH 109,A01,083213,Ganzberger; Geoffrey Michael,0,0,34,34
1656250073764,MATH 109,A02,083214,Ganzberger; Geoffrey Michael,0,0,34,34
1656250073764,MATH 109,A03,093478,Staff,1,0,34,33
1656250073764,MATH 109,B01,083215,Ganzberger; Geoffrey Michael,4,0,32,28
1656250073764,MATH 109,B02,083216,Ganzberger; Geoffrey Michael,1,0,32,31
1656250073764,MATH 109,B03,093479,Staff,3,0,32,29
1656250079792,MATH 142A,A01,083219,Chow; Bennett,2,0,32,30
1656250079792,MATH 142A,A02,083220,Chow; Bennett,8,0,32,24
1656250079792,MATH 142A,A03,093480,Staff,5,0,32,27
1656250079792,MATH 142A,B03,093481,Staff,3,0,32,29
1656250079792,MATH 142A,B04,093558,Staff,6,0,32,26
1656250079792,MATH 142A,B05,093559,Staff,0,0,32,32
1656250085833,MATH 193A,A01,083224,Rotar; Vladimir,0,1,34,34
1656250085833,MATH 193A,A02,083225,Rotar; Vladimir,0,0,34,34
1656250085833,MATH 193A,A03,083781,Rotar; Vladimir,0,0,34,34
1656250085833,MATH 193A,A04,083782,Rotar; Vladimir,6,0,34,28
1656250085833,MATH 193A,A05,093482,Rotar; Vladimir,0,0,34,34
1656250091861,MATH 197,001,091859,McAuley; Julian John,9999,0,9999,0
1656250091861,MATH 197,002,095566,Kedlaya; Kiran S.,9997,0,9999,2
1656250091861,MATH 197,003,095567,Xiao; Ming,9999,0,9999,0
1656250091861,MATH 197,004,095571,Perols; Johan Lars,9998,0,9999,1
1656250098931,COGS 9,A01,083615,Shannon; Kyle Michael,3,0,75,72
1656250104962,COGS 11,A01,083617,Boyle; Mary E. T.,14,0,48,34
1656250110988,COGS 13,A01,083071,Bastos; Amalia Pinkusfeld,4,0,71,67
1656250117024,COGS 14A,A01,092681,Semenuks; Arturs,1,12,100,99
1656250123054,COGS 14B,A01,083073,Cheng; Tzu-Han,7,0,63,56
1656250129080,COGS 17,A01,092677,Semenuks; Arturs,7,0,81,74
1656250135105,COGS 100,A01,083619,Allen; Michael Gordon,2,0,70,68
1656250141136,COGS 101A,A01,083621,Davis; Joshua Daniel,4,0,68,64
1656250147166,COGS 101B,A01,091572,Allen; Michael Gordon,4,0,65,61
1656250153192,COGS 101C,A01,083625,Delgado; Tania,10,0,35,25
1656250159221,COGS 107A,A01,083627,Boyle; Mary E. T.,0,0,60,60
1656250165245,COGS 118A,A01,083075,Gupta; Anjum,8,0,76,68
1656250171273,CSE 3,A50,083646,Miranda; Gregory Joseph,18,0,50,32
1656250177303,CSE 8A,A50,083650,Miranda; Gregory Joseph,2,2,56,54
1656250183339,CSE 11,A01,083080,Cao; Yingjun,0,49,40,40
1656250189373,CSE 12,A01,083652,Krause-Levy; Sophia Louisa,5,1,120,115
1656250195404,CSE 15L,A01,083654,Morris; Justin Loren,2,0,50,48
1656250195404,CSE 15L,A02,083655,Morris; Justin Loren,4,0,50,46
1656250201430,CSE 20,A01,083657,Tran; Khoa Dang,30,0,80,50
1656250207464,CSE 21,A01,095574,Bach; Quang Tran,23,0,48,25
1656250213494,CSE 30,A01,083084,Eldon; John,2,6,80,78
1656250213494,CSE 30,B01,095061,Bhaskar; Nishant,0,1,50,50
1656250219517,CSE 100,A01,083659,Cao; Yingjun,1,18,70,69
1656250225546,CSE 134B,A01,083661,Powell; Thomas Allan,5,0,100,95
1656250231572,CSE 140,A01,083663,Gungor; Onat,9,0,85,76
1656250237595,CSE 140L,A01,083088,Eldon; John,8,0,100,92
1656250243623,CSE 175,A01,083665,Kumar; Rakesh,0,0,25,25
1656250249654,CSE 190,A00,092507,Dubnov; Shlomo,3,0,20,17
1656250255680,ECE 45,A01,083139,Congero; Spencer William,1,0,75,74
1656250261713,ECE 65,A50,083695,Saad; Andrew S,9,0,30,21
1656250261713,ECE 65,A51,095125,Staff,24,0,26,2
1656250267743,ECE 109,A01,091882,Touri; Behrouz,0,1,70,70
1656250273768,ECE 180,A00,083140,Abi Samra; Nicholas Camill,1,0,30,29
1656250273768,ECE 180,B00,083141,Abi Samra; Nicholas Camill,0,4,30,30
1656250279799,MATH 10A,A01,083735,Patchell; Gregory David,0,0,30,30
1656250279799,MATH 10A,A02,083736,Patchell; Gregory David,22,0,30,8
1656250279799,MATH 10A,A03,083737,Patchell; Gregory David,16,0,30,14
1656250285826,MATH 10B,A01,083207,Lim; Seonhee,0,0,34,34
1656250285826,MATH 10B,A02,083208,Lim; Seonhee,7,0,35,28
1656250285826,MATH 10B,A03,093472,Staff,1,0,34,33
1656250285826,MATH 10B,B01,083739,Sinha; Shubham,11,0,30,19
1656250291868,MATH 18,A01,083743,Cinel; Cameron Alexander,7,0,30,23
1656250291868,MATH 18,A02,083744,Cinel; Cameron Alexander,9,0,30,21
1656250291868,MATH 18,A03,083745,Cinel; Cameron Alexander,5,0,30,25
1656250291868,MATH 18,B01,083748,Rideout; David Porter,1,0,36,35
1656250291868,MATH 18,B02,083749,Rideout; David Porter,0,0,36,36
1656250291868,MATH 18,B03,083750,Rideout; David Porter,0,0,36,36
1656250291868,MATH 18,B04,083751,Rideout; David Porter,0,1,36,36
1656250291868,MATH 18,B05,093473,Rideout; David Porter,0,0,36,36
1656250291868,MATH 18,B06,093474,Rideout; David Porter,3,0,36,33
1656250297894,MATH 20A,A01,083754,Zheng; Zequn,11,0,40,29
1656250303934,MATH 20B,A01,083756,Briones; Jor-el Thomas Caparas,0,0,36,36
1656250303934,MATH 20B,A02,083757,Briones; Jor-el Thomas Caparas,0,0,36,36
1656250303934,MATH 20B,A03,093475,Staff,0,0,36,36
1656250309968,MATH 20C,A01,083760,Briones; Jor-el Thomas Caparas,0,0,35,35
1656250309968,MATH 20C,A02,083761,Briones; Jor-el Thomas Caparas,9,1,35,26
1656250309968,MATH 20C,A03,093476,Staff,0,0,35,35
1656250309968,MATH 20C,B01,083762,Bach; Quang Tran,1,0,30,29
1656250315996,MATH 20D,A01,083765,Tran; Brian Kha,1,0,30,29
1656250315996,MATH 20D,A02,083766,Tran; Brian Kha,0,1,30,30
1656250315996,MATH 20D,A03,083767,Tran; Brian Kha,2,0,30,28
1656250322030,MATH 20E,A01,083771,Ganguly; Soumya,3,0,32,29
1656250322030,MATH 20E,A02,083772,Ganguly; Soumya,0,0,32,32
1656250322030,MATH 20E,B01,083773,Ciotti; Benjamin,16,0,35,19
1656250322030,MATH 20E,B02,083774,Ciotti; Benjamin,15,0,35,20
1656250328064,MATH 103A,A01,083777,Greenfeld; Be'Eri,1,0,36,35
1656250328064,MATH 103A,A02,083778,Greenfeld; Be'Eri,1,0,36,35
1656250328064,MATH 103A,A03,093561,Staff,5,0,36,31
1656250328064,MATH 103A,B01,083779,Greenfeld; Be'Eri,8,0,36,28
1656250328064,MATH 103A,B02,083780,Greenfeld; Be'Eri,1,0,36,35
1656250328064,MATH 103A,B03,093562,Staff,0,0,36,36
1656250334092,MATH 105,A01,085443,Carter; Anne Toulson,5,0,35,30
1656250334092,MATH 105,A02,093477,Staff,14,0,35,21
1656250340118,MATH 109,A01,083213,Ganzberger; Geoffrey Michael,0,0,34,34
1656250340118,MATH 109,A02,083214,Ganzberger; Geoffrey Michael,0,0,34,34
1656250340118,MATH 109,A03,093478,Staff,1,0,34,33
1656250340118,MATH 109,B01,083215,Ganzberger; Geoffrey Michael,4,0,32,28
1656250340118,MATH 109,B02,083216,Ganzberger; Geoffrey Michael,1,0,32,31
1656250340118,MATH 109,B03,093479,Staff,3,0,32,29
1656250346143,MATH 142A,A01,083219,Chow; Bennett,2,0,32,30
1656250346143,MATH 142A,A02,083220,Chow; Bennett,8,0,32,24
1656250346143,MATH 142A,A03,093480,Staff,5,0,32,27
1656250346143,MATH 142A,B03,093481,Staff,3,0,32,29
1656250346143,MATH 142A,B04,093558,Staff,6,0,32,26
1656250346143,MATH 142A,B05,093559,Staff,0,0,32,32
1656250352171,MATH 193A,A01,083224,Rotar; Vladimir,0,1,34,34
1656250352171,MATH 193A,A02,083225,Rotar; Vladimir,0,0,34,34
1656250352171,MATH 193A,A03,083781,Rotar; Vladimir,0,0,34,34
1656250352171,MATH 193A,A04,083782,Rotar; Vladimir,6,0,34,28
1656250352171,MATH 193A,A05,093482,Rotar; Vladimir,0,0,34,34
1656250358199,MATH 197,001,091859,McAuley; Julian John,9999,0,9999,0
1656250358199,MATH 197,002,095566,Kedlaya; Kiran S.,9997,0,9999,2
1656250358199,MATH 197,003,095567,Xiao; Ming,9999,0,9999,0
1656250358199,MATH 197,004,095571,Perols; Johan Lars,9998,0,9999,1
1656250365282,COGS 9,A01,083615,Shannon; Kyle Michael,3,0,75,72
1656250371307,COGS 11,A01,083617,Boyle; Mary E. T.,14,0,48,34
1656250377338,COGS 13,A01,083071,Bastos; Amalia Pinkusfeld,4,0,71,67
1656250383361,COGS 14A,A01,092681,Semenuks; Arturs,1,12,100,99
1656250389386,COGS 14B,A01,083073,Cheng; Tzu-Han,7,0,63,56
1656250395411,COGS 17,A01,092677,Semenuks; Arturs,7,0,81,74
1656250401438,COGS 100,A01,083619,Allen; Michael Gordon,2,0,70,68
1656250407462,COGS 101A,A01,083621,Davis; Joshua Daniel,4,0,68,64
1656250413493,COGS 101B,A01,091572,Allen; Michael Gordon,4,0,65,61
1656250419518,COGS 101C,A01,083625,Delgado; Tania,10,0,35,25
1656250425547,COGS 107A,A01,083627,Boyle; Mary E. T.,0,0,60,60
1656250431570,COGS 118A,A01,083075,Gupta; Anjum,8,0,76,68
1656250437597,CSE 3,A50,083646,Miranda; Gregory Joseph,18,0,50,32
1656250443627,CSE 8A,A50,083650,Miranda; Gregory Joseph,2,2,56,54
1656250449650,CSE 11,A01,083080,Cao; Yingjun,0,49,40,40
1656250455748,CSE 12,A01,083652,Krause-Levy; Sophia Louisa,5,1,120,115
1656250461782,CSE 15L,A01,083654,Morris; Justin Loren,2,0,50,48
1656250461782,CSE 15L,A02,083655,Morris; Justin Loren,4,0,50,46
1656250467809,CSE 20,A01,083657,Tran; Khoa Dang,30,0,80,50
1656250473832,CSE 21,A01,095574,Bach; Quang Tran,23,0,48,25
1656250479860,CSE 30,A01,083084,Eldon; John,2,6,80,78
1656250479860,CSE 30,B01,095061,Bhaskar; Nishant,0,1,50,50
1656250485887,CSE 100,A01,083659,Cao; Yingjun,1,18,70,69
1656250491912,CSE 134B,A01,083661,Powell; Thomas Allan,5,0,100,95
1656250497941,CSE 140,A01,083663,Gungor; Onat,9,0,85,76
1656250503978,CSE 140L,A01,083088,Eldon; John,8,0,100,92
1656250510023,CSE 175,A01,083665,Kumar; Rakesh,0,0,25,25
1656250516049,CSE 190,A00,092507,Dubnov; Shlomo,3,0,20,17
1656250522080,ECE 45,A01,083139,Congero; Spencer William,1,0,75,74
1656250528106,ECE 65,A50,083695,Saad; Andrew S,9,0,30,21
1656250528106,ECE 65,A51,095125,Staff,24,0,26,2
1656250534136,ECE 109,A01,091882,Touri; Behrouz,0,1,70,70
1656250540165,ECE 180,A00,083140,Abi Samra; Nicholas Camill,1,0,30,29
1656250540165,ECE 180,B00,083141,Abi Samra; Nicholas Camill,0,4,30,30
1656250546200,MATH 10A,A01,083735,Patchell; Gregory David,0,0,30,30
1656250546200,MATH 10A,A02,083736,Patchell; Gregory David,22,0,30,8
1656250546200,MATH 10A,A03,083737,Patchell; Gregory David,16,0,30,14
1656250552227,MATH 10B,A01,083207,Lim; Seonhee,0,0,34,34
1656250552227,MATH 10B,A02,083208,Lim; Seonhee,7,0,35,28
1656250552227,MATH 10B,A03,093472,Staff,1,0,34,33
1656250552227,MATH 10B,B01,083739,Sinha; Shubham,11,0,30,19
1656250558264,MATH 18,A01,083743,Cinel; Cameron Alexander,7,0,30,23
1656250558264,MATH 18,A02,083744,Cinel; Cameron Alexander,9,0,30,21
1656250558264,MATH 18,A03,083745,Cinel; Cameron Alexander,5,0,30,25
1656250558264,MATH 18,B01,083748,Rideout; David Porter,1,0,36,35
1656250558264,MATH 18,B02,083749,Rideout; David Porter,0,0,36,36
1656250558264,MATH 18,B03,083750,Rideout; David Porter,0,0,36,36
1656250558264,MATH 18,B04,083751,Rideout; David Porter,0,1,36,36
1656250558264,MATH 18,B05,093473,Rideout; David Porter,0,0,36,36
1656250558264,MATH 18,B06,093474,Rideout; David Porter,3,0,36,33
1656250564288,MATH 20A,A01,083754,Zheng; Zequn,11,0,40,29
1656250570313,MATH 20B,A01,083756,Briones; Jor-el Thomas Caparas,0,0,36,36
1656250570313,MATH 20B,A02,083757,Briones; Jor-el Thomas Caparas,0,0,36,36
1656250570313,MATH 20B,A03,093475,Staff,0,0,36,36
1656250576345,MATH 20C,A01,083760,Briones; Jor-el Thomas Caparas,0,0,35,35
1656250576345,MATH 20C,A02,083761,Briones; Jor-el Thomas Caparas,9,1,35,26
1656250576345,MATH 20C,A03,093476,Staff,0,0,35,35
1656250576345,MATH 20C,B01,083762,Bach; Quang Tran,1,0,30,29
1656250582368,MATH 20D,A01,083765,Tran; Brian Kha,1,0,30,29
1656250582368,MATH 20D,A02,083766,Tran; Brian Kha,0,1,30,30
1656250582368,MATH 20D,A03,083767,Tran; Brian Kha,2,0,30,28
1656250588408,MATH 20E,A01,083771,Ganguly; Soumya,3,0,32,29
1656250588408,MATH 20E,A02,083772,Ganguly; Soumya,0,0,32,32
1656250588408,MATH 20E,B01,083773,Ciotti; Benjamin,16,0,35,19
1656250588408,MATH 20E,B02,083774,Ciotti; Benjamin,15,0,35,20
1656250594445,MATH 103A,A01,083777,Greenfeld; Be'Eri,1,0,36,35
1656250594445,MATH 103A,A02,083778,Greenfeld; Be'Eri,1,0,36,35
1656250594445,MATH 103A,A03,093561,Staff,5,0,36,31
1656250594445,MATH 103A,B01,083779,Greenfeld; Be'Eri,8,0,36,28
1656250594445,MATH 103A,B02,083780,Greenfeld; Be'Eri,1,0,36,35
1656250594445,MATH 103A,B03,093562,Staff,0,0,36,36
1656250600470,MATH 105,A01,085443,Carter; Anne Toulson,5,0,35,30
1656250600470,MATH 105,A02,093477,Staff,14,0,35,21
1656250606495,MATH 109,A01,083213,Ganzberger; Geoffrey Michael,0,0,34,34
1656250606495,MATH 109,A02,083214,Ganzberger; Geoffrey Michael,0,0,34,34
1656250606495,MATH 109,A03,093478,Staff,1,0,34,33
1656250606495,MATH 109,B01,083215,Ganzberger; Geoffrey Michael,4,0,32,28
1656250606495,MATH 109,B02,083216,Ganzberger; Geoffrey Michael,1,0,32,31
1656250606495,MATH 109,B03,093479,Staff,3,0,32,29
1656250612527,MATH 142A,A01,083219,Chow; Bennett,2,0,32,30
1656250612527,MATH 142A,A02,083220,Chow; Bennett,8,0,32,24
1656250612527,MATH 142A,A03,093480,Staff,5,0,32,27
1656250612527,MATH 142A,B03,093481,Staff,3,0,32,29
1656250612527,MATH 142A,B04,093558,Staff,6,0,32,26
1656250612527,MATH 142A,B05,093559,Staff,0,0,32,32
1656250618563,MATH 193A,A01,083224,Rotar; Vladimir,0,1,34,34
1656250618563,MATH 193A,A02,083225,Rotar; Vladimir,0,0,34,34
1656250618563,MATH 193A,A03,083781,Rotar; Vladimir,0,0,34,34
1656250618563,MATH 193A,A04,083782,Rotar; Vladimir,6,0,34,28
1656250618563,MATH 193A,A05,093482,Rotar; Vladimir,0,0,34,34
1656250624592,MATH 197,001,091859,McAuley; Julian John,9999,0,9999,0
1656250624592,MATH 197,002,095566,Kedlaya; Kiran S.,9997,0,9999,2
1656250624592,MATH 197,003,095567,Xiao; Ming,9999,0,9999,0
1656250624592,MATH 197,004,095571,Perols; Johan Lars,9998,0,9999,1
1656250631662,COGS 9,A01,083615,Shannon; Kyle Michael,3,0,75,72
1656250637688,COGS 11,A01,083617,Boyle; Mary E. T.,14,0,48,34
1656250643720,COGS 13,A01,083071,Bastos; Amalia Pinkusfeld,4,0,71,67
1656250649752,COGS 14A,A01,092681,Semenuks; Arturs,1,12,100,99
1656250655781,COGS 14B,A01,083073,Cheng; Tzu-Han,7,0,63,56
1656250661808,COGS 17,A01,092677,Semenuks; Arturs,7,0,81,74
1656250667834,COGS 100,A01,083619,Allen; Michael Gordon,2,0,70,68
1656250673859,COGS 101A,A01,083621,Davis; Joshua Daniel,4,0,68,64
1656250679884,COGS 101B,A01,091572,Allen; Michael Gordon,4,0,65,61
1656250685911,COGS 101C,A01,083625,Delgado; Tania,10,0,35,25
1656250691940,COGS 107A,A01,083627,Boyle; Mary E. T.,0,0,60,60
1656250697963,COGS 118A,A01,083075,Gupta; Anjum,8,0,76,68
1656250703997,CSE 3,A50,083646,Miranda; Gregory Joseph,18,0,50,32
1656250710023,CSE 8A,A50,083650,Miranda; Gregory Joseph,2,2,56,54
1656250716050,CSE 11,A01,083080,Cao; Yingjun,0,49,40,40
1656250722086,CSE 12,A01,083652,Krause-Levy; Sophia Louisa,5,1,120,115
1656250728112,CSE 15L,A01,083654,Morris; Justin Loren,2,0,50,48
1656250728112,CSE 15L,A02,083655,Morris; Justin Loren,4,0,50,46
1656250734143,CSE 20,A01,083657,Tran; Khoa Dang,30,0,80,50
1656250740177,CSE 21,A01,095574,Bach; Quang Tran,23,0,48,25
1656250746204,CSE 30,A01,083084,Eldon; John,2,6,80,78
1656250746204,CSE 30,B01,095061,Bhaskar; Nishant,0,1,50,50
1656250752231,CSE 100,A01,083659,Cao; Yingjun,1,18,70,69
1656250758255,CSE 134B,A01,083661,Powell; Thomas Allan,5,0,100,95
1656250764284,CSE 140,A01,083663,Gungor; Onat,9,0,85,76
1656250770309,CSE 140L,A01,083088,Eldon; John,8,0,100,92
1656250776334,CSE 175,A01,083665,Kumar; Rakesh,0,0,25,25
1656250782366,CSE 190,A00,092507,Dubnov; Shlomo,3,0,20,17
1656250788394,ECE 45,A01,083139,Congero; Spencer William,1,0,75,74
1656250794421,ECE 65,A50,083695,Saad; Andrew S,9,0,30,21
1656250794421,ECE 65,A51,095125,Staff,24,0,26,2
1656250800453,ECE 109,A01,091882,Touri; Behrouz,0,1,70,70
1656250806480,ECE 180,A00,083140,Abi Samra; Nicholas Camill,1,0,30,29
1656250806480,ECE 180,B00,083141,Abi Samra; Nicholas Camill,0,4,30,30
1656250812513,MATH 10A,A01,083735,Patchell; Gregory David,0,0,30,30
1656250812513,MATH 10A,A02,083736,Patchell; Gregory David,22,0,30,8
1656250812513,MATH 10A,A03,083737,Patchell; Gregory David,16,0,30,14
1656250818542,MATH 10B,A01,083207,Lim; Seonhee,0,0,34,34
1656250818542,MATH 10B,A02,083208,Lim; Seonhee,7,0,35,28
1656250818542,MATH 10B,A03,093472,Staff,1,0,34,33
1656250818542,MATH 10B,B01,083739,Sinha; Shubham,11,0,30,19
1656250824570,MATH 18,A01,083743,Cinel; Cameron Alexander,7,0,30,23
1656250824570,MATH 18,A02,083744,Cinel; Cameron Alexander,9,0,30,21
1656250824570,MATH 18,A03,083745,Cinel; Cameron Alexander,5,0,30,25
1656250824570,MATH 18,B01,083748,Rideout; David Porter,1,0,36,35
1656250824570,MATH 18,B02,083749,Rideout; David Porter,0,0,36,36
1656250824570,MATH 18,B03,083750,Rideout; David Porter,0,0,36,36
1656250824570,MATH 18,B04,083751,Rideout; David Porter,0,1,36,36
1656250824570,MATH 18,B05,093473,Rideout; David Porter,0,0,36,36
1656250824570,MATH 18,B06,093474,Rideout; David Porter,3,0,36,33
1656250830597,MATH 20A,A01,083754,Zheng; Zequn,11,0,40,29
1656250836636,MATH 20B,A01,083756,Briones; Jor-el Thomas Caparas,0,0,36,36
1656250836636,MATH 20B,A02,083757,Briones; Jor-el Thomas Caparas,0,0,36,36
1656250836636,MATH 20B,A03,093475,Staff,0,0,36,36
1656250842664,MATH 20C,A01,083760,Briones; Jor-el Thomas Caparas,0,0,35,35
1656250842664,MATH 20C,A02,083761,Briones; Jor-el Thomas Caparas,9,1,35,26
1656250842664,MATH 20C,A03,093476,Staff,0,0,35,35
1656250842664,MATH 20C,B01,083762,Bach; Quang Tran,1,0,30,29
1656250848694,MATH 20D,A01,083765,Tran; Brian Kha,1,0,30,29
1656250848694,MATH 20D,A02,083766,Tran; Brian Kha,0,1,30,30
1656250848694,MATH 20D,A03,083767,Tran; Brian Kha,2,0,30,28
1656250854730,MATH 20E,A01,083771,Ganguly; Soumya,3,0,32,29
1656250854730,MATH 20E,A02,083772,Ganguly; Soumya,0,0,32,32
1656250854730,MATH 20E,B01,083773,Ciotti; Benjamin,16,0,35,19
1656250854730,MATH 20E,B02,083774,Ciotti; Benjamin,15,0,35,20
1656250860758,MATH 103A,A01,083777,Greenfeld; Be'Eri,1,0,36,35
1656250860758,MATH 103A,A02,083778,Greenfeld; Be'Eri,1,0,36,35
1656250860758,MATH 103A,A03,093561,Staff,5,0,36,31
1656250860758,MATH 103A,B01,083779,Greenfeld; Be'Eri,8,0,36,28
1656250860758,MATH 103A,B02,083780,Greenfeld; Be'Eri,1,0,36,35
1656250860758,MATH 103A,B03,093562,Staff,0,0,36,36
1656250866794,MATH 105,A01,085443,Carter; Anne Toulson,5,0,35,30
1656250866794,MATH 105,A02,093477,Staff,14,0,35,21
1656250872821,MATH 109,A01,083213,Ganzberger; Geoffrey Michael,0,0,34,34
1656250872821,MATH 109,A02,083214,Ganzberger; Geoffrey Michael,0,0,34,34
1656250872821,MATH 109,A03,093478,Staff,1,0,34,33
1656250872821,MATH 109,B01,083215,Ganzberger; Geoffrey Michael,4,0,32,28
1656250872821,MATH 109,B02,083216,Ganzberger; Geoffrey Michael,1,0,32,31
1656250872821,MATH 109,B03,093479,Staff,3,0,32,29
1656250878849,MATH 142A,A01,083219,Chow; Bennett,2,0,32,30
1656250878849,MATH 142A,A02,083220,Chow; Bennett,8,0,32,24
1656250878849,MATH 142A,A03,093480,Staff,5,0,32,27
1656250878849,MATH 142A,B03,093481,Staff,3,0,32,29
1656250878849,MATH 142A,B04,093558,Staff,6,0,32,26
1656250878849,MATH 142A,B05,093559,Staff,0,0,32,32
1656250884874,MATH 193A,A01,083224,Rotar; Vladimir,0,1,34,34
1656250884874,MATH 193A,A02,083225,Rotar; Vladimir,0,0,34,34
1656250884874,MATH 193A,A03,083781,Rotar; Vladimir,0,0,34,34
1656250884874,MATH 193A,A04,083782,Rotar; Vladimir,6,0,34,28
1656250884874,MATH 193A,A05,093482,Rotar; Vladimir,0,0,34,34
1656250890898,MATH 197,001,091859,McAuley; Julian John,9999,0,9999,0
1656250890898,MATH 197,002,095566,Kedlaya; Kiran S.,9997,0,9999,2
1656250890898,MATH 197,003,095567,Xiao; Ming,9999,0,9999,0
1656250890898,MATH 197,004,095571,Perols; Johan Lars,9998,0,9999,1
1656250897969,COGS 9,A01,083615,Shannon; Kyle Michael,3,0,75,72
1656250903993,COGS 11,A01,083617,Boyle; Mary E. T.,14,0,48,34
1656250910019,COGS 13,A01,083071,Bastos; Amalia Pinkusfeld,4,0,71,67
1656250916053,COGS 14A,A01,092681,Semenuks; Arturs,1,12,100,99
1656250922079,COGS 14B,A01,083073,Cheng; Tzu-Han,7,0,63,56
1656250928105,COGS 17,A01,092677,Semenuks; Arturs,7,0,81,74
1656250934129,COGS 100,A01,083619,Allen; Michael Gordon,2,0,70,68
1656250940161,COGS 101A,A01,083621,Davis; Joshua Daniel,4,0,68,64
1656250946186,COGS 101B,A01,091572,Allen; Michael Gordon,4,0,65,61
1656250952208,COGS 101C,A01,083625,Delgado; Tania,10,0,35,25
1656250958240,COGS 107A,A01,083627,Boyle; Mary E. T.,0,0,60,60
1656250964267,COGS 118A,A01,083075,Gupta; Anjum,8,0,76,68
1656250970299,CSE 3,A50,083646,Miranda; Gregory Joseph,18,0,50,32
1656250976329,CSE 8A,A50,083650,Miranda; Gregory Joseph,2,2,56,54
1656250982355,CSE 11,A01,083080,Cao; Yingjun,0,49,40,40
1656250988384,CSE 12,A01,083652,Krause-Levy; Sophia Louisa,5,1,120,115
1656250994410,CSE 15L,A01,083654,Morris; Justin Loren,2,0,50,48
1656250994410,CSE 15L,A02,083655,Morris; Justin Loren,4,0,50,46
1656251000458,CSE 20,A01,083657,Tran; Khoa Dang,30,0,80,50
1656251006484,CSE 21,A01,095574,Bach; Quang Tran,23,0,48,25
1656251012517,CSE 30,A01,083084,Eldon; John,2,6,80,78
1656251012517,CSE 30,B01,095061,Bhaskar; Nishant,0,1,50,50
1656251018539,CSE 100,A01,083659,Cao; Yingjun,1,18,70,69
1656251024565,CSE 134B,A01,083661,Powell; Thomas Allan,5,0,100,95
1656251030590,CSE 140,A01,083663,Gungor; Onat,9,0,85,76
1656251036618,CSE 140L,A01,083088,Eldon; John,8,0,100,92
1656251042642,CSE 175,A01,083665,Kumar; Rakesh,0,0,25,25
1656251048667,CSE 190,A00,092507,Dubnov; Shlomo,3,0,20,17
1656251054774,ECE 45,A01,083139,Congero; Spencer William,1,0,75,74
1656251060808,ECE 65,A50,083695,Saad; Andrew S,9,0,30,21
1656251060808,ECE 65,A51,095125,Staff,24,0,26,2
1656251066833,ECE 109,A01,091882,Touri; Behrouz,0,1,70,70
1656251072858,ECE 180,A00,083140,Abi Samra; Nicholas Camill,1,0,30,29
1656251072858,ECE 180,B00,083141,Abi Samra; Nicholas Camill,0,4,30,30
1656251078884,MATH 10A,A01,083735,Patchell; Gregory David,0,0,30,30
1656251078884,MATH 10A,A02,083736,Patchell; Gregory David,22,0,30,8
1656251078884,MATH 10A,A03,083737,Patchell; Gregory David,16,0,30,14
1656251084911,MATH 10B,A01,083207,Lim; Seonhee,0,0,34,34
1656251084911,MATH 10B,A02,083208,Lim; Seonhee,7,0,35,28
1656251084911,MATH 10B,A03,093472,Staff,1,0,34,33
1656251084911,MATH 10B,B01,083739,Sinha; Shubham,11,0,30,19
1656251090949,MATH 18,A01,083743,Cinel; Cameron Alexander,7,0,30,23
1656251090949,MATH 18,A02,083744,Cinel; Cameron Alexander,9,0,30,21
1656251090949,MATH 18,A03,083745,Cinel; Cameron Alexander,5,0,30,25
1656251090949,MATH 18,B01,083748,Rideout; David Porter,1,0,36,35
1656251090949,MATH 18,B02,083749,Rideout; David Porter,0,0,36,36
1656251090949,MATH 18,B03,083750,Rideout; David Porter,0,0,36,36
1656251090949,MATH 18,B04,083751,Rideout; David Porter,0,1,36,36
1656251090949,MATH 18,B05,093473,Rideout; David Porter,0,0,36,36
1656251090949,MATH 18,B06,093474,Rideout; David Porter,3,0,36,33
1656251096974,MATH 20A,A01,083754,Zheng; Zequn,11,0,40,29
1656251102997,MATH 20B,A01,083756,Briones; Jor-el Thomas Caparas,0,0,36,36
1656251102997,MATH 20B,A02,083757,Briones; Jor-el Thomas Caparas,0,0,36,36
1656251102997,MATH 20B,A03,093475,Staff,0,0,36,36
1656251109023,MATH 20C,A01,083760,Briones; Jor-el Thomas Caparas,0,0,35,35
1656251109023,MATH 20C,A02,083761,Briones; Jor-el Thomas Caparas,9,1,35,26
1656251109023,MATH 20C,A03,093476,Staff,0,0,35,35
1656251109023,MATH 20C,B01,083762,Bach; Quang Tran,1,0,30,29
1656251115050,MATH 20D,A01,083765,Tran; Brian Kha,1,0,30,29
1656251115050,MATH 20D,A02,083766,Tran; Brian Kha,0,1,30,30
1656251115050,MATH 20D,A03,083767,Tran; Brian Kha,2,0,30,28
1656251121080,MATH 20E,A01,083771,Ganguly; Soumya,3,0,32,29
1656251121080,MATH 20E,A02,083772,Ganguly; Soumya,0,0,32,32
1656251121080,MATH 20E,B01,083773,Ciotti; Benjamin,16,0,35,19
1656251121080,MATH 20E,B02,083774,Ciotti; Benjamin,15,0,35,20
1656251127111,MATH 103A,A01,083777,Greenfeld; Be'Eri,1,0,36,35
1656251127111,MATH 103A,A02,083778,Greenfeld; Be'Eri,1,0,36,35
1656251127111,MATH 103A,A03,093561,Staff,5,0,36,31
1656251127111,MATH 103A,B01,083779,Greenfeld; Be'Eri,8,0,36,28
1656251127111,MATH 103A,B02,083780,Greenfeld; Be'Eri,1,0,36,35
1656251127111,MATH 103A,B03,093562,Staff,0,0,36,36
1656251133135,MATH 105,A01,085443,Carter; Anne Toulson,5,0,35,30
1656251133135,MATH 105,A02,093477,Staff,14,0,35,21
1656251139170,MATH 109,A01,083213,Ganzberger; Geoffrey Michael,0,0,34,34
1656251139170,MATH 109,A02,083214,Ganzberger; Geoffrey Michael,0,0,34,34
1656251139170,MATH 109,A03,093478,Staff,1,0,34,33
1656251139170,MATH 109,B01,083215,Ganzberger; Geoffrey Michael,4,0,32,28
1656251139170,MATH 109,B02,083216,Ganzberger; Geoffrey Michael,1,0,32,31
1656251139170,MATH 109,B03,093479,Staff,3,0,32,29
1656251145197,MATH 142A,A01,083219,Chow; Bennett,2,0,32,30
1656251145197,MATH 142A,A02,083220,Chow; Bennett,8,0,32,24
1656251145197,MATH 142A,A03,093480,Staff,5,0,32,27
1656251145197,MATH 142A,B03,093481,Staff,3,0,32,29
1656251145197,MATH 142A,B04,093558,Staff,6,0,32,26
1656251145197,MATH 142A,B05,093559,Staff,0,0,32,32
1656251151223,MATH 193A,A01,083224,Rotar; Vladimir,0,1,34,34
1656251151223,MATH 193A,A02,083225,Rotar; Vladimir,0,0,34,34
1656251151223,MATH 193A,A03,083781,Rotar; Vladimir,0,0,34,34
1656251151223,MATH 193A,A04,083782,Rotar; Vladimir,6,0,34,28
1656251151223,MATH 193A,A05,093482,Rotar; Vladimir,0,0,34,34
1656251157250,MATH 197,001,091859,McAuley; Julian John,9999,0,9999,0
1656251157250,MATH 197,002,095566,Kedlaya; Kiran S.,9997,0,9999,2
1656251157250,MATH 197,003,095567,Xiao; Ming,9999,0,9999,0
1656251157250,MATH 197,004,095571,Perols; Johan Lars,9998,0,9999,1
1656251164319,COGS 9,A01,083615,Shannon; Kyle Michael,3,0,75,72
1656251170343,COGS 11,A01,083617,Boyle; Mary E. T.,14,0,48,34
1656251176373,COGS 13,A01,083071,Bastos; Amalia Pinkusfeld,4,0,71,67
1656251182400,COGS 14A,A01,092681,Semenuks; Arturs,1,12,100,99
1656251188425,COGS 14B,A01,083073,Cheng; Tzu-Han,7,0,63,56
1656251194454,COGS 17,A01,092677,Semenuks; Arturs,7,0,81,74
1656251200480,COGS 100,A01,083619,Allen; Michael Gordon,2,0,70,68
1656251206505,COGS 101A,A01,083621,Davis; Joshua Daniel,4,0,68,64
1656251212526,COGS 101B,A01,091572,Allen; Michael Gordon,4,0,65,61
1656251218550,COGS 101C,A01,083625,Delgado; Tania,10,0,35,25
1656251224577,COGS 107A,A01,083627,Boyle; Mary E. T.,0,0,60,60
1656251230605,COGS 118A,A01,083075,Gupta; Anjum,8,0,76,68
1656251236639,CSE 3,A50,083646,Miranda; Gregory Joseph,18,0,50,32
1656251242663,CSE 8A,A50,083650,Miranda; Gregory Joseph,2,2,56,54
1656251248691,CSE 11,A01,083080,Cao; Yingjun,0,49,40,40
1656251254716,CSE 12,A01,083652,Krause-Levy; Sophia Louisa,5,1,120,115
1656251260740,CSE 15L,A01,083654,Morris; Justin Loren,2,0,50,48
1656251260740,CSE 15L,A02,083655,Morris; Justin Loren,4,0,50,46
1656251266764,CSE 20,A01,083657,Tran; Khoa Dang,30,0,80,50
1656251272789,CSE 21,A01,095574,Bach; Quang Tran,23,0,48,25
1656251278819,CSE 30,A01,083084,Eldon; John,2,6,80,78
1656251278819,CSE 30,B01,095061,Bhaskar; Nishant,0,1,50,50
1656251284845,CSE 100,A01,083659,Cao; Yingjun,1,18,70,69
1656251290872,CSE 134B,A01,083661,Powell; Thomas Allan,5,0,100,95
1656251296898,CSE 140,A01,083663,Gungor; Onat,9,0,85,76
1656251302922,CSE 140L,A01,083088,Eldon; John,8,0,100,92
1656251308950,CSE 175,A01,083665,Kumar; Rakesh,0,0,25,25
1656251314975,CSE 190,A00,092507,Dubnov; Shlomo,3,0,20,17
1656251321001,ECE 45,A01,083139,Congero; Spencer William,1,0,75,74
1656251327028,ECE 65,A50,083695,Saad; Andrew S,9,0,30,21
1656251327028,ECE 65,A51,095125,Staff,24,0,26,2
1656251333053,ECE 109,A01,091882,Touri; Behrouz,0,1,70,70
1656251339081,ECE 180,A00,083140,Abi Samra; Nicholas Camill,1,0,30,29
1656251339081,ECE 180,B00,083141,Abi Samra; Nicholas Camill,0,4,30,30
1656251345107,MATH 10A,A01,083735,Patchell; Gregory David,0,0,30,30
1656251345107,MATH 10A,A02,083736,Patchell; Gregory David,22,0,30,8
1656251345107,MATH 10A,A03,083737,Patchell; Gregory David,16,0,30,14
1656251351147,MATH 10B,A01,083207,Lim; Seonhee,0,0,34,34
1656251351147,MATH 10B,A02,083208,Lim; Seonhee,7,0,35,28
1656251351147,MATH 10B,A03,093472,Staff,1,0,34,33
1656251351147,MATH 10B,B01,083739,Sinha; Shubham,11,0,30,19
1656251357176,MATH 18,A01,083743,Cinel; Cameron Alexander,7,0,30,23
1656251357176,MATH 18,A02,083744,Cinel; Cameron Alexander,9,0,30,21
1656251357176,MATH 18,A03,083745,Cinel; Cameron Alexander,5,0,30,25
1656251357176,MATH 18,B01,083748,Rideout; David Porter,1,0,36,35
1656251357176,MATH 18,B02,083749,Rideout; David Porter,0,0,36,36
1656251357176,MATH 18,B03,083750,Rideout; David Porter,0,0,36,36
1656251357176,MATH 18,B04,083751,Rideout; David Porter,0,1,36,36
1656251357176,MATH 18,B05,093473,Rideout; David Porter,0,0,36,36
1656251357176,MATH 18,B06,093474,Rideout; David Porter,3,0,36,33
1656251363211,MATH 20A,A01,083754,Zheng; Zequn,11,0,40,29
1656251369236,MATH 20B,A01,083756,Briones; Jor-el Thomas Caparas,0,0,36,36
1656251369236,MATH 20B,A02,083757,Briones; Jor-el Thomas Caparas,0,0,36,36
1656251369236,MATH 20B,A03,093475,Staff,0,0,36,36
1656251375266,MATH 20C,A01,083760,Briones; Jor-el Thomas Caparas,0,0,35,35
1656251375266,MATH 20C,A02,083761,Briones; Jor-el Thomas Caparas,9,1,35,26
1656251375266,MATH 20C,A03,093476,Staff,0,0,35,35
1656251375266,MATH 20C,B01,083762,Bach; Quang Tran,1,0,30,29
1656251381297,MATH 20D,A01,083765,Tran; Brian Kha,1,0,30,29
1656251381297,MATH 20D,A02,083766,Tran; Brian Kha,0,1,30,30
1656251381297,MATH 20D,A03,083767,Tran; Brian Kha,2,0,30,28
1656251387330,MATH 20E,A01,083771,Ganguly; Soumya,3,0,32,29
1656251387330,MATH 20E,A02,083772,Ganguly; Soumya,0,0,32,32
1656251387330,MATH 20E,B01,083773,Ciotti; Benjamin,16,0,35,19
1656251387330,MATH 20E,B02,083774,Ciotti; Benjamin,15,0,35,20
1656251393355,MATH 103A,A01,083777,Greenfeld; Be'Eri,1,0,36,35
1656251393355,MATH 103A,A02,083778,Greenfeld; Be'Eri,1,0,36,35
1656251393355,MATH 103A,A03,093561,Staff,5,0,36,31
1656251393355,MATH 103A,B01,083779,Greenfeld; Be'Eri,8,0,36,28
1656251393355,MATH 103A,B02,083780,Greenfeld; Be'Eri,1,0,36,35
1656251393355,MATH 103A,B03,093562,Staff,0,0,36,36
1656251399380,MATH 105,A01,085443,Carter; Anne Toulson,5,0,35,30
1656251399380,MATH 105,A02,093477,Staff,14,0,35,21
1656251405409,MATH 109,A01,083213,Ganzberger; Geoffrey Michael,0,0,34,34
1656251405409,MATH 109,A02,083214,Ganzberger; Geoffrey Michael,0,0,34,34
1656251405409,MATH 109,A03,093478,Staff,1,0,34,33
1656251405409,MATH 109,B01,083215,Ganzberger; Geoffrey Michael,4,0,32,28
1656251405409,MATH 109,B02,083216,Ganzberger; Geoffrey Michael,1,0,32,31
1656251405409,MATH 109,B03,093479,Staff,3,0,32,29
1656251411435,MATH 142A,A01,083219,Chow; Bennett,2,0,32,30
1656251411435,MATH 142A,A02,083220,Chow; Bennett,8,0,32,24
1656251411435,MATH 142A,A03,093480,Staff,5,0,32,27
1656251411435,MATH 142A,B03,093481,Staff,3,0,32,29
1656251411435,MATH 142A,B04,093558,Staff,6,0,32,26
1656251411435,MATH 142A,B05,093559,Staff,0,0,32,32
1656251417474,MATH 193A,A01,083224,Rotar; Vladimir,0,1,34,34
1656251417474,MATH 193A,A02,083225,Rotar; Vladimir,0,0,34,34
1656251417474,MATH 193A,A03,083781,Rotar; Vladimir,0,0,34,34
1656251417474,MATH 193A,A04,083782,Rotar; Vladimir,6,0,34,28
1656251417474,MATH 193A,A05,093482,Rotar; Vladimir,0,0,34,34
1656251423502,MATH 197,001,091859,McAuley; Julian John,9999,0,9999,0
1656251423502,MATH 197,002,095566,Kedlaya; Kiran S.,9997,0,9999,2
1656251423502,MATH 197,003,095567,Xiao; Ming,9999,0,9999,0
1656251423502,MATH 197,004,095571,Perols; Johan Lars,9998,0,9999,1
1656251430561,COGS 9,A01,083615,Shannon; Kyle Michael,3,0,75,72
1656251436591,COGS 11,A01,083617,Boyle; Mary E. T.,14,0,48,34
1656251442620,COGS 13,A01,083071,Bastos; Amalia Pinkusfeld,4,0,71,67
1656251448648,COGS 14A,A01,092681,Semenuks; Arturs,1,12,100,99
1656251454678,COGS 14B,A01,083073,Cheng; Tzu-Han,7,0,63,56
1656251460702,COGS 17,A01,092677,Semenuks; Arturs,7,0,81,74
1656251466728,COGS 100,A01,083619,Allen; Michael Gordon,2,0,70,68
1656251472753,COGS 101A,A01,083621,Davis; Joshua Daniel,4,0,68,64
1656251478777,COGS 101B,A01,091572,Allen; Michael Gordon,4,0,65,61
1656251484802,COGS 101C,A01,083625,Delgado; Tania,10,0,35,25
1656251490827,COGS 107A,A01,083627,Boyle; Mary E. T.,0,0,60,60
1656251496850,COGS 118A,A01,083075,Gupta; Anjum,8,0,76,68
1656251502876,CSE 3,A50,083646,Miranda; Gregory Joseph,18,0,50,32
1656251508905,CSE 8A,A50,083650,Miranda; Gregory Joseph,2,2,56,54
1656251514929,CSE 11,A01,083080,Cao; Yingjun,0,49,40,40
1656251520954,CSE 12,A01,083652,Krause-Levy; Sophia Louisa,5,1,120,115
1656251526979,CSE 15L,A01,083654,Morris; Justin Loren,2,0,50,48
1656251526979,CSE 15L,A02,083655,Morris; Justin Loren,4,0,50,46
1656251533007,CSE 20,A01,083657,Tran; Khoa Dang,30,0,80,50
1656251539038,CSE 21,A01,095574,Bach; Quang Tran,23,0,48,25
1656251545070,CSE 30,A01,083084,Eldon; John,2,6,80,78
1656251545070,CSE 30,B01,095061,Bhaskar; Nishant,0,1,50,50
1656251551093,CSE 100,A01,083659,Cao; Yingjun,1,18,70,69
1656251557117,CSE 134B,A01,083661,Powell; Thomas Allan,5,0,100,95
1656251563141,CSE 140,A01,083663,Gungor; Onat,9,0,85,76
1656251569168,CSE 140L,A01,083088,Eldon; John,8,0,100,92
1656251575192,CSE 175,A01,083665,Kumar; Rakesh,0,0,25,25
1656251581217,CSE 190,A00,092507,Dubnov; Shlomo,3,0,20,17
1656251587247,ECE 45,A01,083139,Congero; Spencer William,1,0,75,74
1656251593272,ECE 65,A50,083695,Saad; Andrew S,9,0,30,21
1656251593272,ECE 65,A51,095125,Staff,24,0,26,2
1656251599303,ECE 109,A01,091882,Touri; Behrouz,0,1,70,70
1656251605325,ECE 180,A00,083140,Abi Samra; Nicholas Camill,1,0,30,29
1656251605325,ECE 180,B00,083141,Abi Samra; Nicholas Camill,0,4,30,30
1656251611348,MATH 10A,A01,083735,Patchell; Gregory David,0,0,30,30
1656251611348,MATH 10A,A02,083736,Patchell; Gregory David,22,0,30,8
1656251611348,MATH 10A,A03,083737,Patchell; Gregory David,16,0,30,14
1656251617373,MATH 10B,A01,083207,Lim; Seonhee,0,0,34,34
1656251617373,MATH 10B,A02,083208,Lim; Seonhee,7,0,35,28
1656251617373,MATH 10B,A03,093472,Staff,1,0,34,33
1656251617373,MATH 10B,B01,083739,Sinha; Shubham,11,0,30,19
1656251623407,MATH 18,A01,083743,Cinel; Cameron Alexander,7,0,30,23
1656251623407,MATH 18,A02,083744,Cinel; Cameron Alexander,9,0,30,21
1656251623407,MATH 18,A03,083745,Cinel; Cameron Alexander,5,0,30,25
1656251623407,MATH 18,B01,083748,Rideout; David Porter,1,0,36,35
1656251623407,MATH 18,B02,083749,Rideout; David Porter,0,0,36,36
1656251623407,MATH 18,B03,083750,Rideout; David Porter,0,0,36,36
1656251623407,MATH 18,B04,083751,Rideout; David Porter,0,1,36,36
1656251623407,MATH 18,B05,093473,Rideout; David Porter,0,0,36,36
1656251623407,MATH 18,B06,093474,Rideout; David Porter,3,0,36,33
1656251629431,MATH 20A,A01,083754,Zheng; Zequn,11,0,40,29
1656251635455,MATH 20B,A01,083756,Briones; Jor-el Thomas Caparas,0,0,36,36
1656251635455,MATH 20B,A02,083757,Briones; Jor-el Thomas Caparas,0,0,36,36
1656251635455,MATH 20B,A03,093475,Staff,0,0,36,36
1656251641477,MATH 20C,A01,083760,Briones; Jor-el Thomas Caparas,0,0,35,35
1656251641477,MATH 20C,A02,083761,Briones; Jor-el Thomas Caparas,9,1,35,26
1656251641477,MATH 20C,A03,093476,Staff,0,0,35,35
1656251641477,MATH 20C,B01,083762,Bach; Quang Tran,1,0,30,29
1656251647500,MATH 20D,A01,083765,Tran; Brian Kha,1,0,30,29
1656251647500,MATH 20D,A02,083766,Tran; Brian Kha,0,1,30,30
1656251647500,MATH 20D,A03,083767,Tran; Brian Kha,2,0,30,28
1656251653595,MATH 20E,A01,083771,Ganguly; Soumya,3,0,32,29
1656251653595,MATH 20E,A02,083772,Ganguly; Soumya,0,0,32,32
1656251653595,MATH 20E,B01,083773,Ciotti; Benjamin,16,0,35,19
1656251653595,MATH 20E,B02,083774,Ciotti; Benjamin,15,0,35,20
1656251659622,MATH 103A,A01,083777,Greenfeld; Be'Eri,1,0,36,35
1656251659622,MATH 103A,A02,083778,Greenfeld; Be'Eri,1,0,36,35
1656251659622,MATH 103A,A03,093561,Staff,5,0,36,31
1656251659622,MATH 103A,B01,083779,Greenfeld; Be'Eri,8,0,36,28
1656251659622,MATH 103A,B02,083780,Greenfeld; Be'Eri,1,0,36,35
1656251659622,MATH 103A,B03,093562,Staff,0,0,36,36
1656251665655,MATH 105,A01,085443,Carter; Anne Toulson,5,0,35,30
1656251665655,MATH 105,A02,093477,Staff,14,0,35,21
1656251671683,MATH 109,A01,083213,Ganzberger; Geoffrey Michael,0,0,34,34
1656251671683,MATH 109,A02,083214,Ganzberger; Geoffrey Michael,0,0,34,34
1656251671683,MATH 109,A03,093478,Staff,1,0,34,33
1656251671683,MATH 109,B01,083215,Ganzberger; Geoffrey Michael,4,0,32,28
1656251671683,MATH 109,B02,083216,Ganzberger; Geoffrey Michael,1,0,32,31
1656251671683,MATH 109,B03,093479,Staff,3,0,32,29
1656251677711,MATH 142A,A01,083219,Chow; Bennett,2,0,32,30
1656251677711,MATH 142A,A02,083220,Chow; Bennett,8,0,32,24
1656251677711,MATH 142A,A03,093480,Staff,5,0,32,27
1656251677711,MATH 142A,B03,093481,Staff,3,0,32,29
1656251677711,MATH 142A,B04,093558,Staff,6,0,32,26
1656251677711,MATH 142A,B05,093559,Staff,0,0,32,32
1656251683734,MATH 193A,A01,083224,Rotar; Vladimir,0,1,34,34
1656251683734,MATH 193A,A02,083225,Rotar; Vladimir,0,0,34,34
1656251683734,MATH 193A,A03,083781,Rotar; Vladimir,0,0,34,34
1656251683734,MATH 193A,A04,083782,Rotar; Vladimir,6,0,34,28
1656251683734,MATH 193A,A05,093482,Rotar; Vladimir,0,0,34,34
1656251689760,MATH 197,001,091859,McAuley; Julian John,9999,0,9999,0
1656251689760,MATH 197,002,095566,Kedlaya; Kiran S.,9997,0,9999,2
1656251689760,MATH 197,003,095567,Xiao; Ming,9999,0,9999,0
1656251689760,MATH 197,004,095571,Perols; Johan Lars,9998,0,9999,1
1656251696856,COGS 9,A01,083615,Shannon; Kyle Michael,3,0,75,72
1656251702888,COGS 11,A01,083617,Boyle; Mary E. T.,14,0,48,34
1656251708911,COGS 13,A01,083071,Bastos; Amalia Pinkusfeld,4,0,71,67
1656251714937,COGS 14A,A01,092681,Semenuks; Arturs,1,12,100,99
1656251720968,COGS 14B,A01,083073,Cheng; Tzu-Han,7,0,63,56
1656251726993,COGS 17,A01,092677,Semenuks; Arturs,7,0,81,74
1656251733037,COGS 100,A01,083619,Allen; Michael Gordon,2,0,70,68
1656251739068,COGS 101A,A01,083621,Davis; Joshua Daniel,4,0,68,64
1656251745098,COGS 101B,A01,091572,Allen; Michael Gordon,4,0,65,61
1656251751133,COGS 101C,A01,083625,Delgado; Tania,10,0,35,25
1656251757164,COGS 107A,A01,083627,Boyle; Mary E. T.,0,0,60,60
1656251763198,COGS 118A,A01,083075,Gupta; Anjum,8,0,76,68
1656251769227,CSE 3,A50,083646,Miranda; Gregory Joseph,18,0,50,32
1656251775257,CSE 8A,A50,083650,Miranda; Gregory Joseph,2,2,56,54
1656251781289,CSE 11,A01,083080,Cao; Yingjun,0,49,40,40
1656251787322,CSE 12,A01,083652,Krause-Levy; Sophia Louisa,5,1,120,115
1656251793349,CSE 15L,A01,083654,Morris; Justin Loren,2,0,50,48
1656251793349,CSE 15L,A02,083655,Morris; Justin Loren,4,0,50,46
1656251799375,CSE 20,A01,083657,Tran; Khoa Dang,30,0,80,50
1656251805401,CSE 21,A01,095574,Bach; Quang Tran,23,0,48,25
1656251811429,CSE 30,A01,083084,Eldon; John,2,6,80,78
1656251811429,CSE 30,B01,095061,Bhaskar; Nishant,0,1,50,50
1656251817459,CSE 100,A01,083659,Cao; Yingjun,1,18,70,69
1656251823484,CSE 134B,A01,083661,Powell; Thomas Allan,5,0,100,95
1656251829510,CSE 140,A01,083663,Gungor; Onat,9,0,85,76
1656251835539,CSE 140L,A01,083088,Eldon; John,8,0,100,92
1656251841566,CSE 175,A01,083665,Kumar; Rakesh,0,0,25,25
1656251847599,CSE 190,A00,092507,Dubnov; Shlomo,3,0,20,17
1656251853635,ECE 45,A01,083139,Congero; Spencer William,1,0,75,74
1656251859663,ECE 65,A50,083695,Saad; Andrew S,9,0,30,21
1656251859663,ECE 65,A51,095125,Staff,24,0,26,2
1656251865688,ECE 109,A01,091882,Touri; Behrouz,0,1,70,70
1656251871732,ECE 180,A00,083140,Abi Samra; Nicholas Camill,1,0,30,29
1656251871732,ECE 180,B00,083141,Abi Samra; Nicholas Camill,0,4,30,30
1656251877768,MATH 10A,A01,083735,Patchell; Gregory David,0,0,30,30
1656251877768,MATH 10A,A02,083736,Patchell; Gregory David,22,0,30,8
1656251877768,MATH 10A,A03,083737,Patchell; Gregory David,16,0,30,14
1656251883796,MATH 10B,A01,083207,Lim; Seonhee,0,0,34,34
1656251883796,MATH 10B,A02,083208,Lim; Seonhee,7,0,35,28
1656251883796,MATH 10B,A03,093472,Staff,1,0,34,33
1656251883796,MATH 10B,B01,083739,Sinha; Shubham,11,0,30,19
1656251889832,MATH 18,A01,083743,Cinel; Cameron Alexander,7,0,30,23
1656251889832,MATH 18,A02,083744,Cinel; Cameron Alexander,9,0,30,21
1656251889832,MATH 18,A03,083745,Cinel; Cameron Alexander,5,0,30,25
1656251889832,MATH 18,B01,083748,Rideout; David Porter,1,0,36,35
1656251889832,MATH 18,B02,083749,Rideout; David Porter,0,0,36,36
1656251889832,MATH 18,B03,083750,Rideout; David Porter,0,0,36,36
1656251889832,MATH 18,B04,083751,Rideout; David Porter,0,1,36,36
1656251889832,MATH 18,B05,093473,Rideout; David Porter,0,0,36,36
1656251889832,MATH 18,B06,093474,Rideout; David Porter,3,0,36,33
1656251895861,MATH 20A,A01,083754,Zheng; Zequn,11,0,40,29
1656251901897,MATH 20B,A01,083756,Briones; Jor-el Thomas Caparas,0,0,36,36
1656251901897,MATH 20B,A02,083757,Briones; Jor-el Thomas Caparas,0,0,36,36
1656251901897,MATH 20B,A03,093475,Staff,0,0,36,36
1656251907921,MATH 20C,A01,083760,Briones; Jor-el Thomas Caparas,0,0,35,35
1656251907921,MATH 20C,A02,083761,Briones; Jor-el Thomas Caparas,9,1,35,26
1656251907921,MATH 20C,A03,093476,Staff,0,0,35,35
1656251907921,MATH 20C,B01,083762,Bach; Quang Tran,1,0,30,29
1656251913952,MATH 20D,A01,083765,Tran; Brian Kha,1,0,30,29
1656251913952,MATH 20D,A02,083766,Tran; Brian Kha,0,1,30,30
1656251913952,MATH 20D,A03,083767,Tran; Brian Kha,2,0,30,28
1656251919978,MATH 20E,A01,083771,Ganguly; Soumya,3,0,32,29
1656251919978,MATH 20E,A02,083772,Ganguly; Soumya,0,0,32,32
1656251919978,MATH 20E,B01,083773,Ciotti; Benjamin,16,0,35,19
1656251919978,MATH 20E,B02,083774,Ciotti; Benjamin,15,0,35,20
1656251926010,MATH 103A,A01,083777,Greenfeld; Be'Eri,1,0,36,35
1656251926010,MATH 103A,A02,083778,Greenfeld; Be'Eri,1,0,36,35
1656251926010,MATH 103A,A03,093561,Staff,5,0,36,31
1656251926010,MATH 103A,B01,083779,Greenfeld; Be'Eri,8,0,36,28
1656251926010,MATH 103A,B02,083780,Greenfeld; Be'Eri,1,0,36,35
1656251926010,MATH 103A,B03,093562,Staff,0,0,36,36
1656251932044,MATH 105,A01,085443,Carter; Anne Toulson,5,0,35,30
1656251932044,MATH 105,A02,093477,Staff,14,0,35,21
1656251938074,MATH 109,A01,083213,Ganzberger; Geoffrey Michael,0,0,34,34
1656251938074,MATH 109,A02,083214,Ganzberger; Geoffrey Michael,0,0,34,34
1656251938074,MATH 109,A03,093478,Staff,1,0,34,33
1656251938074,MATH 109,B01,083215,Ganzberger; Geoffrey Michael,4,0,32,28
1656251938074,MATH 109,B02,083216,Ganzberger; Geoffrey Michael,1,0,32,31
1656251938074,MATH 109,B03,093479,Staff,3,0,32,29
1656251944118,MATH 142A,A01,083219,Chow; Bennett,2,0,32,30
1656251944118,MATH 142A,A02,083220,Chow; Bennett,8,0,32,24
1656251944118,MATH 142A,A03,093480,Staff,5,0,32,27
1656251944118,MATH 142A,B03,093481,Staff,3,0,32,29
1656251944118,MATH 142A,B04,093558,Staff,6,0,32,26
1656251944118,MATH 142A,B05,093559,Staff,0,0,32,32
1656251950144,MATH 193A,A01,083224,Rotar; Vladimir,0,1,34,34
1656251950144,MATH 193A,A02,083225,Rotar; Vladimir,0,0,34,34
1656251950144,MATH 193A,A03,083781,Rotar; Vladimir,0,0,34,34
1656251950144,MATH 193A,A04,083782,Rotar; Vladimir,6,0,34,28
1656251950144,MATH 193A,A05,093482,Rotar; Vladimir,0,0,34,34
1656251956170,MATH 197,001,091859,McAuley; Julian John,9999,0,9999,0
1656251956170,MATH 197,002,095566,Kedlaya; Kiran S.,9997,0,9999,2
1656251956170,MATH 197,003,095567,Xiao; Ming,9999,0,9999,0
1656251956170,MATH 197,004,095571,Perols; Johan Lars,9998,0,9999,1
1656251963234,COGS 9,A01,083615,Shannon; Kyle Michael,3,0,75,72
1656251969263,COGS 11,A01,083617,Boyle; Mary E. T.,14,0,48,34
1656251975293,COGS 13,A01,083071,Bastos; Amalia Pinkusfeld,4,0,71,67
1656251981322,COGS 14A,A01,092681,Semenuks; Arturs,1,12,100,99
1656251987350,COGS 14B,A01,083073,Cheng; Tzu-Han,7,0,63,56
1656251993375,COGS 17,A01,092677,Semenuks; Arturs,7,0,81,74
1656251999410,COGS 100,A01,083619,Allen; Michael Gordon,2,0,70,68
1656252005436,COGS 101A,A01,083621,Davis; Joshua Daniel,4,0,68,64
1656252011461,COGS 101B,A01,091572,Allen; Michael Gordon,4,0,65,61
1656252017489,COGS 101C,A01,083625,Delgado; Tania,10,0,35,25
1656252023516,COGS 107A,A01,083627,Boyle; Mary E. T.,0,0,60,60
1656252029542,COGS 118A,A01,083075,Gupta; Anjum,8,0,76,68
1656252035566,CSE 3,A50,083646,Miranda; Gregory Joseph,18,0,50,32
1656252041601,CSE 8A,A50,083650,Miranda; Gregory Joseph,2,2,56,54
1656252047635,CSE 11,A01,083080,Cao; Yingjun,0,49,40,40
1656252053663,CSE 12,A01,083652,Krause-Levy; Sophia Louisa,5,1,120,115
1656252059689,CSE 15L,A01,083654,Morris; Justin Loren,2,0,50,48
1656252059689,CSE 15L,A02,083655,Morris; Justin Loren,4,0,50,46
1656252065713,CSE 20,A01,083657,Tran; Khoa Dang,30,0,80,50
1656252071736,CSE 21,A01,095574,Bach; Quang Tran,23,0,48,25
1656252077760,CSE 30,A01,083084,Eldon; John,2,6,80,78
1656252077760,CSE 30,B01,095061,Bhaskar; Nishant,0,1,50,50
1656252083788,CSE 100,A01,083659,Cao; Yingjun,1,18,70,69
1656252089811,CSE 134B,A01,083661,Powell; Thomas Allan,5,0,100,95
1656252095837,CSE 140,A01,083663,Gungor; Onat,9,0,85,76
1656252101861,CSE 140L,A01,083088,Eldon; John,8,0,100,92
1656252107885,CSE 175,A01,083665,Kumar; Rakesh,0,0,25,25
1656252113909,CSE 190,A00,092507,Dubnov; Shlomo,3,0,20,17
1656252119933,ECE 45,A01,083139,Congero; Spencer William,1,0,75,74
1656252125962,ECE 65,A50,083695,Saad; Andrew S,9,0,30,21
1656252125962,ECE 65,A51,095125,Staff,24,0,26,2
1656252131987,ECE 109,A01,091882,Touri; Behrouz,0,1,70,70
1656252138016,ECE 180,A00,083140,Abi Samra; Nicholas Camill,1,0,30,29
1656252138016,ECE 180,B00,083141,Abi Samra; Nicholas Camill,0,4,30,30
1656252144044,MATH 10A,A01,083735,Patchell; Gregory David,0,0,30,30
1656252144044,MATH 10A,A02,083736,Patchell; Gregory David,22,0,30,8
1656252144044,MATH 10A,A03,083737,Patchell; Gregory David,16,0,30,14
1656252150074,MATH 10B,A01,083207,Lim; Seonhee,0,0,34,34
1656252150074,MATH 10B,A02,083208,Lim; Seonhee,7,0,35,28
1656252150074,MATH 10B,A03,093472,Staff,1,0,34,33
1656252150074,MATH 10B,B01,083739,Sinha; Shubham,11,0,30,19
1656252156106,MATH 18,A01,083743,Cinel; Cameron Alexander,7,0,30,23
1656252156106,MATH 18,A02,083744,Cinel; Cameron Alexander,9,0,30,21
1656252156106,MATH 18,A03,083745,Cinel; Cameron Alexander,5,0,30,25
1656252156106,MATH 18,B01,083748,Rideout; David Porter,1,0,36,35
1656252156106,MATH 18,B02,083749,Rideout; David Porter,0,0,36,36
1656252156106,MATH 18,B03,083750,Rideout; David Porter,0,0,36,36
1656252156106,MATH 18,B04,083751,Rideout; David Porter,0,1,36,36
1656252156106,MATH 18,B05,093473,Rideout; David Porter,0,0,36,36
1656252156106,MATH 18,B06,093474,Rideout; David Porter,3,0,36,33
1656252162129,MATH 20A,A01,083754,Zheng; Zequn,11,0,40,29
1656252168159,MATH 20B,A01,083756,Briones; Jor-el Thomas Caparas,0,0,36,36
1656252168159,MATH 20B,A02,083757,Briones; Jor-el Thomas Caparas,0,0,36,36
1656252168159,MATH 20B,A03,093475,Staff,0,0,36,36
1656252174196,MATH 20C,A01,083760,Briones; Jor-el Thomas Caparas,0,0,35,35
1656252174196,MATH 20C,A02,083761,Briones; Jor-el Thomas Caparas,9,1,35,26
1656252174196,MATH 20C,A03,093476,Staff,0,0,35,35
1656252174196,MATH 20C,B01,083762,Bach; Quang Tran,1,0,30,29
1656252180220,MATH 20D,A01,083765,Tran; Brian Kha,1,0,30,29
1656252180220,MATH 20D,A02,083766,Tran; Brian Kha,0,1,30,30
1656252180220,MATH 20D,A03,083767,Tran; Brian Kha,2,0,30,28
1656252186250,MATH 20E,A01,083771,Ganguly; Soumya,3,0,32,29
1656252186250,MATH 20E,A02,083772,Ganguly; Soumya,0,0,32,32
1656252186250,MATH 20E,B01,083773,Ciotti; Benjamin,16,0,35,19
1656252186250,MATH 20E,B02,083774,Ciotti; Benjamin,15,0,35,20
1656252192274,MATH 103A,A01,083777,Greenfeld; Be'Eri,1,0,36,35
1656252192274,MATH 103A,A02,083778,Greenfeld; Be'Eri,1,0,36,35
1656252192274,MATH 103A,A03,093561,Staff,5,0,36,31
1656252192274,MATH 103A,B01,083779,Greenfeld; Be'Eri,8,0,36,28
1656252192274,MATH 103A,B02,083780,Greenfeld; Be'Eri,1,0,36,35
1656252192274,MATH 103A,B03,093562,Staff,0,0,36,36
1656252198302,MATH 105,A01,085443,Carter; Anne Toulson,5,0,35,30
1656252198302,MATH 105,A02,093477,Staff,14,0,35,21
1656252204331,MATH 109,A01,083213,Ganzberger; Geoffrey Michael,0,0,34,34
1656252204331,MATH 109,A02,083214,Ganzberger; Geoffrey Michael,0,0,34,34
1656252204331,MATH 109,A03,093478,Staff,1,0,34,33
1656252204331,MATH 109,B01,083215,Ganzberger; Geoffrey Michael,4,0,32,28
1656252204331,MATH 109,B02,083216,Ganzberger; Geoffrey Michael,1,0,32,31
1656252204331,MATH 109,B03,093479,Staff,3,0,32,29
1656252210359,MATH 142A,A01,083219,Chow; Bennett,2,0,32,30
1656252210359,MATH 142A,A02,083220,Chow; Bennett,8,0,32,24
1656252210359,MATH 142A,A03,093480,Staff,5,0,32,27
1656252210359,MATH 142A,B03,093481,Staff,3,0,32,29
1656252210359,MATH 142A,B04,093558,Staff,6,0,32,26
1656252210359,MATH 142A,B05,093559,Staff,0,0,32,32
1656252216384,MATH 193A,A01,083224,Rotar; Vladimir,0,1,34,34
1656252216384,MATH 193A,A02,083225,Rotar; Vladimir,0,0,34,34
1656252216384,MATH 193A,A03,083781,Rotar; Vladimir,0,0,34,34
1656252216384,MATH 193A,A04,083782,Rotar; Vladimir,6,0,34,28
1656252216384,MATH 193A,A05,093482,Rotar; Vladimir,0,0,34,34
1656252222417,MATH 197,001,091859,McAuley; Julian John,9999,0,9999,0
1656252222417,MATH 197,002,095566,Kedlaya; Kiran S.,9997,0,9999,2
1656252222417,MATH 197,003,095567,Xiao; Ming,9999,0,9999,0
1656252222417,MATH 197,004,095571,Perols; Johan Lars,9998,0,9999,1
1656252229487,COGS 9,A01,083615,Shannon; Kyle Michael,3,0,75,72
1656252235513,COGS 11,A01,083617,Boyle; Mary E. T.,14,0,48,34
1656252241534,COGS 13,A01,083071,Bastos; Amalia Pinkusfeld,4,0,71,67
1656252247690,COGS 14A,A01,092681,Semenuks; Arturs,1,12,100,99
1656252253717,COGS 14B,A01,083073,Cheng; Tzu-Han,7,0,63,56
1656252259746,COGS 17,A01,092677,Semenuks; Arturs,7,0,81,74
1656252265771,COGS 100,A01,083619,Allen; Michael Gordon,2,0,70,68
1656252271800,COGS 101A,A01,083621,Davis; Joshua Daniel,4,0,68,64
1656252277824,COGS 101B,A01,091572,Allen; Michael Gordon,4,0,65,61
1656252283851,COGS 101C,A01,083625,Delgado; Tania,10,0,35,25
1656252289874,COGS 107A,A01,083627,Boyle; Mary E. T.,0,0,60,60
1656252295898,COGS 118A,A01,083075,Gupta; Anjum,8,0,76,68
1656252301927,CSE 3,A50,083646,Miranda; Gregory Joseph,18,0,50,32
1656252307953,CSE 8A,A50,083650,Miranda; Gregory Joseph,2,2,56,54
1656252313990,CSE 11,A01,083080,Cao; Yingjun,0,49,40,40
1656252320015,CSE 12,A01,083652,Krause-Levy; Sophia Louisa,5,1,120,115
1656252326040,CSE 15L,A01,083654,Morris; Justin Loren,2,0,50,48
1656252326040,CSE 15L,A02,083655,Morris; Justin Loren,4,0,50,46
1656252332064,CSE 20,A01,083657,Tran; Khoa Dang,30,0,80,50
1656252338093,CSE 21,A01,095574,Bach; Quang Tran,23,0,48,25
1656252344121,CSE 30,A01,083084,Eldon; John,2,6,80,78
1656252344121,CSE 30,B01,095061,Bhaskar; Nishant,0,1,50,50
1656252350145,CSE 100,A01,083659,Cao; Yingjun,1,18,70,69
1656252356169,CSE 134B,A01,083661,Powell; Thomas Allan,5,0,100,95
1656252362198,CSE 140,A01,083663,Gungor; Onat,9,0,85,76
1656252368229,CSE 140L,A01,083088,Eldon; John,8,0,100,92
1656252374251,CSE 175,A01,083665,Kumar; Rakesh,0,0,25,25
1656252380275,CSE 190,A00,092507,Dubnov; Shlomo,3,0,20,17
1656252386298,ECE 45,A01,083139,Congero; Spencer William,1,0,75,74
1656252392323,ECE 65,A50,083695,Saad; Andrew S,9,0,30,21
1656252392323,ECE 65,A51,095125,Staff,24,0,26,2
1656252398347,ECE 109,A01,091882,Touri; Behrouz,0,1,70,70
1656252404372,ECE 180,A00,083140,Abi Samra; Nicholas Camill,1,0,30,29
1656252404372,ECE 180,B00,083141,Abi Samra; Nicholas Camill,0,4,30,30
1656252410396,MATH 10A,A01,083735,Patchell; Gregory David,0,0,30,30
1656252410396,MATH 10A,A02,083736,Patchell; Gregory David,22,0,30,8
1656252410396,MATH 10A,A03,083737,Patchell; Gregory David,16,0,30,14
1656252416423,MATH 10B,A01,083207,Lim; Seonhee,0,0,34,34
1656252416423,MATH 10B,A02,083208,Lim; Seonhee,7,0,35,28
1656252416423,MATH 10B,A03,093472,Staff,1,0,34,33
1656252416423,MATH 10B,B01,083739,Sinha; Shubham,11,0,30,19
1656252422448,MATH 18,A01,083743,Cinel; Cameron Alexander,7,0,30,23
1656252422448,MATH 18,A02,083744,Cinel; Cameron Alexander,9,0,30,21
1656252422448,MATH 18,A03,083745,Cinel; Cameron Alexander,5,0,30,25
1656252422448,MATH 18,B01,083748,Rideout; David Porter,1,0,36,35
1656252422448,MATH 18,B02,083749,Rideout; David Porter,0,0,36,36
1656252422448,MATH 18,B03,083750,Rideout; David Porter,0,0,36,36
1656252422448,MATH 18,B04,083751,Rideout; David Porter,0,1,36,36
1656252422448,MATH 18,B05,093473,Rideout; David Porter,0,0,36,36
1656252422448,MATH 18,B06,093474,Rideout; David Porter,3,0,36,33
1656252428476,MATH 20A,A01,083754,Zheng; Zequn,11,0,40,29
1656252434500,MATH 20B,A01,083756,Briones; Jor-el Thomas Caparas,0,0,36,36
1656252434500,MATH 20B,A02,083757,Briones; Jor-el Thomas Caparas,0,0,36,36
1656252434500,MATH 20B,A03,093475,Staff,0,0,36,36
1656252440538,MATH 20C,A01,083760,Briones; Jor-el Thomas Caparas,0,0,35,35
1656252440538,MATH 20C,A02,083761,Briones; Jor-el Thomas Caparas,9,1,35,26
1656252440538,MATH 20C,A03,093476,Staff,0,0,35,35
1656252440538,MATH 20C,B01,083762,Bach; Quang Tran,1,0,30,29
1656252446566,MATH 20D,A01,083765,Tran; Brian Kha,1,0,30,29
1656252446566,MATH 20D,A02,083766,Tran; Brian Kha,0,1,30,30
1656252446566,MATH 20D,A03,083767,Tran; Brian Kha,2,0,30,28
1656252452593,MATH 20E,A01,083771,Ganguly; Soumya,3,0,32,29
1656252452593,MATH 20E,A02,083772,Ganguly; Soumya,0,0,32,32
1656252452593,MATH 20E,B01,083773,Ciotti; Benjamin,16,0,35,19
1656252452593,MATH 20E,B02,083774,Ciotti; Benjamin,15,0,35,20
1656252458625,MATH 103A,A01,083777,Greenfeld; Be'Eri,1,0,36,35
1656252458625,MATH 103A,A02,083778,Greenfeld; Be'Eri,1,0,36,35
1656252458625,MATH 103A,A03,093561,Staff,5,0,36,31
1656252458625,MATH 103A,B01,083779,Greenfeld; Be'Eri,8,0,36,28
1656252458625,MATH 103A,B02,083780,Greenfeld; Be'Eri,1,0,36,35
1656252458625,MATH 103A,B03,093562,Staff,0,0,36,36
1656252464654,MATH 105,A01,085443,Carter; Anne Toulson,5,0,35,30
1656252464654,MATH 105,A02,093477,Staff,14,0,35,21
1656252470701,MATH 109,A01,083213,Ganzberger; Geoffrey Michael,0,0,34,34
1656252470701,MATH 109,A02,083214,Ganzberger; Geoffrey Michael,0,0,34,34
1656252470701,MATH 109,A03,093478,Staff,1,0,34,33
1656252470701,MATH 109,B01,083215,Ganzberger; Geoffrey Michael,4,0,32,28
1656252470701,MATH 109,B02,083216,Ganzberger; Geoffrey Michael,1,0,32,31
1656252470701,MATH 109,B03,093479,Staff,3,0,32,29
1656252476738,MATH 142A,A01,083219,Chow; Bennett,2,0,32,30
1656252476738,MATH 142A,A02,083220,Chow; Bennett,8,0,32,24
1656252476738,MATH 142A,A03,093480,Staff,5,0,32,27
1656252476738,MATH 142A,B03,093481,Staff,3,0,32,29
1656252476738,MATH 142A,B04,093558,Staff,6,0,32,26
1656252476738,MATH 142A,B05,093559,Staff,0,0,32,32
1656252482765,MATH 193A,A01,083224,Rotar; Vladimir,0,1,34,34
1656252482765,MATH 193A,A02,083225,Rotar; Vladimir,0,0,34,34
1656252482765,MATH 193A,A03,083781,Rotar; Vladimir,0,0,34,34
1656252482765,MATH 193A,A04,083782,Rotar; Vladimir,6,0,34,28
1656252482765,MATH 193A,A05,093482,Rotar; Vladimir,0,0,34,34
1656252488790,MATH 197,001,091859,McAuley; Julian John,9999,0,9999,0
1656252488790,MATH 197,002,095566,Kedlaya; Kiran S.,9997,0,9999,2
1656252488790,MATH 197,003,095567,Xiao; Ming,9999,0,9999,0
1656252488790,MATH 197,004,095571,Perols; Johan Lars,9998,0,9999,1
1656252495858,COGS 9,A01,083615,Shannon; Kyle Michael,3,0,75,72
1656252501885,COGS 11,A01,083617,Boyle; Mary E. T.,14,0,48,34
1656252507909,COGS 13,A01,083071,Bastos; Amalia Pinkusfeld,4,0,71,67
1656252513942,COGS 14A,A01,092681,Semenuks; Arturs,1,12,100,99
1656252519970,COGS 14B,A01,083073,Cheng; Tzu-Han,7,0,63,56
1656252525998,COGS 17,A01,092677,Semenuks; Arturs,7,0,81,74
1656252532029,COGS 100,A01,083619,Allen; Michael Gordon,2,0,70,68
1656252538061,COGS 101A,A01,083621,Davis; Joshua Daniel,4,0,68,64
1656252544088,COGS 101B,A01,091572,Allen; Michael Gordon,4,0,65,61
1656252550117,COGS 101C,A01,083625,Delgado; Tania,10,0,35,25
1656252556144,COGS 107A,A01,083627,Boyle; Mary E. T.,0,0,60,60
1656252562171,COGS 118A,A01,083075,Gupta; Anjum,8,0,76,68
1656252568196,CSE 3,A50,083646,Miranda; Gregory Joseph,18,0,50,32
1656252574221,CSE 8A,A50,083650,Miranda; Gregory Joseph,2,2,56,54
1656252580249,CSE 11,A01,083080,Cao; Yingjun,0,49,40,40
1656252586280,CSE 12,A01,083652,Krause-Levy; Sophia Louisa,5,1,120,115
1656252592303,CSE 15L,A01,083654,Morris; Justin Loren,2,0,50,48
1656252592303,CSE 15L,A02,083655,Morris; Justin Loren,4,0,50,46
1656252598327,CSE 20,A01,083657,Tran; Khoa Dang,30,0,80,50
1656252604353,CSE 21,A01,095574,Bach; Quang Tran,23,0,48,25
1656252610375,CSE 30,A01,083084,Eldon; John,2,6,80,78
1656252610375,CSE 30,B01,095061,Bhaskar; Nishant,0,1,50,50
1656252616403,CSE 100,A01,083659,Cao; Yingjun,1,18,70,69
1656252622431,CSE 134B,A01,083661,Powell; Thomas Allan,5,0,100,95
1656252628454,CSE 140,A01,083663,Gungor; Onat,9,0,85,76
1656252634478,CSE 140L,A01,083088,Eldon; John,8,0,100,92
1656252640502,CSE 175,A01,083665,Kumar; Rakesh,0,0,25,25
1656252646525,CSE 190,A00,092507,Dubnov; Shlomo,3,0,20,17
1656252652551,ECE 45,A01,083139,Congero; Spencer William,1,0,75,74
1656252658575,ECE 65,A50,083695,Saad; Andrew S,9,0,30,21
1656252658575,ECE 65,A51,095125,Staff,24,0,26,2
1656252664599,ECE 109,A01,091882,Touri; Behrouz,0,1,70,70
1656252670624,ECE 180,A00,083140,Abi Samra; Nicholas Camill,1,0,30,29
1656252670624,ECE 180,B00,083141,Abi Samra; Nicholas Camill,0,4,30,30
1656252676651,MATH 10A,A01,083735,Patchell; Gregory David,0,0,30,30
1656252676651,MATH 10A,A02,083736,Patchell; Gregory David,22,0,30,8
1656252676651,MATH 10A,A03,083737,Patchell; Gregory David,16,0,30,14
1656252682679,MATH 10B,A01,083207,Lim; Seonhee,0,0,34,34
1656252682679,MATH 10B,A02,083208,Lim; Seonhee,7,0,35,28
1656252682679,MATH 10B,A03,093472,Staff,1,0,34,33
1656252682679,MATH 10B,B01,083739,Sinha; Shubham,11,0,30,19
1656252688713,MATH 18,A01,083743,Cinel; Cameron Alexander,7,0,30,23
1656252688713,MATH 18,A02,083744,Cinel; Cameron Alexander,9,0,30,21
1656252688713,MATH 18,A03,083745,Cinel; Cameron Alexander,5,0,30,25
1656252688713,MATH 18,B01,083748,Rideout; David Porter,1,0,36,35
1656252688713,MATH 18,B02,083749,Rideout; David Porter,0,0,36,36
1656252688713,MATH 18,B03,083750,Rideout; David Porter,0,0,36,36
1656252688713,MATH 18,B04,083751,Rideout; David Porter,0,1,36,36
1656252688713,MATH 18,B05,093473,Rideout; David Porter,0,0,36,36
1656252688713,MATH 18,B06,093474,Rideout; David Porter,3,0,36,33
1656252694739,MATH 20A,A01,083754,Zheng; Zequn,11,0,40,29
1656252700764,MATH 20B,A01,083756,Briones; Jor-el Thomas Caparas,0,0,36,36
1656252700764,MATH 20B,A02,083757,Briones; Jor-el Thomas Caparas,0,0,36,36
1656252700764,MATH 20B,A03,093475,Staff,0,0,36,36
1656252706790,MATH 20C,A01,083760,Briones; Jor-el Thomas Caparas,0,0,35,35
1656252706790,MATH 20C,A02,083761,Briones; Jor-el Thomas Caparas,9,1,35,26
1656252706790,MATH 20C,A03,093476,Staff,0,0,35,35
1656252706790,MATH 20C,B01,083762,Bach; Quang Tran,1,0,30,29
1656252712817,MATH 20D,A01,083765,Tran; Brian Kha,1,0,30,29
1656252712817,MATH 20D,A02,083766,Tran; Brian Kha,0,1,30,30
1656252712817,MATH 20D,A03,083767,Tran; Brian Kha,2,0,30,28
1656252718841,MATH 20E,A01,083771,Ganguly; Soumya,3,0,32,29
1656252718841,MATH 20E,A02,083772,Ganguly; Soumya,0,0,32,32
1656252718841,MATH 20E,B01,083773,Ciotti; Benjamin,16,0,35,19
1656252718841,MATH 20E,B02,083774,Ciotti; Benjamin,15,0,35,20
1656252724873,MATH 103A,A01,083777,Greenfeld; Be'Eri,1,0,36,35
1656252724873,MATH 103A,A02,083778,Greenfeld; Be'Eri,1,0,36,35
1656252724873,MATH 103A,A03,093561,Staff,5,0,36,31
1656252724873,MATH 103A,B01,083779,Greenfeld; Be'Eri,8,0,36,28
1656252724873,MATH 103A,B02,083780,Greenfeld; Be'Eri,1,0,36,35
1656252724873,MATH 103A,B03,093562,Staff,0,0,36,36
1656252730899,MATH 105,A01,085443,Carter; Anne Toulson,5,0,35,30
1656252730899,MATH 105,A02,093477,Staff,14,0,35,21
1656252736928,MATH 109,A01,083213,Ganzberger; Geoffrey Michael,0,0,34,34
1656252736928,MATH 109,A02,083214,Ganzberger; Geoffrey Michael,0,0,34,34
1656252736928,MATH 109,A03,093478,Staff,1,0,34,33
1656252736928,MATH 109,B01,083215,Ganzberger; Geoffrey Michael,4,0,32,28
1656252736928,MATH 109,B02,083216,Ganzberger; Geoffrey Michael,1,0,32,31
1656252736928,MATH 109,B03,093479,Staff,3,0,32,29
1656252742955,MATH 142A,A01,083219,Chow; Bennett,2,0,32,30
1656252742955,MATH 142A,A02,083220,Chow; Bennett,8,0,32,24
1656252742955,MATH 142A,A03,093480,Staff,5,0,32,27
1656252742955,MATH 142A,B03,093481,Staff,3,0,32,29
1656252742955,MATH 142A,B04,093558,Staff,6,0,32,26
1656252742955,MATH 142A,B05,093559,Staff,0,0,32,32
1656252748981,MATH 193A,A01,083224,Rotar; Vladimir,0,1,34,34
1656252748981,MATH 193A,A02,083225,Rotar; Vladimir,0,0,34,34
1656252748981,MATH 193A,A03,083781,Rotar; Vladimir,0,0,34,34
1656252748981,MATH 193A,A04,083782,Rotar; Vladimir,6,0,34,28
1656252748981,MATH 193A,A05,093482,Rotar; Vladimir,0,0,34,34
1656252755014,MATH 197,001,091859,McAuley; Julian John,9999,0,9999,0
1656252755014,MATH 197,002,095566,Kedlaya; Kiran S.,9997,0,9999,2
1656252755014,MATH 197,003,095567,Xiao; Ming,9999,0,9999,0
1656252755014,MATH 197,004,095571,Perols; Johan Lars,9998,0,9999,1
1656252762095,COGS 9,A01,083615,Shannon; Kyle Michael,3,0,75,72
1656252768131,COGS 11,A01,083617,Boyle; Mary E. T.,14,0,48,34
1656252774166,COGS 13,A01,083071,Bastos; Amalia Pinkusfeld,4,0,71,67
1656252780198,COGS 14A,A01,092681,Semenuks; Arturs,1,12,100,99
1656252786239,COGS 14B,A01,083073,Cheng; Tzu-Han,7,0,63,56
1656252792277,COGS 17,A01,092677,Semenuks; Arturs,7,0,81,74
1656252798305,COGS 100,A01,083619,Allen; Michael Gordon,2,0,70,68
1656252804334,COGS 101A,A01,083621,Davis; Joshua Daniel,4,0,68,64
1656252810368,COGS 101B,A01,091572,Allen; Michael Gordon,4,0,65,61
1656252816396,COGS 101C,A01,083625,Delgado; Tania,10,0,35,25
1656252822424,COGS 107A,A01,083627,Boyle; Mary E. T.,0,0,60,60
1656252828451,COGS 118A,A01,083075,Gupta; Anjum,8,0,76,68
1656252834489,CSE 3,A50,083646,Miranda; Gregory Joseph,18,0,50,32
1656252840535,CSE 8A,A50,083650,Miranda; Gregory Joseph,2,2,56,54
1656252846641,CSE 11,A01,083080,Cao; Yingjun,0,49,40,40
1656252852666,CSE 12,A01,083652,Krause-Levy; Sophia Louisa,5,1,120,115
1656252858693,CSE 15L,A01,083654,Morris; Justin Loren,2,0,50,48
1656252858693,CSE 15L,A02,083655,Morris; Justin Loren,4,0,50,46
1656252864717,CSE 20,A01,083657,Tran; Khoa Dang,30,0,80,50
1656252870753,CSE 21,A01,095574,Bach; Quang Tran,23,0,48,25
1656252876776,CSE 30,A01,083084,Eldon; John,2,6,80,78
1656252876776,CSE 30,B01,095061,Bhaskar; Nishant,0,1,50,50
1656252882813,CSE 100,A01,083659,Cao; Yingjun,1,18,70,69
1656252888851,CSE 134B,A01,083661,Powell; Thomas Allan,5,0,100,95
1656252894876,CSE 140,A01,083663,Gungor; Onat,9,0,85,76
1656252900921,CSE 140L,A01,083088,Eldon; John,8,0,100,92
1656252906945,CSE 175,A01,083665,Kumar; Rakesh,0,0,25,25
1656252912968,CSE 190,A00,092507,Dubnov; Shlomo,3,0,20,17
1656252919002,ECE 45,A01,083139,Congero; Spencer William,1,0,75,74
1656252925041,ECE 65,A50,083695,Saad; Andrew S,9,0,30,21
1656252925041,ECE 65,A51,095125,Staff,24,0,26,2
1656252931078,ECE 109,A01,091882,Touri; Behrouz,0,1,70,70
1656252937120,ECE 180,A00,083140,Abi Samra; Nicholas Camill,1,0,30,29
1656252937120,ECE 180,B00,083141,Abi Samra; Nicholas Camill,0,4,30,30
1656252943163,MATH 10A,A01,083735,Patchell; Gregory David,0,0,30,30
1656252943163,MATH 10A,A02,083736,Patchell; Gregory David,22,0,30,8
1656252943163,MATH 10A,A03,083737,Patchell; Gregory David,16,0,30,14
1656252949203,MATH 10B,A01,083207,Lim; Seonhee,0,0,34,34
1656252949203,MATH 10B,A02,083208,Lim; Seonhee,7,0,35,28
1656252949203,MATH 10B,A03,093472,Staff,1,0,34,33
1656252949203,MATH 10B,B01,083739,Sinha; Shubham,11,0,30,19
1656252955241,MATH 18,A01,083743,Cinel; Cameron Alexander,7,0,30,23
1656252955241,MATH 18,A02,083744,Cinel; Cameron Alexander,9,0,30,21
1656252955241,MATH 18,A03,083745,Cinel; Cameron Alexander,5,0,30,25
1656252955241,MATH 18,B01,083748,Rideout; David Porter,1,0,36,35
1656252955241,MATH 18,B02,083749,Rideout; David Porter,0,0,36,36
1656252955241,MATH 18,B03,083750,Rideout; David Porter,0,0,36,36
1656252955241,MATH 18,B04,083751,Rideout; David Porter,0,1,36,36
1656252955241,MATH 18,B05,093473,Rideout; David Porter,0,0,36,36
1656252955241,MATH 18,B06,093474,Rideout; David Porter,3,0,36,33
1656252961266,MATH 20A,A01,083754,Zheng; Zequn,11,0,40,29
1656252967292,MATH 20B,A01,083756,Briones; Jor-el Thomas Caparas,0,0,36,36
1656252967292,MATH 20B,A02,083757,Briones; Jor-el Thomas Caparas,0,0,36,36
1656252967292,MATH 20B,A03,093475,Staff,0,0,36,36
1656252973332,MATH 20C,A01,083760,Briones; Jor-el Thomas Caparas,0,0,35,35
1656252973332,MATH 20C,A02,083761,Briones; Jor-el Thomas Caparas,9,1,35,26
1656252973332,MATH 20C,A03,093476,Staff,0,0,35,35
1656252973332,MATH 20C,B01,083762,Bach; Quang Tran,1,0,30,29
1656252979384,MATH 20D,A01,083765,Tran; Brian Kha,1,0,30,29
1656252979384,MATH 20D,A02,083766,Tran; Brian Kha,0,1,30,30
1656252979384,MATH 20D,A03,083767,Tran; Brian Kha,2,0,30,28
1656252985412,MATH 20E,A01,083771,Ganguly; Soumya,3,0,32,29
1656252985412,MATH 20E,A02,083772,Ganguly; Soumya,0,0,32,32
1656252985412,MATH 20E,B01,083773,Ciotti; Benjamin,16,0,35,19
1656252985412,MATH 20E,B02,083774,Ciotti; Benjamin,15,0,35,20
1656252991460,MATH 103A,A01,083777,Greenfeld; Be'Eri,1,0,36,35
1656252991460,MATH 103A,A02,083778,Greenfeld; Be'Eri,1,0,36,35
1656252991460,MATH 103A,A03,093561,Staff,5,0,36,31
1656252991460,MATH 103A,B01,083779,Greenfeld; Be'Eri,8,0,36,28
1656252991460,MATH 103A,B02,083780,Greenfeld; Be'Eri,1,0,36,35
1656252991460,MATH 103A,B03,093562,Staff,0,0,36,36
1656252997512,MATH 105,A01,085443,Carter; Anne Toulson,5,0,35,30
1656252997512,MATH 105,A02,093477,Staff,14,0,35,21
1656253003536,MATH 109,A01,083213,Ganzberger; Geoffrey Michael,0,0,34,34
1656253003536,MATH 109,A02,083214,Ganzberger; Geoffrey Michael,0,0,34,34
1656253003536,MATH 109,A03,093478,Staff,1,0,34,33
1656253003536,MATH 109,B01,083215,Ganzberger; Geoffrey Michael,4,0,32,28
1656253003536,MATH 109,B02,083216,Ganzberger; Geoffrey Michael,1,0,32,31
1656253003536,MATH 109,B03,093479,Staff,3,0,32,29
1656253009573,MATH 142A,A01,083219,Chow; Bennett,2,0,32,30
1656253009573,MATH 142A,A02,083220,Chow; Bennett,8,0,32,24
1656253009573,MATH 142A,A03,093480,Staff,5,0,32,27
1656253009573,MATH 142A,B03,093481,Staff,3,0,32,29
1656253009573,MATH 142A,B04,093558,Staff,6,0,32,26
1656253009573,MATH 142A,B05,093559,Staff,0,0,32,32
1656253015615,MATH 193A,A01,083224,Rotar; Vladimir,0,1,34,34
1656253015615,MATH 193A,A02,083225,Rotar; Vladimir,0,0,34,34
1656253015615,MATH 193A,A03,083781,Rotar; Vladimir,0,0,34,34
1656253015615,MATH 193A,A04,083782,Rotar; Vladimir,6,0,34,28
1656253015615,MATH 193A,A05,093482,Rotar; Vladimir,0,0,34,34
1656253021639,MATH 197,001,091859,McAuley; Julian John,9999,0,9999,0
1656253021639,MATH 197,002,095566,Kedlaya; Kiran S.,9997,0,9999,2
1656253021639,MATH 197,003,095567,Xiao; Ming,9999,0,9999,0
1656253021639,MATH 197,004,095571,Perols; Johan Lars,9998,0,9999,1
1656253028729,COGS 9,A01,083615,Shannon; Kyle Michael,3,0,75,72
1656253034753,COGS 11,A01,083617,Boyle; Mary E. T.,14,0,48,34
1656253040800,COGS 13,A01,083071,Bastos; Amalia Pinkusfeld,4,0,71,67
1656253046840,COGS 14A,A01,092681,Semenuks; Arturs,1,12,100,99
1656253052876,COGS 14B,A01,083073,Cheng; Tzu-Han,7,0,63,56
1656253058912,COGS 17,A01,092677,Semenuks; Arturs,7,0,81,74
1656253064950,COGS 100,A01,083619,Allen; Michael Gordon,2,0,70,68
1656253070987,COGS 101A,A01,083621,Davis; Joshua Daniel,4,0,68,64
1656253077036,COGS 101B,A01,091572,Allen; Michael Gordon,4,0,65,61
1656253083072,COGS 101C,A01,083625,Delgado; Tania,10,0,35,25
1656253089105,COGS 107A,A01,083627,Boyle; Mary E. T.,0,0,60,60
1656253095143,COGS 118A,A01,083075,Gupta; Anjum,8,0,76,68
1656253101168,CSE 3,A50,083646,Miranda; Gregory Joseph,18,0,50,32
1656253107205,CSE 8A,A50,083650,Miranda; Gregory Joseph,2,2,56,54
1656253113227,CSE 11,A01,083080,Cao; Yingjun,0,49,40,40
1656253119256,CSE 12,A01,083652,Krause-Levy; Sophia Louisa,5,1,120,115
1656253125310,CSE 15L,A01,083654,Morris; Justin Loren,2,0,50,48
1656253125310,CSE 15L,A02,083655,Morris; Justin Loren,4,0,50,46
1656253131346,CSE 20,A01,083657,Tran; Khoa Dang,30,0,80,50
1656253137370,CSE 21,A01,095574,Bach; Quang Tran,23,0,48,25
1656253143395,CSE 30,A01,083084,Eldon; John,2,6,80,78
1656253143395,CSE 30,B01,095061,Bhaskar; Nishant,0,1,50,50
1656253149434,CSE 100,A01,083659,Cao; Yingjun,1,18,70,69
1656253155464,CSE 134B,A01,083661,Powell; Thomas Allan,5,0,100,95
1656253161494,CSE 140,A01,083663,Gungor; Onat,9,0,85,76
1656253167523,CSE 140L,A01,083088,Eldon; John,8,0,100,92
1656253173552,CSE 175,A01,083665,Kumar; Rakesh,0,0,25,25
1656253179605,CSE 190,A00,092507,Dubnov; Shlomo,3,0,20,17
1656253185631,ECE 45,A01,083139,Congero; Spencer William,1,0,75,74
1656253191674,ECE 65,A50,083695,Saad; Andrew S,9,0,30,21
1656253191674,ECE 65,A51,095125,Staff,24,0,26,2
1656253197698,ECE 109,A01,091882,Touri; Behrouz,0,1,70,70
1656253203723,ECE 180,A00,083140,Abi Samra; Nicholas Camill,1,0,30,29
1656253203723,ECE 180,B00,083141,Abi Samra; Nicholas Camill,0,4,30,30
1656253209748,MATH 10A,A01,083735,Patchell; Gregory David,0,0,30,30
1656253209748,MATH 10A,A02,083736,Patchell; Gregory David,22,0,30,8
1656253209748,MATH 10A,A03,083737,Patchell; Gregory David,16,0,30,14
1656253215773,MATH 10B,A01,083207,Lim; Seonhee,0,0,34,34
1656253215773,MATH 10B,A02,083208,Lim; Seonhee,7,0,35,28
1656253215773,MATH 10B,A03,093472,Staff,1,0,34,33
1656253215773,MATH 10B,B01,083739,Sinha; Shubham,11,0,30,19
1656253221807,MATH 18,A01,083743,Cinel; Cameron Alexander,7,0,30,23
1656253221807,MATH 18,A02,083744,Cinel; Cameron Alexander,9,0,30,21
1656253221807,MATH 18,A03,083745,Cinel; Cameron Alexander,5,0,30,25
1656253221807,MATH 18,B01,083748,Rideout; David Porter,1,0,36,35
1656253221807,MATH 18,B02,083749,Rideout; David Porter,0,0,36,36
1656253221807,MATH 18,B03,083750,Rideout; David Porter,0,0,36,36
1656253221807,MATH 18,B04,083751,Rideout; David Porter,0,1,36,36
1656253221807,MATH 18,B05,093473,Rideout; David Porter,0,0,36,36
1656253221807,MATH 18,B06,093474,Rideout; David Porter,3,0,36,33
1656253227832,MATH 20A,A01,083754,Zheng; Zequn,11,0,40,29
1656253233867,MATH 20B,A01,083756,Briones; Jor-el Thomas Caparas,0,0,36,36
1656253233867,MATH 20B,A02,083757,Briones; Jor-el Thomas Caparas,0,0,36,36
1656253233867,MATH 20B,A03,093475,Staff,0,0,36,36
1656253239899,MATH 20C,A01,083760,Briones; Jor-el Thomas Caparas,0,0,35,35
1656253239899,MATH 20C,A02,083761,Briones; Jor-el Thomas Caparas,9,1,35,26
1656253239899,MATH 20C,A03,093476,Staff,0,0,35,35
1656253239899,MATH 20C,B01,083762,Bach; Quang Tran,1,0,30,29
1656253245922,MATH 20D,A01,083765,Tran; Brian Kha,1,0,30,29
1656253245922,MATH 20D,A02,083766,Tran; Brian Kha,0,1,30,30
1656253245922,MATH 20D,A03,083767,Tran; Brian Kha,2,0,30,28
1656253251954,MATH 20E,A01,083771,Ganguly; Soumya,3,0,32,29
1656253251954,MATH 20E,A02,083772,Ganguly; Soumya,0,0,32,32
1656253251954,MATH 20E,B01,083773,Ciotti; Benjamin,16,0,35,19
1656253251954,MATH 20E,B02,083774,Ciotti; Benjamin,15,0,35,20
1656253257980,MATH 103A,A01,083777,Greenfeld; Be'Eri,1,0,36,35
1656253257980,MATH 103A,A02,083778,Greenfeld; Be'Eri,1,0,36,35
1656253257980,MATH 103A,A03,093561,Staff,5,0,36,31
1656253257980,MATH 103A,B01,083779,Greenfeld; Be'Eri,8,0,36,28
1656253257980,MATH 103A,B02,083780,Greenfeld; Be'Eri,1,0,36,35
1656253257980,MATH 103A,B03,093562,Staff,0,0,36,36
1656253264034,MATH 105,A01,085443,Carter; Anne Toulson,5,0,35,30
1656253264034,MATH 105,A02,093477,Staff,14,0,35,21
1656253270059,MATH 109,A01,083213,Ganzberger; Geoffrey Michael,0,0,34,34
1656253270059,MATH 109,A02,083214,Ganzberger; Geoffrey Michael,0,0,34,34
1656253270059,MATH 109,A03,093478,Staff,1,0,34,33
1656253270059,MATH 109,B01,083215,Ganzberger; Geoffrey Michael,4,0,32,28
1656253270059,MATH 109,B02,083216,Ganzberger; Geoffrey Michael,1,0,32,31
1656253270059,MATH 109,B03,093479,Staff,3,0,32,29
1656253276098,MATH 142A,A01,083219,Chow; Bennett,2,0,32,30
1656253276098,MATH 142A,A02,083220,Chow; Bennett,8,0,32,24
1656253276098,MATH 142A,A03,093480,Staff,5,0,32,27
1656253276098,MATH 142A,B03,093481,Staff,3,0,32,29
1656253276098,MATH 142A,B04,093558,Staff,6,0,32,26
1656253276098,MATH 142A,B05,093559,Staff,0,0,32,32
1656253282124,MATH 193A,A01,083224,Rotar; Vladimir,0,1,34,34
1656253282124,MATH 193A,A02,083225,Rotar; Vladimir,0,0,34,34
1656253282124,MATH 193A,A03,083781,Rotar; Vladimir,0,0,34,34
1656253282124,MATH 193A,A04,083782,Rotar; Vladimir,6,0,34,28
1656253282124,MATH 193A,A05,093482,Rotar; Vladimir,0,0,34,34
1656253288173,MATH 197,001,091859,McAuley; Julian John,9999,0,9999,0
1656253288173,MATH 197,002,095566,Kedlaya; Kiran S.,9997,0,9999,2
1656253288173,MATH 197,003,095567,Xiao; Ming,9999,0,9999,0
1656253288173,MATH 197,004,095571,Perols; Johan Lars,9998,0,9999,1
1656253295251,COGS 9,A01,083615,Shannon; Kyle Michael,3,0,75,72
1656253301274,COGS 11,A01,083617,Boyle; Mary E. T.,14,0,48,34
1656253307301,COGS 13,A01,083071,Bastos; Amalia Pinkusfeld,4,0,71,67
1656253313325,COGS 14A,A01,092681,Semenuks; Arturs,1,12,100,99
1656253319358,COGS 14B,A01,083073,Cheng; Tzu-Han,7,0,63,56
1656253325386,COGS 17,A01,092677,Semenuks; Arturs,7,0,81,74
1656253331415,COGS 100,A01,083619,Allen; Michael Gordon,2,0,70,68
1656253337438,COGS 101A,A01,083621,Davis; Joshua Daniel,4,0,68,64
1656253343472,COGS 101B,A01,091572,Allen; Michael Gordon,4,0,65,61
1656253349497,COGS 101C,A01,083625,Delgado; Tania,10,0,35,25
1656253355525,COGS 107A,A01,083627,Boyle; Mary E. T.,0,0,60,60
1656253361551,COGS 118A,A01,083075,Gupta; Anjum,8,0,76,68
1656253367580,CSE 3,A50,083646,Miranda; Gregory Joseph,18,0,50,32
1656253373606,CSE 8A,A50,083650,Miranda; Gregory Joseph,2,2,56,54
1656253379627,CSE 11,A01,083080,Cao; Yingjun,0,49,40,40
1656253385652,CSE 12,A01,083652,Krause-Levy; Sophia Louisa,5,1,120,115
1656253391680,CSE 15L,A01,083654,Morris; Justin Loren,2,0,50,48
1656253391680,CSE 15L,A02,083655,Morris; Justin Loren,4,0,50,46
1656253397701,CSE 20,A01,083657,Tran; Khoa Dang,30,0,80,50
1656253403739,CSE 21,A01,095574,Bach; Quang Tran,23,0,48,25
1656253409764,CSE 30,A01,083084,Eldon; John,2,6,80,78
1656253409764,CSE 30,B01,095061,Bhaskar; Nishant,0,1,50,50
1656253415788,CSE 100,A01,083659,Cao; Yingjun,1,18,70,69
1656253421835,CSE 134B,A01,083661,Powell; Thomas Allan,5,0,100,95
1656253427872,CSE 140,A01,083663,Gungor; Onat,9,0,85,76
1656253433899,CSE 140L,A01,083088,Eldon; John,8,0,100,92
1656253439923,CSE 175,A01,083665,Kumar; Rakesh,0,0,25,25
1656253446049,CSE 190,A00,092507,Dubnov; Shlomo,3,0,20,17
1656253452075,ECE 45,A01,083139,Congero; Spencer William,1,0,75,74
1656253458100,ECE 65,A50,083695,Saad; Andrew S,9,0,30,21
1656253458100,ECE 65,A51,095125,Staff,24,0,26,2
1656253464137,ECE 109,A01,091882,Touri; Behrouz,0,1,70,70
1656253470162,ECE 180,A00,083140,Abi Samra; Nicholas Camill,1,0,30,29
1656253470162,ECE 180,B00,083141,Abi Samra; Nicholas Camill,0,4,30,30
1656253476188,MATH 10A,A01,083735,Patchell; Gregory David,0,0,30,30
1656253476188,MATH 10A,A02,083736,Patchell; Gregory David,22,0,30,8
1656253476188,MATH 10A,A03,083737,Patchell; Gregory David,16,0,30,14
1656253482218,MATH 10B,A01,083207,Lim; Seonhee,0,0,34,34
1656253482218,MATH 10B,A02,083208,Lim; Seonhee,7,0,35,28
1656253482218,MATH 10B,A03,093472,Staff,1,0,34,33
1656253482218,MATH 10B,B01,083739,Sinha; Shubham,11,0,30,19
1656253488244,MATH 18,A01,083743,Cinel; Cameron Alexander,7,0,30,23
1656253488244,MATH 18,A02,083744,Cinel; Cameron Alexander,9,0,30,21
1656253488244,MATH 18,A03,083745,Cinel; Cameron Alexander,5,0,30,25
1656253488244,MATH 18,B01,083748,Rideout; David Porter,1,0,36,35
1656253488244,MATH 18,B02,083749,Rideout; David Porter,0,0,36,36
1656253488244,MATH 18,B03,083750,Rideout; David Porter,0,0,36,36
1656253488244,MATH 18,B04,083751,Rideout; David Porter,0,1,36,36
1656253488244,MATH 18,B05,093473,Rideout; David Porter,0,0,36,36
1656253488244,MATH 18,B06,093474,Rideout; David Porter,3,0,36,33
1656253494282,MATH 20A,A01,083754,Zheng; Zequn,11,0,40,29
1656253500323,MATH 20B,A01,083756,Briones; Jor-el Thomas Caparas,0,0,36,36
1656253500323,MATH 20B,A02,083757,Briones; Jor-el Thomas Caparas,0,0,36,36
1656253500323,MATH 20B,A03,093475,Staff,0,0,36,36
1656253506347,MATH 20C,A01,083760,Briones; Jor-el Thomas Caparas,0,0,35,35
1656253506347,MATH 20C,A02,083761,Briones; Jor-el Thomas Caparas,9,1,35,26
1656253506347,MATH 20C,A03,093476,Staff,0,0,35,35
1656253506347,MATH 20C,B01,083762,Bach; Quang Tran,1,0,30,29
1656253512372,MATH 20D,A01,083765,Tran; Brian Kha,1,0,30,29
1656253512372,MATH 20D,A02,083766,Tran; Brian Kha,0,1,30,30
1656253512372,MATH 20D,A03,083767,Tran; Brian Kha,2,0,30,28
1656253518402,MATH 20E,A01,083771,Ganguly; Soumya,3,0,32,29
1656253518402,MATH 20E,A02,083772,Ganguly; Soumya,0,0,32,32
1656253518402,MATH 20E,B01,083773,Ciotti; Benjamin,16,0,35,19
1656253518402,MATH 20E,B02,083774,Ciotti; Benjamin,15,0,35,20
1656253524427,MATH 103A,A01,083777,Greenfeld; Be'Eri,1,0,36,35
1656253524427,MATH 103A,A02,083778,Greenfeld; Be'Eri,1,0,36,35
1656253524427,MATH 103A,A03,093561,Staff,5,0,36,31
1656253524427,MATH 103A,B01,083779,Greenfeld; Be'Eri,8,0,36,28
1656253524427,MATH 103A,B02,083780,Greenfeld; Be'Eri,1,0,36,35
1656253524427,MATH 103A,B03,093562,Staff,0,0,36,36
1656253530454,MATH 105,A01,085443,Carter; Anne Toulson,5,0,35,30
1656253530454,MATH 105,A02,093477,Staff,14,0,35,21
1656253536489,MATH 109,A01,083213,Ganzberger; Geoffrey Michael,0,0,34,34
1656253536489,MATH 109,A02,083214,Ganzberger; Geoffrey Michael,0,0,34,34
1656253536489,MATH 109,A03,093478,Staff,1,0,34,33
1656253536489,MATH 109,B01,083215,Ganzberger; Geoffrey Michael,4,0,32,28
1656253536489,MATH 109,B02,083216,Ganzberger; Geoffrey Michael,1,0,32,31
1656253536489,MATH 109,B03,093479,Staff,3,0,32,29
1656253542515,MATH 142A,A01,083219,Chow; Bennett,2,0,32,30
1656253542515,MATH 142A,A02,083220,Chow; Bennett,8,0,32,24
1656253542515,MATH 142A,A03,093480,Staff,5,0,32,27
1656253542515,MATH 142A,B03,093481,Staff,3,0,32,29
1656253542515,MATH 142A,B04,093558,Staff,6,0,32,26
1656253542515,MATH 142A,B05,093559,Staff,0,0,32,32
1656253548540,MATH 193A,A01,083224,Rotar; Vladimir,0,1,34,34
1656253548540,MATH 193A,A02,083225,Rotar; Vladimir,0,0,34,34
1656253548540,MATH 193A,A03,083781,Rotar; Vladimir,0,0,34,34
1656253548540,MATH 193A,A04,083782,Rotar; Vladimir,6,0,34,28
1656253548540,MATH 193A,A05,093482,Rotar; Vladimir,0,0,34,34
1656253554568,MATH 197,001,091859,McAuley; Julian John,9999,0,9999,0
1656253554568,MATH 197,002,095566,Kedlaya; Kiran S.,9997,0,9999,2
1656253554568,MATH 197,003,095567,Xiao; Ming,9999,0,9999,0
1656253554568,MATH 197,004,095571,Perols; Johan Lars,9998,0,9999,1
1656253561671,COGS 9,A01,083615,Shannon; Kyle Michael,3,0,75,72
1656253567695,COGS 11,A01,083617,Boyle; Mary E. T.,14,0,48,34
1656253573741,COGS 13,A01,083071,Bastos; Amalia Pinkusfeld,4,0,71,67
1656253579777,COGS 14A,A01,092681,Semenuks; Arturs,1,12,100,99
1656253585803,COGS 14B,A01,083073,Cheng; Tzu-Han,7,0,63,56
1656253591830,COGS 17,A01,092677,Semenuks; Arturs,7,0,81,74
1656253597854,COGS 100,A01,083619,Allen; Michael Gordon,2,0,70,68
1656253603885,COGS 101A,A01,083621,Davis; Joshua Daniel,4,0,68,64
1656253609914,COGS 101B,A01,091572,Allen; Michael Gordon,4,0,65,61
1656253615938,COGS 101C,A01,083625,Delgado; Tania,10,0,35,25
1656253621962,COGS 107A,A01,083627,Boyle; Mary E. T.,0,0,60,60
1656253627987,COGS 118A,A01,083075,Gupta; Anjum,8,0,76,68
1656253634015,CSE 3,A50,083646,Miranda; Gregory Joseph,18,0,50,32
1656253640051,CSE 8A,A50,083650,Miranda; Gregory Joseph,2,2,56,54
1656253646074,CSE 11,A01,083080,Cao; Yingjun,0,49,40,40
1656253652100,CSE 12,A01,083652,Krause-Levy; Sophia Louisa,5,1,120,115
1656253658150,CSE 15L,A01,083654,Morris; Justin Loren,2,0,50,48
1656253658150,CSE 15L,A02,083655,Morris; Justin Loren,4,0,50,46
1656253664185,CSE 20,A01,083657,Tran; Khoa Dang,30,0,80,50
1656253670220,CSE 21,A01,095574,Bach; Quang Tran,23,0,48,25
1656253676244,CSE 30,A01,083084,Eldon; John,2,6,80,78
1656253676244,CSE 30,B01,095061,Bhaskar; Nishant,0,1,50,50
1656253682276,CSE 100,A01,083659,Cao; Yingjun,1,18,70,69
1656253688300,CSE 134B,A01,083661,Powell; Thomas Allan,5,0,100,95
1656253694328,CSE 140,A01,083663,Gungor; Onat,9,0,85,76
1656253700353,CSE 140L,A01,083088,Eldon; John,8,0,100,92
1656253706378,CSE 175,A01,083665,Kumar; Rakesh,0,0,25,25
1656253712402,CSE 190,A00,092507,Dubnov; Shlomo,3,0,20,17
1656253718429,ECE 45,A01,083139,Congero; Spencer William,1,0,75,74
1656253724456,ECE 65,A50,083695,Saad; Andrew S,9,0,30,21
1656253724456,ECE 65,A51,095125,Staff,24,0,26,2
1656253730486,ECE 109,A01,091882,Touri; Behrouz,0,1,70,70
1656253736509,ECE 180,A00,083140,Abi Samra; Nicholas Camill,1,0,30,29
1656253736509,ECE 180,B00,083141,Abi Samra; Nicholas Camill,0,4,30,30
1656253742536,MATH 10A,A01,083735,Patchell; Gregory David,0,0,30,30
1656253742536,MATH 10A,A02,083736,Patchell; Gregory David,22,0,30,8
1656253742536,MATH 10A,A03,083737,Patchell; Gregory David,16,0,30,14
1656253748563,MATH 10B,A01,083207,Lim; Seonhee,0,0,34,34
1656253748563,MATH 10B,A02,083208,Lim; Seonhee,7,0,35,28
1656253748563,MATH 10B,A03,093472,Staff,1,0,34,33
1656253748563,MATH 10B,B01,083739,Sinha; Shubham,11,0,30,19
1656253754591,MATH 18,A01,083743,Cinel; Cameron Alexander,7,0,30,23
1656253754591,MATH 18,A02,083744,Cinel; Cameron Alexander,9,0,30,21
1656253754591,MATH 18,A03,083745,Cinel; Cameron Alexander,5,0,30,25
1656253754591,MATH 18,B01,083748,Rideout; David Porter,1,0,36,35
1656253754591,MATH 18,B02,083749,Rideout; David Porter,0,0,36,36
1656253754591,MATH 18,B03,083750,Rideout; David Porter,0,0,36,36
1656253754591,MATH 18,B04,083751,Rideout; David Porter,0,1,36,36
1656253754591,MATH 18,B05,093473,Rideout; David Porter,0,0,36,36
1656253754591,MATH 18,B06,093474,Rideout; David Porter,3,0,36,33
1656253760620,MATH 20A,A01,083754,Zheng; Zequn,11,0,40,29
1656253766649,MATH 20B,A01,083756,Briones; Jor-el Thomas Caparas,0,0,36,36
1656253766649,MATH 20B,A02,083757,Briones; Jor-el Thomas Caparas,0,0,36,36
1656253766649,MATH 20B,A03,093475,Staff,0,0,36,36
1656253772684,MATH 20C,A01,083760,Briones; Jor-el Thomas Caparas,0,0,35,35
1656253772684,MATH 20C,A02,083761,Briones; Jor-el Thomas Caparas,9,1,35,26
1656253772684,MATH 20C,A03,093476,Staff,0,0,35,35
1656253772684,MATH 20C,B01,083762,Bach; Quang Tran,1,0,30,29
1656253778722,MATH 20D,A01,083765,Tran; Brian Kha,1,0,30,29
1656253778722,MATH 20D,A02,083766,Tran; Brian Kha,0,1,30,30
1656253778722,MATH 20D,A03,083767,Tran; Brian Kha,2,0,30,28
1656253784750,MATH 20E,A01,083771,Ganguly; Soumya,3,0,32,29
1656253784750,MATH 20E,A02,083772,Ganguly; Soumya,0,0,32,32
1656253784750,MATH 20E,B01,083773,Ciotti; Benjamin,16,0,35,19
1656253784750,MATH 20E,B02,083774,Ciotti; Benjamin,15,0,35,20
1656253790776,MATH 103A,A01,083777,Greenfeld; Be'Eri,1,0,36,35
1656253790776,MATH 103A,A02,083778,Greenfeld; Be'Eri,1,0,36,35
1656253790776,MATH 103A,A03,093561,Staff,5,0,36,31
1656253790776,MATH 103A,B01,083779,Greenfeld; Be'Eri,8,0,36,28
1656253790776,MATH 103A,B02,083780,Greenfeld; Be'Eri,1,0,36,35
1656253790776,MATH 103A,B03,093562,Staff,0,0,36,36
1656253796800,MATH 105,A01,085443,Carter; Anne Toulson,5,0,35,30
1656253796800,MATH 105,A02,093477,Staff,14,0,35,21
1656253802829,MATH 109,A01,083213,Ganzberger; Geoffrey Michael,0,0,34,34
1656253802829,MATH 109,A02,083214,Ganzberger; Geoffrey Michael,0,0,34,34
1656253802829,MATH 109,A03,093478,Staff,1,0,34,33
1656253802829,MATH 109,B01,083215,Ganzberger; Geoffrey Michael,4,0,32,28
1656253802829,MATH 109,B02,083216,Ganzberger; Geoffrey Michael,1,0,32,31
1656253802829,MATH 109,B03,093479,Staff,3,0,32,29
1656253808854,MATH 142A,A01,083219,Chow; Bennett,2,0,32,30
1656253808854,MATH 142A,A02,083220,Chow; Bennett,8,0,32,24
1656253808854,MATH 142A,A03,093480,Staff,5,0,32,27
1656253808854,MATH 142A,B03,093481,Staff,3,0,32,29
1656253808854,MATH 142A,B04,093558,Staff,6,0,32,26
1656253808854,MATH 142A,B05,093559,Staff,0,0,32,32
1656253814897,MATH 193A,A01,083224,Rotar; Vladimir,0,1,34,34
1656253814897,MATH 193A,A02,083225,Rotar; Vladimir,0,0,34,34
1656253814897,MATH 193A,A03,083781,Rotar; Vladimir,0,0,34,34
1656253814897,MATH 193A,A04,083782,Rotar; Vladimir,6,0,34,28
1656253814897,MATH 193A,A05,093482,Rotar; Vladimir,0,0,34,34
1656253820923,MATH 197,001,091859,McAuley; Julian John,9999,0,9999,0
1656253820923,MATH 197,002,095566,Kedlaya; Kiran S.,9997,0,9999,2
1656253820923,MATH 197,003,095567,Xiao; Ming,9999,0,9999,0
1656253820923,MATH 197,004,095571,Perols; Johan Lars,9998,0,9999,1
1656253827986,COGS 9,A01,083615,Shannon; Kyle Michael,3,0,75,72
1656253834013,COGS 11,A01,083617,Boyle; Mary E. T.,14,0,48,34
1656253840041,COGS 13,A01,083071,Bastos; Amalia Pinkusfeld,4,0,71,67
1656253846067,COGS 14A,A01,092681,Semenuks; Arturs,1,12,100,99
1656253852090,COGS 14B,A01,083073,Cheng; Tzu-Han,7,0,63,56
1656253858114,COGS 17,A01,092677,Semenuks; Arturs,7,0,81,74
1656253864136,COGS 100,A01,083619,Allen; Michael Gordon,2,0,70,68
1656253870167,COGS 101A,A01,083621,Davis; Joshua Daniel,4,0,68,64
1656253876192,COGS 101B,A01,091572,Allen; Michael Gordon,4,0,65,61
1656253882216,COGS 101C,A01,083625,Delgado; Tania,10,0,35,25
1656253888253,COGS 107A,A01,083627,Boyle; Mary E. T.,0,0,60,60
1656253894277,COGS 118A,A01,083075,Gupta; Anjum,8,0,76,68
1656253900302,CSE 3,A50,083646,Miranda; Gregory Joseph,18,0,50,32
1656253906326,CSE 8A,A50,083650,Miranda; Gregory Joseph,2,2,56,54
1656253912351,CSE 11,A01,083080,Cao; Yingjun,0,49,40,40
1656253918374,CSE 12,A01,083652,Krause-Levy; Sophia Louisa,5,1,120,115
1656253924414,CSE 15L,A01,083654,Morris; Justin Loren,2,0,50,48
1656253924414,CSE 15L,A02,083655,Morris; Justin Loren,4,0,50,46
1656253930436,CSE 20,A01,083657,Tran; Khoa Dang,30,0,80,50
1656253936486,CSE 21,A01,095574,Bach; Quang Tran,23,0,48,25
1656253942513,CSE 30,A01,083084,Eldon; John,2,6,80,78
1656253942513,CSE 30,B01,095061,Bhaskar; Nishant,0,1,50,50
1656253948540,CSE 100,A01,083659,Cao; Yingjun,1,18,70,69
1656253954563,CSE 134B,A01,083661,Powell; Thomas Allan,5,0,100,95
1656253960588,CSE 140,A01,083663,Gungor; Onat,9,0,85,76
1656253966612,CSE 140L,A01,083088,Eldon; John,8,0,100,92
1656253972636,CSE 175,A01,083665,Kumar; Rakesh,0,0,25,25
1656253978667,CSE 190,A00,092507,Dubnov; Shlomo,3,0,20,17
1656253984693,ECE 45,A01,083139,Congero; Spencer William,1,0,75,74
1656253990717,ECE 65,A50,083695,Saad; Andrew S,9,0,30,21
1656253990717,ECE 65,A51,095125,Staff,24,0,26,2
1656253996741,ECE 109,A01,091882,Touri; Behrouz,0,1,70,70
1656254002770,ECE 180,A00,083140,Abi Samra; Nicholas Camill,1,0,30,29
1656254002770,ECE 180,B00,083141,Abi Samra; Nicholas Camill,0,4,30,30
1656254008798,MATH 10A,A01,083735,Patchell; Gregory David,0,0,30,30
1656254008798,MATH 10A,A02,083736,Patchell; Gregory David,22,0,30,8
1656254008798,MATH 10A,A03,083737,Patchell; Gregory David,16,0,30,14
1656254014822,MATH 10B,A01,083207,Lim; Seonhee,0,0,34,34
1656254014822,MATH 10B,A02,083208,Lim; Seonhee,7,0,35,28
1656254014822,MATH 10B,A03,093472,Staff,1,0,34,33
1656254014822,MATH 10B,B01,083739,Sinha; Shubham,11,0,30,19
1656254020868,MATH 18,A01,083743,Cinel; Cameron Alexander,7,0,30,23
1656254020868,MATH 18,A02,083744,Cinel; Cameron Alexander,9,0,30,21
1656254020868,MATH 18,A03,083745,Cinel; Cameron Alexander,5,0,30,25
1656254020868,MATH 18,B01,083748,Rideout; David Porter,1,0,36,35
1656254020868,MATH 18,B02,083749,Rideout; David Porter,0,0,36,36
1656254020868,MATH 18,B03,083750,Rideout; David Porter,0,0,36,36
1656254020868,MATH 18,B04,083751,Rideout; David Porter,0,1,36,36
1656254020868,MATH 18,B05,093473,Rideout; David Porter,0,0,36,36
1656254020868,MATH 18,B06,093474,Rideout; David Porter,3,0,36,33
1656254026894,MATH 20A,A01,083754,Zheng; Zequn,11,0,40,29
1656254032918,MATH 20B,A01,083756,Briones; Jor-el Thomas Caparas,0,0,36,36
1656254032918,MATH 20B,A02,083757,Briones; Jor-el Thomas Caparas,0,0,36,36
1656254032918,MATH 20B,A03,093475,Staff,0,0,36,36
1656254038948,MATH 20C,A01,083760,Briones; Jor-el Thomas Caparas,0,0,35,35
1656254038948,MATH 20C,A02,083761,Briones; Jor-el Thomas Caparas,9,1,35,26
1656254038948,MATH 20C,A03,093476,Staff,0,0,35,35
1656254038948,MATH 20C,B01,083762,Bach; Quang Tran,1,0,30,29
1656254045075,MATH 20D,A01,083765,Tran; Brian Kha,1,0,30,29
1656254045075,MATH 20D,A02,083766,Tran; Brian Kha,0,1,30,30
1656254045075,MATH 20D,A03,083767,Tran; Brian Kha,2,0,30,28
1656254051107,MATH 20E,A01,083771,Ganguly; Soumya,3,0,32,29
1656254051107,MATH 20E,A02,083772,Ganguly; Soumya,0,0,32,32
1656254051107,MATH 20E,B01,083773,Ciotti; Benjamin,16,0,35,19
1656254051107,MATH 20E,B02,083774,Ciotti; Benjamin,15,0,35,20
1656254057143,MATH 103A,A01,083777,Greenfeld; Be'Eri,1,0,36,35
1656254057143,MATH 103A,A02,083778,Greenfeld; Be'Eri,1,0,36,35
1656254057143,MATH 103A,A03,093561,Staff,5,0,36,31
1656254057143,MATH 103A,B01,083779,Greenfeld; Be'Eri,8,0,36,28
1656254057143,MATH 103A,B02,083780,Greenfeld; Be'Eri,1,0,36,35
1656254057143,MATH 103A,B03,093562,Staff,0,0,36,36
1656254063170,MATH 105,A01,085443,Carter; Anne Toulson,5,0,35,30
1656254063170,MATH 105,A02,093477,Staff,14,0,35,21
1656254069196,MATH 109,A01,083213,Ganzberger; Geoffrey Michael,0,0,34,34
1656254069196,MATH 109,A02,083214,Ganzberger; Geoffrey Michael,0,0,34,34
1656254069196,MATH 109,A03,093478,Staff,1,0,34,33
1656254069196,MATH 109,B01,083215,Ganzberger; Geoffrey Michael,4,0,32,28
1656254069196,MATH 109,B02,083216,Ganzberger; Geoffrey Michael,1,0,32,31
1656254069196,MATH 109,B03,093479,Staff,3,0,32,29
1656254075221,MATH 142A,A01,083219,Chow; Bennett,2,0,32,30
1656254075221,MATH 142A,A02,083220,Chow; Bennett,8,0,32,24
1656254075221,MATH 142A,A03,093480,Staff,5,0,32,27
1656254075221,MATH 142A,B03,093481,Staff,3,0,32,29
1656254075221,MATH 142A,B04,093558,Staff,6,0,32,26
1656254075221,MATH 142A,B05,093559,Staff,0,0,32,32
1656254081249,MATH 193A,A01,083224,Rotar; Vladimir,0,1,34,34
1656254081249,MATH 193A,A02,083225,Rotar; Vladimir,0,0,34,34
1656254081249,MATH 193A,A03,083781,Rotar; Vladimir,0,0,34,34
1656254081249,MATH 193A,A04,083782,Rotar; Vladimir,6,0,34,28
1656254081249,MATH 193A,A05,093482,Rotar; Vladimir,0,0,34,34
1656254087284,MATH 197,001,091859,McAuley; Julian John,9999,0,9999,0
1656254087284,MATH 197,002,095566,Kedlaya; Kiran S.,9997,0,9999,2
1656254087284,MATH 197,003,095567,Xiao; Ming,9999,0,9999,0
1656254087284,MATH 197,004,095571,Perols; Johan Lars,9998,0,9999,1
1656254094361,COGS 9,A01,083615,Shannon; Kyle Michael,3,0,75,72
1656254100389,COGS 11,A01,083617,Boyle; Mary E. T.,14,0,48,34
1656254106413,COGS 13,A01,083071,Bastos; Amalia Pinkusfeld,4,0,71,67
1656254112436,COGS 14A,A01,092681,Semenuks; Arturs,1,12,100,99
1656254118460,COGS 14B,A01,083073,Cheng; Tzu-Han,7,0,63,56
1656254124488,COGS 17,A01,092677,Semenuks; Arturs,7,0,81,74
1656254130515,COGS 100,A01,083619,Allen; Michael Gordon,2,0,70,68
1656254136546,COGS 101A,A01,083621,Davis; Joshua Daniel,4,0,68,64
1656254142581,COGS 101B,A01,091572,Allen; Michael Gordon,4,0,65,61
1656254148613,COGS 101C,A01,083625,Delgado; Tania,10,0,35,25
1656254154642,COGS 107A,A01,083627,Boyle; Mary E. T.,0,0,60,60
1656254160676,COGS 118A,A01,083075,Gupta; Anjum,8,0,76,68
1656254166705,CSE 3,A50,083646,Miranda; Gregory Joseph,18,0,50,32
1656254172741,CSE 8A,A50,083650,Miranda; Gregory Joseph,2,2,56,54
1656254178769,CSE 11,A01,083080,Cao; Yingjun,0,49,40,40
1656254184806,CSE 12,A01,083652,Krause-Levy; Sophia Louisa,5,1,120,115
1656254190832,CSE 15L,A01,083654,Morris; Justin Loren,2,0,50,48
1656254190832,CSE 15L,A02,083655,Morris; Justin Loren,4,0,50,46
1656254196855,CSE 20,A01,083657,Tran; Khoa Dang,30,0,80,50
1656254202897,CSE 21,A01,095574,Bach; Quang Tran,23,0,48,25
1656254208921,CSE 30,A01,083084,Eldon; John,2,6,80,78
1656254208921,CSE 30,B01,095061,Bhaskar; Nishant,0,1,50,50
1656254214966,CSE 100,A01,083659,Cao; Yingjun,1,18,70,69
1656254221003,CSE 134B,A01,083661,Powell; Thomas Allan,5,0,100,95
1656254227038,CSE 140,A01,083663,Gungor; Onat,9,0,85,76
1656254233061,CSE 140L,A01,083088,Eldon; John,8,0,100,92
1656254239094,CSE 175,A01,083665,Kumar; Rakesh,0,0,25,25
1656254245122,CSE 190,A00,092507,Dubnov; Shlomo,3,0,20,17
1656254251149,ECE 45,A01,083139,Congero; Spencer William,1,0,75,74
1656254257172,ECE 65,A50,083695,Saad; Andrew S,9,0,30,21
1656254257172,ECE 65,A51,095125,Staff,24,0,26,2
1656254263196,ECE 109,A01,091882,Touri; Behrouz,0,1,70,70
1656254269231,ECE 180,A00,083140,Abi Samra; Nicholas Camill,1,0,30,29
1656254269231,ECE 180,B00,083141,Abi Samra; Nicholas Camill,0,4,30,30
1656254275260,MATH 10A,A01,083735,Patchell; Gregory David,0,0,30,30
1656254275260,MATH 10A,A02,083736,Patchell; Gregory David,22,0,30,8
1656254275260,MATH 10A,A03,083737,Patchell; Gregory David,16,0,30,14
1656254281296,MATH 10B,A01,083207,Lim; Seonhee,0,0,34,34
1656254281296,MATH 10B,A02,083208,Lim; Seonhee,7,0,35,28
1656254281296,MATH 10B,A03,093472,Staff,1,0,34,33
1656254281296,MATH 10B,B01,083739,Sinha; Shubham,11,0,30,19
1656254287338,MATH 18,A01,083743,Cinel; Cameron Alexander,7,0,30,23
1656254287338,MATH 18,A02,083744,Cinel; Cameron Alexander,9,0,30,21
1656254287338,MATH 18,A03,083745,Cinel; Cameron Alexander,5,0,30,25
1656254287338,MATH 18,B01,083748,Rideout; David Porter,1,0,36,35
1656254287338,MATH 18,B02,083749,Rideout; David Porter,0,0,36,36
1656254287338,MATH 18,B03,083750,Rideout; David Porter,0,0,36,36
1656254287338,MATH 18,B04,083751,Rideout; David Porter,0,1,36,36
1656254287338,MATH 18,B05,093473,Rideout; David Porter,0,0,36,36
1656254287338,MATH 18,B06,093474,Rideout; David Porter,3,0,36,33
1656254293389,MATH 20A,A01,083754,Zheng; Zequn,11,0,40,29
1656254299416,MATH 20B,A01,083756,Briones; Jor-el Thomas Caparas,0,0,36,36
1656254299416,MATH 20B,A02,083757,Briones; Jor-el Thomas Caparas,0,0,36,36
1656254299416,MATH 20B,A03,093475,Staff,0,0,36,36
1656254305453,MATH 20C,A01,083760,Briones; Jor-el Thomas Caparas,0,0,35,35
1656254305453,MATH 20C,A02,083761,Briones; Jor-el Thomas Caparas,9,1,35,26
1656254305453,MATH 20C,A03,093476,Staff,0,0,35,35
1656254305453,MATH 20C,B01,083762,Bach; Quang Tran,1,0,30,29
1656254311479,MATH 20D,A01,083765,Tran; Brian Kha,1,0,30,29
1656254311479,MATH 20D,A02,083766,Tran; Brian Kha,0,1,30,30
1656254311479,MATH 20D,A03,083767,Tran; Brian Kha,2,0,30,28
1656254317514,MATH 20E,A01,083771,Ganguly; Soumya,3,0,32,29
1656254317514,MATH 20E,A02,083772,Ganguly; Soumya,0,0,32,32
1656254317514,MATH 20E,B01,083773,Ciotti; Benjamin,16,0,35,19
1656254317514,MATH 20E,B02,083774,Ciotti; Benjamin,15,0,35,20
1656254323550,MATH 103A,A01,083777,Greenfeld; Be'Eri,1,0,36,35
1656254323550,MATH 103A,A02,083778,Greenfeld; Be'Eri,1,0,36,35
1656254323550,MATH 103A,A03,093561,Staff,5,0,36,31
1656254323550,MATH 103A,B01,083779,Greenfeld; Be'Eri,8,0,36,28
1656254323550,MATH 103A,B02,083780,Greenfeld; Be'Eri,1,0,36,35
1656254323550,MATH 103A,B03,093562,Staff,0,0,36,36
1656254329574,MATH 105,A01,085443,Carter; Anne Toulson,5,0,35,30
1656254329574,MATH 105,A02,093477,Staff,14,0,35,21
1656254335605,MATH 109,A01,083213,Ganzberger; Geoffrey Michael,0,0,34,34
1656254335605,MATH 109,A02,083214,Ganzberger; Geoffrey Michael,0,0,34,34
1656254335605,MATH 109,A03,093478,Staff,1,0,34,33
1656254335605,MATH 109,B01,083215,Ganzberger; Geoffrey Michael,4,0,32,28
1656254335605,MATH 109,B02,083216,Ganzberger; Geoffrey Michael,1,0,32,31
1656254335605,MATH 109,B03,093479,Staff,3,0,32,29
1656254341635,MATH 142A,A01,083219,Chow; Bennett,2,0,32,30
1656254341635,MATH 142A,A02,083220,Chow; Bennett,8,0,32,24
1656254341635,MATH 142A,A03,093480,Staff,5,0,32,27
1656254341635,MATH 142A,B03,093481,Staff,3,0,32,29
1656254341635,MATH 142A,B04,093558,Staff,6,0,32,26
1656254341635,MATH 142A,B05,093559,Staff,0,0,32,32
1656254347668,MATH 193A,A01,083224,Rotar; Vladimir,0,1,34,34
1656254347668,MATH 193A,A02,083225,Rotar; Vladimir,0,0,34,34
1656254347668,MATH 193A,A03,083781,Rotar; Vladimir,0,0,34,34
1656254347668,MATH 193A,A04,083782,Rotar; Vladimir,6,0,34,28
1656254347668,MATH 193A,A05,093482,Rotar; Vladimir,0,0,34,34
1656254353701,MATH 197,001,091859,McAuley; Julian John,9999,0,9999,0
1656254353701,MATH 197,002,095566,Kedlaya; Kiran S.,9997,0,9999,2
1656254353701,MATH 197,003,095567,Xiao; Ming,9999,0,9999,0
1656254353701,MATH 197,004,095571,Perols; Johan Lars,9998,0,9999,1
1656254360773,COGS 9,A01,083615,Shannon; Kyle Michael,3,0,75,72
1656254366803,COGS 11,A01,083617,Boyle; Mary E. T.,14,0,48,34
1656254372843,COGS 13,A01,083071,Bastos; Amalia Pinkusfeld,4,0,71,67
1656254378866,COGS 14A,A01,092681,Semenuks; Arturs,1,12,100,99
1656254384893,COGS 14B,A01,083073,Cheng; Tzu-Han,7,0,63,56
1656254390920,COGS 17,A01,092677,Semenuks; Arturs,7,0,81,74
1656254396949,COGS 100,A01,083619,Allen; Michael Gordon,2,0,70,68
1656254402982,COGS 101A,A01,083621,Davis; Joshua Daniel,4,0,68,64
1656254409018,COGS 101B,A01,091572,Allen; Michael Gordon,4,0,65,61
1656254415041,COGS 101C,A01,083625,Delgado; Tania,10,0,35,25
1656254421084,COGS 107A,A01,083627,Boyle; Mary E. T.,0,0,60,60
1656254427119,COGS 118A,A01,083075,Gupta; Anjum,8,0,76,68
1656254433144,CSE 3,A50,083646,Miranda; Gregory Joseph,18,0,50,32
1656254439173,CSE 8A,A50,083650,Miranda; Gregory Joseph,2,2,56,54
1656254445196,CSE 11,A01,083080,Cao; Yingjun,0,49,40,40
1656254451221,CSE 12,A01,083652,Krause-Levy; Sophia Louisa,5,1,120,115
1656254457257,CSE 15L,A01,083654,Morris; Justin Loren,2,0,50,48
1656254457257,CSE 15L,A02,083655,Morris; Justin Loren,4,0,50,46
1656254463300,CSE 20,A01,083657,Tran; Khoa Dang,30,0,80,50
1656254469334,CSE 21,A01,095574,Bach; Quang Tran,23,0,48,25
1656254475363,CSE 30,A01,083084,Eldon; John,2,6,80,78
1656254475363,CSE 30,B01,095061,Bhaskar; Nishant,0,1,50,50
1656254481387,CSE 100,A01,083659,Cao; Yingjun,1,18,70,69
1656254487412,CSE 134B,A01,083661,Powell; Thomas Allan,5,0,100,95
1656254493452,CSE 140,A01,083663,Gungor; Onat,9,0,85,76
1656254499479,CSE 140L,A01,083088,Eldon; John,8,0,100,92
1656254505504,CSE 175,A01,083665,Kumar; Rakesh,0,0,25,25
1656254511531,CSE 190,A00,092507,Dubnov; Shlomo,3,0,20,17
1656254517555,ECE 45,A01,083139,Congero; Spencer William,1,0,75,74
1656254523594,ECE 65,A50,083695,Saad; Andrew S,9,0,30,21
1656254523594,ECE 65,A51,095125,Staff,24,0,26,2
1656254529616,ECE 109,A01,091882,Touri; Behrouz,0,1,70,70
1656254535641,ECE 180,A00,083140,Abi Samra; Nicholas Camill,1,0,30,29
1656254535641,ECE 180,B00,083141,Abi Samra; Nicholas Camill,0,4,30,30
1656254541676,MATH 10A,A01,083735,Patchell; Gregory David,0,0,30,30
1656254541676,MATH 10A,A02,083736,Patchell; Gregory David,22,0,30,8
1656254541676,MATH 10A,A03,083737,Patchell; Gregory David,16,0,30,14
1656254547727,MATH 10B,A01,083207,Lim; Seonhee,0,0,34,34
1656254547727,MATH 10B,A02,083208,Lim; Seonhee,7,0,35,28
1656254547727,MATH 10B,A03,093472,Staff,1,0,34,33
1656254547727,MATH 10B,B01,083739,Sinha; Shubham,11,0,30,19
1656254553750,MATH 18,A01,083743,Cinel; Cameron Alexander,7,0,30,23
1656254553750,MATH 18,A02,083744,Cinel; Cameron Alexander,9,0,30,21
1656254553750,MATH 18,A03,083745,Cinel; Cameron Alexander,5,0,30,25
1656254553750,MATH 18,B01,083748,Rideout; David Porter,1,0,36,35
1656254553750,MATH 18,B02,083749,Rideout; David Porter,0,0,36,36
1656254553750,MATH 18,B03,083750,Rideout; David Porter,0,0,36,36
1656254553750,MATH 18,B04,083751,Rideout; David Porter,0,1,36,36
1656254553750,MATH 18,B05,093473,Rideout; David Porter,0,0,36,36
1656254553750,MATH 18,B06,093474,Rideout; David Porter,3,0,36,33
1656254559783,MATH 20A,A01,083754,Zheng; Zequn,11,0,40,29
1656254565807,MATH 20B,A01,083756,Briones; Jor-el Thomas Caparas,0,0,36,36
1656254565807,MATH 20B,A02,083757,Briones; Jor-el Thomas Caparas,0,0,36,36
1656254565807,MATH 20B,A03,093475,Staff,0,0,36,36
1656254571848,MATH 20C,A01,083760,Briones; Jor-el Thomas Caparas,0,0,35,35
1656254571848,MATH 20C,A02,083761,Briones; Jor-el Thomas Caparas,9,1,35,26
1656254571848,MATH 20C,A03,093476,Staff,0,0,35,35
1656254571848,MATH 20C,B01,083762,Bach; Quang Tran,1,0,30,29
1656254577879,MATH 20D,A01,083765,Tran; Brian Kha,1,0,30,29
1656254577879,MATH 20D,A02,083766,Tran; Brian Kha,0,1,30,30
1656254577879,MATH 20D,A03,083767,Tran; Brian Kha,2,0,30,28
1656254583916,MATH 20E,A01,083771,Ganguly; Soumya,3,0,32,29
1656254583916,MATH 20E,A02,083772,Ganguly; Soumya,0,0,32,32
1656254583916,MATH 20E,B01,083773,Ciotti; Benjamin,16,0,35,19
1656254583916,MATH 20E,B02,083774,Ciotti; Benjamin,15,0,35,20
1656254589949,MATH 103A,A01,083777,Greenfeld; Be'Eri,1,0,36,35
1656254589949,MATH 103A,A02,083778,Greenfeld; Be'Eri,1,0,36,35
1656254589949,MATH 103A,A03,093561,Staff,5,0,36,31
1656254589949,MATH 103A,B01,083779,Greenfeld; Be'Eri,8,0,36,28
1656254589949,MATH 103A,B02,083780,Greenfeld; Be'Eri,1,0,36,35
1656254589949,MATH 103A,B03,093562,Staff,0,0,36,36
1656254595974,MATH 105,A01,085443,Carter; Anne Toulson,5,0,35,30
1656254595974,MATH 105,A02,093477,Staff,14,0,35,21
1656254601998,MATH 109,A01,083213,Ganzberger; Geoffrey Michael,0,0,34,34
1656254601998,MATH 109,A02,083214,Ganzberger; Geoffrey Michael,0,0,34,34
1656254601998,MATH 109,A03,093478,Staff,1,0,34,33
1656254601998,MATH 109,B01,083215,Ganzberger; Geoffrey Michael,4,0,32,28
1656254601998,MATH 109,B02,083216,Ganzberger; Geoffrey Michael,1,0,32,31
1656254601998,MATH 109,B03,093479,Staff,3,0,32,29
1656254608032,MATH 142A,A01,083219,Chow; Bennett,2,0,32,30
1656254608032,MATH 142A,A02,083220,Chow; Bennett,8,0,32,24
1656254608032,MATH 142A,A03,093480,Staff,5,0,32,27
1656254608032,MATH 142A,B03,093481,Staff,3,0,32,29
1656254608032,MATH 142A,B04,093558,Staff,6,0,32,26
1656254608032,MATH 142A,B05,093559,Staff,0,0,32,32
1656254614067,MATH 193A,A01,083224,Rotar; Vladimir,0,1,34,34
1656254614067,MATH 193A,A02,083225,Rotar; Vladimir,0,0,34,34
1656254614067,MATH 193A,A03,083781,Rotar; Vladimir,0,0,34,34
1656254614067,MATH 193A,A04,083782,Rotar; Vladimir,6,0,34,28
1656254614067,MATH 193A,A05,093482,Rotar; Vladimir,0,0,34,34
1656254620098,MATH 197,001,091859,McAuley; Julian John,9999,0,9999,0
1656254620098,MATH 197,002,095566,Kedlaya; Kiran S.,9997,0,9999,2
1656254620098,MATH 197,003,095567,Xiao; Ming,9999,0,9999,0
1656254620098,MATH 197,004,095571,Perols; Johan Lars,9998,0,9999,1
1656254627189,COGS 9,A01,083615,Shannon; Kyle Michael,3,0,75,72
1656254633219,COGS 11,A01,083617,Boyle; Mary E. T.,14,0,48,34
1656254639364,COGS 13,A01,083071,Bastos; Amalia Pinkusfeld,5,0,71,66
1656254645398,COGS 14A,A01,092681,Semenuks; Arturs,1,12,100,99
1656254651430,COGS 14B,A01,083073,Cheng; Tzu-Han,7,0,63,56
1656254657472,COGS 17,A01,092677,Semenuks; Arturs,8,0,81,73
1656254663510,COGS 100,A01,083619,Allen; Michael Gordon,2,0,70,68
1656254669538,COGS 101A,A01,083621,Davis; Joshua Daniel,4,0,68,64
1656254675585,COGS 101B,A01,091572,Allen; Michael Gordon,4,0,65,61
1656254681621,COGS 101C,A01,083625,Delgado; Tania,10,0,35,25
1656254687662,COGS 107A,A01,083627,Boyle; Mary E. T.,0,0,60,60
1656254693686,COGS 118A,A01,083075,Gupta; Anjum,8,0,76,68
1656254699735,CSE 3,A50,083646,Miranda; Gregory Joseph,18,0,50,32
1656254705770,CSE 8A,A50,083650,Miranda; Gregory Joseph,2,2,56,54
1656254711794,CSE 11,A01,083080,Cao; Yingjun,0,49,40,40
1656254717844,CSE 12,A01,083652,Krause-Levy; Sophia Louisa,5,1,120,115
1656254723871,CSE 15L,A01,083654,Morris; Justin Loren,2,0,50,48
1656254723871,CSE 15L,A02,083655,Morris; Justin Loren,4,0,50,46
1656254729912,CSE 20,A01,083657,Tran; Khoa Dang,30,0,80,50
1656254735938,CSE 21,A01,095574,Bach; Quang Tran,23,0,48,25
1656254741966,CSE 30,A01,083084,Eldon; John,2,6,80,78
1656254741966,CSE 30,B01,095061,Bhaskar; Nishant,0,1,50,50
1656254747991,CSE 100,A01,083659,Cao; Yingjun,1,18,70,69
1656254754026,CSE 134B,A01,083661,Powell; Thomas Allan,5,0,100,95
1656254760059,CSE 140,A01,083663,Gungor; Onat,9,0,85,76
1656254766112,CSE 140L,A01,083088,Eldon; John,8,0,100,92
1656254772149,CSE 175,A01,083665,Kumar; Rakesh,0,0,25,25
1656254778183,CSE 190,A00,092507,Dubnov; Shlomo,3,0,20,17
1656254784216,ECE 45,A01,083139,Congero; Spencer William,1,0,75,74
1656254790245,ECE 65,A50,083695,Saad; Andrew S,9,0,30,21
1656254790245,ECE 65,A51,095125,Staff,24,0,26,2
1656254796277,ECE 109,A01,091882,Touri; Behrouz,0,1,70,70
1656254802317,ECE 180,A00,083140,Abi Samra; Nicholas Camill,1,0,30,29
1656254802317,ECE 180,B00,083141,Abi Samra; Nicholas Camill,0,4,30,30
1656254808360,MATH 10A,A01,083735,Patchell; Gregory David,0,0,30,30
1656254808360,MATH 10A,A02,083736,Patchell; Gregory David,22,0,30,8
1656254808360,MATH 10A,A03,083737,Patchell; Gregory David,16,0,30,14
1656254814396,MATH 10B,A01,083207,Lim; Seonhee,0,0,34,34
1656254814396,MATH 10B,A02,083208,Lim; Seonhee,7,0,35,28
1656254814396,MATH 10B,A03,093472,Staff,1,0,34,33
1656254814396,MATH 10B,B01,083739,Sinha; Shubham,11,0,30,19
1656254820419,MATH 18,A01,083743,Cinel; Cameron Alexander,7,0,30,23
1656254820419,MATH 18,A02,083744,Cinel; Cameron Alexander,9,0,30,21
1656254820419,MATH 18,A03,083745,Cinel; Cameron Alexander,5,0,30,25
1656254820419,MATH 18,B01,083748,Rideout; David Porter,1,0,36,35
1656254820419,MATH 18,B02,083749,Rideout; David Porter,0,0,36,36
1656254820419,MATH 18,B03,083750,Rideout; David Porter,0,0,36,36
1656254820419,MATH 18,B04,083751,Rideout; David Porter,0,1,36,36
1656254820419,MATH 18,B05,093473,Rideout; David Porter,0,0,36,36
1656254820419,MATH 18,B06,093474,Rideout; David Porter,3,0,36,33
1656254826459,MATH 20A,A01,083754,Zheng; Zequn,11,0,40,29
1656254832516,MATH 20B,A01,083756,Briones; Jor-el Thomas Caparas,0,0,36,36
1656254832516,MATH 20B,A02,083757,Briones; Jor-el Thomas Caparas,0,0,36,36
1656254832516,MATH 20B,A03,093475,Staff,0,0,36,36
1656254838540,MATH 20C,A01,083760,Briones; Jor-el Thomas Caparas,0,0,35,35
1656254838540,MATH 20C,A02,083761,Briones; Jor-el Thomas Caparas,9,1,35,26
1656254838540,MATH 20C,A03,093476,Staff,0,0,35,35
1656254838540,MATH 20C,B01,083762,Bach; Quang Tran,1,0,30,29
1656254844564,MATH 20D,A01,083765,Tran; Brian Kha,1,0,30,29
1656254844564,MATH 20D,A02,083766,Tran; Brian Kha,0,1,30,30
1656254844564,MATH 20D,A03,083767,Tran; Brian Kha,2,0,30,28
1656254850589,MATH 20E,A01,083771,Ganguly; Soumya,3,0,32,29
1656254850589,MATH 20E,A02,083772,Ganguly; Soumya,0,0,32,32
1656254850589,MATH 20E,B01,083773,Ciotti; Benjamin,16,0,35,19
1656254850589,MATH 20E,B02,083774,Ciotti; Benjamin,15,0,35,20
1656254856639,MATH 103A,A01,083777,Greenfeld; Be'Eri,1,0,36,35
1656254856639,MATH 103A,A02,083778,Greenfeld; Be'Eri,1,0,36,35
1656254856639,MATH 103A,A03,093561,Staff,5,0,36,31
1656254856639,MATH 103A,B01,083779,Greenfeld; Be'Eri,8,0,36,28
1656254856639,MATH 103A,B02,083780,Greenfeld; Be'Eri,1,0,36,35
1656254856639,MATH 103A,B03,093562,Staff,0,0,36,36
1656254862667,MATH 105,A01,085443,Carter; Anne Toulson,5,0,35,30
1656254862667,MATH 105,A02,093477,Staff,14,0,35,21
1656254868701,MATH 109,A01,083213,Ganzberger; Geoffrey Michael,0,0,34,34
1656254868701,MATH 109,A02,083214,Ganzberger; Geoffrey Michael,0,0,34,34
1656254868701,MATH 109,A03,093478,Staff,1,0,34,33
1656254868701,MATH 109,B01,083215,Ganzberger; Geoffrey Michael,4,0,32,28
1656254868701,MATH 109,B02,083216,Ganzberger; Geoffrey Michael,1,0,32,31
1656254868701,MATH 109,B03,093479,Staff,3,0,32,29
1656254874726,MATH 142A,A01,083219,Chow; Bennett,2,0,32,30
1656254874726,MATH 142A,A02,083220,Chow; Bennett,8,0,32,24
1656254874726,MATH 142A,A03,093480,Staff,5,0,32,27
1656254874726,MATH 142A,B03,093481,Staff,3,0,32,29
1656254874726,MATH 142A,B04,093558,Staff,6,0,32,26
1656254874726,MATH 142A,B05,093559,Staff,0,0,32,32
1656254880757,MATH 193A,A01,083224,Rotar; Vladimir,0,1,34,34
1656254880757,MATH 193A,A02,083225,Rotar; Vladimir,0,0,34,34
1656254880757,MATH 193A,A03,083781,Rotar; Vladimir,0,0,34,34
1656254880757,MATH 193A,A04,083782,Rotar; Vladimir,6,0,34,28
1656254880757,MATH 193A,A05,093482,Rotar; Vladimir,0,0,34,34
1656254886781,MATH 197,001,091859,McAuley; Julian John,9999,0,9999,0
1656254886781,MATH 197,002,095566,Kedlaya; Kiran S.,9997,0,9999,2
1656254886781,MATH 197,003,095567,Xiao; Ming,9999,0,9999,0
1656254886781,MATH 197,004,095571,Perols; Johan Lars,9998,0,9999,1
1656254893875,COGS 9,A01,083615,Shannon; Kyle Michael,3,0,75,72
1656254899915,COGS 11,A01,083617,Boyle; Mary E. T.,14,0,48,34
1656254905940,COGS 13,A01,083071,Bastos; Amalia Pinkusfeld,5,0,71,66
1656254911967,COGS 14A,A01,092681,Semenuks; Arturs,1,12,100,99
1656254917996,COGS 14B,A01,083073,Cheng; Tzu-Han,7,0,63,56
1656254924020,COGS 17,A01,092677,Semenuks; Arturs,8,0,81,73
1656254930044,COGS 100,A01,083619,Allen; Michael Gordon,2,0,70,68
1656254936071,COGS 101A,A01,083621,Davis; Joshua Daniel,4,0,68,64
1656254942104,COGS 101B,A01,091572,Allen; Michael Gordon,4,0,65,61
1656254948134,COGS 101C,A01,083625,Delgado; Tania,10,0,35,25
1656254954162,COGS 107A,A01,083627,Boyle; Mary E. T.,0,0,60,60
1656254960188,COGS 118A,A01,083075,Gupta; Anjum,8,0,76,68
1656254966212,CSE 3,A50,083646,Miranda; Gregory Joseph,18,0,50,32
1656254972235,CSE 8A,A50,083650,Miranda; Gregory Joseph,2,2,56,54
1656254978266,CSE 11,A01,083080,Cao; Yingjun,0,49,40,40
1656254984297,CSE 12,A01,083652,Krause-Levy; Sophia Louisa,5,1,120,115
1656254990321,CSE 15L,A01,083654,Morris; Justin Loren,2,0,50,48
1656254990321,CSE 15L,A02,083655,Morris; Justin Loren,4,0,50,46
1656254996352,CSE 20,A01,083657,Tran; Khoa Dang,30,0,80,50
1656255002380,CSE 21,A01,095574,Bach; Quang Tran,23,0,48,25
1656255008414,CSE 30,A01,083084,Eldon; John,2,6,80,78
1656255008414,CSE 30,B01,095061,Bhaskar; Nishant,0,1,50,50
1656255014442,CSE 100,A01,083659,Cao; Yingjun,1,18,70,69
1656255020472,CSE 134B,A01,083661,Powell; Thomas Allan,5,0,100,95
1656255026507,CSE 140,A01,083663,Gungor; Onat,9,0,85,76
1656255032558,CSE 140L,A01,083088,Eldon; John,8,0,100,92
1656255038603,CSE 175,A01,083665,Kumar; Rakesh,0,0,25,25
1656255044633,CSE 190,A00,092507,Dubnov; Shlomo,3,0,20,17
1656255050661,ECE 45,A01,083139,Congero; Spencer William,1,0,75,74
1656255056698,ECE 65,A50,083695,Saad; Andrew S,9,0,30,21
1656255056698,ECE 65,A51,095125,Staff,24,0,26,2
1656255062730,ECE 109,A01,091882,Touri; Behrouz,0,1,70,70
1656255068771,ECE 180,A00,083140,Abi Samra; Nicholas Camill,1,0,30,29
1656255068771,ECE 180,B00,083141,Abi Samra; Nicholas Camill,0,4,30,30
1656255074801,MATH 10A,A01,083735,Patchell; Gregory David,0,0,30,30
1656255074801,MATH 10A,A02,083736,Patchell; Gregory David,22,0,30,8
1656255074801,MATH 10A,A03,083737,Patchell; Gregory David,16,0,30,14
1656255080858,MATH 10B,A01,083207,Lim; Seonhee,0,0,34,34
1656255080858,MATH 10B,A02,083208,Lim; Seonhee,7,0,35,28
1656255080858,MATH 10B,A03,093472,Staff,1,0,34,33
1656255080858,MATH 10B,B01,083739,Sinha; Shubham,11,0,30,19
1656255086902,MATH 18,A01,083743,Cinel; Cameron Alexander,7,0,30,23
1656255086902,MATH 18,A02,083744,Cinel; Cameron Alexander,9,0,30,21
1656255086902,MATH 18,A03,083745,Cinel; Cameron Alexander,5,0,30,25
1656255086902,MATH 18,B01,083748,Rideout; David Porter,1,0,36,35
1656255086902,MATH 18,B02,083749,Rideout; David Porter,0,0,36,36
1656255086902,MATH 18,B03,083750,Rideout; David Porter,0,0,36,36
1656255086902,MATH 18,B04,083751,Rideout; David Porter,0,1,36,36
1656255086902,MATH 18,B05,093473,Rideout; David Porter,0,0,36,36
1656255086902,MATH 18,B06,093474,Rideout; David Porter,3,0,36,33
1656255092945,MATH 20A,A01,083754,Zheng; Zequn,11,0,40,29
1656255098988,MATH 20B,A01,083756,Briones; Jor-el Thomas Caparas,0,0,36,36
1656255098988,MATH 20B,A02,083757,Briones; Jor-el Thomas Caparas,0,0,36,36
1656255098988,MATH 20B,A03,093475,Staff,0,0,36,36
1656255105019,MATH 20C,A01,083760,Briones; Jor-el Thomas Caparas,0,0,35,35
1656255105019,MATH 20C,A02,083761,Briones; Jor-el Thomas Caparas,9,1,35,26
1656255105019,MATH 20C,A03,093476,Staff,0,0,35,35
1656255105019,MATH 20C,B01,083762,Bach; Quang Tran,1,0,30,29
1656255111056,MATH 20D,A01,083765,Tran; Brian Kha,1,0,30,29
1656255111056,MATH 20D,A02,083766,Tran; Brian Kha,0,1,30,30
1656255111056,MATH 20D,A03,083767,Tran; Brian Kha,2,0,30,28
1656255117080,MATH 20E,A01,083771,Ganguly; Soumya,3,0,32,29
1656255117080,MATH 20E,A02,083772,Ganguly; Soumya,0,0,32,32
1656255117080,MATH 20E,B01,083773,Ciotti; Benjamin,16,0,35,19
1656255117080,MATH 20E,B02,083774,Ciotti; Benjamin,15,0,35,20
1656255123117,MATH 103A,A01,083777,Greenfeld; Be'Eri,1,0,36,35
1656255123117,MATH 103A,A02,083778,Greenfeld; Be'Eri,1,0,36,35
1656255123117,MATH 103A,A03,093561,Staff,5,0,36,31
1656255123117,MATH 103A,B01,083779,Greenfeld; Be'Eri,8,0,36,28
1656255123117,MATH 103A,B02,083780,Greenfeld; Be'Eri,1,0,36,35
1656255123117,MATH 103A,B03,093562,Staff,0,0,36,36
1656255129146,MATH 105,A01,085443,Carter; Anne Toulson,5,0,35,30
1656255129146,MATH 105,A02,093477,Staff,14,0,35,21
1656255135186,MATH 109,A01,083213,Ganzberger; Geoffrey Michael,0,0,34,34
1656255135186,MATH 109,A02,083214,Ganzberger; Geoffrey Michael,0,0,34,34
1656255135186,MATH 109,A03,093478,Staff,1,0,34,33
1656255135186,MATH 109,B01,083215,Ganzberger; Geoffrey Michael,4,0,32,28
1656255135186,MATH 109,B02,083216,Ganzberger; Geoffrey Michael,1,0,32,31
1656255135186,MATH 109,B03,093479,Staff,3,0,32,29
1656255141235,MATH 142A,A01,083219,Chow; Bennett,2,0,32,30
1656255141235,MATH 142A,A02,083220,Chow; Bennett,8,0,32,24
1656255141235,MATH 142A,A03,093480,Staff,5,0,32,27
1656255141235,MATH 142A,B03,093481,Staff,3,0,32,29
1656255141235,MATH 142A,B04,093558,Staff,6,0,32,26
1656255141235,MATH 142A,B05,093559,Staff,0,0,32,32
1656255147269,MATH 193A,A01,083224,Rotar; Vladimir,0,1,34,34
1656255147269,MATH 193A,A02,083225,Rotar; Vladimir,0,0,34,34
1656255147269,MATH 193A,A03,083781,Rotar; Vladimir,0,0,34,34
1656255147269,MATH 193A,A04,083782,Rotar; Vladimir,6,0,34,28
1656255147269,MATH 193A,A05,093482,Rotar; Vladimir,0,0,34,34
1656255153311,MATH 197,001,091859,McAuley; Julian John,9999,0,9999,0
1656255153311,MATH 197,002,095566,Kedlaya; Kiran S.,9997,0,9999,2
1656255153311,MATH 197,003,095567,Xiao; Ming,9999,0,9999,0
1656255153311,MATH 197,004,095571,Perols; Johan Lars,9998,0,9999,1
1656255160399,COGS 9,A01,083615,Shannon; Kyle Michael,3,0,75,72
1656255166424,COGS 11,A01,083617,Boyle; Mary E. T.,14,0,48,34
1656255172451,COGS 13,A01,083071,Bastos; Amalia Pinkusfeld,5,0,71,66
1656255178474,COGS 14A,A01,092681,Semenuks; Arturs,1,12,100,99
1656255184506,COGS 14B,A01,083073,Cheng; Tzu-Han,7,0,63,56
1656255190536,COGS 17,A01,092677,Semenuks; Arturs,8,0,81,73
1656255196575,COGS 100,A01,083619,Allen; Michael Gordon,2,0,70,68
1656255202622,COGS 101A,A01,083621,Davis; Joshua Daniel,4,0,68,64
1656255208653,COGS 101B,A01,091572,Allen; Michael Gordon,4,0,65,61
1656255214693,COGS 101C,A01,083625,Delgado; Tania,10,0,35,25
1656255220743,COGS 107A,A01,083627,Boyle; Mary E. T.,0,0,60,60
1656255226774,COGS 118A,A01,083075,Gupta; Anjum,8,0,76,68
1656255232808,CSE 3,A50,083646,Miranda; Gregory Joseph,18,0,50,32
1656255238911,CSE 8A,A50,083650,Miranda; Gregory Joseph,2,2,56,54
1656255244954,CSE 11,A01,083080,Cao; Yingjun,0,49,40,40
1656255250979,CSE 12,A01,083652,Krause-Levy; Sophia Louisa,5,1,120,115
1656255257020,CSE 15L,A01,083654,Morris; Justin Loren,2,0,50,48
1656255257020,CSE 15L,A02,083655,Morris; Justin Loren,4,0,50,46
1656255263055,CSE 20,A01,083657,Tran; Khoa Dang,30,0,80,50
1656255269080,CSE 21,A01,095574,Bach; Quang Tran,23,0,48,25
1656255275114,CSE 30,A01,083084,Eldon; John,2,6,80,78
1656255275114,CSE 30,B01,095061,Bhaskar; Nishant,0,1,50,50
1656255281157,CSE 100,A01,083659,Cao; Yingjun,1,18,70,69
1656255287182,CSE 134B,A01,083661,Powell; Thomas Allan,5,0,100,95
1656255293231,CSE 140,A01,083663,Gungor; Onat,9,0,85,76
1656255299267,CSE 140L,A01,083088,Eldon; John,8,0,100,92
1656255305305,CSE 175,A01,083665,Kumar; Rakesh,0,0,25,25
1656255311355,CSE 190,A00,092507,Dubnov; Shlomo,3,0,20,17
1656255317392,ECE 45,A01,083139,Congero; Spencer William,1,0,75,74
1656255323430,ECE 65,A50,083695,Saad; Andrew S,9,0,30,21
1656255323430,ECE 65,A51,095125,Staff,24,0,26,2
1656255329452,ECE 109,A01,091882,Touri; Behrouz,0,1,70,70
1656255335477,ECE 180,A00,083140,Abi Samra; Nicholas Camill,1,0,30,29
1656255335477,ECE 180,B00,083141,Abi Samra; Nicholas Camill,0,4,30,30
1656255341516,MATH 10A,A01,083735,Patchell; Gregory David,0,0,30,30
1656255341516,MATH 10A,A02,083736,Patchell; Gregory David,22,0,30,8
1656255341516,MATH 10A,A03,083737,Patchell; Gregory David,16,0,30,14
1656255347545,MATH 10B,A01,083207,Lim; Seonhee,0,0,34,34
1656255347545,MATH 10B,A02,083208,Lim; Seonhee,7,0,35,28
1656255347545,MATH 10B,A03,093472,Staff,1,0,34,33
1656255347545,MATH 10B,B01,083739,Sinha; Shubham,11,0,30,19
1656255353577,MATH 18,A01,083743,Cinel; Cameron Alexander,7,0,30,23
1656255353577,MATH 18,A02,083744,Cinel; Cameron Alexander,9,0,30,21
1656255353577,MATH 18,A03,083745,Cinel; Cameron Alexander,5,0,30,25
1656255353577,MATH 18,B01,083748,Rideout; David Porter,1,0,36,35
1656255353577,MATH 18,B02,083749,Rideout; David Porter,0,0,36,36
1656255353577,MATH 18,B03,083750,Rideout; David Porter,0,0,36,36
1656255353577,MATH 18,B04,083751,Rideout; David Porter,0,1,36,36
1656255353577,MATH 18,B05,093473,Rideout; David Porter,0,0,36,36
1656255353577,MATH 18,B06,093474,Rideout; David Porter,3,0,36,33
1656255359633,MATH 20A,A01,083754,Zheng; Zequn,11,0,40,29
1656255365661,MATH 20B,A01,083756,Briones; Jor-el Thomas Caparas,0,0,36,36
1656255365661,MATH 20B,A02,083757,Briones; Jor-el Thomas Caparas,0,0,36,36
1656255365661,MATH 20B,A03,093475,Staff,0,0,36,36
1656255371689,MATH 20C,A01,083760,Briones; Jor-el Thomas Caparas,0,0,35,35
1656255371689,MATH 20C,A02,083761,Briones; Jor-el Thomas Caparas,9,1,35,26
1656255371689,MATH 20C,A03,093476,Staff,0,0,35,35
1656255371689,MATH 20C,B01,083762,Bach; Quang Tran,1,0,30,29
1656255377723,MATH 20D,A01,083765,Tran; Brian Kha,1,0,30,29
1656255377723,MATH 20D,A02,083766,Tran; Brian Kha,0,1,30,30
1656255377723,MATH 20D,A03,083767,Tran; Brian Kha,2,0,30,28
1656255383752,MATH 20E,A01,083771,Ganguly; Soumya,3,0,32,29
1656255383752,MATH 20E,A02,083772,Ganguly; Soumya,0,0,32,32
1656255383752,MATH 20E,B01,083773,Ciotti; Benjamin,16,0,35,19
1656255383752,MATH 20E,B02,083774,Ciotti; Benjamin,15,0,35,20
1656255389783,MATH 103A,A01,083777,Greenfeld; Be'Eri,1,0,36,35
1656255389783,MATH 103A,A02,083778,Greenfeld; Be'Eri,1,0,36,35
1656255389783,MATH 103A,A03,093561,Staff,5,0,36,31
1656255389783,MATH 103A,B01,083779,Greenfeld; Be'Eri,8,0,36,28
1656255389783,MATH 103A,B02,083780,Greenfeld; Be'Eri,1,0,36,35
1656255389783,MATH 103A,B03,093562,Staff,0,0,36,36
1656255395817,MATH 105,A01,085443,Carter; Anne Toulson,5,0,35,30
1656255395817,MATH 105,A02,093477,Staff,14,0,35,21
1656255401861,MATH 109,A01,083213,Ganzberger; Geoffrey Michael,0,0,34,34
1656255401861,MATH 109,A02,083214,Ganzberger; Geoffrey Michael,0,0,34,34
1656255401861,MATH 109,A03,093478,Staff,1,0,34,33
1656255401861,MATH 109,B01,083215,Ganzberger; Geoffrey Michael,4,0,32,28
1656255401861,MATH 109,B02,083216,Ganzberger; Geoffrey Michael,1,0,32,31
1656255401861,MATH 109,B03,093479,Staff,3,0,32,29
1656255407900,MATH 142A,A01,083219,Chow; Bennett,2,0,32,30
1656255407900,MATH 142A,A02,083220,Chow; Bennett,8,0,32,24
1656255407900,MATH 142A,A03,093480,Staff,5,0,32,27
1656255407900,MATH 142A,B03,093481,Staff,3,0,32,29
1656255407900,MATH 142A,B04,093558,Staff,6,0,32,26
1656255407900,MATH 142A,B05,093559,Staff,0,0,32,32
1656255413928,MATH 193A,A01,083224,Rotar; Vladimir,0,1,34,34
1656255413928,MATH 193A,A02,083225,Rotar; Vladimir,0,0,34,34
1656255413928,MATH 193A,A03,083781,Rotar; Vladimir,0,0,34,34
1656255413928,MATH 193A,A04,083782,Rotar; Vladimir,6,0,34,28
1656255413928,MATH 193A,A05,093482,Rotar; Vladimir,0,0,34,34
1656255419955,MATH 197,001,091859,McAuley; Julian John,9999,0,9999,0
1656255419955,MATH 197,002,095566,Kedlaya; Kiran S.,9997,0,9999,2
1656255419955,MATH 197,003,095567,Xiao; Ming,9999,0,9999,0
1656255419955,MATH 197,004,095571,Perols; Johan Lars,9998,0,9999,1
1656255427027,COGS 9,A01,083615,Shannon; Kyle Michael,3,0,75,72
1656255433064,COGS 11,A01,083617,Boyle; Mary E. T.,14,0,48,34
1656255439099,COGS 13,A01,083071,Bastos; Amalia Pinkusfeld,5,0,71,66
1656255445123,COGS 14A,A01,092681,Semenuks; Arturs,1,12,100,99
1656255451168,COGS 14B,A01,083073,Cheng; Tzu-Han,7,0,63,56
1656255457203,COGS 17,A01,092677,Semenuks; Arturs,8,0,81,73
1656255463236,COGS 100,A01,083619,Allen; Michael Gordon,2,0,70,68
1656255469268,COGS 101A,A01,083621,Davis; Joshua Daniel,4,0,68,64
1656255475296,COGS 101B,A01,091572,Allen; Michael Gordon,4,0,65,61
1656255481319,COGS 101C,A01,083625,Delgado; Tania,10,0,35,25
1656255487342,COGS 107A,A01,083627,Boyle; Mary E. T.,0,0,60,60
1656255493365,COGS 118A,A01,083075,Gupta; Anjum,8,0,76,68
1656255499395,CSE 3,A50,083646,Miranda; Gregory Joseph,18,0,50,32
1656255505422,CSE 8A,A50,083650,Miranda; Gregory Joseph,2,2,56,54
1656255511459,CSE 11,A01,083080,Cao; Yingjun,0,49,40,40
1656255517481,CSE 12,A01,083652,Krause-Levy; Sophia Louisa,5,1,120,115
1656255523504,CSE 15L,A01,083654,Morris; Justin Loren,2,0,50,48
1656255523504,CSE 15L,A02,083655,Morris; Justin Loren,4,0,50,46
1656255529550,CSE 20,A01,083657,Tran; Khoa Dang,30,0,80,50
1656255535582,CSE 21,A01,095574,Bach; Quang Tran,23,0,48,25
1656255541628,CSE 30,A01,083084,Eldon; John,2,6,80,78
1656255541628,CSE 30,B01,095061,Bhaskar; Nishant,0,1,50,50
1656255547653,CSE 100,A01,083659,Cao; Yingjun,1,18,70,69
1656255553681,CSE 134B,A01,083661,Powell; Thomas Allan,5,0,100,95
1656255559707,CSE 140,A01,083663,Gungor; Onat,9,0,85,76
1656255565734,CSE 140L,A01,083088,Eldon; John,8,0,100,92
1656255571761,CSE 175,A01,083665,Kumar; Rakesh,0,0,25,25
1656255577796,CSE 190,A00,092507,Dubnov; Shlomo,3,0,20,17
1656255583822,ECE 45,A01,083139,Congero; Spencer William,1,0,75,74
1656255589856,ECE 65,A50,083695,Saad; Andrew S,9,0,30,21
1656255589856,ECE 65,A51,095125,Staff,24,0,26,2
1656255595892,ECE 109,A01,091882,Touri; Behrouz,0,1,70,70
1656255601920,ECE 180,A00,083140,Abi Samra; Nicholas Camill,1,0,30,29
1656255601920,ECE 180,B00,083141,Abi Samra; Nicholas Camill,0,4,30,30
1656255607948,MATH 10A,A01,083735,Patchell; Gregory David,0,0,30,30
1656255607948,MATH 10A,A02,083736,Patchell; Gregory David,22,0,30,8
1656255607948,MATH 10A,A03,083737,Patchell; Gregory David,16,0,30,14
1656255613973,MATH 10B,A01,083207,Lim; Seonhee,0,0,34,34
1656255613973,MATH 10B,A02,083208,Lim; Seonhee,7,0,35,28
1656255613973,MATH 10B,A03,093472,Staff,1,0,34,33
1656255613973,MATH 10B,B01,083739,Sinha; Shubham,11,0,30,19
1656255619998,MATH 18,A01,083743,Cinel; Cameron Alexander,7,0,30,23
1656255619998,MATH 18,A02,083744,Cinel; Cameron Alexander,9,0,30,21
1656255619998,MATH 18,A03,083745,Cinel; Cameron Alexander,5,0,30,25
1656255619998,MATH 18,B01,083748,Rideout; David Porter,1,0,36,35
1656255619998,MATH 18,B02,083749,Rideout; David Porter,0,0,36,36
1656255619998,MATH 18,B03,083750,Rideout; David Porter,0,0,36,36
1656255619998,MATH 18,B04,083751,Rideout; David Porter,0,1,36,36
1656255619998,MATH 18,B05,093473,Rideout; David Porter,0,0,36,36
1656255619998,MATH 18,B06,093474,Rideout; David Porter,3,0,36,33
1656255626036,MATH 20A,A01,083754,Zheng; Zequn,11,0,40,29
1656255632064,MATH 20B,A01,083756,Briones; Jor-el Thomas Caparas,0,0,36,36
1656255632064,MATH 20B,A02,083757,Briones; Jor-el Thomas Caparas,0,0,36,36
1656255632064,MATH 20B,A03,093475,Staff,0,0,36,36
1656255638087,MATH 20C,A01,083760,Briones; Jor-el Thomas Caparas,0,0,35,35
1656255638087,MATH 20C,A02,083761,Briones; Jor-el Thomas Caparas,9,1,35,26
1656255638087,MATH 20C,A03,093476,Staff,0,0,35,35
1656255638087,MATH 20C,B01,083762,Bach; Quang Tran,1,0,30,29
1656255644123,MATH 20D,A01,083765,Tran; Brian Kha,1,0,30,29
1656255644123,MATH 20D,A02,083766,Tran; Brian Kha,0,1,30,30
1656255644123,MATH 20D,A03,083767,Tran; Brian Kha,2,0,30,28
1656255650147,MATH 20E,A01,083771,Ganguly; Soumya,3,0,32,29
1656255650147,MATH 20E,A02,083772,Ganguly; Soumya,0,0,32,32
1656255650147,MATH 20E,B01,083773,Ciotti; Benjamin,16,0,35,19
1656255650147,MATH 20E,B02,083774,Ciotti; Benjamin,15,0,35,20
1656255656181,MATH 103A,A01,083777,Greenfeld; Be'Eri,1,0,36,35
1656255656181,MATH 103A,A02,083778,Greenfeld; Be'Eri,1,0,36,35
1656255656181,MATH 103A,A03,093561,Staff,5,0,36,31
1656255656181,MATH 103A,B01,083779,Greenfeld; Be'Eri,8,0,36,28
1656255656181,MATH 103A,B02,083780,Greenfeld; Be'Eri,1,0,36,35
1656255656181,MATH 103A,B03,093562,Staff,0,0,36,36
1656255662218,MATH 105,A01,085443,Carter; Anne Toulson,5,0,35,30
1656255662218,MATH 105,A02,093477,Staff,14,0,35,21
1656255668258,MATH 109,A01,083213,Ganzberger; Geoffrey Michael,0,0,34,34
1656255668258,MATH 109,A02,083214,Ganzberger; Geoffrey Michael,0,0,34,34
1656255668258,MATH 109,A03,093478,Staff,1,0,34,33
1656255668258,MATH 109,B01,083215,Ganzberger; Geoffrey Michael,4,0,32,28
1656255668258,MATH 109,B02,083216,Ganzberger; Geoffrey Michael,1,0,32,31
1656255668258,MATH 109,B03,093479,Staff,3,0,32,29
1656255674286,MATH 142A,A01,083219,Chow; Bennett,2,0,32,30
1656255674286,MATH 142A,A02,083220,Chow; Bennett,8,0,32,24
1656255674286,MATH 142A,A03,093480,Staff,5,0,32,27
1656255674286,MATH 142A,B03,093481,Staff,3,0,32,29
1656255674286,MATH 142A,B04,093558,Staff,6,0,32,26
1656255674286,MATH 142A,B05,093559,Staff,0,0,32,32
1656255680310,MATH 193A,A01,083224,Rotar; Vladimir,0,1,34,34
1656255680310,MATH 193A,A02,083225,Rotar; Vladimir,0,0,34,34
1656255680310,MATH 193A,A03,083781,Rotar; Vladimir,0,0,34,34
1656255680310,MATH 193A,A04,083782,Rotar; Vladimir,6,0,34,28
1656255680310,MATH 193A,A05,093482,Rotar; Vladimir,0,0,34,34
1656255686335,MATH 197,001,091859,McAuley; Julian John,9999,0,9999,0
1656255686335,MATH 197,002,095566,Kedlaya; Kiran S.,9997,0,9999,2
1656255686335,MATH 197,003,095567,Xiao; Ming,9999,0,9999,0
1656255686335,MATH 197,004,095571,Perols; Johan Lars,9998,0,9999,1
1656255693406,COGS 9,A01,083615,Shannon; Kyle Michael,3,0,75,72
1656255699439,COGS 11,A01,083617,Boyle; Mary E. T.,14,0,48,34
1656255705489,COGS 13,A01,083071,Bastos; Amalia Pinkusfeld,5,0,71,66
1656255711528,COGS 14A,A01,092681,Semenuks; Arturs,1,12,100,99
1656255717551,COGS 14B,A01,083073,Cheng; Tzu-Han,7,0,63,56
1656255723589,COGS 17,A01,092677,Semenuks; Arturs,8,0,81,73
1656255729627,COGS 100,A01,083619,Allen; Michael Gordon,2,0,70,68
1656255735652,COGS 101A,A01,083621,Davis; Joshua Daniel,4,0,68,64
1656255741674,COGS 101B,A01,091572,Allen; Michael Gordon,4,0,65,61
1656255747709,COGS 101C,A01,083625,Delgado; Tania,10,0,35,25
1656255753736,COGS 107A,A01,083627,Boyle; Mary E. T.,0,0,60,60
1656255759772,COGS 118A,A01,083075,Gupta; Anjum,8,0,76,68
1656255765796,CSE 3,A50,083646,Miranda; Gregory Joseph,18,0,50,32
1656255771825,CSE 8A,A50,083650,Miranda; Gregory Joseph,2,2,56,54
1656255777858,CSE 11,A01,083080,Cao; Yingjun,0,49,40,40
1656255783882,CSE 12,A01,083652,Krause-Levy; Sophia Louisa,5,1,120,115
1656255789918,CSE 15L,A01,083654,Morris; Justin Loren,2,0,50,48
1656255789918,CSE 15L,A02,083655,Morris; Justin Loren,4,0,50,46
1656255795957,CSE 20,A01,083657,Tran; Khoa Dang,30,0,80,50
1656255801981,CSE 21,A01,095574,Bach; Quang Tran,23,0,48,25
1656255808010,CSE 30,A01,083084,Eldon; John,2,6,80,78
1656255808010,CSE 30,B01,095061,Bhaskar; Nishant,0,1,50,50
1656255814034,CSE 100,A01,083659,Cao; Yingjun,1,18,70,69
1656255820057,CSE 134B,A01,083661,Powell; Thomas Allan,5,0,100,95
1656255826100,CSE 140,A01,083663,Gungor; Onat,9,0,85,76
1656255832137,CSE 140L,A01,083088,Eldon; John,8,0,100,92
1656255838291,CSE 175,A01,083665,Kumar; Rakesh,0,0,25,25
1656255844333,CSE 190,A00,092507,Dubnov; Shlomo,3,0,20,17
1656255850357,ECE 45,A01,083139,Congero; Spencer William,1,0,75,74
1656255856380,ECE 65,A50,083695,Saad; Andrew S,9,0,30,21
1656255856380,ECE 65,A51,095125,Staff,24,0,26,2
1656255862413,ECE 109,A01,091882,Touri; Behrouz,0,1,70,70
1656255868440,ECE 180,A00,083140,Abi Samra; Nicholas Camill,1,0,30,29
1656255868440,ECE 180,B00,083141,Abi Samra; Nicholas Camill,0,4,30,30
1656255874468,MATH 10A,A01,083735,Patchell; Gregory David,0,0,30,30
1656255874468,MATH 10A,A02,083736,Patchell; Gregory David,22,0,30,8
1656255874468,MATH 10A,A03,083737,Patchell; Gregory David,16,0,30,14
1656255880502,MATH 10B,A01,083207,Lim; Seonhee,0,0,34,34
1656255880502,MATH 10B,A02,083208,Lim; Seonhee,7,0,35,28
1656255880502,MATH 10B,A03,093472,Staff,1,0,34,33
1656255880502,MATH 10B,B01,083739,Sinha; Shubham,11,0,30,19
1656255886546,MATH 18,A01,083743,Cinel; Cameron Alexander,7,0,30,23
1656255886546,MATH 18,A02,083744,Cinel; Cameron Alexander,9,0,30,21
1656255886546,MATH 18,A03,083745,Cinel; Cameron Alexander,5,0,30,25
1656255886546,MATH 18,B01,083748,Rideout; David Porter,1,0,36,35
1656255886546,MATH 18,B02,083749,Rideout; David Porter,0,0,36,36
1656255886546,MATH 18,B03,083750,Rideout; David Porter,0,0,36,36
1656255886546,MATH 18,B04,083751,Rideout; David Porter,0,1,36,36
1656255886546,MATH 18,B05,093473,Rideout; David Porter,0,0,36,36
1656255886546,MATH 18,B06,093474,Rideout; David Porter,3,0,36,33
1656255892589,MATH 20A,A01,083754,Zheng; Zequn,11,0,40,29
1656255898612,MATH 20B,A01,083756,Briones; Jor-el Thomas Caparas,0,0,36,36
1656255898612,MATH 20B,A02,083757,Briones; Jor-el Thomas Caparas,0,0,36,36
1656255898612,MATH 20B,A03,093475,Staff,0,0,36,36
1656255904636,MATH 20C,A01,083760,Briones; Jor-el Thomas Caparas,0,0,35,35
1656255904636,MATH 20C,A02,083761,Briones; Jor-el Thomas Caparas,9,1,35,26
1656255904636,MATH 20C,A03,093476,Staff,0,0,35,35
1656255904636,MATH 20C,B01,083762,Bach; Quang Tran,1,0,30,29
1656255910692,MATH 20D,A01,083765,Tran; Brian Kha,1,0,30,29
1656255910692,MATH 20D,A02,083766,Tran; Brian Kha,0,1,30,30
1656255910692,MATH 20D,A03,083767,Tran; Brian Kha,2,0,30,28
1656255916731,MATH 20E,A01,083771,Ganguly; Soumya,3,0,32,29
1656255916731,MATH 20E,A02,083772,Ganguly; Soumya,0,0,32,32
1656255916731,MATH 20E,B01,083773,Ciotti; Benjamin,16,0,35,19
1656255916731,MATH 20E,B02,083774,Ciotti; Benjamin,15,0,35,20
1656255922757,MATH 103A,A01,083777,Greenfeld; Be'Eri,1,0,36,35
1656255922757,MATH 103A,A02,083778,Greenfeld; Be'Eri,1,0,36,35
1656255922757,MATH 103A,A03,093561,Staff,5,0,36,31
1656255922757,MATH 103A,B01,083779,Greenfeld; Be'Eri,8,0,36,28
1656255922757,MATH 103A,B02,083780,Greenfeld; Be'Eri,1,0,36,35
1656255922757,MATH 103A,B03,093562,Staff,0,0,36,36
1656255928789,MATH 105,A01,085443,Carter; Anne Toulson,5,0,35,30
1656255928789,MATH 105,A02,093477,Staff,14,0,35,21
1656255934829,MATH 109,A01,083213,Ganzberger; Geoffrey Michael,0,0,34,34
1656255934829,MATH 109,A02,083214,Ganzberger; Geoffrey Michael,0,0,34,34
1656255934829,MATH 109,A03,093478,Staff,1,0,34,33
1656255934829,MATH 109,B01,083215,Ganzberger; Geoffrey Michael,4,0,32,28
1656255934829,MATH 109,B02,083216,Ganzberger; Geoffrey Michael,1,0,32,31
1656255934829,MATH 109,B03,093479,Staff,3,0,32,29
1656255940867,MATH 142A,A01,083219,Chow; Bennett,2,0,32,30
1656255940867,MATH 142A,A02,083220,Chow; Bennett,8,0,32,24
1656255940867,MATH 142A,A03,093480,Staff,5,0,32,27
1656255940867,MATH 142A,B03,093481,Staff,3,0,32,29
1656255940867,MATH 142A,B04,093558,Staff,6,0,32,26
1656255940867,MATH 142A,B05,093559,Staff,0,0,32,32
1656255946910,MATH 193A,A01,083224,Rotar; Vladimir,0,1,34,34
1656255946910,MATH 193A,A02,083225,Rotar; Vladimir,0,0,34,34
1656255946910,MATH 193A,A03,083781,Rotar; Vladimir,0,0,34,34
1656255946910,MATH 193A,A04,083782,Rotar; Vladimir,6,0,34,28
1656255946910,MATH 193A,A05,093482,Rotar; Vladimir,0,0,34,34
1656255952943,MATH 197,001,091859,McAuley; Julian John,9999,0,9999,0
1656255952943,MATH 197,002,095566,Kedlaya; Kiran S.,9997,0,9999,2
1656255952943,MATH 197,003,095567,Xiao; Ming,9999,0,9999,0
1656255952943,MATH 197,004,095571,Perols; Johan Lars,9998,0,9999,1
1656255960011,COGS 9,A01,083615,Shannon; Kyle Michael,3,0,75,72
1656255966038,COGS 11,A01,083617,Boyle; Mary E. T.,14,0,48,34
1656255972066,COGS 13,A01,083071,Bastos; Amalia Pinkusfeld,5,0,71,66
1656255978100,COGS 14A,A01,092681,Semenuks; Arturs,1,12,100,99
1656255984140,COGS 14B,A01,083073,Cheng; Tzu-Han,7,0,63,56
1656255990164,COGS 17,A01,092677,Semenuks; Arturs,8,0,81,73
1656255996188,COGS 100,A01,083619,Allen; Michael Gordon,2,0,70,68
1656256002212,COGS 101A,A01,083621,Davis; Joshua Daniel,4,0,68,64
1656256008261,COGS 101B,A01,091572,Allen; Michael Gordon,4,0,65,61
1656256014286,COGS 101C,A01,083625,Delgado; Tania,10,0,35,25
1656256020309,COGS 107A,A01,083627,Boyle; Mary E. T.,0,0,60,60
1656256026338,COGS 118A,A01,083075,Gupta; Anjum,8,0,76,68
1656256032366,CSE 3,A50,083646,Miranda; Gregory Joseph,18,0,50,32
1656256038389,CSE 8A,A50,083650,Miranda; Gregory Joseph,2,2,56,54
1656256044413,CSE 11,A01,083080,Cao; Yingjun,0,49,40,40
1656256050463,CSE 12,A01,083652,Krause-Levy; Sophia Louisa,5,1,120,115
1656256056493,CSE 15L,A01,083654,Morris; Justin Loren,2,0,50,48
1656256056493,CSE 15L,A02,083655,Morris; Justin Loren,4,0,50,46
1656256062516,CSE 20,A01,083657,Tran; Khoa Dang,30,0,80,50
1656256068544,CSE 21,A01,095574,Bach; Quang Tran,23,0,48,25
1656256074573,CSE 30,A01,083084,Eldon; John,2,6,80,78
1656256074573,CSE 30,B01,095061,Bhaskar; Nishant,0,1,50,50
1656256080599,CSE 100,A01,083659,Cao; Yingjun,1,18,70,69
1656256086623,CSE 134B,A01,083661,Powell; Thomas Allan,5,0,100,95
1656256092651,CSE 140,A01,083663,Gungor; Onat,9,0,85,76
1656256098704,CSE 140L,A01,083088,Eldon; John,8,0,100,92
1656256104730,CSE 175,A01,083665,Kumar; Rakesh,0,0,25,25
1656256110757,CSE 190,A00,092507,Dubnov; Shlomo,3,0,20,17
1656256116781,ECE 45,A01,083139,Congero; Spencer William,1,0,75,74
1656256122811,ECE 65,A50,083695,Saad; Andrew S,9,0,30,21
1656256122811,ECE 65,A51,095125,Staff,24,0,26,2
1656256128841,ECE 109,A01,091882,Touri; Behrouz,0,1,70,70
1656256134864,ECE 180,A00,083140,Abi Samra; Nicholas Camill,1,0,30,29
1656256134864,ECE 180,B00,083141,Abi Samra; Nicholas Camill,0,4,30,30
1656256140888,MATH 10A,A01,083735,Patchell; Gregory David,0,0,30,30
1656256140888,MATH 10A,A02,083736,Patchell; Gregory David,22,0,30,8
1656256140888,MATH 10A,A03,083737,Patchell; Gregory David,16,0,30,14
1656256146932,MATH 10B,A01,083207,Lim; Seonhee,0,0,34,34
1656256146932,MATH 10B,A02,083208,Lim; Seonhee,7,0,35,28
1656256146932,MATH 10B,A03,093472,Staff,1,0,34,33
1656256146932,MATH 10B,B01,083739,Sinha; Shubham,11,0,30,19
1656256152956,MATH 18,A01,083743,Cinel; Cameron Alexander,7,0,30,23
1656256152956,MATH 18,A02,083744,Cinel; Cameron Alexander,9,0,30,21
1656256152956,MATH 18,A03,083745,Cinel; Cameron Alexander,5,0,30,25
1656256152956,MATH 18,B01,083748,Rideout; David Porter,1,0,36,35
1656256152956,MATH 18,B02,083749,Rideout; David Porter,0,0,36,36
1656256152956,MATH 18,B03,083750,Rideout; David Porter,0,0,36,36
1656256152956,MATH 18,B04,083751,Rideout; David Porter,0,1,36,36
1656256152956,MATH 18,B05,093473,Rideout; David Porter,0,0,36,36
1656256152956,MATH 18,B06,093474,Rideout; David Porter,3,0,36,33
1656256158993,MATH 20A,A01,083754,Zheng; Zequn,11,0,40,29
1656256165023,MATH 20B,A01,083756,Briones; Jor-el Thomas Caparas,0,0,36,36
1656256165023,MATH 20B,A02,083757,Briones; Jor-el Thomas Caparas,0,0,36,36
1656256165023,MATH 20B,A03,093475,Staff,0,0,36,36
1656256171047,MATH 20C,A01,083760,Briones; Jor-el Thomas Caparas,0,0,35,35
1656256171047,MATH 20C,A02,083761,Briones; Jor-el Thomas Caparas,9,1,35,26
1656256171047,MATH 20C,A03,093476,Staff,0,0,35,35
1656256171047,MATH 20C,B01,083762,Bach; Quang Tran,1,0,30,29
1656256177093,MATH 20D,A01,083765,Tran; Brian Kha,1,0,30,29
1656256177093,MATH 20D,A02,083766,Tran; Brian Kha,0,1,30,30
1656256177093,MATH 20D,A03,083767,Tran; Brian Kha,2,0,30,28
1656256183122,MATH 20E,A01,083771,Ganguly; Soumya,3,0,32,29
1656256183122,MATH 20E,A02,083772,Ganguly; Soumya,0,0,32,32
1656256183122,MATH 20E,B01,083773,Ciotti; Benjamin,16,0,35,19
1656256183122,MATH 20E,B02,083774,Ciotti; Benjamin,15,0,35,20
1656256189160,MATH 103A,A01,083777,Greenfeld; Be'Eri,1,0,36,35
1656256189160,MATH 103A,A02,083778,Greenfeld; Be'Eri,1,0,36,35
1656256189160,MATH 103A,A03,093561,Staff,5,0,36,31
1656256189160,MATH 103A,B01,083779,Greenfeld; Be'Eri,8,0,36,28
1656256189160,MATH 103A,B02,083780,Greenfeld; Be'Eri,1,0,36,35
1656256189160,MATH 103A,B03,093562,Staff,0,0,36,36
1656256195206,MATH 105,A01,085443,Carter; Anne Toulson,5,0,35,30
1656256195206,MATH 105,A02,093477,Staff,14,0,35,21
1656256201238,MATH 109,A01,083213,Ganzberger; Geoffrey Michael,0,0,34,34
1656256201238,MATH 109,A02,083214,Ganzberger; Geoffrey Michael,0,0,34,34
1656256201238,MATH 109,A03,093478,Staff,1,0,34,33
1656256201238,MATH 109,B01,083215,Ganzberger; Geoffrey Michael,4,0,32,28
1656256201238,MATH 109,B02,083216,Ganzberger; Geoffrey Michael,1,0,32,31
1656256201238,MATH 109,B03,093479,Staff,3,0,32,29
1656256207263,MATH 142A,A01,083219,Chow; Bennett,2,0,32,30
1656256207263,MATH 142A,A02,083220,Chow; Bennett,8,0,32,24
1656256207263,MATH 142A,A03,093480,Staff,5,0,32,27
1656256207263,MATH 142A,B03,093481,Staff,3,0,32,29
1656256207263,MATH 142A,B04,093558,Staff,6,0,32,26
1656256207263,MATH 142A,B05,093559,Staff,0,0,32,32
1656256213291,MATH 193A,A01,083224,Rotar; Vladimir,0,1,34,34
1656256213291,MATH 193A,A02,083225,Rotar; Vladimir,0,0,34,34
1656256213291,MATH 193A,A03,083781,Rotar; Vladimir,0,0,34,34
1656256213291,MATH 193A,A04,083782,Rotar; Vladimir,6,0,34,28
1656256213291,MATH 193A,A05,093482,Rotar; Vladimir,0,0,34,34
1656256219314,MATH 197,001,091859,McAuley; Julian John,9999,0,9999,0
1656256219314,MATH 197,002,095566,Kedlaya; Kiran S.,9997,0,9999,2
1656256219314,MATH 197,003,095567,Xiao; Ming,9999,0,9999,0
1656256219314,MATH 197,004,095571,Perols; Johan Lars,9998,0,9999,1
1656256226407,COGS 9,A01,083615,Shannon; Kyle Michael,3,0,75,72
1656256232435,COGS 11,A01,083617,Boyle; Mary E. T.,14,0,48,34
1656256238475,COGS 13,A01,083071,Bastos; Amalia Pinkusfeld,5,0,71,66
1656256244499,COGS 14A,A01,092681,Semenuks; Arturs,1,12,100,99
1656256250531,COGS 14B,A01,083073,Cheng; Tzu-Han,7,0,63,56
1656256256556,COGS 17,A01,092677,Semenuks; Arturs,8,0,81,73
1656256262578,COGS 100,A01,083619,Allen; Michael Gordon,2,0,70,68
1656256268602,COGS 101A,A01,083621,Davis; Joshua Daniel,4,0,68,64
1656256274641,COGS 101B,A01,091572,Allen; Michael Gordon,4,0,65,61
1656256280671,COGS 101C,A01,083625,Delgado; Tania,10,0,35,25
1656256286698,COGS 107A,A01,083627,Boyle; Mary E. T.,0,0,60,60
1656256292725,COGS 118A,A01,083075,Gupta; Anjum,8,0,76,68
1656256298757,CSE 3,A50,083646,Miranda; Gregory Joseph,18,0,50,32
1656256304784,CSE 8A,A50,083650,Miranda; Gregory Joseph,2,2,56,54
1656256310808,CSE 11,A01,083080,Cao; Yingjun,0,49,40,40
1656256316833,CSE 12,A01,083652,Krause-Levy; Sophia Louisa,5,1,120,115
1656256322856,CSE 15L,A01,083654,Morris; Justin Loren,2,0,50,48
1656256322856,CSE 15L,A02,083655,Morris; Justin Loren,4,0,50,46
1656256328883,CSE 20,A01,083657,Tran; Khoa Dang,30,0,80,50
1656256334925,CSE 21,A01,095574,Bach; Quang Tran,23,0,48,25
1656256340980,CSE 30,A01,083084,Eldon; John,2,6,80,78
1656256340980,CSE 30,B01,095061,Bhaskar; Nishant,0,1,50,50
1656256347032,CSE 100,A01,083659,Cao; Yingjun,1,18,70,69
1656256353071,CSE 134B,A01,083661,Powell; Thomas Allan,5,0,100,95
1656256359096,CSE 140,A01,083663,Gungor; Onat,9,0,85,76
1656256365120,CSE 140L,A01,083088,Eldon; John,8,0,100,92
1656256371146,CSE 175,A01,083665,Kumar; Rakesh,0,0,25,25
1656256377178,CSE 190,A00,092507,Dubnov; Shlomo,3,0,20,17
1656256383200,ECE 45,A01,083139,Congero; Spencer William,1,0,75,74
1656256389228,ECE 65,A50,083695,Saad; Andrew S,9,0,30,21
1656256389228,ECE 65,A51,095125,Staff,24,0,26,2
1656256395256,ECE 109,A01,091882,Touri; Behrouz,0,1,70,70
1656256401284,ECE 180,A00,083140,Abi Samra; Nicholas Camill,1,0,30,29
1656256401284,ECE 180,B00,083141,Abi Samra; Nicholas Camill,0,4,30,30
1656256407324,MATH 10A,A01,083735,Patchell; Gregory David,0,0,30,30
1656256407324,MATH 10A,A02,083736,Patchell; Gregory David,22,0,30,8
1656256407324,MATH 10A,A03,083737,Patchell; Gregory David,16,0,30,14
1656256413357,MATH 10B,A01,083207,Lim; Seonhee,0,0,34,34
1656256413357,MATH 10B,A02,083208,Lim; Seonhee,7,0,35,28
1656256413357,MATH 10B,A03,093472,Staff,1,0,34,33
1656256413357,MATH 10B,B01,083739,Sinha; Shubham,11,0,30,19
1656256419390,MATH 18,A01,083743,Cinel; Cameron Alexander,7,0,30,23
1656256419390,MATH 18,A02,083744,Cinel; Cameron Alexander,9,0,30,21
1656256419390,MATH 18,A03,083745,Cinel; Cameron Alexander,5,0,30,25
1656256419390,MATH 18,B01,083748,Rideout; David Porter,1,0,36,35
1656256419390,MATH 18,B02,083749,Rideout; David Porter,0,0,36,36
1656256419390,MATH 18,B03,083750,Rideout; David Porter,0,0,36,36
1656256419390,MATH 18,B04,083751,Rideout; David Porter,0,1,36,36
1656256419390,MATH 18,B05,093473,Rideout; David Porter,0,0,36,36
1656256419390,MATH 18,B06,093474,Rideout; David Porter,3,0,36,33
1656256425427,MATH 20A,A01,083754,Zheng; Zequn,11,0,40,29
1656256431470,MATH 20B,A01,083756,Briones; Jor-el Thomas Caparas,0,0,36,36
1656256431470,MATH 20B,A02,083757,Briones; Jor-el Thomas Caparas,0,0,36,36
1656256431470,MATH 20B,A03,093475,Staff,0,0,36,36
1656256437608,MATH 20C,A01,083760,Briones; Jor-el Thomas Caparas,0,0,35,35
1656256437608,MATH 20C,A02,083761,Briones; Jor-el Thomas Caparas,9,1,35,26
1656256437608,MATH 20C,A03,093476,Staff,0,0,35,35
1656256437608,MATH 20C,B01,083762,Bach; Quang Tran,1,0,30,29
1656256443646,MATH 20D,A01,083765,Tran; Brian Kha,1,0,30,29
1656256443646,MATH 20D,A02,083766,Tran; Brian Kha,0,1,30,30
1656256443646,MATH 20D,A03,083767,Tran; Brian Kha,2,0,30,28
1656256449684,MATH 20E,A01,083771,Ganguly; Soumya,3,0,32,29
1656256449684,MATH 20E,A02,083772,Ganguly; Soumya,0,0,32,32
1656256449684,MATH 20E,B01,083773,Ciotti; Benjamin,16,0,35,19
1656256449684,MATH 20E,B02,083774,Ciotti; Benjamin,15,0,35,20
1656256455724,MATH 103A,A01,083777,Greenfeld; Be'Eri,1,0,36,35
1656256455724,MATH 103A,A02,083778,Greenfeld; Be'Eri,1,0,36,35
1656256455724,MATH 103A,A03,093561,Staff,5,0,36,31
1656256455724,MATH 103A,B01,083779,Greenfeld; Be'Eri,8,0,36,28
1656256455724,MATH 103A,B02,083780,Greenfeld; Be'Eri,1,0,36,35
1656256455724,MATH 103A,B03,093562,Staff,0,0,36,36
1656256461756,MATH 105,A01,085443,Carter; Anne Toulson,5,0,35,30
1656256461756,MATH 105,A02,093477,Staff,14,0,35,21
1656256467805,MATH 109,A01,083213,Ganzberger; Geoffrey Michael,0,0,34,34
1656256467805,MATH 109,A02,083214,Ganzberger; Geoffrey Michael,0,0,34,34
1656256467805,MATH 109,A03,093478,Staff,1,0,34,33
1656256467805,MATH 109,B01,083215,Ganzberger; Geoffrey Michael,4,0,32,28
1656256467805,MATH 109,B02,083216,Ganzberger; Geoffrey Michael,1,0,32,31
1656256467805,MATH 109,B03,093479,Staff,3,0,32,29
1656256473839,MATH 142A,A01,083219,Chow; Bennett,2,0,32,30
1656256473839,MATH 142A,A02,083220,Chow; Bennett,8,0,32,24
1656256473839,MATH 142A,A03,093480,Staff,5,0,32,27
1656256473839,MATH 142A,B03,093481,Staff,3,0,32,29
1656256473839,MATH 142A,B04,093558,Staff,6,0,32,26
1656256473839,MATH 142A,B05,093559,Staff,0,0,32,32
1656256479869,MATH 193A,A01,083224,Rotar; Vladimir,0,1,34,34
1656256479869,MATH 193A,A02,083225,Rotar; Vladimir,0,0,34,34
1656256479869,MATH 193A,A03,083781,Rotar; Vladimir,0,0,34,34
1656256479869,MATH 193A,A04,083782,Rotar; Vladimir,6,0,34,28
1656256479869,MATH 193A,A05,093482,Rotar; Vladimir,0,0,34,34
1656256485904,MATH 197,001,091859,McAuley; Julian John,9999,0,9999,0
1656256485904,MATH 197,002,095566,Kedlaya; Kiran S.,9997,0,9999,2
1656256485904,MATH 197,003,095567,Xiao; Ming,9999,0,9999,0
1656256485904,MATH 197,004,095571,Perols; Johan Lars,9998,0,9999,1
1656256493013,COGS 9,A01,083615,Shannon; Kyle Michael,3,0,75,72
1656256499037,COGS 11,A01,083617,Boyle; Mary E. T.,14,0,48,34
1656256505065,COGS 13,A01,083071,Bastos; Amalia Pinkusfeld,5,0,71,66
1656256511100,COGS 14A,A01,092681,Semenuks; Arturs,1,12,100,99
1656256517135,COGS 14B,A01,083073,Cheng; Tzu-Han,7,0,63,56
1656256523171,COGS 17,A01,092677,Semenuks; Arturs,8,0,81,73
1656256529211,COGS 100,A01,083619,Allen; Michael Gordon,2,0,70,68
1656256535236,COGS 101A,A01,083621,Davis; Joshua Daniel,4,0,68,64
1656256541262,COGS 101B,A01,091572,Allen; Michael Gordon,4,0,65,61
1656256547286,COGS 101C,A01,083625,Delgado; Tania,10,0,35,25
1656256553330,COGS 107A,A01,083627,Boyle; Mary E. T.,0,0,60,60
1656256559356,COGS 118A,A01,083075,Gupta; Anjum,8,0,76,68
1656256565399,CSE 3,A50,083646,Miranda; Gregory Joseph,18,0,50,32
1656256571423,CSE 8A,A50,083650,Miranda; Gregory Joseph,2,2,56,54
1656256577483,CSE 11,A01,083080,Cao; Yingjun,0,49,40,40
1656256583521,CSE 12,A01,083652,Krause-Levy; Sophia Louisa,5,1,120,115
1656256589555,CSE 15L,A01,083654,Morris; Justin Loren,2,0,50,48
1656256589555,CSE 15L,A02,083655,Morris; Justin Loren,4,0,50,46
1656256595579,CSE 20,A01,083657,Tran; Khoa Dang,30,0,80,50
1656256601612,CSE 21,A01,095574,Bach; Quang Tran,23,0,48,25
1656256607636,CSE 30,A01,083084,Eldon; John,2,6,80,78
1656256607636,CSE 30,B01,095061,Bhaskar; Nishant,0,1,50,50
1656256613688,CSE 100,A01,083659,Cao; Yingjun,1,18,70,69
1656256619711,CSE 134B,A01,083661,Powell; Thomas Allan,5,0,100,95
1656256625747,CSE 140,A01,083663,Gungor; Onat,9,0,85,76
1656256631775,CSE 140L,A01,083088,Eldon; John,8,0,100,92
1656256637806,CSE 175,A01,083665,Kumar; Rakesh,0,0,25,25
1656256643844,CSE 190,A00,092507,Dubnov; Shlomo,3,0,20,17
1656256649896,ECE 45,A01,083139,Congero; Spencer William,1,0,75,74
1656256655934,ECE 65,A50,083695,Saad; Andrew S,9,0,30,21
1656256655934,ECE 65,A51,095125,Staff,24,0,26,2
1656256661963,ECE 109,A01,091882,Touri; Behrouz,0,1,70,70
1656256667991,ECE 180,A00,083140,Abi Samra; Nicholas Camill,1,0,30,29
1656256667991,ECE 180,B00,083141,Abi Samra; Nicholas Camill,0,4,30,30
1656256674030,MATH 10A,A01,083735,Patchell; Gregory David,0,0,30,30
1656256674030,MATH 10A,A02,083736,Patchell; Gregory David,22,0,30,8
1656256674030,MATH 10A,A03,083737,Patchell; Gregory David,16,0,30,14
1656256680084,MATH 10B,A01,083207,Lim; Seonhee,0,0,34,34
1656256680084,MATH 10B,A02,083208,Lim; Seonhee,7,0,35,28
1656256680084,MATH 10B,A03,093472,Staff,1,0,34,33
1656256680084,MATH 10B,B01,083739,Sinha; Shubham,11,0,30,19
1656256686132,MATH 18,A01,083743,Cinel; Cameron Alexander,7,0,30,23
1656256686132,MATH 18,A02,083744,Cinel; Cameron Alexander,9,0,30,21
1656256686132,MATH 18,A03,083745,Cinel; Cameron Alexander,5,0,30,25
1656256686132,MATH 18,B01,083748,Rideout; David Porter,1,0,36,35
1656256686132,MATH 18,B02,083749,Rideout; David Porter,0,0,36,36
1656256686132,MATH 18,B03,083750,Rideout; David Porter,0,0,36,36
1656256686132,MATH 18,B04,083751,Rideout; David Porter,0,1,36,36
1656256686132,MATH 18,B05,093473,Rideout; David Porter,0,0,36,36
1656256686132,MATH 18,B06,093474,Rideout; David Porter,3,0,36,33
1656256692169,MATH 20A,A01,083754,Zheng; Zequn,11,0,40,29
1656256698194,MATH 20B,A01,083756,Briones; Jor-el Thomas Caparas,0,0,36,36
1656256698194,MATH 20B,A02,083757,Briones; Jor-el Thomas Caparas,0,0,36,36
1656256698194,MATH 20B,A03,093475,Staff,0,0,36,36
1656256704222,MATH 20C,A01,083760,Briones; Jor-el Thomas Caparas,0,0,35,35
1656256704222,MATH 20C,A02,083761,Briones; Jor-el Thomas Caparas,9,1,35,26
1656256704222,MATH 20C,A03,093476,Staff,0,0,35,35
1656256704222,MATH 20C,B01,083762,Bach; Quang Tran,1,0,30,29
1656256710252,MATH 20D,A01,083765,Tran; Brian Kha,1,0,30,29
1656256710252,MATH 20D,A02,083766,Tran; Brian Kha,0,1,30,30
1656256710252,MATH 20D,A03,083767,Tran; Brian Kha,2,0,30,28
1656256716294,MATH 20E,A01,083771,Ganguly; Soumya,3,0,32,29
1656256716294,MATH 20E,A02,083772,Ganguly; Soumya,0,0,32,32
1656256716294,MATH 20E,B01,083773,Ciotti; Benjamin,16,0,35,19
1656256716294,MATH 20E,B02,083774,Ciotti; Benjamin,15,0,35,20
1656256722318,MATH 103A,A01,083777,Greenfeld; Be'Eri,1,0,36,35
1656256722318,MATH 103A,A02,083778,Greenfeld; Be'Eri,1,0,36,35
1656256722318,MATH 103A,A03,093561,Staff,5,0,36,31
1656256722318,MATH 103A,B01,083779,Greenfeld; Be'Eri,8,0,36,28
1656256722318,MATH 103A,B02,083780,Greenfeld; Be'Eri,1,0,36,35
1656256722318,MATH 103A,B03,093562,Staff,0,0,36,36
1656256728359,MATH 105,A01,085443,Carter; Anne Toulson,5,0,35,30
1656256728359,MATH 105,A02,093477,Staff,14,0,35,21
1656256734398,MATH 109,A01,083213,Ganzberger; Geoffrey Michael,0,0,34,34
1656256734398,MATH 109,A02,083214,Ganzberger; Geoffrey Michael,0,0,34,34
1656256734398,MATH 109,A03,093478,Staff,1,0,34,33
1656256734398,MATH 109,B01,083215,Ganzberger; Geoffrey Michael,4,0,32,28
1656256734398,MATH 109,B02,083216,Ganzberger; Geoffrey Michael,1,0,32,31
1656256734398,MATH 109,B03,093479,Staff,3,0,32,29
1656256740447,MATH 142A,A01,083219,Chow; Bennett,2,0,32,30
1656256740447,MATH 142A,A02,083220,Chow; Bennett,8,0,32,24
1656256740447,MATH 142A,A03,093480,Staff,5,0,32,27
1656256740447,MATH 142A,B03,093481,Staff,3,0,32,29
1656256740447,MATH 142A,B04,093558,Staff,6,0,32,26
1656256740447,MATH 142A,B05,093559,Staff,0,0,32,32
1656256746471,MATH 193A,A01,083224,Rotar; Vladimir,0,1,34,34
1656256746471,MATH 193A,A02,083225,Rotar; Vladimir,0,0,34,34
1656256746471,MATH 193A,A03,083781,Rotar; Vladimir,0,0,34,34
1656256746471,MATH 193A,A04,083782,Rotar; Vladimir,6,0,34,28
1656256746471,MATH 193A,A05,093482,Rotar; Vladimir,0,0,34,34
1656256752494,MATH 197,001,091859,McAuley; Julian John,9999,0,9999,0
1656256752494,MATH 197,002,095566,Kedlaya; Kiran S.,9997,0,9999,2
1656256752494,MATH 197,003,095567,Xiao; Ming,9999,0,9999,0
1656256752494,MATH 197,004,095571,Perols; Johan Lars,9998,0,9999,1
1656256759587,COGS 9,A01,083615,Shannon; Kyle Michael,3,0,75,72
1656256765613,COGS 11,A01,083617,Boyle; Mary E. T.,14,0,48,34
1656256771646,COGS 13,A01,083071,Bastos; Amalia Pinkusfeld,5,0,71,66
1656256777672,COGS 14A,A01,092681,Semenuks; Arturs,1,12,100,99
1656256783708,COGS 14B,A01,083073,Cheng; Tzu-Han,7,0,63,56
1656256789744,COGS 17,A01,092677,Semenuks; Arturs,8,0,81,73
1656256795770,COGS 100,A01,083619,Allen; Michael Gordon,2,0,70,68
1656256801800,COGS 101A,A01,083621,Davis; Joshua Daniel,4,0,68,64
1656256807824,COGS 101B,A01,091572,Allen; Michael Gordon,4,0,65,61
1656256813870,COGS 101C,A01,083625,Delgado; Tania,10,0,35,25
1656256819898,COGS 107A,A01,083627,Boyle; Mary E. T.,0,0,60,60
1656256825921,COGS 118A,A01,083075,Gupta; Anjum,8,0,76,68
1656256831950,CSE 3,A50,083646,Miranda; Gregory Joseph,18,0,50,32
1656256837989,CSE 8A,A50,083650,Miranda; Gregory Joseph,2,2,56,54
1656256844038,CSE 11,A01,083080,Cao; Yingjun,0,49,40,40
1656256850072,CSE 12,A01,083652,Krause-Levy; Sophia Louisa,5,1,120,115
1656256856097,CSE 15L,A01,083654,Morris; Justin Loren,2,0,50,48
1656256856097,CSE 15L,A02,083655,Morris; Justin Loren,4,0,50,46
1656256862126,CSE 20,A01,083657,Tran; Khoa Dang,30,0,80,50
1656256868158,CSE 21,A01,095574,Bach; Quang Tran,23,0,48,25
1656256874182,CSE 30,A01,083084,Eldon; John,2,6,80,78
1656256874182,CSE 30,B01,095061,Bhaskar; Nishant,0,1,50,50
1656256880217,CSE 100,A01,083659,Cao; Yingjun,1,18,70,69
1656256886240,CSE 134B,A01,083661,Powell; Thomas Allan,5,0,100,95
1656256892263,CSE 140,A01,083663,Gungor; Onat,9,0,85,76
1656256898287,CSE 140L,A01,083088,Eldon; John,8,0,100,92
1656256904312,CSE 175,A01,083665,Kumar; Rakesh,0,0,25,25
1656256910356,CSE 190,A00,092507,Dubnov; Shlomo,3,0,20,17
1656256916387,ECE 45,A01,083139,Congero; Spencer William,1,0,75,74
1656256922411,ECE 65,A50,083695,Saad; Andrew S,9,0,30,21
1656256922411,ECE 65,A51,095125,Staff,24,0,26,2
1656256928435,ECE 109,A01,091882,Touri; Behrouz,0,1,70,70
1656256934460,ECE 180,A00,083140,Abi Samra; Nicholas Camill,1,0,30,29
1656256934460,ECE 180,B00,083141,Abi Samra; Nicholas Camill,0,4,30,30
1656256940497,MATH 10A,A01,083735,Patchell; Gregory David,0,0,30,30
1656256940497,MATH 10A,A02,083736,Patchell; Gregory David,22,0,30,8
1656256940497,MATH 10A,A03,083737,Patchell; Gregory David,16,0,30,14
1656256946543,MATH 10B,A01,083207,Lim; Seonhee,0,0,34,34
1656256946543,MATH 10B,A02,083208,Lim; Seonhee,7,0,35,28
1656256946543,MATH 10B,A03,093472,Staff,1,0,34,33
1656256946543,MATH 10B,B01,083739,Sinha; Shubham,11,0,30,19
1656256952585,MATH 18,A01,083743,Cinel; Cameron Alexander,7,0,30,23
1656256952585,MATH 18,A02,083744,Cinel; Cameron Alexander,9,0,30,21
1656256952585,MATH 18,A03,083745,Cinel; Cameron Alexander,5,0,30,25
1656256952585,MATH 18,B01,083748,Rideout; David Porter,1,0,36,35
1656256952585,MATH 18,B02,083749,Rideout; David Porter,0,0,36,36
1656256952585,MATH 18,B03,083750,Rideout; David Porter,0,0,36,36
1656256952585,MATH 18,B04,083751,Rideout; David Porter,0,1,36,36
1656256952585,MATH 18,B05,093473,Rideout; David Porter,0,0,36,36
1656256952585,MATH 18,B06,093474,Rideout; David Porter,3,0,36,33
1656256958609,MATH 20A,A01,083754,Zheng; Zequn,11,0,40,29
1656256964640,MATH 20B,A01,083756,Briones; Jor-el Thomas Caparas,0,0,36,36
1656256964640,MATH 20B,A02,083757,Briones; Jor-el Thomas Caparas,0,0,36,36
1656256964640,MATH 20B,A03,093475,Staff,0,0,36,36
1656256970679,MATH 20C,A01,083760,Briones; Jor-el Thomas Caparas,0,0,35,35
1656256970679,MATH 20C,A02,083761,Briones; Jor-el Thomas Caparas,9,1,35,26
1656256970679,MATH 20C,A03,093476,Staff,0,0,35,35
1656256970679,MATH 20C,B01,083762,Bach; Quang Tran,1,0,30,29
1656256976704,MATH 20D,A01,083765,Tran; Brian Kha,1,0,30,29
1656256976704,MATH 20D,A02,083766,Tran; Brian Kha,0,1,30,30
1656256976704,MATH 20D,A03,083767,Tran; Brian Kha,2,0,30,28
1656256982728,MATH 20E,A01,083771,Ganguly; Soumya,3,0,32,29
1656256982728,MATH 20E,A02,083772,Ganguly; Soumya,0,0,32,32
1656256982728,MATH 20E,B01,083773,Ciotti; Benjamin,16,0,35,19
1656256982728,MATH 20E,B02,083774,Ciotti; Benjamin,15,0,35,20
1656256988772,MATH 103A,A01,083777,Greenfeld; Be'Eri,1,0,36,35
1656256988772,MATH 103A,A02,083778,Greenfeld; Be'Eri,1,0,36,35
1656256988772,MATH 103A,A03,093561,Staff,5,0,36,31
1656256988772,MATH 103A,B01,083779,Greenfeld; Be'Eri,8,0,36,28
1656256988772,MATH 103A,B02,083780,Greenfeld; Be'Eri,1,0,36,35
1656256988772,MATH 103A,B03,093562,Staff,0,0,36,36
1656256994816,MATH 105,A01,085443,Carter; Anne Toulson,5,0,35,30
1656256994816,MATH 105,A02,093477,Staff,14,0,35,21
1656257000848,MATH 109,A01,083213,Ganzberger; Geoffrey Michael,0,0,34,34
1656257000848,MATH 109,A02,083214,Ganzberger; Geoffrey Michael,0,0,34,34
1656257000848,MATH 109,A03,093478,Staff,1,0,34,33
1656257000848,MATH 109,B01,083215,Ganzberger; Geoffrey Michael,4,0,32,28
1656257000848,MATH 109,B02,083216,Ganzberger; Geoffrey Michael,1,0,32,31
1656257000848,MATH 109,B03,093479,Staff,3,0,32,29
1656257006880,MATH 142A,A01,083219,Chow; Bennett,2,0,32,30
1656257006880,MATH 142A,A02,083220,Chow; Bennett,8,0,32,24
1656257006880,MATH 142A,A03,093480,Staff,5,0,32,27
1656257006880,MATH 142A,B03,093481,Staff,3,0,32,29
1656257006880,MATH 142A,B04,093558,Staff,6,0,32,26
1656257006880,MATH 142A,B05,093559,Staff,0,0,32,32
1656257012929,MATH 193A,A01,083224,Rotar; Vladimir,0,1,34,34
1656257012929,MATH 193A,A02,083225,Rotar; Vladimir,0,0,34,34
1656257012929,MATH 193A,A03,083781,Rotar; Vladimir,0,0,34,34
1656257012929,MATH 193A,A04,083782,Rotar; Vladimir,6,0,34,28
1656257012929,MATH 193A,A05,093482,Rotar; Vladimir,0,0,34,34
1656257018969,MATH 197,001,091859,McAuley; Julian John,9999,0,9999,0
1656257018969,MATH 197,002,095566,Kedlaya; Kiran S.,9997,0,9999,2
1656257018969,MATH 197,003,095567,Xiao; Ming,9999,0,9999,0
1656257018969,MATH 197,004,095571,Perols; Johan Lars,9998,0,9999,1
1656257026041,COGS 9,A01,083615,Shannon; Kyle Michael,3,0,75,72
1656257032161,COGS 11,A01,083617,Boyle; Mary E. T.,14,0,48,34
1656257038187,COGS 13,A01,083071,Bastos; Amalia Pinkusfeld,5,0,71,66
1656257044220,COGS 14A,A01,092681,Semenuks; Arturs,1,12,100,99
1656257050246,COGS 14B,A01,083073,Cheng; Tzu-Han,7,0,63,56
1656257056289,COGS 17,A01,092677,Semenuks; Arturs,8,0,81,73
1656257062367,COGS 100,A01,083619,Allen; Michael Gordon,2,0,70,68
1656257068398,COGS 101A,A01,083621,Davis; Joshua Daniel,4,0,68,64
1656257074431,COGS 101B,A01,091572,Allen; Michael Gordon,4,0,65,61
1656257080458,COGS 101C,A01,083625,Delgado; Tania,10,0,35,25
1656257086505,COGS 107A,A01,083627,Boyle; Mary E. T.,0,0,60,60
1656257092535,COGS 118A,A01,083075,Gupta; Anjum,8,0,76,68
1656257098571,CSE 3,A50,083646,Miranda; Gregory Joseph,18,0,50,32
1656257104595,CSE 8A,A50,083650,Miranda; Gregory Joseph,2,2,56,54
1656257110647,CSE 11,A01,083080,Cao; Yingjun,0,49,40,40
1656257116685,CSE 12,A01,083652,Krause-Levy; Sophia Louisa,5,1,120,115
1656257122714,CSE 15L,A01,083654,Morris; Justin Loren,2,0,50,48
1656257122714,CSE 15L,A02,083655,Morris; Justin Loren,4,0,50,46
1656257128759,CSE 20,A01,083657,Tran; Khoa Dang,30,0,80,50
1656257134791,CSE 21,A01,095574,Bach; Quang Tran,23,0,48,25
1656257140832,CSE 30,A01,083084,Eldon; John,2,6,80,78
1656257140832,CSE 30,B01,095061,Bhaskar; Nishant,0,1,50,50
1656257146857,CSE 100,A01,083659,Cao; Yingjun,1,18,70,69
1656257152884,CSE 134B,A01,083661,Powell; Thomas Allan,5,0,100,95
1656257158919,CSE 140,A01,083663,Gungor; Onat,9,0,85,76
1656257164947,CSE 140L,A01,083088,Eldon; John,8,0,100,92
1656257171000,CSE 175,A01,083665,Kumar; Rakesh,0,0,25,25
1656257177024,CSE 190,A00,092507,Dubnov; Shlomo,3,0,20,17
1656257183068,ECE 45,A01,083139,Congero; Spencer William,1,0,75,74
1656257189097,ECE 65,A50,083695,Saad; Andrew S,9,0,30,21
1656257189097,ECE 65,A51,095125,Staff,24,0,26,2
1656257195133,ECE 109,A01,091882,Touri; Behrouz,0,1,70,70
1656257201157,ECE 180,A00,083140,Abi Samra; Nicholas Camill,1,0,30,29
1656257201157,ECE 180,B00,083141,Abi Samra; Nicholas Camill,0,4,30,30
1656257207183,MATH 10A,A01,083735,Patchell; Gregory David,0,0,30,30
1656257207183,MATH 10A,A02,083736,Patchell; Gregory David,22,0,30,8
1656257207183,MATH 10A,A03,083737,Patchell; Gregory David,16,0,30,14
1656257213224,MATH 10B,A01,083207,Lim; Seonhee,0,0,34,34
1656257213224,MATH 10B,A02,083208,Lim; Seonhee,7,0,35,28
1656257213224,MATH 10B,A03,093472,Staff,1,0,34,33
1656257213224,MATH 10B,B01,083739,Sinha; Shubham,11,0,30,19
1656257219262,MATH 18,A01,083743,Cinel; Cameron Alexander,7,0,30,23
1656257219262,MATH 18,A02,083744,Cinel; Cameron Alexander,9,0,30,21
1656257219262,MATH 18,A03,083745,Cinel; Cameron Alexander,5,0,30,25
1656257219262,MATH 18,B01,083748,Rideout; David Porter,1,0,36,35
1656257219262,MATH 18,B02,083749,Rideout; David Porter,0,0,36,36
1656257219262,MATH 18,B03,083750,Rideout; David Porter,0,0,36,36
1656257219262,MATH 18,B04,083751,Rideout; David Porter,0,1,36,36
1656257219262,MATH 18,B05,093473,Rideout; David Porter,0,0,36,36
1656257219262,MATH 18,B06,093474,Rideout; David Porter,3,0,36,33
1656257225303,MATH 20A,A01,083754,Zheng; Zequn,11,0,40,29
1656257231328,MATH 20B,A01,083756,Briones; Jor-el Thomas Caparas,0,0,36,36
1656257231328,MATH 20B,A02,083757,Briones; Jor-el Thomas Caparas,0,0,36,36
1656257231328,MATH 20B,A03,093475,Staff,0,0,36,36
1656257237353,MATH 20C,A01,083760,Briones; Jor-el Thomas Caparas,0,0,35,35
1656257237353,MATH 20C,A02,083761,Briones; Jor-el Thomas Caparas,9,1,35,26
1656257237353,MATH 20C,A03,093476,Staff,0,0,35,35
1656257237353,MATH 20C,B01,083762,Bach; Quang Tran,1,0,30,29
1656257243377,MATH 20D,A01,083765,Tran; Brian Kha,1,0,30,29
1656257243377,MATH 20D,A02,083766,Tran; Brian Kha,0,1,30,30
1656257243377,MATH 20D,A03,083767,Tran; Brian Kha,2,0,30,28
1656257249414,MATH 20E,A01,083771,Ganguly; Soumya,3,0,32,29
1656257249414,MATH 20E,A02,083772,Ganguly; Soumya,0,0,32,32
1656257249414,MATH 20E,B01,083773,Ciotti; Benjamin,16,0,35,19
1656257249414,MATH 20E,B02,083774,Ciotti; Benjamin,15,0,35,20
1656257255456,MATH 103A,A01,083777,Greenfeld; Be'Eri,1,0,36,35
1656257255456,MATH 103A,A02,083778,Greenfeld; Be'Eri,1,0,36,35
1656257255456,MATH 103A,A03,093561,Staff,5,0,36,31
1656257255456,MATH 103A,B01,083779,Greenfeld; Be'Eri,8,0,36,28
1656257255456,MATH 103A,B02,083780,Greenfeld; Be'Eri,1,0,36,35
1656257255456,MATH 103A,B03,093562,Staff,0,0,36,36
1656257261490,MATH 105,A01,085443,Carter; Anne Toulson,5,0,35,30
1656257261490,MATH 105,A02,093477,Staff,14,0,35,21
1656257267521,MATH 109,A01,083213,Ganzberger; Geoffrey Michael,0,0,34,34
1656257267521,MATH 109,A02,083214,Ganzberger; Geoffrey Michael,0,0,34,34
1656257267521,MATH 109,A03,093478,Staff,1,0,34,33
1656257267521,MATH 109,B01,083215,Ganzberger; Geoffrey Michael,4,0,32,28
1656257267521,MATH 109,B02,083216,Ganzberger; Geoffrey Michael,1,0,32,31
1656257267521,MATH 109,B03,093479,Staff,3,0,32,29
1656257273559,MATH 142A,A01,083219,Chow; Bennett,2,0,32,30
1656257273559,MATH 142A,A02,083220,Chow; Bennett,8,0,32,24
1656257273559,MATH 142A,A03,093480,Staff,5,0,32,27
1656257273559,MATH 142A,B03,093481,Staff,3,0,32,29
1656257273559,MATH 142A,B04,093558,Staff,6,0,32,26
1656257273559,MATH 142A,B05,093559,Staff,0,0,32,32
1656257279610,MATH 193A,A01,083224,Rotar; Vladimir,0,1,34,34
1656257279610,MATH 193A,A02,083225,Rotar; Vladimir,0,0,34,34
1656257279610,MATH 193A,A03,083781,Rotar; Vladimir,0,0,34,34
1656257279610,MATH 193A,A04,083782,Rotar; Vladimir,6,0,34,28
1656257279610,MATH 193A,A05,093482,Rotar; Vladimir,0,0,34,34
1656257285650,MATH 197,001,091859,McAuley; Julian John,9999,0,9999,0
1656257285650,MATH 197,002,095566,Kedlaya; Kiran S.,9997,0,9999,2
1656257285650,MATH 197,003,095567,Xiao; Ming,9999,0,9999,0
1656257285650,MATH 197,004,095571,Perols; Johan Lars,9998,0,9999,1
1656257292717,COGS 9,A01,083615,Shannon; Kyle Michael,3,0,75,72
1656257298756,COGS 11,A01,083617,Boyle; Mary E. T.,14,0,48,34
1656257304779,COGS 13,A01,083071,Bastos; Amalia Pinkusfeld,5,0,71,66
1656257310814,COGS 14A,A01,092681,Semenuks; Arturs,1,12,100,99
1656257316846,COGS 14B,A01,083073,Cheng; Tzu-Han,7,0,63,56
1656257322888,COGS 17,A01,092677,Semenuks; Arturs,8,0,81,73
1656257328924,COGS 100,A01,083619,Allen; Michael Gordon,2,0,70,68
1656257334948,COGS 101A,A01,083621,Davis; Joshua Daniel,4,0,68,64
1656257340990,COGS 101B,A01,091572,Allen; Michael Gordon,4,0,65,61
1656257347021,COGS 101C,A01,083625,Delgado; Tania,10,0,35,25
1656257353045,COGS 107A,A01,083627,Boyle; Mary E. T.,0,0,60,60
1656257359071,COGS 118A,A01,083075,Gupta; Anjum,8,0,76,68
1656257365096,CSE 3,A50,083646,Miranda; Gregory Joseph,18,0,50,32
1656257371124,CSE 8A,A50,083650,Miranda; Gregory Joseph,2,2,56,54
1656257377152,CSE 11,A01,083080,Cao; Yingjun,0,49,40,40
1656257383177,CSE 12,A01,083652,Krause-Levy; Sophia Louisa,5,1,120,115
1656257389201,CSE 15L,A01,083654,Morris; Justin Loren,2,0,50,48
1656257389201,CSE 15L,A02,083655,Morris; Justin Loren,4,0,50,46
1656257395228,CSE 20,A01,083657,Tran; Khoa Dang,30,0,80,50
1656257401265,CSE 21,A01,095574,Bach; Quang Tran,23,0,48,25
1656257407306,CSE 30,A01,083084,Eldon; John,2,6,80,78
1656257407306,CSE 30,B01,095061,Bhaskar; Nishant,0,1,50,50
1656257413330,CSE 100,A01,083659,Cao; Yingjun,1,18,70,69
1656257419357,CSE 134B,A01,083661,Powell; Thomas Allan,5,0,100,95
1656257425377,CSE 140,A01,083663,Gungor; Onat,9,0,85,76
1656257431412,CSE 140L,A01,083088,Eldon; John,8,0,100,92
1656257437454,CSE 175,A01,083665,Kumar; Rakesh,0,0,25,25
1656257443481,CSE 190,A00,092507,Dubnov; Shlomo,3,0,20,17
1656257449516,ECE 45,A01,083139,Congero; Spencer William,1,0,75,74
1656257455540,ECE 65,A50,083695,Saad; Andrew S,9,0,30,21
1656257455540,ECE 65,A51,095125,Staff,24,0,26,2
1656257461577,ECE 109,A01,091882,Touri; Behrouz,0,1,70,70
1656257467607,ECE 180,A00,083140,Abi Samra; Nicholas Camill,1,0,30,29
1656257467607,ECE 180,B00,083141,Abi Samra; Nicholas Camill,0,4,30,30
1656257473630,MATH 10A,A01,083735,Patchell; Gregory David,0,0,30,30
1656257473630,MATH 10A,A02,083736,Patchell; Gregory David,22,0,30,8
1656257473630,MATH 10A,A03,083737,Patchell; Gregory David,16,0,30,14
1656257479671,MATH 10B,A01,083207,Lim; Seonhee,0,0,34,34
1656257479671,MATH 10B,A02,083208,Lim; Seonhee,7,0,35,28
1656257479671,MATH 10B,A03,093472,Staff,1,0,34,33
1656257479671,MATH 10B,B01,083739,Sinha; Shubham,11,0,30,19
1656257485713,MATH 18,A01,083743,Cinel; Cameron Alexander,7,0,30,23
1656257485713,MATH 18,A02,083744,Cinel; Cameron Alexander,9,0,30,21
1656257485713,MATH 18,A03,083745,Cinel; Cameron Alexander,5,0,30,25
1656257485713,MATH 18,B01,083748,Rideout; David Porter,1,0,36,35
1656257485713,MATH 18,B02,083749,Rideout; David Porter,0,0,36,36
1656257485713,MATH 18,B03,083750,Rideout; David Porter,0,0,36,36
1656257485713,MATH 18,B04,083751,Rideout; David Porter,0,1,36,36
1656257485713,MATH 18,B05,093473,Rideout; David Porter,0,0,36,36
1656257485713,MATH 18,B06,093474,Rideout; David Porter,3,0,36,33
1656257491735,MATH 20A,A01,083754,Zheng; Zequn,11,0,40,29
1656257497769,MATH 20B,A01,083756,Briones; Jor-el Thomas Caparas,0,0,36,36
1656257497769,MATH 20B,A02,083757,Briones; Jor-el Thomas Caparas,0,0,36,36
1656257497769,MATH 20B,A03,093475,Staff,0,0,36,36
1656257503808,MATH 20C,A01,083760,Briones; Jor-el Thomas Caparas,0,0,35,35
1656257503808,MATH 20C,A02,083761,Briones; Jor-el Thomas Caparas,9,1,35,26
1656257503808,MATH 20C,A03,093476,Staff,0,0,35,35
1656257503808,MATH 20C,B01,083762,Bach; Quang Tran,1,0,30,29
1656257509841,MATH 20D,A01,083765,Tran; Brian Kha,1,0,30,29
1656257509841,MATH 20D,A02,083766,Tran; Brian Kha,0,1,30,30
1656257509841,MATH 20D,A03,083767,Tran; Brian Kha,2,0,30,28
1656257515865,MATH 20E,A01,083771,Ganguly; Soumya,3,0,32,29
1656257515865,MATH 20E,A02,083772,Ganguly; Soumya,0,0,32,32
1656257515865,MATH 20E,B01,083773,Ciotti; Benjamin,16,0,35,19
1656257515865,MATH 20E,B02,083774,Ciotti; Benjamin,15,0,35,20
1656257521889,MATH 103A,A01,083777,Greenfeld; Be'Eri,1,0,36,35
1656257521889,MATH 103A,A02,083778,Greenfeld; Be'Eri,1,0,36,35
1656257521889,MATH 103A,A03,093561,Staff,5,0,36,31
1656257521889,MATH 103A,B01,083779,Greenfeld; Be'Eri,8,0,36,28
1656257521889,MATH 103A,B02,083780,Greenfeld; Be'Eri,1,0,36,35
1656257521889,MATH 103A,B03,093562,Staff,0,0,36,36
1656257527913,MATH 105,A01,085443,Carter; Anne Toulson,5,0,35,30
1656257527913,MATH 105,A02,093477,Staff,14,0,35,21
1656257533943,MATH 109,A01,083213,Ganzberger; Geoffrey Michael,0,0,34,34
1656257533943,MATH 109,A02,083214,Ganzberger; Geoffrey Michael,0,0,34,34
1656257533943,MATH 109,A03,093478,Staff,1,0,34,33
1656257533943,MATH 109,B01,083215,Ganzberger; Geoffrey Michael,4,0,32,28
1656257533943,MATH 109,B02,083216,Ganzberger; Geoffrey Michael,1,0,32,31
1656257533943,MATH 109,B03,093479,Staff,3,0,32,29
1656257539972,MATH 142A,A01,083219,Chow; Bennett,2,0,32,30
1656257539972,MATH 142A,A02,083220,Chow; Bennett,8,0,32,24
1656257539972,MATH 142A,A03,093480,Staff,5,0,32,27
1656257539972,MATH 142A,B03,093481,Staff,3,0,32,29
1656257539972,MATH 142A,B04,093558,Staff,6,0,32,26
1656257539972,MATH 142A,B05,093559,Staff,0,0,32,32
1656257546003,MATH 193A,A01,083224,Rotar; Vladimir,0,1,34,34
1656257546003,MATH 193A,A02,083225,Rotar; Vladimir,0,0,34,34
1656257546003,MATH 193A,A03,083781,Rotar; Vladimir,0,0,34,34
1656257546003,MATH 193A,A04,083782,Rotar; Vladimir,6,0,34,28
1656257546003,MATH 193A,A05,093482,Rotar; Vladimir,0,0,34,34
1656257552029,MATH 197,001,091859,McAuley; Julian John,9999,0,9999,0
1656257552029,MATH 197,002,095566,Kedlaya; Kiran S.,9997,0,9999,2
1656257552029,MATH 197,003,095567,Xiao; Ming,9999,0,9999,0
1656257552029,MATH 197,004,095571,Perols; Johan Lars,9998,0,9999,1
1656257559098,COGS 9,A01,083615,Shannon; Kyle Michael,3,0,75,72
1656257565125,COGS 11,A01,083617,Boyle; Mary E. T.,14,0,48,34
1656257571158,COGS 13,A01,083071,Bastos; Amalia Pinkusfeld,5,0,71,66
1656257577186,COGS 14A,A01,092681,Semenuks; Arturs,1,12,100,99
1656257583213,COGS 14B,A01,083073,Cheng; Tzu-Han,7,0,63,56
1656257589241,COGS 17,A01,092677,Semenuks; Arturs,8,0,81,73
1656257595277,COGS 100,A01,083619,Allen; Michael Gordon,2,0,70,68
1656257601305,COGS 101A,A01,083621,Davis; Joshua Daniel,4,0,68,64
1656257607333,COGS 101B,A01,091572,Allen; Michael Gordon,4,0,65,61
1656257613374,COGS 101C,A01,083625,Delgado; Tania,10,0,35,25
1656257619401,COGS 107A,A01,083627,Boyle; Mary E. T.,0,0,60,60
1656257625425,COGS 118A,A01,083075,Gupta; Anjum,8,0,76,68
1656257631573,CSE 3,A50,083646,Miranda; Gregory Joseph,18,0,50,32
1656257637618,CSE 8A,A50,083650,Miranda; Gregory Joseph,2,2,56,54
1656257643647,CSE 11,A01,083080,Cao; Yingjun,0,49,40,40
1656257649689,CSE 12,A01,083652,Krause-Levy; Sophia Louisa,5,1,120,115
1656257655725,CSE 15L,A01,083654,Morris; Justin Loren,2,0,50,48
1656257655725,CSE 15L,A02,083655,Morris; Justin Loren,4,0,50,46
1656257661756,CSE 20,A01,083657,Tran; Khoa Dang,30,0,80,50
1656257667802,CSE 21,A01,095574,Bach; Quang Tran,23,0,48,25
1656257673837,CSE 30,A01,083084,Eldon; John,2,6,80,78
1656257673837,CSE 30,B01,095061,Bhaskar; Nishant,0,1,50,50
1656257679870,CSE 100,A01,083659,Cao; Yingjun,1,18,70,69
1656257685912,CSE 134B,A01,083661,Powell; Thomas Allan,5,0,100,95
1656257691951,CSE 140,A01,083663,Gungor; Onat,9,0,85,76
1656257698001,CSE 140L,A01,083088,Eldon; John,8,0,100,92
1656257704024,CSE 175,A01,083665,Kumar; Rakesh,0,0,25,25
1656257710046,CSE 190,A00,092507,Dubnov; Shlomo,3,0,20,17
1656257716082,ECE 45,A01,083139,Congero; Spencer William,1,0,75,74
1656257722106,ECE 65,A50,083695,Saad; Andrew S,9,0,30,21
1656257722106,ECE 65,A51,095125,Staff,24,0,26,2
1656257728145,ECE 109,A01,091882,Touri; Behrouz,0,1,70,70
1656257734168,ECE 180,A00,083140,Abi Samra; Nicholas Camill,1,0,30,29
1656257734168,ECE 180,B00,083141,Abi Samra; Nicholas Camill,0,4,30,30
1656257740210,MATH 10A,A01,083735,Patchell; Gregory David,0,0,30,30
1656257740210,MATH 10A,A02,083736,Patchell; Gregory David,22,0,30,8
1656257740210,MATH 10A,A03,083737,Patchell; Gregory David,16,0,30,14
1656257746239,MATH 10B,A01,083207,Lim; Seonhee,0,0,34,34
1656257746239,MATH 10B,A02,083208,Lim; Seonhee,7,0,35,28
1656257746239,MATH 10B,A03,093472,Staff,1,0,34,33
1656257746239,MATH 10B,B01,083739,Sinha; Shubham,11,0,30,19
1656257752271,MATH 18,A01,083743,Cinel; Cameron Alexander,7,0,30,23
1656257752271,MATH 18,A02,083744,Cinel; Cameron Alexander,9,0,30,21
1656257752271,MATH 18,A03,083745,Cinel; Cameron Alexander,5,0,30,25
1656257752271,MATH 18,B01,083748,Rideout; David Porter,1,0,36,35
1656257752271,MATH 18,B02,083749,Rideout; David Porter,0,0,36,36
1656257752271,MATH 18,B03,083750,Rideout; David Porter,0,0,36,36
1656257752271,MATH 18,B04,083751,Rideout; David Porter,0,1,36,36
1656257752271,MATH 18,B05,093473,Rideout; David Porter,0,0,36,36
1656257752271,MATH 18,B06,093474,Rideout; David Porter,3,0,36,33
1656257758307,MATH 20A,A01,083754,Zheng; Zequn,11,0,40,29
1656257764337,MATH 20B,A01,083756,Briones; Jor-el Thomas Caparas,0,0,36,36
1656257764337,MATH 20B,A02,083757,Briones; Jor-el Thomas Caparas,0,0,36,36
1656257764337,MATH 20B,A03,093475,Staff,0,0,36,36
1656257770368,MATH 20C,A01,083760,Briones; Jor-el Thomas Caparas,0,0,35,35
1656257770368,MATH 20C,A02,083761,Briones; Jor-el Thomas Caparas,9,1,35,26
1656257770368,MATH 20C,A03,093476,Staff,0,0,35,35
1656257770368,MATH 20C,B01,083762,Bach; Quang Tran,1,0,30,29
1656257776397,MATH 20D,A01,083765,Tran; Brian Kha,1,0,30,29
1656257776397,MATH 20D,A02,083766,Tran; Brian Kha,0,1,30,30
1656257776397,MATH 20D,A03,083767,Tran; Brian Kha,2,0,30,28
1656257782428,MATH 20E,A01,083771,Ganguly; Soumya,3,0,32,29
1656257782428,MATH 20E,A02,083772,Ganguly; Soumya,0,0,32,32
1656257782428,MATH 20E,B01,083773,Ciotti; Benjamin,16,0,35,19
1656257782428,MATH 20E,B02,083774,Ciotti; Benjamin,15,0,35,20
1656257788456,MATH 103A,A01,083777,Greenfeld; Be'Eri,1,0,36,35
1656257788456,MATH 103A,A02,083778,Greenfeld; Be'Eri,1,0,36,35
1656257788456,MATH 103A,A03,093561,Staff,5,0,36,31
1656257788456,MATH 103A,B01,083779,Greenfeld; Be'Eri,8,0,36,28
1656257788456,MATH 103A,B02,083780,Greenfeld; Be'Eri,1,0,36,35
1656257788456,MATH 103A,B03,093562,Staff,0,0,36,36
1656257794479,MATH 105,A01,085443,Carter; Anne Toulson,5,0,35,30
1656257794479,MATH 105,A02,093477,Staff,14,0,35,21
1656257800525,MATH 109,A01,083213,Ganzberger; Geoffrey Michael,0,0,34,34
1656257800525,MATH 109,A02,083214,Ganzberger; Geoffrey Michael,0,0,34,34
1656257800525,MATH 109,A03,093478,Staff,1,0,34,33
1656257800525,MATH 109,B01,083215,Ganzberger; Geoffrey Michael,4,0,32,28
1656257800525,MATH 109,B02,083216,Ganzberger; Geoffrey Michael,1,0,32,31
1656257800525,MATH 109,B03,093479,Staff,3,0,32,29
1656257806579,MATH 142A,A01,083219,Chow; Bennett,2,0,32,30
1656257806579,MATH 142A,A02,083220,Chow; Bennett,8,0,32,24
1656257806579,MATH 142A,A03,093480,Staff,5,0,32,27
1656257806579,MATH 142A,B03,093481,Staff,3,0,32,29
1656257806579,MATH 142A,B04,093558,Staff,6,0,32,26
1656257806579,MATH 142A,B05,093559,Staff,0,0,32,32
1656257812622,MATH 193A,A01,083224,Rotar; Vladimir,0,1,34,34
1656257812622,MATH 193A,A02,083225,Rotar; Vladimir,0,0,34,34
1656257812622,MATH 193A,A03,083781,Rotar; Vladimir,0,0,34,34
1656257812622,MATH 193A,A04,083782,Rotar; Vladimir,6,0,34,28
1656257812622,MATH 193A,A05,093482,Rotar; Vladimir,0,0,34,34
1656257818652,MATH 197,001,091859,McAuley; Julian John,9999,0,9999,0
1656257818652,MATH 197,002,095566,Kedlaya; Kiran S.,9997,0,9999,2
1656257818652,MATH 197,003,095567,Xiao; Ming,9999,0,9999,0
1656257818652,MATH 197,004,095571,Perols; Johan Lars,9998,0,9999,1
1656257825720,COGS 9,A01,083615,Shannon; Kyle Michael,3,0,75,72
1656257831748,COGS 11,A01,083617,Boyle; Mary E. T.,14,0,48,34
1656257837786,COGS 13,A01,083071,Bastos; Amalia Pinkusfeld,5,0,71,66
1656257843829,COGS 14A,A01,092681,Semenuks; Arturs,1,12,100,99
1656257849862,COGS 14B,A01,083073,Cheng; Tzu-Han,7,0,63,56
1656257855889,COGS 17,A01,092677,Semenuks; Arturs,8,0,81,73
1656257861927,COGS 100,A01,083619,Allen; Michael Gordon,2,0,70,68
1656257867953,COGS 101A,A01,083621,Davis; Joshua Daniel,4,0,68,64
1656257873980,COGS 101B,A01,091572,Allen; Michael Gordon,4,0,65,61
1656257880026,COGS 101C,A01,083625,Delgado; Tania,10,0,35,25
1656257886058,COGS 107A,A01,083627,Boyle; Mary E. T.,0,0,60,60
1656257892098,COGS 118A,A01,083075,Gupta; Anjum,8,0,76,68
1656257898120,CSE 3,A50,083646,Miranda; Gregory Joseph,18,0,50,32
1656257904158,CSE 8A,A50,083650,Miranda; Gregory Joseph,2,2,56,54
1656257910192,CSE 11,A01,083080,Cao; Yingjun,0,49,40,40
1656257916215,CSE 12,A01,083652,Krause-Levy; Sophia Louisa,5,1,120,115
1656257922238,CSE 15L,A01,083654,Morris; Justin Loren,2,0,50,48
1656257922238,CSE 15L,A02,083655,Morris; Justin Loren,4,0,50,46
1656257928265,CSE 20,A01,083657,Tran; Khoa Dang,30,0,80,50
1656257934289,CSE 21,A01,095574,Bach; Quang Tran,23,0,48,25
1656257940333,CSE 30,A01,083084,Eldon; John,2,6,80,78
1656257940333,CSE 30,B01,095061,Bhaskar; Nishant,0,1,50,50
1656257946356,CSE 100,A01,083659,Cao; Yingjun,1,18,70,69
1656257952378,CSE 134B,A01,083661,Powell; Thomas Allan,5,0,100,95
1656257958411,CSE 140,A01,083663,Gungor; Onat,9,0,85,76
1656257964434,CSE 140L,A01,083088,Eldon; John,8,0,100,92
1656257970461,CSE 175,A01,083665,Kumar; Rakesh,0,0,25,25
1656257976486,CSE 190,A00,092507,Dubnov; Shlomo,3,0,20,17
1656257982513,ECE 45,A01,083139,Congero; Spencer William,1,0,75,74
1656257988558,ECE 65,A50,083695,Saad; Andrew S,9,0,30,21
1656257988558,ECE 65,A51,095125,Staff,24,0,26,2
1656257994590,ECE 109,A01,091882,Touri; Behrouz,0,1,70,70
1656258000614,ECE 180,A00,083140,Abi Samra; Nicholas Camill,1,0,30,29
1656258000614,ECE 180,B00,083141,Abi Samra; Nicholas Camill,0,4,30,30
1656258006665,MATH 10A,A01,083735,Patchell; Gregory David,0,0,30,30
1656258006665,MATH 10A,A02,083736,Patchell; Gregory David,22,0,30,8
1656258006665,MATH 10A,A03,083737,Patchell; Gregory David,16,0,30,14
1656258012693,MATH 10B,A01,083207,Lim; Seonhee,0,0,34,34
1656258012693,MATH 10B,A02,083208,Lim; Seonhee,7,0,35,28
1656258012693,MATH 10B,A03,093472,Staff,1,0,34,33
1656258012693,MATH 10B,B01,083739,Sinha; Shubham,11,0,30,19
1656258018730,MATH 18,A01,083743,Cinel; Cameron Alexander,7,0,30,23
1656258018730,MATH 18,A02,083744,Cinel; Cameron Alexander,9,0,30,21
1656258018730,MATH 18,A03,083745,Cinel; Cameron Alexander,5,0,30,25
1656258018730,MATH 18,B01,083748,Rideout; David Porter,1,0,36,35
1656258018730,MATH 18,B02,083749,Rideout; David Porter,0,0,36,36
1656258018730,MATH 18,B03,083750,Rideout; David Porter,0,0,36,36
1656258018730,MATH 18,B04,083751,Rideout; David Porter,0,1,36,36
1656258018730,MATH 18,B05,093473,Rideout; David Porter,0,0,36,36
1656258018730,MATH 18,B06,093474,Rideout; David Porter,3,0,36,33
1656258024757,MATH 20A,A01,083754,Zheng; Zequn,11,0,40,29
1656258030794,MATH 20B,A01,083756,Briones; Jor-el Thomas Caparas,0,0,36,36
1656258030794,MATH 20B,A02,083757,Briones; Jor-el Thomas Caparas,0,0,36,36
1656258030794,MATH 20B,A03,093475,Staff,0,0,36,36
1656258036823,MATH 20C,A01,083760,Briones; Jor-el Thomas Caparas,0,0,35,35
1656258036823,MATH 20C,A02,083761,Briones; Jor-el Thomas Caparas,9,1,35,26
1656258036823,MATH 20C,A03,093476,Staff,0,0,35,35
1656258036823,MATH 20C,B01,083762,Bach; Quang Tran,1,0,30,29
1656258042869,MATH 20D,A01,083765,Tran; Brian Kha,1,0,30,29
1656258042869,MATH 20D,A02,083766,Tran; Brian Kha,0,1,30,30
1656258042869,MATH 20D,A03,083767,Tran; Brian Kha,2,0,30,28
1656258048897,MATH 20E,A01,083771,Ganguly; Soumya,3,0,32,29
1656258048897,MATH 20E,A02,083772,Ganguly; Soumya,0,0,32,32
1656258048897,MATH 20E,B01,083773,Ciotti; Benjamin,16,0,35,19
1656258048897,MATH 20E,B02,083774,Ciotti; Benjamin,15,0,35,20
1656258054921,MATH 103A,A01,083777,Greenfeld; Be'Eri,1,0,36,35
1656258054921,MATH 103A,A02,083778,Greenfeld; Be'Eri,1,0,36,35
1656258054921,MATH 103A,A03,093561,Staff,5,0,36,31
1656258054921,MATH 103A,B01,083779,Greenfeld; Be'Eri,8,0,36,28
1656258054921,MATH 103A,B02,083780,Greenfeld; Be'Eri,1,0,36,35
1656258054921,MATH 103A,B03,093562,Staff,0,0,36,36
1656258060954,MATH 105,A01,085443,Carter; Anne Toulson,5,0,35,30
1656258060954,MATH 105,A02,093477,Staff,14,0,35,21
1656258066987,MATH 109,A01,083213,Ganzberger; Geoffrey Michael,0,0,34,34
1656258066987,MATH 109,A02,083214,Ganzberger; Geoffrey Michael,0,0,34,34
1656258066987,MATH 109,A03,093478,Staff,1,0,34,33
1656258066987,MATH 109,B01,083215,Ganzberger; Geoffrey Michael,4,0,32,28
1656258066987,MATH 109,B02,083216,Ganzberger; Geoffrey Michael,1,0,32,31
1656258066987,MATH 109,B03,093479,Staff,3,0,32,29
1656258073016,MATH 142A,A01,083219,Chow; Bennett,2,0,32,30
1656258073016,MATH 142A,A02,083220,Chow; Bennett,8,0,32,24
1656258073016,MATH 142A,A03,093480,Staff,5,0,32,27
1656258073016,MATH 142A,B03,093481,Staff,3,0,32,29
1656258073016,MATH 142A,B04,093558,Staff,6,0,32,26
1656258073016,MATH 142A,B05,093559,Staff,0,0,32,32
1656258079057,MATH 193A,A01,083224,Rotar; Vladimir,0,1,34,34
1656258079057,MATH 193A,A02,083225,Rotar; Vladimir,0,0,34,34
1656258079057,MATH 193A,A03,083781,Rotar; Vladimir,0,0,34,34
1656258079057,MATH 193A,A04,083782,Rotar; Vladimir,6,0,34,28
1656258079057,MATH 193A,A05,093482,Rotar; Vladimir,0,0,34,34
1656258085091,MATH 197,001,091859,McAuley; Julian John,9999,0,9999,0
1656258085091,MATH 197,002,095566,Kedlaya; Kiran S.,9997,0,9999,2
1656258085091,MATH 197,003,095567,Xiao; Ming,9999,0,9999,0
1656258085091,MATH 197,004,095571,Perols; Johan Lars,9998,0,9999,1
1656258092162,COGS 9,A01,083615,Shannon; Kyle Michael,3,0,75,72
1656258098191,COGS 11,A01,083617,Boyle; Mary E. T.,14,0,48,34
1656258104214,COGS 13,A01,083071,Bastos; Amalia Pinkusfeld,5,0,71,66
1656258110242,COGS 14A,A01,092681,Semenuks; Arturs,1,12,100,99
1656258116271,COGS 14B,A01,083073,Cheng; Tzu-Han,7,0,63,56
1656258122303,COGS 17,A01,092677,Semenuks; Arturs,8,0,81,73
1656258128331,COGS 100,A01,083619,Allen; Michael Gordon,2,0,70,68
1656258134355,COGS 101A,A01,083621,Davis; Joshua Daniel,4,0,68,64
1656258140381,COGS 101B,A01,091572,Allen; Michael Gordon,4,0,65,61
1656258146414,COGS 101C,A01,083625,Delgado; Tania,10,0,35,25
1656258152437,COGS 107A,A01,083627,Boyle; Mary E. T.,0,0,60,60
1656258158470,COGS 118A,A01,083075,Gupta; Anjum,8,0,76,68
1656258164501,CSE 3,A50,083646,Miranda; Gregory Joseph,18,0,50,32
1656258170546,CSE 8A,A50,083650,Miranda; Gregory Joseph,2,2,56,54
1656258176578,CSE 11,A01,083080,Cao; Yingjun,0,49,40,40
1656258182615,CSE 12,A01,083652,Krause-Levy; Sophia Louisa,5,1,120,115
1656258188652,CSE 15L,A01,083654,Morris; Justin Loren,2,0,50,48
1656258188652,CSE 15L,A02,083655,Morris; Justin Loren,4,0,50,46
1656258194697,CSE 20,A01,083657,Tran; Khoa Dang,30,0,80,50
1656258200722,CSE 21,A01,095574,Bach; Quang Tran,23,0,48,25
1656258206771,CSE 30,A01,083084,Eldon; John,2,6,80,78
1656258206771,CSE 30,B01,095061,Bhaskar; Nishant,0,1,50,50
1656258212824,CSE 100,A01,083659,Cao; Yingjun,1,18,70,69
1656258218866,CSE 134B,A01,083661,Powell; Thomas Allan,5,0,100,95
1656258224900,CSE 140,A01,083663,Gungor; Onat,9,0,85,76
1656258231029,CSE 140L,A01,083088,Eldon; John,8,0,100,92
1656258237070,CSE 175,A01,083665,Kumar; Rakesh,0,0,25,25
1656258243094,CSE 190,A00,092507,Dubnov; Shlomo,3,0,20,17
1656258249133,ECE 45,A01,083139,Congero; Spencer William,1,0,75,74
1656258255159,ECE 65,A50,083695,Saad; Andrew S,9,0,30,21
1656258255159,ECE 65,A51,095125,Staff,24,0,26,2
1656258261193,ECE 109,A01,091882,Touri; Behrouz,0,1,70,70
1656258267217,ECE 180,A00,083140,Abi Samra; Nicholas Camill,1,0,30,29
1656258267217,ECE 180,B00,083141,Abi Samra; Nicholas Camill,0,4,30,30
1656258273241,MATH 10A,A01,083735,Patchell; Gregory David,0,0,30,30
1656258273241,MATH 10A,A02,083736,Patchell; Gregory David,22,0,30,8
1656258273241,MATH 10A,A03,083737,Patchell; Gregory David,16,0,30,14
1656258279295,MATH 10B,A01,083207,Lim; Seonhee,0,0,34,34
1656258279295,MATH 10B,A02,083208,Lim; Seonhee,7,0,35,28
1656258279295,MATH 10B,A03,093472,Staff,1,0,34,33
1656258279295,MATH 10B,B01,083739,Sinha; Shubham,11,0,30,19
1656258285333,MATH 18,A01,083743,Cinel; Cameron Alexander,7,0,30,23
1656258285333,MATH 18,A02,083744,Cinel; Cameron Alexander,9,0,30,21
1656258285333,MATH 18,A03,083745,Cinel; Cameron Alexander,5,0,30,25
1656258285333,MATH 18,B01,083748,Rideout; David Porter,1,0,36,35
1656258285333,MATH 18,B02,083749,Rideout; David Porter,0,0,36,36
1656258285333,MATH 18,B03,083750,Rideout; David Porter,0,0,36,36
1656258285333,MATH 18,B04,083751,Rideout; David Porter,0,1,36,36
1656258285333,MATH 18,B05,093473,Rideout; David Porter,0,0,36,36
1656258285333,MATH 18,B06,093474,Rideout; David Porter,3,0,36,33
1656258291365,MATH 20A,A01,083754,Zheng; Zequn,11,0,40,29
1656258297412,MATH 20B,A01,083756,Briones; Jor-el Thomas Caparas,0,0,36,36
1656258297412,MATH 20B,A02,083757,Briones; Jor-el Thomas Caparas,0,0,36,36
1656258297412,MATH 20B,A03,093475,Staff,0,0,36,36
1656258303445,MATH 20C,A01,083760,Briones; Jor-el Thomas Caparas,0,0,35,35
1656258303445,MATH 20C,A02,083761,Briones; Jor-el Thomas Caparas,9,1,35,26
1656258303445,MATH 20C,A03,093476,Staff,0,0,35,35
1656258303445,MATH 20C,B01,083762,Bach; Quang Tran,1,0,30,29
1656258309494,MATH 20D,A01,083765,Tran; Brian Kha,1,0,30,29
1656258309494,MATH 20D,A02,083766,Tran; Brian Kha,0,1,30,30
1656258309494,MATH 20D,A03,083767,Tran; Brian Kha,2,0,30,28
1656258315559,MATH 20E,A01,083771,Ganguly; Soumya,3,0,32,29
1656258315559,MATH 20E,A02,083772,Ganguly; Soumya,0,0,32,32
1656258315559,MATH 20E,B01,083773,Ciotti; Benjamin,16,0,35,19
1656258315559,MATH 20E,B02,083774,Ciotti; Benjamin,15,0,35,20
1656258321586,MATH 103A,A01,083777,Greenfeld; Be'Eri,1,0,36,35
1656258321586,MATH 103A,A02,083778,Greenfeld; Be'Eri,1,0,36,35
1656258321586,MATH 103A,A03,093561,Staff,5,0,36,31
1656258321586,MATH 103A,B01,083779,Greenfeld; Be'Eri,8,0,36,28
1656258321586,MATH 103A,B02,083780,Greenfeld; Be'Eri,1,0,36,35
1656258321586,MATH 103A,B03,093562,Staff,0,0,36,36
1656258327610,MATH 105,A01,085443,Carter; Anne Toulson,5,0,35,30
1656258327610,MATH 105,A02,093477,Staff,14,0,35,21
1656258333638,MATH 109,A01,083213,Ganzberger; Geoffrey Michael,0,0,34,34
1656258333638,MATH 109,A02,083214,Ganzberger; Geoffrey Michael,0,0,34,34
1656258333638,MATH 109,A03,093478,Staff,1,0,34,33
1656258333638,MATH 109,B01,083215,Ganzberger; Geoffrey Michael,4,0,32,28
1656258333638,MATH 109,B02,083216,Ganzberger; Geoffrey Michael,1,0,32,31
1656258333638,MATH 109,B03,093479,Staff,3,0,32,29
1656258339673,MATH 142A,A01,083219,Chow; Bennett,2,0,32,30
1656258339673,MATH 142A,A02,083220,Chow; Bennett,8,0,32,24
1656258339673,MATH 142A,A03,093480,Staff,5,0,32,27
1656258339673,MATH 142A,B03,093481,Staff,3,0,32,29
1656258339673,MATH 142A,B04,093558,Staff,6,0,32,26
1656258339673,MATH 142A,B05,093559,Staff,0,0,32,32
1656258345707,MATH 193A,A01,083224,Rotar; Vladimir,0,1,34,34
1656258345707,MATH 193A,A02,083225,Rotar; Vladimir,0,0,34,34
1656258345707,MATH 193A,A03,083781,Rotar; Vladimir,0,0,34,34
1656258345707,MATH 193A,A04,083782,Rotar; Vladimir,6,0,34,28
1656258345707,MATH 193A,A05,093482,Rotar; Vladimir,0,0,34,34
1656258351755,MATH 197,001,091859,McAuley; Julian John,9999,0,9999,0
1656258351755,MATH 197,002,095566,Kedlaya; Kiran S.,9997,0,9999,2
1656258351755,MATH 197,003,095567,Xiao; Ming,9999,0,9999,0
1656258351755,MATH 197,004,095571,Perols; Johan Lars,9998,0,9999,1
1656258358812,COGS 9,A01,083615,Shannon; Kyle Michael,3,0,75,72
1656258364836,COGS 11,A01,083617,Boyle; Mary E. T.,14,0,48,34
1656258370866,COGS 13,A01,083071,Bastos; Amalia Pinkusfeld,5,0,71,66
1656258376914,COGS 14A,A01,092681,Semenuks; Arturs,1,12,100,99
1656258382955,COGS 14B,A01,083073,Cheng; Tzu-Han,7,0,63,56
1656258388984,COGS 17,A01,092677,Semenuks; Arturs,8,0,81,73
1656258395013,COGS 100,A01,083619,Allen; Michael Gordon,2,0,70,68
1656258401038,COGS 101A,A01,083621,Davis; Joshua Daniel,4,0,68,64
1656258407077,COGS 101B,A01,091572,Allen; Michael Gordon,4,0,65,61
1656258413114,COGS 101C,A01,083625,Delgado; Tania,10,0,35,25
1656258419148,COGS 107A,A01,083627,Boyle; Mary E. T.,0,0,60,60
1656258425172,COGS 118A,A01,083075,Gupta; Anjum,8,0,76,68
1656258431197,CSE 3,A50,083646,Miranda; Gregory Joseph,18,0,50,32
1656258437251,CSE 8A,A50,083650,Miranda; Gregory Joseph,2,2,56,54
1656258443276,CSE 11,A01,083080,Cao; Yingjun,0,49,40,40
1656258449310,CSE 12,A01,083652,Krause-Levy; Sophia Louisa,5,1,120,115
1656258455337,CSE 15L,A01,083654,Morris; Justin Loren,2,0,50,48
1656258455337,CSE 15L,A02,083655,Morris; Justin Loren,4,0,50,46
1656258461364,CSE 20,A01,083657,Tran; Khoa Dang,30,0,80,50
1656258467392,CSE 21,A01,095574,Bach; Quang Tran,23,0,48,25
1656258473432,CSE 30,A01,083084,Eldon; John,2,6,80,78
1656258473432,CSE 30,B01,095061,Bhaskar; Nishant,0,1,50,50
1656258479462,CSE 100,A01,083659,Cao; Yingjun,1,18,70,69
1656258485487,CSE 134B,A01,083661,Powell; Thomas Allan,5,0,100,95
1656258491512,CSE 140,A01,083663,Gungor; Onat,9,0,85,76
1656258497538,CSE 140L,A01,083088,Eldon; John,8,0,100,92
1656258503578,CSE 175,A01,083665,Kumar; Rakesh,0,0,25,25
1656258509604,CSE 190,A00,092507,Dubnov; Shlomo,3,0,20,17
1656258515654,ECE 45,A01,083139,Congero; Spencer William,1,0,75,74
1656258521690,ECE 65,A50,083695,Saad; Andrew S,9,0,30,21
1656258521690,ECE 65,A51,095125,Staff,24,0,26,2
1656258527734,ECE 109,A01,091882,Touri; Behrouz,0,1,70,70
1656258533780,ECE 180,A00,083140,Abi Samra; Nicholas Camill,1,0,30,29
1656258533780,ECE 180,B00,083141,Abi Samra; Nicholas Camill,0,4,30,30
1656258539805,MATH 10A,A01,083735,Patchell; Gregory David,0,0,30,30
1656258539805,MATH 10A,A02,083736,Patchell; Gregory David,22,0,30,8
1656258539805,MATH 10A,A03,083737,Patchell; Gregory David,16,0,30,14
1656258545830,MATH 10B,A01,083207,Lim; Seonhee,0,0,34,34
1656258545830,MATH 10B,A02,083208,Lim; Seonhee,7,0,35,28
1656258545830,MATH 10B,A03,093472,Staff,1,0,34,33
1656258545830,MATH 10B,B01,083739,Sinha; Shubham,11,0,30,19
1656258551867,MATH 18,A01,083743,Cinel; Cameron Alexander,7,0,30,23
1656258551867,MATH 18,A02,083744,Cinel; Cameron Alexander,9,0,30,21
1656258551867,MATH 18,A03,083745,Cinel; Cameron Alexander,5,0,30,25
1656258551867,MATH 18,B01,083748,Rideout; David Porter,1,0,36,35
1656258551867,MATH 18,B02,083749,Rideout; David Porter,0,0,36,36
1656258551867,MATH 18,B03,083750,Rideout; David Porter,0,0,36,36
1656258551867,MATH 18,B04,083751,Rideout; David Porter,0,1,36,36
1656258551867,MATH 18,B05,093473,Rideout; David Porter,0,0,36,36
1656258551867,MATH 18,B06,093474,Rideout; David Porter,3,0,36,33
1656258557892,MATH 20A,A01,083754,Zheng; Zequn,11,0,40,29
1656258563929,MATH 20B,A01,083756,Briones; Jor-el Thomas Caparas,0,0,36,36
1656258563929,MATH 20B,A02,083757,Briones; Jor-el Thomas Caparas,0,0,36,36
1656258563929,MATH 20B,A03,093475,Staff,0,0,36,36
1656258569953,MATH 20C,A01,083760,Briones; Jor-el Thomas Caparas,0,0,35,35
1656258569953,MATH 20C,A02,083761,Briones; Jor-el Thomas Caparas,9,1,35,26
1656258569953,MATH 20C,A03,093476,Staff,0,0,35,35
1656258569953,MATH 20C,B01,083762,Bach; Quang Tran,1,0,30,29
1656258575997,MATH 20D,A01,083765,Tran; Brian Kha,1,0,30,29
1656258575997,MATH 20D,A02,083766,Tran; Brian Kha,0,1,30,30
1656258575997,MATH 20D,A03,083767,Tran; Brian Kha,2,0,30,28
1656258582038,MATH 20E,A01,083771,Ganguly; Soumya,3,0,32,29
1656258582038,MATH 20E,A02,083772,Ganguly; Soumya,0,0,32,32
1656258582038,MATH 20E,B01,083773,Ciotti; Benjamin,16,0,35,19
1656258582038,MATH 20E,B02,083774,Ciotti; Benjamin,15,0,35,20
1656258588061,MATH 103A,A01,083777,Greenfeld; Be'Eri,1,0,36,35
1656258588061,MATH 103A,A02,083778,Greenfeld; Be'Eri,1,0,36,35
1656258588061,MATH 103A,A03,093561,Staff,5,0,36,31
1656258588061,MATH 103A,B01,083779,Greenfeld; Be'Eri,8,0,36,28
1656258588061,MATH 103A,B02,083780,Greenfeld; Be'Eri,1,0,36,35
1656258588061,MATH 103A,B03,093562,Staff,0,0,36,36
1656258594090,MATH 105,A01,085443,Carter; Anne Toulson,5,0,35,30
1656258594090,MATH 105,A02,093477,Staff,14,0,35,21
1656258600146,MATH 109,A01,083213,Ganzberger; Geoffrey Michael,0,0,34,34
1656258600146,MATH 109,A02,083214,Ganzberger; Geoffrey Michael,0,0,34,34
1656258600146,MATH 109,A03,093478,Staff,1,0,34,33
1656258600146,MATH 109,B01,083215,Ganzberger; Geoffrey Michael,4,0,32,28
1656258600146,MATH 109,B02,083216,Ganzberger; Geoffrey Michael,1,0,32,31
1656258600146,MATH 109,B03,093479,Staff,3,0,32,29
1656258606185,MATH 142A,A01,083219,Chow; Bennett,2,0,32,30
1656258606185,MATH 142A,A02,083220,Chow; Bennett,8,0,32,24
1656258606185,MATH 142A,A03,093480,Staff,5,0,32,27
1656258606185,MATH 142A,B03,093481,Staff,3,0,32,29
1656258606185,MATH 142A,B04,093558,Staff,6,0,32,26
1656258606185,MATH 142A,B05,093559,Staff,0,0,32,32
1656258612217,MATH 193A,A01,083224,Rotar; Vladimir,0,1,34,34
1656258612217,MATH 193A,A02,083225,Rotar; Vladimir,0,0,34,34
1656258612217,MATH 193A,A03,083781,Rotar; Vladimir,0,0,34,34
1656258612217,MATH 193A,A04,083782,Rotar; Vladimir,6,0,34,28
1656258612217,MATH 193A,A05,093482,Rotar; Vladimir,0,0,34,34
1656258618241,MATH 197,001,091859,McAuley; Julian John,9999,0,9999,0
1656258618241,MATH 197,002,095566,Kedlaya; Kiran S.,9997,0,9999,2
1656258618241,MATH 197,003,095567,Xiao; Ming,9999,0,9999,0
1656258618241,MATH 197,004,095571,Perols; Johan Lars,9998,0,9999,1
1656258625333,COGS 9,A01,083615,Shannon; Kyle Michael,3,0,75,72
1656258631366,COGS 11,A01,083617,Boyle; Mary E. T.,14,0,48,34
1656258637395,COGS 13,A01,083071,Bastos; Amalia Pinkusfeld,5,0,71,66
1656258643422,COGS 14A,A01,092681,Semenuks; Arturs,1,12,100,99
1656258649444,COGS 14B,A01,083073,Cheng; Tzu-Han,7,0,63,56
1656258655476,COGS 17,A01,092677,Semenuks; Arturs,8,0,81,73
1656258661522,COGS 100,A01,083619,Allen; Michael Gordon,2,0,70,68
1656258667545,COGS 101A,A01,083621,Davis; Joshua Daniel,4,0,68,64
1656258673569,COGS 101B,A01,091572,Allen; Michael Gordon,4,0,65,61
1656258679596,COGS 101C,A01,083625,Delgado; Tania,10,0,35,25
1656258685641,COGS 107A,A01,083627,Boyle; Mary E. T.,0,0,60,60
1656258691677,COGS 118A,A01,083075,Gupta; Anjum,8,0,76,68
1656258697701,CSE 3,A50,083646,Miranda; Gregory Joseph,18,0,50,32
1656258703744,CSE 8A,A50,083650,Miranda; Gregory Joseph,2,2,56,54
1656258709782,CSE 11,A01,083080,Cao; Yingjun,0,49,40,40
1656258715817,CSE 12,A01,083652,Krause-Levy; Sophia Louisa,5,1,120,115
1656258721840,CSE 15L,A01,083654,Morris; Justin Loren,2,0,50,48
1656258721840,CSE 15L,A02,083655,Morris; Justin Loren,4,0,50,46
1656258727871,CSE 20,A01,083657,Tran; Khoa Dang,30,0,80,50
1656258733895,CSE 21,A01,095574,Bach; Quang Tran,23,0,48,25
1656258739940,CSE 30,A01,083084,Eldon; John,2,6,80,78
1656258739940,CSE 30,B01,095061,Bhaskar; Nishant,0,1,50,50
1656258745966,CSE 100,A01,083659,Cao; Yingjun,1,18,70,69
1656258751989,CSE 134B,A01,083661,Powell; Thomas Allan,5,0,100,95
1656258758016,CSE 140,A01,083663,Gungor; Onat,9,0,85,76
1656258764045,CSE 140L,A01,083088,Eldon; John,8,0,100,92
1656258770079,CSE 175,A01,083665,Kumar; Rakesh,0,0,25,25
1656258776106,CSE 190,A00,092507,Dubnov; Shlomo,3,0,20,17
1656258782150,ECE 45,A01,083139,Congero; Spencer William,1,0,75,74
1656258788180,ECE 65,A50,083695,Saad; Andrew S,9,0,30,21
1656258788180,ECE 65,A51,095125,Staff,24,0,26,2
1656258794203,ECE 109,A01,091882,Touri; Behrouz,0,1,70,70
1656258800229,ECE 180,A00,083140,Abi Samra; Nicholas Camill,1,0,30,29
1656258800229,ECE 180,B00,083141,Abi Samra; Nicholas Camill,0,4,30,30
1656258806262,MATH 10A,A01,083735,Patchell; Gregory David,0,0,30,30
1656258806262,MATH 10A,A02,083736,Patchell; Gregory David,22,0,30,8
1656258806262,MATH 10A,A03,083737,Patchell; Gregory David,16,0,30,14
1656258812290,MATH 10B,A01,083207,Lim; Seonhee,0,0,34,34
1656258812290,MATH 10B,A02,083208,Lim; Seonhee,7,0,35,28
1656258812290,MATH 10B,A03,093472,Staff,1,0,34,33
1656258812290,MATH 10B,B01,083739,Sinha; Shubham,11,0,30,19
1656258818323,MATH 18,A01,083743,Cinel; Cameron Alexander,7,0,30,23
1656258818323,MATH 18,A02,083744,Cinel; Cameron Alexander,9,0,30,21
1656258818323,MATH 18,A03,083745,Cinel; Cameron Alexander,5,0,30,25
1656258818323,MATH 18,B01,083748,Rideout; David Porter,1,0,36,35
1656258818323,MATH 18,B02,083749,Rideout; David Porter,0,0,36,36
1656258818323,MATH 18,B03,083750,Rideout; David Porter,0,0,36,36
1656258818323,MATH 18,B04,083751,Rideout; David Porter,0,1,36,36
1656258818323,MATH 18,B05,093473,Rideout; David Porter,0,0,36,36
1656258818323,MATH 18,B06,093474,Rideout; David Porter,3,0,36,33
1656258824347,MATH 20A,A01,083754,Zheng; Zequn,11,0,40,29
1656258830482,MATH 20B,A01,083756,Briones; Jor-el Thomas Caparas,0,0,36,36
1656258830482,MATH 20B,A02,083757,Briones; Jor-el Thomas Caparas,0,0,36,36
1656258830482,MATH 20B,A03,093475,Staff,0,0,36,36
1656258836523,MATH 20C,A01,083760,Briones; Jor-el Thomas Caparas,0,0,35,35
1656258836523,MATH 20C,A02,083761,Briones; Jor-el Thomas Caparas,9,1,35,26
1656258836523,MATH 20C,A03,093476,Staff,0,0,35,35
1656258836523,MATH 20C,B01,083762,Bach; Quang Tran,1,0,30,29
1656258842547,MATH 20D,A01,083765,Tran; Brian Kha,1,0,30,29
1656258842547,MATH 20D,A02,083766,Tran; Brian Kha,0,1,30,30
1656258842547,MATH 20D,A03,083767,Tran; Brian Kha,2,0,30,28
1656258848584,MATH 20E,A01,083771,Ganguly; Soumya,3,0,32,29
1656258848584,MATH 20E,A02,083772,Ganguly; Soumya,0,0,32,32
1656258848584,MATH 20E,B01,083773,Ciotti; Benjamin,16,0,35,19
1656258848584,MATH 20E,B02,083774,Ciotti; Benjamin,15,0,35,20
1656258854628,MATH 103A,A01,083777,Greenfeld; Be'Eri,1,0,36,35
1656258854628,MATH 103A,A02,083778,Greenfeld; Be'Eri,1,0,36,35
1656258854628,MATH 103A,A03,093561,Staff,5,0,36,31
1656258854628,MATH 103A,B01,083779,Greenfeld; Be'Eri,8,0,36,28
1656258854628,MATH 103A,B02,083780,Greenfeld; Be'Eri,1,0,36,35
1656258854628,MATH 103A,B03,093562,Staff,0,0,36,36
1656258860657,MATH 105,A01,085443,Carter; Anne Toulson,5,0,35,30
1656258860657,MATH 105,A02,093477,Staff,14,0,35,21
1656258866698,MATH 109,A01,083213,Ganzberger; Geoffrey Michael,0,0,34,34
1656258866698,MATH 109,A02,083214,Ganzberger; Geoffrey Michael,0,0,34,34
1656258866698,MATH 109,A03,093478,Staff,1,0,34,33
1656258866698,MATH 109,B01,083215,Ganzberger; Geoffrey Michael,4,0,32,28
1656258866698,MATH 109,B02,083216,Ganzberger; Geoffrey Michael,1,0,32,31
1656258866698,MATH 109,B03,093479,Staff,3,0,32,29
1656258872722,MATH 142A,A01,083219,Chow; Bennett,2,0,32,30
1656258872722,MATH 142A,A02,083220,Chow; Bennett,8,0,32,24
1656258872722,MATH 142A,A03,093480,Staff,5,0,32,27
1656258872722,MATH 142A,B03,093481,Staff,3,0,32,29
1656258872722,MATH 142A,B04,093558,Staff,6,0,32,26
1656258872722,MATH 142A,B05,093559,Staff,0,0,32,32
1656258878749,MATH 193A,A01,083224,Rotar; Vladimir,0,1,34,34
1656258878749,MATH 193A,A02,083225,Rotar; Vladimir,0,0,34,34
1656258878749,MATH 193A,A03,083781,Rotar; Vladimir,0,0,34,34
1656258878749,MATH 193A,A04,083782,Rotar; Vladimir,6,0,34,28
1656258878749,MATH 193A,A05,093482,Rotar; Vladimir,0,0,34,34
1656258884779,MATH 197,001,091859,McAuley; Julian John,9999,0,9999,0
1656258884779,MATH 197,002,095566,Kedlaya; Kiran S.,9997,0,9999,2
1656258884779,MATH 197,003,095567,Xiao; Ming,9999,0,9999,0
1656258884779,MATH 197,004,095571,Perols; Johan Lars,9998,0,9999,1
1656258891837,COGS 9,A01,083615,Shannon; Kyle Michael,3,0,75,72
1656258897879,COGS 11,A01,083617,Boyle; Mary E. T.,14,0,48,34
1656258903921,COGS 13,A01,083071,Bastos; Amalia Pinkusfeld,5,0,71,66
1656258909968,COGS 14A,A01,092681,Semenuks; Arturs,1,12,100,99
1656258915991,COGS 14B,A01,083073,Cheng; Tzu-Han,7,0,63,56
1656258922045,COGS 17,A01,092677,Semenuks; Arturs,8,0,81,73
1656258928072,COGS 100,A01,083619,Allen; Michael Gordon,2,0,70,68
1656258934099,COGS 101A,A01,083621,Davis; Joshua Daniel,4,0,68,64
1656258940124,COGS 101B,A01,091572,Allen; Michael Gordon,4,0,65,61
1656258946170,COGS 101C,A01,083625,Delgado; Tania,10,0,35,25
1656258952193,COGS 107A,A01,083627,Boyle; Mary E. T.,0,0,60,60
1656258958221,COGS 118A,A01,083075,Gupta; Anjum,8,0,76,68
1656258964245,CSE 3,A50,083646,Miranda; Gregory Joseph,18,0,50,32
1656258970282,CSE 8A,A50,083650,Miranda; Gregory Joseph,2,2,56,54
1656258976327,CSE 11,A01,083080,Cao; Yingjun,0,49,40,40
1656258982365,CSE 12,A01,083652,Krause-Levy; Sophia Louisa,5,1,120,115
1656258988402,CSE 15L,A01,083654,Morris; Justin Loren,2,0,50,48
1656258988402,CSE 15L,A02,083655,Morris; Justin Loren,4,0,50,46
1656258994442,CSE 20,A01,083657,Tran; Khoa Dang,30,0,80,50
1656259000476,CSE 21,A01,095574,Bach; Quang Tran,23,0,48,25
1656259006526,CSE 30,A01,083084,Eldon; John,2,6,80,78
1656259006526,CSE 30,B01,095061,Bhaskar; Nishant,0,1,50,50
1656259012561,CSE 100,A01,083659,Cao; Yingjun,1,18,70,69
1656259018587,CSE 134B,A01,083661,Powell; Thomas Allan,5,0,100,95
1656259024615,CSE 140,A01,083663,Gungor; Onat,9,0,85,76
1656259030642,CSE 140L,A01,083088,Eldon; John,8,0,100,92
1656259036677,CSE 175,A01,083665,Kumar; Rakesh,0,0,25,25
1656259042705,CSE 190,A00,092507,Dubnov; Shlomo,3,0,20,17
1656259048744,ECE 45,A01,083139,Congero; Spencer William,1,0,75,74
1656259054778,ECE 65,A50,083695,Saad; Andrew S,9,0,30,21
1656259054778,ECE 65,A51,095125,Staff,24,0,26,2
1656259060800,ECE 109,A01,091882,Touri; Behrouz,0,1,70,70
1656259066827,ECE 180,A00,083140,Abi Samra; Nicholas Camill,1,0,30,29
1656259066827,ECE 180,B00,083141,Abi Samra; Nicholas Camill,0,4,30,30
1656259072854,MATH 10A,A01,083735,Patchell; Gregory David,0,0,30,30
1656259072854,MATH 10A,A02,083736,Patchell; Gregory David,22,0,30,8
1656259072854,MATH 10A,A03,083737,Patchell; Gregory David,16,0,30,14
1656259078883,MATH 10B,A01,083207,Lim; Seonhee,0,0,34,34
1656259078883,MATH 10B,A02,083208,Lim; Seonhee,7,0,35,28
1656259078883,MATH 10B,A03,093472,Staff,1,0,34,33
1656259078883,MATH 10B,B01,083739,Sinha; Shubham,11,0,30,19
1656259084915,MATH 18,A01,083743,Cinel; Cameron Alexander,7,0,30,23
1656259084915,MATH 18,A02,083744,Cinel; Cameron Alexander,9,0,30,21
1656259084915,MATH 18,A03,083745,Cinel; Cameron Alexander,5,0,30,25
1656259084915,MATH 18,B01,083748,Rideout; David Porter,1,0,36,35
1656259084915,MATH 18,B02,083749,Rideout; David Porter,0,0,36,36
1656259084915,MATH 18,B03,083750,Rideout; David Porter,0,0,36,36
1656259084915,MATH 18,B04,083751,Rideout; David Porter,0,1,36,36
1656259084915,MATH 18,B05,093473,Rideout; David Porter,0,0,36,36
1656259084915,MATH 18,B06,093474,Rideout; David Porter,3,0,36,33
1656259090962,MATH 20A,A01,083754,Zheng; Zequn,11,0,40,29
1656259096986,MATH 20B,A01,083756,Briones; Jor-el Thomas Caparas,0,0,36,36
1656259096986,MATH 20B,A02,083757,Briones; Jor-el Thomas Caparas,0,0,36,36
1656259096986,MATH 20B,A03,093475,Staff,0,0,36,36
1656259103021,MATH 20C,A01,083760,Briones; Jor-el Thomas Caparas,0,0,35,35
1656259103021,MATH 20C,A02,083761,Briones; Jor-el Thomas Caparas,9,1,35,26
1656259103021,MATH 20C,A03,093476,Staff,0,0,35,35
1656259103021,MATH 20C,B01,083762,Bach; Quang Tran,1,0,30,29
1656259109059,MATH 20D,A01,083765,Tran; Brian Kha,1,0,30,29
1656259109059,MATH 20D,A02,083766,Tran; Brian Kha,0,1,30,30
1656259109059,MATH 20D,A03,083767,Tran; Brian Kha,2,0,30,28
1656259115108,MATH 20E,A01,083771,Ganguly; Soumya,3,0,32,29
1656259115108,MATH 20E,A02,083772,Ganguly; Soumya,0,0,32,32
1656259115108,MATH 20E,B01,083773,Ciotti; Benjamin,16,0,35,19
1656259115108,MATH 20E,B02,083774,Ciotti; Benjamin,15,0,35,20
1656259121140,MATH 103A,A01,083777,Greenfeld; Be'Eri,1,0,36,35
1656259121140,MATH 103A,A02,083778,Greenfeld; Be'Eri,1,0,36,35
1656259121140,MATH 103A,A03,093561,Staff,5,0,36,31
1656259121140,MATH 103A,B01,083779,Greenfeld; Be'Eri,8,0,36,28
1656259121140,MATH 103A,B02,083780,Greenfeld; Be'Eri,1,0,36,35
1656259121140,MATH 103A,B03,093562,Staff,0,0,36,36
1656259127179,MATH 105,A01,085443,Carter; Anne Toulson,5,0,35,30
1656259127179,MATH 105,A02,093477,Staff,14,0,35,21
1656259133204,MATH 109,A01,083213,Ganzberger; Geoffrey Michael,0,0,34,34
1656259133204,MATH 109,A02,083214,Ganzberger; Geoffrey Michael,0,0,34,34
1656259133204,MATH 109,A03,093478,Staff,1,0,34,33
1656259133204,MATH 109,B01,083215,Ganzberger; Geoffrey Michael,4,0,32,28
1656259133204,MATH 109,B02,083216,Ganzberger; Geoffrey Michael,1,0,32,31
1656259133204,MATH 109,B03,093479,Staff,3,0,32,29
1656259139245,MATH 142A,A01,083219,Chow; Bennett,2,0,32,30
1656259139245,MATH 142A,A02,083220,Chow; Bennett,8,0,32,24
1656259139245,MATH 142A,A03,093480,Staff,5,0,32,27
1656259139245,MATH 142A,B03,093481,Staff,3,0,32,29
1656259139245,MATH 142A,B04,093558,Staff,6,0,32,26
1656259139245,MATH 142A,B05,093559,Staff,0,0,32,32
1656259145299,MATH 193A,A01,083224,Rotar; Vladimir,0,1,34,34
1656259145299,MATH 193A,A02,083225,Rotar; Vladimir,0,0,34,34
1656259145299,MATH 193A,A03,083781,Rotar; Vladimir,0,0,34,34
1656259145299,MATH 193A,A04,083782,Rotar; Vladimir,6,0,34,28
1656259145299,MATH 193A,A05,093482,Rotar; Vladimir,0,0,34,34
1656259158080,MATH 197,001,091859,McAuley; Julian John,9999,0,9999,0
1656259158080,MATH 197,002,095566,Kedlaya; Kiran S.,9997,0,9999,2
1656259158080,MATH 197,003,095567,Xiao; Ming,9999,0,9999,0
1656259158080,MATH 197,004,095571,Perols; Johan Lars,9998,0,9999,1
1656259165149,COGS 9,A01,083615,Shannon; Kyle Michael,3,0,75,72
1656259171176,COGS 11,A01,083617,Boyle; Mary E. T.,14,0,48,34
1656259177199,COGS 13,A01,083071,Bastos; Amalia Pinkusfeld,5,0,71,66
1656259183236,COGS 14A,A01,092681,Semenuks; Arturs,1,12,100,99
1656259189272,COGS 14B,A01,083073,Cheng; Tzu-Han,7,0,63,56
1656259195308,COGS 17,A01,092677,Semenuks; Arturs,8,0,81,73
1656259201354,COGS 100,A01,083619,Allen; Michael Gordon,2,0,70,68
1656259207380,COGS 101A,A01,083621,Davis; Joshua Daniel,4,0,68,64
1656259213424,COGS 101B,A01,091572,Allen; Michael Gordon,4,0,65,61
1656259219451,COGS 101C,A01,083625,Delgado; Tania,10,0,35,25
1656259225472,COGS 107A,A01,083627,Boyle; Mary E. T.,0,0,60,60
1656259231496,COGS 118A,A01,083075,Gupta; Anjum,8,0,76,68
1656259237529,CSE 3,A50,083646,Miranda; Gregory Joseph,18,0,50,32
1656259243552,CSE 8A,A50,083650,Miranda; Gregory Joseph,2,2,56,54
1656259249593,CSE 11,A01,083080,Cao; Yingjun,0,49,40,40
1656259255620,CSE 12,A01,083652,Krause-Levy; Sophia Louisa,5,1,120,115
1656259261643,CSE 15L,A01,083654,Morris; Justin Loren,2,0,50,48
1656259261643,CSE 15L,A02,083655,Morris; Justin Loren,4,0,50,46
1656259267667,CSE 20,A01,083657,Tran; Khoa Dang,30,0,80,50
1656259273689,CSE 21,A01,095574,Bach; Quang Tran,23,0,48,25
1656259279717,CSE 30,A01,083084,Eldon; John,2,6,80,78
1656259279717,CSE 30,B01,095061,Bhaskar; Nishant,0,1,50,50
1656259285741,CSE 100,A01,083659,Cao; Yingjun,1,18,70,69
1656259291768,CSE 134B,A01,083661,Powell; Thomas Allan,5,0,100,95
1656259297792,CSE 140,A01,083663,Gungor; Onat,9,0,85,76
1656259303819,CSE 140L,A01,083088,Eldon; John,8,0,100,92
1656259309843,CSE 175,A01,083665,Kumar; Rakesh,0,0,25,25
1656259315872,CSE 190,A00,092507,Dubnov; Shlomo,3,0,20,17
1656259321900,ECE 45,A01,083139,Congero; Spencer William,1,0,75,74
1656259327957,ECE 65,A50,083695,Saad; Andrew S,9,0,30,21
1656259327957,ECE 65,A51,095125,Staff,24,0,26,2
1656259333980,ECE 109,A01,091882,Touri; Behrouz,0,1,70,70
1656259340016,ECE 180,A00,083140,Abi Samra; Nicholas Camill,1,0,30,29
1656259340016,ECE 180,B00,083141,Abi Samra; Nicholas Camill,0,4,30,30
1656259346039,MATH 10A,A01,083735,Patchell; Gregory David,0,0,30,30
1656259346039,MATH 10A,A02,083736,Patchell; Gregory David,22,0,30,8
1656259346039,MATH 10A,A03,083737,Patchell; Gregory David,16,0,30,14
1656259352062,MATH 10B,A01,083207,Lim; Seonhee,0,0,34,34
1656259352062,MATH 10B,A02,083208,Lim; Seonhee,7,0,35,28
1656259352062,MATH 10B,A03,093472,Staff,1,0,34,33
1656259352062,MATH 10B,B01,083739,Sinha; Shubham,11,0,30,19
1656259358090,MATH 18,A01,083743,Cinel; Cameron Alexander,7,0,30,23
1656259358090,MATH 18,A02,083744,Cinel; Cameron Alexander,9,0,30,21
1656259358090,MATH 18,A03,083745,Cinel; Cameron Alexander,5,0,30,25
1656259358090,MATH 18,B01,083748,Rideout; David Porter,1,0,36,35
1656259358090,MATH 18,B02,083749,Rideout; David Porter,0,0,36,36
1656259358090,MATH 18,B03,083750,Rideout; David Porter,0,0,36,36
1656259358090,MATH 18,B04,083751,Rideout; David Porter,0,1,36,36
1656259358090,MATH 18,B05,093473,Rideout; David Porter,0,0,36,36
1656259358090,MATH 18,B06,093474,Rideout; David Porter,3,0,36,33
1656259364116,MATH 20A,A01,083754,Zheng; Zequn,11,0,40,29
1656259370140,MATH 20B,A01,083756,Briones; Jor-el Thomas Caparas,0,0,36,36
1656259370140,MATH 20B,A02,083757,Briones; Jor-el Thomas Caparas,0,0,36,36
1656259370140,MATH 20B,A03,093475,Staff,0,0,36,36
1656259376169,MATH 20C,A01,083760,Briones; Jor-el Thomas Caparas,0,0,35,35
1656259376169,MATH 20C,A02,083761,Briones; Jor-el Thomas Caparas,9,1,35,26
1656259376169,MATH 20C,A03,093476,Staff,0,0,35,35
1656259376169,MATH 20C,B01,083762,Bach; Quang Tran,1,0,30,29
1656259382194,MATH 20D,A01,083765,Tran; Brian Kha,1,0,30,29
1656259382194,MATH 20D,A02,083766,Tran; Brian Kha,0,1,30,30
1656259382194,MATH 20D,A03,083767,Tran; Brian Kha,2,0,30,28
1656259388231,MATH 20E,A01,083771,Ganguly; Soumya,3,0,32,29
1656259388231,MATH 20E,A02,083772,Ganguly; Soumya,0,0,32,32
1656259388231,MATH 20E,B01,083773,Ciotti; Benjamin,16,0,35,19
1656259388231,MATH 20E,B02,083774,Ciotti; Benjamin,15,0,35,20
1656259394269,MATH 103A,A01,083777,Greenfeld; Be'Eri,1,0,36,35
1656259394269,MATH 103A,A02,083778,Greenfeld; Be'Eri,1,0,36,35
1656259394269,MATH 103A,A03,093561,Staff,5,0,36,31
1656259394269,MATH 103A,B01,083779,Greenfeld; Be'Eri,8,0,36,28
1656259394269,MATH 103A,B02,083780,Greenfeld; Be'Eri,1,0,36,35
1656259394269,MATH 103A,B03,093562,Staff,0,0,36,36
1656259400294,MATH 105,A01,085443,Carter; Anne Toulson,5,0,35,30
1656259400294,MATH 105,A02,093477,Staff,14,0,35,21
1656259406323,MATH 109,A01,083213,Ganzberger; Geoffrey Michael,0,0,34,34
1656259406323,MATH 109,A02,083214,Ganzberger; Geoffrey Michael,0,0,34,34
1656259406323,MATH 109,A03,093478,Staff,1,0,34,33
1656259406323,MATH 109,B01,083215,Ganzberger; Geoffrey Michael,4,0,32,28
1656259406323,MATH 109,B02,083216,Ganzberger; Geoffrey Michael,1,0,32,31
1656259406323,MATH 109,B03,093479,Staff,3,0,32,29
1656259412347,MATH 142A,A01,083219,Chow; Bennett,2,0,32,30
1656259412347,MATH 142A,A02,083220,Chow; Bennett,8,0,32,24
1656259412347,MATH 142A,A03,093480,Staff,5,0,32,27
1656259412347,MATH 142A,B03,093481,Staff,3,0,32,29
1656259412347,MATH 142A,B04,093558,Staff,6,0,32,26
1656259412347,MATH 142A,B05,093559,Staff,0,0,32,32
1656259418376,MATH 193A,A01,083224,Rotar; Vladimir,0,1,34,34
1656259418376,MATH 193A,A02,083225,Rotar; Vladimir,0,0,34,34
1656259418376,MATH 193A,A03,083781,Rotar; Vladimir,0,0,34,34
1656259418376,MATH 193A,A04,083782,Rotar; Vladimir,6,0,34,28
1656259418376,MATH 193A,A05,093482,Rotar; Vladimir,0,0,34,34
1656259424403,MATH 197,001,091859,McAuley; Julian John,9999,0,9999,0
1656259424403,MATH 197,002,095566,Kedlaya; Kiran S.,9997,0,9999,2
1656259424403,MATH 197,003,095567,Xiao; Ming,9999,0,9999,0
1656259424403,MATH 197,004,095571,Perols; Johan Lars,9998,0,9999,1
1656259431542,COGS 9,A01,083615,Shannon; Kyle Michael,3,0,75,72
1656259437565,COGS 11,A01,083617,Boyle; Mary E. T.,14,0,48,34
1656259443594,COGS 13,A01,083071,Bastos; Amalia Pinkusfeld,5,0,71,66
1656259449616,COGS 14A,A01,092681,Semenuks; Arturs,1,12,100,99
1656259455652,COGS 14B,A01,083073,Cheng; Tzu-Han,7,0,63,56
1656259461679,COGS 17,A01,092677,Semenuks; Arturs,8,0,81,73
1656259467703,COGS 100,A01,083619,Allen; Michael Gordon,2,0,70,68
1656259473728,COGS 101A,A01,083621,Davis; Joshua Daniel,4,0,68,64
1656259479751,COGS 101B,A01,091572,Allen; Michael Gordon,4,0,65,61
1656259485775,COGS 101C,A01,083625,Delgado; Tania,10,0,35,25
1656259491810,COGS 107A,A01,083627,Boyle; Mary E. T.,0,0,60,60
1656259497840,COGS 118A,A01,083075,Gupta; Anjum,8,0,76,68
1656259503866,CSE 3,A50,083646,Miranda; Gregory Joseph,18,0,50,32
1656259509894,CSE 8A,A50,083650,Miranda; Gregory Joseph,2,2,56,54
1656259515930,CSE 11,A01,083080,Cao; Yingjun,0,49,40,40
1656259521952,CSE 12,A01,083652,Krause-Levy; Sophia Louisa,5,1,120,115
1656259527975,CSE 15L,A01,083654,Morris; Justin Loren,2,0,50,48
1656259527975,CSE 15L,A02,083655,Morris; Justin Loren,4,0,50,46
1656259533998,CSE 20,A01,083657,Tran; Khoa Dang,30,0,80,50
1656259540025,CSE 21,A01,095574,Bach; Quang Tran,23,0,48,25
1656259546048,CSE 30,A01,083084,Eldon; John,2,6,80,78
1656259546048,CSE 30,B01,095061,Bhaskar; Nishant,0,1,50,50
1656259552081,CSE 100,A01,083659,Cao; Yingjun,1,18,70,69
1656259558109,CSE 134B,A01,083661,Powell; Thomas Allan,5,0,100,95
1656259564136,CSE 140,A01,083663,Gungor; Onat,9,0,85,76
1656259570161,CSE 140L,A01,083088,Eldon; John,8,0,100,92
1656259576183,CSE 175,A01,083665,Kumar; Rakesh,0,0,25,25
1656259582207,CSE 190,A00,092507,Dubnov; Shlomo,3,0,20,17
1656259588234,ECE 45,A01,083139,Congero; Spencer William,1,0,75,74
1656259594258,ECE 65,A50,083695,Saad; Andrew S,9,0,30,21
1656259594258,ECE 65,A51,095125,Staff,24,0,26,2
1656259600289,ECE 109,A01,091882,Touri; Behrouz,0,1,70,70
1656259606313,ECE 180,A00,083140,Abi Samra; Nicholas Camill,1,0,30,29
1656259606313,ECE 180,B00,083141,Abi Samra; Nicholas Camill,0,4,30,30
1656259612337,MATH 10A,A01,083735,Patchell; Gregory David,0,0,30,30
1656259612337,MATH 10A,A02,083736,Patchell; Gregory David,22,0,30,8
1656259612337,MATH 10A,A03,083737,Patchell; Gregory David,16,0,30,14
1656259618369,MATH 10B,A01,083207,Lim; Seonhee,0,0,34,34
1656259618369,MATH 10B,A02,083208,Lim; Seonhee,7,0,35,28
1656259618369,MATH 10B,A03,093472,Staff,1,0,34,33
1656259618369,MATH 10B,B01,083739,Sinha; Shubham,11,0,30,19
1656259624394,MATH 18,A01,083743,Cinel; Cameron Alexander,7,0,30,23
1656259624394,MATH 18,A02,083744,Cinel; Cameron Alexander,9,0,30,21
1656259624394,MATH 18,A03,083745,Cinel; Cameron Alexander,5,0,30,25
1656259624394,MATH 18,B01,083748,Rideout; David Porter,1,0,36,35
1656259624394,MATH 18,B02,083749,Rideout; David Porter,0,0,36,36
1656259624394,MATH 18,B03,083750,Rideout; David Porter,0,0,36,36
1656259624394,MATH 18,B04,083751,Rideout; David Porter,0,1,36,36
1656259624394,MATH 18,B05,093473,Rideout; David Porter,0,0,36,36
1656259624394,MATH 18,B06,093474,Rideout; David Porter,3,0,36,33
1656259630422,MATH 20A,A01,083754,Zheng; Zequn,11,0,40,29
1656259636444,MATH 20B,A01,083756,Briones; Jor-el Thomas Caparas,0,0,36,36
1656259636444,MATH 20B,A02,083757,Briones; Jor-el Thomas Caparas,0,0,36,36
1656259636444,MATH 20B,A03,093475,Staff,0,0,36,36
1656259642471,MATH 20C,A01,083760,Briones; Jor-el Thomas Caparas,0,0,35,35
1656259642471,MATH 20C,A02,083761,Briones; Jor-el Thomas Caparas,9,1,35,26
1656259642471,MATH 20C,A03,093476,Staff,0,0,35,35
1656259642471,MATH 20C,B01,083762,Bach; Quang Tran,1,0,30,29
1656259648496,MATH 20D,A01,083765,Tran; Brian Kha,1,0,30,29
1656259648496,MATH 20D,A02,083766,Tran; Brian Kha,0,1,30,30
1656259648496,MATH 20D,A03,083767,Tran; Brian Kha,2,0,30,28
1656259654519,MATH 20E,A01,083771,Ganguly; Soumya,3,0,32,29
1656259654519,MATH 20E,A02,083772,Ganguly; Soumya,0,0,32,32
1656259654519,MATH 20E,B01,083773,Ciotti; Benjamin,16,0,35,19
1656259654519,MATH 20E,B02,083774,Ciotti; Benjamin,15,0,35,20
1656259660541,MATH 103A,A01,083777,Greenfeld; Be'Eri,1,0,36,35
1656259660541,MATH 103A,A02,083778,Greenfeld; Be'Eri,1,0,36,35
1656259660541,MATH 103A,A03,093561,Staff,5,0,36,31
1656259660541,MATH 103A,B01,083779,Greenfeld; Be'Eri,8,0,36,28
1656259660541,MATH 103A,B02,083780,Greenfeld; Be'Eri,1,0,36,35
1656259660541,MATH 103A,B03,093562,Staff,0,0,36,36
1656259666564,MATH 105,A01,085443,Carter; Anne Toulson,5,0,35,30
1656259666564,MATH 105,A02,093477,Staff,14,0,35,21
1656259672589,MATH 109,A01,083213,Ganzberger; Geoffrey Michael,0,0,34,34
1656259672589,MATH 109,A02,083214,Ganzberger; Geoffrey Michael,0,0,34,34
1656259672589,MATH 109,A03,093478,Staff,1,0,34,33
1656259672589,MATH 109,B01,083215,Ganzberger; Geoffrey Michael,4,0,32,28
1656259672589,MATH 109,B02,083216,Ganzberger; Geoffrey Michael,1,0,32,31
1656259672589,MATH 109,B03,093479,Staff,3,0,32,29
1656259678630,MATH 142A,A01,083219,Chow; Bennett,2,0,32,30
1656259678630,MATH 142A,A02,083220,Chow; Bennett,8,0,32,24
1656259678630,MATH 142A,A03,093480,Staff,5,0,32,27
1656259678630,MATH 142A,B03,093481,Staff,3,0,32,29
1656259678630,MATH 142A,B04,093558,Staff,6,0,32,26
1656259678630,MATH 142A,B05,093559,Staff,0,0,32,32
1656259684662,MATH 193A,A01,083224,Rotar; Vladimir,0,1,34,34
1656259684662,MATH 193A,A02,083225,Rotar; Vladimir,0,0,34,34
1656259684662,MATH 193A,A03,083781,Rotar; Vladimir,0,0,34,34
1656259684662,MATH 193A,A04,083782,Rotar; Vladimir,6,0,34,28
1656259684662,MATH 193A,A05,093482,Rotar; Vladimir,0,0,34,34
1656259690688,MATH 197,001,091859,McAuley; Julian John,9999,0,9999,0
1656259690688,MATH 197,002,095566,Kedlaya; Kiran S.,9997,0,9999,2
1656259690688,MATH 197,003,095567,Xiao; Ming,9999,0,9999,0
1656259690688,MATH 197,004,095571,Perols; Johan Lars,9998,0,9999,1
1656259697751,COGS 9,A01,083615,Shannon; Kyle Michael,3,0,75,72
1656259703783,COGS 11,A01,083617,Boyle; Mary E. T.,14,0,48,34
1656259709812,COGS 13,A01,083071,Bastos; Amalia Pinkusfeld,5,0,71,66
1656259715845,COGS 14A,A01,092681,Semenuks; Arturs,1,12,100,99
1656259721879,COGS 14B,A01,083073,Cheng; Tzu-Han,7,0,63,56
1656259727903,COGS 17,A01,092677,Semenuks; Arturs,8,0,81,73
1656259733930,COGS 100,A01,083619,Allen; Michael Gordon,2,0,70,68
1656259739965,COGS 101A,A01,083621,Davis; Joshua Daniel,4,0,68,64
1656259745989,COGS 101B,A01,091572,Allen; Michael Gordon,4,0,65,61
1656259752020,COGS 101C,A01,083625,Delgado; Tania,10,0,35,25
1656259758047,COGS 107A,A01,083627,Boyle; Mary E. T.,0,0,60,60
1656259764075,COGS 118A,A01,083075,Gupta; Anjum,8,0,76,68
1656259770098,CSE 3,A50,083646,Miranda; Gregory Joseph,18,0,50,32
1656259776125,CSE 8A,A50,083650,Miranda; Gregory Joseph,2,2,56,54
1656259782152,CSE 11,A01,083080,Cao; Yingjun,0,49,40,40
1656259788176,CSE 12,A01,083652,Krause-Levy; Sophia Louisa,5,1,120,115
1656259794200,CSE 15L,A01,083654,Morris; Justin Loren,2,0,50,48
1656259794200,CSE 15L,A02,083655,Morris; Justin Loren,4,0,50,46
1656259800227,CSE 20,A01,083657,Tran; Khoa Dang,30,0,80,50
1656259806253,CSE 21,A01,095574,Bach; Quang Tran,23,0,48,25
1656259812277,CSE 30,A01,083084,Eldon; John,2,6,80,78
1656259812277,CSE 30,B01,095061,Bhaskar; Nishant,0,1,50,50
1656259818305,CSE 100,A01,083659,Cao; Yingjun,1,18,70,69
1656259824329,CSE 134B,A01,083661,Powell; Thomas Allan,5,0,100,95
1656259830352,CSE 140,A01,083663,Gungor; Onat,9,0,85,76
1656259836379,CSE 140L,A01,083088,Eldon; John,8,0,100,92
1656259842402,CSE 175,A01,083665,Kumar; Rakesh,0,0,25,25
1656259848424,CSE 190,A00,092507,Dubnov; Shlomo,3,0,20,17
1656259854452,ECE 45,A01,083139,Congero; Spencer William,1,0,75,74
1656259860478,ECE 65,A50,083695,Saad; Andrew S,9,0,30,21
1656259860478,ECE 65,A51,095125,Staff,24,0,26,2
1656259866505,ECE 109,A01,091882,Touri; Behrouz,0,1,70,70
1656259872541,ECE 180,A00,083140,Abi Samra; Nicholas Camill,1,0,30,29
1656259872541,ECE 180,B00,083141,Abi Samra; Nicholas Camill,0,4,30,30
1656259878579,MATH 10A,A01,083735,Patchell; Gregory David,0,0,30,30
1656259878579,MATH 10A,A02,083736,Patchell; Gregory David,22,0,30,8
1656259878579,MATH 10A,A03,083737,Patchell; Gregory David,16,0,30,14
1656259884602,MATH 10B,A01,083207,Lim; Seonhee,0,0,34,34
1656259884602,MATH 10B,A02,083208,Lim; Seonhee,7,0,35,28
1656259884602,MATH 10B,A03,093472,Staff,1,0,34,33
1656259884602,MATH 10B,B01,083739,Sinha; Shubham,11,0,30,19
1656259890635,MATH 18,A01,083743,Cinel; Cameron Alexander,7,0,30,23
1656259890635,MATH 18,A02,083744,Cinel; Cameron Alexander,9,0,30,21
1656259890635,MATH 18,A03,083745,Cinel; Cameron Alexander,5,0,30,25
1656259890635,MATH 18,B01,083748,Rideout; David Porter,1,0,36,35
1656259890635,MATH 18,B02,083749,Rideout; David Porter,0,0,36,36
1656259890635,MATH 18,B03,083750,Rideout; David Porter,0,0,36,36
1656259890635,MATH 18,B04,083751,Rideout; David Porter,0,1,36,36
1656259890635,MATH 18,B05,093473,Rideout; David Porter,0,0,36,36
1656259890635,MATH 18,B06,093474,Rideout; David Porter,3,0,36,33
1656259896658,MATH 20A,A01,083754,Zheng; Zequn,11,0,40,29
1656259902688,MATH 20B,A01,083756,Briones; Jor-el Thomas Caparas,0,0,36,36
1656259902688,MATH 20B,A02,083757,Briones; Jor-el Thomas Caparas,0,0,36,36
1656259902688,MATH 20B,A03,093475,Staff,0,0,36,36
1656259908713,MATH 20C,A01,083760,Briones; Jor-el Thomas Caparas,0,0,35,35
1656259908713,MATH 20C,A02,083761,Briones; Jor-el Thomas Caparas,9,1,35,26
1656259908713,MATH 20C,A03,093476,Staff,0,0,35,35
1656259908713,MATH 20C,B01,083762,Bach; Quang Tran,1,0,30,29
1656259914740,MATH 20D,A01,083765,Tran; Brian Kha,1,0,30,29
1656259914740,MATH 20D,A02,083766,Tran; Brian Kha,0,1,30,30
1656259914740,MATH 20D,A03,083767,Tran; Brian Kha,2,0,30,28
1656259920769,MATH 20E,A01,083771,Ganguly; Soumya,3,0,32,29
1656259920769,MATH 20E,A02,083772,Ganguly; Soumya,0,0,32,32
1656259920769,MATH 20E,B01,083773,Ciotti; Benjamin,16,0,35,19
1656259920769,MATH 20E,B02,083774,Ciotti; Benjamin,15,0,35,20
1656259926809,MATH 103A,A01,083777,Greenfeld; Be'Eri,1,0,36,35
1656259926809,MATH 103A,A02,083778,Greenfeld; Be'Eri,1,0,36,35
1656259926809,MATH 103A,A03,093561,Staff,5,0,36,31
1656259926809,MATH 103A,B01,083779,Greenfeld; Be'Eri,8,0,36,28
1656259926809,MATH 103A,B02,083780,Greenfeld; Be'Eri,1,0,36,35
1656259926809,MATH 103A,B03,093562,Staff,0,0,36,36
1656259932853,MATH 105,A01,085443,Carter; Anne Toulson,5,0,35,30
1656259932853,MATH 105,A02,093477,Staff,14,0,35,21
1656259938881,MATH 109,A01,083213,Ganzberger; Geoffrey Michael,0,0,34,34
1656259938881,MATH 109,A02,083214,Ganzberger; Geoffrey Michael,0,0,34,34
1656259938881,MATH 109,A03,093478,Staff,1,0,34,33
1656259938881,MATH 109,B01,083215,Ganzberger; Geoffrey Michael,4,0,32,28
1656259938881,MATH 109,B02,083216,Ganzberger; Geoffrey Michael,1,0,32,31
1656259938881,MATH 109,B03,093479,Staff,3,0,32,29
1656259944912,MATH 142A,A01,083219,Chow; Bennett,2,0,32,30
1656259944912,MATH 142A,A02,083220,Chow; Bennett,8,0,32,24
1656259944912,MATH 142A,A03,093480,Staff,5,0,32,27
1656259944912,MATH 142A,B03,093481,Staff,3,0,32,29
1656259944912,MATH 142A,B04,093558,Staff,6,0,32,26
1656259944912,MATH 142A,B05,093559,Staff,0,0,32,32
1656259950958,MATH 193A,A01,083224,Rotar; Vladimir,0,1,34,34
1656259950958,MATH 193A,A02,083225,Rotar; Vladimir,0,0,34,34
1656259950958,MATH 193A,A03,083781,Rotar; Vladimir,0,0,34,34
1656259950958,MATH 193A,A04,083782,Rotar; Vladimir,6,0,34,28
1656259950958,MATH 193A,A05,093482,Rotar; Vladimir,0,0,34,34
1656259956986,MATH 197,001,091859,McAuley; Julian John,9999,0,9999,0
1656259956986,MATH 197,002,095566,Kedlaya; Kiran S.,9997,0,9999,2
1656259956986,MATH 197,003,095567,Xiao; Ming,9999,0,9999,0
1656259956986,MATH 197,004,095571,Perols; Johan Lars,9998,0,9999,1
1656259964064,COGS 9,A01,083615,Shannon; Kyle Michael,3,0,75,72
1656259970094,COGS 11,A01,083617,Boyle; Mary E. T.,14,0,48,34
1656259976136,COGS 13,A01,083071,Bastos; Amalia Pinkusfeld,5,0,71,66
1656259982167,COGS 14A,A01,092681,Semenuks; Arturs,1,12,100,99
1656259988194,COGS 14B,A01,083073,Cheng; Tzu-Han,7,0,63,56
1656259994216,COGS 17,A01,092677,Semenuks; Arturs,8,0,81,73
1656260000238,COGS 100,A01,083619,Allen; Michael Gordon,2,0,70,68
1656260006262,COGS 101A,A01,083621,Davis; Joshua Daniel,4,0,68,64
1656260012286,COGS 101B,A01,091572,Allen; Michael Gordon,4,0,65,61
1656260018314,COGS 101C,A01,083625,Delgado; Tania,10,0,35,25
1656260024338,COGS 107A,A01,083627,Boyle; Mary E. T.,0,0,60,60
1656260030447,COGS 118A,A01,083075,Gupta; Anjum,8,0,76,68
1656260036474,CSE 3,A50,083646,Miranda; Gregory Joseph,18,0,50,32
1656260042512,CSE 8A,A50,083650,Miranda; Gregory Joseph,2,2,56,54
1656260048535,CSE 11,A01,083080,Cao; Yingjun,0,49,40,40
1656260054571,CSE 12,A01,083652,Krause-Levy; Sophia Louisa,5,1,120,115
1656260060594,CSE 15L,A01,083654,Morris; Justin Loren,2,0,50,48
1656260060594,CSE 15L,A02,083655,Morris; Justin Loren,4,0,50,46
1656260066627,CSE 20,A01,083657,Tran; Khoa Dang,30,0,80,50
1656260072662,CSE 21,A01,095574,Bach; Quang Tran,23,0,48,25
1656260078686,CSE 30,A01,083084,Eldon; John,2,6,80,78
1656260078686,CSE 30,B01,095061,Bhaskar; Nishant,0,1,50,50
1656260084709,CSE 100,A01,083659,Cao; Yingjun,1,18,70,69
1656260090736,CSE 134B,A01,083661,Powell; Thomas Allan,5,0,100,95
1656260096763,CSE 140,A01,083663,Gungor; Onat,9,0,85,76
1656260102786,CSE 140L,A01,083088,Eldon; John,8,0,100,92
1656260108812,CSE 175,A01,083665,Kumar; Rakesh,0,0,25,25
1656260114840,CSE 190,A00,092507,Dubnov; Shlomo,3,0,20,17
1656260120877,ECE 45,A01,083139,Congero; Spencer William,1,0,75,74
1656260126917,ECE 65,A50,083695,Saad; Andrew S,9,0,30,21
1656260126917,ECE 65,A51,095125,Staff,24,0,26,2
1656260132944,ECE 109,A01,091882,Touri; Behrouz,0,1,70,70
1656260138970,ECE 180,A00,083140,Abi Samra; Nicholas Camill,1,0,30,29
1656260138970,ECE 180,B00,083141,Abi Samra; Nicholas Camill,0,4,30,30
1656260144997,MATH 10A,A01,083735,Patchell; Gregory David,0,0,30,30
1656260144997,MATH 10A,A02,083736,Patchell; Gregory David,22,0,30,8
1656260144997,MATH 10A,A03,083737,Patchell; Gregory David,16,0,30,14
1656260151022,MATH 10B,A01,083207,Lim; Seonhee,0,0,34,34
1656260151022,MATH 10B,A02,083208,Lim; Seonhee,7,0,35,28
1656260151022,MATH 10B,A03,093472,Staff,1,0,34,33
1656260151022,MATH 10B,B01,083739,Sinha; Shubham,11,0,30,19
1656260157053,MATH 18,A01,083743,Cinel; Cameron Alexander,7,0,30,23
1656260157053,MATH 18,A02,083744,Cinel; Cameron Alexander,9,0,30,21
1656260157053,MATH 18,A03,083745,Cinel; Cameron Alexander,5,0,30,25
1656260157053,MATH 18,B01,083748,Rideout; David Porter,1,0,36,35
1656260157053,MATH 18,B02,083749,Rideout; David Porter,0,0,36,36
1656260157053,MATH 18,B03,083750,Rideout; David Porter,0,0,36,36
1656260157053,MATH 18,B04,083751,Rideout; David Porter,0,1,36,36
1656260157053,MATH 18,B05,093473,Rideout; David Porter,0,0,36,36
1656260157053,MATH 18,B06,093474,Rideout; David Porter,3,0,36,33
1656260163080,MATH 20A,A01,083754,Zheng; Zequn,11,0,40,29
1656260169105,MATH 20B,A01,083756,Briones; Jor-el Thomas Caparas,0,0,36,36
1656260169105,MATH 20B,A02,083757,Briones; Jor-el Thomas Caparas,0,0,36,36
1656260169105,MATH 20B,A03,093475,Staff,0,0,36,36
1656260175141,MATH 20C,A01,083760,Briones; Jor-el Thomas Caparas,0,0,35,35
1656260175141,MATH 20C,A02,083761,Briones; Jor-el Thomas Caparas,9,1,35,26
1656260175141,MATH 20C,A03,093476,Staff,0,0,35,35
1656260175141,MATH 20C,B01,083762,Bach; Quang Tran,1,0,30,29
1656260181189,MATH 20D,A01,083765,Tran; Brian Kha,1,0,30,29
1656260181189,MATH 20D,A02,083766,Tran; Brian Kha,0,1,30,30
1656260181189,MATH 20D,A03,083767,Tran; Brian Kha,2,0,30,28
1656260187214,MATH 20E,A01,083771,Ganguly; Soumya,3,0,32,29
1656260187214,MATH 20E,A02,083772,Ganguly; Soumya,0,0,32,32
1656260187214,MATH 20E,B01,083773,Ciotti; Benjamin,16,0,35,19
1656260187214,MATH 20E,B02,083774,Ciotti; Benjamin,15,0,35,20
1656260193244,MATH 103A,A01,083777,Greenfeld; Be'Eri,1,0,36,35
1656260193244,MATH 103A,A02,083778,Greenfeld; Be'Eri,1,0,36,35
1656260193244,MATH 103A,A03,093561,Staff,5,0,36,31
1656260193244,MATH 103A,B01,083779,Greenfeld; Be'Eri,8,0,36,28
1656260193244,MATH 103A,B02,083780,Greenfeld; Be'Eri,1,0,36,35
1656260193244,MATH 103A,B03,093562,Staff,0,0,36,36
1656260199293,MATH 105,A01,085443,Carter; Anne Toulson,5,0,35,30
1656260199293,MATH 105,A02,093477,Staff,14,0,35,21
1656260205317,MATH 109,A01,083213,Ganzberger; Geoffrey Michael,0,0,34,34
1656260205317,MATH 109,A02,083214,Ganzberger; Geoffrey Michael,0,0,34,34
1656260205317,MATH 109,A03,093478,Staff,1,0,34,33
1656260205317,MATH 109,B01,083215,Ganzberger; Geoffrey Michael,4,0,32,28
1656260205317,MATH 109,B02,083216,Ganzberger; Geoffrey Michael,1,0,32,31
1656260205317,MATH 109,B03,093479,Staff,3,0,32,29
1656260211352,MATH 142A,A01,083219,Chow; Bennett,2,0,32,30
1656260211352,MATH 142A,A02,083220,Chow; Bennett,8,0,32,24
1656260211352,MATH 142A,A03,093480,Staff,5,0,32,27
1656260211352,MATH 142A,B03,093481,Staff,3,0,32,29
1656260211352,MATH 142A,B04,093558,Staff,6,0,32,26
1656260211352,MATH 142A,B05,093559,Staff,0,0,32,32
1656260217377,MATH 193A,A01,083224,Rotar; Vladimir,0,1,34,34
1656260217377,MATH 193A,A02,083225,Rotar; Vladimir,0,0,34,34
1656260217377,MATH 193A,A03,083781,Rotar; Vladimir,0,0,34,34
1656260217377,MATH 193A,A04,083782,Rotar; Vladimir,6,0,34,28
1656260217377,MATH 193A,A05,093482,Rotar; Vladimir,0,0,34,34
1656260223407,MATH 197,001,091859,McAuley; Julian John,9999,0,9999,0
1656260223407,MATH 197,002,095566,Kedlaya; Kiran S.,9997,0,9999,2
1656260223407,MATH 197,003,095567,Xiao; Ming,9999,0,9999,0
1656260223407,MATH 197,004,095571,Perols; Johan Lars,9998,0,9999,1
1656260230476,COGS 9,A01,083615,Shannon; Kyle Michael,3,0,75,72
1656260236501,COGS 11,A01,083617,Boyle; Mary E. T.,14,0,48,34
1656260242526,COGS 13,A01,083071,Bastos; Amalia Pinkusfeld,5,0,71,66
1656260248547,COGS 14A,A01,092681,Semenuks; Arturs,1,12,100,99
1656260254571,COGS 14B,A01,083073,Cheng; Tzu-Han,7,0,63,56
1656260260594,COGS 17,A01,092677,Semenuks; Arturs,8,0,81,73
1656260266632,COGS 100,A01,083619,Allen; Michael Gordon,2,0,70,68
1656260272663,COGS 101A,A01,083621,Davis; Joshua Daniel,4,0,68,64
1656260278690,COGS 101B,A01,091572,Allen; Michael Gordon,4,0,65,61
1656260284729,COGS 101C,A01,083625,Delgado; Tania,10,0,35,25
1656260290753,COGS 107A,A01,083627,Boyle; Mary E. T.,0,0,60,60
1656260296777,COGS 118A,A01,083075,Gupta; Anjum,8,0,76,68
1656260302805,CSE 3,A50,083646,Miranda; Gregory Joseph,18,0,50,32
1656260308841,CSE 8A,A50,083650,Miranda; Gregory Joseph,2,2,56,54
1656260314866,CSE 11,A01,083080,Cao; Yingjun,0,49,40,40
1656260320889,CSE 12,A01,083652,Krause-Levy; Sophia Louisa,5,1,120,115
1656260326916,CSE 15L,A01,083654,Morris; Justin Loren,2,0,50,48
1656260326916,CSE 15L,A02,083655,Morris; Justin Loren,4,0,50,46
1656260332941,CSE 20,A01,083657,Tran; Khoa Dang,30,0,80,50
1656260338966,CSE 21,A01,095574,Bach; Quang Tran,23,0,48,25
1656260344990,CSE 30,A01,083084,Eldon; John,2,6,80,78
1656260344990,CSE 30,B01,095061,Bhaskar; Nishant,0,1,50,50
1656260351036,CSE 100,A01,083659,Cao; Yingjun,1,18,70,69
1656260357068,CSE 134B,A01,083661,Powell; Thomas Allan,5,0,100,95
1656260363091,CSE 140,A01,083663,Gungor; Onat,9,0,85,76
1656260369121,CSE 140L,A01,083088,Eldon; John,8,0,100,92
1656260375149,CSE 175,A01,083665,Kumar; Rakesh,0,0,25,25
1656260381174,CSE 190,A00,092507,Dubnov; Shlomo,3,0,20,17
1656260387214,ECE 45,A01,083139,Congero; Spencer William,1,0,75,74
1656260393270,ECE 65,A50,083695,Saad; Andrew S,9,0,30,21
1656260393270,ECE 65,A51,095125,Staff,24,0,26,2
1656260399315,ECE 109,A01,091882,Touri; Behrouz,0,1,70,70
1656260405380,ECE 180,A00,083140,Abi Samra; Nicholas Camill,1,0,30,29
1656260405380,ECE 180,B00,083141,Abi Samra; Nicholas Camill,0,4,30,30
1656260411423,MATH 10A,A01,083735,Patchell; Gregory David,0,0,30,30
1656260411423,MATH 10A,A02,083736,Patchell; Gregory David,22,0,30,8
1656260411423,MATH 10A,A03,083737,Patchell; Gregory David,16,0,30,14
1656260417484,MATH 10B,A01,083207,Lim; Seonhee,0,0,34,34
1656260417484,MATH 10B,A02,083208,Lim; Seonhee,7,0,35,28
1656260417484,MATH 10B,A03,093472,Staff,1,0,34,33
1656260417484,MATH 10B,B01,083739,Sinha; Shubham,11,0,30,19
1656260423511,MATH 18,A01,083743,Cinel; Cameron Alexander,7,0,30,23
1656260423511,MATH 18,A02,083744,Cinel; Cameron Alexander,9,0,30,21
1656260423511,MATH 18,A03,083745,Cinel; Cameron Alexander,5,0,30,25
1656260423511,MATH 18,B01,083748,Rideout; David Porter,1,0,36,35
1656260423511,MATH 18,B02,083749,Rideout; David Porter,0,0,36,36
1656260423511,MATH 18,B03,083750,Rideout; David Porter,0,0,36,36
1656260423511,MATH 18,B04,083751,Rideout; David Porter,0,1,36,36
1656260423511,MATH 18,B05,093473,Rideout; David Porter,0,0,36,36
1656260423511,MATH 18,B06,093474,Rideout; David Porter,3,0,36,33
1656260429545,MATH 20A,A01,083754,Zheng; Zequn,11,0,40,29
1656260435605,MATH 20B,A01,083756,Briones; Jor-el Thomas Caparas,0,0,36,36
1656260435605,MATH 20B,A02,083757,Briones; Jor-el Thomas Caparas,0,0,36,36
1656260435605,MATH 20B,A03,093475,Staff,0,0,36,36
1656260441632,MATH 20C,A01,083760,Briones; Jor-el Thomas Caparas,0,0,35,35
1656260441632,MATH 20C,A02,083761,Briones; Jor-el Thomas Caparas,9,1,35,26
1656260441632,MATH 20C,A03,093476,Staff,0,0,35,35
1656260441632,MATH 20C,B01,083762,Bach; Quang Tran,1,0,30,29
1656260447657,MATH 20D,A01,083765,Tran; Brian Kha,1,0,30,29
1656260447657,MATH 20D,A02,083766,Tran; Brian Kha,0,1,30,30
1656260447657,MATH 20D,A03,083767,Tran; Brian Kha,2,0,30,28
1656260453686,MATH 20E,A01,083771,Ganguly; Soumya,3,0,32,29
1656260453686,MATH 20E,A02,083772,Ganguly; Soumya,0,0,32,32
1656260453686,MATH 20E,B01,083773,Ciotti; Benjamin,16,0,35,19
1656260453686,MATH 20E,B02,083774,Ciotti; Benjamin,15,0,35,20
1656260459728,MATH 103A,A01,083777,Greenfeld; Be'Eri,1,0,36,35
1656260459728,MATH 103A,A02,083778,Greenfeld; Be'Eri,1,0,36,35
1656260459728,MATH 103A,A03,093561,Staff,5,0,36,31
1656260459728,MATH 103A,B01,083779,Greenfeld; Be'Eri,8,0,36,28
1656260459728,MATH 103A,B02,083780,Greenfeld; Be'Eri,1,0,36,35
1656260459728,MATH 103A,B03,093562,Staff,0,0,36,36
1656260465757,MATH 105,A01,085443,Carter; Anne Toulson,5,0,35,30
1656260465757,MATH 105,A02,093477,Staff,14,0,35,21
1656260471802,MATH 109,A01,083213,Ganzberger; Geoffrey Michael,0,0,34,34
1656260471802,MATH 109,A02,083214,Ganzberger; Geoffrey Michael,0,0,34,34
1656260471802,MATH 109,A03,093478,Staff,1,0,34,33
1656260471802,MATH 109,B01,083215,Ganzberger; Geoffrey Michael,4,0,32,28
1656260471802,MATH 109,B02,083216,Ganzberger; Geoffrey Michael,1,0,32,31
1656260471802,MATH 109,B03,093479,Staff,3,0,32,29
1656260477849,MATH 142A,A01,083219,Chow; Bennett,2,0,32,30
1656260477849,MATH 142A,A02,083220,Chow; Bennett,8,0,32,24
1656260477849,MATH 142A,A03,093480,Staff,5,0,32,27
1656260477849,MATH 142A,B03,093481,Staff,3,0,32,29
1656260477849,MATH 142A,B04,093558,Staff,6,0,32,26
1656260477849,MATH 142A,B05,093559,Staff,0,0,32,32
1656260483892,MATH 193A,A01,083224,Rotar; Vladimir,0,1,34,34
1656260483892,MATH 193A,A02,083225,Rotar; Vladimir,0,0,34,34
1656260483892,MATH 193A,A03,083781,Rotar; Vladimir,0,0,34,34
1656260483892,MATH 193A,A04,083782,Rotar; Vladimir,6,0,34,28
1656260483892,MATH 193A,A05,093482,Rotar; Vladimir,0,0,34,34
1656260489916,MATH 197,001,091859,McAuley; Julian John,9999,0,9999,0
1656260489916,MATH 197,002,095566,Kedlaya; Kiran S.,9997,0,9999,2
1656260489916,MATH 197,003,095567,Xiao; Ming,9999,0,9999,0
1656260489916,MATH 197,004,095571,Perols; Johan Lars,9998,0,9999,1
1656260496980,COGS 9,A01,083615,Shannon; Kyle Michael,3,0,75,72
1656260503004,COGS 11,A01,083617,Boyle; Mary E. T.,14,0,48,34
1656260509031,COGS 13,A01,083071,Bastos; Amalia Pinkusfeld,5,0,71,66
1656260515061,COGS 14A,A01,092681,Semenuks; Arturs,1,12,100,99
1656260521101,COGS 14B,A01,083073,Cheng; Tzu-Han,7,0,63,56
1656260527137,COGS 17,A01,092677,Semenuks; Arturs,8,0,81,73
1656260533166,COGS 100,A01,083619,Allen; Michael Gordon,2,0,70,68
1656260539189,COGS 101A,A01,083621,Davis; Joshua Daniel,4,0,68,64
1656260545217,COGS 101B,A01,091572,Allen; Michael Gordon,4,0,65,61
1656260551252,COGS 101C,A01,083625,Delgado; Tania,10,0,35,25
1656260557280,COGS 107A,A01,083627,Boyle; Mary E. T.,0,0,60,60
1656260563303,COGS 118A,A01,083075,Gupta; Anjum,8,0,76,68
1656260569325,CSE 3,A50,083646,Miranda; Gregory Joseph,18,0,50,32
1656260575354,CSE 8A,A50,083650,Miranda; Gregory Joseph,2,2,56,54
1656260581384,CSE 11,A01,083080,Cao; Yingjun,0,49,40,40
1656260587417,CSE 12,A01,083652,Krause-Levy; Sophia Louisa,5,1,120,115
1656260593451,CSE 15L,A01,083654,Morris; Justin Loren,2,0,50,48
1656260593451,CSE 15L,A02,083655,Morris; Justin Loren,4,0,50,46
1656260599487,CSE 20,A01,083657,Tran; Khoa Dang,30,0,80,50
1656260605509,CSE 21,A01,095574,Bach; Quang Tran,23,0,48,25
1656260611536,CSE 30,A01,083084,Eldon; John,2,6,80,78
1656260611536,CSE 30,B01,095061,Bhaskar; Nishant,0,1,50,50
1656260617558,CSE 100,A01,083659,Cao; Yingjun,1,18,70,69
1656260623581,CSE 134B,A01,083661,Powell; Thomas Allan,5,0,100,95
1656260629722,CSE 140,A01,083663,Gungor; Onat,9,0,85,76
1656260635759,CSE 140L,A01,083088,Eldon; John,8,0,100,92
1656260641795,CSE 175,A01,083665,Kumar; Rakesh,0,0,25,25
1656260647828,CSE 190,A00,092507,Dubnov; Shlomo,3,0,20,17
1656260653876,ECE 45,A01,083139,Congero; Spencer William,1,0,75,74
1656260659904,ECE 65,A50,083695,Saad; Andrew S,9,0,30,21
1656260659904,ECE 65,A51,095125,Staff,24,0,26,2
1656260665939,ECE 109,A01,091882,Touri; Behrouz,0,1,70,70
1656260671984,ECE 180,A00,083140,Abi Samra; Nicholas Camill,1,0,30,29
1656260671984,ECE 180,B00,083141,Abi Samra; Nicholas Camill,0,4,30,30
1656260678022,MATH 10A,A01,083735,Patchell; Gregory David,0,0,30,30
1656260678022,MATH 10A,A02,083736,Patchell; Gregory David,22,0,30,8
1656260678022,MATH 10A,A03,083737,Patchell; Gregory David,16,0,30,14
1656260684047,MATH 10B,A01,083207,Lim; Seonhee,0,0,34,34
1656260684047,MATH 10B,A02,083208,Lim; Seonhee,7,0,35,28
1656260684047,MATH 10B,A03,093472,Staff,1,0,34,33
1656260684047,MATH 10B,B01,083739,Sinha; Shubham,11,0,30,19
1656260690072,MATH 18,A01,083743,Cinel; Cameron Alexander,7,0,30,23
1656260690072,MATH 18,A02,083744,Cinel; Cameron Alexander,9,0,30,21
1656260690072,MATH 18,A03,083745,Cinel; Cameron Alexander,5,0,30,25
1656260690072,MATH 18,B01,083748,Rideout; David Porter,1,0,36,35
1656260690072,MATH 18,B02,083749,Rideout; David Porter,0,0,36,36
1656260690072,MATH 18,B03,083750,Rideout; David Porter,0,0,36,36
1656260690072,MATH 18,B04,083751,Rideout; David Porter,0,1,36,36
1656260690072,MATH 18,B05,093473,Rideout; David Porter,0,0,36,36
1656260690072,MATH 18,B06,093474,Rideout; David Porter,3,0,36,33
1656260696104,MATH 20A,A01,083754,Zheng; Zequn,11,0,40,29
1656260702136,MATH 20B,A01,083756,Briones; Jor-el Thomas Caparas,0,0,36,36
1656260702136,MATH 20B,A02,083757,Briones; Jor-el Thomas Caparas,0,0,36,36
1656260702136,MATH 20B,A03,093475,Staff,0,0,36,36
1656260708164,MATH 20C,A01,083760,Briones; Jor-el Thomas Caparas,0,0,35,35
1656260708164,MATH 20C,A02,083761,Briones; Jor-el Thomas Caparas,9,1,35,26
1656260708164,MATH 20C,A03,093476,Staff,0,0,35,35
1656260708164,MATH 20C,B01,083762,Bach; Quang Tran,1,0,30,29
1656260714197,MATH 20D,A01,083765,Tran; Brian Kha,1,0,30,29
1656260714197,MATH 20D,A02,083766,Tran; Brian Kha,0,1,30,30
1656260714197,MATH 20D,A03,083767,Tran; Brian Kha,2,0,30,28
1656260720230,MATH 20E,A01,083771,Ganguly; Soumya,3,0,32,29
1656260720230,MATH 20E,A02,083772,Ganguly; Soumya,0,0,32,32
1656260720230,MATH 20E,B01,083773,Ciotti; Benjamin,16,0,35,19
1656260720230,MATH 20E,B02,083774,Ciotti; Benjamin,15,0,35,20
1656260726264,MATH 103A,A01,083777,Greenfeld; Be'Eri,1,0,36,35
1656260726264,MATH 103A,A02,083778,Greenfeld; Be'Eri,1,0,36,35
1656260726264,MATH 103A,A03,093561,Staff,5,0,36,31
1656260726264,MATH 103A,B01,083779,Greenfeld; Be'Eri,8,0,36,28
1656260726264,MATH 103A,B02,083780,Greenfeld; Be'Eri,1,0,36,35
1656260726264,MATH 103A,B03,093562,Staff,0,0,36,36
1656260732306,MATH 105,A01,085443,Carter; Anne Toulson,5,0,35,30
1656260732306,MATH 105,A02,093477,Staff,14,0,35,21
1656260738355,MATH 109,A01,083213,Ganzberger; Geoffrey Michael,0,0,34,34
1656260738355,MATH 109,A02,083214,Ganzberger; Geoffrey Michael,0,0,34,34
1656260738355,MATH 109,A03,093478,Staff,1,0,34,33
1656260738355,MATH 109,B01,083215,Ganzberger; Geoffrey Michael,4,0,32,28
1656260738355,MATH 109,B02,083216,Ganzberger; Geoffrey Michael,1,0,32,31
1656260738355,MATH 109,B03,093479,Staff,3,0,32,29
1656260744385,MATH 142A,A01,083219,Chow; Bennett,2,0,32,30
1656260744385,MATH 142A,A02,083220,Chow; Bennett,8,0,32,24
1656260744385,MATH 142A,A03,093480,Staff,5,0,32,27
1656260744385,MATH 142A,B03,093481,Staff,3,0,32,29
1656260744385,MATH 142A,B04,093558,Staff,6,0,32,26
1656260744385,MATH 142A,B05,093559,Staff,0,0,32,32
1656260750428,MATH 193A,A01,083224,Rotar; Vladimir,0,1,34,34
1656260750428,MATH 193A,A02,083225,Rotar; Vladimir,0,0,34,34
1656260750428,MATH 193A,A03,083781,Rotar; Vladimir,0,0,34,34
1656260750428,MATH 193A,A04,083782,Rotar; Vladimir,6,0,34,28
1656260750428,MATH 193A,A05,093482,Rotar; Vladimir,0,0,34,34
1656260756469,MATH 197,001,091859,McAuley; Julian John,9999,0,9999,0
1656260756469,MATH 197,002,095566,Kedlaya; Kiran S.,9997,0,9999,2
1656260756469,MATH 197,003,095567,Xiao; Ming,9999,0,9999,0
1656260756469,MATH 197,004,095571,Perols; Johan Lars,9998,0,9999,1
1656260763537,COGS 9,A01,083615,Shannon; Kyle Michael,3,0,75,72
1656260769571,COGS 11,A01,083617,Boyle; Mary E. T.,14,0,48,34
1656260775595,COGS 13,A01,083071,Bastos; Amalia Pinkusfeld,5,0,71,66
1656260781620,COGS 14A,A01,092681,Semenuks; Arturs,1,12,100,99
1656260787660,COGS 14B,A01,083073,Cheng; Tzu-Han,7,0,63,56
1656260793704,COGS 17,A01,092677,Semenuks; Arturs,8,0,81,73
1656260799754,COGS 100,A01,083619,Allen; Michael Gordon,2,0,70,68
1656260805797,COGS 101A,A01,083621,Davis; Joshua Daniel,4,0,68,64
1656260811831,COGS 101B,A01,091572,Allen; Michael Gordon,4,0,65,61
1656260817858,COGS 101C,A01,083625,Delgado; Tania,10,0,35,25
1656260823885,COGS 107A,A01,083627,Boyle; Mary E. T.,0,0,60,60
1656260829909,COGS 118A,A01,083075,Gupta; Anjum,8,0,76,68
1656260835948,CSE 3,A50,083646,Miranda; Gregory Joseph,18,0,50,32
1656260841990,CSE 8A,A50,083650,Miranda; Gregory Joseph,2,2,56,54
1656260848024,CSE 11,A01,083080,Cao; Yingjun,0,49,40,40
1656260854052,CSE 12,A01,083652,Krause-Levy; Sophia Louisa,5,1,120,115
1656260860077,CSE 15L,A01,083654,Morris; Justin Loren,2,0,50,48
1656260860077,CSE 15L,A02,083655,Morris; Justin Loren,4,0,50,46
1656260866105,CSE 20,A01,083657,Tran; Khoa Dang,30,0,80,50
1656260872141,CSE 21,A01,095574,Bach; Quang Tran,23,0,48,25
1656260878166,CSE 30,A01,083084,Eldon; John,2,6,80,78
1656260878166,CSE 30,B01,095061,Bhaskar; Nishant,0,1,50,50
1656260884212,CSE 100,A01,083659,Cao; Yingjun,1,18,70,69
1656260890253,CSE 134B,A01,083661,Powell; Thomas Allan,5,0,100,95
1656260896302,CSE 140,A01,083663,Gungor; Onat,9,0,85,76
1656260902325,CSE 140L,A01,083088,Eldon; John,8,0,100,92
1656260908362,CSE 175,A01,083665,Kumar; Rakesh,0,0,25,25
1656260914393,CSE 190,A00,092507,Dubnov; Shlomo,3,0,20,17
1656260920429,ECE 45,A01,083139,Congero; Spencer William,1,0,75,74
1656260926462,ECE 65,A50,083695,Saad; Andrew S,9,0,30,21
1656260926462,ECE 65,A51,095125,Staff,24,0,26,2
1656260932506,ECE 109,A01,091882,Touri; Behrouz,0,1,70,70
1656260938531,ECE 180,A00,083140,Abi Samra; Nicholas Camill,1,0,30,29
1656260938531,ECE 180,B00,083141,Abi Samra; Nicholas Camill,0,4,30,30
1656260944575,MATH 10A,A01,083735,Patchell; Gregory David,0,0,30,30
1656260944575,MATH 10A,A02,083736,Patchell; Gregory David,22,0,30,8
1656260944575,MATH 10A,A03,083737,Patchell; Gregory David,16,0,30,14
1656260950598,MATH 10B,A01,083207,Lim; Seonhee,0,0,34,34
1656260950598,MATH 10B,A02,083208,Lim; Seonhee,7,0,35,28
1656260950598,MATH 10B,A03,093472,Staff,1,0,34,33
1656260950598,MATH 10B,B01,083739,Sinha; Shubham,11,0,30,19
1656260956652,MATH 18,A01,083743,Cinel; Cameron Alexander,7,0,30,23
1656260956652,MATH 18,A02,083744,Cinel; Cameron Alexander,9,0,30,21
1656260956652,MATH 18,A03,083745,Cinel; Cameron Alexander,5,0,30,25
1656260956652,MATH 18,B01,083748,Rideout; David Porter,1,0,36,35
1656260956652,MATH 18,B02,083749,Rideout; David Porter,0,0,36,36
1656260956652,MATH 18,B03,083750,Rideout; David Porter,0,0,36,36
1656260956652,MATH 18,B04,083751,Rideout; David Porter,0,1,36,36
1656260956652,MATH 18,B05,093473,Rideout; David Porter,0,0,36,36
1656260956652,MATH 18,B06,093474,Rideout; David Porter,3,0,36,33
1656260962685,MATH 20A,A01,083754,Zheng; Zequn,11,0,40,29
1656260968719,MATH 20B,A01,083756,Briones; Jor-el Thomas Caparas,0,0,36,36
1656260968719,MATH 20B,A02,083757,Briones; Jor-el Thomas Caparas,0,0,36,36
1656260968719,MATH 20B,A03,093475,Staff,0,0,36,36
1656260974744,MATH 20C,A01,083760,Briones; Jor-el Thomas Caparas,0,0,35,35
1656260974744,MATH 20C,A02,083761,Briones; Jor-el Thomas Caparas,9,1,35,26
1656260974744,MATH 20C,A03,093476,Staff,0,0,35,35
1656260974744,MATH 20C,B01,083762,Bach; Quang Tran,1,0,30,29
1656260980768,MATH 20D,A01,083765,Tran; Brian Kha,1,0,30,29
1656260980768,MATH 20D,A02,083766,Tran; Brian Kha,0,1,30,30
1656260980768,MATH 20D,A03,083767,Tran; Brian Kha,2,0,30,28
1656260986801,MATH 20E,A01,083771,Ganguly; Soumya,3,0,32,29
1656260986801,MATH 20E,A02,083772,Ganguly; Soumya,0,0,32,32
1656260986801,MATH 20E,B01,083773,Ciotti; Benjamin,16,0,35,19
1656260986801,MATH 20E,B02,083774,Ciotti; Benjamin,15,0,35,20
1656260992826,MATH 103A,A01,083777,Greenfeld; Be'Eri,1,0,36,35
1656260992826,MATH 103A,A02,083778,Greenfeld; Be'Eri,1,0,36,35
1656260992826,MATH 103A,A03,093561,Staff,5,0,36,31
1656260992826,MATH 103A,B01,083779,Greenfeld; Be'Eri,8,0,36,28
1656260992826,MATH 103A,B02,083780,Greenfeld; Be'Eri,1,0,36,35
1656260992826,MATH 103A,B03,093562,Staff,0,0,36,36
1656260998869,MATH 105,A01,085443,Carter; Anne Toulson,5,0,35,30
1656260998869,MATH 105,A02,093477,Staff,14,0,35,21
1656261004898,MATH 109,A01,083213,Ganzberger; Geoffrey Michael,0,0,34,34
1656261004898,MATH 109,A02,083214,Ganzberger; Geoffrey Michael,0,0,34,34
1656261004898,MATH 109,A03,093478,Staff,1,0,34,33
1656261004898,MATH 109,B01,083215,Ganzberger; Geoffrey Michael,4,0,32,28
1656261004898,MATH 109,B02,083216,Ganzberger; Geoffrey Michael,1,0,32,31
1656261004898,MATH 109,B03,093479,Staff,3,0,32,29
1656261010923,MATH 142A,A01,083219,Chow; Bennett,2,0,32,30
1656261010923,MATH 142A,A02,083220,Chow; Bennett,8,0,32,24
1656261010923,MATH 142A,A03,093480,Staff,5,0,32,27
1656261010923,MATH 142A,B03,093481,Staff,3,0,32,29
1656261010923,MATH 142A,B04,093558,Staff,6,0,32,26
1656261010923,MATH 142A,B05,093559,Staff,0,0,32,32
1656261016947,MATH 193A,A01,083224,Rotar; Vladimir,0,1,34,34
1656261016947,MATH 193A,A02,083225,Rotar; Vladimir,0,0,34,34
1656261016947,MATH 193A,A03,083781,Rotar; Vladimir,0,0,34,34
1656261016947,MATH 193A,A04,083782,Rotar; Vladimir,6,0,34,28
1656261016947,MATH 193A,A05,093482,Rotar; Vladimir,0,0,34,34
1656261022972,MATH 197,001,091859,McAuley; Julian John,9999,0,9999,0
1656261022972,MATH 197,002,095566,Kedlaya; Kiran S.,9997,0,9999,2
1656261022972,MATH 197,003,095567,Xiao; Ming,9999,0,9999,0
1656261022972,MATH 197,004,095571,Perols; Johan Lars,9998,0,9999,1
1656261030037,COGS 9,A01,083615,Shannon; Kyle Michael,3,0,75,72
1656261036076,COGS 11,A01,083617,Boyle; Mary E. T.,14,0,48,34
1656261042100,COGS 13,A01,083071,Bastos; Amalia Pinkusfeld,5,0,71,66
1656261048123,COGS 14A,A01,092681,Semenuks; Arturs,1,12,100,99
1656261054147,COGS 14B,A01,083073,Cheng; Tzu-Han,7,0,63,56
1656261060171,COGS 17,A01,092677,Semenuks; Arturs,8,0,81,73
1656261066199,COGS 100,A01,083619,Allen; Michael Gordon,2,0,70,68
1656261072223,COGS 101A,A01,083621,Davis; Joshua Daniel,4,0,68,64
1656261078248,COGS 101B,A01,091572,Allen; Michael Gordon,4,0,65,61
1656261084279,COGS 101C,A01,083625,Delgado; Tania,10,0,35,25
1656261090315,COGS 107A,A01,083627,Boyle; Mary E. T.,0,0,60,60
1656261096340,COGS 118A,A01,083075,Gupta; Anjum,8,0,76,68
1656261102372,CSE 3,A50,083646,Miranda; Gregory Joseph,18,0,50,32
1656261108396,CSE 8A,A50,083650,Miranda; Gregory Joseph,2,2,56,54
1656261114420,CSE 11,A01,083080,Cao; Yingjun,0,49,40,40
1656261120445,CSE 12,A01,083652,Krause-Levy; Sophia Louisa,5,1,120,115
1656261126473,CSE 15L,A01,083654,Morris; Justin Loren,2,0,50,48
1656261126473,CSE 15L,A02,083655,Morris; Justin Loren,4,0,50,46
1656261132496,CSE 20,A01,083657,Tran; Khoa Dang,30,0,80,50
1656261138540,CSE 21,A01,095574,Bach; Quang Tran,23,0,48,25
1656261144568,CSE 30,A01,083084,Eldon; John,2,6,80,78
1656261144568,CSE 30,B01,095061,Bhaskar; Nishant,0,1,50,50
1656261150597,CSE 100,A01,083659,Cao; Yingjun,1,18,70,69
1656261156625,CSE 134B,A01,083661,Powell; Thomas Allan,5,0,100,95
1656261162651,CSE 140,A01,083663,Gungor; Onat,9,0,85,76
1656261168675,CSE 140L,A01,083088,Eldon; John,8,0,100,92
1656261174725,CSE 175,A01,083665,Kumar; Rakesh,0,0,25,25
1656261180757,CSE 190,A00,092507,Dubnov; Shlomo,3,0,20,17
1656261186794,ECE 45,A01,083139,Congero; Spencer William,1,0,75,74
1656261192824,ECE 65,A50,083695,Saad; Andrew S,9,0,30,21
1656261192824,ECE 65,A51,095125,Staff,24,0,26,2
1656261198850,ECE 109,A01,091882,Touri; Behrouz,0,1,70,70
1656261204878,ECE 180,A00,083140,Abi Samra; Nicholas Camill,1,0,30,29
1656261204878,ECE 180,B00,083141,Abi Samra; Nicholas Camill,0,4,30,30
1656261210908,MATH 10A,A01,083735,Patchell; Gregory David,0,0,30,30
1656261210908,MATH 10A,A02,083736,Patchell; Gregory David,22,0,30,8
1656261210908,MATH 10A,A03,083737,Patchell; Gregory David,16,0,30,14
1656261216948,MATH 10B,A01,083207,Lim; Seonhee,0,0,34,34
1656261216948,MATH 10B,A02,083208,Lim; Seonhee,7,0,35,28
1656261216948,MATH 10B,A03,093472,Staff,1,0,34,33
1656261216948,MATH 10B,B01,083739,Sinha; Shubham,11,0,30,19
1656261222994,MATH 18,A01,083743,Cinel; Cameron Alexander,7,0,30,23
1656261222994,MATH 18,A02,083744,Cinel; Cameron Alexander,9,0,30,21
1656261222994,MATH 18,A03,083745,Cinel; Cameron Alexander,5,0,30,25
1656261222994,MATH 18,B01,083748,Rideout; David Porter,1,0,36,35
1656261222994,MATH 18,B02,083749,Rideout; David Porter,0,0,36,36
1656261222994,MATH 18,B03,083750,Rideout; David Porter,0,0,36,36
1656261222994,MATH 18,B04,083751,Rideout; David Porter,0,1,36,36
1656261222994,MATH 18,B05,093473,Rideout; David Porter,0,0,36,36
1656261222994,MATH 18,B06,093474,Rideout; David Porter,3,0,36,33
1656261229091,MATH 20A,A01,083754,Zheng; Zequn,11,0,40,29
1656261235119,MATH 20B,A01,083756,Briones; Jor-el Thomas Caparas,0,0,36,36
1656261235119,MATH 20B,A02,083757,Briones; Jor-el Thomas Caparas,0,0,36,36
1656261235119,MATH 20B,A03,093475,Staff,0,0,36,36
1656261241152,MATH 20C,A01,083760,Briones; Jor-el Thomas Caparas,0,0,35,35
1656261241152,MATH 20C,A02,083761,Briones; Jor-el Thomas Caparas,9,1,35,26
1656261241152,MATH 20C,A03,093476,Staff,0,0,35,35
1656261241152,MATH 20C,B01,083762,Bach; Quang Tran,1,0,30,29
1656261247189,MATH 20D,A01,083765,Tran; Brian Kha,1,0,30,29
1656261247189,MATH 20D,A02,083766,Tran; Brian Kha,0,1,30,30
1656261247189,MATH 20D,A03,083767,Tran; Brian Kha,2,0,30,28
1656261253215,MATH 20E,A01,083771,Ganguly; Soumya,3,0,32,29
1656261253215,MATH 20E,A02,083772,Ganguly; Soumya,0,0,32,32
1656261253215,MATH 20E,B01,083773,Ciotti; Benjamin,16,0,35,19
1656261253215,MATH 20E,B02,083774,Ciotti; Benjamin,15,0,35,20
1656261259244,MATH 103A,A01,083777,Greenfeld; Be'Eri,1,0,36,35
1656261259244,MATH 103A,A02,083778,Greenfeld; Be'Eri,1,0,36,35
1656261259244,MATH 103A,A03,093561,Staff,5,0,36,31
1656261259244,MATH 103A,B01,083779,Greenfeld; Be'Eri,8,0,36,28
1656261259244,MATH 103A,B02,083780,Greenfeld; Be'Eri,1,0,36,35
1656261259244,MATH 103A,B03,093562,Staff,0,0,36,36
1656261265267,MATH 105,A01,085443,Carter; Anne Toulson,5,0,35,30
1656261265267,MATH 105,A02,093477,Staff,14,0,35,21
1656261271290,MATH 109,A01,083213,Ganzberger; Geoffrey Michael,0,0,34,34
1656261271290,MATH 109,A02,083214,Ganzberger; Geoffrey Michael,0,0,34,34
1656261271290,MATH 109,A03,093478,Staff,1,0,34,33
1656261271290,MATH 109,B01,083215,Ganzberger; Geoffrey Michael,4,0,32,28
1656261271290,MATH 109,B02,083216,Ganzberger; Geoffrey Michael,1,0,32,31
1656261271290,MATH 109,B03,093479,Staff,3,0,32,29
1656261277317,MATH 142A,A01,083219,Chow; Bennett,2,0,32,30
1656261277317,MATH 142A,A02,083220,Chow; Bennett,8,0,32,24
1656261277317,MATH 142A,A03,093480,Staff,5,0,32,27
1656261277317,MATH 142A,B03,093481,Staff,3,0,32,29
1656261277317,MATH 142A,B04,093558,Staff,6,0,32,26
1656261277317,MATH 142A,B05,093559,Staff,0,0,32,32
1656261283353,MATH 193A,A01,083224,Rotar; Vladimir,0,1,34,34
1656261283353,MATH 193A,A02,083225,Rotar; Vladimir,0,0,34,34
1656261283353,MATH 193A,A03,083781,Rotar; Vladimir,0,0,34,34
1656261283353,MATH 193A,A04,083782,Rotar; Vladimir,6,0,34,28
1656261283353,MATH 193A,A05,093482,Rotar; Vladimir,0,0,34,34
1656261289380,MATH 197,001,091859,McAuley; Julian John,9999,0,9999,0
1656261289380,MATH 197,002,095566,Kedlaya; Kiran S.,9997,0,9999,2
1656261289380,MATH 197,003,095567,Xiao; Ming,9999,0,9999,0
1656261289380,MATH 197,004,095571,Perols; Johan Lars,9998,0,9999,1
1656261296438,COGS 9,A01,083615,Shannon; Kyle Michael,3,0,75,72
1656261302461,COGS 11,A01,083617,Boyle; Mary E. T.,14,0,48,34
1656261308499,COGS 13,A01,083071,Bastos; Amalia Pinkusfeld,5,0,71,66
1656261314527,COGS 14A,A01,092681,Semenuks; Arturs,1,12,100,99
1656261320554,COGS 14B,A01,083073,Cheng; Tzu-Han,7,0,63,56
1656261326582,COGS 17,A01,092677,Semenuks; Arturs,8,0,81,73
1656261332622,COGS 100,A01,083619,Allen; Michael Gordon,2,0,70,68
1656261338652,COGS 101A,A01,083621,Davis; Joshua Daniel,4,0,68,64
1656261344675,COGS 101B,A01,091572,Allen; Michael Gordon,4,0,65,61
1656261350697,COGS 101C,A01,083625,Delgado; Tania,10,0,35,25
1656261356721,COGS 107A,A01,083627,Boyle; Mary E. T.,0,0,60,60
1656261362749,COGS 118A,A01,083075,Gupta; Anjum,8,0,76,68
1656261368790,CSE 3,A50,083646,Miranda; Gregory Joseph,18,0,50,32
1656261374822,CSE 8A,A50,083650,Miranda; Gregory Joseph,2,2,56,54
1656261380873,CSE 11,A01,083080,Cao; Yingjun,0,49,40,40
1656261386899,CSE 12,A01,083652,Krause-Levy; Sophia Louisa,5,1,120,115
1656261392935,CSE 15L,A01,083654,Morris; Justin Loren,2,0,50,48
1656261392935,CSE 15L,A02,083655,Morris; Justin Loren,4,0,50,46
1656261398978,CSE 20,A01,083657,Tran; Khoa Dang,30,0,80,50
1656261405002,CSE 21,A01,095574,Bach; Quang Tran,23,0,48,25
1656261411026,CSE 30,A01,083084,Eldon; John,2,6,80,78
1656261411026,CSE 30,B01,095061,Bhaskar; Nishant,0,1,50,50
1656261417072,CSE 100,A01,083659,Cao; Yingjun,1,18,70,69
1656261423097,CSE 134B,A01,083661,Powell; Thomas Allan,5,0,100,95
1656261429124,CSE 140,A01,083663,Gungor; Onat,9,0,85,76
1656261435157,CSE 140L,A01,083088,Eldon; John,8,0,100,92
1656261441185,CSE 175,A01,083665,Kumar; Rakesh,0,0,25,25
1656261447208,CSE 190,A00,092507,Dubnov; Shlomo,3,0,20,17
1656261453243,ECE 45,A01,083139,Congero; Spencer William,1,0,75,74
1656261459270,ECE 65,A50,083695,Saad; Andrew S,9,0,30,21
1656261459270,ECE 65,A51,095125,Staff,24,0,26,2
1656261465301,ECE 109,A01,091882,Touri; Behrouz,0,1,70,70
1656261471331,ECE 180,A00,083140,Abi Samra; Nicholas Camill,1,0,30,29
1656261471331,ECE 180,B00,083141,Abi Samra; Nicholas Camill,0,4,30,30
1656261477383,MATH 10A,A01,083735,Patchell; Gregory David,0,0,30,30
1656261477383,MATH 10A,A02,083736,Patchell; Gregory David,22,0,30,8
1656261477383,MATH 10A,A03,083737,Patchell; Gregory David,16,0,30,14
1656261483408,MATH 10B,A01,083207,Lim; Seonhee,0,0,34,34
1656261483408,MATH 10B,A02,083208,Lim; Seonhee,7,0,35,28
1656261483408,MATH 10B,A03,093472,Staff,1,0,34,33
1656261483408,MATH 10B,B01,083739,Sinha; Shubham,11,0,30,19
1656261489442,MATH 18,A01,083743,Cinel; Cameron Alexander,7,0,30,23
1656261489442,MATH 18,A02,083744,Cinel; Cameron Alexander,9,0,30,21
1656261489442,MATH 18,A03,083745,Cinel; Cameron Alexander,5,0,30,25
1656261489442,MATH 18,B01,083748,Rideout; David Porter,1,0,36,35
1656261489442,MATH 18,B02,083749,Rideout; David Porter,0,0,36,36
1656261489442,MATH 18,B03,083750,Rideout; David Porter,0,0,36,36
1656261489442,MATH 18,B04,083751,Rideout; David Porter,0,1,36,36
1656261489442,MATH 18,B05,093473,Rideout; David Porter,0,0,36,36
1656261489442,MATH 18,B06,093474,Rideout; David Porter,3,0,36,33
1656261495470,MATH 20A,A01,083754,Zheng; Zequn,11,0,40,29
1656261501494,MATH 20B,A01,083756,Briones; Jor-el Thomas Caparas,0,0,36,36
1656261501494,MATH 20B,A02,083757,Briones; Jor-el Thomas Caparas,0,0,36,36
1656261501494,MATH 20B,A03,093475,Staff,0,0,36,36
1656261507524,MATH 20C,A01,083760,Briones; Jor-el Thomas Caparas,0,0,35,35
1656261507524,MATH 20C,A02,083761,Briones; Jor-el Thomas Caparas,9,1,35,26
1656261507524,MATH 20C,A03,093476,Staff,0,0,35,35
1656261507524,MATH 20C,B01,083762,Bach; Quang Tran,1,0,30,29
1656261513548,MATH 20D,A01,083765,Tran; Brian Kha,1,0,30,29
1656261513548,MATH 20D,A02,083766,Tran; Brian Kha,0,1,30,30
1656261513548,MATH 20D,A03,083767,Tran; Brian Kha,2,0,30,28
1656261519600,MATH 20E,A01,083771,Ganguly; Soumya,3,0,32,29
1656261519600,MATH 20E,A02,083772,Ganguly; Soumya,0,0,32,32
1656261519600,MATH 20E,B01,083773,Ciotti; Benjamin,16,0,35,19
1656261519600,MATH 20E,B02,083774,Ciotti; Benjamin,15,0,35,20
1656261525656,MATH 103A,A01,083777,Greenfeld; Be'Eri,1,0,36,35
1656261525656,MATH 103A,A02,083778,Greenfeld; Be'Eri,1,0,36,35
1656261525656,MATH 103A,A03,093561,Staff,5,0,36,31
1656261525656,MATH 103A,B01,083779,Greenfeld; Be'Eri,8,0,36,28
1656261525656,MATH 103A,B02,083780,Greenfeld; Be'Eri,1,0,36,35
1656261525656,MATH 103A,B03,093562,Staff,0,0,36,36
1656261531680,MATH 105,A01,085443,Carter; Anne Toulson,5,0,35,30
1656261531680,MATH 105,A02,093477,Staff,14,0,35,21
1656261537722,MATH 109,A01,083213,Ganzberger; Geoffrey Michael,0,0,34,34
1656261537722,MATH 109,A02,083214,Ganzberger; Geoffrey Michael,0,0,34,34
1656261537722,MATH 109,A03,093478,Staff,1,0,34,33
1656261537722,MATH 109,B01,083215,Ganzberger; Geoffrey Michael,4,0,32,28
1656261537722,MATH 109,B02,083216,Ganzberger; Geoffrey Michael,1,0,32,31
1656261537722,MATH 109,B03,093479,Staff,3,0,32,29
1656261543752,MATH 142A,A01,083219,Chow; Bennett,2,0,32,30
1656261543752,MATH 142A,A02,083220,Chow; Bennett,8,0,32,24
1656261543752,MATH 142A,A03,093480,Staff,5,0,32,27
1656261543752,MATH 142A,B03,093481,Staff,3,0,32,29
1656261543752,MATH 142A,B04,093558,Staff,6,0,32,26
1656261543752,MATH 142A,B05,093559,Staff,0,0,32,32
1656261549781,MATH 193A,A01,083224,Rotar; Vladimir,0,1,34,34
1656261549781,MATH 193A,A02,083225,Rotar; Vladimir,0,0,34,34
1656261549781,MATH 193A,A03,083781,Rotar; Vladimir,0,0,34,34
1656261549781,MATH 193A,A04,083782,Rotar; Vladimir,6,0,34,28
1656261549781,MATH 193A,A05,093482,Rotar; Vladimir,0,0,34,34
1656261555838,MATH 197,001,091859,McAuley; Julian John,9999,0,9999,0
1656261555838,MATH 197,002,095566,Kedlaya; Kiran S.,9997,0,9999,2
1656261555838,MATH 197,003,095567,Xiao; Ming,9999,0,9999,0
1656261555838,MATH 197,004,095571,Perols; Johan Lars,9998,0,9999,1
1656261562905,COGS 9,A01,083615,Shannon; Kyle Michael,3,0,75,72
1656261568940,COGS 11,A01,083617,Boyle; Mary E. T.,14,0,48,34
1656261574964,COGS 13,A01,083071,Bastos; Amalia Pinkusfeld,5,0,71,66
1656261581001,COGS 14A,A01,092681,Semenuks; Arturs,1,12,100,99
1656261587032,COGS 14B,A01,083073,Cheng; Tzu-Han,7,0,63,56
1656261593056,COGS 17,A01,092677,Semenuks; Arturs,8,0,81,73
1656261599093,COGS 100,A01,083619,Allen; Michael Gordon,2,0,70,68
1656261605121,COGS 101A,A01,083621,Davis; Joshua Daniel,4,0,68,64
1656261611143,COGS 101B,A01,091572,Allen; Michael Gordon,4,0,65,61
1656261617176,COGS 101C,A01,083625,Delgado; Tania,10,0,35,25
1656261623228,COGS 107A,A01,083627,Boyle; Mary E. T.,0,0,60,60
1656261629256,COGS 118A,A01,083075,Gupta; Anjum,8,0,76,68
1656261635284,CSE 3,A50,083646,Miranda; Gregory Joseph,18,0,50,32
1656261641333,CSE 8A,A50,083650,Miranda; Gregory Joseph,2,2,56,54
1656261647374,CSE 11,A01,083080,Cao; Yingjun,0,49,40,40
1656261653398,CSE 12,A01,083652,Krause-Levy; Sophia Louisa,5,1,120,115
1656261659432,CSE 15L,A01,083654,Morris; Justin Loren,2,0,50,48
1656261659432,CSE 15L,A02,083655,Morris; Justin Loren,4,0,50,46
1656261665469,CSE 20,A01,083657,Tran; Khoa Dang,30,0,80,50
1656261671492,CSE 21,A01,095574,Bach; Quang Tran,23,0,48,25
1656261677521,CSE 30,A01,083084,Eldon; John,2,6,80,78
1656261677521,CSE 30,B01,095061,Bhaskar; Nishant,0,1,50,50
1656261683560,CSE 100,A01,083659,Cao; Yingjun,1,18,70,69
1656261689590,CSE 134B,A01,083661,Powell; Thomas Allan,5,0,100,95
1656261695613,CSE 140,A01,083663,Gungor; Onat,9,0,85,76
1656261701657,CSE 140L,A01,083088,Eldon; John,8,0,100,92
1656261707684,CSE 175,A01,083665,Kumar; Rakesh,0,0,25,25
1656261713708,CSE 190,A00,092507,Dubnov; Shlomo,3,0,20,17
1656261719730,ECE 45,A01,083139,Congero; Spencer William,1,0,75,74
1656261725753,ECE 65,A50,083695,Saad; Andrew S,9,0,30,21
1656261725753,ECE 65,A51,095125,Staff,24,0,26,2
1656261731780,ECE 109,A01,091882,Touri; Behrouz,0,1,70,70
1656261737807,ECE 180,A00,083140,Abi Samra; Nicholas Camill,1,0,30,29
1656261737807,ECE 180,B00,083141,Abi Samra; Nicholas Camill,0,4,30,30
1656261743832,MATH 10A,A01,083735,Patchell; Gregory David,0,0,30,30
1656261743832,MATH 10A,A02,083736,Patchell; Gregory David,22,0,30,8
1656261743832,MATH 10A,A03,083737,Patchell; Gregory David,16,0,30,14
1656261749855,MATH 10B,A01,083207,Lim; Seonhee,0,0,34,34
1656261749855,MATH 10B,A02,083208,Lim; Seonhee,7,0,35,28
1656261749855,MATH 10B,A03,093472,Staff,1,0,34,33
1656261749855,MATH 10B,B01,083739,Sinha; Shubham,11,0,30,19
1656261755886,MATH 18,A01,083743,Cinel; Cameron Alexander,7,0,30,23
1656261755886,MATH 18,A02,083744,Cinel; Cameron Alexander,9,0,30,21
1656261755886,MATH 18,A03,083745,Cinel; Cameron Alexander,5,0,30,25
1656261755886,MATH 18,B01,083748,Rideout; David Porter,1,0,36,35
1656261755886,MATH 18,B02,083749,Rideout; David Porter,0,0,36,36
1656261755886,MATH 18,B03,083750,Rideout; David Porter,0,0,36,36
1656261755886,MATH 18,B04,083751,Rideout; David Porter,0,1,36,36
1656261755886,MATH 18,B05,093473,Rideout; David Porter,0,0,36,36
1656261755886,MATH 18,B06,093474,Rideout; David Porter,3,0,36,33
1656261761910,MATH 20A,A01,083754,Zheng; Zequn,11,0,40,29
1656261767940,MATH 20B,A01,083756,Briones; Jor-el Thomas Caparas,0,0,36,36
1656261767940,MATH 20B,A02,083757,Briones; Jor-el Thomas Caparas,0,0,36,36
1656261767940,MATH 20B,A03,093475,Staff,0,0,36,36
1656261773971,MATH 20C,A01,083760,Briones; Jor-el Thomas Caparas,0,0,35,35
1656261773971,MATH 20C,A02,083761,Briones; Jor-el Thomas Caparas,9,1,35,26
1656261773971,MATH 20C,A03,093476,Staff,0,0,35,35
1656261773971,MATH 20C,B01,083762,Bach; Quang Tran,1,0,30,29
1656261780004,MATH 20D,A01,083765,Tran; Brian Kha,1,0,30,29
1656261780004,MATH 20D,A02,083766,Tran; Brian Kha,0,1,30,30
1656261780004,MATH 20D,A03,083767,Tran; Brian Kha,2,0,30,28
1656261786029,MATH 20E,A01,083771,Ganguly; Soumya,3,0,32,29
1656261786029,MATH 20E,A02,083772,Ganguly; Soumya,0,0,32,32
1656261786029,MATH 20E,B01,083773,Ciotti; Benjamin,16,0,35,19
1656261786029,MATH 20E,B02,083774,Ciotti; Benjamin,15,0,35,20
1656261792052,MATH 103A,A01,083777,Greenfeld; Be'Eri,1,0,36,35
1656261792052,MATH 103A,A02,083778,Greenfeld; Be'Eri,1,0,36,35
1656261792052,MATH 103A,A03,093561,Staff,5,0,36,31
1656261792052,MATH 103A,B01,083779,Greenfeld; Be'Eri,8,0,36,28
1656261792052,MATH 103A,B02,083780,Greenfeld; Be'Eri,1,0,36,35
1656261792052,MATH 103A,B03,093562,Staff,0,0,36,36
1656261798086,MATH 105,A01,085443,Carter; Anne Toulson,5,0,35,30
1656261798086,MATH 105,A02,093477,Staff,14,0,35,21
1656261804125,MATH 109,A01,083213,Ganzberger; Geoffrey Michael,0,0,34,34
1656261804125,MATH 109,A02,083214,Ganzberger; Geoffrey Michael,0,0,34,34
1656261804125,MATH 109,A03,093478,Staff,1,0,34,33
1656261804125,MATH 109,B01,083215,Ganzberger; Geoffrey Michael,4,0,32,28
1656261804125,MATH 109,B02,083216,Ganzberger; Geoffrey Michael,1,0,32,31
1656261804125,MATH 109,B03,093479,Staff,3,0,32,29
1656261810175,MATH 142A,A01,083219,Chow; Bennett,2,0,32,30
1656261810175,MATH 142A,A02,083220,Chow; Bennett,8,0,32,24
1656261810175,MATH 142A,A03,093480,Staff,5,0,32,27
1656261810175,MATH 142A,B03,093481,Staff,3,0,32,29
1656261810175,MATH 142A,B04,093558,Staff,6,0,32,26
1656261810175,MATH 142A,B05,093559,Staff,0,0,32,32
1656261816203,MATH 193A,A01,083224,Rotar; Vladimir,0,1,34,34
1656261816203,MATH 193A,A02,083225,Rotar; Vladimir,0,0,34,34
1656261816203,MATH 193A,A03,083781,Rotar; Vladimir,0,0,34,34
1656261816203,MATH 193A,A04,083782,Rotar; Vladimir,6,0,34,28
1656261816203,MATH 193A,A05,093482,Rotar; Vladimir,0,0,34,34
1656261822233,MATH 197,001,091859,McAuley; Julian John,9999,0,9999,0
1656261822233,MATH 197,002,095566,Kedlaya; Kiran S.,9997,0,9999,2
1656261822233,MATH 197,003,095567,Xiao; Ming,9999,0,9999,0
1656261822233,MATH 197,004,095571,Perols; Johan Lars,9998,0,9999,1
1656261829424,COGS 9,A01,083615,Shannon; Kyle Michael,3,0,75,72
1656261835448,COGS 11,A01,083617,Boyle; Mary E. T.,14,0,48,34
1656261841470,COGS 13,A01,083071,Bastos; Amalia Pinkusfeld,5,0,71,66
1656261847496,COGS 14A,A01,092681,Semenuks; Arturs,1,12,100,99
1656261853523,COGS 14B,A01,083073,Cheng; Tzu-Han,7,0,63,56
1656261859546,COGS 17,A01,092677,Semenuks; Arturs,8,0,81,73
1656261865572,COGS 100,A01,083619,Allen; Michael Gordon,2,0,70,68
1656261871599,COGS 101A,A01,083621,Davis; Joshua Daniel,4,0,68,64
1656261877631,COGS 101B,A01,091572,Allen; Michael Gordon,4,0,65,61
1656261883652,COGS 101C,A01,083625,Delgado; Tania,10,0,35,25
1656261889675,COGS 107A,A01,083627,Boyle; Mary E. T.,0,0,60,60
1656261895721,COGS 118A,A01,083075,Gupta; Anjum,8,0,76,68
1656261901757,CSE 3,A50,083646,Miranda; Gregory Joseph,18,0,50,32
1656261907812,CSE 8A,A50,083650,Miranda; Gregory Joseph,2,2,56,54
1656261913834,CSE 11,A01,083080,Cao; Yingjun,0,49,40,40
1656261919871,CSE 12,A01,083652,Krause-Levy; Sophia Louisa,5,1,120,115
1656261925895,CSE 15L,A01,083654,Morris; Justin Loren,2,0,50,48
1656261925895,CSE 15L,A02,083655,Morris; Justin Loren,4,0,50,46
1656261931926,CSE 20,A01,083657,Tran; Khoa Dang,30,0,80,50
1656261937972,CSE 21,A01,095574,Bach; Quang Tran,23,0,48,25
1656261943995,CSE 30,A01,083084,Eldon; John,2,6,80,78
1656261943995,CSE 30,B01,095061,Bhaskar; Nishant,0,1,50,50
1656261950019,CSE 100,A01,083659,Cao; Yingjun,1,18,70,69
1656261956063,CSE 134B,A01,083661,Powell; Thomas Allan,5,0,100,95
1656261962101,CSE 140,A01,083663,Gungor; Onat,9,0,85,76
1656261968151,CSE 140L,A01,083088,Eldon; John,8,0,100,92
1656261974174,CSE 175,A01,083665,Kumar; Rakesh,0,0,25,25
1656261980223,CSE 190,A00,092507,Dubnov; Shlomo,3,0,20,17
1656261986256,ECE 45,A01,083139,Congero; Spencer William,1,0,75,74
1656261992281,ECE 65,A50,083695,Saad; Andrew S,9,0,30,21
1656261992281,ECE 65,A51,095125,Staff,24,0,26,2
1656261998314,ECE 109,A01,091882,Touri; Behrouz,0,1,70,70
1656262004340,ECE 180,A00,083140,Abi Samra; Nicholas Camill,1,0,30,29
1656262004340,ECE 180,B00,083141,Abi Samra; Nicholas Camill,0,4,30,30
1656262010369,MATH 10A,A01,083735,Patchell; Gregory David,0,0,30,30
1656262010369,MATH 10A,A02,083736,Patchell; Gregory David,22,0,30,8
1656262010369,MATH 10A,A03,083737,Patchell; Gregory David,16,0,30,14
1656262016393,MATH 10B,A01,083207,Lim; Seonhee,0,0,34,34
1656262016393,MATH 10B,A02,083208,Lim; Seonhee,7,0,35,28
1656262016393,MATH 10B,A03,093472,Staff,1,0,34,33
1656262016393,MATH 10B,B01,083739,Sinha; Shubham,11,0,30,19
1656262022423,MATH 18,A01,083743,Cinel; Cameron Alexander,7,0,30,23
1656262022423,MATH 18,A02,083744,Cinel; Cameron Alexander,9,0,30,21
1656262022423,MATH 18,A03,083745,Cinel; Cameron Alexander,5,0,30,25
1656262022423,MATH 18,B01,083748,Rideout; David Porter,1,0,36,35
1656262022423,MATH 18,B02,083749,Rideout; David Porter,0,0,36,36
1656262022423,MATH 18,B03,083750,Rideout; David Porter,0,0,36,36
1656262022423,MATH 18,B04,083751,Rideout; David Porter,0,1,36,36
1656262022423,MATH 18,B05,093473,Rideout; David Porter,0,0,36,36
1656262022423,MATH 18,B06,093474,Rideout; David Porter,3,0,36,33
1656262028446,MATH 20A,A01,083754,Zheng; Zequn,11,0,40,29
1656262034486,MATH 20B,A01,083756,Briones; Jor-el Thomas Caparas,0,0,36,36
1656262034486,MATH 20B,A02,083757,Briones; Jor-el Thomas Caparas,0,0,36,36
1656262034486,MATH 20B,A03,093475,Staff,0,0,36,36
1656262040517,MATH 20C,A01,083760,Briones; Jor-el Thomas Caparas,0,0,35,35
1656262040517,MATH 20C,A02,083761,Briones; Jor-el Thomas Caparas,9,1,35,26
1656262040517,MATH 20C,A03,093476,Staff,0,0,35,35
1656262040517,MATH 20C,B01,083762,Bach; Quang Tran,1,0,30,29
1656262046552,MATH 20D,A01,083765,Tran; Brian Kha,1,0,30,29
1656262046552,MATH 20D,A02,083766,Tran; Brian Kha,0,1,30,30
1656262046552,MATH 20D,A03,083767,Tran; Brian Kha,2,0,30,28
1656262052576,MATH 20E,A01,083771,Ganguly; Soumya,3,0,32,29
1656262052576,MATH 20E,A02,083772,Ganguly; Soumya,0,0,32,32
1656262052576,MATH 20E,B01,083773,Ciotti; Benjamin,16,0,35,19
1656262052576,MATH 20E,B02,083774,Ciotti; Benjamin,15,0,35,20
1656262058616,MATH 103A,A01,083777,Greenfeld; Be'Eri,1,0,36,35
1656262058616,MATH 103A,A02,083778,Greenfeld; Be'Eri,1,0,36,35
1656262058616,MATH 103A,A03,093561,Staff,5,0,36,31
1656262058616,MATH 103A,B01,083779,Greenfeld; Be'Eri,8,0,36,28
1656262058616,MATH 103A,B02,083780,Greenfeld; Be'Eri,1,0,36,35
1656262058616,MATH 103A,B03,093562,Staff,0,0,36,36
1656262064641,MATH 105,A01,085443,Carter; Anne Toulson,5,0,35,30
1656262064641,MATH 105,A02,093477,Staff,14,0,35,21
1656262070671,MATH 109,A01,083213,Ganzberger; Geoffrey Michael,0,0,34,34
1656262070671,MATH 109,A02,083214,Ganzberger; Geoffrey Michael,0,0,34,34
1656262070671,MATH 109,A03,093478,Staff,1,0,34,33
1656262070671,MATH 109,B01,083215,Ganzberger; Geoffrey Michael,4,0,32,28
1656262070671,MATH 109,B02,083216,Ganzberger; Geoffrey Michael,1,0,32,31
1656262070671,MATH 109,B03,093479,Staff,3,0,32,29
1656262076719,MATH 142A,A01,083219,Chow; Bennett,2,0,32,30
1656262076719,MATH 142A,A02,083220,Chow; Bennett,8,0,32,24
1656262076719,MATH 142A,A03,093480,Staff,5,0,32,27
1656262076719,MATH 142A,B03,093481,Staff,3,0,32,29
1656262076719,MATH 142A,B04,093558,Staff,6,0,32,26
1656262076719,MATH 142A,B05,093559,Staff,0,0,32,32
1656262082750,MATH 193A,A01,083224,Rotar; Vladimir,0,1,34,34
1656262082750,MATH 193A,A02,083225,Rotar; Vladimir,0,0,34,34
1656262082750,MATH 193A,A03,083781,Rotar; Vladimir,0,0,34,34
1656262082750,MATH 193A,A04,083782,Rotar; Vladimir,6,0,34,28
1656262082750,MATH 193A,A05,093482,Rotar; Vladimir,0,0,34,34
1656262088775,MATH 197,001,091859,McAuley; Julian John,9999,0,9999,0
1656262088775,MATH 197,002,095566,Kedlaya; Kiran S.,9997,0,9999,2
1656262088775,MATH 197,003,095567,Xiao; Ming,9999,0,9999,0
1656262088775,MATH 197,004,095571,Perols; Johan Lars,9998,0,9999,1
1656262095857,COGS 9,A01,083615,Shannon; Kyle Michael,3,0,75,72
1656262101881,COGS 11,A01,083617,Boyle; Mary E. T.,14,0,48,34
1656262107902,COGS 13,A01,083071,Bastos; Amalia Pinkusfeld,5,0,71,66
1656262113957,COGS 14A,A01,092681,Semenuks; Arturs,1,12,100,99
1656262119984,COGS 14B,A01,083073,Cheng; Tzu-Han,7,0,63,56
1656262126005,COGS 17,A01,092677,Semenuks; Arturs,8,0,81,73
1656262132048,COGS 100,A01,083619,Allen; Michael Gordon,2,0,70,68
1656262138090,COGS 101A,A01,083621,Davis; Joshua Daniel,4,0,68,64
1656262144114,COGS 101B,A01,091572,Allen; Michael Gordon,4,0,65,61
1656262150138,COGS 101C,A01,083625,Delgado; Tania,10,0,35,25
1656262156161,COGS 107A,A01,083627,Boyle; Mary E. T.,0,0,60,60
1656262162185,COGS 118A,A01,083075,Gupta; Anjum,8,0,76,68
1656262168213,CSE 3,A50,083646,Miranda; Gregory Joseph,18,0,50,32
1656262174237,CSE 8A,A50,083650,Miranda; Gregory Joseph,2,2,56,54
1656262180259,CSE 11,A01,083080,Cao; Yingjun,0,49,40,40
1656262186284,CSE 12,A01,083652,Krause-Levy; Sophia Louisa,5,1,120,115
1656262192305,CSE 15L,A01,083654,Morris; Justin Loren,2,0,50,48
1656262192305,CSE 15L,A02,083655,Morris; Justin Loren,4,0,50,46
1656262198338,CSE 20,A01,083657,Tran; Khoa Dang,30,0,80,50
1656262204365,CSE 21,A01,095574,Bach; Quang Tran,23,0,48,25
1656262210396,CSE 30,A01,083084,Eldon; John,2,6,80,78
1656262210396,CSE 30,B01,095061,Bhaskar; Nishant,0,1,50,50
1656262216418,CSE 100,A01,083659,Cao; Yingjun,1,18,70,69
1656262222441,CSE 134B,A01,083661,Powell; Thomas Allan,5,0,100,95
1656262228464,CSE 140,A01,083663,Gungor; Onat,9,0,85,76
1656262234486,CSE 140L,A01,083088,Eldon; John,8,0,100,92
1656262240510,CSE 175,A01,083665,Kumar; Rakesh,0,0,25,25
1656262246532,CSE 190,A00,092507,Dubnov; Shlomo,3,0,20,17
1656262252559,ECE 45,A01,083139,Congero; Spencer William,1,0,75,74
1656262258582,ECE 65,A50,083695,Saad; Andrew S,9,0,30,21
1656262258582,ECE 65,A51,095125,Staff,24,0,26,2
1656262264606,ECE 109,A01,091882,Touri; Behrouz,0,1,70,70
1656262270631,ECE 180,A00,083140,Abi Samra; Nicholas Camill,1,0,30,29
1656262270631,ECE 180,B00,083141,Abi Samra; Nicholas Camill,0,4,30,30
1656262276654,MATH 10A,A01,083735,Patchell; Gregory David,0,0,30,30
1656262276654,MATH 10A,A02,083736,Patchell; Gregory David,22,0,30,8
1656262276654,MATH 10A,A03,083737,Patchell; Gregory David,16,0,30,14
1656262282683,MATH 10B,A01,083207,Lim; Seonhee,0,0,34,34
1656262282683,MATH 10B,A02,083208,Lim; Seonhee,7,0,35,28
1656262282683,MATH 10B,A03,093472,Staff,1,0,34,33
1656262282683,MATH 10B,B01,083739,Sinha; Shubham,11,0,30,19
1656262288716,MATH 18,A01,083743,Cinel; Cameron Alexander,7,0,30,23
1656262288716,MATH 18,A02,083744,Cinel; Cameron Alexander,9,0,30,21
1656262288716,MATH 18,A03,083745,Cinel; Cameron Alexander,5,0,30,25
1656262288716,MATH 18,B01,083748,Rideout; David Porter,1,0,36,35
1656262288716,MATH 18,B02,083749,Rideout; David Porter,0,0,36,36
1656262288716,MATH 18,B03,083750,Rideout; David Porter,0,0,36,36
1656262288716,MATH 18,B04,083751,Rideout; David Porter,0,1,36,36
1656262288716,MATH 18,B05,093473,Rideout; David Porter,0,0,36,36
1656262288716,MATH 18,B06,093474,Rideout; David Porter,3,0,36,33
1656262294741,MATH 20A,A01,083754,Zheng; Zequn,11,0,40,29
1656262300769,MATH 20B,A01,083756,Briones; Jor-el Thomas Caparas,0,0,36,36
1656262300769,MATH 20B,A02,083757,Briones; Jor-el Thomas Caparas,0,0,36,36
1656262300769,MATH 20B,A03,093475,Staff,0,0,36,36
1656262306793,MATH 20C,A01,083760,Briones; Jor-el Thomas Caparas,0,0,35,35
1656262306793,MATH 20C,A02,083761,Briones; Jor-el Thomas Caparas,9,1,35,26
1656262306793,MATH 20C,A03,093476,Staff,0,0,35,35
1656262306793,MATH 20C,B01,083762,Bach; Quang Tran,1,0,30,29
1656262312822,MATH 20D,A01,083765,Tran; Brian Kha,1,0,30,29
1656262312822,MATH 20D,A02,083766,Tran; Brian Kha,0,1,30,30
1656262312822,MATH 20D,A03,083767,Tran; Brian Kha,2,0,30,28
1656262318852,MATH 20E,A01,083771,Ganguly; Soumya,3,0,32,29
1656262318852,MATH 20E,A02,083772,Ganguly; Soumya,0,0,32,32
1656262318852,MATH 20E,B01,083773,Ciotti; Benjamin,16,0,35,19
1656262318852,MATH 20E,B02,083774,Ciotti; Benjamin,15,0,35,20
1656262324877,MATH 103A,A01,083777,Greenfeld; Be'Eri,1,0,36,35
1656262324877,MATH 103A,A02,083778,Greenfeld; Be'Eri,1,0,36,35
1656262324877,MATH 103A,A03,093561,Staff,5,0,36,31
1656262324877,MATH 103A,B01,083779,Greenfeld; Be'Eri,8,0,36,28
1656262324877,MATH 103A,B02,083780,Greenfeld; Be'Eri,1,0,36,35
1656262324877,MATH 103A,B03,093562,Staff,0,0,36,36
1656262330904,MATH 105,A01,085443,Carter; Anne Toulson,5,0,35,30
1656262330904,MATH 105,A02,093477,Staff,14,0,35,21
1656262336941,MATH 109,A01,083213,Ganzberger; Geoffrey Michael,0,0,34,34
1656262336941,MATH 109,A02,083214,Ganzberger; Geoffrey Michael,0,0,34,34
1656262336941,MATH 109,A03,093478,Staff,1,0,34,33
1656262336941,MATH 109,B01,083215,Ganzberger; Geoffrey Michael,4,0,32,28
1656262336941,MATH 109,B02,083216,Ganzberger; Geoffrey Michael,1,0,32,31
1656262336941,MATH 109,B03,093479,Staff,3,0,32,29
1656262342972,MATH 142A,A01,083219,Chow; Bennett,2,0,32,30
1656262342972,MATH 142A,A02,083220,Chow; Bennett,8,0,32,24
1656262342972,MATH 142A,A03,093480,Staff,5,0,32,27
1656262342972,MATH 142A,B03,093481,Staff,3,0,32,29
1656262342972,MATH 142A,B04,093558,Staff,6,0,32,26
1656262342972,MATH 142A,B05,093559,Staff,0,0,32,32
1656262348996,MATH 193A,A01,083224,Rotar; Vladimir,0,1,34,34
1656262348996,MATH 193A,A02,083225,Rotar; Vladimir,0,0,34,34
1656262348996,MATH 193A,A03,083781,Rotar; Vladimir,0,0,34,34
1656262348996,MATH 193A,A04,083782,Rotar; Vladimir,6,0,34,28
1656262348996,MATH 193A,A05,093482,Rotar; Vladimir,0,0,34,34
1656262355021,MATH 197,001,091859,McAuley; Julian John,9999,0,9999,0
1656262355021,MATH 197,002,095566,Kedlaya; Kiran S.,9997,0,9999,2
1656262355021,MATH 197,003,095567,Xiao; Ming,9999,0,9999,0
1656262355021,MATH 197,004,095571,Perols; Johan Lars,9998,0,9999,1
1656262362102,COGS 9,A01,083615,Shannon; Kyle Michael,3,0,75,72
1656262368136,COGS 11,A01,083617,Boyle; Mary E. T.,14,0,48,34
1656262374161,COGS 13,A01,083071,Bastos; Amalia Pinkusfeld,5,0,71,66
1656262380189,COGS 14A,A01,092681,Semenuks; Arturs,1,12,100,99
1656262386214,COGS 14B,A01,083073,Cheng; Tzu-Han,7,0,63,56
1656262392238,COGS 17,A01,092677,Semenuks; Arturs,8,0,81,73
1656262398282,COGS 100,A01,083619,Allen; Michael Gordon,2,0,70,68
1656262404326,COGS 101A,A01,083621,Davis; Joshua Daniel,4,0,68,64
1656262410354,COGS 101B,A01,091572,Allen; Michael Gordon,4,0,65,61
1656262416381,COGS 101C,A01,083625,Delgado; Tania,10,0,35,25
1656262422506,COGS 107A,A01,083627,Boyle; Mary E. T.,0,0,60,60
1656262428530,COGS 118A,A01,083075,Gupta; Anjum,8,0,76,68
1656262434553,CSE 3,A50,083646,Miranda; Gregory Joseph,18,0,50,32
1656262440584,CSE 8A,A50,083650,Miranda; Gregory Joseph,2,2,56,54
1656262446608,CSE 11,A01,083080,Cao; Yingjun,0,49,40,40
1656262452632,CSE 12,A01,083652,Krause-Levy; Sophia Louisa,5,1,120,115
1656262458662,CSE 15L,A01,083654,Morris; Justin Loren,2,0,50,48
1656262458662,CSE 15L,A02,083655,Morris; Justin Loren,4,0,50,46
1656262464684,CSE 20,A01,083657,Tran; Khoa Dang,30,0,80,50
1656262470706,CSE 21,A01,095574,Bach; Quang Tran,23,0,48,25
1656262476733,CSE 30,A01,083084,Eldon; John,2,6,80,78
1656262476733,CSE 30,B01,095061,Bhaskar; Nishant,0,1,50,50
1656262482757,CSE 100,A01,083659,Cao; Yingjun,1,18,70,69
1656262488784,CSE 134B,A01,083661,Powell; Thomas Allan,5,0,100,95
1656262494810,CSE 140,A01,083663,Gungor; Onat,9,0,85,76
1656262500839,CSE 140L,A01,083088,Eldon; John,8,0,100,92
1656262506875,CSE 175,A01,083665,Kumar; Rakesh,0,0,25,25
1656262512901,CSE 190,A00,092507,Dubnov; Shlomo,3,0,20,17
1656262518924,ECE 45,A01,083139,Congero; Spencer William,1,0,75,74
1656262524946,ECE 65,A50,083695,Saad; Andrew S,9,0,30,21
1656262524946,ECE 65,A51,095125,Staff,24,0,26,2
1656262530974,ECE 109,A01,091882,Touri; Behrouz,0,1,70,70
1656262537009,ECE 180,A00,083140,Abi Samra; Nicholas Camill,1,0,30,29
1656262537009,ECE 180,B00,083141,Abi Samra; Nicholas Camill,0,4,30,30
1656262543040,MATH 10A,A01,083735,Patchell; Gregory David,0,0,30,30
1656262543040,MATH 10A,A02,083736,Patchell; Gregory David,22,0,30,8
1656262543040,MATH 10A,A03,083737,Patchell; Gregory David,16,0,30,14
1656262549073,MATH 10B,A01,083207,Lim; Seonhee,0,0,34,34
1656262549073,MATH 10B,A02,083208,Lim; Seonhee,7,0,35,28
1656262549073,MATH 10B,A03,093472,Staff,1,0,34,33
1656262549073,MATH 10B,B01,083739,Sinha; Shubham,11,0,30,19
1656262555104,MATH 18,A01,083743,Cinel; Cameron Alexander,7,0,30,23
1656262555104,MATH 18,A02,083744,Cinel; Cameron Alexander,9,0,30,21
1656262555104,MATH 18,A03,083745,Cinel; Cameron Alexander,5,0,30,25
1656262555104,MATH 18,B01,083748,Rideout; David Porter,1,0,36,35
1656262555104,MATH 18,B02,083749,Rideout; David Porter,0,0,36,36
1656262555104,MATH 18,B03,083750,Rideout; David Porter,0,0,36,36
1656262555104,MATH 18,B04,083751,Rideout; David Porter,0,1,36,36
1656262555104,MATH 18,B05,093473,Rideout; David Porter,0,0,36,36
1656262555104,MATH 18,B06,093474,Rideout; David Porter,3,0,36,33
1656262561152,MATH 20A,A01,083754,Zheng; Zequn,11,0,40,29
1656262567196,MATH 20B,A01,083756,Briones; Jor-el Thomas Caparas,0,0,36,36
1656262567196,MATH 20B,A02,083757,Briones; Jor-el Thomas Caparas,0,0,36,36
1656262567196,MATH 20B,A03,093475,Staff,0,0,36,36
1656262573225,MATH 20C,A01,083760,Briones; Jor-el Thomas Caparas,0,0,35,35
1656262573225,MATH 20C,A02,083761,Briones; Jor-el Thomas Caparas,9,1,35,26
1656262573225,MATH 20C,A03,093476,Staff,0,0,35,35
1656262573225,MATH 20C,B01,083762,Bach; Quang Tran,1,0,30,29
1656262579249,MATH 20D,A01,083765,Tran; Brian Kha,1,0,30,29
1656262579249,MATH 20D,A02,083766,Tran; Brian Kha,0,1,30,30
1656262579249,MATH 20D,A03,083767,Tran; Brian Kha,2,0,30,28
1656262585282,MATH 20E,A01,083771,Ganguly; Soumya,3,0,32,29
1656262585282,MATH 20E,A02,083772,Ganguly; Soumya,0,0,32,32
1656262585282,MATH 20E,B01,083773,Ciotti; Benjamin,16,0,35,19
1656262585282,MATH 20E,B02,083774,Ciotti; Benjamin,15,0,35,20
1656262591314,MATH 103A,A01,083777,Greenfeld; Be'Eri,1,0,36,35
1656262591314,MATH 103A,A02,083778,Greenfeld; Be'Eri,1,0,36,35
1656262591314,MATH 103A,A03,093561,Staff,5,0,36,31
1656262591314,MATH 103A,B01,083779,Greenfeld; Be'Eri,8,0,36,28
1656262591314,MATH 103A,B02,083780,Greenfeld; Be'Eri,1,0,36,35
1656262591314,MATH 103A,B03,093562,Staff,0,0,36,36
1656262597344,MATH 105,A01,085443,Carter; Anne Toulson,5,0,35,30
1656262597344,MATH 105,A02,093477,Staff,14,0,35,21
1656262603381,MATH 109,A01,083213,Ganzberger; Geoffrey Michael,0,0,34,34
1656262603381,MATH 109,A02,083214,Ganzberger; Geoffrey Michael,0,0,34,34
1656262603381,MATH 109,A03,093478,Staff,1,0,34,33
1656262603381,MATH 109,B01,083215,Ganzberger; Geoffrey Michael,4,0,32,28
1656262603381,MATH 109,B02,083216,Ganzberger; Geoffrey Michael,1,0,32,31
1656262603381,MATH 109,B03,093479,Staff,3,0,32,29
1656262609403,MATH 142A,A01,083219,Chow; Bennett,2,0,32,30
1656262609403,MATH 142A,A02,083220,Chow; Bennett,8,0,32,24
1656262609403,MATH 142A,A03,093480,Staff,5,0,32,27
1656262609403,MATH 142A,B03,093481,Staff,3,0,32,29
1656262609403,MATH 142A,B04,093558,Staff,6,0,32,26
1656262609403,MATH 142A,B05,093559,Staff,0,0,32,32
1656262615432,MATH 193A,A01,083224,Rotar; Vladimir,0,1,34,34
1656262615432,MATH 193A,A02,083225,Rotar; Vladimir,0,0,34,34
1656262615432,MATH 193A,A03,083781,Rotar; Vladimir,0,0,34,34
1656262615432,MATH 193A,A04,083782,Rotar; Vladimir,6,0,34,28
1656262615432,MATH 193A,A05,093482,Rotar; Vladimir,0,0,34,34
1656262621464,MATH 197,001,091859,McAuley; Julian John,9999,0,9999,0
1656262621464,MATH 197,002,095566,Kedlaya; Kiran S.,9997,0,9999,2
1656262621464,MATH 197,003,095567,Xiao; Ming,9999,0,9999,0
1656262621464,MATH 197,004,095571,Perols; Johan Lars,9998,0,9999,1
1656262628527,COGS 9,A01,083615,Shannon; Kyle Michael,3,0,75,72
1656262634551,COGS 11,A01,083617,Boyle; Mary E. T.,14,0,48,34
1656262640579,COGS 13,A01,083071,Bastos; Amalia Pinkusfeld,5,0,71,66
1656262646604,COGS 14A,A01,092681,Semenuks; Arturs,1,12,100,99
1656262652631,COGS 14B,A01,083073,Cheng; Tzu-Han,7,0,63,56
1656262658658,COGS 17,A01,092677,Semenuks; Arturs,8,0,81,73
1656262664682,COGS 100,A01,083619,Allen; Michael Gordon,2,0,70,68
1656262670707,COGS 101A,A01,083621,Davis; Joshua Daniel,4,0,68,64
1656262676733,COGS 101B,A01,091572,Allen; Michael Gordon,4,0,65,61
1656262682760,COGS 101C,A01,083625,Delgado; Tania,10,0,35,25
1656262688783,COGS 107A,A01,083627,Boyle; Mary E. T.,0,0,60,60
1656262694807,COGS 118A,A01,083075,Gupta; Anjum,8,0,76,68
1656262700832,CSE 3,A50,083646,Miranda; Gregory Joseph,18,0,50,32
1656262706855,CSE 8A,A50,083650,Miranda; Gregory Joseph,2,2,56,54
1656262712881,CSE 11,A01,083080,Cao; Yingjun,0,49,40,40
1656262718909,CSE 12,A01,083652,Krause-Levy; Sophia Louisa,5,1,120,115
1656262724933,CSE 15L,A01,083654,Morris; Justin Loren,2,0,50,48
1656262724933,CSE 15L,A02,083655,Morris; Justin Loren,4,0,50,46
1656262730958,CSE 20,A01,083657,Tran; Khoa Dang,30,0,80,50
1656262736982,CSE 21,A01,095574,Bach; Quang Tran,23,0,48,25
1656262743013,CSE 30,A01,083084,Eldon; John,2,6,80,78
1656262743013,CSE 30,B01,095061,Bhaskar; Nishant,0,1,50,50
1656262749039,CSE 100,A01,083659,Cao; Yingjun,1,18,70,69
1656262755083,CSE 134B,A01,083661,Powell; Thomas Allan,5,0,100,95
1656262761121,CSE 140,A01,083663,Gungor; Onat,9,0,85,76
1656262767155,CSE 140L,A01,083088,Eldon; John,8,0,100,92
1656262773190,CSE 175,A01,083665,Kumar; Rakesh,0,0,25,25
1656262779220,CSE 190,A00,092507,Dubnov; Shlomo,3,0,20,17
1656262785241,ECE 45,A01,083139,Congero; Spencer William,1,0,75,74
1656262791269,ECE 65,A50,083695,Saad; Andrew S,9,0,30,21
1656262791269,ECE 65,A51,095125,Staff,24,0,26,2
1656262797296,ECE 109,A01,091882,Touri; Behrouz,0,1,70,70
1656262803336,ECE 180,A00,083140,Abi Samra; Nicholas Camill,1,0,30,29
1656262803336,ECE 180,B00,083141,Abi Samra; Nicholas Camill,0,4,30,30
1656262809375,MATH 10A,A01,083735,Patchell; Gregory David,0,0,30,30
1656262809375,MATH 10A,A02,083736,Patchell; Gregory David,22,0,30,8
1656262809375,MATH 10A,A03,083737,Patchell; Gregory David,16,0,30,14
1656262815400,MATH 10B,A01,083207,Lim; Seonhee,0,0,34,34
1656262815400,MATH 10B,A02,083208,Lim; Seonhee,7,0,35,28
1656262815400,MATH 10B,A03,093472,Staff,1,0,34,33
1656262815400,MATH 10B,B01,083739,Sinha; Shubham,11,0,30,19
1656262821426,MATH 18,A01,083743,Cinel; Cameron Alexander,7,0,30,23
1656262821426,MATH 18,A02,083744,Cinel; Cameron Alexander,9,0,30,21
1656262821426,MATH 18,A03,083745,Cinel; Cameron Alexander,5,0,30,25
1656262821426,MATH 18,B01,083748,Rideout; David Porter,1,0,36,35
1656262821426,MATH 18,B02,083749,Rideout; David Porter,0,0,36,36
1656262821426,MATH 18,B03,083750,Rideout; David Porter,0,0,36,36
1656262821426,MATH 18,B04,083751,Rideout; David Porter,0,1,36,36
1656262821426,MATH 18,B05,093473,Rideout; David Porter,0,0,36,36
1656262821426,MATH 18,B06,093474,Rideout; David Porter,3,0,36,33
1656262827453,MATH 20A,A01,083754,Zheng; Zequn,11,0,40,29
1656262833490,MATH 20B,A01,083756,Briones; Jor-el Thomas Caparas,0,0,36,36
1656262833490,MATH 20B,A02,083757,Briones; Jor-el Thomas Caparas,0,0,36,36
1656262833490,MATH 20B,A03,093475,Staff,0,0,36,36
1656262839513,MATH 20C,A01,083760,Briones; Jor-el Thomas Caparas,0,0,35,35
1656262839513,MATH 20C,A02,083761,Briones; Jor-el Thomas Caparas,9,1,35,26
1656262839513,MATH 20C,A03,093476,Staff,0,0,35,35
1656262839513,MATH 20C,B01,083762,Bach; Quang Tran,1,0,30,29
1656262845585,MATH 20D,A01,083765,Tran; Brian Kha,1,0,30,29
1656262845585,MATH 20D,A02,083766,Tran; Brian Kha,0,1,30,30
1656262845585,MATH 20D,A03,083767,Tran; Brian Kha,2,0,30,28
1656262851646,MATH 20E,A01,083771,Ganguly; Soumya,3,0,32,29
1656262851646,MATH 20E,A02,083772,Ganguly; Soumya,0,0,32,32
1656262851646,MATH 20E,B01,083773,Ciotti; Benjamin,16,0,35,19
1656262851646,MATH 20E,B02,083774,Ciotti; Benjamin,15,0,35,20
1656262857670,MATH 103A,A01,083777,Greenfeld; Be'Eri,1,0,36,35
1656262857670,MATH 103A,A02,083778,Greenfeld; Be'Eri,1,0,36,35
1656262857670,MATH 103A,A03,093561,Staff,5,0,36,31
1656262857670,MATH 103A,B01,083779,Greenfeld; Be'Eri,8,0,36,28
1656262857670,MATH 103A,B02,083780,Greenfeld; Be'Eri,1,0,36,35
1656262857670,MATH 103A,B03,093562,Staff,0,0,36,36
1656262863706,MATH 105,A01,085443,Carter; Anne Toulson,5,0,35,30
1656262863706,MATH 105,A02,093477,Staff,14,0,35,21
1656262869749,MATH 109,A01,083213,Ganzberger; Geoffrey Michael,0,0,34,34
1656262869749,MATH 109,A02,083214,Ganzberger; Geoffrey Michael,0,0,34,34
1656262869749,MATH 109,A03,093478,Staff,1,0,34,33
1656262869749,MATH 109,B01,083215,Ganzberger; Geoffrey Michael,4,0,32,28
1656262869749,MATH 109,B02,083216,Ganzberger; Geoffrey Michael,1,0,32,31
1656262869749,MATH 109,B03,093479,Staff,3,0,32,29
1656262875788,MATH 142A,A01,083219,Chow; Bennett,2,0,32,30
1656262875788,MATH 142A,A02,083220,Chow; Bennett,8,0,32,24
1656262875788,MATH 142A,A03,093480,Staff,5,0,32,27
1656262875788,MATH 142A,B03,093481,Staff,3,0,32,29
1656262875788,MATH 142A,B04,093558,Staff,6,0,32,26
1656262875788,MATH 142A,B05,093559,Staff,0,0,32,32
1656262881822,MATH 193A,A01,083224,Rotar; Vladimir,0,1,34,34
1656262881822,MATH 193A,A02,083225,Rotar; Vladimir,0,0,34,34
1656262881822,MATH 193A,A03,083781,Rotar; Vladimir,0,0,34,34
1656262881822,MATH 193A,A04,083782,Rotar; Vladimir,6,0,34,28
1656262881822,MATH 193A,A05,093482,Rotar; Vladimir,0,0,34,34
1656262887845,MATH 197,001,091859,McAuley; Julian John,9999,0,9999,0
1656262887845,MATH 197,002,095566,Kedlaya; Kiran S.,9997,0,9999,2
1656262887845,MATH 197,003,095567,Xiao; Ming,9999,0,9999,0
1656262887845,MATH 197,004,095571,Perols; Johan Lars,9998,0,9999,1
1656262894919,COGS 9,A01,083615,Shannon; Kyle Michael,3,0,75,72
1656262900946,COGS 11,A01,083617,Boyle; Mary E. T.,14,0,48,34
1656262906969,COGS 13,A01,083071,Bastos; Amalia Pinkusfeld,5,0,71,66
1656262912994,COGS 14A,A01,092681,Semenuks; Arturs,1,12,100,99
1656262919023,COGS 14B,A01,083073,Cheng; Tzu-Han,7,0,63,56
1656262925046,COGS 17,A01,092677,Semenuks; Arturs,8,0,81,73
1656262931069,COGS 100,A01,083619,Allen; Michael Gordon,2,0,70,68
1656262937094,COGS 101A,A01,083621,Davis; Joshua Daniel,4,0,68,64
1656262943119,COGS 101B,A01,091572,Allen; Michael Gordon,4,0,65,61
1656262949154,COGS 101C,A01,083625,Delgado; Tania,10,0,35,25
1656262955182,COGS 107A,A01,083627,Boyle; Mary E. T.,0,0,60,60
1656262961215,COGS 118A,A01,083075,Gupta; Anjum,8,0,76,68
1656262967240,CSE 3,A50,083646,Miranda; Gregory Joseph,18,0,50,32
1656262973266,CSE 8A,A50,083650,Miranda; Gregory Joseph,2,2,56,54
1656262979291,CSE 11,A01,083080,Cao; Yingjun,0,49,40,40
1656262985314,CSE 12,A01,083652,Krause-Levy; Sophia Louisa,5,1,120,115
1656262991342,CSE 15L,A01,083654,Morris; Justin Loren,2,0,50,48
1656262991342,CSE 15L,A02,083655,Morris; Justin Loren,4,0,50,46
1656262997365,CSE 20,A01,083657,Tran; Khoa Dang,30,0,80,50
1656263003393,CSE 21,A01,095574,Bach; Quang Tran,23,0,48,25
1656263009416,CSE 30,A01,083084,Eldon; John,2,6,80,78
1656263009416,CSE 30,B01,095061,Bhaskar; Nishant,0,1,50,50
1656263015441,CSE 100,A01,083659,Cao; Yingjun,1,18,70,69
1656263021557,CSE 134B,A01,083661,Powell; Thomas Allan,5,0,100,95
1656263027593,CSE 140,A01,083663,Gungor; Onat,9,0,85,76
1656263033626,CSE 140L,A01,083088,Eldon; John,8,0,100,92
1656263039657,CSE 175,A01,083665,Kumar; Rakesh,0,0,25,25
1656263045685,CSE 190,A00,092507,Dubnov; Shlomo,3,0,20,17
1656263051720,ECE 45,A01,083139,Congero; Spencer William,1,0,75,74
1656263057755,ECE 65,A50,083695,Saad; Andrew S,9,0,30,21
1656263057755,ECE 65,A51,095125,Staff,24,0,26,2
1656263063781,ECE 109,A01,091882,Touri; Behrouz,0,1,70,70
1656263069804,ECE 180,A00,083140,Abi Samra; Nicholas Camill,1,0,30,29
1656263069804,ECE 180,B00,083141,Abi Samra; Nicholas Camill,0,4,30,30
1656263075851,MATH 10A,A01,083735,Patchell; Gregory David,0,0,30,30
1656263075851,MATH 10A,A02,083736,Patchell; Gregory David,22,0,30,8
1656263075851,MATH 10A,A03,083737,Patchell; Gregory David,16,0,30,14
1656263081900,MATH 10B,A01,083207,Lim; Seonhee,0,0,34,34
1656263081900,MATH 10B,A02,083208,Lim; Seonhee,7,0,35,28
1656263081900,MATH 10B,A03,093472,Staff,1,0,34,33
1656263081900,MATH 10B,B01,083739,Sinha; Shubham,11,0,30,19
1656263087950,MATH 18,A01,083743,Cinel; Cameron Alexander,7,0,30,23
1656263087950,MATH 18,A02,083744,Cinel; Cameron Alexander,9,0,30,21
1656263087950,MATH 18,A03,083745,Cinel; Cameron Alexander,5,0,30,25
1656263087950,MATH 18,B01,083748,Rideout; David Porter,1,0,36,35
1656263087950,MATH 18,B02,083749,Rideout; David Porter,0,0,36,36
1656263087950,MATH 18,B03,083750,Rideout; David Porter,0,0,36,36
1656263087950,MATH 18,B04,083751,Rideout; David Porter,0,1,36,36
1656263087950,MATH 18,B05,093473,Rideout; David Porter,0,0,36,36
1656263087950,MATH 18,B06,093474,Rideout; David Porter,3,0,36,33
1656263093992,MATH 20A,A01,083754,Zheng; Zequn,11,0,40,29
1656263100033,MATH 20B,A01,083756,Briones; Jor-el Thomas Caparas,0,0,36,36
1656263100033,MATH 20B,A02,083757,Briones; Jor-el Thomas Caparas,0,0,36,36
1656263100033,MATH 20B,A03,093475,Staff,0,0,36,36
1656263106057,MATH 20C,A01,083760,Briones; Jor-el Thomas Caparas,0,0,35,35
1656263106057,MATH 20C,A02,083761,Briones; Jor-el Thomas Caparas,9,1,35,26
1656263106057,MATH 20C,A03,093476,Staff,0,0,35,35
1656263106057,MATH 20C,B01,083762,Bach; Quang Tran,1,0,30,29
1656263112116,MATH 20D,A01,083765,Tran; Brian Kha,1,0,30,29
1656263112116,MATH 20D,A02,083766,Tran; Brian Kha,0,1,30,30
1656263112116,MATH 20D,A03,083767,Tran; Brian Kha,2,0,30,28
1656263118145,MATH 20E,A01,083771,Ganguly; Soumya,3,0,32,29
1656263118145,MATH 20E,A02,083772,Ganguly; Soumya,0,0,32,32
1656263118145,MATH 20E,B01,083773,Ciotti; Benjamin,16,0,35,19
1656263118145,MATH 20E,B02,083774,Ciotti; Benjamin,15,0,35,20
1656263124168,MATH 103A,A01,083777,Greenfeld; Be'Eri,1,0,36,35
1656263124168,MATH 103A,A02,083778,Greenfeld; Be'Eri,1,0,36,35
1656263124168,MATH 103A,A03,093561,Staff,5,0,36,31
1656263124168,MATH 103A,B01,083779,Greenfeld; Be'Eri,8,0,36,28
1656263124168,MATH 103A,B02,083780,Greenfeld; Be'Eri,1,0,36,35
1656263124168,MATH 103A,B03,093562,Staff,0,0,36,36
1656263130192,MATH 105,A01,085443,Carter; Anne Toulson,5,0,35,30
1656263130192,MATH 105,A02,093477,Staff,14,0,35,21
1656263136215,MATH 109,A01,083213,Ganzberger; Geoffrey Michael,0,0,34,34
1656263136215,MATH 109,A02,083214,Ganzberger; Geoffrey Michael,0,0,34,34
1656263136215,MATH 109,A03,093478,Staff,1,0,34,33
1656263136215,MATH 109,B01,083215,Ganzberger; Geoffrey Michael,4,0,32,28
1656263136215,MATH 109,B02,083216,Ganzberger; Geoffrey Michael,1,0,32,31
1656263136215,MATH 109,B03,093479,Staff,3,0,32,29
1656263142240,MATH 142A,A01,083219,Chow; Bennett,2,0,32,30
1656263142240,MATH 142A,A02,083220,Chow; Bennett,8,0,32,24
1656263142240,MATH 142A,A03,093480,Staff,5,0,32,27
1656263142240,MATH 142A,B03,093481,Staff,3,0,32,29
1656263142240,MATH 142A,B04,093558,Staff,6,0,32,26
1656263142240,MATH 142A,B05,093559,Staff,0,0,32,32
1656263148285,MATH 193A,A01,083224,Rotar; Vladimir,0,1,34,34
1656263148285,MATH 193A,A02,083225,Rotar; Vladimir,0,0,34,34
1656263148285,MATH 193A,A03,083781,Rotar; Vladimir,0,0,34,34
1656263148285,MATH 193A,A04,083782,Rotar; Vladimir,6,0,34,28
1656263148285,MATH 193A,A05,093482,Rotar; Vladimir,0,0,34,34
1656263154311,MATH 197,001,091859,McAuley; Julian John,9999,0,9999,0
1656263154311,MATH 197,002,095566,Kedlaya; Kiran S.,9997,0,9999,2
1656263154311,MATH 197,003,095567,Xiao; Ming,9999,0,9999,0
1656263154311,MATH 197,004,095571,Perols; Johan Lars,9998,0,9999,1
1656263161383,COGS 9,A01,083615,Shannon; Kyle Michael,3,0,75,72
1656263167440,COGS 11,A01,083617,Boyle; Mary E. T.,14,0,48,34
1656263173467,COGS 13,A01,083071,Bastos; Amalia Pinkusfeld,5,0,71,66
1656263179492,COGS 14A,A01,092681,Semenuks; Arturs,1,12,100,99
1656263185536,COGS 14B,A01,083073,Cheng; Tzu-Han,7,0,63,56
1656263191571,COGS 17,A01,092677,Semenuks; Arturs,8,0,81,73
1656263197598,COGS 100,A01,083619,Allen; Michael Gordon,2,0,70,68
1656263203627,COGS 101A,A01,083621,Davis; Joshua Daniel,4,0,68,64
1656263209668,COGS 101B,A01,091572,Allen; Michael Gordon,4,0,65,61
1656263215697,COGS 101C,A01,083625,Delgado; Tania,10,0,35,25
1656263221724,COGS 107A,A01,083627,Boyle; Mary E. T.,0,0,60,60
1656263227751,COGS 118A,A01,083075,Gupta; Anjum,8,0,76,68
1656263233787,CSE 3,A50,083646,Miranda; Gregory Joseph,18,0,50,32
1656263239840,CSE 8A,A50,083650,Miranda; Gregory Joseph,2,2,56,54
1656263245867,CSE 11,A01,083080,Cao; Yingjun,0,49,40,40
1656263251891,CSE 12,A01,083652,Krause-Levy; Sophia Louisa,5,1,120,115
1656263257919,CSE 15L,A01,083654,Morris; Justin Loren,2,0,50,48
1656263257919,CSE 15L,A02,083655,Morris; Justin Loren,4,0,50,46
1656263263943,CSE 20,A01,083657,Tran; Khoa Dang,30,0,80,50
1656263269969,CSE 21,A01,095574,Bach; Quang Tran,23,0,48,25
1656263275996,CSE 30,A01,083084,Eldon; John,2,6,80,78
1656263275996,CSE 30,B01,095061,Bhaskar; Nishant,0,1,50,50
1656263282017,CSE 100,A01,083659,Cao; Yingjun,1,18,70,69
1656263288051,CSE 134B,A01,083661,Powell; Thomas Allan,5,0,100,95
1656263294075,CSE 140,A01,083663,Gungor; Onat,9,0,85,76
1656263300103,CSE 140L,A01,083088,Eldon; John,8,0,100,92
1656263306130,CSE 175,A01,083665,Kumar; Rakesh,0,0,25,25
1656263312163,CSE 190,A00,092507,Dubnov; Shlomo,3,0,20,17
1656263318194,ECE 45,A01,083139,Congero; Spencer William,1,0,75,74
1656263324243,ECE 65,A50,083695,Saad; Andrew S,9,0,30,21
1656263324243,ECE 65,A51,095125,Staff,24,0,26,2
1656263330275,ECE 109,A01,091882,Touri; Behrouz,0,1,70,70
1656263336298,ECE 180,A00,083140,Abi Samra; Nicholas Camill,1,0,30,29
1656263336298,ECE 180,B00,083141,Abi Samra; Nicholas Camill,0,4,30,30
1656263342339,MATH 10A,A01,083735,Patchell; Gregory David,0,0,30,30
1656263342339,MATH 10A,A02,083736,Patchell; Gregory David,22,0,30,8
1656263342339,MATH 10A,A03,083737,Patchell; Gregory David,16,0,30,14
1656263348371,MATH 10B,A01,083207,Lim; Seonhee,0,0,34,34
1656263348371,MATH 10B,A02,083208,Lim; Seonhee,7,0,35,28
1656263348371,MATH 10B,A03,093472,Staff,1,0,34,33
1656263348371,MATH 10B,B01,083739,Sinha; Shubham,11,0,30,19
1656263354397,MATH 18,A01,083743,Cinel; Cameron Alexander,7,0,30,23
1656263354397,MATH 18,A02,083744,Cinel; Cameron Alexander,9,0,30,21
1656263354397,MATH 18,A03,083745,Cinel; Cameron Alexander,5,0,30,25
1656263354397,MATH 18,B01,083748,Rideout; David Porter,1,0,36,35
1656263354397,MATH 18,B02,083749,Rideout; David Porter,0,0,36,36
1656263354397,MATH 18,B03,083750,Rideout; David Porter,0,0,36,36
1656263354397,MATH 18,B04,083751,Rideout; David Porter,0,1,36,36
1656263354397,MATH 18,B05,093473,Rideout; David Porter,0,0,36,36
1656263354397,MATH 18,B06,093474,Rideout; David Porter,3,0,36,33
1656263360422,MATH 20A,A01,083754,Zheng; Zequn,11,0,40,29
1656263366445,MATH 20B,A01,083756,Briones; Jor-el Thomas Caparas,0,0,36,36
1656263366445,MATH 20B,A02,083757,Briones; Jor-el Thomas Caparas,0,0,36,36
1656263366445,MATH 20B,A03,093475,Staff,0,0,36,36
1656263372480,MATH 20C,A01,083760,Briones; Jor-el Thomas Caparas,0,0,35,35
1656263372480,MATH 20C,A02,083761,Briones; Jor-el Thomas Caparas,9,1,35,26
1656263372480,MATH 20C,A03,093476,Staff,0,0,35,35
1656263372480,MATH 20C,B01,083762,Bach; Quang Tran,1,0,30,29
1656263378521,MATH 20D,A01,083765,Tran; Brian Kha,1,0,30,29
1656263378521,MATH 20D,A02,083766,Tran; Brian Kha,0,1,30,30
1656263378521,MATH 20D,A03,083767,Tran; Brian Kha,2,0,30,28
1656263384548,MATH 20E,A01,083771,Ganguly; Soumya,3,0,32,29
1656263384548,MATH 20E,A02,083772,Ganguly; Soumya,0,0,32,32
1656263384548,MATH 20E,B01,083773,Ciotti; Benjamin,16,0,35,19
1656263384548,MATH 20E,B02,083774,Ciotti; Benjamin,15,0,35,20
1656263390573,MATH 103A,A01,083777,Greenfeld; Be'Eri,1,0,36,35
1656263390573,MATH 103A,A02,083778,Greenfeld; Be'Eri,1,0,36,35
1656263390573,MATH 103A,A03,093561,Staff,5,0,36,31
1656263390573,MATH 103A,B01,083779,Greenfeld; Be'Eri,8,0,36,28
1656263390573,MATH 103A,B02,083780,Greenfeld; Be'Eri,1,0,36,35
1656263390573,MATH 103A,B03,093562,Staff,0,0,36,36
1656263396599,MATH 105,A01,085443,Carter; Anne Toulson,5,0,35,30
1656263396599,MATH 105,A02,093477,Staff,14,0,35,21
1656263402631,MATH 109,A01,083213,Ganzberger; Geoffrey Michael,0,0,34,34
1656263402631,MATH 109,A02,083214,Ganzberger; Geoffrey Michael,0,0,34,34
1656263402631,MATH 109,A03,093478,Staff,1,0,34,33
1656263402631,MATH 109,B01,083215,Ganzberger; Geoffrey Michael,4,0,32,28
1656263402631,MATH 109,B02,083216,Ganzberger; Geoffrey Michael,1,0,32,31
1656263402631,MATH 109,B03,093479,Staff,3,0,32,29
1656263408660,MATH 142A,A01,083219,Chow; Bennett,2,0,32,30
1656263408660,MATH 142A,A02,083220,Chow; Bennett,8,0,32,24
1656263408660,MATH 142A,A03,093480,Staff,5,0,32,27
1656263408660,MATH 142A,B03,093481,Staff,3,0,32,29
1656263408660,MATH 142A,B04,093558,Staff,6,0,32,26
1656263408660,MATH 142A,B05,093559,Staff,0,0,32,32
1656263414685,MATH 193A,A01,083224,Rotar; Vladimir,0,1,34,34
1656263414685,MATH 193A,A02,083225,Rotar; Vladimir,0,0,34,34
1656263414685,MATH 193A,A03,083781,Rotar; Vladimir,0,0,34,34
1656263414685,MATH 193A,A04,083782,Rotar; Vladimir,6,0,34,28
1656263414685,MATH 193A,A05,093482,Rotar; Vladimir,0,0,34,34
1656263420725,MATH 197,001,091859,McAuley; Julian John,9999,0,9999,0
1656263420725,MATH 197,002,095566,Kedlaya; Kiran S.,9997,0,9999,2
1656263420725,MATH 197,003,095567,Xiao; Ming,9999,0,9999,0
1656263420725,MATH 197,004,095571,Perols; Johan Lars,9998,0,9999,1
1656263427792,COGS 9,A01,083615,Shannon; Kyle Michael,3,0,75,72
1656263433843,COGS 11,A01,083617,Boyle; Mary E. T.,14,0,48,34
1656263439875,COGS 13,A01,083071,Bastos; Amalia Pinkusfeld,5,0,71,66
1656263445911,COGS 14A,A01,092681,Semenuks; Arturs,1,12,100,99
1656263451938,COGS 14B,A01,083073,Cheng; Tzu-Han,7,0,63,56
1656263457971,COGS 17,A01,092677,Semenuks; Arturs,8,0,81,73
1656263464001,COGS 100,A01,083619,Allen; Michael Gordon,2,0,70,68
1656263470037,COGS 101A,A01,083621,Davis; Joshua Daniel,4,0,68,64
1656263476074,COGS 101B,A01,091572,Allen; Michael Gordon,4,0,65,61
1656263482098,COGS 101C,A01,083625,Delgado; Tania,10,0,35,25
1656263488160,COGS 107A,A01,083627,Boyle; Mary E. T.,0,0,60,60
1656263494192,COGS 118A,A01,083075,Gupta; Anjum,8,0,76,68
1656263500228,CSE 3,A50,083646,Miranda; Gregory Joseph,18,0,50,32
1656263506278,CSE 8A,A50,083650,Miranda; Gregory Joseph,2,2,56,54
1656263512303,CSE 11,A01,083080,Cao; Yingjun,0,49,40,40
1656263518342,CSE 12,A01,083652,Krause-Levy; Sophia Louisa,5,1,120,115
1656263524390,CSE 15L,A01,083654,Morris; Justin Loren,2,0,50,48
1656263524390,CSE 15L,A02,083655,Morris; Justin Loren,4,0,50,46
1656263530414,CSE 20,A01,083657,Tran; Khoa Dang,30,0,80,50
1656263536436,CSE 21,A01,095574,Bach; Quang Tran,23,0,48,25
1656263542460,CSE 30,A01,083084,Eldon; John,2,6,80,78
1656263542460,CSE 30,B01,095061,Bhaskar; Nishant,0,1,50,50
1656263548484,CSE 100,A01,083659,Cao; Yingjun,1,18,70,69
1656263554507,CSE 134B,A01,083661,Powell; Thomas Allan,5,0,100,95
1656263560541,CSE 140,A01,083663,Gungor; Onat,9,0,85,76
1656263566564,CSE 140L,A01,083088,Eldon; John,8,0,100,92
1656263572598,CSE 175,A01,083665,Kumar; Rakesh,0,0,25,25
1656263578624,CSE 190,A00,092507,Dubnov; Shlomo,3,0,20,17
1656263584652,ECE 45,A01,083139,Congero; Spencer William,1,0,75,74
1656263590685,ECE 65,A50,083695,Saad; Andrew S,9,0,30,21
1656263590685,ECE 65,A51,095125,Staff,24,0,26,2
1656263596720,ECE 109,A01,091882,Touri; Behrouz,0,1,70,70
1656263602757,ECE 180,A00,083140,Abi Samra; Nicholas Camill,1,0,30,29
1656263602757,ECE 180,B00,083141,Abi Samra; Nicholas Camill,0,4,30,30
1656263608781,MATH 10A,A01,083735,Patchell; Gregory David,0,0,30,30
1656263608781,MATH 10A,A02,083736,Patchell; Gregory David,22,0,30,8
1656263608781,MATH 10A,A03,083737,Patchell; Gregory David,16,0,30,14
1656263614809,MATH 10B,A01,083207,Lim; Seonhee,0,0,34,34
1656263614809,MATH 10B,A02,083208,Lim; Seonhee,7,0,35,28
1656263614809,MATH 10B,A03,093472,Staff,1,0,34,33
1656263614809,MATH 10B,B01,083739,Sinha; Shubham,11,0,30,19
1656263620940,MATH 18,A01,083743,Cinel; Cameron Alexander,7,0,30,23
1656263620940,MATH 18,A02,083744,Cinel; Cameron Alexander,9,0,30,21
1656263620940,MATH 18,A03,083745,Cinel; Cameron Alexander,5,0,30,25
1656263620940,MATH 18,B01,083748,Rideout; David Porter,1,0,36,35
1656263620940,MATH 18,B02,083749,Rideout; David Porter,0,0,36,36
1656263620940,MATH 18,B03,083750,Rideout; David Porter,0,0,36,36
1656263620940,MATH 18,B04,083751,Rideout; David Porter,0,1,36,36
1656263620940,MATH 18,B05,093473,Rideout; David Porter,0,0,36,36
1656263620940,MATH 18,B06,093474,Rideout; David Porter,3,0,36,33
1656263626976,MATH 20A,A01,083754,Zheng; Zequn,11,0,40,29
1656263633014,MATH 20B,A01,083756,Briones; Jor-el Thomas Caparas,0,0,36,36
1656263633014,MATH 20B,A02,083757,Briones; Jor-el Thomas Caparas,0,0,36,36
1656263633014,MATH 20B,A03,093475,Staff,0,0,36,36
1656263639076,MATH 20C,A01,083760,Briones; Jor-el Thomas Caparas,0,0,35,35
1656263639076,MATH 20C,A02,083761,Briones; Jor-el Thomas Caparas,9,1,35,26
1656263639076,MATH 20C,A03,093476,Staff,0,0,35,35
1656263639076,MATH 20C,B01,083762,Bach; Quang Tran,1,0,30,29
1656263645111,MATH 20D,A01,083765,Tran; Brian Kha,1,0,30,29
1656263645111,MATH 20D,A02,083766,Tran; Brian Kha,0,1,30,30
1656263645111,MATH 20D,A03,083767,Tran; Brian Kha,2,0,30,28
1656263651150,MATH 20E,A01,083771,Ganguly; Soumya,3,0,32,29
1656263651150,MATH 20E,A02,083772,Ganguly; Soumya,0,0,32,32
1656263651150,MATH 20E,B01,083773,Ciotti; Benjamin,16,0,35,19
1656263651150,MATH 20E,B02,083774,Ciotti; Benjamin,15,0,35,20
1656263657176,MATH 103A,A01,083777,Greenfeld; Be'Eri,1,0,36,35
1656263657176,MATH 103A,A02,083778,Greenfeld; Be'Eri,1,0,36,35
1656263657176,MATH 103A,A03,093561,Staff,5,0,36,31
1656263657176,MATH 103A,B01,083779,Greenfeld; Be'Eri,8,0,36,28
1656263657176,MATH 103A,B02,083780,Greenfeld; Be'Eri,1,0,36,35
1656263657176,MATH 103A,B03,093562,Staff,0,0,36,36
1656263663206,MATH 105,A01,085443,Carter; Anne Toulson,5,0,35,30
1656263663206,MATH 105,A02,093477,Staff,14,0,35,21
1656263669246,MATH 109,A01,083213,Ganzberger; Geoffrey Michael,0,0,34,34
1656263669246,MATH 109,A02,083214,Ganzberger; Geoffrey Michael,0,0,34,34
1656263669246,MATH 109,A03,093478,Staff,1,0,34,33
1656263669246,MATH 109,B01,083215,Ganzberger; Geoffrey Michael,4,0,32,28
1656263669246,MATH 109,B02,083216,Ganzberger; Geoffrey Michael,1,0,32,31
1656263669246,MATH 109,B03,093479,Staff,3,0,32,29
1656263675271,MATH 142A,A01,083219,Chow; Bennett,2,0,32,30
1656263675271,MATH 142A,A02,083220,Chow; Bennett,8,0,32,24
1656263675271,MATH 142A,A03,093480,Staff,5,0,32,27
1656263675271,MATH 142A,B03,093481,Staff,3,0,32,29
1656263675271,MATH 142A,B04,093558,Staff,6,0,32,26
1656263675271,MATH 142A,B05,093559,Staff,0,0,32,32
1656263681305,MATH 193A,A01,083224,Rotar; Vladimir,0,1,34,34
1656263681305,MATH 193A,A02,083225,Rotar; Vladimir,0,0,34,34
1656263681305,MATH 193A,A03,083781,Rotar; Vladimir,0,0,34,34
1656263681305,MATH 193A,A04,083782,Rotar; Vladimir,6,0,34,28
1656263681305,MATH 193A,A05,093482,Rotar; Vladimir,0,0,34,34
1656263687344,MATH 197,001,091859,McAuley; Julian John,9999,0,9999,0
1656263687344,MATH 197,002,095566,Kedlaya; Kiran S.,9997,0,9999,2
1656263687344,MATH 197,003,095567,Xiao; Ming,9999,0,9999,0
1656263687344,MATH 197,004,095571,Perols; Johan Lars,9998,0,9999,1
1656263694452,COGS 9,A01,083615,Shannon; Kyle Michael,3,0,75,72
1656263700494,COGS 11,A01,083617,Boyle; Mary E. T.,14,0,48,34
1656263706516,COGS 13,A01,083071,Bastos; Amalia Pinkusfeld,5,0,71,66
1656263712553,COGS 14A,A01,092681,Semenuks; Arturs,1,12,100,99
1656263718576,COGS 14B,A01,083073,Cheng; Tzu-Han,7,0,63,56
1656263724607,COGS 17,A01,092677,Semenuks; Arturs,8,0,81,73
1656263730638,COGS 100,A01,083619,Allen; Michael Gordon,2,0,70,68
1656263736686,COGS 101A,A01,083621,Davis; Joshua Daniel,4,0,68,64
1656263742720,COGS 101B,A01,091572,Allen; Michael Gordon,4,0,65,61
1656263748770,COGS 101C,A01,083625,Delgado; Tania,10,0,35,25
1656263754793,COGS 107A,A01,083627,Boyle; Mary E. T.,0,0,60,60
1656263760817,COGS 118A,A01,083075,Gupta; Anjum,8,0,76,68
1656263766859,CSE 3,A50,083646,Miranda; Gregory Joseph,18,0,50,32
1656263772887,CSE 8A,A50,083650,Miranda; Gregory Joseph,2,2,56,54
1656263778921,CSE 11,A01,083080,Cao; Yingjun,0,49,40,40
1656263784945,CSE 12,A01,083652,Krause-Levy; Sophia Louisa,5,1,120,115
1656263790978,CSE 15L,A01,083654,Morris; Justin Loren,2,0,50,48
1656263790978,CSE 15L,A02,083655,Morris; Justin Loren,4,0,50,46
1656263797002,CSE 20,A01,083657,Tran; Khoa Dang,30,0,80,50
1656263803026,CSE 21,A01,095574,Bach; Quang Tran,23,0,48,25
1656263809070,CSE 30,A01,083084,Eldon; John,2,6,80,78
1656263809070,CSE 30,B01,095061,Bhaskar; Nishant,0,1,50,50
1656263815098,CSE 100,A01,083659,Cao; Yingjun,1,18,70,69
1656263821146,CSE 134B,A01,083661,Powell; Thomas Allan,5,0,100,95
1656263827177,CSE 140,A01,083663,Gungor; Onat,9,0,85,76
1656263833229,CSE 140L,A01,083088,Eldon; John,8,0,100,92
1656263839261,CSE 175,A01,083665,Kumar; Rakesh,0,0,25,25
1656263845307,CSE 190,A00,092507,Dubnov; Shlomo,3,0,20,17
1656263851336,ECE 45,A01,083139,Congero; Spencer William,1,0,75,74
1656263857364,ECE 65,A50,083695,Saad; Andrew S,9,0,30,21
1656263857364,ECE 65,A51,095125,Staff,24,0,26,2
1656263863387,ECE 109,A01,091882,Touri; Behrouz,0,1,70,70
1656263869423,ECE 180,A00,083140,Abi Samra; Nicholas Camill,1,0,30,29
1656263869423,ECE 180,B00,083141,Abi Samra; Nicholas Camill,0,4,30,30
1656263875458,MATH 10A,A01,083735,Patchell; Gregory David,0,0,30,30
1656263875458,MATH 10A,A02,083736,Patchell; Gregory David,22,0,30,8
1656263875458,MATH 10A,A03,083737,Patchell; Gregory David,16,0,30,14
1656263881491,MATH 10B,A01,083207,Lim; Seonhee,0,0,34,34
1656263881491,MATH 10B,A02,083208,Lim; Seonhee,7,0,35,28
1656263881491,MATH 10B,A03,093472,Staff,1,0,34,33
1656263881491,MATH 10B,B01,083739,Sinha; Shubham,11,0,30,19
1656263887515,MATH 18,A01,083743,Cinel; Cameron Alexander,7,0,30,23
1656263887515,MATH 18,A02,083744,Cinel; Cameron Alexander,9,0,30,21
1656263887515,MATH 18,A03,083745,Cinel; Cameron Alexander,5,0,30,25
1656263887515,MATH 18,B01,083748,Rideout; David Porter,1,0,36,35
1656263887515,MATH 18,B02,083749,Rideout; David Porter,0,0,36,36
1656263887515,MATH 18,B03,083750,Rideout; David Porter,0,0,36,36
1656263887515,MATH 18,B04,083751,Rideout; David Porter,0,1,36,36
1656263887515,MATH 18,B05,093473,Rideout; David Porter,0,0,36,36
1656263887515,MATH 18,B06,093474,Rideout; David Porter,3,0,36,33
1656263893538,MATH 20A,A01,083754,Zheng; Zequn,11,0,40,29
1656263899566,MATH 20B,A01,083756,Briones; Jor-el Thomas Caparas,0,0,36,36
1656263899566,MATH 20B,A02,083757,Briones; Jor-el Thomas Caparas,0,0,36,36
1656263899566,MATH 20B,A03,093475,Staff,0,0,36,36
1656263905589,MATH 20C,A01,083760,Briones; Jor-el Thomas Caparas,0,0,35,35
1656263905589,MATH 20C,A02,083761,Briones; Jor-el Thomas Caparas,9,1,35,26
1656263905589,MATH 20C,A03,093476,Staff,0,0,35,35
1656263905589,MATH 20C,B01,083762,Bach; Quang Tran,1,0,30,29
1656263911645,MATH 20D,A01,083765,Tran; Brian Kha,1,0,30,29
1656263911645,MATH 20D,A02,083766,Tran; Brian Kha,0,1,30,30
1656263911645,MATH 20D,A03,083767,Tran; Brian Kha,2,0,30,28
1656263917667,MATH 20E,A01,083771,Ganguly; Soumya,3,0,32,29
1656263917667,MATH 20E,A02,083772,Ganguly; Soumya,0,0,32,32
1656263917667,MATH 20E,B01,083773,Ciotti; Benjamin,16,0,35,19
1656263917667,MATH 20E,B02,083774,Ciotti; Benjamin,15,0,35,20
1656263923712,MATH 103A,A01,083777,Greenfeld; Be'Eri,1,0,36,35
1656263923712,MATH 103A,A02,083778,Greenfeld; Be'Eri,1,0,36,35
1656263923712,MATH 103A,A03,093561,Staff,5,0,36,31
1656263923712,MATH 103A,B01,083779,Greenfeld; Be'Eri,8,0,36,28
1656263923712,MATH 103A,B02,083780,Greenfeld; Be'Eri,1,0,36,35
1656263923712,MATH 103A,B03,093562,Staff,0,0,36,36
1656263929740,MATH 105,A01,085443,Carter; Anne Toulson,5,0,35,30
1656263929740,MATH 105,A02,093477,Staff,14,0,35,21
1656263935767,MATH 109,A01,083213,Ganzberger; Geoffrey Michael,0,0,34,34
1656263935767,MATH 109,A02,083214,Ganzberger; Geoffrey Michael,0,0,34,34
1656263935767,MATH 109,A03,093478,Staff,1,0,34,33
1656263935767,MATH 109,B01,083215,Ganzberger; Geoffrey Michael,4,0,32,28
1656263935767,MATH 109,B02,083216,Ganzberger; Geoffrey Michael,1,0,32,31
1656263935767,MATH 109,B03,093479,Staff,3,0,32,29
1656263941794,MATH 142A,A01,083219,Chow; Bennett,2,0,32,30
1656263941794,MATH 142A,A02,083220,Chow; Bennett,8,0,32,24
1656263941794,MATH 142A,A03,093480,Staff,5,0,32,27
1656263941794,MATH 142A,B03,093481,Staff,3,0,32,29
1656263941794,MATH 142A,B04,093558,Staff,6,0,32,26
1656263941794,MATH 142A,B05,093559,Staff,0,0,32,32
1656263947823,MATH 193A,A01,083224,Rotar; Vladimir,0,1,34,34
1656263947823,MATH 193A,A02,083225,Rotar; Vladimir,0,0,34,34
1656263947823,MATH 193A,A03,083781,Rotar; Vladimir,0,0,34,34
1656263947823,MATH 193A,A04,083782,Rotar; Vladimir,6,0,34,28
1656263947823,MATH 193A,A05,093482,Rotar; Vladimir,0,0,34,34
1656263953856,MATH 197,001,091859,McAuley; Julian John,9999,0,9999,0
1656263953856,MATH 197,002,095566,Kedlaya; Kiran S.,9997,0,9999,2
1656263953856,MATH 197,003,095567,Xiao; Ming,9999,0,9999,0
1656263953856,MATH 197,004,095571,Perols; Johan Lars,9998,0,9999,1
1656263960944,COGS 9,A01,083615,Shannon; Kyle Michael,3,0,75,72
1656263966979,COGS 11,A01,083617,Boyle; Mary E. T.,14,0,48,34
1656263973020,COGS 13,A01,083071,Bastos; Amalia Pinkusfeld,5,0,71,66
1656263979047,COGS 14A,A01,092681,Semenuks; Arturs,1,12,100,99
1656263985072,COGS 14B,A01,083073,Cheng; Tzu-Han,7,0,63,56
1656263991103,COGS 17,A01,092677,Semenuks; Arturs,8,0,81,73
1656263997130,COGS 100,A01,083619,Allen; Michael Gordon,2,0,70,68
1656264003154,COGS 101A,A01,083621,Davis; Joshua Daniel,4,0,68,64
1656264009180,COGS 101B,A01,091572,Allen; Michael Gordon,4,0,65,61
1656264015206,COGS 101C,A01,083625,Delgado; Tania,10,0,35,25
1656264021233,COGS 107A,A01,083627,Boyle; Mary E. T.,0,0,60,60
1656264027267,COGS 118A,A01,083075,Gupta; Anjum,8,0,76,68
1656264033291,CSE 3,A50,083646,Miranda; Gregory Joseph,18,0,50,32
1656264039316,CSE 8A,A50,083650,Miranda; Gregory Joseph,2,2,56,54
1656264045353,CSE 11,A01,083080,Cao; Yingjun,0,49,40,40
1656264051388,CSE 12,A01,083652,Krause-Levy; Sophia Louisa,5,1,120,115
1656264057413,CSE 15L,A01,083654,Morris; Justin Loren,2,0,50,48
1656264057413,CSE 15L,A02,083655,Morris; Justin Loren,4,0,50,46
1656264063436,CSE 20,A01,083657,Tran; Khoa Dang,30,0,80,50
1656264069457,CSE 21,A01,095574,Bach; Quang Tran,23,0,48,25
1656264075481,CSE 30,A01,083084,Eldon; John,2,6,80,78
1656264075481,CSE 30,B01,095061,Bhaskar; Nishant,0,1,50,50
1656264081515,CSE 100,A01,083659,Cao; Yingjun,1,18,70,69
1656264087549,CSE 134B,A01,083661,Powell; Thomas Allan,5,0,100,95
1656264093586,CSE 140,A01,083663,Gungor; Onat,9,0,85,76
1656264099611,CSE 140L,A01,083088,Eldon; John,8,0,100,92
1656264105638,CSE 175,A01,083665,Kumar; Rakesh,0,0,25,25
1656264111669,CSE 190,A00,092507,Dubnov; Shlomo,3,0,20,17
1656264117693,ECE 45,A01,083139,Congero; Spencer William,1,0,75,74
1656264123720,ECE 65,A50,083695,Saad; Andrew S,9,0,30,21
1656264123720,ECE 65,A51,095125,Staff,24,0,26,2
1656264129745,ECE 109,A01,091882,Touri; Behrouz,0,1,70,70
1656264135771,ECE 180,A00,083140,Abi Samra; Nicholas Camill,1,0,30,29
1656264135771,ECE 180,B00,083141,Abi Samra; Nicholas Camill,0,4,30,30
1656264141827,MATH 10A,A01,083735,Patchell; Gregory David,0,0,30,30
1656264141827,MATH 10A,A02,083736,Patchell; Gregory David,22,0,30,8
1656264141827,MATH 10A,A03,083737,Patchell; Gregory David,16,0,30,14
1656264147856,MATH 10B,A01,083207,Lim; Seonhee,0,0,34,34
1656264147856,MATH 10B,A02,083208,Lim; Seonhee,7,0,35,28
1656264147856,MATH 10B,A03,093472,Staff,1,0,34,33
1656264147856,MATH 10B,B01,083739,Sinha; Shubham,11,0,30,19
1656264153882,MATH 18,A01,083743,Cinel; Cameron Alexander,7,0,30,23
1656264153882,MATH 18,A02,083744,Cinel; Cameron Alexander,9,0,30,21
1656264153882,MATH 18,A03,083745,Cinel; Cameron Alexander,5,0,30,25
1656264153882,MATH 18,B01,083748,Rideout; David Porter,1,0,36,35
1656264153882,MATH 18,B02,083749,Rideout; David Porter,0,0,36,36
1656264153882,MATH 18,B03,083750,Rideout; David Porter,0,0,36,36
1656264153882,MATH 18,B04,083751,Rideout; David Porter,0,1,36,36
1656264153882,MATH 18,B05,093473,Rideout; David Porter,0,0,36,36
1656264153882,MATH 18,B06,093474,Rideout; David Porter,3,0,36,33
1656264159905,MATH 20A,A01,083754,Zheng; Zequn,11,0,40,29
1656264165929,MATH 20B,A01,083756,Briones; Jor-el Thomas Caparas,0,0,36,36
1656264165929,MATH 20B,A02,083757,Briones; Jor-el Thomas Caparas,0,0,36,36
1656264165929,MATH 20B,A03,093475,Staff,0,0,36,36
1656264171953,MATH 20C,A01,083760,Briones; Jor-el Thomas Caparas,0,0,35,35
1656264171953,MATH 20C,A02,083761,Briones; Jor-el Thomas Caparas,9,1,35,26
1656264171953,MATH 20C,A03,093476,Staff,0,0,35,35
1656264171953,MATH 20C,B01,083762,Bach; Quang Tran,1,0,30,29
1656264177978,MATH 20D,A01,083765,Tran; Brian Kha,1,0,30,29
1656264177978,MATH 20D,A02,083766,Tran; Brian Kha,0,1,30,30
1656264177978,MATH 20D,A03,083767,Tran; Brian Kha,2,0,30,28
1656264184015,MATH 20E,A01,083771,Ganguly; Soumya,3,0,32,29
1656264184015,MATH 20E,A02,083772,Ganguly; Soumya,0,0,32,32
1656264184015,MATH 20E,B01,083773,Ciotti; Benjamin,16,0,35,19
1656264184015,MATH 20E,B02,083774,Ciotti; Benjamin,15,0,35,20
1656264190054,MATH 103A,A01,083777,Greenfeld; Be'Eri,1,0,36,35
1656264190054,MATH 103A,A02,083778,Greenfeld; Be'Eri,1,0,36,35
1656264190054,MATH 103A,A03,093561,Staff,5,0,36,31
1656264190054,MATH 103A,B01,083779,Greenfeld; Be'Eri,8,0,36,28
1656264190054,MATH 103A,B02,083780,Greenfeld; Be'Eri,1,0,36,35
1656264190054,MATH 103A,B03,093562,Staff,0,0,36,36
1656264196077,MATH 105,A01,085443,Carter; Anne Toulson,5,0,35,30
1656264196077,MATH 105,A02,093477,Staff,14,0,35,21
1656264202101,MATH 109,A01,083213,Ganzberger; Geoffrey Michael,0,0,34,34
1656264202101,MATH 109,A02,083214,Ganzberger; Geoffrey Michael,0,0,34,34
1656264202101,MATH 109,A03,093478,Staff,1,0,34,33
1656264202101,MATH 109,B01,083215,Ganzberger; Geoffrey Michael,4,0,32,28
1656264202101,MATH 109,B02,083216,Ganzberger; Geoffrey Michael,1,0,32,31
1656264202101,MATH 109,B03,093479,Staff,3,0,32,29
1656264208126,MATH 142A,A01,083219,Chow; Bennett,2,0,32,30
1656264208126,MATH 142A,A02,083220,Chow; Bennett,8,0,32,24
1656264208126,MATH 142A,A03,093480,Staff,5,0,32,27
1656264208126,MATH 142A,B03,093481,Staff,3,0,32,29
1656264208126,MATH 142A,B04,093558,Staff,6,0,32,26
1656264208126,MATH 142A,B05,093559,Staff,0,0,32,32
1656264214157,MATH 193A,A01,083224,Rotar; Vladimir,0,1,34,34
1656264214157,MATH 193A,A02,083225,Rotar; Vladimir,0,0,34,34
1656264214157,MATH 193A,A03,083781,Rotar; Vladimir,0,0,34,34
1656264214157,MATH 193A,A04,083782,Rotar; Vladimir,6,0,34,28
1656264214157,MATH 193A,A05,093482,Rotar; Vladimir,0,0,34,34
1656264220272,MATH 197,001,091859,McAuley; Julian John,9999,0,9999,0
1656264220272,MATH 197,002,095566,Kedlaya; Kiran S.,9997,0,9999,2
1656264220272,MATH 197,003,095567,Xiao; Ming,9999,0,9999,0
1656264220272,MATH 197,004,095571,Perols; Johan Lars,9998,0,9999,1
1656264227325,COGS 9,A01,083615,Shannon; Kyle Michael,3,0,75,72
1656264233347,COGS 11,A01,083617,Boyle; Mary E. T.,14,0,48,34
1656264239375,COGS 13,A01,083071,Bastos; Amalia Pinkusfeld,5,0,71,66
1656264245404,COGS 14A,A01,092681,Semenuks; Arturs,1,12,100,99
1656264251457,COGS 14B,A01,083073,Cheng; Tzu-Han,7,0,63,56
1656264257480,COGS 17,A01,092677,Semenuks; Arturs,8,0,81,73
1656264263509,COGS 100,A01,083619,Allen; Michael Gordon,2,0,70,68
1656264269547,COGS 101A,A01,083621,Davis; Joshua Daniel,4,0,68,64
1656264275574,COGS 101B,A01,091572,Allen; Michael Gordon,4,0,65,61
1656264281598,COGS 101C,A01,083625,Delgado; Tania,10,0,35,25
1656264287625,COGS 107A,A01,083627,Boyle; Mary E. T.,0,0,60,60
1656264293653,COGS 118A,A01,083075,Gupta; Anjum,8,0,76,68
1656264299689,CSE 3,A50,083646,Miranda; Gregory Joseph,18,0,50,32
1656264305711,CSE 8A,A50,083650,Miranda; Gregory Joseph,2,2,56,54
1656264311735,CSE 11,A01,083080,Cao; Yingjun,0,49,40,40
1656264317779,CSE 12,A01,083652,Krause-Levy; Sophia Louisa,5,1,120,115
1656264323833,CSE 15L,A01,083654,Morris; Justin Loren,2,0,50,48
1656264323833,CSE 15L,A02,083655,Morris; Justin Loren,4,0,50,46
1656264329863,CSE 20,A01,083657,Tran; Khoa Dang,30,0,80,50
1656264335919,CSE 21,A01,095574,Bach; Quang Tran,23,0,48,25
1656264341943,CSE 30,A01,083084,Eldon; John,2,6,80,78
1656264341943,CSE 30,B01,095061,Bhaskar; Nishant,0,1,50,50
1656264347967,CSE 100,A01,083659,Cao; Yingjun,1,18,70,69
1656264354001,CSE 134B,A01,083661,Powell; Thomas Allan,5,0,100,95
1656264360033,CSE 140,A01,083663,Gungor; Onat,9,0,85,76
1656264366078,CSE 140L,A01,083088,Eldon; John,8,0,100,92
1656264372116,CSE 175,A01,083665,Kumar; Rakesh,0,0,25,25
1656264378165,CSE 190,A00,092507,Dubnov; Shlomo,3,0,20,17
1656264384189,ECE 45,A01,083139,Congero; Spencer William,1,0,75,74
1656264390222,ECE 65,A50,083695,Saad; Andrew S,9,0,30,21
1656264390222,ECE 65,A51,095125,Staff,24,0,26,2
1656264396246,ECE 109,A01,091882,Touri; Behrouz,0,1,70,70
1656264402271,ECE 180,A00,083140,Abi Samra; Nicholas Camill,1,0,30,29
1656264402271,ECE 180,B00,083141,Abi Samra; Nicholas Camill,0,4,30,30
1656264408299,MATH 10A,A01,083735,Patchell; Gregory David,0,0,30,30
1656264408299,MATH 10A,A02,083736,Patchell; Gregory David,22,0,30,8
1656264408299,MATH 10A,A03,083737,Patchell; Gregory David,16,0,30,14
1656264414325,MATH 10B,A01,083207,Lim; Seonhee,0,0,34,34
1656264414325,MATH 10B,A02,083208,Lim; Seonhee,7,0,35,28
1656264414325,MATH 10B,A03,093472,Staff,1,0,34,33
1656264414325,MATH 10B,B01,083739,Sinha; Shubham,11,0,30,19
1656264420369,MATH 18,A01,083743,Cinel; Cameron Alexander,7,0,30,23
1656264420369,MATH 18,A02,083744,Cinel; Cameron Alexander,9,0,30,21
1656264420369,MATH 18,A03,083745,Cinel; Cameron Alexander,5,0,30,25
1656264420369,MATH 18,B01,083748,Rideout; David Porter,1,0,36,35
1656264420369,MATH 18,B02,083749,Rideout; David Porter,0,0,36,36
1656264420369,MATH 18,B03,083750,Rideout; David Porter,0,0,36,36
1656264420369,MATH 18,B04,083751,Rideout; David Porter,0,1,36,36
1656264420369,MATH 18,B05,093473,Rideout; David Porter,0,0,36,36
1656264420369,MATH 18,B06,093474,Rideout; David Porter,3,0,36,33
1656264426398,MATH 20A,A01,083754,Zheng; Zequn,11,0,40,29
1656264432423,MATH 20B,A01,083756,Briones; Jor-el Thomas Caparas,0,0,36,36
1656264432423,MATH 20B,A02,083757,Briones; Jor-el Thomas Caparas,0,0,36,36
1656264432423,MATH 20B,A03,093475,Staff,0,0,36,36
1656264438448,MATH 20C,A01,083760,Briones; Jor-el Thomas Caparas,0,0,35,35
1656264438448,MATH 20C,A02,083761,Briones; Jor-el Thomas Caparas,9,1,35,26
1656264438448,MATH 20C,A03,093476,Staff,0,0,35,35
1656264438448,MATH 20C,B01,083762,Bach; Quang Tran,1,0,30,29
1656264444495,MATH 20D,A01,083765,Tran; Brian Kha,1,0,30,29
1656264444495,MATH 20D,A02,083766,Tran; Brian Kha,0,1,30,30
1656264444495,MATH 20D,A03,083767,Tran; Brian Kha,2,0,30,28
1656264450520,MATH 20E,A01,083771,Ganguly; Soumya,3,0,32,29
1656264450520,MATH 20E,A02,083772,Ganguly; Soumya,0,0,32,32
1656264450520,MATH 20E,B01,083773,Ciotti; Benjamin,16,0,35,19
1656264450520,MATH 20E,B02,083774,Ciotti; Benjamin,15,0,35,20
1656264456552,MATH 103A,A01,083777,Greenfeld; Be'Eri,1,0,36,35
1656264456552,MATH 103A,A02,083778,Greenfeld; Be'Eri,1,0,36,35
1656264456552,MATH 103A,A03,093561,Staff,5,0,36,31
1656264456552,MATH 103A,B01,083779,Greenfeld; Be'Eri,8,0,36,28
1656264456552,MATH 103A,B02,083780,Greenfeld; Be'Eri,1,0,36,35
1656264456552,MATH 103A,B03,093562,Staff,0,0,36,36
1656264462615,MATH 105,A01,085443,Carter; Anne Toulson,5,0,35,30
1656264462615,MATH 105,A02,093477,Staff,14,0,35,21
1656264468640,MATH 109,A01,083213,Ganzberger; Geoffrey Michael,0,0,34,34
1656264468640,MATH 109,A02,083214,Ganzberger; Geoffrey Michael,0,0,34,34
1656264468640,MATH 109,A03,093478,Staff,1,0,34,33
1656264468640,MATH 109,B01,083215,Ganzberger; Geoffrey Michael,4,0,32,28
1656264468640,MATH 109,B02,083216,Ganzberger; Geoffrey Michael,1,0,32,31
1656264468640,MATH 109,B03,093479,Staff,3,0,32,29
1656264474665,MATH 142A,A01,083219,Chow; Bennett,2,0,32,30
1656264474665,MATH 142A,A02,083220,Chow; Bennett,8,0,32,24
1656264474665,MATH 142A,A03,093480,Staff,5,0,32,27
1656264474665,MATH 142A,B03,093481,Staff,3,0,32,29
1656264474665,MATH 142A,B04,093558,Staff,6,0,32,26
1656264474665,MATH 142A,B05,093559,Staff,0,0,32,32
1656264480690,MATH 193A,A01,083224,Rotar; Vladimir,0,1,34,34
1656264480690,MATH 193A,A02,083225,Rotar; Vladimir,0,0,34,34
1656264480690,MATH 193A,A03,083781,Rotar; Vladimir,0,0,34,34
1656264480690,MATH 193A,A04,083782,Rotar; Vladimir,6,0,34,28
1656264480690,MATH 193A,A05,093482,Rotar; Vladimir,0,0,34,34
1656264486712,MATH 197,001,091859,McAuley; Julian John,9999,0,9999,0
1656264486712,MATH 197,002,095566,Kedlaya; Kiran S.,9997,0,9999,2
1656264486712,MATH 197,003,095567,Xiao; Ming,9999,0,9999,0
1656264486712,MATH 197,004,095571,Perols; Johan Lars,9998,0,9999,1
1656264493781,COGS 9,A01,083615,Shannon; Kyle Michael,3,0,75,72
1656264499832,COGS 11,A01,083617,Boyle; Mary E. T.,14,0,48,34
1656264505868,COGS 13,A01,083071,Bastos; Amalia Pinkusfeld,5,0,71,66
1656264511913,COGS 14A,A01,092681,Semenuks; Arturs,1,12,100,99
1656264517936,COGS 14B,A01,083073,Cheng; Tzu-Han,7,0,63,56
1656264523963,COGS 17,A01,092677,Semenuks; Arturs,8,0,81,73
1656264530007,COGS 100,A01,083619,Allen; Michael Gordon,2,0,70,68
1656264536038,COGS 101A,A01,083621,Davis; Joshua Daniel,4,0,68,64
1656264542062,COGS 101B,A01,091572,Allen; Michael Gordon,4,0,65,61
1656264548089,COGS 101C,A01,083625,Delgado; Tania,10,0,35,25
1656264554132,COGS 107A,A01,083627,Boyle; Mary E. T.,0,0,60,60
1656264560166,COGS 118A,A01,083075,Gupta; Anjum,8,0,76,68
1656264566195,CSE 3,A50,083646,Miranda; Gregory Joseph,18,0,50,32
1656264572222,CSE 8A,A50,083650,Miranda; Gregory Joseph,2,2,56,54
1656264578246,CSE 11,A01,083080,Cao; Yingjun,0,49,40,40
1656264584292,CSE 12,A01,083652,Krause-Levy; Sophia Louisa,5,1,120,115
1656264590326,CSE 15L,A01,083654,Morris; Justin Loren,2,0,50,48
1656264590326,CSE 15L,A02,083655,Morris; Justin Loren,4,0,50,46
1656264596360,CSE 20,A01,083657,Tran; Khoa Dang,30,0,80,50
1656264602383,CSE 21,A01,095574,Bach; Quang Tran,23,0,48,25
1656264608410,CSE 30,A01,083084,Eldon; John,2,6,80,78
1656264608410,CSE 30,B01,095061,Bhaskar; Nishant,0,1,50,50
1656264614440,CSE 100,A01,083659,Cao; Yingjun,1,18,70,69
1656264620467,CSE 134B,A01,083661,Powell; Thomas Allan,5,0,100,95
1656264626493,CSE 140,A01,083663,Gungor; Onat,9,0,85,76
1656264632520,CSE 140L,A01,083088,Eldon; John,8,0,100,92
1656264638556,CSE 175,A01,083665,Kumar; Rakesh,0,0,25,25
1656264644589,CSE 190,A00,092507,Dubnov; Shlomo,3,0,20,17
1656264650613,ECE 45,A01,083139,Congero; Spencer William,1,0,75,74
1656264656639,ECE 65,A50,083695,Saad; Andrew S,9,0,30,21
1656264656639,ECE 65,A51,095125,Staff,24,0,26,2
1656264662677,ECE 109,A01,091882,Touri; Behrouz,0,1,70,70
1656264668711,ECE 180,A00,083140,Abi Samra; Nicholas Camill,1,0,30,29
1656264668711,ECE 180,B00,083141,Abi Samra; Nicholas Camill,0,4,30,30
1656264674739,MATH 10A,A01,083735,Patchell; Gregory David,0,0,30,30
1656264674739,MATH 10A,A02,083736,Patchell; Gregory David,22,0,30,8
1656264674739,MATH 10A,A03,083737,Patchell; Gregory David,16,0,30,14
1656264680776,MATH 10B,A01,083207,Lim; Seonhee,0,0,34,34
1656264680776,MATH 10B,A02,083208,Lim; Seonhee,7,0,35,28
1656264680776,MATH 10B,A03,093472,Staff,1,0,34,33
1656264680776,MATH 10B,B01,083739,Sinha; Shubham,11,0,30,19
1656264686815,MATH 18,A01,083743,Cinel; Cameron Alexander,7,0,30,23
1656264686815,MATH 18,A02,083744,Cinel; Cameron Alexander,9,0,30,21
1656264686815,MATH 18,A03,083745,Cinel; Cameron Alexander,5,0,30,25
1656264686815,MATH 18,B01,083748,Rideout; David Porter,1,0,36,35
1656264686815,MATH 18,B02,083749,Rideout; David Porter,0,0,36,36
1656264686815,MATH 18,B03,083750,Rideout; David Porter,0,0,36,36
1656264686815,MATH 18,B04,083751,Rideout; David Porter,0,1,36,36
1656264686815,MATH 18,B05,093473,Rideout; David Porter,0,0,36,36
1656264686815,MATH 18,B06,093474,Rideout; David Porter,3,0,36,33
1656264692856,MATH 20A,A01,083754,Zheng; Zequn,11,0,40,29
1656264698885,MATH 20B,A01,083756,Briones; Jor-el Thomas Caparas,0,0,36,36
1656264698885,MATH 20B,A02,083757,Briones; Jor-el Thomas Caparas,0,0,36,36
1656264698885,MATH 20B,A03,093475,Staff,0,0,36,36
1656264704934,MATH 20C,A01,083760,Briones; Jor-el Thomas Caparas,0,0,35,35
1656264704934,MATH 20C,A02,083761,Briones; Jor-el Thomas Caparas,9,1,35,26
1656264704934,MATH 20C,A03,093476,Staff,0,0,35,35
1656264704934,MATH 20C,B01,083762,Bach; Quang Tran,1,0,30,29
1656264710966,MATH 20D,A01,083765,Tran; Brian Kha,1,0,30,29
1656264710966,MATH 20D,A02,083766,Tran; Brian Kha,0,1,30,30
1656264710966,MATH 20D,A03,083767,Tran; Brian Kha,2,0,30,28
1656264716988,MATH 20E,A01,083771,Ganguly; Soumya,3,0,32,29
1656264716988,MATH 20E,A02,083772,Ganguly; Soumya,0,0,32,32
1656264716988,MATH 20E,B01,083773,Ciotti; Benjamin,16,0,35,19
1656264716988,MATH 20E,B02,083774,Ciotti; Benjamin,15,0,35,20
1656264723011,MATH 103A,A01,083777,Greenfeld; Be'Eri,1,0,36,35
1656264723011,MATH 103A,A02,083778,Greenfeld; Be'Eri,1,0,36,35
1656264723011,MATH 103A,A03,093561,Staff,5,0,36,31
1656264723011,MATH 103A,B01,083779,Greenfeld; Be'Eri,8,0,36,28
1656264723011,MATH 103A,B02,083780,Greenfeld; Be'Eri,1,0,36,35
1656264723011,MATH 103A,B03,093562,Staff,0,0,36,36
1656264729039,MATH 105,A01,085443,Carter; Anne Toulson,5,0,35,30
1656264729039,MATH 105,A02,093477,Staff,14,0,35,21
1656264735088,MATH 109,A01,083213,Ganzberger; Geoffrey Michael,0,0,34,34
1656264735088,MATH 109,A02,083214,Ganzberger; Geoffrey Michael,0,0,34,34
1656264735088,MATH 109,A03,093478,Staff,1,0,34,33
1656264735088,MATH 109,B01,083215,Ganzberger; Geoffrey Michael,4,0,32,28
1656264735088,MATH 109,B02,083216,Ganzberger; Geoffrey Michael,1,0,32,31
1656264735088,MATH 109,B03,093479,Staff,3,0,32,29
1656264741121,MATH 142A,A01,083219,Chow; Bennett,2,0,32,30
1656264741121,MATH 142A,A02,083220,Chow; Bennett,8,0,32,24
1656264741121,MATH 142A,A03,093480,Staff,5,0,32,27
1656264741121,MATH 142A,B03,093481,Staff,3,0,32,29
1656264741121,MATH 142A,B04,093558,Staff,6,0,32,26
1656264741121,MATH 142A,B05,093559,Staff,0,0,32,32
1656264747145,MATH 193A,A01,083224,Rotar; Vladimir,0,1,34,34
1656264747145,MATH 193A,A02,083225,Rotar; Vladimir,0,0,34,34
1656264747145,MATH 193A,A03,083781,Rotar; Vladimir,0,0,34,34
1656264747145,MATH 193A,A04,083782,Rotar; Vladimir,6,0,34,28
1656264747145,MATH 193A,A05,093482,Rotar; Vladimir,0,0,34,34
1656264753172,MATH 197,001,091859,McAuley; Julian John,9999,0,9999,0
1656264753172,MATH 197,002,095566,Kedlaya; Kiran S.,9997,0,9999,2
1656264753172,MATH 197,003,095567,Xiao; Ming,9999,0,9999,0
1656264753172,MATH 197,004,095571,Perols; Johan Lars,9998,0,9999,1
1656264760224,COGS 9,A01,083615,Shannon; Kyle Michael,4,0,75,71
1656264766249,COGS 11,A01,083617,Boyle; Mary E. T.,14,0,48,34
1656264772274,COGS 13,A01,083071,Bastos; Amalia Pinkusfeld,5,0,71,66
1656264778303,COGS 14A,A01,092681,Semenuks; Arturs,1,12,100,99
1656264784344,COGS 14B,A01,083073,Cheng; Tzu-Han,7,0,63,56
1656264790368,COGS 17,A01,092677,Semenuks; Arturs,8,0,81,73
1656264796392,COGS 100,A01,083619,Allen; Michael Gordon,2,0,70,68
1656264802417,COGS 101A,A01,083621,Davis; Joshua Daniel,4,0,68,64
1656264808442,COGS 101B,A01,091572,Allen; Michael Gordon,4,0,65,61
1656264814552,COGS 101C,A01,083625,Delgado; Tania,10,0,35,25
1656264820585,COGS 107A,A01,083627,Boyle; Mary E. T.,0,0,60,60
1656264826607,COGS 118A,A01,083075,Gupta; Anjum,8,0,76,68
1656264832634,CSE 3,A50,083646,Miranda; Gregory Joseph,18,0,50,32
1656264838667,CSE 8A,A50,083650,Miranda; Gregory Joseph,2,2,56,54
1656264844693,CSE 11,A01,083080,Cao; Yingjun,0,49,40,40
1656264850730,CSE 12,A01,083652,Krause-Levy; Sophia Louisa,5,1,120,115
1656264856753,CSE 15L,A01,083654,Morris; Justin Loren,2,0,50,48
1656264856753,CSE 15L,A02,083655,Morris; Justin Loren,4,0,50,46
1656264862796,CSE 20,A01,083657,Tran; Khoa Dang,30,0,80,50
1656264868832,CSE 21,A01,095574,Bach; Quang Tran,23,0,48,25
1656264874867,CSE 30,A01,083084,Eldon; John,2,6,80,78
1656264874867,CSE 30,B01,095061,Bhaskar; Nishant,0,1,50,50
1656264880889,CSE 100,A01,083659,Cao; Yingjun,1,18,70,69
1656264886934,CSE 134B,A01,083661,Powell; Thomas Allan,5,0,100,95
1656264892989,CSE 140,A01,083663,Gungor; Onat,9,0,85,76
1656264899016,CSE 140L,A01,083088,Eldon; John,8,0,100,92
1656264905041,CSE 175,A01,083665,Kumar; Rakesh,0,0,25,25
1656264911079,CSE 190,A00,092507,Dubnov; Shlomo,3,0,20,17
1656264917112,ECE 45,A01,083139,Congero; Spencer William,1,0,75,74
1656264923139,ECE 65,A50,083695,Saad; Andrew S,9,0,30,21
1656264923139,ECE 65,A51,095125,Staff,24,0,26,2
1656264929165,ECE 109,A01,091882,Touri; Behrouz,0,1,70,70
1656264935215,ECE 180,A00,083140,Abi Samra; Nicholas Camill,1,0,30,29
1656264935215,ECE 180,B00,083141,Abi Samra; Nicholas Camill,0,4,30,30
1656264941253,MATH 10A,A01,083735,Patchell; Gregory David,0,0,30,30
1656264941253,MATH 10A,A02,083736,Patchell; Gregory David,22,0,30,8
1656264941253,MATH 10A,A03,083737,Patchell; Gregory David,16,0,30,14
1656264947281,MATH 10B,A01,083207,Lim; Seonhee,0,0,34,34
1656264947281,MATH 10B,A02,083208,Lim; Seonhee,7,0,35,28
1656264947281,MATH 10B,A03,093472,Staff,1,0,34,33
1656264947281,MATH 10B,B01,083739,Sinha; Shubham,11,0,30,19
1656264953306,MATH 18,A01,083743,Cinel; Cameron Alexander,7,0,30,23
1656264953306,MATH 18,A02,083744,Cinel; Cameron Alexander,9,0,30,21
1656264953306,MATH 18,A03,083745,Cinel; Cameron Alexander,5,0,30,25
1656264953306,MATH 18,B01,083748,Rideout; David Porter,1,0,36,35
1656264953306,MATH 18,B02,083749,Rideout; David Porter,0,0,36,36
1656264953306,MATH 18,B03,083750,Rideout; David Porter,0,0,36,36
1656264953306,MATH 18,B04,083751,Rideout; David Porter,0,1,36,36
1656264953306,MATH 18,B05,093473,Rideout; David Porter,0,0,36,36
1656264953306,MATH 18,B06,093474,Rideout; David Porter,3,0,36,33
1656264959330,MATH 20A,A01,083754,Zheng; Zequn,11,0,40,29
1656264965356,MATH 20B,A01,083756,Briones; Jor-el Thomas Caparas,0,0,36,36
1656264965356,MATH 20B,A02,083757,Briones; Jor-el Thomas Caparas,0,0,36,36
1656264965356,MATH 20B,A03,093475,Staff,0,0,36,36
1656264971380,MATH 20C,A01,083760,Briones; Jor-el Thomas Caparas,0,0,35,35
1656264971380,MATH 20C,A02,083761,Briones; Jor-el Thomas Caparas,9,1,35,26
1656264971380,MATH 20C,A03,093476,Staff,0,0,35,35
1656264971380,MATH 20C,B01,083762,Bach; Quang Tran,1,0,30,29
1656264977408,MATH 20D,A01,083765,Tran; Brian Kha,1,0,30,29
1656264977408,MATH 20D,A02,083766,Tran; Brian Kha,0,1,30,30
1656264977408,MATH 20D,A03,083767,Tran; Brian Kha,2,0,30,28
1656264983436,MATH 20E,A01,083771,Ganguly; Soumya,3,0,32,29
1656264983436,MATH 20E,A02,083772,Ganguly; Soumya,0,0,32,32
1656264983436,MATH 20E,B01,083773,Ciotti; Benjamin,16,0,35,19
1656264983436,MATH 20E,B02,083774,Ciotti; Benjamin,15,0,35,20
1656264989465,MATH 103A,A01,083777,Greenfeld; Be'Eri,1,0,36,35
1656264989465,MATH 103A,A02,083778,Greenfeld; Be'Eri,1,0,36,35
1656264989465,MATH 103A,A03,093561,Staff,5,0,36,31
1656264989465,MATH 103A,B01,083779,Greenfeld; Be'Eri,8,0,36,28
1656264989465,MATH 103A,B02,083780,Greenfeld; Be'Eri,1,0,36,35
1656264989465,MATH 103A,B03,093562,Staff,0,0,36,36
1656264995494,MATH 105,A01,085443,Carter; Anne Toulson,5,0,35,30
1656264995494,MATH 105,A02,093477,Staff,14,0,35,21
1656265001522,MATH 109,A01,083213,Ganzberger; Geoffrey Michael,0,0,34,34
1656265001522,MATH 109,A02,083214,Ganzberger; Geoffrey Michael,0,0,34,34
1656265001522,MATH 109,A03,093478,Staff,1,0,34,33
1656265001522,MATH 109,B01,083215,Ganzberger; Geoffrey Michael,4,0,32,28
1656265001522,MATH 109,B02,083216,Ganzberger; Geoffrey Michael,1,0,32,31
1656265001522,MATH 109,B03,093479,Staff,3,0,32,29
1656265007545,MATH 142A,A01,083219,Chow; Bennett,2,0,32,30
1656265007545,MATH 142A,A02,083220,Chow; Bennett,8,0,32,24
1656265007545,MATH 142A,A03,093480,Staff,5,0,32,27
1656265007545,MATH 142A,B03,093481,Staff,3,0,32,29
1656265007545,MATH 142A,B04,093558,Staff,6,0,32,26
1656265007545,MATH 142A,B05,093559,Staff,0,0,32,32
1656265013573,MATH 193A,A01,083224,Rotar; Vladimir,0,1,34,34
1656265013573,MATH 193A,A02,083225,Rotar; Vladimir,0,0,34,34
1656265013573,MATH 193A,A03,083781,Rotar; Vladimir,0,0,34,34
1656265013573,MATH 193A,A04,083782,Rotar; Vladimir,6,0,34,28
1656265013573,MATH 193A,A05,093482,Rotar; Vladimir,0,0,34,34
1656265019606,MATH 197,001,091859,McAuley; Julian John,9999,0,9999,0
1656265019606,MATH 197,002,095566,Kedlaya; Kiran S.,9997,0,9999,2
1656265019606,MATH 197,003,095567,Xiao; Ming,9999,0,9999,0
1656265019606,MATH 197,004,095571,Perols; Johan Lars,9998,0,9999,1
1656265026664,COGS 9,A01,083615,Shannon; Kyle Michael,4,0,75,71
1656265032691,COGS 11,A01,083617,Boyle; Mary E. T.,14,0,48,34
1656265038724,COGS 13,A01,083071,Bastos; Amalia Pinkusfeld,5,0,71,66
1656265044748,COGS 14A,A01,092681,Semenuks; Arturs,1,12,100,99
1656265050775,COGS 14B,A01,083073,Cheng; Tzu-Han,7,0,63,56
1656265056807,COGS 17,A01,092677,Semenuks; Arturs,8,0,81,73
1656265062838,COGS 100,A01,083619,Allen; Michael Gordon,2,0,70,68
1656265068902,COGS 101A,A01,083621,Davis; Joshua Daniel,4,0,68,64
1656265074958,COGS 101B,A01,091572,Allen; Michael Gordon,4,0,65,61
1656265080982,COGS 101C,A01,083625,Delgado; Tania,10,0,35,25
1656265087034,COGS 107A,A01,083627,Boyle; Mary E. T.,0,0,60,60
1656265093078,COGS 118A,A01,083075,Gupta; Anjum,8,0,76,68
1656265099112,CSE 3,A50,083646,Miranda; Gregory Joseph,18,0,50,32
1656265105145,CSE 8A,A50,083650,Miranda; Gregory Joseph,2,2,56,54
1656265111168,CSE 11,A01,083080,Cao; Yingjun,0,49,40,40
1656265117203,CSE 12,A01,083652,Krause-Levy; Sophia Louisa,5,1,120,115
1656265123230,CSE 15L,A01,083654,Morris; Justin Loren,2,0,50,48
1656265123230,CSE 15L,A02,083655,Morris; Justin Loren,4,0,50,46
1656265129255,CSE 20,A01,083657,Tran; Khoa Dang,30,0,80,50
1656265135302,CSE 21,A01,095574,Bach; Quang Tran,23,0,48,25
1656265141340,CSE 30,A01,083084,Eldon; John,2,6,80,78
1656265141340,CSE 30,B01,095061,Bhaskar; Nishant,0,1,50,50
1656265147368,CSE 100,A01,083659,Cao; Yingjun,1,18,70,69
1656265153390,CSE 134B,A01,083661,Powell; Thomas Allan,5,0,100,95
1656265159419,CSE 140,A01,083663,Gungor; Onat,9,0,85,76
1656265165448,CSE 140L,A01,083088,Eldon; John,8,0,100,92
1656265171474,CSE 175,A01,083665,Kumar; Rakesh,0,0,25,25
1656265177512,CSE 190,A00,092507,Dubnov; Shlomo,3,0,20,17
1656265183534,ECE 45,A01,083139,Congero; Spencer William,1,0,75,74
1656265189555,ECE 65,A50,083695,Saad; Andrew S,9,0,30,21
1656265189555,ECE 65,A51,095125,Staff,24,0,26,2
1656265195596,ECE 109,A01,091882,Touri; Behrouz,0,1,70,70
1656265201618,ECE 180,A00,083140,Abi Samra; Nicholas Camill,1,0,30,29
1656265201618,ECE 180,B00,083141,Abi Samra; Nicholas Camill,0,4,30,30
1656265207652,MATH 10A,A01,083735,Patchell; Gregory David,0,0,30,30
1656265207652,MATH 10A,A02,083736,Patchell; Gregory David,22,0,30,8
1656265207652,MATH 10A,A03,083737,Patchell; Gregory David,16,0,30,14
1656265213676,MATH 10B,A01,083207,Lim; Seonhee,0,0,34,34
1656265213676,MATH 10B,A02,083208,Lim; Seonhee,7,0,35,28
1656265213676,MATH 10B,A03,093472,Staff,1,0,34,33
1656265213676,MATH 10B,B01,083739,Sinha; Shubham,11,0,30,19
1656265219704,MATH 18,A01,083743,Cinel; Cameron Alexander,7,0,30,23
1656265219704,MATH 18,A02,083744,Cinel; Cameron Alexander,9,0,30,21
1656265219704,MATH 18,A03,083745,Cinel; Cameron Alexander,5,0,30,25
1656265219704,MATH 18,B01,083748,Rideout; David Porter,1,0,36,35
1656265219704,MATH 18,B02,083749,Rideout; David Porter,0,0,36,36
1656265219704,MATH 18,B03,083750,Rideout; David Porter,0,0,36,36
1656265219704,MATH 18,B04,083751,Rideout; David Porter,0,1,36,36
1656265219704,MATH 18,B05,093473,Rideout; David Porter,0,0,36,36
1656265219704,MATH 18,B06,093474,Rideout; David Porter,3,0,36,33
1656265225741,MATH 20A,A01,083754,Zheng; Zequn,11,0,40,29
1656265231768,MATH 20B,A01,083756,Briones; Jor-el Thomas Caparas,0,0,36,36
1656265231768,MATH 20B,A02,083757,Briones; Jor-el Thomas Caparas,0,0,36,36
1656265231768,MATH 20B,A03,093475,Staff,0,0,36,36
1656265237816,MATH 20C,A01,083760,Briones; Jor-el Thomas Caparas,0,0,35,35
1656265237816,MATH 20C,A02,083761,Briones; Jor-el Thomas Caparas,9,1,35,26
1656265237816,MATH 20C,A03,093476,Staff,0,0,35,35
1656265237816,MATH 20C,B01,083762,Bach; Quang Tran,1,0,30,29
1656265243840,MATH 20D,A01,083765,Tran; Brian Kha,1,0,30,29
1656265243840,MATH 20D,A02,083766,Tran; Brian Kha,0,1,30,30
1656265243840,MATH 20D,A03,083767,Tran; Brian Kha,2,0,30,28
1656265249877,MATH 20E,A01,083771,Ganguly; Soumya,3,0,32,29
1656265249877,MATH 20E,A02,083772,Ganguly; Soumya,0,0,32,32
1656265249877,MATH 20E,B01,083773,Ciotti; Benjamin,16,0,35,19
1656265249877,MATH 20E,B02,083774,Ciotti; Benjamin,15,0,35,20
1656265255900,MATH 103A,A01,083777,Greenfeld; Be'Eri,1,0,36,35
1656265255900,MATH 103A,A02,083778,Greenfeld; Be'Eri,1,0,36,35
1656265255900,MATH 103A,A03,093561,Staff,5,0,36,31
1656265255900,MATH 103A,B01,083779,Greenfeld; Be'Eri,8,0,36,28
1656265255900,MATH 103A,B02,083780,Greenfeld; Be'Eri,1,0,36,35
1656265255900,MATH 103A,B03,093562,Staff,0,0,36,36
1656265261941,MATH 105,A01,085443,Carter; Anne Toulson,5,0,35,30
1656265261941,MATH 105,A02,093477,Staff,14,0,35,21
1656265267972,MATH 109,A01,083213,Ganzberger; Geoffrey Michael,0,0,34,34
1656265267972,MATH 109,A02,083214,Ganzberger; Geoffrey Michael,0,0,34,34
1656265267972,MATH 109,A03,093478,Staff,1,0,34,33
1656265267972,MATH 109,B01,083215,Ganzberger; Geoffrey Michael,4,0,32,28
1656265267972,MATH 109,B02,083216,Ganzberger; Geoffrey Michael,1,0,32,31
1656265267972,MATH 109,B03,093479,Staff,3,0,32,29
1656265274004,MATH 142A,A01,083219,Chow; Bennett,2,0,32,30
1656265274004,MATH 142A,A02,083220,Chow; Bennett,8,0,32,24
1656265274004,MATH 142A,A03,093480,Staff,5,0,32,27
1656265274004,MATH 142A,B03,093481,Staff,3,0,32,29
1656265274004,MATH 142A,B04,093558,Staff,6,0,32,26
1656265274004,MATH 142A,B05,093559,Staff,0,0,32,32
1656265280062,MATH 193A,A01,083224,Rotar; Vladimir,0,1,34,34
1656265280062,MATH 193A,A02,083225,Rotar; Vladimir,0,0,34,34
1656265280062,MATH 193A,A03,083781,Rotar; Vladimir,0,0,34,34
1656265280062,MATH 193A,A04,083782,Rotar; Vladimir,6,0,34,28
1656265280062,MATH 193A,A05,093482,Rotar; Vladimir,0,0,34,34
1656265286091,MATH 197,001,091859,McAuley; Julian John,9999,0,9999,0
1656265286091,MATH 197,002,095566,Kedlaya; Kiran S.,9997,0,9999,2
1656265286091,MATH 197,003,095567,Xiao; Ming,9999,0,9999,0
1656265286091,MATH 197,004,095571,Perols; Johan Lars,9998,0,9999,1
1656265293178,COGS 9,A01,083615,Shannon; Kyle Michael,4,0,75,71
1656265299216,COGS 11,A01,083617,Boyle; Mary E. T.,14,0,48,34
1656265305242,COGS 13,A01,083071,Bastos; Amalia Pinkusfeld,5,0,71,66
1656265311268,COGS 14A,A01,092681,Semenuks; Arturs,1,12,100,99
1656265317296,COGS 14B,A01,083073,Cheng; Tzu-Han,7,0,63,56
1656265323319,COGS 17,A01,092677,Semenuks; Arturs,8,0,81,73
1656265329342,COGS 100,A01,083619,Allen; Michael Gordon,2,0,70,68
1656265335365,COGS 101A,A01,083621,Davis; Joshua Daniel,4,0,68,64
1656265341391,COGS 101B,A01,091572,Allen; Michael Gordon,4,0,65,61
1656265347436,COGS 101C,A01,083625,Delgado; Tania,10,0,35,25
1656265353466,COGS 107A,A01,083627,Boyle; Mary E. T.,0,0,60,60
1656265359516,COGS 118A,A01,083075,Gupta; Anjum,8,0,76,68
1656265365558,CSE 3,A50,083646,Miranda; Gregory Joseph,18,0,50,32
1656265371586,CSE 8A,A50,083650,Miranda; Gregory Joseph,2,2,56,54
1656265377609,CSE 11,A01,083080,Cao; Yingjun,0,49,40,40
1656265383635,CSE 12,A01,083652,Krause-Levy; Sophia Louisa,5,1,120,115
1656265389658,CSE 15L,A01,083654,Morris; Justin Loren,2,0,50,48
1656265389658,CSE 15L,A02,083655,Morris; Justin Loren,4,0,50,46
1656265395681,CSE 20,A01,083657,Tran; Khoa Dang,30,0,80,50
1656265401704,CSE 21,A01,095574,Bach; Quang Tran,23,0,48,25
1656265407729,CSE 30,A01,083084,Eldon; John,2,6,80,78
1656265407729,CSE 30,B01,095061,Bhaskar; Nishant,0,1,50,50
1656265413827,CSE 100,A01,083659,Cao; Yingjun,1,18,70,69
1656265419855,CSE 134B,A01,083661,Powell; Thomas Allan,5,0,100,95
1656265425878,CSE 140,A01,083663,Gungor; Onat,9,0,85,76
1656265431910,CSE 140L,A01,083088,Eldon; John,8,0,100,92
1656265437938,CSE 175,A01,083665,Kumar; Rakesh,0,0,25,25
1656265443967,CSE 190,A00,092507,Dubnov; Shlomo,3,0,20,17
1656265450001,ECE 45,A01,083139,Congero; Spencer William,1,0,75,74
1656265456025,ECE 65,A50,083695,Saad; Andrew S,9,0,30,21
1656265456025,ECE 65,A51,095125,Staff,24,0,26,2
1656265462047,ECE 109,A01,091882,Touri; Behrouz,0,1,70,70
1656265468080,ECE 180,A00,083140,Abi Samra; Nicholas Camill,1,0,30,29
1656265468080,ECE 180,B00,083141,Abi Samra; Nicholas Camill,0,4,30,30
1656265474113,MATH 10A,A01,083735,Patchell; Gregory David,0,0,30,30
1656265474113,MATH 10A,A02,083736,Patchell; Gregory David,22,0,30,8
1656265474113,MATH 10A,A03,083737,Patchell; Gregory David,16,0,30,14
1656265480142,MATH 10B,A01,083207,Lim; Seonhee,0,0,34,34
1656265480142,MATH 10B,A02,083208,Lim; Seonhee,7,0,35,28
1656265480142,MATH 10B,A03,093472,Staff,1,0,34,33
1656265480142,MATH 10B,B01,083739,Sinha; Shubham,11,0,30,19
1656265486167,MATH 18,A01,083743,Cinel; Cameron Alexander,7,0,30,23
1656265486167,MATH 18,A02,083744,Cinel; Cameron Alexander,9,0,30,21
1656265486167,MATH 18,A03,083745,Cinel; Cameron Alexander,5,0,30,25
1656265486167,MATH 18,B01,083748,Rideout; David Porter,1,0,36,35
1656265486167,MATH 18,B02,083749,Rideout; David Porter,0,0,36,36
1656265486167,MATH 18,B03,083750,Rideout; David Porter,0,0,36,36
1656265486167,MATH 18,B04,083751,Rideout; David Porter,0,1,36,36
1656265486167,MATH 18,B05,093473,Rideout; David Porter,0,0,36,36
1656265486167,MATH 18,B06,093474,Rideout; David Porter,3,0,36,33
1656265492192,MATH 20A,A01,083754,Zheng; Zequn,11,0,40,29
1656265498220,MATH 20B,A01,083756,Briones; Jor-el Thomas Caparas,0,0,36,36
1656265498220,MATH 20B,A02,083757,Briones; Jor-el Thomas Caparas,0,0,36,36
1656265498220,MATH 20B,A03,093475,Staff,0,0,36,36
1656265504257,MATH 20C,A01,083760,Briones; Jor-el Thomas Caparas,0,0,35,35
1656265504257,MATH 20C,A02,083761,Briones; Jor-el Thomas Caparas,9,1,35,26
1656265504257,MATH 20C,A03,093476,Staff,0,0,35,35
1656265504257,MATH 20C,B01,083762,Bach; Quang Tran,1,0,30,29
1656265510310,MATH 20D,A01,083765,Tran; Brian Kha,1,0,30,29
1656265510310,MATH 20D,A02,083766,Tran; Brian Kha,0,1,30,30
1656265510310,MATH 20D,A03,083767,Tran; Brian Kha,2,0,30,28
1656265516347,MATH 20E,A01,083771,Ganguly; Soumya,3,0,32,29
1656265516347,MATH 20E,A02,083772,Ganguly; Soumya,0,0,32,32
1656265516347,MATH 20E,B01,083773,Ciotti; Benjamin,16,0,35,19
1656265516347,MATH 20E,B02,083774,Ciotti; Benjamin,15,0,35,20
1656265522371,MATH 103A,A01,083777,Greenfeld; Be'Eri,1,0,36,35
1656265522371,MATH 103A,A02,083778,Greenfeld; Be'Eri,1,0,36,35
1656265522371,MATH 103A,A03,093561,Staff,5,0,36,31
1656265522371,MATH 103A,B01,083779,Greenfeld; Be'Eri,8,0,36,28
1656265522371,MATH 103A,B02,083780,Greenfeld; Be'Eri,1,0,36,35
1656265522371,MATH 103A,B03,093562,Staff,0,0,36,36
1656265528394,MATH 105,A01,085443,Carter; Anne Toulson,5,0,35,30
1656265528394,MATH 105,A02,093477,Staff,14,0,35,21
1656265534430,MATH 109,A01,083213,Ganzberger; Geoffrey Michael,0,0,34,34
1656265534430,MATH 109,A02,083214,Ganzberger; Geoffrey Michael,0,0,34,34
1656265534430,MATH 109,A03,093478,Staff,1,0,34,33
1656265534430,MATH 109,B01,083215,Ganzberger; Geoffrey Michael,4,0,32,28
1656265534430,MATH 109,B02,083216,Ganzberger; Geoffrey Michael,1,0,32,31
1656265534430,MATH 109,B03,093479,Staff,3,0,32,29
1656265540453,MATH 142A,A01,083219,Chow; Bennett,2,0,32,30
1656265540453,MATH 142A,A02,083220,Chow; Bennett,8,0,32,24
1656265540453,MATH 142A,A03,093480,Staff,5,0,32,27
1656265540453,MATH 142A,B03,093481,Staff,3,0,32,29
1656265540453,MATH 142A,B04,093558,Staff,6,0,32,26
1656265540453,MATH 142A,B05,093559,Staff,0,0,32,32
1656265546477,MATH 193A,A01,083224,Rotar; Vladimir,0,1,34,34
1656265546477,MATH 193A,A02,083225,Rotar; Vladimir,0,0,34,34
1656265546477,MATH 193A,A03,083781,Rotar; Vladimir,0,0,34,34
1656265546477,MATH 193A,A04,083782,Rotar; Vladimir,6,0,34,28
1656265546477,MATH 193A,A05,093482,Rotar; Vladimir,0,0,34,34
1656265552508,MATH 197,001,091859,McAuley; Julian John,9999,0,9999,0
1656265552508,MATH 197,002,095566,Kedlaya; Kiran S.,9997,0,9999,2
1656265552508,MATH 197,003,095567,Xiao; Ming,9999,0,9999,0
1656265552508,MATH 197,004,095571,Perols; Johan Lars,9998,0,9999,1
1656265559576,COGS 9,A01,083615,Shannon; Kyle Michael,4,0,75,71
1656265565604,COGS 11,A01,083617,Boyle; Mary E. T.,14,0,48,34
1656265571640,COGS 13,A01,083071,Bastos; Amalia Pinkusfeld,5,0,71,66
1656265577665,COGS 14A,A01,092681,Semenuks; Arturs,1,12,100,99
1656265583700,COGS 14B,A01,083073,Cheng; Tzu-Han,7,0,63,56
1656265589739,COGS 17,A01,092677,Semenuks; Arturs,8,0,81,73
1656265595766,COGS 100,A01,083619,Allen; Michael Gordon,2,0,70,68
1656265601792,COGS 101A,A01,083621,Davis; Joshua Daniel,4,0,68,64
1656265607827,COGS 101B,A01,091572,Allen; Michael Gordon,4,0,65,61
1656265613855,COGS 101C,A01,083625,Delgado; Tania,10,0,35,25
1656265619881,COGS 107A,A01,083627,Boyle; Mary E. T.,0,0,60,60
1656265625911,COGS 118A,A01,083075,Gupta; Anjum,8,0,76,68
1656265631945,CSE 3,A50,083646,Miranda; Gregory Joseph,18,0,50,32
1656265637970,CSE 8A,A50,083650,Miranda; Gregory Joseph,2,2,56,54
1656265643993,CSE 11,A01,083080,Cao; Yingjun,0,49,40,40
1656265650025,CSE 12,A01,083652,Krause-Levy; Sophia Louisa,5,1,120,115
1656265656048,CSE 15L,A01,083654,Morris; Justin Loren,2,0,50,48
1656265656048,CSE 15L,A02,083655,Morris; Justin Loren,4,0,50,46
1656265662081,CSE 20,A01,083657,Tran; Khoa Dang,30,0,80,50
1656265668105,CSE 21,A01,095574,Bach; Quang Tran,23,0,48,25
1656265674133,CSE 30,A01,083084,Eldon; John,2,6,80,78
1656265674133,CSE 30,B01,095061,Bhaskar; Nishant,0,1,50,50
1656265680157,CSE 100,A01,083659,Cao; Yingjun,1,18,70,69
1656265686191,CSE 134B,A01,083661,Powell; Thomas Allan,5,0,100,95
1656265692218,CSE 140,A01,083663,Gungor; Onat,9,0,85,76
1656265698243,CSE 140L,A01,083088,Eldon; John,8,0,100,92
1656265704273,CSE 175,A01,083665,Kumar; Rakesh,0,0,25,25
1656265710297,CSE 190,A00,092507,Dubnov; Shlomo,3,0,20,17
1656265716321,ECE 45,A01,083139,Congero; Spencer William,1,0,75,74
1656265722344,ECE 65,A50,083695,Saad; Andrew S,9,0,30,21
1656265722344,ECE 65,A51,095125,Staff,24,0,26,2
1656265728367,ECE 109,A01,091882,Touri; Behrouz,0,1,70,70
1656265734392,ECE 180,A00,083140,Abi Samra; Nicholas Camill,1,0,30,29
1656265734392,ECE 180,B00,083141,Abi Samra; Nicholas Camill,0,4,30,30
1656265740419,MATH 10A,A01,083735,Patchell; Gregory David,0,0,30,30
1656265740419,MATH 10A,A02,083736,Patchell; Gregory David,22,0,30,8
1656265740419,MATH 10A,A03,083737,Patchell; Gregory David,16,0,30,14
1656265746445,MATH 10B,A01,083207,Lim; Seonhee,0,0,34,34
1656265746445,MATH 10B,A02,083208,Lim; Seonhee,7,0,35,28
1656265746445,MATH 10B,A03,093472,Staff,1,0,34,33
1656265746445,MATH 10B,B01,083739,Sinha; Shubham,11,0,30,19
1656265752471,MATH 18,A01,083743,Cinel; Cameron Alexander,7,0,30,23
1656265752471,MATH 18,A02,083744,Cinel; Cameron Alexander,9,0,30,21
1656265752471,MATH 18,A03,083745,Cinel; Cameron Alexander,5,0,30,25
1656265752471,MATH 18,B01,083748,Rideout; David Porter,1,0,36,35
1656265752471,MATH 18,B02,083749,Rideout; David Porter,0,0,36,36
1656265752471,MATH 18,B03,083750,Rideout; David Porter,0,0,36,36
1656265752471,MATH 18,B04,083751,Rideout; David Porter,0,1,36,36
1656265752471,MATH 18,B05,093473,Rideout; David Porter,0,0,36,36
1656265752471,MATH 18,B06,093474,Rideout; David Porter,3,0,36,33
1656265758494,MATH 20A,A01,083754,Zheng; Zequn,11,0,40,29
1656265764529,MATH 20B,A01,083756,Briones; Jor-el Thomas Caparas,0,0,36,36
1656265764529,MATH 20B,A02,083757,Briones; Jor-el Thomas Caparas,0,0,36,36
1656265764529,MATH 20B,A03,093475,Staff,0,0,36,36
1656265770556,MATH 20C,A01,083760,Briones; Jor-el Thomas Caparas,0,0,35,35
1656265770556,MATH 20C,A02,083761,Briones; Jor-el Thomas Caparas,9,1,35,26
1656265770556,MATH 20C,A03,093476,Staff,0,0,35,35
1656265770556,MATH 20C,B01,083762,Bach; Quang Tran,1,0,30,29
1656265776615,MATH 20D,A01,083765,Tran; Brian Kha,1,0,30,29
1656265776615,MATH 20D,A02,083766,Tran; Brian Kha,0,1,30,30
1656265776615,MATH 20D,A03,083767,Tran; Brian Kha,2,0,30,28
1656265782657,MATH 20E,A01,083771,Ganguly; Soumya,3,0,32,29
1656265782657,MATH 20E,A02,083772,Ganguly; Soumya,0,0,32,32
1656265782657,MATH 20E,B01,083773,Ciotti; Benjamin,16,0,35,19
1656265782657,MATH 20E,B02,083774,Ciotti; Benjamin,15,0,35,20
1656265788685,MATH 103A,A01,083777,Greenfeld; Be'Eri,1,0,36,35
1656265788685,MATH 103A,A02,083778,Greenfeld; Be'Eri,1,0,36,35
1656265788685,MATH 103A,A03,093561,Staff,5,0,36,31
1656265788685,MATH 103A,B01,083779,Greenfeld; Be'Eri,8,0,36,28
1656265788685,MATH 103A,B02,083780,Greenfeld; Be'Eri,1,0,36,35
1656265788685,MATH 103A,B03,093562,Staff,0,0,36,36
1656265794712,MATH 105,A01,085443,Carter; Anne Toulson,5,0,35,30
1656265794712,MATH 105,A02,093477,Staff,14,0,35,21
1656265800737,MATH 109,A01,083213,Ganzberger; Geoffrey Michael,0,0,34,34
1656265800737,MATH 109,A02,083214,Ganzberger; Geoffrey Michael,0,0,34,34
1656265800737,MATH 109,A03,093478,Staff,1,0,34,33
1656265800737,MATH 109,B01,083215,Ganzberger; Geoffrey Michael,4,0,32,28
1656265800737,MATH 109,B02,083216,Ganzberger; Geoffrey Michael,1,0,32,31
1656265800737,MATH 109,B03,093479,Staff,3,0,32,29
1656265806787,MATH 142A,A01,083219,Chow; Bennett,2,0,32,30
1656265806787,MATH 142A,A02,083220,Chow; Bennett,8,0,32,24
1656265806787,MATH 142A,A03,093480,Staff,5,0,32,27
1656265806787,MATH 142A,B03,093481,Staff,3,0,32,29
1656265806787,MATH 142A,B04,093558,Staff,6,0,32,26
1656265806787,MATH 142A,B05,093559,Staff,0,0,32,32
1656265812811,MATH 193A,A01,083224,Rotar; Vladimir,0,1,34,34
1656265812811,MATH 193A,A02,083225,Rotar; Vladimir,0,0,34,34
1656265812811,MATH 193A,A03,083781,Rotar; Vladimir,0,0,34,34
1656265812811,MATH 193A,A04,083782,Rotar; Vladimir,6,0,34,28
1656265812811,MATH 193A,A05,093482,Rotar; Vladimir,0,0,34,34
1656265818859,MATH 197,001,091859,McAuley; Julian John,9999,0,9999,0
1656265818859,MATH 197,002,095566,Kedlaya; Kiran S.,9997,0,9999,2
1656265818859,MATH 197,003,095567,Xiao; Ming,9999,0,9999,0
1656265818859,MATH 197,004,095571,Perols; Johan Lars,9998,0,9999,1
1656265825924,COGS 9,A01,083615,Shannon; Kyle Michael,4,0,75,71
1656265831948,COGS 11,A01,083617,Boyle; Mary E. T.,14,0,48,34
1656265837984,COGS 13,A01,083071,Bastos; Amalia Pinkusfeld,5,0,71,66
1656265844020,COGS 14A,A01,092681,Semenuks; Arturs,1,12,100,99
1656265850048,COGS 14B,A01,083073,Cheng; Tzu-Han,7,0,63,56
1656265856072,COGS 17,A01,092677,Semenuks; Arturs,8,0,81,73
1656265862100,COGS 100,A01,083619,Allen; Michael Gordon,2,0,70,68
1656265868123,COGS 101A,A01,083621,Davis; Joshua Daniel,4,0,68,64
1656265874149,COGS 101B,A01,091572,Allen; Michael Gordon,4,0,65,61
1656265880176,COGS 101C,A01,083625,Delgado; Tania,10,0,35,25
1656265886200,COGS 107A,A01,083627,Boyle; Mary E. T.,0,0,60,60
1656265892228,COGS 118A,A01,083075,Gupta; Anjum,8,0,76,68
1656265898277,CSE 3,A50,083646,Miranda; Gregory Joseph,18,0,50,32
1656265904312,CSE 8A,A50,083650,Miranda; Gregory Joseph,2,2,56,54
1656265910339,CSE 11,A01,083080,Cao; Yingjun,0,49,40,40
1656265916367,CSE 12,A01,083652,Krause-Levy; Sophia Louisa,5,1,120,115
1656265922408,CSE 15L,A01,083654,Morris; Justin Loren,2,0,50,48
1656265922408,CSE 15L,A02,083655,Morris; Justin Loren,4,0,50,46
1656265928432,CSE 20,A01,083657,Tran; Khoa Dang,30,0,80,50
1656265934463,CSE 21,A01,095574,Bach; Quang Tran,23,0,48,25
1656265940489,CSE 30,A01,083084,Eldon; John,2,6,80,78
1656265940489,CSE 30,B01,095061,Bhaskar; Nishant,0,1,50,50
1656265946513,CSE 100,A01,083659,Cao; Yingjun,1,18,70,69
1656265952535,CSE 134B,A01,083661,Powell; Thomas Allan,5,0,100,95
1656265958559,CSE 140,A01,083663,Gungor; Onat,9,0,85,76
1656265964583,CSE 140L,A01,083088,Eldon; John,8,0,100,92
1656265970609,CSE 175,A01,083665,Kumar; Rakesh,0,0,25,25
1656265976632,CSE 190,A00,092507,Dubnov; Shlomo,3,0,20,17
1656265982659,ECE 45,A01,083139,Congero; Spencer William,1,0,75,74
1656265988683,ECE 65,A50,083695,Saad; Andrew S,9,0,30,21
1656265988683,ECE 65,A51,095125,Staff,24,0,26,2
1656265994717,ECE 109,A01,091882,Touri; Behrouz,0,1,70,70
1656266000744,ECE 180,A00,083140,Abi Samra; Nicholas Camill,1,0,30,29
1656266000744,ECE 180,B00,083141,Abi Samra; Nicholas Camill,0,4,30,30
1656266006769,MATH 10A,A01,083735,Patchell; Gregory David,0,0,30,30
1656266006769,MATH 10A,A02,083736,Patchell; Gregory David,22,0,30,8
1656266006769,MATH 10A,A03,083737,Patchell; Gregory David,16,0,30,14
1656266012874,MATH 10B,A01,083207,Lim; Seonhee,0,0,34,34
1656266012874,MATH 10B,A02,083208,Lim; Seonhee,7,0,35,28
1656266012874,MATH 10B,A03,093472,Staff,1,0,34,33
1656266012874,MATH 10B,B01,083739,Sinha; Shubham,11,0,30,19
1656266018905,MATH 18,A01,083743,Cinel; Cameron Alexander,7,0,30,23
1656266018905,MATH 18,A02,083744,Cinel; Cameron Alexander,9,0,30,21
1656266018905,MATH 18,A03,083745,Cinel; Cameron Alexander,5,0,30,25
1656266018905,MATH 18,B01,083748,Rideout; David Porter,1,0,36,35
1656266018905,MATH 18,B02,083749,Rideout; David Porter,0,0,36,36
1656266018905,MATH 18,B03,083750,Rideout; David Porter,0,0,36,36
1656266018905,MATH 18,B04,083751,Rideout; David Porter,0,1,36,36
1656266018905,MATH 18,B05,093473,Rideout; David Porter,0,0,36,36
1656266018905,MATH 18,B06,093474,Rideout; David Porter,3,0,36,33
1656266024927,MATH 20A,A01,083754,Zheng; Zequn,11,0,40,29
1656266030950,MATH 20B,A01,083756,Briones; Jor-el Thomas Caparas,0,0,36,36
1656266030950,MATH 20B,A02,083757,Briones; Jor-el Thomas Caparas,0,0,36,36
1656266030950,MATH 20B,A03,093475,Staff,0,0,36,36
1656266037005,MATH 20C,A01,083760,Briones; Jor-el Thomas Caparas,0,0,35,35
1656266037005,MATH 20C,A02,083761,Briones; Jor-el Thomas Caparas,9,1,35,26
1656266037005,MATH 20C,A03,093476,Staff,0,0,35,35
1656266037005,MATH 20C,B01,083762,Bach; Quang Tran,1,0,30,29
1656266043039,MATH 20D,A01,083765,Tran; Brian Kha,1,0,30,29
1656266043039,MATH 20D,A02,083766,Tran; Brian Kha,0,1,30,30
1656266043039,MATH 20D,A03,083767,Tran; Brian Kha,2,0,30,28
1656266049062,MATH 20E,A01,083771,Ganguly; Soumya,3,0,32,29
1656266049062,MATH 20E,A02,083772,Ganguly; Soumya,0,0,32,32
1656266049062,MATH 20E,B01,083773,Ciotti; Benjamin,16,0,35,19
1656266049062,MATH 20E,B02,083774,Ciotti; Benjamin,15,0,35,20
1656266055092,MATH 103A,A01,083777,Greenfeld; Be'Eri,1,0,36,35
1656266055092,MATH 103A,A02,083778,Greenfeld; Be'Eri,1,0,36,35
1656266055092,MATH 103A,A03,093561,Staff,5,0,36,31
1656266055092,MATH 103A,B01,083779,Greenfeld; Be'Eri,8,0,36,28
1656266055092,MATH 103A,B02,083780,Greenfeld; Be'Eri,1,0,36,35
1656266055092,MATH 103A,B03,093562,Staff,0,0,36,36
1656266061115,MATH 105,A01,085443,Carter; Anne Toulson,5,0,35,30
1656266061115,MATH 105,A02,093477,Staff,14,0,35,21
1656266067155,MATH 109,A01,083213,Ganzberger; Geoffrey Michael,0,0,34,34
1656266067155,MATH 109,A02,083214,Ganzberger; Geoffrey Michael,0,0,34,34
1656266067155,MATH 109,A03,093478,Staff,1,0,34,33
1656266067155,MATH 109,B01,083215,Ganzberger; Geoffrey Michael,4,0,32,28
1656266067155,MATH 109,B02,083216,Ganzberger; Geoffrey Michael,1,0,32,31
1656266067155,MATH 109,B03,093479,Staff,3,0,32,29
1656266073178,MATH 142A,A01,083219,Chow; Bennett,2,0,32,30
1656266073178,MATH 142A,A02,083220,Chow; Bennett,8,0,32,24
1656266073178,MATH 142A,A03,093480,Staff,5,0,32,27
1656266073178,MATH 142A,B03,093481,Staff,3,0,32,29
1656266073178,MATH 142A,B04,093558,Staff,6,0,32,26
1656266073178,MATH 142A,B05,093559,Staff,0,0,32,32
1656266079205,MATH 193A,A01,083224,Rotar; Vladimir,0,1,34,34
1656266079205,MATH 193A,A02,083225,Rotar; Vladimir,0,0,34,34
1656266079205,MATH 193A,A03,083781,Rotar; Vladimir,0,0,34,34
1656266079205,MATH 193A,A04,083782,Rotar; Vladimir,6,0,34,28
1656266079205,MATH 193A,A05,093482,Rotar; Vladimir,0,0,34,34
1656266085231,MATH 197,001,091859,McAuley; Julian John,9999,0,9999,0
1656266085231,MATH 197,002,095566,Kedlaya; Kiran S.,9997,0,9999,2
1656266085231,MATH 197,003,095567,Xiao; Ming,9999,0,9999,0
1656266085231,MATH 197,004,095571,Perols; Johan Lars,9998,0,9999,1
1656266092287,COGS 9,A01,083615,Shannon; Kyle Michael,4,0,75,71
1656266098311,COGS 11,A01,083617,Boyle; Mary E. T.,14,0,48,34
1656266104344,COGS 13,A01,083071,Bastos; Amalia Pinkusfeld,5,0,71,66
1656266110383,COGS 14A,A01,092681,Semenuks; Arturs,1,12,100,99
1656266116406,COGS 14B,A01,083073,Cheng; Tzu-Han,7,0,63,56
1656266122440,COGS 17,A01,092677,Semenuks; Arturs,8,0,81,73
1656266128462,COGS 100,A01,083619,Allen; Michael Gordon,2,0,70,68
1656266134494,COGS 101A,A01,083621,Davis; Joshua Daniel,4,0,68,64
1656266140520,COGS 101B,A01,091572,Allen; Michael Gordon,4,0,65,61
1656266146546,COGS 101C,A01,083625,Delgado; Tania,10,0,35,25
1656266152582,COGS 107A,A01,083627,Boyle; Mary E. T.,0,0,60,60
1656266158604,COGS 118A,A01,083075,Gupta; Anjum,8,0,76,68
1656266164630,CSE 3,A50,083646,Miranda; Gregory Joseph,18,0,50,32
1656266170665,CSE 8A,A50,083650,Miranda; Gregory Joseph,2,2,56,54
1656266176688,CSE 11,A01,083080,Cao; Yingjun,0,49,40,40
1656266182714,CSE 12,A01,083652,Krause-Levy; Sophia Louisa,5,1,120,115
1656266188740,CSE 15L,A01,083654,Morris; Justin Loren,2,0,50,48
1656266188740,CSE 15L,A02,083655,Morris; Justin Loren,4,0,50,46
1656266194795,CSE 20,A01,083657,Tran; Khoa Dang,30,0,80,50
1656266200818,CSE 21,A01,095574,Bach; Quang Tran,23,0,48,25
1656266206842,CSE 30,A01,083084,Eldon; John,2,6,80,78
1656266206842,CSE 30,B01,095061,Bhaskar; Nishant,0,1,50,50
1656266212869,CSE 100,A01,083659,Cao; Yingjun,1,18,70,69
1656266218893,CSE 134B,A01,083661,Powell; Thomas Allan,5,0,100,95
1656266224916,CSE 140,A01,083663,Gungor; Onat,9,0,85,76
1656266230952,CSE 140L,A01,083088,Eldon; John,8,0,100,92
1656266236999,CSE 175,A01,083665,Kumar; Rakesh,0,0,25,25
1656266243024,CSE 190,A00,092507,Dubnov; Shlomo,3,0,20,17
1656266249066,ECE 45,A01,083139,Congero; Spencer William,1,0,75,74
1656266255090,ECE 65,A50,083695,Saad; Andrew S,9,0,30,21
1656266255090,ECE 65,A51,095125,Staff,24,0,26,2
1656266261114,ECE 109,A01,091882,Touri; Behrouz,0,1,70,70
1656266267140,ECE 180,A00,083140,Abi Samra; Nicholas Camill,1,0,30,29
1656266267140,ECE 180,B00,083141,Abi Samra; Nicholas Camill,0,4,30,30
1656266273168,MATH 10A,A01,083735,Patchell; Gregory David,0,0,30,30
1656266273168,MATH 10A,A02,083736,Patchell; Gregory David,22,0,30,8
1656266273168,MATH 10A,A03,083737,Patchell; Gregory David,16,0,30,14
1656266279191,MATH 10B,A01,083207,Lim; Seonhee,0,0,34,34
1656266279191,MATH 10B,A02,083208,Lim; Seonhee,7,0,35,28
1656266279191,MATH 10B,A03,093472,Staff,1,0,34,33
1656266279191,MATH 10B,B01,083739,Sinha; Shubham,11,0,30,19
1656266285222,MATH 18,A01,083743,Cinel; Cameron Alexander,7,0,30,23
1656266285222,MATH 18,A02,083744,Cinel; Cameron Alexander,9,0,30,21
1656266285222,MATH 18,A03,083745,Cinel; Cameron Alexander,5,0,30,25
1656266285222,MATH 18,B01,083748,Rideout; David Porter,1,0,36,35
1656266285222,MATH 18,B02,083749,Rideout; David Porter,0,0,36,36
1656266285222,MATH 18,B03,083750,Rideout; David Porter,0,0,36,36
1656266285222,MATH 18,B04,083751,Rideout; David Porter,0,1,36,36
1656266285222,MATH 18,B05,093473,Rideout; David Porter,0,0,36,36
1656266285222,MATH 18,B06,093474,Rideout; David Porter,3,0,36,33
1656266291245,MATH 20A,A01,083754,Zheng; Zequn,11,0,40,29
1656266297271,MATH 20B,A01,083756,Briones; Jor-el Thomas Caparas,0,0,36,36
1656266297271,MATH 20B,A02,083757,Briones; Jor-el Thomas Caparas,0,0,36,36
1656266297271,MATH 20B,A03,093475,Staff,0,0,36,36
1656266303296,MATH 20C,A01,083760,Briones; Jor-el Thomas Caparas,0,0,35,35
1656266303296,MATH 20C,A02,083761,Briones; Jor-el Thomas Caparas,9,1,35,26
1656266303296,MATH 20C,A03,093476,Staff,0,0,35,35
1656266303296,MATH 20C,B01,083762,Bach; Quang Tran,1,0,30,29
1656266309321,MATH 20D,A01,083765,Tran; Brian Kha,1,0,30,29
1656266309321,MATH 20D,A02,083766,Tran; Brian Kha,0,1,30,30
1656266309321,MATH 20D,A03,083767,Tran; Brian Kha,2,0,30,28
1656266315347,MATH 20E,A01,083771,Ganguly; Soumya,3,0,32,29
1656266315347,MATH 20E,A02,083772,Ganguly; Soumya,0,0,32,32
1656266315347,MATH 20E,B01,083773,Ciotti; Benjamin,16,0,35,19
1656266315347,MATH 20E,B02,083774,Ciotti; Benjamin,15,0,35,20
1656266321381,MATH 103A,A01,083777,Greenfeld; Be'Eri,1,0,36,35
1656266321381,MATH 103A,A02,083778,Greenfeld; Be'Eri,1,0,36,35
1656266321381,MATH 103A,A03,093561,Staff,5,0,36,31
1656266321381,MATH 103A,B01,083779,Greenfeld; Be'Eri,8,0,36,28
1656266321381,MATH 103A,B02,083780,Greenfeld; Be'Eri,1,0,36,35
1656266321381,MATH 103A,B03,093562,Staff,0,0,36,36
1656266327407,MATH 105,A01,085443,Carter; Anne Toulson,5,0,35,30
1656266327407,MATH 105,A02,093477,Staff,14,0,35,21
1656266333434,MATH 109,A01,083213,Ganzberger; Geoffrey Michael,0,0,34,34
1656266333434,MATH 109,A02,083214,Ganzberger; Geoffrey Michael,0,0,34,34
1656266333434,MATH 109,A03,093478,Staff,1,0,34,33
1656266333434,MATH 109,B01,083215,Ganzberger; Geoffrey Michael,4,0,32,28
1656266333434,MATH 109,B02,083216,Ganzberger; Geoffrey Michael,1,0,32,31
1656266333434,MATH 109,B03,093479,Staff,3,0,32,29
1656266339463,MATH 142A,A01,083219,Chow; Bennett,2,0,32,30
1656266339463,MATH 142A,A02,083220,Chow; Bennett,8,0,32,24
1656266339463,MATH 142A,A03,093480,Staff,5,0,32,27
1656266339463,MATH 142A,B03,093481,Staff,3,0,32,29
1656266339463,MATH 142A,B04,093558,Staff,6,0,32,26
1656266339463,MATH 142A,B05,093559,Staff,0,0,32,32
1656266345486,MATH 193A,A01,083224,Rotar; Vladimir,0,1,34,34
1656266345486,MATH 193A,A02,083225,Rotar; Vladimir,0,0,34,34
1656266345486,MATH 193A,A03,083781,Rotar; Vladimir,0,0,34,34
1656266345486,MATH 193A,A04,083782,Rotar; Vladimir,6,0,34,28
1656266345486,MATH 193A,A05,093482,Rotar; Vladimir,0,0,34,34
1656266351512,MATH 197,001,091859,McAuley; Julian John,9999,0,9999,0
1656266351512,MATH 197,002,095566,Kedlaya; Kiran S.,9997,0,9999,2
1656266351512,MATH 197,003,095567,Xiao; Ming,9999,0,9999,0
1656266351512,MATH 197,004,095571,Perols; Johan Lars,9998,0,9999,1
1656266358564,COGS 9,A01,083615,Shannon; Kyle Michael,4,0,75,71
1656266364585,COGS 11,A01,083617,Boyle; Mary E. T.,14,0,48,34
1656266370620,COGS 13,A01,083071,Bastos; Amalia Pinkusfeld,5,0,71,66
1656266376643,COGS 14A,A01,092681,Semenuks; Arturs,1,12,100,99
1656266382669,COGS 14B,A01,083073,Cheng; Tzu-Han,7,0,63,56
1656266388692,COGS 17,A01,092677,Semenuks; Arturs,8,0,81,73
1656266394725,COGS 100,A01,083619,Allen; Michael Gordon,2,0,70,68
1656266400753,COGS 101A,A01,083621,Davis; Joshua Daniel,4,0,68,64
1656266406782,COGS 101B,A01,091572,Allen; Michael Gordon,4,0,65,61
1656266412805,COGS 101C,A01,083625,Delgado; Tania,10,0,35,25
1656266418853,COGS 107A,A01,083627,Boyle; Mary E. T.,0,0,60,60
1656266424875,COGS 118A,A01,083075,Gupta; Anjum,8,0,76,68
1656266430908,CSE 3,A50,083646,Miranda; Gregory Joseph,18,0,50,32
1656266436936,CSE 8A,A50,083650,Miranda; Gregory Joseph,2,2,56,54
1656266442959,CSE 11,A01,083080,Cao; Yingjun,0,49,40,40
1656266448983,CSE 12,A01,083652,Krause-Levy; Sophia Louisa,5,1,120,115
1656266455006,CSE 15L,A01,083654,Morris; Justin Loren,2,0,50,48
1656266455006,CSE 15L,A02,083655,Morris; Justin Loren,4,0,50,46
1656266461034,CSE 20,A01,083657,Tran; Khoa Dang,30,0,80,50
1656266467063,CSE 21,A01,095574,Bach; Quang Tran,23,0,48,25
1656266473090,CSE 30,A01,083084,Eldon; John,2,6,80,78
1656266473090,CSE 30,B01,095061,Bhaskar; Nishant,0,1,50,50
1656266479147,CSE 100,A01,083659,Cao; Yingjun,1,18,70,69
1656266485177,CSE 134B,A01,083661,Powell; Thomas Allan,5,0,100,95
1656266491202,CSE 140,A01,083663,Gungor; Onat,9,0,85,76
1656266497230,CSE 140L,A01,083088,Eldon; John,8,0,100,92
1656266503273,CSE 175,A01,083665,Kumar; Rakesh,0,0,25,25
1656266509296,CSE 190,A00,092507,Dubnov; Shlomo,3,0,20,17
1656266515330,ECE 45,A01,083139,Congero; Spencer William,1,0,75,74
1656266521376,ECE 65,A50,083695,Saad; Andrew S,9,0,30,21
1656266521376,ECE 65,A51,095125,Staff,24,0,26,2
1656266527400,ECE 109,A01,091882,Touri; Behrouz,0,1,70,70
1656266533424,ECE 180,A00,083140,Abi Samra; Nicholas Camill,1,0,30,29
1656266533424,ECE 180,B00,083141,Abi Samra; Nicholas Camill,0,4,30,30
1656266539459,MATH 10A,A01,083735,Patchell; Gregory David,0,0,30,30
1656266539459,MATH 10A,A02,083736,Patchell; Gregory David,22,0,30,8
1656266539459,MATH 10A,A03,083737,Patchell; Gregory David,16,0,30,14
1656266545486,MATH 10B,A01,083207,Lim; Seonhee,0,0,34,34
1656266545486,MATH 10B,A02,083208,Lim; Seonhee,7,0,35,28
1656266545486,MATH 10B,A03,093472,Staff,1,0,34,33
1656266545486,MATH 10B,B01,083739,Sinha; Shubham,11,0,30,19
1656266551508,MATH 18,A01,083743,Cinel; Cameron Alexander,7,0,30,23
1656266551508,MATH 18,A02,083744,Cinel; Cameron Alexander,9,0,30,21
1656266551508,MATH 18,A03,083745,Cinel; Cameron Alexander,5,0,30,25
1656266551508,MATH 18,B01,083748,Rideout; David Porter,1,0,36,35
1656266551508,MATH 18,B02,083749,Rideout; David Porter,0,0,36,36
1656266551508,MATH 18,B03,083750,Rideout; David Porter,0,0,36,36
1656266551508,MATH 18,B04,083751,Rideout; David Porter,0,1,36,36
1656266551508,MATH 18,B05,093473,Rideout; David Porter,0,0,36,36
1656266551508,MATH 18,B06,093474,Rideout; David Porter,3,0,36,33
1656266557530,MATH 20A,A01,083754,Zheng; Zequn,11,0,40,29
1656266563552,MATH 20B,A01,083756,Briones; Jor-el Thomas Caparas,0,0,36,36
1656266563552,MATH 20B,A02,083757,Briones; Jor-el Thomas Caparas,0,0,36,36
1656266563552,MATH 20B,A03,093475,Staff,0,0,36,36
1656266569577,MATH 20C,A01,083760,Briones; Jor-el Thomas Caparas,0,0,35,35
1656266569577,MATH 20C,A02,083761,Briones; Jor-el Thomas Caparas,9,1,35,26
1656266569577,MATH 20C,A03,093476,Staff,0,0,35,35
1656266569577,MATH 20C,B01,083762,Bach; Quang Tran,1,0,30,29
1656266575624,MATH 20D,A01,083765,Tran; Brian Kha,1,0,30,29
1656266575624,MATH 20D,A02,083766,Tran; Brian Kha,0,1,30,30
1656266575624,MATH 20D,A03,083767,Tran; Brian Kha,2,0,30,28
1656266581673,MATH 20E,A01,083771,Ganguly; Soumya,3,0,32,29
1656266581673,MATH 20E,A02,083772,Ganguly; Soumya,0,0,32,32
1656266581673,MATH 20E,B01,083773,Ciotti; Benjamin,16,0,35,19
1656266581673,MATH 20E,B02,083774,Ciotti; Benjamin,15,0,35,20
1656266587698,MATH 103A,A01,083777,Greenfeld; Be'Eri,1,0,36,35
1656266587698,MATH 103A,A02,083778,Greenfeld; Be'Eri,1,0,36,35
1656266587698,MATH 103A,A03,093561,Staff,5,0,36,31
1656266587698,MATH 103A,B01,083779,Greenfeld; Be'Eri,8,0,36,28
1656266587698,MATH 103A,B02,083780,Greenfeld; Be'Eri,1,0,36,35
1656266587698,MATH 103A,B03,093562,Staff,0,0,36,36
1656266593733,MATH 105,A01,085443,Carter; Anne Toulson,5,0,35,30
1656266593733,MATH 105,A02,093477,Staff,14,0,35,21
1656266599764,MATH 109,A01,083213,Ganzberger; Geoffrey Michael,0,0,34,34
1656266599764,MATH 109,A02,083214,Ganzberger; Geoffrey Michael,0,0,34,34
1656266599764,MATH 109,A03,093478,Staff,1,0,34,33
1656266599764,MATH 109,B01,083215,Ganzberger; Geoffrey Michael,4,0,32,28
1656266599764,MATH 109,B02,083216,Ganzberger; Geoffrey Michael,1,0,32,31
1656266599764,MATH 109,B03,093479,Staff,3,0,32,29
1656266605793,MATH 142A,A01,083219,Chow; Bennett,2,0,32,30
1656266605793,MATH 142A,A02,083220,Chow; Bennett,8,0,32,24
1656266605793,MATH 142A,A03,093480,Staff,5,0,32,27
1656266605793,MATH 142A,B03,093481,Staff,3,0,32,29
1656266605793,MATH 142A,B04,093558,Staff,6,0,32,26
1656266605793,MATH 142A,B05,093559,Staff,0,0,32,32
1656266611890,MATH 193A,A01,083224,Rotar; Vladimir,0,1,34,34
1656266611890,MATH 193A,A02,083225,Rotar; Vladimir,0,0,34,34
1656266611890,MATH 193A,A03,083781,Rotar; Vladimir,0,0,34,34
1656266611890,MATH 193A,A04,083782,Rotar; Vladimir,6,0,34,28
1656266611890,MATH 193A,A05,093482,Rotar; Vladimir,0,0,34,34
1656266617913,MATH 197,001,091859,McAuley; Julian John,9999,0,9999,0
1656266617913,MATH 197,002,095566,Kedlaya; Kiran S.,9997,0,9999,2
1656266617913,MATH 197,003,095567,Xiao; Ming,9999,0,9999,0
1656266617913,MATH 197,004,095571,Perols; Johan Lars,9998,0,9999,1
1656266624964,COGS 9,A01,083615,Shannon; Kyle Michael,4,0,75,71
1656266630991,COGS 11,A01,083617,Boyle; Mary E. T.,14,0,48,34
1656266637014,COGS 13,A01,083071,Bastos; Amalia Pinkusfeld,5,0,71,66
1656266643038,COGS 14A,A01,092681,Semenuks; Arturs,1,12,100,99
1656266649073,COGS 14B,A01,083073,Cheng; Tzu-Han,7,0,63,56
1656266655101,COGS 17,A01,092677,Semenuks; Arturs,8,0,81,73
1656266661124,COGS 100,A01,083619,Allen; Michael Gordon,2,0,70,68
1656266667148,COGS 101A,A01,083621,Davis; Joshua Daniel,4,0,68,64
1656266673171,COGS 101B,A01,091572,Allen; Michael Gordon,4,0,65,61
1656266679198,COGS 101C,A01,083625,Delgado; Tania,10,0,35,25
1656266685232,COGS 107A,A01,083627,Boyle; Mary E. T.,0,0,60,60
1656266691255,COGS 118A,A01,083075,Gupta; Anjum,8,0,76,68
1656266697279,CSE 3,A50,083646,Miranda; Gregory Joseph,18,0,50,32
1656266703311,CSE 8A,A50,083650,Miranda; Gregory Joseph,2,2,56,54
1656266709337,CSE 11,A01,083080,Cao; Yingjun,0,49,40,40
1656266715365,CSE 12,A01,083652,Krause-Levy; Sophia Louisa,5,1,120,115
1656266721388,CSE 15L,A01,083654,Morris; Justin Loren,2,0,50,48
1656266721388,CSE 15L,A02,083655,Morris; Justin Loren,4,0,50,46
1656266727412,CSE 20,A01,083657,Tran; Khoa Dang,30,0,80,50
1656266733438,CSE 21,A01,095574,Bach; Quang Tran,23,0,48,25
1656266739464,CSE 30,A01,083084,Eldon; John,2,6,80,78
1656266739464,CSE 30,B01,095061,Bhaskar; Nishant,0,1,50,50
1656266745487,CSE 100,A01,083659,Cao; Yingjun,1,18,70,69
1656266751511,CSE 134B,A01,083661,Powell; Thomas Allan,5,0,100,95
1656266757538,CSE 140,A01,083663,Gungor; Onat,9,0,85,76
1656266763561,CSE 140L,A01,083088,Eldon; John,8,0,100,92
1656266769598,CSE 175,A01,083665,Kumar; Rakesh,0,0,25,25
1656266775623,CSE 190,A00,092507,Dubnov; Shlomo,3,0,20,17
1656266781647,ECE 45,A01,083139,Congero; Spencer William,1,0,75,74
1656266787701,ECE 65,A50,083695,Saad; Andrew S,9,0,30,21
1656266787701,ECE 65,A51,095125,Staff,24,0,26,2
1656266793727,ECE 109,A01,091882,Touri; Behrouz,0,1,70,70
1656266799761,ECE 180,A00,083140,Abi Samra; Nicholas Camill,1,0,30,29
1656266799761,ECE 180,B00,083141,Abi Samra; Nicholas Camill,0,4,30,30
1656266805788,MATH 10A,A01,083735,Patchell; Gregory David,0,0,30,30
1656266805788,MATH 10A,A02,083736,Patchell; Gregory David,22,0,30,8
1656266805788,MATH 10A,A03,083737,Patchell; Gregory David,16,0,30,14
1656266811813,MATH 10B,A01,083207,Lim; Seonhee,0,0,34,34
1656266811813,MATH 10B,A02,083208,Lim; Seonhee,7,0,35,28
1656266811813,MATH 10B,A03,093472,Staff,1,0,34,33
1656266811813,MATH 10B,B01,083739,Sinha; Shubham,11,0,30,19
1656266817837,MATH 18,A01,083743,Cinel; Cameron Alexander,7,0,30,23
1656266817837,MATH 18,A02,083744,Cinel; Cameron Alexander,9,0,30,21
1656266817837,MATH 18,A03,083745,Cinel; Cameron Alexander,5,0,30,25
1656266817837,MATH 18,B01,083748,Rideout; David Porter,1,0,36,35
1656266817837,MATH 18,B02,083749,Rideout; David Porter,0,0,36,36
1656266817837,MATH 18,B03,083750,Rideout; David Porter,0,0,36,36
1656266817837,MATH 18,B04,083751,Rideout; David Porter,0,1,36,36
1656266817837,MATH 18,B05,093473,Rideout; David Porter,0,0,36,36
1656266817837,MATH 18,B06,093474,Rideout; David Porter,3,0,36,33
1656266823860,MATH 20A,A01,083754,Zheng; Zequn,11,0,40,29
1656266829900,MATH 20B,A01,083756,Briones; Jor-el Thomas Caparas,0,0,36,36
1656266829900,MATH 20B,A02,083757,Briones; Jor-el Thomas Caparas,0,0,36,36
1656266829900,MATH 20B,A03,093475,Staff,0,0,36,36
1656266835924,MATH 20C,A01,083760,Briones; Jor-el Thomas Caparas,0,0,35,35
1656266835924,MATH 20C,A02,083761,Briones; Jor-el Thomas Caparas,9,1,35,26
1656266835924,MATH 20C,A03,093476,Staff,0,0,35,35
1656266835924,MATH 20C,B01,083762,Bach; Quang Tran,1,0,30,29
1656266841953,MATH 20D,A01,083765,Tran; Brian Kha,1,0,30,29
1656266841953,MATH 20D,A02,083766,Tran; Brian Kha,0,1,30,30
1656266841953,MATH 20D,A03,083767,Tran; Brian Kha,2,0,30,28
1656266847986,MATH 20E,A01,083771,Ganguly; Soumya,3,0,32,29
1656266847986,MATH 20E,A02,083772,Ganguly; Soumya,0,0,32,32
1656266847986,MATH 20E,B01,083773,Ciotti; Benjamin,16,0,35,19
1656266847986,MATH 20E,B02,083774,Ciotti; Benjamin,15,0,35,20
1656266854010,MATH 103A,A01,083777,Greenfeld; Be'Eri,1,0,36,35
1656266854010,MATH 103A,A02,083778,Greenfeld; Be'Eri,1,0,36,35
1656266854010,MATH 103A,A03,093561,Staff,5,0,36,31
1656266854010,MATH 103A,B01,083779,Greenfeld; Be'Eri,8,0,36,28
1656266854010,MATH 103A,B02,083780,Greenfeld; Be'Eri,1,0,36,35
1656266854010,MATH 103A,B03,093562,Staff,0,0,36,36
1656266860033,MATH 105,A01,085443,Carter; Anne Toulson,5,0,35,30
1656266860033,MATH 105,A02,093477,Staff,14,0,35,21
1656266866059,MATH 109,A01,083213,Ganzberger; Geoffrey Michael,0,0,34,34
1656266866059,MATH 109,A02,083214,Ganzberger; Geoffrey Michael,0,0,34,34
1656266866059,MATH 109,A03,093478,Staff,1,0,34,33
1656266866059,MATH 109,B01,083215,Ganzberger; Geoffrey Michael,4,0,32,28
1656266866059,MATH 109,B02,083216,Ganzberger; Geoffrey Michael,1,0,32,31
1656266866059,MATH 109,B03,093479,Staff,3,0,32,29
1656266872084,MATH 142A,A01,083219,Chow; Bennett,2,0,32,30
1656266872084,MATH 142A,A02,083220,Chow; Bennett,8,0,32,24
1656266872084,MATH 142A,A03,093480,Staff,5,0,32,27
1656266872084,MATH 142A,B03,093481,Staff,3,0,32,29
1656266872084,MATH 142A,B04,093558,Staff,6,0,32,26
1656266872084,MATH 142A,B05,093559,Staff,0,0,32,32
1656266878109,MATH 193A,A01,083224,Rotar; Vladimir,0,1,34,34
1656266878109,MATH 193A,A02,083225,Rotar; Vladimir,0,0,34,34
1656266878109,MATH 193A,A03,083781,Rotar; Vladimir,0,0,34,34
1656266878109,MATH 193A,A04,083782,Rotar; Vladimir,6,0,34,28
1656266878109,MATH 193A,A05,093482,Rotar; Vladimir,0,0,34,34
1656266884132,MATH 197,001,091859,McAuley; Julian John,9999,0,9999,0
1656266884132,MATH 197,002,095566,Kedlaya; Kiran S.,9997,0,9999,2
1656266884132,MATH 197,003,095567,Xiao; Ming,9999,0,9999,0
1656266884132,MATH 197,004,095571,Perols; Johan Lars,9998,0,9999,1
1656266891209,COGS 9,A01,083615,Shannon; Kyle Michael,4,0,75,71
1656266897235,COGS 11,A01,083617,Boyle; Mary E. T.,14,0,48,34
1656266903258,COGS 13,A01,083071,Bastos; Amalia Pinkusfeld,5,0,71,66
1656266909286,COGS 14A,A01,092681,Semenuks; Arturs,1,12,100,99
1656266915310,COGS 14B,A01,083073,Cheng; Tzu-Han,7,0,63,56
1656266921357,COGS 17,A01,092677,Semenuks; Arturs,8,0,81,73
1656266927384,COGS 100,A01,083619,Allen; Michael Gordon,2,0,70,68
1656266933415,COGS 101A,A01,083621,Davis; Joshua Daniel,4,0,68,64
1656266939442,COGS 101B,A01,091572,Allen; Michael Gordon,4,0,65,61
1656266945478,COGS 101C,A01,083625,Delgado; Tania,10,0,35,25
1656266951501,COGS 107A,A01,083627,Boyle; Mary E. T.,0,0,60,60
1656266957527,COGS 118A,A01,083075,Gupta; Anjum,8,0,76,68
1656266963555,CSE 3,A50,083646,Miranda; Gregory Joseph,18,0,50,32
1656266969579,CSE 8A,A50,083650,Miranda; Gregory Joseph,2,2,56,54
1656266975605,CSE 11,A01,083080,Cao; Yingjun,0,49,40,40
1656266981630,CSE 12,A01,083652,Krause-Levy; Sophia Louisa,5,1,120,115
1656266987660,CSE 15L,A01,083654,Morris; Justin Loren,2,0,50,48
1656266987660,CSE 15L,A02,083655,Morris; Justin Loren,4,0,50,46
1656266993684,CSE 20,A01,083657,Tran; Khoa Dang,30,0,80,50
1656266999716,CSE 21,A01,095574,Bach; Quang Tran,23,0,48,25
1656267005739,CSE 30,A01,083084,Eldon; John,2,6,80,78
1656267005739,CSE 30,B01,095061,Bhaskar; Nishant,0,1,50,50
1656267011774,CSE 100,A01,083659,Cao; Yingjun,1,18,70,69
1656267017800,CSE 134B,A01,083661,Powell; Thomas Allan,5,0,100,95
1656267023831,CSE 140,A01,083663,Gungor; Onat,9,0,85,76
1656267029854,CSE 140L,A01,083088,Eldon; John,8,0,100,92
1656267035878,CSE 175,A01,083665,Kumar; Rakesh,0,0,25,25
1656267041916,CSE 190,A00,092507,Dubnov; Shlomo,3,0,20,17
1656267047939,ECE 45,A01,083139,Congero; Spencer William,1,0,75,74
1656267053967,ECE 65,A50,083695,Saad; Andrew S,9,0,30,21
1656267053967,ECE 65,A51,095125,Staff,24,0,26,2
1656267059995,ECE 109,A01,091882,Touri; Behrouz,0,1,70,70
1656267066022,ECE 180,A00,083140,Abi Samra; Nicholas Camill,1,0,30,29
1656267066022,ECE 180,B00,083141,Abi Samra; Nicholas Camill,0,4,30,30
1656267072049,MATH 10A,A01,083735,Patchell; Gregory David,0,0,30,30
1656267072049,MATH 10A,A02,083736,Patchell; Gregory David,22,0,30,8
1656267072049,MATH 10A,A03,083737,Patchell; Gregory David,16,0,30,14
1656267078078,MATH 10B,A01,083207,Lim; Seonhee,0,0,34,34
1656267078078,MATH 10B,A02,083208,Lim; Seonhee,7,0,35,28
1656267078078,MATH 10B,A03,093472,Staff,1,0,34,33
1656267078078,MATH 10B,B01,083739,Sinha; Shubham,11,0,30,19
1656267084102,MATH 18,A01,083743,Cinel; Cameron Alexander,7,0,30,23
1656267084102,MATH 18,A02,083744,Cinel; Cameron Alexander,9,0,30,21
1656267084102,MATH 18,A03,083745,Cinel; Cameron Alexander,5,0,30,25
1656267084102,MATH 18,B01,083748,Rideout; David Porter,1,0,36,35
1656267084102,MATH 18,B02,083749,Rideout; David Porter,0,0,36,36
1656267084102,MATH 18,B03,083750,Rideout; David Porter,0,0,36,36
1656267084102,MATH 18,B04,083751,Rideout; David Porter,0,1,36,36
1656267084102,MATH 18,B05,093473,Rideout; David Porter,0,0,36,36
1656267084102,MATH 18,B06,093474,Rideout; David Porter,3,0,36,33
1656267090128,MATH 20A,A01,083754,Zheng; Zequn,11,0,40,29
1656267096153,MATH 20B,A01,083756,Briones; Jor-el Thomas Caparas,0,0,36,36
1656267096153,MATH 20B,A02,083757,Briones; Jor-el Thomas Caparas,0,0,36,36
1656267096153,MATH 20B,A03,093475,Staff,0,0,36,36
1656267102177,MATH 20C,A01,083760,Briones; Jor-el Thomas Caparas,0,0,35,35
1656267102177,MATH 20C,A02,083761,Briones; Jor-el Thomas Caparas,9,1,35,26
1656267102177,MATH 20C,A03,093476,Staff,0,0,35,35
1656267102177,MATH 20C,B01,083762,Bach; Quang Tran,1,0,30,29
1656267108201,MATH 20D,A01,083765,Tran; Brian Kha,1,0,30,29
1656267108201,MATH 20D,A02,083766,Tran; Brian Kha,0,1,30,30
1656267108201,MATH 20D,A03,083767,Tran; Brian Kha,2,0,30,28
1656267114224,MATH 20E,A01,083771,Ganguly; Soumya,3,0,32,29
1656267114224,MATH 20E,A02,083772,Ganguly; Soumya,0,0,32,32
1656267114224,MATH 20E,B01,083773,Ciotti; Benjamin,16,0,35,19
1656267114224,MATH 20E,B02,083774,Ciotti; Benjamin,15,0,35,20
1656267120248,MATH 103A,A01,083777,Greenfeld; Be'Eri,1,0,36,35
1656267120248,MATH 103A,A02,083778,Greenfeld; Be'Eri,1,0,36,35
1656267120248,MATH 103A,A03,093561,Staff,5,0,36,31
1656267120248,MATH 103A,B01,083779,Greenfeld; Be'Eri,8,0,36,28
1656267120248,MATH 103A,B02,083780,Greenfeld; Be'Eri,1,0,36,35
1656267120248,MATH 103A,B03,093562,Staff,0,0,36,36
1656267126277,MATH 105,A01,085443,Carter; Anne Toulson,5,0,35,30
1656267126277,MATH 105,A02,093477,Staff,14,0,35,21
1656267132301,MATH 109,A01,083213,Ganzberger; Geoffrey Michael,0,0,34,34
1656267132301,MATH 109,A02,083214,Ganzberger; Geoffrey Michael,0,0,34,34
1656267132301,MATH 109,A03,093478,Staff,1,0,34,33
1656267132301,MATH 109,B01,083215,Ganzberger; Geoffrey Michael,4,0,32,28
1656267132301,MATH 109,B02,083216,Ganzberger; Geoffrey Michael,1,0,32,31
1656267132301,MATH 109,B03,093479,Staff,3,0,32,29
1656267138325,MATH 142A,A01,083219,Chow; Bennett,2,0,32,30
1656267138325,MATH 142A,A02,083220,Chow; Bennett,8,0,32,24
1656267138325,MATH 142A,A03,093480,Staff,5,0,32,27
1656267138325,MATH 142A,B03,093481,Staff,3,0,32,29
1656267138325,MATH 142A,B04,093558,Staff,6,0,32,26
1656267138325,MATH 142A,B05,093559,Staff,0,0,32,32
1656267144353,MATH 193A,A01,083224,Rotar; Vladimir,0,1,34,34
1656267144353,MATH 193A,A02,083225,Rotar; Vladimir,0,0,34,34
1656267144353,MATH 193A,A03,083781,Rotar; Vladimir,0,0,34,34
1656267144353,MATH 193A,A04,083782,Rotar; Vladimir,6,0,34,28
1656267144353,MATH 193A,A05,093482,Rotar; Vladimir,0,0,34,34
1656267150376,MATH 197,001,091859,McAuley; Julian John,9999,0,9999,0
1656267150376,MATH 197,002,095566,Kedlaya; Kiran S.,9997,0,9999,2
1656267150376,MATH 197,003,095567,Xiao; Ming,9999,0,9999,0
1656267150376,MATH 197,004,095571,Perols; Johan Lars,9998,0,9999,1
1656267157440,COGS 9,A01,083615,Shannon; Kyle Michael,4,0,75,71
1656267163467,COGS 11,A01,083617,Boyle; Mary E. T.,14,0,48,34
1656267169489,COGS 13,A01,083071,Bastos; Amalia Pinkusfeld,5,0,71,66
1656267175527,COGS 14A,A01,092681,Semenuks; Arturs,1,12,100,99
1656267181550,COGS 14B,A01,083073,Cheng; Tzu-Han,7,0,63,56
1656267187571,COGS 17,A01,092677,Semenuks; Arturs,8,0,81,73
1656267193593,COGS 100,A01,083619,Allen; Michael Gordon,2,0,70,68
1656267199616,COGS 101A,A01,083621,Davis; Joshua Daniel,4,0,68,64
1656267205739,COGS 101B,A01,091572,Allen; Michael Gordon,4,0,65,61
1656267211793,COGS 101C,A01,083625,Delgado; Tania,10,0,35,25
1656267217817,COGS 107A,A01,083627,Boyle; Mary E. T.,0,0,60,60
1656267223839,COGS 118A,A01,083075,Gupta; Anjum,8,0,76,68
1656267229876,CSE 3,A50,083646,Miranda; Gregory Joseph,18,0,50,32
1656267235898,CSE 8A,A50,083650,Miranda; Gregory Joseph,2,2,56,54
1656267241924,CSE 11,A01,083080,Cao; Yingjun,0,49,40,40
1656267247951,CSE 12,A01,083652,Krause-Levy; Sophia Louisa,5,1,120,115
1656267253977,CSE 15L,A01,083654,Morris; Justin Loren,2,0,50,48
1656267253977,CSE 15L,A02,083655,Morris; Justin Loren,4,0,50,46
1656267260000,CSE 20,A01,083657,Tran; Khoa Dang,30,0,80,50
1656267266027,CSE 21,A01,095574,Bach; Quang Tran,23,0,48,25
1656267272060,CSE 30,A01,083084,Eldon; John,2,6,80,78
1656267272060,CSE 30,B01,095061,Bhaskar; Nishant,0,1,50,50
1656267278089,CSE 100,A01,083659,Cao; Yingjun,1,18,70,69
1656267284121,CSE 134B,A01,083661,Powell; Thomas Allan,5,0,100,95
1656267290145,CSE 140,A01,083663,Gungor; Onat,9,0,85,76
1656267296172,CSE 140L,A01,083088,Eldon; John,8,0,100,92
1656267302201,CSE 175,A01,083665,Kumar; Rakesh,0,0,25,25
1656267308225,CSE 190,A00,092507,Dubnov; Shlomo,3,0,20,17
1656267314253,ECE 45,A01,083139,Congero; Spencer William,1,0,75,74
1656267320279,ECE 65,A50,083695,Saad; Andrew S,9,0,30,21
1656267320279,ECE 65,A51,095125,Staff,24,0,26,2
1656267326303,ECE 109,A01,091882,Touri; Behrouz,0,1,70,70
1656267332325,ECE 180,A00,083140,Abi Samra; Nicholas Camill,1,0,30,29
1656267332325,ECE 180,B00,083141,Abi Samra; Nicholas Camill,0,4,30,30
1656267338353,MATH 10A,A01,083735,Patchell; Gregory David,0,0,30,30
1656267338353,MATH 10A,A02,083736,Patchell; Gregory David,22,0,30,8
1656267338353,MATH 10A,A03,083737,Patchell; Gregory David,16,0,30,14
1656267344379,MATH 10B,A01,083207,Lim; Seonhee,0,0,34,34
1656267344379,MATH 10B,A02,083208,Lim; Seonhee,7,0,35,28
1656267344379,MATH 10B,A03,093472,Staff,1,0,34,33
1656267344379,MATH 10B,B01,083739,Sinha; Shubham,11,0,30,19
1656267350411,MATH 18,A01,083743,Cinel; Cameron Alexander,7,0,30,23
1656267350411,MATH 18,A02,083744,Cinel; Cameron Alexander,9,0,30,21
1656267350411,MATH 18,A03,083745,Cinel; Cameron Alexander,5,0,30,25
1656267350411,MATH 18,B01,083748,Rideout; David Porter,1,0,36,35
1656267350411,MATH 18,B02,083749,Rideout; David Porter,0,0,36,36
1656267350411,MATH 18,B03,083750,Rideout; David Porter,0,0,36,36
1656267350411,MATH 18,B04,083751,Rideout; David Porter,0,1,36,36
1656267350411,MATH 18,B05,093473,Rideout; David Porter,0,0,36,36
1656267350411,MATH 18,B06,093474,Rideout; David Porter,3,0,36,33
1656267356433,MATH 20A,A01,083754,Zheng; Zequn,11,0,40,29
1656267362459,MATH 20B,A01,083756,Briones; Jor-el Thomas Caparas,0,0,36,36
1656267362459,MATH 20B,A02,083757,Briones; Jor-el Thomas Caparas,0,0,36,36
1656267362459,MATH 20B,A03,093475,Staff,0,0,36,36
1656267368493,MATH 20C,A01,083760,Briones; Jor-el Thomas Caparas,0,0,35,35
1656267368493,MATH 20C,A02,083761,Briones; Jor-el Thomas Caparas,9,1,35,26
1656267368493,MATH 20C,A03,093476,Staff,0,0,35,35
1656267368493,MATH 20C,B01,083762,Bach; Quang Tran,1,0,30,29
1656267374523,MATH 20D,A01,083765,Tran; Brian Kha,1,0,30,29
1656267374523,MATH 20D,A02,083766,Tran; Brian Kha,0,1,30,30
1656267374523,MATH 20D,A03,083767,Tran; Brian Kha,2,0,30,28
1656267380552,MATH 20E,A01,083771,Ganguly; Soumya,3,0,32,29
1656267380552,MATH 20E,A02,083772,Ganguly; Soumya,0,0,32,32
1656267380552,MATH 20E,B01,083773,Ciotti; Benjamin,16,0,35,19
1656267380552,MATH 20E,B02,083774,Ciotti; Benjamin,15,0,35,20
1656267386579,MATH 103A,A01,083777,Greenfeld; Be'Eri,1,0,36,35
1656267386579,MATH 103A,A02,083778,Greenfeld; Be'Eri,1,0,36,35
1656267386579,MATH 103A,A03,093561,Staff,5,0,36,31
1656267386579,MATH 103A,B01,083779,Greenfeld; Be'Eri,8,0,36,28
1656267386579,MATH 103A,B02,083780,Greenfeld; Be'Eri,1,0,36,35
1656267386579,MATH 103A,B03,093562,Staff,0,0,36,36
1656267392604,MATH 105,A01,085443,Carter; Anne Toulson,5,0,35,30
1656267392604,MATH 105,A02,093477,Staff,14,0,35,21
1656267398632,MATH 109,A01,083213,Ganzberger; Geoffrey Michael,0,0,34,34
1656267398632,MATH 109,A02,083214,Ganzberger; Geoffrey Michael,0,0,34,34
1656267398632,MATH 109,A03,093478,Staff,1,0,34,33
1656267398632,MATH 109,B01,083215,Ganzberger; Geoffrey Michael,4,0,32,28
1656267398632,MATH 109,B02,083216,Ganzberger; Geoffrey Michael,1,0,32,31
1656267398632,MATH 109,B03,093479,Staff,3,0,32,29
1656267404661,MATH 142A,A01,083219,Chow; Bennett,2,0,32,30
1656267404661,MATH 142A,A02,083220,Chow; Bennett,8,0,32,24
1656267404661,MATH 142A,A03,093480,Staff,5,0,32,27
1656267404661,MATH 142A,B03,093481,Staff,3,0,32,29
1656267404661,MATH 142A,B04,093558,Staff,6,0,32,26
1656267404661,MATH 142A,B05,093559,Staff,0,0,32,32
1656267410686,MATH 193A,A01,083224,Rotar; Vladimir,0,1,34,34
1656267410686,MATH 193A,A02,083225,Rotar; Vladimir,0,0,34,34
1656267410686,MATH 193A,A03,083781,Rotar; Vladimir,0,0,34,34
1656267410686,MATH 193A,A04,083782,Rotar; Vladimir,6,0,34,28
1656267410686,MATH 193A,A05,093482,Rotar; Vladimir,0,0,34,34
1656267416712,MATH 197,001,091859,McAuley; Julian John,9999,0,9999,0
1656267416712,MATH 197,002,095566,Kedlaya; Kiran S.,9997,0,9999,2
1656267416712,MATH 197,003,095567,Xiao; Ming,9999,0,9999,0
1656267416712,MATH 197,004,095571,Perols; Johan Lars,9998,0,9999,1
1656267423788,COGS 9,A01,083615,Shannon; Kyle Michael,4,0,75,71
1656267429815,COGS 11,A01,083617,Boyle; Mary E. T.,14,0,48,34
1656267435842,COGS 13,A01,083071,Bastos; Amalia Pinkusfeld,5,0,71,66
1656267441868,COGS 14A,A01,092681,Semenuks; Arturs,1,12,100,99
1656267447890,COGS 14B,A01,083073,Cheng; Tzu-Han,7,0,63,56
1656267453913,COGS 17,A01,092677,Semenuks; Arturs,8,0,81,73
1656267459936,COGS 100,A01,083619,Allen; Michael Gordon,2,0,70,68
1656267465961,COGS 101A,A01,083621,Davis; Joshua Daniel,4,0,68,64
1656267471984,COGS 101B,A01,091572,Allen; Michael Gordon,4,0,65,61
1656267478016,COGS 101C,A01,083625,Delgado; Tania,10,0,35,25
1656267484050,COGS 107A,A01,083627,Boyle; Mary E. T.,0,0,60,60
1656267490075,COGS 118A,A01,083075,Gupta; Anjum,8,0,76,68
1656267496103,CSE 3,A50,083646,Miranda; Gregory Joseph,18,0,50,32
1656267502130,CSE 8A,A50,083650,Miranda; Gregory Joseph,2,2,56,54
1656267508152,CSE 11,A01,083080,Cao; Yingjun,0,49,40,40
1656267514180,CSE 12,A01,083652,Krause-Levy; Sophia Louisa,5,1,120,115
1656267520208,CSE 15L,A01,083654,Morris; Justin Loren,2,0,50,48
1656267520208,CSE 15L,A02,083655,Morris; Justin Loren,4,0,50,46
1656267526231,CSE 20,A01,083657,Tran; Khoa Dang,30,0,80,50
1656267532264,CSE 21,A01,095574,Bach; Quang Tran,23,0,48,25
1656267538289,CSE 30,A01,083084,Eldon; John,2,6,80,78
1656267538289,CSE 30,B01,095061,Bhaskar; Nishant,0,1,50,50
1656267544312,CSE 100,A01,083659,Cao; Yingjun,1,18,70,69
1656267550343,CSE 134B,A01,083661,Powell; Thomas Allan,5,0,100,95
1656267556372,CSE 140,A01,083663,Gungor; Onat,9,0,85,76
1656267562394,CSE 140L,A01,083088,Eldon; John,8,0,100,92
1656267568418,CSE 175,A01,083665,Kumar; Rakesh,0,0,25,25
1656267574447,CSE 190,A00,092507,Dubnov; Shlomo,3,0,20,17
1656267580472,ECE 45,A01,083139,Congero; Spencer William,1,0,75,74
1656267586498,ECE 65,A50,083695,Saad; Andrew S,9,0,30,21
1656267586498,ECE 65,A51,095125,Staff,24,0,26,2
1656267592524,ECE 109,A01,091882,Touri; Behrouz,0,1,70,70
1656267598551,ECE 180,A00,083140,Abi Samra; Nicholas Camill,1,0,30,29
1656267598551,ECE 180,B00,083141,Abi Samra; Nicholas Camill,0,4,30,30
1656267604579,MATH 10A,A01,083735,Patchell; Gregory David,0,0,30,30
1656267604579,MATH 10A,A02,083736,Patchell; Gregory David,22,0,30,8
1656267604579,MATH 10A,A03,083737,Patchell; Gregory David,16,0,30,14
1656267610602,MATH 10B,A01,083207,Lim; Seonhee,0,0,34,34
1656267610602,MATH 10B,A02,083208,Lim; Seonhee,7,0,35,28
1656267610602,MATH 10B,A03,093472,Staff,1,0,34,33
1656267610602,MATH 10B,B01,083739,Sinha; Shubham,11,0,30,19
1656267616626,MATH 18,A01,083743,Cinel; Cameron Alexander,7,0,30,23
1656267616626,MATH 18,A02,083744,Cinel; Cameron Alexander,9,0,30,21
1656267616626,MATH 18,A03,083745,Cinel; Cameron Alexander,5,0,30,25
1656267616626,MATH 18,B01,083748,Rideout; David Porter,1,0,36,35
1656267616626,MATH 18,B02,083749,Rideout; David Porter,0,0,36,36
1656267616626,MATH 18,B03,083750,Rideout; David Porter,0,0,36,36
1656267616626,MATH 18,B04,083751,Rideout; David Porter,0,1,36,36
1656267616626,MATH 18,B05,093473,Rideout; David Porter,0,0,36,36
1656267616626,MATH 18,B06,093474,Rideout; David Porter,3,0,36,33
1656267622651,MATH 20A,A01,083754,Zheng; Zequn,11,0,40,29
1656267628678,MATH 20B,A01,083756,Briones; Jor-el Thomas Caparas,0,0,36,36
1656267628678,MATH 20B,A02,083757,Briones; Jor-el Thomas Caparas,0,0,36,36
1656267628678,MATH 20B,A03,093475,Staff,0,0,36,36
1656267634702,MATH 20C,A01,083760,Briones; Jor-el Thomas Caparas,0,0,35,35
1656267634702,MATH 20C,A02,083761,Briones; Jor-el Thomas Caparas,9,1,35,26
1656267634702,MATH 20C,A03,093476,Staff,0,0,35,35
1656267634702,MATH 20C,B01,083762,Bach; Quang Tran,1,0,30,29
1656267640728,MATH 20D,A01,083765,Tran; Brian Kha,1,0,30,29
1656267640728,MATH 20D,A02,083766,Tran; Brian Kha,0,1,30,30
1656267640728,MATH 20D,A03,083767,Tran; Brian Kha,2,0,30,28
1656267646757,MATH 20E,A01,083771,Ganguly; Soumya,3,0,32,29
1656267646757,MATH 20E,A02,083772,Ganguly; Soumya,0,0,32,32
1656267646757,MATH 20E,B01,083773,Ciotti; Benjamin,16,0,35,19
1656267646757,MATH 20E,B02,083774,Ciotti; Benjamin,15,0,35,20
1656267652780,MATH 103A,A01,083777,Greenfeld; Be'Eri,1,0,36,35
1656267652780,MATH 103A,A02,083778,Greenfeld; Be'Eri,1,0,36,35
1656267652780,MATH 103A,A03,093561,Staff,5,0,36,31
1656267652780,MATH 103A,B01,083779,Greenfeld; Be'Eri,8,0,36,28
1656267652780,MATH 103A,B02,083780,Greenfeld; Be'Eri,1,0,36,35
1656267652780,MATH 103A,B03,093562,Staff,0,0,36,36
1656267658804,MATH 105,A01,085443,Carter; Anne Toulson,5,0,35,30
1656267658804,MATH 105,A02,093477,Staff,14,0,35,21
1656267664829,MATH 109,A01,083213,Ganzberger; Geoffrey Michael,0,0,34,34
1656267664829,MATH 109,A02,083214,Ganzberger; Geoffrey Michael,0,0,34,34
1656267664829,MATH 109,A03,093478,Staff,1,0,34,33
1656267664829,MATH 109,B01,083215,Ganzberger; Geoffrey Michael,4,0,32,28
1656267664829,MATH 109,B02,083216,Ganzberger; Geoffrey Michael,1,0,32,31
1656267664829,MATH 109,B03,093479,Staff,3,0,32,29
1656267670854,MATH 142A,A01,083219,Chow; Bennett,2,0,32,30
1656267670854,MATH 142A,A02,083220,Chow; Bennett,8,0,32,24
1656267670854,MATH 142A,A03,093480,Staff,5,0,32,27
1656267670854,MATH 142A,B03,093481,Staff,3,0,32,29
1656267670854,MATH 142A,B04,093558,Staff,6,0,32,26
1656267670854,MATH 142A,B05,093559,Staff,0,0,32,32
1656267676883,MATH 193A,A01,083224,Rotar; Vladimir,0,1,34,34
1656267676883,MATH 193A,A02,083225,Rotar; Vladimir,0,0,34,34
1656267676883,MATH 193A,A03,083781,Rotar; Vladimir,0,0,34,34
1656267676883,MATH 193A,A04,083782,Rotar; Vladimir,6,0,34,28
1656267676883,MATH 193A,A05,093482,Rotar; Vladimir,0,0,34,34
1656267682909,MATH 197,001,091859,McAuley; Julian John,9999,0,9999,0
1656267682909,MATH 197,002,095566,Kedlaya; Kiran S.,9997,0,9999,2
1656267682909,MATH 197,003,095567,Xiao; Ming,9999,0,9999,0
1656267682909,MATH 197,004,095571,Perols; Johan Lars,9998,0,9999,1
1656267689969,COGS 9,A01,083615,Shannon; Kyle Michael,4,0,75,71
1656267695993,COGS 11,A01,083617,Boyle; Mary E. T.,14,0,48,34
1656267702019,COGS 13,A01,083071,Bastos; Amalia Pinkusfeld,5,0,71,66
1656267708047,COGS 14A,A01,092681,Semenuks; Arturs,1,12,100,99
1656267714071,COGS 14B,A01,083073,Cheng; Tzu-Han,7,0,63,56
1656267720096,COGS 17,A01,092677,Semenuks; Arturs,8,0,81,73
1656267726120,COGS 100,A01,083619,Allen; Michael Gordon,2,0,70,68
1656267732143,COGS 101A,A01,083621,Davis; Joshua Daniel,4,0,68,64
1656267738166,COGS 101B,A01,091572,Allen; Michael Gordon,4,0,65,61
1656267744202,COGS 101C,A01,083625,Delgado; Tania,10,0,35,25
1656267750230,COGS 107A,A01,083627,Boyle; Mary E. T.,0,0,60,60
1656267756257,COGS 118A,A01,083075,Gupta; Anjum,8,0,76,68
1656267762283,CSE 3,A50,083646,Miranda; Gregory Joseph,18,0,50,32
1656267768306,CSE 8A,A50,083650,Miranda; Gregory Joseph,2,2,56,54
1656267774329,CSE 11,A01,083080,Cao; Yingjun,0,49,40,40
1656267780357,CSE 12,A01,083652,Krause-Levy; Sophia Louisa,5,1,120,115
1656267786385,CSE 15L,A01,083654,Morris; Justin Loren,2,0,50,48
1656267786385,CSE 15L,A02,083655,Morris; Justin Loren,4,0,50,46
1656267792409,CSE 20,A01,083657,Tran; Khoa Dang,30,0,80,50
1656267798440,CSE 21,A01,095574,Bach; Quang Tran,23,0,48,25
1656267804544,CSE 30,A01,083084,Eldon; John,2,6,80,78
1656267804544,CSE 30,B01,095061,Bhaskar; Nishant,0,1,50,50
1656267810571,CSE 100,A01,083659,Cao; Yingjun,1,18,70,69
1656267816595,CSE 134B,A01,083661,Powell; Thomas Allan,5,0,100,95
1656267822618,CSE 140,A01,083663,Gungor; Onat,9,0,85,76
1656267828652,CSE 140L,A01,083088,Eldon; John,8,0,100,92
1656267834675,CSE 175,A01,083665,Kumar; Rakesh,0,0,25,25
1656267840703,CSE 190,A00,092507,Dubnov; Shlomo,3,0,20,17
1656267846728,ECE 45,A01,083139,Congero; Spencer William,1,0,75,74
1656267852750,ECE 65,A50,083695,Saad; Andrew S,9,0,30,21
1656267852750,ECE 65,A51,095125,Staff,24,0,26,2
1656267858773,ECE 109,A01,091882,Touri; Behrouz,0,1,70,70
1656267864825,ECE 180,A00,083140,Abi Samra; Nicholas Camill,1,0,30,29
1656267864825,ECE 180,B00,083141,Abi Samra; Nicholas Camill,0,4,30,30
1656267870852,MATH 10A,A01,083735,Patchell; Gregory David,0,0,30,30
1656267870852,MATH 10A,A02,083736,Patchell; Gregory David,22,0,30,8
1656267870852,MATH 10A,A03,083737,Patchell; Gregory David,16,0,30,14
1656267876877,MATH 10B,A01,083207,Lim; Seonhee,0,0,34,34
1656267876877,MATH 10B,A02,083208,Lim; Seonhee,7,0,35,28
1656267876877,MATH 10B,A03,093472,Staff,1,0,34,33
1656267876877,MATH 10B,B01,083739,Sinha; Shubham,11,0,30,19
1656267882902,MATH 18,A01,083743,Cinel; Cameron Alexander,7,0,30,23
1656267882902,MATH 18,A02,083744,Cinel; Cameron Alexander,9,0,30,21
1656267882902,MATH 18,A03,083745,Cinel; Cameron Alexander,5,0,30,25
1656267882902,MATH 18,B01,083748,Rideout; David Porter,1,0,36,35
1656267882902,MATH 18,B02,083749,Rideout; David Porter,0,0,36,36
1656267882902,MATH 18,B03,083750,Rideout; David Porter,0,0,36,36
1656267882902,MATH 18,B04,083751,Rideout; David Porter,0,1,36,36
1656267882902,MATH 18,B05,093473,Rideout; David Porter,0,0,36,36
1656267882902,MATH 18,B06,093474,Rideout; David Porter,3,0,36,33
1656267888927,MATH 20A,A01,083754,Zheng; Zequn,11,0,40,29
1656267894950,MATH 20B,A01,083756,Briones; Jor-el Thomas Caparas,0,0,36,36
1656267894950,MATH 20B,A02,083757,Briones; Jor-el Thomas Caparas,0,0,36,36
1656267894950,MATH 20B,A03,093475,Staff,0,0,36,36
1656267900981,MATH 20C,A01,083760,Briones; Jor-el Thomas Caparas,0,0,35,35
1656267900981,MATH 20C,A02,083761,Briones; Jor-el Thomas Caparas,9,1,35,26
1656267900981,MATH 20C,A03,093476,Staff,0,0,35,35
1656267900981,MATH 20C,B01,083762,Bach; Quang Tran,1,0,30,29
1656267907009,MATH 20D,A01,083765,Tran; Brian Kha,1,0,30,29
1656267907009,MATH 20D,A02,083766,Tran; Brian Kha,0,1,30,30
1656267907009,MATH 20D,A03,083767,Tran; Brian Kha,2,0,30,28
1656267913038,MATH 20E,A01,083771,Ganguly; Soumya,3,0,32,29
1656267913038,MATH 20E,A02,083772,Ganguly; Soumya,0,0,32,32
1656267913038,MATH 20E,B01,083773,Ciotti; Benjamin,16,0,35,19
1656267913038,MATH 20E,B02,083774,Ciotti; Benjamin,15,0,35,20
1656267919070,MATH 103A,A01,083777,Greenfeld; Be'Eri,1,0,36,35
1656267919070,MATH 103A,A02,083778,Greenfeld; Be'Eri,1,0,36,35
1656267919070,MATH 103A,A03,093561,Staff,5,0,36,31
1656267919070,MATH 103A,B01,083779,Greenfeld; Be'Eri,8,0,36,28
1656267919070,MATH 103A,B02,083780,Greenfeld; Be'Eri,1,0,36,35
1656267919070,MATH 103A,B03,093562,Staff,0,0,36,36
1656267925098,MATH 105,A01,085443,Carter; Anne Toulson,5,0,35,30
1656267925098,MATH 105,A02,093477,Staff,14,0,35,21
1656267931122,MATH 109,A01,083213,Ganzberger; Geoffrey Michael,0,0,34,34
1656267931122,MATH 109,A02,083214,Ganzberger; Geoffrey Michael,0,0,34,34
1656267931122,MATH 109,A03,093478,Staff,1,0,34,33
1656267931122,MATH 109,B01,083215,Ganzberger; Geoffrey Michael,4,0,32,28
1656267931122,MATH 109,B02,083216,Ganzberger; Geoffrey Michael,1,0,32,31
1656267931122,MATH 109,B03,093479,Staff,3,0,32,29
1656267937151,MATH 142A,A01,083219,Chow; Bennett,2,0,32,30
1656267937151,MATH 142A,A02,083220,Chow; Bennett,8,0,32,24
1656267937151,MATH 142A,A03,093480,Staff,5,0,32,27
1656267937151,MATH 142A,B03,093481,Staff,3,0,32,29
1656267937151,MATH 142A,B04,093558,Staff,6,0,32,26
1656267937151,MATH 142A,B05,093559,Staff,0,0,32,32
1656267943178,MATH 193A,A01,083224,Rotar; Vladimir,0,1,34,34
1656267943178,MATH 193A,A02,083225,Rotar; Vladimir,0,0,34,34
1656267943178,MATH 193A,A03,083781,Rotar; Vladimir,0,0,34,34
1656267943178,MATH 193A,A04,083782,Rotar; Vladimir,6,0,34,28
1656267943178,MATH 193A,A05,093482,Rotar; Vladimir,0,0,34,34
1656267949205,MATH 197,001,091859,McAuley; Julian John,9999,0,9999,0
1656267949205,MATH 197,002,095566,Kedlaya; Kiran S.,9997,0,9999,2
1656267949205,MATH 197,003,095567,Xiao; Ming,9999,0,9999,0
1656267949205,MATH 197,004,095571,Perols; Johan Lars,9998,0,9999,1
1656267956264,COGS 9,A01,083615,Shannon; Kyle Michael,4,0,75,71
1656267962289,COGS 11,A01,083617,Boyle; Mary E. T.,14,0,48,34
1656267968313,COGS 13,A01,083071,Bastos; Amalia Pinkusfeld,5,0,71,66
1656267974336,COGS 14A,A01,092681,Semenuks; Arturs,1,12,100,99
1656267980359,COGS 14B,A01,083073,Cheng; Tzu-Han,7,0,63,56
1656267986381,COGS 17,A01,092677,Semenuks; Arturs,8,0,81,73
1656267992405,COGS 100,A01,083619,Allen; Michael Gordon,2,0,70,68
1656267998428,COGS 101A,A01,083621,Davis; Joshua Daniel,4,0,68,64
1656268004451,COGS 101B,A01,091572,Allen; Michael Gordon,4,0,65,61
1656268010477,COGS 101C,A01,083625,Delgado; Tania,10,0,35,25
1656268016504,COGS 107A,A01,083627,Boyle; Mary E. T.,0,0,60,60
1656268022530,COGS 118A,A01,083075,Gupta; Anjum,8,0,76,68
1656268028555,CSE 3,A50,083646,Miranda; Gregory Joseph,18,0,50,32
1656268034581,CSE 8A,A50,083650,Miranda; Gregory Joseph,2,2,56,54
1656268040607,CSE 11,A01,083080,Cao; Yingjun,0,49,40,40
1656268046638,CSE 12,A01,083652,Krause-Levy; Sophia Louisa,5,1,120,115
1656268052668,CSE 15L,A01,083654,Morris; Justin Loren,2,0,50,48
1656268052668,CSE 15L,A02,083655,Morris; Justin Loren,4,0,50,46
1656268058694,CSE 20,A01,083657,Tran; Khoa Dang,30,0,80,50
1656268064717,CSE 21,A01,095574,Bach; Quang Tran,23,0,48,25
1656268070745,CSE 30,A01,083084,Eldon; John,2,6,80,78
1656268070745,CSE 30,B01,095061,Bhaskar; Nishant,0,1,50,50
1656268076771,CSE 100,A01,083659,Cao; Yingjun,1,18,70,69
1656268082795,CSE 134B,A01,083661,Powell; Thomas Allan,5,0,100,95
1656268088818,CSE 140,A01,083663,Gungor; Onat,9,0,85,76
1656268094841,CSE 140L,A01,083088,Eldon; John,8,0,100,92
1656268100864,CSE 175,A01,083665,Kumar; Rakesh,0,0,25,25
1656268106890,CSE 190,A00,092507,Dubnov; Shlomo,3,0,20,17
1656268112912,ECE 45,A01,083139,Congero; Spencer William,1,0,75,74
1656268118944,ECE 65,A50,083695,Saad; Andrew S,9,0,30,21
1656268118944,ECE 65,A51,095125,Staff,24,0,26,2
1656268124967,ECE 109,A01,091882,Touri; Behrouz,0,1,70,70
1656268131000,ECE 180,A00,083140,Abi Samra; Nicholas Camill,1,0,30,29
1656268131000,ECE 180,B00,083141,Abi Samra; Nicholas Camill,0,4,30,30
1656268137036,MATH 10A,A01,083735,Patchell; Gregory David,0,0,30,30
1656268137036,MATH 10A,A02,083736,Patchell; Gregory David,22,0,30,8
1656268137036,MATH 10A,A03,083737,Patchell; Gregory David,16,0,30,14
1656268143063,MATH 10B,A01,083207,Lim; Seonhee,0,0,34,34
1656268143063,MATH 10B,A02,083208,Lim; Seonhee,7,0,35,28
1656268143063,MATH 10B,A03,093472,Staff,1,0,34,33
1656268143063,MATH 10B,B01,083739,Sinha; Shubham,11,0,30,19
1656268149100,MATH 18,A01,083743,Cinel; Cameron Alexander,7,0,30,23
1656268149100,MATH 18,A02,083744,Cinel; Cameron Alexander,9,0,30,21
1656268149100,MATH 18,A03,083745,Cinel; Cameron Alexander,5,0,30,25
1656268149100,MATH 18,B01,083748,Rideout; David Porter,1,0,36,35
1656268149100,MATH 18,B02,083749,Rideout; David Porter,0,0,36,36
1656268149100,MATH 18,B03,083750,Rideout; David Porter,0,0,36,36
1656268149100,MATH 18,B04,083751,Rideout; David Porter,0,1,36,36
1656268149100,MATH 18,B05,093473,Rideout; David Porter,0,0,36,36
1656268149100,MATH 18,B06,093474,Rideout; David Porter,3,0,36,33
1656268155123,MATH 20A,A01,083754,Zheng; Zequn,11,0,40,29
1656268161150,MATH 20B,A01,083756,Briones; Jor-el Thomas Caparas,0,0,36,36
1656268161150,MATH 20B,A02,083757,Briones; Jor-el Thomas Caparas,0,0,36,36
1656268161150,MATH 20B,A03,093475,Staff,0,0,36,36
1656268167185,MATH 20C,A01,083760,Briones; Jor-el Thomas Caparas,0,0,35,35
1656268167185,MATH 20C,A02,083761,Briones; Jor-el Thomas Caparas,9,1,35,26
1656268167185,MATH 20C,A03,093476,Staff,0,0,35,35
1656268167185,MATH 20C,B01,083762,Bach; Quang Tran,1,0,30,29
1656268173208,MATH 20D,A01,083765,Tran; Brian Kha,1,0,30,29
1656268173208,MATH 20D,A02,083766,Tran; Brian Kha,0,1,30,30
1656268173208,MATH 20D,A03,083767,Tran; Brian Kha,2,0,30,28
1656268179230,MATH 20E,A01,083771,Ganguly; Soumya,3,0,32,29
1656268179230,MATH 20E,A02,083772,Ganguly; Soumya,0,0,32,32
1656268179230,MATH 20E,B01,083773,Ciotti; Benjamin,16,0,35,19
1656268179230,MATH 20E,B02,083774,Ciotti; Benjamin,15,0,35,20
1656268185259,MATH 103A,A01,083777,Greenfeld; Be'Eri,1,0,36,35
1656268185259,MATH 103A,A02,083778,Greenfeld; Be'Eri,1,0,36,35
1656268185259,MATH 103A,A03,093561,Staff,5,0,36,31
1656268185259,MATH 103A,B01,083779,Greenfeld; Be'Eri,8,0,36,28
1656268185259,MATH 103A,B02,083780,Greenfeld; Be'Eri,1,0,36,35
1656268185259,MATH 103A,B03,093562,Staff,0,0,36,36
1656268191282,MATH 105,A01,085443,Carter; Anne Toulson,5,0,35,30
1656268191282,MATH 105,A02,093477,Staff,14,0,35,21
1656268197313,MATH 109,A01,083213,Ganzberger; Geoffrey Michael,0,0,34,34
1656268197313,MATH 109,A02,083214,Ganzberger; Geoffrey Michael,0,0,34,34
1656268197313,MATH 109,A03,093478,Staff,1,0,34,33
1656268197313,MATH 109,B01,083215,Ganzberger; Geoffrey Michael,4,0,32,28
1656268197313,MATH 109,B02,083216,Ganzberger; Geoffrey Michael,1,0,32,31
1656268197313,MATH 109,B03,093479,Staff,3,0,32,29
1656268203337,MATH 142A,A01,083219,Chow; Bennett,2,0,32,30
1656268203337,MATH 142A,A02,083220,Chow; Bennett,8,0,32,24
1656268203337,MATH 142A,A03,093480,Staff,5,0,32,27
1656268203337,MATH 142A,B03,093481,Staff,3,0,32,29
1656268203337,MATH 142A,B04,093558,Staff,6,0,32,26
1656268203337,MATH 142A,B05,093559,Staff,0,0,32,32
1656268209372,MATH 193A,A01,083224,Rotar; Vladimir,0,1,34,34
1656268209372,MATH 193A,A02,083225,Rotar; Vladimir,0,0,34,34
1656268209372,MATH 193A,A03,083781,Rotar; Vladimir,0,0,34,34
1656268209372,MATH 193A,A04,083782,Rotar; Vladimir,6,0,34,28
1656268209372,MATH 193A,A05,093482,Rotar; Vladimir,0,0,34,34
1656268215395,MATH 197,001,091859,McAuley; Julian John,9999,0,9999,0
1656268215395,MATH 197,002,095566,Kedlaya; Kiran S.,9997,0,9999,2
1656268215395,MATH 197,003,095567,Xiao; Ming,9999,0,9999,0
1656268215395,MATH 197,004,095571,Perols; Johan Lars,9998,0,9999,1
1656268222457,COGS 9,A01,083615,Shannon; Kyle Michael,4,0,75,71
1656268228479,COGS 11,A01,083617,Boyle; Mary E. T.,14,0,48,34
1656268234502,COGS 13,A01,083071,Bastos; Amalia Pinkusfeld,5,0,71,66
1656268240528,COGS 14A,A01,092681,Semenuks; Arturs,1,12,100,99
1656268246553,COGS 14B,A01,083073,Cheng; Tzu-Han,7,0,63,56
1656268252575,COGS 17,A01,092677,Semenuks; Arturs,8,0,81,73
1656268258599,COGS 100,A01,083619,Allen; Michael Gordon,2,0,70,68
1656268264622,COGS 101A,A01,083621,Davis; Joshua Daniel,4,0,68,64
1656268270646,COGS 101B,A01,091572,Allen; Michael Gordon,4,0,65,61
1656268276673,COGS 101C,A01,083625,Delgado; Tania,10,0,35,25
1656268282699,COGS 107A,A01,083627,Boyle; Mary E. T.,0,0,60,60
1656268288734,COGS 118A,A01,083075,Gupta; Anjum,8,0,76,68
1656268294758,CSE 3,A50,083646,Miranda; Gregory Joseph,18,0,50,32
1656268300786,CSE 8A,A50,083650,Miranda; Gregory Joseph,2,2,56,54
1656268306821,CSE 11,A01,083080,Cao; Yingjun,0,49,40,40
1656268312846,CSE 12,A01,083652,Krause-Levy; Sophia Louisa,5,1,120,115
1656268318870,CSE 15L,A01,083654,Morris; Justin Loren,2,0,50,48
1656268318870,CSE 15L,A02,083655,Morris; Justin Loren,4,0,50,46
1656268324898,CSE 20,A01,083657,Tran; Khoa Dang,30,0,80,50
1656268330922,CSE 21,A01,095574,Bach; Quang Tran,23,0,48,25
1656268336949,CSE 30,A01,083084,Eldon; John,2,6,80,78
1656268336949,CSE 30,B01,095061,Bhaskar; Nishant,0,1,50,50
1656268342978,CSE 100,A01,083659,Cao; Yingjun,1,18,70,69
1656268349001,CSE 134B,A01,083661,Powell; Thomas Allan,5,0,100,95
1656268355029,CSE 140,A01,083663,Gungor; Onat,9,0,85,76
1656268361056,CSE 140L,A01,083088,Eldon; John,8,0,100,92
1656268367079,CSE 175,A01,083665,Kumar; Rakesh,0,0,25,25
1656268373103,CSE 190,A00,092507,Dubnov; Shlomo,3,0,20,17
1656268379129,ECE 45,A01,083139,Congero; Spencer William,1,0,75,74
1656268385157,ECE 65,A50,083695,Saad; Andrew S,9,0,30,21
1656268385157,ECE 65,A51,095125,Staff,24,0,26,2
1656268391181,ECE 109,A01,091882,Touri; Behrouz,0,1,70,70
1656268397205,ECE 180,A00,083140,Abi Samra; Nicholas Camill,1,0,30,29
1656268397205,ECE 180,B00,083141,Abi Samra; Nicholas Camill,0,4,30,30
1656268403311,MATH 10A,A01,083735,Patchell; Gregory David,0,0,30,30
1656268403311,MATH 10A,A02,083736,Patchell; Gregory David,22,0,30,8
1656268403311,MATH 10A,A03,083737,Patchell; Gregory David,16,0,30,14
1656268409334,MATH 10B,A01,083207,Lim; Seonhee,0,0,34,34
1656268409334,MATH 10B,A02,083208,Lim; Seonhee,7,0,35,28
1656268409334,MATH 10B,A03,093472,Staff,1,0,34,33
1656268409334,MATH 10B,B01,083739,Sinha; Shubham,11,0,30,19
1656268415359,MATH 18,A01,083743,Cinel; Cameron Alexander,7,0,30,23
1656268415359,MATH 18,A02,083744,Cinel; Cameron Alexander,9,0,30,21
1656268415359,MATH 18,A03,083745,Cinel; Cameron Alexander,5,0,30,25
1656268415359,MATH 18,B01,083748,Rideout; David Porter,1,0,36,35
1656268415359,MATH 18,B02,083749,Rideout; David Porter,0,0,36,36
1656268415359,MATH 18,B03,083750,Rideout; David Porter,0,0,36,36
1656268415359,MATH 18,B04,083751,Rideout; David Porter,0,1,36,36
1656268415359,MATH 18,B05,093473,Rideout; David Porter,0,0,36,36
1656268415359,MATH 18,B06,093474,Rideout; David Porter,3,0,36,33
1656268421385,MATH 20A,A01,083754,Zheng; Zequn,11,0,40,29
1656268427408,MATH 20B,A01,083756,Briones; Jor-el Thomas Caparas,0,0,36,36
1656268427408,MATH 20B,A02,083757,Briones; Jor-el Thomas Caparas,0,0,36,36
1656268427408,MATH 20B,A03,093475,Staff,0,0,36,36
1656268433438,MATH 20C,A01,083760,Briones; Jor-el Thomas Caparas,0,0,35,35
1656268433438,MATH 20C,A02,083761,Briones; Jor-el Thomas Caparas,9,1,35,26
1656268433438,MATH 20C,A03,093476,Staff,0,0,35,35
1656268433438,MATH 20C,B01,083762,Bach; Quang Tran,1,0,30,29
1656268439466,MATH 20D,A01,083765,Tran; Brian Kha,1,0,30,29
1656268439466,MATH 20D,A02,083766,Tran; Brian Kha,0,1,30,30
1656268439466,MATH 20D,A03,083767,Tran; Brian Kha,2,0,30,28
1656268445500,MATH 20E,A01,083771,Ganguly; Soumya,3,0,32,29
1656268445500,MATH 20E,A02,083772,Ganguly; Soumya,0,0,32,32
1656268445500,MATH 20E,B01,083773,Ciotti; Benjamin,16,0,35,19
1656268445500,MATH 20E,B02,083774,Ciotti; Benjamin,15,0,35,20
1656268451525,MATH 103A,A01,083777,Greenfeld; Be'Eri,1,0,36,35
1656268451525,MATH 103A,A02,083778,Greenfeld; Be'Eri,1,0,36,35
1656268451525,MATH 103A,A03,093561,Staff,5,0,36,31
1656268451525,MATH 103A,B01,083779,Greenfeld; Be'Eri,8,0,36,28
1656268451525,MATH 103A,B02,083780,Greenfeld; Be'Eri,1,0,36,35
1656268451525,MATH 103A,B03,093562,Staff,0,0,36,36
1656268457552,MATH 105,A01,085443,Carter; Anne Toulson,5,0,35,30
1656268457552,MATH 105,A02,093477,Staff,14,0,35,21
1656268463576,MATH 109,A01,083213,Ganzberger; Geoffrey Michael,0,0,34,34
1656268463576,MATH 109,A02,083214,Ganzberger; Geoffrey Michael,0,0,34,34
1656268463576,MATH 109,A03,093478,Staff,1,0,34,33
1656268463576,MATH 109,B01,083215,Ganzberger; Geoffrey Michael,4,0,32,28
1656268463576,MATH 109,B02,083216,Ganzberger; Geoffrey Michael,1,0,32,31
1656268463576,MATH 109,B03,093479,Staff,3,0,32,29
1656268469600,MATH 142A,A01,083219,Chow; Bennett,2,0,32,30
1656268469600,MATH 142A,A02,083220,Chow; Bennett,8,0,32,24
1656268469600,MATH 142A,A03,093480,Staff,5,0,32,27
1656268469600,MATH 142A,B03,093481,Staff,3,0,32,29
1656268469600,MATH 142A,B04,093558,Staff,6,0,32,26
1656268469600,MATH 142A,B05,093559,Staff,0,0,32,32
1656268475626,MATH 193A,A01,083224,Rotar; Vladimir,0,1,34,34
1656268475626,MATH 193A,A02,083225,Rotar; Vladimir,0,0,34,34
1656268475626,MATH 193A,A03,083781,Rotar; Vladimir,0,0,34,34
1656268475626,MATH 193A,A04,083782,Rotar; Vladimir,6,0,34,28
1656268475626,MATH 193A,A05,093482,Rotar; Vladimir,0,0,34,34
1656268481650,MATH 197,001,091859,McAuley; Julian John,9999,0,9999,0
1656268481650,MATH 197,002,095566,Kedlaya; Kiran S.,9997,0,9999,2
1656268481650,MATH 197,003,095567,Xiao; Ming,9999,0,9999,0
1656268481650,MATH 197,004,095571,Perols; Johan Lars,9998,0,9999,1
1656268488704,COGS 9,A01,083615,Shannon; Kyle Michael,4,0,75,71
1656268494727,COGS 11,A01,083617,Boyle; Mary E. T.,14,0,48,34
1656268500749,COGS 13,A01,083071,Bastos; Amalia Pinkusfeld,5,0,71,66
1656268506775,COGS 14A,A01,092681,Semenuks; Arturs,1,12,100,99
1656268512801,COGS 14B,A01,083073,Cheng; Tzu-Han,7,0,63,56
1656268518825,COGS 17,A01,092677,Semenuks; Arturs,8,0,81,73
1656268524847,COGS 100,A01,083619,Allen; Michael Gordon,2,0,70,68
1656268530874,COGS 101A,A01,083621,Davis; Joshua Daniel,4,0,68,64
1656268536900,COGS 101B,A01,091572,Allen; Michael Gordon,4,0,65,61
1656268542924,COGS 101C,A01,083625,Delgado; Tania,10,0,35,25
1656268548948,COGS 107A,A01,083627,Boyle; Mary E. T.,0,0,60,60
1656268554974,COGS 118A,A01,083075,Gupta; Anjum,8,0,76,68
1656268560996,CSE 3,A50,083646,Miranda; Gregory Joseph,18,0,50,32
1656268567019,CSE 8A,A50,083650,Miranda; Gregory Joseph,2,2,56,54
1656268573043,CSE 11,A01,083080,Cao; Yingjun,0,49,40,40
1656268579064,CSE 12,A01,083652,Krause-Levy; Sophia Louisa,5,1,120,115
1656268585091,CSE 15L,A01,083654,Morris; Justin Loren,2,0,50,48
1656268585091,CSE 15L,A02,083655,Morris; Justin Loren,4,0,50,46
1656268591118,CSE 20,A01,083657,Tran; Khoa Dang,30,0,80,50
1656268597145,CSE 21,A01,095574,Bach; Quang Tran,23,0,48,25
1656268603168,CSE 30,A01,083084,Eldon; John,2,6,80,78
1656268603168,CSE 30,B01,095061,Bhaskar; Nishant,0,1,50,50
1656268609192,CSE 100,A01,083659,Cao; Yingjun,1,18,70,69
1656268615216,CSE 134B,A01,083661,Powell; Thomas Allan,5,0,100,95
1656268621243,CSE 140,A01,083663,Gungor; Onat,9,0,85,76
1656268627266,CSE 140L,A01,083088,Eldon; John,8,0,100,92
1656268633289,CSE 175,A01,083665,Kumar; Rakesh,0,0,25,25
1656268639311,CSE 190,A00,092507,Dubnov; Shlomo,3,0,20,17
1656268645340,ECE 45,A01,083139,Congero; Spencer William,1,0,75,74
1656268651367,ECE 65,A50,083695,Saad; Andrew S,9,0,30,21
1656268651367,ECE 65,A51,095125,Staff,24,0,26,2
1656268657389,ECE 109,A01,091882,Touri; Behrouz,0,1,70,70
1656268663411,ECE 180,A00,083140,Abi Samra; Nicholas Camill,1,0,30,29
1656268663411,ECE 180,B00,083141,Abi Samra; Nicholas Camill,0,4,30,30
1656268669435,MATH 10A,A01,083735,Patchell; Gregory David,0,0,30,30
1656268669435,MATH 10A,A02,083736,Patchell; Gregory David,22,0,30,8
1656268669435,MATH 10A,A03,083737,Patchell; Gregory David,16,0,30,14
1656268675462,MATH 10B,A01,083207,Lim; Seonhee,0,0,34,34
1656268675462,MATH 10B,A02,083208,Lim; Seonhee,7,0,35,28
1656268675462,MATH 10B,A03,093472,Staff,1,0,34,33
1656268675462,MATH 10B,B01,083739,Sinha; Shubham,11,0,30,19
1656268681492,MATH 18,A01,083743,Cinel; Cameron Alexander,7,0,30,23
1656268681492,MATH 18,A02,083744,Cinel; Cameron Alexander,9,0,30,21
1656268681492,MATH 18,A03,083745,Cinel; Cameron Alexander,5,0,30,25
1656268681492,MATH 18,B01,083748,Rideout; David Porter,1,0,36,35
1656268681492,MATH 18,B02,083749,Rideout; David Porter,0,0,36,36
1656268681492,MATH 18,B03,083750,Rideout; David Porter,0,0,36,36
1656268681492,MATH 18,B04,083751,Rideout; David Porter,0,1,36,36
1656268681492,MATH 18,B05,093473,Rideout; David Porter,0,0,36,36
1656268681492,MATH 18,B06,093474,Rideout; David Porter,3,0,36,33
1656268687517,MATH 20A,A01,083754,Zheng; Zequn,11,0,40,29
1656268693539,MATH 20B,A01,083756,Briones; Jor-el Thomas Caparas,0,0,36,36
1656268693539,MATH 20B,A02,083757,Briones; Jor-el Thomas Caparas,0,0,36,36
1656268693539,MATH 20B,A03,093475,Staff,0,0,36,36
1656268699568,MATH 20C,A01,083760,Briones; Jor-el Thomas Caparas,0,0,35,35
1656268699568,MATH 20C,A02,083761,Briones; Jor-el Thomas Caparas,9,1,35,26
1656268699568,MATH 20C,A03,093476,Staff,0,0,35,35
1656268699568,MATH 20C,B01,083762,Bach; Quang Tran,1,0,30,29
1656268705597,MATH 20D,A01,083765,Tran; Brian Kha,1,0,30,29
1656268705597,MATH 20D,A02,083766,Tran; Brian Kha,0,1,30,30
1656268705597,MATH 20D,A03,083767,Tran; Brian Kha,2,0,30,28
1656268711620,MATH 20E,A01,083771,Ganguly; Soumya,3,0,32,29
1656268711620,MATH 20E,A02,083772,Ganguly; Soumya,0,0,32,32
1656268711620,MATH 20E,B01,083773,Ciotti; Benjamin,16,0,35,19
1656268711620,MATH 20E,B02,083774,Ciotti; Benjamin,15,0,35,20
1656268717643,MATH 103A,A01,083777,Greenfeld; Be'Eri,1,0,36,35
1656268717643,MATH 103A,A02,083778,Greenfeld; Be'Eri,1,0,36,35
1656268717643,MATH 103A,A03,093561,Staff,5,0,36,31
1656268717643,MATH 103A,B01,083779,Greenfeld; Be'Eri,8,0,36,28
1656268717643,MATH 103A,B02,083780,Greenfeld; Be'Eri,1,0,36,35
1656268717643,MATH 103A,B03,093562,Staff,0,0,36,36
1656268723666,MATH 105,A01,085443,Carter; Anne Toulson,5,0,35,30
1656268723666,MATH 105,A02,093477,Staff,14,0,35,21
1656268729690,MATH 109,A01,083213,Ganzberger; Geoffrey Michael,0,0,34,34
1656268729690,MATH 109,A02,083214,Ganzberger; Geoffrey Michael,0,0,34,34
1656268729690,MATH 109,A03,093478,Staff,1,0,34,33
1656268729690,MATH 109,B01,083215,Ganzberger; Geoffrey Michael,4,0,32,28
1656268729690,MATH 109,B02,083216,Ganzberger; Geoffrey Michael,1,0,32,31
1656268729690,MATH 109,B03,093479,Staff,3,0,32,29
1656268735714,MATH 142A,A01,083219,Chow; Bennett,2,0,32,30
1656268735714,MATH 142A,A02,083220,Chow; Bennett,8,0,32,24
1656268735714,MATH 142A,A03,093480,Staff,5,0,32,27
1656268735714,MATH 142A,B03,093481,Staff,3,0,32,29
1656268735714,MATH 142A,B04,093558,Staff,6,0,32,26
1656268735714,MATH 142A,B05,093559,Staff,0,0,32,32
1656268741739,MATH 193A,A01,083224,Rotar; Vladimir,0,1,34,34
1656268741739,MATH 193A,A02,083225,Rotar; Vladimir,0,0,34,34
1656268741739,MATH 193A,A03,083781,Rotar; Vladimir,0,0,34,34
1656268741739,MATH 193A,A04,083782,Rotar; Vladimir,6,0,34,28
1656268741739,MATH 193A,A05,093482,Rotar; Vladimir,0,0,34,34
1656268747762,MATH 197,001,091859,McAuley; Julian John,9999,0,9999,0
1656268747762,MATH 197,002,095566,Kedlaya; Kiran S.,9997,0,9999,2
1656268747762,MATH 197,003,095567,Xiao; Ming,9999,0,9999,0
1656268747762,MATH 197,004,095571,Perols; Johan Lars,9998,0,9999,1
1656268754821,COGS 9,A01,083615,Shannon; Kyle Michael,4,0,75,71
1656268760843,COGS 11,A01,083617,Boyle; Mary E. T.,14,0,48,34
1656268766869,COGS 13,A01,083071,Bastos; Amalia Pinkusfeld,5,0,71,66
1656268772892,COGS 14A,A01,092681,Semenuks; Arturs,1,12,100,99
1656268778915,COGS 14B,A01,083073,Cheng; Tzu-Han,7,0,63,56
1656268784949,COGS 17,A01,092677,Semenuks; Arturs,8,0,81,73
1656268790978,COGS 100,A01,083619,Allen; Michael Gordon,2,0,70,68
1656268797017,COGS 101A,A01,083621,Davis; Joshua Daniel,4,0,68,64
1656268803043,COGS 101B,A01,091572,Allen; Michael Gordon,4,0,65,61
1656268809080,COGS 101C,A01,083625,Delgado; Tania,10,0,35,25
1656268815103,COGS 107A,A01,083627,Boyle; Mary E. T.,0,0,60,60
1656268828437,COGS 118A,A01,083075,Gupta; Anjum,8,0,76,68
1656268834465,CSE 3,A50,083646,Miranda; Gregory Joseph,18,0,50,32
1656268840486,CSE 8A,A50,083650,Miranda; Gregory Joseph,2,2,56,54
1656268846509,CSE 11,A01,083080,Cao; Yingjun,0,49,40,40
1656268852535,CSE 12,A01,083652,Krause-Levy; Sophia Louisa,5,1,120,115
1656268858558,CSE 15L,A01,083654,Morris; Justin Loren,2,0,50,48
1656268858558,CSE 15L,A02,083655,Morris; Justin Loren,4,0,50,46
1656268864591,CSE 20,A01,083657,Tran; Khoa Dang,30,0,80,50
1656268870617,CSE 21,A01,095574,Bach; Quang Tran,23,0,48,25
1656268876640,CSE 30,A01,083084,Eldon; John,2,6,80,78
1656268876640,CSE 30,B01,095061,Bhaskar; Nishant,0,1,50,50
1656268882664,CSE 100,A01,083659,Cao; Yingjun,1,18,70,69
1656268888689,CSE 134B,A01,083661,Powell; Thomas Allan,5,0,100,95
1656268894714,CSE 140,A01,083663,Gungor; Onat,9,0,85,76
1656268900736,CSE 140L,A01,083088,Eldon; John,8,0,100,92
1656268906763,CSE 175,A01,083665,Kumar; Rakesh,0,0,25,25
1656268912786,CSE 190,A00,092507,Dubnov; Shlomo,3,0,20,17
1656268918813,ECE 45,A01,083139,Congero; Spencer William,1,0,75,74
1656268924839,ECE 65,A50,083695,Saad; Andrew S,9,0,30,21
1656268924839,ECE 65,A51,095125,Staff,24,0,26,2
1656268930871,ECE 109,A01,091882,Touri; Behrouz,0,1,70,70
1656268936894,ECE 180,A00,083140,Abi Samra; Nicholas Camill,1,0,30,29
1656268936894,ECE 180,B00,083141,Abi Samra; Nicholas Camill,0,4,30,30
1656268942916,MATH 10A,A01,083735,Patchell; Gregory David,0,0,30,30
1656268942916,MATH 10A,A02,083736,Patchell; Gregory David,22,0,30,8
1656268942916,MATH 10A,A03,083737,Patchell; Gregory David,16,0,30,14
1656268948938,MATH 10B,A01,083207,Lim; Seonhee,0,0,34,34
1656268948938,MATH 10B,A02,083208,Lim; Seonhee,7,0,35,28
1656268948938,MATH 10B,A03,093472,Staff,1,0,34,33
1656268948938,MATH 10B,B01,083739,Sinha; Shubham,11,0,30,19
1656268954961,MATH 18,A01,083743,Cinel; Cameron Alexander,7,0,30,23
1656268954961,MATH 18,A02,083744,Cinel; Cameron Alexander,9,0,30,21
1656268954961,MATH 18,A03,083745,Cinel; Cameron Alexander,5,0,30,25
1656268954961,MATH 18,B01,083748,Rideout; David Porter,1,0,36,35
1656268954961,MATH 18,B02,083749,Rideout; David Porter,0,0,36,36
1656268954961,MATH 18,B03,083750,Rideout; David Porter,0,0,36,36
1656268954961,MATH 18,B04,083751,Rideout; David Porter,0,1,36,36
1656268954961,MATH 18,B05,093473,Rideout; David Porter,0,0,36,36
1656268954961,MATH 18,B06,093474,Rideout; David Porter,3,0,36,33
1656268960985,MATH 20A,A01,083754,Zheng; Zequn,11,0,40,29
1656268967014,MATH 20B,A01,083756,Briones; Jor-el Thomas Caparas,0,0,36,36
1656268967014,MATH 20B,A02,083757,Briones; Jor-el Thomas Caparas,0,0,36,36
1656268967014,MATH 20B,A03,093475,Staff,0,0,36,36
1656268973038,MATH 20C,A01,083760,Briones; Jor-el Thomas Caparas,0,0,35,35
1656268973038,MATH 20C,A02,083761,Briones; Jor-el Thomas Caparas,9,1,35,26
1656268973038,MATH 20C,A03,093476,Staff,0,0,35,35
1656268973038,MATH 20C,B01,083762,Bach; Quang Tran,1,0,30,29
1656268979066,MATH 20D,A01,083765,Tran; Brian Kha,1,0,30,29
1656268979066,MATH 20D,A02,083766,Tran; Brian Kha,0,1,30,30
1656268979066,MATH 20D,A03,083767,Tran; Brian Kha,2,0,30,28
1656268985090,MATH 20E,A01,083771,Ganguly; Soumya,3,0,32,29
1656268985090,MATH 20E,A02,083772,Ganguly; Soumya,0,0,32,32
1656268985090,MATH 20E,B01,083773,Ciotti; Benjamin,16,0,35,19
1656268985090,MATH 20E,B02,083774,Ciotti; Benjamin,15,0,35,20
1656268991119,MATH 103A,A01,083777,Greenfeld; Be'Eri,1,0,36,35
1656268991119,MATH 103A,A02,083778,Greenfeld; Be'Eri,1,0,36,35
1656268991119,MATH 103A,A03,093561,Staff,5,0,36,31
1656268991119,MATH 103A,B01,083779,Greenfeld; Be'Eri,8,0,36,28
1656268991119,MATH 103A,B02,083780,Greenfeld; Be'Eri,1,0,36,35
1656268991119,MATH 103A,B03,093562,Staff,0,0,36,36
1656268997145,MATH 105,A01,085443,Carter; Anne Toulson,5,0,35,30
1656268997145,MATH 105,A02,093477,Staff,14,0,35,21
1656269003168,MATH 109,A01,083213,Ganzberger; Geoffrey Michael,0,0,34,34
1656269003168,MATH 109,A02,083214,Ganzberger; Geoffrey Michael,0,0,34,34
1656269003168,MATH 109,A03,093478,Staff,1,0,34,33
1656269003168,MATH 109,B01,083215,Ganzberger; Geoffrey Michael,4,0,32,28
1656269003168,MATH 109,B02,083216,Ganzberger; Geoffrey Michael,1,0,32,31
1656269003168,MATH 109,B03,093479,Staff,3,0,32,29
1656269009273,MATH 142A,A01,083219,Chow; Bennett,2,0,32,30
1656269009273,MATH 142A,A02,083220,Chow; Bennett,8,0,32,24
1656269009273,MATH 142A,A03,093480,Staff,5,0,32,27
1656269009273,MATH 142A,B03,093481,Staff,3,0,32,29
1656269009273,MATH 142A,B04,093558,Staff,6,0,32,26
1656269009273,MATH 142A,B05,093559,Staff,0,0,32,32
1656269015310,MATH 193A,A01,083224,Rotar; Vladimir,0,1,34,34
1656269015310,MATH 193A,A02,083225,Rotar; Vladimir,0,0,34,34
1656269015310,MATH 193A,A03,083781,Rotar; Vladimir,0,0,34,34
1656269015310,MATH 193A,A04,083782,Rotar; Vladimir,6,0,34,28
1656269015310,MATH 193A,A05,093482,Rotar; Vladimir,0,0,34,34
1656269021337,MATH 197,001,091859,McAuley; Julian John,9999,0,9999,0
1656269021337,MATH 197,002,095566,Kedlaya; Kiran S.,9997,0,9999,2
1656269021337,MATH 197,003,095567,Xiao; Ming,9999,0,9999,0
1656269021337,MATH 197,004,095571,Perols; Johan Lars,9998,0,9999,1
1656269028399,COGS 9,A01,083615,Shannon; Kyle Michael,4,0,75,71
1656269034431,COGS 11,A01,083617,Boyle; Mary E. T.,14,0,48,34
1656269040456,COGS 13,A01,083071,Bastos; Amalia Pinkusfeld,5,0,71,66
1656269046484,COGS 14A,A01,092681,Semenuks; Arturs,1,12,100,99
1656269052507,COGS 14B,A01,083073,Cheng; Tzu-Han,7,0,63,56
1656269058531,COGS 17,A01,092677,Semenuks; Arturs,8,0,81,73
1656269064555,COGS 100,A01,083619,Allen; Michael Gordon,2,0,70,68
1656269070581,COGS 101A,A01,083621,Davis; Joshua Daniel,4,0,68,64
1656269076604,COGS 101B,A01,091572,Allen; Michael Gordon,4,0,65,61
1656269082631,COGS 101C,A01,083625,Delgado; Tania,10,0,35,25
1656269088658,COGS 107A,A01,083627,Boyle; Mary E. T.,0,0,60,60
1656269094683,COGS 118A,A01,083075,Gupta; Anjum,8,0,76,68
1656269100707,CSE 3,A50,083646,Miranda; Gregory Joseph,18,0,50,32
1656269106731,CSE 8A,A50,083650,Miranda; Gregory Joseph,2,2,56,54
1656269112757,CSE 11,A01,083080,Cao; Yingjun,0,49,40,40
1656269118785,CSE 12,A01,083652,Krause-Levy; Sophia Louisa,5,1,120,115
1656269124809,CSE 15L,A01,083654,Morris; Justin Loren,2,0,50,48
1656269124809,CSE 15L,A02,083655,Morris; Justin Loren,4,0,50,46
1656269130834,CSE 20,A01,083657,Tran; Khoa Dang,30,0,80,50
1656269136861,CSE 21,A01,095574,Bach; Quang Tran,23,0,48,25
1656269142884,CSE 30,A01,083084,Eldon; John,2,6,80,78
1656269142884,CSE 30,B01,095061,Bhaskar; Nishant,0,1,50,50
1656269148908,CSE 100,A01,083659,Cao; Yingjun,1,18,70,69
1656269154936,CSE 134B,A01,083661,Powell; Thomas Allan,5,0,100,95
1656269160960,CSE 140,A01,083663,Gungor; Onat,9,0,85,76
1656269166988,CSE 140L,A01,083088,Eldon; John,8,0,100,92
1656269173012,CSE 175,A01,083665,Kumar; Rakesh,0,0,25,25
1656269179038,CSE 190,A00,092507,Dubnov; Shlomo,3,0,20,17
1656269185063,ECE 45,A01,083139,Congero; Spencer William,1,0,75,74
1656269191088,ECE 65,A50,083695,Saad; Andrew S,9,0,30,21
1656269191088,ECE 65,A51,095125,Staff,24,0,26,2
1656269197112,ECE 109,A01,091882,Touri; Behrouz,0,1,70,70
1656269203147,ECE 180,A00,083140,Abi Samra; Nicholas Camill,1,0,30,29
1656269203147,ECE 180,B00,083141,Abi Samra; Nicholas Camill,0,4,30,30
1656269209175,MATH 10A,A01,083735,Patchell; Gregory David,0,0,30,30
1656269209175,MATH 10A,A02,083736,Patchell; Gregory David,22,0,30,8
1656269209175,MATH 10A,A03,083737,Patchell; Gregory David,16,0,30,14
1656269215204,MATH 10B,A01,083207,Lim; Seonhee,0,0,34,34
1656269215204,MATH 10B,A02,083208,Lim; Seonhee,7,0,35,28
1656269215204,MATH 10B,A03,093472,Staff,1,0,34,33
1656269215204,MATH 10B,B01,083739,Sinha; Shubham,11,0,30,19
1656269221235,MATH 18,A01,083743,Cinel; Cameron Alexander,7,0,30,23
1656269221235,MATH 18,A02,083744,Cinel; Cameron Alexander,9,0,30,21
1656269221235,MATH 18,A03,083745,Cinel; Cameron Alexander,5,0,30,25
1656269221235,MATH 18,B01,083748,Rideout; David Porter,1,0,36,35
1656269221235,MATH 18,B02,083749,Rideout; David Porter,0,0,36,36
1656269221235,MATH 18,B03,083750,Rideout; David Porter,0,0,36,36
1656269221235,MATH 18,B04,083751,Rideout; David Porter,0,1,36,36
1656269221235,MATH 18,B05,093473,Rideout; David Porter,0,0,36,36
1656269221235,MATH 18,B06,093474,Rideout; David Porter,3,0,36,33
1656269227264,MATH 20A,A01,083754,Zheng; Zequn,11,0,40,29
1656269233288,MATH 20B,A01,083756,Briones; Jor-el Thomas Caparas,0,0,36,36
1656269233288,MATH 20B,A02,083757,Briones; Jor-el Thomas Caparas,0,0,36,36
1656269233288,MATH 20B,A03,093475,Staff,0,0,36,36
1656269239315,MATH 20C,A01,083760,Briones; Jor-el Thomas Caparas,0,0,35,35
1656269239315,MATH 20C,A02,083761,Briones; Jor-el Thomas Caparas,9,1,35,26
1656269239315,MATH 20C,A03,093476,Staff,0,0,35,35
1656269239315,MATH 20C,B01,083762,Bach; Quang Tran,1,0,30,29
1656269245339,MATH 20D,A01,083765,Tran; Brian Kha,1,0,30,29
1656269245339,MATH 20D,A02,083766,Tran; Brian Kha,0,1,30,30
1656269245339,MATH 20D,A03,083767,Tran; Brian Kha,2,0,30,28
1656269251362,MATH 20E,A01,083771,Ganguly; Soumya,3,0,32,29
1656269251362,MATH 20E,A02,083772,Ganguly; Soumya,0,0,32,32
1656269251362,MATH 20E,B01,083773,Ciotti; Benjamin,16,0,35,19
1656269251362,MATH 20E,B02,083774,Ciotti; Benjamin,15,0,35,20
1656269257390,MATH 103A,A01,083777,Greenfeld; Be'Eri,1,0,36,35
1656269257390,MATH 103A,A02,083778,Greenfeld; Be'Eri,1,0,36,35
1656269257390,MATH 103A,A03,093561,Staff,5,0,36,31
1656269257390,MATH 103A,B01,083779,Greenfeld; Be'Eri,8,0,36,28
1656269257390,MATH 103A,B02,083780,Greenfeld; Be'Eri,1,0,36,35
1656269257390,MATH 103A,B03,093562,Staff,0,0,36,36
1656269263418,MATH 105,A01,085443,Carter; Anne Toulson,5,0,35,30
1656269263418,MATH 105,A02,093477,Staff,14,0,35,21
1656269269447,MATH 109,A01,083213,Ganzberger; Geoffrey Michael,0,0,34,34
1656269269447,MATH 109,A02,083214,Ganzberger; Geoffrey Michael,0,0,34,34
1656269269447,MATH 109,A03,093478,Staff,1,0,34,33
1656269269447,MATH 109,B01,083215,Ganzberger; Geoffrey Michael,4,0,32,28
1656269269447,MATH 109,B02,083216,Ganzberger; Geoffrey Michael,1,0,32,31
1656269269447,MATH 109,B03,093479,Staff,3,0,32,29
1656269275477,MATH 142A,A01,083219,Chow; Bennett,2,0,32,30
1656269275477,MATH 142A,A02,083220,Chow; Bennett,8,0,32,24
1656269275477,MATH 142A,A03,093480,Staff,5,0,32,27
1656269275477,MATH 142A,B03,093481,Staff,3,0,32,29
1656269275477,MATH 142A,B04,093558,Staff,6,0,32,26
1656269275477,MATH 142A,B05,093559,Staff,0,0,32,32
1656269281500,MATH 193A,A01,083224,Rotar; Vladimir,0,1,34,34
1656269281500,MATH 193A,A02,083225,Rotar; Vladimir,0,0,34,34
1656269281500,MATH 193A,A03,083781,Rotar; Vladimir,0,0,34,34
1656269281500,MATH 193A,A04,083782,Rotar; Vladimir,6,0,34,28
1656269281500,MATH 193A,A05,093482,Rotar; Vladimir,0,0,34,34
1656269287524,MATH 197,001,091859,McAuley; Julian John,9999,0,9999,0
1656269287524,MATH 197,002,095566,Kedlaya; Kiran S.,9997,0,9999,2
1656269287524,MATH 197,003,095567,Xiao; Ming,9999,0,9999,0
1656269287524,MATH 197,004,095571,Perols; Johan Lars,9998,0,9999,1
1656269294577,COGS 9,A01,083615,Shannon; Kyle Michael,4,0,75,71
1656269300601,COGS 11,A01,083617,Boyle; Mary E. T.,14,0,48,34
1656269306627,COGS 13,A01,083071,Bastos; Amalia Pinkusfeld,5,0,71,66
1656269312651,COGS 14A,A01,092681,Semenuks; Arturs,1,12,100,99
1656269318674,COGS 14B,A01,083073,Cheng; Tzu-Han,7,0,63,56
1656269324698,COGS 17,A01,092677,Semenuks; Arturs,8,0,81,73
1656269330721,COGS 100,A01,083619,Allen; Michael Gordon,2,0,70,68
1656269336745,COGS 101A,A01,083621,Davis; Joshua Daniel,4,0,68,64
1656269342767,COGS 101B,A01,091572,Allen; Michael Gordon,4,0,65,61
1656269348795,COGS 101C,A01,083625,Delgado; Tania,10,0,35,25
1656269354819,COGS 107A,A01,083627,Boyle; Mary E. T.,0,0,60,60
1656269360843,COGS 118A,A01,083075,Gupta; Anjum,8,0,76,68
1656269366872,CSE 3,A50,083646,Miranda; Gregory Joseph,18,0,50,32
1656269372898,CSE 8A,A50,083650,Miranda; Gregory Joseph,2,2,56,54
1656269378921,CSE 11,A01,083080,Cao; Yingjun,0,49,40,40
1656269384952,CSE 12,A01,083652,Krause-Levy; Sophia Louisa,5,1,120,115
1656269390975,CSE 15L,A01,083654,Morris; Justin Loren,2,0,50,48
1656269390975,CSE 15L,A02,083655,Morris; Justin Loren,4,0,50,46
1656269396999,CSE 20,A01,083657,Tran; Khoa Dang,30,0,80,50
1656269403035,CSE 21,A01,095574,Bach; Quang Tran,23,0,48,25
1656269409058,CSE 30,A01,083084,Eldon; John,2,6,80,78
1656269409058,CSE 30,B01,095061,Bhaskar; Nishant,0,1,50,50
1656269415082,CSE 100,A01,083659,Cao; Yingjun,1,18,70,69
1656269421108,CSE 134B,A01,083661,Powell; Thomas Allan,5,0,100,95
1656269427131,CSE 140,A01,083663,Gungor; Onat,9,0,85,76
1656269433161,CSE 140L,A01,083088,Eldon; John,8,0,100,92
1656269439184,CSE 175,A01,083665,Kumar; Rakesh,0,0,25,25
1656269445211,CSE 190,A00,092507,Dubnov; Shlomo,3,0,20,17
1656269451235,ECE 45,A01,083139,Congero; Spencer William,1,0,75,74
1656269457265,ECE 65,A50,083695,Saad; Andrew S,9,0,30,21
1656269457265,ECE 65,A51,095125,Staff,24,0,26,2
1656269463299,ECE 109,A01,091882,Touri; Behrouz,0,1,70,70
1656269469320,ECE 180,A00,083140,Abi Samra; Nicholas Camill,1,0,30,29
1656269469320,ECE 180,B00,083141,Abi Samra; Nicholas Camill,0,4,30,30
1656269475348,MATH 10A,A01,083735,Patchell; Gregory David,0,0,30,30
1656269475348,MATH 10A,A02,083736,Patchell; Gregory David,22,0,30,8
1656269475348,MATH 10A,A03,083737,Patchell; Gregory David,16,0,30,14
1656269481373,MATH 10B,A01,083207,Lim; Seonhee,0,0,34,34
1656269481373,MATH 10B,A02,083208,Lim; Seonhee,7,0,35,28
1656269481373,MATH 10B,A03,093472,Staff,1,0,34,33
1656269481373,MATH 10B,B01,083739,Sinha; Shubham,11,0,30,19
1656269487399,MATH 18,A01,083743,Cinel; Cameron Alexander,7,0,30,23
1656269487399,MATH 18,A02,083744,Cinel; Cameron Alexander,9,0,30,21
1656269487399,MATH 18,A03,083745,Cinel; Cameron Alexander,5,0,30,25
1656269487399,MATH 18,B01,083748,Rideout; David Porter,1,0,36,35
1656269487399,MATH 18,B02,083749,Rideout; David Porter,0,0,36,36
1656269487399,MATH 18,B03,083750,Rideout; David Porter,0,0,36,36
1656269487399,MATH 18,B04,083751,Rideout; David Porter,0,1,36,36
1656269487399,MATH 18,B05,093473,Rideout; David Porter,0,0,36,36
1656269487399,MATH 18,B06,093474,Rideout; David Porter,3,0,36,33
1656269493427,MATH 20A,A01,083754,Zheng; Zequn,11,0,40,29
1656269499451,MATH 20B,A01,083756,Briones; Jor-el Thomas Caparas,0,0,36,36
1656269499451,MATH 20B,A02,083757,Briones; Jor-el Thomas Caparas,0,0,36,36
1656269499451,MATH 20B,A03,093475,Staff,0,0,36,36
1656269505478,MATH 20C,A01,083760,Briones; Jor-el Thomas Caparas,0,0,35,35
1656269505478,MATH 20C,A02,083761,Briones; Jor-el Thomas Caparas,9,1,35,26
1656269505478,MATH 20C,A03,093476,Staff,0,0,35,35
1656269505478,MATH 20C,B01,083762,Bach; Quang Tran,1,0,30,29
1656269511503,MATH 20D,A01,083765,Tran; Brian Kha,1,0,30,29
1656269511503,MATH 20D,A02,083766,Tran; Brian Kha,0,1,30,30
1656269511503,MATH 20D,A03,083767,Tran; Brian Kha,2,0,30,28
1656269517528,MATH 20E,A01,083771,Ganguly; Soumya,3,0,32,29
1656269517528,MATH 20E,A02,083772,Ganguly; Soumya,0,0,32,32
1656269517528,MATH 20E,B01,083773,Ciotti; Benjamin,16,0,35,19
1656269517528,MATH 20E,B02,083774,Ciotti; Benjamin,15,0,35,20
1656269523561,MATH 103A,A01,083777,Greenfeld; Be'Eri,1,0,36,35
1656269523561,MATH 103A,A02,083778,Greenfeld; Be'Eri,1,0,36,35
1656269523561,MATH 103A,A03,093561,Staff,5,0,36,31
1656269523561,MATH 103A,B01,083779,Greenfeld; Be'Eri,8,0,36,28
1656269523561,MATH 103A,B02,083780,Greenfeld; Be'Eri,1,0,36,35
1656269523561,MATH 103A,B03,093562,Staff,0,0,36,36
1656269529585,MATH 105,A01,085443,Carter; Anne Toulson,5,0,35,30
1656269529585,MATH 105,A02,093477,Staff,14,0,35,21
1656269535610,MATH 109,A01,083213,Ganzberger; Geoffrey Michael,0,0,34,34
1656269535610,MATH 109,A02,083214,Ganzberger; Geoffrey Michael,0,0,34,34
1656269535610,MATH 109,A03,093478,Staff,1,0,34,33
1656269535610,MATH 109,B01,083215,Ganzberger; Geoffrey Michael,4,0,32,28
1656269535610,MATH 109,B02,083216,Ganzberger; Geoffrey Michael,1,0,32,31
1656269535610,MATH 109,B03,093479,Staff,3,0,32,29
1656269541632,MATH 142A,A01,083219,Chow; Bennett,2,0,32,30
1656269541632,MATH 142A,A02,083220,Chow; Bennett,8,0,32,24
1656269541632,MATH 142A,A03,093480,Staff,5,0,32,27
1656269541632,MATH 142A,B03,093481,Staff,3,0,32,29
1656269541632,MATH 142A,B04,093558,Staff,6,0,32,26
1656269541632,MATH 142A,B05,093559,Staff,0,0,32,32
1656269547655,MATH 193A,A01,083224,Rotar; Vladimir,0,1,34,34
1656269547655,MATH 193A,A02,083225,Rotar; Vladimir,0,0,34,34
1656269547655,MATH 193A,A03,083781,Rotar; Vladimir,0,0,34,34
1656269547655,MATH 193A,A04,083782,Rotar; Vladimir,6,0,34,28
1656269547655,MATH 193A,A05,093482,Rotar; Vladimir,0,0,34,34
1656269553682,MATH 197,001,091859,McAuley; Julian John,9999,0,9999,0
1656269553682,MATH 197,002,095566,Kedlaya; Kiran S.,9997,0,9999,2
1656269553682,MATH 197,003,095567,Xiao; Ming,9999,0,9999,0
1656269553682,MATH 197,004,095571,Perols; Johan Lars,9998,0,9999,1
1656269560732,COGS 9,A01,083615,Shannon; Kyle Michael,4,0,75,71
1656269566759,COGS 11,A01,083617,Boyle; Mary E. T.,14,0,48,34
1656269572784,COGS 13,A01,083071,Bastos; Amalia Pinkusfeld,5,0,71,66
1656269578808,COGS 14A,A01,092681,Semenuks; Arturs,1,12,100,99
1656269584830,COGS 14B,A01,083073,Cheng; Tzu-Han,7,0,63,56
1656269590853,COGS 17,A01,092677,Semenuks; Arturs,8,0,81,73
1656269596878,COGS 100,A01,083619,Allen; Michael Gordon,2,0,70,68
1656269602992,COGS 101A,A01,083621,Davis; Joshua Daniel,4,0,68,64
1656269609016,COGS 101B,A01,091572,Allen; Michael Gordon,4,0,65,61
1656269615039,COGS 101C,A01,083625,Delgado; Tania,10,0,35,25
1656269621063,COGS 107A,A01,083627,Boyle; Mary E. T.,0,0,60,60
1656269627087,COGS 118A,A01,083075,Gupta; Anjum,8,0,76,68
1656269633126,CSE 3,A50,083646,Miranda; Gregory Joseph,18,0,50,32
1656269639159,CSE 8A,A50,083650,Miranda; Gregory Joseph,2,2,56,54
1656269645181,CSE 11,A01,083080,Cao; Yingjun,0,49,40,40
1656269651218,CSE 12,A01,083652,Krause-Levy; Sophia Louisa,5,1,120,115
1656269657241,CSE 15L,A01,083654,Morris; Justin Loren,2,0,50,48
1656269657241,CSE 15L,A02,083655,Morris; Justin Loren,4,0,50,46
1656269663264,CSE 20,A01,083657,Tran; Khoa Dang,30,0,80,50
1656269669288,CSE 21,A01,095574,Bach; Quang Tran,23,0,48,25
1656269675313,CSE 30,A01,083084,Eldon; John,2,6,80,78
1656269675313,CSE 30,B01,095061,Bhaskar; Nishant,0,1,50,50
1656269681336,CSE 100,A01,083659,Cao; Yingjun,1,18,70,69
1656269687360,CSE 134B,A01,083661,Powell; Thomas Allan,5,0,100,95
1656269693386,CSE 140,A01,083663,Gungor; Onat,9,0,85,76
1656269699409,CSE 140L,A01,083088,Eldon; John,8,0,100,92
1656269705432,CSE 175,A01,083665,Kumar; Rakesh,0,0,25,25
1656269711460,CSE 190,A00,092507,Dubnov; Shlomo,3,0,20,17
1656269717487,ECE 45,A01,083139,Congero; Spencer William,1,0,75,74
1656269723512,ECE 65,A50,083695,Saad; Andrew S,9,0,30,21
1656269723512,ECE 65,A51,095125,Staff,24,0,26,2
1656269729542,ECE 109,A01,091882,Touri; Behrouz,0,1,70,70
1656269735568,ECE 180,A00,083140,Abi Samra; Nicholas Camill,1,0,30,29
1656269735568,ECE 180,B00,083141,Abi Samra; Nicholas Camill,0,4,30,30
1656269741592,MATH 10A,A01,083735,Patchell; Gregory David,0,0,30,30
1656269741592,MATH 10A,A02,083736,Patchell; Gregory David,22,0,30,8
1656269741592,MATH 10A,A03,083737,Patchell; Gregory David,16,0,30,14
1656269747615,MATH 10B,A01,083207,Lim; Seonhee,0,0,34,34
1656269747615,MATH 10B,A02,083208,Lim; Seonhee,7,0,35,28
1656269747615,MATH 10B,A03,093472,Staff,1,0,34,33
1656269747615,MATH 10B,B01,083739,Sinha; Shubham,11,0,30,19
1656269753641,MATH 18,A01,083743,Cinel; Cameron Alexander,7,0,30,23
1656269753641,MATH 18,A02,083744,Cinel; Cameron Alexander,9,0,30,21
1656269753641,MATH 18,A03,083745,Cinel; Cameron Alexander,5,0,30,25
1656269753641,MATH 18,B01,083748,Rideout; David Porter,1,0,36,35
1656269753641,MATH 18,B02,083749,Rideout; David Porter,0,0,36,36
1656269753641,MATH 18,B03,083750,Rideout; David Porter,0,0,36,36
1656269753641,MATH 18,B04,083751,Rideout; David Porter,0,1,36,36
1656269753641,MATH 18,B05,093473,Rideout; David Porter,0,0,36,36
1656269753641,MATH 18,B06,093474,Rideout; David Porter,3,0,36,33
1656269759664,MATH 20A,A01,083754,Zheng; Zequn,11,0,40,29
1656269765692,MATH 20B,A01,083756,Briones; Jor-el Thomas Caparas,0,0,36,36
1656269765692,MATH 20B,A02,083757,Briones; Jor-el Thomas Caparas,0,0,36,36
1656269765692,MATH 20B,A03,093475,Staff,0,0,36,36
1656269771716,MATH 20C,A01,083760,Briones; Jor-el Thomas Caparas,0,0,35,35
1656269771716,MATH 20C,A02,083761,Briones; Jor-el Thomas Caparas,9,1,35,26
1656269771716,MATH 20C,A03,093476,Staff,0,0,35,35
1656269771716,MATH 20C,B01,083762,Bach; Quang Tran,1,0,30,29
1656269777739,MATH 20D,A01,083765,Tran; Brian Kha,1,0,30,29
1656269777739,MATH 20D,A02,083766,Tran; Brian Kha,0,1,30,30
1656269777739,MATH 20D,A03,083767,Tran; Brian Kha,2,0,30,28
1656269783766,MATH 20E,A01,083771,Ganguly; Soumya,3,0,32,29
1656269783766,MATH 20E,A02,083772,Ganguly; Soumya,0,0,32,32
1656269783766,MATH 20E,B01,083773,Ciotti; Benjamin,16,0,35,19
1656269783766,MATH 20E,B02,083774,Ciotti; Benjamin,15,0,35,20
1656269789792,MATH 103A,A01,083777,Greenfeld; Be'Eri,1,0,36,35
1656269789792,MATH 103A,A02,083778,Greenfeld; Be'Eri,1,0,36,35
1656269789792,MATH 103A,A03,093561,Staff,5,0,36,31
1656269789792,MATH 103A,B01,083779,Greenfeld; Be'Eri,8,0,36,28
1656269789792,MATH 103A,B02,083780,Greenfeld; Be'Eri,1,0,36,35
1656269789792,MATH 103A,B03,093562,Staff,0,0,36,36
1656269795820,MATH 105,A01,085443,Carter; Anne Toulson,5,0,35,30
1656269795820,MATH 105,A02,093477,Staff,14,0,35,21
1656269801844,MATH 109,A01,083213,Ganzberger; Geoffrey Michael,0,0,34,34
1656269801844,MATH 109,A02,083214,Ganzberger; Geoffrey Michael,0,0,34,34
1656269801844,MATH 109,A03,093478,Staff,1,0,34,33
1656269801844,MATH 109,B01,083215,Ganzberger; Geoffrey Michael,4,0,32,28
1656269801844,MATH 109,B02,083216,Ganzberger; Geoffrey Michael,1,0,32,31
1656269801844,MATH 109,B03,093479,Staff,3,0,32,29
1656269807869,MATH 142A,A01,083219,Chow; Bennett,2,0,32,30
1656269807869,MATH 142A,A02,083220,Chow; Bennett,8,0,32,24
1656269807869,MATH 142A,A03,093480,Staff,5,0,32,27
1656269807869,MATH 142A,B03,093481,Staff,3,0,32,29
1656269807869,MATH 142A,B04,093558,Staff,6,0,32,26
1656269807869,MATH 142A,B05,093559,Staff,0,0,32,32
1656269813894,MATH 193A,A01,083224,Rotar; Vladimir,0,1,34,34
1656269813894,MATH 193A,A02,083225,Rotar; Vladimir,0,0,34,34
1656269813894,MATH 193A,A03,083781,Rotar; Vladimir,0,0,34,34
1656269813894,MATH 193A,A04,083782,Rotar; Vladimir,6,0,34,28
1656269813894,MATH 193A,A05,093482,Rotar; Vladimir,0,0,34,34
1656269819920,MATH 197,001,091859,McAuley; Julian John,9999,0,9999,0
1656269819920,MATH 197,002,095566,Kedlaya; Kiran S.,9997,0,9999,2
1656269819920,MATH 197,003,095567,Xiao; Ming,9999,0,9999,0
1656269819920,MATH 197,004,095571,Perols; Johan Lars,9998,0,9999,1
1656269826974,COGS 9,A01,083615,Shannon; Kyle Michael,4,0,75,71
1656269833000,COGS 11,A01,083617,Boyle; Mary E. T.,14,0,48,34
1656269839027,COGS 13,A01,083071,Bastos; Amalia Pinkusfeld,4,0,71,67
1656269845051,COGS 14A,A01,092681,Semenuks; Arturs,1,12,100,99
1656269851075,COGS 14B,A01,083073,Cheng; Tzu-Han,7,0,63,56
1656269857101,COGS 17,A01,092677,Semenuks; Arturs,8,0,81,73
1656269863127,COGS 100,A01,083619,Allen; Michael Gordon,2,0,70,68
1656269869155,COGS 101A,A01,083621,Davis; Joshua Daniel,4,0,68,64
1656269875180,COGS 101B,A01,091572,Allen; Michael Gordon,4,0,65,61
1656269881217,COGS 101C,A01,083625,Delgado; Tania,10,0,35,25
1656269887243,COGS 107A,A01,083627,Boyle; Mary E. T.,0,0,60,60
1656269893270,COGS 118A,A01,083075,Gupta; Anjum,8,0,76,68
1656269899298,CSE 3,A50,083646,Miranda; Gregory Joseph,18,0,50,32
1656269905321,CSE 8A,A50,083650,Miranda; Gregory Joseph,2,2,56,54
1656269911344,CSE 11,A01,083080,Cao; Yingjun,0,49,40,40
1656269917369,CSE 12,A01,083652,Krause-Levy; Sophia Louisa,5,1,120,115
1656269923394,CSE 15L,A01,083654,Morris; Justin Loren,2,0,50,48
1656269923394,CSE 15L,A02,083655,Morris; Justin Loren,4,0,50,46
1656269929426,CSE 20,A01,083657,Tran; Khoa Dang,30,0,80,50
1656269935449,CSE 21,A01,095574,Bach; Quang Tran,23,0,48,25
1656269941472,CSE 30,A01,083084,Eldon; John,2,6,80,78
1656269941472,CSE 30,B01,095061,Bhaskar; Nishant,0,1,50,50
1656269947498,CSE 100,A01,083659,Cao; Yingjun,1,18,70,69
1656269953520,CSE 134B,A01,083661,Powell; Thomas Allan,5,0,100,95
1656269959542,CSE 140,A01,083663,Gungor; Onat,9,0,85,76
1656269965570,CSE 140L,A01,083088,Eldon; John,8,0,100,92
1656269971593,CSE 175,A01,083665,Kumar; Rakesh,0,0,25,25
1656269977618,CSE 190,A00,092507,Dubnov; Shlomo,3,0,20,17
1656269983641,ECE 45,A01,083139,Congero; Spencer William,1,0,75,74
1656269989667,ECE 65,A50,083695,Saad; Andrew S,9,0,30,21
1656269989667,ECE 65,A51,095125,Staff,24,0,26,2
1656269995694,ECE 109,A01,091882,Touri; Behrouz,0,1,70,70
1656270001723,ECE 180,A00,083140,Abi Samra; Nicholas Camill,1,0,30,29
1656270001723,ECE 180,B00,083141,Abi Samra; Nicholas Camill,0,4,30,30
1656270007746,MATH 10A,A01,083735,Patchell; Gregory David,0,0,30,30
1656270007746,MATH 10A,A02,083736,Patchell; Gregory David,22,0,30,8
1656270007746,MATH 10A,A03,083737,Patchell; Gregory David,16,0,30,14
1656270013770,MATH 10B,A01,083207,Lim; Seonhee,0,0,34,34
1656270013770,MATH 10B,A02,083208,Lim; Seonhee,7,0,35,28
1656270013770,MATH 10B,A03,093472,Staff,1,0,34,33
1656270013770,MATH 10B,B01,083739,Sinha; Shubham,11,0,30,19
1656270019806,MATH 18,A01,083743,Cinel; Cameron Alexander,7,0,30,23
1656270019806,MATH 18,A02,083744,Cinel; Cameron Alexander,9,0,30,21
1656270019806,MATH 18,A03,083745,Cinel; Cameron Alexander,5,0,30,25
1656270019806,MATH 18,B01,083748,Rideout; David Porter,1,0,36,35
1656270019806,MATH 18,B02,083749,Rideout; David Porter,0,0,36,36
1656270019806,MATH 18,B03,083750,Rideout; David Porter,0,0,36,36
1656270019806,MATH 18,B04,083751,Rideout; David Porter,0,1,36,36
1656270019806,MATH 18,B05,093473,Rideout; David Porter,0,0,36,36
1656270019806,MATH 18,B06,093474,Rideout; David Porter,3,0,36,33
1656270025834,MATH 20A,A01,083754,Zheng; Zequn,11,0,40,29
1656270031859,MATH 20B,A01,083756,Briones; Jor-el Thomas Caparas,0,0,36,36
1656270031859,MATH 20B,A02,083757,Briones; Jor-el Thomas Caparas,0,0,36,36
1656270031859,MATH 20B,A03,093475,Staff,0,0,36,36
1656270037884,MATH 20C,A01,083760,Briones; Jor-el Thomas Caparas,0,0,35,35
1656270037884,MATH 20C,A02,083761,Briones; Jor-el Thomas Caparas,9,1,35,26
1656270037884,MATH 20C,A03,093476,Staff,0,0,35,35
1656270037884,MATH 20C,B01,083762,Bach; Quang Tran,1,0,30,29
1656270043908,MATH 20D,A01,083765,Tran; Brian Kha,1,0,30,29
1656270043908,MATH 20D,A02,083766,Tran; Brian Kha,0,1,30,30
1656270043908,MATH 20D,A03,083767,Tran; Brian Kha,2,0,30,28
1656270049932,MATH 20E,A01,083771,Ganguly; Soumya,3,0,32,29
1656270049932,MATH 20E,A02,083772,Ganguly; Soumya,0,0,32,32
1656270049932,MATH 20E,B01,083773,Ciotti; Benjamin,16,0,35,19
1656270049932,MATH 20E,B02,083774,Ciotti; Benjamin,15,0,35,20
1656270055961,MATH 103A,A01,083777,Greenfeld; Be'Eri,1,0,36,35
1656270055961,MATH 103A,A02,083778,Greenfeld; Be'Eri,1,0,36,35
1656270055961,MATH 103A,A03,093561,Staff,5,0,36,31
1656270055961,MATH 103A,B01,083779,Greenfeld; Be'Eri,8,0,36,28
1656270055961,MATH 103A,B02,083780,Greenfeld; Be'Eri,1,0,36,35
1656270055961,MATH 103A,B03,093562,Staff,0,0,36,36
1656270061988,MATH 105,A01,085443,Carter; Anne Toulson,5,0,35,30
1656270061988,MATH 105,A02,093477,Staff,14,0,35,21
1656270068017,MATH 109,A01,083213,Ganzberger; Geoffrey Michael,0,0,34,34
1656270068017,MATH 109,A02,083214,Ganzberger; Geoffrey Michael,0,0,34,34
1656270068017,MATH 109,A03,093478,Staff,1,0,34,33
1656270068017,MATH 109,B01,083215,Ganzberger; Geoffrey Michael,4,0,32,28
1656270068017,MATH 109,B02,083216,Ganzberger; Geoffrey Michael,1,0,32,31
1656270068017,MATH 109,B03,093479,Staff,3,0,32,29
1656270074041,MATH 142A,A01,083219,Chow; Bennett,2,0,32,30
1656270074041,MATH 142A,A02,083220,Chow; Bennett,8,0,32,24
1656270074041,MATH 142A,A03,093480,Staff,5,0,32,27
1656270074041,MATH 142A,B03,093481,Staff,3,0,32,29
1656270074041,MATH 142A,B04,093558,Staff,6,0,32,26
1656270074041,MATH 142A,B05,093559,Staff,0,0,32,32
1656270080064,MATH 193A,A01,083224,Rotar; Vladimir,0,1,34,34
1656270080064,MATH 193A,A02,083225,Rotar; Vladimir,0,0,34,34
1656270080064,MATH 193A,A03,083781,Rotar; Vladimir,0,0,34,34
1656270080064,MATH 193A,A04,083782,Rotar; Vladimir,6,0,34,28
1656270080064,MATH 193A,A05,093482,Rotar; Vladimir,0,0,34,34
1656270086097,MATH 197,001,091859,McAuley; Julian John,9999,0,9999,0
1656270086097,MATH 197,002,095566,Kedlaya; Kiran S.,9997,0,9999,2
1656270086097,MATH 197,003,095567,Xiao; Ming,9999,0,9999,0
1656270086097,MATH 197,004,095571,Perols; Johan Lars,9998,0,9999,1
1656270093159,COGS 9,A01,083615,Shannon; Kyle Michael,4,0,75,71
1656270099184,COGS 11,A01,083617,Boyle; Mary E. T.,14,0,48,34
1656270105209,COGS 13,A01,083071,Bastos; Amalia Pinkusfeld,4,0,71,67
1656270111234,COGS 14A,A01,092681,Semenuks; Arturs,1,12,100,99
1656270117261,COGS 14B,A01,083073,Cheng; Tzu-Han,7,0,63,56
1656270123287,COGS 17,A01,092677,Semenuks; Arturs,8,0,81,73
1656270129309,COGS 100,A01,083619,Allen; Michael Gordon,2,0,70,68
1656270135337,COGS 101A,A01,083621,Davis; Joshua Daniel,4,0,68,64
1656270141361,COGS 101B,A01,091572,Allen; Michael Gordon,4,0,65,61
1656270147390,COGS 101C,A01,083625,Delgado; Tania,10,0,35,25
1656270153417,COGS 107A,A01,083627,Boyle; Mary E. T.,0,0,60,60
1656270159443,COGS 118A,A01,083075,Gupta; Anjum,8,0,76,68
1656270165467,CSE 3,A50,083646,Miranda; Gregory Joseph,18,0,50,32
1656270171510,CSE 8A,A50,083650,Miranda; Gregory Joseph,2,2,56,54
1656270177533,CSE 11,A01,083080,Cao; Yingjun,0,49,40,40
1656270183557,CSE 12,A01,083652,Krause-Levy; Sophia Louisa,5,1,120,115
1656270189579,CSE 15L,A01,083654,Morris; Justin Loren,2,0,50,48
1656270189579,CSE 15L,A02,083655,Morris; Justin Loren,4,0,50,46
1656270195608,CSE 20,A01,083657,Tran; Khoa Dang,30,0,80,50
1656270201703,CSE 21,A01,095574,Bach; Quang Tran,23,0,48,25
1656270207725,CSE 30,A01,083084,Eldon; John,2,6,80,78
1656270207725,CSE 30,B01,095061,Bhaskar; Nishant,0,1,50,50
1656270213761,CSE 100,A01,083659,Cao; Yingjun,1,18,70,69
1656270219794,CSE 134B,A01,083661,Powell; Thomas Allan,5,0,100,95
1656270225818,CSE 140,A01,083663,Gungor; Onat,9,0,85,76
1656270231845,CSE 140L,A01,083088,Eldon; John,8,0,100,92
1656270237868,CSE 175,A01,083665,Kumar; Rakesh,0,0,25,25
1656270243890,CSE 190,A00,092507,Dubnov; Shlomo,3,0,20,17
1656270249918,ECE 45,A01,083139,Congero; Spencer William,1,0,75,74
1656270255940,ECE 65,A50,083695,Saad; Andrew S,9,0,30,21
1656270255940,ECE 65,A51,095125,Staff,24,0,26,2
1656270261963,ECE 109,A01,091882,Touri; Behrouz,0,1,70,70
1656270267985,ECE 180,A00,083140,Abi Samra; Nicholas Camill,1,0,30,29
1656270267985,ECE 180,B00,083141,Abi Samra; Nicholas Camill,0,4,30,30
1656270274012,MATH 10A,A01,083735,Patchell; Gregory David,0,0,30,30
1656270274012,MATH 10A,A02,083736,Patchell; Gregory David,22,0,30,8
1656270274012,MATH 10A,A03,083737,Patchell; Gregory David,16,0,30,14
1656270280036,MATH 10B,A01,083207,Lim; Seonhee,0,0,34,34
1656270280036,MATH 10B,A02,083208,Lim; Seonhee,7,0,35,28
1656270280036,MATH 10B,A03,093472,Staff,1,0,34,33
1656270280036,MATH 10B,B01,083739,Sinha; Shubham,11,0,30,19
1656270286062,MATH 18,A01,083743,Cinel; Cameron Alexander,7,0,30,23
1656270286062,MATH 18,A02,083744,Cinel; Cameron Alexander,9,0,30,21
1656270286062,MATH 18,A03,083745,Cinel; Cameron Alexander,5,0,30,25
1656270286062,MATH 18,B01,083748,Rideout; David Porter,1,0,36,35
1656270286062,MATH 18,B02,083749,Rideout; David Porter,0,0,36,36
1656270286062,MATH 18,B03,083750,Rideout; David Porter,0,0,36,36
1656270286062,MATH 18,B04,083751,Rideout; David Porter,0,1,36,36
1656270286062,MATH 18,B05,093473,Rideout; David Porter,0,0,36,36
1656270286062,MATH 18,B06,093474,Rideout; David Porter,3,0,36,33
1656270292094,MATH 20A,A01,083754,Zheng; Zequn,11,0,40,29
1656270298117,MATH 20B,A01,083756,Briones; Jor-el Thomas Caparas,0,0,36,36
1656270298117,MATH 20B,A02,083757,Briones; Jor-el Thomas Caparas,0,0,36,36
1656270298117,MATH 20B,A03,093475,Staff,0,0,36,36
1656270304146,MATH 20C,A01,083760,Briones; Jor-el Thomas Caparas,0,0,35,35
1656270304146,MATH 20C,A02,083761,Briones; Jor-el Thomas Caparas,9,1,35,26
1656270304146,MATH 20C,A03,093476,Staff,0,0,35,35
1656270304146,MATH 20C,B01,083762,Bach; Quang Tran,1,0,30,29
1656270310168,MATH 20D,A01,083765,Tran; Brian Kha,1,0,30,29
1656270310168,MATH 20D,A02,083766,Tran; Brian Kha,0,1,30,30
1656270310168,MATH 20D,A03,083767,Tran; Brian Kha,2,0,30,28
1656270316192,MATH 20E,A01,083771,Ganguly; Soumya,3,0,32,29
1656270316192,MATH 20E,A02,083772,Ganguly; Soumya,0,0,32,32
1656270316192,MATH 20E,B01,083773,Ciotti; Benjamin,16,0,35,19
1656270316192,MATH 20E,B02,083774,Ciotti; Benjamin,15,0,35,20
1656270322216,MATH 103A,A01,083777,Greenfeld; Be'Eri,1,0,36,35
1656270322216,MATH 103A,A02,083778,Greenfeld; Be'Eri,1,0,36,35
1656270322216,MATH 103A,A03,093561,Staff,5,0,36,31
1656270322216,MATH 103A,B01,083779,Greenfeld; Be'Eri,8,0,36,28
1656270322216,MATH 103A,B02,083780,Greenfeld; Be'Eri,1,0,36,35
1656270322216,MATH 103A,B03,093562,Staff,0,0,36,36
1656270328240,MATH 105,A01,085443,Carter; Anne Toulson,5,0,35,30
1656270328240,MATH 105,A02,093477,Staff,14,0,35,21
1656270334268,MATH 109,A01,083213,Ganzberger; Geoffrey Michael,1,0,34,33
1656270334268,MATH 109,A02,083214,Ganzberger; Geoffrey Michael,0,0,34,34
1656270334268,MATH 109,A03,093478,Staff,1,0,34,33
1656270334268,MATH 109,B01,083215,Ganzberger; Geoffrey Michael,4,0,32,28
1656270334268,MATH 109,B02,083216,Ganzberger; Geoffrey Michael,1,0,32,31
1656270334268,MATH 109,B03,093479,Staff,3,0,32,29
1656270340298,MATH 142A,A01,083219,Chow; Bennett,2,0,32,30
1656270340298,MATH 142A,A02,083220,Chow; Bennett,8,0,32,24
1656270340298,MATH 142A,A03,093480,Staff,5,0,32,27
1656270340298,MATH 142A,B03,093481,Staff,3,0,32,29
1656270340298,MATH 142A,B04,093558,Staff,6,0,32,26
1656270340298,MATH 142A,B05,093559,Staff,0,0,32,32
1656270346326,MATH 193A,A01,083224,Rotar; Vladimir,0,1,34,34
1656270346326,MATH 193A,A02,083225,Rotar; Vladimir,0,0,34,34
1656270346326,MATH 193A,A03,083781,Rotar; Vladimir,0,0,34,34
1656270346326,MATH 193A,A04,083782,Rotar; Vladimir,6,0,34,28
1656270346326,MATH 193A,A05,093482,Rotar; Vladimir,0,0,34,34
1656270352351,MATH 197,001,091859,McAuley; Julian John,9999,0,9999,0
1656270352351,MATH 197,002,095566,Kedlaya; Kiran S.,9997,0,9999,2
1656270352351,MATH 197,003,095567,Xiao; Ming,9999,0,9999,0
1656270352351,MATH 197,004,095571,Perols; Johan Lars,9998,0,9999,1
1656270359404,COGS 9,A01,083615,Shannon; Kyle Michael,4,0,75,71
1656270365431,COGS 11,A01,083617,Boyle; Mary E. T.,14,0,48,34
1656270371453,COGS 13,A01,083071,Bastos; Amalia Pinkusfeld,4,0,71,67
1656270377475,COGS 14A,A01,092681,Semenuks; Arturs,1,12,100,99
1656270383501,COGS 14B,A01,083073,Cheng; Tzu-Han,7,0,63,56
1656270389528,COGS 17,A01,092677,Semenuks; Arturs,8,0,81,73
1656270395562,COGS 100,A01,083619,Allen; Michael Gordon,2,0,70,68
1656270401586,COGS 101A,A01,083621,Davis; Joshua Daniel,4,0,68,64
1656270407613,COGS 101B,A01,091572,Allen; Michael Gordon,4,0,65,61
1656270413641,COGS 101C,A01,083625,Delgado; Tania,10,0,35,25
1656270419668,COGS 107A,A01,083627,Boyle; Mary E. T.,0,0,60,60
1656270425707,COGS 118A,A01,083075,Gupta; Anjum,8,0,76,68
1656270431732,CSE 3,A50,083646,Miranda; Gregory Joseph,18,0,50,32
1656270437755,CSE 8A,A50,083650,Miranda; Gregory Joseph,2,2,56,54
1656270443779,CSE 11,A01,083080,Cao; Yingjun,0,49,40,40
1656270449802,CSE 12,A01,083652,Krause-Levy; Sophia Louisa,5,1,120,115
1656270455833,CSE 15L,A01,083654,Morris; Justin Loren,2,0,50,48
1656270455833,CSE 15L,A02,083655,Morris; Justin Loren,4,0,50,46
1656270461858,CSE 20,A01,083657,Tran; Khoa Dang,30,0,80,50
1656270467884,CSE 21,A01,095574,Bach; Quang Tran,23,0,48,25
1656270473908,CSE 30,A01,083084,Eldon; John,2,6,80,78
1656270473908,CSE 30,B01,095061,Bhaskar; Nishant,0,1,50,50
1656270479931,CSE 100,A01,083659,Cao; Yingjun,1,18,70,69
1656270485959,CSE 134B,A01,083661,Powell; Thomas Allan,5,0,100,95
1656270491986,CSE 140,A01,083663,Gungor; Onat,9,0,85,76
1656270498009,CSE 140L,A01,083088,Eldon; John,8,0,100,92
1656270504034,CSE 175,A01,083665,Kumar; Rakesh,0,0,25,25
1656270510060,CSE 190,A00,092507,Dubnov; Shlomo,3,0,20,17
1656270516087,ECE 45,A01,083139,Congero; Spencer William,1,0,75,74
1656270522114,ECE 65,A50,083695,Saad; Andrew S,9,0,30,21
1656270522114,ECE 65,A51,095125,Staff,24,0,26,2
1656270528139,ECE 109,A01,091882,Touri; Behrouz,0,1,70,70
1656270534164,ECE 180,A00,083140,Abi Samra; Nicholas Camill,1,0,30,29
1656270534164,ECE 180,B00,083141,Abi Samra; Nicholas Camill,0,4,30,30
1656270540203,MATH 10A,A01,083735,Patchell; Gregory David,0,0,30,30
1656270540203,MATH 10A,A02,083736,Patchell; Gregory David,22,0,30,8
1656270540203,MATH 10A,A03,083737,Patchell; Gregory David,16,0,30,14
1656270546226,MATH 10B,A01,083207,Lim; Seonhee,0,0,34,34
1656270546226,MATH 10B,A02,083208,Lim; Seonhee,7,0,35,28
1656270546226,MATH 10B,A03,093472,Staff,1,0,34,33
1656270546226,MATH 10B,B01,083739,Sinha; Shubham,11,0,30,19
1656270552252,MATH 18,A01,083743,Cinel; Cameron Alexander,7,0,30,23
1656270552252,MATH 18,A02,083744,Cinel; Cameron Alexander,9,0,30,21
1656270552252,MATH 18,A03,083745,Cinel; Cameron Alexander,5,0,30,25
1656270552252,MATH 18,B01,083748,Rideout; David Porter,1,0,36,35
1656270552252,MATH 18,B02,083749,Rideout; David Porter,0,0,36,36
1656270552252,MATH 18,B03,083750,Rideout; David Porter,0,0,36,36
1656270552252,MATH 18,B04,083751,Rideout; David Porter,0,1,36,36
1656270552252,MATH 18,B05,093473,Rideout; David Porter,0,0,36,36
1656270552252,MATH 18,B06,093474,Rideout; David Porter,3,0,36,33
1656270558278,MATH 20A,A01,083754,Zheng; Zequn,11,0,40,29
1656270564302,MATH 20B,A01,083756,Briones; Jor-el Thomas Caparas,0,0,36,36
1656270564302,MATH 20B,A02,083757,Briones; Jor-el Thomas Caparas,0,0,36,36
1656270564302,MATH 20B,A03,093475,Staff,0,0,36,36
1656270570326,MATH 20C,A01,083760,Briones; Jor-el Thomas Caparas,0,0,35,35
1656270570326,MATH 20C,A02,083761,Briones; Jor-el Thomas Caparas,9,1,35,26
1656270570326,MATH 20C,A03,093476,Staff,0,0,35,35
1656270570326,MATH 20C,B01,083762,Bach; Quang Tran,1,0,30,29
1656270576364,MATH 20D,A01,083765,Tran; Brian Kha,1,0,30,29
1656270576364,MATH 20D,A02,083766,Tran; Brian Kha,0,1,30,30
1656270576364,MATH 20D,A03,083767,Tran; Brian Kha,2,0,30,28
1656270582389,MATH 20E,A01,083771,Ganguly; Soumya,3,0,32,29
1656270582389,MATH 20E,A02,083772,Ganguly; Soumya,0,0,32,32
1656270582389,MATH 20E,B01,083773,Ciotti; Benjamin,16,0,35,19
1656270582389,MATH 20E,B02,083774,Ciotti; Benjamin,15,0,35,20
1656270588414,MATH 103A,A01,083777,Greenfeld; Be'Eri,1,0,36,35
1656270588414,MATH 103A,A02,083778,Greenfeld; Be'Eri,1,0,36,35
1656270588414,MATH 103A,A03,093561,Staff,5,0,36,31
1656270588414,MATH 103A,B01,083779,Greenfeld; Be'Eri,8,0,36,28
1656270588414,MATH 103A,B02,083780,Greenfeld; Be'Eri,1,0,36,35
1656270588414,MATH 103A,B03,093562,Staff,0,0,36,36
1656270594442,MATH 105,A01,085443,Carter; Anne Toulson,5,0,35,30
1656270594442,MATH 105,A02,093477,Staff,14,0,35,21
1656270600467,MATH 109,A01,083213,Ganzberger; Geoffrey Michael,1,0,34,33
1656270600467,MATH 109,A02,083214,Ganzberger; Geoffrey Michael,0,0,34,34
1656270600467,MATH 109,A03,093478,Staff,1,0,34,33
1656270600467,MATH 109,B01,083215,Ganzberger; Geoffrey Michael,4,0,32,28
1656270600467,MATH 109,B02,083216,Ganzberger; Geoffrey Michael,1,0,32,31
1656270600467,MATH 109,B03,093479,Staff,3,0,32,29
1656270606492,MATH 142A,A01,083219,Chow; Bennett,2,0,32,30
1656270606492,MATH 142A,A02,083220,Chow; Bennett,8,0,32,24
1656270606492,MATH 142A,A03,093480,Staff,5,0,32,27
1656270606492,MATH 142A,B03,093481,Staff,3,0,32,29
1656270606492,MATH 142A,B04,093558,Staff,6,0,32,26
1656270606492,MATH 142A,B05,093559,Staff,0,0,32,32
1656270612518,MATH 193A,A01,083224,Rotar; Vladimir,0,1,34,34
1656270612518,MATH 193A,A02,083225,Rotar; Vladimir,0,0,34,34
1656270612518,MATH 193A,A03,083781,Rotar; Vladimir,0,0,34,34
1656270612518,MATH 193A,A04,083782,Rotar; Vladimir,6,0,34,28
1656270612518,MATH 193A,A05,093482,Rotar; Vladimir,0,0,34,34
1656270618540,MATH 197,001,091859,McAuley; Julian John,9999,0,9999,0
1656270618540,MATH 197,002,095566,Kedlaya; Kiran S.,9997,0,9999,2
1656270618540,MATH 197,003,095567,Xiao; Ming,9999,0,9999,0
1656270618540,MATH 197,004,095571,Perols; Johan Lars,9998,0,9999,1
1656270625600,COGS 9,A01,083615,Shannon; Kyle Michael,4,0,75,71
1656270631622,COGS 11,A01,083617,Boyle; Mary E. T.,14,0,48,34
1656270637644,COGS 13,A01,083071,Bastos; Amalia Pinkusfeld,4,0,71,67
1656270643666,COGS 14A,A01,092681,Semenuks; Arturs,1,12,100,99
1656270649689,COGS 14B,A01,083073,Cheng; Tzu-Han,7,0,63,56
1656270655713,COGS 17,A01,092677,Semenuks; Arturs,8,0,81,73
1656270661742,COGS 100,A01,083619,Allen; Michael Gordon,2,0,70,68
1656270667766,COGS 101A,A01,083621,Davis; Joshua Daniel,4,0,68,64
1656270673792,COGS 101B,A01,091572,Allen; Michael Gordon,4,0,65,61
1656270679817,COGS 101C,A01,083625,Delgado; Tania,10,0,35,25
1656270685850,COGS 107A,A01,083627,Boyle; Mary E. T.,0,0,60,60
1656270691872,COGS 118A,A01,083075,Gupta; Anjum,8,0,76,68
1656270697896,CSE 3,A50,083646,Miranda; Gregory Joseph,18,0,50,32
1656270703920,CSE 8A,A50,083650,Miranda; Gregory Joseph,2,2,56,54
1656270709942,CSE 11,A01,083080,Cao; Yingjun,0,49,40,40
1656270715966,CSE 12,A01,083652,Krause-Levy; Sophia Louisa,5,1,120,115
1656270721997,CSE 15L,A01,083654,Morris; Justin Loren,2,0,50,48
1656270721997,CSE 15L,A02,083655,Morris; Justin Loren,4,0,50,46
1656270728023,CSE 20,A01,083657,Tran; Khoa Dang,30,0,80,50
1656270734049,CSE 21,A01,095574,Bach; Quang Tran,23,0,48,25
1656270740076,CSE 30,A01,083084,Eldon; John,2,6,80,78
1656270740076,CSE 30,B01,095061,Bhaskar; Nishant,0,1,50,50
1656270746099,CSE 100,A01,083659,Cao; Yingjun,1,18,70,69
1656270752123,CSE 134B,A01,083661,Powell; Thomas Allan,5,0,100,95
1656270758146,CSE 140,A01,083663,Gungor; Onat,9,0,85,76
1656270764170,CSE 140L,A01,083088,Eldon; John,8,0,100,92
1656270770192,CSE 175,A01,083665,Kumar; Rakesh,0,0,25,25
1656270776215,CSE 190,A00,092507,Dubnov; Shlomo,3,0,20,17
1656270782238,ECE 45,A01,083139,Congero; Spencer William,1,0,75,74
1656270788263,ECE 65,A50,083695,Saad; Andrew S,9,0,30,21
1656270788263,ECE 65,A51,095125,Staff,24,0,26,2
1656270794286,ECE 109,A01,091882,Touri; Behrouz,0,1,70,70
1656270800381,ECE 180,A00,083140,Abi Samra; Nicholas Camill,1,0,30,29
1656270800381,ECE 180,B00,083141,Abi Samra; Nicholas Camill,0,4,30,30
1656270806405,MATH 10A,A01,083735,Patchell; Gregory David,0,0,30,30
1656270806405,MATH 10A,A02,083736,Patchell; Gregory David,22,0,30,8
1656270806405,MATH 10A,A03,083737,Patchell; Gregory David,16,0,30,14
1656270812439,MATH 10B,A01,083207,Lim; Seonhee,0,0,34,34
1656270812439,MATH 10B,A02,083208,Lim; Seonhee,7,0,35,28
1656270812439,MATH 10B,A03,093472,Staff,1,0,34,33
1656270812439,MATH 10B,B01,083739,Sinha; Shubham,11,0,30,19
1656270818464,MATH 18,A01,083743,Cinel; Cameron Alexander,7,0,30,23
1656270818464,MATH 18,A02,083744,Cinel; Cameron Alexander,9,0,30,21
1656270818464,MATH 18,A03,083745,Cinel; Cameron Alexander,5,0,30,25
1656270818464,MATH 18,B01,083748,Rideout; David Porter,1,0,36,35
1656270818464,MATH 18,B02,083749,Rideout; David Porter,0,0,36,36
1656270818464,MATH 18,B03,083750,Rideout; David Porter,0,0,36,36
1656270818464,MATH 18,B04,083751,Rideout; David Porter,0,1,36,36
1656270818464,MATH 18,B05,093473,Rideout; David Porter,0,0,36,36
1656270818464,MATH 18,B06,093474,Rideout; David Porter,3,0,36,33
1656270824488,MATH 20A,A01,083754,Zheng; Zequn,11,0,40,29
1656270830512,MATH 20B,A01,083756,Briones; Jor-el Thomas Caparas,0,0,36,36
1656270830512,MATH 20B,A02,083757,Briones; Jor-el Thomas Caparas,0,0,36,36
1656270830512,MATH 20B,A03,093475,Staff,0,0,36,36
1656270836540,MATH 20C,A01,083760,Briones; Jor-el Thomas Caparas,0,0,35,35
1656270836540,MATH 20C,A02,083761,Briones; Jor-el Thomas Caparas,9,1,35,26
1656270836540,MATH 20C,A03,093476,Staff,0,0,35,35
1656270836540,MATH 20C,B01,083762,Bach; Quang Tran,1,0,30,29
1656270842570,MATH 20D,A01,083765,Tran; Brian Kha,1,0,30,29
1656270842570,MATH 20D,A02,083766,Tran; Brian Kha,0,1,30,30
1656270842570,MATH 20D,A03,083767,Tran; Brian Kha,2,0,30,28
1656270848595,MATH 20E,A01,083771,Ganguly; Soumya,3,0,32,29
1656270848595,MATH 20E,A02,083772,Ganguly; Soumya,0,0,32,32
1656270848595,MATH 20E,B01,083773,Ciotti; Benjamin,16,0,35,19
1656270848595,MATH 20E,B02,083774,Ciotti; Benjamin,15,0,35,20
1656270854633,MATH 103A,A01,083777,Greenfeld; Be'Eri,1,0,36,35
1656270854633,MATH 103A,A02,083778,Greenfeld; Be'Eri,1,0,36,35
1656270854633,MATH 103A,A03,093561,Staff,5,0,36,31
1656270854633,MATH 103A,B01,083779,Greenfeld; Be'Eri,8,0,36,28
1656270854633,MATH 103A,B02,083780,Greenfeld; Be'Eri,1,0,36,35
1656270854633,MATH 103A,B03,093562,Staff,0,0,36,36
1656270860664,MATH 105,A01,085443,Carter; Anne Toulson,5,0,35,30
1656270860664,MATH 105,A02,093477,Staff,14,0,35,21
1656270866688,MATH 109,A01,083213,Ganzberger; Geoffrey Michael,1,0,34,33
1656270866688,MATH 109,A02,083214,Ganzberger; Geoffrey Michael,0,0,34,34
1656270866688,MATH 109,A03,093478,Staff,1,0,34,33
1656270866688,MATH 109,B01,083215,Ganzberger; Geoffrey Michael,4,0,32,28
1656270866688,MATH 109,B02,083216,Ganzberger; Geoffrey Michael,1,0,32,31
1656270866688,MATH 109,B03,093479,Staff,3,0,32,29
1656270872717,MATH 142A,A01,083219,Chow; Bennett,2,0,32,30
1656270872717,MATH 142A,A02,083220,Chow; Bennett,8,0,32,24
1656270872717,MATH 142A,A03,093480,Staff,5,0,32,27
1656270872717,MATH 142A,B03,093481,Staff,3,0,32,29
1656270872717,MATH 142A,B04,093558,Staff,6,0,32,26
1656270872717,MATH 142A,B05,093559,Staff,0,0,32,32
1656270878741,MATH 193A,A01,083224,Rotar; Vladimir,0,1,34,34
1656270878741,MATH 193A,A02,083225,Rotar; Vladimir,0,0,34,34
1656270878741,MATH 193A,A03,083781,Rotar; Vladimir,0,0,34,34
1656270878741,MATH 193A,A04,083782,Rotar; Vladimir,6,0,34,28
1656270878741,MATH 193A,A05,093482,Rotar; Vladimir,0,0,34,34
1656270884764,MATH 197,001,091859,McAuley; Julian John,9999,0,9999,0
1656270884764,MATH 197,002,095566,Kedlaya; Kiran S.,9997,0,9999,2
1656270884764,MATH 197,003,095567,Xiao; Ming,9999,0,9999,0
1656270884764,MATH 197,004,095571,Perols; Johan Lars,9998,0,9999,1
1656270891814,COGS 9,A01,083615,Shannon; Kyle Michael,4,0,75,71
1656270897838,COGS 11,A01,083617,Boyle; Mary E. T.,14,0,48,34
1656270903862,COGS 13,A01,083071,Bastos; Amalia Pinkusfeld,4,0,71,67
1656270909886,COGS 14A,A01,092681,Semenuks; Arturs,1,12,100,99
1656270915912,COGS 14B,A01,083073,Cheng; Tzu-Han,7,0,63,56
1656270921935,COGS 17,A01,092677,Semenuks; Arturs,8,0,81,73
1656270927961,COGS 100,A01,083619,Allen; Michael Gordon,2,0,70,68
1656270933985,COGS 101A,A01,083621,Davis; Joshua Daniel,4,0,68,64
1656270940007,COGS 101B,A01,091572,Allen; Michael Gordon,4,0,65,61
1656270946033,COGS 101C,A01,083625,Delgado; Tania,10,0,35,25
1656270952060,COGS 107A,A01,083627,Boyle; Mary E. T.,0,0,60,60
1656270958088,COGS 118A,A01,083075,Gupta; Anjum,8,0,76,68
1656270964111,CSE 3,A50,083646,Miranda; Gregory Joseph,18,0,50,32
1656270970145,CSE 8A,A50,083650,Miranda; Gregory Joseph,2,2,56,54
1656270976168,CSE 11,A01,083080,Cao; Yingjun,0,49,40,40
1656270982196,CSE 12,A01,083652,Krause-Levy; Sophia Louisa,5,1,120,115
1656270988227,CSE 15L,A01,083654,Morris; Justin Loren,2,0,50,48
1656270988227,CSE 15L,A02,083655,Morris; Justin Loren,4,0,50,46
1656270994255,CSE 20,A01,083657,Tran; Khoa Dang,30,0,80,50
1656271000279,CSE 21,A01,095574,Bach; Quang Tran,23,0,48,25
1656271006307,CSE 30,A01,083084,Eldon; John,2,6,80,78
1656271006307,CSE 30,B01,095061,Bhaskar; Nishant,0,1,50,50
1656271012328,CSE 100,A01,083659,Cao; Yingjun,1,18,70,69
1656271018350,CSE 134B,A01,083661,Powell; Thomas Allan,5,0,100,95
1656271024373,CSE 140,A01,083663,Gungor; Onat,9,0,85,76
1656271030409,CSE 140L,A01,083088,Eldon; John,8,0,100,92
1656271036432,CSE 175,A01,083665,Kumar; Rakesh,0,0,25,25
1656271042456,CSE 190,A00,092507,Dubnov; Shlomo,3,0,20,17
1656271048478,ECE 45,A01,083139,Congero; Spencer William,1,0,75,74
1656271054501,ECE 65,A50,083695,Saad; Andrew S,9,0,30,21
1656271054501,ECE 65,A51,095125,Staff,24,0,26,2
1656271060527,ECE 109,A01,091882,Touri; Behrouz,0,1,70,70
1656271066551,ECE 180,A00,083140,Abi Samra; Nicholas Camill,1,0,30,29
1656271066551,ECE 180,B00,083141,Abi Samra; Nicholas Camill,0,4,30,30
1656271072574,MATH 10A,A01,083735,Patchell; Gregory David,0,0,30,30
1656271072574,MATH 10A,A02,083736,Patchell; Gregory David,22,0,30,8
1656271072574,MATH 10A,A03,083737,Patchell; Gregory David,16,0,30,14
1656271078597,MATH 10B,A01,083207,Lim; Seonhee,0,0,34,34
1656271078597,MATH 10B,A02,083208,Lim; Seonhee,7,0,35,28
1656271078597,MATH 10B,A03,093472,Staff,1,0,34,33
1656271078597,MATH 10B,B01,083739,Sinha; Shubham,11,0,30,19
1656271084627,MATH 18,A01,083743,Cinel; Cameron Alexander,7,0,30,23
1656271084627,MATH 18,A02,083744,Cinel; Cameron Alexander,9,0,30,21
1656271084627,MATH 18,A03,083745,Cinel; Cameron Alexander,5,0,30,25
1656271084627,MATH 18,B01,083748,Rideout; David Porter,1,0,36,35
1656271084627,MATH 18,B02,083749,Rideout; David Porter,0,0,36,36
1656271084627,MATH 18,B03,083750,Rideout; David Porter,0,0,36,36
1656271084627,MATH 18,B04,083751,Rideout; David Porter,0,1,36,36
1656271084627,MATH 18,B05,093473,Rideout; David Porter,0,0,36,36
1656271084627,MATH 18,B06,093474,Rideout; David Porter,3,0,36,33
1656271090655,MATH 20A,A01,083754,Zheng; Zequn,11,0,40,29
1656271096688,MATH 20B,A01,083756,Briones; Jor-el Thomas Caparas,0,0,36,36
1656271096688,MATH 20B,A02,083757,Briones; Jor-el Thomas Caparas,0,0,36,36
1656271096688,MATH 20B,A03,093475,Staff,0,0,36,36
1656271102713,MATH 20C,A01,083760,Briones; Jor-el Thomas Caparas,0,0,35,35
1656271102713,MATH 20C,A02,083761,Briones; Jor-el Thomas Caparas,9,1,35,26
1656271102713,MATH 20C,A03,093476,Staff,0,0,35,35
1656271102713,MATH 20C,B01,083762,Bach; Quang Tran,1,0,30,29
1656271108738,MATH 20D,A01,083765,Tran; Brian Kha,1,0,30,29
1656271108738,MATH 20D,A02,083766,Tran; Brian Kha,0,1,30,30
1656271108738,MATH 20D,A03,083767,Tran; Brian Kha,2,0,30,28
1656271114778,MATH 20E,A01,083771,Ganguly; Soumya,3,0,32,29
1656271114778,MATH 20E,A02,083772,Ganguly; Soumya,0,0,32,32
1656271114778,MATH 20E,B01,083773,Ciotti; Benjamin,16,0,35,19
1656271114778,MATH 20E,B02,083774,Ciotti; Benjamin,15,0,35,20
1656271120803,MATH 103A,A01,083777,Greenfeld; Be'Eri,1,0,36,35
1656271120803,MATH 103A,A02,083778,Greenfeld; Be'Eri,1,0,36,35
1656271120803,MATH 103A,A03,093561,Staff,5,0,36,31
1656271120803,MATH 103A,B01,083779,Greenfeld; Be'Eri,8,0,36,28
1656271120803,MATH 103A,B02,083780,Greenfeld; Be'Eri,1,0,36,35
1656271120803,MATH 103A,B03,093562,Staff,0,0,36,36
1656271126827,MATH 105,A01,085443,Carter; Anne Toulson,5,0,35,30
1656271126827,MATH 105,A02,093477,Staff,14,0,35,21
1656271132860,MATH 109,A01,083213,Ganzberger; Geoffrey Michael,1,0,34,33
1656271132860,MATH 109,A02,083214,Ganzberger; Geoffrey Michael,0,0,34,34
1656271132860,MATH 109,A03,093478,Staff,1,0,34,33
1656271132860,MATH 109,B01,083215,Ganzberger; Geoffrey Michael,4,0,32,28
1656271132860,MATH 109,B02,083216,Ganzberger; Geoffrey Michael,1,0,32,31
1656271132860,MATH 109,B03,093479,Staff,3,0,32,29
1656271138890,MATH 142A,A01,083219,Chow; Bennett,2,0,32,30
1656271138890,MATH 142A,A02,083220,Chow; Bennett,8,0,32,24
1656271138890,MATH 142A,A03,093480,Staff,5,0,32,27
1656271138890,MATH 142A,B03,093481,Staff,3,0,32,29
1656271138890,MATH 142A,B04,093558,Staff,6,0,32,26
1656271138890,MATH 142A,B05,093559,Staff,0,0,32,32
1656271144913,MATH 193A,A01,083224,Rotar; Vladimir,0,1,34,34
1656271144913,MATH 193A,A02,083225,Rotar; Vladimir,0,0,34,34
1656271144913,MATH 193A,A03,083781,Rotar; Vladimir,0,0,34,34
1656271144913,MATH 193A,A04,083782,Rotar; Vladimir,6,0,34,28
1656271144913,MATH 193A,A05,093482,Rotar; Vladimir,0,0,34,34
1656271150940,MATH 197,001,091859,McAuley; Julian John,9999,0,9999,0
1656271150940,MATH 197,002,095566,Kedlaya; Kiran S.,9997,0,9999,2
1656271150940,MATH 197,003,095567,Xiao; Ming,9999,0,9999,0
1656271150940,MATH 197,004,095571,Perols; Johan Lars,9998,0,9999,1
1656271158000,COGS 9,A01,083615,Shannon; Kyle Michael,4,0,75,71
1656271164024,COGS 11,A01,083617,Boyle; Mary E. T.,14,0,48,34
1656271170046,COGS 13,A01,083071,Bastos; Amalia Pinkusfeld,4,0,71,67
1656271176069,COGS 14A,A01,092681,Semenuks; Arturs,1,12,100,99
1656271182095,COGS 14B,A01,083073,Cheng; Tzu-Han,7,0,63,56
1656271188120,COGS 17,A01,092677,Semenuks; Arturs,8,0,81,73
1656271194144,COGS 100,A01,083619,Allen; Michael Gordon,2,0,70,68
1656271200172,COGS 101A,A01,083621,Davis; Joshua Daniel,4,0,68,64
1656271206194,COGS 101B,A01,091572,Allen; Michael Gordon,4,0,65,61
1656271212222,COGS 101C,A01,083625,Delgado; Tania,10,0,35,25
1656271218246,COGS 107A,A01,083627,Boyle; Mary E. T.,0,0,60,60
1656271224275,COGS 118A,A01,083075,Gupta; Anjum,8,0,76,68
1656271230302,CSE 3,A50,083646,Miranda; Gregory Joseph,18,0,50,32
1656271236330,CSE 8A,A50,083650,Miranda; Gregory Joseph,2,2,56,54
1656271242353,CSE 11,A01,083080,Cao; Yingjun,0,49,40,40
1656271248379,CSE 12,A01,083652,Krause-Levy; Sophia Louisa,5,1,120,115
1656271254411,CSE 15L,A01,083654,Morris; Justin Loren,2,0,50,48
1656271254411,CSE 15L,A02,083655,Morris; Justin Loren,4,0,50,46
1656271260438,CSE 20,A01,083657,Tran; Khoa Dang,30,0,80,50
1656271266464,CSE 21,A01,095574,Bach; Quang Tran,23,0,48,25
1656271272491,CSE 30,A01,083084,Eldon; John,2,6,80,78
1656271272491,CSE 30,B01,095061,Bhaskar; Nishant,0,1,50,50
1656271278515,CSE 100,A01,083659,Cao; Yingjun,1,18,70,69
1656271284541,CSE 134B,A01,083661,Powell; Thomas Allan,5,0,100,95
1656271290565,CSE 140,A01,083663,Gungor; Onat,9,0,85,76
1656271296588,CSE 140L,A01,083088,Eldon; John,8,0,100,92
1656271302611,CSE 175,A01,083665,Kumar; Rakesh,0,0,25,25
1656271308634,CSE 190,A00,092507,Dubnov; Shlomo,3,0,20,17
1656271314658,ECE 45,A01,083139,Congero; Spencer William,1,0,75,74
1656271320696,ECE 65,A50,083695,Saad; Andrew S,9,0,30,21
1656271320696,ECE 65,A51,095125,Staff,24,0,26,2
1656271326743,ECE 109,A01,091882,Touri; Behrouz,0,1,70,70
1656271332765,ECE 180,A00,083140,Abi Samra; Nicholas Camill,1,0,30,29
1656271332765,ECE 180,B00,083141,Abi Samra; Nicholas Camill,0,4,30,30
1656271338794,MATH 10A,A01,083735,Patchell; Gregory David,0,0,30,30
1656271338794,MATH 10A,A02,083736,Patchell; Gregory David,22,0,30,8
1656271338794,MATH 10A,A03,083737,Patchell; Gregory David,16,0,30,14
1656271344822,MATH 10B,A01,083207,Lim; Seonhee,0,0,34,34
1656271344822,MATH 10B,A02,083208,Lim; Seonhee,7,0,35,28
1656271344822,MATH 10B,A03,093472,Staff,1,0,34,33
1656271344822,MATH 10B,B01,083739,Sinha; Shubham,11,0,30,19
1656271350857,MATH 18,A01,083743,Cinel; Cameron Alexander,7,0,30,23
1656271350857,MATH 18,A02,083744,Cinel; Cameron Alexander,9,0,30,21
1656271350857,MATH 18,A03,083745,Cinel; Cameron Alexander,5,0,30,25
1656271350857,MATH 18,B01,083748,Rideout; David Porter,1,0,36,35
1656271350857,MATH 18,B02,083749,Rideout; David Porter,0,0,36,36
1656271350857,MATH 18,B03,083750,Rideout; David Porter,0,0,36,36
1656271350857,MATH 18,B04,083751,Rideout; David Porter,0,1,36,36
1656271350857,MATH 18,B05,093473,Rideout; David Porter,0,0,36,36
1656271350857,MATH 18,B06,093474,Rideout; David Porter,3,0,36,33
1656271356881,MATH 20A,A01,083754,Zheng; Zequn,11,0,40,29
1656271362907,MATH 20B,A01,083756,Briones; Jor-el Thomas Caparas,0,0,36,36
1656271362907,MATH 20B,A02,083757,Briones; Jor-el Thomas Caparas,0,0,36,36
1656271362907,MATH 20B,A03,093475,Staff,0,0,36,36
1656271368931,MATH 20C,A01,083760,Briones; Jor-el Thomas Caparas,0,0,35,35
1656271368931,MATH 20C,A02,083761,Briones; Jor-el Thomas Caparas,9,1,35,26
1656271368931,MATH 20C,A03,093476,Staff,0,0,35,35
1656271368931,MATH 20C,B01,083762,Bach; Quang Tran,1,0,30,29
1656271374955,MATH 20D,A01,083765,Tran; Brian Kha,1,0,30,29
1656271374955,MATH 20D,A02,083766,Tran; Brian Kha,0,1,30,30
1656271374955,MATH 20D,A03,083767,Tran; Brian Kha,2,0,30,28
1656271380985,MATH 20E,A01,083771,Ganguly; Soumya,3,0,32,29
1656271380985,MATH 20E,A02,083772,Ganguly; Soumya,0,0,32,32
1656271380985,MATH 20E,B01,083773,Ciotti; Benjamin,16,0,35,19
1656271380985,MATH 20E,B02,083774,Ciotti; Benjamin,15,0,35,20
1656271387015,MATH 103A,A01,083777,Greenfeld; Be'Eri,1,0,36,35
1656271387015,MATH 103A,A02,083778,Greenfeld; Be'Eri,1,0,36,35
1656271387015,MATH 103A,A03,093561,Staff,5,0,36,31
1656271387015,MATH 103A,B01,083779,Greenfeld; Be'Eri,8,0,36,28
1656271387015,MATH 103A,B02,083780,Greenfeld; Be'Eri,1,0,36,35
1656271387015,MATH 103A,B03,093562,Staff,0,0,36,36
1656271393037,MATH 105,A01,085443,Carter; Anne Toulson,5,0,35,30
1656271393037,MATH 105,A02,093477,Staff,14,0,35,21
1656271399132,MATH 109,A01,083213,Ganzberger; Geoffrey Michael,1,0,34,33
1656271399132,MATH 109,A02,083214,Ganzberger; Geoffrey Michael,0,0,34,34
1656271399132,MATH 109,A03,093478,Staff,1,0,34,33
1656271399132,MATH 109,B01,083215,Ganzberger; Geoffrey Michael,4,0,32,28
1656271399132,MATH 109,B02,083216,Ganzberger; Geoffrey Michael,1,0,32,31
1656271399132,MATH 109,B03,093479,Staff,3,0,32,29
1656271405156,MATH 142A,A01,083219,Chow; Bennett,2,0,32,30
1656271405156,MATH 142A,A02,083220,Chow; Bennett,8,0,32,24
1656271405156,MATH 142A,A03,093480,Staff,5,0,32,27
1656271405156,MATH 142A,B03,093481,Staff,3,0,32,29
1656271405156,MATH 142A,B04,093558,Staff,6,0,32,26
1656271405156,MATH 142A,B05,093559,Staff,0,0,32,32
1656271411182,MATH 193A,A01,083224,Rotar; Vladimir,0,1,34,34
1656271411182,MATH 193A,A02,083225,Rotar; Vladimir,0,0,34,34
1656271411182,MATH 193A,A03,083781,Rotar; Vladimir,0,0,34,34
1656271411182,MATH 193A,A04,083782,Rotar; Vladimir,6,0,34,28
1656271411182,MATH 193A,A05,093482,Rotar; Vladimir,0,0,34,34
1656271417205,MATH 197,001,091859,McAuley; Julian John,9999,0,9999,0
1656271417205,MATH 197,002,095566,Kedlaya; Kiran S.,9997,0,9999,2
1656271417205,MATH 197,003,095567,Xiao; Ming,9999,0,9999,0
1656271417205,MATH 197,004,095571,Perols; Johan Lars,9998,0,9999,1
1656271424256,COGS 9,A01,083615,Shannon; Kyle Michael,4,0,75,71
1656271430290,COGS 11,A01,083617,Boyle; Mary E. T.,14,0,48,34
1656271436313,COGS 13,A01,083071,Bastos; Amalia Pinkusfeld,4,0,71,67
1656271442336,COGS 14A,A01,092681,Semenuks; Arturs,1,12,100,99
1656271448358,COGS 14B,A01,083073,Cheng; Tzu-Han,7,0,63,56
1656271454382,COGS 17,A01,092677,Semenuks; Arturs,8,0,81,73
1656271460409,COGS 100,A01,083619,Allen; Michael Gordon,2,0,70,68
1656271466442,COGS 101A,A01,083621,Davis; Joshua Daniel,4,0,68,64
1656271472468,COGS 101B,A01,091572,Allen; Michael Gordon,4,0,65,61
1656271478495,COGS 101C,A01,083625,Delgado; Tania,10,0,35,25
1656271484521,COGS 107A,A01,083627,Boyle; Mary E. T.,0,0,60,60
1656271490548,COGS 118A,A01,083075,Gupta; Anjum,8,0,76,68
1656271496572,CSE 3,A50,083646,Miranda; Gregory Joseph,18,0,50,32
1656271502599,CSE 8A,A50,083650,Miranda; Gregory Joseph,2,2,56,54
1656271508626,CSE 11,A01,083080,Cao; Yingjun,0,49,40,40
1656271514653,CSE 12,A01,083652,Krause-Levy; Sophia Louisa,5,1,120,115
1656271520681,CSE 15L,A01,083654,Morris; Justin Loren,2,0,50,48
1656271520681,CSE 15L,A02,083655,Morris; Justin Loren,4,0,50,46
1656271526709,CSE 20,A01,083657,Tran; Khoa Dang,30,0,80,50
1656271532733,CSE 21,A01,095574,Bach; Quang Tran,23,0,48,25
1656271538761,CSE 30,A01,083084,Eldon; John,2,6,80,78
1656271538761,CSE 30,B01,095061,Bhaskar; Nishant,0,1,50,50
1656271544788,CSE 100,A01,083659,Cao; Yingjun,1,18,70,69
1656271550815,CSE 134B,A01,083661,Powell; Thomas Allan,5,0,100,95
1656271556842,CSE 140,A01,083663,Gungor; Onat,9,0,85,76
1656271562866,CSE 140L,A01,083088,Eldon; John,8,0,100,92
1656271568897,CSE 175,A01,083665,Kumar; Rakesh,0,0,25,25
1656271574920,CSE 190,A00,092507,Dubnov; Shlomo,3,0,20,17
1656271580946,ECE 45,A01,083139,Congero; Spencer William,1,0,75,74
1656271586977,ECE 65,A50,083695,Saad; Andrew S,9,0,30,21
1656271586977,ECE 65,A51,095125,Staff,24,0,26,2
1656271593001,ECE 109,A01,091882,Touri; Behrouz,0,1,70,70
1656271599035,ECE 180,A00,083140,Abi Samra; Nicholas Camill,1,0,30,29
1656271599035,ECE 180,B00,083141,Abi Samra; Nicholas Camill,0,4,30,30
1656271605059,MATH 10A,A01,083735,Patchell; Gregory David,0,0,30,30
1656271605059,MATH 10A,A02,083736,Patchell; Gregory David,22,0,30,8
1656271605059,MATH 10A,A03,083737,Patchell; Gregory David,16,0,30,14
1656271611083,MATH 10B,A01,083207,Lim; Seonhee,0,0,34,34
1656271611083,MATH 10B,A02,083208,Lim; Seonhee,7,0,35,28
1656271611083,MATH 10B,A03,093472,Staff,1,0,34,33
1656271611083,MATH 10B,B01,083739,Sinha; Shubham,11,0,30,19
1656271617109,MATH 18,A01,083743,Cinel; Cameron Alexander,7,0,30,23
1656271617109,MATH 18,A02,083744,Cinel; Cameron Alexander,9,0,30,21
1656271617109,MATH 18,A03,083745,Cinel; Cameron Alexander,5,0,30,25
1656271617109,MATH 18,B01,083748,Rideout; David Porter,1,0,36,35
1656271617109,MATH 18,B02,083749,Rideout; David Porter,0,0,36,36
1656271617109,MATH 18,B03,083750,Rideout; David Porter,0,0,36,36
1656271617109,MATH 18,B04,083751,Rideout; David Porter,0,1,36,36
1656271617109,MATH 18,B05,093473,Rideout; David Porter,0,0,36,36
1656271617109,MATH 18,B06,093474,Rideout; David Porter,3,0,36,33
1656271623136,MATH 20A,A01,083754,Zheng; Zequn,11,0,40,29
1656271629160,MATH 20B,A01,083756,Briones; Jor-el Thomas Caparas,0,0,36,36
1656271629160,MATH 20B,A02,083757,Briones; Jor-el Thomas Caparas,0,0,36,36
1656271629160,MATH 20B,A03,093475,Staff,0,0,36,36
1656271635184,MATH 20C,A01,083760,Briones; Jor-el Thomas Caparas,0,0,35,35
1656271635184,MATH 20C,A02,083761,Briones; Jor-el Thomas Caparas,9,1,35,26
1656271635184,MATH 20C,A03,093476,Staff,0,0,35,35
1656271635184,MATH 20C,B01,083762,Bach; Quang Tran,1,0,30,29
1656271641209,MATH 20D,A01,083765,Tran; Brian Kha,1,0,30,29
1656271641209,MATH 20D,A02,083766,Tran; Brian Kha,0,1,30,30
1656271641209,MATH 20D,A03,083767,Tran; Brian Kha,2,0,30,28
1656271647238,MATH 20E,A01,083771,Ganguly; Soumya,3,0,32,29
1656271647238,MATH 20E,A02,083772,Ganguly; Soumya,0,0,32,32
1656271647238,MATH 20E,B01,083773,Ciotti; Benjamin,16,0,35,19
1656271647238,MATH 20E,B02,083774,Ciotti; Benjamin,15,0,35,20
1656271653262,MATH 103A,A01,083777,Greenfeld; Be'Eri,1,0,36,35
1656271653262,MATH 103A,A02,083778,Greenfeld; Be'Eri,1,0,36,35
1656271653262,MATH 103A,A03,093561,Staff,5,0,36,31
1656271653262,MATH 103A,B01,083779,Greenfeld; Be'Eri,8,0,36,28
1656271653262,MATH 103A,B02,083780,Greenfeld; Be'Eri,1,0,36,35
1656271653262,MATH 103A,B03,093562,Staff,0,0,36,36
1656271659289,MATH 105,A01,085443,Carter; Anne Toulson,5,0,35,30
1656271659289,MATH 105,A02,093477,Staff,14,0,35,21
1656271665313,MATH 109,A01,083213,Ganzberger; Geoffrey Michael,1,0,34,33
1656271665313,MATH 109,A02,083214,Ganzberger; Geoffrey Michael,0,0,34,34
1656271665313,MATH 109,A03,093478,Staff,1,0,34,33
1656271665313,MATH 109,B01,083215,Ganzberger; Geoffrey Michael,4,0,32,28
1656271665313,MATH 109,B02,083216,Ganzberger; Geoffrey Michael,1,0,32,31
1656271665313,MATH 109,B03,093479,Staff,3,0,32,29
1656271671340,MATH 142A,A01,083219,Chow; Bennett,2,0,32,30
1656271671340,MATH 142A,A02,083220,Chow; Bennett,8,0,32,24
1656271671340,MATH 142A,A03,093480,Staff,5,0,32,27
1656271671340,MATH 142A,B03,093481,Staff,3,0,32,29
1656271671340,MATH 142A,B04,093558,Staff,6,0,32,26
1656271671340,MATH 142A,B05,093559,Staff,0,0,32,32
1656271677365,MATH 193A,A01,083224,Rotar; Vladimir,0,1,34,34
1656271677365,MATH 193A,A02,083225,Rotar; Vladimir,0,0,34,34
1656271677365,MATH 193A,A03,083781,Rotar; Vladimir,0,0,34,34
1656271677365,MATH 193A,A04,083782,Rotar; Vladimir,6,0,34,28
1656271677365,MATH 193A,A05,093482,Rotar; Vladimir,0,0,34,34
1656271683389,MATH 197,001,091859,McAuley; Julian John,9999,0,9999,0
1656271683389,MATH 197,002,095566,Kedlaya; Kiran S.,9997,0,9999,2
1656271683389,MATH 197,003,095567,Xiao; Ming,9999,0,9999,0
1656271683389,MATH 197,004,095571,Perols; Johan Lars,9998,0,9999,1
1656271690451,COGS 9,A01,083615,Shannon; Kyle Michael,4,0,75,71
1656271696477,COGS 11,A01,083617,Boyle; Mary E. T.,14,0,48,34
1656271702502,COGS 13,A01,083071,Bastos; Amalia Pinkusfeld,4,0,71,67
1656271708528,COGS 14A,A01,092681,Semenuks; Arturs,1,12,100,99
1656271714555,COGS 14B,A01,083073,Cheng; Tzu-Han,7,0,63,56
1656271720577,COGS 17,A01,092677,Semenuks; Arturs,8,0,81,73
1656271726602,COGS 100,A01,083619,Allen; Michael Gordon,2,0,70,68
1656271732624,COGS 101A,A01,083621,Davis; Joshua Daniel,4,0,68,64
1656271738650,COGS 101B,A01,091572,Allen; Michael Gordon,4,0,65,61
1656271744671,COGS 101C,A01,083625,Delgado; Tania,10,0,35,25
1656271750694,COGS 107A,A01,083627,Boyle; Mary E. T.,0,0,60,60
1656271756718,COGS 118A,A01,083075,Gupta; Anjum,8,0,76,68
1656271762746,CSE 3,A50,083646,Miranda; Gregory Joseph,18,0,50,32
1656271768782,CSE 8A,A50,083650,Miranda; Gregory Joseph,2,2,56,54
1656271774811,CSE 11,A01,083080,Cao; Yingjun,0,49,40,40
1656271780834,CSE 12,A01,083652,Krause-Levy; Sophia Louisa,5,1,120,115
1656271786857,CSE 15L,A01,083654,Morris; Justin Loren,2,0,50,48
1656271786857,CSE 15L,A02,083655,Morris; Justin Loren,4,0,50,46
1656271792884,CSE 20,A01,083657,Tran; Khoa Dang,30,0,80,50
1656271798911,CSE 21,A01,095574,Bach; Quang Tran,23,0,48,25
1656271804934,CSE 30,A01,083084,Eldon; John,2,6,80,78
1656271804934,CSE 30,B01,095061,Bhaskar; Nishant,0,1,50,50
1656271810957,CSE 100,A01,083659,Cao; Yingjun,1,18,70,69
1656271816985,CSE 134B,A01,083661,Powell; Thomas Allan,5,0,100,95
1656271823012,CSE 140,A01,083663,Gungor; Onat,9,0,85,76
1656271829035,CSE 140L,A01,083088,Eldon; John,8,0,100,92
1656271835061,CSE 175,A01,083665,Kumar; Rakesh,0,0,25,25
1656271841091,CSE 190,A00,092507,Dubnov; Shlomo,3,0,20,17
1656271847124,ECE 45,A01,083139,Congero; Spencer William,1,0,75,74
1656271853148,ECE 65,A50,083695,Saad; Andrew S,9,0,30,21
1656271853148,ECE 65,A51,095125,Staff,24,0,26,2
1656271859173,ECE 109,A01,091882,Touri; Behrouz,0,1,70,70
1656271865199,ECE 180,A00,083140,Abi Samra; Nicholas Camill,1,0,30,29
1656271865199,ECE 180,B00,083141,Abi Samra; Nicholas Camill,0,4,30,30
1656271871231,MATH 10A,A01,083735,Patchell; Gregory David,0,0,30,30
1656271871231,MATH 10A,A02,083736,Patchell; Gregory David,22,0,30,8
1656271871231,MATH 10A,A03,083737,Patchell; Gregory David,16,0,30,14
1656271877256,MATH 10B,A01,083207,Lim; Seonhee,0,0,34,34
1656271877256,MATH 10B,A02,083208,Lim; Seonhee,7,0,35,28
1656271877256,MATH 10B,A03,093472,Staff,1,0,34,33
1656271877256,MATH 10B,B01,083739,Sinha; Shubham,11,0,30,19
1656271883287,MATH 18,A01,083743,Cinel; Cameron Alexander,7,0,30,23
1656271883287,MATH 18,A02,083744,Cinel; Cameron Alexander,9,0,30,21
1656271883287,MATH 18,A03,083745,Cinel; Cameron Alexander,5,0,30,25
1656271883287,MATH 18,B01,083748,Rideout; David Porter,1,0,36,35
1656271883287,MATH 18,B02,083749,Rideout; David Porter,0,0,36,36
1656271883287,MATH 18,B03,083750,Rideout; David Porter,0,0,36,36
1656271883287,MATH 18,B04,083751,Rideout; David Porter,0,1,36,36
1656271883287,MATH 18,B05,093473,Rideout; David Porter,0,0,36,36
1656271883287,MATH 18,B06,093474,Rideout; David Porter,3,0,36,33
1656271889314,MATH 20A,A01,083754,Zheng; Zequn,11,0,40,29
1656271895342,MATH 20B,A01,083756,Briones; Jor-el Thomas Caparas,0,0,36,36
1656271895342,MATH 20B,A02,083757,Briones; Jor-el Thomas Caparas,0,0,36,36
1656271895342,MATH 20B,A03,093475,Staff,0,0,36,36
1656271901366,MATH 20C,A01,083760,Briones; Jor-el Thomas Caparas,0,0,35,35
1656271901366,MATH 20C,A02,083761,Briones; Jor-el Thomas Caparas,9,1,35,26
1656271901366,MATH 20C,A03,093476,Staff,0,0,35,35
1656271901366,MATH 20C,B01,083762,Bach; Quang Tran,1,0,30,29
1656271907390,MATH 20D,A01,083765,Tran; Brian Kha,1,0,30,29
1656271907390,MATH 20D,A02,083766,Tran; Brian Kha,0,1,30,30
1656271907390,MATH 20D,A03,083767,Tran; Brian Kha,2,0,30,28
1656271913417,MATH 20E,A01,083771,Ganguly; Soumya,3,0,32,29
1656271913417,MATH 20E,A02,083772,Ganguly; Soumya,0,0,32,32
1656271913417,MATH 20E,B01,083773,Ciotti; Benjamin,16,0,35,19
1656271913417,MATH 20E,B02,083774,Ciotti; Benjamin,15,0,35,20
1656271919446,MATH 103A,A01,083777,Greenfeld; Be'Eri,1,0,36,35
1656271919446,MATH 103A,A02,083778,Greenfeld; Be'Eri,1,0,36,35
1656271919446,MATH 103A,A03,093561,Staff,5,0,36,31
1656271919446,MATH 103A,B01,083779,Greenfeld; Be'Eri,8,0,36,28
1656271919446,MATH 103A,B02,083780,Greenfeld; Be'Eri,1,0,36,35
1656271919446,MATH 103A,B03,093562,Staff,0,0,36,36
1656271925470,MATH 105,A01,085443,Carter; Anne Toulson,5,0,35,30
1656271925470,MATH 105,A02,093477,Staff,14,0,35,21
1656271931499,MATH 109,A01,083213,Ganzberger; Geoffrey Michael,1,0,34,33
1656271931499,MATH 109,A02,083214,Ganzberger; Geoffrey Michael,0,0,34,34
1656271931499,MATH 109,A03,093478,Staff,1,0,34,33
1656271931499,MATH 109,B01,083215,Ganzberger; Geoffrey Michael,4,0,32,28
1656271931499,MATH 109,B02,083216,Ganzberger; Geoffrey Michael,1,0,32,31
1656271931499,MATH 109,B03,093479,Staff,3,0,32,29
1656271937523,MATH 142A,A01,083219,Chow; Bennett,2,0,32,30
1656271937523,MATH 142A,A02,083220,Chow; Bennett,8,0,32,24
1656271937523,MATH 142A,A03,093480,Staff,5,0,32,27
1656271937523,MATH 142A,B03,093481,Staff,3,0,32,29
1656271937523,MATH 142A,B04,093558,Staff,6,0,32,26
1656271937523,MATH 142A,B05,093559,Staff,0,0,32,32
1656271943546,MATH 193A,A01,083224,Rotar; Vladimir,0,1,34,34
1656271943546,MATH 193A,A02,083225,Rotar; Vladimir,0,0,34,34
1656271943546,MATH 193A,A03,083781,Rotar; Vladimir,0,0,34,34
1656271943546,MATH 193A,A04,083782,Rotar; Vladimir,6,0,34,28
1656271943546,MATH 193A,A05,093482,Rotar; Vladimir,0,0,34,34
1656271949568,MATH 197,001,091859,McAuley; Julian John,9999,0,9999,0
1656271949568,MATH 197,002,095566,Kedlaya; Kiran S.,9997,0,9999,2
1656271949568,MATH 197,003,095567,Xiao; Ming,9999,0,9999,0
1656271949568,MATH 197,004,095571,Perols; Johan Lars,9998,0,9999,1
1656271956635,COGS 9,A01,083615,Shannon; Kyle Michael,4,0,75,71
1656271962661,COGS 11,A01,083617,Boyle; Mary E. T.,14,0,48,34
1656271968685,COGS 13,A01,083071,Bastos; Amalia Pinkusfeld,4,0,71,67
1656271974712,COGS 14A,A01,092681,Semenuks; Arturs,1,12,100,99
1656271980739,COGS 14B,A01,083073,Cheng; Tzu-Han,7,0,63,56
1656271986766,COGS 17,A01,092677,Semenuks; Arturs,8,0,81,73
1656271992861,COGS 100,A01,083619,Allen; Michael Gordon,2,0,70,68
1656271998885,COGS 101A,A01,083621,Davis; Joshua Daniel,4,0,68,64
1656272004908,COGS 101B,A01,091572,Allen; Michael Gordon,4,0,65,61
1656272010932,COGS 101C,A01,083625,Delgado; Tania,10,0,35,25
1656272016956,COGS 107A,A01,083627,Boyle; Mary E. T.,0,0,60,60
1656272022978,COGS 118A,A01,083075,Gupta; Anjum,8,0,76,68
1656272029004,CSE 3,A50,083646,Miranda; Gregory Joseph,18,0,50,32
1656272035032,CSE 8A,A50,083650,Miranda; Gregory Joseph,2,2,56,54
1656272041055,CSE 11,A01,083080,Cao; Yingjun,0,49,40,40
1656272047082,CSE 12,A01,083652,Krause-Levy; Sophia Louisa,5,1,120,115
1656272053106,CSE 15L,A01,083654,Morris; Justin Loren,2,0,50,48
1656272053106,CSE 15L,A02,083655,Morris; Justin Loren,4,0,50,46
1656272059129,CSE 20,A01,083657,Tran; Khoa Dang,30,0,80,50
1656272065151,CSE 21,A01,095574,Bach; Quang Tran,23,0,48,25
1656272071181,CSE 30,A01,083084,Eldon; John,2,6,80,78
1656272071181,CSE 30,B01,095061,Bhaskar; Nishant,0,1,50,50
1656272077204,CSE 100,A01,083659,Cao; Yingjun,1,18,70,69
1656272083231,CSE 134B,A01,083661,Powell; Thomas Allan,5,0,100,95
1656272089258,CSE 140,A01,083663,Gungor; Onat,9,0,85,76
1656272095281,CSE 140L,A01,083088,Eldon; John,8,0,100,92
1656272101323,CSE 175,A01,083665,Kumar; Rakesh,0,0,25,25
1656272107348,CSE 190,A00,092507,Dubnov; Shlomo,3,0,20,17
1656272113372,ECE 45,A01,083139,Congero; Spencer William,1,0,75,74
1656272119399,ECE 65,A50,083695,Saad; Andrew S,9,0,30,21
1656272119399,ECE 65,A51,095125,Staff,24,0,26,2
1656272125421,ECE 109,A01,091882,Touri; Behrouz,0,1,70,70
1656272131445,ECE 180,A00,083140,Abi Samra; Nicholas Camill,1,0,30,29
1656272131445,ECE 180,B00,083141,Abi Samra; Nicholas Camill,0,4,30,30
1656272137467,MATH 10A,A01,083735,Patchell; Gregory David,0,0,30,30
1656272137467,MATH 10A,A02,083736,Patchell; Gregory David,22,0,30,8
1656272137467,MATH 10A,A03,083737,Patchell; Gregory David,16,0,30,14
1656272143499,MATH 10B,A01,083207,Lim; Seonhee,0,0,34,34
1656272143499,MATH 10B,A02,083208,Lim; Seonhee,7,0,35,28
1656272143499,MATH 10B,A03,093472,Staff,1,0,34,33
1656272143499,MATH 10B,B01,083739,Sinha; Shubham,11,0,30,19
1656272149528,MATH 18,A01,083743,Cinel; Cameron Alexander,7,0,30,23
1656272149528,MATH 18,A02,083744,Cinel; Cameron Alexander,9,0,30,21
1656272149528,MATH 18,A03,083745,Cinel; Cameron Alexander,5,0,30,25
1656272149528,MATH 18,B01,083748,Rideout; David Porter,1,0,36,35
1656272149528,MATH 18,B02,083749,Rideout; David Porter,0,0,36,36
1656272149528,MATH 18,B03,083750,Rideout; David Porter,0,0,36,36
1656272149528,MATH 18,B04,083751,Rideout; David Porter,0,1,36,36
1656272149528,MATH 18,B05,093473,Rideout; David Porter,0,0,36,36
1656272149528,MATH 18,B06,093474,Rideout; David Porter,3,0,36,33
1656272155556,MATH 20A,A01,083754,Zheng; Zequn,11,0,40,29
1656272161582,MATH 20B,A01,083756,Briones; Jor-el Thomas Caparas,0,0,36,36
1656272161582,MATH 20B,A02,083757,Briones; Jor-el Thomas Caparas,0,0,36,36
1656272161582,MATH 20B,A03,093475,Staff,0,0,36,36
1656272167603,MATH 20C,A01,083760,Briones; Jor-el Thomas Caparas,0,0,35,35
1656272167603,MATH 20C,A02,083761,Briones; Jor-el Thomas Caparas,9,1,35,26
1656272167603,MATH 20C,A03,093476,Staff,0,0,35,35
1656272167603,MATH 20C,B01,083762,Bach; Quang Tran,1,0,30,29
1656272173644,MATH 20D,A01,083765,Tran; Brian Kha,1,0,30,29
1656272173644,MATH 20D,A02,083766,Tran; Brian Kha,0,1,30,30
1656272173644,MATH 20D,A03,083767,Tran; Brian Kha,2,0,30,28
1656272179669,MATH 20E,A01,083771,Ganguly; Soumya,3,0,32,29
1656272179669,MATH 20E,A02,083772,Ganguly; Soumya,0,0,32,32
1656272179669,MATH 20E,B01,083773,Ciotti; Benjamin,16,0,35,19
1656272179669,MATH 20E,B02,083774,Ciotti; Benjamin,15,0,35,20
1656272185700,MATH 103A,A01,083777,Greenfeld; Be'Eri,1,0,36,35
1656272185700,MATH 103A,A02,083778,Greenfeld; Be'Eri,1,0,36,35
1656272185700,MATH 103A,A03,093561,Staff,5,0,36,31
1656272185700,MATH 103A,B01,083779,Greenfeld; Be'Eri,8,0,36,28
1656272185700,MATH 103A,B02,083780,Greenfeld; Be'Eri,1,0,36,35
1656272185700,MATH 103A,B03,093562,Staff,0,0,36,36
1656272191727,MATH 105,A01,085443,Carter; Anne Toulson,5,0,35,30
1656272191727,MATH 105,A02,093477,Staff,14,0,35,21
1656272197752,MATH 109,A01,083213,Ganzberger; Geoffrey Michael,1,0,34,33
1656272197752,MATH 109,A02,083214,Ganzberger; Geoffrey Michael,0,0,34,34
1656272197752,MATH 109,A03,093478,Staff,1,0,34,33
1656272197752,MATH 109,B01,083215,Ganzberger; Geoffrey Michael,4,0,32,28
1656272197752,MATH 109,B02,083216,Ganzberger; Geoffrey Michael,1,0,32,31
1656272197752,MATH 109,B03,093479,Staff,3,0,32,29
1656272203781,MATH 142A,A01,083219,Chow; Bennett,2,0,32,30
1656272203781,MATH 142A,A02,083220,Chow; Bennett,8,0,32,24
1656272203781,MATH 142A,A03,093480,Staff,5,0,32,27
1656272203781,MATH 142A,B03,093481,Staff,3,0,32,29
1656272203781,MATH 142A,B04,093558,Staff,6,0,32,26
1656272203781,MATH 142A,B05,093559,Staff,0,0,32,32
1656272209809,MATH 193A,A01,083224,Rotar; Vladimir,0,1,34,34
1656272209809,MATH 193A,A02,083225,Rotar; Vladimir,0,0,34,34
1656272209809,MATH 193A,A03,083781,Rotar; Vladimir,0,0,34,34
1656272209809,MATH 193A,A04,083782,Rotar; Vladimir,6,0,34,28
1656272209809,MATH 193A,A05,093482,Rotar; Vladimir,0,0,34,34
1656272215832,MATH 197,001,091859,McAuley; Julian John,9999,0,9999,0
1656272215832,MATH 197,002,095566,Kedlaya; Kiran S.,9997,0,9999,2
1656272215832,MATH 197,003,095567,Xiao; Ming,9999,0,9999,0
1656272215832,MATH 197,004,095571,Perols; Johan Lars,9998,0,9999,1
1656272222889,COGS 9,A01,083615,Shannon; Kyle Michael,4,0,75,71
1656272228913,COGS 11,A01,083617,Boyle; Mary E. T.,14,0,48,34
1656272234940,COGS 13,A01,083071,Bastos; Amalia Pinkusfeld,4,0,71,67
1656272240967,COGS 14A,A01,092681,Semenuks; Arturs,1,12,100,99
1656272246992,COGS 14B,A01,083073,Cheng; Tzu-Han,7,0,63,56
1656272253014,COGS 17,A01,092677,Semenuks; Arturs,8,0,81,73
1656272259037,COGS 100,A01,083619,Allen; Michael Gordon,2,0,70,68
1656272265061,COGS 101A,A01,083621,Davis; Joshua Daniel,4,0,68,64
1656272271089,COGS 101B,A01,091572,Allen; Michael Gordon,4,0,65,61
1656272277116,COGS 101C,A01,083625,Delgado; Tania,10,0,35,25
1656272283139,COGS 107A,A01,083627,Boyle; Mary E. T.,0,0,60,60
1656272289169,COGS 118A,A01,083075,Gupta; Anjum,8,0,76,68
1656272295194,CSE 3,A50,083646,Miranda; Gregory Joseph,18,0,50,32
1656272301254,CSE 8A,A50,083650,Miranda; Gregory Joseph,2,2,56,54
1656272307279,CSE 11,A01,083080,Cao; Yingjun,0,49,40,40
1656272313310,CSE 12,A01,083652,Krause-Levy; Sophia Louisa,5,1,120,115
1656272319334,CSE 15L,A01,083654,Morris; Justin Loren,2,0,50,48
1656272319334,CSE 15L,A02,083655,Morris; Justin Loren,4,0,50,46
1656272325362,CSE 20,A01,083657,Tran; Khoa Dang,30,0,80,50
1656272331388,CSE 21,A01,095574,Bach; Quang Tran,23,0,48,25
1656272337412,CSE 30,A01,083084,Eldon; John,2,6,80,78
1656272337412,CSE 30,B01,095061,Bhaskar; Nishant,0,1,50,50
1656272343435,CSE 100,A01,083659,Cao; Yingjun,1,18,70,69
1656272349458,CSE 134B,A01,083661,Powell; Thomas Allan,5,0,100,95
1656272355481,CSE 140,A01,083663,Gungor; Onat,9,0,85,76
1656272361504,CSE 140L,A01,083088,Eldon; John,8,0,100,92
1656272367529,CSE 175,A01,083665,Kumar; Rakesh,0,0,25,25
1656272373560,CSE 190,A00,092507,Dubnov; Shlomo,3,0,20,17
1656272379590,ECE 45,A01,083139,Congero; Spencer William,1,0,75,74
1656272385618,ECE 65,A50,083695,Saad; Andrew S,9,0,30,21
1656272385618,ECE 65,A51,095125,Staff,24,0,26,2
1656272391641,ECE 109,A01,091882,Touri; Behrouz,0,1,70,70
1656272397664,ECE 180,A00,083140,Abi Samra; Nicholas Camill,1,0,30,29
1656272397664,ECE 180,B00,083141,Abi Samra; Nicholas Camill,0,4,30,30
1656272403691,MATH 10A,A01,083735,Patchell; Gregory David,0,0,30,30
1656272403691,MATH 10A,A02,083736,Patchell; Gregory David,22,0,30,8
1656272403691,MATH 10A,A03,083737,Patchell; Gregory David,16,0,30,14
1656272409719,MATH 10B,A01,083207,Lim; Seonhee,0,0,34,34
1656272409719,MATH 10B,A02,083208,Lim; Seonhee,7,0,35,28
1656272409719,MATH 10B,A03,093472,Staff,1,0,34,33
1656272409719,MATH 10B,B01,083739,Sinha; Shubham,11,0,30,19
1656272415750,MATH 18,A01,083743,Cinel; Cameron Alexander,7,0,30,23
1656272415750,MATH 18,A02,083744,Cinel; Cameron Alexander,9,0,30,21
1656272415750,MATH 18,A03,083745,Cinel; Cameron Alexander,5,0,30,25
1656272415750,MATH 18,B01,083748,Rideout; David Porter,1,0,36,35
1656272415750,MATH 18,B02,083749,Rideout; David Porter,0,0,36,36
1656272415750,MATH 18,B03,083750,Rideout; David Porter,0,0,36,36
1656272415750,MATH 18,B04,083751,Rideout; David Porter,0,1,36,36
1656272415750,MATH 18,B05,093473,Rideout; David Porter,0,0,36,36
1656272415750,MATH 18,B06,093474,Rideout; David Porter,3,0,36,33
1656272421774,MATH 20A,A01,083754,Zheng; Zequn,11,0,40,29
1656272427800,MATH 20B,A01,083756,Briones; Jor-el Thomas Caparas,0,0,36,36
1656272427800,MATH 20B,A02,083757,Briones; Jor-el Thomas Caparas,0,0,36,36
1656272427800,MATH 20B,A03,093475,Staff,0,0,36,36
1656272433829,MATH 20C,A01,083760,Briones; Jor-el Thomas Caparas,0,0,35,35
1656272433829,MATH 20C,A02,083761,Briones; Jor-el Thomas Caparas,9,1,35,26
1656272433829,MATH 20C,A03,093476,Staff,0,0,35,35
1656272433829,MATH 20C,B01,083762,Bach; Quang Tran,1,0,30,29
1656272439853,MATH 20D,A01,083765,Tran; Brian Kha,1,0,30,29
1656272439853,MATH 20D,A02,083766,Tran; Brian Kha,0,1,30,30
1656272439853,MATH 20D,A03,083767,Tran; Brian Kha,2,0,30,28
1656272445881,MATH 20E,A01,083771,Ganguly; Soumya,3,0,32,29
1656272445881,MATH 20E,A02,083772,Ganguly; Soumya,0,0,32,32
1656272445881,MATH 20E,B01,083773,Ciotti; Benjamin,16,0,35,19
1656272445881,MATH 20E,B02,083774,Ciotti; Benjamin,15,0,35,20
1656272451906,MATH 103A,A01,083777,Greenfeld; Be'Eri,1,0,36,35
1656272451906,MATH 103A,A02,083778,Greenfeld; Be'Eri,1,0,36,35
1656272451906,MATH 103A,A03,093561,Staff,5,0,36,31
1656272451906,MATH 103A,B01,083779,Greenfeld; Be'Eri,8,0,36,28
1656272451906,MATH 103A,B02,083780,Greenfeld; Be'Eri,1,0,36,35
1656272451906,MATH 103A,B03,093562,Staff,0,0,36,36
1656272457934,MATH 105,A01,085443,Carter; Anne Toulson,5,0,35,30
1656272457934,MATH 105,A02,093477,Staff,14,0,35,21
1656272463957,MATH 109,A01,083213,Ganzberger; Geoffrey Michael,1,0,34,33
1656272463957,MATH 109,A02,083214,Ganzberger; Geoffrey Michael,0,0,34,34
1656272463957,MATH 109,A03,093478,Staff,1,0,34,33
1656272463957,MATH 109,B01,083215,Ganzberger; Geoffrey Michael,4,0,32,28
1656272463957,MATH 109,B02,083216,Ganzberger; Geoffrey Michael,1,0,32,31
1656272463957,MATH 109,B03,093479,Staff,3,0,32,29
1656272469984,MATH 142A,A01,083219,Chow; Bennett,2,0,32,30
1656272469984,MATH 142A,A02,083220,Chow; Bennett,8,0,32,24
1656272469984,MATH 142A,A03,093480,Staff,5,0,32,27
1656272469984,MATH 142A,B03,093481,Staff,3,0,32,29
1656272469984,MATH 142A,B04,093558,Staff,6,0,32,26
1656272469984,MATH 142A,B05,093559,Staff,0,0,32,32
1656272476008,MATH 193A,A01,083224,Rotar; Vladimir,0,1,34,34
1656272476008,MATH 193A,A02,083225,Rotar; Vladimir,0,0,34,34
1656272476008,MATH 193A,A03,083781,Rotar; Vladimir,0,0,34,34
1656272476008,MATH 193A,A04,083782,Rotar; Vladimir,6,0,34,28
1656272476008,MATH 193A,A05,093482,Rotar; Vladimir,0,0,34,34
1656272482045,MATH 197,001,091859,McAuley; Julian John,9999,0,9999,0
1656272482045,MATH 197,002,095566,Kedlaya; Kiran S.,9997,0,9999,2
1656272482045,MATH 197,003,095567,Xiao; Ming,9999,0,9999,0
1656272482045,MATH 197,004,095571,Perols; Johan Lars,9998,0,9999,1
1656272489107,COGS 9,A01,083615,Shannon; Kyle Michael,4,0,75,71
1656272495133,COGS 11,A01,083617,Boyle; Mary E. T.,14,0,48,34
1656272501162,COGS 13,A01,083071,Bastos; Amalia Pinkusfeld,4,0,71,67
1656272507186,COGS 14A,A01,092681,Semenuks; Arturs,1,12,100,99
1656272513210,COGS 14B,A01,083073,Cheng; Tzu-Han,7,0,63,56
1656272519232,COGS 17,A01,092677,Semenuks; Arturs,8,0,81,73
1656272525275,COGS 100,A01,083619,Allen; Michael Gordon,2,0,70,68
1656272531300,COGS 101A,A01,083621,Davis; Joshua Daniel,4,0,68,64
1656272537325,COGS 101B,A01,091572,Allen; Michael Gordon,4,0,65,61
1656272543352,COGS 101C,A01,083625,Delgado; Tania,10,0,35,25
1656272549377,COGS 107A,A01,083627,Boyle; Mary E. T.,0,0,60,60
1656272555401,COGS 118A,A01,083075,Gupta; Anjum,8,0,76,68
1656272561430,CSE 3,A50,083646,Miranda; Gregory Joseph,18,0,50,32
1656272567454,CSE 8A,A50,083650,Miranda; Gregory Joseph,2,2,56,54
1656272573480,CSE 11,A01,083080,Cao; Yingjun,0,49,40,40
1656272579504,CSE 12,A01,083652,Krause-Levy; Sophia Louisa,5,1,120,115
1656272585530,CSE 15L,A01,083654,Morris; Justin Loren,2,0,50,48
1656272585530,CSE 15L,A02,083655,Morris; Justin Loren,4,0,50,46
1656272591645,CSE 20,A01,083657,Tran; Khoa Dang,30,0,80,50
1656272597669,CSE 21,A01,095574,Bach; Quang Tran,23,0,48,25
1656272603693,CSE 30,A01,083084,Eldon; John,2,6,80,78
1656272603693,CSE 30,B01,095061,Bhaskar; Nishant,0,1,50,50
1656272609717,CSE 100,A01,083659,Cao; Yingjun,1,18,70,69
1656272615745,CSE 134B,A01,083661,Powell; Thomas Allan,5,0,100,95
1656272621772,CSE 140,A01,083663,Gungor; Onat,9,0,85,76
1656272627798,CSE 140L,A01,083088,Eldon; John,8,0,100,92
1656272633824,CSE 175,A01,083665,Kumar; Rakesh,0,0,25,25
1656272639847,CSE 190,A00,092507,Dubnov; Shlomo,3,0,20,17
1656272645872,ECE 45,A01,083139,Congero; Spencer William,1,0,75,74
1656272651896,ECE 65,A50,083695,Saad; Andrew S,9,0,30,21
1656272651896,ECE 65,A51,095125,Staff,24,0,26,2
1656272657923,ECE 109,A01,091882,Touri; Behrouz,0,1,70,70
1656272663945,ECE 180,A00,083140,Abi Samra; Nicholas Camill,1,0,30,29
1656272663945,ECE 180,B00,083141,Abi Samra; Nicholas Camill,0,4,30,30
1656272669977,MATH 10A,A01,083735,Patchell; Gregory David,0,0,30,30
1656272669977,MATH 10A,A02,083736,Patchell; Gregory David,22,0,30,8
1656272669977,MATH 10A,A03,083737,Patchell; Gregory David,16,0,30,14
1656272676005,MATH 10B,A01,083207,Lim; Seonhee,0,0,34,34
1656272676005,MATH 10B,A02,083208,Lim; Seonhee,7,0,35,28
1656272676005,MATH 10B,A03,093472,Staff,1,0,34,33
1656272676005,MATH 10B,B01,083739,Sinha; Shubham,11,0,30,19
1656272682035,MATH 18,A01,083743,Cinel; Cameron Alexander,7,0,30,23
1656272682035,MATH 18,A02,083744,Cinel; Cameron Alexander,9,0,30,21
1656272682035,MATH 18,A03,083745,Cinel; Cameron Alexander,5,0,30,25
1656272682035,MATH 18,B01,083748,Rideout; David Porter,1,0,36,35
1656272682035,MATH 18,B02,083749,Rideout; David Porter,0,0,36,36
1656272682035,MATH 18,B03,083750,Rideout; David Porter,0,0,36,36
1656272682035,MATH 18,B04,083751,Rideout; David Porter,0,1,36,36
1656272682035,MATH 18,B05,093473,Rideout; David Porter,0,0,36,36
1656272682035,MATH 18,B06,093474,Rideout; David Porter,3,0,36,33
1656272688058,MATH 20A,A01,083754,Zheng; Zequn,11,0,40,29
1656272694082,MATH 20B,A01,083756,Briones; Jor-el Thomas Caparas,0,0,36,36
1656272694082,MATH 20B,A02,083757,Briones; Jor-el Thomas Caparas,0,0,36,36
1656272694082,MATH 20B,A03,093475,Staff,0,0,36,36
1656272700106,MATH 20C,A01,083760,Briones; Jor-el Thomas Caparas,0,0,35,35
1656272700106,MATH 20C,A02,083761,Briones; Jor-el Thomas Caparas,9,1,35,26
1656272700106,MATH 20C,A03,093476,Staff,0,0,35,35
1656272700106,MATH 20C,B01,083762,Bach; Quang Tran,1,0,30,29
1656272706132,MATH 20D,A01,083765,Tran; Brian Kha,1,0,30,29
1656272706132,MATH 20D,A02,083766,Tran; Brian Kha,0,1,30,30
1656272706132,MATH 20D,A03,083767,Tran; Brian Kha,2,0,30,28
1656272712169,MATH 20E,A01,083771,Ganguly; Soumya,3,0,32,29
1656272712169,MATH 20E,A02,083772,Ganguly; Soumya,0,0,32,32
1656272712169,MATH 20E,B01,083773,Ciotti; Benjamin,16,0,35,19
1656272712169,MATH 20E,B02,083774,Ciotti; Benjamin,15,0,35,20
1656272718205,MATH 103A,A01,083777,Greenfeld; Be'Eri,1,0,36,35
1656272718205,MATH 103A,A02,083778,Greenfeld; Be'Eri,1,0,36,35
1656272718205,MATH 103A,A03,093561,Staff,5,0,36,31
1656272718205,MATH 103A,B01,083779,Greenfeld; Be'Eri,8,0,36,28
1656272718205,MATH 103A,B02,083780,Greenfeld; Be'Eri,1,0,36,35
1656272718205,MATH 103A,B03,093562,Staff,0,0,36,36
1656272724230,MATH 105,A01,085443,Carter; Anne Toulson,5,0,35,30
1656272724230,MATH 105,A02,093477,Staff,14,0,35,21
1656272730256,MATH 109,A01,083213,Ganzberger; Geoffrey Michael,1,0,34,33
1656272730256,MATH 109,A02,083214,Ganzberger; Geoffrey Michael,0,0,34,34
1656272730256,MATH 109,A03,093478,Staff,1,0,34,33
1656272730256,MATH 109,B01,083215,Ganzberger; Geoffrey Michael,4,0,32,28
1656272730256,MATH 109,B02,083216,Ganzberger; Geoffrey Michael,1,0,32,31
1656272730256,MATH 109,B03,093479,Staff,3,0,32,29
1656272736280,MATH 142A,A01,083219,Chow; Bennett,2,0,32,30
1656272736280,MATH 142A,A02,083220,Chow; Bennett,8,0,32,24
1656272736280,MATH 142A,A03,093480,Staff,5,0,32,27
1656272736280,MATH 142A,B03,093481,Staff,3,0,32,29
1656272736280,MATH 142A,B04,093558,Staff,6,0,32,26
1656272736280,MATH 142A,B05,093559,Staff,0,0,32,32
1656272742309,MATH 193A,A01,083224,Rotar; Vladimir,0,1,34,34
1656272742309,MATH 193A,A02,083225,Rotar; Vladimir,0,0,34,34
1656272742309,MATH 193A,A03,083781,Rotar; Vladimir,0,0,34,34
1656272742309,MATH 193A,A04,083782,Rotar; Vladimir,6,0,34,28
1656272742309,MATH 193A,A05,093482,Rotar; Vladimir,0,0,34,34
1656272748331,MATH 197,001,091859,McAuley; Julian John,9999,0,9999,0
1656272748331,MATH 197,002,095566,Kedlaya; Kiran S.,9997,0,9999,2
1656272748331,MATH 197,003,095567,Xiao; Ming,9999,0,9999,0
1656272748331,MATH 197,004,095571,Perols; Johan Lars,9998,0,9999,1
1656272755396,COGS 9,A01,083615,Shannon; Kyle Michael,4,0,75,71
1656272761423,COGS 11,A01,083617,Boyle; Mary E. T.,14,0,48,34
1656272767445,COGS 13,A01,083071,Bastos; Amalia Pinkusfeld,4,0,71,67
1656272773468,COGS 14A,A01,092681,Semenuks; Arturs,1,12,100,99
1656272779493,COGS 14B,A01,083073,Cheng; Tzu-Han,7,0,63,56
1656272785514,COGS 17,A01,092677,Semenuks; Arturs,8,0,81,73
1656272791535,COGS 100,A01,083619,Allen; Michael Gordon,2,0,70,68
1656272797560,COGS 101A,A01,083621,Davis; Joshua Daniel,4,0,68,64
1656272803587,COGS 101B,A01,091572,Allen; Michael Gordon,4,0,65,61
1656272809610,COGS 101C,A01,083625,Delgado; Tania,10,0,35,25
1656272815637,COGS 107A,A01,083627,Boyle; Mary E. T.,0,0,60,60
1656272821661,COGS 118A,A01,083075,Gupta; Anjum,8,0,76,68
1656272827683,CSE 3,A50,083646,Miranda; Gregory Joseph,18,0,50,32
1656272833707,CSE 8A,A50,083650,Miranda; Gregory Joseph,2,2,56,54
1656272839730,CSE 11,A01,083080,Cao; Yingjun,0,49,40,40
1656272845752,CSE 12,A01,083652,Krause-Levy; Sophia Louisa,5,1,120,115
1656272851780,CSE 15L,A01,083654,Morris; Justin Loren,2,0,50,48
1656272851780,CSE 15L,A02,083655,Morris; Justin Loren,4,0,50,46
1656272857807,CSE 20,A01,083657,Tran; Khoa Dang,30,0,80,50
1656272863833,CSE 21,A01,095574,Bach; Quang Tran,23,0,48,25
1656272869860,CSE 30,A01,083084,Eldon; John,2,6,80,78
1656272869860,CSE 30,B01,095061,Bhaskar; Nishant,0,1,50,50
1656272875885,CSE 100,A01,083659,Cao; Yingjun,1,18,70,69
1656272881908,CSE 134B,A01,083661,Powell; Thomas Allan,5,0,100,95
1656272887935,CSE 140,A01,083663,Gungor; Onat,9,0,85,76
1656272893961,CSE 140L,A01,083088,Eldon; John,8,0,100,92
1656272899985,CSE 175,A01,083665,Kumar; Rakesh,0,0,25,25
1656272906011,CSE 190,A00,092507,Dubnov; Shlomo,3,0,20,17
1656272912035,ECE 45,A01,083139,Congero; Spencer William,1,0,75,74
1656272918066,ECE 65,A50,083695,Saad; Andrew S,9,0,30,21
1656272918066,ECE 65,A51,095125,Staff,24,0,26,2
1656272924092,ECE 109,A01,091882,Touri; Behrouz,0,1,70,70
1656272930115,ECE 180,A00,083140,Abi Samra; Nicholas Camill,1,0,30,29
1656272930115,ECE 180,B00,083141,Abi Samra; Nicholas Camill,0,4,30,30
1656272936144,MATH 10A,A01,083735,Patchell; Gregory David,0,0,30,30
1656272936144,MATH 10A,A02,083736,Patchell; Gregory David,22,0,30,8
1656272936144,MATH 10A,A03,083737,Patchell; Gregory David,16,0,30,14
1656272942169,MATH 10B,A01,083207,Lim; Seonhee,0,0,34,34
1656272942169,MATH 10B,A02,083208,Lim; Seonhee,7,0,35,28
1656272942169,MATH 10B,A03,093472,Staff,1,0,34,33
1656272942169,MATH 10B,B01,083739,Sinha; Shubham,11,0,30,19
1656272948199,MATH 18,A01,083743,Cinel; Cameron Alexander,7,0,30,23
1656272948199,MATH 18,A02,083744,Cinel; Cameron Alexander,9,0,30,21
1656272948199,MATH 18,A03,083745,Cinel; Cameron Alexander,5,0,30,25
1656272948199,MATH 18,B01,083748,Rideout; David Porter,1,0,36,35
1656272948199,MATH 18,B02,083749,Rideout; David Porter,0,0,36,36
1656272948199,MATH 18,B03,083750,Rideout; David Porter,0,0,36,36
1656272948199,MATH 18,B04,083751,Rideout; David Porter,0,1,36,36
1656272948199,MATH 18,B05,093473,Rideout; David Porter,0,0,36,36
1656272948199,MATH 18,B06,093474,Rideout; David Porter,3,0,36,33
1656272954222,MATH 20A,A01,083754,Zheng; Zequn,11,0,40,29
1656272960249,MATH 20B,A01,083756,Briones; Jor-el Thomas Caparas,0,0,36,36
1656272960249,MATH 20B,A02,083757,Briones; Jor-el Thomas Caparas,0,0,36,36
1656272960249,MATH 20B,A03,093475,Staff,0,0,36,36
1656272966286,MATH 20C,A01,083760,Briones; Jor-el Thomas Caparas,0,0,35,35
1656272966286,MATH 20C,A02,083761,Briones; Jor-el Thomas Caparas,9,1,35,26
1656272966286,MATH 20C,A03,093476,Staff,0,0,35,35
1656272966286,MATH 20C,B01,083762,Bach; Quang Tran,1,0,30,29
1656272972311,MATH 20D,A01,083765,Tran; Brian Kha,1,0,30,29
1656272972311,MATH 20D,A02,083766,Tran; Brian Kha,0,1,30,30
1656272972311,MATH 20D,A03,083767,Tran; Brian Kha,2,0,30,28
1656272978334,MATH 20E,A01,083771,Ganguly; Soumya,3,0,32,29
1656272978334,MATH 20E,A02,083772,Ganguly; Soumya,0,0,32,32
1656272978334,MATH 20E,B01,083773,Ciotti; Benjamin,16,0,35,19
1656272978334,MATH 20E,B02,083774,Ciotti; Benjamin,15,0,35,20
1656272984365,MATH 103A,A01,083777,Greenfeld; Be'Eri,1,0,36,35
1656272984365,MATH 103A,A02,083778,Greenfeld; Be'Eri,1,0,36,35
1656272984365,MATH 103A,A03,093561,Staff,5,0,36,31
1656272984365,MATH 103A,B01,083779,Greenfeld; Be'Eri,8,0,36,28
1656272984365,MATH 103A,B02,083780,Greenfeld; Be'Eri,1,0,36,35
1656272984365,MATH 103A,B03,093562,Staff,0,0,36,36
1656272990388,MATH 105,A01,085443,Carter; Anne Toulson,5,0,35,30
1656272990388,MATH 105,A02,093477,Staff,14,0,35,21
1656272996413,MATH 109,A01,083213,Ganzberger; Geoffrey Michael,1,0,34,33
1656272996413,MATH 109,A02,083214,Ganzberger; Geoffrey Michael,0,0,34,34
1656272996413,MATH 109,A03,093478,Staff,1,0,34,33
1656272996413,MATH 109,B01,083215,Ganzberger; Geoffrey Michael,4,0,32,28
1656272996413,MATH 109,B02,083216,Ganzberger; Geoffrey Michael,1,0,32,31
1656272996413,MATH 109,B03,093479,Staff,3,0,32,29
1656273002444,MATH 142A,A01,083219,Chow; Bennett,2,0,32,30
1656273002444,MATH 142A,A02,083220,Chow; Bennett,8,0,32,24
1656273002444,MATH 142A,A03,093480,Staff,5,0,32,27
1656273002444,MATH 142A,B03,093481,Staff,3,0,32,29
1656273002444,MATH 142A,B04,093558,Staff,6,0,32,26
1656273002444,MATH 142A,B05,093559,Staff,0,0,32,32
1656273008471,MATH 193A,A01,083224,Rotar; Vladimir,0,1,34,34
1656273008471,MATH 193A,A02,083225,Rotar; Vladimir,0,0,34,34
1656273008471,MATH 193A,A03,083781,Rotar; Vladimir,0,0,34,34
1656273008471,MATH 193A,A04,083782,Rotar; Vladimir,6,0,34,28
1656273008471,MATH 193A,A05,093482,Rotar; Vladimir,0,0,34,34
1656273014496,MATH 197,001,091859,McAuley; Julian John,9999,0,9999,0
1656273014496,MATH 197,002,095566,Kedlaya; Kiran S.,9997,0,9999,2
1656273014496,MATH 197,003,095567,Xiao; Ming,9999,0,9999,0
1656273014496,MATH 197,004,095571,Perols; Johan Lars,9998,0,9999,1
1656273021554,COGS 9,A01,083615,Shannon; Kyle Michael,4,0,75,71
1656273027581,COGS 11,A01,083617,Boyle; Mary E. T.,14,0,48,34
1656273033608,COGS 13,A01,083071,Bastos; Amalia Pinkusfeld,4,0,71,67
1656273039630,COGS 14A,A01,092681,Semenuks; Arturs,1,12,100,99
1656273045656,COGS 14B,A01,083073,Cheng; Tzu-Han,7,0,63,56
1656273051683,COGS 17,A01,092677,Semenuks; Arturs,8,0,81,73
1656273057705,COGS 100,A01,083619,Allen; Michael Gordon,2,0,70,68
1656273063733,COGS 101A,A01,083621,Davis; Joshua Daniel,4,0,68,64
1656273069757,COGS 101B,A01,091572,Allen; Michael Gordon,4,0,65,61
1656273075786,COGS 101C,A01,083625,Delgado; Tania,10,0,35,25
1656273081809,COGS 107A,A01,083627,Boyle; Mary E. T.,0,0,60,60
1656273087835,COGS 118A,A01,083075,Gupta; Anjum,8,0,76,68
1656273093864,CSE 3,A50,083646,Miranda; Gregory Joseph,18,0,50,32
1656273099887,CSE 8A,A50,083650,Miranda; Gregory Joseph,2,2,56,54
1656273105916,CSE 11,A01,083080,Cao; Yingjun,0,49,40,40
1656273111943,CSE 12,A01,083652,Krause-Levy; Sophia Louisa,5,1,120,115
1656273117970,CSE 15L,A01,083654,Morris; Justin Loren,2,0,50,48
1656273117970,CSE 15L,A02,083655,Morris; Justin Loren,4,0,50,46
1656273123998,CSE 20,A01,083657,Tran; Khoa Dang,30,0,80,50
1656273130025,CSE 21,A01,095574,Bach; Quang Tran,23,0,48,25
1656273136049,CSE 30,A01,083084,Eldon; John,2,6,80,78
1656273136049,CSE 30,B01,095061,Bhaskar; Nishant,0,1,50,50
1656273142075,CSE 100,A01,083659,Cao; Yingjun,1,18,70,69
1656273148102,CSE 134B,A01,083661,Powell; Thomas Allan,5,0,100,95
1656273154126,CSE 140,A01,083663,Gungor; Onat,9,0,85,76
1656273160158,CSE 140L,A01,083088,Eldon; John,8,0,100,92
1656273166184,CSE 175,A01,083665,Kumar; Rakesh,0,0,25,25
1656273172210,CSE 190,A00,092507,Dubnov; Shlomo,3,0,20,17
1656273178238,ECE 45,A01,083139,Congero; Spencer William,1,0,75,74
1656273184260,ECE 65,A50,083695,Saad; Andrew S,9,0,30,21
1656273184260,ECE 65,A51,095125,Staff,24,0,26,2
1656273190379,ECE 109,A01,091882,Touri; Behrouz,0,1,70,70
1656273196404,ECE 180,A00,083140,Abi Samra; Nicholas Camill,1,0,30,29
1656273196404,ECE 180,B00,083141,Abi Samra; Nicholas Camill,0,4,30,30
1656273202444,MATH 10A,A01,083735,Patchell; Gregory David,0,0,30,30
1656273202444,MATH 10A,A02,083736,Patchell; Gregory David,22,0,30,8
1656273202444,MATH 10A,A03,083737,Patchell; Gregory David,16,0,30,14
1656273208469,MATH 10B,A01,083207,Lim; Seonhee,0,0,34,34
1656273208469,MATH 10B,A02,083208,Lim; Seonhee,7,0,35,28
1656273208469,MATH 10B,A03,093472,Staff,1,0,34,33
1656273208469,MATH 10B,B01,083739,Sinha; Shubham,11,0,30,19
1656273214499,MATH 18,A01,083743,Cinel; Cameron Alexander,7,0,30,23
1656273214499,MATH 18,A02,083744,Cinel; Cameron Alexander,9,0,30,21
1656273214499,MATH 18,A03,083745,Cinel; Cameron Alexander,5,0,30,25
1656273214499,MATH 18,B01,083748,Rideout; David Porter,1,0,36,35
1656273214499,MATH 18,B02,083749,Rideout; David Porter,0,0,36,36
1656273214499,MATH 18,B03,083750,Rideout; David Porter,0,0,36,36
1656273214499,MATH 18,B04,083751,Rideout; David Porter,0,1,36,36
1656273214499,MATH 18,B05,093473,Rideout; David Porter,0,0,36,36
1656273214499,MATH 18,B06,093474,Rideout; David Porter,3,0,36,33
1656273220523,MATH 20A,A01,083754,Zheng; Zequn,11,0,40,29
1656273226549,MATH 20B,A01,083756,Briones; Jor-el Thomas Caparas,0,0,36,36
1656273226549,MATH 20B,A02,083757,Briones; Jor-el Thomas Caparas,0,0,36,36
1656273226549,MATH 20B,A03,093475,Staff,0,0,36,36
1656273232583,MATH 20C,A01,083760,Briones; Jor-el Thomas Caparas,0,0,35,35
1656273232583,MATH 20C,A02,083761,Briones; Jor-el Thomas Caparas,9,1,35,26
1656273232583,MATH 20C,A03,093476,Staff,0,0,35,35
1656273232583,MATH 20C,B01,083762,Bach; Quang Tran,1,0,30,29
1656273238608,MATH 20D,A01,083765,Tran; Brian Kha,1,0,30,29
1656273238608,MATH 20D,A02,083766,Tran; Brian Kha,0,1,30,30
1656273238608,MATH 20D,A03,083767,Tran; Brian Kha,2,0,30,28
1656273244635,MATH 20E,A01,083771,Ganguly; Soumya,3,0,32,29
1656273244635,MATH 20E,A02,083772,Ganguly; Soumya,0,0,32,32
1656273244635,MATH 20E,B01,083773,Ciotti; Benjamin,16,0,35,19
1656273244635,MATH 20E,B02,083774,Ciotti; Benjamin,15,0,35,20
1656273250660,MATH 103A,A01,083777,Greenfeld; Be'Eri,1,0,36,35
1656273250660,MATH 103A,A02,083778,Greenfeld; Be'Eri,1,0,36,35
1656273250660,MATH 103A,A03,093561,Staff,5,0,36,31
1656273250660,MATH 103A,B01,083779,Greenfeld; Be'Eri,8,0,36,28
1656273250660,MATH 103A,B02,083780,Greenfeld; Be'Eri,1,0,36,35
1656273250660,MATH 103A,B03,093562,Staff,0,0,36,36
1656273256683,MATH 105,A01,085443,Carter; Anne Toulson,5,0,35,30
1656273256683,MATH 105,A02,093477,Staff,14,0,35,21
1656273262710,MATH 109,A01,083213,Ganzberger; Geoffrey Michael,1,0,34,33
1656273262710,MATH 109,A02,083214,Ganzberger; Geoffrey Michael,0,0,34,34
1656273262710,MATH 109,A03,093478,Staff,1,0,34,33
1656273262710,MATH 109,B01,083215,Ganzberger; Geoffrey Michael,4,0,32,28
1656273262710,MATH 109,B02,083216,Ganzberger; Geoffrey Michael,1,0,32,31
1656273262710,MATH 109,B03,093479,Staff,3,0,32,29
1656273268735,MATH 142A,A01,083219,Chow; Bennett,2,0,32,30
1656273268735,MATH 142A,A02,083220,Chow; Bennett,8,0,32,24
1656273268735,MATH 142A,A03,093480,Staff,5,0,32,27
1656273268735,MATH 142A,B03,093481,Staff,3,0,32,29
1656273268735,MATH 142A,B04,093558,Staff,6,0,32,26
1656273268735,MATH 142A,B05,093559,Staff,0,0,32,32
1656273274769,MATH 193A,A01,083224,Rotar; Vladimir,0,1,34,34
1656273274769,MATH 193A,A02,083225,Rotar; Vladimir,0,0,34,34
1656273274769,MATH 193A,A03,083781,Rotar; Vladimir,0,0,34,34
1656273274769,MATH 193A,A04,083782,Rotar; Vladimir,6,0,34,28
1656273274769,MATH 193A,A05,093482,Rotar; Vladimir,0,0,34,34
1656273280793,MATH 197,001,091859,McAuley; Julian John,9999,0,9999,0
1656273280793,MATH 197,002,095566,Kedlaya; Kiran S.,9997,0,9999,2
1656273280793,MATH 197,003,095567,Xiao; Ming,9999,0,9999,0
1656273280793,MATH 197,004,095571,Perols; Johan Lars,9998,0,9999,1
1656273287845,COGS 9,A01,083615,Shannon; Kyle Michael,4,0,75,71
1656273293869,COGS 11,A01,083617,Boyle; Mary E. T.,14,0,48,34
1656273299896,COGS 13,A01,083071,Bastos; Amalia Pinkusfeld,4,0,71,67
1656273305924,COGS 14A,A01,092681,Semenuks; Arturs,1,12,100,99
1656273311947,COGS 14B,A01,083073,Cheng; Tzu-Han,7,0,63,56
1656273317970,COGS 17,A01,092677,Semenuks; Arturs,8,0,81,73
1656273323997,COGS 100,A01,083619,Allen; Michael Gordon,2,0,70,68
1656273330021,COGS 101A,A01,083621,Davis; Joshua Daniel,4,0,68,64
1656273336049,COGS 101B,A01,091572,Allen; Michael Gordon,4,0,65,61
1656273342077,COGS 101C,A01,083625,Delgado; Tania,10,0,35,25
1656273348103,COGS 107A,A01,083627,Boyle; Mary E. T.,0,0,60,60
1656273354127,COGS 118A,A01,083075,Gupta; Anjum,8,0,76,68
1656273360152,CSE 3,A50,083646,Miranda; Gregory Joseph,18,0,50,32
1656273366182,CSE 8A,A50,083650,Miranda; Gregory Joseph,2,2,56,54
1656273372206,CSE 11,A01,083080,Cao; Yingjun,0,49,40,40
1656273378232,CSE 12,A01,083652,Krause-Levy; Sophia Louisa,5,1,120,115
1656273384258,CSE 15L,A01,083654,Morris; Justin Loren,2,0,50,48
1656273384258,CSE 15L,A02,083655,Morris; Justin Loren,4,0,50,46
1656273390284,CSE 20,A01,083657,Tran; Khoa Dang,30,0,80,50
1656273396317,CSE 21,A01,095574,Bach; Quang Tran,23,0,48,25
1656273402340,CSE 30,A01,083084,Eldon; John,2,6,80,78
1656273402340,CSE 30,B01,095061,Bhaskar; Nishant,0,1,50,50
1656273408375,CSE 100,A01,083659,Cao; Yingjun,1,18,70,69
1656273414400,CSE 134B,A01,083661,Powell; Thomas Allan,5,0,100,95
1656273420426,CSE 140,A01,083663,Gungor; Onat,9,0,85,76
1656273426452,CSE 140L,A01,083088,Eldon; John,8,0,100,92
1656273432476,CSE 175,A01,083665,Kumar; Rakesh,0,0,25,25
1656273438500,CSE 190,A00,092507,Dubnov; Shlomo,3,0,20,17
1656273444527,ECE 45,A01,083139,Congero; Spencer William,1,0,75,74
1656273450554,ECE 65,A50,083695,Saad; Andrew S,9,0,30,21
1656273450554,ECE 65,A51,095125,Staff,24,0,26,2
1656273456577,ECE 109,A01,091882,Touri; Behrouz,0,1,70,70
1656273462605,ECE 180,A00,083140,Abi Samra; Nicholas Camill,1,0,30,29
1656273462605,ECE 180,B00,083141,Abi Samra; Nicholas Camill,0,4,30,30
1656273468640,MATH 10A,A01,083735,Patchell; Gregory David,0,0,30,30
1656273468640,MATH 10A,A02,083736,Patchell; Gregory David,22,0,30,8
1656273468640,MATH 10A,A03,083737,Patchell; Gregory David,16,0,30,14
1656273474664,MATH 10B,A01,083207,Lim; Seonhee,0,0,34,34
1656273474664,MATH 10B,A02,083208,Lim; Seonhee,7,0,35,28
1656273474664,MATH 10B,A03,093472,Staff,1,0,34,33
1656273474664,MATH 10B,B01,083739,Sinha; Shubham,11,0,30,19
1656273480695,MATH 18,A01,083743,Cinel; Cameron Alexander,7,0,30,23
1656273480695,MATH 18,A02,083744,Cinel; Cameron Alexander,9,0,30,21
1656273480695,MATH 18,A03,083745,Cinel; Cameron Alexander,5,0,30,25
1656273480695,MATH 18,B01,083748,Rideout; David Porter,1,0,36,35
1656273480695,MATH 18,B02,083749,Rideout; David Porter,0,0,36,36
1656273480695,MATH 18,B03,083750,Rideout; David Porter,0,0,36,36
1656273480695,MATH 18,B04,083751,Rideout; David Porter,0,1,36,36
1656273480695,MATH 18,B05,093473,Rideout; David Porter,0,0,36,36
1656273480695,MATH 18,B06,093474,Rideout; David Porter,3,0,36,33
1656273486722,MATH 20A,A01,083754,Zheng; Zequn,11,0,40,29
1656273492748,MATH 20B,A01,083756,Briones; Jor-el Thomas Caparas,0,0,36,36
1656273492748,MATH 20B,A02,083757,Briones; Jor-el Thomas Caparas,0,0,36,36
1656273492748,MATH 20B,A03,093475,Staff,0,0,36,36
1656273498772,MATH 20C,A01,083760,Briones; Jor-el Thomas Caparas,0,0,35,35
1656273498772,MATH 20C,A02,083761,Briones; Jor-el Thomas Caparas,9,1,35,26
1656273498772,MATH 20C,A03,093476,Staff,0,0,35,35
1656273498772,MATH 20C,B01,083762,Bach; Quang Tran,1,0,30,29
1656273504800,MATH 20D,A01,083765,Tran; Brian Kha,1,0,30,29
1656273504800,MATH 20D,A02,083766,Tran; Brian Kha,0,1,30,30
1656273504800,MATH 20D,A03,083767,Tran; Brian Kha,2,0,30,28
1656273510828,MATH 20E,A01,083771,Ganguly; Soumya,3,0,32,29
1656273510828,MATH 20E,A02,083772,Ganguly; Soumya,0,0,32,32
1656273510828,MATH 20E,B01,083773,Ciotti; Benjamin,16,0,35,19
1656273510828,MATH 20E,B02,083774,Ciotti; Benjamin,15,0,35,20
1656273516858,MATH 103A,A01,083777,Greenfeld; Be'Eri,1,0,36,35
1656273516858,MATH 103A,A02,083778,Greenfeld; Be'Eri,1,0,36,35
1656273516858,MATH 103A,A03,093561,Staff,5,0,36,31
1656273516858,MATH 103A,B01,083779,Greenfeld; Be'Eri,8,0,36,28
1656273516858,MATH 103A,B02,083780,Greenfeld; Be'Eri,1,0,36,35
1656273516858,MATH 103A,B03,093562,Staff,0,0,36,36
1656273522882,MATH 105,A01,085443,Carter; Anne Toulson,5,0,35,30
1656273522882,MATH 105,A02,093477,Staff,14,0,35,21
1656273528918,MATH 109,A01,083213,Ganzberger; Geoffrey Michael,1,0,34,33
1656273528918,MATH 109,A02,083214,Ganzberger; Geoffrey Michael,0,0,34,34
1656273528918,MATH 109,A03,093478,Staff,1,0,34,33
1656273528918,MATH 109,B01,083215,Ganzberger; Geoffrey Michael,4,0,32,28
1656273528918,MATH 109,B02,083216,Ganzberger; Geoffrey Michael,1,0,32,31
1656273528918,MATH 109,B03,093479,Staff,3,0,32,29
1656273534948,MATH 142A,A01,083219,Chow; Bennett,2,0,32,30
1656273534948,MATH 142A,A02,083220,Chow; Bennett,8,0,32,24
1656273534948,MATH 142A,A03,093480,Staff,5,0,32,27
1656273534948,MATH 142A,B03,093481,Staff,3,0,32,29
1656273534948,MATH 142A,B04,093558,Staff,6,0,32,26
1656273534948,MATH 142A,B05,093559,Staff,0,0,32,32
1656273540970,MATH 193A,A01,083224,Rotar; Vladimir,0,1,34,34
1656273540970,MATH 193A,A02,083225,Rotar; Vladimir,0,0,34,34
1656273540970,MATH 193A,A03,083781,Rotar; Vladimir,0,0,34,34
1656273540970,MATH 193A,A04,083782,Rotar; Vladimir,6,0,34,28
1656273540970,MATH 193A,A05,093482,Rotar; Vladimir,0,0,34,34
1656273546996,MATH 197,001,091859,McAuley; Julian John,9999,0,9999,0
1656273546996,MATH 197,002,095566,Kedlaya; Kiran S.,9997,0,9999,2
1656273546996,MATH 197,003,095567,Xiao; Ming,9999,0,9999,0
1656273546996,MATH 197,004,095571,Perols; Johan Lars,9998,0,9999,1
1656273554066,COGS 9,A01,083615,Shannon; Kyle Michael,4,0,75,71
1656273560089,COGS 11,A01,083617,Boyle; Mary E. T.,14,0,48,34
1656273566117,COGS 13,A01,083071,Bastos; Amalia Pinkusfeld,4,0,71,67
1656273572145,COGS 14A,A01,092681,Semenuks; Arturs,1,12,100,99
1656273578167,COGS 14B,A01,083073,Cheng; Tzu-Han,7,0,63,56
1656273584195,COGS 17,A01,092677,Semenuks; Arturs,8,0,81,73
1656273590219,COGS 100,A01,083619,Allen; Michael Gordon,2,0,70,68
1656273596247,COGS 101A,A01,083621,Davis; Joshua Daniel,4,0,68,64
1656273602270,COGS 101B,A01,091572,Allen; Michael Gordon,4,0,65,61
1656273608294,COGS 101C,A01,083625,Delgado; Tania,10,0,35,25
1656273614322,COGS 107A,A01,083627,Boyle; Mary E. T.,0,0,60,60
1656273620349,COGS 118A,A01,083075,Gupta; Anjum,8,0,76,68
1656273626377,CSE 3,A50,083646,Miranda; Gregory Joseph,18,0,50,32
1656273632444,CSE 8A,A50,083650,Miranda; Gregory Joseph,2,2,56,54
1656273638471,CSE 11,A01,083080,Cao; Yingjun,0,48,40,40
1656273644496,CSE 12,A01,083652,Krause-Levy; Sophia Louisa,5,1,120,115
1656273650519,CSE 15L,A01,083654,Morris; Justin Loren,2,0,50,48
1656273650519,CSE 15L,A02,083655,Morris; Justin Loren,4,0,50,46
1656273656546,CSE 20,A01,083657,Tran; Khoa Dang,30,0,80,50
1656273662578,CSE 21,A01,095574,Bach; Quang Tran,23,0,48,25
1656273668604,CSE 30,A01,083084,Eldon; John,2,6,80,78
1656273668604,CSE 30,B01,095061,Bhaskar; Nishant,0,1,50,50
1656273674633,CSE 100,A01,083659,Cao; Yingjun,1,18,70,69
1656273680656,CSE 134B,A01,083661,Powell; Thomas Allan,5,0,100,95
1656273686682,CSE 140,A01,083663,Gungor; Onat,9,0,85,76
1656273692709,CSE 140L,A01,083088,Eldon; John,8,0,100,92
1656273698732,CSE 175,A01,083665,Kumar; Rakesh,0,0,25,25
1656273704761,CSE 190,A00,092507,Dubnov; Shlomo,3,0,20,17
1656273710792,ECE 45,A01,083139,Congero; Spencer William,1,0,75,74
1656273716832,ECE 65,A50,083695,Saad; Andrew S,9,0,30,21
1656273716832,ECE 65,A51,095125,Staff,24,0,26,2
1656273722856,ECE 109,A01,091882,Touri; Behrouz,0,1,70,70
1656273728880,ECE 180,A00,083140,Abi Samra; Nicholas Camill,1,0,30,29
1656273728880,ECE 180,B00,083141,Abi Samra; Nicholas Camill,0,4,30,30
1656273734904,MATH 10A,A01,083735,Patchell; Gregory David,0,0,30,30
1656273734904,MATH 10A,A02,083736,Patchell; Gregory David,22,0,30,8
1656273734904,MATH 10A,A03,083737,Patchell; Gregory David,16,0,30,14
1656273740928,MATH 10B,A01,083207,Lim; Seonhee,0,0,34,34
1656273740928,MATH 10B,A02,083208,Lim; Seonhee,7,0,35,28
1656273740928,MATH 10B,A03,093472,Staff,1,0,34,33
1656273740928,MATH 10B,B01,083739,Sinha; Shubham,11,0,30,19
1656273746954,MATH 18,A01,083743,Cinel; Cameron Alexander,7,0,30,23
1656273746954,MATH 18,A02,083744,Cinel; Cameron Alexander,9,0,30,21
1656273746954,MATH 18,A03,083745,Cinel; Cameron Alexander,5,0,30,25
1656273746954,MATH 18,B01,083748,Rideout; David Porter,1,0,36,35
1656273746954,MATH 18,B02,083749,Rideout; David Porter,0,0,36,36
1656273746954,MATH 18,B03,083750,Rideout; David Porter,0,0,36,36
1656273746954,MATH 18,B04,083751,Rideout; David Porter,0,1,36,36
1656273746954,MATH 18,B05,093473,Rideout; David Porter,0,0,36,36
1656273746954,MATH 18,B06,093474,Rideout; David Porter,3,0,36,33
1656273752976,MATH 20A,A01,083754,Zheng; Zequn,11,0,40,29
1656273759003,MATH 20B,A01,083756,Briones; Jor-el Thomas Caparas,0,0,36,36
1656273759003,MATH 20B,A02,083757,Briones; Jor-el Thomas Caparas,0,0,36,36
1656273759003,MATH 20B,A03,093475,Staff,0,0,36,36
1656273765028,MATH 20C,A01,083760,Briones; Jor-el Thomas Caparas,0,0,35,35
1656273765028,MATH 20C,A02,083761,Briones; Jor-el Thomas Caparas,9,1,35,26
1656273765028,MATH 20C,A03,093476,Staff,0,0,35,35
1656273765028,MATH 20C,B01,083762,Bach; Quang Tran,1,0,30,29
1656273771050,MATH 20D,A01,083765,Tran; Brian Kha,1,0,30,29
1656273771050,MATH 20D,A02,083766,Tran; Brian Kha,0,1,30,30
1656273771050,MATH 20D,A03,083767,Tran; Brian Kha,2,0,30,28
1656273777074,MATH 20E,A01,083771,Ganguly; Soumya,3,0,32,29
1656273777074,MATH 20E,A02,083772,Ganguly; Soumya,0,0,32,32
1656273777074,MATH 20E,B01,083773,Ciotti; Benjamin,16,0,35,19
1656273777074,MATH 20E,B02,083774,Ciotti; Benjamin,15,0,35,20
1656273783103,MATH 103A,A01,083777,Greenfeld; Be'Eri,1,0,36,35
1656273783103,MATH 103A,A02,083778,Greenfeld; Be'Eri,1,0,36,35
1656273783103,MATH 103A,A03,093561,Staff,5,0,36,31
1656273783103,MATH 103A,B01,083779,Greenfeld; Be'Eri,8,0,36,28
1656273783103,MATH 103A,B02,083780,Greenfeld; Be'Eri,1,0,36,35
1656273783103,MATH 103A,B03,093562,Staff,0,0,36,36
1656273789202,MATH 105,A01,085443,Carter; Anne Toulson,5,0,35,30
1656273789202,MATH 105,A02,093477,Staff,14,0,35,21
1656273795230,MATH 109,A01,083213,Ganzberger; Geoffrey Michael,1,0,34,33
1656273795230,MATH 109,A02,083214,Ganzberger; Geoffrey Michael,0,0,34,34
1656273795230,MATH 109,A03,093478,Staff,1,0,34,33
1656273795230,MATH 109,B01,083215,Ganzberger; Geoffrey Michael,4,0,32,28
1656273795230,MATH 109,B02,083216,Ganzberger; Geoffrey Michael,1,0,32,31
1656273795230,MATH 109,B03,093479,Staff,3,0,32,29
1656273801255,MATH 142A,A01,083219,Chow; Bennett,2,0,32,30
1656273801255,MATH 142A,A02,083220,Chow; Bennett,8,0,32,24
1656273801255,MATH 142A,A03,093480,Staff,5,0,32,27
1656273801255,MATH 142A,B03,093481,Staff,3,0,32,29
1656273801255,MATH 142A,B04,093558,Staff,6,0,32,26
1656273801255,MATH 142A,B05,093559,Staff,0,0,32,32
1656273807284,MATH 193A,A01,083224,Rotar; Vladimir,0,1,34,34
1656273807284,MATH 193A,A02,083225,Rotar; Vladimir,0,0,34,34
1656273807284,MATH 193A,A03,083781,Rotar; Vladimir,0,0,34,34
1656273807284,MATH 193A,A04,083782,Rotar; Vladimir,6,0,34,28
1656273807284,MATH 193A,A05,093482,Rotar; Vladimir,0,0,34,34
1656273813308,MATH 197,001,091859,McAuley; Julian John,9999,0,9999,0
1656273813308,MATH 197,002,095566,Kedlaya; Kiran S.,9997,0,9999,2
1656273813308,MATH 197,003,095567,Xiao; Ming,9999,0,9999,0
1656273813308,MATH 197,004,095571,Perols; Johan Lars,9998,0,9999,1
1656273820372,COGS 9,A01,083615,Shannon; Kyle Michael,4,0,75,71
1656273826394,COGS 11,A01,083617,Boyle; Mary E. T.,14,0,48,34
1656273832418,COGS 13,A01,083071,Bastos; Amalia Pinkusfeld,4,0,71,67
1656273838442,COGS 14A,A01,092681,Semenuks; Arturs,1,12,100,99
1656273844465,COGS 14B,A01,083073,Cheng; Tzu-Han,7,0,63,56
1656273850487,COGS 17,A01,092677,Semenuks; Arturs,8,0,81,73
1656273856510,COGS 100,A01,083619,Allen; Michael Gordon,2,0,70,68
1656273862536,COGS 101A,A01,083621,Davis; Joshua Daniel,4,0,68,64
1656273868565,COGS 101B,A01,091572,Allen; Michael Gordon,4,0,65,61
1656273874592,COGS 101C,A01,083625,Delgado; Tania,10,0,35,25
1656273880616,COGS 107A,A01,083627,Boyle; Mary E. T.,0,0,60,60
1656273886641,COGS 118A,A01,083075,Gupta; Anjum,8,0,76,68
1656273892667,CSE 3,A50,083646,Miranda; Gregory Joseph,18,0,50,32
1656273898695,CSE 8A,A50,083650,Miranda; Gregory Joseph,2,2,56,54
1656273904721,CSE 11,A01,083080,Cao; Yingjun,0,48,40,40
1656273910745,CSE 12,A01,083652,Krause-Levy; Sophia Louisa,5,1,120,115
1656273916772,CSE 15L,A01,083654,Morris; Justin Loren,2,0,50,48
1656273916772,CSE 15L,A02,083655,Morris; Justin Loren,4,0,50,46
1656273922795,CSE 20,A01,083657,Tran; Khoa Dang,30,0,80,50
1656273928818,CSE 21,A01,095574,Bach; Quang Tran,23,0,48,25
1656273934846,CSE 30,A01,083084,Eldon; John,2,6,80,78
1656273934846,CSE 30,B01,095061,Bhaskar; Nishant,0,1,50,50
1656273940873,CSE 100,A01,083659,Cao; Yingjun,1,18,70,69
1656273946906,CSE 134B,A01,083661,Powell; Thomas Allan,5,0,100,95
1656273952931,CSE 140,A01,083663,Gungor; Onat,9,0,85,76
1656273958955,CSE 140L,A01,083088,Eldon; John,8,0,100,92
1656273964977,CSE 175,A01,083665,Kumar; Rakesh,0,0,25,25
1656273971002,CSE 190,A00,092507,Dubnov; Shlomo,3,0,20,17
1656273977023,ECE 45,A01,083139,Congero; Spencer William,1,0,75,74
1656273983052,ECE 65,A50,083695,Saad; Andrew S,9,0,30,21
1656273983052,ECE 65,A51,095125,Staff,24,0,26,2
1656273989077,ECE 109,A01,091882,Touri; Behrouz,0,1,70,70
1656273995104,ECE 180,A00,083140,Abi Samra; Nicholas Camill,1,0,30,29
1656273995104,ECE 180,B00,083141,Abi Samra; Nicholas Camill,0,4,30,30
1656274001134,MATH 10A,A01,083735,Patchell; Gregory David,0,0,30,30
1656274001134,MATH 10A,A02,083736,Patchell; Gregory David,22,0,30,8
1656274001134,MATH 10A,A03,083737,Patchell; Gregory David,16,0,30,14
1656274007163,MATH 10B,A01,083207,Lim; Seonhee,0,0,34,34
1656274007163,MATH 10B,A02,083208,Lim; Seonhee,7,0,35,28
1656274007163,MATH 10B,A03,093472,Staff,1,0,34,33
1656274007163,MATH 10B,B01,083739,Sinha; Shubham,11,0,30,19
1656274013194,MATH 18,A01,083743,Cinel; Cameron Alexander,7,0,30,23
1656274013194,MATH 18,A02,083744,Cinel; Cameron Alexander,9,0,30,21
1656274013194,MATH 18,A03,083745,Cinel; Cameron Alexander,5,0,30,25
1656274013194,MATH 18,B01,083748,Rideout; David Porter,1,0,36,35
1656274013194,MATH 18,B02,083749,Rideout; David Porter,0,0,36,36
1656274013194,MATH 18,B03,083750,Rideout; David Porter,0,0,36,36
1656274013194,MATH 18,B04,083751,Rideout; David Porter,0,1,36,36
1656274013194,MATH 18,B05,093473,Rideout; David Porter,0,0,36,36
1656274013194,MATH 18,B06,093474,Rideout; David Porter,3,0,36,33
1656274019221,MATH 20A,A01,083754,Zheng; Zequn,11,0,40,29
1656274025245,MATH 20B,A01,083756,Briones; Jor-el Thomas Caparas,0,0,36,36
1656274025245,MATH 20B,A02,083757,Briones; Jor-el Thomas Caparas,0,0,36,36
1656274025245,MATH 20B,A03,093475,Staff,0,0,36,36
1656274031269,MATH 20C,A01,083760,Briones; Jor-el Thomas Caparas,0,0,35,35
1656274031269,MATH 20C,A02,083761,Briones; Jor-el Thomas Caparas,9,1,35,26
1656274031269,MATH 20C,A03,093476,Staff,0,0,35,35
1656274031269,MATH 20C,B01,083762,Bach; Quang Tran,1,0,30,29
1656274037294,MATH 20D,A01,083765,Tran; Brian Kha,1,0,30,29
1656274037294,MATH 20D,A02,083766,Tran; Brian Kha,0,1,30,30
1656274037294,MATH 20D,A03,083767,Tran; Brian Kha,2,0,30,28
1656274043326,MATH 20E,A01,083771,Ganguly; Soumya,3,0,32,29
1656274043326,MATH 20E,A02,083772,Ganguly; Soumya,0,0,32,32
1656274043326,MATH 20E,B01,083773,Ciotti; Benjamin,16,0,35,19
1656274043326,MATH 20E,B02,083774,Ciotti; Benjamin,15,0,35,20
1656274049368,MATH 103A,A01,083777,Greenfeld; Be'Eri,1,0,36,35
1656274049368,MATH 103A,A02,083778,Greenfeld; Be'Eri,1,0,36,35
1656274049368,MATH 103A,A03,093561,Staff,5,0,36,31
1656274049368,MATH 103A,B01,083779,Greenfeld; Be'Eri,8,0,36,28
1656274049368,MATH 103A,B02,083780,Greenfeld; Be'Eri,1,0,36,35
1656274049368,MATH 103A,B03,093562,Staff,0,0,36,36
1656274055397,MATH 105,A01,085443,Carter; Anne Toulson,5,0,35,30
1656274055397,MATH 105,A02,093477,Staff,14,0,35,21
1656274061421,MATH 109,A01,083213,Ganzberger; Geoffrey Michael,1,0,34,33
1656274061421,MATH 109,A02,083214,Ganzberger; Geoffrey Michael,0,0,34,34
1656274061421,MATH 109,A03,093478,Staff,1,0,34,33
1656274061421,MATH 109,B01,083215,Ganzberger; Geoffrey Michael,4,0,32,28
1656274061421,MATH 109,B02,083216,Ganzberger; Geoffrey Michael,1,0,32,31
1656274061421,MATH 109,B03,093479,Staff,3,0,32,29
1656274067449,MATH 142A,A01,083219,Chow; Bennett,2,0,32,30
1656274067449,MATH 142A,A02,083220,Chow; Bennett,8,0,32,24
1656274067449,MATH 142A,A03,093480,Staff,5,0,32,27
1656274067449,MATH 142A,B03,093481,Staff,3,0,32,29
1656274067449,MATH 142A,B04,093558,Staff,6,0,32,26
1656274067449,MATH 142A,B05,093559,Staff,0,0,32,32
1656274073477,MATH 193A,A01,083224,Rotar; Vladimir,0,1,34,34
1656274073477,MATH 193A,A02,083225,Rotar; Vladimir,0,0,34,34
1656274073477,MATH 193A,A03,083781,Rotar; Vladimir,0,0,34,34
1656274073477,MATH 193A,A04,083782,Rotar; Vladimir,6,0,34,28
1656274073477,MATH 193A,A05,093482,Rotar; Vladimir,0,0,34,34
1656274079500,MATH 197,001,091859,McAuley; Julian John,9999,0,9999,0
1656274079500,MATH 197,002,095566,Kedlaya; Kiran S.,9997,0,9999,2
1656274079500,MATH 197,003,095567,Xiao; Ming,9999,0,9999,0
1656274079500,MATH 197,004,095571,Perols; Johan Lars,9998,0,9999,1
1656274086555,COGS 9,A01,083615,Shannon; Kyle Michael,4,0,75,71
1656274092582,COGS 11,A01,083617,Boyle; Mary E. T.,14,0,48,34
1656274098609,COGS 13,A01,083071,Bastos; Amalia Pinkusfeld,4,0,71,67
1656274104632,COGS 14A,A01,092681,Semenuks; Arturs,1,12,100,99
1656274110653,COGS 14B,A01,083073,Cheng; Tzu-Han,7,0,63,56
1656274116677,COGS 17,A01,092677,Semenuks; Arturs,8,0,81,73
1656274122703,COGS 100,A01,083619,Allen; Michael Gordon,2,0,70,68
1656274128730,COGS 101A,A01,083621,Davis; Joshua Daniel,4,0,68,64
1656274134752,COGS 101B,A01,091572,Allen; Michael Gordon,4,0,65,61
1656274140774,COGS 101C,A01,083625,Delgado; Tania,10,0,35,25
1656274146798,COGS 107A,A01,083627,Boyle; Mary E. T.,0,0,60,60
1656274152821,COGS 118A,A01,083075,Gupta; Anjum,8,0,76,68
1656274158849,CSE 3,A50,083646,Miranda; Gregory Joseph,18,0,50,32
1656274164875,CSE 8A,A50,083650,Miranda; Gregory Joseph,2,2,56,54
1656274170898,CSE 11,A01,083080,Cao; Yingjun,0,48,40,40
1656274176921,CSE 12,A01,083652,Krause-Levy; Sophia Louisa,5,1,120,115
1656274182955,CSE 15L,A01,083654,Morris; Justin Loren,2,0,50,48
1656274182955,CSE 15L,A02,083655,Morris; Justin Loren,4,0,50,46
1656274188982,CSE 20,A01,083657,Tran; Khoa Dang,30,0,80,50
1656274195006,CSE 21,A01,095574,Bach; Quang Tran,23,0,48,25
1656274201029,CSE 30,A01,083084,Eldon; John,2,6,80,78
1656274201029,CSE 30,B01,095061,Bhaskar; Nishant,0,1,50,50
1656274207056,CSE 100,A01,083659,Cao; Yingjun,1,18,70,69
1656274213084,CSE 134B,A01,083661,Powell; Thomas Allan,5,0,100,95
1656274219110,CSE 140,A01,083663,Gungor; Onat,9,0,85,76
1656274225134,CSE 140L,A01,083088,Eldon; John,8,0,100,92
1656274231156,CSE 175,A01,083665,Kumar; Rakesh,0,0,25,25
1656274237179,CSE 190,A00,092507,Dubnov; Shlomo,3,0,20,17
1656274243204,ECE 45,A01,083139,Congero; Spencer William,1,0,75,74
1656274249227,ECE 65,A50,083695,Saad; Andrew S,9,0,30,21
1656274249227,ECE 65,A51,095125,Staff,24,0,26,2
1656274255256,ECE 109,A01,091882,Touri; Behrouz,0,1,70,70
1656274261283,ECE 180,A00,083140,Abi Samra; Nicholas Camill,1,0,30,29
1656274261283,ECE 180,B00,083141,Abi Samra; Nicholas Camill,0,4,30,30
1656274267305,MATH 10A,A01,083735,Patchell; Gregory David,0,0,30,30
1656274267305,MATH 10A,A02,083736,Patchell; Gregory David,22,0,30,8
1656274267305,MATH 10A,A03,083737,Patchell; Gregory David,16,0,30,14
1656274273329,MATH 10B,A01,083207,Lim; Seonhee,0,0,34,34
1656274273329,MATH 10B,A02,083208,Lim; Seonhee,7,0,35,28
1656274273329,MATH 10B,A03,093472,Staff,1,0,34,33
1656274273329,MATH 10B,B01,083739,Sinha; Shubham,11,0,30,19
1656274279354,MATH 18,A01,083743,Cinel; Cameron Alexander,7,0,30,23
1656274279354,MATH 18,A02,083744,Cinel; Cameron Alexander,9,0,30,21
1656274279354,MATH 18,A03,083745,Cinel; Cameron Alexander,5,0,30,25
1656274279354,MATH 18,B01,083748,Rideout; David Porter,1,0,36,35
1656274279354,MATH 18,B02,083749,Rideout; David Porter,0,0,36,36
1656274279354,MATH 18,B03,083750,Rideout; David Porter,0,0,36,36
1656274279354,MATH 18,B04,083751,Rideout; David Porter,0,1,36,36
1656274279354,MATH 18,B05,093473,Rideout; David Porter,0,0,36,36
1656274279354,MATH 18,B06,093474,Rideout; David Porter,3,0,36,33
1656274285377,MATH 20A,A01,083754,Zheng; Zequn,11,0,40,29
1656274291400,MATH 20B,A01,083756,Briones; Jor-el Thomas Caparas,0,0,36,36
1656274291400,MATH 20B,A02,083757,Briones; Jor-el Thomas Caparas,0,0,36,36
1656274291400,MATH 20B,A03,093475,Staff,0,0,36,36
1656274297422,MATH 20C,A01,083760,Briones; Jor-el Thomas Caparas,0,0,35,35
1656274297422,MATH 20C,A02,083761,Briones; Jor-el Thomas Caparas,9,1,35,26
1656274297422,MATH 20C,A03,093476,Staff,0,0,35,35
1656274297422,MATH 20C,B01,083762,Bach; Quang Tran,1,0,30,29
1656274303447,MATH 20D,A01,083765,Tran; Brian Kha,1,0,30,29
1656274303447,MATH 20D,A02,083766,Tran; Brian Kha,0,1,30,30
1656274303447,MATH 20D,A03,083767,Tran; Brian Kha,2,0,30,28
1656274309472,MATH 20E,A01,083771,Ganguly; Soumya,3,0,32,29
1656274309472,MATH 20E,A02,083772,Ganguly; Soumya,0,0,32,32
1656274309472,MATH 20E,B01,083773,Ciotti; Benjamin,16,0,35,19
1656274309472,MATH 20E,B02,083774,Ciotti; Benjamin,15,0,35,20
1656274315501,MATH 103A,A01,083777,Greenfeld; Be'Eri,1,0,36,35
1656274315501,MATH 103A,A02,083778,Greenfeld; Be'Eri,1,0,36,35
1656274315501,MATH 103A,A03,093561,Staff,5,0,36,31
1656274315501,MATH 103A,B01,083779,Greenfeld; Be'Eri,8,0,36,28
1656274315501,MATH 103A,B02,083780,Greenfeld; Be'Eri,1,0,36,35
1656274315501,MATH 103A,B03,093562,Staff,0,0,36,36
1656274321522,MATH 105,A01,085443,Carter; Anne Toulson,5,0,35,30
1656274321522,MATH 105,A02,093477,Staff,14,0,35,21
1656274327546,MATH 109,A01,083213,Ganzberger; Geoffrey Michael,1,0,34,33
1656274327546,MATH 109,A02,083214,Ganzberger; Geoffrey Michael,0,0,34,34
1656274327546,MATH 109,A03,093478,Staff,1,0,34,33
1656274327546,MATH 109,B01,083215,Ganzberger; Geoffrey Michael,4,0,32,28
1656274327546,MATH 109,B02,083216,Ganzberger; Geoffrey Michael,1,0,32,31
1656274327546,MATH 109,B03,093479,Staff,3,0,32,29
1656274333579,MATH 142A,A01,083219,Chow; Bennett,2,0,32,30
1656274333579,MATH 142A,A02,083220,Chow; Bennett,8,0,32,24
1656274333579,MATH 142A,A03,093480,Staff,5,0,32,27
1656274333579,MATH 142A,B03,093481,Staff,3,0,32,29
1656274333579,MATH 142A,B04,093558,Staff,6,0,32,26
1656274333579,MATH 142A,B05,093559,Staff,0,0,32,32
1656274339604,MATH 193A,A01,083224,Rotar; Vladimir,0,1,34,34
1656274339604,MATH 193A,A02,083225,Rotar; Vladimir,0,0,34,34
1656274339604,MATH 193A,A03,083781,Rotar; Vladimir,0,0,34,34
1656274339604,MATH 193A,A04,083782,Rotar; Vladimir,6,0,34,28
1656274339604,MATH 193A,A05,093482,Rotar; Vladimir,0,0,34,34
1656274345633,MATH 197,001,091859,McAuley; Julian John,9999,0,9999,0
1656274345633,MATH 197,002,095566,Kedlaya; Kiran S.,9997,0,9999,2
1656274345633,MATH 197,003,095567,Xiao; Ming,9999,0,9999,0
1656274345633,MATH 197,004,095571,Perols; Johan Lars,9998,0,9999,1
1656274352706,COGS 9,A01,083615,Shannon; Kyle Michael,4,0,75,71
1656274358729,COGS 11,A01,083617,Boyle; Mary E. T.,14,0,48,34
1656274364757,COGS 13,A01,083071,Bastos; Amalia Pinkusfeld,5,0,71,66
1656274370780,COGS 14A,A01,092681,Semenuks; Arturs,1,12,100,99
1656274376805,COGS 14B,A01,083073,Cheng; Tzu-Han,7,0,63,56
1656274382903,COGS 17,A01,092677,Semenuks; Arturs,8,0,81,73
1656274388933,COGS 100,A01,083619,Allen; Michael Gordon,2,0,70,68
1656274394956,COGS 101A,A01,083621,Davis; Joshua Daniel,4,0,68,64
1656274400981,COGS 101B,A01,091572,Allen; Michael Gordon,4,0,65,61
1656274407008,COGS 101C,A01,083625,Delgado; Tania,10,0,35,25
1656274413031,COGS 107A,A01,083627,Boyle; Mary E. T.,0,0,60,60
1656274419058,COGS 118A,A01,083075,Gupta; Anjum,8,0,76,68
1656274425083,CSE 3,A50,083646,Miranda; Gregory Joseph,18,0,50,32
1656274431106,CSE 8A,A50,083650,Miranda; Gregory Joseph,2,2,56,54
1656274437130,CSE 11,A01,083080,Cao; Yingjun,0,48,40,40
1656274443161,CSE 12,A01,083652,Krause-Levy; Sophia Louisa,5,1,120,115
1656274449186,CSE 15L,A01,083654,Morris; Justin Loren,2,0,50,48
1656274449186,CSE 15L,A02,083655,Morris; Justin Loren,4,0,50,46
1656274455208,CSE 20,A01,083657,Tran; Khoa Dang,30,0,80,50
1656274461235,CSE 21,A01,095574,Bach; Quang Tran,23,0,48,25
1656274467264,CSE 30,A01,083084,Eldon; John,2,6,80,78
1656274467264,CSE 30,B01,095061,Bhaskar; Nishant,0,1,50,50
1656274473288,CSE 100,A01,083659,Cao; Yingjun,1,18,70,69
1656274479314,CSE 134B,A01,083661,Powell; Thomas Allan,5,0,100,95
1656274485340,CSE 140,A01,083663,Gungor; Onat,9,0,85,76
1656274491364,CSE 140L,A01,083088,Eldon; John,9,0,100,91
1656274497387,CSE 175,A01,083665,Kumar; Rakesh,0,0,25,25
1656274503410,CSE 190,A00,092507,Dubnov; Shlomo,3,0,20,17
1656274509434,ECE 45,A01,083139,Congero; Spencer William,1,0,75,74
1656274515460,ECE 65,A50,083695,Saad; Andrew S,9,0,30,21
1656274515460,ECE 65,A51,095125,Staff,24,0,26,2
1656274521484,ECE 109,A01,091882,Touri; Behrouz,0,1,70,70
1656274527507,ECE 180,A00,083140,Abi Samra; Nicholas Camill,1,0,30,29
1656274527507,ECE 180,B00,083141,Abi Samra; Nicholas Camill,0,4,30,30
1656274533534,MATH 10A,A01,083735,Patchell; Gregory David,0,0,30,30
1656274533534,MATH 10A,A02,083736,Patchell; Gregory David,22,0,30,8
1656274533534,MATH 10A,A03,083737,Patchell; Gregory David,16,0,30,14
1656274539558,MATH 10B,A01,083207,Lim; Seonhee,0,0,34,34
1656274539558,MATH 10B,A02,083208,Lim; Seonhee,7,0,35,28
1656274539558,MATH 10B,A03,093472,Staff,1,0,34,33
1656274539558,MATH 10B,B01,083739,Sinha; Shubham,11,0,30,19
1656274545581,MATH 18,A01,083743,Cinel; Cameron Alexander,7,0,30,23
1656274545581,MATH 18,A02,083744,Cinel; Cameron Alexander,9,0,30,21
1656274545581,MATH 18,A03,083745,Cinel; Cameron Alexander,5,0,30,25
1656274545581,MATH 18,B01,083748,Rideout; David Porter,1,0,36,35
1656274545581,MATH 18,B02,083749,Rideout; David Porter,0,0,36,36
1656274545581,MATH 18,B03,083750,Rideout; David Porter,0,0,36,36
1656274545581,MATH 18,B04,083751,Rideout; David Porter,0,1,36,36
1656274545581,MATH 18,B05,093473,Rideout; David Porter,0,0,36,36
1656274545581,MATH 18,B06,093474,Rideout; David Porter,3,0,36,33
1656274551606,MATH 20A,A01,083754,Zheng; Zequn,11,0,40,29
1656274557629,MATH 20B,A01,083756,Briones; Jor-el Thomas Caparas,0,0,36,36
1656274557629,MATH 20B,A02,083757,Briones; Jor-el Thomas Caparas,0,0,36,36
1656274557629,MATH 20B,A03,093475,Staff,0,0,36,36
1656274563654,MATH 20C,A01,083760,Briones; Jor-el Thomas Caparas,0,0,35,35
1656274563654,MATH 20C,A02,083761,Briones; Jor-el Thomas Caparas,9,1,35,26
1656274563654,MATH 20C,A03,093476,Staff,0,0,35,35
1656274563654,MATH 20C,B01,083762,Bach; Quang Tran,1,0,30,29
1656274569683,MATH 20D,A01,083765,Tran; Brian Kha,1,0,30,29
1656274569683,MATH 20D,A02,083766,Tran; Brian Kha,0,1,30,30
1656274569683,MATH 20D,A03,083767,Tran; Brian Kha,2,0,30,28
1656274575711,MATH 20E,A01,083771,Ganguly; Soumya,3,0,32,29
1656274575711,MATH 20E,A02,083772,Ganguly; Soumya,0,0,32,32
1656274575711,MATH 20E,B01,083773,Ciotti; Benjamin,16,0,35,19
1656274575711,MATH 20E,B02,083774,Ciotti; Benjamin,15,0,35,20
1656274581735,MATH 103A,A01,083777,Greenfeld; Be'Eri,1,0,36,35
1656274581735,MATH 103A,A02,083778,Greenfeld; Be'Eri,2,0,36,34
1656274581735,MATH 103A,A03,093561,Staff,5,0,36,31
1656274581735,MATH 103A,B01,083779,Greenfeld; Be'Eri,8,0,36,28
1656274581735,MATH 103A,B02,083780,Greenfeld; Be'Eri,0,0,36,36
1656274581735,MATH 103A,B03,093562,Staff,0,0,36,36
1656274587763,MATH 105,A01,085443,Carter; Anne Toulson,5,0,35,30
1656274587763,MATH 105,A02,093477,Staff,14,0,35,21
1656274593786,MATH 109,A01,083213,Ganzberger; Geoffrey Michael,1,0,34,33
1656274593786,MATH 109,A02,083214,Ganzberger; Geoffrey Michael,0,0,34,34
1656274593786,MATH 109,A03,093478,Staff,1,0,34,33
1656274593786,MATH 109,B01,083215,Ganzberger; Geoffrey Michael,4,0,32,28
1656274593786,MATH 109,B02,083216,Ganzberger; Geoffrey Michael,1,0,32,31
1656274593786,MATH 109,B03,093479,Staff,3,0,32,29
1656274599813,MATH 142A,A01,083219,Chow; Bennett,2,0,32,30
1656274599813,MATH 142A,A02,083220,Chow; Bennett,8,0,32,24
1656274599813,MATH 142A,A03,093480,Staff,5,0,32,27
1656274599813,MATH 142A,B03,093481,Staff,3,0,32,29
1656274599813,MATH 142A,B04,093558,Staff,6,0,32,26
1656274599813,MATH 142A,B05,093559,Staff,0,0,32,32
1656274605837,MATH 193A,A01,083224,Rotar; Vladimir,0,1,34,34
1656274605837,MATH 193A,A02,083225,Rotar; Vladimir,0,0,34,34
1656274605837,MATH 193A,A03,083781,Rotar; Vladimir,0,0,34,34
1656274605837,MATH 193A,A04,083782,Rotar; Vladimir,6,0,34,28
1656274605837,MATH 193A,A05,093482,Rotar; Vladimir,0,0,34,34
1656274611861,MATH 197,001,091859,McAuley; Julian John,9999,0,9999,0
1656274611861,MATH 197,002,095566,Kedlaya; Kiran S.,9997,0,9999,2
1656274611861,MATH 197,003,095567,Xiao; Ming,9999,0,9999,0
1656274611861,MATH 197,004,095571,Perols; Johan Lars,9998,0,9999,1
1656274618919,COGS 9,A01,083615,Shannon; Kyle Michael,4,0,75,71
1656274624943,COGS 11,A01,083617,Boyle; Mary E. T.,14,0,48,34
1656274630974,COGS 13,A01,083071,Bastos; Amalia Pinkusfeld,5,0,71,66
1656274637000,COGS 14A,A01,092681,Semenuks; Arturs,1,12,100,99
1656274643024,COGS 14B,A01,083073,Cheng; Tzu-Han,7,0,63,56
1656274649048,COGS 17,A01,092677,Semenuks; Arturs,8,0,81,73
1656274655076,COGS 100,A01,083619,Allen; Michael Gordon,2,0,70,68
1656274661099,COGS 101A,A01,083621,Davis; Joshua Daniel,4,0,68,64
1656274667123,COGS 101B,A01,091572,Allen; Michael Gordon,4,0,65,61
1656274673151,COGS 101C,A01,083625,Delgado; Tania,10,0,35,25
1656274679174,COGS 107A,A01,083627,Boyle; Mary E. T.,0,0,60,60
1656274685207,COGS 118A,A01,083075,Gupta; Anjum,8,0,76,68
1656274691232,CSE 3,A50,083646,Miranda; Gregory Joseph,18,0,50,32
1656274697259,CSE 8A,A50,083650,Miranda; Gregory Joseph,2,2,56,54
1656274703286,CSE 11,A01,083080,Cao; Yingjun,0,48,40,40
1656274709309,CSE 12,A01,083652,Krause-Levy; Sophia Louisa,5,1,120,115
1656274715332,CSE 15L,A01,083654,Morris; Justin Loren,2,0,50,48
1656274715332,CSE 15L,A02,083655,Morris; Justin Loren,4,0,50,46
1656274721359,CSE 20,A01,083657,Tran; Khoa Dang,30,0,80,50
1656274727383,CSE 21,A01,095574,Bach; Quang Tran,23,0,48,25
1656274733407,CSE 30,A01,083084,Eldon; John,2,6,80,78
1656274733407,CSE 30,B01,095061,Bhaskar; Nishant,0,1,50,50
1656274739431,CSE 100,A01,083659,Cao; Yingjun,1,18,70,69
1656274745455,CSE 134B,A01,083661,Powell; Thomas Allan,5,0,100,95
1656274751477,CSE 140,A01,083663,Gungor; Onat,9,0,85,76
1656274757503,CSE 140L,A01,083088,Eldon; John,9,0,100,91
1656274763533,CSE 175,A01,083665,Kumar; Rakesh,0,0,25,25
1656274769556,CSE 190,A00,092507,Dubnov; Shlomo,3,0,20,17
1656274775579,ECE 45,A01,083139,Congero; Spencer William,1,0,75,74
1656274781604,ECE 65,A50,083695,Saad; Andrew S,9,0,30,21
1656274781604,ECE 65,A51,095125,Staff,24,0,26,2
1656274787627,ECE 109,A01,091882,Touri; Behrouz,0,1,70,70
1656274793655,ECE 180,A00,083140,Abi Samra; Nicholas Camill,1,0,30,29
1656274793655,ECE 180,B00,083141,Abi Samra; Nicholas Camill,0,4,30,30
1656274799680,MATH 10A,A01,083735,Patchell; Gregory David,0,0,30,30
1656274799680,MATH 10A,A02,083736,Patchell; Gregory David,22,0,30,8
1656274799680,MATH 10A,A03,083737,Patchell; Gregory David,16,0,30,14
1656274805737,MATH 10B,A01,083207,Lim; Seonhee,0,0,34,34
1656274805737,MATH 10B,A02,083208,Lim; Seonhee,7,0,35,28
1656274805737,MATH 10B,A03,093472,Staff,1,0,34,33
1656274805737,MATH 10B,B01,083739,Sinha; Shubham,11,0,30,19
1656274811762,MATH 18,A01,083743,Cinel; Cameron Alexander,7,0,30,23
1656274811762,MATH 18,A02,083744,Cinel; Cameron Alexander,9,0,30,21
1656274811762,MATH 18,A03,083745,Cinel; Cameron Alexander,5,0,30,25
1656274811762,MATH 18,B01,083748,Rideout; David Porter,1,0,36,35
1656274811762,MATH 18,B02,083749,Rideout; David Porter,0,0,36,36
1656274811762,MATH 18,B03,083750,Rideout; David Porter,0,0,36,36
1656274811762,MATH 18,B04,083751,Rideout; David Porter,0,1,36,36
1656274811762,MATH 18,B05,093473,Rideout; David Porter,0,0,36,36
1656274811762,MATH 18,B06,093474,Rideout; David Porter,3,0,36,33
1656274817790,MATH 20A,A01,083754,Zheng; Zequn,11,0,40,29
1656274823818,MATH 20B,A01,083756,Briones; Jor-el Thomas Caparas,0,0,36,36
1656274823818,MATH 20B,A02,083757,Briones; Jor-el Thomas Caparas,0,0,36,36
1656274823818,MATH 20B,A03,093475,Staff,0,0,36,36
1656274829846,MATH 20C,A01,083760,Briones; Jor-el Thomas Caparas,0,0,35,35
1656274829846,MATH 20C,A02,083761,Briones; Jor-el Thomas Caparas,9,1,35,26
1656274829846,MATH 20C,A03,093476,Staff,0,0,35,35
1656274829846,MATH 20C,B01,083762,Bach; Quang Tran,1,0,30,29
1656274835871,MATH 20D,A01,083765,Tran; Brian Kha,1,0,30,29
1656274835871,MATH 20D,A02,083766,Tran; Brian Kha,0,1,30,30
1656274835871,MATH 20D,A03,083767,Tran; Brian Kha,2,0,30,28
1656274841897,MATH 20E,A01,083771,Ganguly; Soumya,3,0,32,29
1656274841897,MATH 20E,A02,083772,Ganguly; Soumya,0,0,32,32
1656274841897,MATH 20E,B01,083773,Ciotti; Benjamin,16,0,35,19
1656274841897,MATH 20E,B02,083774,Ciotti; Benjamin,15,0,35,20
1656274847922,MATH 103A,A01,083777,Greenfeld; Be'Eri,1,0,36,35
1656274847922,MATH 103A,A02,083778,Greenfeld; Be'Eri,2,0,36,34
1656274847922,MATH 103A,A03,093561,Staff,5,0,36,31
1656274847922,MATH 103A,B01,083779,Greenfeld; Be'Eri,8,0,36,28
1656274847922,MATH 103A,B02,083780,Greenfeld; Be'Eri,0,0,36,36
1656274847922,MATH 103A,B03,093562,Staff,0,0,36,36
1656274853945,MATH 105,A01,085443,Carter; Anne Toulson,5,0,35,30
1656274853945,MATH 105,A02,093477,Staff,14,0,35,21
1656274859969,MATH 109,A01,083213,Ganzberger; Geoffrey Michael,1,0,34,33
1656274859969,MATH 109,A02,083214,Ganzberger; Geoffrey Michael,0,0,34,34
1656274859969,MATH 109,A03,093478,Staff,1,0,34,33
1656274859969,MATH 109,B01,083215,Ganzberger; Geoffrey Michael,4,0,32,28
1656274859969,MATH 109,B02,083216,Ganzberger; Geoffrey Michael,1,0,32,31
1656274859969,MATH 109,B03,093479,Staff,3,0,32,29
1656274866001,MATH 142A,A01,083219,Chow; Bennett,2,0,32,30
1656274866001,MATH 142A,A02,083220,Chow; Bennett,8,0,32,24
1656274866001,MATH 142A,A03,093480,Staff,5,0,32,27
1656274866001,MATH 142A,B03,093481,Staff,3,0,32,29
1656274866001,MATH 142A,B04,093558,Staff,6,0,32,26
1656274866001,MATH 142A,B05,093559,Staff,0,0,32,32
1656274872026,MATH 193A,A01,083224,Rotar; Vladimir,0,1,34,34
1656274872026,MATH 193A,A02,083225,Rotar; Vladimir,0,0,34,34
1656274872026,MATH 193A,A03,083781,Rotar; Vladimir,0,0,34,34
1656274872026,MATH 193A,A04,083782,Rotar; Vladimir,6,0,34,28
1656274872026,MATH 193A,A05,093482,Rotar; Vladimir,0,0,34,34
1656274878051,MATH 197,001,091859,McAuley; Julian John,9999,0,9999,0
1656274878051,MATH 197,002,095566,Kedlaya; Kiran S.,9997,0,9999,2
1656274878051,MATH 197,003,095567,Xiao; Ming,9999,0,9999,0
1656274878051,MATH 197,004,095571,Perols; Johan Lars,9998,0,9999,1
1656274885132,COGS 9,A01,083615,Shannon; Kyle Michael,4,0,75,71
1656274891155,COGS 11,A01,083617,Boyle; Mary E. T.,14,0,48,34
1656274897182,COGS 13,A01,083071,Bastos; Amalia Pinkusfeld,5,0,71,66
1656274903205,COGS 14A,A01,092681,Semenuks; Arturs,1,12,100,99
1656274909232,COGS 14B,A01,083073,Cheng; Tzu-Han,7,0,63,56
1656274915255,COGS 17,A01,092677,Semenuks; Arturs,8,0,81,73
1656274921279,COGS 100,A01,083619,Allen; Michael Gordon,2,0,70,68
1656274927303,COGS 101A,A01,083621,Davis; Joshua Daniel,4,0,68,64
1656274933335,COGS 101B,A01,091572,Allen; Michael Gordon,4,0,65,61
1656274939368,COGS 101C,A01,083625,Delgado; Tania,10,0,35,25
1656274945391,COGS 107A,A01,083627,Boyle; Mary E. T.,0,0,60,60
1656274951415,COGS 118A,A01,083075,Gupta; Anjum,8,0,76,68
1656274957437,CSE 3,A50,083646,Miranda; Gregory Joseph,18,0,50,32
1656274963469,CSE 8A,A50,083650,Miranda; Gregory Joseph,2,2,56,54
1656274969494,CSE 11,A01,083080,Cao; Yingjun,0,48,40,40
1656274975517,CSE 12,A01,083652,Krause-Levy; Sophia Louisa,5,1,120,115
1656274981631,CSE 15L,A01,083654,Morris; Justin Loren,2,0,50,48
1656274981631,CSE 15L,A02,083655,Morris; Justin Loren,4,0,50,46
1656274987659,CSE 20,A01,083657,Tran; Khoa Dang,30,0,80,50
1656274993686,CSE 21,A01,095574,Bach; Quang Tran,23,0,48,25
1656274999711,CSE 30,A01,083084,Eldon; John,2,6,80,78
1656274999711,CSE 30,B01,095061,Bhaskar; Nishant,0,1,50,50
1656275005734,CSE 100,A01,083659,Cao; Yingjun,1,18,70,69
1656275011762,CSE 134B,A01,083661,Powell; Thomas Allan,5,0,100,95
1656275017788,CSE 140,A01,083663,Gungor; Onat,9,0,85,76
1656275023819,CSE 140L,A01,083088,Eldon; John,9,0,100,91
1656275029867,CSE 175,A01,083665,Kumar; Rakesh,0,0,25,25
1656275035893,CSE 190,A00,092507,Dubnov; Shlomo,3,0,20,17
1656275041918,ECE 45,A01,083139,Congero; Spencer William,1,0,75,74
1656275047942,ECE 65,A50,083695,Saad; Andrew S,9,0,30,21
1656275047942,ECE 65,A51,095125,Staff,24,0,26,2
1656275053978,ECE 109,A01,091882,Touri; Behrouz,0,1,70,70
1656275060001,ECE 180,A00,083140,Abi Samra; Nicholas Camill,1,0,30,29
1656275060001,ECE 180,B00,083141,Abi Samra; Nicholas Camill,0,4,30,30
1656275066027,MATH 10A,A01,083735,Patchell; Gregory David,0,0,30,30
1656275066027,MATH 10A,A02,083736,Patchell; Gregory David,22,0,30,8
1656275066027,MATH 10A,A03,083737,Patchell; Gregory David,16,0,30,14
1656275072051,MATH 10B,A01,083207,Lim; Seonhee,0,0,34,34
1656275072051,MATH 10B,A02,083208,Lim; Seonhee,7,0,35,28
1656275072051,MATH 10B,A03,093472,Staff,1,0,34,33
1656275072051,MATH 10B,B01,083739,Sinha; Shubham,11,0,30,19
1656275078081,MATH 18,A01,083743,Cinel; Cameron Alexander,7,0,30,23
1656275078081,MATH 18,A02,083744,Cinel; Cameron Alexander,9,0,30,21
1656275078081,MATH 18,A03,083745,Cinel; Cameron Alexander,5,0,30,25
1656275078081,MATH 18,B01,083748,Rideout; David Porter,1,0,36,35
1656275078081,MATH 18,B02,083749,Rideout; David Porter,0,0,36,36
1656275078081,MATH 18,B03,083750,Rideout; David Porter,0,0,36,36
1656275078081,MATH 18,B04,083751,Rideout; David Porter,0,1,36,36
1656275078081,MATH 18,B05,093473,Rideout; David Porter,0,0,36,36
1656275078081,MATH 18,B06,093474,Rideout; David Porter,3,0,36,33
1656275084105,MATH 20A,A01,083754,Zheng; Zequn,11,0,40,29
1656275090132,MATH 20B,A01,083756,Briones; Jor-el Thomas Caparas,0,0,36,36
1656275090132,MATH 20B,A02,083757,Briones; Jor-el Thomas Caparas,0,0,36,36
1656275090132,MATH 20B,A03,093475,Staff,0,0,36,36
1656275096155,MATH 20C,A01,083760,Briones; Jor-el Thomas Caparas,0,0,35,35
1656275096155,MATH 20C,A02,083761,Briones; Jor-el Thomas Caparas,9,1,35,26
1656275096155,MATH 20C,A03,093476,Staff,0,0,35,35
1656275096155,MATH 20C,B01,083762,Bach; Quang Tran,1,0,30,29
1656275102185,MATH 20D,A01,083765,Tran; Brian Kha,1,0,30,29
1656275102185,MATH 20D,A02,083766,Tran; Brian Kha,0,1,30,30
1656275102185,MATH 20D,A03,083767,Tran; Brian Kha,2,0,30,28
1656275108208,MATH 20E,A01,083771,Ganguly; Soumya,3,0,32,29
1656275108208,MATH 20E,A02,083772,Ganguly; Soumya,0,0,32,32
1656275108208,MATH 20E,B01,083773,Ciotti; Benjamin,16,0,35,19
1656275108208,MATH 20E,B02,083774,Ciotti; Benjamin,15,0,35,20
1656275114252,MATH 103A,A01,083777,Greenfeld; Be'Eri,1,0,36,35
1656275114252,MATH 103A,A02,083778,Greenfeld; Be'Eri,2,0,36,34
1656275114252,MATH 103A,A03,093561,Staff,5,0,36,31
1656275114252,MATH 103A,B01,083779,Greenfeld; Be'Eri,8,0,36,28
1656275114252,MATH 103A,B02,083780,Greenfeld; Be'Eri,0,0,36,36
1656275114252,MATH 103A,B03,093562,Staff,0,0,36,36
1656275120275,MATH 105,A01,085443,Carter; Anne Toulson,5,0,35,30
1656275120275,MATH 105,A02,093477,Staff,14,0,35,21
1656275126303,MATH 109,A01,083213,Ganzberger; Geoffrey Michael,1,0,34,33
1656275126303,MATH 109,A02,083214,Ganzberger; Geoffrey Michael,0,0,34,34
1656275126303,MATH 109,A03,093478,Staff,1,0,34,33
1656275126303,MATH 109,B01,083215,Ganzberger; Geoffrey Michael,4,0,32,28
1656275126303,MATH 109,B02,083216,Ganzberger; Geoffrey Michael,1,0,32,31
1656275126303,MATH 109,B03,093479,Staff,3,0,32,29
1656275132327,MATH 142A,A01,083219,Chow; Bennett,2,0,32,30
1656275132327,MATH 142A,A02,083220,Chow; Bennett,8,0,32,24
1656275132327,MATH 142A,A03,093480,Staff,5,0,32,27
1656275132327,MATH 142A,B03,093481,Staff,3,0,32,29
1656275132327,MATH 142A,B04,093558,Staff,6,0,32,26
1656275132327,MATH 142A,B05,093559,Staff,0,0,32,32
1656275138356,MATH 193A,A01,083224,Rotar; Vladimir,0,1,34,34
1656275138356,MATH 193A,A02,083225,Rotar; Vladimir,0,0,34,34
1656275138356,MATH 193A,A03,083781,Rotar; Vladimir,0,0,34,34
1656275138356,MATH 193A,A04,083782,Rotar; Vladimir,6,0,34,28
1656275138356,MATH 193A,A05,093482,Rotar; Vladimir,0,0,34,34
1656275144383,MATH 197,001,091859,McAuley; Julian John,9999,0,9999,0
1656275144383,MATH 197,002,095566,Kedlaya; Kiran S.,9997,0,9999,2
1656275144383,MATH 197,003,095567,Xiao; Ming,9999,0,9999,0
1656275144383,MATH 197,004,095571,Perols; Johan Lars,9998,0,9999,1
1656275151450,COGS 9,A01,083615,Shannon; Kyle Michael,4,0,75,71
1656275157475,COGS 11,A01,083617,Boyle; Mary E. T.,14,0,48,34
1656275163501,COGS 13,A01,083071,Bastos; Amalia Pinkusfeld,5,0,71,66
1656275169528,COGS 14A,A01,092681,Semenuks; Arturs,1,12,100,99
1656275175551,COGS 14B,A01,083073,Cheng; Tzu-Han,7,0,63,56
1656275181579,COGS 17,A01,092677,Semenuks; Arturs,8,0,81,73
1656275187602,COGS 100,A01,083619,Allen; Michael Gordon,2,0,70,68
1656275193626,COGS 101A,A01,083621,Davis; Joshua Daniel,4,0,68,64
1656275199651,COGS 101B,A01,091572,Allen; Michael Gordon,4,0,65,61
1656275205674,COGS 101C,A01,083625,Delgado; Tania,10,0,35,25
1656275211701,COGS 107A,A01,083627,Boyle; Mary E. T.,0,0,60,60
1656275217727,COGS 118A,A01,083075,Gupta; Anjum,8,0,76,68
1656275223753,CSE 3,A50,083646,Miranda; Gregory Joseph,18,0,50,32
1656275229777,CSE 8A,A50,083650,Miranda; Gregory Joseph,2,2,56,54
1656275235804,CSE 11,A01,083080,Cao; Yingjun,0,48,40,40
1656275241826,CSE 12,A01,083652,Krause-Levy; Sophia Louisa,5,1,120,115
1656275247849,CSE 15L,A01,083654,Morris; Justin Loren,2,0,50,48
1656275247849,CSE 15L,A02,083655,Morris; Justin Loren,4,0,50,46
1656275253876,CSE 20,A01,083657,Tran; Khoa Dang,30,0,80,50
1656275259903,CSE 21,A01,095574,Bach; Quang Tran,23,0,48,25
1656275265926,CSE 30,A01,083084,Eldon; John,2,6,80,78
1656275265926,CSE 30,B01,095061,Bhaskar; Nishant,0,1,50,50
1656275271949,CSE 100,A01,083659,Cao; Yingjun,1,18,70,69
1656275277975,CSE 134B,A01,083661,Powell; Thomas Allan,5,0,100,95
1656275284001,CSE 140,A01,083663,Gungor; Onat,9,0,85,76
1656275290024,CSE 140L,A01,083088,Eldon; John,9,0,100,91
1656275296051,CSE 175,A01,083665,Kumar; Rakesh,0,0,25,25
1656275302074,CSE 190,A00,092507,Dubnov; Shlomo,3,0,20,17
1656275308100,ECE 45,A01,083139,Congero; Spencer William,1,0,75,74
1656275314124,ECE 65,A50,083695,Saad; Andrew S,9,0,30,21
1656275314124,ECE 65,A51,095125,Staff,24,0,26,2
1656275320150,ECE 109,A01,091882,Touri; Behrouz,0,1,70,70
1656275326174,ECE 180,A00,083140,Abi Samra; Nicholas Camill,1,0,30,29
1656275326174,ECE 180,B00,083141,Abi Samra; Nicholas Camill,0,4,30,30
1656275332200,MATH 10A,A01,083735,Patchell; Gregory David,0,0,30,30
1656275332200,MATH 10A,A02,083736,Patchell; Gregory David,22,0,30,8
1656275332200,MATH 10A,A03,083737,Patchell; Gregory David,16,0,30,14
1656275338226,MATH 10B,A01,083207,Lim; Seonhee,0,0,34,34
1656275338226,MATH 10B,A02,083208,Lim; Seonhee,7,0,35,28
1656275338226,MATH 10B,A03,093472,Staff,1,0,34,33
1656275338226,MATH 10B,B01,083739,Sinha; Shubham,11,0,30,19
1656275344251,MATH 18,A01,083743,Cinel; Cameron Alexander,7,0,30,23
1656275344251,MATH 18,A02,083744,Cinel; Cameron Alexander,9,0,30,21
1656275344251,MATH 18,A03,083745,Cinel; Cameron Alexander,5,0,30,25
1656275344251,MATH 18,B01,083748,Rideout; David Porter,1,0,36,35
1656275344251,MATH 18,B02,083749,Rideout; David Porter,0,0,36,36
1656275344251,MATH 18,B03,083750,Rideout; David Porter,0,0,36,36
1656275344251,MATH 18,B04,083751,Rideout; David Porter,0,1,36,36
1656275344251,MATH 18,B05,093473,Rideout; David Porter,0,0,36,36
1656275344251,MATH 18,B06,093474,Rideout; David Porter,3,0,36,33
1656275350273,MATH 20A,A01,083754,Zheng; Zequn,11,0,40,29
1656275356300,MATH 20B,A01,083756,Briones; Jor-el Thomas Caparas,0,0,36,36
1656275356300,MATH 20B,A02,083757,Briones; Jor-el Thomas Caparas,0,0,36,36
1656275356300,MATH 20B,A03,093475,Staff,0,0,36,36
1656275362323,MATH 20C,A01,083760,Briones; Jor-el Thomas Caparas,0,0,35,35
1656275362323,MATH 20C,A02,083761,Briones; Jor-el Thomas Caparas,9,1,35,26
1656275362323,MATH 20C,A03,093476,Staff,0,0,35,35
1656275362323,MATH 20C,B01,083762,Bach; Quang Tran,1,0,30,29
1656275368351,MATH 20D,A01,083765,Tran; Brian Kha,1,0,30,29
1656275368351,MATH 20D,A02,083766,Tran; Brian Kha,0,1,30,30
1656275368351,MATH 20D,A03,083767,Tran; Brian Kha,2,0,30,28
1656275374380,MATH 20E,A01,083771,Ganguly; Soumya,3,0,32,29
1656275374380,MATH 20E,A02,083772,Ganguly; Soumya,0,0,32,32
1656275374380,MATH 20E,B01,083773,Ciotti; Benjamin,16,0,35,19
1656275374380,MATH 20E,B02,083774,Ciotti; Benjamin,15,0,35,20
1656275380404,MATH 103A,A01,083777,Greenfeld; Be'Eri,1,0,36,35
1656275380404,MATH 103A,A02,083778,Greenfeld; Be'Eri,2,0,36,34
1656275380404,MATH 103A,A03,093561,Staff,5,0,36,31
1656275380404,MATH 103A,B01,083779,Greenfeld; Be'Eri,8,0,36,28
1656275380404,MATH 103A,B02,083780,Greenfeld; Be'Eri,0,0,36,36
1656275380404,MATH 103A,B03,093562,Staff,0,0,36,36
1656275386431,MATH 105,A01,085443,Carter; Anne Toulson,5,0,35,30
1656275386431,MATH 105,A02,093477,Staff,14,0,35,21
1656275392459,MATH 109,A01,083213,Ganzberger; Geoffrey Michael,1,0,34,33
1656275392459,MATH 109,A02,083214,Ganzberger; Geoffrey Michael,0,0,34,34
1656275392459,MATH 109,A03,093478,Staff,1,0,34,33
1656275392459,MATH 109,B01,083215,Ganzberger; Geoffrey Michael,4,0,32,28
1656275392459,MATH 109,B02,083216,Ganzberger; Geoffrey Michael,1,0,32,31
1656275392459,MATH 109,B03,093479,Staff,3,0,32,29
1656275398483,MATH 142A,A01,083219,Chow; Bennett,2,0,32,30
1656275398483,MATH 142A,A02,083220,Chow; Bennett,8,0,32,24
1656275398483,MATH 142A,A03,093480,Staff,5,0,32,27
1656275398483,MATH 142A,B03,093481,Staff,3,0,32,29
1656275398483,MATH 142A,B04,093558,Staff,6,0,32,26
1656275398483,MATH 142A,B05,093559,Staff,0,0,32,32
1656275404510,MATH 193A,A01,083224,Rotar; Vladimir,0,1,34,34
1656275404510,MATH 193A,A02,083225,Rotar; Vladimir,0,0,34,34
1656275404510,MATH 193A,A03,083781,Rotar; Vladimir,0,0,34,34
1656275404510,MATH 193A,A04,083782,Rotar; Vladimir,6,0,34,28
1656275404510,MATH 193A,A05,093482,Rotar; Vladimir,0,0,34,34
1656275410532,MATH 197,001,091859,McAuley; Julian John,9999,0,9999,0
1656275410532,MATH 197,002,095566,Kedlaya; Kiran S.,9997,0,9999,2
1656275410532,MATH 197,003,095567,Xiao; Ming,9999,0,9999,0
1656275410532,MATH 197,004,095571,Perols; Johan Lars,9998,0,9999,1
1656275417586,COGS 9,A01,083615,Shannon; Kyle Michael,4,0,75,71
1656275423610,COGS 11,A01,083617,Boyle; Mary E. T.,14,0,48,34
1656275429638,COGS 13,A01,083071,Bastos; Amalia Pinkusfeld,5,0,71,66
1656275435665,COGS 14A,A01,092681,Semenuks; Arturs,1,12,100,99
1656275441688,COGS 14B,A01,083073,Cheng; Tzu-Han,7,0,63,56
1656275447712,COGS 17,A01,092677,Semenuks; Arturs,8,0,81,73
1656275453735,COGS 100,A01,083619,Allen; Michael Gordon,2,0,70,68
1656275459762,COGS 101A,A01,083621,Davis; Joshua Daniel,4,0,68,64
1656275465788,COGS 101B,A01,091572,Allen; Michael Gordon,4,0,65,61
1656275471818,COGS 101C,A01,083625,Delgado; Tania,10,0,35,25
1656275477843,COGS 107A,A01,083627,Boyle; Mary E. T.,0,0,60,60
1656275483867,COGS 118A,A01,083075,Gupta; Anjum,8,0,76,68
1656275489897,CSE 3,A50,083646,Miranda; Gregory Joseph,18,0,50,32
1656275495924,CSE 8A,A50,083650,Miranda; Gregory Joseph,2,2,56,54
1656275501947,CSE 11,A01,083080,Cao; Yingjun,0,48,40,40
1656275507971,CSE 12,A01,083652,Krause-Levy; Sophia Louisa,5,1,120,115
1656275513994,CSE 15L,A01,083654,Morris; Justin Loren,2,0,50,48
1656275513994,CSE 15L,A02,083655,Morris; Justin Loren,4,0,50,46
1656275520018,CSE 20,A01,083657,Tran; Khoa Dang,30,0,80,50
1656275526041,CSE 21,A01,095574,Bach; Quang Tran,23,0,48,25
1656275532064,CSE 30,A01,083084,Eldon; John,2,6,80,78
1656275532064,CSE 30,B01,095061,Bhaskar; Nishant,0,1,50,50
1656275538086,CSE 100,A01,083659,Cao; Yingjun,1,18,70,69
1656275544111,CSE 134B,A01,083661,Powell; Thomas Allan,5,0,100,95
1656275550134,CSE 140,A01,083663,Gungor; Onat,9,0,85,76
1656275556157,CSE 140L,A01,083088,Eldon; John,9,0,100,91
1656275562180,CSE 175,A01,083665,Kumar; Rakesh,0,0,25,25
1656275568203,CSE 190,A00,092507,Dubnov; Shlomo,3,0,20,17
1656275574227,ECE 45,A01,083139,Congero; Spencer William,1,0,75,74
1656275580334,ECE 65,A50,083695,Saad; Andrew S,9,0,30,21
1656275580334,ECE 65,A51,095125,Staff,24,0,26,2
1656275586362,ECE 109,A01,091882,Touri; Behrouz,0,1,70,70
1656275592389,ECE 180,A00,083140,Abi Samra; Nicholas Camill,1,0,30,29
1656275592389,ECE 180,B00,083141,Abi Samra; Nicholas Camill,0,4,30,30
1656275598412,MATH 10A,A01,083735,Patchell; Gregory David,0,0,30,30
1656275598412,MATH 10A,A02,083736,Patchell; Gregory David,22,0,30,8
1656275598412,MATH 10A,A03,083737,Patchell; Gregory David,16,0,30,14
1656275604436,MATH 10B,A01,083207,Lim; Seonhee,0,0,34,34
1656275604436,MATH 10B,A02,083208,Lim; Seonhee,7,0,35,28
1656275604436,MATH 10B,A03,093472,Staff,1,0,34,33
1656275604436,MATH 10B,B01,083739,Sinha; Shubham,11,0,30,19
1656275610468,MATH 18,A01,083743,Cinel; Cameron Alexander,7,0,30,23
1656275610468,MATH 18,A02,083744,Cinel; Cameron Alexander,9,0,30,21
1656275610468,MATH 18,A03,083745,Cinel; Cameron Alexander,5,0,30,25
1656275610468,MATH 18,B01,083748,Rideout; David Porter,1,0,36,35
1656275610468,MATH 18,B02,083749,Rideout; David Porter,0,0,36,36
1656275610468,MATH 18,B03,083750,Rideout; David Porter,0,0,36,36
1656275610468,MATH 18,B04,083751,Rideout; David Porter,0,1,36,36
1656275610468,MATH 18,B05,093473,Rideout; David Porter,0,0,36,36
1656275610468,MATH 18,B06,093474,Rideout; David Porter,3,0,36,33
1656275616503,MATH 20A,A01,083754,Zheng; Zequn,11,0,40,29
1656275622526,MATH 20B,A01,083756,Briones; Jor-el Thomas Caparas,0,0,36,36
1656275622526,MATH 20B,A02,083757,Briones; Jor-el Thomas Caparas,0,0,36,36
1656275622526,MATH 20B,A03,093475,Staff,0,0,36,36
1656275628552,MATH 20C,A01,083760,Briones; Jor-el Thomas Caparas,0,0,35,35
1656275628552,MATH 20C,A02,083761,Briones; Jor-el Thomas Caparas,9,1,35,26
1656275628552,MATH 20C,A03,093476,Staff,0,0,35,35
1656275628552,MATH 20C,B01,083762,Bach; Quang Tran,1,0,30,29
1656275634577,MATH 20D,A01,083765,Tran; Brian Kha,1,0,30,29
1656275634577,MATH 20D,A02,083766,Tran; Brian Kha,0,1,30,30
1656275634577,MATH 20D,A03,083767,Tran; Brian Kha,2,0,30,28
1656275640601,MATH 20E,A01,083771,Ganguly; Soumya,3,0,32,29
1656275640601,MATH 20E,A02,083772,Ganguly; Soumya,0,0,32,32
1656275640601,MATH 20E,B01,083773,Ciotti; Benjamin,16,0,35,19
1656275640601,MATH 20E,B02,083774,Ciotti; Benjamin,15,0,35,20
1656275646629,MATH 103A,A01,083777,Greenfeld; Be'Eri,1,0,36,35
1656275646629,MATH 103A,A02,083778,Greenfeld; Be'Eri,2,0,36,34
1656275646629,MATH 103A,A03,093561,Staff,5,0,36,31
1656275646629,MATH 103A,B01,083779,Greenfeld; Be'Eri,8,0,36,28
1656275646629,MATH 103A,B02,083780,Greenfeld; Be'Eri,0,0,36,36
1656275646629,MATH 103A,B03,093562,Staff,0,0,36,36
1656275652653,MATH 105,A01,085443,Carter; Anne Toulson,5,0,35,30
1656275652653,MATH 105,A02,093477,Staff,14,0,35,21
1656275658681,MATH 109,A01,083213,Ganzberger; Geoffrey Michael,1,0,34,33
1656275658681,MATH 109,A02,083214,Ganzberger; Geoffrey Michael,0,0,34,34
1656275658681,MATH 109,A03,093478,Staff,1,0,34,33
1656275658681,MATH 109,B01,083215,Ganzberger; Geoffrey Michael,4,0,32,28
1656275658681,MATH 109,B02,083216,Ganzberger; Geoffrey Michael,1,0,32,31
1656275658681,MATH 109,B03,093479,Staff,3,0,32,29
1656275664711,MATH 142A,A01,083219,Chow; Bennett,2,0,32,30
1656275664711,MATH 142A,A02,083220,Chow; Bennett,8,0,32,24
1656275664711,MATH 142A,A03,093480,Staff,5,0,32,27
1656275664711,MATH 142A,B03,093481,Staff,3,0,32,29
1656275664711,MATH 142A,B04,093558,Staff,6,0,32,26
1656275664711,MATH 142A,B05,093559,Staff,0,0,32,32
1656275670740,MATH 193A,A01,083224,Rotar; Vladimir,0,1,34,34
1656275670740,MATH 193A,A02,083225,Rotar; Vladimir,0,0,34,34
1656275670740,MATH 193A,A03,083781,Rotar; Vladimir,0,0,34,34
1656275670740,MATH 193A,A04,083782,Rotar; Vladimir,6,0,34,28
1656275670740,MATH 193A,A05,093482,Rotar; Vladimir,0,0,34,34
1656275676773,MATH 197,001,091859,McAuley; Julian John,9999,0,9999,0
1656275676773,MATH 197,002,095566,Kedlaya; Kiran S.,9997,0,9999,2
1656275676773,MATH 197,003,095567,Xiao; Ming,9999,0,9999,0
1656275676773,MATH 197,004,095571,Perols; Johan Lars,9998,0,9999,1
1656275683825,COGS 9,A01,083615,Shannon; Kyle Michael,4,0,75,71
1656275689849,COGS 11,A01,083617,Boyle; Mary E. T.,14,0,48,34
1656275695877,COGS 13,A01,083071,Bastos; Amalia Pinkusfeld,5,0,71,66
1656275701903,COGS 14A,A01,092681,Semenuks; Arturs,1,12,100,99
1656275707926,COGS 14B,A01,083073,Cheng; Tzu-Han,7,0,63,56
1656275713950,COGS 17,A01,092677,Semenuks; Arturs,8,0,81,73
1656275719974,COGS 100,A01,083619,Allen; Michael Gordon,2,0,70,68
1656275726000,COGS 101A,A01,083621,Davis; Joshua Daniel,4,0,68,64
1656275732031,COGS 101B,A01,091572,Allen; Michael Gordon,4,0,65,61
1656275738065,COGS 101C,A01,083625,Delgado; Tania,10,0,35,25
1656275744089,COGS 107A,A01,083627,Boyle; Mary E. T.,0,0,60,60
1656275750116,COGS 118A,A01,083075,Gupta; Anjum,8,0,76,68
1656275756141,CSE 3,A50,083646,Miranda; Gregory Joseph,18,0,50,32
1656275762165,CSE 8A,A50,083650,Miranda; Gregory Joseph,2,2,56,54
1656275768188,CSE 11,A01,083080,Cao; Yingjun,0,48,40,40
1656275774211,CSE 12,A01,083652,Krause-Levy; Sophia Louisa,5,1,120,115
1656275780238,CSE 15L,A01,083654,Morris; Justin Loren,2,0,50,48
1656275780238,CSE 15L,A02,083655,Morris; Justin Loren,4,0,50,46
1656275786266,CSE 20,A01,083657,Tran; Khoa Dang,30,0,80,50
1656275792295,CSE 21,A01,095574,Bach; Quang Tran,23,0,48,25
1656275798318,CSE 30,A01,083084,Eldon; John,2,6,80,78
1656275798318,CSE 30,B01,095061,Bhaskar; Nishant,0,1,50,50
1656275804343,CSE 100,A01,083659,Cao; Yingjun,1,18,70,69
1656275810370,CSE 134B,A01,083661,Powell; Thomas Allan,5,0,100,95
1656275816393,CSE 140,A01,083663,Gungor; Onat,9,0,85,76
1656275822416,CSE 140L,A01,083088,Eldon; John,9,0,100,91
1656275828442,CSE 175,A01,083665,Kumar; Rakesh,0,0,25,25
1656275834468,CSE 190,A00,092507,Dubnov; Shlomo,3,0,20,17
1656275840491,ECE 45,A01,083139,Congero; Spencer William,1,0,75,74
1656275846521,ECE 65,A50,083695,Saad; Andrew S,9,0,30,21
1656275846521,ECE 65,A51,095125,Staff,24,0,26,2
1656275852544,ECE 109,A01,091882,Touri; Behrouz,0,1,70,70
1656275858571,ECE 180,A00,083140,Abi Samra; Nicholas Camill,1,0,30,29
1656275858571,ECE 180,B00,083141,Abi Samra; Nicholas Camill,0,4,30,30
1656275864595,MATH 10A,A01,083735,Patchell; Gregory David,0,0,30,30
1656275864595,MATH 10A,A02,083736,Patchell; Gregory David,22,0,30,8
1656275864595,MATH 10A,A03,083737,Patchell; Gregory David,16,0,30,14
1656275870637,MATH 10B,A01,083207,Lim; Seonhee,0,0,34,34
1656275870637,MATH 10B,A02,083208,Lim; Seonhee,7,0,35,28
1656275870637,MATH 10B,A03,093472,Staff,1,0,34,33
1656275870637,MATH 10B,B01,083739,Sinha; Shubham,11,0,30,19
1656275876664,MATH 18,A01,083743,Cinel; Cameron Alexander,7,0,30,23
1656275876664,MATH 18,A02,083744,Cinel; Cameron Alexander,9,0,30,21
1656275876664,MATH 18,A03,083745,Cinel; Cameron Alexander,5,0,30,25
1656275876664,MATH 18,B01,083748,Rideout; David Porter,1,0,36,35
1656275876664,MATH 18,B02,083749,Rideout; David Porter,0,0,36,36
1656275876664,MATH 18,B03,083750,Rideout; David Porter,0,0,36,36
1656275876664,MATH 18,B04,083751,Rideout; David Porter,0,1,36,36
1656275876664,MATH 18,B05,093473,Rideout; David Porter,0,0,36,36
1656275876664,MATH 18,B06,093474,Rideout; David Porter,3,0,36,33
1656275882690,MATH 20A,A01,083754,Zheng; Zequn,11,0,40,29
1656275888718,MATH 20B,A01,083756,Briones; Jor-el Thomas Caparas,0,0,36,36
1656275888718,MATH 20B,A02,083757,Briones; Jor-el Thomas Caparas,0,0,36,36
1656275888718,MATH 20B,A03,093475,Staff,0,0,36,36
1656275894746,MATH 20C,A01,083760,Briones; Jor-el Thomas Caparas,0,0,35,35
1656275894746,MATH 20C,A02,083761,Briones; Jor-el Thomas Caparas,9,1,35,26
1656275894746,MATH 20C,A03,093476,Staff,0,0,35,35
1656275894746,MATH 20C,B01,083762,Bach; Quang Tran,1,0,30,29
1656275900775,MATH 20D,A01,083765,Tran; Brian Kha,1,0,30,29
1656275900775,MATH 20D,A02,083766,Tran; Brian Kha,0,1,30,30
1656275900775,MATH 20D,A03,083767,Tran; Brian Kha,2,0,30,28
1656275906798,MATH 20E,A01,083771,Ganguly; Soumya,3,0,32,29
1656275906798,MATH 20E,A02,083772,Ganguly; Soumya,0,0,32,32
1656275906798,MATH 20E,B01,083773,Ciotti; Benjamin,16,0,35,19
1656275906798,MATH 20E,B02,083774,Ciotti; Benjamin,15,0,35,20
1656275912823,MATH 103A,A01,083777,Greenfeld; Be'Eri,1,0,36,35
1656275912823,MATH 103A,A02,083778,Greenfeld; Be'Eri,2,0,36,34
1656275912823,MATH 103A,A03,093561,Staff,5,0,36,31
1656275912823,MATH 103A,B01,083779,Greenfeld; Be'Eri,8,0,36,28
1656275912823,MATH 103A,B02,083780,Greenfeld; Be'Eri,0,0,36,36
1656275912823,MATH 103A,B03,093562,Staff,0,0,36,36
1656275918854,MATH 105,A01,085443,Carter; Anne Toulson,5,0,35,30
1656275918854,MATH 105,A02,093477,Staff,14,0,35,21
1656275924882,MATH 109,A01,083213,Ganzberger; Geoffrey Michael,1,0,34,33
1656275924882,MATH 109,A02,083214,Ganzberger; Geoffrey Michael,0,0,34,34
1656275924882,MATH 109,A03,093478,Staff,1,0,34,33
1656275924882,MATH 109,B01,083215,Ganzberger; Geoffrey Michael,4,0,32,28
1656275924882,MATH 109,B02,083216,Ganzberger; Geoffrey Michael,1,0,32,31
1656275924882,MATH 109,B03,093479,Staff,3,0,32,29
1656275930912,MATH 142A,A01,083219,Chow; Bennett,2,0,32,30
1656275930912,MATH 142A,A02,083220,Chow; Bennett,8,0,32,24
1656275930912,MATH 142A,A03,093480,Staff,5,0,32,27
1656275930912,MATH 142A,B03,093481,Staff,3,0,32,29
1656275930912,MATH 142A,B04,093558,Staff,6,0,32,26
1656275930912,MATH 142A,B05,093559,Staff,0,0,32,32
1656275936943,MATH 193A,A01,083224,Rotar; Vladimir,0,1,34,34
1656275936943,MATH 193A,A02,083225,Rotar; Vladimir,0,0,34,34
1656275936943,MATH 193A,A03,083781,Rotar; Vladimir,0,0,34,34
1656275936943,MATH 193A,A04,083782,Rotar; Vladimir,6,0,34,28
1656275936943,MATH 193A,A05,093482,Rotar; Vladimir,0,0,34,34
1656275942968,MATH 197,001,091859,McAuley; Julian John,9999,0,9999,0
1656275942968,MATH 197,002,095566,Kedlaya; Kiran S.,9997,0,9999,2
1656275942968,MATH 197,003,095567,Xiao; Ming,9999,0,9999,0
1656275942968,MATH 197,004,095571,Perols; Johan Lars,9998,0,9999,1
1656275950024,COGS 9,A01,083615,Shannon; Kyle Michael,4,0,75,71
1656275956050,COGS 11,A01,083617,Boyle; Mary E. T.,14,0,48,34
1656275962074,COGS 13,A01,083071,Bastos; Amalia Pinkusfeld,5,0,71,66
1656275968116,COGS 14A,A01,092681,Semenuks; Arturs,1,12,100,99
1656275974139,COGS 14B,A01,083073,Cheng; Tzu-Han,7,0,63,56
1656275980169,COGS 17,A01,092677,Semenuks; Arturs,8,0,81,73
1656275986191,COGS 100,A01,083619,Allen; Michael Gordon,2,0,70,68
1656275992217,COGS 101A,A01,083621,Davis; Joshua Daniel,4,0,68,64
1656275998240,COGS 101B,A01,091572,Allen; Michael Gordon,4,0,65,61
1656276004263,COGS 101C,A01,083625,Delgado; Tania,10,0,35,25
1656276010289,COGS 107A,A01,083627,Boyle; Mary E. T.,0,0,60,60
1656276016311,COGS 118A,A01,083075,Gupta; Anjum,8,0,76,68
1656276022339,CSE 3,A50,083646,Miranda; Gregory Joseph,18,0,50,32
1656276028365,CSE 8A,A50,083650,Miranda; Gregory Joseph,2,2,56,54
1656276034390,CSE 11,A01,083080,Cao; Yingjun,0,48,40,40
1656276040412,CSE 12,A01,083652,Krause-Levy; Sophia Louisa,5,1,120,115
1656276046442,CSE 15L,A01,083654,Morris; Justin Loren,2,0,50,48
1656276046442,CSE 15L,A02,083655,Morris; Justin Loren,4,0,50,46
1656276052468,CSE 20,A01,083657,Tran; Khoa Dang,30,0,80,50
1656276058494,CSE 21,A01,095574,Bach; Quang Tran,23,0,48,25
1656276064522,CSE 30,A01,083084,Eldon; John,2,6,80,78
1656276064522,CSE 30,B01,095061,Bhaskar; Nishant,0,1,50,50
1656276070550,CSE 100,A01,083659,Cao; Yingjun,1,18,70,69
1656276076575,CSE 134B,A01,083661,Powell; Thomas Allan,5,0,100,95
1656276082601,CSE 140,A01,083663,Gungor; Onat,9,0,85,76
1656276088627,CSE 140L,A01,083088,Eldon; John,9,0,100,91
1656276094650,CSE 175,A01,083665,Kumar; Rakesh,0,0,25,25
1656276100681,CSE 190,A00,092507,Dubnov; Shlomo,3,0,20,17
1656276106711,ECE 45,A01,083139,Congero; Spencer William,1,0,75,74
1656276112734,ECE 65,A50,083695,Saad; Andrew S,9,0,30,21
1656276112734,ECE 65,A51,095125,Staff,24,0,26,2
1656276118760,ECE 109,A01,091882,Touri; Behrouz,0,1,70,70
1656276124784,ECE 180,A00,083140,Abi Samra; Nicholas Camill,1,0,30,29
1656276124784,ECE 180,B00,083141,Abi Samra; Nicholas Camill,0,4,30,30
1656276130812,MATH 10A,A01,083735,Patchell; Gregory David,0,0,30,30
1656276130812,MATH 10A,A02,083736,Patchell; Gregory David,22,0,30,8
1656276130812,MATH 10A,A03,083737,Patchell; Gregory David,16,0,30,14
1656276136835,MATH 10B,A01,083207,Lim; Seonhee,0,0,34,34
1656276136835,MATH 10B,A02,083208,Lim; Seonhee,7,0,35,28
1656276136835,MATH 10B,A03,093472,Staff,1,0,34,33
1656276136835,MATH 10B,B01,083739,Sinha; Shubham,11,0,30,19
1656276142865,MATH 18,A01,083743,Cinel; Cameron Alexander,7,0,30,23
1656276142865,MATH 18,A02,083744,Cinel; Cameron Alexander,9,0,30,21
1656276142865,MATH 18,A03,083745,Cinel; Cameron Alexander,5,0,30,25
1656276142865,MATH 18,B01,083748,Rideout; David Porter,1,0,36,35
1656276142865,MATH 18,B02,083749,Rideout; David Porter,0,0,36,36
1656276142865,MATH 18,B03,083750,Rideout; David Porter,0,0,36,36
1656276142865,MATH 18,B04,083751,Rideout; David Porter,0,1,36,36
1656276142865,MATH 18,B05,093473,Rideout; David Porter,0,0,36,36
1656276142865,MATH 18,B06,093474,Rideout; David Porter,3,0,36,33
1656276148891,MATH 20A,A01,083754,Zheng; Zequn,11,0,40,29
1656276154919,MATH 20B,A01,083756,Briones; Jor-el Thomas Caparas,0,0,36,36
1656276154919,MATH 20B,A02,083757,Briones; Jor-el Thomas Caparas,0,0,36,36
1656276154919,MATH 20B,A03,093475,Staff,0,0,36,36
1656276160941,MATH 20C,A01,083760,Briones; Jor-el Thomas Caparas,0,0,35,35
1656276160941,MATH 20C,A02,083761,Briones; Jor-el Thomas Caparas,9,1,35,26
1656276160941,MATH 20C,A03,093476,Staff,0,0,35,35
1656276160941,MATH 20C,B01,083762,Bach; Quang Tran,1,0,30,29
1656276166964,MATH 20D,A01,083765,Tran; Brian Kha,1,0,30,29
1656276166964,MATH 20D,A02,083766,Tran; Brian Kha,0,1,30,30
1656276166964,MATH 20D,A03,083767,Tran; Brian Kha,2,0,30,28
1656276172988,MATH 20E,A01,083771,Ganguly; Soumya,3,0,32,29
1656276172988,MATH 20E,A02,083772,Ganguly; Soumya,0,0,32,32
1656276172988,MATH 20E,B01,083773,Ciotti; Benjamin,16,0,35,19
1656276172988,MATH 20E,B02,083774,Ciotti; Benjamin,15,0,35,20
1656276179100,MATH 103A,A01,083777,Greenfeld; Be'Eri,1,0,36,35
1656276179100,MATH 103A,A02,083778,Greenfeld; Be'Eri,2,0,36,34
1656276179100,MATH 103A,A03,093561,Staff,5,0,36,31
1656276179100,MATH 103A,B01,083779,Greenfeld; Be'Eri,8,0,36,28
1656276179100,MATH 103A,B02,083780,Greenfeld; Be'Eri,0,0,36,36
1656276179100,MATH 103A,B03,093562,Staff,0,0,36,36
1656276185127,MATH 105,A01,085443,Carter; Anne Toulson,5,0,35,30
1656276185127,MATH 105,A02,093477,Staff,14,0,35,21
1656276191154,MATH 109,A01,083213,Ganzberger; Geoffrey Michael,1,0,34,33
1656276191154,MATH 109,A02,083214,Ganzberger; Geoffrey Michael,0,0,34,34
1656276191154,MATH 109,A03,093478,Staff,1,0,34,33
1656276191154,MATH 109,B01,083215,Ganzberger; Geoffrey Michael,4,0,32,28
1656276191154,MATH 109,B02,083216,Ganzberger; Geoffrey Michael,1,0,32,31
1656276191154,MATH 109,B03,093479,Staff,3,0,32,29
1656276197184,MATH 142A,A01,083219,Chow; Bennett,2,0,32,30
1656276197184,MATH 142A,A02,083220,Chow; Bennett,8,0,32,24
1656276197184,MATH 142A,A03,093480,Staff,5,0,32,27
1656276197184,MATH 142A,B03,093481,Staff,3,0,32,29
1656276197184,MATH 142A,B04,093558,Staff,6,0,32,26
1656276197184,MATH 142A,B05,093559,Staff,0,0,32,32
1656276203211,MATH 193A,A01,083224,Rotar; Vladimir,0,1,34,34
1656276203211,MATH 193A,A02,083225,Rotar; Vladimir,0,0,34,34
1656276203211,MATH 193A,A03,083781,Rotar; Vladimir,0,0,34,34
1656276203211,MATH 193A,A04,083782,Rotar; Vladimir,6,0,34,28
1656276203211,MATH 193A,A05,093482,Rotar; Vladimir,0,0,34,34
1656276209233,MATH 197,001,091859,McAuley; Julian John,9999,0,9999,0
1656276209233,MATH 197,002,095566,Kedlaya; Kiran S.,9997,0,9999,2
1656276209233,MATH 197,003,095567,Xiao; Ming,9999,0,9999,0
1656276209233,MATH 197,004,095571,Perols; Johan Lars,9998,0,9999,1
1656276216300,COGS 9,A01,083615,Shannon; Kyle Michael,4,0,75,71
1656276222324,COGS 11,A01,083617,Boyle; Mary E. T.,14,0,48,34
1656276228352,COGS 13,A01,083071,Bastos; Amalia Pinkusfeld,5,0,71,66
1656276234379,COGS 14A,A01,092681,Semenuks; Arturs,1,12,100,99
1656276240406,COGS 14B,A01,083073,Cheng; Tzu-Han,7,0,63,56
1656276246433,COGS 17,A01,092677,Semenuks; Arturs,8,0,81,73
1656276252456,COGS 100,A01,083619,Allen; Michael Gordon,2,0,70,68
1656276258482,COGS 101A,A01,083621,Davis; Joshua Daniel,4,0,68,64
1656276264517,COGS 101B,A01,091572,Allen; Michael Gordon,4,0,65,61
1656276270540,COGS 101C,A01,083625,Delgado; Tania,10,0,35,25
1656276276565,COGS 107A,A01,083627,Boyle; Mary E. T.,0,0,60,60
1656276282594,COGS 118A,A01,083075,Gupta; Anjum,8,0,76,68
1656276288617,CSE 3,A50,083646,Miranda; Gregory Joseph,18,0,50,32
1656276294641,CSE 8A,A50,083650,Miranda; Gregory Joseph,2,2,56,54
1656276300667,CSE 11,A01,083080,Cao; Yingjun,0,48,40,40
1656276306691,CSE 12,A01,083652,Krause-Levy; Sophia Louisa,5,1,120,115
1656276312715,CSE 15L,A01,083654,Morris; Justin Loren,2,0,50,48
1656276312715,CSE 15L,A02,083655,Morris; Justin Loren,4,0,50,46
1656276318742,CSE 20,A01,083657,Tran; Khoa Dang,30,0,80,50
1656276324765,CSE 21,A01,095574,Bach; Quang Tran,23,0,48,25
1656276330790,CSE 30,A01,083084,Eldon; John,2,6,80,78
1656276330790,CSE 30,B01,095061,Bhaskar; Nishant,0,1,50,50
1656276336816,CSE 100,A01,083659,Cao; Yingjun,1,18,70,69
1656276342840,CSE 134B,A01,083661,Powell; Thomas Allan,5,0,100,95
1656276348870,CSE 140,A01,083663,Gungor; Onat,9,0,85,76
1656276354893,CSE 140L,A01,083088,Eldon; John,9,0,100,91
1656276360920,CSE 175,A01,083665,Kumar; Rakesh,0,0,25,25
1656276366943,CSE 190,A00,092507,Dubnov; Shlomo,3,0,20,17
1656276372969,ECE 45,A01,083139,Congero; Spencer William,1,0,75,74
1656276378996,ECE 65,A50,083695,Saad; Andrew S,9,0,30,21
1656276378996,ECE 65,A51,095125,Staff,24,0,26,2
1656276385020,ECE 109,A01,091882,Touri; Behrouz,0,1,70,70
1656276391047,ECE 180,A00,083140,Abi Samra; Nicholas Camill,1,0,30,29
1656276391047,ECE 180,B00,083141,Abi Samra; Nicholas Camill,0,4,30,30
1656276397072,MATH 10A,A01,083735,Patchell; Gregory David,0,0,30,30
1656276397072,MATH 10A,A02,083736,Patchell; Gregory David,22,0,30,8
1656276397072,MATH 10A,A03,083737,Patchell; Gregory David,16,0,30,14
1656276403098,MATH 10B,A01,083207,Lim; Seonhee,1,0,34,33
1656276403098,MATH 10B,A02,083208,Lim; Seonhee,7,0,35,28
1656276403098,MATH 10B,A03,093472,Staff,1,0,34,33
1656276403098,MATH 10B,B01,083739,Sinha; Shubham,11,0,30,19
1656276409123,MATH 18,A01,083743,Cinel; Cameron Alexander,7,0,30,23
1656276409123,MATH 18,A02,083744,Cinel; Cameron Alexander,9,0,30,21
1656276409123,MATH 18,A03,083745,Cinel; Cameron Alexander,5,0,30,25
1656276409123,MATH 18,B01,083748,Rideout; David Porter,1,0,36,35
1656276409123,MATH 18,B02,083749,Rideout; David Porter,0,0,36,36
1656276409123,MATH 18,B03,083750,Rideout; David Porter,0,0,36,36
1656276409123,MATH 18,B04,083751,Rideout; David Porter,0,1,36,36
1656276409123,MATH 18,B05,093473,Rideout; David Porter,0,0,36,36
1656276409123,MATH 18,B06,093474,Rideout; David Porter,3,0,36,33
1656276415156,MATH 20A,A01,083754,Zheng; Zequn,11,0,40,29
1656276421184,MATH 20B,A01,083756,Briones; Jor-el Thomas Caparas,0,0,36,36
1656276421184,MATH 20B,A02,083757,Briones; Jor-el Thomas Caparas,0,0,36,36
1656276421184,MATH 20B,A03,093475,Staff,0,0,36,36
1656276427209,MATH 20C,A01,083760,Briones; Jor-el Thomas Caparas,0,0,35,35
1656276427209,MATH 20C,A02,083761,Briones; Jor-el Thomas Caparas,9,1,35,26
1656276427209,MATH 20C,A03,093476,Staff,0,0,35,35
1656276427209,MATH 20C,B01,083762,Bach; Quang Tran,1,0,30,29
1656276433238,MATH 20D,A01,083765,Tran; Brian Kha,1,0,30,29
1656276433238,MATH 20D,A02,083766,Tran; Brian Kha,0,1,30,30
1656276433238,MATH 20D,A03,083767,Tran; Brian Kha,2,0,30,28
1656276439262,MATH 20E,A01,083771,Ganguly; Soumya,3,0,32,29
1656276439262,MATH 20E,A02,083772,Ganguly; Soumya,0,0,32,32
1656276439262,MATH 20E,B01,083773,Ciotti; Benjamin,16,0,35,19
1656276439262,MATH 20E,B02,083774,Ciotti; Benjamin,15,0,35,20
1656276445287,MATH 103A,A01,083777,Greenfeld; Be'Eri,1,0,36,35
1656276445287,MATH 103A,A02,083778,Greenfeld; Be'Eri,2,0,36,34
1656276445287,MATH 103A,A03,093561,Staff,5,0,36,31
1656276445287,MATH 103A,B01,083779,Greenfeld; Be'Eri,8,0,36,28
1656276445287,MATH 103A,B02,083780,Greenfeld; Be'Eri,0,0,36,36
1656276445287,MATH 103A,B03,093562,Staff,0,0,36,36
1656276451316,MATH 105,A01,085443,Carter; Anne Toulson,5,0,35,30
1656276451316,MATH 105,A02,093477,Staff,14,0,35,21
1656276457345,MATH 109,A01,083213,Ganzberger; Geoffrey Michael,1,0,34,33
1656276457345,MATH 109,A02,083214,Ganzberger; Geoffrey Michael,0,0,34,34
1656276457345,MATH 109,A03,093478,Staff,1,0,34,33
1656276457345,MATH 109,B01,083215,Ganzberger; Geoffrey Michael,4,0,32,28
1656276457345,MATH 109,B02,083216,Ganzberger; Geoffrey Michael,1,0,32,31
1656276457345,MATH 109,B03,093479,Staff,3,0,32,29
1656276463373,MATH 142A,A01,083219,Chow; Bennett,2,0,32,30
1656276463373,MATH 142A,A02,083220,Chow; Bennett,8,0,32,24
1656276463373,MATH 142A,A03,093480,Staff,5,0,32,27
1656276463373,MATH 142A,B03,093481,Staff,3,0,32,29
1656276463373,MATH 142A,B04,093558,Staff,6,0,32,26
1656276463373,MATH 142A,B05,093559,Staff,0,0,32,32
1656276469403,MATH 193A,A01,083224,Rotar; Vladimir,0,1,34,34
1656276469403,MATH 193A,A02,083225,Rotar; Vladimir,0,0,34,34
1656276469403,MATH 193A,A03,083781,Rotar; Vladimir,0,0,34,34
1656276469403,MATH 193A,A04,083782,Rotar; Vladimir,6,0,34,28
1656276469403,MATH 193A,A05,093482,Rotar; Vladimir,0,0,34,34
1656276475426,MATH 197,001,091859,McAuley; Julian John,9999,0,9999,0
1656276475426,MATH 197,002,095566,Kedlaya; Kiran S.,9997,0,9999,2
1656276475426,MATH 197,003,095567,Xiao; Ming,9999,0,9999,0
1656276475426,MATH 197,004,095571,Perols; Johan Lars,9998,0,9999,1
1656276482481,COGS 9,A01,083615,Shannon; Kyle Michael,4,0,75,71
1656276488508,COGS 11,A01,083617,Boyle; Mary E. T.,14,0,48,34
1656276494534,COGS 13,A01,083071,Bastos; Amalia Pinkusfeld,5,0,71,66
1656276500561,COGS 14A,A01,092681,Semenuks; Arturs,1,12,100,99
1656276506585,COGS 14B,A01,083073,Cheng; Tzu-Han,7,0,63,56
1656276512612,COGS 17,A01,092677,Semenuks; Arturs,8,0,81,73
1656276518639,COGS 100,A01,083619,Allen; Michael Gordon,2,0,70,68
1656276524664,COGS 101A,A01,083621,Davis; Joshua Daniel,4,0,68,64
1656276530697,COGS 101B,A01,091572,Allen; Michael Gordon,4,0,65,61
1656276536724,COGS 101C,A01,083625,Delgado; Tania,10,0,35,25
1656276542752,COGS 107A,A01,083627,Boyle; Mary E. T.,0,0,60,60
1656276548775,COGS 118A,A01,083075,Gupta; Anjum,8,0,76,68
1656276554799,CSE 3,A50,083646,Miranda; Gregory Joseph,18,0,50,32
1656276560822,CSE 8A,A50,083650,Miranda; Gregory Joseph,2,2,56,54
1656276566849,CSE 11,A01,083080,Cao; Yingjun,0,48,40,40
1656276572872,CSE 12,A01,083652,Krause-Levy; Sophia Louisa,5,1,120,115
1656276578898,CSE 15L,A01,083654,Morris; Justin Loren,2,0,50,48
1656276578898,CSE 15L,A02,083655,Morris; Justin Loren,4,0,50,46
1656276584927,CSE 20,A01,083657,Tran; Khoa Dang,30,0,80,50
1656276590950,CSE 21,A01,095574,Bach; Quang Tran,23,0,48,25
1656276596973,CSE 30,A01,083084,Eldon; John,2,6,80,78
1656276596973,CSE 30,B01,095061,Bhaskar; Nishant,0,1,50,50
1656276603006,CSE 100,A01,083659,Cao; Yingjun,1,18,70,69
1656276609029,CSE 134B,A01,083661,Powell; Thomas Allan,5,0,100,95
1656276615055,CSE 140,A01,083663,Gungor; Onat,9,0,85,76
1656276621089,CSE 140L,A01,083088,Eldon; John,9,0,100,91
1656276627115,CSE 175,A01,083665,Kumar; Rakesh,0,0,25,25
1656276633142,CSE 190,A00,092507,Dubnov; Shlomo,3,0,20,17
1656276639168,ECE 45,A01,083139,Congero; Spencer William,1,0,75,74
1656276645195,ECE 65,A50,083695,Saad; Andrew S,9,0,30,21
1656276645195,ECE 65,A51,095125,Staff,24,0,26,2
1656276651221,ECE 109,A01,091882,Touri; Behrouz,0,1,70,70
1656276657244,ECE 180,A00,083140,Abi Samra; Nicholas Camill,1,0,30,29
1656276657244,ECE 180,B00,083141,Abi Samra; Nicholas Camill,0,4,30,30
1656276663267,MATH 10A,A01,083735,Patchell; Gregory David,0,0,30,30
1656276663267,MATH 10A,A02,083736,Patchell; Gregory David,22,0,30,8
1656276663267,MATH 10A,A03,083737,Patchell; Gregory David,16,0,30,14
1656276669293,MATH 10B,A01,083207,Lim; Seonhee,1,0,34,33
1656276669293,MATH 10B,A02,083208,Lim; Seonhee,7,0,35,28
1656276669293,MATH 10B,A03,093472,Staff,1,0,34,33
1656276669293,MATH 10B,B01,083739,Sinha; Shubham,11,0,30,19
1656276675317,MATH 18,A01,083743,Cinel; Cameron Alexander,7,0,30,23
1656276675317,MATH 18,A02,083744,Cinel; Cameron Alexander,9,0,30,21
1656276675317,MATH 18,A03,083745,Cinel; Cameron Alexander,5,0,30,25
1656276675317,MATH 18,B01,083748,Rideout; David Porter,1,0,36,35
1656276675317,MATH 18,B02,083749,Rideout; David Porter,0,0,36,36
1656276675317,MATH 18,B03,083750,Rideout; David Porter,0,0,36,36
1656276675317,MATH 18,B04,083751,Rideout; David Porter,0,1,36,36
1656276675317,MATH 18,B05,093473,Rideout; David Porter,0,0,36,36
1656276675317,MATH 18,B06,093474,Rideout; David Porter,3,0,36,33
1656276681352,MATH 20A,A01,083754,Zheng; Zequn,11,0,40,29
1656276687374,MATH 20B,A01,083756,Briones; Jor-el Thomas Caparas,0,0,36,36
1656276687374,MATH 20B,A02,083757,Briones; Jor-el Thomas Caparas,0,0,36,36
1656276687374,MATH 20B,A03,093475,Staff,0,0,36,36
1656276693402,MATH 20C,A01,083760,Briones; Jor-el Thomas Caparas,0,0,35,35
1656276693402,MATH 20C,A02,083761,Briones; Jor-el Thomas Caparas,9,1,35,26
1656276693402,MATH 20C,A03,093476,Staff,0,0,35,35
1656276693402,MATH 20C,B01,083762,Bach; Quang Tran,1,0,30,29
1656276699425,MATH 20D,A01,083765,Tran; Brian Kha,1,0,30,29
1656276699425,MATH 20D,A02,083766,Tran; Brian Kha,0,1,30,30
1656276699425,MATH 20D,A03,083767,Tran; Brian Kha,2,0,30,28
1656276705449,MATH 20E,A01,083771,Ganguly; Soumya,3,0,32,29
1656276705449,MATH 20E,A02,083772,Ganguly; Soumya,0,0,32,32
1656276705449,MATH 20E,B01,083773,Ciotti; Benjamin,16,0,35,19
1656276705449,MATH 20E,B02,083774,Ciotti; Benjamin,15,0,35,20
1656276711478,MATH 103A,A01,083777,Greenfeld; Be'Eri,1,0,36,35
1656276711478,MATH 103A,A02,083778,Greenfeld; Be'Eri,2,0,36,34
1656276711478,MATH 103A,A03,093561,Staff,5,0,36,31
1656276711478,MATH 103A,B01,083779,Greenfeld; Be'Eri,8,0,36,28
1656276711478,MATH 103A,B02,083780,Greenfeld; Be'Eri,0,0,36,36
1656276711478,MATH 103A,B03,093562,Staff,0,0,36,36
1656276717505,MATH 105,A01,085443,Carter; Anne Toulson,5,0,35,30
1656276717505,MATH 105,A02,093477,Staff,14,0,35,21
1656276723541,MATH 109,A01,083213,Ganzberger; Geoffrey Michael,1,0,34,33
1656276723541,MATH 109,A02,083214,Ganzberger; Geoffrey Michael,0,0,34,34
1656276723541,MATH 109,A03,093478,Staff,1,0,34,33
1656276723541,MATH 109,B01,083215,Ganzberger; Geoffrey Michael,4,0,32,28
1656276723541,MATH 109,B02,083216,Ganzberger; Geoffrey Michael,1,0,32,31
1656276723541,MATH 109,B03,093479,Staff,3,0,32,29
1656276729566,MATH 142A,A01,083219,Chow; Bennett,2,0,32,30
1656276729566,MATH 142A,A02,083220,Chow; Bennett,8,0,32,24
1656276729566,MATH 142A,A03,093480,Staff,5,0,32,27
1656276729566,MATH 142A,B03,093481,Staff,3,0,32,29
1656276729566,MATH 142A,B04,093558,Staff,6,0,32,26
1656276729566,MATH 142A,B05,093559,Staff,0,0,32,32
1656276735589,MATH 193A,A01,083224,Rotar; Vladimir,0,1,34,34
1656276735589,MATH 193A,A02,083225,Rotar; Vladimir,0,0,34,34
1656276735589,MATH 193A,A03,083781,Rotar; Vladimir,0,0,34,34
1656276735589,MATH 193A,A04,083782,Rotar; Vladimir,6,0,34,28
1656276735589,MATH 193A,A05,093482,Rotar; Vladimir,0,0,34,34
1656276741617,MATH 197,001,091859,McAuley; Julian John,9999,0,9999,0
1656276741617,MATH 197,002,095566,Kedlaya; Kiran S.,9997,0,9999,2
1656276741617,MATH 197,003,095567,Xiao; Ming,9999,0,9999,0
1656276741617,MATH 197,004,095571,Perols; Johan Lars,9998,0,9999,1
1656276748664,COGS 9,A01,083615,Shannon; Kyle Michael,4,0,75,71
1656276754691,COGS 11,A01,083617,Boyle; Mary E. T.,14,0,48,34
1656276760715,COGS 13,A01,083071,Bastos; Amalia Pinkusfeld,5,0,71,66
1656276766747,COGS 14A,A01,092681,Semenuks; Arturs,1,12,100,99
1656276772867,COGS 14B,A01,083073,Cheng; Tzu-Han,7,0,63,56
1656276778891,COGS 17,A01,092677,Semenuks; Arturs,8,0,81,73
1656276784917,COGS 100,A01,083619,Allen; Michael Gordon,2,0,70,68
1656276790945,COGS 101A,A01,083621,Davis; Joshua Daniel,4,0,68,64
1656276796973,COGS 101B,A01,091572,Allen; Michael Gordon,4,0,65,61
1656276802996,COGS 101C,A01,083625,Delgado; Tania,10,0,35,25
1656276809018,COGS 107A,A01,083627,Boyle; Mary E. T.,0,0,60,60
1656276815043,COGS 118A,A01,083075,Gupta; Anjum,8,0,76,68
1656276821067,CSE 3,A50,083646,Miranda; Gregory Joseph,18,0,50,32
1656276827091,CSE 8A,A50,083650,Miranda; Gregory Joseph,2,2,56,54
1656276833115,CSE 11,A01,083080,Cao; Yingjun,0,48,40,40
1656276839138,CSE 12,A01,083652,Krause-Levy; Sophia Louisa,5,1,120,115
1656276845161,CSE 15L,A01,083654,Morris; Justin Loren,2,0,50,48
1656276845161,CSE 15L,A02,083655,Morris; Justin Loren,4,0,50,46
1656276851185,CSE 20,A01,083657,Tran; Khoa Dang,30,0,80,50
1656276857216,CSE 21,A01,095574,Bach; Quang Tran,23,0,48,25
1656276863240,CSE 30,A01,083084,Eldon; John,2,6,80,78
1656276863240,CSE 30,B01,095061,Bhaskar; Nishant,0,1,50,50
1656276869263,CSE 100,A01,083659,Cao; Yingjun,1,18,70,69
1656276875295,CSE 134B,A01,083661,Powell; Thomas Allan,5,0,100,95
1656276881317,CSE 140,A01,083663,Gungor; Onat,9,0,85,76
1656276887343,CSE 140L,A01,083088,Eldon; John,9,0,100,91
1656276893366,CSE 175,A01,083665,Kumar; Rakesh,0,0,25,25
1656276899390,CSE 190,A00,092507,Dubnov; Shlomo,3,0,20,17
1656276905418,ECE 45,A01,083139,Congero; Spencer William,1,0,75,74
1656276911442,ECE 65,A50,083695,Saad; Andrew S,9,0,30,21
1656276911442,ECE 65,A51,095125,Staff,24,0,26,2
1656276917469,ECE 109,A01,091882,Touri; Behrouz,0,1,70,70
1656276923493,ECE 180,A00,083140,Abi Samra; Nicholas Camill,1,0,30,29
1656276923493,ECE 180,B00,083141,Abi Samra; Nicholas Camill,0,4,30,30
1656276929517,MATH 10A,A01,083735,Patchell; Gregory David,0,0,30,30
1656276929517,MATH 10A,A02,083736,Patchell; Gregory David,22,0,30,8
1656276929517,MATH 10A,A03,083737,Patchell; Gregory David,16,0,30,14
1656276935540,MATH 10B,A01,083207,Lim; Seonhee,1,0,34,33
1656276935540,MATH 10B,A02,083208,Lim; Seonhee,7,0,35,28
1656276935540,MATH 10B,A03,093472,Staff,1,0,34,33
1656276935540,MATH 10B,B01,083739,Sinha; Shubham,11,0,30,19
1656276941571,MATH 18,A01,083743,Cinel; Cameron Alexander,7,0,30,23
1656276941571,MATH 18,A02,083744,Cinel; Cameron Alexander,9,0,30,21
1656276941571,MATH 18,A03,083745,Cinel; Cameron Alexander,5,0,30,25
1656276941571,MATH 18,B01,083748,Rideout; David Porter,1,0,36,35
1656276941571,MATH 18,B02,083749,Rideout; David Porter,0,0,36,36
1656276941571,MATH 18,B03,083750,Rideout; David Porter,0,0,36,36
1656276941571,MATH 18,B04,083751,Rideout; David Porter,0,1,36,36
1656276941571,MATH 18,B05,093473,Rideout; David Porter,0,0,36,36
1656276941571,MATH 18,B06,093474,Rideout; David Porter,3,0,36,33
1656276947595,MATH 20A,A01,083754,Zheng; Zequn,11,0,40,29
1656276953622,MATH 20B,A01,083756,Briones; Jor-el Thomas Caparas,0,0,36,36
1656276953622,MATH 20B,A02,083757,Briones; Jor-el Thomas Caparas,0,0,36,36
1656276953622,MATH 20B,A03,093475,Staff,0,0,36,36
1656276959651,MATH 20C,A01,083760,Briones; Jor-el Thomas Caparas,0,0,35,35
1656276959651,MATH 20C,A02,083761,Briones; Jor-el Thomas Caparas,9,1,35,26
1656276959651,MATH 20C,A03,093476,Staff,0,0,35,35
1656276959651,MATH 20C,B01,083762,Bach; Quang Tran,1,0,30,29
1656276965675,MATH 20D,A01,083765,Tran; Brian Kha,1,0,30,29
1656276965675,MATH 20D,A02,083766,Tran; Brian Kha,0,1,30,30
1656276965675,MATH 20D,A03,083767,Tran; Brian Kha,2,0,30,28
1656276971700,MATH 20E,A01,083771,Ganguly; Soumya,3,0,32,29
1656276971700,MATH 20E,A02,083772,Ganguly; Soumya,0,0,32,32
1656276971700,MATH 20E,B01,083773,Ciotti; Benjamin,16,0,35,19
1656276971700,MATH 20E,B02,083774,Ciotti; Benjamin,15,0,35,20
1656276977729,MATH 103A,A01,083777,Greenfeld; Be'Eri,1,0,36,35
1656276977729,MATH 103A,A02,083778,Greenfeld; Be'Eri,2,0,36,34
1656276977729,MATH 103A,A03,093561,Staff,5,0,36,31
1656276977729,MATH 103A,B01,083779,Greenfeld; Be'Eri,8,0,36,28
1656276977729,MATH 103A,B02,083780,Greenfeld; Be'Eri,0,0,36,36
1656276977729,MATH 103A,B03,093562,Staff,0,0,36,36
1656276983753,MATH 105,A01,085443,Carter; Anne Toulson,5,0,35,30
1656276983753,MATH 105,A02,093477,Staff,14,0,35,21
1656276989778,MATH 109,A01,083213,Ganzberger; Geoffrey Michael,1,0,34,33
1656276989778,MATH 109,A02,083214,Ganzberger; Geoffrey Michael,0,0,34,34
1656276989778,MATH 109,A03,093478,Staff,1,0,34,33
1656276989778,MATH 109,B01,083215,Ganzberger; Geoffrey Michael,4,0,32,28
1656276989778,MATH 109,B02,083216,Ganzberger; Geoffrey Michael,1,0,32,31
1656276989778,MATH 109,B03,093479,Staff,3,0,32,29
1656276995805,MATH 142A,A01,083219,Chow; Bennett,2,0,32,30
1656276995805,MATH 142A,A02,083220,Chow; Bennett,8,0,32,24
1656276995805,MATH 142A,A03,093480,Staff,5,0,32,27
1656276995805,MATH 142A,B03,093481,Staff,3,0,32,29
1656276995805,MATH 142A,B04,093558,Staff,6,0,32,26
1656276995805,MATH 142A,B05,093559,Staff,0,0,32,32
1656277001833,MATH 193A,A01,083224,Rotar; Vladimir,0,1,34,34
1656277001833,MATH 193A,A02,083225,Rotar; Vladimir,0,0,34,34
1656277001833,MATH 193A,A03,083781,Rotar; Vladimir,0,0,34,34
1656277001833,MATH 193A,A04,083782,Rotar; Vladimir,6,0,34,28
1656277001833,MATH 193A,A05,093482,Rotar; Vladimir,0,0,34,34
1656277007857,MATH 197,001,091859,McAuley; Julian John,9999,0,9999,0
1656277007857,MATH 197,002,095566,Kedlaya; Kiran S.,9997,0,9999,2
1656277007857,MATH 197,003,095567,Xiao; Ming,9999,0,9999,0
1656277007857,MATH 197,004,095571,Perols; Johan Lars,9998,0,9999,1
1656277014930,COGS 9,A01,083615,Shannon; Kyle Michael,4,0,75,71
1656277020954,COGS 11,A01,083617,Boyle; Mary E. T.,14,0,48,34
1656277026977,COGS 13,A01,083071,Bastos; Amalia Pinkusfeld,5,0,71,66
1656277033001,COGS 14A,A01,092681,Semenuks; Arturs,1,12,100,99
1656277039033,COGS 14B,A01,083073,Cheng; Tzu-Han,7,0,63,56
1656277045060,COGS 17,A01,092677,Semenuks; Arturs,8,0,81,73
1656277051083,COGS 100,A01,083619,Allen; Michael Gordon,2,0,70,68
1656277057112,COGS 101A,A01,083621,Davis; Joshua Daniel,4,0,68,64
1656277063138,COGS 101B,A01,091572,Allen; Michael Gordon,4,0,65,61
1656277069161,COGS 101C,A01,083625,Delgado; Tania,10,0,35,25
1656277075185,COGS 107A,A01,083627,Boyle; Mary E. T.,0,0,60,60
1656277081208,COGS 118A,A01,083075,Gupta; Anjum,8,0,76,68
1656277087242,CSE 3,A50,083646,Miranda; Gregory Joseph,18,0,50,32
1656277093266,CSE 8A,A50,083650,Miranda; Gregory Joseph,2,2,56,54
1656277099288,CSE 11,A01,083080,Cao; Yingjun,0,48,40,40
1656277105311,CSE 12,A01,083652,Krause-Levy; Sophia Louisa,5,1,120,115
1656277111340,CSE 15L,A01,083654,Morris; Justin Loren,2,0,50,48
1656277111340,CSE 15L,A02,083655,Morris; Justin Loren,4,0,50,46
1656277117366,CSE 20,A01,083657,Tran; Khoa Dang,30,0,80,50
1656277123390,CSE 21,A01,095574,Bach; Quang Tran,23,0,48,25
1656277129422,CSE 30,A01,083084,Eldon; John,2,6,80,78
1656277129422,CSE 30,B01,095061,Bhaskar; Nishant,0,1,50,50
1656277135447,CSE 100,A01,083659,Cao; Yingjun,1,18,70,69
1656277141473,CSE 134B,A01,083661,Powell; Thomas Allan,5,0,100,95
1656277147498,CSE 140,A01,083663,Gungor; Onat,9,0,85,76
1656277153521,CSE 140L,A01,083088,Eldon; John,9,0,100,91
1656277159545,CSE 175,A01,083665,Kumar; Rakesh,0,0,25,25
1656277165567,CSE 190,A00,092507,Dubnov; Shlomo,3,0,20,17
1656277171588,ECE 45,A01,083139,Congero; Spencer William,1,0,75,74
1656277177611,ECE 65,A50,083695,Saad; Andrew S,9,0,30,21
1656277177611,ECE 65,A51,095125,Staff,24,0,26,2
1656277183633,ECE 109,A01,091882,Touri; Behrouz,0,1,70,70
1656277189658,ECE 180,A00,083140,Abi Samra; Nicholas Camill,1,0,30,29
1656277189658,ECE 180,B00,083141,Abi Samra; Nicholas Camill,0,4,30,30
1656277195681,MATH 10A,A01,083735,Patchell; Gregory David,0,0,30,30
1656277195681,MATH 10A,A02,083736,Patchell; Gregory David,22,0,30,8
1656277195681,MATH 10A,A03,083737,Patchell; Gregory David,16,0,30,14
1656277201711,MATH 10B,A01,083207,Lim; Seonhee,1,0,34,33
1656277201711,MATH 10B,A02,083208,Lim; Seonhee,7,0,35,28
1656277201711,MATH 10B,A03,093472,Staff,1,0,34,33
1656277201711,MATH 10B,B01,083739,Sinha; Shubham,11,0,30,19
1656277207736,MATH 18,A01,083743,Cinel; Cameron Alexander,7,0,30,23
1656277207736,MATH 18,A02,083744,Cinel; Cameron Alexander,9,0,30,21
1656277207736,MATH 18,A03,083745,Cinel; Cameron Alexander,5,0,30,25
1656277207736,MATH 18,B01,083748,Rideout; David Porter,1,0,36,35
1656277207736,MATH 18,B02,083749,Rideout; David Porter,0,0,36,36
1656277207736,MATH 18,B03,083750,Rideout; David Porter,0,0,36,36
1656277207736,MATH 18,B04,083751,Rideout; David Porter,0,1,36,36
1656277207736,MATH 18,B05,093473,Rideout; David Porter,0,0,36,36
1656277207736,MATH 18,B06,093474,Rideout; David Porter,3,0,36,33
1656277213759,MATH 20A,A01,083754,Zheng; Zequn,11,0,40,29
1656277219782,MATH 20B,A01,083756,Briones; Jor-el Thomas Caparas,0,0,36,36
1656277219782,MATH 20B,A02,083757,Briones; Jor-el Thomas Caparas,0,0,36,36
1656277219782,MATH 20B,A03,093475,Staff,0,0,36,36
1656277225810,MATH 20C,A01,083760,Briones; Jor-el Thomas Caparas,0,0,35,35
1656277225810,MATH 20C,A02,083761,Briones; Jor-el Thomas Caparas,9,1,35,26
1656277225810,MATH 20C,A03,093476,Staff,0,0,35,35
1656277225810,MATH 20C,B01,083762,Bach; Quang Tran,1,0,30,29
1656277231838,MATH 20D,A01,083765,Tran; Brian Kha,1,0,30,29
1656277231838,MATH 20D,A02,083766,Tran; Brian Kha,0,1,30,30
1656277231838,MATH 20D,A03,083767,Tran; Brian Kha,2,0,30,28
1656277237875,MATH 20E,A01,083771,Ganguly; Soumya,3,0,32,29
1656277237875,MATH 20E,A02,083772,Ganguly; Soumya,0,0,32,32
1656277237875,MATH 20E,B01,083773,Ciotti; Benjamin,16,0,35,19
1656277237875,MATH 20E,B02,083774,Ciotti; Benjamin,15,0,35,20
1656277243908,MATH 103A,A01,083777,Greenfeld; Be'Eri,1,0,36,35
1656277243908,MATH 103A,A02,083778,Greenfeld; Be'Eri,2,0,36,34
1656277243908,MATH 103A,A03,093561,Staff,5,0,36,31
1656277243908,MATH 103A,B01,083779,Greenfeld; Be'Eri,8,0,36,28
1656277243908,MATH 103A,B02,083780,Greenfeld; Be'Eri,0,0,36,36
1656277243908,MATH 103A,B03,093562,Staff,0,0,36,36
1656277249936,MATH 105,A01,085443,Carter; Anne Toulson,5,0,35,30
1656277249936,MATH 105,A02,093477,Staff,14,0,35,21
1656277255964,MATH 109,A01,083213,Ganzberger; Geoffrey Michael,1,0,34,33
1656277255964,MATH 109,A02,083214,Ganzberger; Geoffrey Michael,0,0,34,34
1656277255964,MATH 109,A03,093478,Staff,1,0,34,33
1656277255964,MATH 109,B01,083215,Ganzberger; Geoffrey Michael,4,0,32,28
1656277255964,MATH 109,B02,083216,Ganzberger; Geoffrey Michael,1,0,32,31
1656277255964,MATH 109,B03,093479,Staff,3,0,32,29
1656277261989,MATH 142A,A01,083219,Chow; Bennett,2,0,32,30
1656277261989,MATH 142A,A02,083220,Chow; Bennett,8,0,32,24
1656277261989,MATH 142A,A03,093480,Staff,5,0,32,27
1656277261989,MATH 142A,B03,093481,Staff,3,0,32,29
1656277261989,MATH 142A,B04,093558,Staff,6,0,32,26
1656277261989,MATH 142A,B05,093559,Staff,0,0,32,32
1656277268018,MATH 193A,A01,083224,Rotar; Vladimir,0,1,34,34
1656277268018,MATH 193A,A02,083225,Rotar; Vladimir,0,0,34,34
1656277268018,MATH 193A,A03,083781,Rotar; Vladimir,0,0,34,34
1656277268018,MATH 193A,A04,083782,Rotar; Vladimir,6,0,34,28
1656277268018,MATH 193A,A05,093482,Rotar; Vladimir,0,0,34,34
1656277274041,MATH 197,001,091859,McAuley; Julian John,9999,0,9999,0
1656277274041,MATH 197,002,095566,Kedlaya; Kiran S.,9997,0,9999,2
1656277274041,MATH 197,003,095567,Xiao; Ming,9999,0,9999,0
1656277274041,MATH 197,004,095571,Perols; Johan Lars,9998,0,9999,1
1656277281097,COGS 9,A01,083615,Shannon; Kyle Michael,4,0,75,71
1656277287120,COGS 11,A01,083617,Boyle; Mary E. T.,14,0,48,34
1656277293142,COGS 13,A01,083071,Bastos; Amalia Pinkusfeld,5,0,71,66
1656277299166,COGS 14A,A01,092681,Semenuks; Arturs,1,12,100,99
1656277305190,COGS 14B,A01,083073,Cheng; Tzu-Han,7,0,63,56
1656277311214,COGS 17,A01,092677,Semenuks; Arturs,8,0,81,73
1656277317238,COGS 100,A01,083619,Allen; Michael Gordon,2,0,70,68
1656277323261,COGS 101A,A01,083621,Davis; Joshua Daniel,4,0,68,64
1656277329285,COGS 101B,A01,091572,Allen; Michael Gordon,4,0,65,61
1656277335311,COGS 101C,A01,083625,Delgado; Tania,10,0,35,25
1656277341338,COGS 107A,A01,083627,Boyle; Mary E. T.,0,0,60,60
1656277347364,COGS 118A,A01,083075,Gupta; Anjum,8,0,76,68
1656277353392,CSE 3,A50,083646,Miranda; Gregory Joseph,18,0,50,32
1656277359416,CSE 8A,A50,083650,Miranda; Gregory Joseph,2,2,56,54
1656277365442,CSE 11,A01,083080,Cao; Yingjun,0,48,40,40
1656277371542,CSE 12,A01,083652,Krause-Levy; Sophia Louisa,5,1,120,115
1656277377570,CSE 15L,A01,083654,Morris; Justin Loren,2,0,50,48
1656277377570,CSE 15L,A02,083655,Morris; Justin Loren,4,0,50,46
1656277383594,CSE 20,A01,083657,Tran; Khoa Dang,30,0,80,50
1656277389621,CSE 21,A01,095574,Bach; Quang Tran,23,0,48,25
1656277395645,CSE 30,A01,083084,Eldon; John,2,6,80,78
1656277395645,CSE 30,B01,095061,Bhaskar; Nishant,0,1,50,50
1656277401668,CSE 100,A01,083659,Cao; Yingjun,1,18,70,69
1656277407692,CSE 134B,A01,083661,Powell; Thomas Allan,5,0,100,95
1656277413720,CSE 140,A01,083663,Gungor; Onat,9,0,85,76
1656277419749,CSE 140L,A01,083088,Eldon; John,9,0,100,91
1656277425774,CSE 175,A01,083665,Kumar; Rakesh,0,0,25,25
1656277431796,CSE 190,A00,092507,Dubnov; Shlomo,3,0,20,17
1656277437819,ECE 45,A01,083139,Congero; Spencer William,1,0,75,74
1656277443841,ECE 65,A50,083695,Saad; Andrew S,9,0,30,21
1656277443841,ECE 65,A51,095125,Staff,24,0,26,2
1656277449865,ECE 109,A01,091882,Touri; Behrouz,0,1,70,70
1656277455888,ECE 180,A00,083140,Abi Samra; Nicholas Camill,2,0,30,28
1656277455888,ECE 180,B00,083141,Abi Samra; Nicholas Camill,0,4,30,30
1656277461917,MATH 10A,A01,083735,Patchell; Gregory David,0,0,30,30
1656277461917,MATH 10A,A02,083736,Patchell; Gregory David,22,0,30,8
1656277461917,MATH 10A,A03,083737,Patchell; Gregory David,16,0,30,14
1656277467941,MATH 10B,A01,083207,Lim; Seonhee,1,0,34,33
1656277467941,MATH 10B,A02,083208,Lim; Seonhee,7,0,35,28
1656277467941,MATH 10B,A03,093472,Staff,1,0,34,33
1656277467941,MATH 10B,B01,083739,Sinha; Shubham,11,0,30,19
1656277473973,MATH 18,A01,083743,Cinel; Cameron Alexander,7,0,30,23
1656277473973,MATH 18,A02,083744,Cinel; Cameron Alexander,9,0,30,21
1656277473973,MATH 18,A03,083745,Cinel; Cameron Alexander,5,0,30,25
1656277473973,MATH 18,B01,083748,Rideout; David Porter,1,0,36,35
1656277473973,MATH 18,B02,083749,Rideout; David Porter,0,0,36,36
1656277473973,MATH 18,B03,083750,Rideout; David Porter,0,0,36,36
1656277473973,MATH 18,B04,083751,Rideout; David Porter,0,1,36,36
1656277473973,MATH 18,B05,093473,Rideout; David Porter,0,0,36,36
1656277473973,MATH 18,B06,093474,Rideout; David Porter,3,0,36,33
1656277479999,MATH 20A,A01,083754,Zheng; Zequn,11,0,40,29
1656277486036,MATH 20B,A01,083756,Briones; Jor-el Thomas Caparas,0,0,36,36
1656277486036,MATH 20B,A02,083757,Briones; Jor-el Thomas Caparas,0,0,36,36
1656277486036,MATH 20B,A03,093475,Staff,0,0,36,36
1656277492060,MATH 20C,A01,083760,Briones; Jor-el Thomas Caparas,0,0,35,35
1656277492060,MATH 20C,A02,083761,Briones; Jor-el Thomas Caparas,9,1,35,26
1656277492060,MATH 20C,A03,093476,Staff,0,0,35,35
1656277492060,MATH 20C,B01,083762,Bach; Quang Tran,1,0,30,29
1656277498089,MATH 20D,A01,083765,Tran; Brian Kha,1,0,30,29
1656277498089,MATH 20D,A02,083766,Tran; Brian Kha,0,1,30,30
1656277498089,MATH 20D,A03,083767,Tran; Brian Kha,2,0,30,28
1656277504124,MATH 20E,A01,083771,Ganguly; Soumya,3,0,32,29
1656277504124,MATH 20E,A02,083772,Ganguly; Soumya,0,0,32,32
1656277504124,MATH 20E,B01,083773,Ciotti; Benjamin,16,0,35,19
1656277504124,MATH 20E,B02,083774,Ciotti; Benjamin,15,0,35,20
1656277510151,MATH 103A,A01,083777,Greenfeld; Be'Eri,1,0,36,35
1656277510151,MATH 103A,A02,083778,Greenfeld; Be'Eri,2,0,36,34
1656277510151,MATH 103A,A03,093561,Staff,5,0,36,31
1656277510151,MATH 103A,B01,083779,Greenfeld; Be'Eri,8,0,36,28
1656277510151,MATH 103A,B02,083780,Greenfeld; Be'Eri,0,0,36,36
1656277510151,MATH 103A,B03,093562,Staff,0,0,36,36
1656277516178,MATH 105,A01,085443,Carter; Anne Toulson,5,0,35,30
1656277516178,MATH 105,A02,093477,Staff,14,0,35,21
1656277522201,MATH 109,A01,083213,Ganzberger; Geoffrey Michael,1,0,34,33
1656277522201,MATH 109,A02,083214,Ganzberger; Geoffrey Michael,0,0,34,34
1656277522201,MATH 109,A03,093478,Staff,1,0,34,33
1656277522201,MATH 109,B01,083215,Ganzberger; Geoffrey Michael,4,0,32,28
1656277522201,MATH 109,B02,083216,Ganzberger; Geoffrey Michael,1,0,32,31
1656277522201,MATH 109,B03,093479,Staff,3,0,32,29
1656277528231,MATH 142A,A01,083219,Chow; Bennett,2,0,32,30
1656277528231,MATH 142A,A02,083220,Chow; Bennett,8,0,32,24
1656277528231,MATH 142A,A03,093480,Staff,5,0,32,27
1656277528231,MATH 142A,B03,093481,Staff,3,0,32,29
1656277528231,MATH 142A,B04,093558,Staff,6,0,32,26
1656277528231,MATH 142A,B05,093559,Staff,0,0,32,32
1656277534259,MATH 193A,A01,083224,Rotar; Vladimir,0,1,34,34
1656277534259,MATH 193A,A02,083225,Rotar; Vladimir,0,0,34,34
1656277534259,MATH 193A,A03,083781,Rotar; Vladimir,0,0,34,34
1656277534259,MATH 193A,A04,083782,Rotar; Vladimir,6,0,34,28
1656277534259,MATH 193A,A05,093482,Rotar; Vladimir,0,0,34,34
1656277540294,MATH 197,001,091859,McAuley; Julian John,9999,0,9999,0
1656277540294,MATH 197,002,095566,Kedlaya; Kiran S.,9997,0,9999,2
1656277540294,MATH 197,003,095567,Xiao; Ming,9999,0,9999,0
1656277540294,MATH 197,004,095571,Perols; Johan Lars,9998,0,9999,1
1656277547347,COGS 9,A01,083615,Shannon; Kyle Michael,4,0,75,71
1656277553370,COGS 11,A01,083617,Boyle; Mary E. T.,14,0,48,34
1656277559401,COGS 13,A01,083071,Bastos; Amalia Pinkusfeld,5,0,71,66
1656277565428,COGS 14A,A01,092681,Semenuks; Arturs,1,12,100,99
1656277571452,COGS 14B,A01,083073,Cheng; Tzu-Han,7,0,63,56
1656277577475,COGS 17,A01,092677,Semenuks; Arturs,8,0,81,73
1656277583499,COGS 100,A01,083619,Allen; Michael Gordon,2,0,70,68
1656277589526,COGS 101A,A01,083621,Davis; Joshua Daniel,4,0,68,64
1656277595552,COGS 101B,A01,091572,Allen; Michael Gordon,4,0,65,61
1656277601578,COGS 101C,A01,083625,Delgado; Tania,10,0,35,25
1656277607602,COGS 107A,A01,083627,Boyle; Mary E. T.,0,0,60,60
1656277613625,COGS 118A,A01,083075,Gupta; Anjum,8,0,76,68
1656277619655,CSE 3,A50,083646,Miranda; Gregory Joseph,18,0,50,32
1656277625683,CSE 8A,A50,083650,Miranda; Gregory Joseph,2,2,56,54
1656277631707,CSE 11,A01,083080,Cao; Yingjun,0,48,40,40
1656277637730,CSE 12,A01,083652,Krause-Levy; Sophia Louisa,5,1,120,115
1656277643754,CSE 15L,A01,083654,Morris; Justin Loren,2,0,50,48
1656277643754,CSE 15L,A02,083655,Morris; Justin Loren,4,0,50,46
1656277649781,CSE 20,A01,083657,Tran; Khoa Dang,30,0,80,50
1656277655809,CSE 21,A01,095574,Bach; Quang Tran,23,0,48,25
1656277661836,CSE 30,A01,083084,Eldon; John,2,6,80,78
1656277661836,CSE 30,B01,095061,Bhaskar; Nishant,0,1,50,50
1656277667867,CSE 100,A01,083659,Cao; Yingjun,1,18,70,69
1656277673889,CSE 134B,A01,083661,Powell; Thomas Allan,5,0,100,95
1656277679916,CSE 140,A01,083663,Gungor; Onat,9,0,85,76
1656277685940,CSE 140L,A01,083088,Eldon; John,9,0,100,91
1656277691965,CSE 175,A01,083665,Kumar; Rakesh,0,0,25,25
1656277697989,CSE 190,A00,092507,Dubnov; Shlomo,3,0,20,17
1656277704013,ECE 45,A01,083139,Congero; Spencer William,1,0,75,74
1656277710037,ECE 65,A50,083695,Saad; Andrew S,9,0,30,21
1656277710037,ECE 65,A51,095125,Staff,24,0,26,2
1656277716061,ECE 109,A01,091882,Touri; Behrouz,0,1,70,70
1656277722088,ECE 180,A00,083140,Abi Samra; Nicholas Camill,2,0,30,28
1656277722088,ECE 180,B00,083141,Abi Samra; Nicholas Camill,0,4,30,30
1656277728114,MATH 10A,A01,083735,Patchell; Gregory David,0,0,30,30
1656277728114,MATH 10A,A02,083736,Patchell; Gregory David,22,0,30,8
1656277728114,MATH 10A,A03,083737,Patchell; Gregory David,16,0,30,14
1656277734138,MATH 10B,A01,083207,Lim; Seonhee,1,0,34,33
1656277734138,MATH 10B,A02,083208,Lim; Seonhee,7,0,35,28
1656277734138,MATH 10B,A03,093472,Staff,1,0,34,33
1656277734138,MATH 10B,B01,083739,Sinha; Shubham,11,0,30,19
1656277740163,MATH 18,A01,083743,Cinel; Cameron Alexander,7,0,30,23
1656277740163,MATH 18,A02,083744,Cinel; Cameron Alexander,9,0,30,21
1656277740163,MATH 18,A03,083745,Cinel; Cameron Alexander,5,0,30,25
1656277740163,MATH 18,B01,083748,Rideout; David Porter,1,0,36,35
1656277740163,MATH 18,B02,083749,Rideout; David Porter,0,0,36,36
1656277740163,MATH 18,B03,083750,Rideout; David Porter,0,0,36,36
1656277740163,MATH 18,B04,083751,Rideout; David Porter,0,1,36,36
1656277740163,MATH 18,B05,093473,Rideout; David Porter,0,0,36,36
1656277740163,MATH 18,B06,093474,Rideout; David Porter,3,0,36,33
1656277746188,MATH 20A,A01,083754,Zheng; Zequn,11,0,40,29
1656277752211,MATH 20B,A01,083756,Briones; Jor-el Thomas Caparas,0,0,36,36
1656277752211,MATH 20B,A02,083757,Briones; Jor-el Thomas Caparas,0,0,36,36
1656277752211,MATH 20B,A03,093475,Staff,0,0,36,36
1656277758234,MATH 20C,A01,083760,Briones; Jor-el Thomas Caparas,0,0,35,35
1656277758234,MATH 20C,A02,083761,Briones; Jor-el Thomas Caparas,9,1,35,26
1656277758234,MATH 20C,A03,093476,Staff,0,0,35,35
1656277758234,MATH 20C,B01,083762,Bach; Quang Tran,1,0,30,29
1656277764261,MATH 20D,A01,083765,Tran; Brian Kha,1,0,30,29
1656277764261,MATH 20D,A02,083766,Tran; Brian Kha,0,1,30,30
1656277764261,MATH 20D,A03,083767,Tran; Brian Kha,2,0,30,28
1656277770283,MATH 20E,A01,083771,Ganguly; Soumya,3,0,32,29
1656277770283,MATH 20E,A02,083772,Ganguly; Soumya,0,0,32,32
1656277770283,MATH 20E,B01,083773,Ciotti; Benjamin,16,0,35,19
1656277770283,MATH 20E,B02,083774,Ciotti; Benjamin,15,0,35,20
1656277776314,MATH 103A,A01,083777,Greenfeld; Be'Eri,1,0,36,35
1656277776314,MATH 103A,A02,083778,Greenfeld; Be'Eri,2,0,36,34
1656277776314,MATH 103A,A03,093561,Staff,5,0,36,31
1656277776314,MATH 103A,B01,083779,Greenfeld; Be'Eri,8,0,36,28
1656277776314,MATH 103A,B02,083780,Greenfeld; Be'Eri,0,0,36,36
1656277776314,MATH 103A,B03,093562,Staff,0,0,36,36
1656277782340,MATH 105,A01,085443,Carter; Anne Toulson,5,0,35,30
1656277782340,MATH 105,A02,093477,Staff,14,0,35,21
1656277788376,MATH 109,A01,083213,Ganzberger; Geoffrey Michael,1,0,34,33
1656277788376,MATH 109,A02,083214,Ganzberger; Geoffrey Michael,0,0,34,34
1656277788376,MATH 109,A03,093478,Staff,1,0,34,33
1656277788376,MATH 109,B01,083215,Ganzberger; Geoffrey Michael,4,0,32,28
1656277788376,MATH 109,B02,083216,Ganzberger; Geoffrey Michael,1,0,32,31
1656277788376,MATH 109,B03,093479,Staff,3,0,32,29
1656277794411,MATH 142A,A01,083219,Chow; Bennett,2,0,32,30
1656277794411,MATH 142A,A02,083220,Chow; Bennett,8,0,32,24
1656277794411,MATH 142A,A03,093480,Staff,5,0,32,27
1656277794411,MATH 142A,B03,093481,Staff,3,0,32,29
1656277794411,MATH 142A,B04,093558,Staff,6,0,32,26
1656277794411,MATH 142A,B05,093559,Staff,0,0,32,32
1656277800443,MATH 193A,A01,083224,Rotar; Vladimir,0,1,34,34
1656277800443,MATH 193A,A02,083225,Rotar; Vladimir,0,0,34,34
1656277800443,MATH 193A,A03,083781,Rotar; Vladimir,0,0,34,34
1656277800443,MATH 193A,A04,083782,Rotar; Vladimir,6,0,34,28
1656277800443,MATH 193A,A05,093482,Rotar; Vladimir,0,0,34,34
1656277806466,MATH 197,001,091859,McAuley; Julian John,9999,0,9999,0
1656277806466,MATH 197,002,095566,Kedlaya; Kiran S.,9997,0,9999,2
1656277806466,MATH 197,003,095567,Xiao; Ming,9999,0,9999,0
1656277806466,MATH 197,004,095571,Perols; Johan Lars,9998,0,9999,1
1656277813528,COGS 9,A01,083615,Shannon; Kyle Michael,4,0,75,71
1656277819569,COGS 11,A01,083617,Boyle; Mary E. T.,14,0,48,34
1656277825593,COGS 13,A01,083071,Bastos; Amalia Pinkusfeld,5,0,71,66
1656277831616,COGS 14A,A01,092681,Semenuks; Arturs,1,12,100,99
1656277837639,COGS 14B,A01,083073,Cheng; Tzu-Han,7,0,63,56
1656277843664,COGS 17,A01,092677,Semenuks; Arturs,8,0,81,73
1656277849691,COGS 100,A01,083619,Allen; Michael Gordon,2,0,70,68
1656277855717,COGS 101A,A01,083621,Davis; Joshua Daniel,4,0,68,64
1656277861741,COGS 101B,A01,091572,Allen; Michael Gordon,4,0,65,61
1656277867769,COGS 101C,A01,083625,Delgado; Tania,10,0,35,25
1656277873796,COGS 107A,A01,083627,Boyle; Mary E. T.,0,0,60,60
1656277879825,COGS 118A,A01,083075,Gupta; Anjum,8,0,76,68
1656277885859,CSE 3,A50,083646,Miranda; Gregory Joseph,18,0,50,32
1656277891883,CSE 8A,A50,083650,Miranda; Gregory Joseph,2,2,56,54
1656277897907,CSE 11,A01,083080,Cao; Yingjun,0,48,40,40
1656277903944,CSE 12,A01,083652,Krause-Levy; Sophia Louisa,5,1,120,115
1656277909970,CSE 15L,A01,083654,Morris; Justin Loren,2,0,50,48
1656277909970,CSE 15L,A02,083655,Morris; Justin Loren,4,0,50,46
1656277915997,CSE 20,A01,083657,Tran; Khoa Dang,30,0,80,50
1656277922021,CSE 21,A01,095574,Bach; Quang Tran,23,0,48,25
1656277928045,CSE 30,A01,083084,Eldon; John,2,6,80,78
1656277928045,CSE 30,B01,095061,Bhaskar; Nishant,0,1,50,50
1656277934071,CSE 100,A01,083659,Cao; Yingjun,1,18,70,69
1656277940105,CSE 134B,A01,083661,Powell; Thomas Allan,5,0,100,95
1656277946127,CSE 140,A01,083663,Gungor; Onat,9,0,85,76
1656277952152,CSE 140L,A01,083088,Eldon; John,9,0,100,91
1656277958175,CSE 175,A01,083665,Kumar; Rakesh,0,0,25,25
1656277964196,CSE 190,A00,092507,Dubnov; Shlomo,3,0,20,17
1656277970300,ECE 45,A01,083139,Congero; Spencer William,1,0,75,74
1656277976328,ECE 65,A50,083695,Saad; Andrew S,9,0,30,21
1656277976328,ECE 65,A51,095125,Staff,24,0,26,2
1656277982353,ECE 109,A01,091882,Touri; Behrouz,0,1,70,70
1656277988380,ECE 180,A00,083140,Abi Samra; Nicholas Camill,2,0,30,28
1656277988380,ECE 180,B00,083141,Abi Samra; Nicholas Camill,0,4,30,30
1656277994404,MATH 10A,A01,083735,Patchell; Gregory David,0,0,30,30
1656277994404,MATH 10A,A02,083736,Patchell; Gregory David,22,0,30,8
1656277994404,MATH 10A,A03,083737,Patchell; Gregory David,16,0,30,14
1656278000427,MATH 10B,A01,083207,Lim; Seonhee,1,0,34,33
1656278000427,MATH 10B,A02,083208,Lim; Seonhee,7,0,35,28
1656278000427,MATH 10B,A03,093472,Staff,1,0,34,33
1656278000427,MATH 10B,B01,083739,Sinha; Shubham,11,0,30,19
1656278006453,MATH 18,A01,083743,Cinel; Cameron Alexander,7,0,30,23
1656278006453,MATH 18,A02,083744,Cinel; Cameron Alexander,9,0,30,21
1656278006453,MATH 18,A03,083745,Cinel; Cameron Alexander,5,0,30,25
1656278006453,MATH 18,B01,083748,Rideout; David Porter,1,0,36,35
1656278006453,MATH 18,B02,083749,Rideout; David Porter,0,0,36,36
1656278006453,MATH 18,B03,083750,Rideout; David Porter,0,0,36,36
1656278006453,MATH 18,B04,083751,Rideout; David Porter,0,1,36,36
1656278006453,MATH 18,B05,093473,Rideout; David Porter,0,0,36,36
1656278006453,MATH 18,B06,093474,Rideout; David Porter,3,0,36,33
1656278012478,MATH 20A,A01,083754,Zheng; Zequn,11,0,40,29
1656278018508,MATH 20B,A01,083756,Briones; Jor-el Thomas Caparas,0,0,36,36
1656278018508,MATH 20B,A02,083757,Briones; Jor-el Thomas Caparas,0,0,36,36
1656278018508,MATH 20B,A03,093475,Staff,0,0,36,36
1656278024531,MATH 20C,A01,083760,Briones; Jor-el Thomas Caparas,0,0,35,35
1656278024531,MATH 20C,A02,083761,Briones; Jor-el Thomas Caparas,9,1,35,26
1656278024531,MATH 20C,A03,093476,Staff,0,0,35,35
1656278024531,MATH 20C,B01,083762,Bach; Quang Tran,1,0,30,29
1656278030558,MATH 20D,A01,083765,Tran; Brian Kha,1,0,30,29
1656278030558,MATH 20D,A02,083766,Tran; Brian Kha,0,1,30,30
1656278030558,MATH 20D,A03,083767,Tran; Brian Kha,2,0,30,28
1656278036581,MATH 20E,A01,083771,Ganguly; Soumya,3,0,32,29
1656278036581,MATH 20E,A02,083772,Ganguly; Soumya,0,0,32,32
1656278036581,MATH 20E,B01,083773,Ciotti; Benjamin,16,0,35,19
1656278036581,MATH 20E,B02,083774,Ciotti; Benjamin,15,0,35,20
1656278042608,MATH 103A,A01,083777,Greenfeld; Be'Eri,1,0,36,35
1656278042608,MATH 103A,A02,083778,Greenfeld; Be'Eri,2,0,36,34
1656278042608,MATH 103A,A03,093561,Staff,5,0,36,31
1656278042608,MATH 103A,B01,083779,Greenfeld; Be'Eri,8,0,36,28
1656278042608,MATH 103A,B02,083780,Greenfeld; Be'Eri,0,0,36,36
1656278042608,MATH 103A,B03,093562,Staff,0,0,36,36
1656278048630,MATH 105,A01,085443,Carter; Anne Toulson,5,0,35,30
1656278048630,MATH 105,A02,093477,Staff,14,0,35,21
1656278054660,MATH 109,A01,083213,Ganzberger; Geoffrey Michael,1,0,34,33
1656278054660,MATH 109,A02,083214,Ganzberger; Geoffrey Michael,0,0,34,34
1656278054660,MATH 109,A03,093478,Staff,1,0,34,33
1656278054660,MATH 109,B01,083215,Ganzberger; Geoffrey Michael,4,0,32,28
1656278054660,MATH 109,B02,083216,Ganzberger; Geoffrey Michael,1,0,32,31
1656278054660,MATH 109,B03,093479,Staff,3,0,32,29
1656278060689,MATH 142A,A01,083219,Chow; Bennett,2,0,32,30
1656278060689,MATH 142A,A02,083220,Chow; Bennett,8,0,32,24
1656278060689,MATH 142A,A03,093480,Staff,5,0,32,27
1656278060689,MATH 142A,B03,093481,Staff,3,0,32,29
1656278060689,MATH 142A,B04,093558,Staff,6,0,32,26
1656278060689,MATH 142A,B05,093559,Staff,0,0,32,32
1656278066711,MATH 193A,A01,083224,Rotar; Vladimir,0,1,34,34
1656278066711,MATH 193A,A02,083225,Rotar; Vladimir,0,0,34,34
1656278066711,MATH 193A,A03,083781,Rotar; Vladimir,0,0,34,34
1656278066711,MATH 193A,A04,083782,Rotar; Vladimir,6,0,34,28
1656278066711,MATH 193A,A05,093482,Rotar; Vladimir,0,0,34,34
1656278072735,MATH 197,001,091859,McAuley; Julian John,9999,0,9999,0
1656278072735,MATH 197,002,095566,Kedlaya; Kiran S.,9997,0,9999,2
1656278072735,MATH 197,003,095567,Xiao; Ming,9999,0,9999,0
1656278072735,MATH 197,004,095571,Perols; Johan Lars,9998,0,9999,1
1656278079797,COGS 9,A01,083615,Shannon; Kyle Michael,4,0,75,71
1656278085823,COGS 11,A01,083617,Boyle; Mary E. T.,14,0,48,34
1656278091847,COGS 13,A01,083071,Bastos; Amalia Pinkusfeld,5,0,71,66
1656278097871,COGS 14A,A01,092681,Semenuks; Arturs,1,12,100,99
1656278104008,COGS 14B,A01,083073,Cheng; Tzu-Han,7,0,63,56
1656278110031,COGS 17,A01,092677,Semenuks; Arturs,8,0,81,73
1656278116057,COGS 100,A01,083619,Allen; Michael Gordon,2,0,70,68
1656278122080,COGS 101A,A01,083621,Davis; Joshua Daniel,4,0,68,64
1656278128102,COGS 101B,A01,091572,Allen; Michael Gordon,4,0,65,61
1656278134133,COGS 101C,A01,083625,Delgado; Tania,10,0,35,25
1656278140159,COGS 107A,A01,083627,Boyle; Mary E. T.,0,0,60,60
1656278146183,COGS 118A,A01,083075,Gupta; Anjum,8,0,76,68
1656278152218,CSE 3,A50,083646,Miranda; Gregory Joseph,18,0,50,32
1656278158241,CSE 8A,A50,083650,Miranda; Gregory Joseph,2,2,56,54
1656278164266,CSE 11,A01,083080,Cao; Yingjun,0,48,40,40
1656278170290,CSE 12,A01,083652,Krause-Levy; Sophia Louisa,5,1,120,115
1656278176316,CSE 15L,A01,083654,Morris; Justin Loren,2,0,50,48
1656278176316,CSE 15L,A02,083655,Morris; Justin Loren,4,0,50,46
1656278182343,CSE 20,A01,083657,Tran; Khoa Dang,30,0,80,50
1656278188366,CSE 21,A01,095574,Bach; Quang Tran,23,0,48,25
1656278194389,CSE 30,A01,083084,Eldon; John,2,6,80,78
1656278194389,CSE 30,B01,095061,Bhaskar; Nishant,0,1,50,50
1656278200415,CSE 100,A01,083659,Cao; Yingjun,1,18,70,69
1656278206443,CSE 134B,A01,083661,Powell; Thomas Allan,5,0,100,95
1656278212467,CSE 140,A01,083663,Gungor; Onat,9,0,85,76
1656278218494,CSE 140L,A01,083088,Eldon; John,9,0,100,91
1656278224521,CSE 175,A01,083665,Kumar; Rakesh,0,0,25,25
1656278230547,CSE 190,A00,092507,Dubnov; Shlomo,3,0,20,17
1656278236568,ECE 45,A01,083139,Congero; Spencer William,1,0,75,74
1656278242590,ECE 65,A50,083695,Saad; Andrew S,9,0,30,21
1656278242590,ECE 65,A51,095125,Staff,24,0,26,2
1656278248614,ECE 109,A01,091882,Touri; Behrouz,0,1,70,70
1656278254637,ECE 180,A00,083140,Abi Samra; Nicholas Camill,2,0,30,28
1656278254637,ECE 180,B00,083141,Abi Samra; Nicholas Camill,0,4,30,30
1656278260660,MATH 10A,A01,083735,Patchell; Gregory David,0,0,30,30
1656278260660,MATH 10A,A02,083736,Patchell; Gregory David,22,0,30,8
1656278260660,MATH 10A,A03,083737,Patchell; Gregory David,16,0,30,14
1656278266683,MATH 10B,A01,083207,Lim; Seonhee,1,0,34,33
1656278266683,MATH 10B,A02,083208,Lim; Seonhee,7,0,35,28
1656278266683,MATH 10B,A03,093472,Staff,1,0,34,33
1656278266683,MATH 10B,B01,083739,Sinha; Shubham,11,0,30,19
1656278272711,MATH 18,A01,083743,Cinel; Cameron Alexander,7,0,30,23
1656278272711,MATH 18,A02,083744,Cinel; Cameron Alexander,9,0,30,21
1656278272711,MATH 18,A03,083745,Cinel; Cameron Alexander,5,0,30,25
1656278272711,MATH 18,B01,083748,Rideout; David Porter,1,0,36,35
1656278272711,MATH 18,B02,083749,Rideout; David Porter,0,0,36,36
1656278272711,MATH 18,B03,083750,Rideout; David Porter,0,0,36,36
1656278272711,MATH 18,B04,083751,Rideout; David Porter,0,1,36,36
1656278272711,MATH 18,B05,093473,Rideout; David Porter,0,0,36,36
1656278272711,MATH 18,B06,093474,Rideout; David Porter,3,0,36,33
1656278278734,MATH 20A,A01,083754,Zheng; Zequn,11,0,40,29
1656278284762,MATH 20B,A01,083756,Briones; Jor-el Thomas Caparas,0,0,36,36
1656278284762,MATH 20B,A02,083757,Briones; Jor-el Thomas Caparas,0,0,36,36
1656278284762,MATH 20B,A03,093475,Staff,0,0,36,36
1656278290791,MATH 20C,A01,083760,Briones; Jor-el Thomas Caparas,0,0,35,35
1656278290791,MATH 20C,A02,083761,Briones; Jor-el Thomas Caparas,9,1,35,26
1656278290791,MATH 20C,A03,093476,Staff,0,0,35,35
1656278290791,MATH 20C,B01,083762,Bach; Quang Tran,1,0,30,29
1656278296827,MATH 20D,A01,083765,Tran; Brian Kha,1,0,30,29
1656278296827,MATH 20D,A02,083766,Tran; Brian Kha,0,1,30,30
1656278296827,MATH 20D,A03,083767,Tran; Brian Kha,2,0,30,28
1656278302856,MATH 20E,A01,083771,Ganguly; Soumya,3,0,32,29
1656278302856,MATH 20E,A02,083772,Ganguly; Soumya,0,0,32,32
1656278302856,MATH 20E,B01,083773,Ciotti; Benjamin,16,0,35,19
1656278302856,MATH 20E,B02,083774,Ciotti; Benjamin,15,0,35,20
1656278308880,MATH 103A,A01,083777,Greenfeld; Be'Eri,1,0,36,35
1656278308880,MATH 103A,A02,083778,Greenfeld; Be'Eri,2,0,36,34
1656278308880,MATH 103A,A03,093561,Staff,5,0,36,31
1656278308880,MATH 103A,B01,083779,Greenfeld; Be'Eri,8,0,36,28
1656278308880,MATH 103A,B02,083780,Greenfeld; Be'Eri,0,0,36,36
1656278308880,MATH 103A,B03,093562,Staff,0,0,36,36
1656278314904,MATH 105,A01,085443,Carter; Anne Toulson,5,0,35,30
1656278314904,MATH 105,A02,093477,Staff,14,0,35,21
1656278320927,MATH 109,A01,083213,Ganzberger; Geoffrey Michael,1,0,34,33
1656278320927,MATH 109,A02,083214,Ganzberger; Geoffrey Michael,0,0,34,34
1656278320927,MATH 109,A03,093478,Staff,1,0,34,33
1656278320927,MATH 109,B01,083215,Ganzberger; Geoffrey Michael,4,0,32,28
1656278320927,MATH 109,B02,083216,Ganzberger; Geoffrey Michael,1,0,32,31
1656278320927,MATH 109,B03,093479,Staff,3,0,32,29
1656278326955,MATH 142A,A01,083219,Chow; Bennett,2,0,32,30
1656278326955,MATH 142A,A02,083220,Chow; Bennett,8,0,32,24
1656278326955,MATH 142A,A03,093480,Staff,5,0,32,27
1656278326955,MATH 142A,B03,093481,Staff,3,0,32,29
1656278326955,MATH 142A,B04,093558,Staff,6,0,32,26
1656278326955,MATH 142A,B05,093559,Staff,0,0,32,32
1656278332979,MATH 193A,A01,083224,Rotar; Vladimir,0,1,34,34
1656278332979,MATH 193A,A02,083225,Rotar; Vladimir,0,0,34,34
1656278332979,MATH 193A,A03,083781,Rotar; Vladimir,0,0,34,34
1656278332979,MATH 193A,A04,083782,Rotar; Vladimir,6,0,34,28
1656278332979,MATH 193A,A05,093482,Rotar; Vladimir,0,0,34,34
1656278339002,MATH 197,001,091859,McAuley; Julian John,9999,0,9999,0
1656278339002,MATH 197,002,095566,Kedlaya; Kiran S.,9997,0,9999,2
1656278339002,MATH 197,003,095567,Xiao; Ming,9999,0,9999,0
1656278339002,MATH 197,004,095571,Perols; Johan Lars,9998,0,9999,1
1656278346066,COGS 9,A01,083615,Shannon; Kyle Michael,4,0,75,71
1656278352093,COGS 11,A01,083617,Boyle; Mary E. T.,14,0,48,34
1656278358116,COGS 13,A01,083071,Bastos; Amalia Pinkusfeld,5,0,71,66
1656278364139,COGS 14A,A01,092681,Semenuks; Arturs,1,12,100,99
1656278370165,COGS 14B,A01,083073,Cheng; Tzu-Han,7,0,63,56
1656278376188,COGS 17,A01,092677,Semenuks; Arturs,8,0,81,73
1656278382211,COGS 100,A01,083619,Allen; Michael Gordon,2,0,70,68
1656278388241,COGS 101A,A01,083621,Davis; Joshua Daniel,4,0,68,64
1656278394267,COGS 101B,A01,091572,Allen; Michael Gordon,4,0,65,61
1656278400293,COGS 101C,A01,083625,Delgado; Tania,10,0,35,25
1656278406320,COGS 107A,A01,083627,Boyle; Mary E. T.,0,0,60,60
1656278412344,COGS 118A,A01,083075,Gupta; Anjum,8,0,76,68
1656278418369,CSE 3,A50,083646,Miranda; Gregory Joseph,18,0,50,32
1656278424392,CSE 8A,A50,083650,Miranda; Gregory Joseph,2,2,56,54
1656278430415,CSE 11,A01,083080,Cao; Yingjun,0,48,40,40
1656278436441,CSE 12,A01,083652,Krause-Levy; Sophia Louisa,5,1,120,115
1656278442465,CSE 15L,A01,083654,Morris; Justin Loren,2,0,50,48
1656278442465,CSE 15L,A02,083655,Morris; Justin Loren,4,0,50,46
1656278448488,CSE 20,A01,083657,Tran; Khoa Dang,30,0,80,50
1656278454516,CSE 21,A01,095574,Bach; Quang Tran,23,0,48,25
1656278460540,CSE 30,A01,083084,Eldon; John,2,6,80,78
1656278460540,CSE 30,B01,095061,Bhaskar; Nishant,0,1,50,50
1656278466571,CSE 100,A01,083659,Cao; Yingjun,1,18,70,69
1656278472598,CSE 134B,A01,083661,Powell; Thomas Allan,5,0,100,95
1656278478622,CSE 140,A01,083663,Gungor; Onat,9,0,85,76
1656278484644,CSE 140L,A01,083088,Eldon; John,9,0,100,91
1656278490667,CSE 175,A01,083665,Kumar; Rakesh,0,0,25,25
1656278496690,CSE 190,A00,092507,Dubnov; Shlomo,3,0,20,17
1656278502716,ECE 45,A01,083139,Congero; Spencer William,1,0,75,74
1656278508739,ECE 65,A50,083695,Saad; Andrew S,9,0,30,21
1656278508739,ECE 65,A51,095125,Staff,24,0,26,2
1656278514762,ECE 109,A01,091882,Touri; Behrouz,1,1,70,69
1656278520784,ECE 180,A00,083140,Abi Samra; Nicholas Camill,2,0,30,28
1656278520784,ECE 180,B00,083141,Abi Samra; Nicholas Camill,0,4,30,30
1656278526808,MATH 10A,A01,083735,Patchell; Gregory David,0,0,30,30
1656278526808,MATH 10A,A02,083736,Patchell; Gregory David,22,0,30,8
1656278526808,MATH 10A,A03,083737,Patchell; Gregory David,16,0,30,14
1656278532836,MATH 10B,A01,083207,Lim; Seonhee,1,0,34,33
1656278532836,MATH 10B,A02,083208,Lim; Seonhee,7,0,35,28
1656278532836,MATH 10B,A03,093472,Staff,1,0,34,33
1656278532836,MATH 10B,B01,083739,Sinha; Shubham,11,0,30,19
1656278538862,MATH 18,A01,083743,Cinel; Cameron Alexander,7,0,30,23
1656278538862,MATH 18,A02,083744,Cinel; Cameron Alexander,9,0,30,21
1656278538862,MATH 18,A03,083745,Cinel; Cameron Alexander,5,0,30,25
1656278538862,MATH 18,B01,083748,Rideout; David Porter,1,0,36,35
1656278538862,MATH 18,B02,083749,Rideout; David Porter,0,0,36,36
1656278538862,MATH 18,B03,083750,Rideout; David Porter,0,0,36,36
1656278538862,MATH 18,B04,083751,Rideout; David Porter,0,1,36,36
1656278538862,MATH 18,B05,093473,Rideout; David Porter,0,0,36,36
1656278538862,MATH 18,B06,093474,Rideout; David Porter,3,0,36,33
1656278544884,MATH 20A,A01,083754,Zheng; Zequn,11,0,40,29
1656278550909,MATH 20B,A01,083756,Briones; Jor-el Thomas Caparas,0,0,36,36
1656278550909,MATH 20B,A02,083757,Briones; Jor-el Thomas Caparas,0,0,36,36
1656278550909,MATH 20B,A03,093475,Staff,0,0,36,36
1656278556940,MATH 20C,A01,083760,Briones; Jor-el Thomas Caparas,0,0,35,35
1656278556940,MATH 20C,A02,083761,Briones; Jor-el Thomas Caparas,9,1,35,26
1656278556940,MATH 20C,A03,093476,Staff,0,0,35,35
1656278556940,MATH 20C,B01,083762,Bach; Quang Tran,1,0,30,29
1656278562973,MATH 20D,A01,083765,Tran; Brian Kha,1,0,30,29
1656278562973,MATH 20D,A02,083766,Tran; Brian Kha,0,1,30,30
1656278562973,MATH 20D,A03,083767,Tran; Brian Kha,2,0,30,28
1656278569093,MATH 20E,A01,083771,Ganguly; Soumya,3,0,32,29
1656278569093,MATH 20E,A02,083772,Ganguly; Soumya,0,0,32,32
1656278569093,MATH 20E,B01,083773,Ciotti; Benjamin,16,0,35,19
1656278569093,MATH 20E,B02,083774,Ciotti; Benjamin,15,0,35,20
1656278575122,MATH 103A,A01,083777,Greenfeld; Be'Eri,1,0,36,35
1656278575122,MATH 103A,A02,083778,Greenfeld; Be'Eri,2,0,36,34
1656278575122,MATH 103A,A03,093561,Staff,5,0,36,31
1656278575122,MATH 103A,B01,083779,Greenfeld; Be'Eri,8,0,36,28
1656278575122,MATH 103A,B02,083780,Greenfeld; Be'Eri,0,0,36,36
1656278575122,MATH 103A,B03,093562,Staff,0,0,36,36
1656278581146,MATH 105,A01,085443,Carter; Anne Toulson,5,0,35,30
1656278581146,MATH 105,A02,093477,Staff,14,0,35,21
1656278587170,MATH 109,A01,083213,Ganzberger; Geoffrey Michael,1,0,34,33
1656278587170,MATH 109,A02,083214,Ganzberger; Geoffrey Michael,0,0,34,34
1656278587170,MATH 109,A03,093478,Staff,1,0,34,33
1656278587170,MATH 109,B01,083215,Ganzberger; Geoffrey Michael,4,0,32,28
1656278587170,MATH 109,B02,083216,Ganzberger; Geoffrey Michael,1,0,32,31
1656278587170,MATH 109,B03,093479,Staff,3,0,32,29
1656278593200,MATH 142A,A01,083219,Chow; Bennett,2,0,32,30
1656278593200,MATH 142A,A02,083220,Chow; Bennett,8,0,32,24
1656278593200,MATH 142A,A03,093480,Staff,5,0,32,27
1656278593200,MATH 142A,B03,093481,Staff,3,0,32,29
1656278593200,MATH 142A,B04,093558,Staff,6,0,32,26
1656278593200,MATH 142A,B05,093559,Staff,0,0,32,32
1656278599227,MATH 193A,A01,083224,Rotar; Vladimir,0,1,34,34
1656278599227,MATH 193A,A02,083225,Rotar; Vladimir,0,0,34,34
1656278599227,MATH 193A,A03,083781,Rotar; Vladimir,0,0,34,34
1656278599227,MATH 193A,A04,083782,Rotar; Vladimir,6,0,34,28
1656278599227,MATH 193A,A05,093482,Rotar; Vladimir,0,0,34,34
1656278605253,MATH 197,001,091859,McAuley; Julian John,9999,0,9999,0
1656278605253,MATH 197,002,095566,Kedlaya; Kiran S.,9997,0,9999,2
1656278605253,MATH 197,003,095567,Xiao; Ming,9999,0,9999,0
1656278605253,MATH 197,004,095571,Perols; Johan Lars,9998,0,9999,1
1656278612314,COGS 9,A01,083615,Shannon; Kyle Michael,4,0,75,71
1656278618343,COGS 11,A01,083617,Boyle; Mary E. T.,14,0,48,34
1656278624369,COGS 13,A01,083071,Bastos; Amalia Pinkusfeld,5,0,71,66
1656278630397,COGS 14A,A01,092681,Semenuks; Arturs,1,12,100,99
1656278636420,COGS 14B,A01,083073,Cheng; Tzu-Han,7,0,63,56
1656278642442,COGS 17,A01,092677,Semenuks; Arturs,8,0,81,73
1656278648466,COGS 100,A01,083619,Allen; Michael Gordon,2,0,70,68
1656278654490,COGS 101A,A01,083621,Davis; Joshua Daniel,4,0,68,64
1656278660513,COGS 101B,A01,091572,Allen; Michael Gordon,4,0,65,61
1656278666536,COGS 101C,A01,083625,Delgado; Tania,10,0,35,25
1656278672562,COGS 107A,A01,083627,Boyle; Mary E. T.,0,0,60,60
1656278678586,COGS 118A,A01,083075,Gupta; Anjum,8,0,76,68
1656278684609,CSE 3,A50,083646,Miranda; Gregory Joseph,18,0,50,32
1656278690636,CSE 8A,A50,083650,Miranda; Gregory Joseph,2,2,56,54
1656278696663,CSE 11,A01,083080,Cao; Yingjun,0,48,40,40
1656278702697,CSE 12,A01,083652,Krause-Levy; Sophia Louisa,5,1,120,115
1656278708720,CSE 15L,A01,083654,Morris; Justin Loren,2,0,50,48
1656278708720,CSE 15L,A02,083655,Morris; Justin Loren,4,0,50,46
1656278714743,CSE 20,A01,083657,Tran; Khoa Dang,30,0,80,50
1656278720771,CSE 21,A01,095574,Bach; Quang Tran,23,0,48,25
1656278726795,CSE 30,A01,083084,Eldon; John,2,6,80,78
1656278726795,CSE 30,B01,095061,Bhaskar; Nishant,0,1,50,50
1656278732819,CSE 100,A01,083659,Cao; Yingjun,1,18,70,69
1656278738841,CSE 134B,A01,083661,Powell; Thomas Allan,5,0,100,95
1656278744867,CSE 140,A01,083663,Gungor; Onat,9,0,85,76
1656278750895,CSE 140L,A01,083088,Eldon; John,9,0,100,91
1656278756918,CSE 175,A01,083665,Kumar; Rakesh,0,0,25,25
1656278762944,CSE 190,A00,092507,Dubnov; Shlomo,3,0,20,17
1656278768967,ECE 45,A01,083139,Congero; Spencer William,1,0,75,74
1656278774993,ECE 65,A50,083695,Saad; Andrew S,9,0,30,21
1656278774993,ECE 65,A51,095125,Staff,24,0,26,2
1656278781019,ECE 109,A01,091882,Touri; Behrouz,1,1,70,69
1656278787046,ECE 180,A00,083140,Abi Samra; Nicholas Camill,2,0,30,28
1656278787046,ECE 180,B00,083141,Abi Samra; Nicholas Camill,0,4,30,30
1656278793071,MATH 10A,A01,083735,Patchell; Gregory David,0,0,30,30
1656278793071,MATH 10A,A02,083736,Patchell; Gregory David,22,0,30,8
1656278793071,MATH 10A,A03,083737,Patchell; Gregory David,16,0,30,14
1656278799118,MATH 10B,A01,083207,Lim; Seonhee,1,0,34,33
1656278799118,MATH 10B,A02,083208,Lim; Seonhee,7,0,35,28
1656278799118,MATH 10B,A03,093472,Staff,1,0,34,33
1656278799118,MATH 10B,B01,083739,Sinha; Shubham,11,0,30,19
1656278805147,MATH 18,A01,083743,Cinel; Cameron Alexander,7,0,30,23
1656278805147,MATH 18,A02,083744,Cinel; Cameron Alexander,9,0,30,21
1656278805147,MATH 18,A03,083745,Cinel; Cameron Alexander,5,0,30,25
1656278805147,MATH 18,B01,083748,Rideout; David Porter,1,0,36,35
1656278805147,MATH 18,B02,083749,Rideout; David Porter,0,0,36,36
1656278805147,MATH 18,B03,083750,Rideout; David Porter,0,0,36,36
1656278805147,MATH 18,B04,083751,Rideout; David Porter,0,1,36,36
1656278805147,MATH 18,B05,093473,Rideout; David Porter,0,0,36,36
1656278805147,MATH 18,B06,093474,Rideout; David Porter,3,0,36,33
1656278811175,MATH 20A,A01,083754,Zheng; Zequn,11,0,40,29
1656278817203,MATH 20B,A01,083756,Briones; Jor-el Thomas Caparas,0,0,36,36
1656278817203,MATH 20B,A02,083757,Briones; Jor-el Thomas Caparas,0,0,36,36
1656278817203,MATH 20B,A03,093475,Staff,0,0,36,36
1656278823226,MATH 20C,A01,083760,Briones; Jor-el Thomas Caparas,0,0,35,35
1656278823226,MATH 20C,A02,083761,Briones; Jor-el Thomas Caparas,9,1,35,26
1656278823226,MATH 20C,A03,093476,Staff,0,0,35,35
1656278823226,MATH 20C,B01,083762,Bach; Quang Tran,1,0,30,29
1656278829254,MATH 20D,A01,083765,Tran; Brian Kha,1,0,30,29
1656278829254,MATH 20D,A02,083766,Tran; Brian Kha,0,1,30,30
1656278829254,MATH 20D,A03,083767,Tran; Brian Kha,2,0,30,28
1656278835282,MATH 20E,A01,083771,Ganguly; Soumya,3,0,32,29
1656278835282,MATH 20E,A02,083772,Ganguly; Soumya,0,0,32,32
1656278835282,MATH 20E,B01,083773,Ciotti; Benjamin,16,0,35,19
1656278835282,MATH 20E,B02,083774,Ciotti; Benjamin,15,0,35,20
1656278841312,MATH 103A,A01,083777,Greenfeld; Be'Eri,1,0,36,35
1656278841312,MATH 103A,A02,083778,Greenfeld; Be'Eri,2,0,36,34
1656278841312,MATH 103A,A03,093561,Staff,5,0,36,31
1656278841312,MATH 103A,B01,083779,Greenfeld; Be'Eri,8,0,36,28
1656278841312,MATH 103A,B02,083780,Greenfeld; Be'Eri,0,0,36,36
1656278841312,MATH 103A,B03,093562,Staff,0,0,36,36
1656278847339,MATH 105,A01,085443,Carter; Anne Toulson,5,0,35,30
1656278847339,MATH 105,A02,093477,Staff,14,0,35,21
1656278853362,MATH 109,A01,083213,Ganzberger; Geoffrey Michael,1,0,34,33
1656278853362,MATH 109,A02,083214,Ganzberger; Geoffrey Michael,0,0,34,34
1656278853362,MATH 109,A03,093478,Staff,1,0,34,33
1656278853362,MATH 109,B01,083215,Ganzberger; Geoffrey Michael,4,0,32,28
1656278853362,MATH 109,B02,083216,Ganzberger; Geoffrey Michael,1,0,32,31
1656278853362,MATH 109,B03,093479,Staff,3,0,32,29
1656278859391,MATH 142A,A01,083219,Chow; Bennett,1,0,32,31
1656278859391,MATH 142A,A02,083220,Chow; Bennett,8,0,32,24
1656278859391,MATH 142A,A03,093480,Staff,5,0,32,27
1656278859391,MATH 142A,B03,093481,Staff,3,0,32,29
1656278859391,MATH 142A,B04,093558,Staff,6,0,32,26
1656278859391,MATH 142A,B05,093559,Staff,0,0,32,32
1656278865420,MATH 193A,A01,083224,Rotar; Vladimir,0,1,34,34
1656278865420,MATH 193A,A02,083225,Rotar; Vladimir,0,0,34,34
1656278865420,MATH 193A,A03,083781,Rotar; Vladimir,0,0,34,34
1656278865420,MATH 193A,A04,083782,Rotar; Vladimir,6,0,34,28
1656278865420,MATH 193A,A05,093482,Rotar; Vladimir,0,0,34,34
1656278871443,MATH 197,001,091859,McAuley; Julian John,9999,0,9999,0
1656278871443,MATH 197,002,095566,Kedlaya; Kiran S.,9997,0,9999,2
1656278871443,MATH 197,003,095567,Xiao; Ming,9999,0,9999,0
1656278871443,MATH 197,004,095571,Perols; Johan Lars,9998,0,9999,1
1656278878498,COGS 9,A01,083615,Shannon; Kyle Michael,4,0,75,71
1656278884521,COGS 11,A01,083617,Boyle; Mary E. T.,14,0,48,34
1656278890545,COGS 13,A01,083071,Bastos; Amalia Pinkusfeld,5,0,71,66
1656278896572,COGS 14A,A01,092681,Semenuks; Arturs,1,12,100,99
1656278902596,COGS 14B,A01,083073,Cheng; Tzu-Han,7,0,63,56
1656278908619,COGS 17,A01,092677,Semenuks; Arturs,8,0,81,73
1656278914642,COGS 100,A01,083619,Allen; Michael Gordon,2,0,70,68
1656278920668,COGS 101A,A01,083621,Davis; Joshua Daniel,4,0,68,64
1656278926697,COGS 101B,A01,091572,Allen; Michael Gordon,4,0,65,61
1656278932721,COGS 101C,A01,083625,Delgado; Tania,10,0,35,25
1656278938745,COGS 107A,A01,083627,Boyle; Mary E. T.,0,0,60,60
1656278944770,COGS 118A,A01,083075,Gupta; Anjum,8,0,76,68
1656278950794,CSE 3,A50,083646,Miranda; Gregory Joseph,18,0,50,32
1656278956821,CSE 8A,A50,083650,Miranda; Gregory Joseph,2,2,56,54
1656278962847,CSE 11,A01,083080,Cao; Yingjun,0,48,40,40
1656278968870,CSE 12,A01,083652,Krause-Levy; Sophia Louisa,5,1,120,115
1656278974895,CSE 15L,A01,083654,Morris; Justin Loren,2,0,50,48
1656278974895,CSE 15L,A02,083655,Morris; Justin Loren,4,0,50,46
1656278980916,CSE 20,A01,083657,Tran; Khoa Dang,30,0,80,50
1656278986938,CSE 21,A01,095574,Bach; Quang Tran,23,0,48,25
1656278992961,CSE 30,A01,083084,Eldon; John,2,6,80,78
1656278992961,CSE 30,B01,095061,Bhaskar; Nishant,0,1,50,50
1656278998985,CSE 100,A01,083659,Cao; Yingjun,1,18,70,69
1656279005010,CSE 134B,A01,083661,Powell; Thomas Allan,5,0,100,95
1656279011033,CSE 140,A01,083663,Gungor; Onat,8,0,85,77
1656279017055,CSE 140L,A01,083088,Eldon; John,9,0,100,91
1656279023079,CSE 175,A01,083665,Kumar; Rakesh,0,0,25,25
1656279029106,CSE 190,A00,092507,Dubnov; Shlomo,3,0,20,17
1656279035131,ECE 45,A01,083139,Congero; Spencer William,1,0,75,74
1656279041167,ECE 65,A50,083695,Saad; Andrew S,9,0,30,21
1656279041167,ECE 65,A51,095125,Staff,24,0,26,2
1656279047193,ECE 109,A01,091882,Touri; Behrouz,1,1,70,69
1656279053216,ECE 180,A00,083140,Abi Samra; Nicholas Camill,2,0,30,28
1656279053216,ECE 180,B00,083141,Abi Samra; Nicholas Camill,0,4,30,30
1656279059240,MATH 10A,A01,083735,Patchell; Gregory David,0,0,30,30
1656279059240,MATH 10A,A02,083736,Patchell; Gregory David,22,0,30,8
1656279059240,MATH 10A,A03,083737,Patchell; Gregory David,16,0,30,14
1656279065265,MATH 10B,A01,083207,Lim; Seonhee,1,0,34,33
1656279065265,MATH 10B,A02,083208,Lim; Seonhee,7,0,35,28
1656279065265,MATH 10B,A03,093472,Staff,1,0,34,33
1656279065265,MATH 10B,B01,083739,Sinha; Shubham,11,0,30,19
1656279071290,MATH 18,A01,083743,Cinel; Cameron Alexander,7,0,30,23
1656279071290,MATH 18,A02,083744,Cinel; Cameron Alexander,9,0,30,21
1656279071290,MATH 18,A03,083745,Cinel; Cameron Alexander,5,0,30,25
1656279071290,MATH 18,B01,083748,Rideout; David Porter,1,0,36,35
1656279071290,MATH 18,B02,083749,Rideout; David Porter,0,0,36,36
1656279071290,MATH 18,B03,083750,Rideout; David Porter,0,0,36,36
1656279071290,MATH 18,B04,083751,Rideout; David Porter,0,1,36,36
1656279071290,MATH 18,B05,093473,Rideout; David Porter,0,0,36,36
1656279071290,MATH 18,B06,093474,Rideout; David Porter,3,0,36,33
1656279077317,MATH 20A,A01,083754,Zheng; Zequn,11,0,40,29
1656279083347,MATH 20B,A01,083756,Briones; Jor-el Thomas Caparas,0,0,36,36
1656279083347,MATH 20B,A02,083757,Briones; Jor-el Thomas Caparas,0,0,36,36
1656279083347,MATH 20B,A03,093475,Staff,0,0,36,36
1656279089372,MATH 20C,A01,083760,Briones; Jor-el Thomas Caparas,0,0,35,35
1656279089372,MATH 20C,A02,083761,Briones; Jor-el Thomas Caparas,9,1,35,26
1656279089372,MATH 20C,A03,093476,Staff,0,0,35,35
1656279089372,MATH 20C,B01,083762,Bach; Quang Tran,1,0,30,29
1656279095394,MATH 20D,A01,083765,Tran; Brian Kha,1,0,30,29
1656279095394,MATH 20D,A02,083766,Tran; Brian Kha,0,1,30,30
1656279095394,MATH 20D,A03,083767,Tran; Brian Kha,2,0,30,28
1656279101419,MATH 20E,A01,083771,Ganguly; Soumya,3,0,32,29
1656279101419,MATH 20E,A02,083772,Ganguly; Soumya,0,0,32,32
1656279101419,MATH 20E,B01,083773,Ciotti; Benjamin,16,0,35,19
1656279101419,MATH 20E,B02,083774,Ciotti; Benjamin,15,0,35,20
1656279107444,MATH 103A,A01,083777,Greenfeld; Be'Eri,1,0,36,35
1656279107444,MATH 103A,A02,083778,Greenfeld; Be'Eri,2,0,36,34
1656279107444,MATH 103A,A03,093561,Staff,5,0,36,31
1656279107444,MATH 103A,B01,083779,Greenfeld; Be'Eri,8,0,36,28
1656279107444,MATH 103A,B02,083780,Greenfeld; Be'Eri,0,0,36,36
1656279107444,MATH 103A,B03,093562,Staff,0,0,36,36
1656279113472,MATH 105,A01,085443,Carter; Anne Toulson,5,0,35,30
1656279113472,MATH 105,A02,093477,Staff,14,0,35,21
1656279119496,MATH 109,A01,083213,Ganzberger; Geoffrey Michael,1,0,34,33
1656279119496,MATH 109,A02,083214,Ganzberger; Geoffrey Michael,0,0,34,34
1656279119496,MATH 109,A03,093478,Staff,1,0,34,33
1656279119496,MATH 109,B01,083215,Ganzberger; Geoffrey Michael,4,0,32,28
1656279119496,MATH 109,B02,083216,Ganzberger; Geoffrey Michael,1,0,32,31
1656279119496,MATH 109,B03,093479,Staff,3,0,32,29
1656279125521,MATH 142A,A01,083219,Chow; Bennett,1,0,32,31
1656279125521,MATH 142A,A02,083220,Chow; Bennett,8,0,32,24
1656279125521,MATH 142A,A03,093480,Staff,5,0,32,27
1656279125521,MATH 142A,B03,093481,Staff,3,0,32,29
1656279125521,MATH 142A,B04,093558,Staff,6,0,32,26
1656279125521,MATH 142A,B05,093559,Staff,0,0,32,32
1656279131544,MATH 193A,A01,083224,Rotar; Vladimir,0,1,34,34
1656279131544,MATH 193A,A02,083225,Rotar; Vladimir,0,0,34,34
1656279131544,MATH 193A,A03,083781,Rotar; Vladimir,0,0,34,34
1656279131544,MATH 193A,A04,083782,Rotar; Vladimir,6,0,34,28
1656279131544,MATH 193A,A05,093482,Rotar; Vladimir,0,0,34,34
1656279137571,MATH 197,001,091859,McAuley; Julian John,9999,0,9999,0
1656279137571,MATH 197,002,095566,Kedlaya; Kiran S.,9997,0,9999,2
1656279137571,MATH 197,003,095567,Xiao; Ming,9999,0,9999,0
1656279137571,MATH 197,004,095571,Perols; Johan Lars,9998,0,9999,1
1656279144632,COGS 9,A01,083615,Shannon; Kyle Michael,4,0,75,71
1656279150659,COGS 11,A01,083617,Boyle; Mary E. T.,14,0,48,34
1656279156686,COGS 13,A01,083071,Bastos; Amalia Pinkusfeld,5,0,71,66
1656279162791,COGS 14A,A01,092681,Semenuks; Arturs,1,12,100,99
1656279168818,COGS 14B,A01,083073,Cheng; Tzu-Han,7,0,63,56
1656279174840,COGS 17,A01,092677,Semenuks; Arturs,8,0,81,73
1656279180866,COGS 100,A01,083619,Allen; Michael Gordon,2,0,70,68
1656279186912,COGS 101A,A01,083621,Davis; Joshua Daniel,4,0,68,64
1656279192935,COGS 101B,A01,091572,Allen; Michael Gordon,4,0,65,61
1656279198962,COGS 101C,A01,083625,Delgado; Tania,10,0,35,25
1656279204990,COGS 107A,A01,083627,Boyle; Mary E. T.,0,0,60,60
1656279211017,COGS 118A,A01,083075,Gupta; Anjum,8,0,76,68
1656279217041,CSE 3,A50,083646,Miranda; Gregory Joseph,18,0,50,32
1656279223069,CSE 8A,A50,083650,Miranda; Gregory Joseph,2,2,56,54
1656279229091,CSE 11,A01,083080,Cao; Yingjun,0,48,40,40
1656279235113,CSE 12,A01,083652,Krause-Levy; Sophia Louisa,5,1,120,115
1656279241140,CSE 15L,A01,083654,Morris; Justin Loren,2,0,50,48
1656279241140,CSE 15L,A02,083655,Morris; Justin Loren,4,0,50,46
1656279247167,CSE 20,A01,083657,Tran; Khoa Dang,30,0,80,50
1656279253193,CSE 21,A01,095574,Bach; Quang Tran,23,0,48,25
1656279259217,CSE 30,A01,083084,Eldon; John,2,6,80,78
1656279259217,CSE 30,B01,095061,Bhaskar; Nishant,0,1,50,50
1656279265241,CSE 100,A01,083659,Cao; Yingjun,1,18,70,69
1656279271264,CSE 134B,A01,083661,Powell; Thomas Allan,5,0,100,95
1656279277289,CSE 140,A01,083663,Gungor; Onat,8,0,85,77
1656279283313,CSE 140L,A01,083088,Eldon; John,9,0,100,91
1656279289339,CSE 175,A01,083665,Kumar; Rakesh,0,0,25,25
1656279295366,CSE 190,A00,092507,Dubnov; Shlomo,3,0,20,17
1656279301399,ECE 45,A01,083139,Congero; Spencer William,1,0,75,74
1656279307422,ECE 65,A50,083695,Saad; Andrew S,9,0,30,21
1656279307422,ECE 65,A51,095125,Staff,24,0,26,2
1656279313445,ECE 109,A01,091882,Touri; Behrouz,1,1,70,69
1656279319470,ECE 180,A00,083140,Abi Samra; Nicholas Camill,2,0,30,28
1656279319470,ECE 180,B00,083141,Abi Samra; Nicholas Camill,0,4,30,30
1656279325493,MATH 10A,A01,083735,Patchell; Gregory David,0,0,30,30
1656279325493,MATH 10A,A02,083736,Patchell; Gregory David,22,0,30,8
1656279325493,MATH 10A,A03,083737,Patchell; Gregory David,16,0,30,14
1656279331516,MATH 10B,A01,083207,Lim; Seonhee,1,0,34,33
1656279331516,MATH 10B,A02,083208,Lim; Seonhee,7,0,35,28
1656279331516,MATH 10B,A03,093472,Staff,1,0,34,33
1656279331516,MATH 10B,B01,083739,Sinha; Shubham,11,0,30,19
1656279337540,MATH 18,A01,083743,Cinel; Cameron Alexander,7,0,30,23
1656279337540,MATH 18,A02,083744,Cinel; Cameron Alexander,9,0,30,21
1656279337540,MATH 18,A03,083745,Cinel; Cameron Alexander,5,0,30,25
1656279337540,MATH 18,B01,083748,Rideout; David Porter,1,0,36,35
1656279337540,MATH 18,B02,083749,Rideout; David Porter,0,0,36,36
1656279337540,MATH 18,B03,083750,Rideout; David Porter,0,0,36,36
1656279337540,MATH 18,B04,083751,Rideout; David Porter,0,1,36,36
1656279337540,MATH 18,B05,093473,Rideout; David Porter,0,0,36,36
1656279337540,MATH 18,B06,093474,Rideout; David Porter,3,0,36,33
1656279343563,MATH 20A,A01,083754,Zheng; Zequn,11,0,40,29
1656279349586,MATH 20B,A01,083756,Briones; Jor-el Thomas Caparas,0,0,36,36
1656279349586,MATH 20B,A02,083757,Briones; Jor-el Thomas Caparas,0,0,36,36
1656279349586,MATH 20B,A03,093475,Staff,0,0,36,36
1656279355626,MATH 20C,A01,083760,Briones; Jor-el Thomas Caparas,0,0,35,35
1656279355626,MATH 20C,A02,083761,Briones; Jor-el Thomas Caparas,9,1,35,26
1656279355626,MATH 20C,A03,093476,Staff,0,0,35,35
1656279355626,MATH 20C,B01,083762,Bach; Quang Tran,1,0,30,29
1656279361651,MATH 20D,A01,083765,Tran; Brian Kha,1,0,30,29
1656279361651,MATH 20D,A02,083766,Tran; Brian Kha,0,1,30,30
1656279361651,MATH 20D,A03,083767,Tran; Brian Kha,2,0,30,28
1656279367678,MATH 20E,A01,083771,Ganguly; Soumya,3,0,32,29
1656279367678,MATH 20E,A02,083772,Ganguly; Soumya,0,0,32,32
1656279367678,MATH 20E,B01,083773,Ciotti; Benjamin,16,0,35,19
1656279367678,MATH 20E,B02,083774,Ciotti; Benjamin,15,0,35,20
1656279373701,MATH 103A,A01,083777,Greenfeld; Be'Eri,1,0,36,35
1656279373701,MATH 103A,A02,083778,Greenfeld; Be'Eri,2,0,36,34
1656279373701,MATH 103A,A03,093561,Staff,5,0,36,31
1656279373701,MATH 103A,B01,083779,Greenfeld; Be'Eri,8,0,36,28
1656279373701,MATH 103A,B02,083780,Greenfeld; Be'Eri,0,0,36,36
1656279373701,MATH 103A,B03,093562,Staff,0,0,36,36
1656279379725,MATH 105,A01,085443,Carter; Anne Toulson,5,0,35,30
1656279379725,MATH 105,A02,093477,Staff,14,0,35,21
1656279385764,MATH 109,A01,083213,Ganzberger; Geoffrey Michael,1,0,34,33
1656279385764,MATH 109,A02,083214,Ganzberger; Geoffrey Michael,0,0,34,34
1656279385764,MATH 109,A03,093478,Staff,1,0,34,33
1656279385764,MATH 109,B01,083215,Ganzberger; Geoffrey Michael,4,0,32,28
1656279385764,MATH 109,B02,083216,Ganzberger; Geoffrey Michael,1,0,32,31
1656279385764,MATH 109,B03,093479,Staff,3,0,32,29
1656279391789,MATH 142A,A01,083219,Chow; Bennett,1,0,32,31
1656279391789,MATH 142A,A02,083220,Chow; Bennett,8,0,32,24
1656279391789,MATH 142A,A03,093480,Staff,5,0,32,27
1656279391789,MATH 142A,B03,093481,Staff,3,0,32,29
1656279391789,MATH 142A,B04,093558,Staff,6,0,32,26
1656279391789,MATH 142A,B05,093559,Staff,0,0,32,32
1656279397820,MATH 193A,A01,083224,Rotar; Vladimir,0,1,34,34
1656279397820,MATH 193A,A02,083225,Rotar; Vladimir,0,0,34,34
1656279397820,MATH 193A,A03,083781,Rotar; Vladimir,0,0,34,34
1656279397820,MATH 193A,A04,083782,Rotar; Vladimir,6,0,34,28
1656279397820,MATH 193A,A05,093482,Rotar; Vladimir,0,0,34,34
1656279403847,MATH 197,001,091859,McAuley; Julian John,9999,0,9999,0
1656279403847,MATH 197,002,095566,Kedlaya; Kiran S.,9997,0,9999,2
1656279403847,MATH 197,003,095567,Xiao; Ming,9999,0,9999,0
1656279403847,MATH 197,004,095571,Perols; Johan Lars,9998,0,9999,1
1656279410900,COGS 9,A01,083615,Shannon; Kyle Michael,4,0,75,71
1656279416924,COGS 11,A01,083617,Boyle; Mary E. T.,14,0,48,34
1656279422952,COGS 13,A01,083071,Bastos; Amalia Pinkusfeld,5,0,71,66
1656279428976,COGS 14A,A01,092681,Semenuks; Arturs,1,12,100,99
1656279435001,COGS 14B,A01,083073,Cheng; Tzu-Han,7,0,63,56
1656279441023,COGS 17,A01,092677,Semenuks; Arturs,8,0,81,73
1656279447051,COGS 100,A01,083619,Allen; Michael Gordon,2,0,70,68
1656279453075,COGS 101A,A01,083621,Davis; Joshua Daniel,4,0,68,64
1656279459098,COGS 101B,A01,091572,Allen; Michael Gordon,4,0,65,61
1656279465132,COGS 101C,A01,083625,Delgado; Tania,10,0,35,25
1656279471156,COGS 107A,A01,083627,Boyle; Mary E. T.,0,0,60,60
1656279477182,COGS 118A,A01,083075,Gupta; Anjum,8,0,76,68
1656279483210,CSE 3,A50,083646,Miranda; Gregory Joseph,18,0,50,32
1656279489238,CSE 8A,A50,083650,Miranda; Gregory Joseph,2,2,56,54
1656279495269,CSE 11,A01,083080,Cao; Yingjun,0,48,40,40
1656279501294,CSE 12,A01,083652,Krause-Levy; Sophia Louisa,5,1,120,115
1656279507320,CSE 15L,A01,083654,Morris; Justin Loren,2,0,50,48
1656279507320,CSE 15L,A02,083655,Morris; Justin Loren,4,0,50,46
1656279513347,CSE 20,A01,083657,Tran; Khoa Dang,30,0,80,50
1656279519379,CSE 21,A01,095574,Bach; Quang Tran,23,0,48,25
1656279525408,CSE 30,A01,083084,Eldon; John,2,6,80,78
1656279525408,CSE 30,B01,095061,Bhaskar; Nishant,0,1,50,50
1656279531438,CSE 100,A01,083659,Cao; Yingjun,1,18,70,69
1656279537465,CSE 134B,A01,083661,Powell; Thomas Allan,5,0,100,95
1656279543499,CSE 140,A01,083663,Gungor; Onat,8,0,85,77
1656279549524,CSE 140L,A01,083088,Eldon; John,9,0,100,91
1656279555553,CSE 175,A01,083665,Kumar; Rakesh,0,0,25,25
1656279561580,CSE 190,A00,092507,Dubnov; Shlomo,3,0,20,17
1656279567604,ECE 45,A01,083139,Congero; Spencer William,1,0,75,74
1656279573627,ECE 65,A50,083695,Saad; Andrew S,9,0,30,21
1656279573627,ECE 65,A51,095125,Staff,24,0,26,2
1656279579650,ECE 109,A01,091882,Touri; Behrouz,1,1,70,69
1656279585673,ECE 180,A00,083140,Abi Samra; Nicholas Camill,2,0,30,28
1656279585673,ECE 180,B00,083141,Abi Samra; Nicholas Camill,0,4,30,30
1656279591696,MATH 10A,A01,083735,Patchell; Gregory David,0,0,30,30
1656279591696,MATH 10A,A02,083736,Patchell; Gregory David,22,0,30,8
1656279591696,MATH 10A,A03,083737,Patchell; Gregory David,16,0,30,14
1656279597720,MATH 10B,A01,083207,Lim; Seonhee,1,0,34,33
1656279597720,MATH 10B,A02,083208,Lim; Seonhee,7,0,35,28
1656279597720,MATH 10B,A03,093472,Staff,1,0,34,33
1656279597720,MATH 10B,B01,083739,Sinha; Shubham,11,0,30,19
1656279603744,MATH 18,A01,083743,Cinel; Cameron Alexander,7,0,30,23
1656279603744,MATH 18,A02,083744,Cinel; Cameron Alexander,9,0,30,21
1656279603744,MATH 18,A03,083745,Cinel; Cameron Alexander,5,0,30,25
1656279603744,MATH 18,B01,083748,Rideout; David Porter,1,0,36,35
1656279603744,MATH 18,B02,083749,Rideout; David Porter,0,0,36,36
1656279603744,MATH 18,B03,083750,Rideout; David Porter,0,0,36,36
1656279603744,MATH 18,B04,083751,Rideout; David Porter,0,1,36,36
1656279603744,MATH 18,B05,093473,Rideout; David Porter,0,0,36,36
1656279603744,MATH 18,B06,093474,Rideout; David Porter,3,0,36,33
1656279609768,MATH 20A,A01,083754,Zheng; Zequn,11,0,40,29
1656279615792,MATH 20B,A01,083756,Briones; Jor-el Thomas Caparas,0,0,36,36
1656279615792,MATH 20B,A02,083757,Briones; Jor-el Thomas Caparas,0,0,36,36
1656279615792,MATH 20B,A03,093475,Staff,0,0,36,36
1656279621814,MATH 20C,A01,083760,Briones; Jor-el Thomas Caparas,0,0,35,35
1656279621814,MATH 20C,A02,083761,Briones; Jor-el Thomas Caparas,9,1,35,26
1656279621814,MATH 20C,A03,093476,Staff,0,0,35,35
1656279621814,MATH 20C,B01,083762,Bach; Quang Tran,1,0,30,29
1656279627838,MATH 20D,A01,083765,Tran; Brian Kha,1,0,30,29
1656279627838,MATH 20D,A02,083766,Tran; Brian Kha,0,1,30,30
1656279627838,MATH 20D,A03,083767,Tran; Brian Kha,2,0,30,28
1656279633864,MATH 20E,A01,083771,Ganguly; Soumya,3,0,32,29
1656279633864,MATH 20E,A02,083772,Ganguly; Soumya,0,0,32,32
1656279633864,MATH 20E,B01,083773,Ciotti; Benjamin,16,0,35,19
1656279633864,MATH 20E,B02,083774,Ciotti; Benjamin,15,0,35,20
1656279639895,MATH 103A,A01,083777,Greenfeld; Be'Eri,1,0,36,35
1656279639895,MATH 103A,A02,083778,Greenfeld; Be'Eri,2,0,36,34
1656279639895,MATH 103A,A03,093561,Staff,5,0,36,31
1656279639895,MATH 103A,B01,083779,Greenfeld; Be'Eri,8,0,36,28
1656279639895,MATH 103A,B02,083780,Greenfeld; Be'Eri,0,0,36,36
1656279639895,MATH 103A,B03,093562,Staff,0,0,36,36
1656279645918,MATH 105,A01,085443,Carter; Anne Toulson,5,0,35,30
1656279645918,MATH 105,A02,093477,Staff,14,0,35,21
1656279651946,MATH 109,A01,083213,Ganzberger; Geoffrey Michael,1,0,34,33
1656279651946,MATH 109,A02,083214,Ganzberger; Geoffrey Michael,0,0,34,34
1656279651946,MATH 109,A03,093478,Staff,1,0,34,33
1656279651946,MATH 109,B01,083215,Ganzberger; Geoffrey Michael,4,0,32,28
1656279651946,MATH 109,B02,083216,Ganzberger; Geoffrey Michael,1,0,32,31
1656279651946,MATH 109,B03,093479,Staff,3,0,32,29
1656279657978,MATH 142A,A01,083219,Chow; Bennett,1,0,32,31
1656279657978,MATH 142A,A02,083220,Chow; Bennett,8,0,32,24
1656279657978,MATH 142A,A03,093480,Staff,5,0,32,27
1656279657978,MATH 142A,B03,093481,Staff,3,0,32,29
1656279657978,MATH 142A,B04,093558,Staff,6,0,32,26
1656279657978,MATH 142A,B05,093559,Staff,0,0,32,32
1656279664001,MATH 193A,A01,083224,Rotar; Vladimir,0,1,34,34
1656279664001,MATH 193A,A02,083225,Rotar; Vladimir,0,0,34,34
1656279664001,MATH 193A,A03,083781,Rotar; Vladimir,0,0,34,34
1656279664001,MATH 193A,A04,083782,Rotar; Vladimir,6,0,34,28
1656279664001,MATH 193A,A05,093482,Rotar; Vladimir,0,0,34,34
1656279670028,MATH 197,001,091859,McAuley; Julian John,9999,0,9999,0
1656279670028,MATH 197,002,095566,Kedlaya; Kiran S.,9997,0,9999,2
1656279670028,MATH 197,003,095567,Xiao; Ming,9999,0,9999,0
1656279670028,MATH 197,004,095571,Perols; Johan Lars,9998,0,9999,1
1656279677078,COGS 9,A01,083615,Shannon; Kyle Michael,4,0,75,71
1656279683104,COGS 11,A01,083617,Boyle; Mary E. T.,14,0,48,34
1656279689128,COGS 13,A01,083071,Bastos; Amalia Pinkusfeld,5,0,71,66
1656279695152,COGS 14A,A01,092681,Semenuks; Arturs,1,12,100,99
1656279701175,COGS 14B,A01,083073,Cheng; Tzu-Han,7,0,63,56
1656279707202,COGS 17,A01,092677,Semenuks; Arturs,8,0,81,73
1656279713226,COGS 100,A01,083619,Allen; Michael Gordon,2,0,70,68
1656279719250,COGS 101A,A01,083621,Davis; Joshua Daniel,4,0,68,64
1656279725277,COGS 101B,A01,091572,Allen; Michael Gordon,4,0,65,61
1656279731309,COGS 101C,A01,083625,Delgado; Tania,10,0,35,25
1656279737335,COGS 107A,A01,083627,Boyle; Mary E. T.,0,0,60,60
1656279743364,COGS 118A,A01,083075,Gupta; Anjum,8,0,76,68
1656279749389,CSE 3,A50,083646,Miranda; Gregory Joseph,18,0,50,32
1656279755424,CSE 8A,A50,083650,Miranda; Gregory Joseph,2,2,56,54
1656279761546,CSE 11,A01,083080,Cao; Yingjun,0,48,40,40
1656279767569,CSE 12,A01,083652,Krause-Levy; Sophia Louisa,5,1,120,115
1656279773594,CSE 15L,A01,083654,Morris; Justin Loren,2,0,50,48
1656279773594,CSE 15L,A02,083655,Morris; Justin Loren,4,0,50,46
1656279779617,CSE 20,A01,083657,Tran; Khoa Dang,30,0,80,50
1656279785641,CSE 21,A01,095574,Bach; Quang Tran,23,0,48,25
1656279791669,CSE 30,A01,083084,Eldon; John,2,6,80,78
1656279791669,CSE 30,B01,095061,Bhaskar; Nishant,0,1,50,50
1656279797693,CSE 100,A01,083659,Cao; Yingjun,1,18,70,69
1656279803720,CSE 134B,A01,083661,Powell; Thomas Allan,5,0,100,95
1656279809747,CSE 140,A01,083663,Gungor; Onat,8,0,85,77
1656279815774,CSE 140L,A01,083088,Eldon; John,10,0,100,90
1656279821797,CSE 175,A01,083665,Kumar; Rakesh,0,0,25,25
1656279827824,CSE 190,A00,092507,Dubnov; Shlomo,3,0,20,17
1656279833849,ECE 45,A01,083139,Congero; Spencer William,1,0,75,74
1656279839875,ECE 65,A50,083695,Saad; Andrew S,9,0,30,21
1656279839875,ECE 65,A51,095125,Staff,24,0,26,2
1656279845903,ECE 109,A01,091882,Touri; Behrouz,1,1,70,69
1656279851929,ECE 180,A00,083140,Abi Samra; Nicholas Camill,2,0,30,28
1656279851929,ECE 180,B00,083141,Abi Samra; Nicholas Camill,0,4,30,30
1656279857950,MATH 10A,A01,083735,Patchell; Gregory David,0,0,30,30
1656279857950,MATH 10A,A02,083736,Patchell; Gregory David,22,0,30,8
1656279857950,MATH 10A,A03,083737,Patchell; Gregory David,16,0,30,14
1656279863974,MATH 10B,A01,083207,Lim; Seonhee,1,0,34,33
1656279863974,MATH 10B,A02,083208,Lim; Seonhee,7,0,35,28
1656279863974,MATH 10B,A03,093472,Staff,1,0,34,33
1656279863974,MATH 10B,B01,083739,Sinha; Shubham,11,0,30,19
1656279869999,MATH 18,A01,083743,Cinel; Cameron Alexander,7,0,30,23
1656279869999,MATH 18,A02,083744,Cinel; Cameron Alexander,9,0,30,21
1656279869999,MATH 18,A03,083745,Cinel; Cameron Alexander,5,0,30,25
1656279869999,MATH 18,B01,083748,Rideout; David Porter,1,0,36,35
1656279869999,MATH 18,B02,083749,Rideout; David Porter,0,0,36,36
1656279869999,MATH 18,B03,083750,Rideout; David Porter,0,0,36,36
1656279869999,MATH 18,B04,083751,Rideout; David Porter,0,1,36,36
1656279869999,MATH 18,B05,093473,Rideout; David Porter,0,0,36,36
1656279869999,MATH 18,B06,093474,Rideout; David Porter,3,0,36,33
1656279876022,MATH 20A,A01,083754,Zheng; Zequn,11,0,40,29
1656279882044,MATH 20B,A01,083756,Briones; Jor-el Thomas Caparas,0,0,36,36
1656279882044,MATH 20B,A02,083757,Briones; Jor-el Thomas Caparas,0,0,36,36
1656279882044,MATH 20B,A03,093475,Staff,0,0,36,36
1656279888072,MATH 20C,A01,083760,Briones; Jor-el Thomas Caparas,0,0,35,35
1656279888072,MATH 20C,A02,083761,Briones; Jor-el Thomas Caparas,9,1,35,26
1656279888072,MATH 20C,A03,093476,Staff,0,0,35,35
1656279888072,MATH 20C,B01,083762,Bach; Quang Tran,1,0,30,29
1656279894099,MATH 20D,A01,083765,Tran; Brian Kha,1,0,30,29
1656279894099,MATH 20D,A02,083766,Tran; Brian Kha,0,1,30,30
1656279894099,MATH 20D,A03,083767,Tran; Brian Kha,2,0,30,28
1656279900128,MATH 20E,A01,083771,Ganguly; Soumya,3,0,32,29
1656279900128,MATH 20E,A02,083772,Ganguly; Soumya,0,0,32,32
1656279900128,MATH 20E,B01,083773,Ciotti; Benjamin,16,0,35,19
1656279900128,MATH 20E,B02,083774,Ciotti; Benjamin,15,0,35,20
1656279906163,MATH 103A,A01,083777,Greenfeld; Be'Eri,1,0,36,35
1656279906163,MATH 103A,A02,083778,Greenfeld; Be'Eri,2,0,36,34
1656279906163,MATH 103A,A03,093561,Staff,5,0,36,31
1656279906163,MATH 103A,B01,083779,Greenfeld; Be'Eri,8,0,36,28
1656279906163,MATH 103A,B02,083780,Greenfeld; Be'Eri,0,0,36,36
1656279906163,MATH 103A,B03,093562,Staff,0,0,36,36
1656279912187,MATH 105,A01,085443,Carter; Anne Toulson,5,0,35,30
1656279912187,MATH 105,A02,093477,Staff,14,0,35,21
1656279918216,MATH 109,A01,083213,Ganzberger; Geoffrey Michael,1,0,34,33
1656279918216,MATH 109,A02,083214,Ganzberger; Geoffrey Michael,0,0,34,34
1656279918216,MATH 109,A03,093478,Staff,1,0,34,33
1656279918216,MATH 109,B01,083215,Ganzberger; Geoffrey Michael,4,0,32,28
1656279918216,MATH 109,B02,083216,Ganzberger; Geoffrey Michael,1,0,32,31
1656279918216,MATH 109,B03,093479,Staff,3,0,32,29
1656279924240,MATH 142A,A01,083219,Chow; Bennett,1,0,32,31
1656279924240,MATH 142A,A02,083220,Chow; Bennett,8,0,32,24
1656279924240,MATH 142A,A03,093480,Staff,5,0,32,27
1656279924240,MATH 142A,B03,093481,Staff,3,0,32,29
1656279924240,MATH 142A,B04,093558,Staff,6,0,32,26
1656279924240,MATH 142A,B05,093559,Staff,0,0,32,32
1656279930264,MATH 193A,A01,083224,Rotar; Vladimir,0,1,34,34
1656279930264,MATH 193A,A02,083225,Rotar; Vladimir,0,0,34,34
1656279930264,MATH 193A,A03,083781,Rotar; Vladimir,0,0,34,34
1656279930264,MATH 193A,A04,083782,Rotar; Vladimir,6,0,34,28
1656279930264,MATH 193A,A05,093482,Rotar; Vladimir,0,0,34,34
1656279936288,MATH 197,001,091859,McAuley; Julian John,9999,0,9999,0
1656279936288,MATH 197,002,095566,Kedlaya; Kiran S.,9997,0,9999,2
1656279936288,MATH 197,003,095567,Xiao; Ming,9999,0,9999,0
1656279936288,MATH 197,004,095571,Perols; Johan Lars,9998,0,9999,1
1656279943353,COGS 9,A01,083615,Shannon; Kyle Michael,4,0,75,71
1656279949375,COGS 11,A01,083617,Boyle; Mary E. T.,14,0,48,34
1656279955398,COGS 13,A01,083071,Bastos; Amalia Pinkusfeld,5,0,71,66
1656279961424,COGS 14A,A01,092681,Semenuks; Arturs,1,12,100,99
1656279967446,COGS 14B,A01,083073,Cheng; Tzu-Han,7,0,63,56
1656279973469,COGS 17,A01,092677,Semenuks; Arturs,8,0,81,73
1656279979498,COGS 100,A01,083619,Allen; Michael Gordon,2,0,70,68
1656279985521,COGS 101A,A01,083621,Davis; Joshua Daniel,4,0,68,64
1656279991546,COGS 101B,A01,091572,Allen; Michael Gordon,4,0,65,61
1656279997567,COGS 101C,A01,083625,Delgado; Tania,10,0,35,25
1656280003593,COGS 107A,A01,083627,Boyle; Mary E. T.,0,0,60,60
1656280009620,COGS 118A,A01,083075,Gupta; Anjum,8,0,76,68
1656280015646,CSE 3,A50,083646,Miranda; Gregory Joseph,18,0,50,32
1656280021675,CSE 8A,A50,083650,Miranda; Gregory Joseph,2,2,56,54
1656280027703,CSE 11,A01,083080,Cao; Yingjun,0,48,40,40
1656280033730,CSE 12,A01,083652,Krause-Levy; Sophia Louisa,5,1,120,115
1656280039754,CSE 15L,A01,083654,Morris; Justin Loren,2,0,50,48
1656280039754,CSE 15L,A02,083655,Morris; Justin Loren,4,0,50,46
1656280045782,CSE 20,A01,083657,Tran; Khoa Dang,30,0,80,50
1656280051805,CSE 21,A01,095574,Bach; Quang Tran,23,0,48,25
1656280057829,CSE 30,A01,083084,Eldon; John,2,6,80,78
1656280057829,CSE 30,B01,095061,Bhaskar; Nishant,0,1,50,50
1656280063853,CSE 100,A01,083659,Cao; Yingjun,1,18,70,69
1656280069877,CSE 134B,A01,083661,Powell; Thomas Allan,5,0,100,95
1656280075908,CSE 140,A01,083663,Gungor; Onat,8,0,85,77
1656280081934,CSE 140L,A01,083088,Eldon; John,10,0,100,90
1656280087962,CSE 175,A01,083665,Kumar; Rakesh,0,0,25,25
1656280093988,CSE 190,A00,092507,Dubnov; Shlomo,3,0,20,17
1656280100012,ECE 45,A01,083139,Congero; Spencer William,1,0,75,74
1656280106035,ECE 65,A50,083695,Saad; Andrew S,9,0,30,21
1656280106035,ECE 65,A51,095125,Staff,24,0,26,2
1656280112059,ECE 109,A01,091882,Touri; Behrouz,1,1,70,69
1656280124633,ECE 180,A00,083140,Abi Samra; Nicholas Camill,2,0,30,28
1656280124633,ECE 180,B00,083141,Abi Samra; Nicholas Camill,0,4,30,30
1656280130660,MATH 10A,A01,083735,Patchell; Gregory David,0,0,30,30
1656280130660,MATH 10A,A02,083736,Patchell; Gregory David,22,0,30,8
1656280130660,MATH 10A,A03,083737,Patchell; Gregory David,16,0,30,14
1656280136688,MATH 10B,A01,083207,Lim; Seonhee,1,0,34,33
1656280136688,MATH 10B,A02,083208,Lim; Seonhee,7,0,35,28
1656280136688,MATH 10B,A03,093472,Staff,1,0,34,33
1656280136688,MATH 10B,B01,083739,Sinha; Shubham,11,0,30,19
1656280142722,MATH 18,A01,083743,Cinel; Cameron Alexander,7,0,30,23
1656280142722,MATH 18,A02,083744,Cinel; Cameron Alexander,9,0,30,21
1656280142722,MATH 18,A03,083745,Cinel; Cameron Alexander,5,0,30,25
1656280142722,MATH 18,B01,083748,Rideout; David Porter,1,0,36,35
1656280142722,MATH 18,B02,083749,Rideout; David Porter,0,0,36,36
1656280142722,MATH 18,B03,083750,Rideout; David Porter,0,0,36,36
1656280142722,MATH 18,B04,083751,Rideout; David Porter,0,1,36,36
1656280142722,MATH 18,B05,093473,Rideout; David Porter,0,0,36,36
1656280142722,MATH 18,B06,093474,Rideout; David Porter,3,0,36,33
1656280148747,MATH 20A,A01,083754,Zheng; Zequn,11,0,40,29
1656280154770,MATH 20B,A01,083756,Briones; Jor-el Thomas Caparas,0,0,36,36
1656280154770,MATH 20B,A02,083757,Briones; Jor-el Thomas Caparas,0,0,36,36
1656280154770,MATH 20B,A03,093475,Staff,0,0,36,36
1656280160799,MATH 20C,A01,083760,Briones; Jor-el Thomas Caparas,0,0,35,35
1656280160799,MATH 20C,A02,083761,Briones; Jor-el Thomas Caparas,9,1,35,26
1656280160799,MATH 20C,A03,093476,Staff,0,0,35,35
1656280160799,MATH 20C,B01,083762,Bach; Quang Tran,1,0,30,29
1656280166825,MATH 20D,A01,083765,Tran; Brian Kha,1,0,30,29
1656280166825,MATH 20D,A02,083766,Tran; Brian Kha,0,1,30,30
1656280166825,MATH 20D,A03,083767,Tran; Brian Kha,2,0,30,28
1656280172850,MATH 20E,A01,083771,Ganguly; Soumya,3,0,32,29
1656280172850,MATH 20E,A02,083772,Ganguly; Soumya,0,0,32,32
1656280172850,MATH 20E,B01,083773,Ciotti; Benjamin,16,0,35,19
1656280172850,MATH 20E,B02,083774,Ciotti; Benjamin,15,0,35,20
1656280178874,MATH 103A,A01,083777,Greenfeld; Be'Eri,1,0,36,35
1656280178874,MATH 103A,A02,083778,Greenfeld; Be'Eri,2,0,36,34
1656280178874,MATH 103A,A03,093561,Staff,5,0,36,31
1656280178874,MATH 103A,B01,083779,Greenfeld; Be'Eri,8,0,36,28
1656280178874,MATH 103A,B02,083780,Greenfeld; Be'Eri,0,0,36,36
1656280178874,MATH 103A,B03,093562,Staff,0,0,36,36
1656280184902,MATH 105,A01,085443,Carter; Anne Toulson,5,0,35,30
1656280184902,MATH 105,A02,093477,Staff,14,0,35,21
1656280190927,MATH 109,A01,083213,Ganzberger; Geoffrey Michael,1,0,34,33
1656280190927,MATH 109,A02,083214,Ganzberger; Geoffrey Michael,0,0,34,34
1656280190927,MATH 109,A03,093478,Staff,2,0,34,32
1656280190927,MATH 109,B01,083215,Ganzberger; Geoffrey Michael,4,0,32,28
1656280190927,MATH 109,B02,083216,Ganzberger; Geoffrey Michael,1,0,32,31
1656280190927,MATH 109,B03,093479,Staff,3,0,32,29
1656280196951,MATH 142A,A01,083219,Chow; Bennett,1,0,32,31
1656280196951,MATH 142A,A02,083220,Chow; Bennett,8,0,32,24
1656280196951,MATH 142A,A03,093480,Staff,5,0,32,27
1656280196951,MATH 142A,B03,093481,Staff,3,0,32,29
1656280196951,MATH 142A,B04,093558,Staff,6,0,32,26
1656280196951,MATH 142A,B05,093559,Staff,0,0,32,32
1656280202981,MATH 193A,A01,083224,Rotar; Vladimir,0,1,34,34
1656280202981,MATH 193A,A02,083225,Rotar; Vladimir,0,0,34,34
1656280202981,MATH 193A,A03,083781,Rotar; Vladimir,0,0,34,34
1656280202981,MATH 193A,A04,083782,Rotar; Vladimir,6,0,34,28
1656280202981,MATH 193A,A05,093482,Rotar; Vladimir,0,0,34,34
1656280209007,MATH 197,001,091859,McAuley; Julian John,9999,0,9999,0
1656280209007,MATH 197,002,095566,Kedlaya; Kiran S.,9997,0,9999,2
1656280209007,MATH 197,003,095567,Xiao; Ming,9999,0,9999,0
1656280209007,MATH 197,004,095571,Perols; Johan Lars,9998,0,9999,1
1656280216069,COGS 9,A01,083615,Shannon; Kyle Michael,4,0,75,71
1656280222093,COGS 11,A01,083617,Boyle; Mary E. T.,14,0,48,34
1656280228117,COGS 13,A01,083071,Bastos; Amalia Pinkusfeld,5,0,71,66
1656280234139,COGS 14A,A01,092681,Semenuks; Arturs,1,12,100,99
1656280240163,COGS 14B,A01,083073,Cheng; Tzu-Han,7,0,63,56
1656280246187,COGS 17,A01,092677,Semenuks; Arturs,8,0,81,73
1656280252210,COGS 100,A01,083619,Allen; Michael Gordon,2,0,70,68
1656280258246,COGS 101A,A01,083621,Davis; Joshua Daniel,4,0,68,64
1656280264269,COGS 101B,A01,091572,Allen; Michael Gordon,4,0,65,61
1656280270294,COGS 101C,A01,083625,Delgado; Tania,10,0,35,25
1656280276332,COGS 107A,A01,083627,Boyle; Mary E. T.,0,0,60,60
1656280282353,COGS 118A,A01,083075,Gupta; Anjum,8,0,76,68
1656280288381,CSE 3,A50,083646,Miranda; Gregory Joseph,18,0,50,32
1656280294404,CSE 8A,A50,083650,Miranda; Gregory Joseph,2,2,56,54
1656280300430,CSE 11,A01,083080,Cao; Yingjun,0,48,40,40
1656280306456,CSE 12,A01,083652,Krause-Levy; Sophia Louisa,5,1,120,115
1656280312478,CSE 15L,A01,083654,Morris; Justin Loren,2,0,50,48
1656280312478,CSE 15L,A02,083655,Morris; Justin Loren,4,0,50,46
1656280318502,CSE 20,A01,083657,Tran; Khoa Dang,30,0,80,50
1656280324524,CSE 21,A01,095574,Bach; Quang Tran,23,0,48,25
1656280330551,CSE 30,A01,083084,Eldon; John,2,6,80,78
1656280330551,CSE 30,B01,095061,Bhaskar; Nishant,0,1,50,50
1656280336572,CSE 100,A01,083659,Cao; Yingjun,1,18,70,69
1656280342599,CSE 134B,A01,083661,Powell; Thomas Allan,6,0,100,94
1656280348625,CSE 140,A01,083663,Gungor; Onat,8,0,85,77
1656280354666,CSE 140L,A01,083088,Eldon; John,10,0,100,90
1656280360688,CSE 175,A01,083665,Kumar; Rakesh,0,0,25,25
1656280366787,CSE 190,A00,092507,Dubnov; Shlomo,3,0,20,17
1656280372810,ECE 45,A01,083139,Congero; Spencer William,1,0,75,74
1656280378838,ECE 65,A50,083695,Saad; Andrew S,9,0,30,21
1656280378838,ECE 65,A51,095125,Staff,24,0,26,2
1656280384861,ECE 109,A01,091882,Touri; Behrouz,1,1,70,69
1656280390889,ECE 180,A00,083140,Abi Samra; Nicholas Camill,2,0,30,28
1656280390889,ECE 180,B00,083141,Abi Samra; Nicholas Camill,0,4,30,30
1656280396912,MATH 10A,A01,083735,Patchell; Gregory David,0,0,30,30
1656280396912,MATH 10A,A02,083736,Patchell; Gregory David,22,0,30,8
1656280396912,MATH 10A,A03,083737,Patchell; Gregory David,16,0,30,14
1656280402936,MATH 10B,A01,083207,Lim; Seonhee,1,0,34,33
1656280402936,MATH 10B,A02,083208,Lim; Seonhee,7,0,35,28
1656280402936,MATH 10B,A03,093472,Staff,1,0,34,33
1656280402936,MATH 10B,B01,083739,Sinha; Shubham,11,0,30,19
1656280408961,MATH 18,A01,083743,Cinel; Cameron Alexander,7,0,30,23
1656280408961,MATH 18,A02,083744,Cinel; Cameron Alexander,9,0,30,21
1656280408961,MATH 18,A03,083745,Cinel; Cameron Alexander,5,0,30,25
1656280408961,MATH 18,B01,083748,Rideout; David Porter,1,0,36,35
1656280408961,MATH 18,B02,083749,Rideout; David Porter,0,0,36,36
1656280408961,MATH 18,B03,083750,Rideout; David Porter,0,0,36,36
1656280408961,MATH 18,B04,083751,Rideout; David Porter,0,1,36,36
1656280408961,MATH 18,B05,093473,Rideout; David Porter,0,0,36,36
1656280408961,MATH 18,B06,093474,Rideout; David Porter,3,0,36,33
1656280414986,MATH 20A,A01,083754,Zheng; Zequn,11,0,40,29
1656280421012,MATH 20B,A01,083756,Briones; Jor-el Thomas Caparas,0,0,36,36
1656280421012,MATH 20B,A02,083757,Briones; Jor-el Thomas Caparas,0,0,36,36
1656280421012,MATH 20B,A03,093475,Staff,0,0,36,36
1656280427038,MATH 20C,A01,083760,Briones; Jor-el Thomas Caparas,0,0,35,35
1656280427038,MATH 20C,A02,083761,Briones; Jor-el Thomas Caparas,9,1,35,26
1656280427038,MATH 20C,A03,093476,Staff,0,0,35,35
1656280427038,MATH 20C,B01,083762,Bach; Quang Tran,1,0,30,29
1656280433069,MATH 20D,A01,083765,Tran; Brian Kha,1,0,30,29
1656280433069,MATH 20D,A02,083766,Tran; Brian Kha,0,1,30,30
1656280433069,MATH 20D,A03,083767,Tran; Brian Kha,2,0,30,28
1656280439099,MATH 20E,A01,083771,Ganguly; Soumya,3,0,32,29
1656280439099,MATH 20E,A02,083772,Ganguly; Soumya,0,0,32,32
1656280439099,MATH 20E,B01,083773,Ciotti; Benjamin,16,0,35,19
1656280439099,MATH 20E,B02,083774,Ciotti; Benjamin,15,0,35,20
1656280445127,MATH 103A,A01,083777,Greenfeld; Be'Eri,1,0,36,35
1656280445127,MATH 103A,A02,083778,Greenfeld; Be'Eri,2,0,36,34
1656280445127,MATH 103A,A03,093561,Staff,5,0,36,31
1656280445127,MATH 103A,B01,083779,Greenfeld; Be'Eri,8,0,36,28
1656280445127,MATH 103A,B02,083780,Greenfeld; Be'Eri,0,0,36,36
1656280445127,MATH 103A,B03,093562,Staff,0,0,36,36
1656280451154,MATH 105,A01,085443,Carter; Anne Toulson,5,0,35,30
1656280451154,MATH 105,A02,093477,Staff,14,0,35,21
1656280457178,MATH 109,A01,083213,Ganzberger; Geoffrey Michael,1,0,34,33
1656280457178,MATH 109,A02,083214,Ganzberger; Geoffrey Michael,0,0,34,34
1656280457178,MATH 109,A03,093478,Staff,2,0,34,32
1656280457178,MATH 109,B01,083215,Ganzberger; Geoffrey Michael,4,0,32,28
1656280457178,MATH 109,B02,083216,Ganzberger; Geoffrey Michael,1,0,32,31
1656280457178,MATH 109,B03,093479,Staff,3,0,32,29
1656280463208,MATH 142A,A01,083219,Chow; Bennett,1,0,32,31
1656280463208,MATH 142A,A02,083220,Chow; Bennett,8,0,32,24
1656280463208,MATH 142A,A03,093480,Staff,5,0,32,27
1656280463208,MATH 142A,B03,093481,Staff,3,0,32,29
1656280463208,MATH 142A,B04,093558,Staff,6,0,32,26
1656280463208,MATH 142A,B05,093559,Staff,0,0,32,32
1656280469232,MATH 193A,A01,083224,Rotar; Vladimir,0,1,34,34
1656280469232,MATH 193A,A02,083225,Rotar; Vladimir,0,0,34,34
1656280469232,MATH 193A,A03,083781,Rotar; Vladimir,0,0,34,34
1656280469232,MATH 193A,A04,083782,Rotar; Vladimir,6,0,34,28
1656280469232,MATH 193A,A05,093482,Rotar; Vladimir,0,0,34,34
1656280475262,MATH 197,001,091859,McAuley; Julian John,9999,0,9999,0
1656280475262,MATH 197,002,095566,Kedlaya; Kiran S.,9997,0,9999,2
1656280475262,MATH 197,003,095567,Xiao; Ming,9999,0,9999,0
1656280475262,MATH 197,004,095571,Perols; Johan Lars,9998,0,9999,1
1656280482326,COGS 9,A01,083615,Shannon; Kyle Michael,4,0,75,71
1656280488354,COGS 11,A01,083617,Boyle; Mary E. T.,14,0,48,34
1656280494380,COGS 13,A01,083071,Bastos; Amalia Pinkusfeld,5,0,71,66
1656280500404,COGS 14A,A01,092681,Semenuks; Arturs,1,12,100,99
1656280506435,COGS 14B,A01,083073,Cheng; Tzu-Han,7,0,63,56
1656280512461,COGS 17,A01,092677,Semenuks; Arturs,8,0,81,73
1656280518487,COGS 100,A01,083619,Allen; Michael Gordon,2,0,70,68
1656280524511,COGS 101A,A01,083621,Davis; Joshua Daniel,4,0,68,64
1656280530535,COGS 101B,A01,091572,Allen; Michael Gordon,4,0,65,61
1656280536560,COGS 101C,A01,083625,Delgado; Tania,10,0,35,25
1656280542584,COGS 107A,A01,083627,Boyle; Mary E. T.,0,0,60,60
1656280548610,COGS 118A,A01,083075,Gupta; Anjum,8,0,76,68
1656280554636,CSE 3,A50,083646,Miranda; Gregory Joseph,18,0,50,32
1656280560661,CSE 8A,A50,083650,Miranda; Gregory Joseph,2,2,56,54
1656280566685,CSE 11,A01,083080,Cao; Yingjun,0,48,40,40
1656280572713,CSE 12,A01,083652,Krause-Levy; Sophia Louisa,5,1,120,115
1656280578738,CSE 15L,A01,083654,Morris; Justin Loren,2,0,50,48
1656280578738,CSE 15L,A02,083655,Morris; Justin Loren,4,0,50,46
1656280584764,CSE 20,A01,083657,Tran; Khoa Dang,30,0,80,50
1656280590788,CSE 21,A01,095574,Bach; Quang Tran,23,0,48,25
1656280596818,CSE 30,A01,083084,Eldon; John,2,6,80,78
1656280596818,CSE 30,B01,095061,Bhaskar; Nishant,0,1,50,50
1656280602842,CSE 100,A01,083659,Cao; Yingjun,1,18,70,69
1656280608869,CSE 134B,A01,083661,Powell; Thomas Allan,6,0,100,94
1656280614893,CSE 140,A01,083663,Gungor; Onat,8,0,85,77
1656280620917,CSE 140L,A01,083088,Eldon; John,10,0,100,90
1656280626953,CSE 175,A01,083665,Kumar; Rakesh,0,0,25,25
1656280632981,CSE 190,A00,092507,Dubnov; Shlomo,3,0,20,17
1656280639007,ECE 45,A01,083139,Congero; Spencer William,1,0,75,74
1656280645031,ECE 65,A50,083695,Saad; Andrew S,9,0,30,21
1656280645031,ECE 65,A51,095125,Staff,24,0,26,2
1656280651060,ECE 109,A01,091882,Touri; Behrouz,1,1,70,69
1656280657087,ECE 180,A00,083140,Abi Samra; Nicholas Camill,2,0,30,28
1656280657087,ECE 180,B00,083141,Abi Samra; Nicholas Camill,0,4,30,30
1656280663113,MATH 10A,A01,083735,Patchell; Gregory David,0,0,30,30
1656280663113,MATH 10A,A02,083736,Patchell; Gregory David,22,0,30,8
1656280663113,MATH 10A,A03,083737,Patchell; Gregory David,16,0,30,14
1656280669138,MATH 10B,A01,083207,Lim; Seonhee,1,0,34,33
1656280669138,MATH 10B,A02,083208,Lim; Seonhee,7,0,35,28
1656280669138,MATH 10B,A03,093472,Staff,1,0,34,33
1656280669138,MATH 10B,B01,083739,Sinha; Shubham,11,0,30,19
1656280675166,MATH 18,A01,083743,Cinel; Cameron Alexander,7,0,30,23
1656280675166,MATH 18,A02,083744,Cinel; Cameron Alexander,9,0,30,21
1656280675166,MATH 18,A03,083745,Cinel; Cameron Alexander,5,0,30,25
1656280675166,MATH 18,B01,083748,Rideout; David Porter,1,0,36,35
1656280675166,MATH 18,B02,083749,Rideout; David Porter,0,0,36,36
1656280675166,MATH 18,B03,083750,Rideout; David Porter,0,0,36,36
1656280675166,MATH 18,B04,083751,Rideout; David Porter,0,1,36,36
1656280675166,MATH 18,B05,093473,Rideout; David Porter,0,0,36,36
1656280675166,MATH 18,B06,093474,Rideout; David Porter,3,0,36,33
1656280681194,MATH 20A,A01,083754,Zheng; Zequn,11,0,40,29
1656280687222,MATH 20B,A01,083756,Briones; Jor-el Thomas Caparas,0,0,36,36
1656280687222,MATH 20B,A02,083757,Briones; Jor-el Thomas Caparas,0,0,36,36
1656280687222,MATH 20B,A03,093475,Staff,0,0,36,36
1656280693248,MATH 20C,A01,083760,Briones; Jor-el Thomas Caparas,0,0,35,35
1656280693248,MATH 20C,A02,083761,Briones; Jor-el Thomas Caparas,9,1,35,26
1656280693248,MATH 20C,A03,093476,Staff,0,0,35,35
1656280693248,MATH 20C,B01,083762,Bach; Quang Tran,1,0,30,29
1656280699281,MATH 20D,A01,083765,Tran; Brian Kha,1,0,30,29
1656280699281,MATH 20D,A02,083766,Tran; Brian Kha,0,1,30,30
1656280699281,MATH 20D,A03,083767,Tran; Brian Kha,2,0,30,28
1656280705322,MATH 20E,A01,083771,Ganguly; Soumya,3,0,32,29
1656280705322,MATH 20E,A02,083772,Ganguly; Soumya,0,0,32,32
1656280705322,MATH 20E,B01,083773,Ciotti; Benjamin,16,0,35,19
1656280705322,MATH 20E,B02,083774,Ciotti; Benjamin,15,0,35,20
1656280711356,MATH 103A,A01,083777,Greenfeld; Be'Eri,1,0,36,35
1656280711356,MATH 103A,A02,083778,Greenfeld; Be'Eri,2,0,36,34
1656280711356,MATH 103A,A03,093561,Staff,5,0,36,31
1656280711356,MATH 103A,B01,083779,Greenfeld; Be'Eri,8,0,36,28
1656280711356,MATH 103A,B02,083780,Greenfeld; Be'Eri,0,0,36,36
1656280711356,MATH 103A,B03,093562,Staff,0,0,36,36
1656280717377,MATH 105,A01,085443,Carter; Anne Toulson,5,0,35,30
1656280717377,MATH 105,A02,093477,Staff,14,0,35,21
1656280723405,MATH 109,A01,083213,Ganzberger; Geoffrey Michael,1,0,34,33
1656280723405,MATH 109,A02,083214,Ganzberger; Geoffrey Michael,0,0,34,34
1656280723405,MATH 109,A03,093478,Staff,2,0,34,32
1656280723405,MATH 109,B01,083215,Ganzberger; Geoffrey Michael,4,0,32,28
1656280723405,MATH 109,B02,083216,Ganzberger; Geoffrey Michael,1,0,32,31
1656280723405,MATH 109,B03,093479,Staff,3,0,32,29
1656280729430,MATH 142A,A01,083219,Chow; Bennett,1,0,32,31
1656280729430,MATH 142A,A02,083220,Chow; Bennett,8,0,32,24
1656280729430,MATH 142A,A03,093480,Staff,5,0,32,27
1656280729430,MATH 142A,B03,093481,Staff,3,0,32,29
1656280729430,MATH 142A,B04,093558,Staff,6,0,32,26
1656280729430,MATH 142A,B05,093559,Staff,0,0,32,32
1656280735451,MATH 193A,A01,083224,Rotar; Vladimir,0,1,34,34
1656280735451,MATH 193A,A02,083225,Rotar; Vladimir,0,0,34,34
1656280735451,MATH 193A,A03,083781,Rotar; Vladimir,0,0,34,34
1656280735451,MATH 193A,A04,083782,Rotar; Vladimir,6,0,34,28
1656280735451,MATH 193A,A05,093482,Rotar; Vladimir,0,0,34,34
1656280741475,MATH 197,001,091859,McAuley; Julian John,9999,0,9999,0
1656280741475,MATH 197,002,095566,Kedlaya; Kiran S.,9997,0,9999,2
1656280741475,MATH 197,003,095567,Xiao; Ming,9999,0,9999,0
1656280741475,MATH 197,004,095571,Perols; Johan Lars,9998,0,9999,1
1656280748532,COGS 9,A01,083615,Shannon; Kyle Michael,4,0,75,71
1656280754555,COGS 11,A01,083617,Boyle; Mary E. T.,14,0,48,34
1656280760586,COGS 13,A01,083071,Bastos; Amalia Pinkusfeld,5,0,71,66
1656280766609,COGS 14A,A01,092681,Semenuks; Arturs,1,12,100,99
1656280772635,COGS 14B,A01,083073,Cheng; Tzu-Han,7,0,63,56
1656280778659,COGS 17,A01,092677,Semenuks; Arturs,8,0,81,73
1656280784683,COGS 100,A01,083619,Allen; Michael Gordon,2,0,70,68
1656280790705,COGS 101A,A01,083621,Davis; Joshua Daniel,4,0,68,64
1656280796727,COGS 101B,A01,091572,Allen; Michael Gordon,4,0,65,61
1656280802750,COGS 101C,A01,083625,Delgado; Tania,10,0,35,25
1656280808779,COGS 107A,A01,083627,Boyle; Mary E. T.,0,0,60,60
1656280814809,COGS 118A,A01,083075,Gupta; Anjum,8,0,76,68
1656280820832,CSE 3,A50,083646,Miranda; Gregory Joseph,18,0,50,32
1656280826858,CSE 8A,A50,083650,Miranda; Gregory Joseph,2,2,56,54
1656280832881,CSE 11,A01,083080,Cao; Yingjun,0,48,40,40
1656280838906,CSE 12,A01,083652,Krause-Levy; Sophia Louisa,5,1,120,115
1656280844940,CSE 15L,A01,083654,Morris; Justin Loren,2,0,50,48
1656280844940,CSE 15L,A02,083655,Morris; Justin Loren,4,0,50,46
1656280850963,CSE 20,A01,083657,Tran; Khoa Dang,30,0,80,50
1656280856985,CSE 21,A01,095574,Bach; Quang Tran,23,0,48,25
1656280863017,CSE 30,A01,083084,Eldon; John,2,6,80,78
1656280863017,CSE 30,B01,095061,Bhaskar; Nishant,0,1,50,50
1656280869041,CSE 100,A01,083659,Cao; Yingjun,1,18,70,69
1656280875066,CSE 134B,A01,083661,Powell; Thomas Allan,6,0,100,94
1656280881091,CSE 140,A01,083663,Gungor; Onat,8,0,85,77
1656280887118,CSE 140L,A01,083088,Eldon; John,10,0,100,90
1656280893141,CSE 175,A01,083665,Kumar; Rakesh,0,0,25,25
1656280899166,CSE 190,A00,092507,Dubnov; Shlomo,3,0,20,17
1656280905196,ECE 45,A01,083139,Congero; Spencer William,1,0,75,74
1656280911224,ECE 65,A50,083695,Saad; Andrew S,9,0,30,21
1656280911224,ECE 65,A51,095125,Staff,24,0,26,2
1656280917250,ECE 109,A01,091882,Touri; Behrouz,1,1,70,69
1656280923275,ECE 180,A00,083140,Abi Samra; Nicholas Camill,2,0,30,28
1656280923275,ECE 180,B00,083141,Abi Samra; Nicholas Camill,0,4,30,30
1656280929303,MATH 10A,A01,083735,Patchell; Gregory David,0,0,30,30
1656280929303,MATH 10A,A02,083736,Patchell; Gregory David,22,0,30,8
1656280929303,MATH 10A,A03,083737,Patchell; Gregory David,16,0,30,14
1656280935333,MATH 10B,A01,083207,Lim; Seonhee,1,0,34,33
1656280935333,MATH 10B,A02,083208,Lim; Seonhee,7,0,35,28
1656280935333,MATH 10B,A03,093472,Staff,1,0,34,33
1656280935333,MATH 10B,B01,083739,Sinha; Shubham,11,0,30,19
1656280941363,MATH 18,A01,083743,Cinel; Cameron Alexander,7,0,30,23
1656280941363,MATH 18,A02,083744,Cinel; Cameron Alexander,9,0,30,21
1656280941363,MATH 18,A03,083745,Cinel; Cameron Alexander,5,0,30,25
1656280941363,MATH 18,B01,083748,Rideout; David Porter,1,0,36,35
1656280941363,MATH 18,B02,083749,Rideout; David Porter,0,0,36,36
1656280941363,MATH 18,B03,083750,Rideout; David Porter,0,0,36,36
1656280941363,MATH 18,B04,083751,Rideout; David Porter,0,1,36,36
1656280941363,MATH 18,B05,093473,Rideout; David Porter,0,0,36,36
1656280941363,MATH 18,B06,093474,Rideout; David Porter,3,0,36,33
1656280947392,MATH 20A,A01,083754,Zheng; Zequn,11,0,40,29
1656280953423,MATH 20B,A01,083756,Briones; Jor-el Thomas Caparas,0,0,36,36
1656280953423,MATH 20B,A02,083757,Briones; Jor-el Thomas Caparas,0,0,36,36
1656280953423,MATH 20B,A03,093475,Staff,0,0,36,36
1656280959452,MATH 20C,A01,083760,Briones; Jor-el Thomas Caparas,0,0,35,35
1656280959452,MATH 20C,A02,083761,Briones; Jor-el Thomas Caparas,9,1,35,26
1656280959452,MATH 20C,A03,093476,Staff,0,0,35,35
1656280959452,MATH 20C,B01,083762,Bach; Quang Tran,1,0,30,29
1656280965549,MATH 20D,A01,083765,Tran; Brian Kha,1,0,30,29
1656280965549,MATH 20D,A02,083766,Tran; Brian Kha,0,1,30,30
1656280965549,MATH 20D,A03,083767,Tran; Brian Kha,2,0,30,28
1656280971578,MATH 20E,A01,083771,Ganguly; Soumya,3,0,32,29
1656280971578,MATH 20E,A02,083772,Ganguly; Soumya,0,0,32,32
1656280971578,MATH 20E,B01,083773,Ciotti; Benjamin,16,0,35,19
1656280971578,MATH 20E,B02,083774,Ciotti; Benjamin,15,0,35,20
1656280977601,MATH 103A,A01,083777,Greenfeld; Be'Eri,1,0,36,35
1656280977601,MATH 103A,A02,083778,Greenfeld; Be'Eri,2,0,36,34
1656280977601,MATH 103A,A03,093561,Staff,5,0,36,31
1656280977601,MATH 103A,B01,083779,Greenfeld; Be'Eri,8,0,36,28
1656280977601,MATH 103A,B02,083780,Greenfeld; Be'Eri,0,0,36,36
1656280977601,MATH 103A,B03,093562,Staff,0,0,36,36
1656280983625,MATH 105,A01,085443,Carter; Anne Toulson,5,0,35,30
1656280983625,MATH 105,A02,093477,Staff,14,0,35,21
1656280989655,MATH 109,A01,083213,Ganzberger; Geoffrey Michael,1,0,34,33
1656280989655,MATH 109,A02,083214,Ganzberger; Geoffrey Michael,0,0,34,34
1656280989655,MATH 109,A03,093478,Staff,2,0,34,32
1656280989655,MATH 109,B01,083215,Ganzberger; Geoffrey Michael,4,0,32,28
1656280989655,MATH 109,B02,083216,Ganzberger; Geoffrey Michael,1,0,32,31
1656280989655,MATH 109,B03,093479,Staff,3,0,32,29
1656280995685,MATH 142A,A01,083219,Chow; Bennett,1,0,32,31
1656280995685,MATH 142A,A02,083220,Chow; Bennett,8,0,32,24
1656280995685,MATH 142A,A03,093480,Staff,5,0,32,27
1656280995685,MATH 142A,B03,093481,Staff,3,0,32,29
1656280995685,MATH 142A,B04,093558,Staff,6,0,32,26
1656280995685,MATH 142A,B05,093559,Staff,0,0,32,32
1656281001713,MATH 193A,A01,083224,Rotar; Vladimir,0,1,34,34
1656281001713,MATH 193A,A02,083225,Rotar; Vladimir,0,0,34,34
1656281001713,MATH 193A,A03,083781,Rotar; Vladimir,0,0,34,34
1656281001713,MATH 193A,A04,083782,Rotar; Vladimir,6,0,34,28
1656281001713,MATH 193A,A05,093482,Rotar; Vladimir,0,0,34,34
1656281007740,MATH 197,001,091859,McAuley; Julian John,9999,0,9999,0
1656281007740,MATH 197,002,095566,Kedlaya; Kiran S.,9997,0,9999,2
1656281007740,MATH 197,003,095567,Xiao; Ming,9999,0,9999,0
1656281007740,MATH 197,004,095571,Perols; Johan Lars,9998,0,9999,1
1656281014801,COGS 9,A01,083615,Shannon; Kyle Michael,4,0,75,71
1656281020829,COGS 11,A01,083617,Boyle; Mary E. T.,14,0,48,34
1656281026858,COGS 13,A01,083071,Bastos; Amalia Pinkusfeld,5,0,71,66
1656281032885,COGS 14A,A01,092681,Semenuks; Arturs,1,12,100,99
1656281038910,COGS 14B,A01,083073,Cheng; Tzu-Han,7,0,63,56
1656281044936,COGS 17,A01,092677,Semenuks; Arturs,8,0,81,73
1656281050958,COGS 100,A01,083619,Allen; Michael Gordon,2,0,70,68
1656281056981,COGS 101A,A01,083621,Davis; Joshua Daniel,4,0,68,64
1656281063006,COGS 101B,A01,091572,Allen; Michael Gordon,4,0,65,61
1656281069030,COGS 101C,A01,083625,Delgado; Tania,10,0,35,25
1656281075053,COGS 107A,A01,083627,Boyle; Mary E. T.,0,0,60,60
1656281081079,COGS 118A,A01,083075,Gupta; Anjum,8,0,76,68
1656281087107,CSE 3,A50,083646,Miranda; Gregory Joseph,18,0,50,32
1656281093138,CSE 8A,A50,083650,Miranda; Gregory Joseph,2,2,56,54
1656281099161,CSE 11,A01,083080,Cao; Yingjun,0,48,40,40
1656281105185,CSE 12,A01,083652,Krause-Levy; Sophia Louisa,5,1,120,115
1656281111208,CSE 15L,A01,083654,Morris; Justin Loren,2,0,50,48
1656281111208,CSE 15L,A02,083655,Morris; Justin Loren,4,0,50,46
1656281117241,CSE 20,A01,083657,Tran; Khoa Dang,30,0,80,50
1656281123265,CSE 21,A01,095574,Bach; Quang Tran,23,0,48,25
1656281129292,CSE 30,A01,083084,Eldon; John,2,6,80,78
1656281129292,CSE 30,B01,095061,Bhaskar; Nishant,0,1,50,50
1656281135318,CSE 100,A01,083659,Cao; Yingjun,1,18,70,69
1656281141341,CSE 134B,A01,083661,Powell; Thomas Allan,6,0,100,94
1656281147365,CSE 140,A01,083663,Gungor; Onat,8,0,85,77
1656281153388,CSE 140L,A01,083088,Eldon; John,10,0,100,90
1656281159415,CSE 175,A01,083665,Kumar; Rakesh,0,0,25,25
1656281165439,CSE 190,A00,092507,Dubnov; Shlomo,3,0,20,17
1656281171465,ECE 45,A01,083139,Congero; Spencer William,1,0,75,74
1656281177489,ECE 65,A50,083695,Saad; Andrew S,9,0,30,21
1656281177489,ECE 65,A51,095125,Staff,24,0,26,2
1656281183513,ECE 109,A01,091882,Touri; Behrouz,1,1,70,69
1656281189539,ECE 180,A00,083140,Abi Samra; Nicholas Camill,2,0,30,28
1656281189539,ECE 180,B00,083141,Abi Samra; Nicholas Camill,0,4,30,30
1656281195560,MATH 10A,A01,083735,Patchell; Gregory David,0,0,30,30
1656281195560,MATH 10A,A02,083736,Patchell; Gregory David,22,0,30,8
1656281195560,MATH 10A,A03,083737,Patchell; Gregory David,16,0,30,14
1656281201585,MATH 10B,A01,083207,Lim; Seonhee,1,0,34,33
1656281201585,MATH 10B,A02,083208,Lim; Seonhee,7,0,35,28
1656281201585,MATH 10B,A03,093472,Staff,1,0,34,33
1656281201585,MATH 10B,B01,083739,Sinha; Shubham,11,0,30,19
1656281207610,MATH 18,A01,083743,Cinel; Cameron Alexander,7,0,30,23
1656281207610,MATH 18,A02,083744,Cinel; Cameron Alexander,9,0,30,21
1656281207610,MATH 18,A03,083745,Cinel; Cameron Alexander,5,0,30,25
1656281207610,MATH 18,B01,083748,Rideout; David Porter,1,0,36,35
1656281207610,MATH 18,B02,083749,Rideout; David Porter,0,0,36,36
1656281207610,MATH 18,B03,083750,Rideout; David Porter,0,0,36,36
1656281207610,MATH 18,B04,083751,Rideout; David Porter,0,1,36,36
1656281207610,MATH 18,B05,093473,Rideout; David Porter,0,0,36,36
1656281207610,MATH 18,B06,093474,Rideout; David Porter,3,0,36,33
1656281213633,MATH 20A,A01,083754,Zheng; Zequn,11,0,40,29
1656281219660,MATH 20B,A01,083756,Briones; Jor-el Thomas Caparas,0,0,36,36
1656281219660,MATH 20B,A02,083757,Briones; Jor-el Thomas Caparas,0,0,36,36
1656281219660,MATH 20B,A03,093475,Staff,0,0,36,36
1656281225692,MATH 20C,A01,083760,Briones; Jor-el Thomas Caparas,0,0,35,35
1656281225692,MATH 20C,A02,083761,Briones; Jor-el Thomas Caparas,9,1,35,26
1656281225692,MATH 20C,A03,093476,Staff,0,0,35,35
1656281225692,MATH 20C,B01,083762,Bach; Quang Tran,1,0,30,29
1656281231716,MATH 20D,A01,083765,Tran; Brian Kha,1,0,30,29
1656281231716,MATH 20D,A02,083766,Tran; Brian Kha,0,1,30,30
1656281231716,MATH 20D,A03,083767,Tran; Brian Kha,2,0,30,28
1656281237740,MATH 20E,A01,083771,Ganguly; Soumya,3,0,32,29
1656281237740,MATH 20E,A02,083772,Ganguly; Soumya,0,0,32,32
1656281237740,MATH 20E,B01,083773,Ciotti; Benjamin,16,0,35,19
1656281237740,MATH 20E,B02,083774,Ciotti; Benjamin,15,0,35,20
1656281243764,MATH 103A,A01,083777,Greenfeld; Be'Eri,1,0,36,35
1656281243764,MATH 103A,A02,083778,Greenfeld; Be'Eri,2,0,36,34
1656281243764,MATH 103A,A03,093561,Staff,5,0,36,31
1656281243764,MATH 103A,B01,083779,Greenfeld; Be'Eri,8,0,36,28
1656281243764,MATH 103A,B02,083780,Greenfeld; Be'Eri,0,0,36,36
1656281243764,MATH 103A,B03,093562,Staff,0,0,36,36
1656281249797,MATH 105,A01,085443,Carter; Anne Toulson,5,0,35,30
1656281249797,MATH 105,A02,093477,Staff,14,0,35,21
1656281255827,MATH 109,A01,083213,Ganzberger; Geoffrey Michael,1,0,34,33
1656281255827,MATH 109,A02,083214,Ganzberger; Geoffrey Michael,0,0,34,34
1656281255827,MATH 109,A03,093478,Staff,2,0,34,32
1656281255827,MATH 109,B01,083215,Ganzberger; Geoffrey Michael,4,0,32,28
1656281255827,MATH 109,B02,083216,Ganzberger; Geoffrey Michael,1,0,32,31
1656281255827,MATH 109,B03,093479,Staff,3,0,32,29
1656281261856,MATH 142A,A01,083219,Chow; Bennett,1,0,32,31
1656281261856,MATH 142A,A02,083220,Chow; Bennett,8,0,32,24
1656281261856,MATH 142A,A03,093480,Staff,5,0,32,27
1656281261856,MATH 142A,B03,093481,Staff,3,0,32,29
1656281261856,MATH 142A,B04,093558,Staff,6,0,32,26
1656281261856,MATH 142A,B05,093559,Staff,0,0,32,32
1656281267889,MATH 193A,A01,083224,Rotar; Vladimir,0,1,34,34
1656281267889,MATH 193A,A02,083225,Rotar; Vladimir,0,0,34,34
1656281267889,MATH 193A,A03,083781,Rotar; Vladimir,0,0,34,34
1656281267889,MATH 193A,A04,083782,Rotar; Vladimir,6,0,34,28
1656281267889,MATH 193A,A05,093482,Rotar; Vladimir,0,0,34,34
1656281273912,MATH 197,001,091859,McAuley; Julian John,9999,0,9999,0
1656281273912,MATH 197,002,095566,Kedlaya; Kiran S.,9997,0,9999,2
1656281273912,MATH 197,003,095567,Xiao; Ming,9999,0,9999,0
1656281273912,MATH 197,004,095571,Perols; Johan Lars,9998,0,9999,1
1656281280967,COGS 9,A01,083615,Shannon; Kyle Michael,4,0,75,71
1656281286995,COGS 11,A01,083617,Boyle; Mary E. T.,14,0,48,34
1656281293019,COGS 13,A01,083071,Bastos; Amalia Pinkusfeld,5,0,71,66
1656281299042,COGS 14A,A01,092681,Semenuks; Arturs,1,12,100,99
1656281305067,COGS 14B,A01,083073,Cheng; Tzu-Han,7,0,63,56
1656281311094,COGS 17,A01,092677,Semenuks; Arturs,8,0,81,73
1656281317121,COGS 100,A01,083619,Allen; Michael Gordon,2,0,70,68
1656281323148,COGS 101A,A01,083621,Davis; Joshua Daniel,4,0,68,64
1656281329178,COGS 101B,A01,091572,Allen; Michael Gordon,4,0,65,61
1656281335208,COGS 101C,A01,083625,Delgado; Tania,10,0,35,25
1656281341232,COGS 107A,A01,083627,Boyle; Mary E. T.,0,0,60,60
1656281347259,COGS 118A,A01,083075,Gupta; Anjum,8,0,76,68
1656281353286,CSE 3,A50,083646,Miranda; Gregory Joseph,18,0,50,32
1656281359310,CSE 8A,A50,083650,Miranda; Gregory Joseph,2,2,56,54
1656281365332,CSE 11,A01,083080,Cao; Yingjun,0,48,40,40
1656281371354,CSE 12,A01,083652,Krause-Levy; Sophia Louisa,5,1,120,115
1656281377384,CSE 15L,A01,083654,Morris; Justin Loren,2,0,50,48
1656281377384,CSE 15L,A02,083655,Morris; Justin Loren,4,0,50,46
1656281383406,CSE 20,A01,083657,Tran; Khoa Dang,30,0,80,50
1656281389433,CSE 21,A01,095574,Bach; Quang Tran,23,0,48,25
1656281395453,CSE 30,A01,083084,Eldon; John,2,6,80,78
1656281395453,CSE 30,B01,095061,Bhaskar; Nishant,0,1,50,50
1656281401479,CSE 100,A01,083659,Cao; Yingjun,1,18,70,69
1656281407500,CSE 134B,A01,083661,Powell; Thomas Allan,6,0,100,94
1656281413525,CSE 140,A01,083663,Gungor; Onat,8,0,85,77
1656281419549,CSE 140L,A01,083088,Eldon; John,10,0,100,90
1656281425571,CSE 175,A01,083665,Kumar; Rakesh,0,0,25,25
1656281431596,CSE 190,A00,092507,Dubnov; Shlomo,3,0,20,17
1656281437621,ECE 45,A01,083139,Congero; Spencer William,1,0,75,74
1656281443651,ECE 65,A50,083695,Saad; Andrew S,9,0,30,21
1656281443651,ECE 65,A51,095125,Staff,24,0,26,2
1656281449676,ECE 109,A01,091882,Touri; Behrouz,1,1,70,69
1656281455699,ECE 180,A00,083140,Abi Samra; Nicholas Camill,2,0,30,28
1656281455699,ECE 180,B00,083141,Abi Samra; Nicholas Camill,0,4,30,30
1656281461724,MATH 10A,A01,083735,Patchell; Gregory David,0,0,30,30
1656281461724,MATH 10A,A02,083736,Patchell; Gregory David,22,0,30,8
1656281461724,MATH 10A,A03,083737,Patchell; Gregory David,16,0,30,14
1656281467750,MATH 10B,A01,083207,Lim; Seonhee,1,0,34,33
1656281467750,MATH 10B,A02,083208,Lim; Seonhee,7,0,35,28
1656281467750,MATH 10B,A03,093472,Staff,1,0,34,33
1656281467750,MATH 10B,B01,083739,Sinha; Shubham,11,0,30,19
1656281473776,MATH 18,A01,083743,Cinel; Cameron Alexander,7,0,30,23
1656281473776,MATH 18,A02,083744,Cinel; Cameron Alexander,9,0,30,21
1656281473776,MATH 18,A03,083745,Cinel; Cameron Alexander,5,0,30,25
1656281473776,MATH 18,B01,083748,Rideout; David Porter,1,0,36,35
1656281473776,MATH 18,B02,083749,Rideout; David Porter,0,0,36,36
1656281473776,MATH 18,B03,083750,Rideout; David Porter,0,0,36,36
1656281473776,MATH 18,B04,083751,Rideout; David Porter,0,1,36,36
1656281473776,MATH 18,B05,093473,Rideout; David Porter,0,0,36,36
1656281473776,MATH 18,B06,093474,Rideout; David Porter,3,0,36,33
1656281479799,MATH 20A,A01,083754,Zheng; Zequn,11,0,40,29
1656281485826,MATH 20B,A01,083756,Briones; Jor-el Thomas Caparas,0,0,36,36
1656281485826,MATH 20B,A02,083757,Briones; Jor-el Thomas Caparas,0,0,36,36
1656281485826,MATH 20B,A03,093475,Staff,0,0,36,36
1656281491850,MATH 20C,A01,083760,Briones; Jor-el Thomas Caparas,0,0,35,35
1656281491850,MATH 20C,A02,083761,Briones; Jor-el Thomas Caparas,9,1,35,26
1656281491850,MATH 20C,A03,093476,Staff,0,0,35,35
1656281491850,MATH 20C,B01,083762,Bach; Quang Tran,1,0,30,29
1656281497877,MATH 20D,A01,083765,Tran; Brian Kha,1,0,30,29
1656281497877,MATH 20D,A02,083766,Tran; Brian Kha,0,1,30,30
1656281497877,MATH 20D,A03,083767,Tran; Brian Kha,2,0,30,28
1656281503903,MATH 20E,A01,083771,Ganguly; Soumya,3,0,32,29
1656281503903,MATH 20E,A02,083772,Ganguly; Soumya,0,0,32,32
1656281503903,MATH 20E,B01,083773,Ciotti; Benjamin,16,0,35,19
1656281503903,MATH 20E,B02,083774,Ciotti; Benjamin,15,0,35,20
1656281509927,MATH 103A,A01,083777,Greenfeld; Be'Eri,1,0,36,35
1656281509927,MATH 103A,A02,083778,Greenfeld; Be'Eri,2,0,36,34
1656281509927,MATH 103A,A03,093561,Staff,5,0,36,31
1656281509927,MATH 103A,B01,083779,Greenfeld; Be'Eri,8,0,36,28
1656281509927,MATH 103A,B02,083780,Greenfeld; Be'Eri,0,0,36,36
1656281509927,MATH 103A,B03,093562,Staff,0,0,36,36
1656281515955,MATH 105,A01,085443,Carter; Anne Toulson,5,0,35,30
1656281515955,MATH 105,A02,093477,Staff,14,0,35,21
1656281521980,MATH 109,A01,083213,Ganzberger; Geoffrey Michael,1,0,34,33
1656281521980,MATH 109,A02,083214,Ganzberger; Geoffrey Michael,0,0,34,34
1656281521980,MATH 109,A03,093478,Staff,2,0,34,32
1656281521980,MATH 109,B01,083215,Ganzberger; Geoffrey Michael,4,0,32,28
1656281521980,MATH 109,B02,083216,Ganzberger; Geoffrey Michael,1,0,32,31
1656281521980,MATH 109,B03,093479,Staff,3,0,32,29
1656281528006,MATH 142A,A01,083219,Chow; Bennett,1,0,32,31
1656281528006,MATH 142A,A02,083220,Chow; Bennett,8,0,32,24
1656281528006,MATH 142A,A03,093480,Staff,5,0,32,27
1656281528006,MATH 142A,B03,093481,Staff,3,0,32,29
1656281528006,MATH 142A,B04,093558,Staff,6,0,32,26
1656281528006,MATH 142A,B05,093559,Staff,0,0,32,32
1656281534038,MATH 193A,A01,083224,Rotar; Vladimir,0,1,34,34
1656281534038,MATH 193A,A02,083225,Rotar; Vladimir,0,0,34,34
1656281534038,MATH 193A,A03,083781,Rotar; Vladimir,0,0,34,34
1656281534038,MATH 193A,A04,083782,Rotar; Vladimir,6,0,34,28
1656281534038,MATH 193A,A05,093482,Rotar; Vladimir,0,0,34,34
1656281540063,MATH 197,001,091859,McAuley; Julian John,9999,0,9999,0
1656281540063,MATH 197,002,095566,Kedlaya; Kiran S.,9997,0,9999,2
1656281540063,MATH 197,003,095567,Xiao; Ming,9999,0,9999,0
1656281540063,MATH 197,004,095571,Perols; Johan Lars,9998,0,9999,1
1656281547133,COGS 9,A01,083615,Shannon; Kyle Michael,4,0,75,71
1656281553160,COGS 11,A01,083617,Boyle; Mary E. T.,14,0,48,34
1656281559275,COGS 13,A01,083071,Bastos; Amalia Pinkusfeld,5,0,71,66
1656281565309,COGS 14A,A01,092681,Semenuks; Arturs,1,13,100,99
1656281571332,COGS 14B,A01,083073,Cheng; Tzu-Han,7,0,63,56
1656281577356,COGS 17,A01,092677,Semenuks; Arturs,8,0,81,73
1656281583381,COGS 100,A01,083619,Allen; Michael Gordon,2,0,70,68
1656281589405,COGS 101A,A01,083621,Davis; Joshua Daniel,4,0,68,64
1656281595429,COGS 101B,A01,091572,Allen; Michael Gordon,4,0,65,61
1656281601453,COGS 101C,A01,083625,Delgado; Tania,10,0,35,25
1656281607480,COGS 107A,A01,083627,Boyle; Mary E. T.,0,0,60,60
1656281613503,COGS 118A,A01,083075,Gupta; Anjum,8,0,76,68
1656281619527,CSE 3,A50,083646,Miranda; Gregory Joseph,18,0,50,32
1656281625552,CSE 8A,A50,083650,Miranda; Gregory Joseph,2,2,56,54
1656281631578,CSE 11,A01,083080,Cao; Yingjun,0,48,40,40
1656281637614,CSE 12,A01,083652,Krause-Levy; Sophia Louisa,5,1,120,115
1656281643637,CSE 15L,A01,083654,Morris; Justin Loren,2,0,50,48
1656281643637,CSE 15L,A02,083655,Morris; Justin Loren,4,0,50,46
1656281649661,CSE 20,A01,083657,Tran; Khoa Dang,30,0,80,50
1656281655684,CSE 21,A01,095574,Bach; Quang Tran,23,0,48,25
1656281661706,CSE 30,A01,083084,Eldon; John,2,6,80,78
1656281661706,CSE 30,B01,095061,Bhaskar; Nishant,0,1,50,50
1656281667732,CSE 100,A01,083659,Cao; Yingjun,1,18,70,69
1656281673759,CSE 134B,A01,083661,Powell; Thomas Allan,6,0,100,94
1656281679783,CSE 140,A01,083663,Gungor; Onat,8,0,85,77
1656281685813,CSE 140L,A01,083088,Eldon; John,10,0,100,90
1656281691838,CSE 175,A01,083665,Kumar; Rakesh,0,0,25,25
1656281697862,CSE 190,A00,092507,Dubnov; Shlomo,3,0,20,17
1656281703886,ECE 45,A01,083139,Congero; Spencer William,1,0,75,74
1656281709907,ECE 65,A50,083695,Saad; Andrew S,9,0,30,21
1656281709907,ECE 65,A51,095125,Staff,24,0,26,2
1656281715934,ECE 109,A01,091882,Touri; Behrouz,1,1,70,69
1656281721956,ECE 180,A00,083140,Abi Samra; Nicholas Camill,2,0,30,28
1656281721956,ECE 180,B00,083141,Abi Samra; Nicholas Camill,0,4,30,30
1656281727990,MATH 10A,A01,083735,Patchell; Gregory David,0,0,30,30
1656281727990,MATH 10A,A02,083736,Patchell; Gregory David,22,0,30,8
1656281727990,MATH 10A,A03,083737,Patchell; Gregory David,16,0,30,14
1656281734023,MATH 10B,A01,083207,Lim; Seonhee,1,0,34,33
1656281734023,MATH 10B,A02,083208,Lim; Seonhee,7,0,35,28
1656281734023,MATH 10B,A03,093472,Staff,1,0,34,33
1656281734023,MATH 10B,B01,083739,Sinha; Shubham,11,0,30,19
1656281740049,MATH 18,A01,083743,Cinel; Cameron Alexander,7,0,30,23
1656281740049,MATH 18,A02,083744,Cinel; Cameron Alexander,9,0,30,21
1656281740049,MATH 18,A03,083745,Cinel; Cameron Alexander,5,0,30,25
1656281740049,MATH 18,B01,083748,Rideout; David Porter,1,0,36,35
1656281740049,MATH 18,B02,083749,Rideout; David Porter,0,0,36,36
1656281740049,MATH 18,B03,083750,Rideout; David Porter,0,0,36,36
1656281740049,MATH 18,B04,083751,Rideout; David Porter,0,1,36,36
1656281740049,MATH 18,B05,093473,Rideout; David Porter,0,0,36,36
1656281740049,MATH 18,B06,093474,Rideout; David Porter,3,0,36,33
1656281746073,MATH 20A,A01,083754,Zheng; Zequn,11,0,40,29
1656281752099,MATH 20B,A01,083756,Briones; Jor-el Thomas Caparas,0,0,36,36
1656281752099,MATH 20B,A02,083757,Briones; Jor-el Thomas Caparas,0,0,36,36
1656281752099,MATH 20B,A03,093475,Staff,0,0,36,36
1656281758128,MATH 20C,A01,083760,Briones; Jor-el Thomas Caparas,0,0,35,35
1656281758128,MATH 20C,A02,083761,Briones; Jor-el Thomas Caparas,9,1,35,26
1656281758128,MATH 20C,A03,093476,Staff,0,0,35,35
1656281758128,MATH 20C,B01,083762,Bach; Quang Tran,1,0,30,29
1656281764152,MATH 20D,A01,083765,Tran; Brian Kha,1,0,30,29
1656281764152,MATH 20D,A02,083766,Tran; Brian Kha,0,1,30,30
1656281764152,MATH 20D,A03,083767,Tran; Brian Kha,2,0,30,28
1656281770175,MATH 20E,A01,083771,Ganguly; Soumya,3,0,32,29
1656281770175,MATH 20E,A02,083772,Ganguly; Soumya,0,0,32,32
1656281770175,MATH 20E,B01,083773,Ciotti; Benjamin,16,0,35,19
1656281770175,MATH 20E,B02,083774,Ciotti; Benjamin,15,0,35,20
1656281776199,MATH 103A,A01,083777,Greenfeld; Be'Eri,1,0,36,35
1656281776199,MATH 103A,A02,083778,Greenfeld; Be'Eri,2,0,36,34
1656281776199,MATH 103A,A03,093561,Staff,5,0,36,31
1656281776199,MATH 103A,B01,083779,Greenfeld; Be'Eri,8,0,36,28
1656281776199,MATH 103A,B02,083780,Greenfeld; Be'Eri,0,0,36,36
1656281776199,MATH 103A,B03,093562,Staff,0,0,36,36
1656281782224,MATH 105,A01,085443,Carter; Anne Toulson,5,0,35,30
1656281782224,MATH 105,A02,093477,Staff,14,0,35,21
1656281788251,MATH 109,A01,083213,Ganzberger; Geoffrey Michael,1,0,34,33
1656281788251,MATH 109,A02,083214,Ganzberger; Geoffrey Michael,0,0,34,34
1656281788251,MATH 109,A03,093478,Staff,2,0,34,32
1656281788251,MATH 109,B01,083215,Ganzberger; Geoffrey Michael,4,0,32,28
1656281788251,MATH 109,B02,083216,Ganzberger; Geoffrey Michael,1,0,32,31
1656281788251,MATH 109,B03,093479,Staff,3,0,32,29
1656281794273,MATH 142A,A01,083219,Chow; Bennett,1,0,32,31
1656281794273,MATH 142A,A02,083220,Chow; Bennett,8,0,32,24
1656281794273,MATH 142A,A03,093480,Staff,5,0,32,27
1656281794273,MATH 142A,B03,093481,Staff,3,0,32,29
1656281794273,MATH 142A,B04,093558,Staff,6,0,32,26
1656281794273,MATH 142A,B05,093559,Staff,0,0,32,32
1656281800302,MATH 193A,A01,083224,Rotar; Vladimir,0,1,34,34
1656281800302,MATH 193A,A02,083225,Rotar; Vladimir,0,0,34,34
1656281800302,MATH 193A,A03,083781,Rotar; Vladimir,0,0,34,34
1656281800302,MATH 193A,A04,083782,Rotar; Vladimir,6,0,34,28
1656281800302,MATH 193A,A05,093482,Rotar; Vladimir,0,0,34,34
1656281806325,MATH 197,001,091859,McAuley; Julian John,9999,0,9999,0
1656281806325,MATH 197,002,095566,Kedlaya; Kiran S.,9997,0,9999,2
1656281806325,MATH 197,003,095567,Xiao; Ming,9999,0,9999,0
1656281806325,MATH 197,004,095571,Perols; Johan Lars,9998,0,9999,1
1656281813391,COGS 9,A01,083615,Shannon; Kyle Michael,4,0,75,71
1656281819418,COGS 11,A01,083617,Boyle; Mary E. T.,14,0,48,34
1656281825442,COGS 13,A01,083071,Bastos; Amalia Pinkusfeld,5,0,71,66
1656281831466,COGS 14A,A01,092681,Semenuks; Arturs,1,13,100,99
1656281837494,COGS 14B,A01,083073,Cheng; Tzu-Han,7,0,63,56
1656281843530,COGS 17,A01,092677,Semenuks; Arturs,7,0,81,74
1656281849552,COGS 100,A01,083619,Allen; Michael Gordon,2,0,70,68
1656281855576,COGS 101A,A01,083621,Davis; Joshua Daniel,4,0,68,64
1656281861600,COGS 101B,A01,091572,Allen; Michael Gordon,4,0,65,61
1656281867622,COGS 101C,A01,083625,Delgado; Tania,10,0,35,25
1656281873647,COGS 107A,A01,083627,Boyle; Mary E. T.,0,0,60,60
1656281879679,COGS 118A,A01,083075,Gupta; Anjum,8,0,76,68
1656281885708,CSE 3,A50,083646,Miranda; Gregory Joseph,18,0,50,32
1656281891740,CSE 8A,A50,083650,Miranda; Gregory Joseph,2,2,56,54
1656281897762,CSE 11,A01,083080,Cao; Yingjun,0,48,40,40
1656281903790,CSE 12,A01,083652,Krause-Levy; Sophia Louisa,5,1,120,115
1656281909820,CSE 15L,A01,083654,Morris; Justin Loren,2,0,50,48
1656281909820,CSE 15L,A02,083655,Morris; Justin Loren,4,0,50,46
1656281915844,CSE 20,A01,083657,Tran; Khoa Dang,30,0,80,50
1656281921871,CSE 21,A01,095574,Bach; Quang Tran,23,0,48,25
1656281927895,CSE 30,A01,083084,Eldon; John,2,6,80,78
1656281927895,CSE 30,B01,095061,Bhaskar; Nishant,0,1,50,50
1656281933922,CSE 100,A01,083659,Cao; Yingjun,1,18,70,69
1656281939946,CSE 134B,A01,083661,Powell; Thomas Allan,6,0,100,94
1656281945968,CSE 140,A01,083663,Gungor; Onat,8,0,85,77
1656281951991,CSE 140L,A01,083088,Eldon; John,10,0,100,90
1656281958013,CSE 175,A01,083665,Kumar; Rakesh,0,0,25,25
1656281964036,CSE 190,A00,092507,Dubnov; Shlomo,3,0,20,17
1656281970059,ECE 45,A01,083139,Congero; Spencer William,1,0,75,74
1656281976084,ECE 65,A50,083695,Saad; Andrew S,9,0,30,21
1656281976084,ECE 65,A51,095125,Staff,24,0,26,2
1656281982108,ECE 109,A01,091882,Touri; Behrouz,1,1,70,69
1656281988131,ECE 180,A00,083140,Abi Samra; Nicholas Camill,2,0,30,28
1656281988131,ECE 180,B00,083141,Abi Samra; Nicholas Camill,0,4,30,30
1656281994155,MATH 10A,A01,083735,Patchell; Gregory David,0,0,30,30
1656281994155,MATH 10A,A02,083736,Patchell; Gregory David,22,0,30,8
1656281994155,MATH 10A,A03,083737,Patchell; Gregory David,16,0,30,14
1656282000185,MATH 10B,A01,083207,Lim; Seonhee,1,0,34,33
1656282000185,MATH 10B,A02,083208,Lim; Seonhee,7,0,35,28
1656282000185,MATH 10B,A03,093472,Staff,1,0,34,33
1656282000185,MATH 10B,B01,083739,Sinha; Shubham,11,0,30,19
1656282006217,MATH 18,A01,083743,Cinel; Cameron Alexander,7,0,30,23
1656282006217,MATH 18,A02,083744,Cinel; Cameron Alexander,9,0,30,21
1656282006217,MATH 18,A03,083745,Cinel; Cameron Alexander,5,0,30,25
1656282006217,MATH 18,B01,083748,Rideout; David Porter,1,0,36,35
1656282006217,MATH 18,B02,083749,Rideout; David Porter,0,0,36,36
1656282006217,MATH 18,B03,083750,Rideout; David Porter,0,0,36,36
1656282006217,MATH 18,B04,083751,Rideout; David Porter,0,1,36,36
1656282006217,MATH 18,B05,093473,Rideout; David Porter,0,0,36,36
1656282006217,MATH 18,B06,093474,Rideout; David Porter,3,0,36,33
1656282012252,MATH 20A,A01,083754,Zheng; Zequn,11,0,40,29
1656282018285,MATH 20B,A01,083756,Briones; Jor-el Thomas Caparas,0,0,36,36
1656282018285,MATH 20B,A02,083757,Briones; Jor-el Thomas Caparas,0,0,36,36
1656282018285,MATH 20B,A03,093475,Staff,0,0,36,36
1656282024315,MATH 20C,A01,083760,Briones; Jor-el Thomas Caparas,0,0,35,35
1656282024315,MATH 20C,A02,083761,Briones; Jor-el Thomas Caparas,9,1,35,26
1656282024315,MATH 20C,A03,093476,Staff,0,0,35,35
1656282024315,MATH 20C,B01,083762,Bach; Quang Tran,1,0,30,29
1656282030339,MATH 20D,A01,083765,Tran; Brian Kha,1,0,30,29
1656282030339,MATH 20D,A02,083766,Tran; Brian Kha,0,1,30,30
1656282030339,MATH 20D,A03,083767,Tran; Brian Kha,2,0,30,28
1656282036362,MATH 20E,A01,083771,Ganguly; Soumya,3,0,32,29
1656282036362,MATH 20E,A02,083772,Ganguly; Soumya,0,0,32,32
1656282036362,MATH 20E,B01,083773,Ciotti; Benjamin,16,0,35,19
1656282036362,MATH 20E,B02,083774,Ciotti; Benjamin,15,0,35,20
1656282042386,MATH 103A,A01,083777,Greenfeld; Be'Eri,1,0,36,35
1656282042386,MATH 103A,A02,083778,Greenfeld; Be'Eri,2,0,36,34
1656282042386,MATH 103A,A03,093561,Staff,5,0,36,31
1656282042386,MATH 103A,B01,083779,Greenfeld; Be'Eri,8,0,36,28
1656282042386,MATH 103A,B02,083780,Greenfeld; Be'Eri,0,0,36,36
1656282042386,MATH 103A,B03,093562,Staff,0,0,36,36
1656282048410,MATH 105,A01,085443,Carter; Anne Toulson,5,0,35,30
1656282048410,MATH 105,A02,093477,Staff,14,0,35,21
1656282054435,MATH 109,A01,083213,Ganzberger; Geoffrey Michael,1,0,34,33
1656282054435,MATH 109,A02,083214,Ganzberger; Geoffrey Michael,0,0,34,34
1656282054435,MATH 109,A03,093478,Staff,2,0,34,32
1656282054435,MATH 109,B01,083215,Ganzberger; Geoffrey Michael,4,0,32,28
1656282054435,MATH 109,B02,083216,Ganzberger; Geoffrey Michael,1,0,32,31
1656282054435,MATH 109,B03,093479,Staff,3,0,32,29
1656282060459,MATH 142A,A01,083219,Chow; Bennett,1,0,32,31
1656282060459,MATH 142A,A02,083220,Chow; Bennett,8,0,32,24
1656282060459,MATH 142A,A03,093480,Staff,5,0,32,27
1656282060459,MATH 142A,B03,093481,Staff,3,0,32,29
1656282060459,MATH 142A,B04,093558,Staff,6,0,32,26
1656282060459,MATH 142A,B05,093559,Staff,0,0,32,32
1656282066487,MATH 193A,A01,083224,Rotar; Vladimir,0,1,34,34
1656282066487,MATH 193A,A02,083225,Rotar; Vladimir,0,0,34,34
1656282066487,MATH 193A,A03,083781,Rotar; Vladimir,0,0,34,34
1656282066487,MATH 193A,A04,083782,Rotar; Vladimir,6,0,34,28
1656282066487,MATH 193A,A05,093482,Rotar; Vladimir,0,0,34,34
1656282072520,MATH 197,001,091859,McAuley; Julian John,9999,0,9999,0
1656282072520,MATH 197,002,095566,Kedlaya; Kiran S.,9997,0,9999,2
1656282072520,MATH 197,003,095567,Xiao; Ming,9999,0,9999,0
1656282072520,MATH 197,004,095571,Perols; Johan Lars,9998,0,9999,1
1656282079591,COGS 9,A01,083615,Shannon; Kyle Michael,4,0,75,71
1656282085617,COGS 11,A01,083617,Boyle; Mary E. T.,14,0,48,34
1656282091643,COGS 13,A01,083071,Bastos; Amalia Pinkusfeld,5,0,71,66
1656282097668,COGS 14A,A01,092681,Semenuks; Arturs,1,13,100,99
1656282103696,COGS 14B,A01,083073,Cheng; Tzu-Han,7,0,63,56
1656282109723,COGS 17,A01,092677,Semenuks; Arturs,7,0,81,74
1656282115749,COGS 100,A01,083619,Allen; Michael Gordon,2,0,70,68
1656282121773,COGS 101A,A01,083621,Davis; Joshua Daniel,4,0,68,64
1656282127797,COGS 101B,A01,091572,Allen; Michael Gordon,4,0,65,61
1656282133821,COGS 101C,A01,083625,Delgado; Tania,10,0,35,25
1656282139845,COGS 107A,A01,083627,Boyle; Mary E. T.,0,0,60,60
1656282145869,COGS 118A,A01,083075,Gupta; Anjum,8,0,76,68
1656282151909,CSE 3,A50,083646,Miranda; Gregory Joseph,18,0,50,32
1656282158012,CSE 8A,A50,083650,Miranda; Gregory Joseph,2,2,56,54
1656282164035,CSE 11,A01,083080,Cao; Yingjun,0,48,40,40
1656282170067,CSE 12,A01,083652,Krause-Levy; Sophia Louisa,5,1,120,115
1656282176091,CSE 15L,A01,083654,Morris; Justin Loren,2,0,50,48
1656282176091,CSE 15L,A02,083655,Morris; Justin Loren,4,0,50,46
1656282182115,CSE 20,A01,083657,Tran; Khoa Dang,30,0,80,50
1656282188142,CSE 21,A01,095574,Bach; Quang Tran,23,0,48,25
1656282194166,CSE 30,A01,083084,Eldon; John,2,6,80,78
1656282194166,CSE 30,B01,095061,Bhaskar; Nishant,0,1,50,50
1656282200193,CSE 100,A01,083659,Cao; Yingjun,1,18,70,69
1656282206221,CSE 134B,A01,083661,Powell; Thomas Allan,6,0,100,94
1656282212257,CSE 140,A01,083663,Gungor; Onat,8,0,85,77
1656282218281,CSE 140L,A01,083088,Eldon; John,10,0,100,90
1656282224307,CSE 175,A01,083665,Kumar; Rakesh,0,0,25,25
1656282230340,CSE 190,A00,092507,Dubnov; Shlomo,3,0,20,17
1656282236368,ECE 45,A01,083139,Congero; Spencer William,1,0,75,74
1656282242390,ECE 65,A50,083695,Saad; Andrew S,9,0,30,21
1656282242390,ECE 65,A51,095125,Staff,24,0,26,2
1656282248416,ECE 109,A01,091882,Touri; Behrouz,1,1,70,69
1656282254445,ECE 180,A00,083140,Abi Samra; Nicholas Camill,2,0,30,28
1656282254445,ECE 180,B00,083141,Abi Samra; Nicholas Camill,0,4,30,30
1656282260472,MATH 10A,A01,083735,Patchell; Gregory David,0,0,30,30
1656282260472,MATH 10A,A02,083736,Patchell; Gregory David,22,0,30,8
1656282260472,MATH 10A,A03,083737,Patchell; Gregory David,16,0,30,14
1656282266497,MATH 10B,A01,083207,Lim; Seonhee,1,0,34,33
1656282266497,MATH 10B,A02,083208,Lim; Seonhee,7,0,35,28
1656282266497,MATH 10B,A03,093472,Staff,1,0,34,33
1656282266497,MATH 10B,B01,083739,Sinha; Shubham,11,0,30,19
1656282272522,MATH 18,A01,083743,Cinel; Cameron Alexander,7,0,30,23
1656282272522,MATH 18,A02,083744,Cinel; Cameron Alexander,9,0,30,21
1656282272522,MATH 18,A03,083745,Cinel; Cameron Alexander,5,0,30,25
1656282272522,MATH 18,B01,083748,Rideout; David Porter,1,0,36,35
1656282272522,MATH 18,B02,083749,Rideout; David Porter,0,0,36,36
1656282272522,MATH 18,B03,083750,Rideout; David Porter,0,0,36,36
1656282272522,MATH 18,B04,083751,Rideout; David Porter,0,1,36,36
1656282272522,MATH 18,B05,093473,Rideout; David Porter,0,0,36,36
1656282272522,MATH 18,B06,093474,Rideout; David Porter,3,0,36,33
1656282278554,MATH 20A,A01,083754,Zheng; Zequn,11,0,40,29
1656282284591,MATH 20B,A01,083756,Briones; Jor-el Thomas Caparas,0,0,36,36
1656282284591,MATH 20B,A02,083757,Briones; Jor-el Thomas Caparas,0,0,36,36
1656282284591,MATH 20B,A03,093475,Staff,0,0,36,36
1656282290613,MATH 20C,A01,083760,Briones; Jor-el Thomas Caparas,0,0,35,35
1656282290613,MATH 20C,A02,083761,Briones; Jor-el Thomas Caparas,9,1,35,26
1656282290613,MATH 20C,A03,093476,Staff,0,0,35,35
1656282290613,MATH 20C,B01,083762,Bach; Quang Tran,1,0,30,29
1656282296641,MATH 20D,A01,083765,Tran; Brian Kha,1,0,30,29
1656282296641,MATH 20D,A02,083766,Tran; Brian Kha,0,1,30,30
1656282296641,MATH 20D,A03,083767,Tran; Brian Kha,2,0,30,28
1656282302664,MATH 20E,A01,083771,Ganguly; Soumya,3,0,32,29
1656282302664,MATH 20E,A02,083772,Ganguly; Soumya,0,0,32,32
1656282302664,MATH 20E,B01,083773,Ciotti; Benjamin,16,0,35,19
1656282302664,MATH 20E,B02,083774,Ciotti; Benjamin,15,0,35,20
1656282308701,MATH 103A,A01,083777,Greenfeld; Be'Eri,1,0,36,35
1656282308701,MATH 103A,A02,083778,Greenfeld; Be'Eri,2,0,36,34
1656282308701,MATH 103A,A03,093561,Staff,5,0,36,31
1656282308701,MATH 103A,B01,083779,Greenfeld; Be'Eri,8,0,36,28
1656282308701,MATH 103A,B02,083780,Greenfeld; Be'Eri,0,0,36,36
1656282308701,MATH 103A,B03,093562,Staff,0,0,36,36
1656282314735,MATH 105,A01,085443,Carter; Anne Toulson,5,0,35,30
1656282314735,MATH 105,A02,093477,Staff,14,0,35,21
1656282320759,MATH 109,A01,083213,Ganzberger; Geoffrey Michael,1,0,34,33
1656282320759,MATH 109,A02,083214,Ganzberger; Geoffrey Michael,0,0,34,34
1656282320759,MATH 109,A03,093478,Staff,2,0,34,32
1656282320759,MATH 109,B01,083215,Ganzberger; Geoffrey Michael,4,0,32,28
1656282320759,MATH 109,B02,083216,Ganzberger; Geoffrey Michael,1,0,32,31
1656282320759,MATH 109,B03,093479,Staff,3,0,32,29
1656282326788,MATH 142A,A01,083219,Chow; Bennett,1,0,32,31
1656282326788,MATH 142A,A02,083220,Chow; Bennett,8,0,32,24
1656282326788,MATH 142A,A03,093480,Staff,5,0,32,27
1656282326788,MATH 142A,B03,093481,Staff,3,0,32,29
1656282326788,MATH 142A,B04,093558,Staff,6,0,32,26
1656282326788,MATH 142A,B05,093559,Staff,0,0,32,32
1656282332817,MATH 193A,A01,083224,Rotar; Vladimir,0,1,34,34
1656282332817,MATH 193A,A02,083225,Rotar; Vladimir,0,0,34,34
1656282332817,MATH 193A,A03,083781,Rotar; Vladimir,0,0,34,34
1656282332817,MATH 193A,A04,083782,Rotar; Vladimir,6,0,34,28
1656282332817,MATH 193A,A05,093482,Rotar; Vladimir,0,0,34,34
1656282338840,MATH 197,001,091859,McAuley; Julian John,9999,0,9999,0
1656282338840,MATH 197,002,095566,Kedlaya; Kiran S.,9997,0,9999,2
1656282338840,MATH 197,003,095567,Xiao; Ming,9999,0,9999,0
1656282338840,MATH 197,004,095571,Perols; Johan Lars,9998,0,9999,1
1656282345894,COGS 9,A01,083615,Shannon; Kyle Michael,4,0,75,71
1656282351917,COGS 11,A01,083617,Boyle; Mary E. T.,14,0,48,34
1656282357944,COGS 13,A01,083071,Bastos; Amalia Pinkusfeld,5,0,71,66
1656282363970,COGS 14A,A01,092681,Semenuks; Arturs,1,13,100,99
1656282369994,COGS 14B,A01,083073,Cheng; Tzu-Han,7,0,63,56
1656282376022,COGS 17,A01,092677,Semenuks; Arturs,7,0,81,74
1656282382048,COGS 100,A01,083619,Allen; Michael Gordon,2,0,70,68
1656282388071,COGS 101A,A01,083621,Davis; Joshua Daniel,4,0,68,64
1656282394097,COGS 101B,A01,091572,Allen; Michael Gordon,4,0,65,61
1656282400121,COGS 101C,A01,083625,Delgado; Tania,10,0,35,25
1656282406145,COGS 107A,A01,083627,Boyle; Mary E. T.,0,0,60,60
1656282412167,COGS 118A,A01,083075,Gupta; Anjum,8,0,76,68
1656282418194,CSE 3,A50,083646,Miranda; Gregory Joseph,18,0,50,32
1656282424216,CSE 8A,A50,083650,Miranda; Gregory Joseph,2,2,56,54
1656282430251,CSE 11,A01,083080,Cao; Yingjun,0,48,40,40
1656282436277,CSE 12,A01,083652,Krause-Levy; Sophia Louisa,5,1,120,115
1656282442299,CSE 15L,A01,083654,Morris; Justin Loren,2,0,50,48
1656282442299,CSE 15L,A02,083655,Morris; Justin Loren,4,0,50,46
1656282448324,CSE 20,A01,083657,Tran; Khoa Dang,30,0,80,50
1656282454349,CSE 21,A01,095574,Bach; Quang Tran,23,0,48,25
1656282460380,CSE 30,A01,083084,Eldon; John,2,6,80,78
1656282460380,CSE 30,B01,095061,Bhaskar; Nishant,0,1,50,50
1656282466411,CSE 100,A01,083659,Cao; Yingjun,1,18,70,69
1656282472437,CSE 134B,A01,083661,Powell; Thomas Allan,6,0,100,94
1656282478459,CSE 140,A01,083663,Gungor; Onat,8,0,85,77
1656282484487,CSE 140L,A01,083088,Eldon; John,10,0,100,90
1656282490513,CSE 175,A01,083665,Kumar; Rakesh,0,0,25,25
1656282496534,CSE 190,A00,092507,Dubnov; Shlomo,3,0,20,17
1656282502561,ECE 45,A01,083139,Congero; Spencer William,1,0,75,74
1656282508591,ECE 65,A50,083695,Saad; Andrew S,9,0,30,21
1656282508591,ECE 65,A51,095125,Staff,24,0,26,2
1656282514618,ECE 109,A01,091882,Touri; Behrouz,1,1,70,69
1656282520642,ECE 180,A00,083140,Abi Samra; Nicholas Camill,2,0,30,28
1656282520642,ECE 180,B00,083141,Abi Samra; Nicholas Camill,0,4,30,30
1656282526670,MATH 10A,A01,083735,Patchell; Gregory David,0,0,30,30
1656282526670,MATH 10A,A02,083736,Patchell; Gregory David,22,0,30,8
1656282526670,MATH 10A,A03,083737,Patchell; Gregory David,16,0,30,14
1656282532695,MATH 10B,A01,083207,Lim; Seonhee,1,0,34,33
1656282532695,MATH 10B,A02,083208,Lim; Seonhee,7,0,35,28
1656282532695,MATH 10B,A03,093472,Staff,1,0,34,33
1656282532695,MATH 10B,B01,083739,Sinha; Shubham,11,0,30,19
1656282538724,MATH 18,A01,083743,Cinel; Cameron Alexander,7,0,30,23
1656282538724,MATH 18,A02,083744,Cinel; Cameron Alexander,9,0,30,21
1656282538724,MATH 18,A03,083745,Cinel; Cameron Alexander,5,0,30,25
1656282538724,MATH 18,B01,083748,Rideout; David Porter,1,0,36,35
1656282538724,MATH 18,B02,083749,Rideout; David Porter,0,0,36,36
1656282538724,MATH 18,B03,083750,Rideout; David Porter,0,0,36,36
1656282538724,MATH 18,B04,083751,Rideout; David Porter,0,1,36,36
1656282538724,MATH 18,B05,093473,Rideout; David Porter,0,0,36,36
1656282538724,MATH 18,B06,093474,Rideout; David Porter,3,0,36,33
1656282544748,MATH 20A,A01,083754,Zheng; Zequn,11,0,40,29
1656282550775,MATH 20B,A01,083756,Briones; Jor-el Thomas Caparas,0,0,36,36
1656282550775,MATH 20B,A02,083757,Briones; Jor-el Thomas Caparas,0,0,36,36
1656282550775,MATH 20B,A03,093475,Staff,0,0,36,36
1656282556799,MATH 20C,A01,083760,Briones; Jor-el Thomas Caparas,0,0,35,35
1656282556799,MATH 20C,A02,083761,Briones; Jor-el Thomas Caparas,9,1,35,26
1656282556799,MATH 20C,A03,093476,Staff,0,0,35,35
1656282556799,MATH 20C,B01,083762,Bach; Quang Tran,1,0,30,29
1656282562823,MATH 20D,A01,083765,Tran; Brian Kha,1,0,30,29
1656282562823,MATH 20D,A02,083766,Tran; Brian Kha,0,1,30,30
1656282562823,MATH 20D,A03,083767,Tran; Brian Kha,2,0,30,28
1656282568867,MATH 20E,A01,083771,Ganguly; Soumya,3,0,32,29
1656282568867,MATH 20E,A02,083772,Ganguly; Soumya,0,0,32,32
1656282568867,MATH 20E,B01,083773,Ciotti; Benjamin,16,0,35,19
1656282568867,MATH 20E,B02,083774,Ciotti; Benjamin,15,0,35,20
1656282574897,MATH 103A,A01,083777,Greenfeld; Be'Eri,1,0,36,35
1656282574897,MATH 103A,A02,083778,Greenfeld; Be'Eri,2,0,36,34
1656282574897,MATH 103A,A03,093561,Staff,5,0,36,31
1656282574897,MATH 103A,B01,083779,Greenfeld; Be'Eri,8,0,36,28
1656282574897,MATH 103A,B02,083780,Greenfeld; Be'Eri,0,0,36,36
1656282574897,MATH 103A,B03,093562,Staff,0,0,36,36
1656282580924,MATH 105,A01,085443,Carter; Anne Toulson,5,0,35,30
1656282580924,MATH 105,A02,093477,Staff,14,0,35,21
1656282586952,MATH 109,A01,083213,Ganzberger; Geoffrey Michael,1,0,34,33
1656282586952,MATH 109,A02,083214,Ganzberger; Geoffrey Michael,0,0,34,34
1656282586952,MATH 109,A03,093478,Staff,2,0,34,32
1656282586952,MATH 109,B01,083215,Ganzberger; Geoffrey Michael,4,0,32,28
1656282586952,MATH 109,B02,083216,Ganzberger; Geoffrey Michael,1,0,32,31
1656282586952,MATH 109,B03,093479,Staff,3,0,32,29
1656282592982,MATH 142A,A01,083219,Chow; Bennett,1,0,32,31
1656282592982,MATH 142A,A02,083220,Chow; Bennett,8,0,32,24
1656282592982,MATH 142A,A03,093480,Staff,5,0,32,27
1656282592982,MATH 142A,B03,093481,Staff,3,0,32,29
1656282592982,MATH 142A,B04,093558,Staff,6,0,32,26
1656282592982,MATH 142A,B05,093559,Staff,0,0,32,32
1656282599005,MATH 193A,A01,083224,Rotar; Vladimir,0,1,34,34
1656282599005,MATH 193A,A02,083225,Rotar; Vladimir,0,0,34,34
1656282599005,MATH 193A,A03,083781,Rotar; Vladimir,0,0,34,34
1656282599005,MATH 193A,A04,083782,Rotar; Vladimir,6,0,34,28
1656282599005,MATH 193A,A05,093482,Rotar; Vladimir,0,0,34,34
1656282605031,MATH 197,001,091859,McAuley; Julian John,9999,0,9999,0
1656282605031,MATH 197,002,095566,Kedlaya; Kiran S.,9997,0,9999,2
1656282605031,MATH 197,003,095567,Xiao; Ming,9999,0,9999,0
1656282605031,MATH 197,004,095571,Perols; Johan Lars,9998,0,9999,1
1656282612093,COGS 9,A01,083615,Shannon; Kyle Michael,4,0,75,71
1656282618116,COGS 11,A01,083617,Boyle; Mary E. T.,14,0,48,34
1656282624141,COGS 13,A01,083071,Bastos; Amalia Pinkusfeld,5,0,71,66
1656282630164,COGS 14A,A01,092681,Semenuks; Arturs,1,13,100,99
1656282636192,COGS 14B,A01,083073,Cheng; Tzu-Han,7,0,63,56
1656282642216,COGS 17,A01,092677,Semenuks; Arturs,7,0,81,74
1656282648242,COGS 100,A01,083619,Allen; Michael Gordon,2,0,70,68
1656282654270,COGS 101A,A01,083621,Davis; Joshua Daniel,4,0,68,64
1656282660298,COGS 101B,A01,091572,Allen; Michael Gordon,4,0,65,61
1656282666322,COGS 101C,A01,083625,Delgado; Tania,10,0,35,25
1656282672348,COGS 107A,A01,083627,Boyle; Mary E. T.,0,0,60,60
1656282678372,COGS 118A,A01,083075,Gupta; Anjum,8,0,76,68
1656282684396,CSE 3,A50,083646,Miranda; Gregory Joseph,18,0,50,32
1656282690419,CSE 8A,A50,083650,Miranda; Gregory Joseph,2,2,56,54
1656282696446,CSE 11,A01,083080,Cao; Yingjun,0,48,40,40
1656282702468,CSE 12,A01,083652,Krause-Levy; Sophia Louisa,5,1,120,115
1656282708492,CSE 15L,A01,083654,Morris; Justin Loren,2,0,50,48
1656282708492,CSE 15L,A02,083655,Morris; Justin Loren,4,0,50,46
1656282714523,CSE 20,A01,083657,Tran; Khoa Dang,30,0,80,50
1656282720550,CSE 21,A01,095574,Bach; Quang Tran,23,0,48,25
1656282726577,CSE 30,A01,083084,Eldon; John,2,6,80,78
1656282726577,CSE 30,B01,095061,Bhaskar; Nishant,0,1,50,50
1656282732604,CSE 100,A01,083659,Cao; Yingjun,1,18,70,69
1656282738627,CSE 134B,A01,083661,Powell; Thomas Allan,6,0,100,94
1656282744655,CSE 140,A01,083663,Gungor; Onat,8,0,85,77
1656282750683,CSE 140L,A01,083088,Eldon; John,10,0,100,90
1656282756799,CSE 175,A01,083665,Kumar; Rakesh,0,0,25,25
1656282762822,CSE 190,A00,092507,Dubnov; Shlomo,3,0,20,17
1656282768858,ECE 45,A01,083139,Congero; Spencer William,1,0,75,74
1656282774881,ECE 65,A50,083695,Saad; Andrew S,9,0,30,21
1656282774881,ECE 65,A51,095125,Staff,24,0,26,2
1656282780907,ECE 109,A01,091882,Touri; Behrouz,1,1,70,69
1656282786944,ECE 180,A00,083140,Abi Samra; Nicholas Camill,2,0,30,28
1656282786944,ECE 180,B00,083141,Abi Samra; Nicholas Camill,0,4,30,30
1656282792967,MATH 10A,A01,083735,Patchell; Gregory David,0,0,30,30
1656282792967,MATH 10A,A02,083736,Patchell; Gregory David,22,0,30,8
1656282792967,MATH 10A,A03,083737,Patchell; Gregory David,16,0,30,14
1656282798991,MATH 10B,A01,083207,Lim; Seonhee,1,0,34,33
1656282798991,MATH 10B,A02,083208,Lim; Seonhee,7,0,35,28
1656282798991,MATH 10B,A03,093472,Staff,1,0,34,33
1656282798991,MATH 10B,B01,083739,Sinha; Shubham,11,0,30,19
1656282805025,MATH 18,A01,083743,Cinel; Cameron Alexander,7,0,30,23
1656282805025,MATH 18,A02,083744,Cinel; Cameron Alexander,9,0,30,21
1656282805025,MATH 18,A03,083745,Cinel; Cameron Alexander,5,0,30,25
1656282805025,MATH 18,B01,083748,Rideout; David Porter,1,0,36,35
1656282805025,MATH 18,B02,083749,Rideout; David Porter,0,0,36,36
1656282805025,MATH 18,B03,083750,Rideout; David Porter,0,0,36,36
1656282805025,MATH 18,B04,083751,Rideout; David Porter,0,1,36,36
1656282805025,MATH 18,B05,093473,Rideout; David Porter,0,0,36,36
1656282805025,MATH 18,B06,093474,Rideout; David Porter,3,0,36,33
1656282811051,MATH 20A,A01,083754,Zheng; Zequn,11,0,40,29
1656282817075,MATH 20B,A01,083756,Briones; Jor-el Thomas Caparas,0,0,36,36
1656282817075,MATH 20B,A02,083757,Briones; Jor-el Thomas Caparas,0,0,36,36
1656282817075,MATH 20B,A03,093475,Staff,0,0,36,36
1656282823099,MATH 20C,A01,083760,Briones; Jor-el Thomas Caparas,0,0,35,35
1656282823099,MATH 20C,A02,083761,Briones; Jor-el Thomas Caparas,9,1,35,26
1656282823099,MATH 20C,A03,093476,Staff,0,0,35,35
1656282823099,MATH 20C,B01,083762,Bach; Quang Tran,1,0,30,29
1656282829122,MATH 20D,A01,083765,Tran; Brian Kha,1,0,30,29
1656282829122,MATH 20D,A02,083766,Tran; Brian Kha,0,1,30,30
1656282829122,MATH 20D,A03,083767,Tran; Brian Kha,2,0,30,28
1656282835152,MATH 20E,A01,083771,Ganguly; Soumya,3,0,32,29
1656282835152,MATH 20E,A02,083772,Ganguly; Soumya,0,0,32,32
1656282835152,MATH 20E,B01,083773,Ciotti; Benjamin,16,0,35,19
1656282835152,MATH 20E,B02,083774,Ciotti; Benjamin,15,0,35,20
1656282841175,MATH 103A,A01,083777,Greenfeld; Be'Eri,1,0,36,35
1656282841175,MATH 103A,A02,083778,Greenfeld; Be'Eri,2,0,36,34
1656282841175,MATH 103A,A03,093561,Staff,5,0,36,31
1656282841175,MATH 103A,B01,083779,Greenfeld; Be'Eri,8,0,36,28
1656282841175,MATH 103A,B02,083780,Greenfeld; Be'Eri,0,0,36,36
1656282841175,MATH 103A,B03,093562,Staff,0,0,36,36
1656282847203,MATH 105,A01,085443,Carter; Anne Toulson,5,0,35,30
1656282847203,MATH 105,A02,093477,Staff,14,0,35,21
1656282853226,MATH 109,A01,083213,Ganzberger; Geoffrey Michael,1,0,34,33
1656282853226,MATH 109,A02,083214,Ganzberger; Geoffrey Michael,0,0,34,34
1656282853226,MATH 109,A03,093478,Staff,2,0,34,32
1656282853226,MATH 109,B01,083215,Ganzberger; Geoffrey Michael,4,0,32,28
1656282853226,MATH 109,B02,083216,Ganzberger; Geoffrey Michael,1,0,32,31
1656282853226,MATH 109,B03,093479,Staff,3,0,32,29
1656282859250,MATH 142A,A01,083219,Chow; Bennett,1,0,32,31
1656282859250,MATH 142A,A02,083220,Chow; Bennett,8,0,32,24
1656282859250,MATH 142A,A03,093480,Staff,5,0,32,27
1656282859250,MATH 142A,B03,093481,Staff,3,0,32,29
1656282859250,MATH 142A,B04,093558,Staff,6,0,32,26
1656282859250,MATH 142A,B05,093559,Staff,0,0,32,32
1656282865278,MATH 193A,A01,083224,Rotar; Vladimir,0,1,34,34
1656282865278,MATH 193A,A02,083225,Rotar; Vladimir,0,0,34,34
1656282865278,MATH 193A,A03,083781,Rotar; Vladimir,0,0,34,34
1656282865278,MATH 193A,A04,083782,Rotar; Vladimir,6,0,34,28
1656282865278,MATH 193A,A05,093482,Rotar; Vladimir,0,0,34,34
1656282871305,MATH 197,001,091859,McAuley; Julian John,9999,0,9999,0
1656282871305,MATH 197,002,095566,Kedlaya; Kiran S.,9997,0,9999,2
1656282871305,MATH 197,003,095567,Xiao; Ming,9999,0,9999,0
1656282871305,MATH 197,004,095571,Perols; Johan Lars,9998,0,9999,1
1656282878362,COGS 9,A01,083615,Shannon; Kyle Michael,4,0,75,71
1656282884386,COGS 11,A01,083617,Boyle; Mary E. T.,14,0,48,34
1656282890413,COGS 13,A01,083071,Bastos; Amalia Pinkusfeld,5,0,71,66
1656282896437,COGS 14A,A01,092681,Semenuks; Arturs,1,13,100,99
1656282902472,COGS 14B,A01,083073,Cheng; Tzu-Han,7,0,63,56
1656282908500,COGS 17,A01,092677,Semenuks; Arturs,7,0,81,74
1656282914528,COGS 100,A01,083619,Allen; Michael Gordon,2,0,70,68
1656282920554,COGS 101A,A01,083621,Davis; Joshua Daniel,4,0,68,64
1656282926577,COGS 101B,A01,091572,Allen; Michael Gordon,4,0,65,61
1656282932600,COGS 101C,A01,083625,Delgado; Tania,10,0,35,25
1656282938624,COGS 107A,A01,083627,Boyle; Mary E. T.,0,0,60,60
1656282944648,COGS 118A,A01,083075,Gupta; Anjum,8,0,76,68
1656282950671,CSE 3,A50,083646,Miranda; Gregory Joseph,18,0,50,32
1656282956696,CSE 8A,A50,083650,Miranda; Gregory Joseph,2,2,56,54
1656282962723,CSE 11,A01,083080,Cao; Yingjun,0,48,40,40
1656282968755,CSE 12,A01,083652,Krause-Levy; Sophia Louisa,5,1,120,115
1656282974781,CSE 15L,A01,083654,Morris; Justin Loren,2,0,50,48
1656282974781,CSE 15L,A02,083655,Morris; Justin Loren,4,0,50,46
1656282980811,CSE 20,A01,083657,Tran; Khoa Dang,30,0,80,50
1656282986834,CSE 21,A01,095574,Bach; Quang Tran,23,0,48,25
1656282992862,CSE 30,A01,083084,Eldon; John,2,6,80,78
1656282992862,CSE 30,B01,095061,Bhaskar; Nishant,0,1,50,50
1656282998901,CSE 100,A01,083659,Cao; Yingjun,1,18,70,69
1656283004927,CSE 134B,A01,083661,Powell; Thomas Allan,6,0,100,94
1656283010950,CSE 140,A01,083663,Gungor; Onat,8,0,85,77
1656283016974,CSE 140L,A01,083088,Eldon; John,10,0,100,90
1656283023001,CSE 175,A01,083665,Kumar; Rakesh,0,0,25,25
1656283029027,CSE 190,A00,092507,Dubnov; Shlomo,3,0,20,17
1656283035050,ECE 45,A01,083139,Congero; Spencer William,1,0,75,74
1656283041073,ECE 65,A50,083695,Saad; Andrew S,9,0,30,21
1656283041073,ECE 65,A51,095125,Staff,24,0,26,2
1656283047097,ECE 109,A01,091882,Touri; Behrouz,1,1,70,69
1656283053120,ECE 180,A00,083140,Abi Samra; Nicholas Camill,2,0,30,28
1656283053120,ECE 180,B00,083141,Abi Samra; Nicholas Camill,0,4,30,30
1656283059148,MATH 10A,A01,083735,Patchell; Gregory David,0,0,30,30
1656283059148,MATH 10A,A02,083736,Patchell; Gregory David,22,0,30,8
1656283059148,MATH 10A,A03,083737,Patchell; Gregory David,16,0,30,14
1656283065172,MATH 10B,A01,083207,Lim; Seonhee,1,0,34,33
1656283065172,MATH 10B,A02,083208,Lim; Seonhee,7,0,35,28
1656283065172,MATH 10B,A03,093472,Staff,1,0,34,33
1656283065172,MATH 10B,B01,083739,Sinha; Shubham,11,0,30,19
1656283071208,MATH 18,A01,083743,Cinel; Cameron Alexander,7,0,30,23
1656283071208,MATH 18,A02,083744,Cinel; Cameron Alexander,9,0,30,21
1656283071208,MATH 18,A03,083745,Cinel; Cameron Alexander,5,0,30,25
1656283071208,MATH 18,B01,083748,Rideout; David Porter,1,0,36,35
1656283071208,MATH 18,B02,083749,Rideout; David Porter,0,0,36,36
1656283071208,MATH 18,B03,083750,Rideout; David Porter,0,0,36,36
1656283071208,MATH 18,B04,083751,Rideout; David Porter,0,1,36,36
1656283071208,MATH 18,B05,093473,Rideout; David Porter,0,0,36,36
1656283071208,MATH 18,B06,093474,Rideout; David Porter,3,0,36,33
1656283077235,MATH 20A,A01,083754,Zheng; Zequn,11,0,40,29
1656283083263,MATH 20B,A01,083756,Briones; Jor-el Thomas Caparas,0,0,36,36
1656283083263,MATH 20B,A02,083757,Briones; Jor-el Thomas Caparas,0,0,36,36
1656283083263,MATH 20B,A03,093475,Staff,0,0,36,36
1656283089292,MATH 20C,A01,083760,Briones; Jor-el Thomas Caparas,0,0,35,35
1656283089292,MATH 20C,A02,083761,Briones; Jor-el Thomas Caparas,9,1,35,26
1656283089292,MATH 20C,A03,093476,Staff,0,0,35,35
1656283089292,MATH 20C,B01,083762,Bach; Quang Tran,1,0,30,29
1656283095316,MATH 20D,A01,083765,Tran; Brian Kha,1,0,30,29
1656283095316,MATH 20D,A02,083766,Tran; Brian Kha,0,1,30,30
1656283095316,MATH 20D,A03,083767,Tran; Brian Kha,2,0,30,28
1656283101339,MATH 20E,A01,083771,Ganguly; Soumya,3,0,32,29
1656283101339,MATH 20E,A02,083772,Ganguly; Soumya,0,0,32,32
1656283101339,MATH 20E,B01,083773,Ciotti; Benjamin,16,0,35,19
1656283101339,MATH 20E,B02,083774,Ciotti; Benjamin,15,0,35,20
1656283107369,MATH 103A,A01,083777,Greenfeld; Be'Eri,1,0,36,35
1656283107369,MATH 103A,A02,083778,Greenfeld; Be'Eri,2,0,36,34
1656283107369,MATH 103A,A03,093561,Staff,5,0,36,31
1656283107369,MATH 103A,B01,083779,Greenfeld; Be'Eri,8,0,36,28
1656283107369,MATH 103A,B02,083780,Greenfeld; Be'Eri,0,0,36,36
1656283107369,MATH 103A,B03,093562,Staff,0,0,36,36
1656283113396,MATH 105,A01,085443,Carter; Anne Toulson,5,0,35,30
1656283113396,MATH 105,A02,093477,Staff,14,0,35,21
1656283119421,MATH 109,A01,083213,Ganzberger; Geoffrey Michael,1,0,34,33
1656283119421,MATH 109,A02,083214,Ganzberger; Geoffrey Michael,0,0,34,34
1656283119421,MATH 109,A03,093478,Staff,2,0,34,32
1656283119421,MATH 109,B01,083215,Ganzberger; Geoffrey Michael,4,0,32,28
1656283119421,MATH 109,B02,083216,Ganzberger; Geoffrey Michael,1,0,32,31
1656283119421,MATH 109,B03,093479,Staff,3,0,32,29
1656283125451,MATH 142A,A01,083219,Chow; Bennett,1,0,32,31
1656283125451,MATH 142A,A02,083220,Chow; Bennett,8,0,32,24
1656283125451,MATH 142A,A03,093480,Staff,5,0,32,27
1656283125451,MATH 142A,B03,093481,Staff,3,0,32,29
1656283125451,MATH 142A,B04,093558,Staff,6,0,32,26
1656283125451,MATH 142A,B05,093559,Staff,0,0,32,32
1656283131475,MATH 193A,A01,083224,Rotar; Vladimir,0,1,34,34
1656283131475,MATH 193A,A02,083225,Rotar; Vladimir,0,0,34,34
1656283131475,MATH 193A,A03,083781,Rotar; Vladimir,0,0,34,34
1656283131475,MATH 193A,A04,083782,Rotar; Vladimir,6,0,34,28
1656283131475,MATH 193A,A05,093482,Rotar; Vladimir,0,0,34,34
1656283137510,MATH 197,001,091859,McAuley; Julian John,9999,0,9999,0
1656283137510,MATH 197,002,095566,Kedlaya; Kiran S.,9997,0,9999,2
1656283137510,MATH 197,003,095567,Xiao; Ming,9999,0,9999,0
1656283137510,MATH 197,004,095571,Perols; Johan Lars,9998,0,9999,1
1656283144560,COGS 9,A01,083615,Shannon; Kyle Michael,4,0,75,71
1656283150585,COGS 11,A01,083617,Boyle; Mary E. T.,14,0,48,34
1656283156612,COGS 13,A01,083071,Bastos; Amalia Pinkusfeld,5,0,71,66
1656283162639,COGS 14A,A01,092681,Semenuks; Arturs,1,13,100,99
1656283168662,COGS 14B,A01,083073,Cheng; Tzu-Han,7,0,63,56
1656283174688,COGS 17,A01,092677,Semenuks; Arturs,7,0,81,74
1656283180710,COGS 100,A01,083619,Allen; Michael Gordon,2,0,70,68
1656283186738,COGS 101A,A01,083621,Davis; Joshua Daniel,4,0,68,64
1656283192761,COGS 101B,A01,091572,Allen; Michael Gordon,4,0,65,61
1656283198785,COGS 101C,A01,083625,Delgado; Tania,10,0,35,25
1656283204808,COGS 107A,A01,083627,Boyle; Mary E. T.,0,0,60,60
1656283210831,COGS 118A,A01,083075,Gupta; Anjum,8,0,76,68
1656283216854,CSE 3,A50,083646,Miranda; Gregory Joseph,18,0,50,32
1656283222883,CSE 8A,A50,083650,Miranda; Gregory Joseph,2,2,56,54
1656283228905,CSE 11,A01,083080,Cao; Yingjun,0,48,40,40
1656283234927,CSE 12,A01,083652,Krause-Levy; Sophia Louisa,5,1,120,115
1656283240950,CSE 15L,A01,083654,Morris; Justin Loren,2,0,50,48
1656283240950,CSE 15L,A02,083655,Morris; Justin Loren,4,0,50,46
1656283246977,CSE 20,A01,083657,Tran; Khoa Dang,30,0,80,50
1656283253003,CSE 21,A01,095574,Bach; Quang Tran,23,0,48,25
1656283259027,CSE 30,A01,083084,Eldon; John,2,6,80,78
1656283259027,CSE 30,B01,095061,Bhaskar; Nishant,0,1,50,50
1656283265049,CSE 100,A01,083659,Cao; Yingjun,1,18,70,69
1656283271087,CSE 134B,A01,083661,Powell; Thomas Allan,6,0,100,94
1656283277108,CSE 140,A01,083663,Gungor; Onat,8,0,85,77
1656283283136,CSE 140L,A01,083088,Eldon; John,10,0,100,90
1656283289160,CSE 175,A01,083665,Kumar; Rakesh,0,0,25,25
1656283295184,CSE 190,A00,092507,Dubnov; Shlomo,3,0,20,17
1656283301214,ECE 45,A01,083139,Congero; Spencer William,1,0,75,74
1656283307240,ECE 65,A50,083695,Saad; Andrew S,9,0,30,21
1656283307240,ECE 65,A51,095125,Staff,24,0,26,2
1656283313267,ECE 109,A01,091882,Touri; Behrouz,1,1,70,69
1656283319291,ECE 180,A00,083140,Abi Samra; Nicholas Camill,2,0,30,28
1656283319291,ECE 180,B00,083141,Abi Samra; Nicholas Camill,0,4,30,30
1656283325313,MATH 10A,A01,083735,Patchell; Gregory David,0,0,30,30
1656283325313,MATH 10A,A02,083736,Patchell; Gregory David,22,0,30,8
1656283325313,MATH 10A,A03,083737,Patchell; Gregory David,16,0,30,14
1656283331340,MATH 10B,A01,083207,Lim; Seonhee,1,0,34,33
1656283331340,MATH 10B,A02,083208,Lim; Seonhee,7,0,35,28
1656283331340,MATH 10B,A03,093472,Staff,1,0,34,33
1656283331340,MATH 10B,B01,083739,Sinha; Shubham,11,0,30,19
1656283337369,MATH 18,A01,083743,Cinel; Cameron Alexander,7,0,30,23
1656283337369,MATH 18,A02,083744,Cinel; Cameron Alexander,9,0,30,21
1656283337369,MATH 18,A03,083745,Cinel; Cameron Alexander,5,0,30,25
1656283337369,MATH 18,B01,083748,Rideout; David Porter,1,0,36,35
1656283337369,MATH 18,B02,083749,Rideout; David Porter,0,0,36,36
1656283337369,MATH 18,B03,083750,Rideout; David Porter,0,0,36,36
1656283337369,MATH 18,B04,083751,Rideout; David Porter,0,1,36,36
1656283337369,MATH 18,B05,093473,Rideout; David Porter,0,0,36,36
1656283337369,MATH 18,B06,093474,Rideout; David Porter,3,0,36,33
1656283343391,MATH 20A,A01,083754,Zheng; Zequn,11,0,40,29
1656283349420,MATH 20B,A01,083756,Briones; Jor-el Thomas Caparas,0,0,36,36
1656283349420,MATH 20B,A02,083757,Briones; Jor-el Thomas Caparas,0,0,36,36
1656283349420,MATH 20B,A03,093475,Staff,0,0,36,36
1656283355518,MATH 20C,A01,083760,Briones; Jor-el Thomas Caparas,0,0,35,35
1656283355518,MATH 20C,A02,083761,Briones; Jor-el Thomas Caparas,9,1,35,26
1656283355518,MATH 20C,A03,093476,Staff,0,0,35,35
1656283355518,MATH 20C,B01,083762,Bach; Quang Tran,1,0,30,29
1656283361540,MATH 20D,A01,083765,Tran; Brian Kha,1,0,30,29
1656283361540,MATH 20D,A02,083766,Tran; Brian Kha,0,1,30,30
1656283361540,MATH 20D,A03,083767,Tran; Brian Kha,2,0,30,28
1656283367572,MATH 20E,A01,083771,Ganguly; Soumya,3,0,32,29
1656283367572,MATH 20E,A02,083772,Ganguly; Soumya,0,0,32,32
1656283367572,MATH 20E,B01,083773,Ciotti; Benjamin,16,0,35,19
1656283367572,MATH 20E,B02,083774,Ciotti; Benjamin,15,0,35,20
1656283373597,MATH 103A,A01,083777,Greenfeld; Be'Eri,1,0,36,35
1656283373597,MATH 103A,A02,083778,Greenfeld; Be'Eri,2,0,36,34
1656283373597,MATH 103A,A03,093561,Staff,5,0,36,31
1656283373597,MATH 103A,B01,083779,Greenfeld; Be'Eri,8,0,36,28
1656283373597,MATH 103A,B02,083780,Greenfeld; Be'Eri,0,0,36,36
1656283373597,MATH 103A,B03,093562,Staff,0,0,36,36
1656283379625,MATH 105,A01,085443,Carter; Anne Toulson,5,0,35,30
1656283379625,MATH 105,A02,093477,Staff,14,0,35,21
1656283385650,MATH 109,A01,083213,Ganzberger; Geoffrey Michael,1,0,34,33
1656283385650,MATH 109,A02,083214,Ganzberger; Geoffrey Michael,0,0,34,34
1656283385650,MATH 109,A03,093478,Staff,2,0,34,32
1656283385650,MATH 109,B01,083215,Ganzberger; Geoffrey Michael,4,0,32,28
1656283385650,MATH 109,B02,083216,Ganzberger; Geoffrey Michael,1,0,32,31
1656283385650,MATH 109,B03,093479,Staff,3,0,32,29
1656283391674,MATH 142A,A01,083219,Chow; Bennett,1,0,32,31
1656283391674,MATH 142A,A02,083220,Chow; Bennett,8,0,32,24
1656283391674,MATH 142A,A03,093480,Staff,5,0,32,27
1656283391674,MATH 142A,B03,093481,Staff,3,0,32,29
1656283391674,MATH 142A,B04,093558,Staff,6,0,32,26
1656283391674,MATH 142A,B05,093559,Staff,0,0,32,32
1656283397698,MATH 193A,A01,083224,Rotar; Vladimir,0,1,34,34
1656283397698,MATH 193A,A02,083225,Rotar; Vladimir,0,0,34,34
1656283397698,MATH 193A,A03,083781,Rotar; Vladimir,0,0,34,34
1656283397698,MATH 193A,A04,083782,Rotar; Vladimir,6,0,34,28
1656283397698,MATH 193A,A05,093482,Rotar; Vladimir,0,0,34,34
1656283403731,MATH 197,001,091859,McAuley; Julian John,9999,0,9999,0
1656283403731,MATH 197,002,095566,Kedlaya; Kiran S.,9997,0,9999,2
1656283403731,MATH 197,003,095567,Xiao; Ming,9999,0,9999,0
1656283403731,MATH 197,004,095571,Perols; Johan Lars,9998,0,9999,1
1656283410784,COGS 9,A01,083615,Shannon; Kyle Michael,4,0,75,71
1656283416806,COGS 11,A01,083617,Boyle; Mary E. T.,15,0,48,33
1656283422833,COGS 13,A01,083071,Bastos; Amalia Pinkusfeld,5,0,71,66
1656283428861,COGS 14A,A01,092681,Semenuks; Arturs,1,13,100,99
1656283434887,COGS 14B,A01,083073,Cheng; Tzu-Han,7,0,63,56
1656283440911,COGS 17,A01,092677,Semenuks; Arturs,7,0,81,74
1656283446933,COGS 100,A01,083619,Allen; Michael Gordon,2,0,70,68
1656283452967,COGS 101A,A01,083621,Davis; Joshua Daniel,4,0,68,64
1656283459000,COGS 101B,A01,091572,Allen; Michael Gordon,4,0,65,61
1656283465036,COGS 101C,A01,083625,Delgado; Tania,10,0,35,25
1656283471060,COGS 107A,A01,083627,Boyle; Mary E. T.,0,0,60,60
1656283477081,COGS 118A,A01,083075,Gupta; Anjum,8,0,76,68
1656283483109,CSE 3,A50,083646,Miranda; Gregory Joseph,18,0,50,32
1656283489133,CSE 8A,A50,083650,Miranda; Gregory Joseph,2,2,56,54
1656283495155,CSE 11,A01,083080,Cao; Yingjun,0,48,40,40
1656283501181,CSE 12,A01,083652,Krause-Levy; Sophia Louisa,5,1,120,115
1656283507202,CSE 15L,A01,083654,Morris; Justin Loren,2,0,50,48
1656283507202,CSE 15L,A02,083655,Morris; Justin Loren,4,0,50,46
1656283513230,CSE 20,A01,083657,Tran; Khoa Dang,30,0,80,50
1656283519254,CSE 21,A01,095574,Bach; Quang Tran,23,0,48,25
1656283525279,CSE 30,A01,083084,Eldon; John,2,6,80,78
1656283525279,CSE 30,B01,095061,Bhaskar; Nishant,0,1,50,50
1656283531300,CSE 100,A01,083659,Cao; Yingjun,1,18,70,69
1656283537322,CSE 134B,A01,083661,Powell; Thomas Allan,6,0,100,94
1656283543353,CSE 140,A01,083663,Gungor; Onat,8,0,85,77
1656283549379,CSE 140L,A01,083088,Eldon; John,10,0,100,90
1656283555400,CSE 175,A01,083665,Kumar; Rakesh,0,0,25,25
1656283561426,CSE 190,A00,092507,Dubnov; Shlomo,3,0,20,17
1656283567453,ECE 45,A01,083139,Congero; Spencer William,1,0,75,74
1656283573479,ECE 65,A50,083695,Saad; Andrew S,9,0,30,21
1656283573479,ECE 65,A51,095125,Staff,24,0,26,2
1656283579501,ECE 109,A01,091882,Touri; Behrouz,1,1,70,69
1656283585525,ECE 180,A00,083140,Abi Samra; Nicholas Camill,2,0,30,28
1656283585525,ECE 180,B00,083141,Abi Samra; Nicholas Camill,0,4,30,30
1656283591553,MATH 10A,A01,083735,Patchell; Gregory David,0,0,30,30
1656283591553,MATH 10A,A02,083736,Patchell; Gregory David,22,0,30,8
1656283591553,MATH 10A,A03,083737,Patchell; Gregory David,16,0,30,14
1656283597576,MATH 10B,A01,083207,Lim; Seonhee,1,0,34,33
1656283597576,MATH 10B,A02,083208,Lim; Seonhee,7,0,35,28
1656283597576,MATH 10B,A03,093472,Staff,1,0,34,33
1656283597576,MATH 10B,B01,083739,Sinha; Shubham,11,0,30,19
1656283603606,MATH 18,A01,083743,Cinel; Cameron Alexander,7,0,30,23
1656283603606,MATH 18,A02,083744,Cinel; Cameron Alexander,9,0,30,21
1656283603606,MATH 18,A03,083745,Cinel; Cameron Alexander,5,0,30,25
1656283603606,MATH 18,B01,083748,Rideout; David Porter,1,0,36,35
1656283603606,MATH 18,B02,083749,Rideout; David Porter,0,0,36,36
1656283603606,MATH 18,B03,083750,Rideout; David Porter,0,0,36,36
1656283603606,MATH 18,B04,083751,Rideout; David Porter,0,1,36,36
1656283603606,MATH 18,B05,093473,Rideout; David Porter,0,0,36,36
1656283603606,MATH 18,B06,093474,Rideout; David Porter,3,0,36,33
1656283609638,MATH 20A,A01,083754,Zheng; Zequn,11,0,40,29
1656283615667,MATH 20B,A01,083756,Briones; Jor-el Thomas Caparas,0,0,36,36
1656283615667,MATH 20B,A02,083757,Briones; Jor-el Thomas Caparas,0,0,36,36
1656283615667,MATH 20B,A03,093475,Staff,0,0,36,36
1656283621690,MATH 20C,A01,083760,Briones; Jor-el Thomas Caparas,0,0,35,35
1656283621690,MATH 20C,A02,083761,Briones; Jor-el Thomas Caparas,9,1,35,26
1656283621690,MATH 20C,A03,093476,Staff,0,0,35,35
1656283621690,MATH 20C,B01,083762,Bach; Quang Tran,1,0,30,29
1656283627718,MATH 20D,A01,083765,Tran; Brian Kha,1,0,30,29
1656283627718,MATH 20D,A02,083766,Tran; Brian Kha,0,1,30,30
1656283627718,MATH 20D,A03,083767,Tran; Brian Kha,2,0,30,28
1656283633742,MATH 20E,A01,083771,Ganguly; Soumya,3,0,32,29
1656283633742,MATH 20E,A02,083772,Ganguly; Soumya,0,0,32,32
1656283633742,MATH 20E,B01,083773,Ciotti; Benjamin,16,0,35,19
1656283633742,MATH 20E,B02,083774,Ciotti; Benjamin,15,0,35,20
1656283639767,MATH 103A,A01,083777,Greenfeld; Be'Eri,1,0,36,35
1656283639767,MATH 103A,A02,083778,Greenfeld; Be'Eri,2,0,36,34
1656283639767,MATH 103A,A03,093561,Staff,5,0,36,31
1656283639767,MATH 103A,B01,083779,Greenfeld; Be'Eri,8,0,36,28
1656283639767,MATH 103A,B02,083780,Greenfeld; Be'Eri,0,0,36,36
1656283639767,MATH 103A,B03,093562,Staff,0,0,36,36
1656283645795,MATH 105,A01,085443,Carter; Anne Toulson,5,0,35,30
1656283645795,MATH 105,A02,093477,Staff,14,0,35,21
1656283651819,MATH 109,A01,083213,Ganzberger; Geoffrey Michael,1,0,34,33
1656283651819,MATH 109,A02,083214,Ganzberger; Geoffrey Michael,0,0,34,34
1656283651819,MATH 109,A03,093478,Staff,2,0,34,32
1656283651819,MATH 109,B01,083215,Ganzberger; Geoffrey Michael,4,0,32,28
1656283651819,MATH 109,B02,083216,Ganzberger; Geoffrey Michael,1,0,32,31
1656283651819,MATH 109,B03,093479,Staff,3,0,32,29
1656283657844,MATH 142A,A01,083219,Chow; Bennett,1,0,32,31
1656283657844,MATH 142A,A02,083220,Chow; Bennett,8,0,32,24
1656283657844,MATH 142A,A03,093480,Staff,5,0,32,27
1656283657844,MATH 142A,B03,093481,Staff,3,0,32,29
1656283657844,MATH 142A,B04,093558,Staff,6,0,32,26
1656283657844,MATH 142A,B05,093559,Staff,0,0,32,32
1656283663872,MATH 193A,A01,083224,Rotar; Vladimir,0,1,34,34
1656283663872,MATH 193A,A02,083225,Rotar; Vladimir,0,0,34,34
1656283663872,MATH 193A,A03,083781,Rotar; Vladimir,0,0,34,34
1656283663872,MATH 193A,A04,083782,Rotar; Vladimir,6,0,34,28
1656283663872,MATH 193A,A05,093482,Rotar; Vladimir,0,0,34,34
1656283669896,MATH 197,001,091859,McAuley; Julian John,9999,0,9999,0
1656283669896,MATH 197,002,095566,Kedlaya; Kiran S.,9997,0,9999,2
1656283669896,MATH 197,003,095567,Xiao; Ming,9999,0,9999,0
1656283669896,MATH 197,004,095571,Perols; Johan Lars,9998,0,9999,1
1656283676949,COGS 9,A01,083615,Shannon; Kyle Michael,4,0,75,71
1656283682973,COGS 11,A01,083617,Boyle; Mary E. T.,15,0,48,33
1656283688996,COGS 13,A01,083071,Bastos; Amalia Pinkusfeld,5,0,71,66
1656283695019,COGS 14A,A01,092681,Semenuks; Arturs,1,13,100,99
1656283701042,COGS 14B,A01,083073,Cheng; Tzu-Han,7,0,63,56
1656283707065,COGS 17,A01,092677,Semenuks; Arturs,7,0,81,74
1656283713088,COGS 100,A01,083619,Allen; Michael Gordon,2,0,70,68
1656283719110,COGS 101A,A01,083621,Davis; Joshua Daniel,4,0,68,64
1656283725137,COGS 101B,A01,091572,Allen; Michael Gordon,4,0,65,61
1656283731166,COGS 101C,A01,083625,Delgado; Tania,10,0,35,25
1656283737190,COGS 107A,A01,083627,Boyle; Mary E. T.,0,0,60,60
1656283743213,COGS 118A,A01,083075,Gupta; Anjum,8,0,76,68
1656283749236,CSE 3,A50,083646,Miranda; Gregory Joseph,18,0,50,32
1656283755262,CSE 8A,A50,083650,Miranda; Gregory Joseph,2,2,56,54
1656283761288,CSE 11,A01,083080,Cao; Yingjun,0,48,40,40
1656283767321,CSE 12,A01,083652,Krause-Levy; Sophia Louisa,5,1,120,115
1656283773344,CSE 15L,A01,083654,Morris; Justin Loren,2,0,50,48
1656283773344,CSE 15L,A02,083655,Morris; Justin Loren,4,0,50,46
1656283779368,CSE 20,A01,083657,Tran; Khoa Dang,30,0,80,50
1656283785392,CSE 21,A01,095574,Bach; Quang Tran,23,0,48,25
1656283791420,CSE 30,A01,083084,Eldon; John,2,6,80,78
1656283791420,CSE 30,B01,095061,Bhaskar; Nishant,0,1,50,50
1656283797446,CSE 100,A01,083659,Cao; Yingjun,1,18,70,69
1656283803468,CSE 134B,A01,083661,Powell; Thomas Allan,6,0,100,94
1656283809495,CSE 140,A01,083663,Gungor; Onat,8,0,85,77
1656283815517,CSE 140L,A01,083088,Eldon; John,10,0,100,90
1656283821539,CSE 175,A01,083665,Kumar; Rakesh,0,0,25,25
1656283827569,CSE 190,A00,092507,Dubnov; Shlomo,3,0,20,17
1656283833592,ECE 45,A01,083139,Congero; Spencer William,1,0,75,74
1656283839619,ECE 65,A50,083695,Saad; Andrew S,9,0,30,21
1656283839619,ECE 65,A51,095125,Staff,24,0,26,2
1656283845648,ECE 109,A01,091882,Touri; Behrouz,1,1,70,69
1656283851672,ECE 180,A00,083140,Abi Samra; Nicholas Camill,2,0,30,28
1656283851672,ECE 180,B00,083141,Abi Samra; Nicholas Camill,0,4,30,30
1656283857699,MATH 10A,A01,083735,Patchell; Gregory David,0,0,30,30
1656283857699,MATH 10A,A02,083736,Patchell; Gregory David,22,0,30,8
1656283857699,MATH 10A,A03,083737,Patchell; Gregory David,16,0,30,14
1656283863724,MATH 10B,A01,083207,Lim; Seonhee,1,0,34,33
1656283863724,MATH 10B,A02,083208,Lim; Seonhee,7,0,35,28
1656283863724,MATH 10B,A03,093472,Staff,1,0,34,33
1656283863724,MATH 10B,B01,083739,Sinha; Shubham,11,0,30,19
1656283869748,MATH 18,A01,083743,Cinel; Cameron Alexander,7,0,30,23
1656283869748,MATH 18,A02,083744,Cinel; Cameron Alexander,9,0,30,21
1656283869748,MATH 18,A03,083745,Cinel; Cameron Alexander,5,0,30,25
1656283869748,MATH 18,B01,083748,Rideout; David Porter,1,0,36,35
1656283869748,MATH 18,B02,083749,Rideout; David Porter,0,0,36,36
1656283869748,MATH 18,B03,083750,Rideout; David Porter,0,0,36,36
1656283869748,MATH 18,B04,083751,Rideout; David Porter,0,1,36,36
1656283869748,MATH 18,B05,093473,Rideout; David Porter,0,0,36,36
1656283869748,MATH 18,B06,093474,Rideout; David Porter,3,0,36,33
1656283875772,MATH 20A,A01,083754,Zheng; Zequn,11,0,40,29
1656283881799,MATH 20B,A01,083756,Briones; Jor-el Thomas Caparas,0,0,36,36
1656283881799,MATH 20B,A02,083757,Briones; Jor-el Thomas Caparas,0,0,36,36
1656283881799,MATH 20B,A03,093475,Staff,0,0,36,36
1656283887823,MATH 20C,A01,083760,Briones; Jor-el Thomas Caparas,0,0,35,35
1656283887823,MATH 20C,A02,083761,Briones; Jor-el Thomas Caparas,9,1,35,26
1656283887823,MATH 20C,A03,093476,Staff,0,0,35,35
1656283887823,MATH 20C,B01,083762,Bach; Quang Tran,1,0,30,29
1656283893845,MATH 20D,A01,083765,Tran; Brian Kha,1,0,30,29
1656283893845,MATH 20D,A02,083766,Tran; Brian Kha,0,1,30,30
1656283893845,MATH 20D,A03,083767,Tran; Brian Kha,2,0,30,28
1656283899870,MATH 20E,A01,083771,Ganguly; Soumya,3,0,32,29
1656283899870,MATH 20E,A02,083772,Ganguly; Soumya,0,0,32,32
1656283899870,MATH 20E,B01,083773,Ciotti; Benjamin,16,0,35,19
1656283899870,MATH 20E,B02,083774,Ciotti; Benjamin,15,0,35,20
1656283905901,MATH 103A,A01,083777,Greenfeld; Be'Eri,1,0,36,35
1656283905901,MATH 103A,A02,083778,Greenfeld; Be'Eri,2,0,36,34
1656283905901,MATH 103A,A03,093561,Staff,5,0,36,31
1656283905901,MATH 103A,B01,083779,Greenfeld; Be'Eri,8,0,36,28
1656283905901,MATH 103A,B02,083780,Greenfeld; Be'Eri,0,0,36,36
1656283905901,MATH 103A,B03,093562,Staff,0,0,36,36
1656283911925,MATH 105,A01,085443,Carter; Anne Toulson,5,0,35,30
1656283911925,MATH 105,A02,093477,Staff,14,0,35,21
1656283917947,MATH 109,A01,083213,Ganzberger; Geoffrey Michael,1,0,34,33
1656283917947,MATH 109,A02,083214,Ganzberger; Geoffrey Michael,0,0,34,34
1656283917947,MATH 109,A03,093478,Staff,2,0,34,32
1656283917947,MATH 109,B01,083215,Ganzberger; Geoffrey Michael,4,0,32,28
1656283917947,MATH 109,B02,083216,Ganzberger; Geoffrey Michael,1,0,32,31
1656283917947,MATH 109,B03,093479,Staff,3,0,32,29
1656283923971,MATH 142A,A01,083219,Chow; Bennett,1,0,32,31
1656283923971,MATH 142A,A02,083220,Chow; Bennett,8,0,32,24
1656283923971,MATH 142A,A03,093480,Staff,5,0,32,27
1656283923971,MATH 142A,B03,093481,Staff,3,0,32,29
1656283923971,MATH 142A,B04,093558,Staff,6,0,32,26
1656283923971,MATH 142A,B05,093559,Staff,0,0,32,32
1656283929995,MATH 193A,A01,083224,Rotar; Vladimir,0,1,34,34
1656283929995,MATH 193A,A02,083225,Rotar; Vladimir,0,0,34,34
1656283929995,MATH 193A,A03,083781,Rotar; Vladimir,0,0,34,34
1656283929995,MATH 193A,A04,083782,Rotar; Vladimir,6,0,34,28
1656283929995,MATH 193A,A05,093482,Rotar; Vladimir,0,0,34,34
1656283936018,MATH 197,001,091859,McAuley; Julian John,9999,0,9999,0
1656283936018,MATH 197,002,095566,Kedlaya; Kiran S.,9997,0,9999,2
1656283936018,MATH 197,003,095567,Xiao; Ming,9999,0,9999,0
1656283936018,MATH 197,004,095571,Perols; Johan Lars,9998,0,9999,1
1656283943083,COGS 9,A01,083615,Shannon; Kyle Michael,4,0,75,71
1656283949180,COGS 11,A01,083617,Boyle; Mary E. T.,15,0,48,33
1656283955202,COGS 13,A01,083071,Bastos; Amalia Pinkusfeld,5,0,71,66
1656283961227,COGS 14A,A01,092681,Semenuks; Arturs,1,13,100,99
1656283967250,COGS 14B,A01,083073,Cheng; Tzu-Han,7,0,63,56
1656283973273,COGS 17,A01,092677,Semenuks; Arturs,7,0,81,74
1656283979295,COGS 100,A01,083619,Allen; Michael Gordon,2,0,70,68
1656283985326,COGS 101A,A01,083621,Davis; Joshua Daniel,4,0,68,64
1656283991349,COGS 101B,A01,091572,Allen; Michael Gordon,4,0,65,61
1656283997372,COGS 101C,A01,083625,Delgado; Tania,10,0,35,25
1656284003410,COGS 107A,A01,083627,Boyle; Mary E. T.,0,0,60,60
1656284009436,COGS 118A,A01,083075,Gupta; Anjum,8,0,76,68
1656284015469,CSE 3,A50,083646,Miranda; Gregory Joseph,18,0,50,32
1656284021493,CSE 8A,A50,083650,Miranda; Gregory Joseph,2,2,56,54
1656284027517,CSE 11,A01,083080,Cao; Yingjun,0,48,40,40
1656284033540,CSE 12,A01,083652,Krause-Levy; Sophia Louisa,5,1,120,115
1656284039570,CSE 15L,A01,083654,Morris; Justin Loren,2,0,50,48
1656284039570,CSE 15L,A02,083655,Morris; Justin Loren,4,0,50,46
1656284045593,CSE 20,A01,083657,Tran; Khoa Dang,30,0,80,50
1656284051616,CSE 21,A01,095574,Bach; Quang Tran,23,0,48,25
1656284057639,CSE 30,A01,083084,Eldon; John,2,6,80,78
1656284057639,CSE 30,B01,095061,Bhaskar; Nishant,0,1,50,50
1656284063665,CSE 100,A01,083659,Cao; Yingjun,1,18,70,69
1656284069690,CSE 134B,A01,083661,Powell; Thomas Allan,6,0,100,94
1656284075716,CSE 140,A01,083663,Gungor; Onat,8,0,85,77
1656284081743,CSE 140L,A01,083088,Eldon; John,10,0,100,90
1656284087767,CSE 175,A01,083665,Kumar; Rakesh,0,0,25,25
1656284093791,CSE 190,A00,092507,Dubnov; Shlomo,3,0,20,17
1656284099814,ECE 45,A01,083139,Congero; Spencer William,1,0,75,74
1656284105840,ECE 65,A50,083695,Saad; Andrew S,9,0,30,21
1656284105840,ECE 65,A51,095125,Staff,24,0,26,2
1656284111864,ECE 109,A01,091882,Touri; Behrouz,1,1,70,69
1656284117889,ECE 180,A00,083140,Abi Samra; Nicholas Camill,2,0,30,28
1656284117889,ECE 180,B00,083141,Abi Samra; Nicholas Camill,0,4,30,30
1656284123912,MATH 10A,A01,083735,Patchell; Gregory David,0,0,30,30
1656284123912,MATH 10A,A02,083736,Patchell; Gregory David,22,0,30,8
1656284123912,MATH 10A,A03,083737,Patchell; Gregory David,16,0,30,14
1656284129940,MATH 10B,A01,083207,Lim; Seonhee,1,0,34,33
1656284129940,MATH 10B,A02,083208,Lim; Seonhee,7,0,35,28
1656284129940,MATH 10B,A03,093472,Staff,1,0,34,33
1656284129940,MATH 10B,B01,083739,Sinha; Shubham,11,0,30,19
1656284135966,MATH 18,A01,083743,Cinel; Cameron Alexander,7,0,30,23
1656284135966,MATH 18,A02,083744,Cinel; Cameron Alexander,9,0,30,21
1656284135966,MATH 18,A03,083745,Cinel; Cameron Alexander,5,0,30,25
1656284135966,MATH 18,B01,083748,Rideout; David Porter,1,0,36,35
1656284135966,MATH 18,B02,083749,Rideout; David Porter,0,0,36,36
1656284135966,MATH 18,B03,083750,Rideout; David Porter,0,0,36,36
1656284135966,MATH 18,B04,083751,Rideout; David Porter,0,1,36,36
1656284135966,MATH 18,B05,093473,Rideout; David Porter,0,0,36,36
1656284135966,MATH 18,B06,093474,Rideout; David Porter,3,0,36,33
1656284141992,MATH 20A,A01,083754,Zheng; Zequn,11,0,40,29
1656284148018,MATH 20B,A01,083756,Briones; Jor-el Thomas Caparas,0,0,36,36
1656284148018,MATH 20B,A02,083757,Briones; Jor-el Thomas Caparas,0,0,36,36
1656284148018,MATH 20B,A03,093475,Staff,0,0,36,36
1656284154050,MATH 20C,A01,083760,Briones; Jor-el Thomas Caparas,0,0,35,35
1656284154050,MATH 20C,A02,083761,Briones; Jor-el Thomas Caparas,9,1,35,26
1656284154050,MATH 20C,A03,093476,Staff,0,0,35,35
1656284154050,MATH 20C,B01,083762,Bach; Quang Tran,1,0,30,29
1656284160079,MATH 20D,A01,083765,Tran; Brian Kha,1,0,30,29
1656284160079,MATH 20D,A02,083766,Tran; Brian Kha,0,1,30,30
1656284160079,MATH 20D,A03,083767,Tran; Brian Kha,2,0,30,28
1656284166107,MATH 20E,A01,083771,Ganguly; Soumya,3,0,32,29
1656284166107,MATH 20E,A02,083772,Ganguly; Soumya,0,0,32,32
1656284166107,MATH 20E,B01,083773,Ciotti; Benjamin,16,0,35,19
1656284166107,MATH 20E,B02,083774,Ciotti; Benjamin,15,0,35,20
1656284172131,MATH 103A,A01,083777,Greenfeld; Be'Eri,1,0,36,35
1656284172131,MATH 103A,A02,083778,Greenfeld; Be'Eri,2,0,36,34
1656284172131,MATH 103A,A03,093561,Staff,5,0,36,31
1656284172131,MATH 103A,B01,083779,Greenfeld; Be'Eri,8,0,36,28
1656284172131,MATH 103A,B02,083780,Greenfeld; Be'Eri,0,0,36,36
1656284172131,MATH 103A,B03,093562,Staff,0,0,36,36
1656284178154,MATH 105,A01,085443,Carter; Anne Toulson,5,0,35,30
1656284178154,MATH 105,A02,093477,Staff,14,0,35,21
1656284184179,MATH 109,A01,083213,Ganzberger; Geoffrey Michael,1,0,34,33
1656284184179,MATH 109,A02,083214,Ganzberger; Geoffrey Michael,0,0,34,34
1656284184179,MATH 109,A03,093478,Staff,2,0,34,32
1656284184179,MATH 109,B01,083215,Ganzberger; Geoffrey Michael,4,0,32,28
1656284184179,MATH 109,B02,083216,Ganzberger; Geoffrey Michael,1,0,32,31
1656284184179,MATH 109,B03,093479,Staff,3,0,32,29
1656284190202,MATH 142A,A01,083219,Chow; Bennett,1,0,32,31
1656284190202,MATH 142A,A02,083220,Chow; Bennett,8,0,32,24
1656284190202,MATH 142A,A03,093480,Staff,5,0,32,27
1656284190202,MATH 142A,B03,093481,Staff,3,0,32,29
1656284190202,MATH 142A,B04,093558,Staff,6,0,32,26
1656284190202,MATH 142A,B05,093559,Staff,0,0,32,32
1656284196227,MATH 193A,A01,083224,Rotar; Vladimir,0,1,34,34
1656284196227,MATH 193A,A02,083225,Rotar; Vladimir,0,0,34,34
1656284196227,MATH 193A,A03,083781,Rotar; Vladimir,0,0,34,34
1656284196227,MATH 193A,A04,083782,Rotar; Vladimir,6,0,34,28
1656284196227,MATH 193A,A05,093482,Rotar; Vladimir,0,0,34,34
1656284202248,MATH 197,001,091859,McAuley; Julian John,9999,0,9999,0
1656284202248,MATH 197,002,095566,Kedlaya; Kiran S.,9997,0,9999,2
1656284202248,MATH 197,003,095567,Xiao; Ming,9999,0,9999,0
1656284202248,MATH 197,004,095571,Perols; Johan Lars,9998,0,9999,1
1656284209302,COGS 9,A01,083615,Shannon; Kyle Michael,4,0,75,71
1656284215332,COGS 11,A01,083617,Boyle; Mary E. T.,15,0,48,33
1656284221358,COGS 13,A01,083071,Bastos; Amalia Pinkusfeld,5,0,71,66
1656284227381,COGS 14A,A01,092681,Semenuks; Arturs,1,13,100,99
1656284233407,COGS 14B,A01,083073,Cheng; Tzu-Han,7,0,63,56
1656284239434,COGS 17,A01,092677,Semenuks; Arturs,7,0,81,74
1656284245457,COGS 100,A01,083619,Allen; Michael Gordon,2,0,70,68
1656284251481,COGS 101A,A01,083621,Davis; Joshua Daniel,4,0,68,64
1656284257506,COGS 101B,A01,091572,Allen; Michael Gordon,4,0,65,61
1656284263532,COGS 101C,A01,083625,Delgado; Tania,10,0,35,25
1656284269558,COGS 107A,A01,083627,Boyle; Mary E. T.,0,0,60,60
1656284275581,COGS 118A,A01,083075,Gupta; Anjum,8,0,76,68
1656284281605,CSE 3,A50,083646,Miranda; Gregory Joseph,18,0,50,32
1656284287627,CSE 8A,A50,083650,Miranda; Gregory Joseph,2,2,56,54
1656284293655,CSE 11,A01,083080,Cao; Yingjun,0,48,40,40
1656284299677,CSE 12,A01,083652,Krause-Levy; Sophia Louisa,5,1,120,115
1656284305703,CSE 15L,A01,083654,Morris; Justin Loren,2,0,50,48
1656284305703,CSE 15L,A02,083655,Morris; Justin Loren,4,0,50,46
1656284311726,CSE 20,A01,083657,Tran; Khoa Dang,30,0,80,50
1656284317753,CSE 21,A01,095574,Bach; Quang Tran,23,0,48,25
1656284323777,CSE 30,A01,083084,Eldon; John,2,6,80,78
1656284323777,CSE 30,B01,095061,Bhaskar; Nishant,0,1,50,50
1656284329804,CSE 100,A01,083659,Cao; Yingjun,1,18,70,69
1656284335826,CSE 134B,A01,083661,Powell; Thomas Allan,6,0,100,94
1656284341853,CSE 140,A01,083663,Gungor; Onat,8,0,85,77
1656284347877,CSE 140L,A01,083088,Eldon; John,10,0,100,90
1656284353901,CSE 175,A01,083665,Kumar; Rakesh,0,0,25,25
1656284359924,CSE 190,A00,092507,Dubnov; Shlomo,3,0,20,17
1656284365960,ECE 45,A01,083139,Congero; Spencer William,1,0,75,74
1656284371984,ECE 65,A50,083695,Saad; Andrew S,9,0,30,21
1656284371984,ECE 65,A51,095125,Staff,24,0,26,2
1656284378011,ECE 109,A01,091882,Touri; Behrouz,1,1,70,69
1656284384039,ECE 180,A00,083140,Abi Samra; Nicholas Camill,2,0,30,28
1656284384039,ECE 180,B00,083141,Abi Samra; Nicholas Camill,0,4,30,30
1656284390064,MATH 10A,A01,083735,Patchell; Gregory David,0,0,30,30
1656284390064,MATH 10A,A02,083736,Patchell; Gregory David,22,0,30,8
1656284390064,MATH 10A,A03,083737,Patchell; Gregory David,16,0,30,14
1656284396097,MATH 10B,A01,083207,Lim; Seonhee,1,0,34,33
1656284396097,MATH 10B,A02,083208,Lim; Seonhee,7,0,35,28
1656284396097,MATH 10B,A03,093472,Staff,1,0,34,33
1656284396097,MATH 10B,B01,083739,Sinha; Shubham,11,0,30,19
1656284402125,MATH 18,A01,083743,Cinel; Cameron Alexander,7,0,30,23
1656284402125,MATH 18,A02,083744,Cinel; Cameron Alexander,9,0,30,21
1656284402125,MATH 18,A03,083745,Cinel; Cameron Alexander,5,0,30,25
1656284402125,MATH 18,B01,083748,Rideout; David Porter,1,0,36,35
1656284402125,MATH 18,B02,083749,Rideout; David Porter,0,0,36,36
1656284402125,MATH 18,B03,083750,Rideout; David Porter,0,0,36,36
1656284402125,MATH 18,B04,083751,Rideout; David Porter,0,1,36,36
1656284402125,MATH 18,B05,093473,Rideout; David Porter,0,0,36,36
1656284402125,MATH 18,B06,093474,Rideout; David Porter,3,0,36,33
1656284408152,MATH 20A,A01,083754,Zheng; Zequn,11,0,40,29
1656284414180,MATH 20B,A01,083756,Briones; Jor-el Thomas Caparas,0,0,36,36
1656284414180,MATH 20B,A02,083757,Briones; Jor-el Thomas Caparas,0,0,36,36
1656284414180,MATH 20B,A03,093475,Staff,0,0,36,36
1656284420205,MATH 20C,A01,083760,Briones; Jor-el Thomas Caparas,0,0,35,35
1656284420205,MATH 20C,A02,083761,Briones; Jor-el Thomas Caparas,9,1,35,26
1656284420205,MATH 20C,A03,093476,Staff,0,0,35,35
1656284420205,MATH 20C,B01,083762,Bach; Quang Tran,1,0,30,29
1656284426233,MATH 20D,A01,083765,Tran; Brian Kha,1,0,30,29
1656284426233,MATH 20D,A02,083766,Tran; Brian Kha,0,1,30,30
1656284426233,MATH 20D,A03,083767,Tran; Brian Kha,2,0,30,28
1656284432259,MATH 20E,A01,083771,Ganguly; Soumya,3,0,32,29
1656284432259,MATH 20E,A02,083772,Ganguly; Soumya,0,0,32,32
1656284432259,MATH 20E,B01,083773,Ciotti; Benjamin,16,0,35,19
1656284432259,MATH 20E,B02,083774,Ciotti; Benjamin,15,0,35,20
1656284438288,MATH 103A,A01,083777,Greenfeld; Be'Eri,1,0,36,35
1656284438288,MATH 103A,A02,083778,Greenfeld; Be'Eri,2,0,36,34
1656284438288,MATH 103A,A03,093561,Staff,5,0,36,31
1656284438288,MATH 103A,B01,083779,Greenfeld; Be'Eri,8,0,36,28
1656284438288,MATH 103A,B02,083780,Greenfeld; Be'Eri,0,0,36,36
1656284438288,MATH 103A,B03,093562,Staff,0,0,36,36
1656284444329,MATH 105,A01,085443,Carter; Anne Toulson,5,0,35,30
1656284444329,MATH 105,A02,093477,Staff,14,0,35,21
1656284450351,MATH 109,A01,083213,Ganzberger; Geoffrey Michael,1,0,34,33
1656284450351,MATH 109,A02,083214,Ganzberger; Geoffrey Michael,0,0,34,34
1656284450351,MATH 109,A03,093478,Staff,2,0,34,32
1656284450351,MATH 109,B01,083215,Ganzberger; Geoffrey Michael,4,0,32,28
1656284450351,MATH 109,B02,083216,Ganzberger; Geoffrey Michael,1,0,32,31
1656284450351,MATH 109,B03,093479,Staff,3,0,32,29
1656284456375,MATH 142A,A01,083219,Chow; Bennett,1,0,32,31
1656284456375,MATH 142A,A02,083220,Chow; Bennett,8,0,32,24
1656284456375,MATH 142A,A03,093480,Staff,5,0,32,27
1656284456375,MATH 142A,B03,093481,Staff,3,0,32,29
1656284456375,MATH 142A,B04,093558,Staff,6,0,32,26
1656284456375,MATH 142A,B05,093559,Staff,0,0,32,32
1656284462400,MATH 193A,A01,083224,Rotar; Vladimir,0,1,34,34
1656284462400,MATH 193A,A02,083225,Rotar; Vladimir,0,0,34,34
1656284462400,MATH 193A,A03,083781,Rotar; Vladimir,0,0,34,34
1656284462400,MATH 193A,A04,083782,Rotar; Vladimir,6,0,34,28
1656284462400,MATH 193A,A05,093482,Rotar; Vladimir,0,0,34,34
1656284468431,MATH 197,001,091859,McAuley; Julian John,9999,0,9999,0
1656284468431,MATH 197,002,095566,Kedlaya; Kiran S.,9997,0,9999,2
1656284468431,MATH 197,003,095567,Xiao; Ming,9999,0,9999,0
1656284468431,MATH 197,004,095571,Perols; Johan Lars,9998,0,9999,1
1656284475492,COGS 9,A01,083615,Shannon; Kyle Michael,4,0,75,71
1656284481520,COGS 11,A01,083617,Boyle; Mary E. T.,15,0,48,33
1656284487544,COGS 13,A01,083071,Bastos; Amalia Pinkusfeld,5,0,71,66
1656284493570,COGS 14A,A01,092681,Semenuks; Arturs,1,13,100,99
1656284499593,COGS 14B,A01,083073,Cheng; Tzu-Han,7,0,63,56
1656284505617,COGS 17,A01,092677,Semenuks; Arturs,7,0,81,74
1656284511641,COGS 100,A01,083619,Allen; Michael Gordon,2,0,70,68
1656284517668,COGS 101A,A01,083621,Davis; Joshua Daniel,4,0,68,64
1656284523692,COGS 101B,A01,091572,Allen; Michael Gordon,4,0,65,61
1656284529718,COGS 101C,A01,083625,Delgado; Tania,10,0,35,25
1656284535741,COGS 107A,A01,083627,Boyle; Mary E. T.,0,0,60,60
1656284541763,COGS 118A,A01,083075,Gupta; Anjum,8,0,76,68
1656284547863,CSE 3,A50,083646,Miranda; Gregory Joseph,18,0,50,32
1656284553891,CSE 8A,A50,083650,Miranda; Gregory Joseph,2,2,56,54
1656284559915,CSE 11,A01,083080,Cao; Yingjun,0,48,40,40
1656284565941,CSE 12,A01,083652,Krause-Levy; Sophia Louisa,5,1,120,115
1656284571968,CSE 15L,A01,083654,Morris; Justin Loren,2,0,50,48
1656284571968,CSE 15L,A02,083655,Morris; Justin Loren,4,0,50,46
1656284577992,CSE 20,A01,083657,Tran; Khoa Dang,30,0,80,50
1656284584016,CSE 21,A01,095574,Bach; Quang Tran,23,0,48,25
1656284590044,CSE 30,A01,083084,Eldon; John,2,6,80,78
1656284590044,CSE 30,B01,095061,Bhaskar; Nishant,0,1,50,50
1656284596071,CSE 100,A01,083659,Cao; Yingjun,1,18,70,69
1656284602097,CSE 134B,A01,083661,Powell; Thomas Allan,6,0,100,94
1656284608124,CSE 140,A01,083663,Gungor; Onat,8,0,85,77
1656284614147,CSE 140L,A01,083088,Eldon; John,10,0,100,90
1656284620175,CSE 175,A01,083665,Kumar; Rakesh,0,0,25,25
1656284626200,CSE 190,A00,092507,Dubnov; Shlomo,3,0,20,17
1656284632226,ECE 45,A01,083139,Congero; Spencer William,1,0,75,74
1656284638251,ECE 65,A50,083695,Saad; Andrew S,9,0,30,21
1656284638251,ECE 65,A51,095125,Staff,24,0,26,2
1656284644274,ECE 109,A01,091882,Touri; Behrouz,1,1,70,69
1656284650298,ECE 180,A00,083140,Abi Samra; Nicholas Camill,2,0,30,28
1656284650298,ECE 180,B00,083141,Abi Samra; Nicholas Camill,0,4,30,30
1656284656322,MATH 10A,A01,083735,Patchell; Gregory David,0,0,30,30
1656284656322,MATH 10A,A02,083736,Patchell; Gregory David,22,0,30,8
1656284656322,MATH 10A,A03,083737,Patchell; Gregory David,16,0,30,14
1656284662346,MATH 10B,A01,083207,Lim; Seonhee,1,0,34,33
1656284662346,MATH 10B,A02,083208,Lim; Seonhee,7,0,35,28
1656284662346,MATH 10B,A03,093472,Staff,1,0,34,33
1656284662346,MATH 10B,B01,083739,Sinha; Shubham,11,0,30,19
1656284668370,MATH 18,A01,083743,Cinel; Cameron Alexander,7,0,30,23
1656284668370,MATH 18,A02,083744,Cinel; Cameron Alexander,9,0,30,21
1656284668370,MATH 18,A03,083745,Cinel; Cameron Alexander,5,0,30,25
1656284668370,MATH 18,B01,083748,Rideout; David Porter,1,0,36,35
1656284668370,MATH 18,B02,083749,Rideout; David Porter,0,0,36,36
1656284668370,MATH 18,B03,083750,Rideout; David Porter,0,0,36,36
1656284668370,MATH 18,B04,083751,Rideout; David Porter,0,1,36,36
1656284668370,MATH 18,B05,093473,Rideout; David Porter,0,0,36,36
1656284668370,MATH 18,B06,093474,Rideout; David Porter,3,0,36,33
1656284674397,MATH 20A,A01,083754,Zheng; Zequn,11,0,40,29
1656284680425,MATH 20B,A01,083756,Briones; Jor-el Thomas Caparas,0,0,36,36
1656284680425,MATH 20B,A02,083757,Briones; Jor-el Thomas Caparas,0,0,36,36
1656284680425,MATH 20B,A03,093475,Staff,0,0,36,36
1656284686448,MATH 20C,A01,083760,Briones; Jor-el Thomas Caparas,0,0,35,35
1656284686448,MATH 20C,A02,083761,Briones; Jor-el Thomas Caparas,9,1,35,26
1656284686448,MATH 20C,A03,093476,Staff,0,0,35,35
1656284686448,MATH 20C,B01,083762,Bach; Quang Tran,1,0,30,29
1656284692476,MATH 20D,A01,083765,Tran; Brian Kha,1,0,30,29
1656284692476,MATH 20D,A02,083766,Tran; Brian Kha,0,1,30,30
1656284692476,MATH 20D,A03,083767,Tran; Brian Kha,2,0,30,28
1656284698498,MATH 20E,A01,083771,Ganguly; Soumya,3,0,32,29
1656284698498,MATH 20E,A02,083772,Ganguly; Soumya,0,0,32,32
1656284698498,MATH 20E,B01,083773,Ciotti; Benjamin,16,0,35,19
1656284698498,MATH 20E,B02,083774,Ciotti; Benjamin,15,0,35,20
1656284704530,MATH 103A,A01,083777,Greenfeld; Be'Eri,1,0,36,35
1656284704530,MATH 103A,A02,083778,Greenfeld; Be'Eri,2,0,36,34
1656284704530,MATH 103A,A03,093561,Staff,5,0,36,31
1656284704530,MATH 103A,B01,083779,Greenfeld; Be'Eri,8,0,36,28
1656284704530,MATH 103A,B02,083780,Greenfeld; Be'Eri,0,0,36,36
1656284704530,MATH 103A,B03,093562,Staff,0,0,36,36
1656284710554,MATH 105,A01,085443,Carter; Anne Toulson,5,0,35,30
1656284710554,MATH 105,A02,093477,Staff,14,0,35,21
1656284716580,MATH 109,A01,083213,Ganzberger; Geoffrey Michael,1,0,34,33
1656284716580,MATH 109,A02,083214,Ganzberger; Geoffrey Michael,0,0,34,34
1656284716580,MATH 109,A03,093478,Staff,2,0,34,32
1656284716580,MATH 109,B01,083215,Ganzberger; Geoffrey Michael,4,0,32,28
1656284716580,MATH 109,B02,083216,Ganzberger; Geoffrey Michael,1,0,32,31
1656284716580,MATH 109,B03,093479,Staff,3,0,32,29
1656284722604,MATH 142A,A01,083219,Chow; Bennett,1,0,32,31
1656284722604,MATH 142A,A02,083220,Chow; Bennett,8,0,32,24
1656284722604,MATH 142A,A03,093480,Staff,5,0,32,27
1656284722604,MATH 142A,B03,093481,Staff,3,0,32,29
1656284722604,MATH 142A,B04,093558,Staff,6,0,32,26
1656284722604,MATH 142A,B05,093559,Staff,0,0,32,32
1656284728632,MATH 193A,A01,083224,Rotar; Vladimir,0,1,34,34
1656284728632,MATH 193A,A02,083225,Rotar; Vladimir,0,0,34,34
1656284728632,MATH 193A,A03,083781,Rotar; Vladimir,0,0,34,34
1656284728632,MATH 193A,A04,083782,Rotar; Vladimir,6,0,34,28
1656284728632,MATH 193A,A05,093482,Rotar; Vladimir,0,0,34,34
1656284734659,MATH 197,001,091859,McAuley; Julian John,9999,0,9999,0
1656284734659,MATH 197,002,095566,Kedlaya; Kiran S.,9997,0,9999,2
1656284734659,MATH 197,003,095567,Xiao; Ming,9999,0,9999,0
1656284734659,MATH 197,004,095571,Perols; Johan Lars,9998,0,9999,1
1656284741711,COGS 9,A01,083615,Shannon; Kyle Michael,4,0,75,71
1656284747734,COGS 11,A01,083617,Boyle; Mary E. T.,15,0,48,33
1656284753762,COGS 13,A01,083071,Bastos; Amalia Pinkusfeld,5,0,71,66
1656284759788,COGS 14A,A01,092681,Semenuks; Arturs,1,13,100,99
1656284765815,COGS 14B,A01,083073,Cheng; Tzu-Han,7,0,63,56
1656284771840,COGS 17,A01,092677,Semenuks; Arturs,7,0,81,74
1656284777863,COGS 100,A01,083619,Allen; Michael Gordon,2,0,70,68
1656284783887,COGS 101A,A01,083621,Davis; Joshua Daniel,4,0,68,64
1656284789911,COGS 101B,A01,091572,Allen; Michael Gordon,4,0,65,61
1656284795937,COGS 101C,A01,083625,Delgado; Tania,10,0,35,25
1656284801962,COGS 107A,A01,083627,Boyle; Mary E. T.,0,0,60,60
1656284807985,COGS 118A,A01,083075,Gupta; Anjum,8,0,76,68
1656284814010,CSE 3,A50,083646,Miranda; Gregory Joseph,18,0,50,32
1656284820038,CSE 8A,A50,083650,Miranda; Gregory Joseph,2,2,56,54
1656284826066,CSE 11,A01,083080,Cao; Yingjun,0,48,40,40
1656284832091,CSE 12,A01,083652,Krause-Levy; Sophia Louisa,5,1,120,115
1656284838122,CSE 15L,A01,083654,Morris; Justin Loren,2,0,50,48
1656284838122,CSE 15L,A02,083655,Morris; Justin Loren,4,0,50,46
1656284844150,CSE 20,A01,083657,Tran; Khoa Dang,30,0,80,50
1656284850174,CSE 21,A01,095574,Bach; Quang Tran,23,0,48,25
1656284856197,CSE 30,A01,083084,Eldon; John,2,6,80,78
1656284856197,CSE 30,B01,095061,Bhaskar; Nishant,0,1,50,50
1656284862221,CSE 100,A01,083659,Cao; Yingjun,1,18,70,69
1656284868245,CSE 134B,A01,083661,Powell; Thomas Allan,6,0,100,94
1656284874271,CSE 140,A01,083663,Gungor; Onat,8,0,85,77
1656284880318,CSE 140L,A01,083088,Eldon; John,10,0,100,90
1656284886341,CSE 175,A01,083665,Kumar; Rakesh,0,0,25,25
1656284892367,CSE 190,A00,092507,Dubnov; Shlomo,3,0,20,17
1656284898393,ECE 45,A01,083139,Congero; Spencer William,1,0,75,74
1656284904419,ECE 65,A50,083695,Saad; Andrew S,9,0,30,21
1656284904419,ECE 65,A51,095125,Staff,24,0,26,2
1656284910444,ECE 109,A01,091882,Touri; Behrouz,1,1,70,69
1656284916480,ECE 180,A00,083140,Abi Samra; Nicholas Camill,2,0,30,28
1656284916480,ECE 180,B00,083141,Abi Samra; Nicholas Camill,0,4,30,30
1656284922505,MATH 10A,A01,083735,Patchell; Gregory David,0,0,30,30
1656284922505,MATH 10A,A02,083736,Patchell; Gregory David,22,0,30,8
1656284922505,MATH 10A,A03,083737,Patchell; Gregory David,16,0,30,14
1656284928540,MATH 10B,A01,083207,Lim; Seonhee,1,0,34,33
1656284928540,MATH 10B,A02,083208,Lim; Seonhee,7,0,35,28
1656284928540,MATH 10B,A03,093472,Staff,1,0,34,33
1656284928540,MATH 10B,B01,083739,Sinha; Shubham,11,0,30,19
1656284934564,MATH 18,A01,083743,Cinel; Cameron Alexander,7,0,30,23
1656284934564,MATH 18,A02,083744,Cinel; Cameron Alexander,9,0,30,21
1656284934564,MATH 18,A03,083745,Cinel; Cameron Alexander,5,0,30,25
1656284934564,MATH 18,B01,083748,Rideout; David Porter,1,0,36,35
1656284934564,MATH 18,B02,083749,Rideout; David Porter,0,0,36,36
1656284934564,MATH 18,B03,083750,Rideout; David Porter,0,0,36,36
1656284934564,MATH 18,B04,083751,Rideout; David Porter,0,1,36,36
1656284934564,MATH 18,B05,093473,Rideout; David Porter,0,0,36,36
1656284934564,MATH 18,B06,093474,Rideout; David Porter,3,0,36,33
1656284940591,MATH 20A,A01,083754,Zheng; Zequn,11,0,40,29
1656284946614,MATH 20B,A01,083756,Briones; Jor-el Thomas Caparas,0,0,36,36
1656284946614,MATH 20B,A02,083757,Briones; Jor-el Thomas Caparas,0,0,36,36
1656284946614,MATH 20B,A03,093475,Staff,0,0,36,36
1656284952642,MATH 20C,A01,083760,Briones; Jor-el Thomas Caparas,0,0,35,35
1656284952642,MATH 20C,A02,083761,Briones; Jor-el Thomas Caparas,9,1,35,26
1656284952642,MATH 20C,A03,093476,Staff,0,0,35,35
1656284952642,MATH 20C,B01,083762,Bach; Quang Tran,1,0,30,29
1656284958671,MATH 20D,A01,083765,Tran; Brian Kha,1,0,30,29
1656284958671,MATH 20D,A02,083766,Tran; Brian Kha,0,1,30,30
1656284958671,MATH 20D,A03,083767,Tran; Brian Kha,2,0,30,28
1656284964696,MATH 20E,A01,083771,Ganguly; Soumya,3,0,32,29
1656284964696,MATH 20E,A02,083772,Ganguly; Soumya,0,0,32,32
1656284964696,MATH 20E,B01,083773,Ciotti; Benjamin,16,0,35,19
1656284964696,MATH 20E,B02,083774,Ciotti; Benjamin,15,0,35,20
1656284970727,MATH 103A,A01,083777,Greenfeld; Be'Eri,1,0,36,35
1656284970727,MATH 103A,A02,083778,Greenfeld; Be'Eri,2,0,36,34
1656284970727,MATH 103A,A03,093561,Staff,5,0,36,31
1656284970727,MATH 103A,B01,083779,Greenfeld; Be'Eri,8,0,36,28
1656284970727,MATH 103A,B02,083780,Greenfeld; Be'Eri,0,0,36,36
1656284970727,MATH 103A,B03,093562,Staff,0,0,36,36
1656284976756,MATH 105,A01,085443,Carter; Anne Toulson,5,0,35,30
1656284976756,MATH 105,A02,093477,Staff,14,0,35,21
1656284982787,MATH 109,A01,083213,Ganzberger; Geoffrey Michael,1,0,34,33
1656284982787,MATH 109,A02,083214,Ganzberger; Geoffrey Michael,0,0,34,34
1656284982787,MATH 109,A03,093478,Staff,2,0,34,32
1656284982787,MATH 109,B01,083215,Ganzberger; Geoffrey Michael,4,0,32,28
1656284982787,MATH 109,B02,083216,Ganzberger; Geoffrey Michael,1,0,32,31
1656284982787,MATH 109,B03,093479,Staff,3,0,32,29
1656284988812,MATH 142A,A01,083219,Chow; Bennett,1,0,32,31
1656284988812,MATH 142A,A02,083220,Chow; Bennett,8,0,32,24
1656284988812,MATH 142A,A03,093480,Staff,5,0,32,27
1656284988812,MATH 142A,B03,093481,Staff,3,0,32,29
1656284988812,MATH 142A,B04,093558,Staff,6,0,32,26
1656284988812,MATH 142A,B05,093559,Staff,0,0,32,32
1656284994836,MATH 193A,A01,083224,Rotar; Vladimir,0,1,34,34
1656284994836,MATH 193A,A02,083225,Rotar; Vladimir,0,0,34,34
1656284994836,MATH 193A,A03,083781,Rotar; Vladimir,0,0,34,34
1656284994836,MATH 193A,A04,083782,Rotar; Vladimir,6,0,34,28
1656284994836,MATH 193A,A05,093482,Rotar; Vladimir,0,0,34,34
1656285000859,MATH 197,001,091859,McAuley; Julian John,9999,0,9999,0
1656285000859,MATH 197,002,095566,Kedlaya; Kiran S.,9997,0,9999,2
1656285000859,MATH 197,003,095567,Xiao; Ming,9999,0,9999,0
1656285000859,MATH 197,004,095571,Perols; Johan Lars,9998,0,9999,1
1656285007918,COGS 9,A01,083615,Shannon; Kyle Michael,4,0,75,71
1656285013944,COGS 11,A01,083617,Boyle; Mary E. T.,15,0,48,33
1656285019968,COGS 13,A01,083071,Bastos; Amalia Pinkusfeld,5,0,71,66
1656285025990,COGS 14A,A01,092681,Semenuks; Arturs,1,13,100,99
1656285032017,COGS 14B,A01,083073,Cheng; Tzu-Han,7,0,63,56
1656285038047,COGS 17,A01,092677,Semenuks; Arturs,7,0,81,74
1656285044070,COGS 100,A01,083619,Allen; Michael Gordon,2,0,70,68
1656285050105,COGS 101A,A01,083621,Davis; Joshua Daniel,4,0,68,64
1656285056133,COGS 101B,A01,091572,Allen; Michael Gordon,4,0,65,61
1656285062155,COGS 101C,A01,083625,Delgado; Tania,10,0,35,25
1656285068180,COGS 107A,A01,083627,Boyle; Mary E. T.,0,0,60,60
1656285074203,COGS 118A,A01,083075,Gupta; Anjum,8,0,76,68
1656285080230,CSE 3,A50,083646,Miranda; Gregory Joseph,18,0,50,32
1656285086254,CSE 8A,A50,083650,Miranda; Gregory Joseph,2,2,56,54
1656285092277,CSE 11,A01,083080,Cao; Yingjun,0,48,40,40
1656285098304,CSE 12,A01,083652,Krause-Levy; Sophia Louisa,5,1,120,115
1656285104328,CSE 15L,A01,083654,Morris; Justin Loren,2,0,50,48
1656285104328,CSE 15L,A02,083655,Morris; Justin Loren,4,0,50,46
1656285110351,CSE 20,A01,083657,Tran; Khoa Dang,30,0,80,50
1656285116375,CSE 21,A01,095574,Bach; Quang Tran,23,0,48,25
1656285122399,CSE 30,A01,083084,Eldon; John,2,6,80,78
1656285122399,CSE 30,B01,095061,Bhaskar; Nishant,0,1,50,50
1656285128424,CSE 100,A01,083659,Cao; Yingjun,1,18,70,69
1656285134448,CSE 134B,A01,083661,Powell; Thomas Allan,6,0,100,94
1656285140472,CSE 140,A01,083663,Gungor; Onat,8,0,85,77
1656285146572,CSE 140L,A01,083088,Eldon; John,10,0,100,90
1656285152600,CSE 175,A01,083665,Kumar; Rakesh,0,0,25,25
1656285158623,CSE 190,A00,092507,Dubnov; Shlomo,3,0,20,17
1656285164652,ECE 45,A01,083139,Congero; Spencer William,1,0,75,74
1656285170680,ECE 65,A50,083695,Saad; Andrew S,9,0,30,21
1656285170680,ECE 65,A51,095125,Staff,24,0,26,2
1656285176706,ECE 109,A01,091882,Touri; Behrouz,1,1,70,69
1656285182731,ECE 180,A00,083140,Abi Samra; Nicholas Camill,2,0,30,28
1656285182731,ECE 180,B00,083141,Abi Samra; Nicholas Camill,0,4,30,30
1656285188758,MATH 10A,A01,083735,Patchell; Gregory David,0,0,30,30
1656285188758,MATH 10A,A02,083736,Patchell; Gregory David,22,0,30,8
1656285188758,MATH 10A,A03,083737,Patchell; Gregory David,16,0,30,14
1656285194782,MATH 10B,A01,083207,Lim; Seonhee,1,0,34,33
1656285194782,MATH 10B,A02,083208,Lim; Seonhee,7,0,35,28
1656285194782,MATH 10B,A03,093472,Staff,1,0,34,33
1656285194782,MATH 10B,B01,083739,Sinha; Shubham,11,0,30,19
1656285200814,MATH 18,A01,083743,Cinel; Cameron Alexander,7,0,30,23
1656285200814,MATH 18,A02,083744,Cinel; Cameron Alexander,9,0,30,21
1656285200814,MATH 18,A03,083745,Cinel; Cameron Alexander,5,0,30,25
1656285200814,MATH 18,B01,083748,Rideout; David Porter,1,0,36,35
1656285200814,MATH 18,B02,083749,Rideout; David Porter,0,0,36,36
1656285200814,MATH 18,B03,083750,Rideout; David Porter,0,0,36,36
1656285200814,MATH 18,B04,083751,Rideout; David Porter,0,1,36,36
1656285200814,MATH 18,B05,093473,Rideout; David Porter,0,0,36,36
1656285200814,MATH 18,B06,093474,Rideout; David Porter,3,0,36,33
1656285206842,MATH 20A,A01,083754,Zheng; Zequn,11,0,40,29
1656285212868,MATH 20B,A01,083756,Briones; Jor-el Thomas Caparas,0,0,36,36
1656285212868,MATH 20B,A02,083757,Briones; Jor-el Thomas Caparas,0,0,36,36
1656285212868,MATH 20B,A03,093475,Staff,0,0,36,36
1656285218913,MATH 20C,A01,083760,Briones; Jor-el Thomas Caparas,0,0,35,35
1656285218913,MATH 20C,A02,083761,Briones; Jor-el Thomas Caparas,9,1,35,26
1656285218913,MATH 20C,A03,093476,Staff,0,0,35,35
1656285218913,MATH 20C,B01,083762,Bach; Quang Tran,1,0,30,29
1656285224937,MATH 20D,A01,083765,Tran; Brian Kha,1,0,30,29
1656285224937,MATH 20D,A02,083766,Tran; Brian Kha,0,1,30,30
1656285224937,MATH 20D,A03,083767,Tran; Brian Kha,2,0,30,28
1656285230960,MATH 20E,A01,083771,Ganguly; Soumya,3,0,32,29
1656285230960,MATH 20E,A02,083772,Ganguly; Soumya,0,0,32,32
1656285230960,MATH 20E,B01,083773,Ciotti; Benjamin,16,0,35,19
1656285230960,MATH 20E,B02,083774,Ciotti; Benjamin,15,0,35,20
1656285237000,MATH 103A,A01,083777,Greenfeld; Be'Eri,1,0,36,35
1656285237000,MATH 103A,A02,083778,Greenfeld; Be'Eri,2,0,36,34
1656285237000,MATH 103A,A03,093561,Staff,5,0,36,31
1656285237000,MATH 103A,B01,083779,Greenfeld; Be'Eri,8,0,36,28
1656285237000,MATH 103A,B02,083780,Greenfeld; Be'Eri,0,0,36,36
1656285237000,MATH 103A,B03,093562,Staff,0,0,36,36
1656285243026,MATH 105,A01,085443,Carter; Anne Toulson,5,0,35,30
1656285243026,MATH 105,A02,093477,Staff,14,0,35,21
1656285249050,MATH 109,A01,083213,Ganzberger; Geoffrey Michael,1,0,34,33
1656285249050,MATH 109,A02,083214,Ganzberger; Geoffrey Michael,0,0,34,34
1656285249050,MATH 109,A03,093478,Staff,2,0,34,32
1656285249050,MATH 109,B01,083215,Ganzberger; Geoffrey Michael,4,0,32,28
1656285249050,MATH 109,B02,083216,Ganzberger; Geoffrey Michael,1,0,32,31
1656285249050,MATH 109,B03,093479,Staff,3,0,32,29
1656285255079,MATH 142A,A01,083219,Chow; Bennett,1,0,32,31
1656285255079,MATH 142A,A02,083220,Chow; Bennett,8,0,32,24
1656285255079,MATH 142A,A03,093480,Staff,5,0,32,27
1656285255079,MATH 142A,B03,093481,Staff,3,0,32,29
1656285255079,MATH 142A,B04,093558,Staff,6,0,32,26
1656285255079,MATH 142A,B05,093559,Staff,0,0,32,32
1656285261110,MATH 193A,A01,083224,Rotar; Vladimir,0,1,34,34
1656285261110,MATH 193A,A02,083225,Rotar; Vladimir,0,0,34,34
1656285261110,MATH 193A,A03,083781,Rotar; Vladimir,0,0,34,34
1656285261110,MATH 193A,A04,083782,Rotar; Vladimir,6,0,34,28
1656285261110,MATH 193A,A05,093482,Rotar; Vladimir,0,0,34,34
1656285267133,MATH 197,001,091859,McAuley; Julian John,9999,0,9999,0
1656285267133,MATH 197,002,095566,Kedlaya; Kiran S.,9997,0,9999,2
1656285267133,MATH 197,003,095567,Xiao; Ming,9999,0,9999,0
1656285267133,MATH 197,004,095571,Perols; Johan Lars,9998,0,9999,1
1656285274197,COGS 9,A01,083615,Shannon; Kyle Michael,4,0,75,71
1656285280225,COGS 11,A01,083617,Boyle; Mary E. T.,15,0,48,33
1656285286252,COGS 13,A01,083071,Bastos; Amalia Pinkusfeld,5,0,71,66
1656285292275,COGS 14A,A01,092681,Semenuks; Arturs,1,13,100,99
1656285298304,COGS 14B,A01,083073,Cheng; Tzu-Han,7,0,63,56
1656285304330,COGS 17,A01,092677,Semenuks; Arturs,7,0,81,74
1656285310353,COGS 100,A01,083619,Allen; Michael Gordon,2,0,70,68
1656285316377,COGS 101A,A01,083621,Davis; Joshua Daniel,4,0,68,64
1656285322400,COGS 101B,A01,091572,Allen; Michael Gordon,4,0,65,61
1656285328426,COGS 101C,A01,083625,Delgado; Tania,10,0,35,25
1656285334450,COGS 107A,A01,083627,Boyle; Mary E. T.,0,0,60,60
1656285340476,COGS 118A,A01,083075,Gupta; Anjum,8,0,76,68
1656285346498,CSE 3,A50,083646,Miranda; Gregory Joseph,18,0,50,32
1656285352522,CSE 8A,A50,083650,Miranda; Gregory Joseph,2,2,56,54
1656285358547,CSE 11,A01,083080,Cao; Yingjun,0,48,40,40
1656285364573,CSE 12,A01,083652,Krause-Levy; Sophia Louisa,5,1,120,115
1656285370595,CSE 15L,A01,083654,Morris; Justin Loren,2,0,50,48
1656285370595,CSE 15L,A02,083655,Morris; Justin Loren,4,0,50,46
1656285376621,CSE 20,A01,083657,Tran; Khoa Dang,30,0,80,50
1656285382644,CSE 21,A01,095574,Bach; Quang Tran,23,0,48,25
1656285388668,CSE 30,A01,083084,Eldon; John,2,6,80,78
1656285388668,CSE 30,B01,095061,Bhaskar; Nishant,0,1,50,50
1656285394697,CSE 100,A01,083659,Cao; Yingjun,1,18,70,69
1656285400720,CSE 134B,A01,083661,Powell; Thomas Allan,6,0,100,94
1656285406744,CSE 140,A01,083663,Gungor; Onat,8,0,85,77
1656285412769,CSE 140L,A01,083088,Eldon; John,10,0,100,90
1656285418796,CSE 175,A01,083665,Kumar; Rakesh,0,0,25,25
1656285424821,CSE 190,A00,092507,Dubnov; Shlomo,3,0,20,17
1656285430845,ECE 45,A01,083139,Congero; Spencer William,1,0,75,74
1656285436869,ECE 65,A50,083695,Saad; Andrew S,9,0,30,21
1656285436869,ECE 65,A51,095125,Staff,24,0,26,2
1656285442894,ECE 109,A01,091882,Touri; Behrouz,1,1,70,69
1656285448923,ECE 180,A00,083140,Abi Samra; Nicholas Camill,2,0,30,28
1656285448923,ECE 180,B00,083141,Abi Samra; Nicholas Camill,0,4,30,30
1656285454947,MATH 10A,A01,083735,Patchell; Gregory David,0,0,30,30
1656285454947,MATH 10A,A02,083736,Patchell; Gregory David,22,0,30,8
1656285454947,MATH 10A,A03,083737,Patchell; Gregory David,16,0,30,14
1656285460976,MATH 10B,A01,083207,Lim; Seonhee,1,0,34,33
1656285460976,MATH 10B,A02,083208,Lim; Seonhee,7,0,35,28
1656285460976,MATH 10B,A03,093472,Staff,1,0,34,33
1656285460976,MATH 10B,B01,083739,Sinha; Shubham,11,0,30,19
1656285467007,MATH 18,A01,083743,Cinel; Cameron Alexander,7,0,30,23
1656285467007,MATH 18,A02,083744,Cinel; Cameron Alexander,9,0,30,21
1656285467007,MATH 18,A03,083745,Cinel; Cameron Alexander,5,0,30,25
1656285467007,MATH 18,B01,083748,Rideout; David Porter,1,0,36,35
1656285467007,MATH 18,B02,083749,Rideout; David Porter,0,0,36,36
1656285467007,MATH 18,B03,083750,Rideout; David Porter,0,0,36,36
1656285467007,MATH 18,B04,083751,Rideout; David Porter,0,1,36,36
1656285467007,MATH 18,B05,093473,Rideout; David Porter,0,0,36,36
1656285467007,MATH 18,B06,093474,Rideout; David Porter,3,0,36,33
1656285473031,MATH 20A,A01,083754,Zheng; Zequn,11,0,40,29
1656285479059,MATH 20B,A01,083756,Briones; Jor-el Thomas Caparas,0,0,36,36
1656285479059,MATH 20B,A02,083757,Briones; Jor-el Thomas Caparas,0,0,36,36
1656285479059,MATH 20B,A03,093475,Staff,0,0,36,36
1656285485082,MATH 20C,A01,083760,Briones; Jor-el Thomas Caparas,0,0,35,35
1656285485082,MATH 20C,A02,083761,Briones; Jor-el Thomas Caparas,9,1,35,26
1656285485082,MATH 20C,A03,093476,Staff,0,0,35,35
1656285485082,MATH 20C,B01,083762,Bach; Quang Tran,1,0,30,29
1656285491106,MATH 20D,A01,083765,Tran; Brian Kha,1,0,30,29
1656285491106,MATH 20D,A02,083766,Tran; Brian Kha,0,1,30,30
1656285491106,MATH 20D,A03,083767,Tran; Brian Kha,2,0,30,28
1656285497133,MATH 20E,A01,083771,Ganguly; Soumya,3,0,32,29
1656285497133,MATH 20E,A02,083772,Ganguly; Soumya,0,0,32,32
1656285497133,MATH 20E,B01,083773,Ciotti; Benjamin,16,0,35,19
1656285497133,MATH 20E,B02,083774,Ciotti; Benjamin,15,0,35,20
1656285503163,MATH 103A,A01,083777,Greenfeld; Be'Eri,1,0,36,35
1656285503163,MATH 103A,A02,083778,Greenfeld; Be'Eri,2,0,36,34
1656285503163,MATH 103A,A03,093561,Staff,5,0,36,31
1656285503163,MATH 103A,B01,083779,Greenfeld; Be'Eri,8,0,36,28
1656285503163,MATH 103A,B02,083780,Greenfeld; Be'Eri,0,0,36,36
1656285503163,MATH 103A,B03,093562,Staff,0,0,36,36
1656285509190,MATH 105,A01,085443,Carter; Anne Toulson,5,0,35,30
1656285509190,MATH 105,A02,093477,Staff,14,0,35,21
1656285515215,MATH 109,A01,083213,Ganzberger; Geoffrey Michael,1,0,34,33
1656285515215,MATH 109,A02,083214,Ganzberger; Geoffrey Michael,0,0,34,34
1656285515215,MATH 109,A03,093478,Staff,2,0,34,32
1656285515215,MATH 109,B01,083215,Ganzberger; Geoffrey Michael,4,0,32,28
1656285515215,MATH 109,B02,083216,Ganzberger; Geoffrey Michael,1,0,32,31
1656285515215,MATH 109,B03,093479,Staff,3,0,32,29
1656285521256,MATH 142A,A01,083219,Chow; Bennett,1,0,32,31
1656285521256,MATH 142A,A02,083220,Chow; Bennett,8,0,32,24
1656285521256,MATH 142A,A03,093480,Staff,5,0,32,27
1656285521256,MATH 142A,B03,093481,Staff,3,0,32,29
1656285521256,MATH 142A,B04,093558,Staff,6,0,32,26
1656285521256,MATH 142A,B05,093559,Staff,0,0,32,32
1656285527278,MATH 193A,A01,083224,Rotar; Vladimir,0,1,34,34
1656285527278,MATH 193A,A02,083225,Rotar; Vladimir,0,0,34,34
1656285527278,MATH 193A,A03,083781,Rotar; Vladimir,0,0,34,34
1656285527278,MATH 193A,A04,083782,Rotar; Vladimir,6,0,34,28
1656285527278,MATH 193A,A05,093482,Rotar; Vladimir,0,0,34,34
1656285533306,MATH 197,001,091859,McAuley; Julian John,9999,0,9999,0
1656285533306,MATH 197,002,095566,Kedlaya; Kiran S.,9997,0,9999,2
1656285533306,MATH 197,003,095567,Xiao; Ming,9999,0,9999,0
1656285533306,MATH 197,004,095571,Perols; Johan Lars,9998,0,9999,1
1656285540362,COGS 9,A01,083615,Shannon; Kyle Michael,4,0,75,71
1656285546390,COGS 11,A01,083617,Boyle; Mary E. T.,15,0,48,33
1656285552419,COGS 13,A01,083071,Bastos; Amalia Pinkusfeld,5,0,71,66
1656285558447,COGS 14A,A01,092681,Semenuks; Arturs,1,13,100,99
1656285564474,COGS 14B,A01,083073,Cheng; Tzu-Han,7,0,63,56
1656285570500,COGS 17,A01,092677,Semenuks; Arturs,7,0,81,74
1656285576523,COGS 100,A01,083619,Allen; Michael Gordon,2,0,70,68
1656285582550,COGS 101A,A01,083621,Davis; Joshua Daniel,4,0,68,64
1656285588577,COGS 101B,A01,091572,Allen; Michael Gordon,4,0,65,61
1656285594609,COGS 101C,A01,083625,Delgado; Tania,10,0,35,25
1656285600642,COGS 107A,A01,083627,Boyle; Mary E. T.,0,0,60,60
1656285606669,COGS 118A,A01,083075,Gupta; Anjum,8,0,76,68
1656285612696,CSE 3,A50,083646,Miranda; Gregory Joseph,18,0,50,32
1656285618724,CSE 8A,A50,083650,Miranda; Gregory Joseph,2,2,56,54
1656285624747,CSE 11,A01,083080,Cao; Yingjun,0,48,40,40
1656285630772,CSE 12,A01,083652,Krause-Levy; Sophia Louisa,5,1,120,115
1656285636800,CSE 15L,A01,083654,Morris; Justin Loren,2,0,50,48
1656285636800,CSE 15L,A02,083655,Morris; Justin Loren,4,0,50,46
1656285642823,CSE 20,A01,083657,Tran; Khoa Dang,30,0,80,50
1656285648850,CSE 21,A01,095574,Bach; Quang Tran,23,0,48,25
1656285654873,CSE 30,A01,083084,Eldon; John,2,6,80,78
1656285654873,CSE 30,B01,095061,Bhaskar; Nishant,0,1,50,50
1656285660897,CSE 100,A01,083659,Cao; Yingjun,1,18,70,69
1656285666927,CSE 134B,A01,083661,Powell; Thomas Allan,6,0,100,94
1656285672957,CSE 140,A01,083663,Gungor; Onat,8,0,85,77
1656285678987,CSE 140L,A01,083088,Eldon; John,10,0,100,90
1656285685009,CSE 175,A01,083665,Kumar; Rakesh,0,0,25,25
1656285691032,CSE 190,A00,092507,Dubnov; Shlomo,3,0,20,17
1656285697059,ECE 45,A01,083139,Congero; Spencer William,1,0,75,74
1656285703088,ECE 65,A50,083695,Saad; Andrew S,9,0,30,21
1656285703088,ECE 65,A51,095125,Staff,24,0,26,2
1656285709110,ECE 109,A01,091882,Touri; Behrouz,1,1,70,69
1656285715142,ECE 180,A00,083140,Abi Samra; Nicholas Camill,2,0,30,28
1656285715142,ECE 180,B00,083141,Abi Samra; Nicholas Camill,0,4,30,30
1656285721170,MATH 10A,A01,083735,Patchell; Gregory David,0,0,30,30
1656285721170,MATH 10A,A02,083736,Patchell; Gregory David,22,0,30,8
1656285721170,MATH 10A,A03,083737,Patchell; Gregory David,16,0,30,14
1656285727199,MATH 10B,A01,083207,Lim; Seonhee,1,0,34,33
1656285727199,MATH 10B,A02,083208,Lim; Seonhee,7,0,35,28
1656285727199,MATH 10B,A03,093472,Staff,1,0,34,33
1656285727199,MATH 10B,B01,083739,Sinha; Shubham,11,0,30,19
1656285733225,MATH 18,A01,083743,Cinel; Cameron Alexander,7,0,30,23
1656285733225,MATH 18,A02,083744,Cinel; Cameron Alexander,9,0,30,21
1656285733225,MATH 18,A03,083745,Cinel; Cameron Alexander,5,0,30,25
1656285733225,MATH 18,B01,083748,Rideout; David Porter,1,0,36,35
1656285733225,MATH 18,B02,083749,Rideout; David Porter,0,0,36,36
1656285733225,MATH 18,B03,083750,Rideout; David Porter,0,0,36,36
1656285733225,MATH 18,B04,083751,Rideout; David Porter,0,1,36,36
1656285733225,MATH 18,B05,093473,Rideout; David Porter,0,0,36,36
1656285733225,MATH 18,B06,093474,Rideout; David Porter,3,0,36,33
1656285739252,MATH 20A,A01,083754,Zheng; Zequn,11,0,40,29
1656285745352,MATH 20B,A01,083756,Briones; Jor-el Thomas Caparas,0,0,36,36
1656285745352,MATH 20B,A02,083757,Briones; Jor-el Thomas Caparas,0,0,36,36
1656285745352,MATH 20B,A03,093475,Staff,0,0,36,36
1656285751380,MATH 20C,A01,083760,Briones; Jor-el Thomas Caparas,0,0,35,35
1656285751380,MATH 20C,A02,083761,Briones; Jor-el Thomas Caparas,9,1,35,26
1656285751380,MATH 20C,A03,093476,Staff,0,0,35,35
1656285751380,MATH 20C,B01,083762,Bach; Quang Tran,1,0,30,29
1656285757404,MATH 20D,A01,083765,Tran; Brian Kha,1,0,30,29
1656285757404,MATH 20D,A02,083766,Tran; Brian Kha,0,1,30,30
1656285757404,MATH 20D,A03,083767,Tran; Brian Kha,2,0,30,28
1656285763426,MATH 20E,A01,083771,Ganguly; Soumya,3,0,32,29
1656285763426,MATH 20E,A02,083772,Ganguly; Soumya,0,0,32,32
1656285763426,MATH 20E,B01,083773,Ciotti; Benjamin,16,0,35,19
1656285763426,MATH 20E,B02,083774,Ciotti; Benjamin,15,0,35,20
1656285769454,MATH 103A,A01,083777,Greenfeld; Be'Eri,1,0,36,35
1656285769454,MATH 103A,A02,083778,Greenfeld; Be'Eri,2,0,36,34
1656285769454,MATH 103A,A03,093561,Staff,5,0,36,31
1656285769454,MATH 103A,B01,083779,Greenfeld; Be'Eri,8,0,36,28
1656285769454,MATH 103A,B02,083780,Greenfeld; Be'Eri,0,0,36,36
1656285769454,MATH 103A,B03,093562,Staff,0,0,36,36
1656285775480,MATH 105,A01,085443,Carter; Anne Toulson,5,0,35,30
1656285775480,MATH 105,A02,093477,Staff,14,0,35,21
1656285781508,MATH 109,A01,083213,Ganzberger; Geoffrey Michael,1,0,34,33
1656285781508,MATH 109,A02,083214,Ganzberger; Geoffrey Michael,0,0,34,34
1656285781508,MATH 109,A03,093478,Staff,2,0,34,32
1656285781508,MATH 109,B01,083215,Ganzberger; Geoffrey Michael,4,0,32,28
1656285781508,MATH 109,B02,083216,Ganzberger; Geoffrey Michael,1,0,32,31
1656285781508,MATH 109,B03,093479,Staff,3,0,32,29
1656285787531,MATH 142A,A01,083219,Chow; Bennett,1,0,32,31
1656285787531,MATH 142A,A02,083220,Chow; Bennett,8,0,32,24
1656285787531,MATH 142A,A03,093480,Staff,5,0,32,27
1656285787531,MATH 142A,B03,093481,Staff,3,0,32,29
1656285787531,MATH 142A,B04,093558,Staff,6,0,32,26
1656285787531,MATH 142A,B05,093559,Staff,0,0,32,32
1656285793561,MATH 193A,A01,083224,Rotar; Vladimir,0,1,34,34
1656285793561,MATH 193A,A02,083225,Rotar; Vladimir,0,0,34,34
1656285793561,MATH 193A,A03,083781,Rotar; Vladimir,0,0,34,34
1656285793561,MATH 193A,A04,083782,Rotar; Vladimir,6,0,34,28
1656285793561,MATH 193A,A05,093482,Rotar; Vladimir,0,0,34,34
1656285799586,MATH 197,001,091859,McAuley; Julian John,9999,0,9999,0
1656285799586,MATH 197,002,095566,Kedlaya; Kiran S.,9997,0,9999,2
1656285799586,MATH 197,003,095567,Xiao; Ming,9999,0,9999,0
1656285799586,MATH 197,004,095571,Perols; Johan Lars,9998,0,9999,1
1656285806653,COGS 9,A01,083615,Shannon; Kyle Michael,4,0,75,71
1656285812680,COGS 11,A01,083617,Boyle; Mary E. T.,15,0,48,33
1656285818705,COGS 13,A01,083071,Bastos; Amalia Pinkusfeld,5,0,71,66
1656285824728,COGS 14A,A01,092681,Semenuks; Arturs,1,13,100,99
1656285830754,COGS 14B,A01,083073,Cheng; Tzu-Han,7,0,63,56
1656285836778,COGS 17,A01,092677,Semenuks; Arturs,7,0,81,74
1656285842801,COGS 100,A01,083619,Allen; Michael Gordon,2,0,70,68
1656285848829,COGS 101A,A01,083621,Davis; Joshua Daniel,4,0,68,64
1656285854856,COGS 101B,A01,091572,Allen; Michael Gordon,4,0,65,61
1656285860880,COGS 101C,A01,083625,Delgado; Tania,10,0,35,25
1656285866909,COGS 107A,A01,083627,Boyle; Mary E. T.,0,0,60,60
1656285872935,COGS 118A,A01,083075,Gupta; Anjum,8,0,76,68
1656285878964,CSE 3,A50,083646,Miranda; Gregory Joseph,18,0,50,32
1656285884996,CSE 8A,A50,083650,Miranda; Gregory Joseph,2,2,56,54
1656285891023,CSE 11,A01,083080,Cao; Yingjun,0,48,40,40
1656285897048,CSE 12,A01,083652,Krause-Levy; Sophia Louisa,5,1,120,115
1656285903075,CSE 15L,A01,083654,Morris; Justin Loren,2,0,50,48
1656285903075,CSE 15L,A02,083655,Morris; Justin Loren,4,0,50,46
1656285909098,CSE 20,A01,083657,Tran; Khoa Dang,30,0,80,50
1656285915129,CSE 21,A01,095574,Bach; Quang Tran,23,0,48,25
1656285921158,CSE 30,A01,083084,Eldon; John,2,6,80,78
1656285921158,CSE 30,B01,095061,Bhaskar; Nishant,0,1,50,50
1656285927186,CSE 100,A01,083659,Cao; Yingjun,1,18,70,69
1656285933216,CSE 134B,A01,083661,Powell; Thomas Allan,6,0,100,94
1656285939239,CSE 140,A01,083663,Gungor; Onat,8,0,85,77
1656285945263,CSE 140L,A01,083088,Eldon; John,10,0,100,90
1656285951296,CSE 175,A01,083665,Kumar; Rakesh,0,0,25,25
1656285957319,CSE 190,A00,092507,Dubnov; Shlomo,3,0,20,17
1656285963359,ECE 45,A01,083139,Congero; Spencer William,1,0,75,74
1656285969386,ECE 65,A50,083695,Saad; Andrew S,9,0,30,21
1656285969386,ECE 65,A51,095125,Staff,24,0,26,2
1656285975414,ECE 109,A01,091882,Touri; Behrouz,1,1,70,69
1656285981441,ECE 180,A00,083140,Abi Samra; Nicholas Camill,2,0,30,28
1656285981441,ECE 180,B00,083141,Abi Samra; Nicholas Camill,0,4,30,30
1656285987472,MATH 10A,A01,083735,Patchell; Gregory David,0,0,30,30
1656285987472,MATH 10A,A02,083736,Patchell; Gregory David,22,0,30,8
1656285987472,MATH 10A,A03,083737,Patchell; Gregory David,16,0,30,14
1656285993502,MATH 10B,A01,083207,Lim; Seonhee,1,0,34,33
1656285993502,MATH 10B,A02,083208,Lim; Seonhee,7,0,35,28
1656285993502,MATH 10B,A03,093472,Staff,1,0,34,33
1656285993502,MATH 10B,B01,083739,Sinha; Shubham,11,0,30,19
1656285999532,MATH 18,A01,083743,Cinel; Cameron Alexander,7,0,30,23
1656285999532,MATH 18,A02,083744,Cinel; Cameron Alexander,9,0,30,21
1656285999532,MATH 18,A03,083745,Cinel; Cameron Alexander,5,0,30,25
1656285999532,MATH 18,B01,083748,Rideout; David Porter,1,0,36,35
1656285999532,MATH 18,B02,083749,Rideout; David Porter,0,0,36,36
1656285999532,MATH 18,B03,083750,Rideout; David Porter,0,0,36,36
1656285999532,MATH 18,B04,083751,Rideout; David Porter,0,1,36,36
1656285999532,MATH 18,B05,093473,Rideout; David Porter,0,0,36,36
1656285999532,MATH 18,B06,093474,Rideout; David Porter,3,0,36,33
1656286005557,MATH 20A,A01,083754,Zheng; Zequn,11,0,40,29
1656286011581,MATH 20B,A01,083756,Briones; Jor-el Thomas Caparas,0,0,36,36
1656286011581,MATH 20B,A02,083757,Briones; Jor-el Thomas Caparas,0,0,36,36
1656286011581,MATH 20B,A03,093475,Staff,0,0,36,36
1656286017605,MATH 20C,A01,083760,Briones; Jor-el Thomas Caparas,0,0,35,35
1656286017605,MATH 20C,A02,083761,Briones; Jor-el Thomas Caparas,9,1,35,26
1656286017605,MATH 20C,A03,093476,Staff,0,0,35,35
1656286017605,MATH 20C,B01,083762,Bach; Quang Tran,1,0,30,29
1656286023646,MATH 20D,A01,083765,Tran; Brian Kha,1,0,30,29
1656286023646,MATH 20D,A02,083766,Tran; Brian Kha,0,1,30,30
1656286023646,MATH 20D,A03,083767,Tran; Brian Kha,2,0,30,28
1656286029673,MATH 20E,A01,083771,Ganguly; Soumya,3,0,32,29
1656286029673,MATH 20E,A02,083772,Ganguly; Soumya,0,0,32,32
1656286029673,MATH 20E,B01,083773,Ciotti; Benjamin,16,0,35,19
1656286029673,MATH 20E,B02,083774,Ciotti; Benjamin,15,0,35,20
1656286035696,MATH 103A,A01,083777,Greenfeld; Be'Eri,1,0,36,35
1656286035696,MATH 103A,A02,083778,Greenfeld; Be'Eri,2,0,36,34
1656286035696,MATH 103A,A03,093561,Staff,5,0,36,31
1656286035696,MATH 103A,B01,083779,Greenfeld; Be'Eri,8,0,36,28
1656286035696,MATH 103A,B02,083780,Greenfeld; Be'Eri,0,0,36,36
1656286035696,MATH 103A,B03,093562,Staff,0,0,36,36
1656286041720,MATH 105,A01,085443,Carter; Anne Toulson,5,0,35,30
1656286041720,MATH 105,A02,093477,Staff,14,0,35,21
1656286047746,MATH 109,A01,083213,Ganzberger; Geoffrey Michael,1,0,34,33
1656286047746,MATH 109,A02,083214,Ganzberger; Geoffrey Michael,0,0,34,34
1656286047746,MATH 109,A03,093478,Staff,2,0,34,32
1656286047746,MATH 109,B01,083215,Ganzberger; Geoffrey Michael,4,0,32,28
1656286047746,MATH 109,B02,083216,Ganzberger; Geoffrey Michael,1,0,32,31
1656286047746,MATH 109,B03,093479,Staff,3,0,32,29
1656286053776,MATH 142A,A01,083219,Chow; Bennett,1,0,32,31
1656286053776,MATH 142A,A02,083220,Chow; Bennett,8,0,32,24
1656286053776,MATH 142A,A03,093480,Staff,5,0,32,27
1656286053776,MATH 142A,B03,093481,Staff,3,0,32,29
1656286053776,MATH 142A,B04,093558,Staff,6,0,32,26
1656286053776,MATH 142A,B05,093559,Staff,0,0,32,32
1656286059799,MATH 193A,A01,083224,Rotar; Vladimir,0,1,34,34
1656286059799,MATH 193A,A02,083225,Rotar; Vladimir,0,0,34,34
1656286059799,MATH 193A,A03,083781,Rotar; Vladimir,0,0,34,34
1656286059799,MATH 193A,A04,083782,Rotar; Vladimir,6,0,34,28
1656286059799,MATH 193A,A05,093482,Rotar; Vladimir,0,0,34,34
1656286065822,MATH 197,001,091859,McAuley; Julian John,9999,0,9999,0
1656286065822,MATH 197,002,095566,Kedlaya; Kiran S.,9997,0,9999,2
1656286065822,MATH 197,003,095567,Xiao; Ming,9999,0,9999,0
1656286065822,MATH 197,004,095571,Perols; Johan Lars,9998,0,9999,1
1656286072881,COGS 9,A01,083615,Shannon; Kyle Michael,4,0,75,71
1656286078905,COGS 11,A01,083617,Boyle; Mary E. T.,15,0,48,33
1656286084931,COGS 13,A01,083071,Bastos; Amalia Pinkusfeld,5,0,71,66
1656286090958,COGS 14A,A01,092681,Semenuks; Arturs,1,13,100,99
1656286096983,COGS 14B,A01,083073,Cheng; Tzu-Han,7,0,63,56
1656286103009,COGS 17,A01,092677,Semenuks; Arturs,7,0,81,74
1656286109033,COGS 100,A01,083619,Allen; Michael Gordon,2,0,70,68
1656286115060,COGS 101A,A01,083621,Davis; Joshua Daniel,4,0,68,64
1656286121087,COGS 101B,A01,091572,Allen; Michael Gordon,4,0,65,61
1656286127111,COGS 101C,A01,083625,Delgado; Tania,10,0,35,25
1656286133136,COGS 107A,A01,083627,Boyle; Mary E. T.,0,0,60,60
1656286139169,COGS 118A,A01,083075,Gupta; Anjum,8,0,76,68
1656286145192,CSE 3,A50,083646,Miranda; Gregory Joseph,18,0,50,32
1656286151217,CSE 8A,A50,083650,Miranda; Gregory Joseph,2,2,56,54
1656286157240,CSE 11,A01,083080,Cao; Yingjun,0,48,40,40
1656286163268,CSE 12,A01,083652,Krause-Levy; Sophia Louisa,5,1,120,115
1656286169292,CSE 15L,A01,083654,Morris; Justin Loren,2,0,50,48
1656286169292,CSE 15L,A02,083655,Morris; Justin Loren,4,0,50,46
1656286175316,CSE 20,A01,083657,Tran; Khoa Dang,30,0,80,50
1656286181346,CSE 21,A01,095574,Bach; Quang Tran,23,0,48,25
1656286187374,CSE 30,A01,083084,Eldon; John,2,6,80,78
1656286187374,CSE 30,B01,095061,Bhaskar; Nishant,0,1,50,50
1656286193400,CSE 100,A01,083659,Cao; Yingjun,1,18,70,69
1656286199423,CSE 134B,A01,083661,Powell; Thomas Allan,6,0,100,94
1656286205447,CSE 140,A01,083663,Gungor; Onat,8,0,85,77
1656286211475,CSE 140L,A01,083088,Eldon; John,10,0,100,90
1656286217497,CSE 175,A01,083665,Kumar; Rakesh,0,0,25,25
1656286223525,CSE 190,A00,092507,Dubnov; Shlomo,3,0,20,17
1656286229557,ECE 45,A01,083139,Congero; Spencer William,1,0,75,74
1656286235579,ECE 65,A50,083695,Saad; Andrew S,9,0,30,21
1656286235579,ECE 65,A51,095125,Staff,24,0,26,2
1656286241606,ECE 109,A01,091882,Touri; Behrouz,1,1,70,69
1656286247630,ECE 180,A00,083140,Abi Samra; Nicholas Camill,2,0,30,28
1656286247630,ECE 180,B00,083141,Abi Samra; Nicholas Camill,0,4,30,30
1656286253653,MATH 10A,A01,083735,Patchell; Gregory David,0,0,30,30
1656286253653,MATH 10A,A02,083736,Patchell; Gregory David,22,0,30,8
1656286253653,MATH 10A,A03,083737,Patchell; Gregory David,16,0,30,14
1656286259678,MATH 10B,A01,083207,Lim; Seonhee,1,0,34,33
1656286259678,MATH 10B,A02,083208,Lim; Seonhee,7,0,35,28
1656286259678,MATH 10B,A03,093472,Staff,1,0,34,33
1656286259678,MATH 10B,B01,083739,Sinha; Shubham,11,0,30,19
1656286265708,MATH 18,A01,083743,Cinel; Cameron Alexander,7,0,30,23
1656286265708,MATH 18,A02,083744,Cinel; Cameron Alexander,9,0,30,21
1656286265708,MATH 18,A03,083745,Cinel; Cameron Alexander,5,0,30,25
1656286265708,MATH 18,B01,083748,Rideout; David Porter,1,0,36,35
1656286265708,MATH 18,B02,083749,Rideout; David Porter,0,0,36,36
1656286265708,MATH 18,B03,083750,Rideout; David Porter,0,0,36,36
1656286265708,MATH 18,B04,083751,Rideout; David Porter,0,1,36,36
1656286265708,MATH 18,B05,093473,Rideout; David Porter,0,0,36,36
1656286265708,MATH 18,B06,093474,Rideout; David Porter,3,0,36,33
1656286271732,MATH 20A,A01,083754,Zheng; Zequn,11,0,40,29
1656286277756,MATH 20B,A01,083756,Briones; Jor-el Thomas Caparas,0,0,36,36
1656286277756,MATH 20B,A02,083757,Briones; Jor-el Thomas Caparas,0,0,36,36
1656286277756,MATH 20B,A03,093475,Staff,0,0,36,36
1656286283780,MATH 20C,A01,083760,Briones; Jor-el Thomas Caparas,0,0,35,35
1656286283780,MATH 20C,A02,083761,Briones; Jor-el Thomas Caparas,9,1,35,26
1656286283780,MATH 20C,A03,093476,Staff,0,0,35,35
1656286283780,MATH 20C,B01,083762,Bach; Quang Tran,1,0,30,29
1656286289805,MATH 20D,A01,083765,Tran; Brian Kha,1,0,30,29
1656286289805,MATH 20D,A02,083766,Tran; Brian Kha,0,1,30,30
1656286289805,MATH 20D,A03,083767,Tran; Brian Kha,2,0,30,28
1656286295833,MATH 20E,A01,083771,Ganguly; Soumya,3,0,32,29
1656286295833,MATH 20E,A02,083772,Ganguly; Soumya,0,0,32,32
1656286295833,MATH 20E,B01,083773,Ciotti; Benjamin,16,0,35,19
1656286295833,MATH 20E,B02,083774,Ciotti; Benjamin,15,0,35,20
1656286301862,MATH 103A,A01,083777,Greenfeld; Be'Eri,1,0,36,35
1656286301862,MATH 103A,A02,083778,Greenfeld; Be'Eri,2,0,36,34
1656286301862,MATH 103A,A03,093561,Staff,5,0,36,31
1656286301862,MATH 103A,B01,083779,Greenfeld; Be'Eri,8,0,36,28
1656286301862,MATH 103A,B02,083780,Greenfeld; Be'Eri,0,0,36,36
1656286301862,MATH 103A,B03,093562,Staff,0,0,36,36
1656286307886,MATH 105,A01,085443,Carter; Anne Toulson,5,0,35,30
1656286307886,MATH 105,A02,093477,Staff,14,0,35,21
1656286313909,MATH 109,A01,083213,Ganzberger; Geoffrey Michael,1,0,34,33
1656286313909,MATH 109,A02,083214,Ganzberger; Geoffrey Michael,0,0,34,34
1656286313909,MATH 109,A03,093478,Staff,2,0,34,32
1656286313909,MATH 109,B01,083215,Ganzberger; Geoffrey Michael,4,0,32,28
1656286313909,MATH 109,B02,083216,Ganzberger; Geoffrey Michael,1,0,32,31
1656286313909,MATH 109,B03,093479,Staff,3,0,32,29
1656286319932,MATH 142A,A01,083219,Chow; Bennett,1,0,32,31
1656286319932,MATH 142A,A02,083220,Chow; Bennett,8,0,32,24
1656286319932,MATH 142A,A03,093480,Staff,5,0,32,27
1656286319932,MATH 142A,B03,093481,Staff,3,0,32,29
1656286319932,MATH 142A,B04,093558,Staff,6,0,32,26
1656286319932,MATH 142A,B05,093559,Staff,0,0,32,32
1656286325957,MATH 193A,A01,083224,Rotar; Vladimir,0,1,34,34
1656286325957,MATH 193A,A02,083225,Rotar; Vladimir,0,0,34,34
1656286325957,MATH 193A,A03,083781,Rotar; Vladimir,0,0,34,34
1656286325957,MATH 193A,A04,083782,Rotar; Vladimir,6,0,34,28
1656286325957,MATH 193A,A05,093482,Rotar; Vladimir,0,0,34,34
1656286331984,MATH 197,001,091859,McAuley; Julian John,9999,0,9999,0
1656286331984,MATH 197,002,095566,Kedlaya; Kiran S.,9997,0,9999,2
1656286331984,MATH 197,003,095567,Xiao; Ming,9999,0,9999,0
1656286331984,MATH 197,004,095571,Perols; Johan Lars,9998,0,9999,1
1656286339129,COGS 9,A01,083615,Shannon; Kyle Michael,4,0,75,71
1656286345157,COGS 11,A01,083617,Boyle; Mary E. T.,15,0,48,33
1656286351181,COGS 13,A01,083071,Bastos; Amalia Pinkusfeld,5,0,71,66
1656286357204,COGS 14A,A01,092681,Semenuks; Arturs,1,13,100,99
1656286363232,COGS 14B,A01,083073,Cheng; Tzu-Han,7,0,63,56
1656286369258,COGS 17,A01,092677,Semenuks; Arturs,7,0,81,74
1656286375290,COGS 100,A01,083619,Allen; Michael Gordon,2,0,70,68
1656286381318,COGS 101A,A01,083621,Davis; Joshua Daniel,4,0,68,64
1656286387341,COGS 101B,A01,091572,Allen; Michael Gordon,4,0,65,61
1656286393363,COGS 101C,A01,083625,Delgado; Tania,10,0,35,25
1656286399385,COGS 107A,A01,083627,Boyle; Mary E. T.,0,0,60,60
1656286405411,COGS 118A,A01,083075,Gupta; Anjum,8,0,76,68
1656286411442,CSE 3,A50,083646,Miranda; Gregory Joseph,18,0,50,32
1656286417463,CSE 8A,A50,083650,Miranda; Gregory Joseph,2,2,56,54
1656286423488,CSE 11,A01,083080,Cao; Yingjun,0,48,40,40
1656286429510,CSE 12,A01,083652,Krause-Levy; Sophia Louisa,5,1,120,115
1656286435533,CSE 15L,A01,083654,Morris; Justin Loren,2,0,50,48
1656286435533,CSE 15L,A02,083655,Morris; Justin Loren,4,0,50,46
1656286441566,CSE 20,A01,083657,Tran; Khoa Dang,30,0,80,50
1656286447589,CSE 21,A01,095574,Bach; Quang Tran,23,0,48,25
1656286453617,CSE 30,A01,083084,Eldon; John,2,6,80,78
1656286453617,CSE 30,B01,095061,Bhaskar; Nishant,0,1,50,50
1656286459639,CSE 100,A01,083659,Cao; Yingjun,1,18,70,69
1656286465665,CSE 134B,A01,083661,Powell; Thomas Allan,6,0,100,94
1656286471687,CSE 140,A01,083663,Gungor; Onat,8,0,85,77
1656286477718,CSE 140L,A01,083088,Eldon; John,10,0,100,90
1656286483743,CSE 175,A01,083665,Kumar; Rakesh,0,0,25,25
1656286489772,CSE 190,A00,092507,Dubnov; Shlomo,3,0,20,17
1656286495800,ECE 45,A01,083139,Congero; Spencer William,1,0,75,74
1656286501824,ECE 65,A50,083695,Saad; Andrew S,9,0,30,21
1656286501824,ECE 65,A51,095125,Staff,24,0,26,2
1656286507852,ECE 109,A01,091882,Touri; Behrouz,1,1,70,69
1656286513876,ECE 180,A00,083140,Abi Samra; Nicholas Camill,2,0,30,28
1656286513876,ECE 180,B00,083141,Abi Samra; Nicholas Camill,0,4,30,30
1656286519910,MATH 10A,A01,083735,Patchell; Gregory David,0,0,30,30
1656286519910,MATH 10A,A02,083736,Patchell; Gregory David,22,0,30,8
1656286519910,MATH 10A,A03,083737,Patchell; Gregory David,16,0,30,14
1656286525937,MATH 10B,A01,083207,Lim; Seonhee,1,0,34,33
1656286525937,MATH 10B,A02,083208,Lim; Seonhee,7,0,35,28
1656286525937,MATH 10B,A03,093472,Staff,1,0,34,33
1656286525937,MATH 10B,B01,083739,Sinha; Shubham,11,0,30,19
1656286531970,MATH 18,A01,083743,Cinel; Cameron Alexander,7,0,30,23
1656286531970,MATH 18,A02,083744,Cinel; Cameron Alexander,9,0,30,21
1656286531970,MATH 18,A03,083745,Cinel; Cameron Alexander,5,0,30,25
1656286531970,MATH 18,B01,083748,Rideout; David Porter,1,0,36,35
1656286531970,MATH 18,B02,083749,Rideout; David Porter,0,0,36,36
1656286531970,MATH 18,B03,083750,Rideout; David Porter,0,0,36,36
1656286531970,MATH 18,B04,083751,Rideout; David Porter,0,1,36,36
1656286531970,MATH 18,B05,093473,Rideout; David Porter,0,0,36,36
1656286531970,MATH 18,B06,093474,Rideout; David Porter,3,0,36,33
1656286537996,MATH 20A,A01,083754,Zheng; Zequn,11,0,40,29
1656286544024,MATH 20B,A01,083756,Briones; Jor-el Thomas Caparas,0,0,36,36
1656286544024,MATH 20B,A02,083757,Briones; Jor-el Thomas Caparas,0,0,36,36
1656286544024,MATH 20B,A03,093475,Staff,0,0,36,36
1656286550053,MATH 20C,A01,083760,Briones; Jor-el Thomas Caparas,0,0,35,35
1656286550053,MATH 20C,A02,083761,Briones; Jor-el Thomas Caparas,9,1,35,26
1656286550053,MATH 20C,A03,093476,Staff,0,0,35,35
1656286550053,MATH 20C,B01,083762,Bach; Quang Tran,1,0,30,29
1656286556083,MATH 20D,A01,083765,Tran; Brian Kha,1,0,30,29
1656286556083,MATH 20D,A02,083766,Tran; Brian Kha,0,1,30,30
1656286556083,MATH 20D,A03,083767,Tran; Brian Kha,2,0,30,28
1656286562112,MATH 20E,A01,083771,Ganguly; Soumya,3,0,32,29
1656286562112,MATH 20E,A02,083772,Ganguly; Soumya,0,0,32,32
1656286562112,MATH 20E,B01,083773,Ciotti; Benjamin,16,0,35,19
1656286562112,MATH 20E,B02,083774,Ciotti; Benjamin,15,0,35,20
1656286568142,MATH 103A,A01,083777,Greenfeld; Be'Eri,1,0,36,35
1656286568142,MATH 103A,A02,083778,Greenfeld; Be'Eri,2,0,36,34
1656286568142,MATH 103A,A03,093561,Staff,5,0,36,31
1656286568142,MATH 103A,B01,083779,Greenfeld; Be'Eri,8,0,36,28
1656286568142,MATH 103A,B02,083780,Greenfeld; Be'Eri,0,0,36,36
1656286568142,MATH 103A,B03,093562,Staff,0,0,36,36
1656286574168,MATH 105,A01,085443,Carter; Anne Toulson,5,0,35,30
1656286574168,MATH 105,A02,093477,Staff,14,0,35,21
1656286580197,MATH 109,A01,083213,Ganzberger; Geoffrey Michael,1,0,34,33
1656286580197,MATH 109,A02,083214,Ganzberger; Geoffrey Michael,0,0,34,34
1656286580197,MATH 109,A03,093478,Staff,2,0,34,32
1656286580197,MATH 109,B01,083215,Ganzberger; Geoffrey Michael,4,0,32,28
1656286580197,MATH 109,B02,083216,Ganzberger; Geoffrey Michael,1,0,32,31
1656286580197,MATH 109,B03,093479,Staff,3,0,32,29
1656286586221,MATH 142A,A01,083219,Chow; Bennett,1,0,32,31
1656286586221,MATH 142A,A02,083220,Chow; Bennett,8,0,32,24
1656286586221,MATH 142A,A03,093480,Staff,5,0,32,27
1656286586221,MATH 142A,B03,093481,Staff,3,0,32,29
1656286586221,MATH 142A,B04,093558,Staff,6,0,32,26
1656286586221,MATH 142A,B05,093559,Staff,0,0,32,32
1656286592251,MATH 193A,A01,083224,Rotar; Vladimir,0,1,34,34
1656286592251,MATH 193A,A02,083225,Rotar; Vladimir,0,0,34,34
1656286592251,MATH 193A,A03,083781,Rotar; Vladimir,0,0,34,34
1656286592251,MATH 193A,A04,083782,Rotar; Vladimir,6,0,34,28
1656286592251,MATH 193A,A05,093482,Rotar; Vladimir,0,0,34,34
1656286598277,MATH 197,001,091859,McAuley; Julian John,9999,0,9999,0
1656286598277,MATH 197,002,095566,Kedlaya; Kiran S.,9997,0,9999,2
1656286598277,MATH 197,003,095567,Xiao; Ming,9999,0,9999,0
1656286598277,MATH 197,004,095571,Perols; Johan Lars,9998,0,9999,1
1656286605330,COGS 9,A01,083615,Shannon; Kyle Michael,4,0,75,71
1656286611371,COGS 11,A01,083617,Boyle; Mary E. T.,15,0,48,33
1656286617410,COGS 13,A01,083071,Bastos; Amalia Pinkusfeld,5,0,71,66
1656286623432,COGS 14A,A01,092681,Semenuks; Arturs,1,13,100,99
1656286629456,COGS 14B,A01,083073,Cheng; Tzu-Han,7,0,63,56
1656286635480,COGS 17,A01,092677,Semenuks; Arturs,7,0,81,74
1656286641507,COGS 100,A01,083619,Allen; Michael Gordon,2,0,70,68
1656286647531,COGS 101A,A01,083621,Davis; Joshua Daniel,4,0,68,64
1656286653555,COGS 101B,A01,091572,Allen; Michael Gordon,4,0,65,61
1656286659582,COGS 101C,A01,083625,Delgado; Tania,10,0,35,25
1656286665605,COGS 107A,A01,083627,Boyle; Mary E. T.,0,0,60,60
1656286671628,COGS 118A,A01,083075,Gupta; Anjum,8,0,76,68
1656286677655,CSE 3,A50,083646,Miranda; Gregory Joseph,18,0,50,32
1656286683680,CSE 8A,A50,083650,Miranda; Gregory Joseph,2,2,56,54
1656286689706,CSE 11,A01,083080,Cao; Yingjun,0,48,40,40
1656286695730,CSE 12,A01,083652,Krause-Levy; Sophia Louisa,5,1,120,115
1656286701760,CSE 15L,A01,083654,Morris; Justin Loren,2,0,50,48
1656286701760,CSE 15L,A02,083655,Morris; Justin Loren,4,0,50,46
1656286707785,CSE 20,A01,083657,Tran; Khoa Dang,30,0,80,50
1656286713812,CSE 21,A01,095574,Bach; Quang Tran,23,0,48,25
1656286719841,CSE 30,A01,083084,Eldon; John,2,6,80,78
1656286719841,CSE 30,B01,095061,Bhaskar; Nishant,0,1,50,50
1656286725868,CSE 100,A01,083659,Cao; Yingjun,1,18,70,69
1656286731895,CSE 134B,A01,083661,Powell; Thomas Allan,6,0,100,94
1656286737922,CSE 140,A01,083663,Gungor; Onat,8,0,85,77
1656286743945,CSE 140L,A01,083088,Eldon; John,10,0,100,90
1656286749972,CSE 175,A01,083665,Kumar; Rakesh,0,0,25,25
1656286755994,CSE 190,A00,092507,Dubnov; Shlomo,3,0,20,17
1656286762021,ECE 45,A01,083139,Congero; Spencer William,1,0,75,74
1656286768045,ECE 65,A50,083695,Saad; Andrew S,9,0,30,21
1656286768045,ECE 65,A51,095125,Staff,24,0,26,2
1656286774069,ECE 109,A01,091882,Touri; Behrouz,1,1,70,69
1656286780092,ECE 180,A00,083140,Abi Samra; Nicholas Camill,2,0,30,28
1656286780092,ECE 180,B00,083141,Abi Samra; Nicholas Camill,0,4,30,30
1656286786121,MATH 10A,A01,083735,Patchell; Gregory David,0,0,30,30
1656286786121,MATH 10A,A02,083736,Patchell; Gregory David,22,0,30,8
1656286786121,MATH 10A,A03,083737,Patchell; Gregory David,16,0,30,14
1656286792146,MATH 10B,A01,083207,Lim; Seonhee,1,0,34,33
1656286792146,MATH 10B,A02,083208,Lim; Seonhee,7,0,35,28
1656286792146,MATH 10B,A03,093472,Staff,1,0,34,33
1656286792146,MATH 10B,B01,083739,Sinha; Shubham,11,0,30,19
1656286798171,MATH 18,A01,083743,Cinel; Cameron Alexander,7,0,30,23
1656286798171,MATH 18,A02,083744,Cinel; Cameron Alexander,9,0,30,21
1656286798171,MATH 18,A03,083745,Cinel; Cameron Alexander,5,0,30,25
1656286798171,MATH 18,B01,083748,Rideout; David Porter,1,0,36,35
1656286798171,MATH 18,B02,083749,Rideout; David Porter,0,0,36,36
1656286798171,MATH 18,B03,083750,Rideout; David Porter,0,0,36,36
1656286798171,MATH 18,B04,083751,Rideout; David Porter,0,1,36,36
1656286798171,MATH 18,B05,093473,Rideout; David Porter,0,0,36,36
1656286798171,MATH 18,B06,093474,Rideout; David Porter,3,0,36,33
1656286804197,MATH 20A,A01,083754,Zheng; Zequn,11,0,40,29
1656286810224,MATH 20B,A01,083756,Briones; Jor-el Thomas Caparas,0,0,36,36
1656286810224,MATH 20B,A02,083757,Briones; Jor-el Thomas Caparas,0,0,36,36
1656286810224,MATH 20B,A03,093475,Staff,0,0,36,36
1656286816248,MATH 20C,A01,083760,Briones; Jor-el Thomas Caparas,0,0,35,35
1656286816248,MATH 20C,A02,083761,Briones; Jor-el Thomas Caparas,9,1,35,26
1656286816248,MATH 20C,A03,093476,Staff,0,0,35,35
1656286816248,MATH 20C,B01,083762,Bach; Quang Tran,1,0,30,29
1656286822285,MATH 20D,A01,083765,Tran; Brian Kha,1,0,30,29
1656286822285,MATH 20D,A02,083766,Tran; Brian Kha,0,1,30,30
1656286822285,MATH 20D,A03,083767,Tran; Brian Kha,2,0,30,28
1656286828307,MATH 20E,A01,083771,Ganguly; Soumya,3,0,32,29
1656286828307,MATH 20E,A02,083772,Ganguly; Soumya,0,0,32,32
1656286828307,MATH 20E,B01,083773,Ciotti; Benjamin,16,0,35,19
1656286828307,MATH 20E,B02,083774,Ciotti; Benjamin,15,0,35,20
1656286834329,MATH 103A,A01,083777,Greenfeld; Be'Eri,1,0,36,35
1656286834329,MATH 103A,A02,083778,Greenfeld; Be'Eri,2,0,36,34
1656286834329,MATH 103A,A03,093561,Staff,5,0,36,31
1656286834329,MATH 103A,B01,083779,Greenfeld; Be'Eri,8,0,36,28
1656286834329,MATH 103A,B02,083780,Greenfeld; Be'Eri,0,0,36,36
1656286834329,MATH 103A,B03,093562,Staff,0,0,36,36
1656286840357,MATH 105,A01,085443,Carter; Anne Toulson,5,0,35,30
1656286840357,MATH 105,A02,093477,Staff,14,0,35,21
1656286846384,MATH 109,A01,083213,Ganzberger; Geoffrey Michael,1,0,34,33
1656286846384,MATH 109,A02,083214,Ganzberger; Geoffrey Michael,0,0,34,34
1656286846384,MATH 109,A03,093478,Staff,2,0,34,32
1656286846384,MATH 109,B01,083215,Ganzberger; Geoffrey Michael,4,0,32,28
1656286846384,MATH 109,B02,083216,Ganzberger; Geoffrey Michael,1,0,32,31
1656286846384,MATH 109,B03,093479,Staff,3,0,32,29
1656286852407,MATH 142A,A01,083219,Chow; Bennett,1,0,32,31
1656286852407,MATH 142A,A02,083220,Chow; Bennett,8,0,32,24
1656286852407,MATH 142A,A03,093480,Staff,5,0,32,27
1656286852407,MATH 142A,B03,093481,Staff,3,0,32,29
1656286852407,MATH 142A,B04,093558,Staff,6,0,32,26
1656286852407,MATH 142A,B05,093559,Staff,0,0,32,32
1656286858454,MATH 193A,A01,083224,Rotar; Vladimir,0,1,34,34
1656286858454,MATH 193A,A02,083225,Rotar; Vladimir,0,0,34,34
1656286858454,MATH 193A,A03,083781,Rotar; Vladimir,0,0,34,34
1656286858454,MATH 193A,A04,083782,Rotar; Vladimir,6,0,34,28
1656286858454,MATH 193A,A05,093482,Rotar; Vladimir,0,0,34,34
1656286864475,MATH 197,001,091859,McAuley; Julian John,9999,0,9999,0
1656286864475,MATH 197,002,095566,Kedlaya; Kiran S.,9997,0,9999,2
1656286864475,MATH 197,003,095567,Xiao; Ming,9999,0,9999,0
1656286864475,MATH 197,004,095571,Perols; Johan Lars,9998,0,9999,1
1656286871545,COGS 9,A01,083615,Shannon; Kyle Michael,4,0,75,71
1656286877568,COGS 11,A01,083617,Boyle; Mary E. T.,15,0,48,33
1656286883591,COGS 13,A01,083071,Bastos; Amalia Pinkusfeld,5,0,71,66
1656286889615,COGS 14A,A01,092681,Semenuks; Arturs,1,13,100,99
1656286895640,COGS 14B,A01,083073,Cheng; Tzu-Han,7,0,63,56
1656286901670,COGS 17,A01,092677,Semenuks; Arturs,7,0,81,74
1656286907694,COGS 100,A01,083619,Allen; Michael Gordon,2,0,70,68
1656286913719,COGS 101A,A01,083621,Davis; Joshua Daniel,4,0,68,64
1656286919744,COGS 101B,A01,091572,Allen; Michael Gordon,4,0,65,61
1656286925780,COGS 101C,A01,083625,Delgado; Tania,10,0,35,25
1656286931807,COGS 107A,A01,083627,Boyle; Mary E. T.,0,0,60,60
1656286937907,COGS 118A,A01,083075,Gupta; Anjum,8,0,76,68
1656286943937,CSE 3,A50,083646,Miranda; Gregory Joseph,18,0,50,32
1656286949965,CSE 8A,A50,083650,Miranda; Gregory Joseph,2,2,56,54
1656286955992,CSE 11,A01,083080,Cao; Yingjun,0,48,40,40
1656286962019,CSE 12,A01,083652,Krause-Levy; Sophia Louisa,5,1,120,115
1656286968052,CSE 15L,A01,083654,Morris; Justin Loren,2,0,50,48
1656286968052,CSE 15L,A02,083655,Morris; Justin Loren,4,0,50,46
1656286974078,CSE 20,A01,083657,Tran; Khoa Dang,30,0,80,50
1656286980108,CSE 21,A01,095574,Bach; Quang Tran,23,0,48,25
1656286986134,CSE 30,A01,083084,Eldon; John,2,6,80,78
1656286986134,CSE 30,B01,095061,Bhaskar; Nishant,0,1,50,50
1656286992157,CSE 100,A01,083659,Cao; Yingjun,1,18,70,69
1656286998181,CSE 134B,A01,083661,Powell; Thomas Allan,6,0,100,94
1656287004205,CSE 140,A01,083663,Gungor; Onat,8,0,85,77
1656287010240,CSE 140L,A01,083088,Eldon; John,10,0,100,90
1656287016264,CSE 175,A01,083665,Kumar; Rakesh,0,0,25,25
1656287022290,CSE 190,A00,092507,Dubnov; Shlomo,3,0,20,17
1656287028319,ECE 45,A01,083139,Congero; Spencer William,1,0,75,74
1656287034347,ECE 65,A50,083695,Saad; Andrew S,9,0,30,21
1656287034347,ECE 65,A51,095125,Staff,24,0,26,2
1656287040374,ECE 109,A01,091882,Touri; Behrouz,1,1,70,69
1656287046401,ECE 180,A00,083140,Abi Samra; Nicholas Camill,2,0,30,28
1656287046401,ECE 180,B00,083141,Abi Samra; Nicholas Camill,0,4,30,30
1656287052430,MATH 10A,A01,083735,Patchell; Gregory David,0,0,30,30
1656287052430,MATH 10A,A02,083736,Patchell; Gregory David,22,0,30,8
1656287052430,MATH 10A,A03,083737,Patchell; Gregory David,16,0,30,14
1656287058458,MATH 10B,A01,083207,Lim; Seonhee,1,0,34,33
1656287058458,MATH 10B,A02,083208,Lim; Seonhee,7,0,35,28
1656287058458,MATH 10B,A03,093472,Staff,1,0,34,33
1656287058458,MATH 10B,B01,083739,Sinha; Shubham,11,0,30,19
1656287064491,MATH 18,A01,083743,Cinel; Cameron Alexander,7,0,30,23
1656287064491,MATH 18,A02,083744,Cinel; Cameron Alexander,9,0,30,21
1656287064491,MATH 18,A03,083745,Cinel; Cameron Alexander,5,0,30,25
1656287064491,MATH 18,B01,083748,Rideout; David Porter,1,0,36,35
1656287064491,MATH 18,B02,083749,Rideout; David Porter,0,0,36,36
1656287064491,MATH 18,B03,083750,Rideout; David Porter,0,0,36,36
1656287064491,MATH 18,B04,083751,Rideout; David Porter,0,1,36,36
1656287064491,MATH 18,B05,093473,Rideout; David Porter,0,0,36,36
1656287064491,MATH 18,B06,093474,Rideout; David Porter,3,0,36,33
1656287070518,MATH 20A,A01,083754,Zheng; Zequn,11,0,40,29
1656287076544,MATH 20B,A01,083756,Briones; Jor-el Thomas Caparas,0,0,36,36
1656287076544,MATH 20B,A02,083757,Briones; Jor-el Thomas Caparas,0,0,36,36
1656287076544,MATH 20B,A03,093475,Staff,0,0,36,36
1656287082574,MATH 20C,A01,083760,Briones; Jor-el Thomas Caparas,0,0,35,35
1656287082574,MATH 20C,A02,083761,Briones; Jor-el Thomas Caparas,9,1,35,26
1656287082574,MATH 20C,A03,093476,Staff,0,0,35,35
1656287082574,MATH 20C,B01,083762,Bach; Quang Tran,1,0,30,29
1656287088599,MATH 20D,A01,083765,Tran; Brian Kha,1,0,30,29
1656287088599,MATH 20D,A02,083766,Tran; Brian Kha,0,1,30,30
1656287088599,MATH 20D,A03,083767,Tran; Brian Kha,2,0,30,28
1656287094621,MATH 20E,A01,083771,Ganguly; Soumya,3,0,32,29
1656287094621,MATH 20E,A02,083772,Ganguly; Soumya,0,0,32,32
1656287094621,MATH 20E,B01,083773,Ciotti; Benjamin,16,0,35,19
1656287094621,MATH 20E,B02,083774,Ciotti; Benjamin,15,0,35,20
1656287100645,MATH 103A,A01,083777,Greenfeld; Be'Eri,1,0,36,35
1656287100645,MATH 103A,A02,083778,Greenfeld; Be'Eri,2,0,36,34
1656287100645,MATH 103A,A03,093561,Staff,5,0,36,31
1656287100645,MATH 103A,B01,083779,Greenfeld; Be'Eri,8,0,36,28
1656287100645,MATH 103A,B02,083780,Greenfeld; Be'Eri,0,0,36,36
1656287100645,MATH 103A,B03,093562,Staff,0,0,36,36
1656287106669,MATH 105,A01,085443,Carter; Anne Toulson,5,0,35,30
1656287106669,MATH 105,A02,093477,Staff,14,0,35,21
1656287112697,MATH 109,A01,083213,Ganzberger; Geoffrey Michael,1,0,34,33
1656287112697,MATH 109,A02,083214,Ganzberger; Geoffrey Michael,0,0,34,34
1656287112697,MATH 109,A03,093478,Staff,2,0,34,32
1656287112697,MATH 109,B01,083215,Ganzberger; Geoffrey Michael,4,0,32,28
1656287112697,MATH 109,B02,083216,Ganzberger; Geoffrey Michael,1,0,32,31
1656287112697,MATH 109,B03,093479,Staff,3,0,32,29
1656287118721,MATH 142A,A01,083219,Chow; Bennett,1,0,32,31
1656287118721,MATH 142A,A02,083220,Chow; Bennett,8,0,32,24
1656287118721,MATH 142A,A03,093480,Staff,5,0,32,27
1656287118721,MATH 142A,B03,093481,Staff,3,0,32,29
1656287118721,MATH 142A,B04,093558,Staff,6,0,32,26
1656287118721,MATH 142A,B05,093559,Staff,0,0,32,32
1656287124745,MATH 193A,A01,083224,Rotar; Vladimir,0,1,34,34
1656287124745,MATH 193A,A02,083225,Rotar; Vladimir,0,0,34,34
1656287124745,MATH 193A,A03,083781,Rotar; Vladimir,0,0,34,34
1656287124745,MATH 193A,A04,083782,Rotar; Vladimir,6,0,34,28
1656287124745,MATH 193A,A05,093482,Rotar; Vladimir,0,0,34,34
1656287130772,MATH 197,001,091859,McAuley; Julian John,9999,0,9999,0
1656287130772,MATH 197,002,095566,Kedlaya; Kiran S.,9997,0,9999,2
1656287130772,MATH 197,003,095567,Xiao; Ming,9999,0,9999,0
1656287130772,MATH 197,004,095571,Perols; Johan Lars,9998,0,9999,1
1656287137825,COGS 9,A01,083615,Shannon; Kyle Michael,4,0,75,71
1656287143849,COGS 11,A01,083617,Boyle; Mary E. T.,15,0,48,33
1656287149876,COGS 13,A01,083071,Bastos; Amalia Pinkusfeld,5,0,71,66
1656287155900,COGS 14A,A01,092681,Semenuks; Arturs,1,13,100,99
1656287161926,COGS 14B,A01,083073,Cheng; Tzu-Han,7,0,63,56
1656287167949,COGS 17,A01,092677,Semenuks; Arturs,7,0,81,74
1656287173980,COGS 100,A01,083619,Allen; Michael Gordon,2,0,70,68
1656287180007,COGS 101A,A01,083621,Davis; Joshua Daniel,4,0,68,64
1656287186031,COGS 101B,A01,091572,Allen; Michael Gordon,4,0,65,61
1656287192059,COGS 101C,A01,083625,Delgado; Tania,10,0,35,25
1656287198090,COGS 107A,A01,083627,Boyle; Mary E. T.,0,0,60,60
1656287204114,COGS 118A,A01,083075,Gupta; Anjum,8,0,76,68
1656287210144,CSE 3,A50,083646,Miranda; Gregory Joseph,18,0,50,32
1656287216171,CSE 8A,A50,083650,Miranda; Gregory Joseph,2,2,56,54
1656287222197,CSE 11,A01,083080,Cao; Yingjun,0,48,40,40
1656287228220,CSE 12,A01,083652,Krause-Levy; Sophia Louisa,5,1,120,115
1656287234247,CSE 15L,A01,083654,Morris; Justin Loren,2,0,50,48
1656287234247,CSE 15L,A02,083655,Morris; Justin Loren,4,0,50,46
1656287240273,CSE 20,A01,083657,Tran; Khoa Dang,30,0,80,50
1656287246299,CSE 21,A01,095574,Bach; Quang Tran,23,0,48,25
1656287252322,CSE 30,A01,083084,Eldon; John,2,6,80,78
1656287252322,CSE 30,B01,095061,Bhaskar; Nishant,0,1,50,50
1656287258345,CSE 100,A01,083659,Cao; Yingjun,1,18,70,69
1656287264373,CSE 134B,A01,083661,Powell; Thomas Allan,6,0,100,94
1656287270401,CSE 140,A01,083663,Gungor; Onat,8,0,85,77
1656287276428,CSE 140L,A01,083088,Eldon; John,10,0,100,90
1656287282452,CSE 175,A01,083665,Kumar; Rakesh,0,0,25,25
1656287288477,CSE 190,A00,092507,Dubnov; Shlomo,3,0,20,17
1656287294504,ECE 45,A01,083139,Congero; Spencer William,1,0,75,74
1656287300535,ECE 65,A50,083695,Saad; Andrew S,9,0,30,21
1656287300535,ECE 65,A51,095125,Staff,24,0,26,2
1656287306559,ECE 109,A01,091882,Touri; Behrouz,1,1,70,69
1656287312586,ECE 180,A00,083140,Abi Samra; Nicholas Camill,2,0,30,28
1656287312586,ECE 180,B00,083141,Abi Samra; Nicholas Camill,0,4,30,30
1656287318615,MATH 10A,A01,083735,Patchell; Gregory David,0,0,30,30
1656287318615,MATH 10A,A02,083736,Patchell; Gregory David,22,0,30,8
1656287318615,MATH 10A,A03,083737,Patchell; Gregory David,16,0,30,14
1656287324640,MATH 10B,A01,083207,Lim; Seonhee,1,0,34,33
1656287324640,MATH 10B,A02,083208,Lim; Seonhee,7,0,35,28
1656287324640,MATH 10B,A03,093472,Staff,1,0,34,33
1656287324640,MATH 10B,B01,083739,Sinha; Shubham,11,0,30,19
1656287330664,MATH 18,A01,083743,Cinel; Cameron Alexander,7,0,30,23
1656287330664,MATH 18,A02,083744,Cinel; Cameron Alexander,9,0,30,21
1656287330664,MATH 18,A03,083745,Cinel; Cameron Alexander,5,0,30,25
1656287330664,MATH 18,B01,083748,Rideout; David Porter,1,0,36,35
1656287330664,MATH 18,B02,083749,Rideout; David Porter,0,0,36,36
1656287330664,MATH 18,B03,083750,Rideout; David Porter,0,0,36,36
1656287330664,MATH 18,B04,083751,Rideout; David Porter,0,1,36,36
1656287330664,MATH 18,B05,093473,Rideout; David Porter,0,0,36,36
1656287330664,MATH 18,B06,093474,Rideout; David Porter,3,0,36,33
1656287336688,MATH 20A,A01,083754,Zheng; Zequn,11,0,40,29
1656287342715,MATH 20B,A01,083756,Briones; Jor-el Thomas Caparas,0,0,36,36
1656287342715,MATH 20B,A02,083757,Briones; Jor-el Thomas Caparas,0,0,36,36
1656287342715,MATH 20B,A03,093475,Staff,0,0,36,36
1656287348739,MATH 20C,A01,083760,Briones; Jor-el Thomas Caparas,0,0,35,35
1656287348739,MATH 20C,A02,083761,Briones; Jor-el Thomas Caparas,9,1,35,26
1656287348739,MATH 20C,A03,093476,Staff,0,0,35,35
1656287348739,MATH 20C,B01,083762,Bach; Quang Tran,1,0,30,29
1656287354763,MATH 20D,A01,083765,Tran; Brian Kha,1,0,30,29
1656287354763,MATH 20D,A02,083766,Tran; Brian Kha,0,1,30,30
1656287354763,MATH 20D,A03,083767,Tran; Brian Kha,2,0,30,28
1656287360791,MATH 20E,A01,083771,Ganguly; Soumya,3,0,32,29
1656287360791,MATH 20E,A02,083772,Ganguly; Soumya,0,0,32,32
1656287360791,MATH 20E,B01,083773,Ciotti; Benjamin,16,0,35,19
1656287360791,MATH 20E,B02,083774,Ciotti; Benjamin,15,0,35,20
1656287366821,MATH 103A,A01,083777,Greenfeld; Be'Eri,1,0,36,35
1656287366821,MATH 103A,A02,083778,Greenfeld; Be'Eri,2,0,36,34
1656287366821,MATH 103A,A03,093561,Staff,5,0,36,31
1656287366821,MATH 103A,B01,083779,Greenfeld; Be'Eri,8,0,36,28
1656287366821,MATH 103A,B02,083780,Greenfeld; Be'Eri,0,0,36,36
1656287366821,MATH 103A,B03,093562,Staff,0,0,36,36
1656287372848,MATH 105,A01,085443,Carter; Anne Toulson,5,0,35,30
1656287372848,MATH 105,A02,093477,Staff,14,0,35,21
1656287378872,MATH 109,A01,083213,Ganzberger; Geoffrey Michael,1,0,34,33
1656287378872,MATH 109,A02,083214,Ganzberger; Geoffrey Michael,0,0,34,34
1656287378872,MATH 109,A03,093478,Staff,2,0,34,32
1656287378872,MATH 109,B01,083215,Ganzberger; Geoffrey Michael,4,0,32,28
1656287378872,MATH 109,B02,083216,Ganzberger; Geoffrey Michael,1,0,32,31
1656287378872,MATH 109,B03,093479,Staff,3,0,32,29
1656287384895,MATH 142A,A01,083219,Chow; Bennett,1,0,32,31
1656287384895,MATH 142A,A02,083220,Chow; Bennett,8,0,32,24
1656287384895,MATH 142A,A03,093480,Staff,5,0,32,27
1656287384895,MATH 142A,B03,093481,Staff,3,0,32,29
1656287384895,MATH 142A,B04,093558,Staff,6,0,32,26
1656287384895,MATH 142A,B05,093559,Staff,0,0,32,32
1656287390919,MATH 193A,A01,083224,Rotar; Vladimir,0,1,34,34
1656287390919,MATH 193A,A02,083225,Rotar; Vladimir,0,0,34,34
1656287390919,MATH 193A,A03,083781,Rotar; Vladimir,0,0,34,34
1656287390919,MATH 193A,A04,083782,Rotar; Vladimir,6,0,34,28
1656287390919,MATH 193A,A05,093482,Rotar; Vladimir,0,0,34,34
1656287396944,MATH 197,001,091859,McAuley; Julian John,9999,0,9999,0
1656287396944,MATH 197,002,095566,Kedlaya; Kiran S.,9997,0,9999,2
1656287396944,MATH 197,003,095567,Xiao; Ming,9999,0,9999,0
1656287396944,MATH 197,004,095571,Perols; Johan Lars,9998,0,9999,1
1656287403998,COGS 9,A01,083615,Shannon; Kyle Michael,4,0,75,71
1656287410022,COGS 11,A01,083617,Boyle; Mary E. T.,15,0,48,33
1656287416049,COGS 13,A01,083071,Bastos; Amalia Pinkusfeld,5,0,71,66
1656287422072,COGS 14A,A01,092681,Semenuks; Arturs,1,13,100,99
1656287428094,COGS 14B,A01,083073,Cheng; Tzu-Han,7,0,63,56
1656287434120,COGS 17,A01,092677,Semenuks; Arturs,7,0,81,74
1656287440144,COGS 100,A01,083619,Allen; Michael Gordon,2,0,70,68
1656287446177,COGS 101A,A01,083621,Davis; Joshua Daniel,4,0,68,64
1656287452201,COGS 101B,A01,091572,Allen; Michael Gordon,4,0,65,61
1656287458228,COGS 101C,A01,083625,Delgado; Tania,10,0,35,25
1656287464252,COGS 107A,A01,083627,Boyle; Mary E. T.,0,0,60,60
1656287470278,COGS 118A,A01,083075,Gupta; Anjum,8,0,76,68
1656287476304,CSE 3,A50,083646,Miranda; Gregory Joseph,18,0,50,32
1656287482325,CSE 8A,A50,083650,Miranda; Gregory Joseph,2,2,56,54
1656287488351,CSE 11,A01,083080,Cao; Yingjun,0,48,40,40
1656287494380,CSE 12,A01,083652,Krause-Levy; Sophia Louisa,5,1,120,115
1656287500402,CSE 15L,A01,083654,Morris; Justin Loren,2,0,50,48
1656287500402,CSE 15L,A02,083655,Morris; Justin Loren,4,0,50,46
1656287506424,CSE 20,A01,083657,Tran; Khoa Dang,30,0,80,50
1656287512449,CSE 21,A01,095574,Bach; Quang Tran,23,0,48,25
1656287518476,CSE 30,A01,083084,Eldon; John,2,6,80,78
1656287518476,CSE 30,B01,095061,Bhaskar; Nishant,0,1,50,50
1656287524501,CSE 100,A01,083659,Cao; Yingjun,1,18,70,69
1656287530522,CSE 134B,A01,083661,Powell; Thomas Allan,6,0,100,94
1656287536622,CSE 140,A01,083663,Gungor; Onat,8,0,85,77
1656287542653,CSE 140L,A01,083088,Eldon; John,10,0,100,90
1656287548680,CSE 175,A01,083665,Kumar; Rakesh,0,0,25,25
1656287554704,CSE 190,A00,092507,Dubnov; Shlomo,3,0,20,17
1656287560735,ECE 45,A01,083139,Congero; Spencer William,1,0,75,74
1656287566762,ECE 65,A50,083695,Saad; Andrew S,9,0,30,21
1656287566762,ECE 65,A51,095125,Staff,24,0,26,2
1656287572791,ECE 109,A01,091882,Touri; Behrouz,1,1,70,69
1656287578817,ECE 180,A00,083140,Abi Samra; Nicholas Camill,2,0,30,28
1656287578817,ECE 180,B00,083141,Abi Samra; Nicholas Camill,0,4,30,30
1656287584845,MATH 10A,A01,083735,Patchell; Gregory David,0,0,30,30
1656287584845,MATH 10A,A02,083736,Patchell; Gregory David,22,0,30,8
1656287584845,MATH 10A,A03,083737,Patchell; Gregory David,16,0,30,14
1656287590874,MATH 10B,A01,083207,Lim; Seonhee,1,0,34,33
1656287590874,MATH 10B,A02,083208,Lim; Seonhee,7,0,35,28
1656287590874,MATH 10B,A03,093472,Staff,1,0,34,33
1656287590874,MATH 10B,B01,083739,Sinha; Shubham,11,0,30,19
1656287596898,MATH 18,A01,083743,Cinel; Cameron Alexander,7,0,30,23
1656287596898,MATH 18,A02,083744,Cinel; Cameron Alexander,9,0,30,21
1656287596898,MATH 18,A03,083745,Cinel; Cameron Alexander,5,0,30,25
1656287596898,MATH 18,B01,083748,Rideout; David Porter,1,0,36,35
1656287596898,MATH 18,B02,083749,Rideout; David Porter,0,0,36,36
1656287596898,MATH 18,B03,083750,Rideout; David Porter,0,0,36,36
1656287596898,MATH 18,B04,083751,Rideout; David Porter,0,1,36,36
1656287596898,MATH 18,B05,093473,Rideout; David Porter,0,0,36,36
1656287596898,MATH 18,B06,093474,Rideout; David Porter,3,0,36,33
1656287602922,MATH 20A,A01,083754,Zheng; Zequn,11,0,40,29
1656287608959,MATH 20B,A01,083756,Briones; Jor-el Thomas Caparas,0,0,36,36
1656287608959,MATH 20B,A02,083757,Briones; Jor-el Thomas Caparas,0,0,36,36
1656287608959,MATH 20B,A03,093475,Staff,0,0,36,36
1656287614991,MATH 20C,A01,083760,Briones; Jor-el Thomas Caparas,0,0,35,35
1656287614991,MATH 20C,A02,083761,Briones; Jor-el Thomas Caparas,9,1,35,26
1656287614991,MATH 20C,A03,093476,Staff,0,0,35,35
1656287614991,MATH 20C,B01,083762,Bach; Quang Tran,1,0,30,29
1656287621018,MATH 20D,A01,083765,Tran; Brian Kha,1,0,30,29
1656287621018,MATH 20D,A02,083766,Tran; Brian Kha,0,1,30,30
1656287621018,MATH 20D,A03,083767,Tran; Brian Kha,2,0,30,28
1656287627045,MATH 20E,A01,083771,Ganguly; Soumya,3,0,32,29
1656287627045,MATH 20E,A02,083772,Ganguly; Soumya,0,0,32,32
1656287627045,MATH 20E,B01,083773,Ciotti; Benjamin,16,0,35,19
1656287627045,MATH 20E,B02,083774,Ciotti; Benjamin,15,0,35,20
1656287633076,MATH 103A,A01,083777,Greenfeld; Be'Eri,1,0,36,35
1656287633076,MATH 103A,A02,083778,Greenfeld; Be'Eri,2,0,36,34
1656287633076,MATH 103A,A03,093561,Staff,5,0,36,31
1656287633076,MATH 103A,B01,083779,Greenfeld; Be'Eri,8,0,36,28
1656287633076,MATH 103A,B02,083780,Greenfeld; Be'Eri,0,0,36,36
1656287633076,MATH 103A,B03,093562,Staff,0,0,36,36
1656287639100,MATH 105,A01,085443,Carter; Anne Toulson,5,0,35,30
1656287639100,MATH 105,A02,093477,Staff,14,0,35,21
1656287645126,MATH 109,A01,083213,Ganzberger; Geoffrey Michael,1,0,34,33
1656287645126,MATH 109,A02,083214,Ganzberger; Geoffrey Michael,0,0,34,34
1656287645126,MATH 109,A03,093478,Staff,2,0,34,32
1656287645126,MATH 109,B01,083215,Ganzberger; Geoffrey Michael,4,0,32,28
1656287645126,MATH 109,B02,083216,Ganzberger; Geoffrey Michael,1,0,32,31
1656287645126,MATH 109,B03,093479,Staff,3,0,32,29
1656287651157,MATH 142A,A01,083219,Chow; Bennett,1,0,32,31
1656287651157,MATH 142A,A02,083220,Chow; Bennett,8,0,32,24
1656287651157,MATH 142A,A03,093480,Staff,5,0,32,27
1656287651157,MATH 142A,B03,093481,Staff,3,0,32,29
1656287651157,MATH 142A,B04,093558,Staff,6,0,32,26
1656287651157,MATH 142A,B05,093559,Staff,0,0,32,32
1656287657191,MATH 193A,A01,083224,Rotar; Vladimir,0,1,34,34
1656287657191,MATH 193A,A02,083225,Rotar; Vladimir,0,0,34,34
1656287657191,MATH 193A,A03,083781,Rotar; Vladimir,0,0,34,34
1656287657191,MATH 193A,A04,083782,Rotar; Vladimir,6,0,34,28
1656287657191,MATH 193A,A05,093482,Rotar; Vladimir,0,0,34,34
1656287663223,MATH 197,001,091859,McAuley; Julian John,9999,0,9999,0
1656287663223,MATH 197,002,095566,Kedlaya; Kiran S.,9997,0,9999,2
1656287663223,MATH 197,003,095567,Xiao; Ming,9999,0,9999,0
1656287663223,MATH 197,004,095571,Perols; Johan Lars,9998,0,9999,1
1656287670285,COGS 9,A01,083615,Shannon; Kyle Michael,4,0,75,71
1656287676311,COGS 11,A01,083617,Boyle; Mary E. T.,15,0,48,33
1656287682347,COGS 13,A01,083071,Bastos; Amalia Pinkusfeld,5,0,71,66
1656287688371,COGS 14A,A01,092681,Semenuks; Arturs,1,13,100,99
1656287694395,COGS 14B,A01,083073,Cheng; Tzu-Han,7,0,63,56
1656287700422,COGS 17,A01,092677,Semenuks; Arturs,7,0,81,74
1656287706444,COGS 100,A01,083619,Allen; Michael Gordon,2,0,70,68
1656287712484,COGS 101A,A01,083621,Davis; Joshua Daniel,4,0,68,64
1656287718511,COGS 101B,A01,091572,Allen; Michael Gordon,4,0,65,61
1656287724538,COGS 101C,A01,083625,Delgado; Tania,10,0,35,25
1656287730564,COGS 107A,A01,083627,Boyle; Mary E. T.,0,0,60,60
1656287736591,COGS 118A,A01,083075,Gupta; Anjum,8,0,76,68
1656287742615,CSE 3,A50,083646,Miranda; Gregory Joseph,18,0,50,32
1656287748640,CSE 8A,A50,083650,Miranda; Gregory Joseph,2,2,56,54
1656287754664,CSE 11,A01,083080,Cao; Yingjun,0,48,40,40
1656287760688,CSE 12,A01,083652,Krause-Levy; Sophia Louisa,5,1,120,115
1656287766712,CSE 15L,A01,083654,Morris; Justin Loren,2,0,50,48
1656287766712,CSE 15L,A02,083655,Morris; Justin Loren,4,0,50,46
1656287772738,CSE 20,A01,083657,Tran; Khoa Dang,30,0,80,50
1656287778760,CSE 21,A01,095574,Bach; Quang Tran,23,0,48,25
1656287784784,CSE 30,A01,083084,Eldon; John,2,6,80,78
1656287784784,CSE 30,B01,095061,Bhaskar; Nishant,0,1,50,50
1656287790808,CSE 100,A01,083659,Cao; Yingjun,1,18,70,69
1656287796835,CSE 134B,A01,083661,Powell; Thomas Allan,6,0,100,94
1656287802863,CSE 140,A01,083663,Gungor; Onat,8,0,85,77
1656287808888,CSE 140L,A01,083088,Eldon; John,10,0,100,90
1656287814916,CSE 175,A01,083665,Kumar; Rakesh,0,0,25,25
1656287820951,CSE 190,A00,092507,Dubnov; Shlomo,3,0,20,17
1656287826981,ECE 45,A01,083139,Congero; Spencer William,1,0,75,74
1656287833008,ECE 65,A50,083695,Saad; Andrew S,9,0,30,21
1656287833008,ECE 65,A51,095125,Staff,24,0,26,2
1656287839036,ECE 109,A01,091882,Touri; Behrouz,1,1,70,69
1656287845062,ECE 180,A00,083140,Abi Samra; Nicholas Camill,2,0,30,28
1656287845062,ECE 180,B00,083141,Abi Samra; Nicholas Camill,0,4,30,30
1656287851085,MATH 10A,A01,083735,Patchell; Gregory David,0,0,30,30
1656287851085,MATH 10A,A02,083736,Patchell; Gregory David,22,0,30,8
1656287851085,MATH 10A,A03,083737,Patchell; Gregory David,16,0,30,14
1656287857116,MATH 10B,A01,083207,Lim; Seonhee,1,0,34,33
1656287857116,MATH 10B,A02,083208,Lim; Seonhee,7,0,35,28
1656287857116,MATH 10B,A03,093472,Staff,1,0,34,33
1656287857116,MATH 10B,B01,083739,Sinha; Shubham,11,0,30,19
1656287863140,MATH 18,A01,083743,Cinel; Cameron Alexander,7,0,30,23
1656287863140,MATH 18,A02,083744,Cinel; Cameron Alexander,9,0,30,21
1656287863140,MATH 18,A03,083745,Cinel; Cameron Alexander,5,0,30,25
1656287863140,MATH 18,B01,083748,Rideout; David Porter,1,0,36,35
1656287863140,MATH 18,B02,083749,Rideout; David Porter,0,0,36,36
1656287863140,MATH 18,B03,083750,Rideout; David Porter,0,0,36,36
1656287863140,MATH 18,B04,083751,Rideout; David Porter,0,1,36,36
1656287863140,MATH 18,B05,093473,Rideout; David Porter,0,0,36,36
1656287863140,MATH 18,B06,093474,Rideout; David Porter,3,0,36,33
1656287869162,MATH 20A,A01,083754,Zheng; Zequn,11,0,40,29
1656287875191,MATH 20B,A01,083756,Briones; Jor-el Thomas Caparas,0,0,36,36
1656287875191,MATH 20B,A02,083757,Briones; Jor-el Thomas Caparas,0,0,36,36
1656287875191,MATH 20B,A03,093475,Staff,0,0,36,36
1656287881220,MATH 20C,A01,083760,Briones; Jor-el Thomas Caparas,0,0,35,35
1656287881220,MATH 20C,A02,083761,Briones; Jor-el Thomas Caparas,9,1,35,26
1656287881220,MATH 20C,A03,093476,Staff,0,0,35,35
1656287881220,MATH 20C,B01,083762,Bach; Quang Tran,1,0,30,29
1656287887249,MATH 20D,A01,083765,Tran; Brian Kha,1,0,30,29
1656287887249,MATH 20D,A02,083766,Tran; Brian Kha,0,1,30,30
1656287887249,MATH 20D,A03,083767,Tran; Brian Kha,2,0,30,28
1656287893278,MATH 20E,A01,083771,Ganguly; Soumya,3,0,32,29
1656287893278,MATH 20E,A02,083772,Ganguly; Soumya,0,0,32,32
1656287893278,MATH 20E,B01,083773,Ciotti; Benjamin,16,0,35,19
1656287893278,MATH 20E,B02,083774,Ciotti; Benjamin,15,0,35,20
1656287899303,MATH 103A,A01,083777,Greenfeld; Be'Eri,1,0,36,35
1656287899303,MATH 103A,A02,083778,Greenfeld; Be'Eri,2,0,36,34
1656287899303,MATH 103A,A03,093561,Staff,4,0,36,32
1656287899303,MATH 103A,B01,083779,Greenfeld; Be'Eri,8,0,36,28
1656287899303,MATH 103A,B02,083780,Greenfeld; Be'Eri,0,0,36,36
1656287899303,MATH 103A,B03,093562,Staff,1,0,36,35
1656287905331,MATH 105,A01,085443,Carter; Anne Toulson,5,0,35,30
1656287905331,MATH 105,A02,093477,Staff,14,0,35,21
1656287911366,MATH 109,A01,083213,Ganzberger; Geoffrey Michael,1,0,34,33
1656287911366,MATH 109,A02,083214,Ganzberger; Geoffrey Michael,0,0,34,34
1656287911366,MATH 109,A03,093478,Staff,2,0,34,32
1656287911366,MATH 109,B01,083215,Ganzberger; Geoffrey Michael,4,0,32,28
1656287911366,MATH 109,B02,083216,Ganzberger; Geoffrey Michael,1,0,32,31
1656287911366,MATH 109,B03,093479,Staff,3,0,32,29
1656287917390,MATH 142A,A01,083219,Chow; Bennett,1,0,32,31
1656287917390,MATH 142A,A02,083220,Chow; Bennett,8,0,32,24
1656287917390,MATH 142A,A03,093480,Staff,5,0,32,27
1656287917390,MATH 142A,B03,093481,Staff,3,0,32,29
1656287917390,MATH 142A,B04,093558,Staff,6,0,32,26
1656287917390,MATH 142A,B05,093559,Staff,0,0,32,32
1656287923417,MATH 193A,A01,083224,Rotar; Vladimir,0,1,34,34
1656287923417,MATH 193A,A02,083225,Rotar; Vladimir,0,0,34,34
1656287923417,MATH 193A,A03,083781,Rotar; Vladimir,0,0,34,34
1656287923417,MATH 193A,A04,083782,Rotar; Vladimir,6,0,34,28
1656287923417,MATH 193A,A05,093482,Rotar; Vladimir,0,0,34,34
1656287929442,MATH 197,001,091859,McAuley; Julian John,9999,0,9999,0
1656287929442,MATH 197,002,095566,Kedlaya; Kiran S.,9997,0,9999,2
1656287929442,MATH 197,003,095567,Xiao; Ming,9999,0,9999,0
1656287929442,MATH 197,004,095571,Perols; Johan Lars,9998,0,9999,1
1656287936506,COGS 9,A01,083615,Shannon; Kyle Michael,3,0,75,72
1656287942541,COGS 11,A01,083617,Boyle; Mary E. T.,15,0,48,33
1656287948568,COGS 13,A01,083071,Bastos; Amalia Pinkusfeld,5,0,71,66
1656287954597,COGS 14A,A01,092681,Semenuks; Arturs,1,13,100,99
1656287960619,COGS 14B,A01,083073,Cheng; Tzu-Han,7,0,63,56
1656287966648,COGS 17,A01,092677,Semenuks; Arturs,7,0,81,74
1656287972670,COGS 100,A01,083619,Allen; Michael Gordon,2,0,70,68
1656287978699,COGS 101A,A01,083621,Davis; Joshua Daniel,4,0,68,64
1656287984727,COGS 101B,A01,091572,Allen; Michael Gordon,4,0,65,61
1656287990754,COGS 101C,A01,083625,Delgado; Tania,10,0,35,25
1656287996787,COGS 107A,A01,083627,Boyle; Mary E. T.,0,0,60,60
1656288002817,COGS 118A,A01,083075,Gupta; Anjum,8,0,76,68
1656288008841,CSE 3,A50,083646,Miranda; Gregory Joseph,18,0,50,32
1656288014865,CSE 8A,A50,083650,Miranda; Gregory Joseph,2,3,56,54
1656288020890,CSE 11,A01,083080,Cao; Yingjun,0,48,40,40
1656288026914,CSE 12,A01,083652,Krause-Levy; Sophia Louisa,5,1,120,115
1656288032939,CSE 15L,A01,083654,Morris; Justin Loren,2,0,50,48
1656288032939,CSE 15L,A02,083655,Morris; Justin Loren,4,0,50,46
1656288038977,CSE 20,A01,083657,Tran; Khoa Dang,30,0,80,50
1656288045001,CSE 21,A01,095574,Bach; Quang Tran,23,0,48,25
1656288051026,CSE 30,A01,083084,Eldon; John,2,6,80,78
1656288051026,CSE 30,B01,095061,Bhaskar; Nishant,0,1,50,50
1656288057048,CSE 100,A01,083659,Cao; Yingjun,1,18,70,69
1656288063072,CSE 134B,A01,083661,Powell; Thomas Allan,6,0,100,94
1656288069100,CSE 140,A01,083663,Gungor; Onat,8,0,85,77
1656288075124,CSE 140L,A01,083088,Eldon; John,10,0,100,90
1656288081146,CSE 175,A01,083665,Kumar; Rakesh,0,0,25,25
1656288087169,CSE 190,A00,092507,Dubnov; Shlomo,3,0,20,17
1656288093193,ECE 45,A01,083139,Congero; Spencer William,1,0,75,74
1656288099217,ECE 65,A50,083695,Saad; Andrew S,9,0,30,21
1656288099217,ECE 65,A51,095125,Staff,24,0,26,2
1656288105241,ECE 109,A01,091882,Touri; Behrouz,1,1,70,69
1656288111265,ECE 180,A00,083140,Abi Samra; Nicholas Camill,2,0,30,28
1656288111265,ECE 180,B00,083141,Abi Samra; Nicholas Camill,0,4,30,30
1656288117290,MATH 10A,A01,083735,Patchell; Gregory David,0,0,30,30
1656288117290,MATH 10A,A02,083736,Patchell; Gregory David,22,0,30,8
1656288117290,MATH 10A,A03,083737,Patchell; Gregory David,16,0,30,14
1656288123316,MATH 10B,A01,083207,Lim; Seonhee,1,0,34,33
1656288123316,MATH 10B,A02,083208,Lim; Seonhee,7,0,35,28
1656288123316,MATH 10B,A03,093472,Staff,1,0,34,33
1656288123316,MATH 10B,B01,083739,Sinha; Shubham,11,0,30,19
1656288129357,MATH 18,A01,083743,Cinel; Cameron Alexander,7,0,30,23
1656288129357,MATH 18,A02,083744,Cinel; Cameron Alexander,9,0,30,21
1656288129357,MATH 18,A03,083745,Cinel; Cameron Alexander,5,0,30,25
1656288129357,MATH 18,B01,083748,Rideout; David Porter,1,0,36,35
1656288129357,MATH 18,B02,083749,Rideout; David Porter,0,0,36,36
1656288129357,MATH 18,B03,083750,Rideout; David Porter,0,0,36,36
1656288129357,MATH 18,B04,083751,Rideout; David Porter,0,1,36,36
1656288129357,MATH 18,B05,093473,Rideout; David Porter,0,0,36,36
1656288129357,MATH 18,B06,093474,Rideout; David Porter,3,0,36,33
1656288135467,MATH 20A,A01,083754,Zheng; Zequn,11,0,40,29
1656288141491,MATH 20B,A01,083756,Briones; Jor-el Thomas Caparas,0,0,36,36
1656288141491,MATH 20B,A02,083757,Briones; Jor-el Thomas Caparas,0,0,36,36
1656288141491,MATH 20B,A03,093475,Staff,0,0,36,36
1656288147519,MATH 20C,A01,083760,Briones; Jor-el Thomas Caparas,0,0,35,35
1656288147519,MATH 20C,A02,083761,Briones; Jor-el Thomas Caparas,9,1,35,26
1656288147519,MATH 20C,A03,093476,Staff,0,0,35,35
1656288147519,MATH 20C,B01,083762,Bach; Quang Tran,1,0,30,29
1656288153551,MATH 20D,A01,083765,Tran; Brian Kha,1,0,30,29
1656288153551,MATH 20D,A02,083766,Tran; Brian Kha,0,1,30,30
1656288153551,MATH 20D,A03,083767,Tran; Brian Kha,2,0,30,28
1656288159587,MATH 20E,A01,083771,Ganguly; Soumya,3,0,32,29
1656288159587,MATH 20E,A02,083772,Ganguly; Soumya,0,0,32,32
1656288159587,MATH 20E,B01,083773,Ciotti; Benjamin,16,0,35,19
1656288159587,MATH 20E,B02,083774,Ciotti; Benjamin,15,0,35,20
1656288165630,MATH 103A,A01,083777,Greenfeld; Be'Eri,1,0,36,35
1656288165630,MATH 103A,A02,083778,Greenfeld; Be'Eri,2,0,36,34
1656288165630,MATH 103A,A03,093561,Staff,4,0,36,32
1656288165630,MATH 103A,B01,083779,Greenfeld; Be'Eri,8,0,36,28
1656288165630,MATH 103A,B02,083780,Greenfeld; Be'Eri,0,0,36,36
1656288165630,MATH 103A,B03,093562,Staff,1,0,36,35
1656288171658,MATH 105,A01,085443,Carter; Anne Toulson,5,0,35,30
1656288171658,MATH 105,A02,093477,Staff,14,0,35,21
1656288177681,MATH 109,A01,083213,Ganzberger; Geoffrey Michael,1,0,34,33
1656288177681,MATH 109,A02,083214,Ganzberger; Geoffrey Michael,0,0,34,34
1656288177681,MATH 109,A03,093478,Staff,2,0,34,32
1656288177681,MATH 109,B01,083215,Ganzberger; Geoffrey Michael,4,0,32,28
1656288177681,MATH 109,B02,083216,Ganzberger; Geoffrey Michael,1,0,32,31
1656288177681,MATH 109,B03,093479,Staff,3,0,32,29
1656288183711,MATH 142A,A01,083219,Chow; Bennett,1,0,32,31
1656288183711,MATH 142A,A02,083220,Chow; Bennett,8,0,32,24
1656288183711,MATH 142A,A03,093480,Staff,5,0,32,27
1656288183711,MATH 142A,B03,093481,Staff,3,0,32,29
1656288183711,MATH 142A,B04,093558,Staff,6,0,32,26
1656288183711,MATH 142A,B05,093559,Staff,0,0,32,32
1656288189734,MATH 193A,A01,083224,Rotar; Vladimir,0,1,34,34
1656288189734,MATH 193A,A02,083225,Rotar; Vladimir,0,0,34,34
1656288189734,MATH 193A,A03,083781,Rotar; Vladimir,0,0,34,34
1656288189734,MATH 193A,A04,083782,Rotar; Vladimir,6,0,34,28
1656288189734,MATH 193A,A05,093482,Rotar; Vladimir,0,0,34,34
1656288195757,MATH 197,001,091859,McAuley; Julian John,9999,0,9999,0
1656288195757,MATH 197,002,095566,Kedlaya; Kiran S.,9997,0,9999,2
1656288195757,MATH 197,003,095567,Xiao; Ming,9999,0,9999,0
1656288195757,MATH 197,004,095571,Perols; Johan Lars,9998,0,9999,1
1656288202819,COGS 9,A01,083615,Shannon; Kyle Michael,3,0,75,72
1656288208843,COGS 11,A01,083617,Boyle; Mary E. T.,15,0,48,33
1656288214869,COGS 13,A01,083071,Bastos; Amalia Pinkusfeld,5,0,71,66
1656288220893,COGS 14A,A01,092681,Semenuks; Arturs,1,13,100,99
1656288226917,COGS 14B,A01,083073,Cheng; Tzu-Han,7,0,63,56
1656288232941,COGS 17,A01,092677,Semenuks; Arturs,7,0,81,74
1656288238967,COGS 100,A01,083619,Allen; Michael Gordon,2,0,70,68
1656288244995,COGS 101A,A01,083621,Davis; Joshua Daniel,4,0,68,64
1656288251017,COGS 101B,A01,091572,Allen; Michael Gordon,4,0,65,61
1656288257041,COGS 101C,A01,083625,Delgado; Tania,11,0,35,24
1656288263069,COGS 107A,A01,083627,Boyle; Mary E. T.,0,0,60,60
1656288269094,COGS 118A,A01,083075,Gupta; Anjum,8,0,76,68
1656288275118,CSE 3,A50,083646,Miranda; Gregory Joseph,18,0,50,32
1656288281141,CSE 8A,A50,083650,Miranda; Gregory Joseph,2,3,56,54
1656288287164,CSE 11,A01,083080,Cao; Yingjun,0,48,40,40
1656288293202,CSE 12,A01,083652,Krause-Levy; Sophia Louisa,5,1,120,115
1656288299226,CSE 15L,A01,083654,Morris; Justin Loren,2,0,50,48
1656288299226,CSE 15L,A02,083655,Morris; Justin Loren,4,0,50,46
1656288305249,CSE 20,A01,083657,Tran; Khoa Dang,30,0,80,50
1656288311275,CSE 21,A01,095574,Bach; Quang Tran,23,0,48,25
1656288317300,CSE 30,A01,083084,Eldon; John,2,6,80,78
1656288317300,CSE 30,B01,095061,Bhaskar; Nishant,0,1,50,50
1656288323324,CSE 100,A01,083659,Cao; Yingjun,1,18,70,69
1656288329351,CSE 134B,A01,083661,Powell; Thomas Allan,6,0,100,94
1656288335377,CSE 140,A01,083663,Gungor; Onat,8,0,85,77
1656288341404,CSE 140L,A01,083088,Eldon; John,10,0,100,90
1656288347427,CSE 175,A01,083665,Kumar; Rakesh,0,0,25,25
1656288353451,CSE 190,A00,092507,Dubnov; Shlomo,3,0,20,17
1656288359483,ECE 45,A01,083139,Congero; Spencer William,1,0,75,74
1656288365510,ECE 65,A50,083695,Saad; Andrew S,9,0,30,21
1656288365510,ECE 65,A51,095125,Staff,24,0,26,2
1656288371532,ECE 109,A01,091882,Touri; Behrouz,1,1,70,69
1656288377555,ECE 180,A00,083140,Abi Samra; Nicholas Camill,2,0,30,28
1656288377555,ECE 180,B00,083141,Abi Samra; Nicholas Camill,0,4,30,30
1656288383583,MATH 10A,A01,083735,Patchell; Gregory David,0,0,30,30
1656288383583,MATH 10A,A02,083736,Patchell; Gregory David,22,0,30,8
1656288383583,MATH 10A,A03,083737,Patchell; Gregory David,16,0,30,14
1656288389610,MATH 10B,A01,083207,Lim; Seonhee,1,0,34,33
1656288389610,MATH 10B,A02,083208,Lim; Seonhee,7,0,35,28
1656288389610,MATH 10B,A03,093472,Staff,1,0,34,33
1656288389610,MATH 10B,B01,083739,Sinha; Shubham,11,0,30,19
1656288395641,MATH 18,A01,083743,Cinel; Cameron Alexander,7,0,30,23
1656288395641,MATH 18,A02,083744,Cinel; Cameron Alexander,9,0,30,21
1656288395641,MATH 18,A03,083745,Cinel; Cameron Alexander,5,0,30,25
1656288395641,MATH 18,B01,083748,Rideout; David Porter,1,0,36,35
1656288395641,MATH 18,B02,083749,Rideout; David Porter,0,0,36,36
1656288395641,MATH 18,B03,083750,Rideout; David Porter,0,0,36,36
1656288395641,MATH 18,B04,083751,Rideout; David Porter,0,1,36,36
1656288395641,MATH 18,B05,093473,Rideout; David Porter,0,0,36,36
1656288395641,MATH 18,B06,093474,Rideout; David Porter,3,0,36,33
1656288401668,MATH 20A,A01,083754,Zheng; Zequn,11,0,40,29
1656288407691,MATH 20B,A01,083756,Briones; Jor-el Thomas Caparas,0,0,36,36
1656288407691,MATH 20B,A02,083757,Briones; Jor-el Thomas Caparas,0,0,36,36
1656288407691,MATH 20B,A03,093475,Staff,0,0,36,36
1656288413736,MATH 20C,A01,083760,Briones; Jor-el Thomas Caparas,0,0,35,35
1656288413736,MATH 20C,A02,083761,Briones; Jor-el Thomas Caparas,9,1,35,26
1656288413736,MATH 20C,A03,093476,Staff,0,0,35,35
1656288413736,MATH 20C,B01,083762,Bach; Quang Tran,1,0,30,29
1656288419764,MATH 20D,A01,083765,Tran; Brian Kha,1,0,30,29
1656288419764,MATH 20D,A02,083766,Tran; Brian Kha,0,1,30,30
1656288419764,MATH 20D,A03,083767,Tran; Brian Kha,2,0,30,28
1656288425795,MATH 20E,A01,083771,Ganguly; Soumya,3,0,32,29
1656288425795,MATH 20E,A02,083772,Ganguly; Soumya,0,0,32,32
1656288425795,MATH 20E,B01,083773,Ciotti; Benjamin,16,0,35,19
1656288425795,MATH 20E,B02,083774,Ciotti; Benjamin,15,0,35,20
1656288431823,MATH 103A,A01,083777,Greenfeld; Be'Eri,1,0,36,35
1656288431823,MATH 103A,A02,083778,Greenfeld; Be'Eri,2,0,36,34
1656288431823,MATH 103A,A03,093561,Staff,4,0,36,32
1656288431823,MATH 103A,B01,083779,Greenfeld; Be'Eri,8,0,36,28
1656288431823,MATH 103A,B02,083780,Greenfeld; Be'Eri,0,0,36,36
1656288431823,MATH 103A,B03,093562,Staff,1,0,36,35
1656288437851,MATH 105,A01,085443,Carter; Anne Toulson,5,0,35,30
1656288437851,MATH 105,A02,093477,Staff,14,0,35,21
1656288443881,MATH 109,A01,083213,Ganzberger; Geoffrey Michael,1,0,34,33
1656288443881,MATH 109,A02,083214,Ganzberger; Geoffrey Michael,0,0,34,34
1656288443881,MATH 109,A03,093478,Staff,2,0,34,32
1656288443881,MATH 109,B01,083215,Ganzberger; Geoffrey Michael,4,0,32,28
1656288443881,MATH 109,B02,083216,Ganzberger; Geoffrey Michael,1,0,32,31
1656288443881,MATH 109,B03,093479,Staff,3,0,32,29
1656288449910,MATH 142A,A01,083219,Chow; Bennett,1,0,32,31
1656288449910,MATH 142A,A02,083220,Chow; Bennett,8,0,32,24
1656288449910,MATH 142A,A03,093480,Staff,5,0,32,27
1656288449910,MATH 142A,B03,093481,Staff,3,0,32,29
1656288449910,MATH 142A,B04,093558,Staff,6,0,32,26
1656288449910,MATH 142A,B05,093559,Staff,0,0,32,32
1656288455935,MATH 193A,A01,083224,Rotar; Vladimir,0,1,34,34
1656288455935,MATH 193A,A02,083225,Rotar; Vladimir,0,0,34,34
1656288455935,MATH 193A,A03,083781,Rotar; Vladimir,0,0,34,34
1656288455935,MATH 193A,A04,083782,Rotar; Vladimir,6,0,34,28
1656288455935,MATH 193A,A05,093482,Rotar; Vladimir,0,0,34,34
1656288461958,MATH 197,001,091859,McAuley; Julian John,9999,0,9999,0
1656288461958,MATH 197,002,095566,Kedlaya; Kiran S.,9997,0,9999,2
1656288461958,MATH 197,003,095567,Xiao; Ming,9999,0,9999,0
1656288461958,MATH 197,004,095571,Perols; Johan Lars,9998,0,9999,1
1656288469013,COGS 9,A01,083615,Shannon; Kyle Michael,3,0,75,72
1656288475037,COGS 11,A01,083617,Boyle; Mary E. T.,15,0,48,33
1656288481061,COGS 13,A01,083071,Bastos; Amalia Pinkusfeld,5,0,71,66
1656288487084,COGS 14A,A01,092681,Semenuks; Arturs,1,13,100,99
1656288493111,COGS 14B,A01,083073,Cheng; Tzu-Han,7,0,63,56
1656288499137,COGS 17,A01,092677,Semenuks; Arturs,7,0,81,74
1656288505161,COGS 100,A01,083619,Allen; Michael Gordon,2,0,70,68
1656288511193,COGS 101A,A01,083621,Davis; Joshua Daniel,4,0,68,64
1656288517215,COGS 101B,A01,091572,Allen; Michael Gordon,4,0,65,61
1656288523237,COGS 101C,A01,083625,Delgado; Tania,11,0,35,24
1656288529265,COGS 107A,A01,083627,Boyle; Mary E. T.,0,0,60,60
1656288535292,COGS 118A,A01,083075,Gupta; Anjum,8,0,76,68
1656288541316,CSE 3,A50,083646,Miranda; Gregory Joseph,18,0,50,32
1656288547338,CSE 8A,A50,083650,Miranda; Gregory Joseph,2,3,56,54
1656288553359,CSE 11,A01,083080,Cao; Yingjun,0,48,40,40
1656288559383,CSE 12,A01,083652,Krause-Levy; Sophia Louisa,5,1,120,115
1656288565408,CSE 15L,A01,083654,Morris; Justin Loren,2,0,50,48
1656288565408,CSE 15L,A02,083655,Morris; Justin Loren,4,0,50,46
1656288571430,CSE 20,A01,083657,Tran; Khoa Dang,30,0,80,50
1656288577455,CSE 21,A01,095574,Bach; Quang Tran,23,0,48,25
1656288583478,CSE 30,A01,083084,Eldon; John,2,6,80,78
1656288583478,CSE 30,B01,095061,Bhaskar; Nishant,0,1,50,50
1656288589504,CSE 100,A01,083659,Cao; Yingjun,1,18,70,69
1656288595526,CSE 134B,A01,083661,Powell; Thomas Allan,6,0,100,94
1656288601548,CSE 140,A01,083663,Gungor; Onat,8,0,85,77
1656288607579,CSE 140L,A01,083088,Eldon; John,10,0,100,90
1656288613600,CSE 175,A01,083665,Kumar; Rakesh,0,0,25,25
1656288619624,CSE 190,A00,092507,Dubnov; Shlomo,3,0,20,17
1656288625671,ECE 45,A01,083139,Congero; Spencer William,1,0,75,74
1656288631695,ECE 65,A50,083695,Saad; Andrew S,9,0,30,21
1656288631695,ECE 65,A51,095125,Staff,24,0,26,2
1656288637722,ECE 109,A01,091882,Touri; Behrouz,1,1,70,69
1656288643750,ECE 180,A00,083140,Abi Samra; Nicholas Camill,2,0,30,28
1656288643750,ECE 180,B00,083141,Abi Samra; Nicholas Camill,0,4,30,30
1656288649777,MATH 10A,A01,083735,Patchell; Gregory David,0,0,30,30
1656288649777,MATH 10A,A02,083736,Patchell; Gregory David,22,0,30,8
1656288649777,MATH 10A,A03,083737,Patchell; Gregory David,16,0,30,14
1656288655805,MATH 10B,A01,083207,Lim; Seonhee,1,0,34,33
1656288655805,MATH 10B,A02,083208,Lim; Seonhee,7,0,35,28
1656288655805,MATH 10B,A03,093472,Staff,1,0,34,33
1656288655805,MATH 10B,B01,083739,Sinha; Shubham,11,0,30,19
1656288661833,MATH 18,A01,083743,Cinel; Cameron Alexander,7,0,30,23
1656288661833,MATH 18,A02,083744,Cinel; Cameron Alexander,9,0,30,21
1656288661833,MATH 18,A03,083745,Cinel; Cameron Alexander,5,0,30,25
1656288661833,MATH 18,B01,083748,Rideout; David Porter,1,0,36,35
1656288661833,MATH 18,B02,083749,Rideout; David Porter,0,0,36,36
1656288661833,MATH 18,B03,083750,Rideout; David Porter,0,0,36,36
1656288661833,MATH 18,B04,083751,Rideout; David Porter,0,1,36,36
1656288661833,MATH 18,B05,093473,Rideout; David Porter,0,0,36,36
1656288661833,MATH 18,B06,093474,Rideout; David Porter,3,0,36,33
1656288667866,MATH 20A,A01,083754,Zheng; Zequn,11,0,40,29
1656288673894,MATH 20B,A01,083756,Briones; Jor-el Thomas Caparas,0,0,36,36
1656288673894,MATH 20B,A02,083757,Briones; Jor-el Thomas Caparas,0,0,36,36
1656288673894,MATH 20B,A03,093475,Staff,0,0,36,36
1656288679924,MATH 20C,A01,083760,Briones; Jor-el Thomas Caparas,0,0,35,35
1656288679924,MATH 20C,A02,083761,Briones; Jor-el Thomas Caparas,9,1,35,26
1656288679924,MATH 20C,A03,093476,Staff,0,0,35,35
1656288679924,MATH 20C,B01,083762,Bach; Quang Tran,1,0,30,29
1656288685950,MATH 20D,A01,083765,Tran; Brian Kha,1,0,30,29
1656288685950,MATH 20D,A02,083766,Tran; Brian Kha,0,1,30,30
1656288685950,MATH 20D,A03,083767,Tran; Brian Kha,2,0,30,28
1656288691974,MATH 20E,A01,083771,Ganguly; Soumya,3,0,32,29
1656288691974,MATH 20E,A02,083772,Ganguly; Soumya,0,0,32,32
1656288691974,MATH 20E,B01,083773,Ciotti; Benjamin,16,0,35,19
1656288691974,MATH 20E,B02,083774,Ciotti; Benjamin,15,0,35,20
1656288698000,MATH 103A,A01,083777,Greenfeld; Be'Eri,1,0,36,35
1656288698000,MATH 103A,A02,083778,Greenfeld; Be'Eri,2,0,36,34
1656288698000,MATH 103A,A03,093561,Staff,4,0,36,32
1656288698000,MATH 103A,B01,083779,Greenfeld; Be'Eri,8,0,36,28
1656288698000,MATH 103A,B02,083780,Greenfeld; Be'Eri,0,0,36,36
1656288698000,MATH 103A,B03,093562,Staff,1,0,36,35
1656288704025,MATH 105,A01,085443,Carter; Anne Toulson,5,0,35,30
1656288704025,MATH 105,A02,093477,Staff,14,0,35,21
1656288710055,MATH 109,A01,083213,Ganzberger; Geoffrey Michael,1,0,34,33
1656288710055,MATH 109,A02,083214,Ganzberger; Geoffrey Michael,0,0,34,34
1656288710055,MATH 109,A03,093478,Staff,2,0,34,32
1656288710055,MATH 109,B01,083215,Ganzberger; Geoffrey Michael,4,0,32,28
1656288710055,MATH 109,B02,083216,Ganzberger; Geoffrey Michael,1,0,32,31
1656288710055,MATH 109,B03,093479,Staff,3,0,32,29
1656288716100,MATH 142A,A01,083219,Chow; Bennett,1,0,32,31
1656288716100,MATH 142A,A02,083220,Chow; Bennett,8,0,32,24
1656288716100,MATH 142A,A03,093480,Staff,5,0,32,27
1656288716100,MATH 142A,B03,093481,Staff,3,0,32,29
1656288716100,MATH 142A,B04,093558,Staff,6,0,32,26
1656288716100,MATH 142A,B05,093559,Staff,0,0,32,32
1656288722135,MATH 193A,A01,083224,Rotar; Vladimir,0,1,34,34
1656288722135,MATH 193A,A02,083225,Rotar; Vladimir,0,0,34,34
1656288722135,MATH 193A,A03,083781,Rotar; Vladimir,0,0,34,34
1656288722135,MATH 193A,A04,083782,Rotar; Vladimir,6,0,34,28
1656288722135,MATH 193A,A05,093482,Rotar; Vladimir,0,0,34,34
1656288728163,MATH 197,001,091859,McAuley; Julian John,9999,0,9999,0
1656288728163,MATH 197,002,095566,Kedlaya; Kiran S.,9997,0,9999,2
1656288728163,MATH 197,003,095567,Xiao; Ming,9999,0,9999,0
1656288728163,MATH 197,004,095571,Perols; Johan Lars,9998,0,9999,1
1656288735316,COGS 9,A01,083615,Shannon; Kyle Michael,3,0,75,72
1656288741339,COGS 11,A01,083617,Boyle; Mary E. T.,15,0,48,33
1656288747362,COGS 13,A01,083071,Bastos; Amalia Pinkusfeld,5,0,71,66
1656288753384,COGS 14A,A01,092681,Semenuks; Arturs,1,13,100,99
1656288759406,COGS 14B,A01,083073,Cheng; Tzu-Han,7,0,63,56
1656288765430,COGS 17,A01,092677,Semenuks; Arturs,7,0,81,74
1656288771453,COGS 100,A01,083619,Allen; Michael Gordon,2,0,70,68
1656288777486,COGS 101A,A01,083621,Davis; Joshua Daniel,4,0,68,64
1656288783512,COGS 101B,A01,091572,Allen; Michael Gordon,4,0,65,61
1656288789541,COGS 101C,A01,083625,Delgado; Tania,11,0,35,24
1656288795567,COGS 107A,A01,083627,Boyle; Mary E. T.,0,0,60,60
1656288801591,COGS 118A,A01,083075,Gupta; Anjum,8,0,76,68
1656288807619,CSE 3,A50,083646,Miranda; Gregory Joseph,18,0,50,32
1656288813643,CSE 8A,A50,083650,Miranda; Gregory Joseph,2,3,56,54
1656288819666,CSE 11,A01,083080,Cao; Yingjun,0,48,40,40
1656288825690,CSE 12,A01,083652,Krause-Levy; Sophia Louisa,5,1,120,115
1656288831724,CSE 15L,A01,083654,Morris; Justin Loren,2,0,50,48
1656288831724,CSE 15L,A02,083655,Morris; Justin Loren,4,0,50,46
1656288837748,CSE 20,A01,083657,Tran; Khoa Dang,30,0,80,50
1656288843771,CSE 21,A01,095574,Bach; Quang Tran,23,0,48,25
1656288849794,CSE 30,A01,083084,Eldon; John,2,6,80,78
1656288849794,CSE 30,B01,095061,Bhaskar; Nishant,0,1,50,50
1656288855825,CSE 100,A01,083659,Cao; Yingjun,1,18,70,69
1656288861848,CSE 134B,A01,083661,Powell; Thomas Allan,6,0,100,94
1656288867878,CSE 140,A01,083663,Gungor; Onat,8,0,85,77
1656288873903,CSE 140L,A01,083088,Eldon; John,10,0,100,90
1656288879925,CSE 175,A01,083665,Kumar; Rakesh,0,0,25,25
1656288885955,CSE 190,A00,092507,Dubnov; Shlomo,3,0,20,17
1656288891981,ECE 45,A01,083139,Congero; Spencer William,1,0,75,74
1656288898008,ECE 65,A50,083695,Saad; Andrew S,9,0,30,21
1656288898008,ECE 65,A51,095125,Staff,24,0,26,2
1656288904033,ECE 109,A01,091882,Touri; Behrouz,1,1,70,69
1656288910060,ECE 180,A00,083140,Abi Samra; Nicholas Camill,2,0,30,28
1656288910060,ECE 180,B00,083141,Abi Samra; Nicholas Camill,0,4,30,30
1656288916088,MATH 10A,A01,083735,Patchell; Gregory David,0,0,30,30
1656288916088,MATH 10A,A02,083736,Patchell; Gregory David,22,0,30,8
1656288916088,MATH 10A,A03,083737,Patchell; Gregory David,16,0,30,14
1656288922112,MATH 10B,A01,083207,Lim; Seonhee,1,0,34,33
1656288922112,MATH 10B,A02,083208,Lim; Seonhee,7,0,35,28
1656288922112,MATH 10B,A03,093472,Staff,1,0,34,33
1656288922112,MATH 10B,B01,083739,Sinha; Shubham,11,0,30,19
1656288928138,MATH 18,A01,083743,Cinel; Cameron Alexander,7,0,30,23
1656288928138,MATH 18,A02,083744,Cinel; Cameron Alexander,9,0,30,21
1656288928138,MATH 18,A03,083745,Cinel; Cameron Alexander,5,0,30,25
1656288928138,MATH 18,B01,083748,Rideout; David Porter,1,0,36,35
1656288928138,MATH 18,B02,083749,Rideout; David Porter,0,0,36,36
1656288928138,MATH 18,B03,083750,Rideout; David Porter,0,0,36,36
1656288928138,MATH 18,B04,083751,Rideout; David Porter,0,1,36,36
1656288928138,MATH 18,B05,093473,Rideout; David Porter,0,0,36,36
1656288928138,MATH 18,B06,093474,Rideout; David Porter,3,0,36,33
1656288934168,MATH 20A,A01,083754,Zheng; Zequn,11,0,40,29
1656288940198,MATH 20B,A01,083756,Briones; Jor-el Thomas Caparas,0,0,36,36
1656288940198,MATH 20B,A02,083757,Briones; Jor-el Thomas Caparas,0,0,36,36
1656288940198,MATH 20B,A03,093475,Staff,0,0,36,36
1656288946222,MATH 20C,A01,083760,Briones; Jor-el Thomas Caparas,0,0,35,35
1656288946222,MATH 20C,A02,083761,Briones; Jor-el Thomas Caparas,9,1,35,26
1656288946222,MATH 20C,A03,093476,Staff,0,0,35,35
1656288946222,MATH 20C,B01,083762,Bach; Quang Tran,1,0,30,29
1656288952245,MATH 20D,A01,083765,Tran; Brian Kha,1,0,30,29
1656288952245,MATH 20D,A02,083766,Tran; Brian Kha,0,1,30,30
1656288952245,MATH 20D,A03,083767,Tran; Brian Kha,2,0,30,28
1656288958275,MATH 20E,A01,083771,Ganguly; Soumya,3,0,32,29
1656288958275,MATH 20E,A02,083772,Ganguly; Soumya,0,0,32,32
1656288958275,MATH 20E,B01,083773,Ciotti; Benjamin,16,0,35,19
1656288958275,MATH 20E,B02,083774,Ciotti; Benjamin,15,0,35,20
1656288964299,MATH 103A,A01,083777,Greenfeld; Be'Eri,1,0,36,35
1656288964299,MATH 103A,A02,083778,Greenfeld; Be'Eri,2,0,36,34
1656288964299,MATH 103A,A03,093561,Staff,4,0,36,32
1656288964299,MATH 103A,B01,083779,Greenfeld; Be'Eri,8,0,36,28
1656288964299,MATH 103A,B02,083780,Greenfeld; Be'Eri,0,0,36,36
1656288964299,MATH 103A,B03,093562,Staff,1,0,36,35
1656288970322,MATH 105,A01,085443,Carter; Anne Toulson,5,0,35,30
1656288970322,MATH 105,A02,093477,Staff,14,0,35,21
1656288976351,MATH 109,A01,083213,Ganzberger; Geoffrey Michael,1,0,34,33
1656288976351,MATH 109,A02,083214,Ganzberger; Geoffrey Michael,0,0,34,34
1656288976351,MATH 109,A03,093478,Staff,2,0,34,32
1656288976351,MATH 109,B01,083215,Ganzberger; Geoffrey Michael,4,0,32,28
1656288976351,MATH 109,B02,083216,Ganzberger; Geoffrey Michael,1,0,32,31
1656288976351,MATH 109,B03,093479,Staff,3,0,32,29
1656288982376,MATH 142A,A01,083219,Chow; Bennett,1,0,32,31
1656288982376,MATH 142A,A02,083220,Chow; Bennett,8,0,32,24
1656288982376,MATH 142A,A03,093480,Staff,5,0,32,27
1656288982376,MATH 142A,B03,093481,Staff,3,0,32,29
1656288982376,MATH 142A,B04,093558,Staff,6,0,32,26
1656288982376,MATH 142A,B05,093559,Staff,0,0,32,32
1656288988400,MATH 193A,A01,083224,Rotar; Vladimir,0,1,34,34
1656288988400,MATH 193A,A02,083225,Rotar; Vladimir,0,0,34,34
1656288988400,MATH 193A,A03,083781,Rotar; Vladimir,0,0,34,34
1656288988400,MATH 193A,A04,083782,Rotar; Vladimir,6,0,34,28
1656288988400,MATH 193A,A05,093482,Rotar; Vladimir,0,0,34,34
1656288994423,MATH 197,001,091859,McAuley; Julian John,9999,0,9999,0
1656288994423,MATH 197,002,095566,Kedlaya; Kiran S.,9997,0,9999,2
1656288994423,MATH 197,003,095567,Xiao; Ming,9999,0,9999,0
1656288994423,MATH 197,004,095571,Perols; Johan Lars,9998,0,9999,1
1656289001479,COGS 9,A01,083615,Shannon; Kyle Michael,3,0,75,72
1656289007506,COGS 11,A01,083617,Boyle; Mary E. T.,15,0,48,33
1656289013532,COGS 13,A01,083071,Bastos; Amalia Pinkusfeld,5,0,71,66
1656289019556,COGS 14A,A01,092681,Semenuks; Arturs,1,13,100,99
1656289025578,COGS 14B,A01,083073,Cheng; Tzu-Han,7,0,63,56
1656289031602,COGS 17,A01,092677,Semenuks; Arturs,7,0,81,74
1656289037635,COGS 100,A01,083619,Allen; Michael Gordon,2,0,70,68
1656289043662,COGS 101A,A01,083621,Davis; Joshua Daniel,4,0,68,64
1656289049686,COGS 101B,A01,091572,Allen; Michael Gordon,4,0,65,61
1656289055713,COGS 101C,A01,083625,Delgado; Tania,11,0,35,24
1656289061738,COGS 107A,A01,083627,Boyle; Mary E. T.,0,0,60,60
1656289067760,COGS 118A,A01,083075,Gupta; Anjum,8,0,76,68
1656289073785,CSE 3,A50,083646,Miranda; Gregory Joseph,18,0,50,32
1656289079809,CSE 8A,A50,083650,Miranda; Gregory Joseph,2,3,56,54
1656289085836,CSE 11,A01,083080,Cao; Yingjun,0,48,40,40
1656289091860,CSE 12,A01,083652,Krause-Levy; Sophia Louisa,5,1,120,115
1656289097883,CSE 15L,A01,083654,Morris; Justin Loren,2,0,50,48
1656289097883,CSE 15L,A02,083655,Morris; Justin Loren,4,0,50,46
1656289103906,CSE 20,A01,083657,Tran; Khoa Dang,30,0,80,50
1656289109930,CSE 21,A01,095574,Bach; Quang Tran,23,0,48,25
1656289115958,CSE 30,A01,083084,Eldon; John,2,6,80,78
1656289115958,CSE 30,B01,095061,Bhaskar; Nishant,0,1,50,50
1656289121980,CSE 100,A01,083659,Cao; Yingjun,1,18,70,69
1656289128010,CSE 134B,A01,083661,Powell; Thomas Allan,6,0,100,94
1656289134033,CSE 140,A01,083663,Gungor; Onat,8,0,85,77
1656289140062,CSE 140L,A01,083088,Eldon; John,10,0,100,90
1656289146084,CSE 175,A01,083665,Kumar; Rakesh,0,0,25,25
1656289152107,CSE 190,A00,092507,Dubnov; Shlomo,3,0,20,17
1656289158130,ECE 45,A01,083139,Congero; Spencer William,1,0,75,74
1656289164157,ECE 65,A50,083695,Saad; Andrew S,9,0,30,21
1656289164157,ECE 65,A51,095125,Staff,24,0,26,2
1656289170180,ECE 109,A01,091882,Touri; Behrouz,1,1,70,69
1656289176203,ECE 180,A00,083140,Abi Samra; Nicholas Camill,2,0,30,28
1656289176203,ECE 180,B00,083141,Abi Samra; Nicholas Camill,0,4,30,30
1656289182226,MATH 10A,A01,083735,Patchell; Gregory David,0,0,30,30
1656289182226,MATH 10A,A02,083736,Patchell; Gregory David,22,0,30,8
1656289182226,MATH 10A,A03,083737,Patchell; Gregory David,16,0,30,14
1656289188252,MATH 10B,A01,083207,Lim; Seonhee,1,0,34,33
1656289188252,MATH 10B,A02,083208,Lim; Seonhee,7,0,35,28
1656289188252,MATH 10B,A03,093472,Staff,1,0,34,33
1656289188252,MATH 10B,B01,083739,Sinha; Shubham,11,0,30,19
1656289194292,MATH 18,A01,083743,Cinel; Cameron Alexander,7,0,30,23
1656289194292,MATH 18,A02,083744,Cinel; Cameron Alexander,9,0,30,21
1656289194292,MATH 18,A03,083745,Cinel; Cameron Alexander,5,0,30,25
1656289194292,MATH 18,B01,083748,Rideout; David Porter,1,0,36,35
1656289194292,MATH 18,B02,083749,Rideout; David Porter,0,0,36,36
1656289194292,MATH 18,B03,083750,Rideout; David Porter,0,0,36,36
1656289194292,MATH 18,B04,083751,Rideout; David Porter,0,1,36,36
1656289194292,MATH 18,B05,093473,Rideout; David Porter,0,0,36,36
1656289194292,MATH 18,B06,093474,Rideout; David Porter,3,0,36,33
1656289200319,MATH 20A,A01,083754,Zheng; Zequn,11,0,40,29
1656289206342,MATH 20B,A01,083756,Briones; Jor-el Thomas Caparas,0,0,36,36
1656289206342,MATH 20B,A02,083757,Briones; Jor-el Thomas Caparas,0,0,36,36
1656289206342,MATH 20B,A03,093475,Staff,0,0,36,36
1656289212371,MATH 20C,A01,083760,Briones; Jor-el Thomas Caparas,0,0,35,35
1656289212371,MATH 20C,A02,083761,Briones; Jor-el Thomas Caparas,9,1,35,26
1656289212371,MATH 20C,A03,093476,Staff,0,0,35,35
1656289212371,MATH 20C,B01,083762,Bach; Quang Tran,1,0,30,29
1656289218399,MATH 20D,A01,083765,Tran; Brian Kha,1,0,30,29
1656289218399,MATH 20D,A02,083766,Tran; Brian Kha,0,1,30,30
1656289218399,MATH 20D,A03,083767,Tran; Brian Kha,2,0,30,28
1656289224424,MATH 20E,A01,083771,Ganguly; Soumya,3,0,32,29
1656289224424,MATH 20E,A02,083772,Ganguly; Soumya,0,0,32,32
1656289224424,MATH 20E,B01,083773,Ciotti; Benjamin,16,0,35,19
1656289224424,MATH 20E,B02,083774,Ciotti; Benjamin,15,0,35,20
1656289230453,MATH 103A,A01,083777,Greenfeld; Be'Eri,1,0,36,35
1656289230453,MATH 103A,A02,083778,Greenfeld; Be'Eri,2,0,36,34
1656289230453,MATH 103A,A03,093561,Staff,4,0,36,32
1656289230453,MATH 103A,B01,083779,Greenfeld; Be'Eri,8,0,36,28
1656289230453,MATH 103A,B02,083780,Greenfeld; Be'Eri,0,0,36,36
1656289230453,MATH 103A,B03,093562,Staff,1,0,36,35
1656289236480,MATH 105,A01,085443,Carter; Anne Toulson,5,0,35,30
1656289236480,MATH 105,A02,093477,Staff,14,0,35,21
1656289242508,MATH 109,A01,083213,Ganzberger; Geoffrey Michael,1,0,34,33
1656289242508,MATH 109,A02,083214,Ganzberger; Geoffrey Michael,0,0,34,34
1656289242508,MATH 109,A03,093478,Staff,2,0,34,32
1656289242508,MATH 109,B01,083215,Ganzberger; Geoffrey Michael,4,0,32,28
1656289242508,MATH 109,B02,083216,Ganzberger; Geoffrey Michael,1,0,32,31
1656289242508,MATH 109,B03,093479,Staff,3,0,32,29
1656289248532,MATH 142A,A01,083219,Chow; Bennett,1,0,32,31
1656289248532,MATH 142A,A02,083220,Chow; Bennett,8,0,32,24
1656289248532,MATH 142A,A03,093480,Staff,5,0,32,27
1656289248532,MATH 142A,B03,093481,Staff,3,0,32,29
1656289248532,MATH 142A,B04,093558,Staff,6,0,32,26
1656289248532,MATH 142A,B05,093559,Staff,0,0,32,32
1656289254561,MATH 193A,A01,083224,Rotar; Vladimir,0,1,34,34
1656289254561,MATH 193A,A02,083225,Rotar; Vladimir,0,0,34,34
1656289254561,MATH 193A,A03,083781,Rotar; Vladimir,0,0,34,34
1656289254561,MATH 193A,A04,083782,Rotar; Vladimir,6,0,34,28
1656289254561,MATH 193A,A05,093482,Rotar; Vladimir,0,0,34,34
1656289260589,MATH 197,001,091859,McAuley; Julian John,9999,0,9999,0
1656289260589,MATH 197,002,095566,Kedlaya; Kiran S.,9997,0,9999,2
1656289260589,MATH 197,003,095567,Xiao; Ming,9999,0,9999,0
1656289260589,MATH 197,004,095571,Perols; Johan Lars,9998,0,9999,1
1656289267639,COGS 9,A01,083615,Shannon; Kyle Michael,3,0,75,72
1656289273662,COGS 11,A01,083617,Boyle; Mary E. T.,15,0,48,33
1656289279685,COGS 13,A01,083071,Bastos; Amalia Pinkusfeld,5,0,71,66
1656289285712,COGS 14A,A01,092681,Semenuks; Arturs,1,13,100,99
1656289291739,COGS 14B,A01,083073,Cheng; Tzu-Han,7,0,63,56
1656289297765,COGS 17,A01,092677,Semenuks; Arturs,7,0,81,74
1656289303791,COGS 100,A01,083619,Allen; Michael Gordon,2,0,70,68
1656289309813,COGS 101A,A01,083621,Davis; Joshua Daniel,4,0,68,64
1656289315840,COGS 101B,A01,091572,Allen; Michael Gordon,4,0,65,61
1656289321869,COGS 101C,A01,083625,Delgado; Tania,11,0,35,24
1656289327981,COGS 107A,A01,083627,Boyle; Mary E. T.,0,0,60,60
1656289334012,COGS 118A,A01,083075,Gupta; Anjum,8,0,76,68
1656289340042,CSE 3,A50,083646,Miranda; Gregory Joseph,18,0,50,32
1656289346071,CSE 8A,A50,083650,Miranda; Gregory Joseph,2,3,56,54
1656289352094,CSE 11,A01,083080,Cao; Yingjun,0,48,40,40
1656289358119,CSE 12,A01,083652,Krause-Levy; Sophia Louisa,5,1,120,115
1656289364149,CSE 15L,A01,083654,Morris; Justin Loren,2,0,50,48
1656289364149,CSE 15L,A02,083655,Morris; Justin Loren,4,0,50,46
1656289370178,CSE 20,A01,083657,Tran; Khoa Dang,30,0,80,50
1656289376206,CSE 21,A01,095574,Bach; Quang Tran,23,0,48,25
1656289382234,CSE 30,A01,083084,Eldon; John,2,6,80,78
1656289382234,CSE 30,B01,095061,Bhaskar; Nishant,0,1,50,50
1656289388255,CSE 100,A01,083659,Cao; Yingjun,1,18,70,69
1656289394280,CSE 134B,A01,083661,Powell; Thomas Allan,6,0,100,94
1656289400303,CSE 140,A01,083663,Gungor; Onat,8,0,85,77
1656289406329,CSE 140L,A01,083088,Eldon; John,10,0,100,90
1656289412353,CSE 175,A01,083665,Kumar; Rakesh,0,0,25,25
1656289418378,CSE 190,A00,092507,Dubnov; Shlomo,3,0,20,17
1656289424406,ECE 45,A01,083139,Congero; Spencer William,1,0,75,74
1656289430430,ECE 65,A50,083695,Saad; Andrew S,9,0,30,21
1656289430430,ECE 65,A51,095125,Staff,24,0,26,2
1656289436457,ECE 109,A01,091882,Touri; Behrouz,1,1,70,69
1656289442480,ECE 180,A00,083140,Abi Samra; Nicholas Camill,2,0,30,28
1656289442480,ECE 180,B00,083141,Abi Samra; Nicholas Camill,0,4,30,30
1656289448507,MATH 10A,A01,083735,Patchell; Gregory David,0,0,30,30
1656289448507,MATH 10A,A02,083736,Patchell; Gregory David,22,0,30,8
1656289448507,MATH 10A,A03,083737,Patchell; Gregory David,16,0,30,14
1656289454536,MATH 10B,A01,083207,Lim; Seonhee,1,0,34,33
1656289454536,MATH 10B,A02,083208,Lim; Seonhee,7,0,35,28
1656289454536,MATH 10B,A03,093472,Staff,1,0,34,33
1656289454536,MATH 10B,B01,083739,Sinha; Shubham,11,0,30,19
1656289460561,MATH 18,A01,083743,Cinel; Cameron Alexander,7,0,30,23
1656289460561,MATH 18,A02,083744,Cinel; Cameron Alexander,9,0,30,21
1656289460561,MATH 18,A03,083745,Cinel; Cameron Alexander,5,0,30,25
1656289460561,MATH 18,B01,083748,Rideout; David Porter,1,0,36,35
1656289460561,MATH 18,B02,083749,Rideout; David Porter,0,0,36,36
1656289460561,MATH 18,B03,083750,Rideout; David Porter,0,0,36,36
1656289460561,MATH 18,B04,083751,Rideout; David Porter,0,1,36,36
1656289460561,MATH 18,B05,093473,Rideout; David Porter,0,0,36,36
1656289460561,MATH 18,B06,093474,Rideout; David Porter,3,0,36,33
1656289466584,MATH 20A,A01,083754,Zheng; Zequn,11,0,40,29
1656289472607,MATH 20B,A01,083756,Briones; Jor-el Thomas Caparas,0,0,36,36
1656289472607,MATH 20B,A02,083757,Briones; Jor-el Thomas Caparas,0,0,36,36
1656289472607,MATH 20B,A03,093475,Staff,0,0,36,36
1656289478636,MATH 20C,A01,083760,Briones; Jor-el Thomas Caparas,0,0,35,35
1656289478636,MATH 20C,A02,083761,Briones; Jor-el Thomas Caparas,9,1,35,26
1656289478636,MATH 20C,A03,093476,Staff,0,0,35,35
1656289478636,MATH 20C,B01,083762,Bach; Quang Tran,2,0,30,28
1656289484660,MATH 20D,A01,083765,Tran; Brian Kha,1,0,30,29
1656289484660,MATH 20D,A02,083766,Tran; Brian Kha,0,1,30,30
1656289484660,MATH 20D,A03,083767,Tran; Brian Kha,2,0,30,28
1656289490688,MATH 20E,A01,083771,Ganguly; Soumya,3,0,32,29
1656289490688,MATH 20E,A02,083772,Ganguly; Soumya,0,0,32,32
1656289490688,MATH 20E,B01,083773,Ciotti; Benjamin,16,0,35,19
1656289490688,MATH 20E,B02,083774,Ciotti; Benjamin,15,0,35,20
1656289496718,MATH 103A,A01,083777,Greenfeld; Be'Eri,1,0,36,35
1656289496718,MATH 103A,A02,083778,Greenfeld; Be'Eri,2,0,36,34
1656289496718,MATH 103A,A03,093561,Staff,4,0,36,32
1656289496718,MATH 103A,B01,083779,Greenfeld; Be'Eri,8,0,36,28
1656289496718,MATH 103A,B02,083780,Greenfeld; Be'Eri,0,0,36,36
1656289496718,MATH 103A,B03,093562,Staff,1,0,36,35
1656289502740,MATH 105,A01,085443,Carter; Anne Toulson,5,0,35,30
1656289502740,MATH 105,A02,093477,Staff,14,0,35,21
1656289508765,MATH 109,A01,083213,Ganzberger; Geoffrey Michael,1,0,34,33
1656289508765,MATH 109,A02,083214,Ganzberger; Geoffrey Michael,0,0,34,34
1656289508765,MATH 109,A03,093478,Staff,2,0,34,32
1656289508765,MATH 109,B01,083215,Ganzberger; Geoffrey Michael,4,0,32,28
1656289508765,MATH 109,B02,083216,Ganzberger; Geoffrey Michael,1,0,32,31
1656289508765,MATH 109,B03,093479,Staff,3,0,32,29
1656289514788,MATH 142A,A01,083219,Chow; Bennett,1,0,32,31
1656289514788,MATH 142A,A02,083220,Chow; Bennett,8,0,32,24
1656289514788,MATH 142A,A03,093480,Staff,5,0,32,27
1656289514788,MATH 142A,B03,093481,Staff,3,0,32,29
1656289514788,MATH 142A,B04,093558,Staff,6,0,32,26
1656289514788,MATH 142A,B05,093559,Staff,0,0,32,32
1656289520818,MATH 193A,A01,083224,Rotar; Vladimir,0,1,34,34
1656289520818,MATH 193A,A02,083225,Rotar; Vladimir,0,0,34,34
1656289520818,MATH 193A,A03,083781,Rotar; Vladimir,0,0,34,34
1656289520818,MATH 193A,A04,083782,Rotar; Vladimir,6,0,34,28
1656289520818,MATH 193A,A05,093482,Rotar; Vladimir,0,0,34,34
1656289526840,MATH 197,001,091859,McAuley; Julian John,9999,0,9999,0
1656289526840,MATH 197,002,095566,Kedlaya; Kiran S.,9997,0,9999,2
1656289526840,MATH 197,003,095567,Xiao; Ming,9999,0,9999,0
1656289526840,MATH 197,004,095571,Perols; Johan Lars,9998,0,9999,1
1656289533898,COGS 9,A01,083615,Shannon; Kyle Michael,3,0,75,72
1656289539925,COGS 11,A01,083617,Boyle; Mary E. T.,15,0,48,33
1656289545955,COGS 13,A01,083071,Bastos; Amalia Pinkusfeld,5,0,71,66
1656289551982,COGS 14A,A01,092681,Semenuks; Arturs,1,13,100,99
1656289558006,COGS 14B,A01,083073,Cheng; Tzu-Han,7,0,63,56
1656289564029,COGS 17,A01,092677,Semenuks; Arturs,7,0,81,74
1656289570063,COGS 100,A01,083619,Allen; Michael Gordon,2,0,70,68
1656289576089,COGS 101A,A01,083621,Davis; Joshua Daniel,4,0,68,64
1656289582112,COGS 101B,A01,091572,Allen; Michael Gordon,4,0,65,61
1656289588145,COGS 101C,A01,083625,Delgado; Tania,11,0,35,24
1656289594167,COGS 107A,A01,083627,Boyle; Mary E. T.,0,0,60,60
1656289600190,COGS 118A,A01,083075,Gupta; Anjum,8,0,76,68
1656289606217,CSE 3,A50,083646,Miranda; Gregory Joseph,18,0,50,32
1656289612244,CSE 8A,A50,083650,Miranda; Gregory Joseph,2,3,56,54
1656289618267,CSE 11,A01,083080,Cao; Yingjun,0,48,40,40
1656289624291,CSE 12,A01,083652,Krause-Levy; Sophia Louisa,5,1,120,115
1656289630315,CSE 15L,A01,083654,Morris; Justin Loren,2,0,50,48
1656289630315,CSE 15L,A02,083655,Morris; Justin Loren,4,0,50,46
1656289636349,CSE 20,A01,083657,Tran; Khoa Dang,30,0,80,50
1656289642372,CSE 21,A01,095574,Bach; Quang Tran,23,0,48,25
1656289648395,CSE 30,A01,083084,Eldon; John,2,6,80,78
1656289648395,CSE 30,B01,095061,Bhaskar; Nishant,0,1,50,50
1656289654421,CSE 100,A01,083659,Cao; Yingjun,1,18,70,69
1656289660449,CSE 134B,A01,083661,Powell; Thomas Allan,6,0,100,94
1656289666471,CSE 140,A01,083663,Gungor; Onat,8,0,85,77
1656289672495,CSE 140L,A01,083088,Eldon; John,10,0,100,90
1656289678520,CSE 175,A01,083665,Kumar; Rakesh,0,0,25,25
1656289684544,CSE 190,A00,092507,Dubnov; Shlomo,3,0,20,17
1656289690576,ECE 45,A01,083139,Congero; Spencer William,1,0,75,74
1656289696602,ECE 65,A50,083695,Saad; Andrew S,9,0,30,21
1656289696602,ECE 65,A51,095125,Staff,24,0,26,2
1656289702626,ECE 109,A01,091882,Touri; Behrouz,1,1,70,69
1656289708652,ECE 180,A00,083140,Abi Samra; Nicholas Camill,2,0,30,28
1656289708652,ECE 180,B00,083141,Abi Samra; Nicholas Camill,0,4,30,30
1656289714679,MATH 10A,A01,083735,Patchell; Gregory David,0,0,30,30
1656289714679,MATH 10A,A02,083736,Patchell; Gregory David,22,0,30,8
1656289714679,MATH 10A,A03,083737,Patchell; Gregory David,16,0,30,14
1656289720702,MATH 10B,A01,083207,Lim; Seonhee,1,0,34,33
1656289720702,MATH 10B,A02,083208,Lim; Seonhee,7,0,35,28
1656289720702,MATH 10B,A03,093472,Staff,1,0,34,33
1656289720702,MATH 10B,B01,083739,Sinha; Shubham,11,0,30,19
1656289726727,MATH 18,A01,083743,Cinel; Cameron Alexander,7,0,30,23
1656289726727,MATH 18,A02,083744,Cinel; Cameron Alexander,9,0,30,21
1656289726727,MATH 18,A03,083745,Cinel; Cameron Alexander,5,0,30,25
1656289726727,MATH 18,B01,083748,Rideout; David Porter,1,0,36,35
1656289726727,MATH 18,B02,083749,Rideout; David Porter,0,0,36,36
1656289726727,MATH 18,B03,083750,Rideout; David Porter,0,0,36,36
1656289726727,MATH 18,B04,083751,Rideout; David Porter,0,1,36,36
1656289726727,MATH 18,B05,093473,Rideout; David Porter,0,0,36,36
1656289726727,MATH 18,B06,093474,Rideout; David Porter,3,0,36,33
1656289732751,MATH 20A,A01,083754,Zheng; Zequn,11,0,40,29
1656289738773,MATH 20B,A01,083756,Briones; Jor-el Thomas Caparas,0,0,36,36
1656289738773,MATH 20B,A02,083757,Briones; Jor-el Thomas Caparas,0,0,36,36
1656289738773,MATH 20B,A03,093475,Staff,1,0,36,35
1656289744802,MATH 20C,A01,083760,Briones; Jor-el Thomas Caparas,0,0,35,35
1656289744802,MATH 20C,A02,083761,Briones; Jor-el Thomas Caparas,9,1,35,26
1656289744802,MATH 20C,A03,093476,Staff,0,0,35,35
1656289744802,MATH 20C,B01,083762,Bach; Quang Tran,2,0,30,28
1656289750826,MATH 20D,A01,083765,Tran; Brian Kha,1,0,30,29
1656289750826,MATH 20D,A02,083766,Tran; Brian Kha,0,1,30,30
1656289750826,MATH 20D,A03,083767,Tran; Brian Kha,2,0,30,28
1656289756852,MATH 20E,A01,083771,Ganguly; Soumya,3,0,32,29
1656289756852,MATH 20E,A02,083772,Ganguly; Soumya,0,0,32,32
1656289756852,MATH 20E,B01,083773,Ciotti; Benjamin,16,0,35,19
1656289756852,MATH 20E,B02,083774,Ciotti; Benjamin,15,0,35,20
1656289762876,MATH 103A,A01,083777,Greenfeld; Be'Eri,1,0,36,35
1656289762876,MATH 103A,A02,083778,Greenfeld; Be'Eri,2,0,36,34
1656289762876,MATH 103A,A03,093561,Staff,4,0,36,32
1656289762876,MATH 103A,B01,083779,Greenfeld; Be'Eri,8,0,36,28
1656289762876,MATH 103A,B02,083780,Greenfeld; Be'Eri,0,0,36,36
1656289762876,MATH 103A,B03,093562,Staff,1,0,36,35
1656289768904,MATH 105,A01,085443,Carter; Anne Toulson,5,0,35,30
1656289768904,MATH 105,A02,093477,Staff,14,0,35,21
1656289774928,MATH 109,A01,083213,Ganzberger; Geoffrey Michael,1,0,34,33
1656289774928,MATH 109,A02,083214,Ganzberger; Geoffrey Michael,0,0,34,34
1656289774928,MATH 109,A03,093478,Staff,2,0,34,32
1656289774928,MATH 109,B01,083215,Ganzberger; Geoffrey Michael,4,0,32,28
1656289774928,MATH 109,B02,083216,Ganzberger; Geoffrey Michael,1,0,32,31
1656289774928,MATH 109,B03,093479,Staff,3,0,32,29
1656289780952,MATH 142A,A01,083219,Chow; Bennett,1,0,32,31
1656289780952,MATH 142A,A02,083220,Chow; Bennett,8,0,32,24
1656289780952,MATH 142A,A03,093480,Staff,5,0,32,27
1656289780952,MATH 142A,B03,093481,Staff,3,0,32,29
1656289780952,MATH 142A,B04,093558,Staff,6,0,32,26
1656289780952,MATH 142A,B05,093559,Staff,0,0,32,32
1656289786979,MATH 193A,A01,083224,Rotar; Vladimir,0,1,34,34
1656289786979,MATH 193A,A02,083225,Rotar; Vladimir,0,0,34,34
1656289786979,MATH 193A,A03,083781,Rotar; Vladimir,0,0,34,34
1656289786979,MATH 193A,A04,083782,Rotar; Vladimir,6,0,34,28
1656289786979,MATH 193A,A05,093482,Rotar; Vladimir,0,0,34,34
1656289793006,MATH 197,001,091859,McAuley; Julian John,9999,0,9999,0
1656289793006,MATH 197,002,095566,Kedlaya; Kiran S.,9997,0,9999,2
1656289793006,MATH 197,003,095567,Xiao; Ming,9999,0,9999,0
1656289793006,MATH 197,004,095571,Perols; Johan Lars,9998,0,9999,1
1656289800077,COGS 9,A01,083615,Shannon; Kyle Michael,3,0,75,72
1656289806103,COGS 11,A01,083617,Boyle; Mary E. T.,15,0,48,33
1656289812124,COGS 13,A01,083071,Bastos; Amalia Pinkusfeld,5,0,71,66
1656289818150,COGS 14A,A01,092681,Semenuks; Arturs,1,13,100,99
1656289824175,COGS 14B,A01,083073,Cheng; Tzu-Han,7,0,63,56
1656289830203,COGS 17,A01,092677,Semenuks; Arturs,7,0,81,74
1656289836231,COGS 100,A01,083619,Allen; Michael Gordon,2,0,70,68
1656289842254,COGS 101A,A01,083621,Davis; Joshua Daniel,4,0,68,64
1656289848292,COGS 101B,A01,091572,Allen; Michael Gordon,4,0,65,61
1656289854319,COGS 101C,A01,083625,Delgado; Tania,11,0,35,24
1656289860343,COGS 107A,A01,083627,Boyle; Mary E. T.,0,0,60,60
1656289866367,COGS 118A,A01,083075,Gupta; Anjum,8,0,76,68
1656289872396,CSE 3,A50,083646,Miranda; Gregory Joseph,18,0,50,32
1656289878424,CSE 8A,A50,083650,Miranda; Gregory Joseph,2,3,56,54
1656289884445,CSE 11,A01,083080,Cao; Yingjun,0,48,40,40
1656289890472,CSE 12,A01,083652,Krause-Levy; Sophia Louisa,5,1,120,115
1656289896499,CSE 15L,A01,083654,Morris; Justin Loren,2,0,50,48
1656289896499,CSE 15L,A02,083655,Morris; Justin Loren,4,0,50,46
1656289902527,CSE 20,A01,083657,Tran; Khoa Dang,30,0,80,50
1656289908551,CSE 21,A01,095574,Bach; Quang Tran,23,0,48,25
1656289914575,CSE 30,A01,083084,Eldon; John,2,6,80,78
1656289914575,CSE 30,B01,095061,Bhaskar; Nishant,0,1,50,50
1656289920598,CSE 100,A01,083659,Cao; Yingjun,1,18,70,69
1656289926691,CSE 134B,A01,083661,Powell; Thomas Allan,6,0,100,94
1656289932717,CSE 140,A01,083663,Gungor; Onat,8,0,85,77
1656289938741,CSE 140L,A01,083088,Eldon; John,10,0,100,90
1656289944765,CSE 175,A01,083665,Kumar; Rakesh,0,0,25,25
1656289950790,CSE 190,A00,092507,Dubnov; Shlomo,3,0,20,17
1656289956821,ECE 45,A01,083139,Congero; Spencer William,1,0,75,74
1656289962846,ECE 65,A50,083695,Saad; Andrew S,9,0,30,21
1656289962846,ECE 65,A51,095125,Staff,24,0,26,2
1656289968870,ECE 109,A01,091882,Touri; Behrouz,1,1,70,69
1656289974897,ECE 180,A00,083140,Abi Samra; Nicholas Camill,2,0,30,28
1656289974897,ECE 180,B00,083141,Abi Samra; Nicholas Camill,0,4,30,30
1656289980921,MATH 10A,A01,083735,Patchell; Gregory David,0,0,30,30
1656289980921,MATH 10A,A02,083736,Patchell; Gregory David,22,0,30,8
1656289980921,MATH 10A,A03,083737,Patchell; Gregory David,16,0,30,14
1656289986946,MATH 10B,A01,083207,Lim; Seonhee,1,0,34,33
1656289986946,MATH 10B,A02,083208,Lim; Seonhee,7,0,35,28
1656289986946,MATH 10B,A03,093472,Staff,1,0,34,33
1656289986946,MATH 10B,B01,083739,Sinha; Shubham,11,0,30,19
1656289992971,MATH 18,A01,083743,Cinel; Cameron Alexander,7,0,30,23
1656289992971,MATH 18,A02,083744,Cinel; Cameron Alexander,9,0,30,21
1656289992971,MATH 18,A03,083745,Cinel; Cameron Alexander,5,0,30,25
1656289992971,MATH 18,B01,083748,Rideout; David Porter,1,0,36,35
1656289992971,MATH 18,B02,083749,Rideout; David Porter,0,0,36,36
1656289992971,MATH 18,B03,083750,Rideout; David Porter,0,0,36,36
1656289992971,MATH 18,B04,083751,Rideout; David Porter,0,1,36,36
1656289992971,MATH 18,B05,093473,Rideout; David Porter,0,0,36,36
1656289992971,MATH 18,B06,093474,Rideout; David Porter,3,0,36,33
1656289998996,MATH 20A,A01,083754,Zheng; Zequn,11,0,40,29
1656290005029,MATH 20B,A01,083756,Briones; Jor-el Thomas Caparas,0,0,36,36
1656290005029,MATH 20B,A02,083757,Briones; Jor-el Thomas Caparas,0,0,36,36
1656290005029,MATH 20B,A03,093475,Staff,1,0,36,35
1656290011052,MATH 20C,A01,083760,Briones; Jor-el Thomas Caparas,0,0,35,35
1656290011052,MATH 20C,A02,083761,Briones; Jor-el Thomas Caparas,9,1,35,26
1656290011052,MATH 20C,A03,093476,Staff,0,0,35,35
1656290011052,MATH 20C,B01,083762,Bach; Quang Tran,2,0,30,28
1656290017083,MATH 20D,A01,083765,Tran; Brian Kha,1,0,30,29
1656290017083,MATH 20D,A02,083766,Tran; Brian Kha,0,1,30,30
1656290017083,MATH 20D,A03,083767,Tran; Brian Kha,2,0,30,28
1656290023111,MATH 20E,A01,083771,Ganguly; Soumya,3,0,32,29
1656290023111,MATH 20E,A02,083772,Ganguly; Soumya,0,0,32,32
1656290023111,MATH 20E,B01,083773,Ciotti; Benjamin,16,0,35,19
1656290023111,MATH 20E,B02,083774,Ciotti; Benjamin,15,0,35,20
1656290029136,MATH 103A,A01,083777,Greenfeld; Be'Eri,1,0,36,35
1656290029136,MATH 103A,A02,083778,Greenfeld; Be'Eri,3,0,36,33
1656290029136,MATH 103A,A03,093561,Staff,4,0,36,32
1656290029136,MATH 103A,B01,083779,Greenfeld; Be'Eri,8,0,36,28
1656290029136,MATH 103A,B02,083780,Greenfeld; Be'Eri,0,0,36,36
1656290029136,MATH 103A,B03,093562,Staff,1,0,36,35
1656290035160,MATH 105,A01,085443,Carter; Anne Toulson,5,0,35,30
1656290035160,MATH 105,A02,093477,Staff,14,0,35,21
1656290041189,MATH 109,A01,083213,Ganzberger; Geoffrey Michael,1,0,34,33
1656290041189,MATH 109,A02,083214,Ganzberger; Geoffrey Michael,0,0,34,34
1656290041189,MATH 109,A03,093478,Staff,2,0,34,32
1656290041189,MATH 109,B01,083215,Ganzberger; Geoffrey Michael,4,0,32,28
1656290041189,MATH 109,B02,083216,Ganzberger; Geoffrey Michael,1,0,32,31
1656290041189,MATH 109,B03,093479,Staff,3,0,32,29
1656290047223,MATH 142A,A01,083219,Chow; Bennett,1,0,32,31
1656290047223,MATH 142A,A02,083220,Chow; Bennett,8,0,32,24
1656290047223,MATH 142A,A03,093480,Staff,5,0,32,27
1656290047223,MATH 142A,B03,093481,Staff,3,0,32,29
1656290047223,MATH 142A,B04,093558,Staff,6,0,32,26
1656290047223,MATH 142A,B05,093559,Staff,0,0,32,32
1656290053245,MATH 193A,A01,083224,Rotar; Vladimir,0,1,34,34
1656290053245,MATH 193A,A02,083225,Rotar; Vladimir,0,0,34,34
1656290053245,MATH 193A,A03,083781,Rotar; Vladimir,0,0,34,34
1656290053245,MATH 193A,A04,083782,Rotar; Vladimir,6,0,34,28
1656290053245,MATH 193A,A05,093482,Rotar; Vladimir,0,0,34,34
1656290059287,MATH 197,001,091859,McAuley; Julian John,9999,0,9999,0
1656290059287,MATH 197,002,095566,Kedlaya; Kiran S.,9997,0,9999,2
1656290059287,MATH 197,003,095567,Xiao; Ming,9999,0,9999,0
1656290059287,MATH 197,004,095571,Perols; Johan Lars,9998,0,9999,1
1656290066350,COGS 9,A01,083615,Shannon; Kyle Michael,3,0,75,72
1656290072378,COGS 11,A01,083617,Boyle; Mary E. T.,15,0,48,33
1656290078416,COGS 13,A01,083071,Bastos; Amalia Pinkusfeld,5,0,71,66
1656290084440,COGS 14A,A01,092681,Semenuks; Arturs,1,13,100,99
1656290090465,COGS 14B,A01,083073,Cheng; Tzu-Han,7,0,63,56
1656290096489,COGS 17,A01,092677,Semenuks; Arturs,7,0,81,74
1656290102516,COGS 100,A01,083619,Allen; Michael Gordon,2,0,70,68
1656290108539,COGS 101A,A01,083621,Davis; Joshua Daniel,4,0,68,64
1656290114563,COGS 101B,A01,091572,Allen; Michael Gordon,4,0,65,61
1656290120588,COGS 101C,A01,083625,Delgado; Tania,11,0,35,24
1656290126629,COGS 107A,A01,083627,Boyle; Mary E. T.,0,0,60,60
1656290132655,COGS 118A,A01,083075,Gupta; Anjum,8,0,76,68
1656290138679,CSE 3,A50,083646,Miranda; Gregory Joseph,18,0,50,32
1656290144703,CSE 8A,A50,083650,Miranda; Gregory Joseph,2,3,56,54
1656290158115,CSE 11,A01,083080,Cao; Yingjun,0,48,40,40
1656290164139,CSE 12,A01,083652,Krause-Levy; Sophia Louisa,5,1,120,115
1656290170163,CSE 15L,A01,083654,Morris; Justin Loren,2,0,50,48
1656290170163,CSE 15L,A02,083655,Morris; Justin Loren,4,0,50,46
1656290176195,CSE 20,A01,083657,Tran; Khoa Dang,30,0,80,50
1656290182224,CSE 21,A01,095574,Bach; Quang Tran,23,0,48,25
1656290188247,CSE 30,A01,083084,Eldon; John,2,6,80,78
1656290188247,CSE 30,B01,095061,Bhaskar; Nishant,0,1,50,50
1656290194274,CSE 100,A01,083659,Cao; Yingjun,1,18,70,69
1656290200313,CSE 134B,A01,083661,Powell; Thomas Allan,6,0,100,94
1656290206336,CSE 140,A01,083663,Gungor; Onat,8,0,85,77
1656290212359,CSE 140L,A01,083088,Eldon; John,10,0,100,90
1656290218382,CSE 175,A01,083665,Kumar; Rakesh,0,0,25,25
1656290224413,CSE 190,A00,092507,Dubnov; Shlomo,3,0,20,17
1656290230436,ECE 45,A01,083139,Congero; Spencer William,1,0,75,74
1656290236462,ECE 65,A50,083695,Saad; Andrew S,9,0,30,21
1656290236462,ECE 65,A51,095125,Staff,24,0,26,2
1656290242484,ECE 109,A01,091882,Touri; Behrouz,1,1,70,69
1656290248513,ECE 180,A00,083140,Abi Samra; Nicholas Camill,2,0,30,28
1656290248513,ECE 180,B00,083141,Abi Samra; Nicholas Camill,0,4,30,30
1656290254539,MATH 10A,A01,083735,Patchell; Gregory David,0,0,30,30
1656290254539,MATH 10A,A02,083736,Patchell; Gregory David,22,0,30,8
1656290254539,MATH 10A,A03,083737,Patchell; Gregory David,16,0,30,14
1656290260566,MATH 10B,A01,083207,Lim; Seonhee,1,0,34,33
1656290260566,MATH 10B,A02,083208,Lim; Seonhee,7,0,35,28
1656290260566,MATH 10B,A03,093472,Staff,1,0,34,33
1656290260566,MATH 10B,B01,083739,Sinha; Shubham,11,0,30,19
1656290266603,MATH 18,A01,083743,Cinel; Cameron Alexander,7,0,30,23
1656290266603,MATH 18,A02,083744,Cinel; Cameron Alexander,9,0,30,21
1656290266603,MATH 18,A03,083745,Cinel; Cameron Alexander,5,0,30,25
1656290266603,MATH 18,B01,083748,Rideout; David Porter,1,0,36,35
1656290266603,MATH 18,B02,083749,Rideout; David Porter,0,0,36,36
1656290266603,MATH 18,B03,083750,Rideout; David Porter,0,0,36,36
1656290266603,MATH 18,B04,083751,Rideout; David Porter,0,1,36,36
1656290266603,MATH 18,B05,093473,Rideout; David Porter,0,0,36,36
1656290266603,MATH 18,B06,093474,Rideout; David Porter,3,0,36,33
1656290272626,MATH 20A,A01,083754,Zheng; Zequn,11,0,40,29
1656290278650,MATH 20B,A01,083756,Briones; Jor-el Thomas Caparas,0,0,36,36
1656290278650,MATH 20B,A02,083757,Briones; Jor-el Thomas Caparas,0,0,36,36
1656290278650,MATH 20B,A03,093475,Staff,1,0,36,35
1656290284672,MATH 20C,A01,083760,Briones; Jor-el Thomas Caparas,0,0,35,35
1656290284672,MATH 20C,A02,083761,Briones; Jor-el Thomas Caparas,9,1,35,26
1656290284672,MATH 20C,A03,093476,Staff,0,0,35,35
1656290284672,MATH 20C,B01,083762,Bach; Quang Tran,2,0,30,28
1656290290701,MATH 20D,A01,083765,Tran; Brian Kha,1,0,30,29
1656290290701,MATH 20D,A02,083766,Tran; Brian Kha,0,1,30,30
1656290290701,MATH 20D,A03,083767,Tran; Brian Kha,2,0,30,28
1656290296725,MATH 20E,A01,083771,Ganguly; Soumya,3,0,32,29
1656290296725,MATH 20E,A02,083772,Ganguly; Soumya,0,0,32,32
1656290296725,MATH 20E,B01,083773,Ciotti; Benjamin,16,0,35,19
1656290296725,MATH 20E,B02,083774,Ciotti; Benjamin,15,0,35,20
1656290302751,MATH 103A,A01,083777,Greenfeld; Be'Eri,1,0,36,35
1656290302751,MATH 103A,A02,083778,Greenfeld; Be'Eri,3,0,36,33
1656290302751,MATH 103A,A03,093561,Staff,4,0,36,32
1656290302751,MATH 103A,B01,083779,Greenfeld; Be'Eri,8,0,36,28
1656290302751,MATH 103A,B02,083780,Greenfeld; Be'Eri,0,0,36,36
1656290302751,MATH 103A,B03,093562,Staff,1,0,36,35
1656290308777,MATH 105,A01,085443,Carter; Anne Toulson,5,0,35,30
1656290308777,MATH 105,A02,093477,Staff,14,0,35,21
1656290314808,MATH 109,A01,083213,Ganzberger; Geoffrey Michael,1,0,34,33
1656290314808,MATH 109,A02,083214,Ganzberger; Geoffrey Michael,0,0,34,34
1656290314808,MATH 109,A03,093478,Staff,2,0,34,32
1656290314808,MATH 109,B01,083215,Ganzberger; Geoffrey Michael,4,0,32,28
1656290314808,MATH 109,B02,083216,Ganzberger; Geoffrey Michael,1,0,32,31
1656290314808,MATH 109,B03,093479,Staff,3,0,32,29
1656290320846,MATH 142A,A01,083219,Chow; Bennett,1,0,32,31
1656290320846,MATH 142A,A02,083220,Chow; Bennett,8,0,32,24
1656290320846,MATH 142A,A03,093480,Staff,5,0,32,27
1656290320846,MATH 142A,B03,093481,Staff,3,0,32,29
1656290320846,MATH 142A,B04,093558,Staff,6,0,32,26
1656290320846,MATH 142A,B05,093559,Staff,0,0,32,32
1656290326872,MATH 193A,A01,083224,Rotar; Vladimir,0,1,34,34
1656290326872,MATH 193A,A02,083225,Rotar; Vladimir,0,0,34,34
1656290326872,MATH 193A,A03,083781,Rotar; Vladimir,0,0,34,34
1656290326872,MATH 193A,A04,083782,Rotar; Vladimir,6,0,34,28
1656290326872,MATH 193A,A05,093482,Rotar; Vladimir,0,0,34,34
1656290332898,MATH 197,001,091859,McAuley; Julian John,9999,0,9999,0
1656290332898,MATH 197,002,095566,Kedlaya; Kiran S.,9997,0,9999,2
1656290332898,MATH 197,003,095567,Xiao; Ming,9999,0,9999,0
1656290332898,MATH 197,004,095571,Perols; Johan Lars,9998,0,9999,1
1656290339966,COGS 9,A01,083615,Shannon; Kyle Michael,3,0,75,72
1656290345991,COGS 11,A01,083617,Boyle; Mary E. T.,15,0,48,33
1656290352019,COGS 13,A01,083071,Bastos; Amalia Pinkusfeld,5,0,71,66
1656290358041,COGS 14A,A01,092681,Semenuks; Arturs,1,13,100,99
1656290364066,COGS 14B,A01,083073,Cheng; Tzu-Han,7,0,63,56
1656290370089,COGS 17,A01,092677,Semenuks; Arturs,7,0,81,74
1656290376112,COGS 100,A01,083619,Allen; Michael Gordon,2,0,70,68
1656290382141,COGS 101A,A01,083621,Davis; Joshua Daniel,4,0,68,64
1656290388167,COGS 101B,A01,091572,Allen; Michael Gordon,4,0,65,61
1656290394194,COGS 101C,A01,083625,Delgado; Tania,11,0,35,24
1656290400223,COGS 107A,A01,083627,Boyle; Mary E. T.,0,0,60,60
1656290406268,COGS 118A,A01,083075,Gupta; Anjum,8,0,76,68
1656290412295,CSE 3,A50,083646,Miranda; Gregory Joseph,18,0,50,32
1656290418322,CSE 8A,A50,083650,Miranda; Gregory Joseph,2,3,56,54
1656290424354,CSE 11,A01,083080,Cao; Yingjun,0,48,40,40
1656290430378,CSE 12,A01,083652,Krause-Levy; Sophia Louisa,5,1,120,115
1656290436406,CSE 15L,A01,083654,Morris; Justin Loren,2,0,50,48
1656290436406,CSE 15L,A02,083655,Morris; Justin Loren,4,0,50,46
1656290442431,CSE 20,A01,083657,Tran; Khoa Dang,30,0,80,50
1656290448453,CSE 21,A01,095574,Bach; Quang Tran,23,0,48,25
1656290454480,CSE 30,A01,083084,Eldon; John,2,6,80,78
1656290454480,CSE 30,B01,095061,Bhaskar; Nishant,0,1,50,50
1656290460507,CSE 100,A01,083659,Cao; Yingjun,1,18,70,69
1656290466533,CSE 134B,A01,083661,Powell; Thomas Allan,6,0,100,94
1656290472561,CSE 140,A01,083663,Gungor; Onat,8,0,85,77
1656290478588,CSE 140L,A01,083088,Eldon; John,10,0,100,90
1656290484615,CSE 175,A01,083665,Kumar; Rakesh,0,0,25,25
1656290490642,CSE 190,A00,092507,Dubnov; Shlomo,3,0,20,17
1656290496671,ECE 45,A01,083139,Congero; Spencer William,1,0,75,74
1656290502699,ECE 65,A50,083695,Saad; Andrew S,9,0,30,21
1656290502699,ECE 65,A51,095125,Staff,24,0,26,2
1656290508725,ECE 109,A01,091882,Touri; Behrouz,1,1,70,69
1656290514747,ECE 180,A00,083140,Abi Samra; Nicholas Camill,2,0,30,28
1656290514747,ECE 180,B00,083141,Abi Samra; Nicholas Camill,0,4,30,30
1656290520772,MATH 10A,A01,083735,Patchell; Gregory David,0,0,30,30
1656290520772,MATH 10A,A02,083736,Patchell; Gregory David,22,0,30,8
1656290520772,MATH 10A,A03,083737,Patchell; Gregory David,16,0,30,14
1656290526808,MATH 10B,A01,083207,Lim; Seonhee,1,0,34,33
1656290526808,MATH 10B,A02,083208,Lim; Seonhee,7,0,35,28
1656290526808,MATH 10B,A03,093472,Staff,1,0,34,33
1656290526808,MATH 10B,B01,083739,Sinha; Shubham,11,0,30,19
1656290532912,MATH 18,A01,083743,Cinel; Cameron Alexander,7,0,30,23
1656290532912,MATH 18,A02,083744,Cinel; Cameron Alexander,9,0,30,21
1656290532912,MATH 18,A03,083745,Cinel; Cameron Alexander,5,0,30,25
1656290532912,MATH 18,B01,083748,Rideout; David Porter,1,0,36,35
1656290532912,MATH 18,B02,083749,Rideout; David Porter,0,0,36,36
1656290532912,MATH 18,B03,083750,Rideout; David Porter,0,0,36,36
1656290532912,MATH 18,B04,083751,Rideout; David Porter,0,1,36,36
1656290532912,MATH 18,B05,093473,Rideout; David Porter,0,0,36,36
1656290532912,MATH 18,B06,093474,Rideout; David Porter,3,0,36,33
1656290538937,MATH 20A,A01,083754,Zheng; Zequn,11,0,40,29
1656290544960,MATH 20B,A01,083756,Briones; Jor-el Thomas Caparas,0,0,36,36
1656290544960,MATH 20B,A02,083757,Briones; Jor-el Thomas Caparas,0,0,36,36
1656290544960,MATH 20B,A03,093475,Staff,1,0,36,35
1656290550986,MATH 20C,A01,083760,Briones; Jor-el Thomas Caparas,0,0,35,35
1656290550986,MATH 20C,A02,083761,Briones; Jor-el Thomas Caparas,9,1,35,26
1656290550986,MATH 20C,A03,093476,Staff,0,0,35,35
1656290550986,MATH 20C,B01,083762,Bach; Quang Tran,2,0,30,28
1656290557015,MATH 20D,A01,083765,Tran; Brian Kha,1,0,30,29
1656290557015,MATH 20D,A02,083766,Tran; Brian Kha,0,1,30,30
1656290557015,MATH 20D,A03,083767,Tran; Brian Kha,2,0,30,28
1656290563037,MATH 20E,A01,083771,Ganguly; Soumya,3,0,32,29
1656290563037,MATH 20E,A02,083772,Ganguly; Soumya,0,0,32,32
1656290563037,MATH 20E,B01,083773,Ciotti; Benjamin,17,0,35,18
1656290563037,MATH 20E,B02,083774,Ciotti; Benjamin,15,0,35,20
1656290569061,MATH 103A,A01,083777,Greenfeld; Be'Eri,1,0,36,35
1656290569061,MATH 103A,A02,083778,Greenfeld; Be'Eri,3,0,36,33
1656290569061,MATH 103A,A03,093561,Staff,4,0,36,32
1656290569061,MATH 103A,B01,083779,Greenfeld; Be'Eri,8,0,36,28
1656290569061,MATH 103A,B02,083780,Greenfeld; Be'Eri,0,0,36,36
1656290569061,MATH 103A,B03,093562,Staff,1,0,36,35
1656290575090,MATH 105,A01,085443,Carter; Anne Toulson,5,0,35,30
1656290575090,MATH 105,A02,093477,Staff,14,0,35,21
1656290581120,MATH 109,A01,083213,Ganzberger; Geoffrey Michael,1,0,34,33
1656290581120,MATH 109,A02,083214,Ganzberger; Geoffrey Michael,0,0,34,34
1656290581120,MATH 109,A03,093478,Staff,2,0,34,32
1656290581120,MATH 109,B01,083215,Ganzberger; Geoffrey Michael,4,0,32,28
1656290581120,MATH 109,B02,083216,Ganzberger; Geoffrey Michael,1,0,32,31
1656290581120,MATH 109,B03,093479,Staff,3,0,32,29
1656290587150,MATH 142A,A01,083219,Chow; Bennett,1,0,32,31
1656290587150,MATH 142A,A02,083220,Chow; Bennett,8,0,32,24
1656290587150,MATH 142A,A03,093480,Staff,5,0,32,27
1656290587150,MATH 142A,B03,093481,Staff,3,0,32,29
1656290587150,MATH 142A,B04,093558,Staff,6,0,32,26
1656290587150,MATH 142A,B05,093559,Staff,0,0,32,32
1656290593173,MATH 193A,A01,083224,Rotar; Vladimir,0,1,34,34
1656290593173,MATH 193A,A02,083225,Rotar; Vladimir,0,0,34,34
1656290593173,MATH 193A,A03,083781,Rotar; Vladimir,0,0,34,34
1656290593173,MATH 193A,A04,083782,Rotar; Vladimir,6,0,34,28
1656290593173,MATH 193A,A05,093482,Rotar; Vladimir,0,0,34,34
1656290599199,MATH 197,001,091859,McAuley; Julian John,9999,0,9999,0
1656290599199,MATH 197,002,095566,Kedlaya; Kiran S.,9997,0,9999,2
1656290599199,MATH 197,003,095567,Xiao; Ming,9999,0,9999,0
1656290599199,MATH 197,004,095571,Perols; Johan Lars,9998,0,9999,1
1656290606251,COGS 9,A01,083615,Shannon; Kyle Michael,3,0,75,72
1656290612274,COGS 11,A01,083617,Boyle; Mary E. T.,15,0,48,33
1656290618297,COGS 13,A01,083071,Bastos; Amalia Pinkusfeld,5,0,71,66
1656290624321,COGS 14A,A01,092681,Semenuks; Arturs,1,13,100,99
1656290630344,COGS 14B,A01,083073,Cheng; Tzu-Han,7,0,63,56
1656290636372,COGS 17,A01,092677,Semenuks; Arturs,7,0,81,74
1656290642395,COGS 100,A01,083619,Allen; Michael Gordon,2,0,70,68
1656290648420,COGS 101A,A01,083621,Davis; Joshua Daniel,4,0,68,64
1656290654443,COGS 101B,A01,091572,Allen; Michael Gordon,4,0,65,61
1656290660466,COGS 101C,A01,083625,Delgado; Tania,11,0,35,24
1656290666490,COGS 107A,A01,083627,Boyle; Mary E. T.,0,0,60,60
1656290672513,COGS 118A,A01,083075,Gupta; Anjum,8,0,76,68
1656290678537,CSE 3,A50,083646,Miranda; Gregory Joseph,18,0,50,32
1656290684560,CSE 8A,A50,083650,Miranda; Gregory Joseph,2,3,56,54
1656290690584,CSE 11,A01,083080,Cao; Yingjun,0,48,40,40
1656290696607,CSE 12,A01,083652,Krause-Levy; Sophia Louisa,5,1,120,115
1656290702631,CSE 15L,A01,083654,Morris; Justin Loren,2,0,50,48
1656290702631,CSE 15L,A02,083655,Morris; Justin Loren,4,0,50,46
1656290708656,CSE 20,A01,083657,Tran; Khoa Dang,30,0,80,50
1656290714679,CSE 21,A01,095574,Bach; Quang Tran,23,0,48,25
1656290720704,CSE 30,A01,083084,Eldon; John,2,6,80,78
1656290720704,CSE 30,B01,095061,Bhaskar; Nishant,0,1,50,50
1656290726737,CSE 100,A01,083659,Cao; Yingjun,1,18,70,69
1656290732764,CSE 134B,A01,083661,Powell; Thomas Allan,6,0,100,94
1656290738792,CSE 140,A01,083663,Gungor; Onat,8,0,85,77
1656290744818,CSE 140L,A01,083088,Eldon; John,10,0,100,90
1656290750843,CSE 175,A01,083665,Kumar; Rakesh,0,0,25,25
1656290756866,CSE 190,A00,092507,Dubnov; Shlomo,3,0,20,17
1656290762893,ECE 45,A01,083139,Congero; Spencer William,1,0,75,74
1656290768917,ECE 65,A50,083695,Saad; Andrew S,9,0,30,21
1656290768917,ECE 65,A51,095125,Staff,24,0,26,2
1656290774943,ECE 109,A01,091882,Touri; Behrouz,1,1,70,69
1656290780967,ECE 180,A00,083140,Abi Samra; Nicholas Camill,2,0,30,28
1656290780967,ECE 180,B00,083141,Abi Samra; Nicholas Camill,0,4,30,30
1656290786997,MATH 10A,A01,083735,Patchell; Gregory David,0,0,30,30
1656290786997,MATH 10A,A02,083736,Patchell; Gregory David,22,0,30,8
1656290786997,MATH 10A,A03,083737,Patchell; Gregory David,16,0,30,14
1656290793025,MATH 10B,A01,083207,Lim; Seonhee,1,0,34,33
1656290793025,MATH 10B,A02,083208,Lim; Seonhee,7,0,35,28
1656290793025,MATH 10B,A03,093472,Staff,1,0,34,33
1656290793025,MATH 10B,B01,083739,Sinha; Shubham,11,0,30,19
1656290799057,MATH 18,A01,083743,Cinel; Cameron Alexander,7,0,30,23
1656290799057,MATH 18,A02,083744,Cinel; Cameron Alexander,9,0,30,21
1656290799057,MATH 18,A03,083745,Cinel; Cameron Alexander,5,0,30,25
1656290799057,MATH 18,B01,083748,Rideout; David Porter,1,0,36,35
1656290799057,MATH 18,B02,083749,Rideout; David Porter,0,0,36,36
1656290799057,MATH 18,B03,083750,Rideout; David Porter,0,0,36,36
1656290799057,MATH 18,B04,083751,Rideout; David Porter,0,1,36,36
1656290799057,MATH 18,B05,093473,Rideout; David Porter,0,0,36,36
1656290799057,MATH 18,B06,093474,Rideout; David Porter,3,0,36,33
1656290805081,MATH 20A,A01,083754,Zheng; Zequn,11,0,40,29
1656290811103,MATH 20B,A01,083756,Briones; Jor-el Thomas Caparas,0,0,36,36
1656290811103,MATH 20B,A02,083757,Briones; Jor-el Thomas Caparas,0,0,36,36
1656290811103,MATH 20B,A03,093475,Staff,1,0,36,35
1656290817133,MATH 20C,A01,083760,Briones; Jor-el Thomas Caparas,0,0,35,35
1656290817133,MATH 20C,A02,083761,Briones; Jor-el Thomas Caparas,9,1,35,26
1656290817133,MATH 20C,A03,093476,Staff,0,0,35,35
1656290817133,MATH 20C,B01,083762,Bach; Quang Tran,2,0,30,28
1656290823163,MATH 20D,A01,083765,Tran; Brian Kha,1,0,30,29
1656290823163,MATH 20D,A02,083766,Tran; Brian Kha,0,1,30,30
1656290823163,MATH 20D,A03,083767,Tran; Brian Kha,2,0,30,28
1656290829188,MATH 20E,A01,083771,Ganguly; Soumya,3,0,32,29
1656290829188,MATH 20E,A02,083772,Ganguly; Soumya,0,0,32,32
1656290829188,MATH 20E,B01,083773,Ciotti; Benjamin,17,0,35,18
1656290829188,MATH 20E,B02,083774,Ciotti; Benjamin,15,0,35,20
1656290835217,MATH 103A,A01,083777,Greenfeld; Be'Eri,1,0,36,35
1656290835217,MATH 103A,A02,083778,Greenfeld; Be'Eri,3,0,36,33
1656290835217,MATH 103A,A03,093561,Staff,4,0,36,32
1656290835217,MATH 103A,B01,083779,Greenfeld; Be'Eri,8,0,36,28
1656290835217,MATH 103A,B02,083780,Greenfeld; Be'Eri,0,0,36,36
1656290835217,MATH 103A,B03,093562,Staff,1,0,36,35
1656290841241,MATH 105,A01,085443,Carter; Anne Toulson,5,0,35,30
1656290841241,MATH 105,A02,093477,Staff,14,0,35,21
1656290847265,MATH 109,A01,083213,Ganzberger; Geoffrey Michael,1,0,34,33
1656290847265,MATH 109,A02,083214,Ganzberger; Geoffrey Michael,0,0,34,34
1656290847265,MATH 109,A03,093478,Staff,2,0,34,32
1656290847265,MATH 109,B01,083215,Ganzberger; Geoffrey Michael,4,0,32,28
1656290847265,MATH 109,B02,083216,Ganzberger; Geoffrey Michael,1,0,32,31
1656290847265,MATH 109,B03,093479,Staff,3,0,32,29
1656290853295,MATH 142A,A01,083219,Chow; Bennett,1,0,32,31
1656290853295,MATH 142A,A02,083220,Chow; Bennett,8,0,32,24
1656290853295,MATH 142A,A03,093480,Staff,5,0,32,27
1656290853295,MATH 142A,B03,093481,Staff,3,0,32,29
1656290853295,MATH 142A,B04,093558,Staff,6,0,32,26
1656290853295,MATH 142A,B05,093559,Staff,0,0,32,32
1656290859324,MATH 193A,A01,083224,Rotar; Vladimir,0,1,34,34
1656290859324,MATH 193A,A02,083225,Rotar; Vladimir,0,0,34,34
1656290859324,MATH 193A,A03,083781,Rotar; Vladimir,0,0,34,34
1656290859324,MATH 193A,A04,083782,Rotar; Vladimir,6,0,34,28
1656290859324,MATH 193A,A05,093482,Rotar; Vladimir,0,0,34,34
1656290865351,MATH 197,001,091859,McAuley; Julian John,9999,0,9999,0
1656290865351,MATH 197,002,095566,Kedlaya; Kiran S.,9997,0,9999,2
1656290865351,MATH 197,003,095567,Xiao; Ming,9999,0,9999,0
1656290865351,MATH 197,004,095571,Perols; Johan Lars,9998,0,9999,1
1656290872421,COGS 9,A01,083615,Shannon; Kyle Michael,3,0,75,72
1656290878444,COGS 11,A01,083617,Boyle; Mary E. T.,15,0,48,33
1656290884469,COGS 13,A01,083071,Bastos; Amalia Pinkusfeld,5,0,71,66
1656290890493,COGS 14A,A01,092681,Semenuks; Arturs,1,13,100,99
1656290896517,COGS 14B,A01,083073,Cheng; Tzu-Han,7,0,63,56
1656290902541,COGS 17,A01,092677,Semenuks; Arturs,7,0,81,74
1656290908565,COGS 100,A01,083619,Allen; Michael Gordon,2,0,70,68
1656290914592,COGS 101A,A01,083621,Davis; Joshua Daniel,4,0,68,64
1656290920619,COGS 101B,A01,091572,Allen; Michael Gordon,4,0,65,61
1656290926644,COGS 101C,A01,083625,Delgado; Tania,11,0,35,24
1656290932669,COGS 107A,A01,083627,Boyle; Mary E. T.,0,0,60,60
1656290938702,COGS 118A,A01,083075,Gupta; Anjum,8,0,76,68
1656290944727,CSE 3,A50,083646,Miranda; Gregory Joseph,18,0,50,32
1656290950754,CSE 8A,A50,083650,Miranda; Gregory Joseph,2,3,56,54
1656290956780,CSE 11,A01,083080,Cao; Yingjun,0,48,40,40
1656290962803,CSE 12,A01,083652,Krause-Levy; Sophia Louisa,5,1,120,115
1656290968827,CSE 15L,A01,083654,Morris; Justin Loren,2,0,50,48
1656290968827,CSE 15L,A02,083655,Morris; Justin Loren,4,0,50,46
1656290974850,CSE 20,A01,083657,Tran; Khoa Dang,30,0,80,50
1656290980872,CSE 21,A01,095574,Bach; Quang Tran,23,0,48,25
1656290986896,CSE 30,A01,083084,Eldon; John,2,6,80,78
1656290986896,CSE 30,B01,095061,Bhaskar; Nishant,0,1,50,50
1656290992924,CSE 100,A01,083659,Cao; Yingjun,1,18,70,69
1656290998951,CSE 134B,A01,083661,Powell; Thomas Allan,6,0,100,94
1656291004975,CSE 140,A01,083663,Gungor; Onat,8,0,85,77
1656291010999,CSE 140L,A01,083088,Eldon; John,10,0,100,90
1656291017025,CSE 175,A01,083665,Kumar; Rakesh,0,0,25,25
1656291023050,CSE 190,A00,092507,Dubnov; Shlomo,3,0,20,17
1656291029077,ECE 45,A01,083139,Congero; Spencer William,1,0,75,74
1656291035113,ECE 65,A50,083695,Saad; Andrew S,9,0,30,21
1656291035113,ECE 65,A51,095125,Staff,24,0,26,2
1656291041139,ECE 109,A01,091882,Touri; Behrouz,1,1,70,69
1656291047167,ECE 180,A00,083140,Abi Samra; Nicholas Camill,2,0,30,28
1656291047167,ECE 180,B00,083141,Abi Samra; Nicholas Camill,0,4,30,30
1656291053190,MATH 10A,A01,083735,Patchell; Gregory David,0,0,30,30
1656291053190,MATH 10A,A02,083736,Patchell; Gregory David,22,0,30,8
1656291053190,MATH 10A,A03,083737,Patchell; Gregory David,16,0,30,14
1656291059215,MATH 10B,A01,083207,Lim; Seonhee,1,0,34,33
1656291059215,MATH 10B,A02,083208,Lim; Seonhee,7,0,35,28
1656291059215,MATH 10B,A03,093472,Staff,1,0,34,33
1656291059215,MATH 10B,B01,083739,Sinha; Shubham,11,0,30,19
1656291065240,MATH 18,A01,083743,Cinel; Cameron Alexander,7,0,30,23
1656291065240,MATH 18,A02,083744,Cinel; Cameron Alexander,9,0,30,21
1656291065240,MATH 18,A03,083745,Cinel; Cameron Alexander,5,0,30,25
1656291065240,MATH 18,B01,083748,Rideout; David Porter,1,0,36,35
1656291065240,MATH 18,B02,083749,Rideout; David Porter,0,0,36,36
1656291065240,MATH 18,B03,083750,Rideout; David Porter,0,0,36,36
1656291065240,MATH 18,B04,083751,Rideout; David Porter,0,1,36,36
1656291065240,MATH 18,B05,093473,Rideout; David Porter,0,0,36,36
1656291065240,MATH 18,B06,093474,Rideout; David Porter,3,0,36,33
1656291071269,MATH 20A,A01,083754,Zheng; Zequn,11,0,40,29
1656291077298,MATH 20B,A01,083756,Briones; Jor-el Thomas Caparas,0,0,36,36
1656291077298,MATH 20B,A02,083757,Briones; Jor-el Thomas Caparas,0,0,36,36
1656291077298,MATH 20B,A03,093475,Staff,1,0,36,35
1656291083331,MATH 20C,A01,083760,Briones; Jor-el Thomas Caparas,0,0,35,35
1656291083331,MATH 20C,A02,083761,Briones; Jor-el Thomas Caparas,9,1,35,26
1656291083331,MATH 20C,A03,093476,Staff,0,0,35,35
1656291083331,MATH 20C,B01,083762,Bach; Quang Tran,2,0,30,28
1656291089359,MATH 20D,A01,083765,Tran; Brian Kha,1,0,30,29
1656291089359,MATH 20D,A02,083766,Tran; Brian Kha,0,1,30,30
1656291089359,MATH 20D,A03,083767,Tran; Brian Kha,2,0,30,28
1656291095382,MATH 20E,A01,083771,Ganguly; Soumya,3,0,32,29
1656291095382,MATH 20E,A02,083772,Ganguly; Soumya,0,0,32,32
1656291095382,MATH 20E,B01,083773,Ciotti; Benjamin,17,0,35,18
1656291095382,MATH 20E,B02,083774,Ciotti; Benjamin,15,0,35,20
1656291101419,MATH 103A,A01,083777,Greenfeld; Be'Eri,1,0,36,35
1656291101419,MATH 103A,A02,083778,Greenfeld; Be'Eri,3,0,36,33
1656291101419,MATH 103A,A03,093561,Staff,4,0,36,32
1656291101419,MATH 103A,B01,083779,Greenfeld; Be'Eri,8,0,36,28
1656291101419,MATH 103A,B02,083780,Greenfeld; Be'Eri,0,0,36,36
1656291101419,MATH 103A,B03,093562,Staff,1,0,36,35
1656291107446,MATH 105,A01,085443,Carter; Anne Toulson,5,0,35,30
1656291107446,MATH 105,A02,093477,Staff,14,0,35,21
1656291113470,MATH 109,A01,083213,Ganzberger; Geoffrey Michael,1,0,34,33
1656291113470,MATH 109,A02,083214,Ganzberger; Geoffrey Michael,0,0,34,34
1656291113470,MATH 109,A03,093478,Staff,2,0,34,32
1656291113470,MATH 109,B01,083215,Ganzberger; Geoffrey Michael,4,0,32,28
1656291113470,MATH 109,B02,083216,Ganzberger; Geoffrey Michael,1,0,32,31
1656291113470,MATH 109,B03,093479,Staff,3,0,32,29
1656291119494,MATH 142A,A01,083219,Chow; Bennett,1,0,32,31
1656291119494,MATH 142A,A02,083220,Chow; Bennett,8,0,32,24
1656291119494,MATH 142A,A03,093480,Staff,5,0,32,27
1656291119494,MATH 142A,B03,093481,Staff,3,0,32,29
1656291119494,MATH 142A,B04,093558,Staff,6,0,32,26
1656291119494,MATH 142A,B05,093559,Staff,0,0,32,32
1656291125518,MATH 193A,A01,083224,Rotar; Vladimir,0,1,34,34
1656291125518,MATH 193A,A02,083225,Rotar; Vladimir,0,0,34,34
1656291125518,MATH 193A,A03,083781,Rotar; Vladimir,0,0,34,34
1656291125518,MATH 193A,A04,083782,Rotar; Vladimir,6,0,34,28
1656291125518,MATH 193A,A05,093482,Rotar; Vladimir,0,0,34,34
1656291131615,MATH 197,001,091859,McAuley; Julian John,9999,0,9999,0
1656291131615,MATH 197,002,095566,Kedlaya; Kiran S.,9997,0,9999,2
1656291131615,MATH 197,003,095567,Xiao; Ming,9999,0,9999,0
1656291131615,MATH 197,004,095571,Perols; Johan Lars,9998,0,9999,1
1656291138681,COGS 9,A01,083615,Shannon; Kyle Michael,3,0,75,72
1656291144706,COGS 11,A01,083617,Boyle; Mary E. T.,15,0,48,33
1656291150730,COGS 13,A01,083071,Bastos; Amalia Pinkusfeld,5,0,71,66
1656291156754,COGS 14A,A01,092681,Semenuks; Arturs,1,13,100,99
1656291162776,COGS 14B,A01,083073,Cheng; Tzu-Han,7,0,63,56
1656291168803,COGS 17,A01,092677,Semenuks; Arturs,7,0,81,74
1656291174827,COGS 100,A01,083619,Allen; Michael Gordon,2,0,70,68
1656291180852,COGS 101A,A01,083621,Davis; Joshua Daniel,4,0,68,64
1656291186879,COGS 101B,A01,091572,Allen; Michael Gordon,4,0,65,61
1656291192904,COGS 101C,A01,083625,Delgado; Tania,11,0,35,24
1656291198927,COGS 107A,A01,083627,Boyle; Mary E. T.,0,0,60,60
1656291204954,COGS 118A,A01,083075,Gupta; Anjum,8,0,76,68
1656291210982,CSE 3,A50,083646,Miranda; Gregory Joseph,18,0,50,32
1656291217010,CSE 8A,A50,083650,Miranda; Gregory Joseph,2,3,56,54
1656291223062,CSE 11,A01,083080,Cao; Yingjun,0,48,40,40
1656291229089,CSE 12,A01,083652,Krause-Levy; Sophia Louisa,5,1,120,115
1656291235113,CSE 15L,A01,083654,Morris; Justin Loren,2,0,50,48
1656291235113,CSE 15L,A02,083655,Morris; Justin Loren,4,0,50,46
1656291241141,CSE 20,A01,083657,Tran; Khoa Dang,30,0,80,50
1656291247168,CSE 21,A01,095574,Bach; Quang Tran,23,0,48,25
1656291253192,CSE 30,A01,083084,Eldon; John,2,6,80,78
1656291253192,CSE 30,B01,095061,Bhaskar; Nishant,0,1,50,50
1656291259220,CSE 100,A01,083659,Cao; Yingjun,1,18,70,69
1656291265245,CSE 134B,A01,083661,Powell; Thomas Allan,6,0,100,94
1656291271273,CSE 140,A01,083663,Gungor; Onat,8,0,85,77
1656291277302,CSE 140L,A01,083088,Eldon; John,10,0,100,90
1656291283325,CSE 175,A01,083665,Kumar; Rakesh,0,0,25,25
1656291289351,CSE 190,A00,092507,Dubnov; Shlomo,3,0,20,17
1656291295378,ECE 45,A01,083139,Congero; Spencer William,1,0,75,74
1656291301401,ECE 65,A50,083695,Saad; Andrew S,9,0,30,21
1656291301401,ECE 65,A51,095125,Staff,24,0,26,2
1656291307430,ECE 109,A01,091882,Touri; Behrouz,1,1,70,69
1656291313458,ECE 180,A00,083140,Abi Samra; Nicholas Camill,2,0,30,28
1656291313458,ECE 180,B00,083141,Abi Samra; Nicholas Camill,0,4,30,30
1656291319488,MATH 10A,A01,083735,Patchell; Gregory David,0,0,30,30
1656291319488,MATH 10A,A02,083736,Patchell; Gregory David,22,0,30,8
1656291319488,MATH 10A,A03,083737,Patchell; Gregory David,16,0,30,14
1656291325512,MATH 10B,A01,083207,Lim; Seonhee,1,0,34,33
1656291325512,MATH 10B,A02,083208,Lim; Seonhee,7,0,35,28
1656291325512,MATH 10B,A03,093472,Staff,1,0,34,33
1656291325512,MATH 10B,B01,083739,Sinha; Shubham,11,0,30,19
1656291331534,MATH 18,A01,083743,Cinel; Cameron Alexander,7,0,30,23
1656291331534,MATH 18,A02,083744,Cinel; Cameron Alexander,9,0,30,21
1656291331534,MATH 18,A03,083745,Cinel; Cameron Alexander,5,0,30,25
1656291331534,MATH 18,B01,083748,Rideout; David Porter,1,0,36,35
1656291331534,MATH 18,B02,083749,Rideout; David Porter,0,0,36,36
1656291331534,MATH 18,B03,083750,Rideout; David Porter,0,0,36,36
1656291331534,MATH 18,B04,083751,Rideout; David Porter,0,1,36,36
1656291331534,MATH 18,B05,093473,Rideout; David Porter,0,0,36,36
1656291331534,MATH 18,B06,093474,Rideout; David Porter,3,0,36,33
1656291337555,MATH 20A,A01,083754,Zheng; Zequn,11,0,40,29
1656291343578,MATH 20B,A01,083756,Briones; Jor-el Thomas Caparas,0,0,36,36
1656291343578,MATH 20B,A02,083757,Briones; Jor-el Thomas Caparas,0,0,36,36
1656291343578,MATH 20B,A03,093475,Staff,1,0,36,35
1656291349601,MATH 20C,A01,083760,Briones; Jor-el Thomas Caparas,0,0,35,35
1656291349601,MATH 20C,A02,083761,Briones; Jor-el Thomas Caparas,9,1,35,26
1656291349601,MATH 20C,A03,093476,Staff,0,0,35,35
1656291349601,MATH 20C,B01,083762,Bach; Quang Tran,2,0,30,28
1656291355630,MATH 20D,A01,083765,Tran; Brian Kha,1,0,30,29
1656291355630,MATH 20D,A02,083766,Tran; Brian Kha,0,1,30,30
1656291355630,MATH 20D,A03,083767,Tran; Brian Kha,2,0,30,28
1656291361658,MATH 20E,A01,083771,Ganguly; Soumya,3,0,32,29
1656291361658,MATH 20E,A02,083772,Ganguly; Soumya,0,0,32,32
1656291361658,MATH 20E,B01,083773,Ciotti; Benjamin,17,0,35,18
1656291361658,MATH 20E,B02,083774,Ciotti; Benjamin,15,0,35,20
1656291367680,MATH 103A,A01,083777,Greenfeld; Be'Eri,1,0,36,35
1656291367680,MATH 103A,A02,083778,Greenfeld; Be'Eri,3,0,36,33
1656291367680,MATH 103A,A03,093561,Staff,4,0,36,32
1656291367680,MATH 103A,B01,083779,Greenfeld; Be'Eri,8,0,36,28
1656291367680,MATH 103A,B02,083780,Greenfeld; Be'Eri,0,0,36,36
1656291367680,MATH 103A,B03,093562,Staff,1,0,36,35
1656291373708,MATH 105,A01,085443,Carter; Anne Toulson,5,0,35,30
1656291373708,MATH 105,A02,093477,Staff,14,0,35,21
1656291379732,MATH 109,A01,083213,Ganzberger; Geoffrey Michael,1,0,34,33
1656291379732,MATH 109,A02,083214,Ganzberger; Geoffrey Michael,0,0,34,34
1656291379732,MATH 109,A03,093478,Staff,2,0,34,32
1656291379732,MATH 109,B01,083215,Ganzberger; Geoffrey Michael,4,0,32,28
1656291379732,MATH 109,B02,083216,Ganzberger; Geoffrey Michael,1,0,32,31
1656291379732,MATH 109,B03,093479,Staff,3,0,32,29
1656291385762,MATH 142A,A01,083219,Chow; Bennett,1,0,32,31
1656291385762,MATH 142A,A02,083220,Chow; Bennett,8,0,32,24
1656291385762,MATH 142A,A03,093480,Staff,5,0,32,27
1656291385762,MATH 142A,B03,093481,Staff,3,0,32,29
1656291385762,MATH 142A,B04,093558,Staff,6,0,32,26
1656291385762,MATH 142A,B05,093559,Staff,0,0,32,32
1656291391785,MATH 193A,A01,083224,Rotar; Vladimir,0,1,34,34
1656291391785,MATH 193A,A02,083225,Rotar; Vladimir,0,0,34,34
1656291391785,MATH 193A,A03,083781,Rotar; Vladimir,0,0,34,34
1656291391785,MATH 193A,A04,083782,Rotar; Vladimir,6,0,34,28
1656291391785,MATH 193A,A05,093482,Rotar; Vladimir,0,0,34,34
1656291397812,MATH 197,001,091859,McAuley; Julian John,9999,0,9999,0
1656291397812,MATH 197,002,095566,Kedlaya; Kiran S.,9997,0,9999,2
1656291397812,MATH 197,003,095567,Xiao; Ming,9999,0,9999,0
1656291397812,MATH 197,004,095571,Perols; Johan Lars,9998,0,9999,1
1656291404866,COGS 9,A01,083615,Shannon; Kyle Michael,3,0,75,72
1656291410890,COGS 11,A01,083617,Boyle; Mary E. T.,15,0,48,33
1656291416917,COGS 13,A01,083071,Bastos; Amalia Pinkusfeld,5,0,71,66
1656291422960,COGS 14A,A01,092681,Semenuks; Arturs,1,13,100,99
1656291428985,COGS 14B,A01,083073,Cheng; Tzu-Han,7,0,63,56
1656291435008,COGS 17,A01,092677,Semenuks; Arturs,7,0,81,74
1656291441031,COGS 100,A01,083619,Allen; Michael Gordon,2,0,70,68
1656291447058,COGS 101A,A01,083621,Davis; Joshua Daniel,4,0,68,64
1656291453081,COGS 101B,A01,091572,Allen; Michael Gordon,4,0,65,61
1656291459105,COGS 101C,A01,083625,Delgado; Tania,11,0,35,24
1656291465128,COGS 107A,A01,083627,Boyle; Mary E. T.,0,0,60,60
1656291471153,COGS 118A,A01,083075,Gupta; Anjum,8,0,76,68
1656291477176,CSE 3,A50,083646,Miranda; Gregory Joseph,18,0,50,32
1656291483204,CSE 8A,A50,083650,Miranda; Gregory Joseph,2,3,56,54
1656291489227,CSE 11,A01,083080,Cao; Yingjun,0,48,40,40
1656291495255,CSE 12,A01,083652,Krause-Levy; Sophia Louisa,5,1,120,115
1656291501283,CSE 15L,A01,083654,Morris; Justin Loren,2,0,50,48
1656291501283,CSE 15L,A02,083655,Morris; Justin Loren,4,0,50,46
1656291507314,CSE 20,A01,083657,Tran; Khoa Dang,30,0,80,50
1656291513338,CSE 21,A01,095574,Bach; Quang Tran,23,0,48,25
1656291519365,CSE 30,A01,083084,Eldon; John,2,6,80,78
1656291519365,CSE 30,B01,095061,Bhaskar; Nishant,0,1,50,50
1656291525389,CSE 100,A01,083659,Cao; Yingjun,1,18,70,69
1656291531416,CSE 134B,A01,083661,Powell; Thomas Allan,6,0,100,94
1656291537441,CSE 140,A01,083663,Gungor; Onat,8,0,85,77
1656291543465,CSE 140L,A01,083088,Eldon; John,10,0,100,90
1656291549488,CSE 175,A01,083665,Kumar; Rakesh,0,0,25,25
1656291555514,CSE 190,A00,092507,Dubnov; Shlomo,3,0,20,17
1656291561537,ECE 45,A01,083139,Congero; Spencer William,1,0,75,74
1656291567566,ECE 65,A50,083695,Saad; Andrew S,9,0,30,21
1656291567566,ECE 65,A51,095125,Staff,24,0,26,2
1656291573599,ECE 109,A01,091882,Touri; Behrouz,1,1,70,69
1656291579622,ECE 180,A00,083140,Abi Samra; Nicholas Camill,2,0,30,28
1656291579622,ECE 180,B00,083141,Abi Samra; Nicholas Camill,0,4,30,30
1656291585645,MATH 10A,A01,083735,Patchell; Gregory David,0,0,30,30
1656291585645,MATH 10A,A02,083736,Patchell; Gregory David,22,0,30,8
1656291585645,MATH 10A,A03,083737,Patchell; Gregory David,16,0,30,14
1656291591672,MATH 10B,A01,083207,Lim; Seonhee,1,0,34,33
1656291591672,MATH 10B,A02,083208,Lim; Seonhee,7,0,35,28
1656291591672,MATH 10B,A03,093472,Staff,1,0,34,33
1656291591672,MATH 10B,B01,083739,Sinha; Shubham,11,0,30,19
1656291597696,MATH 18,A01,083743,Cinel; Cameron Alexander,7,0,30,23
1656291597696,MATH 18,A02,083744,Cinel; Cameron Alexander,9,0,30,21
1656291597696,MATH 18,A03,083745,Cinel; Cameron Alexander,5,0,30,25
1656291597696,MATH 18,B01,083748,Rideout; David Porter,1,0,36,35
1656291597696,MATH 18,B02,083749,Rideout; David Porter,0,0,36,36
1656291597696,MATH 18,B03,083750,Rideout; David Porter,0,0,36,36
1656291597696,MATH 18,B04,083751,Rideout; David Porter,0,1,36,36
1656291597696,MATH 18,B05,093473,Rideout; David Porter,0,0,36,36
1656291597696,MATH 18,B06,093474,Rideout; David Porter,3,0,36,33
1656291603721,MATH 20A,A01,083754,Zheng; Zequn,11,0,40,29
1656291609748,MATH 20B,A01,083756,Briones; Jor-el Thomas Caparas,0,0,36,36
1656291609748,MATH 20B,A02,083757,Briones; Jor-el Thomas Caparas,0,0,36,36
1656291609748,MATH 20B,A03,093475,Staff,1,0,36,35
1656291615772,MATH 20C,A01,083760,Briones; Jor-el Thomas Caparas,0,0,35,35
1656291615772,MATH 20C,A02,083761,Briones; Jor-el Thomas Caparas,9,1,35,26
1656291615772,MATH 20C,A03,093476,Staff,0,0,35,35
1656291615772,MATH 20C,B01,083762,Bach; Quang Tran,2,0,30,28
1656291621797,MATH 20D,A01,083765,Tran; Brian Kha,1,0,30,29
1656291621797,MATH 20D,A02,083766,Tran; Brian Kha,0,1,30,30
1656291621797,MATH 20D,A03,083767,Tran; Brian Kha,2,0,30,28
1656291627825,MATH 20E,A01,083771,Ganguly; Soumya,3,0,32,29
1656291627825,MATH 20E,A02,083772,Ganguly; Soumya,0,0,32,32
1656291627825,MATH 20E,B01,083773,Ciotti; Benjamin,17,0,35,18
1656291627825,MATH 20E,B02,083774,Ciotti; Benjamin,15,0,35,20
1656291633849,MATH 103A,A01,083777,Greenfeld; Be'Eri,1,0,36,35
1656291633849,MATH 103A,A02,083778,Greenfeld; Be'Eri,3,0,36,33
1656291633849,MATH 103A,A03,093561,Staff,4,0,36,32
1656291633849,MATH 103A,B01,083779,Greenfeld; Be'Eri,8,0,36,28
1656291633849,MATH 103A,B02,083780,Greenfeld; Be'Eri,0,0,36,36
1656291633849,MATH 103A,B03,093562,Staff,1,0,36,35
1656291639876,MATH 105,A01,085443,Carter; Anne Toulson,5,0,35,30
1656291639876,MATH 105,A02,093477,Staff,14,0,35,21
1656291645903,MATH 109,A01,083213,Ganzberger; Geoffrey Michael,1,0,34,33
1656291645903,MATH 109,A02,083214,Ganzberger; Geoffrey Michael,0,0,34,34
1656291645903,MATH 109,A03,093478,Staff,2,0,34,32
1656291645903,MATH 109,B01,083215,Ganzberger; Geoffrey Michael,4,0,32,28
1656291645903,MATH 109,B02,083216,Ganzberger; Geoffrey Michael,1,0,32,31
1656291645903,MATH 109,B03,093479,Staff,3,0,32,29
1656291651932,MATH 142A,A01,083219,Chow; Bennett,1,0,32,31
1656291651932,MATH 142A,A02,083220,Chow; Bennett,8,0,32,24
1656291651932,MATH 142A,A03,093480,Staff,5,0,32,27
1656291651932,MATH 142A,B03,093481,Staff,3,0,32,29
1656291651932,MATH 142A,B04,093558,Staff,6,0,32,26
1656291651932,MATH 142A,B05,093559,Staff,0,0,32,32
1656291657959,MATH 193A,A01,083224,Rotar; Vladimir,0,1,34,34
1656291657959,MATH 193A,A02,083225,Rotar; Vladimir,0,0,34,34
1656291657959,MATH 193A,A03,083781,Rotar; Vladimir,0,0,34,34
1656291657959,MATH 193A,A04,083782,Rotar; Vladimir,6,0,34,28
1656291657959,MATH 193A,A05,093482,Rotar; Vladimir,0,0,34,34
1656291663988,MATH 197,001,091859,McAuley; Julian John,9999,0,9999,0
1656291663988,MATH 197,002,095566,Kedlaya; Kiran S.,9997,0,9999,2
1656291663988,MATH 197,003,095567,Xiao; Ming,9999,0,9999,0
1656291663988,MATH 197,004,095571,Perols; Johan Lars,9998,0,9999,1
1656291671057,COGS 9,A01,083615,Shannon; Kyle Michael,3,0,75,72
1656291677080,COGS 11,A01,083617,Boyle; Mary E. T.,15,0,48,33
1656291683103,COGS 13,A01,083071,Bastos; Amalia Pinkusfeld,5,0,71,66
1656291689142,COGS 14A,A01,092681,Semenuks; Arturs,1,13,100,99
1656291695168,COGS 14B,A01,083073,Cheng; Tzu-Han,7,0,63,56
1656291701192,COGS 17,A01,092677,Semenuks; Arturs,7,0,81,74
1656291707216,COGS 100,A01,083619,Allen; Michael Gordon,2,0,70,68
1656291713257,COGS 101A,A01,083621,Davis; Joshua Daniel,4,0,68,64
1656291719280,COGS 101B,A01,091572,Allen; Michael Gordon,4,0,65,61
1656291725380,COGS 101C,A01,083625,Delgado; Tania,11,0,35,24
1656291731415,COGS 107A,A01,083627,Boyle; Mary E. T.,0,0,60,60
1656291737451,COGS 118A,A01,083075,Gupta; Anjum,8,0,76,68
1656291743474,CSE 3,A50,083646,Miranda; Gregory Joseph,18,0,50,32
1656291749501,CSE 8A,A50,083650,Miranda; Gregory Joseph,2,3,56,54
1656291755530,CSE 11,A01,083080,Cao; Yingjun,0,48,40,40
1656291761556,CSE 12,A01,083652,Krause-Levy; Sophia Louisa,5,1,120,115
1656291767583,CSE 15L,A01,083654,Morris; Justin Loren,2,0,50,48
1656291767583,CSE 15L,A02,083655,Morris; Justin Loren,4,0,50,46
1656291773607,CSE 20,A01,083657,Tran; Khoa Dang,30,0,80,50
1656291779630,CSE 21,A01,095574,Bach; Quang Tran,23,0,48,25
1656291785653,CSE 30,A01,083084,Eldon; John,2,6,80,78
1656291785653,CSE 30,B01,095061,Bhaskar; Nishant,0,1,50,50
1656291791677,CSE 100,A01,083659,Cao; Yingjun,1,18,70,69
1656291797698,CSE 134B,A01,083661,Powell; Thomas Allan,6,0,100,94
1656291803721,CSE 140,A01,083663,Gungor; Onat,8,0,85,77
1656291809752,CSE 140L,A01,083088,Eldon; John,10,0,100,90
1656291815778,CSE 175,A01,083665,Kumar; Rakesh,0,0,25,25
1656291821800,CSE 190,A00,092507,Dubnov; Shlomo,3,0,20,17
1656291827823,ECE 45,A01,083139,Congero; Spencer William,1,0,75,74
1656291833850,ECE 65,A50,083695,Saad; Andrew S,9,0,30,21
1656291833850,ECE 65,A51,095125,Staff,24,0,26,2
1656291839872,ECE 109,A01,091882,Touri; Behrouz,1,1,70,69
1656291845898,ECE 180,A00,083140,Abi Samra; Nicholas Camill,2,0,30,28
1656291845898,ECE 180,B00,083141,Abi Samra; Nicholas Camill,0,4,30,30
1656291851926,MATH 10A,A01,083735,Patchell; Gregory David,0,0,30,30
1656291851926,MATH 10A,A02,083736,Patchell; Gregory David,22,0,30,8
1656291851926,MATH 10A,A03,083737,Patchell; Gregory David,16,0,30,14
1656291857949,MATH 10B,A01,083207,Lim; Seonhee,1,0,34,33
1656291857949,MATH 10B,A02,083208,Lim; Seonhee,7,0,35,28
1656291857949,MATH 10B,A03,093472,Staff,1,0,34,33
1656291857949,MATH 10B,B01,083739,Sinha; Shubham,11,0,30,19
1656291863980,MATH 18,A01,083743,Cinel; Cameron Alexander,7,0,30,23
1656291863980,MATH 18,A02,083744,Cinel; Cameron Alexander,9,0,30,21
1656291863980,MATH 18,A03,083745,Cinel; Cameron Alexander,5,0,30,25
1656291863980,MATH 18,B01,083748,Rideout; David Porter,1,0,36,35
1656291863980,MATH 18,B02,083749,Rideout; David Porter,0,0,36,36
1656291863980,MATH 18,B03,083750,Rideout; David Porter,0,0,36,36
1656291863980,MATH 18,B04,083751,Rideout; David Porter,0,1,36,36
1656291863980,MATH 18,B05,093473,Rideout; David Porter,0,0,36,36
1656291863980,MATH 18,B06,093474,Rideout; David Porter,3,0,36,33
1656291870006,MATH 20A,A01,083754,Zheng; Zequn,11,0,40,29
1656291876030,MATH 20B,A01,083756,Briones; Jor-el Thomas Caparas,0,0,36,36
1656291876030,MATH 20B,A02,083757,Briones; Jor-el Thomas Caparas,0,0,36,36
1656291876030,MATH 20B,A03,093475,Staff,1,0,36,35
1656291882054,MATH 20C,A01,083760,Briones; Jor-el Thomas Caparas,0,0,35,35
1656291882054,MATH 20C,A02,083761,Briones; Jor-el Thomas Caparas,9,1,35,26
1656291882054,MATH 20C,A03,093476,Staff,0,0,35,35
1656291882054,MATH 20C,B01,083762,Bach; Quang Tran,2,0,30,28
1656291888078,MATH 20D,A01,083765,Tran; Brian Kha,1,0,30,29
1656291888078,MATH 20D,A02,083766,Tran; Brian Kha,0,1,30,30
1656291888078,MATH 20D,A03,083767,Tran; Brian Kha,2,0,30,28
1656291894107,MATH 20E,A01,083771,Ganguly; Soumya,3,0,32,29
1656291894107,MATH 20E,A02,083772,Ganguly; Soumya,0,0,32,32
1656291894107,MATH 20E,B01,083773,Ciotti; Benjamin,17,0,35,18
1656291894107,MATH 20E,B02,083774,Ciotti; Benjamin,15,0,35,20
1656291900135,MATH 103A,A01,083777,Greenfeld; Be'Eri,1,0,36,35
1656291900135,MATH 103A,A02,083778,Greenfeld; Be'Eri,3,0,36,33
1656291900135,MATH 103A,A03,093561,Staff,4,0,36,32
1656291900135,MATH 103A,B01,083779,Greenfeld; Be'Eri,8,0,36,28
1656291900135,MATH 103A,B02,083780,Greenfeld; Be'Eri,0,0,36,36
1656291900135,MATH 103A,B03,093562,Staff,1,0,36,35
1656291906171,MATH 105,A01,085443,Carter; Anne Toulson,5,0,35,30
1656291906171,MATH 105,A02,093477,Staff,14,0,35,21
1656291912198,MATH 109,A01,083213,Ganzberger; Geoffrey Michael,1,0,34,33
1656291912198,MATH 109,A02,083214,Ganzberger; Geoffrey Michael,0,0,34,34
1656291912198,MATH 109,A03,093478,Staff,2,0,34,32
1656291912198,MATH 109,B01,083215,Ganzberger; Geoffrey Michael,4,0,32,28
1656291912198,MATH 109,B02,083216,Ganzberger; Geoffrey Michael,1,0,32,31
1656291912198,MATH 109,B03,093479,Staff,3,0,32,29
1656291918223,MATH 142A,A01,083219,Chow; Bennett,1,0,32,31
1656291918223,MATH 142A,A02,083220,Chow; Bennett,8,0,32,24
1656291918223,MATH 142A,A03,093480,Staff,5,0,32,27
1656291918223,MATH 142A,B03,093481,Staff,3,0,32,29
1656291918223,MATH 142A,B04,093558,Staff,6,0,32,26
1656291918223,MATH 142A,B05,093559,Staff,0,0,32,32
1656291924248,MATH 193A,A01,083224,Rotar; Vladimir,0,1,34,34
1656291924248,MATH 193A,A02,083225,Rotar; Vladimir,0,0,34,34
1656291924248,MATH 193A,A03,083781,Rotar; Vladimir,0,0,34,34
1656291924248,MATH 193A,A04,083782,Rotar; Vladimir,6,0,34,28
1656291924248,MATH 193A,A05,093482,Rotar; Vladimir,0,0,34,34
1656291930271,MATH 197,001,091859,McAuley; Julian John,9999,0,9999,0
1656291930271,MATH 197,002,095566,Kedlaya; Kiran S.,9997,0,9999,2
1656291930271,MATH 197,003,095567,Xiao; Ming,9999,0,9999,0
1656291930271,MATH 197,004,095571,Perols; Johan Lars,9998,0,9999,1
1656291937339,COGS 9,A01,083615,Shannon; Kyle Michael,3,0,75,72
1656291943363,COGS 11,A01,083617,Boyle; Mary E. T.,15,0,48,33
1656291949385,COGS 13,A01,083071,Bastos; Amalia Pinkusfeld,5,0,71,66
1656291955410,COGS 14A,A01,092681,Semenuks; Arturs,1,13,100,99
1656291961442,COGS 14B,A01,083073,Cheng; Tzu-Han,7,0,63,56
1656291967470,COGS 17,A01,092677,Semenuks; Arturs,7,0,81,74
1656291973497,COGS 100,A01,083619,Allen; Michael Gordon,2,0,70,68
1656291979524,COGS 101A,A01,083621,Davis; Joshua Daniel,4,0,68,64
1656291985554,COGS 101B,A01,091572,Allen; Michael Gordon,4,0,65,61
1656291991577,COGS 101C,A01,083625,Delgado; Tania,11,0,35,24
1656291997603,COGS 107A,A01,083627,Boyle; Mary E. T.,0,0,60,60
1656292003627,COGS 118A,A01,083075,Gupta; Anjum,8,0,76,68
1656292009655,CSE 3,A50,083646,Miranda; Gregory Joseph,18,0,50,32
1656292015683,CSE 8A,A50,083650,Miranda; Gregory Joseph,2,3,56,54
1656292021705,CSE 11,A01,083080,Cao; Yingjun,0,48,40,40
1656292027732,CSE 12,A01,083652,Krause-Levy; Sophia Louisa,5,1,120,115
1656292033755,CSE 15L,A01,083654,Morris; Justin Loren,2,0,50,48
1656292033755,CSE 15L,A02,083655,Morris; Justin Loren,4,0,50,46
1656292039792,CSE 20,A01,083657,Tran; Khoa Dang,30,0,80,50
1656292045819,CSE 21,A01,095574,Bach; Quang Tran,23,0,48,25
1656292051841,CSE 30,A01,083084,Eldon; John,2,6,80,78
1656292051841,CSE 30,B01,095061,Bhaskar; Nishant,0,1,50,50
1656292057865,CSE 100,A01,083659,Cao; Yingjun,1,18,70,69
1656292063892,CSE 134B,A01,083661,Powell; Thomas Allan,6,0,100,94
1656292069915,CSE 140,A01,083663,Gungor; Onat,8,0,85,77
1656292075943,CSE 140L,A01,083088,Eldon; John,10,0,100,90
1656292081966,CSE 175,A01,083665,Kumar; Rakesh,0,0,25,25
1656292087992,CSE 190,A00,092507,Dubnov; Shlomo,3,0,20,17
1656292094016,ECE 45,A01,083139,Congero; Spencer William,1,0,75,74
1656292100040,ECE 65,A50,083695,Saad; Andrew S,9,0,30,21
1656292100040,ECE 65,A51,095125,Staff,24,0,26,2
1656292106067,ECE 109,A01,091882,Touri; Behrouz,1,1,70,69
1656292112095,ECE 180,A00,083140,Abi Samra; Nicholas Camill,2,0,30,28
1656292112095,ECE 180,B00,083141,Abi Samra; Nicholas Camill,0,4,30,30
1656292118123,MATH 10A,A01,083735,Patchell; Gregory David,0,0,30,30
1656292118123,MATH 10A,A02,083736,Patchell; Gregory David,22,0,30,8
1656292118123,MATH 10A,A03,083737,Patchell; Gregory David,16,0,30,14
1656292124146,MATH 10B,A01,083207,Lim; Seonhee,2,0,34,32
1656292124146,MATH 10B,A02,083208,Lim; Seonhee,6,0,35,29
1656292124146,MATH 10B,A03,093472,Staff,1,0,34,33
1656292124146,MATH 10B,B01,083739,Sinha; Shubham,11,0,30,19
1656292130172,MATH 18,A01,083743,Cinel; Cameron Alexander,7,0,30,23
1656292130172,MATH 18,A02,083744,Cinel; Cameron Alexander,9,0,30,21
1656292130172,MATH 18,A03,083745,Cinel; Cameron Alexander,5,0,30,25
1656292130172,MATH 18,B01,083748,Rideout; David Porter,1,0,36,35
1656292130172,MATH 18,B02,083749,Rideout; David Porter,0,0,36,36
1656292130172,MATH 18,B03,083750,Rideout; David Porter,0,0,36,36
1656292130172,MATH 18,B04,083751,Rideout; David Porter,0,1,36,36
1656292130172,MATH 18,B05,093473,Rideout; David Porter,0,0,36,36
1656292130172,MATH 18,B06,093474,Rideout; David Porter,3,0,36,33
1656292136196,MATH 20A,A01,083754,Zheng; Zequn,11,0,40,29
1656292142222,MATH 20B,A01,083756,Briones; Jor-el Thomas Caparas,0,0,36,36
1656292142222,MATH 20B,A02,083757,Briones; Jor-el Thomas Caparas,0,0,36,36
1656292142222,MATH 20B,A03,093475,Staff,1,0,36,35
1656292148251,MATH 20C,A01,083760,Briones; Jor-el Thomas Caparas,0,0,35,35
1656292148251,MATH 20C,A02,083761,Briones; Jor-el Thomas Caparas,9,1,35,26
1656292148251,MATH 20C,A03,093476,Staff,0,0,35,35
1656292148251,MATH 20C,B01,083762,Bach; Quang Tran,2,0,30,28
1656292154276,MATH 20D,A01,083765,Tran; Brian Kha,1,0,30,29
1656292154276,MATH 20D,A02,083766,Tran; Brian Kha,0,1,30,30
1656292154276,MATH 20D,A03,083767,Tran; Brian Kha,2,0,30,28
1656292160300,MATH 20E,A01,083771,Ganguly; Soumya,3,0,32,29
1656292160300,MATH 20E,A02,083772,Ganguly; Soumya,0,0,32,32
1656292160300,MATH 20E,B01,083773,Ciotti; Benjamin,17,0,35,18
1656292160300,MATH 20E,B02,083774,Ciotti; Benjamin,15,0,35,20
1656292166324,MATH 103A,A01,083777,Greenfeld; Be'Eri,1,0,36,35
1656292166324,MATH 103A,A02,083778,Greenfeld; Be'Eri,3,0,36,33
1656292166324,MATH 103A,A03,093561,Staff,4,0,36,32
1656292166324,MATH 103A,B01,083779,Greenfeld; Be'Eri,8,0,36,28
1656292166324,MATH 103A,B02,083780,Greenfeld; Be'Eri,0,0,36,36
1656292166324,MATH 103A,B03,093562,Staff,1,0,36,35
1656292172353,MATH 105,A01,085443,Carter; Anne Toulson,5,0,35,30
1656292172353,MATH 105,A02,093477,Staff,14,0,35,21
1656292178377,MATH 109,A01,083213,Ganzberger; Geoffrey Michael,1,0,34,33
1656292178377,MATH 109,A02,083214,Ganzberger; Geoffrey Michael,0,0,34,34
1656292178377,MATH 109,A03,093478,Staff,2,0,34,32
1656292178377,MATH 109,B01,083215,Ganzberger; Geoffrey Michael,4,0,32,28
1656292178377,MATH 109,B02,083216,Ganzberger; Geoffrey Michael,1,0,32,31
1656292178377,MATH 109,B03,093479,Staff,3,0,32,29
1656292184403,MATH 142A,A01,083219,Chow; Bennett,1,0,32,31
1656292184403,MATH 142A,A02,083220,Chow; Bennett,8,0,32,24
1656292184403,MATH 142A,A03,093480,Staff,5,0,32,27
1656292184403,MATH 142A,B03,093481,Staff,3,0,32,29
1656292184403,MATH 142A,B04,093558,Staff,6,0,32,26
1656292184403,MATH 142A,B05,093559,Staff,0,0,32,32
1656292190441,MATH 193A,A01,083224,Rotar; Vladimir,0,1,34,34
1656292190441,MATH 193A,A02,083225,Rotar; Vladimir,0,0,34,34
1656292190441,MATH 193A,A03,083781,Rotar; Vladimir,0,0,34,34
1656292190441,MATH 193A,A04,083782,Rotar; Vladimir,6,0,34,28
1656292190441,MATH 193A,A05,093482,Rotar; Vladimir,0,0,34,34
1656292196473,MATH 197,001,091859,McAuley; Julian John,9999,0,9999,0
1656292196473,MATH 197,002,095566,Kedlaya; Kiran S.,9997,0,9999,2
1656292196473,MATH 197,003,095567,Xiao; Ming,9999,0,9999,0
1656292196473,MATH 197,004,095571,Perols; Johan Lars,9998,0,9999,1
1656292203532,COGS 9,A01,083615,Shannon; Kyle Michael,4,0,75,71
1656292209562,COGS 11,A01,083617,Boyle; Mary E. T.,15,0,48,33
1656292215586,COGS 13,A01,083071,Bastos; Amalia Pinkusfeld,5,0,71,66
1656292221609,COGS 14A,A01,092681,Semenuks; Arturs,1,13,100,99
1656292227633,COGS 14B,A01,083073,Cheng; Tzu-Han,7,0,63,56
1656292233656,COGS 17,A01,092677,Semenuks; Arturs,7,0,81,74
1656292239679,COGS 100,A01,083619,Allen; Michael Gordon,2,0,70,68
1656292245711,COGS 101A,A01,083621,Davis; Joshua Daniel,4,0,68,64
1656292251737,COGS 101B,A01,091572,Allen; Michael Gordon,4,0,65,61
1656292257760,COGS 101C,A01,083625,Delgado; Tania,11,0,35,24
1656292263791,COGS 107A,A01,083627,Boyle; Mary E. T.,0,0,60,60
1656292269818,COGS 118A,A01,083075,Gupta; Anjum,8,0,76,68
1656292275841,CSE 3,A50,083646,Miranda; Gregory Joseph,18,0,50,32
1656292281869,CSE 8A,A50,083650,Miranda; Gregory Joseph,2,3,56,54
1656292287892,CSE 11,A01,083080,Cao; Yingjun,0,48,40,40
1656292293919,CSE 12,A01,083652,Krause-Levy; Sophia Louisa,5,1,120,115
1656292299944,CSE 15L,A01,083654,Morris; Justin Loren,2,0,50,48
1656292299944,CSE 15L,A02,083655,Morris; Justin Loren,4,0,50,46
1656292305972,CSE 20,A01,083657,Tran; Khoa Dang,30,0,80,50
1656292311993,CSE 21,A01,095574,Bach; Quang Tran,23,0,48,25
1656292318031,CSE 30,A01,083084,Eldon; John,2,6,80,78
1656292318031,CSE 30,B01,095061,Bhaskar; Nishant,0,1,50,50
1656292324130,CSE 100,A01,083659,Cao; Yingjun,1,18,70,69
1656292330158,CSE 134B,A01,083661,Powell; Thomas Allan,6,0,100,94
1656292336181,CSE 140,A01,083663,Gungor; Onat,8,0,85,77
1656292342210,CSE 140L,A01,083088,Eldon; John,10,0,100,90
1656292348234,CSE 175,A01,083665,Kumar; Rakesh,0,0,25,25
1656292354257,CSE 190,A00,092507,Dubnov; Shlomo,3,0,20,17
1656292360280,ECE 45,A01,083139,Congero; Spencer William,1,0,75,74
1656292366303,ECE 65,A50,083695,Saad; Andrew S,9,0,30,21
1656292366303,ECE 65,A51,095125,Staff,24,0,26,2
1656292372325,ECE 109,A01,091882,Touri; Behrouz,1,1,70,69
1656292378348,ECE 180,A00,083140,Abi Samra; Nicholas Camill,2,0,30,28
1656292378348,ECE 180,B00,083141,Abi Samra; Nicholas Camill,0,4,30,30
1656292384380,MATH 10A,A01,083735,Patchell; Gregory David,0,0,30,30
1656292384380,MATH 10A,A02,083736,Patchell; Gregory David,22,0,30,8
1656292384380,MATH 10A,A03,083737,Patchell; Gregory David,16,0,30,14
1656292390404,MATH 10B,A01,083207,Lim; Seonhee,2,0,34,32
1656292390404,MATH 10B,A02,083208,Lim; Seonhee,6,0,35,29
1656292390404,MATH 10B,A03,093472,Staff,1,0,34,33
1656292390404,MATH 10B,B01,083739,Sinha; Shubham,11,0,30,19
1656292396427,MATH 18,A01,083743,Cinel; Cameron Alexander,7,0,30,23
1656292396427,MATH 18,A02,083744,Cinel; Cameron Alexander,9,0,30,21
1656292396427,MATH 18,A03,083745,Cinel; Cameron Alexander,5,0,30,25
1656292396427,MATH 18,B01,083748,Rideout; David Porter,1,0,36,35
1656292396427,MATH 18,B02,083749,Rideout; David Porter,0,0,36,36
1656292396427,MATH 18,B03,083750,Rideout; David Porter,0,0,36,36
1656292396427,MATH 18,B04,083751,Rideout; David Porter,0,1,36,36
1656292396427,MATH 18,B05,093473,Rideout; David Porter,0,0,36,36
1656292396427,MATH 18,B06,093474,Rideout; David Porter,3,0,36,33
1656292402451,MATH 20A,A01,083754,Zheng; Zequn,11,0,40,29
1656292408491,MATH 20B,A01,083756,Briones; Jor-el Thomas Caparas,0,0,36,36
1656292408491,MATH 20B,A02,083757,Briones; Jor-el Thomas Caparas,0,0,36,36
1656292408491,MATH 20B,A03,093475,Staff,1,0,36,35
1656292414521,MATH 20C,A01,083760,Briones; Jor-el Thomas Caparas,0,0,35,35
1656292414521,MATH 20C,A02,083761,Briones; Jor-el Thomas Caparas,9,1,35,26
1656292414521,MATH 20C,A03,093476,Staff,0,0,35,35
1656292414521,MATH 20C,B01,083762,Bach; Quang Tran,2,0,30,28
1656292420550,MATH 20D,A01,083765,Tran; Brian Kha,1,0,30,29
1656292420550,MATH 20D,A02,083766,Tran; Brian Kha,0,1,30,30
1656292420550,MATH 20D,A03,083767,Tran; Brian Kha,2,0,30,28
1656292426573,MATH 20E,A01,083771,Ganguly; Soumya,3,0,32,29
1656292426573,MATH 20E,A02,083772,Ganguly; Soumya,0,0,32,32
1656292426573,MATH 20E,B01,083773,Ciotti; Benjamin,17,0,35,18
1656292426573,MATH 20E,B02,083774,Ciotti; Benjamin,15,0,35,20
1656292432596,MATH 103A,A01,083777,Greenfeld; Be'Eri,1,0,36,35
1656292432596,MATH 103A,A02,083778,Greenfeld; Be'Eri,3,0,36,33
1656292432596,MATH 103A,A03,093561,Staff,4,0,36,32
1656292432596,MATH 103A,B01,083779,Greenfeld; Be'Eri,8,0,36,28
1656292432596,MATH 103A,B02,083780,Greenfeld; Be'Eri,0,0,36,36
1656292432596,MATH 103A,B03,093562,Staff,1,0,36,35
1656292438623,MATH 105,A01,085443,Carter; Anne Toulson,5,0,35,30
1656292438623,MATH 105,A02,093477,Staff,14,0,35,21
1656292444658,MATH 109,A01,083213,Ganzberger; Geoffrey Michael,1,0,34,33
1656292444658,MATH 109,A02,083214,Ganzberger; Geoffrey Michael,0,0,34,34
1656292444658,MATH 109,A03,093478,Staff,2,0,34,32
1656292444658,MATH 109,B01,083215,Ganzberger; Geoffrey Michael,4,0,32,28
1656292444658,MATH 109,B02,083216,Ganzberger; Geoffrey Michael,1,0,32,31
1656292444658,MATH 109,B03,093479,Staff,3,0,32,29
1656292450684,MATH 142A,A01,083219,Chow; Bennett,1,0,32,31
1656292450684,MATH 142A,A02,083220,Chow; Bennett,8,0,32,24
1656292450684,MATH 142A,A03,093480,Staff,5,0,32,27
1656292450684,MATH 142A,B03,093481,Staff,3,0,32,29
1656292450684,MATH 142A,B04,093558,Staff,6,0,32,26
1656292450684,MATH 142A,B05,093559,Staff,0,0,32,32
1656292456708,MATH 193A,A01,083224,Rotar; Vladimir,0,1,34,34
1656292456708,MATH 193A,A02,083225,Rotar; Vladimir,0,0,34,34
1656292456708,MATH 193A,A03,083781,Rotar; Vladimir,0,0,34,34
1656292456708,MATH 193A,A04,083782,Rotar; Vladimir,6,0,34,28
1656292456708,MATH 193A,A05,093482,Rotar; Vladimir,0,0,34,34
1656292462731,MATH 197,001,091859,McAuley; Julian John,9999,0,9999,0
1656292462731,MATH 197,002,095566,Kedlaya; Kiran S.,9997,0,9999,2
1656292462731,MATH 197,003,095567,Xiao; Ming,9999,0,9999,0
1656292462731,MATH 197,004,095571,Perols; Johan Lars,9998,0,9999,1
1656292469786,COGS 9,A01,083615,Shannon; Kyle Michael,4,0,75,71
1656292475819,COGS 11,A01,083617,Boyle; Mary E. T.,15,0,48,33
1656292481845,COGS 13,A01,083071,Bastos; Amalia Pinkusfeld,5,0,71,66
1656292487869,COGS 14A,A01,092681,Semenuks; Arturs,1,13,100,99
1656292493894,COGS 14B,A01,083073,Cheng; Tzu-Han,7,0,63,56
1656292499917,COGS 17,A01,092677,Semenuks; Arturs,7,0,81,74
1656292505944,COGS 100,A01,083619,Allen; Michael Gordon,2,0,70,68
1656292511968,COGS 101A,A01,083621,Davis; Joshua Daniel,4,0,68,64
1656292517991,COGS 101B,A01,091572,Allen; Michael Gordon,4,0,65,61
1656292524019,COGS 101C,A01,083625,Delgado; Tania,11,0,35,24
1656292530042,COGS 107A,A01,083627,Boyle; Mary E. T.,0,0,60,60
1656292536065,COGS 118A,A01,083075,Gupta; Anjum,8,0,76,68
1656292542092,CSE 3,A50,083646,Miranda; Gregory Joseph,18,0,50,32
1656292548119,CSE 8A,A50,083650,Miranda; Gregory Joseph,2,3,56,54
1656292554143,CSE 11,A01,083080,Cao; Yingjun,0,48,40,40
1656292560166,CSE 12,A01,083652,Krause-Levy; Sophia Louisa,5,1,120,115
1656292566193,CSE 15L,A01,083654,Morris; Justin Loren,2,0,50,48
1656292566193,CSE 15L,A02,083655,Morris; Justin Loren,4,0,50,46
1656292572216,CSE 20,A01,083657,Tran; Khoa Dang,30,0,80,50
1656292578240,CSE 21,A01,095574,Bach; Quang Tran,23,0,48,25
1656292584270,CSE 30,A01,083084,Eldon; John,2,6,80,78
1656292584270,CSE 30,B01,095061,Bhaskar; Nishant,0,1,50,50
1656292590294,CSE 100,A01,083659,Cao; Yingjun,1,18,70,69
1656292596318,CSE 134B,A01,083661,Powell; Thomas Allan,6,0,100,94
1656292602345,CSE 140,A01,083663,Gungor; Onat,8,0,85,77
1656292608376,CSE 140L,A01,083088,Eldon; John,10,0,100,90
1656292614408,CSE 175,A01,083665,Kumar; Rakesh,0,0,25,25
1656292620442,CSE 190,A00,092507,Dubnov; Shlomo,3,0,20,17
1656292626469,ECE 45,A01,083139,Congero; Spencer William,1,0,75,74
1656292632499,ECE 65,A50,083695,Saad; Andrew S,9,0,30,21
1656292632499,ECE 65,A51,095125,Staff,24,0,26,2
1656292638527,ECE 109,A01,091882,Touri; Behrouz,1,1,70,69
1656292644554,ECE 180,A00,083140,Abi Samra; Nicholas Camill,2,0,30,28
1656292644554,ECE 180,B00,083141,Abi Samra; Nicholas Camill,0,4,30,30
1656292650581,MATH 10A,A01,083735,Patchell; Gregory David,0,0,30,30
1656292650581,MATH 10A,A02,083736,Patchell; Gregory David,22,0,30,8
1656292650581,MATH 10A,A03,083737,Patchell; Gregory David,16,0,30,14
1656292656603,MATH 10B,A01,083207,Lim; Seonhee,2,0,34,32
1656292656603,MATH 10B,A02,083208,Lim; Seonhee,6,0,35,29
1656292656603,MATH 10B,A03,093472,Staff,1,0,34,33
1656292656603,MATH 10B,B01,083739,Sinha; Shubham,11,0,30,19
1656292662628,MATH 18,A01,083743,Cinel; Cameron Alexander,7,0,30,23
1656292662628,MATH 18,A02,083744,Cinel; Cameron Alexander,9,0,30,21
1656292662628,MATH 18,A03,083745,Cinel; Cameron Alexander,5,0,30,25
1656292662628,MATH 18,B01,083748,Rideout; David Porter,1,0,36,35
1656292662628,MATH 18,B02,083749,Rideout; David Porter,0,0,36,36
1656292662628,MATH 18,B03,083750,Rideout; David Porter,0,0,36,36
1656292662628,MATH 18,B04,083751,Rideout; David Porter,0,1,36,36
1656292662628,MATH 18,B05,093473,Rideout; David Porter,0,0,36,36
1656292662628,MATH 18,B06,093474,Rideout; David Porter,3,0,36,33
1656292668654,MATH 20A,A01,083754,Zheng; Zequn,11,0,40,29
1656292674683,MATH 20B,A01,083756,Briones; Jor-el Thomas Caparas,0,0,36,36
1656292674683,MATH 20B,A02,083757,Briones; Jor-el Thomas Caparas,0,0,36,36
1656292674683,MATH 20B,A03,093475,Staff,1,0,36,35
1656292680706,MATH 20C,A01,083760,Briones; Jor-el Thomas Caparas,0,0,35,35
1656292680706,MATH 20C,A02,083761,Briones; Jor-el Thomas Caparas,9,1,35,26
1656292680706,MATH 20C,A03,093476,Staff,0,0,35,35
1656292680706,MATH 20C,B01,083762,Bach; Quang Tran,2,0,30,28
1656292686743,MATH 20D,A01,083765,Tran; Brian Kha,1,0,30,29
1656292686743,MATH 20D,A02,083766,Tran; Brian Kha,0,1,30,30
1656292686743,MATH 20D,A03,083767,Tran; Brian Kha,2,0,30,28
1656292692767,MATH 20E,A01,083771,Ganguly; Soumya,3,0,32,29
1656292692767,MATH 20E,A02,083772,Ganguly; Soumya,0,0,32,32
1656292692767,MATH 20E,B01,083773,Ciotti; Benjamin,17,0,35,18
1656292692767,MATH 20E,B02,083774,Ciotti; Benjamin,15,0,35,20
1656292698800,MATH 103A,A01,083777,Greenfeld; Be'Eri,1,0,36,35
1656292698800,MATH 103A,A02,083778,Greenfeld; Be'Eri,3,0,36,33
1656292698800,MATH 103A,A03,093561,Staff,4,0,36,32
1656292698800,MATH 103A,B01,083779,Greenfeld; Be'Eri,8,0,36,28
1656292698800,MATH 103A,B02,083780,Greenfeld; Be'Eri,0,0,36,36
1656292698800,MATH 103A,B03,093562,Staff,1,0,36,35
1656292704826,MATH 105,A01,085443,Carter; Anne Toulson,5,0,35,30
1656292704826,MATH 105,A02,093477,Staff,14,0,35,21
1656292710855,MATH 109,A01,083213,Ganzberger; Geoffrey Michael,1,0,34,33
1656292710855,MATH 109,A02,083214,Ganzberger; Geoffrey Michael,0,0,34,34
1656292710855,MATH 109,A03,093478,Staff,2,0,34,32
1656292710855,MATH 109,B01,083215,Ganzberger; Geoffrey Michael,4,0,32,28
1656292710855,MATH 109,B02,083216,Ganzberger; Geoffrey Michael,1,0,32,31
1656292710855,MATH 109,B03,093479,Staff,3,0,32,29
1656292716877,MATH 142A,A01,083219,Chow; Bennett,1,0,32,31
1656292716877,MATH 142A,A02,083220,Chow; Bennett,8,0,32,24
1656292716877,MATH 142A,A03,093480,Staff,5,0,32,27
1656292716877,MATH 142A,B03,093481,Staff,3,0,32,29
1656292716877,MATH 142A,B04,093558,Staff,6,0,32,26
1656292716877,MATH 142A,B05,093559,Staff,0,0,32,32
1656292722905,MATH 193A,A01,083224,Rotar; Vladimir,0,1,34,34
1656292722905,MATH 193A,A02,083225,Rotar; Vladimir,0,0,34,34
1656292722905,MATH 193A,A03,083781,Rotar; Vladimir,0,0,34,34
1656292722905,MATH 193A,A04,083782,Rotar; Vladimir,6,0,34,28
1656292722905,MATH 193A,A05,093482,Rotar; Vladimir,0,0,34,34
1656292728929,MATH 197,001,091859,McAuley; Julian John,9999,0,9999,0
1656292728929,MATH 197,002,095566,Kedlaya; Kiran S.,9997,0,9999,2
1656292728929,MATH 197,003,095567,Xiao; Ming,9999,0,9999,0
1656292728929,MATH 197,004,095571,Perols; Johan Lars,9998,0,9999,1
1656292735991,COGS 9,A01,083615,Shannon; Kyle Michael,4,0,75,71
1656292742015,COGS 11,A01,083617,Boyle; Mary E. T.,15,0,48,33
1656292748052,COGS 13,A01,083071,Bastos; Amalia Pinkusfeld,5,0,71,66
1656292754078,COGS 14A,A01,092681,Semenuks; Arturs,1,13,100,99
1656292760101,COGS 14B,A01,083073,Cheng; Tzu-Han,7,0,63,56
1656292766127,COGS 17,A01,092677,Semenuks; Arturs,7,0,81,74
1656292772154,COGS 100,A01,083619,Allen; Michael Gordon,2,0,70,68
1656292778181,COGS 101A,A01,083621,Davis; Joshua Daniel,4,0,68,64
1656292784204,COGS 101B,A01,091572,Allen; Michael Gordon,4,0,65,61
1656292790231,COGS 101C,A01,083625,Delgado; Tania,11,0,35,24
1656292796255,COGS 107A,A01,083627,Boyle; Mary E. T.,0,0,60,60
1656292802278,COGS 118A,A01,083075,Gupta; Anjum,8,0,76,68
1656292808303,CSE 3,A50,083646,Miranda; Gregory Joseph,18,0,50,32
1656292814328,CSE 8A,A50,083650,Miranda; Gregory Joseph,2,3,56,54
1656292820360,CSE 11,A01,083080,Cao; Yingjun,0,48,40,40
1656292826382,CSE 12,A01,083652,Krause-Levy; Sophia Louisa,5,1,120,115
1656292832405,CSE 15L,A01,083654,Morris; Justin Loren,2,0,50,48
1656292832405,CSE 15L,A02,083655,Morris; Justin Loren,4,0,50,46
1656292838433,CSE 20,A01,083657,Tran; Khoa Dang,30,0,80,50
1656292844457,CSE 21,A01,095574,Bach; Quang Tran,23,0,48,25
1656292850480,CSE 30,A01,083084,Eldon; John,2,6,80,78
1656292850480,CSE 30,B01,095061,Bhaskar; Nishant,0,1,50,50
1656292856505,CSE 100,A01,083659,Cao; Yingjun,1,18,70,69
1656292862532,CSE 134B,A01,083661,Powell; Thomas Allan,6,0,100,94
1656292868557,CSE 140,A01,083663,Gungor; Onat,8,0,85,77
1656292874580,CSE 140L,A01,083088,Eldon; John,10,0,100,90
1656292880603,CSE 175,A01,083665,Kumar; Rakesh,0,0,25,25
1656292886644,CSE 190,A00,092507,Dubnov; Shlomo,3,0,20,17
1656292892667,ECE 45,A01,083139,Congero; Spencer William,1,0,75,74
1656292898688,ECE 65,A50,083695,Saad; Andrew S,9,0,30,21
1656292898688,ECE 65,A51,095125,Staff,24,0,26,2
1656292904712,ECE 109,A01,091882,Touri; Behrouz,1,1,70,69
1656292910738,ECE 180,A00,083140,Abi Samra; Nicholas Camill,2,0,30,28
1656292910738,ECE 180,B00,083141,Abi Samra; Nicholas Camill,0,4,30,30
1656292916768,MATH 10A,A01,083735,Patchell; Gregory David,0,0,30,30
1656292916768,MATH 10A,A02,083736,Patchell; Gregory David,22,0,30,8
1656292916768,MATH 10A,A03,083737,Patchell; Gregory David,16,0,30,14
1656292922880,MATH 10B,A01,083207,Lim; Seonhee,2,0,34,32
1656292922880,MATH 10B,A02,083208,Lim; Seonhee,6,0,35,29
1656292922880,MATH 10B,A03,093472,Staff,1,0,34,33
1656292922880,MATH 10B,B01,083739,Sinha; Shubham,11,0,30,19
1656292928906,MATH 18,A01,083743,Cinel; Cameron Alexander,7,0,30,23
1656292928906,MATH 18,A02,083744,Cinel; Cameron Alexander,9,0,30,21
1656292928906,MATH 18,A03,083745,Cinel; Cameron Alexander,5,0,30,25
1656292928906,MATH 18,B01,083748,Rideout; David Porter,1,0,36,35
1656292928906,MATH 18,B02,083749,Rideout; David Porter,0,0,36,36
1656292928906,MATH 18,B03,083750,Rideout; David Porter,0,0,36,36
1656292928906,MATH 18,B04,083751,Rideout; David Porter,0,1,36,36
1656292928906,MATH 18,B05,093473,Rideout; David Porter,0,0,36,36
1656292928906,MATH 18,B06,093474,Rideout; David Porter,3,0,36,33
1656292934930,MATH 20A,A01,083754,Zheng; Zequn,11,0,40,29
1656292940958,MATH 20B,A01,083756,Briones; Jor-el Thomas Caparas,0,0,36,36
1656292940958,MATH 20B,A02,083757,Briones; Jor-el Thomas Caparas,0,0,36,36
1656292940958,MATH 20B,A03,093475,Staff,1,0,36,35
1656292946983,MATH 20C,A01,083760,Briones; Jor-el Thomas Caparas,0,0,35,35
1656292946983,MATH 20C,A02,083761,Briones; Jor-el Thomas Caparas,9,1,35,26
1656292946983,MATH 20C,A03,093476,Staff,0,0,35,35
1656292946983,MATH 20C,B01,083762,Bach; Quang Tran,2,0,30,28
1656292953011,MATH 20D,A01,083765,Tran; Brian Kha,1,0,30,29
1656292953011,MATH 20D,A02,083766,Tran; Brian Kha,0,1,30,30
1656292953011,MATH 20D,A03,083767,Tran; Brian Kha,2,0,30,28
1656292959040,MATH 20E,A01,083771,Ganguly; Soumya,3,0,32,29
1656292959040,MATH 20E,A02,083772,Ganguly; Soumya,0,0,32,32
1656292959040,MATH 20E,B01,083773,Ciotti; Benjamin,17,0,35,18
1656292959040,MATH 20E,B02,083774,Ciotti; Benjamin,15,0,35,20
1656292965064,MATH 103A,A01,083777,Greenfeld; Be'Eri,1,0,36,35
1656292965064,MATH 103A,A02,083778,Greenfeld; Be'Eri,3,0,36,33
1656292965064,MATH 103A,A03,093561,Staff,4,0,36,32
1656292965064,MATH 103A,B01,083779,Greenfeld; Be'Eri,8,0,36,28
1656292965064,MATH 103A,B02,083780,Greenfeld; Be'Eri,0,0,36,36
1656292965064,MATH 103A,B03,093562,Staff,1,0,36,35
1656292971090,MATH 105,A01,085443,Carter; Anne Toulson,5,0,35,30
1656292971090,MATH 105,A02,093477,Staff,14,0,35,21
1656292977115,MATH 109,A01,083213,Ganzberger; Geoffrey Michael,1,0,34,33
1656292977115,MATH 109,A02,083214,Ganzberger; Geoffrey Michael,0,0,34,34
1656292977115,MATH 109,A03,093478,Staff,2,0,34,32
1656292977115,MATH 109,B01,083215,Ganzberger; Geoffrey Michael,4,0,32,28
1656292977115,MATH 109,B02,083216,Ganzberger; Geoffrey Michael,1,0,32,31
1656292977115,MATH 109,B03,093479,Staff,3,0,32,29
1656292983140,MATH 142A,A01,083219,Chow; Bennett,1,0,32,31
1656292983140,MATH 142A,A02,083220,Chow; Bennett,8,0,32,24
1656292983140,MATH 142A,A03,093480,Staff,5,0,32,27
1656292983140,MATH 142A,B03,093481,Staff,3,0,32,29
1656292983140,MATH 142A,B04,093558,Staff,6,0,32,26
1656292983140,MATH 142A,B05,093559,Staff,0,0,32,32
1656292989175,MATH 193A,A01,083224,Rotar; Vladimir,0,1,34,34
1656292989175,MATH 193A,A02,083225,Rotar; Vladimir,0,0,34,34
1656292989175,MATH 193A,A03,083781,Rotar; Vladimir,0,0,34,34
1656292989175,MATH 193A,A04,083782,Rotar; Vladimir,6,0,34,28
1656292989175,MATH 193A,A05,093482,Rotar; Vladimir,0,0,34,34
1656292995199,MATH 197,001,091859,McAuley; Julian John,9999,0,9999,0
1656292995199,MATH 197,002,095566,Kedlaya; Kiran S.,9997,0,9999,2
1656292995199,MATH 197,003,095567,Xiao; Ming,9999,0,9999,0
1656292995199,MATH 197,004,095571,Perols; Johan Lars,9998,0,9999,1
1656293002271,COGS 9,A01,083615,Shannon; Kyle Michael,4,0,75,71
1656293008295,COGS 11,A01,083617,Boyle; Mary E. T.,15,0,48,33
1656293014318,COGS 13,A01,083071,Bastos; Amalia Pinkusfeld,5,0,71,66
1656293020342,COGS 14A,A01,092681,Semenuks; Arturs,1,13,100,99
1656293026365,COGS 14B,A01,083073,Cheng; Tzu-Han,7,0,63,56
1656293032388,COGS 17,A01,092677,Semenuks; Arturs,7,0,81,74
1656293038410,COGS 100,A01,083619,Allen; Michael Gordon,2,0,70,68
1656293044432,COGS 101A,A01,083621,Davis; Joshua Daniel,4,0,68,64
1656293050460,COGS 101B,A01,091572,Allen; Michael Gordon,4,0,65,61
1656293056482,COGS 101C,A01,083625,Delgado; Tania,11,0,35,24
1656293062507,COGS 107A,A01,083627,Boyle; Mary E. T.,0,0,60,60
1656293068530,COGS 118A,A01,083075,Gupta; Anjum,8,0,76,68
1656293074553,CSE 3,A50,083646,Miranda; Gregory Joseph,18,0,50,32
1656293080576,CSE 8A,A50,083650,Miranda; Gregory Joseph,2,3,56,54
1656293086598,CSE 11,A01,083080,Cao; Yingjun,0,48,40,40
1656293092626,CSE 12,A01,083652,Krause-Levy; Sophia Louisa,5,1,120,115
1656293098649,CSE 15L,A01,083654,Morris; Justin Loren,2,0,50,48
1656293098649,CSE 15L,A02,083655,Morris; Justin Loren,4,0,50,46
1656293104685,CSE 20,A01,083657,Tran; Khoa Dang,30,0,80,50
1656293110709,CSE 21,A01,095574,Bach; Quang Tran,23,0,48,25
1656293116737,CSE 30,A01,083084,Eldon; John,2,6,80,78
1656293116737,CSE 30,B01,095061,Bhaskar; Nishant,0,1,50,50
1656293122763,CSE 100,A01,083659,Cao; Yingjun,1,18,70,69
1656293128790,CSE 134B,A01,083661,Powell; Thomas Allan,6,0,100,94
1656293134825,CSE 140,A01,083663,Gungor; Onat,8,0,85,77
1656293140857,CSE 140L,A01,083088,Eldon; John,10,0,100,90
1656293146883,CSE 175,A01,083665,Kumar; Rakesh,0,0,25,25
1656293152907,CSE 190,A00,092507,Dubnov; Shlomo,3,0,20,17
1656293158934,ECE 45,A01,083139,Congero; Spencer William,1,0,75,74
1656293164958,ECE 65,A50,083695,Saad; Andrew S,9,0,30,21
1656293164958,ECE 65,A51,095125,Staff,24,0,26,2
1656293170985,ECE 109,A01,091882,Touri; Behrouz,1,1,70,69
1656293177010,ECE 180,A00,083140,Abi Samra; Nicholas Camill,2,0,30,28
1656293177010,ECE 180,B00,083141,Abi Samra; Nicholas Camill,0,4,30,30
1656293183034,MATH 10A,A01,083735,Patchell; Gregory David,0,0,30,30
1656293183034,MATH 10A,A02,083736,Patchell; Gregory David,22,0,30,8
1656293183034,MATH 10A,A03,083737,Patchell; Gregory David,16,0,30,14
1656293189065,MATH 10B,A01,083207,Lim; Seonhee,2,0,34,32
1656293189065,MATH 10B,A02,083208,Lim; Seonhee,6,0,35,29
1656293189065,MATH 10B,A03,093472,Staff,1,0,34,33
1656293189065,MATH 10B,B01,083739,Sinha; Shubham,11,0,30,19
1656293195089,MATH 18,A01,083743,Cinel; Cameron Alexander,7,0,30,23
1656293195089,MATH 18,A02,083744,Cinel; Cameron Alexander,9,0,30,21
1656293195089,MATH 18,A03,083745,Cinel; Cameron Alexander,5,0,30,25
1656293195089,MATH 18,B01,083748,Rideout; David Porter,1,0,36,35
1656293195089,MATH 18,B02,083749,Rideout; David Porter,0,0,36,36
1656293195089,MATH 18,B03,083750,Rideout; David Porter,0,0,36,36
1656293195089,MATH 18,B04,083751,Rideout; David Porter,0,1,36,36
1656293195089,MATH 18,B05,093473,Rideout; David Porter,0,0,36,36
1656293195089,MATH 18,B06,093474,Rideout; David Porter,3,0,36,33
1656293201116,MATH 20A,A01,083754,Zheng; Zequn,11,0,40,29
1656293207140,MATH 20B,A01,083756,Briones; Jor-el Thomas Caparas,0,0,36,36
1656293207140,MATH 20B,A02,083757,Briones; Jor-el Thomas Caparas,0,0,36,36
1656293207140,MATH 20B,A03,093475,Staff,1,0,36,35
1656293213164,MATH 20C,A01,083760,Briones; Jor-el Thomas Caparas,0,0,35,35
1656293213164,MATH 20C,A02,083761,Briones; Jor-el Thomas Caparas,9,1,35,26
1656293213164,MATH 20C,A03,093476,Staff,0,0,35,35
1656293213164,MATH 20C,B01,083762,Bach; Quang Tran,2,0,30,28
1656293219195,MATH 20D,A01,083765,Tran; Brian Kha,1,0,30,29
1656293219195,MATH 20D,A02,083766,Tran; Brian Kha,0,1,30,30
1656293219195,MATH 20D,A03,083767,Tran; Brian Kha,2,0,30,28
1656293225219,MATH 20E,A01,083771,Ganguly; Soumya,3,0,32,29
1656293225219,MATH 20E,A02,083772,Ganguly; Soumya,0,0,32,32
1656293225219,MATH 20E,B01,083773,Ciotti; Benjamin,17,0,35,18
1656293225219,MATH 20E,B02,083774,Ciotti; Benjamin,15,0,35,20
1656293231244,MATH 103A,A01,083777,Greenfeld; Be'Eri,1,0,36,35
1656293231244,MATH 103A,A02,083778,Greenfeld; Be'Eri,3,0,36,33
1656293231244,MATH 103A,A03,093561,Staff,4,0,36,32
1656293231244,MATH 103A,B01,083779,Greenfeld; Be'Eri,8,0,36,28
1656293231244,MATH 103A,B02,083780,Greenfeld; Be'Eri,0,0,36,36
1656293231244,MATH 103A,B03,093562,Staff,1,0,36,35
1656293237266,MATH 105,A01,085443,Carter; Anne Toulson,5,0,35,30
1656293237266,MATH 105,A02,093477,Staff,14,0,35,21
1656293243291,MATH 109,A01,083213,Ganzberger; Geoffrey Michael,1,0,34,33
1656293243291,MATH 109,A02,083214,Ganzberger; Geoffrey Michael,0,0,34,34
1656293243291,MATH 109,A03,093478,Staff,2,0,34,32
1656293243291,MATH 109,B01,083215,Ganzberger; Geoffrey Michael,4,0,32,28
1656293243291,MATH 109,B02,083216,Ganzberger; Geoffrey Michael,1,0,32,31
1656293243291,MATH 109,B03,093479,Staff,3,0,32,29
1656293249314,MATH 142A,A01,083219,Chow; Bennett,1,0,32,31
1656293249314,MATH 142A,A02,083220,Chow; Bennett,8,0,32,24
1656293249314,MATH 142A,A03,093480,Staff,5,0,32,27
1656293249314,MATH 142A,B03,093481,Staff,3,0,32,29
1656293249314,MATH 142A,B04,093558,Staff,6,0,32,26
1656293249314,MATH 142A,B05,093559,Staff,0,0,32,32
1656293255338,MATH 193A,A01,083224,Rotar; Vladimir,0,1,34,34
1656293255338,MATH 193A,A02,083225,Rotar; Vladimir,0,0,34,34
1656293255338,MATH 193A,A03,083781,Rotar; Vladimir,0,0,34,34
1656293255338,MATH 193A,A04,083782,Rotar; Vladimir,6,0,34,28
1656293255338,MATH 193A,A05,093482,Rotar; Vladimir,0,0,34,34
1656293261365,MATH 197,001,091859,McAuley; Julian John,9999,0,9999,0
1656293261365,MATH 197,002,095566,Kedlaya; Kiran S.,9997,0,9999,2
1656293261365,MATH 197,003,095567,Xiao; Ming,9999,0,9999,0
1656293261365,MATH 197,004,095571,Perols; Johan Lars,9998,0,9999,1
1656293268416,COGS 9,A01,083615,Shannon; Kyle Michael,4,0,75,71
1656293274443,COGS 11,A01,083617,Boyle; Mary E. T.,15,0,48,33
1656293280467,COGS 13,A01,083071,Bastos; Amalia Pinkusfeld,5,0,71,66
1656293286489,COGS 14A,A01,092681,Semenuks; Arturs,1,13,100,99
1656293292512,COGS 14B,A01,083073,Cheng; Tzu-Han,7,0,63,56
1656293298536,COGS 17,A01,092677,Semenuks; Arturs,7,0,81,74
1656293304559,COGS 100,A01,083619,Allen; Michael Gordon,2,0,70,68
1656293310583,COGS 101A,A01,083621,Davis; Joshua Daniel,4,0,68,64
1656293316606,COGS 101B,A01,091572,Allen; Michael Gordon,4,0,65,61
1656293322634,COGS 101C,A01,083625,Delgado; Tania,11,0,35,24
1656293328658,COGS 107A,A01,083627,Boyle; Mary E. T.,0,0,60,60
1656293334682,COGS 118A,A01,083075,Gupta; Anjum,8,0,76,68
1656293340706,CSE 3,A50,083646,Miranda; Gregory Joseph,18,0,50,32
1656293346730,CSE 8A,A50,083650,Miranda; Gregory Joseph,2,3,56,54
1656293352757,CSE 11,A01,083080,Cao; Yingjun,0,48,40,40
1656293358789,CSE 12,A01,083652,Krause-Levy; Sophia Louisa,5,1,120,115
1656293364817,CSE 15L,A01,083654,Morris; Justin Loren,2,0,50,48
1656293364817,CSE 15L,A02,083655,Morris; Justin Loren,4,0,50,46
1656293370841,CSE 20,A01,083657,Tran; Khoa Dang,30,0,80,50
1656293376866,CSE 21,A01,095574,Bach; Quang Tran,23,0,48,25
1656293382895,CSE 30,A01,083084,Eldon; John,2,6,80,78
1656293382895,CSE 30,B01,095061,Bhaskar; Nishant,0,1,50,50
1656293388922,CSE 100,A01,083659,Cao; Yingjun,1,18,70,69
1656293394945,CSE 134B,A01,083661,Powell; Thomas Allan,6,0,100,94
1656293400968,CSE 140,A01,083663,Gungor; Onat,8,0,85,77
1656293406992,CSE 140L,A01,083088,Eldon; John,10,0,100,90
1656293413016,CSE 175,A01,083665,Kumar; Rakesh,0,0,25,25
1656293419043,CSE 190,A00,092507,Dubnov; Shlomo,3,0,20,17
1656293425068,ECE 45,A01,083139,Congero; Spencer William,1,0,75,74
1656293431096,ECE 65,A50,083695,Saad; Andrew S,9,0,30,21
1656293431096,ECE 65,A51,095125,Staff,24,0,26,2
1656293437122,ECE 109,A01,091882,Touri; Behrouz,1,1,70,69
1656293443149,ECE 180,A00,083140,Abi Samra; Nicholas Camill,2,0,30,28
1656293443149,ECE 180,B00,083141,Abi Samra; Nicholas Camill,0,4,30,30
1656293449175,MATH 10A,A01,083735,Patchell; Gregory David,0,0,30,30
1656293449175,MATH 10A,A02,083736,Patchell; Gregory David,22,0,30,8
1656293449175,MATH 10A,A03,083737,Patchell; Gregory David,16,0,30,14
1656293455205,MATH 10B,A01,083207,Lim; Seonhee,2,0,34,32
1656293455205,MATH 10B,A02,083208,Lim; Seonhee,6,0,35,29
1656293455205,MATH 10B,A03,093472,Staff,1,0,34,33
1656293455205,MATH 10B,B01,083739,Sinha; Shubham,11,0,30,19
1656293461229,MATH 18,A01,083743,Cinel; Cameron Alexander,7,0,30,23
1656293461229,MATH 18,A02,083744,Cinel; Cameron Alexander,9,0,30,21
1656293461229,MATH 18,A03,083745,Cinel; Cameron Alexander,5,0,30,25
1656293461229,MATH 18,B01,083748,Rideout; David Porter,1,0,36,35
1656293461229,MATH 18,B02,083749,Rideout; David Porter,0,0,36,36
1656293461229,MATH 18,B03,083750,Rideout; David Porter,0,0,36,36
1656293461229,MATH 18,B04,083751,Rideout; David Porter,0,1,36,36
1656293461229,MATH 18,B05,093473,Rideout; David Porter,0,0,36,36
1656293461229,MATH 18,B06,093474,Rideout; David Porter,3,0,36,33
1656293467260,MATH 20A,A01,083754,Zheng; Zequn,11,0,40,29
1656293473296,MATH 20B,A01,083756,Briones; Jor-el Thomas Caparas,0,0,36,36
1656293473296,MATH 20B,A02,083757,Briones; Jor-el Thomas Caparas,0,0,36,36
1656293473296,MATH 20B,A03,093475,Staff,1,0,36,35
1656293479317,MATH 20C,A01,083760,Briones; Jor-el Thomas Caparas,0,0,35,35
1656293479317,MATH 20C,A02,083761,Briones; Jor-el Thomas Caparas,9,1,35,26
1656293479317,MATH 20C,A03,093476,Staff,0,0,35,35
1656293479317,MATH 20C,B01,083762,Bach; Quang Tran,2,0,30,28
1656293485341,MATH 20D,A01,083765,Tran; Brian Kha,1,0,30,29
1656293485341,MATH 20D,A02,083766,Tran; Brian Kha,0,1,30,30
1656293485341,MATH 20D,A03,083767,Tran; Brian Kha,2,0,30,28
1656293491369,MATH 20E,A01,083771,Ganguly; Soumya,3,0,32,29
1656293491369,MATH 20E,A02,083772,Ganguly; Soumya,0,0,32,32
1656293491369,MATH 20E,B01,083773,Ciotti; Benjamin,17,0,35,18
1656293491369,MATH 20E,B02,083774,Ciotti; Benjamin,15,0,35,20
1656293497392,MATH 103A,A01,083777,Greenfeld; Be'Eri,1,0,36,35
1656293497392,MATH 103A,A02,083778,Greenfeld; Be'Eri,3,0,36,33
1656293497392,MATH 103A,A03,093561,Staff,4,0,36,32
1656293497392,MATH 103A,B01,083779,Greenfeld; Be'Eri,8,0,36,28
1656293497392,MATH 103A,B02,083780,Greenfeld; Be'Eri,0,0,36,36
1656293497392,MATH 103A,B03,093562,Staff,1,0,36,35
1656293503413,MATH 105,A01,085443,Carter; Anne Toulson,5,0,35,30
1656293503413,MATH 105,A02,093477,Staff,14,0,35,21
1656293509437,MATH 109,A01,083213,Ganzberger; Geoffrey Michael,1,0,34,33
1656293509437,MATH 109,A02,083214,Ganzberger; Geoffrey Michael,0,0,34,34
1656293509437,MATH 109,A03,093478,Staff,2,0,34,32
1656293509437,MATH 109,B01,083215,Ganzberger; Geoffrey Michael,4,0,32,28
1656293509437,MATH 109,B02,083216,Ganzberger; Geoffrey Michael,1,0,32,31
1656293509437,MATH 109,B03,093479,Staff,3,0,32,29
1656293515462,MATH 142A,A01,083219,Chow; Bennett,1,0,32,31
1656293515462,MATH 142A,A02,083220,Chow; Bennett,8,0,32,24
1656293515462,MATH 142A,A03,093480,Staff,5,0,32,27
1656293515462,MATH 142A,B03,093481,Staff,3,0,32,29
1656293515462,MATH 142A,B04,093558,Staff,6,0,32,26
1656293515462,MATH 142A,B05,093559,Staff,0,0,32,32
1656293521559,MATH 193A,A01,083224,Rotar; Vladimir,0,1,34,34
1656293521559,MATH 193A,A02,083225,Rotar; Vladimir,0,0,34,34
1656293521559,MATH 193A,A03,083781,Rotar; Vladimir,0,0,34,34
1656293521559,MATH 193A,A04,083782,Rotar; Vladimir,6,0,34,28
1656293521559,MATH 193A,A05,093482,Rotar; Vladimir,0,0,34,34
1656293527582,MATH 197,001,091859,McAuley; Julian John,9999,0,9999,0
1656293527582,MATH 197,002,095566,Kedlaya; Kiran S.,9997,0,9999,2
1656293527582,MATH 197,003,095567,Xiao; Ming,9999,0,9999,0
1656293527582,MATH 197,004,095571,Perols; Johan Lars,9998,0,9999,1
1656293534637,COGS 9,A01,083615,Shannon; Kyle Michael,4,0,75,71
1656293540664,COGS 11,A01,083617,Boyle; Mary E. T.,15,0,48,33
1656293546687,COGS 13,A01,083071,Bastos; Amalia Pinkusfeld,5,0,71,66
1656293552711,COGS 14A,A01,092681,Semenuks; Arturs,1,13,100,99
1656293558734,COGS 14B,A01,083073,Cheng; Tzu-Han,7,0,63,56
1656293564758,COGS 17,A01,092677,Semenuks; Arturs,7,0,81,74
1656293570784,COGS 100,A01,083619,Allen; Michael Gordon,2,0,70,68
1656293576811,COGS 101A,A01,083621,Davis; Joshua Daniel,4,0,68,64
1656293582837,COGS 101B,A01,091572,Allen; Michael Gordon,4,0,65,61
1656293588861,COGS 101C,A01,083625,Delgado; Tania,11,0,35,24
1656293594890,COGS 107A,A01,083627,Boyle; Mary E. T.,0,0,60,60
1656293600914,COGS 118A,A01,083075,Gupta; Anjum,8,0,76,68
1656293606943,CSE 3,A50,083646,Miranda; Gregory Joseph,18,0,50,32
1656293612972,CSE 8A,A50,083650,Miranda; Gregory Joseph,2,3,56,54
1656293618995,CSE 11,A01,083080,Cao; Yingjun,0,48,40,40
1656293625019,CSE 12,A01,083652,Krause-Levy; Sophia Louisa,5,1,120,115
1656293631047,CSE 15L,A01,083654,Morris; Justin Loren,2,0,50,48
1656293631047,CSE 15L,A02,083655,Morris; Justin Loren,4,0,50,46
1656293637072,CSE 20,A01,083657,Tran; Khoa Dang,30,0,80,50
1656293643099,CSE 21,A01,095574,Bach; Quang Tran,23,0,48,25
1656293649123,CSE 30,A01,083084,Eldon; John,2,6,80,78
1656293649123,CSE 30,B01,095061,Bhaskar; Nishant,0,1,50,50
1656293655148,CSE 100,A01,083659,Cao; Yingjun,1,18,70,69
1656293661171,CSE 134B,A01,083661,Powell; Thomas Allan,6,0,100,94
1656293667199,CSE 140,A01,083663,Gungor; Onat,8,0,85,77
1656293673226,CSE 140L,A01,083088,Eldon; John,10,0,100,90
1656293679249,CSE 175,A01,083665,Kumar; Rakesh,0,0,25,25
1656293685272,CSE 190,A00,092507,Dubnov; Shlomo,3,0,20,17
1656293691300,ECE 45,A01,083139,Congero; Spencer William,1,0,75,74
1656293697324,ECE 65,A50,083695,Saad; Andrew S,9,0,30,21
1656293697324,ECE 65,A51,095125,Staff,24,0,26,2
1656293703352,ECE 109,A01,091882,Touri; Behrouz,1,1,70,69
1656293709380,ECE 180,A00,083140,Abi Samra; Nicholas Camill,2,0,30,28
1656293709380,ECE 180,B00,083141,Abi Samra; Nicholas Camill,0,4,30,30
1656293715405,MATH 10A,A01,083735,Patchell; Gregory David,0,0,30,30
1656293715405,MATH 10A,A02,083736,Patchell; Gregory David,22,0,30,8
1656293715405,MATH 10A,A03,083737,Patchell; Gregory David,16,0,30,14
1656293721430,MATH 10B,A01,083207,Lim; Seonhee,2,0,34,32
1656293721430,MATH 10B,A02,083208,Lim; Seonhee,6,0,35,29
1656293721430,MATH 10B,A03,093472,Staff,1,0,34,33
1656293721430,MATH 10B,B01,083739,Sinha; Shubham,11,0,30,19
1656293727452,MATH 18,A01,083743,Cinel; Cameron Alexander,7,0,30,23
1656293727452,MATH 18,A02,083744,Cinel; Cameron Alexander,9,0,30,21
1656293727452,MATH 18,A03,083745,Cinel; Cameron Alexander,5,0,30,25
1656293727452,MATH 18,B01,083748,Rideout; David Porter,1,0,36,35
1656293727452,MATH 18,B02,083749,Rideout; David Porter,0,0,36,36
1656293727452,MATH 18,B03,083750,Rideout; David Porter,0,0,36,36
1656293727452,MATH 18,B04,083751,Rideout; David Porter,0,1,36,36
1656293727452,MATH 18,B05,093473,Rideout; David Porter,0,0,36,36
1656293727452,MATH 18,B06,093474,Rideout; David Porter,3,0,36,33
1656293733479,MATH 20A,A01,083754,Zheng; Zequn,11,0,40,29
1656293739507,MATH 20B,A01,083756,Briones; Jor-el Thomas Caparas,0,0,36,36
1656293739507,MATH 20B,A02,083757,Briones; Jor-el Thomas Caparas,0,0,36,36
1656293739507,MATH 20B,A03,093475,Staff,1,0,36,35
1656293745531,MATH 20C,A01,083760,Briones; Jor-el Thomas Caparas,0,0,35,35
1656293745531,MATH 20C,A02,083761,Briones; Jor-el Thomas Caparas,9,1,35,26
1656293745531,MATH 20C,A03,093476,Staff,0,0,35,35
1656293745531,MATH 20C,B01,083762,Bach; Quang Tran,2,0,30,28
1656293751567,MATH 20D,A01,083765,Tran; Brian Kha,1,0,30,29
1656293751567,MATH 20D,A02,083766,Tran; Brian Kha,0,1,30,30
1656293751567,MATH 20D,A03,083767,Tran; Brian Kha,2,0,30,28
1656293757594,MATH 20E,A01,083771,Ganguly; Soumya,3,0,32,29
1656293757594,MATH 20E,A02,083772,Ganguly; Soumya,0,0,32,32
1656293757594,MATH 20E,B01,083773,Ciotti; Benjamin,17,0,35,18
1656293757594,MATH 20E,B02,083774,Ciotti; Benjamin,15,0,35,20
1656293763624,MATH 103A,A01,083777,Greenfeld; Be'Eri,1,0,36,35
1656293763624,MATH 103A,A02,083778,Greenfeld; Be'Eri,3,0,36,33
1656293763624,MATH 103A,A03,093561,Staff,4,0,36,32
1656293763624,MATH 103A,B01,083779,Greenfeld; Be'Eri,8,0,36,28
1656293763624,MATH 103A,B02,083780,Greenfeld; Be'Eri,0,0,36,36
1656293763624,MATH 103A,B03,093562,Staff,1,0,36,35
1656293769661,MATH 105,A01,085443,Carter; Anne Toulson,5,0,35,30
1656293769661,MATH 105,A02,093477,Staff,14,0,35,21
1656293775689,MATH 109,A01,083213,Ganzberger; Geoffrey Michael,1,0,34,33
1656293775689,MATH 109,A02,083214,Ganzberger; Geoffrey Michael,0,0,34,34
1656293775689,MATH 109,A03,093478,Staff,2,0,34,32
1656293775689,MATH 109,B01,083215,Ganzberger; Geoffrey Michael,4,0,32,28
1656293775689,MATH 109,B02,083216,Ganzberger; Geoffrey Michael,1,0,32,31
1656293775689,MATH 109,B03,093479,Staff,3,0,32,29
1656293781716,MATH 142A,A01,083219,Chow; Bennett,1,0,32,31
1656293781716,MATH 142A,A02,083220,Chow; Bennett,8,0,32,24
1656293781716,MATH 142A,A03,093480,Staff,5,0,32,27
1656293781716,MATH 142A,B03,093481,Staff,3,0,32,29
1656293781716,MATH 142A,B04,093558,Staff,6,0,32,26
1656293781716,MATH 142A,B05,093559,Staff,0,0,32,32
1656293787740,MATH 193A,A01,083224,Rotar; Vladimir,0,1,34,34
1656293787740,MATH 193A,A02,083225,Rotar; Vladimir,0,0,34,34
1656293787740,MATH 193A,A03,083781,Rotar; Vladimir,0,0,34,34
1656293787740,MATH 193A,A04,083782,Rotar; Vladimir,6,0,34,28
1656293787740,MATH 193A,A05,093482,Rotar; Vladimir,0,0,34,34
1656293793763,MATH 197,001,091859,McAuley; Julian John,9999,0,9999,0
1656293793763,MATH 197,002,095566,Kedlaya; Kiran S.,9997,0,9999,2
1656293793763,MATH 197,003,095567,Xiao; Ming,9999,0,9999,0
1656293793763,MATH 197,004,095571,Perols; Johan Lars,9998,0,9999,1
1656293800815,COGS 9,A01,083615,Shannon; Kyle Michael,4,0,75,71
1656293806843,COGS 11,A01,083617,Boyle; Mary E. T.,15,0,48,33
1656293812870,COGS 13,A01,083071,Bastos; Amalia Pinkusfeld,5,0,71,66
1656293818893,COGS 14A,A01,092681,Semenuks; Arturs,1,13,100,99
1656293825023,COGS 14B,A01,083073,Cheng; Tzu-Han,7,0,63,56
1656293831060,COGS 17,A01,092677,Semenuks; Arturs,6,0,81,75
1656293837086,COGS 100,A01,083619,Allen; Michael Gordon,2,0,70,68
1656293843112,COGS 101A,A01,083621,Davis; Joshua Daniel,4,0,68,64
1656293849135,COGS 101B,A01,091572,Allen; Michael Gordon,4,0,65,61
1656293855158,COGS 101C,A01,083625,Delgado; Tania,11,0,35,24
1656293861183,COGS 107A,A01,083627,Boyle; Mary E. T.,0,0,60,60
1656293867206,COGS 118A,A01,083075,Gupta; Anjum,8,0,76,68
1656293873230,CSE 3,A50,083646,Miranda; Gregory Joseph,18,0,50,32
1656293879257,CSE 8A,A50,083650,Miranda; Gregory Joseph,2,3,56,54
1656293885285,CSE 11,A01,083080,Cao; Yingjun,0,48,40,40
1656293891312,CSE 12,A01,083652,Krause-Levy; Sophia Louisa,5,1,120,115
1656293897335,CSE 15L,A01,083654,Morris; Justin Loren,2,0,50,48
1656293897335,CSE 15L,A02,083655,Morris; Justin Loren,4,0,50,46
1656293903362,CSE 20,A01,083657,Tran; Khoa Dang,30,0,80,50
1656293909388,CSE 21,A01,095574,Bach; Quang Tran,23,0,48,25
1656293915416,CSE 30,A01,083084,Eldon; John,2,6,80,78
1656293915416,CSE 30,B01,095061,Bhaskar; Nishant,0,1,50,50
1656293921443,CSE 100,A01,083659,Cao; Yingjun,1,18,70,69
1656293927466,CSE 134B,A01,083661,Powell; Thomas Allan,6,0,100,94
1656293933489,CSE 140,A01,083663,Gungor; Onat,8,0,85,77
1656293939516,CSE 140L,A01,083088,Eldon; John,10,0,100,90
1656293945545,CSE 175,A01,083665,Kumar; Rakesh,0,0,25,25
1656293951567,CSE 190,A00,092507,Dubnov; Shlomo,3,0,20,17
1656293957590,ECE 45,A01,083139,Congero; Spencer William,1,0,75,74
1656293963618,ECE 65,A50,083695,Saad; Andrew S,9,0,30,21
1656293963618,ECE 65,A51,095125,Staff,24,0,26,2
1656293969640,ECE 109,A01,091882,Touri; Behrouz,1,1,70,69
1656293975665,ECE 180,A00,083140,Abi Samra; Nicholas Camill,2,0,30,28
1656293975665,ECE 180,B00,083141,Abi Samra; Nicholas Camill,0,4,30,30
1656293981692,MATH 10A,A01,083735,Patchell; Gregory David,0,0,30,30
1656293981692,MATH 10A,A02,083736,Patchell; Gregory David,22,0,30,8
1656293981692,MATH 10A,A03,083737,Patchell; Gregory David,16,0,30,14
1656293987721,MATH 10B,A01,083207,Lim; Seonhee,2,0,34,32
1656293987721,MATH 10B,A02,083208,Lim; Seonhee,6,0,35,29
1656293987721,MATH 10B,A03,093472,Staff,1,0,34,33
1656293987721,MATH 10B,B01,083739,Sinha; Shubham,11,0,30,19
1656293993744,MATH 18,A01,083743,Cinel; Cameron Alexander,7,0,30,23
1656293993744,MATH 18,A02,083744,Cinel; Cameron Alexander,9,0,30,21
1656293993744,MATH 18,A03,083745,Cinel; Cameron Alexander,5,0,30,25
1656293993744,MATH 18,B01,083748,Rideout; David Porter,1,0,36,35
1656293993744,MATH 18,B02,083749,Rideout; David Porter,0,0,36,36
1656293993744,MATH 18,B03,083750,Rideout; David Porter,0,0,36,36
1656293993744,MATH 18,B04,083751,Rideout; David Porter,0,1,36,36
1656293993744,MATH 18,B05,093473,Rideout; David Porter,0,0,36,36
1656293993744,MATH 18,B06,093474,Rideout; David Porter,3,0,36,33
1656293999769,MATH 20A,A01,083754,Zheng; Zequn,11,0,40,29
1656294005792,MATH 20B,A01,083756,Briones; Jor-el Thomas Caparas,0,0,36,36
1656294005792,MATH 20B,A02,083757,Briones; Jor-el Thomas Caparas,0,0,36,36
1656294005792,MATH 20B,A03,093475,Staff,1,0,36,35
1656294011815,MATH 20C,A01,083760,Briones; Jor-el Thomas Caparas,0,0,35,35
1656294011815,MATH 20C,A02,083761,Briones; Jor-el Thomas Caparas,9,1,35,26
1656294011815,MATH 20C,A03,093476,Staff,0,0,35,35
1656294011815,MATH 20C,B01,083762,Bach; Quang Tran,2,0,30,28
1656294017840,MATH 20D,A01,083765,Tran; Brian Kha,1,0,30,29
1656294017840,MATH 20D,A02,083766,Tran; Brian Kha,0,1,30,30
1656294017840,MATH 20D,A03,083767,Tran; Brian Kha,2,0,30,28
1656294023868,MATH 20E,A01,083771,Ganguly; Soumya,3,0,32,29
1656294023868,MATH 20E,A02,083772,Ganguly; Soumya,0,0,32,32
1656294023868,MATH 20E,B01,083773,Ciotti; Benjamin,17,0,35,18
1656294023868,MATH 20E,B02,083774,Ciotti; Benjamin,15,0,35,20
1656294029899,MATH 103A,A01,083777,Greenfeld; Be'Eri,1,0,36,35
1656294029899,MATH 103A,A02,083778,Greenfeld; Be'Eri,3,0,36,33
1656294029899,MATH 103A,A03,093561,Staff,4,0,36,32
1656294029899,MATH 103A,B01,083779,Greenfeld; Be'Eri,8,0,36,28
1656294029899,MATH 103A,B02,083780,Greenfeld; Be'Eri,0,0,36,36
1656294029899,MATH 103A,B03,093562,Staff,1,0,36,35
1656294035926,MATH 105,A01,085443,Carter; Anne Toulson,5,0,35,30
1656294035926,MATH 105,A02,093477,Staff,14,0,35,21
1656294041950,MATH 109,A01,083213,Ganzberger; Geoffrey Michael,1,0,34,33
1656294041950,MATH 109,A02,083214,Ganzberger; Geoffrey Michael,0,0,34,34
1656294041950,MATH 109,A03,093478,Staff,2,0,34,32
1656294041950,MATH 109,B01,083215,Ganzberger; Geoffrey Michael,4,0,32,28
1656294041950,MATH 109,B02,083216,Ganzberger; Geoffrey Michael,1,0,32,31
1656294041950,MATH 109,B03,093479,Staff,3,0,32,29
1656294047978,MATH 142A,A01,083219,Chow; Bennett,1,0,32,31
1656294047978,MATH 142A,A02,083220,Chow; Bennett,8,0,32,24
1656294047978,MATH 142A,A03,093480,Staff,5,0,32,27
1656294047978,MATH 142A,B03,093481,Staff,3,0,32,29
1656294047978,MATH 142A,B04,093558,Staff,6,0,32,26
1656294047978,MATH 142A,B05,093559,Staff,0,0,32,32
1656294054015,MATH 193A,A01,083224,Rotar; Vladimir,0,1,34,34
1656294054015,MATH 193A,A02,083225,Rotar; Vladimir,0,0,34,34
1656294054015,MATH 193A,A03,083781,Rotar; Vladimir,0,0,34,34
1656294054015,MATH 193A,A04,083782,Rotar; Vladimir,6,0,34,28
1656294054015,MATH 193A,A05,093482,Rotar; Vladimir,0,0,34,34
1656294060040,MATH 197,001,091859,McAuley; Julian John,9999,0,9999,0
1656294060040,MATH 197,002,095566,Kedlaya; Kiran S.,9997,0,9999,2
1656294060040,MATH 197,003,095567,Xiao; Ming,9999,0,9999,0
1656294060040,MATH 197,004,095571,Perols; Johan Lars,9998,0,9999,1
1656294067091,COGS 9,A01,083615,Shannon; Kyle Michael,3,0,75,72
1656294073115,COGS 11,A01,083617,Boyle; Mary E. T.,15,0,48,33
1656294079138,COGS 13,A01,083071,Bastos; Amalia Pinkusfeld,5,0,71,66
1656294085160,COGS 14A,A01,092681,Semenuks; Arturs,1,13,100,99
1656294091191,COGS 14B,A01,083073,Cheng; Tzu-Han,7,0,63,56
1656294097214,COGS 17,A01,092677,Semenuks; Arturs,6,0,81,75
1656294103240,COGS 100,A01,083619,Allen; Michael Gordon,2,0,70,68
1656294109268,COGS 101A,A01,083621,Davis; Joshua Daniel,4,0,68,64
1656294115367,COGS 101B,A01,091572,Allen; Michael Gordon,4,0,65,61
1656294121391,COGS 101C,A01,083625,Delgado; Tania,11,0,35,24
1656294127418,COGS 107A,A01,083627,Boyle; Mary E. T.,0,0,60,60
1656294133440,COGS 118A,A01,083075,Gupta; Anjum,8,0,76,68
1656294139467,CSE 3,A50,083646,Miranda; Gregory Joseph,18,0,50,32
1656294145490,CSE 8A,A50,083650,Miranda; Gregory Joseph,3,3,56,53
1656294151517,CSE 11,A01,083080,Cao; Yingjun,0,48,40,40
1656294157540,CSE 12,A01,083652,Krause-Levy; Sophia Louisa,5,1,120,115
1656294163562,CSE 15L,A01,083654,Morris; Justin Loren,2,0,50,48
1656294163562,CSE 15L,A02,083655,Morris; Justin Loren,4,0,50,46
1656294169593,CSE 20,A01,083657,Tran; Khoa Dang,30,0,80,50
1656294175619,CSE 21,A01,095574,Bach; Quang Tran,23,0,48,25
1656294181647,CSE 30,A01,083084,Eldon; John,2,6,80,78
1656294181647,CSE 30,B01,095061,Bhaskar; Nishant,0,1,50,50
1656294187670,CSE 100,A01,083659,Cao; Yingjun,1,18,70,69
1656294193695,CSE 134B,A01,083661,Powell; Thomas Allan,6,0,100,94
1656294199722,CSE 140,A01,083663,Gungor; Onat,9,0,85,76
1656294205748,CSE 140L,A01,083088,Eldon; John,10,0,100,90
1656294211784,CSE 175,A01,083665,Kumar; Rakesh,0,0,25,25
1656294217811,CSE 190,A00,092507,Dubnov; Shlomo,3,0,20,17
1656294223835,ECE 45,A01,083139,Congero; Spencer William,1,0,75,74
1656294229863,ECE 65,A50,083695,Saad; Andrew S,9,0,30,21
1656294229863,ECE 65,A51,095125,Staff,24,0,26,2
1656294235893,ECE 109,A01,091882,Touri; Behrouz,1,1,70,69
1656294241918,ECE 180,A00,083140,Abi Samra; Nicholas Camill,2,0,30,28
1656294241918,ECE 180,B00,083141,Abi Samra; Nicholas Camill,0,4,30,30
1656294247943,MATH 10A,A01,083735,Patchell; Gregory David,0,0,30,30
1656294247943,MATH 10A,A02,083736,Patchell; Gregory David,22,0,30,8
1656294247943,MATH 10A,A03,083737,Patchell; Gregory David,16,0,30,14
1656294253973,MATH 10B,A01,083207,Lim; Seonhee,2,0,34,32
1656294253973,MATH 10B,A02,083208,Lim; Seonhee,6,0,35,29
1656294253973,MATH 10B,A03,093472,Staff,1,0,34,33
1656294253973,MATH 10B,B01,083739,Sinha; Shubham,11,0,30,19
1656294259998,MATH 18,A01,083743,Cinel; Cameron Alexander,7,0,30,23
1656294259998,MATH 18,A02,083744,Cinel; Cameron Alexander,9,0,30,21
1656294259998,MATH 18,A03,083745,Cinel; Cameron Alexander,5,0,30,25
1656294259998,MATH 18,B01,083748,Rideout; David Porter,1,0,36,35
1656294259998,MATH 18,B02,083749,Rideout; David Porter,0,0,36,36
1656294259998,MATH 18,B03,083750,Rideout; David Porter,0,0,36,36
1656294259998,MATH 18,B04,083751,Rideout; David Porter,0,1,36,36
1656294259998,MATH 18,B05,093473,Rideout; David Porter,0,0,36,36
1656294259998,MATH 18,B06,093474,Rideout; David Porter,3,0,36,33
1656294266022,MATH 20A,A01,083754,Zheng; Zequn,11,0,40,29
1656294272049,MATH 20B,A01,083756,Briones; Jor-el Thomas Caparas,0,0,36,36
1656294272049,MATH 20B,A02,083757,Briones; Jor-el Thomas Caparas,0,0,36,36
1656294272049,MATH 20B,A03,093475,Staff,1,0,36,35
1656294278073,MATH 20C,A01,083760,Briones; Jor-el Thomas Caparas,0,0,35,35
1656294278073,MATH 20C,A02,083761,Briones; Jor-el Thomas Caparas,9,1,35,26
1656294278073,MATH 20C,A03,093476,Staff,0,0,35,35
1656294278073,MATH 20C,B01,083762,Bach; Quang Tran,2,0,30,28
1656294284096,MATH 20D,A01,083765,Tran; Brian Kha,1,0,30,29
1656294284096,MATH 20D,A02,083766,Tran; Brian Kha,0,1,30,30
1656294284096,MATH 20D,A03,083767,Tran; Brian Kha,2,0,30,28
1656294290125,MATH 20E,A01,083771,Ganguly; Soumya,3,0,32,29
1656294290125,MATH 20E,A02,083772,Ganguly; Soumya,0,0,32,32
1656294290125,MATH 20E,B01,083773,Ciotti; Benjamin,17,0,35,18
1656294290125,MATH 20E,B02,083774,Ciotti; Benjamin,15,0,35,20
1656294296154,MATH 103A,A01,083777,Greenfeld; Be'Eri,1,0,36,35
1656294296154,MATH 103A,A02,083778,Greenfeld; Be'Eri,3,0,36,33
1656294296154,MATH 103A,A03,093561,Staff,4,0,36,32
1656294296154,MATH 103A,B01,083779,Greenfeld; Be'Eri,8,0,36,28
1656294296154,MATH 103A,B02,083780,Greenfeld; Be'Eri,0,0,36,36
1656294296154,MATH 103A,B03,093562,Staff,1,0,36,35
1656294302182,MATH 105,A01,085443,Carter; Anne Toulson,5,0,35,30
1656294302182,MATH 105,A02,093477,Staff,14,0,35,21
1656294308219,MATH 109,A01,083213,Ganzberger; Geoffrey Michael,1,0,34,33
1656294308219,MATH 109,A02,083214,Ganzberger; Geoffrey Michael,0,0,34,34
1656294308219,MATH 109,A03,093478,Staff,2,0,34,32
1656294308219,MATH 109,B01,083215,Ganzberger; Geoffrey Michael,4,0,32,28
1656294308219,MATH 109,B02,083216,Ganzberger; Geoffrey Michael,1,0,32,31
1656294308219,MATH 109,B03,093479,Staff,3,0,32,29
1656294314247,MATH 142A,A01,083219,Chow; Bennett,1,0,32,31
1656294314247,MATH 142A,A02,083220,Chow; Bennett,8,0,32,24
1656294314247,MATH 142A,A03,093480,Staff,5,0,32,27
1656294314247,MATH 142A,B03,093481,Staff,3,0,32,29
1656294314247,MATH 142A,B04,093558,Staff,6,0,32,26
1656294314247,MATH 142A,B05,093559,Staff,0,0,32,32
1656294320276,MATH 193A,A01,083224,Rotar; Vladimir,0,1,34,34
1656294320276,MATH 193A,A02,083225,Rotar; Vladimir,0,0,34,34
1656294320276,MATH 193A,A03,083781,Rotar; Vladimir,0,0,34,34
1656294320276,MATH 193A,A04,083782,Rotar; Vladimir,6,0,34,28
1656294320276,MATH 193A,A05,093482,Rotar; Vladimir,0,0,34,34
1656294326303,MATH 197,001,091859,McAuley; Julian John,9999,0,9999,0
1656294326303,MATH 197,002,095566,Kedlaya; Kiran S.,9997,0,9999,2
1656294326303,MATH 197,003,095567,Xiao; Ming,9999,0,9999,0
1656294326303,MATH 197,004,095571,Perols; Johan Lars,9998,0,9999,1
1656294333356,COGS 9,A01,083615,Shannon; Kyle Michael,3,0,75,72
1656294339382,COGS 11,A01,083617,Boyle; Mary E. T.,15,0,48,33
1656294345407,COGS 13,A01,083071,Bastos; Amalia Pinkusfeld,5,0,71,66
1656294351437,COGS 14A,A01,092681,Semenuks; Arturs,1,13,100,99
1656294357461,COGS 14B,A01,083073,Cheng; Tzu-Han,7,0,63,56
1656294363485,COGS 17,A01,092677,Semenuks; Arturs,6,0,81,75
1656294369512,COGS 100,A01,083619,Allen; Michael Gordon,2,0,70,68
1656294375540,COGS 101A,A01,083621,Davis; Joshua Daniel,4,0,68,64
1656294381574,COGS 101B,A01,091572,Allen; Michael Gordon,4,0,65,61
1656294387597,COGS 101C,A01,083625,Delgado; Tania,11,0,35,24
1656294393619,COGS 107A,A01,083627,Boyle; Mary E. T.,0,0,60,60
1656294399643,COGS 118A,A01,083075,Gupta; Anjum,8,0,76,68
1656294405668,CSE 3,A50,083646,Miranda; Gregory Joseph,18,0,50,32
1656294411692,CSE 8A,A50,083650,Miranda; Gregory Joseph,3,3,56,53
1656294417721,CSE 11,A01,083080,Cao; Yingjun,0,48,40,40
1656294423749,CSE 12,A01,083652,Krause-Levy; Sophia Louisa,5,1,120,115
1656294429773,CSE 15L,A01,083654,Morris; Justin Loren,2,0,50,48
1656294429773,CSE 15L,A02,083655,Morris; Justin Loren,4,0,50,46
1656294435796,CSE 20,A01,083657,Tran; Khoa Dang,30,0,80,50
1656294441819,CSE 21,A01,095574,Bach; Quang Tran,23,0,48,25
1656294447847,CSE 30,A01,083084,Eldon; John,2,6,80,78
1656294447847,CSE 30,B01,095061,Bhaskar; Nishant,0,1,50,50
1656294453870,CSE 100,A01,083659,Cao; Yingjun,1,18,70,69
1656294459894,CSE 134B,A01,083661,Powell; Thomas Allan,6,0,100,94
1656294465918,CSE 140,A01,083663,Gungor; Onat,9,0,85,76
1656294471946,CSE 140L,A01,083088,Eldon; John,10,0,100,90
1656294477972,CSE 175,A01,083665,Kumar; Rakesh,0,0,25,25
1656294483996,CSE 190,A00,092507,Dubnov; Shlomo,3,0,20,17
1656294490020,ECE 45,A01,083139,Congero; Spencer William,1,0,75,74
1656294496044,ECE 65,A50,083695,Saad; Andrew S,9,0,30,21
1656294496044,ECE 65,A51,095125,Staff,24,0,26,2
1656294502067,ECE 109,A01,091882,Touri; Behrouz,1,1,70,69
1656294508105,ECE 180,A00,083140,Abi Samra; Nicholas Camill,2,0,30,28
1656294508105,ECE 180,B00,083141,Abi Samra; Nicholas Camill,0,4,30,30
1656294514132,MATH 10A,A01,083735,Patchell; Gregory David,0,0,30,30
1656294514132,MATH 10A,A02,083736,Patchell; Gregory David,22,0,30,8
1656294514132,MATH 10A,A03,083737,Patchell; Gregory David,16,0,30,14
1656294520158,MATH 10B,A01,083207,Lim; Seonhee,2,0,34,32
1656294520158,MATH 10B,A02,083208,Lim; Seonhee,6,0,35,29
1656294520158,MATH 10B,A03,093472,Staff,1,0,34,33
1656294520158,MATH 10B,B01,083739,Sinha; Shubham,11,0,30,19
1656294526182,MATH 18,A01,083743,Cinel; Cameron Alexander,7,0,30,23
1656294526182,MATH 18,A02,083744,Cinel; Cameron Alexander,9,0,30,21
1656294526182,MATH 18,A03,083745,Cinel; Cameron Alexander,5,0,30,25
1656294526182,MATH 18,B01,083748,Rideout; David Porter,1,0,36,35
1656294526182,MATH 18,B02,083749,Rideout; David Porter,0,0,36,36
1656294526182,MATH 18,B03,083750,Rideout; David Porter,0,0,36,36
1656294526182,MATH 18,B04,083751,Rideout; David Porter,0,1,36,36
1656294526182,MATH 18,B05,093473,Rideout; David Porter,0,0,36,36
1656294526182,MATH 18,B06,093474,Rideout; David Porter,3,0,36,33
1656294532206,MATH 20A,A01,083754,Zheng; Zequn,11,0,40,29
1656294538228,MATH 20B,A01,083756,Briones; Jor-el Thomas Caparas,0,0,36,36
1656294538228,MATH 20B,A02,083757,Briones; Jor-el Thomas Caparas,0,0,36,36
1656294538228,MATH 20B,A03,093475,Staff,1,0,36,35
1656294544257,MATH 20C,A01,083760,Briones; Jor-el Thomas Caparas,0,0,35,35
1656294544257,MATH 20C,A02,083761,Briones; Jor-el Thomas Caparas,9,1,35,26
1656294544257,MATH 20C,A03,093476,Staff,0,0,35,35
1656294544257,MATH 20C,B01,083762,Bach; Quang Tran,2,0,30,28
1656294550288,MATH 20D,A01,083765,Tran; Brian Kha,1,0,30,29
1656294550288,MATH 20D,A02,083766,Tran; Brian Kha,1,1,30,29
1656294550288,MATH 20D,A03,083767,Tran; Brian Kha,2,0,30,28
1656294556317,MATH 20E,A01,083771,Ganguly; Soumya,3,0,32,29
1656294556317,MATH 20E,A02,083772,Ganguly; Soumya,0,0,32,32
1656294556317,MATH 20E,B01,083773,Ciotti; Benjamin,17,0,35,18
1656294556317,MATH 20E,B02,083774,Ciotti; Benjamin,15,0,35,20
1656294562345,MATH 103A,A01,083777,Greenfeld; Be'Eri,1,0,36,35
1656294562345,MATH 103A,A02,083778,Greenfeld; Be'Eri,3,0,36,33
1656294562345,MATH 103A,A03,093561,Staff,4,0,36,32
1656294562345,MATH 103A,B01,083779,Greenfeld; Be'Eri,8,0,36,28
1656294562345,MATH 103A,B02,083780,Greenfeld; Be'Eri,0,0,36,36
1656294562345,MATH 103A,B03,093562,Staff,1,0,36,35
1656294568367,MATH 105,A01,085443,Carter; Anne Toulson,5,0,35,30
1656294568367,MATH 105,A02,093477,Staff,14,0,35,21
1656294574390,MATH 109,A01,083213,Ganzberger; Geoffrey Michael,1,0,34,33
1656294574390,MATH 109,A02,083214,Ganzberger; Geoffrey Michael,0,0,34,34
1656294574390,MATH 109,A03,093478,Staff,2,0,34,32
1656294574390,MATH 109,B01,083215,Ganzberger; Geoffrey Michael,4,0,32,28
1656294574390,MATH 109,B02,083216,Ganzberger; Geoffrey Michael,1,0,32,31
1656294574390,MATH 109,B03,093479,Staff,3,0,32,29
1656294580414,MATH 142A,A01,083219,Chow; Bennett,1,0,32,31
1656294580414,MATH 142A,A02,083220,Chow; Bennett,8,0,32,24
1656294580414,MATH 142A,A03,093480,Staff,5,0,32,27
1656294580414,MATH 142A,B03,093481,Staff,3,0,32,29
1656294580414,MATH 142A,B04,093558,Staff,6,0,32,26
1656294580414,MATH 142A,B05,093559,Staff,0,0,32,32
1656294586440,MATH 193A,A01,083224,Rotar; Vladimir,0,1,34,34
1656294586440,MATH 193A,A02,083225,Rotar; Vladimir,0,0,34,34
1656294586440,MATH 193A,A03,083781,Rotar; Vladimir,0,0,34,34
1656294586440,MATH 193A,A04,083782,Rotar; Vladimir,6,0,34,28
1656294586440,MATH 193A,A05,093482,Rotar; Vladimir,0,0,34,34
1656294592463,MATH 197,001,091859,McAuley; Julian John,9999,0,9999,0
1656294592463,MATH 197,002,095566,Kedlaya; Kiran S.,9997,0,9999,2
1656294592463,MATH 197,003,095567,Xiao; Ming,9999,0,9999,0
1656294592463,MATH 197,004,095571,Perols; Johan Lars,9998,0,9999,1
1656294599515,COGS 9,A01,083615,Shannon; Kyle Michael,3,0,75,72
1656294605542,COGS 11,A01,083617,Boyle; Mary E. T.,15,0,48,33
1656294611568,COGS 13,A01,083071,Bastos; Amalia Pinkusfeld,5,0,71,66
1656294617593,COGS 14A,A01,092681,Semenuks; Arturs,1,13,100,99
1656294623619,COGS 14B,A01,083073,Cheng; Tzu-Han,7,0,63,56
1656294629647,COGS 17,A01,092677,Semenuks; Arturs,6,0,81,75
1656294635688,COGS 100,A01,083619,Allen; Michael Gordon,2,0,70,68
1656294641714,COGS 101A,A01,083621,Davis; Joshua Daniel,4,0,68,64
1656294647741,COGS 101B,A01,091572,Allen; Michael Gordon,4,0,65,61
1656294653779,COGS 101C,A01,083625,Delgado; Tania,11,0,35,24
1656294659810,COGS 107A,A01,083627,Boyle; Mary E. T.,0,0,60,60
1656294665835,COGS 118A,A01,083075,Gupta; Anjum,8,0,76,68
1656294671860,CSE 3,A50,083646,Miranda; Gregory Joseph,18,0,50,32
1656294677884,CSE 8A,A50,083650,Miranda; Gregory Joseph,3,3,56,53
1656294683909,CSE 11,A01,083080,Cao; Yingjun,0,48,40,40
1656294689933,CSE 12,A01,083652,Krause-Levy; Sophia Louisa,5,1,120,115
1656294695958,CSE 15L,A01,083654,Morris; Justin Loren,2,0,50,48
1656294695958,CSE 15L,A02,083655,Morris; Justin Loren,4,0,50,46
1656294701982,CSE 20,A01,083657,Tran; Khoa Dang,30,0,80,50
1656294708016,CSE 21,A01,095574,Bach; Quang Tran,23,0,48,25
1656294714132,CSE 30,A01,083084,Eldon; John,2,6,80,78
1656294714132,CSE 30,B01,095061,Bhaskar; Nishant,0,1,50,50
1656294720155,CSE 100,A01,083659,Cao; Yingjun,1,18,70,69
1656294726184,CSE 134B,A01,083661,Powell; Thomas Allan,6,0,100,94
1656294732207,CSE 140,A01,083663,Gungor; Onat,9,0,85,76
1656294738232,CSE 140L,A01,083088,Eldon; John,10,0,100,90
1656294744255,CSE 175,A01,083665,Kumar; Rakesh,0,0,25,25
1656294750282,CSE 190,A00,092507,Dubnov; Shlomo,3,0,20,17
1656294756309,ECE 45,A01,083139,Congero; Spencer William,1,0,75,74
1656294762336,ECE 65,A50,083695,Saad; Andrew S,9,0,30,21
1656294762336,ECE 65,A51,095125,Staff,24,0,26,2
1656294768362,ECE 109,A01,091882,Touri; Behrouz,1,1,70,69
1656294774385,ECE 180,A00,083140,Abi Samra; Nicholas Camill,2,0,30,28
1656294774385,ECE 180,B00,083141,Abi Samra; Nicholas Camill,0,4,30,30
1656294780408,MATH 10A,A01,083735,Patchell; Gregory David,0,0,30,30
1656294780408,MATH 10A,A02,083736,Patchell; Gregory David,22,0,30,8
1656294780408,MATH 10A,A03,083737,Patchell; Gregory David,16,0,30,14
1656294786442,MATH 10B,A01,083207,Lim; Seonhee,2,0,34,32
1656294786442,MATH 10B,A02,083208,Lim; Seonhee,6,0,35,29
1656294786442,MATH 10B,A03,093472,Staff,1,0,34,33
1656294786442,MATH 10B,B01,083739,Sinha; Shubham,11,0,30,19
1656294792473,MATH 18,A01,083743,Cinel; Cameron Alexander,7,0,30,23
1656294792473,MATH 18,A02,083744,Cinel; Cameron Alexander,9,0,30,21
1656294792473,MATH 18,A03,083745,Cinel; Cameron Alexander,5,0,30,25
1656294792473,MATH 18,B01,083748,Rideout; David Porter,1,0,36,35
1656294792473,MATH 18,B02,083749,Rideout; David Porter,0,0,36,36
1656294792473,MATH 18,B03,083750,Rideout; David Porter,0,0,36,36
1656294792473,MATH 18,B04,083751,Rideout; David Porter,0,1,36,36
1656294792473,MATH 18,B05,093473,Rideout; David Porter,0,0,36,36
1656294792473,MATH 18,B06,093474,Rideout; David Porter,3,0,36,33
1656294798498,MATH 20A,A01,083754,Zheng; Zequn,11,0,40,29
1656294804522,MATH 20B,A01,083756,Briones; Jor-el Thomas Caparas,0,0,36,36
1656294804522,MATH 20B,A02,083757,Briones; Jor-el Thomas Caparas,0,0,36,36
1656294804522,MATH 20B,A03,093475,Staff,1,0,36,35
1656294810545,MATH 20C,A01,083760,Briones; Jor-el Thomas Caparas,0,0,35,35
1656294810545,MATH 20C,A02,083761,Briones; Jor-el Thomas Caparas,9,1,35,26
1656294810545,MATH 20C,A03,093476,Staff,0,0,35,35
1656294810545,MATH 20C,B01,083762,Bach; Quang Tran,2,0,30,28
1656294816574,MATH 20D,A01,083765,Tran; Brian Kha,1,0,30,29
1656294816574,MATH 20D,A02,083766,Tran; Brian Kha,1,1,30,29
1656294816574,MATH 20D,A03,083767,Tran; Brian Kha,2,0,30,28
1656294822599,MATH 20E,A01,083771,Ganguly; Soumya,3,0,32,29
1656294822599,MATH 20E,A02,083772,Ganguly; Soumya,0,0,32,32
1656294822599,MATH 20E,B01,083773,Ciotti; Benjamin,17,0,35,18
1656294822599,MATH 20E,B02,083774,Ciotti; Benjamin,15,0,35,20
1656294828627,MATH 103A,A01,083777,Greenfeld; Be'Eri,1,0,36,35
1656294828627,MATH 103A,A02,083778,Greenfeld; Be'Eri,3,0,36,33
1656294828627,MATH 103A,A03,093561,Staff,4,0,36,32
1656294828627,MATH 103A,B01,083779,Greenfeld; Be'Eri,8,0,36,28
1656294828627,MATH 103A,B02,083780,Greenfeld; Be'Eri,0,0,36,36
1656294828627,MATH 103A,B03,093562,Staff,1,0,36,35
1656294834651,MATH 105,A01,085443,Carter; Anne Toulson,5,0,35,30
1656294834651,MATH 105,A02,093477,Staff,14,0,35,21
1656294840680,MATH 109,A01,083213,Ganzberger; Geoffrey Michael,1,0,34,33
1656294840680,MATH 109,A02,083214,Ganzberger; Geoffrey Michael,0,0,34,34
1656294840680,MATH 109,A03,093478,Staff,2,0,34,32
1656294840680,MATH 109,B01,083215,Ganzberger; Geoffrey Michael,4,0,32,28
1656294840680,MATH 109,B02,083216,Ganzberger; Geoffrey Michael,1,0,32,31
1656294840680,MATH 109,B03,093479,Staff,3,0,32,29
1656294846711,MATH 142A,A01,083219,Chow; Bennett,1,0,32,31
1656294846711,MATH 142A,A02,083220,Chow; Bennett,8,0,32,24
1656294846711,MATH 142A,A03,093480,Staff,5,0,32,27
1656294846711,MATH 142A,B03,093481,Staff,3,0,32,29
1656294846711,MATH 142A,B04,093558,Staff,6,0,32,26
1656294846711,MATH 142A,B05,093559,Staff,0,0,32,32
1656294852739,MATH 193A,A01,083224,Rotar; Vladimir,0,1,34,34
1656294852739,MATH 193A,A02,083225,Rotar; Vladimir,0,0,34,34
1656294852739,MATH 193A,A03,083781,Rotar; Vladimir,0,0,34,34
1656294852739,MATH 193A,A04,083782,Rotar; Vladimir,6,0,34,28
1656294852739,MATH 193A,A05,093482,Rotar; Vladimir,0,0,34,34
1656294858766,MATH 197,001,091859,McAuley; Julian John,9999,0,9999,0
1656294858766,MATH 197,002,095566,Kedlaya; Kiran S.,9997,0,9999,2
1656294858766,MATH 197,003,095567,Xiao; Ming,9999,0,9999,0
1656294858766,MATH 197,004,095571,Perols; Johan Lars,9998,0,9999,1
1656294865819,COGS 9,A01,083615,Shannon; Kyle Michael,3,0,75,72
1656294871842,COGS 11,A01,083617,Boyle; Mary E. T.,15,0,48,33
1656294877866,COGS 13,A01,083071,Bastos; Amalia Pinkusfeld,5,0,71,66
1656294883892,COGS 14A,A01,092681,Semenuks; Arturs,1,13,100,99
1656294889918,COGS 14B,A01,083073,Cheng; Tzu-Han,7,0,63,56
1656294895942,COGS 17,A01,092677,Semenuks; Arturs,6,0,81,75
1656294901968,COGS 100,A01,083619,Allen; Michael Gordon,2,0,70,68
1656294907996,COGS 101A,A01,083621,Davis; Joshua Daniel,4,0,68,64
1656294914023,COGS 101B,A01,091572,Allen; Michael Gordon,4,0,65,61
1656294920092,COGS 101C,A01,083625,Delgado; Tania,11,0,35,24
1656294926114,COGS 107A,A01,083627,Boyle; Mary E. T.,0,0,60,60
1656294932138,COGS 118A,A01,083075,Gupta; Anjum,8,0,76,68
1656294938162,CSE 3,A50,083646,Miranda; Gregory Joseph,18,0,50,32
1656294944186,CSE 8A,A50,083650,Miranda; Gregory Joseph,3,3,56,53
1656294950213,CSE 11,A01,083080,Cao; Yingjun,0,48,40,40
1656294956239,CSE 12,A01,083652,Krause-Levy; Sophia Louisa,5,1,120,115
1656294962267,CSE 15L,A01,083654,Morris; Justin Loren,2,0,50,48
1656294962267,CSE 15L,A02,083655,Morris; Justin Loren,4,0,50,46
1656294968289,CSE 20,A01,083657,Tran; Khoa Dang,30,0,80,50
1656294974312,CSE 21,A01,095574,Bach; Quang Tran,23,0,48,25
1656294980341,CSE 30,A01,083084,Eldon; John,2,6,80,78
1656294980341,CSE 30,B01,095061,Bhaskar; Nishant,0,1,50,50
1656294986366,CSE 100,A01,083659,Cao; Yingjun,1,18,70,69
1656294992389,CSE 134B,A01,083661,Powell; Thomas Allan,6,0,100,94
1656294998423,CSE 140,A01,083663,Gungor; Onat,9,0,85,76
1656295004445,CSE 140L,A01,083088,Eldon; John,10,0,100,90
1656295010471,CSE 175,A01,083665,Kumar; Rakesh,0,0,25,25
1656295016493,CSE 190,A00,092507,Dubnov; Shlomo,3,0,20,17
1656295022516,ECE 45,A01,083139,Congero; Spencer William,1,0,75,74
1656295028540,ECE 65,A50,083695,Saad; Andrew S,9,0,30,21
1656295028540,ECE 65,A51,095125,Staff,24,0,26,2
1656295034567,ECE 109,A01,091882,Touri; Behrouz,1,1,70,69
1656295040593,ECE 180,A00,083140,Abi Samra; Nicholas Camill,2,0,30,28
1656295040593,ECE 180,B00,083141,Abi Samra; Nicholas Camill,0,4,30,30
1656295046621,MATH 10A,A01,083735,Patchell; Gregory David,0,0,30,30
1656295046621,MATH 10A,A02,083736,Patchell; Gregory David,22,0,30,8
1656295046621,MATH 10A,A03,083737,Patchell; Gregory David,16,0,30,14
1656295052649,MATH 10B,A01,083207,Lim; Seonhee,2,0,34,32
1656295052649,MATH 10B,A02,083208,Lim; Seonhee,6,0,35,29
1656295052649,MATH 10B,A03,093472,Staff,1,0,34,33
1656295052649,MATH 10B,B01,083739,Sinha; Shubham,11,0,30,19
1656295058681,MATH 18,A01,083743,Cinel; Cameron Alexander,7,0,30,23
1656295058681,MATH 18,A02,083744,Cinel; Cameron Alexander,9,0,30,21
1656295058681,MATH 18,A03,083745,Cinel; Cameron Alexander,5,0,30,25
1656295058681,MATH 18,B01,083748,Rideout; David Porter,1,0,36,35
1656295058681,MATH 18,B02,083749,Rideout; David Porter,0,0,36,36
1656295058681,MATH 18,B03,083750,Rideout; David Porter,0,0,36,36
1656295058681,MATH 18,B04,083751,Rideout; David Porter,0,1,36,36
1656295058681,MATH 18,B05,093473,Rideout; David Porter,0,0,36,36
1656295058681,MATH 18,B06,093474,Rideout; David Porter,3,0,36,33
1656295064704,MATH 20A,A01,083754,Zheng; Zequn,11,0,40,29
1656295070728,MATH 20B,A01,083756,Briones; Jor-el Thomas Caparas,0,0,36,36
1656295070728,MATH 20B,A02,083757,Briones; Jor-el Thomas Caparas,0,0,36,36
1656295070728,MATH 20B,A03,093475,Staff,1,0,36,35
1656295076751,MATH 20C,A01,083760,Briones; Jor-el Thomas Caparas,0,0,35,35
1656295076751,MATH 20C,A02,083761,Briones; Jor-el Thomas Caparas,9,1,35,26
1656295076751,MATH 20C,A03,093476,Staff,0,0,35,35
1656295076751,MATH 20C,B01,083762,Bach; Quang Tran,2,0,30,28
1656295082779,MATH 20D,A01,083765,Tran; Brian Kha,1,0,30,29
1656295082779,MATH 20D,A02,083766,Tran; Brian Kha,1,1,30,29
1656295082779,MATH 20D,A03,083767,Tran; Brian Kha,2,0,30,28
1656295088807,MATH 20E,A01,083771,Ganguly; Soumya,3,0,32,29
1656295088807,MATH 20E,A02,083772,Ganguly; Soumya,0,0,32,32
1656295088807,MATH 20E,B01,083773,Ciotti; Benjamin,17,0,35,18
1656295088807,MATH 20E,B02,083774,Ciotti; Benjamin,15,0,35,20
1656295094837,MATH 103A,A01,083777,Greenfeld; Be'Eri,1,0,36,35
1656295094837,MATH 103A,A02,083778,Greenfeld; Be'Eri,3,0,36,33
1656295094837,MATH 103A,A03,093561,Staff,4,0,36,32
1656295094837,MATH 103A,B01,083779,Greenfeld; Be'Eri,8,0,36,28
1656295094837,MATH 103A,B02,083780,Greenfeld; Be'Eri,0,0,36,36
1656295094837,MATH 103A,B03,093562,Staff,1,0,36,35
1656295100868,MATH 105,A01,085443,Carter; Anne Toulson,5,0,35,30
1656295100868,MATH 105,A02,093477,Staff,14,0,35,21
1656295106892,MATH 109,A01,083213,Ganzberger; Geoffrey Michael,1,0,34,33
1656295106892,MATH 109,A02,083214,Ganzberger; Geoffrey Michael,0,0,34,34
1656295106892,MATH 109,A03,093478,Staff,2,0,34,32
1656295106892,MATH 109,B01,083215,Ganzberger; Geoffrey Michael,4,0,32,28
1656295106892,MATH 109,B02,083216,Ganzberger; Geoffrey Michael,1,0,32,31
1656295106892,MATH 109,B03,093479,Staff,3,0,32,29
1656295112914,MATH 142A,A01,083219,Chow; Bennett,1,0,32,31
1656295112914,MATH 142A,A02,083220,Chow; Bennett,8,0,32,24
1656295112914,MATH 142A,A03,093480,Staff,5,0,32,27
1656295112914,MATH 142A,B03,093481,Staff,3,0,32,29
1656295112914,MATH 142A,B04,093558,Staff,6,0,32,26
1656295112914,MATH 142A,B05,093559,Staff,0,0,32,32
1656295118938,MATH 193A,A01,083224,Rotar; Vladimir,0,1,34,34
1656295118938,MATH 193A,A02,083225,Rotar; Vladimir,0,0,34,34
1656295118938,MATH 193A,A03,083781,Rotar; Vladimir,0,0,34,34
1656295118938,MATH 193A,A04,083782,Rotar; Vladimir,6,0,34,28
1656295118938,MATH 193A,A05,093482,Rotar; Vladimir,0,0,34,34
1656295124962,MATH 197,001,091859,McAuley; Julian John,9999,0,9999,0
1656295124962,MATH 197,002,095566,Kedlaya; Kiran S.,9997,0,9999,2
1656295124962,MATH 197,003,095567,Xiao; Ming,9999,0,9999,0
1656295124962,MATH 197,004,095571,Perols; Johan Lars,9998,0,9999,1
1656295132016,COGS 9,A01,083615,Shannon; Kyle Michael,3,0,75,72
1656295138040,COGS 11,A01,083617,Boyle; Mary E. T.,15,0,48,33
1656295144067,COGS 13,A01,083071,Bastos; Amalia Pinkusfeld,5,0,71,66
1656295150099,COGS 14A,A01,092681,Semenuks; Arturs,1,13,100,99
1656295156122,COGS 14B,A01,083073,Cheng; Tzu-Han,7,0,63,56
1656295162148,COGS 17,A01,092677,Semenuks; Arturs,6,0,81,75
1656295168176,COGS 100,A01,083619,Allen; Michael Gordon,2,0,70,68
1656295174203,COGS 101A,A01,083621,Davis; Joshua Daniel,4,0,68,64
1656295180227,COGS 101B,A01,091572,Allen; Michael Gordon,4,0,65,61
1656295186249,COGS 101C,A01,083625,Delgado; Tania,11,0,35,24
1656295192273,COGS 107A,A01,083627,Boyle; Mary E. T.,0,0,60,60
1656295198302,COGS 118A,A01,083075,Gupta; Anjum,8,0,76,68
1656295204325,CSE 3,A50,083646,Miranda; Gregory Joseph,18,0,50,32
1656295210351,CSE 8A,A50,083650,Miranda; Gregory Joseph,3,3,56,53
1656295216376,CSE 11,A01,083080,Cao; Yingjun,0,48,40,40
1656295222398,CSE 12,A01,083652,Krause-Levy; Sophia Louisa,5,1,120,115
1656295228422,CSE 15L,A01,083654,Morris; Justin Loren,2,0,50,48
1656295228422,CSE 15L,A02,083655,Morris; Justin Loren,4,0,50,46
1656295234444,CSE 20,A01,083657,Tran; Khoa Dang,30,0,80,50
1656295240467,CSE 21,A01,095574,Bach; Quang Tran,23,0,48,25
1656295246489,CSE 30,A01,083084,Eldon; John,2,6,80,78
1656295246489,CSE 30,B01,095061,Bhaskar; Nishant,0,1,50,50
1656295252515,CSE 100,A01,083659,Cao; Yingjun,1,18,70,69
1656295258538,CSE 134B,A01,083661,Powell; Thomas Allan,6,0,100,94
1656295264564,CSE 140,A01,083663,Gungor; Onat,9,0,85,76
1656295270589,CSE 140L,A01,083088,Eldon; John,10,0,100,90
1656295276611,CSE 175,A01,083665,Kumar; Rakesh,0,0,25,25
1656295282634,CSE 190,A00,092507,Dubnov; Shlomo,3,0,20,17
1656295288663,ECE 45,A01,083139,Congero; Spencer William,1,0,75,74
1656295294687,ECE 65,A50,083695,Saad; Andrew S,9,0,30,21
1656295294687,ECE 65,A51,095125,Staff,24,0,26,2
1656295300717,ECE 109,A01,091882,Touri; Behrouz,1,1,70,69
1656295306744,ECE 180,A00,083140,Abi Samra; Nicholas Camill,2,0,30,28
1656295306744,ECE 180,B00,083141,Abi Samra; Nicholas Camill,0,4,30,30
1656295312841,MATH 10A,A01,083735,Patchell; Gregory David,0,0,30,30
1656295312841,MATH 10A,A02,083736,Patchell; Gregory David,22,0,30,8
1656295312841,MATH 10A,A03,083737,Patchell; Gregory David,16,0,30,14
1656295318867,MATH 10B,A01,083207,Lim; Seonhee,2,0,34,32
1656295318867,MATH 10B,A02,083208,Lim; Seonhee,6,0,35,29
1656295318867,MATH 10B,A03,093472,Staff,1,0,34,33
1656295318867,MATH 10B,B01,083739,Sinha; Shubham,11,0,30,19
1656295324893,MATH 18,A01,083743,Cinel; Cameron Alexander,7,0,30,23
1656295324893,MATH 18,A02,083744,Cinel; Cameron Alexander,9,0,30,21
1656295324893,MATH 18,A03,083745,Cinel; Cameron Alexander,5,0,30,25
1656295324893,MATH 18,B01,083748,Rideout; David Porter,1,0,36,35
1656295324893,MATH 18,B02,083749,Rideout; David Porter,0,0,36,36
1656295324893,MATH 18,B03,083750,Rideout; David Porter,0,0,36,36
1656295324893,MATH 18,B04,083751,Rideout; David Porter,0,1,36,36
1656295324893,MATH 18,B05,093473,Rideout; David Porter,0,0,36,36
1656295324893,MATH 18,B06,093474,Rideout; David Porter,3,0,36,33
1656295330920,MATH 20A,A01,083754,Zheng; Zequn,11,0,40,29
1656295336948,MATH 20B,A01,083756,Briones; Jor-el Thomas Caparas,0,0,36,36
1656295336948,MATH 20B,A02,083757,Briones; Jor-el Thomas Caparas,0,0,36,36
1656295336948,MATH 20B,A03,093475,Staff,1,0,36,35
1656295342972,MATH 20C,A01,083760,Briones; Jor-el Thomas Caparas,0,0,35,35
1656295342972,MATH 20C,A02,083761,Briones; Jor-el Thomas Caparas,9,1,35,26
1656295342972,MATH 20C,A03,093476,Staff,0,0,35,35
1656295342972,MATH 20C,B01,083762,Bach; Quang Tran,2,0,30,28
1656295349000,MATH 20D,A01,083765,Tran; Brian Kha,1,0,30,29
1656295349000,MATH 20D,A02,083766,Tran; Brian Kha,1,1,30,29
1656295349000,MATH 20D,A03,083767,Tran; Brian Kha,2,0,30,28
1656295355035,MATH 20E,A01,083771,Ganguly; Soumya,3,0,32,29
1656295355035,MATH 20E,A02,083772,Ganguly; Soumya,0,0,32,32
1656295355035,MATH 20E,B01,083773,Ciotti; Benjamin,17,0,35,18
1656295355035,MATH 20E,B02,083774,Ciotti; Benjamin,15,0,35,20
1656295361064,MATH 103A,A01,083777,Greenfeld; Be'Eri,1,0,36,35
1656295361064,MATH 103A,A02,083778,Greenfeld; Be'Eri,3,0,36,33
1656295361064,MATH 103A,A03,093561,Staff,4,0,36,32
1656295361064,MATH 103A,B01,083779,Greenfeld; Be'Eri,8,0,36,28
1656295361064,MATH 103A,B02,083780,Greenfeld; Be'Eri,0,0,36,36
1656295361064,MATH 103A,B03,093562,Staff,1,0,36,35
1656295367087,MATH 105,A01,085443,Carter; Anne Toulson,5,0,35,30
1656295367087,MATH 105,A02,093477,Staff,14,0,35,21
1656295373110,MATH 109,A01,083213,Ganzberger; Geoffrey Michael,1,0,34,33
1656295373110,MATH 109,A02,083214,Ganzberger; Geoffrey Michael,0,0,34,34
1656295373110,MATH 109,A03,093478,Staff,2,0,34,32
1656295373110,MATH 109,B01,083215,Ganzberger; Geoffrey Michael,4,0,32,28
1656295373110,MATH 109,B02,083216,Ganzberger; Geoffrey Michael,1,0,32,31
1656295373110,MATH 109,B03,093479,Staff,3,0,32,29
1656295379139,MATH 142A,A01,083219,Chow; Bennett,1,0,32,31
1656295379139,MATH 142A,A02,083220,Chow; Bennett,8,0,32,24
1656295379139,MATH 142A,A03,093480,Staff,5,0,32,27
1656295379139,MATH 142A,B03,093481,Staff,3,0,32,29
1656295379139,MATH 142A,B04,093558,Staff,6,0,32,26
1656295379139,MATH 142A,B05,093559,Staff,0,0,32,32
1656295385164,MATH 193A,A01,083224,Rotar; Vladimir,0,1,34,34
1656295385164,MATH 193A,A02,083225,Rotar; Vladimir,0,0,34,34
1656295385164,MATH 193A,A03,083781,Rotar; Vladimir,0,0,34,34
1656295385164,MATH 193A,A04,083782,Rotar; Vladimir,6,0,34,28
1656295385164,MATH 193A,A05,093482,Rotar; Vladimir,0,0,34,34
1656295391189,MATH 197,001,091859,McAuley; Julian John,9999,0,9999,0
1656295391189,MATH 197,002,095566,Kedlaya; Kiran S.,9997,0,9999,2
1656295391189,MATH 197,003,095567,Xiao; Ming,9999,0,9999,0
1656295391189,MATH 197,004,095571,Perols; Johan Lars,9998,0,9999,1
1656295398242,COGS 9,A01,083615,Shannon; Kyle Michael,3,0,75,72
1656295404268,COGS 11,A01,083617,Boyle; Mary E. T.,15,0,48,33
1656295410297,COGS 13,A01,083071,Bastos; Amalia Pinkusfeld,5,0,71,66
1656295416324,COGS 14A,A01,092681,Semenuks; Arturs,1,13,100,99
1656295422352,COGS 14B,A01,083073,Cheng; Tzu-Han,7,0,63,56
1656295428376,COGS 17,A01,092677,Semenuks; Arturs,6,0,81,75
1656295434401,COGS 100,A01,083619,Allen; Michael Gordon,2,0,70,68
1656295440430,COGS 101A,A01,083621,Davis; Joshua Daniel,4,0,68,64
1656295446461,COGS 101B,A01,091572,Allen; Michael Gordon,4,0,65,61
1656295452494,COGS 101C,A01,083625,Delgado; Tania,11,0,35,24
1656295458516,COGS 107A,A01,083627,Boyle; Mary E. T.,0,0,60,60
1656295464540,COGS 118A,A01,083075,Gupta; Anjum,8,0,76,68
1656295470564,CSE 3,A50,083646,Miranda; Gregory Joseph,18,0,50,32
1656295476592,CSE 8A,A50,083650,Miranda; Gregory Joseph,3,3,56,53
1656295482616,CSE 11,A01,083080,Cao; Yingjun,0,48,40,40
1656295488646,CSE 12,A01,083652,Krause-Levy; Sophia Louisa,5,1,120,115
1656295494673,CSE 15L,A01,083654,Morris; Justin Loren,2,0,50,48
1656295494673,CSE 15L,A02,083655,Morris; Justin Loren,4,0,50,46
1656295500704,CSE 20,A01,083657,Tran; Khoa Dang,30,0,80,50
1656295506728,CSE 21,A01,095574,Bach; Quang Tran,23,0,48,25
1656295512756,CSE 30,A01,083084,Eldon; John,2,6,80,78
1656295512756,CSE 30,B01,095061,Bhaskar; Nishant,0,1,50,50
1656295518779,CSE 100,A01,083659,Cao; Yingjun,1,18,70,69
1656295524802,CSE 134B,A01,083661,Powell; Thomas Allan,6,0,100,94
1656295530825,CSE 140,A01,083663,Gungor; Onat,9,0,85,76
1656295536848,CSE 140L,A01,083088,Eldon; John,10,0,100,90
1656295542874,CSE 175,A01,083665,Kumar; Rakesh,0,0,25,25
1656295548899,CSE 190,A00,092507,Dubnov; Shlomo,3,0,20,17
1656295554926,ECE 45,A01,083139,Congero; Spencer William,1,0,75,74
1656295560948,ECE 65,A50,083695,Saad; Andrew S,9,0,30,21
1656295560948,ECE 65,A51,095125,Staff,24,0,26,2
1656295566970,ECE 109,A01,091882,Touri; Behrouz,1,1,70,69
1656295573005,ECE 180,A00,083140,Abi Samra; Nicholas Camill,2,0,30,28
1656295573005,ECE 180,B00,083141,Abi Samra; Nicholas Camill,0,4,30,30
1656295579028,MATH 10A,A01,083735,Patchell; Gregory David,0,0,30,30
1656295579028,MATH 10A,A02,083736,Patchell; Gregory David,22,0,30,8
1656295579028,MATH 10A,A03,083737,Patchell; Gregory David,16,0,30,14
1656295585057,MATH 10B,A01,083207,Lim; Seonhee,2,0,34,32
1656295585057,MATH 10B,A02,083208,Lim; Seonhee,6,0,35,29
1656295585057,MATH 10B,A03,093472,Staff,1,0,34,33
1656295585057,MATH 10B,B01,083739,Sinha; Shubham,11,0,30,19
1656295591081,MATH 18,A01,083743,Cinel; Cameron Alexander,7,0,30,23
1656295591081,MATH 18,A02,083744,Cinel; Cameron Alexander,9,0,30,21
1656295591081,MATH 18,A03,083745,Cinel; Cameron Alexander,5,0,30,25
1656295591081,MATH 18,B01,083748,Rideout; David Porter,1,0,36,35
1656295591081,MATH 18,B02,083749,Rideout; David Porter,0,0,36,36
1656295591081,MATH 18,B03,083750,Rideout; David Porter,0,0,36,36
1656295591081,MATH 18,B04,083751,Rideout; David Porter,0,1,36,36
1656295591081,MATH 18,B05,093473,Rideout; David Porter,0,0,36,36
1656295591081,MATH 18,B06,093474,Rideout; David Porter,3,0,36,33
1656295597104,MATH 20A,A01,083754,Zheng; Zequn,11,0,40,29
1656295603131,MATH 20B,A01,083756,Briones; Jor-el Thomas Caparas,0,0,36,36
1656295603131,MATH 20B,A02,083757,Briones; Jor-el Thomas Caparas,0,0,36,36
1656295603131,MATH 20B,A03,093475,Staff,1,0,36,35
1656295609154,MATH 20C,A01,083760,Briones; Jor-el Thomas Caparas,0,0,35,35
1656295609154,MATH 20C,A02,083761,Briones; Jor-el Thomas Caparas,9,1,35,26
1656295609154,MATH 20C,A03,093476,Staff,0,0,35,35
1656295609154,MATH 20C,B01,083762,Bach; Quang Tran,2,0,30,28
1656295615179,MATH 20D,A01,083765,Tran; Brian Kha,1,0,30,29
1656295615179,MATH 20D,A02,083766,Tran; Brian Kha,1,1,30,29
1656295615179,MATH 20D,A03,083767,Tran; Brian Kha,2,0,30,28
1656295621202,MATH 20E,A01,083771,Ganguly; Soumya,3,0,32,29
1656295621202,MATH 20E,A02,083772,Ganguly; Soumya,0,0,32,32
1656295621202,MATH 20E,B01,083773,Ciotti; Benjamin,17,0,35,18
1656295621202,MATH 20E,B02,083774,Ciotti; Benjamin,15,0,35,20
1656295627228,MATH 103A,A01,083777,Greenfeld; Be'Eri,1,0,36,35
1656295627228,MATH 103A,A02,083778,Greenfeld; Be'Eri,3,0,36,33
1656295627228,MATH 103A,A03,093561,Staff,4,0,36,32
1656295627228,MATH 103A,B01,083779,Greenfeld; Be'Eri,8,0,36,28
1656295627228,MATH 103A,B02,083780,Greenfeld; Be'Eri,0,0,36,36
1656295627228,MATH 103A,B03,093562,Staff,1,0,36,35
1656295633251,MATH 105,A01,085443,Carter; Anne Toulson,5,0,35,30
1656295633251,MATH 105,A02,093477,Staff,14,0,35,21
1656295639276,MATH 109,A01,083213,Ganzberger; Geoffrey Michael,1,0,34,33
1656295639276,MATH 109,A02,083214,Ganzberger; Geoffrey Michael,0,0,34,34
1656295639276,MATH 109,A03,093478,Staff,2,0,34,32
1656295639276,MATH 109,B01,083215,Ganzberger; Geoffrey Michael,4,0,32,28
1656295639276,MATH 109,B02,083216,Ganzberger; Geoffrey Michael,1,0,32,31
1656295639276,MATH 109,B03,093479,Staff,3,0,32,29
1656295645301,MATH 142A,A01,083219,Chow; Bennett,1,0,32,31
1656295645301,MATH 142A,A02,083220,Chow; Bennett,8,0,32,24
1656295645301,MATH 142A,A03,093480,Staff,5,0,32,27
1656295645301,MATH 142A,B03,093481,Staff,3,0,32,29
1656295645301,MATH 142A,B04,093558,Staff,6,0,32,26
1656295645301,MATH 142A,B05,093559,Staff,0,0,32,32
1656295651323,MATH 193A,A01,083224,Rotar; Vladimir,0,1,34,34
1656295651323,MATH 193A,A02,083225,Rotar; Vladimir,0,0,34,34
1656295651323,MATH 193A,A03,083781,Rotar; Vladimir,0,0,34,34
1656295651323,MATH 193A,A04,083782,Rotar; Vladimir,6,0,34,28
1656295651323,MATH 193A,A05,093482,Rotar; Vladimir,0,0,34,34
1656295657350,MATH 197,001,091859,McAuley; Julian John,9999,0,9999,0
1656295657350,MATH 197,002,095566,Kedlaya; Kiran S.,9997,0,9999,2
1656295657350,MATH 197,003,095567,Xiao; Ming,9999,0,9999,0
1656295657350,MATH 197,004,095571,Perols; Johan Lars,9998,0,9999,1
1656295664413,COGS 9,A01,083615,Shannon; Kyle Michael,3,0,75,72
1656295670439,COGS 11,A01,083617,Boyle; Mary E. T.,15,0,48,33
1656295676468,COGS 13,A01,083071,Bastos; Amalia Pinkusfeld,5,0,71,66
1656295682490,COGS 14A,A01,092681,Semenuks; Arturs,1,13,100,99
1656295688514,COGS 14B,A01,083073,Cheng; Tzu-Han,7,0,63,56
1656295694539,COGS 17,A01,092677,Semenuks; Arturs,6,0,81,75
1656295700573,COGS 100,A01,083619,Allen; Michael Gordon,2,0,70,68
1656295706596,COGS 101A,A01,083621,Davis; Joshua Daniel,4,0,68,64
1656295712622,COGS 101B,A01,091572,Allen; Michael Gordon,4,0,65,61
1656295718648,COGS 101C,A01,083625,Delgado; Tania,11,0,35,24
1656295724671,COGS 107A,A01,083627,Boyle; Mary E. T.,0,0,60,60
1656295730695,COGS 118A,A01,083075,Gupta; Anjum,8,0,76,68
1656295736727,CSE 3,A50,083646,Miranda; Gregory Joseph,18,0,50,32
1656295742751,CSE 8A,A50,083650,Miranda; Gregory Joseph,3,3,56,53
1656295748777,CSE 11,A01,083080,Cao; Yingjun,0,48,40,40
1656295754807,CSE 12,A01,083652,Krause-Levy; Sophia Louisa,5,1,120,115
1656295760831,CSE 15L,A01,083654,Morris; Justin Loren,2,0,50,48
1656295760831,CSE 15L,A02,083655,Morris; Justin Loren,4,0,50,46
1656295766855,CSE 20,A01,083657,Tran; Khoa Dang,30,0,80,50
1656295772885,CSE 21,A01,095574,Bach; Quang Tran,23,0,48,25
1656295778908,CSE 30,A01,083084,Eldon; John,2,6,80,78
1656295778908,CSE 30,B01,095061,Bhaskar; Nishant,0,1,50,50
1656295784930,CSE 100,A01,083659,Cao; Yingjun,1,18,70,69
1656295790957,CSE 134B,A01,083661,Powell; Thomas Allan,6,0,100,94
1656295796983,CSE 140,A01,083663,Gungor; Onat,9,0,85,76
1656295803009,CSE 140L,A01,083088,Eldon; John,10,0,100,90
1656295809033,CSE 175,A01,083665,Kumar; Rakesh,0,0,25,25
1656295815055,CSE 190,A00,092507,Dubnov; Shlomo,3,0,20,17
1656295821082,ECE 45,A01,083139,Congero; Spencer William,1,0,75,74
1656295827105,ECE 65,A50,083695,Saad; Andrew S,9,0,30,21
1656295827105,ECE 65,A51,095125,Staff,24,0,26,2
1656295833130,ECE 109,A01,091882,Touri; Behrouz,1,1,70,69
1656295839162,ECE 180,A00,083140,Abi Samra; Nicholas Camill,2,0,30,28
1656295839162,ECE 180,B00,083141,Abi Samra; Nicholas Camill,0,4,30,30
1656295845188,MATH 10A,A01,083735,Patchell; Gregory David,0,0,30,30
1656295845188,MATH 10A,A02,083736,Patchell; Gregory David,22,0,30,8
1656295845188,MATH 10A,A03,083737,Patchell; Gregory David,16,0,30,14
1656295851222,MATH 10B,A01,083207,Lim; Seonhee,2,0,34,32
1656295851222,MATH 10B,A02,083208,Lim; Seonhee,6,0,35,29
1656295851222,MATH 10B,A03,093472,Staff,1,0,34,33
1656295851222,MATH 10B,B01,083739,Sinha; Shubham,11,0,30,19
1656295857247,MATH 18,A01,083743,Cinel; Cameron Alexander,7,0,30,23
1656295857247,MATH 18,A02,083744,Cinel; Cameron Alexander,9,0,30,21
1656295857247,MATH 18,A03,083745,Cinel; Cameron Alexander,5,0,30,25
1656295857247,MATH 18,B01,083748,Rideout; David Porter,1,0,36,35
1656295857247,MATH 18,B02,083749,Rideout; David Porter,0,0,36,36
1656295857247,MATH 18,B03,083750,Rideout; David Porter,0,0,36,36
1656295857247,MATH 18,B04,083751,Rideout; David Porter,0,1,36,36
1656295857247,MATH 18,B05,093473,Rideout; David Porter,0,0,36,36
1656295857247,MATH 18,B06,093474,Rideout; David Porter,3,0,36,33
1656295863271,MATH 20A,A01,083754,Zheng; Zequn,11,0,40,29
1656295869297,MATH 20B,A01,083756,Briones; Jor-el Thomas Caparas,0,0,36,36
1656295869297,MATH 20B,A02,083757,Briones; Jor-el Thomas Caparas,0,0,36,36
1656295869297,MATH 20B,A03,093475,Staff,1,0,36,35
1656295875326,MATH 20C,A01,083760,Briones; Jor-el Thomas Caparas,0,0,35,35
1656295875326,MATH 20C,A02,083761,Briones; Jor-el Thomas Caparas,9,1,35,26
1656295875326,MATH 20C,A03,093476,Staff,0,0,35,35
1656295875326,MATH 20C,B01,083762,Bach; Quang Tran,2,0,30,28
1656295881353,MATH 20D,A01,083765,Tran; Brian Kha,1,0,30,29
1656295881353,MATH 20D,A02,083766,Tran; Brian Kha,1,1,30,29
1656295881353,MATH 20D,A03,083767,Tran; Brian Kha,2,0,30,28
1656295887377,MATH 20E,A01,083771,Ganguly; Soumya,3,0,32,29
1656295887377,MATH 20E,A02,083772,Ganguly; Soumya,0,0,32,32
1656295887377,MATH 20E,B01,083773,Ciotti; Benjamin,17,0,35,18
1656295887377,MATH 20E,B02,083774,Ciotti; Benjamin,15,0,35,20
1656295893401,MATH 103A,A01,083777,Greenfeld; Be'Eri,1,0,36,35
1656295893401,MATH 103A,A02,083778,Greenfeld; Be'Eri,3,0,36,33
1656295893401,MATH 103A,A03,093561,Staff,4,0,36,32
1656295893401,MATH 103A,B01,083779,Greenfeld; Be'Eri,8,0,36,28
1656295893401,MATH 103A,B02,083780,Greenfeld; Be'Eri,0,0,36,36
1656295893401,MATH 103A,B03,093562,Staff,1,0,36,35
1656295899426,MATH 105,A01,085443,Carter; Anne Toulson,5,0,35,30
1656295899426,MATH 105,A02,093477,Staff,14,0,35,21
1656295905454,MATH 109,A01,083213,Ganzberger; Geoffrey Michael,1,0,34,33
1656295905454,MATH 109,A02,083214,Ganzberger; Geoffrey Michael,0,0,34,34
1656295905454,MATH 109,A03,093478,Staff,2,0,34,32
1656295905454,MATH 109,B01,083215,Ganzberger; Geoffrey Michael,4,0,32,28
1656295905454,MATH 109,B02,083216,Ganzberger; Geoffrey Michael,1,0,32,31
1656295905454,MATH 109,B03,093479,Staff,3,0,32,29
1656295911548,MATH 142A,A01,083219,Chow; Bennett,1,0,32,31
1656295911548,MATH 142A,A02,083220,Chow; Bennett,8,0,32,24
1656295911548,MATH 142A,A03,093480,Staff,5,0,32,27
1656295911548,MATH 142A,B03,093481,Staff,3,0,32,29
1656295911548,MATH 142A,B04,093558,Staff,6,0,32,26
1656295911548,MATH 142A,B05,093559,Staff,0,0,32,32
1656295917572,MATH 193A,A01,083224,Rotar; Vladimir,0,1,34,34
1656295917572,MATH 193A,A02,083225,Rotar; Vladimir,0,0,34,34
1656295917572,MATH 193A,A03,083781,Rotar; Vladimir,0,0,34,34
1656295917572,MATH 193A,A04,083782,Rotar; Vladimir,6,0,34,28
1656295917572,MATH 193A,A05,093482,Rotar; Vladimir,0,0,34,34
1656295923599,MATH 197,001,091859,McAuley; Julian John,9999,0,9999,0
1656295923599,MATH 197,002,095566,Kedlaya; Kiran S.,9997,0,9999,2
1656295923599,MATH 197,003,095567,Xiao; Ming,9999,0,9999,0
1656295923599,MATH 197,004,095571,Perols; Johan Lars,9998,0,9999,1
1656295930672,COGS 9,A01,083615,Shannon; Kyle Michael,3,0,75,72
1656295936698,COGS 11,A01,083617,Boyle; Mary E. T.,15,0,48,33
1656295942725,COGS 13,A01,083071,Bastos; Amalia Pinkusfeld,5,0,71,66
1656295948748,COGS 14A,A01,092681,Semenuks; Arturs,1,13,100,99
1656295954771,COGS 14B,A01,083073,Cheng; Tzu-Han,7,0,63,56
1656295960795,COGS 17,A01,092677,Semenuks; Arturs,6,0,81,75
1656295966820,COGS 100,A01,083619,Allen; Michael Gordon,2,0,70,68
1656295972847,COGS 101A,A01,083621,Davis; Joshua Daniel,4,0,68,64
1656295978871,COGS 101B,A01,091572,Allen; Michael Gordon,4,0,65,61
1656295984894,COGS 101C,A01,083625,Delgado; Tania,11,0,35,24
1656295990919,COGS 107A,A01,083627,Boyle; Mary E. T.,0,0,60,60
1656295996945,COGS 118A,A01,083075,Gupta; Anjum,8,0,76,68
1656296002977,CSE 3,A50,083646,Miranda; Gregory Joseph,18,0,50,32
1656296009004,CSE 8A,A50,083650,Miranda; Gregory Joseph,3,3,56,53
1656296015037,CSE 11,A01,083080,Cao; Yingjun,0,48,40,40
1656296021064,CSE 12,A01,083652,Krause-Levy; Sophia Louisa,5,1,120,115
1656296027087,CSE 15L,A01,083654,Morris; Justin Loren,2,0,50,48
1656296027087,CSE 15L,A02,083655,Morris; Justin Loren,4,0,50,46
1656296033119,CSE 20,A01,083657,Tran; Khoa Dang,30,0,80,50
1656296039148,CSE 21,A01,095574,Bach; Quang Tran,23,0,48,25
1656296045181,CSE 30,A01,083084,Eldon; John,2,6,80,78
1656296045181,CSE 30,B01,095061,Bhaskar; Nishant,0,1,50,50
1656296051205,CSE 100,A01,083659,Cao; Yingjun,1,18,70,69
1656296057229,CSE 134B,A01,083661,Powell; Thomas Allan,6,0,100,94
1656296063255,CSE 140,A01,083663,Gungor; Onat,9,0,85,76
1656296069282,CSE 140L,A01,083088,Eldon; John,10,0,100,90
1656296075306,CSE 175,A01,083665,Kumar; Rakesh,0,0,25,25
1656296081329,CSE 190,A00,092507,Dubnov; Shlomo,3,0,20,17
1656296087358,ECE 45,A01,083139,Congero; Spencer William,1,0,75,74
1656296093381,ECE 65,A50,083695,Saad; Andrew S,9,0,30,21
1656296093381,ECE 65,A51,095125,Staff,24,0,26,2
1656296099403,ECE 109,A01,091882,Touri; Behrouz,1,1,70,69
1656296105426,ECE 180,A00,083140,Abi Samra; Nicholas Camill,2,0,30,28
1656296105426,ECE 180,B00,083141,Abi Samra; Nicholas Camill,0,4,30,30
1656296111450,MATH 10A,A01,083735,Patchell; Gregory David,0,0,30,30
1656296111450,MATH 10A,A02,083736,Patchell; Gregory David,22,0,30,8
1656296111450,MATH 10A,A03,083737,Patchell; Gregory David,16,0,30,14
1656296117479,MATH 10B,A01,083207,Lim; Seonhee,2,0,34,32
1656296117479,MATH 10B,A02,083208,Lim; Seonhee,6,0,35,29
1656296117479,MATH 10B,A03,093472,Staff,1,0,34,33
1656296117479,MATH 10B,B01,083739,Sinha; Shubham,11,0,30,19
1656296123522,MATH 18,A01,083743,Cinel; Cameron Alexander,7,0,30,23
1656296123522,MATH 18,A02,083744,Cinel; Cameron Alexander,9,0,30,21
1656296123522,MATH 18,A03,083745,Cinel; Cameron Alexander,5,0,30,25
1656296123522,MATH 18,B01,083748,Rideout; David Porter,1,0,36,35
1656296123522,MATH 18,B02,083749,Rideout; David Porter,0,0,36,36
1656296123522,MATH 18,B03,083750,Rideout; David Porter,0,0,36,36
1656296123522,MATH 18,B04,083751,Rideout; David Porter,0,1,36,36
1656296123522,MATH 18,B05,093473,Rideout; David Porter,0,0,36,36
1656296123522,MATH 18,B06,093474,Rideout; David Porter,3,0,36,33
1656296129544,MATH 20A,A01,083754,Zheng; Zequn,11,0,40,29
1656296135568,MATH 20B,A01,083756,Briones; Jor-el Thomas Caparas,0,0,36,36
1656296135568,MATH 20B,A02,083757,Briones; Jor-el Thomas Caparas,0,0,36,36
1656296135568,MATH 20B,A03,093475,Staff,1,0,36,35
1656296141592,MATH 20C,A01,083760,Briones; Jor-el Thomas Caparas,0,0,35,35
1656296141592,MATH 20C,A02,083761,Briones; Jor-el Thomas Caparas,9,1,35,26
1656296141592,MATH 20C,A03,093476,Staff,0,0,35,35
1656296141592,MATH 20C,B01,083762,Bach; Quang Tran,2,0,30,28
1656296147614,MATH 20D,A01,083765,Tran; Brian Kha,1,0,30,29
1656296147614,MATH 20D,A02,083766,Tran; Brian Kha,1,1,30,29
1656296147614,MATH 20D,A03,083767,Tran; Brian Kha,2,0,30,28
1656296153638,MATH 20E,A01,083771,Ganguly; Soumya,3,0,32,29
1656296153638,MATH 20E,A02,083772,Ganguly; Soumya,0,0,32,32
1656296153638,MATH 20E,B01,083773,Ciotti; Benjamin,17,0,35,18
1656296153638,MATH 20E,B02,083774,Ciotti; Benjamin,15,0,35,20
1656296159662,MATH 103A,A01,083777,Greenfeld; Be'Eri,1,0,36,35
1656296159662,MATH 103A,A02,083778,Greenfeld; Be'Eri,3,0,36,33
1656296159662,MATH 103A,A03,093561,Staff,4,0,36,32
1656296159662,MATH 103A,B01,083779,Greenfeld; Be'Eri,8,0,36,28
1656296159662,MATH 103A,B02,083780,Greenfeld; Be'Eri,0,0,36,36
1656296159662,MATH 103A,B03,093562,Staff,1,0,36,35
1656296165686,MATH 105,A01,085443,Carter; Anne Toulson,5,0,35,30
1656296165686,MATH 105,A02,093477,Staff,14,0,35,21
1656296171710,MATH 109,A01,083213,Ganzberger; Geoffrey Michael,1,0,34,33
1656296171710,MATH 109,A02,083214,Ganzberger; Geoffrey Michael,0,0,34,34
1656296171710,MATH 109,A03,093478,Staff,2,0,34,32
1656296171710,MATH 109,B01,083215,Ganzberger; Geoffrey Michael,4,0,32,28
1656296171710,MATH 109,B02,083216,Ganzberger; Geoffrey Michael,1,0,32,31
1656296171710,MATH 109,B03,093479,Staff,3,0,32,29
1656296177733,MATH 142A,A01,083219,Chow; Bennett,1,0,32,31
1656296177733,MATH 142A,A02,083220,Chow; Bennett,8,0,32,24
1656296177733,MATH 142A,A03,093480,Staff,5,0,32,27
1656296177733,MATH 142A,B03,093481,Staff,3,0,32,29
1656296177733,MATH 142A,B04,093558,Staff,6,0,32,26
1656296177733,MATH 142A,B05,093559,Staff,0,0,32,32
1656296183761,MATH 193A,A01,083224,Rotar; Vladimir,0,1,34,34
1656296183761,MATH 193A,A02,083225,Rotar; Vladimir,0,0,34,34
1656296183761,MATH 193A,A03,083781,Rotar; Vladimir,0,0,34,34
1656296183761,MATH 193A,A04,083782,Rotar; Vladimir,6,0,34,28
1656296183761,MATH 193A,A05,093482,Rotar; Vladimir,0,0,34,34
1656296189787,MATH 197,001,091859,McAuley; Julian John,9999,0,9999,0
1656296189787,MATH 197,002,095566,Kedlaya; Kiran S.,9997,0,9999,2
1656296189787,MATH 197,003,095567,Xiao; Ming,9999,0,9999,0
1656296189787,MATH 197,004,095571,Perols; Johan Lars,9998,0,9999,1
1656296196843,COGS 9,A01,083615,Shannon; Kyle Michael,3,0,75,72
1656296202868,COGS 11,A01,083617,Boyle; Mary E. T.,15,0,48,33
1656296208891,COGS 13,A01,083071,Bastos; Amalia Pinkusfeld,5,0,71,66
1656296214918,COGS 14A,A01,092681,Semenuks; Arturs,1,13,100,99
1656296220945,COGS 14B,A01,083073,Cheng; Tzu-Han,7,0,63,56
1656296226968,COGS 17,A01,092677,Semenuks; Arturs,6,0,81,75
1656296232991,COGS 100,A01,083619,Allen; Michael Gordon,2,0,70,68
1656296239016,COGS 101A,A01,083621,Davis; Joshua Daniel,4,0,68,64
1656296245040,COGS 101B,A01,091572,Allen; Michael Gordon,4,0,65,61
1656296251067,COGS 101C,A01,083625,Delgado; Tania,11,0,35,24
1656296257097,COGS 107A,A01,083627,Boyle; Mary E. T.,0,0,60,60
1656296263119,COGS 118A,A01,083075,Gupta; Anjum,8,0,76,68
1656296269142,CSE 3,A50,083646,Miranda; Gregory Joseph,18,0,50,32
1656296275170,CSE 8A,A50,083650,Miranda; Gregory Joseph,3,3,56,53
1656296281193,CSE 11,A01,083080,Cao; Yingjun,0,48,40,40
1656296287217,CSE 12,A01,083652,Krause-Levy; Sophia Louisa,5,1,120,115
1656296293245,CSE 15L,A01,083654,Morris; Justin Loren,2,0,50,48
1656296293245,CSE 15L,A02,083655,Morris; Justin Loren,4,0,50,46
1656296299277,CSE 20,A01,083657,Tran; Khoa Dang,30,0,80,50
1656296305303,CSE 21,A01,095574,Bach; Quang Tran,23,0,48,25
1656296311330,CSE 30,A01,083084,Eldon; John,2,6,80,78
1656296311330,CSE 30,B01,095061,Bhaskar; Nishant,0,1,50,50
1656296317352,CSE 100,A01,083659,Cao; Yingjun,1,18,70,69
1656296323384,CSE 134B,A01,083661,Powell; Thomas Allan,6,0,100,94
1656296329410,CSE 140,A01,083663,Gungor; Onat,9,0,85,76
1656296335436,CSE 140L,A01,083088,Eldon; John,10,0,100,90
1656296341458,CSE 175,A01,083665,Kumar; Rakesh,0,0,25,25
1656296347484,CSE 190,A00,092507,Dubnov; Shlomo,3,0,20,17
1656296353510,ECE 45,A01,083139,Congero; Spencer William,1,0,75,74
1656296359532,ECE 65,A50,083695,Saad; Andrew S,9,0,30,21
1656296359532,ECE 65,A51,095125,Staff,24,0,26,2
1656296365565,ECE 109,A01,091882,Touri; Behrouz,1,1,70,69
1656296371588,ECE 180,A00,083140,Abi Samra; Nicholas Camill,2,0,30,28
1656296371588,ECE 180,B00,083141,Abi Samra; Nicholas Camill,0,4,30,30
1656296377611,MATH 10A,A01,083735,Patchell; Gregory David,0,0,30,30
1656296377611,MATH 10A,A02,083736,Patchell; Gregory David,22,0,30,8
1656296377611,MATH 10A,A03,083737,Patchell; Gregory David,16,0,30,14
1656296383636,MATH 10B,A01,083207,Lim; Seonhee,2,0,34,32
1656296383636,MATH 10B,A02,083208,Lim; Seonhee,6,0,35,29
1656296383636,MATH 10B,A03,093472,Staff,1,0,34,33
1656296383636,MATH 10B,B01,083739,Sinha; Shubham,11,0,30,19
1656296389666,MATH 18,A01,083743,Cinel; Cameron Alexander,7,0,30,23
1656296389666,MATH 18,A02,083744,Cinel; Cameron Alexander,9,0,30,21
1656296389666,MATH 18,A03,083745,Cinel; Cameron Alexander,5,0,30,25
1656296389666,MATH 18,B01,083748,Rideout; David Porter,1,0,36,35
1656296389666,MATH 18,B02,083749,Rideout; David Porter,0,0,36,36
1656296389666,MATH 18,B03,083750,Rideout; David Porter,0,0,36,36
1656296389666,MATH 18,B04,083751,Rideout; David Porter,0,1,36,36
1656296389666,MATH 18,B05,093473,Rideout; David Porter,0,0,36,36
1656296389666,MATH 18,B06,093474,Rideout; David Porter,3,0,36,33
1656296395693,MATH 20A,A01,083754,Zheng; Zequn,11,0,40,29
1656296401718,MATH 20B,A01,083756,Briones; Jor-el Thomas Caparas,0,0,36,36
1656296401718,MATH 20B,A02,083757,Briones; Jor-el Thomas Caparas,0,0,36,36
1656296401718,MATH 20B,A03,093475,Staff,1,0,36,35
1656296407743,MATH 20C,A01,083760,Briones; Jor-el Thomas Caparas,0,0,35,35
1656296407743,MATH 20C,A02,083761,Briones; Jor-el Thomas Caparas,9,1,35,26
1656296407743,MATH 20C,A03,093476,Staff,0,0,35,35
1656296407743,MATH 20C,B01,083762,Bach; Quang Tran,2,0,30,28
1656296413766,MATH 20D,A01,083765,Tran; Brian Kha,1,0,30,29
1656296413766,MATH 20D,A02,083766,Tran; Brian Kha,1,1,30,29
1656296413766,MATH 20D,A03,083767,Tran; Brian Kha,2,0,30,28
1656296419794,MATH 20E,A01,083771,Ganguly; Soumya,3,0,32,29
1656296419794,MATH 20E,A02,083772,Ganguly; Soumya,0,0,32,32
1656296419794,MATH 20E,B01,083773,Ciotti; Benjamin,17,0,35,18
1656296419794,MATH 20E,B02,083774,Ciotti; Benjamin,15,0,35,20
1656296425834,MATH 103A,A01,083777,Greenfeld; Be'Eri,1,0,36,35
1656296425834,MATH 103A,A02,083778,Greenfeld; Be'Eri,3,0,36,33
1656296425834,MATH 103A,A03,093561,Staff,4,0,36,32
1656296425834,MATH 103A,B01,083779,Greenfeld; Be'Eri,8,0,36,28
1656296425834,MATH 103A,B02,083780,Greenfeld; Be'Eri,0,0,36,36
1656296425834,MATH 103A,B03,093562,Staff,1,0,36,35
1656296431861,MATH 105,A01,085443,Carter; Anne Toulson,5,0,35,30
1656296431861,MATH 105,A02,093477,Staff,14,0,35,21
1656296437885,MATH 109,A01,083213,Ganzberger; Geoffrey Michael,1,0,34,33
1656296437885,MATH 109,A02,083214,Ganzberger; Geoffrey Michael,0,0,34,34
1656296437885,MATH 109,A03,093478,Staff,2,0,34,32
1656296437885,MATH 109,B01,083215,Ganzberger; Geoffrey Michael,4,0,32,28
1656296437885,MATH 109,B02,083216,Ganzberger; Geoffrey Michael,1,0,32,31
1656296437885,MATH 109,B03,093479,Staff,3,0,32,29
1656296443914,MATH 142A,A01,083219,Chow; Bennett,1,0,32,31
1656296443914,MATH 142A,A02,083220,Chow; Bennett,8,0,32,24
1656296443914,MATH 142A,A03,093480,Staff,5,0,32,27
1656296443914,MATH 142A,B03,093481,Staff,3,0,32,29
1656296443914,MATH 142A,B04,093558,Staff,6,0,32,26
1656296443914,MATH 142A,B05,093559,Staff,0,0,32,32
1656296449943,MATH 193A,A01,083224,Rotar; Vladimir,0,1,34,34
1656296449943,MATH 193A,A02,083225,Rotar; Vladimir,0,0,34,34
1656296449943,MATH 193A,A03,083781,Rotar; Vladimir,0,0,34,34
1656296449943,MATH 193A,A04,083782,Rotar; Vladimir,6,0,34,28
1656296449943,MATH 193A,A05,093482,Rotar; Vladimir,0,0,34,34
1656296455965,MATH 197,001,091859,McAuley; Julian John,9999,0,9999,0
1656296455965,MATH 197,002,095566,Kedlaya; Kiran S.,9997,0,9999,2
1656296455965,MATH 197,003,095567,Xiao; Ming,9999,0,9999,0
1656296455965,MATH 197,004,095571,Perols; Johan Lars,9998,0,9999,1
1656296463027,COGS 9,A01,083615,Shannon; Kyle Michael,3,0,75,72
1656296469055,COGS 11,A01,083617,Boyle; Mary E. T.,15,0,48,33
1656296475082,COGS 13,A01,083071,Bastos; Amalia Pinkusfeld,5,0,71,66
1656296481105,COGS 14A,A01,092681,Semenuks; Arturs,1,13,100,99
1656296487133,COGS 14B,A01,083073,Cheng; Tzu-Han,7,0,63,56
1656296493157,COGS 17,A01,092677,Semenuks; Arturs,6,0,81,75
1656296499181,COGS 100,A01,083619,Allen; Michael Gordon,2,0,70,68
1656296505281,COGS 101A,A01,083621,Davis; Joshua Daniel,4,0,68,64
1656296511309,COGS 101B,A01,091572,Allen; Michael Gordon,4,0,65,61
1656296517333,COGS 101C,A01,083625,Delgado; Tania,11,0,35,24
1656296523356,COGS 107A,A01,083627,Boyle; Mary E. T.,0,0,60,60
1656296529386,COGS 118A,A01,083075,Gupta; Anjum,8,0,76,68
1656296535408,CSE 3,A50,083646,Miranda; Gregory Joseph,18,0,50,32
1656296541435,CSE 8A,A50,083650,Miranda; Gregory Joseph,3,3,56,53
1656296547458,CSE 11,A01,083080,Cao; Yingjun,0,48,40,40
1656296553481,CSE 12,A01,083652,Krause-Levy; Sophia Louisa,5,1,120,115
1656296559505,CSE 15L,A01,083654,Morris; Justin Loren,2,0,50,48
1656296559505,CSE 15L,A02,083655,Morris; Justin Loren,4,0,50,46
1656296565533,CSE 20,A01,083657,Tran; Khoa Dang,30,0,80,50
1656296571556,CSE 21,A01,095574,Bach; Quang Tran,23,0,48,25
1656296577583,CSE 30,A01,083084,Eldon; John,2,6,80,78
1656296577583,CSE 30,B01,095061,Bhaskar; Nishant,0,1,50,50
1656296583610,CSE 100,A01,083659,Cao; Yingjun,1,18,70,69
1656296589634,CSE 134B,A01,083661,Powell; Thomas Allan,6,0,100,94
1656296595655,CSE 140,A01,083663,Gungor; Onat,9,0,85,76
1656296601682,CSE 140L,A01,083088,Eldon; John,10,0,100,90
1656296607711,CSE 175,A01,083665,Kumar; Rakesh,0,0,25,25
1656296613733,CSE 190,A00,092507,Dubnov; Shlomo,3,0,20,17
1656296619757,ECE 45,A01,083139,Congero; Spencer William,1,0,75,74
1656296625782,ECE 65,A50,083695,Saad; Andrew S,9,0,30,21
1656296625782,ECE 65,A51,095125,Staff,24,0,26,2
1656296631808,ECE 109,A01,091882,Touri; Behrouz,1,1,70,69
1656296637831,ECE 180,A00,083140,Abi Samra; Nicholas Camill,2,0,30,28
1656296637831,ECE 180,B00,083141,Abi Samra; Nicholas Camill,0,4,30,30
1656296643852,MATH 10A,A01,083735,Patchell; Gregory David,0,0,30,30
1656296643852,MATH 10A,A02,083736,Patchell; Gregory David,22,0,30,8
1656296643852,MATH 10A,A03,083737,Patchell; Gregory David,16,0,30,14
1656296649877,MATH 10B,A01,083207,Lim; Seonhee,2,0,34,32
1656296649877,MATH 10B,A02,083208,Lim; Seonhee,6,0,35,29
1656296649877,MATH 10B,A03,093472,Staff,1,0,34,33
1656296649877,MATH 10B,B01,083739,Sinha; Shubham,11,0,30,19
1656296655911,MATH 18,A01,083743,Cinel; Cameron Alexander,7,0,30,23
1656296655911,MATH 18,A02,083744,Cinel; Cameron Alexander,9,0,30,21
1656296655911,MATH 18,A03,083745,Cinel; Cameron Alexander,5,0,30,25
1656296655911,MATH 18,B01,083748,Rideout; David Porter,1,0,36,35
1656296655911,MATH 18,B02,083749,Rideout; David Porter,0,0,36,36
1656296655911,MATH 18,B03,083750,Rideout; David Porter,0,0,36,36
1656296655911,MATH 18,B04,083751,Rideout; David Porter,0,1,36,36
1656296655911,MATH 18,B05,093473,Rideout; David Porter,0,0,36,36
1656296655911,MATH 18,B06,093474,Rideout; David Porter,3,0,36,33
1656296661933,MATH 20A,A01,083754,Zheng; Zequn,11,0,40,29
1656296667959,MATH 20B,A01,083756,Briones; Jor-el Thomas Caparas,0,0,36,36
1656296667959,MATH 20B,A02,083757,Briones; Jor-el Thomas Caparas,0,0,36,36
1656296667959,MATH 20B,A03,093475,Staff,1,0,36,35
1656296673988,MATH 20C,A01,083760,Briones; Jor-el Thomas Caparas,0,0,35,35
1656296673988,MATH 20C,A02,083761,Briones; Jor-el Thomas Caparas,9,1,35,26
1656296673988,MATH 20C,A03,093476,Staff,0,0,35,35
1656296673988,MATH 20C,B01,083762,Bach; Quang Tran,2,0,30,28
1656296680011,MATH 20D,A01,083765,Tran; Brian Kha,1,0,30,29
1656296680011,MATH 20D,A02,083766,Tran; Brian Kha,1,1,30,29
1656296680011,MATH 20D,A03,083767,Tran; Brian Kha,2,0,30,28
1656296686035,MATH 20E,A01,083771,Ganguly; Soumya,3,0,32,29
1656296686035,MATH 20E,A02,083772,Ganguly; Soumya,0,0,32,32
1656296686035,MATH 20E,B01,083773,Ciotti; Benjamin,17,0,35,18
1656296686035,MATH 20E,B02,083774,Ciotti; Benjamin,15,0,35,20
1656296692058,MATH 103A,A01,083777,Greenfeld; Be'Eri,1,0,36,35
1656296692058,MATH 103A,A02,083778,Greenfeld; Be'Eri,3,0,36,33
1656296692058,MATH 103A,A03,093561,Staff,4,0,36,32
1656296692058,MATH 103A,B01,083779,Greenfeld; Be'Eri,8,0,36,28
1656296692058,MATH 103A,B02,083780,Greenfeld; Be'Eri,0,0,36,36
1656296692058,MATH 103A,B03,093562,Staff,1,0,36,35
1656296698082,MATH 105,A01,085443,Carter; Anne Toulson,5,0,35,30
1656296698082,MATH 105,A02,093477,Staff,14,0,35,21
1656296704107,MATH 109,A01,083213,Ganzberger; Geoffrey Michael,1,0,34,33
1656296704107,MATH 109,A02,083214,Ganzberger; Geoffrey Michael,0,0,34,34
1656296704107,MATH 109,A03,093478,Staff,2,0,34,32
1656296704107,MATH 109,B01,083215,Ganzberger; Geoffrey Michael,4,0,32,28
1656296704107,MATH 109,B02,083216,Ganzberger; Geoffrey Michael,1,0,32,31
1656296704107,MATH 109,B03,093479,Staff,3,0,32,29
1656296710130,MATH 142A,A01,083219,Chow; Bennett,1,0,32,31
1656296710130,MATH 142A,A02,083220,Chow; Bennett,8,0,32,24
1656296710130,MATH 142A,A03,093480,Staff,5,0,32,27
1656296710130,MATH 142A,B03,093481,Staff,3,0,32,29
1656296710130,MATH 142A,B04,093558,Staff,6,0,32,26
1656296710130,MATH 142A,B05,093559,Staff,0,0,32,32
1656296716153,MATH 193A,A01,083224,Rotar; Vladimir,0,1,34,34
1656296716153,MATH 193A,A02,083225,Rotar; Vladimir,0,0,34,34
1656296716153,MATH 193A,A03,083781,Rotar; Vladimir,0,0,34,34
1656296716153,MATH 193A,A04,083782,Rotar; Vladimir,6,0,34,28
1656296716153,MATH 193A,A05,093482,Rotar; Vladimir,0,0,34,34
1656296722176,MATH 197,001,091859,McAuley; Julian John,9999,0,9999,0
1656296722176,MATH 197,002,095566,Kedlaya; Kiran S.,9997,0,9999,2
1656296722176,MATH 197,003,095567,Xiao; Ming,9999,0,9999,0
1656296722176,MATH 197,004,095571,Perols; Johan Lars,9998,0,9999,1
1656296729237,COGS 9,A01,083615,Shannon; Kyle Michael,3,0,75,72
1656296735266,COGS 11,A01,083617,Boyle; Mary E. T.,15,0,48,33
1656296741292,COGS 13,A01,083071,Bastos; Amalia Pinkusfeld,5,0,71,66
1656296747315,COGS 14A,A01,092681,Semenuks; Arturs,1,13,100,99
1656296753338,COGS 14B,A01,083073,Cheng; Tzu-Han,7,0,63,56
1656296759361,COGS 17,A01,092677,Semenuks; Arturs,6,0,81,75
1656296765386,COGS 100,A01,083619,Allen; Michael Gordon,2,0,70,68
1656296771413,COGS 101A,A01,083621,Davis; Joshua Daniel,4,0,68,64
1656296777436,COGS 101B,A01,091572,Allen; Michael Gordon,4,0,65,61
1656296783460,COGS 101C,A01,083625,Delgado; Tania,11,0,35,24
1656296789483,COGS 107A,A01,083627,Boyle; Mary E. T.,0,0,60,60
1656296795507,COGS 118A,A01,083075,Gupta; Anjum,8,0,76,68
1656296801535,CSE 3,A50,083646,Miranda; Gregory Joseph,18,0,50,32
1656296807559,CSE 8A,A50,083650,Miranda; Gregory Joseph,3,3,56,53
1656296813594,CSE 11,A01,083080,Cao; Yingjun,0,48,40,40
1656296819618,CSE 12,A01,083652,Krause-Levy; Sophia Louisa,5,1,120,115
1656296825647,CSE 15L,A01,083654,Morris; Justin Loren,2,0,50,48
1656296825647,CSE 15L,A02,083655,Morris; Justin Loren,4,0,50,46
1656296831671,CSE 20,A01,083657,Tran; Khoa Dang,30,0,80,50
1656296837706,CSE 21,A01,095574,Bach; Quang Tran,23,0,48,25
1656296843730,CSE 30,A01,083084,Eldon; John,2,6,80,78
1656296843730,CSE 30,B01,095061,Bhaskar; Nishant,0,1,50,50
1656296849757,CSE 100,A01,083659,Cao; Yingjun,1,18,70,69
1656296855785,CSE 134B,A01,083661,Powell; Thomas Allan,6,0,100,94
1656296861812,CSE 140,A01,083663,Gungor; Onat,9,0,85,76
1656296867835,CSE 140L,A01,083088,Eldon; John,10,0,100,90
1656296873860,CSE 175,A01,083665,Kumar; Rakesh,0,0,25,25
1656296879883,CSE 190,A00,092507,Dubnov; Shlomo,3,0,20,17
1656296885911,ECE 45,A01,083139,Congero; Spencer William,1,0,75,74
1656296891939,ECE 65,A50,083695,Saad; Andrew S,9,0,30,21
1656296891939,ECE 65,A51,095125,Staff,24,0,26,2
1656296897962,ECE 109,A01,091882,Touri; Behrouz,1,1,70,69
1656296903984,ECE 180,A00,083140,Abi Samra; Nicholas Camill,2,0,30,28
1656296903984,ECE 180,B00,083141,Abi Samra; Nicholas Camill,0,4,30,30
1656296910012,MATH 10A,A01,083735,Patchell; Gregory David,0,0,30,30
1656296910012,MATH 10A,A02,083736,Patchell; Gregory David,22,0,30,8
1656296910012,MATH 10A,A03,083737,Patchell; Gregory David,16,0,30,14
1656296916036,MATH 10B,A01,083207,Lim; Seonhee,2,0,34,32
1656296916036,MATH 10B,A02,083208,Lim; Seonhee,6,0,35,29
1656296916036,MATH 10B,A03,093472,Staff,1,0,34,33
1656296916036,MATH 10B,B01,083739,Sinha; Shubham,11,0,30,19
1656296922061,MATH 18,A01,083743,Cinel; Cameron Alexander,7,0,30,23
1656296922061,MATH 18,A02,083744,Cinel; Cameron Alexander,9,0,30,21
1656296922061,MATH 18,A03,083745,Cinel; Cameron Alexander,5,0,30,25
1656296922061,MATH 18,B01,083748,Rideout; David Porter,1,0,36,35
1656296922061,MATH 18,B02,083749,Rideout; David Porter,0,0,36,36
1656296922061,MATH 18,B03,083750,Rideout; David Porter,0,0,36,36
1656296922061,MATH 18,B04,083751,Rideout; David Porter,0,1,36,36
1656296922061,MATH 18,B05,093473,Rideout; David Porter,0,0,36,36
1656296922061,MATH 18,B06,093474,Rideout; David Porter,3,0,36,33
1656296928092,MATH 20A,A01,083754,Zheng; Zequn,11,0,40,29
1656296934119,MATH 20B,A01,083756,Briones; Jor-el Thomas Caparas,0,0,36,36
1656296934119,MATH 20B,A02,083757,Briones; Jor-el Thomas Caparas,0,0,36,36
1656296934119,MATH 20B,A03,093475,Staff,1,0,36,35
1656296940142,MATH 20C,A01,083760,Briones; Jor-el Thomas Caparas,0,0,35,35
1656296940142,MATH 20C,A02,083761,Briones; Jor-el Thomas Caparas,9,1,35,26
1656296940142,MATH 20C,A03,093476,Staff,0,0,35,35
1656296940142,MATH 20C,B01,083762,Bach; Quang Tran,2,0,30,28
1656296946171,MATH 20D,A01,083765,Tran; Brian Kha,1,0,30,29
1656296946171,MATH 20D,A02,083766,Tran; Brian Kha,1,1,30,29
1656296946171,MATH 20D,A03,083767,Tran; Brian Kha,2,0,30,28
1656296952200,MATH 20E,A01,083771,Ganguly; Soumya,3,0,32,29
1656296952200,MATH 20E,A02,083772,Ganguly; Soumya,0,0,32,32
1656296952200,MATH 20E,B01,083773,Ciotti; Benjamin,17,0,35,18
1656296952200,MATH 20E,B02,083774,Ciotti; Benjamin,15,0,35,20
1656296958222,MATH 103A,A01,083777,Greenfeld; Be'Eri,1,0,36,35
1656296958222,MATH 103A,A02,083778,Greenfeld; Be'Eri,3,0,36,33
1656296958222,MATH 103A,A03,093561,Staff,4,0,36,32
1656296958222,MATH 103A,B01,083779,Greenfeld; Be'Eri,8,0,36,28
1656296958222,MATH 103A,B02,083780,Greenfeld; Be'Eri,0,0,36,36
1656296958222,MATH 103A,B03,093562,Staff,1,0,36,35
1656296964249,MATH 105,A01,085443,Carter; Anne Toulson,5,0,35,30
1656296964249,MATH 105,A02,093477,Staff,14,0,35,21
1656296970280,MATH 109,A01,083213,Ganzberger; Geoffrey Michael,1,0,34,33
1656296970280,MATH 109,A02,083214,Ganzberger; Geoffrey Michael,0,0,34,34
1656296970280,MATH 109,A03,093478,Staff,2,0,34,32
1656296970280,MATH 109,B01,083215,Ganzberger; Geoffrey Michael,4,0,32,28
1656296970280,MATH 109,B02,083216,Ganzberger; Geoffrey Michael,1,0,32,31
1656296970280,MATH 109,B03,093479,Staff,3,0,32,29
1656296976303,MATH 142A,A01,083219,Chow; Bennett,1,0,32,31
1656296976303,MATH 142A,A02,083220,Chow; Bennett,8,0,32,24
1656296976303,MATH 142A,A03,093480,Staff,5,0,32,27
1656296976303,MATH 142A,B03,093481,Staff,3,0,32,29
1656296976303,MATH 142A,B04,093558,Staff,6,0,32,26
1656296976303,MATH 142A,B05,093559,Staff,0,0,32,32
1656296982340,MATH 193A,A01,083224,Rotar; Vladimir,0,1,34,34
1656296982340,MATH 193A,A02,083225,Rotar; Vladimir,0,0,34,34
1656296982340,MATH 193A,A03,083781,Rotar; Vladimir,0,0,34,34
1656296982340,MATH 193A,A04,083782,Rotar; Vladimir,6,0,34,28
1656296982340,MATH 193A,A05,093482,Rotar; Vladimir,0,0,34,34
1656296988363,MATH 197,001,091859,McAuley; Julian John,9999,0,9999,0
1656296988363,MATH 197,002,095566,Kedlaya; Kiran S.,9997,0,9999,2
1656296988363,MATH 197,003,095567,Xiao; Ming,9999,0,9999,0
1656296988363,MATH 197,004,095571,Perols; Johan Lars,9998,0,9999,1
1656296995420,COGS 9,A01,083615,Shannon; Kyle Michael,3,0,75,72
1656297001446,COGS 11,A01,083617,Boyle; Mary E. T.,15,0,48,33
1656297007467,COGS 13,A01,083071,Bastos; Amalia Pinkusfeld,5,0,71,66
1656297013494,COGS 14A,A01,092681,Semenuks; Arturs,1,13,100,99
1656297019529,COGS 14B,A01,083073,Cheng; Tzu-Han,7,0,63,56
1656297025553,COGS 17,A01,092677,Semenuks; Arturs,6,0,81,75
1656297031584,COGS 100,A01,083619,Allen; Michael Gordon,2,0,70,68
1656297037610,COGS 101A,A01,083621,Davis; Joshua Daniel,4,0,68,64
1656297043633,COGS 101B,A01,091572,Allen; Michael Gordon,4,0,65,61
1656297049658,COGS 101C,A01,083625,Delgado; Tania,11,0,35,24
1656297055682,COGS 107A,A01,083627,Boyle; Mary E. T.,0,0,60,60
1656297061708,COGS 118A,A01,083075,Gupta; Anjum,8,0,76,68
1656297067738,CSE 3,A50,083646,Miranda; Gregory Joseph,18,0,50,32
1656297073774,CSE 8A,A50,083650,Miranda; Gregory Joseph,3,3,56,53
1656297079803,CSE 11,A01,083080,Cao; Yingjun,0,48,40,40
1656297085830,CSE 12,A01,083652,Krause-Levy; Sophia Louisa,5,1,120,115
1656297091853,CSE 15L,A01,083654,Morris; Justin Loren,2,0,50,48
1656297091853,CSE 15L,A02,083655,Morris; Justin Loren,4,0,50,46
1656297097881,CSE 20,A01,083657,Tran; Khoa Dang,30,0,80,50
1656297103996,CSE 21,A01,095574,Bach; Quang Tran,23,0,48,25
1656297110019,CSE 30,A01,083084,Eldon; John,2,6,80,78
1656297110019,CSE 30,B01,095061,Bhaskar; Nishant,0,1,50,50
1656297116046,CSE 100,A01,083659,Cao; Yingjun,1,18,70,69
1656297122071,CSE 134B,A01,083661,Powell; Thomas Allan,6,0,100,94
1656297128098,CSE 140,A01,083663,Gungor; Onat,9,0,85,76
1656297134123,CSE 140L,A01,083088,Eldon; John,10,0,100,90
1656297140154,CSE 175,A01,083665,Kumar; Rakesh,0,0,25,25
1656297146177,CSE 190,A00,092507,Dubnov; Shlomo,3,0,20,17
1656297152199,ECE 45,A01,083139,Congero; Spencer William,1,0,75,74
1656297158226,ECE 65,A50,083695,Saad; Andrew S,9,0,30,21
1656297158226,ECE 65,A51,095125,Staff,24,0,26,2
1656297164249,ECE 109,A01,091882,Touri; Behrouz,1,1,70,69
1656297170271,ECE 180,A00,083140,Abi Samra; Nicholas Camill,2,0,30,28
1656297170271,ECE 180,B00,083141,Abi Samra; Nicholas Camill,0,4,30,30
1656297176295,MATH 10A,A01,083735,Patchell; Gregory David,0,0,30,30
1656297176295,MATH 10A,A02,083736,Patchell; Gregory David,22,0,30,8
1656297176295,MATH 10A,A03,083737,Patchell; Gregory David,16,0,30,14
1656297182325,MATH 10B,A01,083207,Lim; Seonhee,1,0,34,33
1656297182325,MATH 10B,A02,083208,Lim; Seonhee,6,0,35,29
1656297182325,MATH 10B,A03,093472,Staff,1,0,34,33
1656297182325,MATH 10B,B01,083739,Sinha; Shubham,11,0,30,19
1656297188357,MATH 18,A01,083743,Cinel; Cameron Alexander,7,0,30,23
1656297188357,MATH 18,A02,083744,Cinel; Cameron Alexander,9,0,30,21
1656297188357,MATH 18,A03,083745,Cinel; Cameron Alexander,5,0,30,25
1656297188357,MATH 18,B01,083748,Rideout; David Porter,1,0,36,35
1656297188357,MATH 18,B02,083749,Rideout; David Porter,0,0,36,36
1656297188357,MATH 18,B03,083750,Rideout; David Porter,0,0,36,36
1656297188357,MATH 18,B04,083751,Rideout; David Porter,0,1,36,36
1656297188357,MATH 18,B05,093473,Rideout; David Porter,0,0,36,36
1656297188357,MATH 18,B06,093474,Rideout; David Porter,3,0,36,33
1656297194380,MATH 20A,A01,083754,Zheng; Zequn,11,0,40,29
1656297200408,MATH 20B,A01,083756,Briones; Jor-el Thomas Caparas,0,0,36,36
1656297200408,MATH 20B,A02,083757,Briones; Jor-el Thomas Caparas,0,0,36,36
1656297200408,MATH 20B,A03,093475,Staff,1,0,36,35
1656297206431,MATH 20C,A01,083760,Briones; Jor-el Thomas Caparas,0,0,35,35
1656297206431,MATH 20C,A02,083761,Briones; Jor-el Thomas Caparas,9,1,35,26
1656297206431,MATH 20C,A03,093476,Staff,0,0,35,35
1656297206431,MATH 20C,B01,083762,Bach; Quang Tran,2,0,30,28
1656297212457,MATH 20D,A01,083765,Tran; Brian Kha,1,0,30,29
1656297212457,MATH 20D,A02,083766,Tran; Brian Kha,1,1,30,29
1656297212457,MATH 20D,A03,083767,Tran; Brian Kha,2,0,30,28
1656297218483,MATH 20E,A01,083771,Ganguly; Soumya,3,0,32,29
1656297218483,MATH 20E,A02,083772,Ganguly; Soumya,0,0,32,32
1656297218483,MATH 20E,B01,083773,Ciotti; Benjamin,17,0,35,18
1656297218483,MATH 20E,B02,083774,Ciotti; Benjamin,15,0,35,20
1656297224517,MATH 103A,A01,083777,Greenfeld; Be'Eri,1,0,36,35
1656297224517,MATH 103A,A02,083778,Greenfeld; Be'Eri,3,0,36,33
1656297224517,MATH 103A,A03,093561,Staff,4,0,36,32
1656297224517,MATH 103A,B01,083779,Greenfeld; Be'Eri,8,0,36,28
1656297224517,MATH 103A,B02,083780,Greenfeld; Be'Eri,0,0,36,36
1656297224517,MATH 103A,B03,093562,Staff,1,0,36,35
1656297230540,MATH 105,A01,085443,Carter; Anne Toulson,5,0,35,30
1656297230540,MATH 105,A02,093477,Staff,14,0,35,21
1656297236563,MATH 109,A01,083213,Ganzberger; Geoffrey Michael,1,0,34,33
1656297236563,MATH 109,A02,083214,Ganzberger; Geoffrey Michael,0,0,34,34
1656297236563,MATH 109,A03,093478,Staff,2,0,34,32
1656297236563,MATH 109,B01,083215,Ganzberger; Geoffrey Michael,4,0,32,28
1656297236563,MATH 109,B02,083216,Ganzberger; Geoffrey Michael,1,0,32,31
1656297236563,MATH 109,B03,093479,Staff,3,0,32,29
1656297242586,MATH 142A,A01,083219,Chow; Bennett,1,0,32,31
1656297242586,MATH 142A,A02,083220,Chow; Bennett,8,0,32,24
1656297242586,MATH 142A,A03,093480,Staff,5,0,32,27
1656297242586,MATH 142A,B03,093481,Staff,3,0,32,29
1656297242586,MATH 142A,B04,093558,Staff,6,0,32,26
1656297242586,MATH 142A,B05,093559,Staff,0,0,32,32
1656297248615,MATH 193A,A01,083224,Rotar; Vladimir,0,1,34,34
1656297248615,MATH 193A,A02,083225,Rotar; Vladimir,0,0,34,34
1656297248615,MATH 193A,A03,083781,Rotar; Vladimir,0,0,34,34
1656297248615,MATH 193A,A04,083782,Rotar; Vladimir,6,0,34,28
1656297248615,MATH 193A,A05,093482,Rotar; Vladimir,0,0,34,34
1656297254640,MATH 197,001,091859,McAuley; Julian John,9999,0,9999,0
1656297254640,MATH 197,002,095566,Kedlaya; Kiran S.,9997,0,9999,2
1656297254640,MATH 197,003,095567,Xiao; Ming,9999,0,9999,0
1656297254640,MATH 197,004,095571,Perols; Johan Lars,9998,0,9999,1
1656297261693,COGS 9,A01,083615,Shannon; Kyle Michael,3,0,75,72
1656297267715,COGS 11,A01,083617,Boyle; Mary E. T.,15,0,48,33
1656297273741,COGS 13,A01,083071,Bastos; Amalia Pinkusfeld,5,0,71,66
1656297279765,COGS 14A,A01,092681,Semenuks; Arturs,1,13,100,99
1656297285791,COGS 14B,A01,083073,Cheng; Tzu-Han,7,0,63,56
1656297291812,COGS 17,A01,092677,Semenuks; Arturs,6,0,81,75
1656297297835,COGS 100,A01,083619,Allen; Michael Gordon,2,0,70,68
1656297303872,COGS 101A,A01,083621,Davis; Joshua Daniel,4,0,68,64
1656297309896,COGS 101B,A01,091572,Allen; Michael Gordon,4,0,65,61
1656297315923,COGS 101C,A01,083625,Delgado; Tania,11,0,35,24
1656297321946,COGS 107A,A01,083627,Boyle; Mary E. T.,0,0,60,60
1656297327973,COGS 118A,A01,083075,Gupta; Anjum,8,0,76,68
1656297334000,CSE 3,A50,083646,Miranda; Gregory Joseph,18,0,50,32
1656297340024,CSE 8A,A50,083650,Miranda; Gregory Joseph,3,3,56,53
1656297346051,CSE 11,A01,083080,Cao; Yingjun,0,48,40,40
1656297352074,CSE 12,A01,083652,Krause-Levy; Sophia Louisa,5,1,120,115
1656297358100,CSE 15L,A01,083654,Morris; Justin Loren,2,0,50,48
1656297358100,CSE 15L,A02,083655,Morris; Justin Loren,4,0,50,46
1656297364131,CSE 20,A01,083657,Tran; Khoa Dang,30,0,80,50
1656297370160,CSE 21,A01,095574,Bach; Quang Tran,23,0,48,25
1656297376188,CSE 30,A01,083084,Eldon; John,2,6,80,78
1656297376188,CSE 30,B01,095061,Bhaskar; Nishant,0,1,50,50
1656297382211,CSE 100,A01,083659,Cao; Yingjun,1,18,70,69
1656297388234,CSE 134B,A01,083661,Powell; Thomas Allan,6,0,100,94
1656297394260,CSE 140,A01,083663,Gungor; Onat,9,0,85,76
1656297400283,CSE 140L,A01,083088,Eldon; John,10,0,100,90
1656297406308,CSE 175,A01,083665,Kumar; Rakesh,0,0,25,25
1656297412331,CSE 190,A00,092507,Dubnov; Shlomo,3,0,20,17
1656297418361,ECE 45,A01,083139,Congero; Spencer William,1,0,75,74
1656297424396,ECE 65,A50,083695,Saad; Andrew S,9,0,30,21
1656297424396,ECE 65,A51,095125,Staff,24,0,26,2
1656297430420,ECE 109,A01,091882,Touri; Behrouz,1,1,70,69
1656297436443,ECE 180,A00,083140,Abi Samra; Nicholas Camill,2,0,30,28
1656297436443,ECE 180,B00,083141,Abi Samra; Nicholas Camill,0,4,30,30
1656297442465,MATH 10A,A01,083735,Patchell; Gregory David,0,0,30,30
1656297442465,MATH 10A,A02,083736,Patchell; Gregory David,22,0,30,8
1656297442465,MATH 10A,A03,083737,Patchell; Gregory David,16,0,30,14
1656297448487,MATH 10B,A01,083207,Lim; Seonhee,2,0,34,32
1656297448487,MATH 10B,A02,083208,Lim; Seonhee,5,0,35,30
1656297448487,MATH 10B,A03,093472,Staff,1,0,34,33
1656297448487,MATH 10B,B01,083739,Sinha; Shubham,11,0,30,19
1656297454517,MATH 18,A01,083743,Cinel; Cameron Alexander,7,0,30,23
1656297454517,MATH 18,A02,083744,Cinel; Cameron Alexander,9,0,30,21
1656297454517,MATH 18,A03,083745,Cinel; Cameron Alexander,5,0,30,25
1656297454517,MATH 18,B01,083748,Rideout; David Porter,1,0,36,35
1656297454517,MATH 18,B02,083749,Rideout; David Porter,0,0,36,36
1656297454517,MATH 18,B03,083750,Rideout; David Porter,0,0,36,36
1656297454517,MATH 18,B04,083751,Rideout; David Porter,0,1,36,36
1656297454517,MATH 18,B05,093473,Rideout; David Porter,0,0,36,36
1656297454517,MATH 18,B06,093474,Rideout; David Porter,3,0,36,33
1656297460540,MATH 20A,A01,083754,Zheng; Zequn,11,0,40,29
1656297466563,MATH 20B,A01,083756,Briones; Jor-el Thomas Caparas,0,0,36,36
1656297466563,MATH 20B,A02,083757,Briones; Jor-el Thomas Caparas,0,0,36,36
1656297466563,MATH 20B,A03,093475,Staff,1,0,36,35
1656297472587,MATH 20C,A01,083760,Briones; Jor-el Thomas Caparas,0,0,35,35
1656297472587,MATH 20C,A02,083761,Briones; Jor-el Thomas Caparas,9,1,35,26
1656297472587,MATH 20C,A03,093476,Staff,0,0,35,35
1656297472587,MATH 20C,B01,083762,Bach; Quang Tran,2,0,30,28
1656297478612,MATH 20D,A01,083765,Tran; Brian Kha,1,0,30,29
1656297478612,MATH 20D,A02,083766,Tran; Brian Kha,1,1,30,29
1656297478612,MATH 20D,A03,083767,Tran; Brian Kha,2,0,30,28
1656297484635,MATH 20E,A01,083771,Ganguly; Soumya,2,0,32,30
1656297484635,MATH 20E,A02,083772,Ganguly; Soumya,0,0,32,32
1656297484635,MATH 20E,B01,083773,Ciotti; Benjamin,18,0,35,17
1656297484635,MATH 20E,B02,083774,Ciotti; Benjamin,15,0,35,20
1656297490657,MATH 103A,A01,083777,Greenfeld; Be'Eri,1,0,36,35
1656297490657,MATH 103A,A02,083778,Greenfeld; Be'Eri,3,0,36,33
1656297490657,MATH 103A,A03,093561,Staff,4,0,36,32
1656297490657,MATH 103A,B01,083779,Greenfeld; Be'Eri,8,0,36,28
1656297490657,MATH 103A,B02,083780,Greenfeld; Be'Eri,0,0,36,36
1656297490657,MATH 103A,B03,093562,Staff,1,0,36,35
1656297496682,MATH 105,A01,085443,Carter; Anne Toulson,5,0,35,30
1656297496682,MATH 105,A02,093477,Staff,14,0,35,21
1656297502711,MATH 109,A01,083213,Ganzberger; Geoffrey Michael,1,0,34,33
1656297502711,MATH 109,A02,083214,Ganzberger; Geoffrey Michael,0,0,34,34
1656297502711,MATH 109,A03,093478,Staff,2,0,34,32
1656297502711,MATH 109,B01,083215,Ganzberger; Geoffrey Michael,4,0,32,28
1656297502711,MATH 109,B02,083216,Ganzberger; Geoffrey Michael,1,0,32,31
1656297502711,MATH 109,B03,093479,Staff,3,0,32,29
1656297508746,MATH 142A,A01,083219,Chow; Bennett,1,0,32,31
1656297508746,MATH 142A,A02,083220,Chow; Bennett,8,0,32,24
1656297508746,MATH 142A,A03,093480,Staff,5,0,32,27
1656297508746,MATH 142A,B03,093481,Staff,3,0,32,29
1656297508746,MATH 142A,B04,093558,Staff,6,0,32,26
1656297508746,MATH 142A,B05,093559,Staff,0,0,32,32
1656297514783,MATH 193A,A01,083224,Rotar; Vladimir,0,1,34,34
1656297514783,MATH 193A,A02,083225,Rotar; Vladimir,0,0,34,34
1656297514783,MATH 193A,A03,083781,Rotar; Vladimir,0,0,34,34
1656297514783,MATH 193A,A04,083782,Rotar; Vladimir,6,0,34,28
1656297514783,MATH 193A,A05,093482,Rotar; Vladimir,0,0,34,34
1656297520806,MATH 197,001,091859,McAuley; Julian John,9999,0,9999,0
1656297520806,MATH 197,002,095566,Kedlaya; Kiran S.,9997,0,9999,2
1656297520806,MATH 197,003,095567,Xiao; Ming,9999,0,9999,0
1656297520806,MATH 197,004,095571,Perols; Johan Lars,9998,0,9999,1
1656297527867,COGS 9,A01,083615,Shannon; Kyle Michael,3,0,75,72
1656297533893,COGS 11,A01,083617,Boyle; Mary E. T.,15,0,48,33
1656297539921,COGS 13,A01,083071,Bastos; Amalia Pinkusfeld,5,0,71,66
1656297545951,COGS 14A,A01,092681,Semenuks; Arturs,1,13,100,99
1656297551978,COGS 14B,A01,083073,Cheng; Tzu-Han,7,0,63,56
1656297558005,COGS 17,A01,092677,Semenuks; Arturs,6,0,81,75
1656297564028,COGS 100,A01,083619,Allen; Michael Gordon,2,0,70,68
1656297570051,COGS 101A,A01,083621,Davis; Joshua Daniel,4,0,68,64
1656297576074,COGS 101B,A01,091572,Allen; Michael Gordon,4,0,65,61
1656297582099,COGS 101C,A01,083625,Delgado; Tania,11,0,35,24
1656297588123,COGS 107A,A01,083627,Boyle; Mary E. T.,0,0,60,60
1656297594150,COGS 118A,A01,083075,Gupta; Anjum,8,0,76,68
1656297600178,CSE 3,A50,083646,Miranda; Gregory Joseph,18,0,50,32
1656297606202,CSE 8A,A50,083650,Miranda; Gregory Joseph,3,3,56,53
1656297612225,CSE 11,A01,083080,Cao; Yingjun,0,48,40,40
1656297618248,CSE 12,A01,083652,Krause-Levy; Sophia Louisa,5,1,120,115
1656297624270,CSE 15L,A01,083654,Morris; Justin Loren,2,0,50,48
1656297624270,CSE 15L,A02,083655,Morris; Justin Loren,4,0,50,46
1656297630293,CSE 20,A01,083657,Tran; Khoa Dang,30,0,80,50
1656297636318,CSE 21,A01,095574,Bach; Quang Tran,23,0,48,25
1656297642341,CSE 30,A01,083084,Eldon; John,2,6,80,78
1656297642341,CSE 30,B01,095061,Bhaskar; Nishant,0,1,50,50
1656297648364,CSE 100,A01,083659,Cao; Yingjun,1,18,70,69
1656297654392,CSE 134B,A01,083661,Powell; Thomas Allan,6,0,100,94
1656297660419,CSE 140,A01,083663,Gungor; Onat,9,0,85,76
1656297666441,CSE 140L,A01,083088,Eldon; John,10,0,100,90
1656297672468,CSE 175,A01,083665,Kumar; Rakesh,0,0,25,25
1656297678493,CSE 190,A00,092507,Dubnov; Shlomo,3,0,20,17
1656297684516,ECE 45,A01,083139,Congero; Spencer William,1,0,75,74
1656297690541,ECE 65,A50,083695,Saad; Andrew S,9,0,30,21
1656297690541,ECE 65,A51,095125,Staff,24,0,26,2
1656297696567,ECE 109,A01,091882,Touri; Behrouz,1,1,70,69
1656297702673,ECE 180,A00,083140,Abi Samra; Nicholas Camill,2,0,30,28
1656297702673,ECE 180,B00,083141,Abi Samra; Nicholas Camill,0,4,30,30
1656297708701,MATH 10A,A01,083735,Patchell; Gregory David,0,0,30,30
1656297708701,MATH 10A,A02,083736,Patchell; Gregory David,22,0,30,8
1656297708701,MATH 10A,A03,083737,Patchell; Gregory David,16,0,30,14
1656297714728,MATH 10B,A01,083207,Lim; Seonhee,2,0,34,32
1656297714728,MATH 10B,A02,083208,Lim; Seonhee,5,0,35,30
1656297714728,MATH 10B,A03,093472,Staff,1,0,34,33
1656297714728,MATH 10B,B01,083739,Sinha; Shubham,11,0,30,19
1656297720754,MATH 18,A01,083743,Cinel; Cameron Alexander,7,0,30,23
1656297720754,MATH 18,A02,083744,Cinel; Cameron Alexander,9,0,30,21
1656297720754,MATH 18,A03,083745,Cinel; Cameron Alexander,5,0,30,25
1656297720754,MATH 18,B01,083748,Rideout; David Porter,1,0,36,35
1656297720754,MATH 18,B02,083749,Rideout; David Porter,0,0,36,36
1656297720754,MATH 18,B03,083750,Rideout; David Porter,0,0,36,36
1656297720754,MATH 18,B04,083751,Rideout; David Porter,0,1,36,36
1656297720754,MATH 18,B05,093473,Rideout; David Porter,0,0,36,36
1656297720754,MATH 18,B06,093474,Rideout; David Porter,3,0,36,33
1656297726794,MATH 20A,A01,083754,Zheng; Zequn,11,0,40,29
1656297732821,MATH 20B,A01,083756,Briones; Jor-el Thomas Caparas,0,0,36,36
1656297732821,MATH 20B,A02,083757,Briones; Jor-el Thomas Caparas,0,0,36,36
1656297732821,MATH 20B,A03,093475,Staff,1,0,36,35
1656297738849,MATH 20C,A01,083760,Briones; Jor-el Thomas Caparas,0,0,35,35
1656297738849,MATH 20C,A02,083761,Briones; Jor-el Thomas Caparas,9,1,35,26
1656297738849,MATH 20C,A03,093476,Staff,0,0,35,35
1656297738849,MATH 20C,B01,083762,Bach; Quang Tran,2,0,30,28
1656297744873,MATH 20D,A01,083765,Tran; Brian Kha,1,0,30,29
1656297744873,MATH 20D,A02,083766,Tran; Brian Kha,1,1,30,29
1656297744873,MATH 20D,A03,083767,Tran; Brian Kha,2,0,30,28
1656297750920,MATH 20E,A01,083771,Ganguly; Soumya,2,0,32,30
1656297750920,MATH 20E,A02,083772,Ganguly; Soumya,0,0,32,32
1656297750920,MATH 20E,B01,083773,Ciotti; Benjamin,18,0,35,17
1656297750920,MATH 20E,B02,083774,Ciotti; Benjamin,15,0,35,20
1656297756944,MATH 103A,A01,083777,Greenfeld; Be'Eri,1,0,36,35
1656297756944,MATH 103A,A02,083778,Greenfeld; Be'Eri,3,0,36,33
1656297756944,MATH 103A,A03,093561,Staff,4,0,36,32
1656297756944,MATH 103A,B01,083779,Greenfeld; Be'Eri,8,0,36,28
1656297756944,MATH 103A,B02,083780,Greenfeld; Be'Eri,0,0,36,36
1656297756944,MATH 103A,B03,093562,Staff,1,0,36,35
1656297762971,MATH 105,A01,085443,Carter; Anne Toulson,5,0,35,30
1656297762971,MATH 105,A02,093477,Staff,14,0,35,21
1656297768995,MATH 109,A01,083213,Ganzberger; Geoffrey Michael,1,0,34,33
1656297768995,MATH 109,A02,083214,Ganzberger; Geoffrey Michael,0,0,34,34
1656297768995,MATH 109,A03,093478,Staff,2,0,34,32
1656297768995,MATH 109,B01,083215,Ganzberger; Geoffrey Michael,4,0,32,28
1656297768995,MATH 109,B02,083216,Ganzberger; Geoffrey Michael,1,0,32,31
1656297768995,MATH 109,B03,093479,Staff,3,0,32,29
1656297775023,MATH 142A,A01,083219,Chow; Bennett,1,0,32,31
1656297775023,MATH 142A,A02,083220,Chow; Bennett,8,0,32,24
1656297775023,MATH 142A,A03,093480,Staff,5,0,32,27
1656297775023,MATH 142A,B03,093481,Staff,3,0,32,29
1656297775023,MATH 142A,B04,093558,Staff,6,0,32,26
1656297775023,MATH 142A,B05,093559,Staff,0,0,32,32
1656297781048,MATH 193A,A01,083224,Rotar; Vladimir,0,1,34,34
1656297781048,MATH 193A,A02,083225,Rotar; Vladimir,0,0,34,34
1656297781048,MATH 193A,A03,083781,Rotar; Vladimir,0,0,34,34
1656297781048,MATH 193A,A04,083782,Rotar; Vladimir,6,0,34,28
1656297781048,MATH 193A,A05,093482,Rotar; Vladimir,0,0,34,34
1656297787079,MATH 197,001,091859,McAuley; Julian John,9999,0,9999,0
1656297787079,MATH 197,002,095566,Kedlaya; Kiran S.,9997,0,9999,2
1656297787079,MATH 197,003,095567,Xiao; Ming,9999,0,9999,0
1656297787079,MATH 197,004,095571,Perols; Johan Lars,9998,0,9999,1
1656297794136,COGS 9,A01,083615,Shannon; Kyle Michael,3,0,75,72
1656297800161,COGS 11,A01,083617,Boyle; Mary E. T.,15,0,48,33
1656297806185,COGS 13,A01,083071,Bastos; Amalia Pinkusfeld,5,0,71,66
1656297812217,COGS 14A,A01,092681,Semenuks; Arturs,1,13,100,99
1656297818241,COGS 14B,A01,083073,Cheng; Tzu-Han,7,0,63,56
1656297824265,COGS 17,A01,092677,Semenuks; Arturs,6,0,81,75
1656297830288,COGS 100,A01,083619,Allen; Michael Gordon,2,0,70,68
1656297836312,COGS 101A,A01,083621,Davis; Joshua Daniel,4,0,68,64
1656297842348,COGS 101B,A01,091572,Allen; Michael Gordon,4,0,65,61
1656297848375,COGS 101C,A01,083625,Delgado; Tania,11,0,35,24
1656297854410,COGS 107A,A01,083627,Boyle; Mary E. T.,0,0,60,60
1656297860437,COGS 118A,A01,083075,Gupta; Anjum,8,0,76,68
1656297866460,CSE 3,A50,083646,Miranda; Gregory Joseph,18,0,50,32
1656297872483,CSE 8A,A50,083650,Miranda; Gregory Joseph,3,3,56,53
1656297878511,CSE 11,A01,083080,Cao; Yingjun,0,48,40,40
1656297884538,CSE 12,A01,083652,Krause-Levy; Sophia Louisa,5,1,120,115
1656297890565,CSE 15L,A01,083654,Morris; Justin Loren,2,0,50,48
1656297890565,CSE 15L,A02,083655,Morris; Justin Loren,4,0,50,46
1656297896588,CSE 20,A01,083657,Tran; Khoa Dang,30,0,80,50
1656297902614,CSE 21,A01,095574,Bach; Quang Tran,23,0,48,25
1656297908638,CSE 30,A01,083084,Eldon; John,2,6,80,78
1656297908638,CSE 30,B01,095061,Bhaskar; Nishant,0,1,50,50
1656297914660,CSE 100,A01,083659,Cao; Yingjun,1,18,70,69
1656297920689,CSE 134B,A01,083661,Powell; Thomas Allan,6,0,100,94
1656297926714,CSE 140,A01,083663,Gungor; Onat,9,0,85,76
1656297932738,CSE 140L,A01,083088,Eldon; John,10,0,100,90
1656297938761,CSE 175,A01,083665,Kumar; Rakesh,0,0,25,25
1656297944783,CSE 190,A00,092507,Dubnov; Shlomo,3,0,20,17
1656297950812,ECE 45,A01,083139,Congero; Spencer William,1,0,75,74
1656297956839,ECE 65,A50,083695,Saad; Andrew S,9,0,30,21
1656297956839,ECE 65,A51,095125,Staff,24,0,26,2
1656297969705,ECE 109,A01,091882,Touri; Behrouz,1,1,70,69
1656297975729,ECE 180,A00,083140,Abi Samra; Nicholas Camill,2,0,30,28
1656297975729,ECE 180,B00,083141,Abi Samra; Nicholas Camill,0,4,30,30
1656297981756,MATH 10A,A01,083735,Patchell; Gregory David,0,0,30,30
1656297981756,MATH 10A,A02,083736,Patchell; Gregory David,22,0,30,8
1656297981756,MATH 10A,A03,083737,Patchell; Gregory David,16,0,30,14
1656297987781,MATH 10B,A01,083207,Lim; Seonhee,2,0,34,32
1656297987781,MATH 10B,A02,083208,Lim; Seonhee,5,0,35,30
1656297987781,MATH 10B,A03,093472,Staff,1,0,34,33
1656297987781,MATH 10B,B01,083739,Sinha; Shubham,11,0,30,19
1656297993817,MATH 18,A01,083743,Cinel; Cameron Alexander,7,0,30,23
1656297993817,MATH 18,A02,083744,Cinel; Cameron Alexander,9,0,30,21
1656297993817,MATH 18,A03,083745,Cinel; Cameron Alexander,5,0,30,25
1656297993817,MATH 18,B01,083748,Rideout; David Porter,1,0,36,35
1656297993817,MATH 18,B02,083749,Rideout; David Porter,0,0,36,36
1656297993817,MATH 18,B03,083750,Rideout; David Porter,0,0,36,36
1656297993817,MATH 18,B04,083751,Rideout; David Porter,0,1,36,36
1656297993817,MATH 18,B05,093473,Rideout; David Porter,0,0,36,36
1656297993817,MATH 18,B06,093474,Rideout; David Porter,3,0,36,33
1656297999840,MATH 20A,A01,083754,Zheng; Zequn,11,0,40,29
1656298005864,MATH 20B,A01,083756,Briones; Jor-el Thomas Caparas,0,0,36,36
1656298005864,MATH 20B,A02,083757,Briones; Jor-el Thomas Caparas,0,0,36,36
1656298005864,MATH 20B,A03,093475,Staff,1,0,36,35
1656298011888,MATH 20C,A01,083760,Briones; Jor-el Thomas Caparas,0,0,35,35
1656298011888,MATH 20C,A02,083761,Briones; Jor-el Thomas Caparas,9,1,35,26
1656298011888,MATH 20C,A03,093476,Staff,0,0,35,35
1656298011888,MATH 20C,B01,083762,Bach; Quang Tran,2,0,30,28
1656298017911,MATH 20D,A01,083765,Tran; Brian Kha,1,0,30,29
1656298017911,MATH 20D,A02,083766,Tran; Brian Kha,1,1,30,29
1656298017911,MATH 20D,A03,083767,Tran; Brian Kha,2,0,30,28
1656298023939,MATH 20E,A01,083771,Ganguly; Soumya,2,0,32,30
1656298023939,MATH 20E,A02,083772,Ganguly; Soumya,0,0,32,32
1656298023939,MATH 20E,B01,083773,Ciotti; Benjamin,18,0,35,17
1656298023939,MATH 20E,B02,083774,Ciotti; Benjamin,15,0,35,20
1656298029964,MATH 103A,A01,083777,Greenfeld; Be'Eri,1,0,36,35
1656298029964,MATH 103A,A02,083778,Greenfeld; Be'Eri,3,0,36,33
1656298029964,MATH 103A,A03,093561,Staff,4,0,36,32
1656298029964,MATH 103A,B01,083779,Greenfeld; Be'Eri,8,0,36,28
1656298029964,MATH 103A,B02,083780,Greenfeld; Be'Eri,0,0,36,36
1656298029964,MATH 103A,B03,093562,Staff,1,0,36,35
1656298035991,MATH 105,A01,085443,Carter; Anne Toulson,5,0,35,30
1656298035991,MATH 105,A02,093477,Staff,14,0,35,21
1656298042016,MATH 109,A01,083213,Ganzberger; Geoffrey Michael,1,0,34,33
1656298042016,MATH 109,A02,083214,Ganzberger; Geoffrey Michael,0,0,34,34
1656298042016,MATH 109,A03,093478,Staff,2,0,34,32
1656298042016,MATH 109,B01,083215,Ganzberger; Geoffrey Michael,4,0,32,28
1656298042016,MATH 109,B02,083216,Ganzberger; Geoffrey Michael,1,0,32,31
1656298042016,MATH 109,B03,093479,Staff,3,0,32,29
1656298048041,MATH 142A,A01,083219,Chow; Bennett,1,0,32,31
1656298048041,MATH 142A,A02,083220,Chow; Bennett,8,0,32,24
1656298048041,MATH 142A,A03,093480,Staff,5,0,32,27
1656298048041,MATH 142A,B03,093481,Staff,3,0,32,29
1656298048041,MATH 142A,B04,093558,Staff,6,0,32,26
1656298048041,MATH 142A,B05,093559,Staff,0,0,32,32
1656298054087,MATH 193A,A01,083224,Rotar; Vladimir,0,1,34,34
1656298054087,MATH 193A,A02,083225,Rotar; Vladimir,0,0,34,34
1656298054087,MATH 193A,A03,083781,Rotar; Vladimir,0,0,34,34
1656298054087,MATH 193A,A04,083782,Rotar; Vladimir,6,0,34,28
1656298054087,MATH 193A,A05,093482,Rotar; Vladimir,0,0,34,34
1656298060113,MATH 197,001,091859,McAuley; Julian John,9999,0,9999,0
1656298060113,MATH 197,002,095566,Kedlaya; Kiran S.,9997,0,9999,2
1656298060113,MATH 197,003,095567,Xiao; Ming,9999,0,9999,0
1656298060113,MATH 197,004,095571,Perols; Johan Lars,9998,0,9999,1
1656298067170,COGS 9,A01,083615,Shannon; Kyle Michael,3,0,75,72
1656298073195,COGS 11,A01,083617,Boyle; Mary E. T.,15,0,48,33
1656298079223,COGS 13,A01,083071,Bastos; Amalia Pinkusfeld,5,0,71,66
1656298085249,COGS 14A,A01,092681,Semenuks; Arturs,1,13,100,99
1656298091274,COGS 14B,A01,083073,Cheng; Tzu-Han,7,0,63,56
1656298097300,COGS 17,A01,092677,Semenuks; Arturs,6,0,81,75
1656298103324,COGS 100,A01,083619,Allen; Michael Gordon,2,0,70,68
1656298109349,COGS 101A,A01,083621,Davis; Joshua Daniel,4,0,68,64
1656298115376,COGS 101B,A01,091572,Allen; Michael Gordon,4,0,65,61
1656298121399,COGS 101C,A01,083625,Delgado; Tania,11,0,35,24
1656298127432,COGS 107A,A01,083627,Boyle; Mary E. T.,0,0,60,60
1656298133459,COGS 118A,A01,083075,Gupta; Anjum,8,0,76,68
1656298139486,CSE 3,A50,083646,Miranda; Gregory Joseph,18,0,50,32
1656298145510,CSE 8A,A50,083650,Miranda; Gregory Joseph,3,3,56,53
1656298151538,CSE 11,A01,083080,Cao; Yingjun,0,48,40,40
1656298157565,CSE 12,A01,083652,Krause-Levy; Sophia Louisa,5,1,120,115
1656298163588,CSE 15L,A01,083654,Morris; Justin Loren,2,0,50,48
1656298163588,CSE 15L,A02,083655,Morris; Justin Loren,4,0,50,46
1656298169614,CSE 20,A01,083657,Tran; Khoa Dang,30,0,80,50
1656298175638,CSE 21,A01,095574,Bach; Quang Tran,23,0,48,25
1656298181665,CSE 30,A01,083084,Eldon; John,2,6,80,78
1656298181665,CSE 30,B01,095061,Bhaskar; Nishant,0,1,50,50
1656298187692,CSE 100,A01,083659,Cao; Yingjun,1,18,70,69
1656298193716,CSE 134B,A01,083661,Powell; Thomas Allan,6,0,100,94
1656298199745,CSE 140,A01,083663,Gungor; Onat,9,0,85,76
1656298205775,CSE 140L,A01,083088,Eldon; John,10,0,100,90
1656298211798,CSE 175,A01,083665,Kumar; Rakesh,0,0,25,25
1656298217825,CSE 190,A00,092507,Dubnov; Shlomo,3,0,20,17
1656298223852,ECE 45,A01,083139,Congero; Spencer William,1,0,75,74
1656298229875,ECE 65,A50,083695,Saad; Andrew S,9,0,30,21
1656298229875,ECE 65,A51,095125,Staff,24,0,26,2
1656298235903,ECE 109,A01,091882,Touri; Behrouz,1,1,70,69
1656298241926,ECE 180,A00,083140,Abi Samra; Nicholas Camill,2,0,30,28
1656298241926,ECE 180,B00,083141,Abi Samra; Nicholas Camill,0,4,30,30
1656298247951,MATH 10A,A01,083735,Patchell; Gregory David,0,0,30,30
1656298247951,MATH 10A,A02,083736,Patchell; Gregory David,22,0,30,8
1656298247951,MATH 10A,A03,083737,Patchell; Gregory David,16,0,30,14
1656298253978,MATH 10B,A01,083207,Lim; Seonhee,2,0,34,32
1656298253978,MATH 10B,A02,083208,Lim; Seonhee,5,0,35,30
1656298253978,MATH 10B,A03,093472,Staff,1,0,34,33
1656298253978,MATH 10B,B01,083739,Sinha; Shubham,11,0,30,19
1656298260005,MATH 18,A01,083743,Cinel; Cameron Alexander,7,0,30,23
1656298260005,MATH 18,A02,083744,Cinel; Cameron Alexander,9,0,30,21
1656298260005,MATH 18,A03,083745,Cinel; Cameron Alexander,5,0,30,25
1656298260005,MATH 18,B01,083748,Rideout; David Porter,1,0,36,35
1656298260005,MATH 18,B02,083749,Rideout; David Porter,0,0,36,36
1656298260005,MATH 18,B03,083750,Rideout; David Porter,0,0,36,36
1656298260005,MATH 18,B04,083751,Rideout; David Porter,0,1,36,36
1656298260005,MATH 18,B05,093473,Rideout; David Porter,0,0,36,36
1656298260005,MATH 18,B06,093474,Rideout; David Porter,3,0,36,33
1656298266029,MATH 20A,A01,083754,Zheng; Zequn,11,0,40,29
1656298272054,MATH 20B,A01,083756,Briones; Jor-el Thomas Caparas,0,0,36,36
1656298272054,MATH 20B,A02,083757,Briones; Jor-el Thomas Caparas,0,0,36,36
1656298272054,MATH 20B,A03,093475,Staff,1,0,36,35
1656298278080,MATH 20C,A01,083760,Briones; Jor-el Thomas Caparas,0,0,35,35
1656298278080,MATH 20C,A02,083761,Briones; Jor-el Thomas Caparas,9,1,35,26
1656298278080,MATH 20C,A03,093476,Staff,0,0,35,35
1656298278080,MATH 20C,B01,083762,Bach; Quang Tran,2,0,30,28
1656298284104,MATH 20D,A01,083765,Tran; Brian Kha,1,0,30,29
1656298284104,MATH 20D,A02,083766,Tran; Brian Kha,1,1,30,29
1656298284104,MATH 20D,A03,083767,Tran; Brian Kha,2,0,30,28
1656298290126,MATH 20E,A01,083771,Ganguly; Soumya,2,0,32,30
1656298290126,MATH 20E,A02,083772,Ganguly; Soumya,0,0,32,32
1656298290126,MATH 20E,B01,083773,Ciotti; Benjamin,18,0,35,17
1656298290126,MATH 20E,B02,083774,Ciotti; Benjamin,15,0,35,20
1656298296157,MATH 103A,A01,083777,Greenfeld; Be'Eri,1,0,36,35
1656298296157,MATH 103A,A02,083778,Greenfeld; Be'Eri,3,0,36,33
1656298296157,MATH 103A,A03,093561,Staff,4,0,36,32
1656298296157,MATH 103A,B01,083779,Greenfeld; Be'Eri,8,0,36,28
1656298296157,MATH 103A,B02,083780,Greenfeld; Be'Eri,0,0,36,36
1656298296157,MATH 103A,B03,093562,Staff,1,0,36,35
1656298302181,MATH 105,A01,085443,Carter; Anne Toulson,5,0,35,30
1656298302181,MATH 105,A02,093477,Staff,14,0,35,21
1656298308288,MATH 109,A01,083213,Ganzberger; Geoffrey Michael,1,0,34,33
1656298308288,MATH 109,A02,083214,Ganzberger; Geoffrey Michael,0,0,34,34
1656298308288,MATH 109,A03,093478,Staff,2,0,34,32
1656298308288,MATH 109,B01,083215,Ganzberger; Geoffrey Michael,4,0,32,28
1656298308288,MATH 109,B02,083216,Ganzberger; Geoffrey Michael,1,0,32,31
1656298308288,MATH 109,B03,093479,Staff,3,0,32,29
1656298314313,MATH 142A,A01,083219,Chow; Bennett,1,0,32,31
1656298314313,MATH 142A,A02,083220,Chow; Bennett,8,0,32,24
1656298314313,MATH 142A,A03,093480,Staff,5,0,32,27
1656298314313,MATH 142A,B03,093481,Staff,3,0,32,29
1656298314313,MATH 142A,B04,093558,Staff,6,0,32,26
1656298314313,MATH 142A,B05,093559,Staff,0,0,32,32
1656298320336,MATH 193A,A01,083224,Rotar; Vladimir,0,1,34,34
1656298320336,MATH 193A,A02,083225,Rotar; Vladimir,0,0,34,34
1656298320336,MATH 193A,A03,083781,Rotar; Vladimir,0,0,34,34
1656298320336,MATH 193A,A04,083782,Rotar; Vladimir,6,0,34,28
1656298320336,MATH 193A,A05,093482,Rotar; Vladimir,0,0,34,34
1656298326360,MATH 197,001,091859,McAuley; Julian John,9999,0,9999,0
1656298326360,MATH 197,002,095566,Kedlaya; Kiran S.,9997,0,9999,2
1656298326360,MATH 197,003,095567,Xiao; Ming,9999,0,9999,0
1656298326360,MATH 197,004,095571,Perols; Johan Lars,9998,0,9999,1
1656298333416,COGS 9,A01,083615,Shannon; Kyle Michael,3,0,75,72
1656298339442,COGS 11,A01,083617,Boyle; Mary E. T.,15,0,48,33
1656298345466,COGS 13,A01,083071,Bastos; Amalia Pinkusfeld,5,0,71,66
1656298351490,COGS 14A,A01,092681,Semenuks; Arturs,1,13,100,99
1656298357512,COGS 14B,A01,083073,Cheng; Tzu-Han,7,0,63,56
1656298363538,COGS 17,A01,092677,Semenuks; Arturs,6,0,81,75
1656298369560,COGS 100,A01,083619,Allen; Michael Gordon,2,0,70,68
1656298375588,COGS 101A,A01,083621,Davis; Joshua Daniel,4,0,68,64
1656298381615,COGS 101B,A01,091572,Allen; Michael Gordon,4,0,65,61
1656298387643,COGS 101C,A01,083625,Delgado; Tania,11,0,35,24
1656298393668,COGS 107A,A01,083627,Boyle; Mary E. T.,0,0,60,60
1656298399699,COGS 118A,A01,083075,Gupta; Anjum,8,0,76,68
1656298405724,CSE 3,A50,083646,Miranda; Gregory Joseph,18,0,50,32
1656298411749,CSE 8A,A50,083650,Miranda; Gregory Joseph,3,3,56,53
1656298417773,CSE 11,A01,083080,Cao; Yingjun,0,48,40,40
1656298423796,CSE 12,A01,083652,Krause-Levy; Sophia Louisa,5,1,120,115
1656298429820,CSE 15L,A01,083654,Morris; Justin Loren,2,0,50,48
1656298429820,CSE 15L,A02,083655,Morris; Justin Loren,4,0,50,46
1656298435844,CSE 20,A01,083657,Tran; Khoa Dang,30,0,80,50
1656298441867,CSE 21,A01,095574,Bach; Quang Tran,23,0,48,25
1656298447898,CSE 30,A01,083084,Eldon; John,2,6,80,78
1656298447898,CSE 30,B01,095061,Bhaskar; Nishant,0,1,50,50
1656298453930,CSE 100,A01,083659,Cao; Yingjun,1,18,70,69
1656298459957,CSE 134B,A01,083661,Powell; Thomas Allan,6,0,100,94
1656298465980,CSE 140,A01,083663,Gungor; Onat,9,0,85,76
1656298472004,CSE 140L,A01,083088,Eldon; John,10,0,100,90
1656298478029,CSE 175,A01,083665,Kumar; Rakesh,0,0,25,25
1656298484054,CSE 190,A00,092507,Dubnov; Shlomo,3,0,20,17
1656298490093,ECE 45,A01,083139,Congero; Spencer William,1,0,75,74
1656298496116,ECE 65,A50,083695,Saad; Andrew S,9,0,30,21
1656298496116,ECE 65,A51,095125,Staff,24,0,26,2
1656298502149,ECE 109,A01,091882,Touri; Behrouz,1,1,70,69
1656298508171,ECE 180,A00,083140,Abi Samra; Nicholas Camill,2,0,30,28
1656298508171,ECE 180,B00,083141,Abi Samra; Nicholas Camill,0,4,30,30
1656298514201,MATH 10A,A01,083735,Patchell; Gregory David,0,0,30,30
1656298514201,MATH 10A,A02,083736,Patchell; Gregory David,22,0,30,8
1656298514201,MATH 10A,A03,083737,Patchell; Gregory David,16,0,30,14
1656298520224,MATH 10B,A01,083207,Lim; Seonhee,2,0,34,32
1656298520224,MATH 10B,A02,083208,Lim; Seonhee,5,0,35,30
1656298520224,MATH 10B,A03,093472,Staff,1,0,34,33
1656298520224,MATH 10B,B01,083739,Sinha; Shubham,11,0,30,19
1656298526257,MATH 18,A01,083743,Cinel; Cameron Alexander,7,0,30,23
1656298526257,MATH 18,A02,083744,Cinel; Cameron Alexander,9,0,30,21
1656298526257,MATH 18,A03,083745,Cinel; Cameron Alexander,5,0,30,25
1656298526257,MATH 18,B01,083748,Rideout; David Porter,1,0,36,35
1656298526257,MATH 18,B02,083749,Rideout; David Porter,0,0,36,36
1656298526257,MATH 18,B03,083750,Rideout; David Porter,0,0,36,36
1656298526257,MATH 18,B04,083751,Rideout; David Porter,0,1,36,36
1656298526257,MATH 18,B05,093473,Rideout; David Porter,0,0,36,36
1656298526257,MATH 18,B06,093474,Rideout; David Porter,3,0,36,33
1656298532280,MATH 20A,A01,083754,Zheng; Zequn,11,0,40,29
1656298538302,MATH 20B,A01,083756,Briones; Jor-el Thomas Caparas,0,0,36,36
1656298538302,MATH 20B,A02,083757,Briones; Jor-el Thomas Caparas,0,0,36,36
1656298538302,MATH 20B,A03,093475,Staff,1,0,36,35
1656298544331,MATH 20C,A01,083760,Briones; Jor-el Thomas Caparas,0,0,35,35
1656298544331,MATH 20C,A02,083761,Briones; Jor-el Thomas Caparas,9,1,35,26
1656298544331,MATH 20C,A03,093476,Staff,0,0,35,35
1656298544331,MATH 20C,B01,083762,Bach; Quang Tran,2,0,30,28
1656298550359,MATH 20D,A01,083765,Tran; Brian Kha,1,0,30,29
1656298550359,MATH 20D,A02,083766,Tran; Brian Kha,1,1,30,29
1656298550359,MATH 20D,A03,083767,Tran; Brian Kha,2,0,30,28
1656298556384,MATH 20E,A01,083771,Ganguly; Soumya,2,0,32,30
1656298556384,MATH 20E,A02,083772,Ganguly; Soumya,0,0,32,32
1656298556384,MATH 20E,B01,083773,Ciotti; Benjamin,18,0,35,17
1656298556384,MATH 20E,B02,083774,Ciotti; Benjamin,15,0,35,20
1656298562409,MATH 103A,A01,083777,Greenfeld; Be'Eri,1,0,36,35
1656298562409,MATH 103A,A02,083778,Greenfeld; Be'Eri,3,0,36,33
1656298562409,MATH 103A,A03,093561,Staff,4,0,36,32
1656298562409,MATH 103A,B01,083779,Greenfeld; Be'Eri,8,0,36,28
1656298562409,MATH 103A,B02,083780,Greenfeld; Be'Eri,0,0,36,36
1656298562409,MATH 103A,B03,093562,Staff,1,0,36,35
1656298568432,MATH 105,A01,085443,Carter; Anne Toulson,5,0,35,30
1656298568432,MATH 105,A02,093477,Staff,14,0,35,21
1656298574456,MATH 109,A01,083213,Ganzberger; Geoffrey Michael,1,0,34,33
1656298574456,MATH 109,A02,083214,Ganzberger; Geoffrey Michael,0,0,34,34
1656298574456,MATH 109,A03,093478,Staff,2,0,34,32
1656298574456,MATH 109,B01,083215,Ganzberger; Geoffrey Michael,4,0,32,28
1656298574456,MATH 109,B02,083216,Ganzberger; Geoffrey Michael,1,0,32,31
1656298574456,MATH 109,B03,093479,Staff,3,0,32,29
1656298580486,MATH 142A,A01,083219,Chow; Bennett,1,0,32,31
1656298580486,MATH 142A,A02,083220,Chow; Bennett,8,0,32,24
1656298580486,MATH 142A,A03,093480,Staff,5,0,32,27
1656298580486,MATH 142A,B03,093481,Staff,3,0,32,29
1656298580486,MATH 142A,B04,093558,Staff,6,0,32,26
1656298580486,MATH 142A,B05,093559,Staff,0,0,32,32
1656298586511,MATH 193A,A01,083224,Rotar; Vladimir,0,1,34,34
1656298586511,MATH 193A,A02,083225,Rotar; Vladimir,0,0,34,34
1656298586511,MATH 193A,A03,083781,Rotar; Vladimir,0,0,34,34
1656298586511,MATH 193A,A04,083782,Rotar; Vladimir,6,0,34,28
1656298586511,MATH 193A,A05,093482,Rotar; Vladimir,0,0,34,34
1656298592534,MATH 197,001,091859,McAuley; Julian John,9999,0,9999,0
1656298592534,MATH 197,002,095566,Kedlaya; Kiran S.,9997,0,9999,2
1656298592534,MATH 197,003,095567,Xiao; Ming,9999,0,9999,0
1656298592534,MATH 197,004,095571,Perols; Johan Lars,9998,0,9999,1
1656298599588,COGS 9,A01,083615,Shannon; Kyle Michael,3,0,75,72
1656298605614,COGS 11,A01,083617,Boyle; Mary E. T.,15,0,48,33
1656298611640,COGS 13,A01,083071,Bastos; Amalia Pinkusfeld,5,0,71,66
1656298617663,COGS 14A,A01,092681,Semenuks; Arturs,1,13,100,99
1656298623687,COGS 14B,A01,083073,Cheng; Tzu-Han,7,0,63,56
1656298629713,COGS 17,A01,092677,Semenuks; Arturs,6,0,81,75
1656298635737,COGS 100,A01,083619,Allen; Michael Gordon,2,0,70,68
1656298641766,COGS 101A,A01,083621,Davis; Joshua Daniel,4,0,68,64
1656298647790,COGS 101B,A01,091572,Allen; Michael Gordon,4,0,65,61
1656298653814,COGS 101C,A01,083625,Delgado; Tania,11,0,35,24
1656298659838,COGS 107A,A01,083627,Boyle; Mary E. T.,0,0,60,60
1656298665865,COGS 118A,A01,083075,Gupta; Anjum,8,0,76,68
1656298671894,CSE 3,A50,083646,Miranda; Gregory Joseph,18,0,50,32
1656298677920,CSE 8A,A50,083650,Miranda; Gregory Joseph,3,3,56,53
1656298683941,CSE 11,A01,083080,Cao; Yingjun,0,48,40,40
1656298689968,CSE 12,A01,083652,Krause-Levy; Sophia Louisa,5,1,120,115
1656298695994,CSE 15L,A01,083654,Morris; Justin Loren,2,0,50,48
1656298695994,CSE 15L,A02,083655,Morris; Justin Loren,4,0,50,46
1656298702021,CSE 20,A01,083657,Tran; Khoa Dang,30,0,80,50
1656298708044,CSE 21,A01,095574,Bach; Quang Tran,23,0,48,25
1656298714067,CSE 30,A01,083084,Eldon; John,2,6,80,78
1656298714067,CSE 30,B01,095061,Bhaskar; Nishant,0,1,50,50
1656298720094,CSE 100,A01,083659,Cao; Yingjun,1,18,70,69
1656298726117,CSE 134B,A01,083661,Powell; Thomas Allan,6,0,100,94
1656298732143,CSE 140,A01,083663,Gungor; Onat,9,0,85,76
1656298738170,CSE 140L,A01,083088,Eldon; John,10,0,100,90
1656298744191,CSE 175,A01,083665,Kumar; Rakesh,0,0,25,25
1656298750217,CSE 190,A00,092507,Dubnov; Shlomo,3,0,20,17
1656298756243,ECE 45,A01,083139,Congero; Spencer William,1,0,75,74
1656298762267,ECE 65,A50,083695,Saad; Andrew S,9,0,30,21
1656298762267,ECE 65,A51,095125,Staff,24,0,26,2
1656298768293,ECE 109,A01,091882,Touri; Behrouz,1,1,70,69
1656298774320,ECE 180,A00,083140,Abi Samra; Nicholas Camill,2,0,30,28
1656298774320,ECE 180,B00,083141,Abi Samra; Nicholas Camill,0,4,30,30
1656298780344,MATH 10A,A01,083735,Patchell; Gregory David,0,0,30,30
1656298780344,MATH 10A,A02,083736,Patchell; Gregory David,22,0,30,8
1656298780344,MATH 10A,A03,083737,Patchell; Gregory David,16,0,30,14
1656298786368,MATH 10B,A01,083207,Lim; Seonhee,2,0,34,32
1656298786368,MATH 10B,A02,083208,Lim; Seonhee,5,0,35,30
1656298786368,MATH 10B,A03,093472,Staff,1,0,34,33
1656298786368,MATH 10B,B01,083739,Sinha; Shubham,11,0,30,19
1656298792398,MATH 18,A01,083743,Cinel; Cameron Alexander,7,0,30,23
1656298792398,MATH 18,A02,083744,Cinel; Cameron Alexander,9,0,30,21
1656298792398,MATH 18,A03,083745,Cinel; Cameron Alexander,5,0,30,25
1656298792398,MATH 18,B01,083748,Rideout; David Porter,1,0,36,35
1656298792398,MATH 18,B02,083749,Rideout; David Porter,0,0,36,36
1656298792398,MATH 18,B03,083750,Rideout; David Porter,0,0,36,36
1656298792398,MATH 18,B04,083751,Rideout; David Porter,0,1,36,36
1656298792398,MATH 18,B05,093473,Rideout; David Porter,0,0,36,36
1656298792398,MATH 18,B06,093474,Rideout; David Porter,3,0,36,33
1656298798422,MATH 20A,A01,083754,Zheng; Zequn,11,0,40,29
1656298804445,MATH 20B,A01,083756,Briones; Jor-el Thomas Caparas,0,0,36,36
1656298804445,MATH 20B,A02,083757,Briones; Jor-el Thomas Caparas,0,0,36,36
1656298804445,MATH 20B,A03,093475,Staff,1,0,36,35
1656298810471,MATH 20C,A01,083760,Briones; Jor-el Thomas Caparas,0,0,35,35
1656298810471,MATH 20C,A02,083761,Briones; Jor-el Thomas Caparas,9,1,35,26
1656298810471,MATH 20C,A03,093476,Staff,0,0,35,35
1656298810471,MATH 20C,B01,083762,Bach; Quang Tran,2,0,30,28
1656298816494,MATH 20D,A01,083765,Tran; Brian Kha,1,0,30,29
1656298816494,MATH 20D,A02,083766,Tran; Brian Kha,1,1,30,29
1656298816494,MATH 20D,A03,083767,Tran; Brian Kha,2,0,30,28
1656298822522,MATH 20E,A01,083771,Ganguly; Soumya,2,0,32,30
1656298822522,MATH 20E,A02,083772,Ganguly; Soumya,0,0,32,32
1656298822522,MATH 20E,B01,083773,Ciotti; Benjamin,18,0,35,17
1656298822522,MATH 20E,B02,083774,Ciotti; Benjamin,15,0,35,20
1656298828544,MATH 103A,A01,083777,Greenfeld; Be'Eri,1,0,36,35
1656298828544,MATH 103A,A02,083778,Greenfeld; Be'Eri,3,0,36,33
1656298828544,MATH 103A,A03,093561,Staff,4,0,36,32
1656298828544,MATH 103A,B01,083779,Greenfeld; Be'Eri,8,0,36,28
1656298828544,MATH 103A,B02,083780,Greenfeld; Be'Eri,0,0,36,36
1656298828544,MATH 103A,B03,093562,Staff,1,0,36,35
1656298834569,MATH 105,A01,085443,Carter; Anne Toulson,5,0,35,30
1656298834569,MATH 105,A02,093477,Staff,14,0,35,21
1656298840593,MATH 109,A01,083213,Ganzberger; Geoffrey Michael,1,0,34,33
1656298840593,MATH 109,A02,083214,Ganzberger; Geoffrey Michael,0,0,34,34
1656298840593,MATH 109,A03,093478,Staff,2,0,34,32
1656298840593,MATH 109,B01,083215,Ganzberger; Geoffrey Michael,4,0,32,28
1656298840593,MATH 109,B02,083216,Ganzberger; Geoffrey Michael,1,0,32,31
1656298840593,MATH 109,B03,093479,Staff,3,0,32,29
1656298846616,MATH 142A,A01,083219,Chow; Bennett,1,0,32,31
1656298846616,MATH 142A,A02,083220,Chow; Bennett,8,0,32,24
1656298846616,MATH 142A,A03,093480,Staff,5,0,32,27
1656298846616,MATH 142A,B03,093481,Staff,3,0,32,29
1656298846616,MATH 142A,B04,093558,Staff,6,0,32,26
1656298846616,MATH 142A,B05,093559,Staff,0,0,32,32
1656298852640,MATH 193A,A01,083224,Rotar; Vladimir,0,1,34,34
1656298852640,MATH 193A,A02,083225,Rotar; Vladimir,0,0,34,34
1656298852640,MATH 193A,A03,083781,Rotar; Vladimir,0,0,34,34
1656298852640,MATH 193A,A04,083782,Rotar; Vladimir,6,0,34,28
1656298852640,MATH 193A,A05,093482,Rotar; Vladimir,0,0,34,34
1656298858667,MATH 197,001,091859,McAuley; Julian John,9999,0,9999,0
1656298858667,MATH 197,002,095566,Kedlaya; Kiran S.,9997,0,9999,2
1656298858667,MATH 197,003,095567,Xiao; Ming,9999,0,9999,0
1656298858667,MATH 197,004,095571,Perols; Johan Lars,9998,0,9999,1
1656298865729,COGS 9,A01,083615,Shannon; Kyle Michael,3,0,75,72
1656298871755,COGS 11,A01,083617,Boyle; Mary E. T.,15,0,48,33
1656298877781,COGS 13,A01,083071,Bastos; Amalia Pinkusfeld,5,0,71,66
1656298883804,COGS 14A,A01,092681,Semenuks; Arturs,1,13,100,99
1656298889832,COGS 14B,A01,083073,Cheng; Tzu-Han,7,0,63,56
1656298895855,COGS 17,A01,092677,Semenuks; Arturs,6,0,81,75
1656298901966,COGS 100,A01,083619,Allen; Michael Gordon,2,0,70,68
1656298907993,COGS 101A,A01,083621,Davis; Joshua Daniel,4,0,68,64
1656298914016,COGS 101B,A01,091572,Allen; Michael Gordon,4,0,65,61
1656298920043,COGS 101C,A01,083625,Delgado; Tania,11,0,35,24
1656298926067,COGS 107A,A01,083627,Boyle; Mary E. T.,0,0,60,60
1656298932092,COGS 118A,A01,083075,Gupta; Anjum,8,0,76,68
1656298938123,CSE 3,A50,083646,Miranda; Gregory Joseph,18,0,50,32
1656298944151,CSE 8A,A50,083650,Miranda; Gregory Joseph,3,3,56,53
1656298950177,CSE 11,A01,083080,Cao; Yingjun,0,48,40,40
1656298956211,CSE 12,A01,083652,Krause-Levy; Sophia Louisa,5,1,120,115
1656298962237,CSE 15L,A01,083654,Morris; Justin Loren,2,0,50,48
1656298962237,CSE 15L,A02,083655,Morris; Justin Loren,4,0,50,46
1656298968260,CSE 20,A01,083657,Tran; Khoa Dang,30,0,80,50
1656298974284,CSE 21,A01,095574,Bach; Quang Tran,23,0,48,25
1656298980315,CSE 30,A01,083084,Eldon; John,2,6,80,78
1656298980315,CSE 30,B01,095061,Bhaskar; Nishant,0,1,50,50
1656298986339,CSE 100,A01,083659,Cao; Yingjun,1,18,70,69
1656298992378,CSE 134B,A01,083661,Powell; Thomas Allan,6,0,100,94
1656298998403,CSE 140,A01,083663,Gungor; Onat,9,0,85,76
1656299004431,CSE 140L,A01,083088,Eldon; John,10,0,100,90
1656299010452,CSE 175,A01,083665,Kumar; Rakesh,0,0,25,25
1656299016477,CSE 190,A00,092507,Dubnov; Shlomo,3,0,20,17
1656299022502,ECE 45,A01,083139,Congero; Spencer William,1,0,75,74
1656299028535,ECE 65,A50,083695,Saad; Andrew S,9,0,30,21
1656299028535,ECE 65,A51,095125,Staff,24,0,26,2
1656299034558,ECE 109,A01,091882,Touri; Behrouz,1,1,70,69
1656299040582,ECE 180,A00,083140,Abi Samra; Nicholas Camill,2,0,30,28
1656299040582,ECE 180,B00,083141,Abi Samra; Nicholas Camill,0,4,30,30
1656299046609,MATH 10A,A01,083735,Patchell; Gregory David,0,0,30,30
1656299046609,MATH 10A,A02,083736,Patchell; Gregory David,22,0,30,8
1656299046609,MATH 10A,A03,083737,Patchell; Gregory David,16,0,30,14
1656299052634,MATH 10B,A01,083207,Lim; Seonhee,2,0,34,32
1656299052634,MATH 10B,A02,083208,Lim; Seonhee,5,0,35,30
1656299052634,MATH 10B,A03,093472,Staff,1,0,34,33
1656299052634,MATH 10B,B01,083739,Sinha; Shubham,11,0,30,19
1656299058660,MATH 18,A01,083743,Cinel; Cameron Alexander,7,0,30,23
1656299058660,MATH 18,A02,083744,Cinel; Cameron Alexander,9,0,30,21
1656299058660,MATH 18,A03,083745,Cinel; Cameron Alexander,5,0,30,25
1656299058660,MATH 18,B01,083748,Rideout; David Porter,1,0,36,35
1656299058660,MATH 18,B02,083749,Rideout; David Porter,0,0,36,36
1656299058660,MATH 18,B03,083750,Rideout; David Porter,0,0,36,36
1656299058660,MATH 18,B04,083751,Rideout; David Porter,0,1,36,36
1656299058660,MATH 18,B05,093473,Rideout; David Porter,0,0,36,36
1656299058660,MATH 18,B06,093474,Rideout; David Porter,3,0,36,33
1656299064683,MATH 20A,A01,083754,Zheng; Zequn,11,0,40,29
1656299070711,MATH 20B,A01,083756,Briones; Jor-el Thomas Caparas,0,0,36,36
1656299070711,MATH 20B,A02,083757,Briones; Jor-el Thomas Caparas,0,0,36,36
1656299070711,MATH 20B,A03,093475,Staff,1,0,36,35
1656299076735,MATH 20C,A01,083760,Briones; Jor-el Thomas Caparas,0,0,35,35
1656299076735,MATH 20C,A02,083761,Briones; Jor-el Thomas Caparas,9,1,35,26
1656299076735,MATH 20C,A03,093476,Staff,0,0,35,35
1656299076735,MATH 20C,B01,083762,Bach; Quang Tran,2,0,30,28
1656299082758,MATH 20D,A01,083765,Tran; Brian Kha,1,0,30,29
1656299082758,MATH 20D,A02,083766,Tran; Brian Kha,1,1,30,29
1656299082758,MATH 20D,A03,083767,Tran; Brian Kha,2,0,30,28
1656299088782,MATH 20E,A01,083771,Ganguly; Soumya,2,0,32,30
1656299088782,MATH 20E,A02,083772,Ganguly; Soumya,0,0,32,32
1656299088782,MATH 20E,B01,083773,Ciotti; Benjamin,18,0,35,17
1656299088782,MATH 20E,B02,083774,Ciotti; Benjamin,15,0,35,20
1656299094810,MATH 103A,A01,083777,Greenfeld; Be'Eri,1,0,36,35
1656299094810,MATH 103A,A02,083778,Greenfeld; Be'Eri,3,0,36,33
1656299094810,MATH 103A,A03,093561,Staff,4,0,36,32
1656299094810,MATH 103A,B01,083779,Greenfeld; Be'Eri,8,0,36,28
1656299094810,MATH 103A,B02,083780,Greenfeld; Be'Eri,0,0,36,36
1656299094810,MATH 103A,B03,093562,Staff,1,0,36,35
1656299100833,MATH 105,A01,085443,Carter; Anne Toulson,5,0,35,30
1656299100833,MATH 105,A02,093477,Staff,14,0,35,21
1656299106864,MATH 109,A01,083213,Ganzberger; Geoffrey Michael,1,0,34,33
1656299106864,MATH 109,A02,083214,Ganzberger; Geoffrey Michael,0,0,34,34
1656299106864,MATH 109,A03,093478,Staff,2,0,34,32
1656299106864,MATH 109,B01,083215,Ganzberger; Geoffrey Michael,4,0,32,28
1656299106864,MATH 109,B02,083216,Ganzberger; Geoffrey Michael,1,0,32,31
1656299106864,MATH 109,B03,093479,Staff,3,0,32,29
1656299112891,MATH 142A,A01,083219,Chow; Bennett,1,0,32,31
1656299112891,MATH 142A,A02,083220,Chow; Bennett,8,0,32,24
1656299112891,MATH 142A,A03,093480,Staff,5,0,32,27
1656299112891,MATH 142A,B03,093481,Staff,3,0,32,29
1656299112891,MATH 142A,B04,093558,Staff,6,0,32,26
1656299112891,MATH 142A,B05,093559,Staff,0,0,32,32
1656299118915,MATH 193A,A01,083224,Rotar; Vladimir,0,1,34,34
1656299118915,MATH 193A,A02,083225,Rotar; Vladimir,0,0,34,34
1656299118915,MATH 193A,A03,083781,Rotar; Vladimir,0,0,34,34
1656299118915,MATH 193A,A04,083782,Rotar; Vladimir,6,0,34,28
1656299118915,MATH 193A,A05,093482,Rotar; Vladimir,0,0,34,34
1656299124940,MATH 197,001,091859,McAuley; Julian John,9999,0,9999,0
1656299124940,MATH 197,002,095566,Kedlaya; Kiran S.,9997,0,9999,2
1656299124940,MATH 197,003,095567,Xiao; Ming,9999,0,9999,0
1656299124940,MATH 197,004,095571,Perols; Johan Lars,9998,0,9999,1
1656299131994,COGS 9,A01,083615,Shannon; Kyle Michael,3,0,75,72
1656299138018,COGS 11,A01,083617,Boyle; Mary E. T.,15,0,48,33
1656299144048,COGS 13,A01,083071,Bastos; Amalia Pinkusfeld,5,0,71,66
1656299150072,COGS 14A,A01,092681,Semenuks; Arturs,1,13,100,99
1656299156097,COGS 14B,A01,083073,Cheng; Tzu-Han,7,0,63,56
1656299162120,COGS 17,A01,092677,Semenuks; Arturs,6,0,81,75
1656299168147,COGS 100,A01,083619,Allen; Michael Gordon,2,0,70,68
1656299174176,COGS 101A,A01,083621,Davis; Joshua Daniel,4,0,68,64
1656299180199,COGS 101B,A01,091572,Allen; Michael Gordon,4,0,65,61
1656299186228,COGS 101C,A01,083625,Delgado; Tania,11,0,35,24
1656299192251,COGS 107A,A01,083627,Boyle; Mary E. T.,0,0,60,60
1656299198277,COGS 118A,A01,083075,Gupta; Anjum,8,0,76,68
1656299204302,CSE 3,A50,083646,Miranda; Gregory Joseph,18,0,50,32
1656299210329,CSE 8A,A50,083650,Miranda; Gregory Joseph,3,3,56,53
1656299216356,CSE 11,A01,083080,Cao; Yingjun,0,48,40,40
1656299222380,CSE 12,A01,083652,Krause-Levy; Sophia Louisa,5,1,120,115
1656299228403,CSE 15L,A01,083654,Morris; Justin Loren,2,0,50,48
1656299228403,CSE 15L,A02,083655,Morris; Justin Loren,4,0,50,46
1656299234428,CSE 20,A01,083657,Tran; Khoa Dang,30,0,80,50
1656299240452,CSE 21,A01,095574,Bach; Quang Tran,23,0,48,25
1656299246475,CSE 30,A01,083084,Eldon; John,2,6,80,78
1656299246475,CSE 30,B01,095061,Bhaskar; Nishant,0,1,50,50
1656299252501,CSE 100,A01,083659,Cao; Yingjun,1,18,70,69
1656299258528,CSE 134B,A01,083661,Powell; Thomas Allan,6,0,100,94
1656299264558,CSE 140,A01,083663,Gungor; Onat,9,0,85,76
1656299270581,CSE 140L,A01,083088,Eldon; John,10,0,100,90
1656299276604,CSE 175,A01,083665,Kumar; Rakesh,0,0,25,25
1656299282627,CSE 190,A00,092507,Dubnov; Shlomo,3,0,20,17
1656299288659,ECE 45,A01,083139,Congero; Spencer William,1,0,75,74
1656299294686,ECE 65,A50,083695,Saad; Andrew S,9,0,30,21
1656299294686,ECE 65,A51,095125,Staff,24,0,26,2
1656299300713,ECE 109,A01,091882,Touri; Behrouz,1,1,70,69
1656299306748,ECE 180,A00,083140,Abi Samra; Nicholas Camill,2,0,30,28
1656299306748,ECE 180,B00,083141,Abi Samra; Nicholas Camill,0,4,30,30
1656299312774,MATH 10A,A01,083735,Patchell; Gregory David,0,0,30,30
1656299312774,MATH 10A,A02,083736,Patchell; Gregory David,22,0,30,8
1656299312774,MATH 10A,A03,083737,Patchell; Gregory David,16,0,30,14
1656299318804,MATH 10B,A01,083207,Lim; Seonhee,2,0,34,32
1656299318804,MATH 10B,A02,083208,Lim; Seonhee,5,0,35,30
1656299318804,MATH 10B,A03,093472,Staff,1,0,34,33
1656299318804,MATH 10B,B01,083739,Sinha; Shubham,11,0,30,19
1656299324827,MATH 18,A01,083743,Cinel; Cameron Alexander,7,0,30,23
1656299324827,MATH 18,A02,083744,Cinel; Cameron Alexander,9,0,30,21
1656299324827,MATH 18,A03,083745,Cinel; Cameron Alexander,5,0,30,25
1656299324827,MATH 18,B01,083748,Rideout; David Porter,1,0,36,35
1656299324827,MATH 18,B02,083749,Rideout; David Porter,0,0,36,36
1656299324827,MATH 18,B03,083750,Rideout; David Porter,0,0,36,36
1656299324827,MATH 18,B04,083751,Rideout; David Porter,0,1,36,36
1656299324827,MATH 18,B05,093473,Rideout; David Porter,0,0,36,36
1656299324827,MATH 18,B06,093474,Rideout; David Porter,3,0,36,33
1656299330851,MATH 20A,A01,083754,Zheng; Zequn,11,0,40,29
1656299336874,MATH 20B,A01,083756,Briones; Jor-el Thomas Caparas,0,0,36,36
1656299336874,MATH 20B,A02,083757,Briones; Jor-el Thomas Caparas,0,0,36,36
1656299336874,MATH 20B,A03,093475,Staff,1,0,36,35
1656299342902,MATH 20C,A01,083760,Briones; Jor-el Thomas Caparas,0,0,35,35
1656299342902,MATH 20C,A02,083761,Briones; Jor-el Thomas Caparas,9,1,35,26
1656299342902,MATH 20C,A03,093476,Staff,0,0,35,35
1656299342902,MATH 20C,B01,083762,Bach; Quang Tran,2,0,30,28
1656299348926,MATH 20D,A01,083765,Tran; Brian Kha,1,0,30,29
1656299348926,MATH 20D,A02,083766,Tran; Brian Kha,1,1,30,29
1656299348926,MATH 20D,A03,083767,Tran; Brian Kha,2,0,30,28
1656299354950,MATH 20E,A01,083771,Ganguly; Soumya,2,0,32,30
1656299354950,MATH 20E,A02,083772,Ganguly; Soumya,0,0,32,32
1656299354950,MATH 20E,B01,083773,Ciotti; Benjamin,18,0,35,17
1656299354950,MATH 20E,B02,083774,Ciotti; Benjamin,15,0,35,20
1656299360979,MATH 103A,A01,083777,Greenfeld; Be'Eri,1,0,36,35
1656299360979,MATH 103A,A02,083778,Greenfeld; Be'Eri,3,0,36,33
1656299360979,MATH 103A,A03,093561,Staff,4,0,36,32
1656299360979,MATH 103A,B01,083779,Greenfeld; Be'Eri,8,0,36,28
1656299360979,MATH 103A,B02,083780,Greenfeld; Be'Eri,0,0,36,36
1656299360979,MATH 103A,B03,093562,Staff,1,0,36,35
1656299367002,MATH 105,A01,085443,Carter; Anne Toulson,5,0,35,30
1656299367002,MATH 105,A02,093477,Staff,14,0,35,21
1656299373026,MATH 109,A01,083213,Ganzberger; Geoffrey Michael,1,0,34,33
1656299373026,MATH 109,A02,083214,Ganzberger; Geoffrey Michael,0,0,34,34
1656299373026,MATH 109,A03,093478,Staff,2,0,34,32
1656299373026,MATH 109,B01,083215,Ganzberger; Geoffrey Michael,4,0,32,28
1656299373026,MATH 109,B02,083216,Ganzberger; Geoffrey Michael,1,0,32,31
1656299373026,MATH 109,B03,093479,Staff,3,0,32,29
1656299379055,MATH 142A,A01,083219,Chow; Bennett,1,0,32,31
1656299379055,MATH 142A,A02,083220,Chow; Bennett,8,0,32,24
1656299379055,MATH 142A,A03,093480,Staff,5,0,32,27
1656299379055,MATH 142A,B03,093481,Staff,3,0,32,29
1656299379055,MATH 142A,B04,093558,Staff,6,0,32,26
1656299379055,MATH 142A,B05,093559,Staff,0,0,32,32
1656299385083,MATH 193A,A01,083224,Rotar; Vladimir,0,1,34,34
1656299385083,MATH 193A,A02,083225,Rotar; Vladimir,0,0,34,34
1656299385083,MATH 193A,A03,083781,Rotar; Vladimir,0,0,34,34
1656299385083,MATH 193A,A04,083782,Rotar; Vladimir,5,0,34,29
1656299385083,MATH 193A,A05,093482,Rotar; Vladimir,0,0,34,34
1656299391114,MATH 197,001,091859,McAuley; Julian John,9999,0,9999,0
1656299391114,MATH 197,002,095566,Kedlaya; Kiran S.,9997,0,9999,2
1656299391114,MATH 197,003,095567,Xiao; Ming,9999,0,9999,0
1656299391114,MATH 197,004,095571,Perols; Johan Lars,9998,0,9999,1
1656299398167,COGS 9,A01,083615,Shannon; Kyle Michael,3,0,75,72
1656299404190,COGS 11,A01,083617,Boyle; Mary E. T.,15,0,48,33
1656299410218,COGS 13,A01,083071,Bastos; Amalia Pinkusfeld,5,0,71,66
1656299416241,COGS 14A,A01,092681,Semenuks; Arturs,1,13,100,99
1656299422264,COGS 14B,A01,083073,Cheng; Tzu-Han,7,0,63,56
1656299428287,COGS 17,A01,092677,Semenuks; Arturs,6,0,81,75
1656299434309,COGS 100,A01,083619,Allen; Michael Gordon,2,0,70,68
1656299440337,COGS 101A,A01,083621,Davis; Joshua Daniel,4,0,68,64
1656299446360,COGS 101B,A01,091572,Allen; Michael Gordon,4,0,65,61
1656299452385,COGS 101C,A01,083625,Delgado; Tania,11,0,35,24
1656299458409,COGS 107A,A01,083627,Boyle; Mary E. T.,0,0,60,60
1656299464436,COGS 118A,A01,083075,Gupta; Anjum,8,0,76,68
1656299470460,CSE 3,A50,083646,Miranda; Gregory Joseph,18,0,50,32
1656299476482,CSE 8A,A50,083650,Miranda; Gregory Joseph,3,3,56,53
1656299482506,CSE 11,A01,083080,Cao; Yingjun,0,48,40,40
1656299488530,CSE 12,A01,083652,Krause-Levy; Sophia Louisa,5,1,120,115
1656299494552,CSE 15L,A01,083654,Morris; Justin Loren,2,0,50,48
1656299494552,CSE 15L,A02,083655,Morris; Justin Loren,4,0,50,46
1656299500664,CSE 20,A01,083657,Tran; Khoa Dang,30,0,80,50
1656299506686,CSE 21,A01,095574,Bach; Quang Tran,23,0,48,25
1656299512710,CSE 30,A01,083084,Eldon; John,2,6,80,78
1656299512710,CSE 30,B01,095061,Bhaskar; Nishant,0,1,50,50
1656299518734,CSE 100,A01,083659,Cao; Yingjun,1,18,70,69
1656299524757,CSE 134B,A01,083661,Powell; Thomas Allan,6,0,100,94
1656299530782,CSE 140,A01,083663,Gungor; Onat,9,0,85,76
1656299536810,CSE 140L,A01,083088,Eldon; John,10,0,100,90
1656299542833,CSE 175,A01,083665,Kumar; Rakesh,0,0,25,25
1656299548857,CSE 190,A00,092507,Dubnov; Shlomo,3,0,20,17
1656299554883,ECE 45,A01,083139,Congero; Spencer William,1,0,75,74
1656299560907,ECE 65,A50,083695,Saad; Andrew S,9,0,30,21
1656299560907,ECE 65,A51,095125,Staff,24,0,26,2
1656299566933,ECE 109,A01,091882,Touri; Behrouz,1,1,70,69
1656299572960,ECE 180,A00,083140,Abi Samra; Nicholas Camill,2,0,30,28
1656299572960,ECE 180,B00,083141,Abi Samra; Nicholas Camill,0,4,30,30
1656299578988,MATH 10A,A01,083735,Patchell; Gregory David,0,0,30,30
1656299578988,MATH 10A,A02,083736,Patchell; Gregory David,22,0,30,8
1656299578988,MATH 10A,A03,083737,Patchell; Gregory David,16,0,30,14
1656299585014,MATH 10B,A01,083207,Lim; Seonhee,2,0,34,32
1656299585014,MATH 10B,A02,083208,Lim; Seonhee,5,0,35,30
1656299585014,MATH 10B,A03,093472,Staff,1,0,34,33
1656299585014,MATH 10B,B01,083739,Sinha; Shubham,11,0,30,19
1656299591054,MATH 18,A01,083743,Cinel; Cameron Alexander,7,0,30,23
1656299591054,MATH 18,A02,083744,Cinel; Cameron Alexander,9,0,30,21
1656299591054,MATH 18,A03,083745,Cinel; Cameron Alexander,5,0,30,25
1656299591054,MATH 18,B01,083748,Rideout; David Porter,1,0,36,35
1656299591054,MATH 18,B02,083749,Rideout; David Porter,0,0,36,36
1656299591054,MATH 18,B03,083750,Rideout; David Porter,0,0,36,36
1656299591054,MATH 18,B04,083751,Rideout; David Porter,0,1,36,36
1656299591054,MATH 18,B05,093473,Rideout; David Porter,0,0,36,36
1656299591054,MATH 18,B06,093474,Rideout; David Porter,3,0,36,33
1656299597080,MATH 20A,A01,083754,Zheng; Zequn,11,0,40,29
1656299603108,MATH 20B,A01,083756,Briones; Jor-el Thomas Caparas,0,0,36,36
1656299603108,MATH 20B,A02,083757,Briones; Jor-el Thomas Caparas,0,0,36,36
1656299603108,MATH 20B,A03,093475,Staff,1,0,36,35
1656299609134,MATH 20C,A01,083760,Briones; Jor-el Thomas Caparas,0,0,35,35
1656299609134,MATH 20C,A02,083761,Briones; Jor-el Thomas Caparas,9,1,35,26
1656299609134,MATH 20C,A03,093476,Staff,0,0,35,35
1656299609134,MATH 20C,B01,083762,Bach; Quang Tran,2,0,30,28
1656299615157,MATH 20D,A01,083765,Tran; Brian Kha,1,0,30,29
1656299615157,MATH 20D,A02,083766,Tran; Brian Kha,1,1,30,29
1656299615157,MATH 20D,A03,083767,Tran; Brian Kha,2,0,30,28
1656299621181,MATH 20E,A01,083771,Ganguly; Soumya,2,0,32,30
1656299621181,MATH 20E,A02,083772,Ganguly; Soumya,0,0,32,32
1656299621181,MATH 20E,B01,083773,Ciotti; Benjamin,18,0,35,17
1656299621181,MATH 20E,B02,083774,Ciotti; Benjamin,15,0,35,20
1656299627208,MATH 103A,A01,083777,Greenfeld; Be'Eri,1,0,36,35
1656299627208,MATH 103A,A02,083778,Greenfeld; Be'Eri,3,0,36,33
1656299627208,MATH 103A,A03,093561,Staff,4,0,36,32
1656299627208,MATH 103A,B01,083779,Greenfeld; Be'Eri,8,0,36,28
1656299627208,MATH 103A,B02,083780,Greenfeld; Be'Eri,0,0,36,36
1656299627208,MATH 103A,B03,093562,Staff,1,0,36,35
1656299633235,MATH 105,A01,085443,Carter; Anne Toulson,5,0,35,30
1656299633235,MATH 105,A02,093477,Staff,14,0,35,21
1656299639266,MATH 109,A01,083213,Ganzberger; Geoffrey Michael,1,0,34,33
1656299639266,MATH 109,A02,083214,Ganzberger; Geoffrey Michael,0,0,34,34
1656299639266,MATH 109,A03,093478,Staff,2,0,34,32
1656299639266,MATH 109,B01,083215,Ganzberger; Geoffrey Michael,4,0,32,28
1656299639266,MATH 109,B02,083216,Ganzberger; Geoffrey Michael,1,0,32,31
1656299639266,MATH 109,B03,093479,Staff,3,0,32,29
1656299645295,MATH 142A,A01,083219,Chow; Bennett,1,0,32,31
1656299645295,MATH 142A,A02,083220,Chow; Bennett,8,0,32,24
1656299645295,MATH 142A,A03,093480,Staff,5,0,32,27
1656299645295,MATH 142A,B03,093481,Staff,3,0,32,29
1656299645295,MATH 142A,B04,093558,Staff,6,0,32,26
1656299645295,MATH 142A,B05,093559,Staff,0,0,32,32
1656299651319,MATH 193A,A01,083224,Rotar; Vladimir,0,1,34,34
1656299651319,MATH 193A,A02,083225,Rotar; Vladimir,0,0,34,34
1656299651319,MATH 193A,A03,083781,Rotar; Vladimir,0,0,34,34
1656299651319,MATH 193A,A04,083782,Rotar; Vladimir,5,0,34,29
1656299651319,MATH 193A,A05,093482,Rotar; Vladimir,0,0,34,34
1656299657356,MATH 197,001,091859,McAuley; Julian John,9999,0,9999,0
1656299657356,MATH 197,002,095566,Kedlaya; Kiran S.,9997,0,9999,2
1656299657356,MATH 197,003,095567,Xiao; Ming,9999,0,9999,0
1656299657356,MATH 197,004,095571,Perols; Johan Lars,9998,0,9999,1
1656299664420,COGS 9,A01,083615,Shannon; Kyle Michael,3,0,75,72
1656299670447,COGS 11,A01,083617,Boyle; Mary E. T.,15,0,48,33
1656299676470,COGS 13,A01,083071,Bastos; Amalia Pinkusfeld,5,0,71,66
1656299682496,COGS 14A,A01,092681,Semenuks; Arturs,1,13,100,99
1656299688522,COGS 14B,A01,083073,Cheng; Tzu-Han,7,0,63,56
1656299694544,COGS 17,A01,092677,Semenuks; Arturs,6,0,81,75
1656299700565,COGS 100,A01,083619,Allen; Michael Gordon,2,0,70,68
1656299706592,COGS 101A,A01,083621,Davis; Joshua Daniel,4,0,68,64
1656299712615,COGS 101B,A01,091572,Allen; Michael Gordon,4,0,65,61
1656299718643,COGS 101C,A01,083625,Delgado; Tania,11,0,35,24
1656299724675,COGS 107A,A01,083627,Boyle; Mary E. T.,0,0,60,60
1656299730698,COGS 118A,A01,083075,Gupta; Anjum,8,0,76,68
1656299736724,CSE 3,A50,083646,Miranda; Gregory Joseph,18,0,50,32
1656299742750,CSE 8A,A50,083650,Miranda; Gregory Joseph,3,3,56,53
1656299748773,CSE 11,A01,083080,Cao; Yingjun,0,48,40,40
1656299754808,CSE 12,A01,083652,Krause-Levy; Sophia Louisa,5,1,120,115
1656299760835,CSE 15L,A01,083654,Morris; Justin Loren,2,0,50,48
1656299760835,CSE 15L,A02,083655,Morris; Justin Loren,4,0,50,46
1656299766859,CSE 20,A01,083657,Tran; Khoa Dang,30,0,80,50
1656299772885,CSE 21,A01,095574,Bach; Quang Tran,23,0,48,25
1656299778907,CSE 30,A01,083084,Eldon; John,2,6,80,78
1656299778907,CSE 30,B01,095061,Bhaskar; Nishant,0,1,50,50
1656299784934,CSE 100,A01,083659,Cao; Yingjun,1,18,70,69
1656299790959,CSE 134B,A01,083661,Powell; Thomas Allan,6,0,100,94
1656299796983,CSE 140,A01,083663,Gungor; Onat,9,0,85,76
1656299803006,CSE 140L,A01,083088,Eldon; John,10,0,100,90
1656299809029,CSE 175,A01,083665,Kumar; Rakesh,0,0,25,25
1656299815070,CSE 190,A00,092507,Dubnov; Shlomo,3,0,20,17
1656299821094,ECE 45,A01,083139,Congero; Spencer William,1,0,75,74
1656299827125,ECE 65,A50,083695,Saad; Andrew S,9,0,30,21
1656299827125,ECE 65,A51,095125,Staff,24,0,26,2
1656299833150,ECE 109,A01,091882,Touri; Behrouz,1,1,70,69
1656299839173,ECE 180,A00,083140,Abi Samra; Nicholas Camill,2,0,30,28
1656299839173,ECE 180,B00,083141,Abi Samra; Nicholas Camill,0,4,30,30
1656299845200,MATH 10A,A01,083735,Patchell; Gregory David,0,0,30,30
1656299845200,MATH 10A,A02,083736,Patchell; Gregory David,22,0,30,8
1656299845200,MATH 10A,A03,083737,Patchell; Gregory David,16,0,30,14
1656299851236,MATH 10B,A01,083207,Lim; Seonhee,2,0,34,32
1656299851236,MATH 10B,A02,083208,Lim; Seonhee,5,0,35,30
1656299851236,MATH 10B,A03,093472,Staff,1,0,34,33
1656299851236,MATH 10B,B01,083739,Sinha; Shubham,11,0,30,19
1656299857277,MATH 18,A01,083743,Cinel; Cameron Alexander,7,0,30,23
1656299857277,MATH 18,A02,083744,Cinel; Cameron Alexander,9,0,30,21
1656299857277,MATH 18,A03,083745,Cinel; Cameron Alexander,5,0,30,25
1656299857277,MATH 18,B01,083748,Rideout; David Porter,1,0,36,35
1656299857277,MATH 18,B02,083749,Rideout; David Porter,0,0,36,36
1656299857277,MATH 18,B03,083750,Rideout; David Porter,0,0,36,36
1656299857277,MATH 18,B04,083751,Rideout; David Porter,0,1,36,36
1656299857277,MATH 18,B05,093473,Rideout; David Porter,0,0,36,36
1656299857277,MATH 18,B06,093474,Rideout; David Porter,3,0,36,33
1656299863299,MATH 20A,A01,083754,Zheng; Zequn,11,0,40,29
1656299869326,MATH 20B,A01,083756,Briones; Jor-el Thomas Caparas,0,0,36,36
1656299869326,MATH 20B,A02,083757,Briones; Jor-el Thomas Caparas,0,0,36,36
1656299869326,MATH 20B,A03,093475,Staff,1,0,36,35
1656299875347,MATH 20C,A01,083760,Briones; Jor-el Thomas Caparas,0,0,35,35
1656299875347,MATH 20C,A02,083761,Briones; Jor-el Thomas Caparas,9,1,35,26
1656299875347,MATH 20C,A03,093476,Staff,0,0,35,35
1656299875347,MATH 20C,B01,083762,Bach; Quang Tran,2,0,30,28
1656299881371,MATH 20D,A01,083765,Tran; Brian Kha,1,0,30,29
1656299881371,MATH 20D,A02,083766,Tran; Brian Kha,1,1,30,29
1656299881371,MATH 20D,A03,083767,Tran; Brian Kha,2,0,30,28
1656299887393,MATH 20E,A01,083771,Ganguly; Soumya,2,0,32,30
1656299887393,MATH 20E,A02,083772,Ganguly; Soumya,0,0,32,32
1656299887393,MATH 20E,B01,083773,Ciotti; Benjamin,18,0,35,17
1656299887393,MATH 20E,B02,083774,Ciotti; Benjamin,15,0,35,20
1656299893419,MATH 103A,A01,083777,Greenfeld; Be'Eri,1,0,36,35
1656299893419,MATH 103A,A02,083778,Greenfeld; Be'Eri,3,0,36,33
1656299893419,MATH 103A,A03,093561,Staff,4,0,36,32
1656299893419,MATH 103A,B01,083779,Greenfeld; Be'Eri,8,0,36,28
1656299893419,MATH 103A,B02,083780,Greenfeld; Be'Eri,0,0,36,36
1656299893419,MATH 103A,B03,093562,Staff,1,0,36,35
1656299899441,MATH 105,A01,085443,Carter; Anne Toulson,5,0,35,30
1656299899441,MATH 105,A02,093477,Staff,14,0,35,21
1656299905468,MATH 109,A01,083213,Ganzberger; Geoffrey Michael,1,0,34,33
1656299905468,MATH 109,A02,083214,Ganzberger; Geoffrey Michael,0,0,34,34
1656299905468,MATH 109,A03,093478,Staff,2,0,34,32
1656299905468,MATH 109,B01,083215,Ganzberger; Geoffrey Michael,4,0,32,28
1656299905468,MATH 109,B02,083216,Ganzberger; Geoffrey Michael,1,0,32,31
1656299905468,MATH 109,B03,093479,Staff,3,0,32,29
1656299911493,MATH 142A,A01,083219,Chow; Bennett,1,0,32,31
1656299911493,MATH 142A,A02,083220,Chow; Bennett,8,0,32,24
1656299911493,MATH 142A,A03,093480,Staff,5,0,32,27
1656299911493,MATH 142A,B03,093481,Staff,3,0,32,29
1656299911493,MATH 142A,B04,093558,Staff,6,0,32,26
1656299911493,MATH 142A,B05,093559,Staff,0,0,32,32
1656299917515,MATH 193A,A01,083224,Rotar; Vladimir,0,1,34,34
1656299917515,MATH 193A,A02,083225,Rotar; Vladimir,0,0,34,34
1656299917515,MATH 193A,A03,083781,Rotar; Vladimir,0,0,34,34
1656299917515,MATH 193A,A04,083782,Rotar; Vladimir,5,0,34,29
1656299917515,MATH 193A,A05,093482,Rotar; Vladimir,0,0,34,34
1656299923540,MATH 197,001,091859,McAuley; Julian John,9999,0,9999,0
1656299923540,MATH 197,002,095566,Kedlaya; Kiran S.,9997,0,9999,2
1656299923540,MATH 197,003,095567,Xiao; Ming,9999,0,9999,0
1656299923540,MATH 197,004,095571,Perols; Johan Lars,9998,0,9999,1
1656299930591,COGS 9,A01,083615,Shannon; Kyle Michael,3,0,75,72
1656299936613,COGS 11,A01,083617,Boyle; Mary E. T.,15,0,48,33
1656299942636,COGS 13,A01,083071,Bastos; Amalia Pinkusfeld,5,0,71,66
1656299948662,COGS 14A,A01,092681,Semenuks; Arturs,1,13,100,99
1656299954688,COGS 14B,A01,083073,Cheng; Tzu-Han,7,0,63,56
1656299960711,COGS 17,A01,092677,Semenuks; Arturs,6,0,81,75
1656299966740,COGS 100,A01,083619,Allen; Michael Gordon,2,0,70,68
1656299972767,COGS 101A,A01,083621,Davis; Joshua Daniel,4,0,68,64
1656299978789,COGS 101B,A01,091572,Allen; Michael Gordon,4,0,65,61
1656299984816,COGS 101C,A01,083625,Delgado; Tania,11,0,35,24
1656299990837,COGS 107A,A01,083627,Boyle; Mary E. T.,0,0,60,60
1656299996861,COGS 118A,A01,083075,Gupta; Anjum,8,0,76,68
1656300002888,CSE 3,A50,083646,Miranda; Gregory Joseph,18,0,50,32
1656300008911,CSE 8A,A50,083650,Miranda; Gregory Joseph,3,3,56,53
1656300014939,CSE 11,A01,083080,Cao; Yingjun,0,48,40,40
1656300020964,CSE 12,A01,083652,Krause-Levy; Sophia Louisa,5,1,120,115
1656300026992,CSE 15L,A01,083654,Morris; Justin Loren,2,0,50,48
1656300026992,CSE 15L,A02,083655,Morris; Justin Loren,4,0,50,46
1656300033019,CSE 20,A01,083657,Tran; Khoa Dang,30,0,80,50
1656300039043,CSE 21,A01,095574,Bach; Quang Tran,23,0,48,25
1656300045066,CSE 30,A01,083084,Eldon; John,2,6,80,78
1656300045066,CSE 30,B01,095061,Bhaskar; Nishant,0,1,50,50
1656300051089,CSE 100,A01,083659,Cao; Yingjun,1,18,70,69
1656300057112,CSE 134B,A01,083661,Powell; Thomas Allan,6,0,100,94
1656300063145,CSE 140,A01,083663,Gungor; Onat,9,0,85,76
1656300069167,CSE 140L,A01,083088,Eldon; John,10,0,100,90
1656300075190,CSE 175,A01,083665,Kumar; Rakesh,0,0,25,25
1656300081216,CSE 190,A00,092507,Dubnov; Shlomo,3,0,20,17
1656300087242,ECE 45,A01,083139,Congero; Spencer William,1,0,75,74
1656300093265,ECE 65,A50,083695,Saad; Andrew S,9,0,30,21
1656300093265,ECE 65,A51,095125,Staff,24,0,26,2
1656300099383,ECE 109,A01,091882,Touri; Behrouz,1,1,70,69
1656300105410,ECE 180,A00,083140,Abi Samra; Nicholas Camill,2,0,30,28
1656300105410,ECE 180,B00,083141,Abi Samra; Nicholas Camill,0,4,30,30
1656300111437,MATH 10A,A01,083735,Patchell; Gregory David,0,0,30,30
1656300111437,MATH 10A,A02,083736,Patchell; Gregory David,22,0,30,8
1656300111437,MATH 10A,A03,083737,Patchell; Gregory David,16,0,30,14
1656300117459,MATH 10B,A01,083207,Lim; Seonhee,2,0,34,32
1656300117459,MATH 10B,A02,083208,Lim; Seonhee,5,0,35,30
1656300117459,MATH 10B,A03,093472,Staff,1,0,34,33
1656300117459,MATH 10B,B01,083739,Sinha; Shubham,11,0,30,19
1656300123491,MATH 18,A01,083743,Cinel; Cameron Alexander,7,0,30,23
1656300123491,MATH 18,A02,083744,Cinel; Cameron Alexander,9,0,30,21
1656300123491,MATH 18,A03,083745,Cinel; Cameron Alexander,5,0,30,25
1656300123491,MATH 18,B01,083748,Rideout; David Porter,1,0,36,35
1656300123491,MATH 18,B02,083749,Rideout; David Porter,0,0,36,36
1656300123491,MATH 18,B03,083750,Rideout; David Porter,0,0,36,36
1656300123491,MATH 18,B04,083751,Rideout; David Porter,0,1,36,36
1656300123491,MATH 18,B05,093473,Rideout; David Porter,0,0,36,36
1656300123491,MATH 18,B06,093474,Rideout; David Porter,3,0,36,33
1656300129517,MATH 20A,A01,083754,Zheng; Zequn,11,0,40,29
1656300135542,MATH 20B,A01,083756,Briones; Jor-el Thomas Caparas,0,0,36,36
1656300135542,MATH 20B,A02,083757,Briones; Jor-el Thomas Caparas,0,0,36,36
1656300135542,MATH 20B,A03,093475,Staff,1,0,36,35
1656300141571,MATH 20C,A01,083760,Briones; Jor-el Thomas Caparas,0,0,35,35
1656300141571,MATH 20C,A02,083761,Briones; Jor-el Thomas Caparas,9,1,35,26
1656300141571,MATH 20C,A03,093476,Staff,0,0,35,35
1656300141571,MATH 20C,B01,083762,Bach; Quang Tran,2,0,30,28
1656300147599,MATH 20D,A01,083765,Tran; Brian Kha,1,0,30,29
1656300147599,MATH 20D,A02,083766,Tran; Brian Kha,1,1,30,29
1656300147599,MATH 20D,A03,083767,Tran; Brian Kha,2,0,30,28
1656300153623,MATH 20E,A01,083771,Ganguly; Soumya,2,0,32,30
1656300153623,MATH 20E,A02,083772,Ganguly; Soumya,0,0,32,32
1656300153623,MATH 20E,B01,083773,Ciotti; Benjamin,18,0,35,17
1656300153623,MATH 20E,B02,083774,Ciotti; Benjamin,15,0,35,20
1656300159653,MATH 103A,A01,083777,Greenfeld; Be'Eri,1,0,36,35
1656300159653,MATH 103A,A02,083778,Greenfeld; Be'Eri,3,0,36,33
1656300159653,MATH 103A,A03,093561,Staff,4,0,36,32
1656300159653,MATH 103A,B01,083779,Greenfeld; Be'Eri,8,0,36,28
1656300159653,MATH 103A,B02,083780,Greenfeld; Be'Eri,0,0,36,36
1656300159653,MATH 103A,B03,093562,Staff,1,0,36,35
1656300165681,MATH 105,A01,085443,Carter; Anne Toulson,5,0,35,30
1656300165681,MATH 105,A02,093477,Staff,14,0,35,21
1656300171711,MATH 109,A01,083213,Ganzberger; Geoffrey Michael,0,0,34,34
1656300171711,MATH 109,A02,083214,Ganzberger; Geoffrey Michael,0,0,34,34
1656300171711,MATH 109,A03,093478,Staff,2,0,34,32
1656300171711,MATH 109,B01,083215,Ganzberger; Geoffrey Michael,4,0,32,28
1656300171711,MATH 109,B02,083216,Ganzberger; Geoffrey Michael,1,0,32,31
1656300171711,MATH 109,B03,093479,Staff,3,0,32,29
1656300177738,MATH 142A,A01,083219,Chow; Bennett,1,0,32,31
1656300177738,MATH 142A,A02,083220,Chow; Bennett,8,0,32,24
1656300177738,MATH 142A,A03,093480,Staff,5,0,32,27
1656300177738,MATH 142A,B03,093481,Staff,3,0,32,29
1656300177738,MATH 142A,B04,093558,Staff,6,0,32,26
1656300177738,MATH 142A,B05,093559,Staff,0,0,32,32
1656300183762,MATH 193A,A01,083224,Rotar; Vladimir,0,1,34,34
1656300183762,MATH 193A,A02,083225,Rotar; Vladimir,0,0,34,34
1656300183762,MATH 193A,A03,083781,Rotar; Vladimir,0,0,34,34
1656300183762,MATH 193A,A04,083782,Rotar; Vladimir,5,0,34,29
1656300183762,MATH 193A,A05,093482,Rotar; Vladimir,0,0,34,34
1656300189784,MATH 197,001,091859,McAuley; Julian John,9999,0,9999,0
1656300189784,MATH 197,002,095566,Kedlaya; Kiran S.,9997,0,9999,2
1656300189784,MATH 197,003,095567,Xiao; Ming,9999,0,9999,0
1656300189784,MATH 197,004,095571,Perols; Johan Lars,9998,0,9999,1
1656300196844,COGS 9,A01,083615,Shannon; Kyle Michael,3,0,75,72
1656300202872,COGS 11,A01,083617,Boyle; Mary E. T.,15,0,48,33
1656300208898,COGS 13,A01,083071,Bastos; Amalia Pinkusfeld,6,0,71,65
1656300214926,COGS 14A,A01,092681,Semenuks; Arturs,1,13,100,99
1656300220953,COGS 14B,A01,083073,Cheng; Tzu-Han,7,0,63,56
1656300226980,COGS 17,A01,092677,Semenuks; Arturs,6,0,81,75
1656300233002,COGS 100,A01,083619,Allen; Michael Gordon,2,0,70,68
1656300239026,COGS 101A,A01,083621,Davis; Joshua Daniel,4,0,68,64
1656300245053,COGS 101B,A01,091572,Allen; Michael Gordon,4,0,65,61
1656300251080,COGS 101C,A01,083625,Delgado; Tania,11,0,35,24
1656300257103,COGS 107A,A01,083627,Boyle; Mary E. T.,0,0,60,60
1656300263130,COGS 118A,A01,083075,Gupta; Anjum,8,0,76,68
1656300269166,CSE 3,A50,083646,Miranda; Gregory Joseph,18,0,50,32
1656300275189,CSE 8A,A50,083650,Miranda; Gregory Joseph,3,3,56,53
1656300281230,CSE 11,A01,083080,Cao; Yingjun,0,48,40,40
1656300287257,CSE 12,A01,083652,Krause-Levy; Sophia Louisa,5,1,120,115
1656300293278,CSE 15L,A01,083654,Morris; Justin Loren,2,0,50,48
1656300293278,CSE 15L,A02,083655,Morris; Justin Loren,4,0,50,46
1656300299301,CSE 20,A01,083657,Tran; Khoa Dang,30,0,80,50
1656300305328,CSE 21,A01,095574,Bach; Quang Tran,23,0,48,25
1656300311356,CSE 30,A01,083084,Eldon; John,2,6,80,78
1656300311356,CSE 30,B01,095061,Bhaskar; Nishant,0,1,50,50
1656300317379,CSE 100,A01,083659,Cao; Yingjun,1,18,70,69
1656300323406,CSE 134B,A01,083661,Powell; Thomas Allan,6,0,100,94
1656300329428,CSE 140,A01,083663,Gungor; Onat,9,0,85,76
1656300335456,CSE 140L,A01,083088,Eldon; John,10,0,100,90
1656300341478,CSE 175,A01,083665,Kumar; Rakesh,0,0,25,25
1656300347505,CSE 190,A00,092507,Dubnov; Shlomo,3,0,20,17
1656300353535,ECE 45,A01,083139,Congero; Spencer William,1,0,75,74
1656300359558,ECE 65,A50,083695,Saad; Andrew S,9,0,30,21
1656300359558,ECE 65,A51,095125,Staff,24,0,26,2
1656300365586,ECE 109,A01,091882,Touri; Behrouz,1,1,70,69
1656300371609,ECE 180,A00,083140,Abi Samra; Nicholas Camill,2,0,30,28
1656300371609,ECE 180,B00,083141,Abi Samra; Nicholas Camill,0,4,30,30
1656300377633,MATH 10A,A01,083735,Patchell; Gregory David,0,0,30,30
1656300377633,MATH 10A,A02,083736,Patchell; Gregory David,22,0,30,8
1656300377633,MATH 10A,A03,083737,Patchell; Gregory David,16,0,30,14
1656300383659,MATH 10B,A01,083207,Lim; Seonhee,2,0,34,32
1656300383659,MATH 10B,A02,083208,Lim; Seonhee,5,0,35,30
1656300383659,MATH 10B,A03,093472,Staff,1,0,34,33
1656300383659,MATH 10B,B01,083739,Sinha; Shubham,11,0,30,19
1656300389684,MATH 18,A01,083743,Cinel; Cameron Alexander,7,0,30,23
1656300389684,MATH 18,A02,083744,Cinel; Cameron Alexander,9,0,30,21
1656300389684,MATH 18,A03,083745,Cinel; Cameron Alexander,5,0,30,25
1656300389684,MATH 18,B01,083748,Rideout; David Porter,1,0,36,35
1656300389684,MATH 18,B02,083749,Rideout; David Porter,0,0,36,36
1656300389684,MATH 18,B03,083750,Rideout; David Porter,0,0,36,36
1656300389684,MATH 18,B04,083751,Rideout; David Porter,0,1,36,36
1656300389684,MATH 18,B05,093473,Rideout; David Porter,0,0,36,36
1656300389684,MATH 18,B06,093474,Rideout; David Porter,3,0,36,33
1656300395718,MATH 20A,A01,083754,Zheng; Zequn,11,0,40,29
1656300401740,MATH 20B,A01,083756,Briones; Jor-el Thomas Caparas,0,0,36,36
1656300401740,MATH 20B,A02,083757,Briones; Jor-el Thomas Caparas,0,0,36,36
1656300401740,MATH 20B,A03,093475,Staff,1,0,36,35
1656300407764,MATH 20C,A01,083760,Briones; Jor-el Thomas Caparas,0,0,35,35
1656300407764,MATH 20C,A02,083761,Briones; Jor-el Thomas Caparas,9,1,35,26
1656300407764,MATH 20C,A03,093476,Staff,0,0,35,35
1656300407764,MATH 20C,B01,083762,Bach; Quang Tran,2,0,30,28
1656300413788,MATH 20D,A01,083765,Tran; Brian Kha,1,0,30,29
1656300413788,MATH 20D,A02,083766,Tran; Brian Kha,1,1,30,29
1656300413788,MATH 20D,A03,083767,Tran; Brian Kha,2,0,30,28
1656300419816,MATH 20E,A01,083771,Ganguly; Soumya,2,0,32,30
1656300419816,MATH 20E,A02,083772,Ganguly; Soumya,0,0,32,32
1656300419816,MATH 20E,B01,083773,Ciotti; Benjamin,18,0,35,17
1656300419816,MATH 20E,B02,083774,Ciotti; Benjamin,15,0,35,20
1656300425846,MATH 103A,A01,083777,Greenfeld; Be'Eri,1,0,36,35
1656300425846,MATH 103A,A02,083778,Greenfeld; Be'Eri,3,0,36,33
1656300425846,MATH 103A,A03,093561,Staff,4,0,36,32
1656300425846,MATH 103A,B01,083779,Greenfeld; Be'Eri,8,0,36,28
1656300425846,MATH 103A,B02,083780,Greenfeld; Be'Eri,0,0,36,36
1656300425846,MATH 103A,B03,093562,Staff,1,0,36,35
1656300431869,MATH 105,A01,085443,Carter; Anne Toulson,5,0,35,30
1656300431869,MATH 105,A02,093477,Staff,14,0,35,21
1656300437895,MATH 109,A01,083213,Ganzberger; Geoffrey Michael,0,0,34,34
1656300437895,MATH 109,A02,083214,Ganzberger; Geoffrey Michael,0,0,34,34
1656300437895,MATH 109,A03,093478,Staff,2,0,34,32
1656300437895,MATH 109,B01,083215,Ganzberger; Geoffrey Michael,4,0,32,28
1656300437895,MATH 109,B02,083216,Ganzberger; Geoffrey Michael,1,0,32,31
1656300437895,MATH 109,B03,093479,Staff,3,0,32,29
1656300443921,MATH 142A,A01,083219,Chow; Bennett,1,0,32,31
1656300443921,MATH 142A,A02,083220,Chow; Bennett,8,0,32,24
1656300443921,MATH 142A,A03,093480,Staff,5,0,32,27
1656300443921,MATH 142A,B03,093481,Staff,3,0,32,29
1656300443921,MATH 142A,B04,093558,Staff,6,0,32,26
1656300443921,MATH 142A,B05,093559,Staff,0,0,32,32
1656300449948,MATH 193A,A01,083224,Rotar; Vladimir,0,1,34,34
1656300449948,MATH 193A,A02,083225,Rotar; Vladimir,0,0,34,34
1656300449948,MATH 193A,A03,083781,Rotar; Vladimir,0,0,34,34
1656300449948,MATH 193A,A04,083782,Rotar; Vladimir,5,0,34,29
1656300449948,MATH 193A,A05,093482,Rotar; Vladimir,0,0,34,34
1656300455976,MATH 197,001,091859,McAuley; Julian John,9999,0,9999,0
1656300455976,MATH 197,002,095566,Kedlaya; Kiran S.,9997,0,9999,2
1656300455976,MATH 197,003,095567,Xiao; Ming,9999,0,9999,0
1656300455976,MATH 197,004,095571,Perols; Johan Lars,9998,0,9999,1
1656300463033,COGS 9,A01,083615,Shannon; Kyle Michael,3,0,75,72
1656300469059,COGS 11,A01,083617,Boyle; Mary E. T.,15,0,48,33
1656300475082,COGS 13,A01,083071,Bastos; Amalia Pinkusfeld,6,0,71,65
1656300481110,COGS 14A,A01,092681,Semenuks; Arturs,1,13,100,99
1656300487137,COGS 14B,A01,083073,Cheng; Tzu-Han,7,0,63,56
1656300493160,COGS 17,A01,092677,Semenuks; Arturs,6,0,81,75
1656300499182,COGS 100,A01,083619,Allen; Michael Gordon,2,0,70,68
1656300505204,COGS 101A,A01,083621,Davis; Joshua Daniel,4,0,68,64
1656300511232,COGS 101B,A01,091572,Allen; Michael Gordon,4,0,65,61
1656300517254,COGS 101C,A01,083625,Delgado; Tania,11,0,35,24
1656300523277,COGS 107A,A01,083627,Boyle; Mary E. T.,0,0,60,60
1656300529300,COGS 118A,A01,083075,Gupta; Anjum,8,0,76,68
1656300535327,CSE 3,A50,083646,Miranda; Gregory Joseph,18,0,50,32
1656300541350,CSE 8A,A50,083650,Miranda; Gregory Joseph,3,3,56,53
1656300547374,CSE 11,A01,083080,Cao; Yingjun,0,48,40,40
1656300553403,CSE 12,A01,083652,Krause-Levy; Sophia Louisa,5,1,120,115
1656300559425,CSE 15L,A01,083654,Morris; Justin Loren,2,0,50,48
1656300559425,CSE 15L,A02,083655,Morris; Justin Loren,4,0,50,46
1656300565448,CSE 20,A01,083657,Tran; Khoa Dang,30,0,80,50
1656300571474,CSE 21,A01,095574,Bach; Quang Tran,23,0,48,25
1656300577496,CSE 30,A01,083084,Eldon; John,2,6,80,78
1656300577496,CSE 30,B01,095061,Bhaskar; Nishant,0,1,50,50
1656300583521,CSE 100,A01,083659,Cao; Yingjun,1,18,70,69
1656300589543,CSE 134B,A01,083661,Powell; Thomas Allan,6,0,100,94
1656300595565,CSE 140,A01,083663,Gungor; Onat,9,0,85,76
1656300601596,CSE 140L,A01,083088,Eldon; John,10,0,100,90
1656300607617,CSE 175,A01,083665,Kumar; Rakesh,0,0,25,25
1656300613640,CSE 190,A00,092507,Dubnov; Shlomo,3,0,20,17
1656300619664,ECE 45,A01,083139,Congero; Spencer William,1,0,75,74
1656300625691,ECE 65,A50,083695,Saad; Andrew S,9,0,30,21
1656300625691,ECE 65,A51,095125,Staff,24,0,26,2
1656300631714,ECE 109,A01,091882,Touri; Behrouz,1,1,70,69
1656300637746,ECE 180,A00,083140,Abi Samra; Nicholas Camill,2,0,30,28
1656300637746,ECE 180,B00,083141,Abi Samra; Nicholas Camill,0,4,30,30
1656300643773,MATH 10A,A01,083735,Patchell; Gregory David,0,0,30,30
1656300643773,MATH 10A,A02,083736,Patchell; Gregory David,22,0,30,8
1656300643773,MATH 10A,A03,083737,Patchell; Gregory David,16,0,30,14
1656300649810,MATH 10B,A01,083207,Lim; Seonhee,2,0,34,32
1656300649810,MATH 10B,A02,083208,Lim; Seonhee,5,0,35,30
1656300649810,MATH 10B,A03,093472,Staff,1,0,34,33
1656300649810,MATH 10B,B01,083739,Sinha; Shubham,11,0,30,19
1656300655843,MATH 18,A01,083743,Cinel; Cameron Alexander,7,0,30,23
1656300655843,MATH 18,A02,083744,Cinel; Cameron Alexander,9,0,30,21
1656300655843,MATH 18,A03,083745,Cinel; Cameron Alexander,5,0,30,25
1656300655843,MATH 18,B01,083748,Rideout; David Porter,1,0,36,35
1656300655843,MATH 18,B02,083749,Rideout; David Porter,0,0,36,36
1656300655843,MATH 18,B03,083750,Rideout; David Porter,0,0,36,36
1656300655843,MATH 18,B04,083751,Rideout; David Porter,0,1,36,36
1656300655843,MATH 18,B05,093473,Rideout; David Porter,0,0,36,36
1656300655843,MATH 18,B06,093474,Rideout; David Porter,3,0,36,33
1656300661867,MATH 20A,A01,083754,Zheng; Zequn,11,0,40,29
1656300667890,MATH 20B,A01,083756,Briones; Jor-el Thomas Caparas,0,0,36,36
1656300667890,MATH 20B,A02,083757,Briones; Jor-el Thomas Caparas,0,0,36,36
1656300667890,MATH 20B,A03,093475,Staff,1,0,36,35
1656300673922,MATH 20C,A01,083760,Briones; Jor-el Thomas Caparas,0,0,35,35
1656300673922,MATH 20C,A02,083761,Briones; Jor-el Thomas Caparas,9,1,35,26
1656300673922,MATH 20C,A03,093476,Staff,0,0,35,35
1656300673922,MATH 20C,B01,083762,Bach; Quang Tran,2,0,30,28
1656300679951,MATH 20D,A01,083765,Tran; Brian Kha,1,0,30,29
1656300679951,MATH 20D,A02,083766,Tran; Brian Kha,1,1,30,29
1656300679951,MATH 20D,A03,083767,Tran; Brian Kha,2,0,30,28
1656300685974,MATH 20E,A01,083771,Ganguly; Soumya,2,0,32,30
1656300685974,MATH 20E,A02,083772,Ganguly; Soumya,0,0,32,32
1656300685974,MATH 20E,B01,083773,Ciotti; Benjamin,18,0,35,17
1656300685974,MATH 20E,B02,083774,Ciotti; Benjamin,15,0,35,20
1656300691998,MATH 103A,A01,083777,Greenfeld; Be'Eri,2,0,36,34
1656300691998,MATH 103A,A02,083778,Greenfeld; Be'Eri,3,0,36,33
1656300691998,MATH 103A,A03,093561,Staff,4,0,36,32
1656300691998,MATH 103A,B01,083779,Greenfeld; Be'Eri,8,0,36,28
1656300691998,MATH 103A,B02,083780,Greenfeld; Be'Eri,0,0,36,36
1656300691998,MATH 103A,B03,093562,Staff,1,0,36,35
1656300698095,MATH 105,A01,085443,Carter; Anne Toulson,5,0,35,30
1656300698095,MATH 105,A02,093477,Staff,14,0,35,21
1656300704122,MATH 109,A01,083213,Ganzberger; Geoffrey Michael,0,0,34,34
1656300704122,MATH 109,A02,083214,Ganzberger; Geoffrey Michael,0,0,34,34
1656300704122,MATH 109,A03,093478,Staff,2,0,34,32
1656300704122,MATH 109,B01,083215,Ganzberger; Geoffrey Michael,4,0,32,28
1656300704122,MATH 109,B02,083216,Ganzberger; Geoffrey Michael,1,0,32,31
1656300704122,MATH 109,B03,093479,Staff,3,0,32,29
1656300710156,MATH 142A,A01,083219,Chow; Bennett,1,0,32,31
1656300710156,MATH 142A,A02,083220,Chow; Bennett,8,0,32,24
1656300710156,MATH 142A,A03,093480,Staff,5,0,32,27
1656300710156,MATH 142A,B03,093481,Staff,3,0,32,29
1656300710156,MATH 142A,B04,093558,Staff,6,0,32,26
1656300710156,MATH 142A,B05,093559,Staff,0,0,32,32
1656300716193,MATH 193A,A01,083224,Rotar; Vladimir,0,1,34,34
1656300716193,MATH 193A,A02,083225,Rotar; Vladimir,0,0,34,34
1656300716193,MATH 193A,A03,083781,Rotar; Vladimir,0,0,34,34
1656300716193,MATH 193A,A04,083782,Rotar; Vladimir,5,0,34,29
1656300716193,MATH 193A,A05,093482,Rotar; Vladimir,0,0,34,34
1656300722228,MATH 197,001,091859,McAuley; Julian John,9999,0,9999,0
1656300722228,MATH 197,002,095566,Kedlaya; Kiran S.,9997,0,9999,2
1656300722228,MATH 197,003,095567,Xiao; Ming,9999,0,9999,0
1656300722228,MATH 197,004,095571,Perols; Johan Lars,9998,0,9999,1
1656300729288,COGS 9,A01,083615,Shannon; Kyle Michael,3,0,75,72
1656300735315,COGS 11,A01,083617,Boyle; Mary E. T.,15,0,48,33
1656300741342,COGS 13,A01,083071,Bastos; Amalia Pinkusfeld,6,0,71,65
1656300747369,COGS 14A,A01,092681,Semenuks; Arturs,1,13,100,99
1656300753392,COGS 14B,A01,083073,Cheng; Tzu-Han,7,0,63,56
1656300759416,COGS 17,A01,092677,Semenuks; Arturs,6,0,81,75
1656300765438,COGS 100,A01,083619,Allen; Michael Gordon,2,0,70,68
1656300771462,COGS 101A,A01,083621,Davis; Joshua Daniel,4,0,68,64
1656300777492,COGS 101B,A01,091572,Allen; Michael Gordon,4,0,65,61
1656300783521,COGS 101C,A01,083625,Delgado; Tania,11,0,35,24
1656300789547,COGS 107A,A01,083627,Boyle; Mary E. T.,0,0,60,60
1656300795584,COGS 118A,A01,083075,Gupta; Anjum,8,0,76,68
1656300801608,CSE 3,A50,083646,Miranda; Gregory Joseph,18,0,50,32
1656300807632,CSE 8A,A50,083650,Miranda; Gregory Joseph,3,3,56,53
1656300813653,CSE 11,A01,083080,Cao; Yingjun,0,48,40,40
1656300819678,CSE 12,A01,083652,Krause-Levy; Sophia Louisa,5,1,120,115
1656300825715,CSE 15L,A01,083654,Morris; Justin Loren,2,0,50,48
1656300825715,CSE 15L,A02,083655,Morris; Justin Loren,4,0,50,46
1656300831737,CSE 20,A01,083657,Tran; Khoa Dang,30,0,80,50
1656300837764,CSE 21,A01,095574,Bach; Quang Tran,23,0,48,25
1656300843786,CSE 30,A01,083084,Eldon; John,2,6,80,78
1656300843786,CSE 30,B01,095061,Bhaskar; Nishant,0,1,50,50
1656300849807,CSE 100,A01,083659,Cao; Yingjun,1,18,70,69
1656300855830,CSE 134B,A01,083661,Powell; Thomas Allan,6,0,100,94
1656300861853,CSE 140,A01,083663,Gungor; Onat,9,0,85,76
1656300867876,CSE 140L,A01,083088,Eldon; John,10,0,100,90
1656300873900,CSE 175,A01,083665,Kumar; Rakesh,0,0,25,25
1656300879922,CSE 190,A00,092507,Dubnov; Shlomo,3,0,20,17
1656300885944,ECE 45,A01,083139,Congero; Spencer William,1,0,75,74
1656300891968,ECE 65,A50,083695,Saad; Andrew S,9,0,30,21
1656300891968,ECE 65,A51,095125,Staff,24,0,26,2
1656300897995,ECE 109,A01,091882,Touri; Behrouz,1,1,70,69
1656300904021,ECE 180,A00,083140,Abi Samra; Nicholas Camill,2,0,30,28
1656300904021,ECE 180,B00,083141,Abi Samra; Nicholas Camill,0,4,30,30
1656300910044,MATH 10A,A01,083735,Patchell; Gregory David,0,0,30,30
1656300910044,MATH 10A,A02,083736,Patchell; Gregory David,22,0,30,8
1656300910044,MATH 10A,A03,083737,Patchell; Gregory David,16,0,30,14
1656300916068,MATH 10B,A01,083207,Lim; Seonhee,2,0,34,32
1656300916068,MATH 10B,A02,083208,Lim; Seonhee,5,0,35,30
1656300916068,MATH 10B,A03,093472,Staff,1,0,34,33
1656300916068,MATH 10B,B01,083739,Sinha; Shubham,11,0,30,19
1656300922099,MATH 18,A01,083743,Cinel; Cameron Alexander,7,0,30,23
1656300922099,MATH 18,A02,083744,Cinel; Cameron Alexander,9,0,30,21
1656300922099,MATH 18,A03,083745,Cinel; Cameron Alexander,5,0,30,25
1656300922099,MATH 18,B01,083748,Rideout; David Porter,1,0,36,35
1656300922099,MATH 18,B02,083749,Rideout; David Porter,0,0,36,36
1656300922099,MATH 18,B03,083750,Rideout; David Porter,0,0,36,36
1656300922099,MATH 18,B04,083751,Rideout; David Porter,0,1,36,36
1656300922099,MATH 18,B05,093473,Rideout; David Porter,0,0,36,36
1656300922099,MATH 18,B06,093474,Rideout; David Porter,3,0,36,33
1656300928123,MATH 20A,A01,083754,Zheng; Zequn,11,0,40,29
1656300934150,MATH 20B,A01,083756,Briones; Jor-el Thomas Caparas,0,0,36,36
1656300934150,MATH 20B,A02,083757,Briones; Jor-el Thomas Caparas,0,0,36,36
1656300934150,MATH 20B,A03,093475,Staff,1,0,36,35
1656300940177,MATH 20C,A01,083760,Briones; Jor-el Thomas Caparas,0,0,35,35
1656300940177,MATH 20C,A02,083761,Briones; Jor-el Thomas Caparas,9,1,35,26
1656300940177,MATH 20C,A03,093476,Staff,0,0,35,35
1656300940177,MATH 20C,B01,083762,Bach; Quang Tran,2,0,30,28
1656300946211,MATH 20D,A01,083765,Tran; Brian Kha,1,0,30,29
1656300946211,MATH 20D,A02,083766,Tran; Brian Kha,1,1,30,29
1656300946211,MATH 20D,A03,083767,Tran; Brian Kha,2,0,30,28
1656300952234,MATH 20E,A01,083771,Ganguly; Soumya,2,0,32,30
1656300952234,MATH 20E,A02,083772,Ganguly; Soumya,0,0,32,32
1656300952234,MATH 20E,B01,083773,Ciotti; Benjamin,18,0,35,17
1656300952234,MATH 20E,B02,083774,Ciotti; Benjamin,15,0,35,20
1656300958258,MATH 103A,A01,083777,Greenfeld; Be'Eri,2,0,36,34
1656300958258,MATH 103A,A02,083778,Greenfeld; Be'Eri,3,0,36,33
1656300958258,MATH 103A,A03,093561,Staff,3,0,36,33
1656300958258,MATH 103A,B01,083779,Greenfeld; Be'Eri,8,0,36,28
1656300958258,MATH 103A,B02,083780,Greenfeld; Be'Eri,0,0,36,36
1656300958258,MATH 103A,B03,093562,Staff,1,0,36,35
1656300964280,MATH 105,A01,085443,Carter; Anne Toulson,5,0,35,30
1656300964280,MATH 105,A02,093477,Staff,14,0,35,21
1656300970308,MATH 109,A01,083213,Ganzberger; Geoffrey Michael,0,0,34,34
1656300970308,MATH 109,A02,083214,Ganzberger; Geoffrey Michael,0,0,34,34
1656300970308,MATH 109,A03,093478,Staff,2,0,34,32
1656300970308,MATH 109,B01,083215,Ganzberger; Geoffrey Michael,4,0,32,28
1656300970308,MATH 109,B02,083216,Ganzberger; Geoffrey Michael,1,0,32,31
1656300970308,MATH 109,B03,093479,Staff,3,0,32,29
1656300976332,MATH 142A,A01,083219,Chow; Bennett,1,0,32,31
1656300976332,MATH 142A,A02,083220,Chow; Bennett,8,0,32,24
1656300976332,MATH 142A,A03,093480,Staff,5,0,32,27
1656300976332,MATH 142A,B03,093481,Staff,3,0,32,29
1656300976332,MATH 142A,B04,093558,Staff,6,0,32,26
1656300976332,MATH 142A,B05,093559,Staff,0,0,32,32
1656300982355,MATH 193A,A01,083224,Rotar; Vladimir,0,1,34,34
1656300982355,MATH 193A,A02,083225,Rotar; Vladimir,0,0,34,34
1656300982355,MATH 193A,A03,083781,Rotar; Vladimir,0,0,34,34
1656300982355,MATH 193A,A04,083782,Rotar; Vladimir,5,0,34,29
1656300982355,MATH 193A,A05,093482,Rotar; Vladimir,0,0,34,34
1656300988379,MATH 197,001,091859,McAuley; Julian John,9999,0,9999,0
1656300988379,MATH 197,002,095566,Kedlaya; Kiran S.,9997,0,9999,2
1656300988379,MATH 197,003,095567,Xiao; Ming,9999,0,9999,0
1656300988379,MATH 197,004,095571,Perols; Johan Lars,9998,0,9999,1
1656300995451,COGS 9,A01,083615,Shannon; Kyle Michael,3,0,75,72
1656301001475,COGS 11,A01,083617,Boyle; Mary E. T.,15,0,48,33
1656301007499,COGS 13,A01,083071,Bastos; Amalia Pinkusfeld,6,0,71,65
1656301013526,COGS 14A,A01,092681,Semenuks; Arturs,1,13,100,99
1656301019548,COGS 14B,A01,083073,Cheng; Tzu-Han,7,0,63,56
1656301025575,COGS 17,A01,092677,Semenuks; Arturs,6,0,81,75
1656301031602,COGS 100,A01,083619,Allen; Michael Gordon,2,0,70,68
1656301037626,COGS 101A,A01,083621,Davis; Joshua Daniel,4,0,68,64
1656301043650,COGS 101B,A01,091572,Allen; Michael Gordon,4,0,65,61
1656301049675,COGS 101C,A01,083625,Delgado; Tania,11,0,35,24
1656301055698,COGS 107A,A01,083627,Boyle; Mary E. T.,0,0,60,60
1656301061725,COGS 118A,A01,083075,Gupta; Anjum,8,0,76,68
1656301067753,CSE 3,A50,083646,Miranda; Gregory Joseph,18,0,50,32
1656301073781,CSE 8A,A50,083650,Miranda; Gregory Joseph,3,3,56,53
1656301079805,CSE 11,A01,083080,Cao; Yingjun,0,48,40,40
1656301085830,CSE 12,A01,083652,Krause-Levy; Sophia Louisa,5,1,120,115
1656301091853,CSE 15L,A01,083654,Morris; Justin Loren,2,0,50,48
1656301091853,CSE 15L,A02,083655,Morris; Justin Loren,4,0,50,46
1656301097880,CSE 20,A01,083657,Tran; Khoa Dang,30,0,80,50
1656301103903,CSE 21,A01,095574,Bach; Quang Tran,23,0,48,25
1656301109946,CSE 30,A01,083084,Eldon; John,2,6,80,78
1656301109946,CSE 30,B01,095061,Bhaskar; Nishant,0,1,50,50
1656301115969,CSE 100,A01,083659,Cao; Yingjun,1,18,70,69
1656301121993,CSE 134B,A01,083661,Powell; Thomas Allan,6,0,100,94
1656301128025,CSE 140,A01,083663,Gungor; Onat,9,0,85,76
1656301134055,CSE 140L,A01,083088,Eldon; John,10,0,100,90
1656301140079,CSE 175,A01,083665,Kumar; Rakesh,0,0,25,25
1656301146109,CSE 190,A00,092507,Dubnov; Shlomo,3,0,20,17
1656301152133,ECE 45,A01,083139,Congero; Spencer William,1,0,75,74
1656301158155,ECE 65,A50,083695,Saad; Andrew S,9,0,30,21
1656301158155,ECE 65,A51,095125,Staff,24,0,26,2
1656301164179,ECE 109,A01,091882,Touri; Behrouz,1,1,70,69
1656301170202,ECE 180,A00,083140,Abi Samra; Nicholas Camill,2,0,30,28
1656301170202,ECE 180,B00,083141,Abi Samra; Nicholas Camill,0,4,30,30
1656301176225,MATH 10A,A01,083735,Patchell; Gregory David,0,0,30,30
1656301176225,MATH 10A,A02,083736,Patchell; Gregory David,22,0,30,8
1656301176225,MATH 10A,A03,083737,Patchell; Gregory David,16,0,30,14
1656301182248,MATH 10B,A01,083207,Lim; Seonhee,2,0,34,32
1656301182248,MATH 10B,A02,083208,Lim; Seonhee,5,0,35,30
1656301182248,MATH 10B,A03,093472,Staff,1,0,34,33
1656301182248,MATH 10B,B01,083739,Sinha; Shubham,11,0,30,19
1656301188273,MATH 18,A01,083743,Cinel; Cameron Alexander,7,0,30,23
1656301188273,MATH 18,A02,083744,Cinel; Cameron Alexander,9,0,30,21
1656301188273,MATH 18,A03,083745,Cinel; Cameron Alexander,5,0,30,25
1656301188273,MATH 18,B01,083748,Rideout; David Porter,1,0,36,35
1656301188273,MATH 18,B02,083749,Rideout; David Porter,0,0,36,36
1656301188273,MATH 18,B03,083750,Rideout; David Porter,0,0,36,36
1656301188273,MATH 18,B04,083751,Rideout; David Porter,0,1,36,36
1656301188273,MATH 18,B05,093473,Rideout; David Porter,0,0,36,36
1656301188273,MATH 18,B06,093474,Rideout; David Porter,3,0,36,33
1656301194300,MATH 20A,A01,083754,Zheng; Zequn,11,0,40,29
1656301200324,MATH 20B,A01,083756,Briones; Jor-el Thomas Caparas,0,0,36,36
1656301200324,MATH 20B,A02,083757,Briones; Jor-el Thomas Caparas,0,0,36,36
1656301200324,MATH 20B,A03,093475,Staff,1,0,36,35
1656301206352,MATH 20C,A01,083760,Briones; Jor-el Thomas Caparas,0,0,35,35
1656301206352,MATH 20C,A02,083761,Briones; Jor-el Thomas Caparas,9,1,35,26
1656301206352,MATH 20C,A03,093476,Staff,0,0,35,35
1656301206352,MATH 20C,B01,083762,Bach; Quang Tran,2,0,30,28
1656301212375,MATH 20D,A01,083765,Tran; Brian Kha,1,0,30,29
1656301212375,MATH 20D,A02,083766,Tran; Brian Kha,1,1,30,29
1656301212375,MATH 20D,A03,083767,Tran; Brian Kha,2,0,30,28
1656301218404,MATH 20E,A01,083771,Ganguly; Soumya,2,0,32,30
1656301218404,MATH 20E,A02,083772,Ganguly; Soumya,0,0,32,32
1656301218404,MATH 20E,B01,083773,Ciotti; Benjamin,18,0,35,17
1656301218404,MATH 20E,B02,083774,Ciotti; Benjamin,15,0,35,20
1656301224434,MATH 103A,A01,083777,Greenfeld; Be'Eri,2,0,36,34
1656301224434,MATH 103A,A02,083778,Greenfeld; Be'Eri,3,0,36,33
1656301224434,MATH 103A,A03,093561,Staff,3,0,36,33
1656301224434,MATH 103A,B01,083779,Greenfeld; Be'Eri,8,0,36,28
1656301224434,MATH 103A,B02,083780,Greenfeld; Be'Eri,0,0,36,36
1656301224434,MATH 103A,B03,093562,Staff,1,0,36,35
1656301230462,MATH 105,A01,085443,Carter; Anne Toulson,5,0,35,30
1656301230462,MATH 105,A02,093477,Staff,14,0,35,21
1656301236485,MATH 109,A01,083213,Ganzberger; Geoffrey Michael,0,0,34,34
1656301236485,MATH 109,A02,083214,Ganzberger; Geoffrey Michael,0,0,34,34
1656301236485,MATH 109,A03,093478,Staff,2,0,34,32
1656301236485,MATH 109,B01,083215,Ganzberger; Geoffrey Michael,4,0,32,28
1656301236485,MATH 109,B02,083216,Ganzberger; Geoffrey Michael,1,0,32,31
1656301236485,MATH 109,B03,093479,Staff,3,0,32,29
1656301242515,MATH 142A,A01,083219,Chow; Bennett,1,0,32,31
1656301242515,MATH 142A,A02,083220,Chow; Bennett,8,0,32,24
1656301242515,MATH 142A,A03,093480,Staff,5,0,32,27
1656301242515,MATH 142A,B03,093481,Staff,3,0,32,29
1656301242515,MATH 142A,B04,093558,Staff,6,0,32,26
1656301242515,MATH 142A,B05,093559,Staff,0,0,32,32
1656301248547,MATH 193A,A01,083224,Rotar; Vladimir,0,1,34,34
1656301248547,MATH 193A,A02,083225,Rotar; Vladimir,0,0,34,34
1656301248547,MATH 193A,A03,083781,Rotar; Vladimir,0,0,34,34
1656301248547,MATH 193A,A04,083782,Rotar; Vladimir,5,0,34,29
1656301248547,MATH 193A,A05,093482,Rotar; Vladimir,0,0,34,34
1656301254571,MATH 197,001,091859,McAuley; Julian John,9999,0,9999,0
1656301254571,MATH 197,002,095566,Kedlaya; Kiran S.,9997,0,9999,2
1656301254571,MATH 197,003,095567,Xiao; Ming,9999,0,9999,0
1656301254571,MATH 197,004,095571,Perols; Johan Lars,9998,0,9999,1
1656301261648,COGS 9,A01,083615,Shannon; Kyle Michael,3,0,75,72
1656301267676,COGS 11,A01,083617,Boyle; Mary E. T.,15,0,48,33
1656301273710,COGS 13,A01,083071,Bastos; Amalia Pinkusfeld,6,0,71,65
1656301279734,COGS 14A,A01,092681,Semenuks; Arturs,1,13,100,99
1656301285777,COGS 14B,A01,083073,Cheng; Tzu-Han,7,0,63,56
1656301291873,COGS 17,A01,092677,Semenuks; Arturs,6,0,81,75
1656301297896,COGS 100,A01,083619,Allen; Michael Gordon,2,0,70,68
1656301303923,COGS 101A,A01,083621,Davis; Joshua Daniel,4,0,68,64
1656301309946,COGS 101B,A01,091572,Allen; Michael Gordon,4,0,65,61
1656301315983,COGS 101C,A01,083625,Delgado; Tania,11,0,35,24
1656301322007,COGS 107A,A01,083627,Boyle; Mary E. T.,0,0,60,60
1656301328036,COGS 118A,A01,083075,Gupta; Anjum,8,0,76,68
1656301334060,CSE 3,A50,083646,Miranda; Gregory Joseph,18,0,50,32
1656301340083,CSE 8A,A50,083650,Miranda; Gregory Joseph,3,3,56,53
1656301346105,CSE 11,A01,083080,Cao; Yingjun,0,48,40,40
1656301352130,CSE 12,A01,083652,Krause-Levy; Sophia Louisa,5,1,120,115
1656301358154,CSE 15L,A01,083654,Morris; Justin Loren,2,0,50,48
1656301358154,CSE 15L,A02,083655,Morris; Justin Loren,4,0,50,46
1656301364179,CSE 20,A01,083657,Tran; Khoa Dang,30,0,80,50
1656301370203,CSE 21,A01,095574,Bach; Quang Tran,23,0,48,25
1656301376227,CSE 30,A01,083084,Eldon; John,2,6,80,78
1656301376227,CSE 30,B01,095061,Bhaskar; Nishant,0,1,50,50
1656301382251,CSE 100,A01,083659,Cao; Yingjun,1,18,70,69
1656301388277,CSE 134B,A01,083661,Powell; Thomas Allan,6,0,100,94
1656301394308,CSE 140,A01,083663,Gungor; Onat,9,0,85,76
1656301400334,CSE 140L,A01,083088,Eldon; John,10,0,100,90
1656301406357,CSE 175,A01,083665,Kumar; Rakesh,0,0,25,25
1656301412389,CSE 190,A00,092507,Dubnov; Shlomo,3,0,20,17
1656301418411,ECE 45,A01,083139,Congero; Spencer William,1,0,75,74
1656301424435,ECE 65,A50,083695,Saad; Andrew S,9,0,30,21
1656301424435,ECE 65,A51,095125,Staff,24,0,26,2
1656301430463,ECE 109,A01,091882,Touri; Behrouz,1,1,70,69
1656301436489,ECE 180,A00,083140,Abi Samra; Nicholas Camill,2,0,30,28
1656301436489,ECE 180,B00,083141,Abi Samra; Nicholas Camill,0,4,30,30
1656301442514,MATH 10A,A01,083735,Patchell; Gregory David,0,0,30,30
1656301442514,MATH 10A,A02,083736,Patchell; Gregory David,22,0,30,8
1656301442514,MATH 10A,A03,083737,Patchell; Gregory David,16,0,30,14
1656301448537,MATH 10B,A01,083207,Lim; Seonhee,2,0,34,32
1656301448537,MATH 10B,A02,083208,Lim; Seonhee,5,0,35,30
1656301448537,MATH 10B,A03,093472,Staff,1,0,34,33
1656301448537,MATH 10B,B01,083739,Sinha; Shubham,11,0,30,19
1656301454560,MATH 18,A01,083743,Cinel; Cameron Alexander,7,0,30,23
1656301454560,MATH 18,A02,083744,Cinel; Cameron Alexander,10,0,30,20
1656301454560,MATH 18,A03,083745,Cinel; Cameron Alexander,5,0,30,25
1656301454560,MATH 18,B01,083748,Rideout; David Porter,0,0,36,36
1656301454560,MATH 18,B02,083749,Rideout; David Porter,0,0,36,36
1656301454560,MATH 18,B03,083750,Rideout; David Porter,0,0,36,36
1656301454560,MATH 18,B04,083751,Rideout; David Porter,0,1,36,36
1656301454560,MATH 18,B05,093473,Rideout; David Porter,0,0,36,36
1656301454560,MATH 18,B06,093474,Rideout; David Porter,3,0,36,33
1656301460584,MATH 20A,A01,083754,Zheng; Zequn,11,0,40,29
1656301466606,MATH 20B,A01,083756,Briones; Jor-el Thomas Caparas,0,0,36,36
1656301466606,MATH 20B,A02,083757,Briones; Jor-el Thomas Caparas,0,0,36,36
1656301466606,MATH 20B,A03,093475,Staff,1,0,36,35
1656301472634,MATH 20C,A01,083760,Briones; Jor-el Thomas Caparas,0,0,35,35
1656301472634,MATH 20C,A02,083761,Briones; Jor-el Thomas Caparas,9,1,35,26
1656301472634,MATH 20C,A03,093476,Staff,0,0,35,35
1656301472634,MATH 20C,B01,083762,Bach; Quang Tran,2,0,30,28
1656301478658,MATH 20D,A01,083765,Tran; Brian Kha,1,0,30,29
1656301478658,MATH 20D,A02,083766,Tran; Brian Kha,1,1,30,29
1656301478658,MATH 20D,A03,083767,Tran; Brian Kha,2,0,30,28
1656301484697,MATH 20E,A01,083771,Ganguly; Soumya,2,0,32,30
1656301484697,MATH 20E,A02,083772,Ganguly; Soumya,0,0,32,32
1656301484697,MATH 20E,B01,083773,Ciotti; Benjamin,18,0,35,17
1656301484697,MATH 20E,B02,083774,Ciotti; Benjamin,15,0,35,20
1656301490727,MATH 103A,A01,083777,Greenfeld; Be'Eri,2,0,36,34
1656301490727,MATH 103A,A02,083778,Greenfeld; Be'Eri,3,0,36,33
1656301490727,MATH 103A,A03,093561,Staff,3,0,36,33
1656301490727,MATH 103A,B01,083779,Greenfeld; Be'Eri,8,0,36,28
1656301490727,MATH 103A,B02,083780,Greenfeld; Be'Eri,0,0,36,36
1656301490727,MATH 103A,B03,093562,Staff,1,0,36,35
1656301496761,MATH 105,A01,085443,Carter; Anne Toulson,5,0,35,30
1656301496761,MATH 105,A02,093477,Staff,14,0,35,21
1656301502784,MATH 109,A01,083213,Ganzberger; Geoffrey Michael,0,0,34,34
1656301502784,MATH 109,A02,083214,Ganzberger; Geoffrey Michael,0,0,34,34
1656301502784,MATH 109,A03,093478,Staff,2,0,34,32
1656301502784,MATH 109,B01,083215,Ganzberger; Geoffrey Michael,4,0,32,28
1656301502784,MATH 109,B02,083216,Ganzberger; Geoffrey Michael,1,0,32,31
1656301502784,MATH 109,B03,093479,Staff,3,0,32,29
1656301508807,MATH 142A,A01,083219,Chow; Bennett,1,0,32,31
1656301508807,MATH 142A,A02,083220,Chow; Bennett,8,0,32,24
1656301508807,MATH 142A,A03,093480,Staff,5,0,32,27
1656301508807,MATH 142A,B03,093481,Staff,3,0,32,29
1656301508807,MATH 142A,B04,093558,Staff,6,0,32,26
1656301508807,MATH 142A,B05,093559,Staff,0,0,32,32
1656301514831,MATH 193A,A01,083224,Rotar; Vladimir,0,1,34,34
1656301514831,MATH 193A,A02,083225,Rotar; Vladimir,0,0,34,34
1656301514831,MATH 193A,A03,083781,Rotar; Vladimir,0,0,34,34
1656301514831,MATH 193A,A04,083782,Rotar; Vladimir,5,0,34,29
1656301514831,MATH 193A,A05,093482,Rotar; Vladimir,0,0,34,34
1656301520854,MATH 197,001,091859,McAuley; Julian John,9999,0,9999,0
1656301520854,MATH 197,002,095566,Kedlaya; Kiran S.,9997,0,9999,2
1656301520854,MATH 197,003,095567,Xiao; Ming,9999,0,9999,0
1656301520854,MATH 197,004,095571,Perols; Johan Lars,9998,0,9999,1
1656301527903,COGS 9,A01,083615,Shannon; Kyle Michael,3,0,75,72
1656301533924,COGS 11,A01,083617,Boyle; Mary E. T.,15,0,48,33
1656301539951,COGS 13,A01,083071,Bastos; Amalia Pinkusfeld,6,0,71,65
1656301545974,COGS 14A,A01,092681,Semenuks; Arturs,1,13,100,99
1656301552002,COGS 14B,A01,083073,Cheng; Tzu-Han,7,0,63,56
1656301558027,COGS 17,A01,092677,Semenuks; Arturs,6,0,81,75
1656301564050,COGS 100,A01,083619,Allen; Michael Gordon,2,0,70,68
1656301570076,COGS 101A,A01,083621,Davis; Joshua Daniel,4,0,68,64
1656301576098,COGS 101B,A01,091572,Allen; Michael Gordon,4,0,65,61
1656301582121,COGS 101C,A01,083625,Delgado; Tania,11,0,35,24
1656301588149,COGS 107A,A01,083627,Boyle; Mary E. T.,0,0,60,60
1656301594172,COGS 118A,A01,083075,Gupta; Anjum,8,0,76,68
1656301600197,CSE 3,A50,083646,Miranda; Gregory Joseph,18,0,50,32
1656301606221,CSE 8A,A50,083650,Miranda; Gregory Joseph,3,3,56,53
1656301612243,CSE 11,A01,083080,Cao; Yingjun,0,48,40,40
1656301618272,CSE 12,A01,083652,Krause-Levy; Sophia Louisa,5,1,120,115
1656301624295,CSE 15L,A01,083654,Morris; Justin Loren,2,0,50,48
1656301624295,CSE 15L,A02,083655,Morris; Justin Loren,4,0,50,46
1656301630324,CSE 20,A01,083657,Tran; Khoa Dang,30,0,80,50
1656301636348,CSE 21,A01,095574,Bach; Quang Tran,23,0,48,25
1656301642370,CSE 30,A01,083084,Eldon; John,2,6,80,78
1656301642370,CSE 30,B01,095061,Bhaskar; Nishant,0,1,50,50
1656301648396,CSE 100,A01,083659,Cao; Yingjun,1,18,70,69
1656301654419,CSE 134B,A01,083661,Powell; Thomas Allan,6,0,100,94
1656301660441,CSE 140,A01,083663,Gungor; Onat,9,0,85,76
1656301666465,CSE 140L,A01,083088,Eldon; John,10,0,100,90
1656301672488,CSE 175,A01,083665,Kumar; Rakesh,0,0,25,25
1656301678511,CSE 190,A00,092507,Dubnov; Shlomo,3,0,20,17
1656301684533,ECE 45,A01,083139,Congero; Spencer William,1,0,75,74
1656301690558,ECE 65,A50,083695,Saad; Andrew S,9,0,30,21
1656301690558,ECE 65,A51,095125,Staff,24,0,26,2
1656301696584,ECE 109,A01,091882,Touri; Behrouz,1,1,70,69
1656301702609,ECE 180,A00,083140,Abi Samra; Nicholas Camill,2,0,30,28
1656301702609,ECE 180,B00,083141,Abi Samra; Nicholas Camill,0,4,30,30
1656301708633,MATH 10A,A01,083735,Patchell; Gregory David,0,0,30,30
1656301708633,MATH 10A,A02,083736,Patchell; Gregory David,22,0,30,8
1656301708633,MATH 10A,A03,083737,Patchell; Gregory David,16,0,30,14
1656301714658,MATH 10B,A01,083207,Lim; Seonhee,2,0,34,32
1656301714658,MATH 10B,A02,083208,Lim; Seonhee,5,0,35,30
1656301714658,MATH 10B,A03,093472,Staff,1,0,34,33
1656301714658,MATH 10B,B01,083739,Sinha; Shubham,11,0,30,19
1656301720681,MATH 18,A01,083743,Cinel; Cameron Alexander,7,0,30,23
1656301720681,MATH 18,A02,083744,Cinel; Cameron Alexander,10,0,30,20
1656301720681,MATH 18,A03,083745,Cinel; Cameron Alexander,5,0,30,25
1656301720681,MATH 18,B01,083748,Rideout; David Porter,0,0,36,36
1656301720681,MATH 18,B02,083749,Rideout; David Porter,0,0,36,36
1656301720681,MATH 18,B03,083750,Rideout; David Porter,0,0,36,36
1656301720681,MATH 18,B04,083751,Rideout; David Porter,0,1,36,36
1656301720681,MATH 18,B05,093473,Rideout; David Porter,0,0,36,36
1656301720681,MATH 18,B06,093474,Rideout; David Porter,3,0,36,33
1656301726705,MATH 20A,A01,083754,Zheng; Zequn,11,0,40,29
1656301732732,MATH 20B,A01,083756,Briones; Jor-el Thomas Caparas,0,0,36,36
1656301732732,MATH 20B,A02,083757,Briones; Jor-el Thomas Caparas,0,0,36,36
1656301732732,MATH 20B,A03,093475,Staff,1,0,36,35
1656301738756,MATH 20C,A01,083760,Briones; Jor-el Thomas Caparas,0,0,35,35
1656301738756,MATH 20C,A02,083761,Briones; Jor-el Thomas Caparas,9,1,35,26
1656301738756,MATH 20C,A03,093476,Staff,0,0,35,35
1656301738756,MATH 20C,B01,083762,Bach; Quang Tran,2,0,30,28
1656301744783,MATH 20D,A01,083765,Tran; Brian Kha,1,0,30,29
1656301744783,MATH 20D,A02,083766,Tran; Brian Kha,1,1,30,29
1656301744783,MATH 20D,A03,083767,Tran; Brian Kha,2,0,30,28
1656301750809,MATH 20E,A01,083771,Ganguly; Soumya,2,0,32,30
1656301750809,MATH 20E,A02,083772,Ganguly; Soumya,0,0,32,32
1656301750809,MATH 20E,B01,083773,Ciotti; Benjamin,18,0,35,17
1656301750809,MATH 20E,B02,083774,Ciotti; Benjamin,15,0,35,20
1656301756840,MATH 103A,A01,083777,Greenfeld; Be'Eri,2,0,36,34
1656301756840,MATH 103A,A02,083778,Greenfeld; Be'Eri,3,0,36,33
1656301756840,MATH 103A,A03,093561,Staff,3,0,36,33
1656301756840,MATH 103A,B01,083779,Greenfeld; Be'Eri,8,0,36,28
1656301756840,MATH 103A,B02,083780,Greenfeld; Be'Eri,0,0,36,36
1656301756840,MATH 103A,B03,093562,Staff,1,0,36,35
1656301762863,MATH 105,A01,085443,Carter; Anne Toulson,5,0,35,30
1656301762863,MATH 105,A02,093477,Staff,14,0,35,21
1656301768886,MATH 109,A01,083213,Ganzberger; Geoffrey Michael,0,0,34,34
1656301768886,MATH 109,A02,083214,Ganzberger; Geoffrey Michael,0,0,34,34
1656301768886,MATH 109,A03,093478,Staff,2,0,34,32
1656301768886,MATH 109,B01,083215,Ganzberger; Geoffrey Michael,4,0,32,28
1656301768886,MATH 109,B02,083216,Ganzberger; Geoffrey Michael,1,0,32,31
1656301768886,MATH 109,B03,093479,Staff,3,0,32,29
1656301774910,MATH 142A,A01,083219,Chow; Bennett,1,0,32,31
1656301774910,MATH 142A,A02,083220,Chow; Bennett,8,0,32,24
1656301774910,MATH 142A,A03,093480,Staff,5,0,32,27
1656301774910,MATH 142A,B03,093481,Staff,3,0,32,29
1656301774910,MATH 142A,B04,093558,Staff,6,0,32,26
1656301774910,MATH 142A,B05,093559,Staff,0,0,32,32
1656301780934,MATH 193A,A01,083224,Rotar; Vladimir,0,1,34,34
1656301780934,MATH 193A,A02,083225,Rotar; Vladimir,0,0,34,34
1656301780934,MATH 193A,A03,083781,Rotar; Vladimir,0,0,34,34
1656301780934,MATH 193A,A04,083782,Rotar; Vladimir,5,0,34,29
1656301780934,MATH 193A,A05,093482,Rotar; Vladimir,0,0,34,34
1656301786961,MATH 197,001,091859,McAuley; Julian John,9999,0,9999,0
1656301786961,MATH 197,002,095566,Kedlaya; Kiran S.,9997,0,9999,2
1656301786961,MATH 197,003,095567,Xiao; Ming,9999,0,9999,0
1656301786961,MATH 197,004,095571,Perols; Johan Lars,9998,0,9999,1
1656301794012,COGS 9,A01,083615,Shannon; Kyle Michael,3,0,75,72
1656301800037,COGS 11,A01,083617,Boyle; Mary E. T.,15,0,48,33
1656301806061,COGS 13,A01,083071,Bastos; Amalia Pinkusfeld,6,0,71,65
1656301812085,COGS 14A,A01,092681,Semenuks; Arturs,1,13,100,99
1656301818107,COGS 14B,A01,083073,Cheng; Tzu-Han,7,0,63,56
1656301824137,COGS 17,A01,092677,Semenuks; Arturs,6,0,81,75
1656301830159,COGS 100,A01,083619,Allen; Michael Gordon,2,0,70,68
1656301836183,COGS 101A,A01,083621,Davis; Joshua Daniel,4,0,68,64
1656301842223,COGS 101B,A01,091572,Allen; Michael Gordon,4,0,65,61
1656301848247,COGS 101C,A01,083625,Delgado; Tania,11,0,35,24
1656301854270,COGS 107A,A01,083627,Boyle; Mary E. T.,0,0,60,60
1656301860304,COGS 118A,A01,083075,Gupta; Anjum,8,0,76,68
1656301866331,CSE 3,A50,083646,Miranda; Gregory Joseph,18,0,50,32
1656301872355,CSE 8A,A50,083650,Miranda; Gregory Joseph,3,3,56,53
1656301878385,CSE 11,A01,083080,Cao; Yingjun,0,48,40,40
1656301884409,CSE 12,A01,083652,Krause-Levy; Sophia Louisa,5,1,120,115
1656301890526,CSE 15L,A01,083654,Morris; Justin Loren,2,0,50,48
1656301890526,CSE 15L,A02,083655,Morris; Justin Loren,4,0,50,46
1656301896554,CSE 20,A01,083657,Tran; Khoa Dang,30,0,80,50
1656301902578,CSE 21,A01,095574,Bach; Quang Tran,23,0,48,25
1656301908610,CSE 30,A01,083084,Eldon; John,2,6,80,78
1656301908610,CSE 30,B01,095061,Bhaskar; Nishant,0,1,50,50
1656301914636,CSE 100,A01,083659,Cao; Yingjun,1,18,70,69
1656301920658,CSE 134B,A01,083661,Powell; Thomas Allan,6,0,100,94
1656301926682,CSE 140,A01,083663,Gungor; Onat,9,0,85,76
1656301932704,CSE 140L,A01,083088,Eldon; John,10,0,100,90
1656301938730,CSE 175,A01,083665,Kumar; Rakesh,0,0,25,25
1656301944754,CSE 190,A00,092507,Dubnov; Shlomo,3,0,20,17
1656301950777,ECE 45,A01,083139,Congero; Spencer William,1,0,75,74
1656301956803,ECE 65,A50,083695,Saad; Andrew S,9,0,30,21
1656301956803,ECE 65,A51,095125,Staff,24,0,26,2
1656301962826,ECE 109,A01,091882,Touri; Behrouz,1,1,70,69
1656301968849,ECE 180,A00,083140,Abi Samra; Nicholas Camill,2,0,30,28
1656301968849,ECE 180,B00,083141,Abi Samra; Nicholas Camill,0,4,30,30
1656301974872,MATH 10A,A01,083735,Patchell; Gregory David,0,0,30,30
1656301974872,MATH 10A,A02,083736,Patchell; Gregory David,22,0,30,8
1656301974872,MATH 10A,A03,083737,Patchell; Gregory David,16,0,30,14
1656301980901,MATH 10B,A01,083207,Lim; Seonhee,2,0,34,32
1656301980901,MATH 10B,A02,083208,Lim; Seonhee,5,0,35,30
1656301980901,MATH 10B,A03,093472,Staff,1,0,34,33
1656301980901,MATH 10B,B01,083739,Sinha; Shubham,11,0,30,19
1656301986936,MATH 18,A01,083743,Cinel; Cameron Alexander,7,0,30,23
1656301986936,MATH 18,A02,083744,Cinel; Cameron Alexander,10,0,30,20
1656301986936,MATH 18,A03,083745,Cinel; Cameron Alexander,5,0,30,25
1656301986936,MATH 18,B01,083748,Rideout; David Porter,0,0,36,36
1656301986936,MATH 18,B02,083749,Rideout; David Porter,0,0,36,36
1656301986936,MATH 18,B03,083750,Rideout; David Porter,0,0,36,36
1656301986936,MATH 18,B04,083751,Rideout; David Porter,0,1,36,36
1656301986936,MATH 18,B05,093473,Rideout; David Porter,0,0,36,36
1656301986936,MATH 18,B06,093474,Rideout; David Porter,3,0,36,33
1656301992965,MATH 20A,A01,083754,Zheng; Zequn,11,0,40,29
1656301998992,MATH 20B,A01,083756,Briones; Jor-el Thomas Caparas,0,0,36,36
1656301998992,MATH 20B,A02,083757,Briones; Jor-el Thomas Caparas,0,0,36,36
1656301998992,MATH 20B,A03,093475,Staff,1,0,36,35
1656302005021,MATH 20C,A01,083760,Briones; Jor-el Thomas Caparas,0,0,35,35
1656302005021,MATH 20C,A02,083761,Briones; Jor-el Thomas Caparas,9,1,35,26
1656302005021,MATH 20C,A03,093476,Staff,0,0,35,35
1656302005021,MATH 20C,B01,083762,Bach; Quang Tran,2,0,30,28
1656302011045,MATH 20D,A01,083765,Tran; Brian Kha,1,0,30,29
1656302011045,MATH 20D,A02,083766,Tran; Brian Kha,1,1,30,29
1656302011045,MATH 20D,A03,083767,Tran; Brian Kha,2,0,30,28
1656302017069,MATH 20E,A01,083771,Ganguly; Soumya,2,0,32,30
1656302017069,MATH 20E,A02,083772,Ganguly; Soumya,0,0,32,32
1656302017069,MATH 20E,B01,083773,Ciotti; Benjamin,18,0,35,17
1656302017069,MATH 20E,B02,083774,Ciotti; Benjamin,15,0,35,20
1656302023097,MATH 103A,A01,083777,Greenfeld; Be'Eri,2,0,36,34
1656302023097,MATH 103A,A02,083778,Greenfeld; Be'Eri,3,0,36,33
1656302023097,MATH 103A,A03,093561,Staff,3,0,36,33
1656302023097,MATH 103A,B01,083779,Greenfeld; Be'Eri,8,0,36,28
1656302023097,MATH 103A,B02,083780,Greenfeld; Be'Eri,0,0,36,36
1656302023097,MATH 103A,B03,093562,Staff,1,0,36,35
1656302029121,MATH 105,A01,085443,Carter; Anne Toulson,5,0,35,30
1656302029121,MATH 105,A02,093477,Staff,14,0,35,21
1656302035145,MATH 109,A01,083213,Ganzberger; Geoffrey Michael,0,0,34,34
1656302035145,MATH 109,A02,083214,Ganzberger; Geoffrey Michael,0,0,34,34
1656302035145,MATH 109,A03,093478,Staff,2,0,34,32
1656302035145,MATH 109,B01,083215,Ganzberger; Geoffrey Michael,4,0,32,28
1656302035145,MATH 109,B02,083216,Ganzberger; Geoffrey Michael,1,0,32,31
1656302035145,MATH 109,B03,093479,Staff,3,0,32,29
1656302041170,MATH 142A,A01,083219,Chow; Bennett,1,0,32,31
1656302041170,MATH 142A,A02,083220,Chow; Bennett,8,0,32,24
1656302041170,MATH 142A,A03,093480,Staff,5,0,32,27
1656302041170,MATH 142A,B03,093481,Staff,3,0,32,29
1656302041170,MATH 142A,B04,093558,Staff,6,0,32,26
1656302041170,MATH 142A,B05,093559,Staff,0,0,32,32
1656302047198,MATH 193A,A01,083224,Rotar; Vladimir,0,1,34,34
1656302047198,MATH 193A,A02,083225,Rotar; Vladimir,0,0,34,34
1656302047198,MATH 193A,A03,083781,Rotar; Vladimir,0,0,34,34
1656302047198,MATH 193A,A04,083782,Rotar; Vladimir,5,0,34,29
1656302047198,MATH 193A,A05,093482,Rotar; Vladimir,0,0,34,34
1656302053225,MATH 197,001,091859,McAuley; Julian John,9999,0,9999,0
1656302053225,MATH 197,002,095566,Kedlaya; Kiran S.,9997,0,9999,2
1656302053225,MATH 197,003,095567,Xiao; Ming,9999,0,9999,0
1656302053225,MATH 197,004,095571,Perols; Johan Lars,9998,0,9999,1
1656302060274,COGS 9,A01,083615,Shannon; Kyle Michael,3,0,75,72
1656302066302,COGS 11,A01,083617,Boyle; Mary E. T.,15,0,48,33
1656302072328,COGS 13,A01,083071,Bastos; Amalia Pinkusfeld,6,0,71,65
1656302078356,COGS 14A,A01,092681,Semenuks; Arturs,1,13,100,99
1656302084387,COGS 14B,A01,083073,Cheng; Tzu-Han,7,0,63,56
1656302090409,COGS 17,A01,092677,Semenuks; Arturs,6,0,81,75
1656302096433,COGS 100,A01,083619,Allen; Michael Gordon,2,0,70,68
1656302102461,COGS 101A,A01,083621,Davis; Joshua Daniel,4,0,68,64
1656302108483,COGS 101B,A01,091572,Allen; Michael Gordon,4,0,65,61
1656302114508,COGS 101C,A01,083625,Delgado; Tania,11,0,35,24
1656302120532,COGS 107A,A01,083627,Boyle; Mary E. T.,1,0,60,59
1656302126557,COGS 118A,A01,083075,Gupta; Anjum,8,0,76,68
1656302132584,CSE 3,A50,083646,Miranda; Gregory Joseph,18,0,50,32
1656302138612,CSE 8A,A50,083650,Miranda; Gregory Joseph,3,3,56,53
1656302144635,CSE 11,A01,083080,Cao; Yingjun,0,48,40,40
1656302150660,CSE 12,A01,083652,Krause-Levy; Sophia Louisa,5,1,120,115
1656302156695,CSE 15L,A01,083654,Morris; Justin Loren,2,0,50,48
1656302156695,CSE 15L,A02,083655,Morris; Justin Loren,4,0,50,46
1656302162717,CSE 20,A01,083657,Tran; Khoa Dang,30,0,80,50
1656302168741,CSE 21,A01,095574,Bach; Quang Tran,23,0,48,25
1656302174769,CSE 30,A01,083084,Eldon; John,2,6,80,78
1656302174769,CSE 30,B01,095061,Bhaskar; Nishant,0,1,50,50
1656302180802,CSE 100,A01,083659,Cao; Yingjun,1,18,70,69
1656302186829,CSE 134B,A01,083661,Powell; Thomas Allan,6,0,100,94
1656302192850,CSE 140,A01,083663,Gungor; Onat,9,0,85,76
1656302198878,CSE 140L,A01,083088,Eldon; John,10,0,100,90
1656302204902,CSE 175,A01,083665,Kumar; Rakesh,0,0,25,25
1656302210938,CSE 190,A00,092507,Dubnov; Shlomo,3,0,20,17
1656302216967,ECE 45,A01,083139,Congero; Spencer William,1,0,75,74
1656302222995,ECE 65,A50,083695,Saad; Andrew S,10,0,30,20
1656302222995,ECE 65,A51,095125,Staff,24,0,26,2
1656302229018,ECE 109,A01,091882,Touri; Behrouz,1,1,70,69
1656302235041,ECE 180,A00,083140,Abi Samra; Nicholas Camill,2,0,30,28
1656302235041,ECE 180,B00,083141,Abi Samra; Nicholas Camill,0,4,30,30
1656302241064,MATH 10A,A01,083735,Patchell; Gregory David,0,0,30,30
1656302241064,MATH 10A,A02,083736,Patchell; Gregory David,22,0,30,8
1656302241064,MATH 10A,A03,083737,Patchell; Gregory David,16,0,30,14
1656302247092,MATH 10B,A01,083207,Lim; Seonhee,2,0,34,32
1656302247092,MATH 10B,A02,083208,Lim; Seonhee,5,0,35,30
1656302247092,MATH 10B,A03,093472,Staff,1,0,34,33
1656302247092,MATH 10B,B01,083739,Sinha; Shubham,11,0,30,19
1656302253116,MATH 18,A01,083743,Cinel; Cameron Alexander,7,0,30,23
1656302253116,MATH 18,A02,083744,Cinel; Cameron Alexander,10,0,30,20
1656302253116,MATH 18,A03,083745,Cinel; Cameron Alexander,5,0,30,25
1656302253116,MATH 18,B01,083748,Rideout; David Porter,0,0,36,36
1656302253116,MATH 18,B02,083749,Rideout; David Porter,0,0,36,36
1656302253116,MATH 18,B03,083750,Rideout; David Porter,0,0,36,36
1656302253116,MATH 18,B04,083751,Rideout; David Porter,0,1,36,36
1656302253116,MATH 18,B05,093473,Rideout; David Porter,0,0,36,36
1656302253116,MATH 18,B06,093474,Rideout; David Porter,3,0,36,33
1656302259142,MATH 20A,A01,083754,Zheng; Zequn,11,0,40,29
1656302265169,MATH 20B,A01,083756,Briones; Jor-el Thomas Caparas,0,0,36,36
1656302265169,MATH 20B,A02,083757,Briones; Jor-el Thomas Caparas,0,0,36,36
1656302265169,MATH 20B,A03,093475,Staff,1,0,36,35
1656302271200,MATH 20C,A01,083760,Briones; Jor-el Thomas Caparas,0,0,35,35
1656302271200,MATH 20C,A02,083761,Briones; Jor-el Thomas Caparas,9,1,35,26
1656302271200,MATH 20C,A03,093476,Staff,0,0,35,35
1656302271200,MATH 20C,B01,083762,Bach; Quang Tran,2,0,30,28
1656302277224,MATH 20D,A01,083765,Tran; Brian Kha,1,0,30,29
1656302277224,MATH 20D,A02,083766,Tran; Brian Kha,1,1,30,29
1656302277224,MATH 20D,A03,083767,Tran; Brian Kha,2,0,30,28
1656302283253,MATH 20E,A01,083771,Ganguly; Soumya,2,0,32,30
1656302283253,MATH 20E,A02,083772,Ganguly; Soumya,0,0,32,32
1656302283253,MATH 20E,B01,083773,Ciotti; Benjamin,18,0,35,17
1656302283253,MATH 20E,B02,083774,Ciotti; Benjamin,15,0,35,20
1656302289277,MATH 103A,A01,083777,Greenfeld; Be'Eri,2,0,36,34
1656302289277,MATH 103A,A02,083778,Greenfeld; Be'Eri,3,0,36,33
1656302289277,MATH 103A,A03,093561,Staff,3,0,36,33
1656302289277,MATH 103A,B01,083779,Greenfeld; Be'Eri,8,0,36,28
1656302289277,MATH 103A,B02,083780,Greenfeld; Be'Eri,0,0,36,36
1656302289277,MATH 103A,B03,093562,Staff,1,0,36,35
1656302295305,MATH 105,A01,085443,Carter; Anne Toulson,5,0,35,30
1656302295305,MATH 105,A02,093477,Staff,14,0,35,21
1656302301332,MATH 109,A01,083213,Ganzberger; Geoffrey Michael,0,0,34,34
1656302301332,MATH 109,A02,083214,Ganzberger; Geoffrey Michael,0,0,34,34
1656302301332,MATH 109,A03,093478,Staff,2,0,34,32
1656302301332,MATH 109,B01,083215,Ganzberger; Geoffrey Michael,4,0,32,28
1656302301332,MATH 109,B02,083216,Ganzberger; Geoffrey Michael,1,0,32,31
1656302301332,MATH 109,B03,093479,Staff,3,0,32,29
1656302307366,MATH 142A,A01,083219,Chow; Bennett,1,0,32,31
1656302307366,MATH 142A,A02,083220,Chow; Bennett,8,0,32,24
1656302307366,MATH 142A,A03,093480,Staff,5,0,32,27
1656302307366,MATH 142A,B03,093481,Staff,3,0,32,29
1656302307366,MATH 142A,B04,093558,Staff,6,0,32,26
1656302307366,MATH 142A,B05,093559,Staff,0,0,32,32
1656302313390,MATH 193A,A01,083224,Rotar; Vladimir,0,1,34,34
1656302313390,MATH 193A,A02,083225,Rotar; Vladimir,0,0,34,34
1656302313390,MATH 193A,A03,083781,Rotar; Vladimir,0,0,34,34
1656302313390,MATH 193A,A04,083782,Rotar; Vladimir,5,0,34,29
1656302313390,MATH 193A,A05,093482,Rotar; Vladimir,0,0,34,34
1656302319414,MATH 197,001,091859,McAuley; Julian John,9999,0,9999,0
1656302319414,MATH 197,002,095566,Kedlaya; Kiran S.,9997,0,9999,2
1656302319414,MATH 197,003,095567,Xiao; Ming,9999,0,9999,0
1656302319414,MATH 197,004,095571,Perols; Johan Lars,9998,0,9999,1
1656302326463,COGS 9,A01,083615,Shannon; Kyle Michael,3,0,75,72
1656302332486,COGS 11,A01,083617,Boyle; Mary E. T.,15,0,48,33
1656302338511,COGS 13,A01,083071,Bastos; Amalia Pinkusfeld,6,0,71,65
1656302344538,COGS 14A,A01,092681,Semenuks; Arturs,1,13,100,99
1656302350564,COGS 14B,A01,083073,Cheng; Tzu-Han,7,0,63,56
1656302356591,COGS 17,A01,092677,Semenuks; Arturs,6,0,81,75
1656302362618,COGS 100,A01,083619,Allen; Michael Gordon,2,0,70,68
1656302368644,COGS 101A,A01,083621,Davis; Joshua Daniel,4,0,68,64
1656302374666,COGS 101B,A01,091572,Allen; Michael Gordon,4,0,65,61
1656302380691,COGS 101C,A01,083625,Delgado; Tania,11,0,35,24
1656302386717,COGS 107A,A01,083627,Boyle; Mary E. T.,1,0,60,59
1656302392743,COGS 118A,A01,083075,Gupta; Anjum,8,0,76,68
1656302398766,CSE 3,A50,083646,Miranda; Gregory Joseph,18,0,50,32
1656302404800,CSE 8A,A50,083650,Miranda; Gregory Joseph,3,3,56,53
1656302410823,CSE 11,A01,083080,Cao; Yingjun,0,48,40,40
1656302416850,CSE 12,A01,083652,Krause-Levy; Sophia Louisa,5,1,120,115
1656302422877,CSE 15L,A01,083654,Morris; Justin Loren,2,0,50,48
1656302422877,CSE 15L,A02,083655,Morris; Justin Loren,4,0,50,46
1656302428900,CSE 20,A01,083657,Tran; Khoa Dang,30,0,80,50
1656302434925,CSE 21,A01,095574,Bach; Quang Tran,23,0,48,25
1656302440949,CSE 30,A01,083084,Eldon; John,2,6,80,78
1656302440949,CSE 30,B01,095061,Bhaskar; Nishant,0,1,50,50
1656302446972,CSE 100,A01,083659,Cao; Yingjun,1,18,70,69
1656302452999,CSE 134B,A01,083661,Powell; Thomas Allan,6,0,100,94
1656302459023,CSE 140,A01,083663,Gungor; Onat,9,0,85,76
1656302465052,CSE 140L,A01,083088,Eldon; John,10,0,100,90
1656302471083,CSE 175,A01,083665,Kumar; Rakesh,0,0,25,25
1656302477109,CSE 190,A00,092507,Dubnov; Shlomo,3,0,20,17
1656302483132,ECE 45,A01,083139,Congero; Spencer William,1,0,75,74
1656302489236,ECE 65,A50,083695,Saad; Andrew S,10,0,30,20
1656302489236,ECE 65,A51,095125,Staff,24,0,26,2
1656302495268,ECE 109,A01,091882,Touri; Behrouz,1,1,70,69
1656302501291,ECE 180,A00,083140,Abi Samra; Nicholas Camill,2,0,30,28
1656302501291,ECE 180,B00,083141,Abi Samra; Nicholas Camill,0,4,30,30
1656302507314,MATH 10A,A01,083735,Patchell; Gregory David,0,0,30,30
1656302507314,MATH 10A,A02,083736,Patchell; Gregory David,22,0,30,8
1656302507314,MATH 10A,A03,083737,Patchell; Gregory David,16,0,30,14
1656302513338,MATH 10B,A01,083207,Lim; Seonhee,2,0,34,32
1656302513338,MATH 10B,A02,083208,Lim; Seonhee,5,0,35,30
1656302513338,MATH 10B,A03,093472,Staff,1,0,34,33
1656302513338,MATH 10B,B01,083739,Sinha; Shubham,11,0,30,19
1656302519370,MATH 18,A01,083743,Cinel; Cameron Alexander,7,0,30,23
1656302519370,MATH 18,A02,083744,Cinel; Cameron Alexander,10,0,30,20
1656302519370,MATH 18,A03,083745,Cinel; Cameron Alexander,5,0,30,25
1656302519370,MATH 18,B01,083748,Rideout; David Porter,0,0,36,36
1656302519370,MATH 18,B02,083749,Rideout; David Porter,0,0,36,36
1656302519370,MATH 18,B03,083750,Rideout; David Porter,0,0,36,36
1656302519370,MATH 18,B04,083751,Rideout; David Porter,0,1,36,36
1656302519370,MATH 18,B05,093473,Rideout; David Porter,0,0,36,36
1656302519370,MATH 18,B06,093474,Rideout; David Porter,3,0,36,33
1656302525402,MATH 20A,A01,083754,Zheng; Zequn,11,0,40,29
1656302531426,MATH 20B,A01,083756,Briones; Jor-el Thomas Caparas,0,0,36,36
1656302531426,MATH 20B,A02,083757,Briones; Jor-el Thomas Caparas,0,0,36,36
1656302531426,MATH 20B,A03,093475,Staff,1,0,36,35
1656302537455,MATH 20C,A01,083760,Briones; Jor-el Thomas Caparas,0,0,35,35
1656302537455,MATH 20C,A02,083761,Briones; Jor-el Thomas Caparas,9,1,35,26
1656302537455,MATH 20C,A03,093476,Staff,0,0,35,35
1656302537455,MATH 20C,B01,083762,Bach; Quang Tran,2,0,30,28
1656302543478,MATH 20D,A01,083765,Tran; Brian Kha,1,0,30,29
1656302543478,MATH 20D,A02,083766,Tran; Brian Kha,1,1,30,29
1656302543478,MATH 20D,A03,083767,Tran; Brian Kha,2,0,30,28
1656302549502,MATH 20E,A01,083771,Ganguly; Soumya,2,0,32,30
1656302549502,MATH 20E,A02,083772,Ganguly; Soumya,0,0,32,32
1656302549502,MATH 20E,B01,083773,Ciotti; Benjamin,18,0,35,17
1656302549502,MATH 20E,B02,083774,Ciotti; Benjamin,15,0,35,20
1656302555526,MATH 103A,A01,083777,Greenfeld; Be'Eri,2,0,36,34
1656302555526,MATH 103A,A02,083778,Greenfeld; Be'Eri,3,0,36,33
1656302555526,MATH 103A,A03,093561,Staff,3,0,36,33
1656302555526,MATH 103A,B01,083779,Greenfeld; Be'Eri,8,0,36,28
1656302555526,MATH 103A,B02,083780,Greenfeld; Be'Eri,0,0,36,36
1656302555526,MATH 103A,B03,093562,Staff,1,0,36,35
1656302561553,MATH 105,A01,085443,Carter; Anne Toulson,5,0,35,30
1656302561553,MATH 105,A02,093477,Staff,14,0,35,21
1656302567582,MATH 109,A01,083213,Ganzberger; Geoffrey Michael,0,0,34,34
1656302567582,MATH 109,A02,083214,Ganzberger; Geoffrey Michael,0,0,34,34
1656302567582,MATH 109,A03,093478,Staff,2,0,34,32
1656302567582,MATH 109,B01,083215,Ganzberger; Geoffrey Michael,4,0,32,28
1656302567582,MATH 109,B02,083216,Ganzberger; Geoffrey Michael,1,0,32,31
1656302567582,MATH 109,B03,093479,Staff,3,0,32,29
1656302573606,MATH 142A,A01,083219,Chow; Bennett,1,0,32,31
1656302573606,MATH 142A,A02,083220,Chow; Bennett,8,0,32,24
1656302573606,MATH 142A,A03,093480,Staff,5,0,32,27
1656302573606,MATH 142A,B03,093481,Staff,3,0,32,29
1656302573606,MATH 142A,B04,093558,Staff,6,0,32,26
1656302573606,MATH 142A,B05,093559,Staff,0,0,32,32
1656302579630,MATH 193A,A01,083224,Rotar; Vladimir,0,1,34,34
1656302579630,MATH 193A,A02,083225,Rotar; Vladimir,0,0,34,34
1656302579630,MATH 193A,A03,083781,Rotar; Vladimir,0,0,34,34
1656302579630,MATH 193A,A04,083782,Rotar; Vladimir,5,0,34,29
1656302579630,MATH 193A,A05,093482,Rotar; Vladimir,0,0,34,34
1656302585653,MATH 197,001,091859,McAuley; Julian John,9999,0,9999,0
1656302585653,MATH 197,002,095566,Kedlaya; Kiran S.,9997,0,9999,2
1656302585653,MATH 197,003,095567,Xiao; Ming,9999,0,9999,0
1656302585653,MATH 197,004,095571,Perols; Johan Lars,9998,0,9999,1
1656302592710,COGS 9,A01,083615,Shannon; Kyle Michael,3,0,75,72
1656302598749,COGS 11,A01,083617,Boyle; Mary E. T.,15,0,48,33
1656302604772,COGS 13,A01,083071,Bastos; Amalia Pinkusfeld,6,0,71,65
1656302610801,COGS 14A,A01,092681,Semenuks; Arturs,1,13,100,99
1656302616828,COGS 14B,A01,083073,Cheng; Tzu-Han,7,0,63,56
1656302622857,COGS 17,A01,092677,Semenuks; Arturs,6,0,81,75
1656302628884,COGS 100,A01,083619,Allen; Michael Gordon,2,0,70,68
1656302634908,COGS 101A,A01,083621,Davis; Joshua Daniel,4,0,68,64
1656302640930,COGS 101B,A01,091572,Allen; Michael Gordon,4,0,65,61
1656302646957,COGS 101C,A01,083625,Delgado; Tania,11,0,35,24
1656302652980,COGS 107A,A01,083627,Boyle; Mary E. T.,1,0,60,59
1656302659004,COGS 118A,A01,083075,Gupta; Anjum,8,0,76,68
1656302665031,CSE 3,A50,083646,Miranda; Gregory Joseph,18,0,50,32
1656302671055,CSE 8A,A50,083650,Miranda; Gregory Joseph,3,3,56,53
1656302677077,CSE 11,A01,083080,Cao; Yingjun,0,48,40,40
1656302683105,CSE 12,A01,083652,Krause-Levy; Sophia Louisa,5,1,120,115
1656302689135,CSE 15L,A01,083654,Morris; Justin Loren,2,0,50,48
1656302689135,CSE 15L,A02,083655,Morris; Justin Loren,4,0,50,46
1656302695162,CSE 20,A01,083657,Tran; Khoa Dang,30,0,80,50
1656302701186,CSE 21,A01,095574,Bach; Quang Tran,23,0,48,25
1656302707209,CSE 30,A01,083084,Eldon; John,2,6,80,78
1656302707209,CSE 30,B01,095061,Bhaskar; Nishant,0,1,50,50
1656302713233,CSE 100,A01,083659,Cao; Yingjun,1,18,70,69
1656302719257,CSE 134B,A01,083661,Powell; Thomas Allan,6,0,100,94
1656302725282,CSE 140,A01,083663,Gungor; Onat,9,0,85,76
1656302731305,CSE 140L,A01,083088,Eldon; John,10,0,100,90
1656302737333,CSE 175,A01,083665,Kumar; Rakesh,0,0,25,25
1656302743355,CSE 190,A00,092507,Dubnov; Shlomo,3,0,20,17
1656302749382,ECE 45,A01,083139,Congero; Spencer William,1,0,75,74
1656302755405,ECE 65,A50,083695,Saad; Andrew S,10,0,30,20
1656302755405,ECE 65,A51,095125,Staff,24,0,26,2
1656302761435,ECE 109,A01,091882,Touri; Behrouz,1,1,70,69
1656302767486,ECE 180,A00,083140,Abi Samra; Nicholas Camill,2,0,30,28
1656302767486,ECE 180,B00,083141,Abi Samra; Nicholas Camill,0,4,30,30
1656302773513,MATH 10A,A01,083735,Patchell; Gregory David,0,0,30,30
1656302773513,MATH 10A,A02,083736,Patchell; Gregory David,22,0,30,8
1656302773513,MATH 10A,A03,083737,Patchell; Gregory David,16,0,30,14
1656302779540,MATH 10B,A01,083207,Lim; Seonhee,2,0,34,32
1656302779540,MATH 10B,A02,083208,Lim; Seonhee,5,0,35,30
1656302779540,MATH 10B,A03,093472,Staff,1,0,34,33
1656302779540,MATH 10B,B01,083739,Sinha; Shubham,11,0,30,19
1656302785564,MATH 18,A01,083743,Cinel; Cameron Alexander,7,0,30,23
1656302785564,MATH 18,A02,083744,Cinel; Cameron Alexander,10,0,30,20
1656302785564,MATH 18,A03,083745,Cinel; Cameron Alexander,5,0,30,25
1656302785564,MATH 18,B01,083748,Rideout; David Porter,0,0,36,36
1656302785564,MATH 18,B02,083749,Rideout; David Porter,0,0,36,36
1656302785564,MATH 18,B03,083750,Rideout; David Porter,0,0,36,36
1656302785564,MATH 18,B04,083751,Rideout; David Porter,0,1,36,36
1656302785564,MATH 18,B05,093473,Rideout; David Porter,0,0,36,36
1656302785564,MATH 18,B06,093474,Rideout; David Porter,2,0,36,34
1656302791587,MATH 20A,A01,083754,Zheng; Zequn,11,0,40,29
1656302797608,MATH 20B,A01,083756,Briones; Jor-el Thomas Caparas,0,0,36,36
1656302797608,MATH 20B,A02,083757,Briones; Jor-el Thomas Caparas,0,0,36,36
1656302797608,MATH 20B,A03,093475,Staff,1,0,36,35
1656302803631,MATH 20C,A01,083760,Briones; Jor-el Thomas Caparas,0,0,35,35
1656302803631,MATH 20C,A02,083761,Briones; Jor-el Thomas Caparas,9,1,35,26
1656302803631,MATH 20C,A03,093476,Staff,0,0,35,35
1656302803631,MATH 20C,B01,083762,Bach; Quang Tran,2,0,30,28
1656302809665,MATH 20D,A01,083765,Tran; Brian Kha,1,0,30,29
1656302809665,MATH 20D,A02,083766,Tran; Brian Kha,1,1,30,29
1656302809665,MATH 20D,A03,083767,Tran; Brian Kha,2,0,30,28
1656302815694,MATH 20E,A01,083771,Ganguly; Soumya,2,0,32,30
1656302815694,MATH 20E,A02,083772,Ganguly; Soumya,0,0,32,32
1656302815694,MATH 20E,B01,083773,Ciotti; Benjamin,18,0,35,17
1656302815694,MATH 20E,B02,083774,Ciotti; Benjamin,15,0,35,20
1656302821719,MATH 103A,A01,083777,Greenfeld; Be'Eri,2,0,36,34
1656302821719,MATH 103A,A02,083778,Greenfeld; Be'Eri,3,0,36,33
1656302821719,MATH 103A,A03,093561,Staff,3,0,36,33
1656302821719,MATH 103A,B01,083779,Greenfeld; Be'Eri,8,0,36,28
1656302821719,MATH 103A,B02,083780,Greenfeld; Be'Eri,0,0,36,36
1656302821719,MATH 103A,B03,093562,Staff,1,0,36,35
1656302827743,MATH 105,A01,085443,Carter; Anne Toulson,5,0,35,30
1656302827743,MATH 105,A02,093477,Staff,14,0,35,21
1656302833773,MATH 109,A01,083213,Ganzberger; Geoffrey Michael,0,0,34,34
1656302833773,MATH 109,A02,083214,Ganzberger; Geoffrey Michael,0,0,34,34
1656302833773,MATH 109,A03,093478,Staff,2,0,34,32
1656302833773,MATH 109,B01,083215,Ganzberger; Geoffrey Michael,4,0,32,28
1656302833773,MATH 109,B02,083216,Ganzberger; Geoffrey Michael,1,0,32,31
1656302833773,MATH 109,B03,093479,Staff,3,0,32,29
1656302839809,MATH 142A,A01,083219,Chow; Bennett,1,0,32,31
1656302839809,MATH 142A,A02,083220,Chow; Bennett,8,0,32,24
1656302839809,MATH 142A,A03,093480,Staff,5,0,32,27
1656302839809,MATH 142A,B03,093481,Staff,3,0,32,29
1656302839809,MATH 142A,B04,093558,Staff,6,0,32,26
1656302839809,MATH 142A,B05,093559,Staff,0,0,32,32
1656302845845,MATH 193A,A01,083224,Rotar; Vladimir,0,1,34,34
1656302845845,MATH 193A,A02,083225,Rotar; Vladimir,0,0,34,34
1656302845845,MATH 193A,A03,083781,Rotar; Vladimir,0,0,34,34
1656302845845,MATH 193A,A04,083782,Rotar; Vladimir,5,0,34,29
1656302845845,MATH 193A,A05,093482,Rotar; Vladimir,0,0,34,34
1656302851869,MATH 197,001,091859,McAuley; Julian John,9999,0,9999,0
1656302851869,MATH 197,002,095566,Kedlaya; Kiran S.,9997,0,9999,2
1656302851869,MATH 197,003,095567,Xiao; Ming,9999,0,9999,0
1656302851869,MATH 197,004,095571,Perols; Johan Lars,9998,0,9999,1
1656302858932,COGS 9,A01,083615,Shannon; Kyle Michael,3,0,75,72
1656302864956,COGS 11,A01,083617,Boyle; Mary E. T.,15,0,48,33
1656302870982,COGS 13,A01,083071,Bastos; Amalia Pinkusfeld,6,0,71,65
1656302877014,COGS 14A,A01,092681,Semenuks; Arturs,1,13,100,99
1656302883037,COGS 14B,A01,083073,Cheng; Tzu-Han,7,0,63,56
1656302889060,COGS 17,A01,092677,Semenuks; Arturs,6,0,81,75
1656302895091,COGS 100,A01,083619,Allen; Michael Gordon,2,0,70,68
1656302901118,COGS 101A,A01,083621,Davis; Joshua Daniel,4,0,68,64
1656302907146,COGS 101B,A01,091572,Allen; Michael Gordon,4,0,65,61
1656302913173,COGS 101C,A01,083625,Delgado; Tania,11,0,35,24
1656302919197,COGS 107A,A01,083627,Boyle; Mary E. T.,1,0,60,59
1656302925222,COGS 118A,A01,083075,Gupta; Anjum,8,0,76,68
1656302931245,CSE 3,A50,083646,Miranda; Gregory Joseph,18,0,50,32
1656302937268,CSE 8A,A50,083650,Miranda; Gregory Joseph,3,3,56,53
1656302943299,CSE 11,A01,083080,Cao; Yingjun,0,48,40,40
1656302949326,CSE 12,A01,083652,Krause-Levy; Sophia Louisa,5,1,120,115
1656302955373,CSE 15L,A01,083654,Morris; Justin Loren,2,0,50,48
1656302955373,CSE 15L,A02,083655,Morris; Justin Loren,4,0,50,46
1656302961396,CSE 20,A01,083657,Tran; Khoa Dang,30,0,80,50
1656302967418,CSE 21,A01,095574,Bach; Quang Tran,23,0,48,25
1656302973448,CSE 30,A01,083084,Eldon; John,2,6,80,78
1656302973448,CSE 30,B01,095061,Bhaskar; Nishant,0,1,50,50
1656302979471,CSE 100,A01,083659,Cao; Yingjun,1,18,70,69
1656302985498,CSE 134B,A01,083661,Powell; Thomas Allan,6,0,100,94
1656302991523,CSE 140,A01,083663,Gungor; Onat,9,0,85,76
1656302997546,CSE 140L,A01,083088,Eldon; John,10,0,100,90
1656303003578,CSE 175,A01,083665,Kumar; Rakesh,0,0,25,25
1656303009605,CSE 190,A00,092507,Dubnov; Shlomo,3,0,20,17
1656303015633,ECE 45,A01,083139,Congero; Spencer William,1,0,75,74
1656303021659,ECE 65,A50,083695,Saad; Andrew S,10,0,30,20
1656303021659,ECE 65,A51,095125,Staff,24,0,26,2
1656303027681,ECE 109,A01,091882,Touri; Behrouz,1,1,70,69
1656303033703,ECE 180,A00,083140,Abi Samra; Nicholas Camill,2,0,30,28
1656303033703,ECE 180,B00,083141,Abi Samra; Nicholas Camill,0,4,30,30
1656303039727,MATH 10A,A01,083735,Patchell; Gregory David,0,0,30,30
1656303039727,MATH 10A,A02,083736,Patchell; Gregory David,22,0,30,8
1656303039727,MATH 10A,A03,083737,Patchell; Gregory David,16,0,30,14
1656303045753,MATH 10B,A01,083207,Lim; Seonhee,2,0,34,32
1656303045753,MATH 10B,A02,083208,Lim; Seonhee,5,0,35,30
1656303045753,MATH 10B,A03,093472,Staff,1,0,34,33
1656303045753,MATH 10B,B01,083739,Sinha; Shubham,11,0,30,19
1656303051777,MATH 18,A01,083743,Cinel; Cameron Alexander,7,0,30,23
1656303051777,MATH 18,A02,083744,Cinel; Cameron Alexander,10,0,30,20
1656303051777,MATH 18,A03,083745,Cinel; Cameron Alexander,5,0,30,25
1656303051777,MATH 18,B01,083748,Rideout; David Porter,0,0,36,36
1656303051777,MATH 18,B02,083749,Rideout; David Porter,0,0,36,36
1656303051777,MATH 18,B03,083750,Rideout; David Porter,0,0,36,36
1656303051777,MATH 18,B04,083751,Rideout; David Porter,0,1,36,36
1656303051777,MATH 18,B05,093473,Rideout; David Porter,0,0,36,36
1656303051777,MATH 18,B06,093474,Rideout; David Porter,2,0,36,34
1656303057801,MATH 20A,A01,083754,Zheng; Zequn,11,0,40,29
1656303063825,MATH 20B,A01,083756,Briones; Jor-el Thomas Caparas,0,0,36,36
1656303063825,MATH 20B,A02,083757,Briones; Jor-el Thomas Caparas,0,0,36,36
1656303063825,MATH 20B,A03,093475,Staff,1,0,36,35
1656303069850,MATH 20C,A01,083760,Briones; Jor-el Thomas Caparas,0,0,35,35
1656303069850,MATH 20C,A02,083761,Briones; Jor-el Thomas Caparas,9,1,35,26
1656303069850,MATH 20C,A03,093476,Staff,0,0,35,35
1656303069850,MATH 20C,B01,083762,Bach; Quang Tran,2,0,30,28
1656303075874,MATH 20D,A01,083765,Tran; Brian Kha,1,0,30,29
1656303075874,MATH 20D,A02,083766,Tran; Brian Kha,1,1,30,29
1656303075874,MATH 20D,A03,083767,Tran; Brian Kha,2,0,30,28
1656303081904,MATH 20E,A01,083771,Ganguly; Soumya,2,0,32,30
1656303081904,MATH 20E,A02,083772,Ganguly; Soumya,0,0,32,32
1656303081904,MATH 20E,B01,083773,Ciotti; Benjamin,18,0,35,17
1656303081904,MATH 20E,B02,083774,Ciotti; Benjamin,15,0,35,20
1656303087999,MATH 103A,A01,083777,Greenfeld; Be'Eri,2,0,36,34
1656303087999,MATH 103A,A02,083778,Greenfeld; Be'Eri,3,0,36,33
1656303087999,MATH 103A,A03,093561,Staff,3,0,36,33
1656303087999,MATH 103A,B01,083779,Greenfeld; Be'Eri,8,0,36,28
1656303087999,MATH 103A,B02,083780,Greenfeld; Be'Eri,0,0,36,36
1656303087999,MATH 103A,B03,093562,Staff,1,0,36,35
1656303094024,MATH 105,A01,085443,Carter; Anne Toulson,5,0,35,30
1656303094024,MATH 105,A02,093477,Staff,14,0,35,21
1656303100053,MATH 109,A01,083213,Ganzberger; Geoffrey Michael,0,0,34,34
1656303100053,MATH 109,A02,083214,Ganzberger; Geoffrey Michael,0,0,34,34
1656303100053,MATH 109,A03,093478,Staff,2,0,34,32
1656303100053,MATH 109,B01,083215,Ganzberger; Geoffrey Michael,4,0,32,28
1656303100053,MATH 109,B02,083216,Ganzberger; Geoffrey Michael,1,0,32,31
1656303100053,MATH 109,B03,093479,Staff,3,0,32,29
1656303106077,MATH 142A,A01,083219,Chow; Bennett,1,0,32,31
1656303106077,MATH 142A,A02,083220,Chow; Bennett,8,0,32,24
1656303106077,MATH 142A,A03,093480,Staff,5,0,32,27
1656303106077,MATH 142A,B03,093481,Staff,3,0,32,29
1656303106077,MATH 142A,B04,093558,Staff,6,0,32,26
1656303106077,MATH 142A,B05,093559,Staff,0,0,32,32
1656303112099,MATH 193A,A01,083224,Rotar; Vladimir,0,1,34,34
1656303112099,MATH 193A,A02,083225,Rotar; Vladimir,0,0,34,34
1656303112099,MATH 193A,A03,083781,Rotar; Vladimir,0,0,34,34
1656303112099,MATH 193A,A04,083782,Rotar; Vladimir,5,0,34,29
1656303112099,MATH 193A,A05,093482,Rotar; Vladimir,0,0,34,34
1656303118124,MATH 197,001,091859,McAuley; Julian John,9999,0,9999,0
1656303118124,MATH 197,002,095566,Kedlaya; Kiran S.,9997,0,9999,2
1656303118124,MATH 197,003,095567,Xiao; Ming,9999,0,9999,0
1656303118124,MATH 197,004,095571,Perols; Johan Lars,9998,0,9999,1
1656303125185,COGS 9,A01,083615,Shannon; Kyle Michael,3,0,75,72
1656303131224,COGS 11,A01,083617,Boyle; Mary E. T.,16,0,48,32
1656303137250,COGS 13,A01,083071,Bastos; Amalia Pinkusfeld,6,0,71,65
1656303143280,COGS 14A,A01,092681,Semenuks; Arturs,1,13,100,99
1656303149304,COGS 14B,A01,083073,Cheng; Tzu-Han,7,0,63,56
1656303155330,COGS 17,A01,092677,Semenuks; Arturs,6,0,81,75
1656303161356,COGS 100,A01,083619,Allen; Michael Gordon,2,0,70,68
1656303167384,COGS 101A,A01,083621,Davis; Joshua Daniel,4,0,68,64
1656303173408,COGS 101B,A01,091572,Allen; Michael Gordon,4,0,65,61
1656303179436,COGS 101C,A01,083625,Delgado; Tania,11,0,35,24
1656303185460,COGS 107A,A01,083627,Boyle; Mary E. T.,1,0,60,59
1656303191487,COGS 118A,A01,083075,Gupta; Anjum,8,0,76,68
1656303197519,CSE 3,A50,083646,Miranda; Gregory Joseph,18,0,50,32
1656303203555,CSE 8A,A50,083650,Miranda; Gregory Joseph,3,3,56,53
1656303209580,CSE 11,A01,083080,Cao; Yingjun,0,48,40,40
1656303215604,CSE 12,A01,083652,Krause-Levy; Sophia Louisa,5,1,120,115
1656303221627,CSE 15L,A01,083654,Morris; Justin Loren,2,0,50,48
1656303221627,CSE 15L,A02,083655,Morris; Justin Loren,4,0,50,46
1656303227656,CSE 20,A01,083657,Tran; Khoa Dang,30,0,80,50
1656303233680,CSE 21,A01,095574,Bach; Quang Tran,23,0,48,25
1656303239703,CSE 30,A01,083084,Eldon; John,2,6,80,78
1656303239703,CSE 30,B01,095061,Bhaskar; Nishant,0,1,50,50
1656303245728,CSE 100,A01,083659,Cao; Yingjun,1,18,70,69
1656303251755,CSE 134B,A01,083661,Powell; Thomas Allan,6,0,100,94
1656303257781,CSE 140,A01,083663,Gungor; Onat,9,0,85,76
1656303263809,CSE 140L,A01,083088,Eldon; John,10,0,100,90
1656303269833,CSE 175,A01,083665,Kumar; Rakesh,0,0,25,25
1656303275860,CSE 190,A00,092507,Dubnov; Shlomo,3,0,20,17
1656303281884,ECE 45,A01,083139,Congero; Spencer William,1,0,75,74
1656303287906,ECE 65,A50,083695,Saad; Andrew S,10,0,30,20
1656303287906,ECE 65,A51,095125,Staff,24,0,26,2
1656303293931,ECE 109,A01,091882,Touri; Behrouz,1,1,70,69
1656303299958,ECE 180,A00,083140,Abi Samra; Nicholas Camill,2,0,30,28
1656303299958,ECE 180,B00,083141,Abi Samra; Nicholas Camill,0,4,30,30
1656303305983,MATH 10A,A01,083735,Patchell; Gregory David,0,0,30,30
1656303305983,MATH 10A,A02,083736,Patchell; Gregory David,22,0,30,8
1656303305983,MATH 10A,A03,083737,Patchell; Gregory David,16,0,30,14
1656303312009,MATH 10B,A01,083207,Lim; Seonhee,2,0,34,32
1656303312009,MATH 10B,A02,083208,Lim; Seonhee,5,0,35,30
1656303312009,MATH 10B,A03,093472,Staff,1,0,34,33
1656303312009,MATH 10B,B01,083739,Sinha; Shubham,11,0,30,19
1656303318034,MATH 18,A01,083743,Cinel; Cameron Alexander,7,0,30,23
1656303318034,MATH 18,A02,083744,Cinel; Cameron Alexander,10,0,30,20
1656303318034,MATH 18,A03,083745,Cinel; Cameron Alexander,5,0,30,25
1656303318034,MATH 18,B01,083748,Rideout; David Porter,0,0,36,36
1656303318034,MATH 18,B02,083749,Rideout; David Porter,0,0,36,36
1656303318034,MATH 18,B03,083750,Rideout; David Porter,0,0,36,36
1656303318034,MATH 18,B04,083751,Rideout; David Porter,0,1,36,36
1656303318034,MATH 18,B05,093473,Rideout; David Porter,0,0,36,36
1656303318034,MATH 18,B06,093474,Rideout; David Porter,2,0,36,34
1656303324057,MATH 20A,A01,083754,Zheng; Zequn,11,0,40,29
1656303330085,MATH 20B,A01,083756,Briones; Jor-el Thomas Caparas,0,0,36,36
1656303330085,MATH 20B,A02,083757,Briones; Jor-el Thomas Caparas,0,0,36,36
1656303330085,MATH 20B,A03,093475,Staff,1,0,36,35
1656303336109,MATH 20C,A01,083760,Briones; Jor-el Thomas Caparas,0,0,35,35
1656303336109,MATH 20C,A02,083761,Briones; Jor-el Thomas Caparas,9,1,35,26
1656303336109,MATH 20C,A03,093476,Staff,0,0,35,35
1656303336109,MATH 20C,B01,083762,Bach; Quang Tran,2,0,30,28
1656303342148,MATH 20D,A01,083765,Tran; Brian Kha,1,0,30,29
1656303342148,MATH 20D,A02,083766,Tran; Brian Kha,1,1,30,29
1656303342148,MATH 20D,A03,083767,Tran; Brian Kha,2,0,30,28
1656303348172,MATH 20E,A01,083771,Ganguly; Soumya,2,0,32,30
1656303348172,MATH 20E,A02,083772,Ganguly; Soumya,0,0,32,32
1656303348172,MATH 20E,B01,083773,Ciotti; Benjamin,18,0,35,17
1656303348172,MATH 20E,B02,083774,Ciotti; Benjamin,15,0,35,20
1656303354196,MATH 103A,A01,083777,Greenfeld; Be'Eri,2,0,36,34
1656303354196,MATH 103A,A02,083778,Greenfeld; Be'Eri,3,0,36,33
1656303354196,MATH 103A,A03,093561,Staff,3,0,36,33
1656303354196,MATH 103A,B01,083779,Greenfeld; Be'Eri,8,0,36,28
1656303354196,MATH 103A,B02,083780,Greenfeld; Be'Eri,0,0,36,36
1656303354196,MATH 103A,B03,093562,Staff,1,0,36,35
1656303360221,MATH 105,A01,085443,Carter; Anne Toulson,5,0,35,30
1656303360221,MATH 105,A02,093477,Staff,14,0,35,21
1656303366245,MATH 109,A01,083213,Ganzberger; Geoffrey Michael,0,0,34,34
1656303366245,MATH 109,A02,083214,Ganzberger; Geoffrey Michael,0,0,34,34
1656303366245,MATH 109,A03,093478,Staff,2,0,34,32
1656303366245,MATH 109,B01,083215,Ganzberger; Geoffrey Michael,4,0,32,28
1656303366245,MATH 109,B02,083216,Ganzberger; Geoffrey Michael,1,0,32,31
1656303366245,MATH 109,B03,093479,Staff,3,0,32,29
1656303372270,MATH 142A,A01,083219,Chow; Bennett,1,0,32,31
1656303372270,MATH 142A,A02,083220,Chow; Bennett,8,0,32,24
1656303372270,MATH 142A,A03,093480,Staff,5,0,32,27
1656303372270,MATH 142A,B03,093481,Staff,3,0,32,29
1656303372270,MATH 142A,B04,093558,Staff,6,0,32,26
1656303372270,MATH 142A,B05,093559,Staff,0,0,32,32
1656303378294,MATH 193A,A01,083224,Rotar; Vladimir,0,1,34,34
1656303378294,MATH 193A,A02,083225,Rotar; Vladimir,0,0,34,34
1656303378294,MATH 193A,A03,083781,Rotar; Vladimir,0,0,34,34
1656303378294,MATH 193A,A04,083782,Rotar; Vladimir,5,0,34,29
1656303378294,MATH 193A,A05,093482,Rotar; Vladimir,0,0,34,34
1656303384320,MATH 197,001,091859,McAuley; Julian John,9999,0,9999,0
1656303384320,MATH 197,002,095566,Kedlaya; Kiran S.,9997,0,9999,2
1656303384320,MATH 197,003,095567,Xiao; Ming,9999,0,9999,0
1656303384320,MATH 197,004,095571,Perols; Johan Lars,9998,0,9999,1
1656303391372,COGS 9,A01,083615,Shannon; Kyle Michael,3,0,75,72
1656303397397,COGS 11,A01,083617,Boyle; Mary E. T.,16,0,48,32
1656303403420,COGS 13,A01,083071,Bastos; Amalia Pinkusfeld,5,0,71,66
1656303409445,COGS 14A,A01,092681,Semenuks; Arturs,1,13,100,99
1656303415471,COGS 14B,A01,083073,Cheng; Tzu-Han,7,0,63,56
1656303421498,COGS 17,A01,092677,Semenuks; Arturs,6,0,81,75
1656303427519,COGS 100,A01,083619,Allen; Michael Gordon,2,0,70,68
1656303433542,COGS 101A,A01,083621,Davis; Joshua Daniel,4,0,68,64
1656303439569,COGS 101B,A01,091572,Allen; Michael Gordon,4,0,65,61
1656303445592,COGS 101C,A01,083625,Delgado; Tania,11,0,35,24
1656303451626,COGS 107A,A01,083627,Boyle; Mary E. T.,1,0,60,59
1656303457648,COGS 118A,A01,083075,Gupta; Anjum,8,0,76,68
1656303463671,CSE 3,A50,083646,Miranda; Gregory Joseph,18,0,50,32
1656303469694,CSE 8A,A50,083650,Miranda; Gregory Joseph,3,3,56,53
1656303475716,CSE 11,A01,083080,Cao; Yingjun,0,48,40,40
1656303481744,CSE 12,A01,083652,Krause-Levy; Sophia Louisa,5,1,120,115
1656303487770,CSE 15L,A01,083654,Morris; Justin Loren,2,0,50,48
1656303487770,CSE 15L,A02,083655,Morris; Justin Loren,4,0,50,46
1656303493794,CSE 20,A01,083657,Tran; Khoa Dang,30,0,80,50
1656303499821,CSE 21,A01,095574,Bach; Quang Tran,23,0,48,25
1656303505865,CSE 30,A01,083084,Eldon; John,2,6,80,78
1656303505865,CSE 30,B01,095061,Bhaskar; Nishant,0,1,50,50
1656303511893,CSE 100,A01,083659,Cao; Yingjun,1,18,70,69
1656303517916,CSE 134B,A01,083661,Powell; Thomas Allan,6,0,100,94
1656303523939,CSE 140,A01,083663,Gungor; Onat,9,0,85,76
1656303529967,CSE 140L,A01,083088,Eldon; John,10,0,100,90
1656303535993,CSE 175,A01,083665,Kumar; Rakesh,0,0,25,25
1656303542033,CSE 190,A00,092507,Dubnov; Shlomo,3,0,20,17
1656303548057,ECE 45,A01,083139,Congero; Spencer William,1,0,75,74
1656303554091,ECE 65,A50,083695,Saad; Andrew S,10,0,30,20
1656303554091,ECE 65,A51,095125,Staff,24,0,26,2
1656303560131,ECE 109,A01,091882,Touri; Behrouz,1,1,70,69
1656303566155,ECE 180,A00,083140,Abi Samra; Nicholas Camill,2,0,30,28
1656303566155,ECE 180,B00,083141,Abi Samra; Nicholas Camill,0,4,30,30
1656303572183,MATH 10A,A01,083735,Patchell; Gregory David,0,0,30,30
1656303572183,MATH 10A,A02,083736,Patchell; Gregory David,22,0,30,8
1656303572183,MATH 10A,A03,083737,Patchell; Gregory David,16,0,30,14
1656303578210,MATH 10B,A01,083207,Lim; Seonhee,2,0,34,32
1656303578210,MATH 10B,A02,083208,Lim; Seonhee,5,0,35,30
1656303578210,MATH 10B,A03,093472,Staff,1,0,34,33
1656303578210,MATH 10B,B01,083739,Sinha; Shubham,11,0,30,19
1656303584241,MATH 18,A01,083743,Cinel; Cameron Alexander,7,0,30,23
1656303584241,MATH 18,A02,083744,Cinel; Cameron Alexander,10,0,30,20
1656303584241,MATH 18,A03,083745,Cinel; Cameron Alexander,5,0,30,25
1656303584241,MATH 18,B01,083748,Rideout; David Porter,0,0,36,36
1656303584241,MATH 18,B02,083749,Rideout; David Porter,0,0,36,36
1656303584241,MATH 18,B03,083750,Rideout; David Porter,0,0,36,36
1656303584241,MATH 18,B04,083751,Rideout; David Porter,0,1,36,36
1656303584241,MATH 18,B05,093473,Rideout; David Porter,0,0,36,36
1656303584241,MATH 18,B06,093474,Rideout; David Porter,2,0,36,34
1656303590269,MATH 20A,A01,083754,Zheng; Zequn,11,0,40,29
1656303596292,MATH 20B,A01,083756,Briones; Jor-el Thomas Caparas,0,0,36,36
1656303596292,MATH 20B,A02,083757,Briones; Jor-el Thomas Caparas,0,0,36,36
1656303596292,MATH 20B,A03,093475,Staff,1,0,36,35
1656303602325,MATH 20C,A01,083760,Briones; Jor-el Thomas Caparas,0,0,35,35
1656303602325,MATH 20C,A02,083761,Briones; Jor-el Thomas Caparas,9,1,35,26
1656303602325,MATH 20C,A03,093476,Staff,0,0,35,35
1656303602325,MATH 20C,B01,083762,Bach; Quang Tran,2,0,30,28
1656303608348,MATH 20D,A01,083765,Tran; Brian Kha,1,0,30,29
1656303608348,MATH 20D,A02,083766,Tran; Brian Kha,1,1,30,29
1656303608348,MATH 20D,A03,083767,Tran; Brian Kha,2,0,30,28
1656303614391,MATH 20E,A01,083771,Ganguly; Soumya,2,0,32,30
1656303614391,MATH 20E,A02,083772,Ganguly; Soumya,0,0,32,32
1656303614391,MATH 20E,B01,083773,Ciotti; Benjamin,18,0,35,17
1656303614391,MATH 20E,B02,083774,Ciotti; Benjamin,15,0,35,20
1656303620416,MATH 103A,A01,083777,Greenfeld; Be'Eri,2,0,36,34
1656303620416,MATH 103A,A02,083778,Greenfeld; Be'Eri,3,0,36,33
1656303620416,MATH 103A,A03,093561,Staff,3,0,36,33
1656303620416,MATH 103A,B01,083779,Greenfeld; Be'Eri,8,0,36,28
1656303620416,MATH 103A,B02,083780,Greenfeld; Be'Eri,0,0,36,36
1656303620416,MATH 103A,B03,093562,Staff,1,0,36,35
1656303626439,MATH 105,A01,085443,Carter; Anne Toulson,5,0,35,30
1656303626439,MATH 105,A02,093477,Staff,14,0,35,21
1656303632466,MATH 109,A01,083213,Ganzberger; Geoffrey Michael,0,0,34,34
1656303632466,MATH 109,A02,083214,Ganzberger; Geoffrey Michael,0,0,34,34
1656303632466,MATH 109,A03,093478,Staff,2,0,34,32
1656303632466,MATH 109,B01,083215,Ganzberger; Geoffrey Michael,4,0,32,28
1656303632466,MATH 109,B02,083216,Ganzberger; Geoffrey Michael,1,0,32,31
1656303632466,MATH 109,B03,093479,Staff,3,0,32,29
1656303638498,MATH 142A,A01,083219,Chow; Bennett,1,0,32,31
1656303638498,MATH 142A,A02,083220,Chow; Bennett,8,0,32,24
1656303638498,MATH 142A,A03,093480,Staff,5,0,32,27
1656303638498,MATH 142A,B03,093481,Staff,3,0,32,29
1656303638498,MATH 142A,B04,093558,Staff,6,0,32,26
1656303638498,MATH 142A,B05,093559,Staff,0,0,32,32
1656303644527,MATH 193A,A01,083224,Rotar; Vladimir,0,1,34,34
1656303644527,MATH 193A,A02,083225,Rotar; Vladimir,0,0,34,34
1656303644527,MATH 193A,A03,083781,Rotar; Vladimir,0,0,34,34
1656303644527,MATH 193A,A04,083782,Rotar; Vladimir,5,0,34,29
1656303644527,MATH 193A,A05,093482,Rotar; Vladimir,0,0,34,34
1656303650549,MATH 197,001,091859,McAuley; Julian John,9999,0,9999,0
1656303650549,MATH 197,002,095566,Kedlaya; Kiran S.,9997,0,9999,2
1656303650549,MATH 197,003,095567,Xiao; Ming,9999,0,9999,0
1656303650549,MATH 197,004,095571,Perols; Johan Lars,9998,0,9999,1
1656303657604,COGS 9,A01,083615,Shannon; Kyle Michael,3,0,75,72
1656303663627,COGS 11,A01,083617,Boyle; Mary E. T.,16,0,48,32
1656303669654,COGS 13,A01,083071,Bastos; Amalia Pinkusfeld,5,0,71,66
1656303675678,COGS 14A,A01,092681,Semenuks; Arturs,1,13,100,99
1656303681777,COGS 14B,A01,083073,Cheng; Tzu-Han,7,0,63,56
1656303687799,COGS 17,A01,092677,Semenuks; Arturs,6,0,81,75
1656303693825,COGS 100,A01,083619,Allen; Michael Gordon,2,0,70,68
1656303699858,COGS 101A,A01,083621,Davis; Joshua Daniel,4,0,68,64
1656303705881,COGS 101B,A01,091572,Allen; Michael Gordon,4,0,65,61
1656303711903,COGS 101C,A01,083625,Delgado; Tania,11,0,35,24
1656303717930,COGS 107A,A01,083627,Boyle; Mary E. T.,1,0,60,59
1656303723954,COGS 118A,A01,083075,Gupta; Anjum,8,0,76,68
1656303729977,CSE 3,A50,083646,Miranda; Gregory Joseph,18,0,50,32
1656303736005,CSE 8A,A50,083650,Miranda; Gregory Joseph,3,3,56,53
1656303742028,CSE 11,A01,083080,Cao; Yingjun,0,48,40,40
1656303748055,CSE 12,A01,083652,Krause-Levy; Sophia Louisa,5,1,120,115
1656303754079,CSE 15L,A01,083654,Morris; Justin Loren,2,0,50,48
1656303754079,CSE 15L,A02,083655,Morris; Justin Loren,4,0,50,46
1656303760109,CSE 20,A01,083657,Tran; Khoa Dang,30,0,80,50
1656303766137,CSE 21,A01,095574,Bach; Quang Tran,23,0,48,25
1656303772164,CSE 30,A01,083084,Eldon; John,2,6,80,78
1656303772164,CSE 30,B01,095061,Bhaskar; Nishant,0,1,50,50
1656303778188,CSE 100,A01,083659,Cao; Yingjun,1,18,70,69
1656303784215,CSE 134B,A01,083661,Powell; Thomas Allan,6,0,100,94
1656303790239,CSE 140,A01,083663,Gungor; Onat,9,0,85,76
1656303796265,CSE 140L,A01,083088,Eldon; John,10,0,100,90
1656303802287,CSE 175,A01,083665,Kumar; Rakesh,0,0,25,25
1656303808309,CSE 190,A00,092507,Dubnov; Shlomo,3,0,20,17
1656303814333,ECE 45,A01,083139,Congero; Spencer William,1,0,75,74
1656303820359,ECE 65,A50,083695,Saad; Andrew S,10,0,30,20
1656303820359,ECE 65,A51,095125,Staff,24,0,26,2
1656303826388,ECE 109,A01,091882,Touri; Behrouz,1,1,70,69
1656303832419,ECE 180,A00,083140,Abi Samra; Nicholas Camill,2,0,30,28
1656303832419,ECE 180,B00,083141,Abi Samra; Nicholas Camill,0,4,30,30
1656303838448,MATH 10A,A01,083735,Patchell; Gregory David,0,0,30,30
1656303838448,MATH 10A,A02,083736,Patchell; Gregory David,22,0,30,8
1656303838448,MATH 10A,A03,083737,Patchell; Gregory David,16,0,30,14
1656303844475,MATH 10B,A01,083207,Lim; Seonhee,2,0,34,32
1656303844475,MATH 10B,A02,083208,Lim; Seonhee,5,0,35,30
1656303844475,MATH 10B,A03,093472,Staff,1,0,34,33
1656303844475,MATH 10B,B01,083739,Sinha; Shubham,11,0,30,19
1656303850498,MATH 18,A01,083743,Cinel; Cameron Alexander,7,0,30,23
1656303850498,MATH 18,A02,083744,Cinel; Cameron Alexander,10,0,30,20
1656303850498,MATH 18,A03,083745,Cinel; Cameron Alexander,5,0,30,25
1656303850498,MATH 18,B01,083748,Rideout; David Porter,0,0,36,36
1656303850498,MATH 18,B02,083749,Rideout; David Porter,0,0,36,36
1656303850498,MATH 18,B03,083750,Rideout; David Porter,0,0,36,36
1656303850498,MATH 18,B04,083751,Rideout; David Porter,0,1,36,36
1656303850498,MATH 18,B05,093473,Rideout; David Porter,0,0,36,36
1656303850498,MATH 18,B06,093474,Rideout; David Porter,2,0,36,34
1656303856524,MATH 20A,A01,083754,Zheng; Zequn,11,0,40,29
1656303862551,MATH 20B,A01,083756,Briones; Jor-el Thomas Caparas,0,0,36,36
1656303862551,MATH 20B,A02,083757,Briones; Jor-el Thomas Caparas,0,0,36,36
1656303862551,MATH 20B,A03,093475,Staff,1,0,36,35
1656303868580,MATH 20C,A01,083760,Briones; Jor-el Thomas Caparas,0,0,35,35
1656303868580,MATH 20C,A02,083761,Briones; Jor-el Thomas Caparas,9,1,35,26
1656303868580,MATH 20C,A03,093476,Staff,0,0,35,35
1656303868580,MATH 20C,B01,083762,Bach; Quang Tran,2,0,30,28
1656303874605,MATH 20D,A01,083765,Tran; Brian Kha,1,0,30,29
1656303874605,MATH 20D,A02,083766,Tran; Brian Kha,1,1,30,29
1656303874605,MATH 20D,A03,083767,Tran; Brian Kha,2,0,30,28
1656303880631,MATH 20E,A01,083771,Ganguly; Soumya,2,0,32,30
1656303880631,MATH 20E,A02,083772,Ganguly; Soumya,0,0,32,32
1656303880631,MATH 20E,B01,083773,Ciotti; Benjamin,18,0,35,17
1656303880631,MATH 20E,B02,083774,Ciotti; Benjamin,15,0,35,20
1656303886654,MATH 103A,A01,083777,Greenfeld; Be'Eri,2,0,36,34
1656303886654,MATH 103A,A02,083778,Greenfeld; Be'Eri,3,0,36,33
1656303886654,MATH 103A,A03,093561,Staff,3,0,36,33
1656303886654,MATH 103A,B01,083779,Greenfeld; Be'Eri,8,0,36,28
1656303886654,MATH 103A,B02,083780,Greenfeld; Be'Eri,0,0,36,36
1656303886654,MATH 103A,B03,093562,Staff,1,0,36,35
1656303892678,MATH 105,A01,085443,Carter; Anne Toulson,4,0,35,31
1656303892678,MATH 105,A02,093477,Staff,14,0,35,21
1656303898702,MATH 109,A01,083213,Ganzberger; Geoffrey Michael,0,0,34,34
1656303898702,MATH 109,A02,083214,Ganzberger; Geoffrey Michael,0,0,34,34
1656303898702,MATH 109,A03,093478,Staff,2,0,34,32
1656303898702,MATH 109,B01,083215,Ganzberger; Geoffrey Michael,4,0,32,28
1656303898702,MATH 109,B02,083216,Ganzberger; Geoffrey Michael,1,0,32,31
1656303898702,MATH 109,B03,093479,Staff,3,0,32,29
1656303904731,MATH 142A,A01,083219,Chow; Bennett,1,0,32,31
1656303904731,MATH 142A,A02,083220,Chow; Bennett,8,0,32,24
1656303904731,MATH 142A,A03,093480,Staff,5,0,32,27
1656303904731,MATH 142A,B03,093481,Staff,3,0,32,29
1656303904731,MATH 142A,B04,093558,Staff,6,0,32,26
1656303904731,MATH 142A,B05,093559,Staff,0,0,32,32
1656303910755,MATH 193A,A01,083224,Rotar; Vladimir,0,1,34,34
1656303910755,MATH 193A,A02,083225,Rotar; Vladimir,0,0,34,34
1656303910755,MATH 193A,A03,083781,Rotar; Vladimir,0,0,34,34
1656303910755,MATH 193A,A04,083782,Rotar; Vladimir,5,0,34,29
1656303910755,MATH 193A,A05,093482,Rotar; Vladimir,0,0,34,34
1656303916786,MATH 197,001,091859,McAuley; Julian John,9999,0,9999,0
1656303916786,MATH 197,002,095566,Kedlaya; Kiran S.,9997,0,9999,2
1656303916786,MATH 197,003,095567,Xiao; Ming,9999,0,9999,0
1656303916786,MATH 197,004,095571,Perols; Johan Lars,9998,0,9999,1
1656303923846,COGS 9,A01,083615,Shannon; Kyle Michael,3,0,75,72
1656303929877,COGS 11,A01,083617,Boyle; Mary E. T.,16,0,48,32
1656303935904,COGS 13,A01,083071,Bastos; Amalia Pinkusfeld,5,0,71,66
1656303941928,COGS 14A,A01,092681,Semenuks; Arturs,1,13,100,99
1656303947957,COGS 14B,A01,083073,Cheng; Tzu-Han,7,0,63,56
1656303953987,COGS 17,A01,092677,Semenuks; Arturs,6,0,81,75
1656303960014,COGS 100,A01,083619,Allen; Michael Gordon,2,0,70,68
1656303966043,COGS 101A,A01,083621,Davis; Joshua Daniel,4,0,68,64
1656303972067,COGS 101B,A01,091572,Allen; Michael Gordon,4,0,65,61
1656303978094,COGS 101C,A01,083625,Delgado; Tania,11,0,35,24
1656303984120,COGS 107A,A01,083627,Boyle; Mary E. T.,1,0,60,59
1656303990141,COGS 118A,A01,083075,Gupta; Anjum,8,0,76,68
1656303996170,CSE 3,A50,083646,Miranda; Gregory Joseph,18,0,50,32
1656304002194,CSE 8A,A50,083650,Miranda; Gregory Joseph,3,3,56,53
1656304008216,CSE 11,A01,083080,Cao; Yingjun,0,48,40,40
1656304014250,CSE 12,A01,083652,Krause-Levy; Sophia Louisa,5,1,120,115
1656304020272,CSE 15L,A01,083654,Morris; Justin Loren,2,0,50,48
1656304020272,CSE 15L,A02,083655,Morris; Justin Loren,4,0,50,46
1656304026297,CSE 20,A01,083657,Tran; Khoa Dang,30,0,80,50
1656304032321,CSE 21,A01,095574,Bach; Quang Tran,23,0,48,25
1656304038347,CSE 30,A01,083084,Eldon; John,2,6,80,78
1656304038347,CSE 30,B01,095061,Bhaskar; Nishant,0,1,50,50
1656304044379,CSE 100,A01,083659,Cao; Yingjun,1,18,70,69
1656304050405,CSE 134B,A01,083661,Powell; Thomas Allan,6,0,100,94
1656304056431,CSE 140,A01,083663,Gungor; Onat,9,0,85,76
1656304062454,CSE 140L,A01,083088,Eldon; John,10,0,100,90
1656304068480,CSE 175,A01,083665,Kumar; Rakesh,0,0,25,25
1656304074506,CSE 190,A00,092507,Dubnov; Shlomo,3,0,20,17
1656304080534,ECE 45,A01,083139,Congero; Spencer William,1,0,75,74
1656304086563,ECE 65,A50,083695,Saad; Andrew S,10,0,30,20
1656304086563,ECE 65,A51,095125,Staff,24,0,26,2
1656304092588,ECE 109,A01,091882,Touri; Behrouz,1,1,70,69
1656304098610,ECE 180,A00,083140,Abi Samra; Nicholas Camill,2,0,30,28
1656304098610,ECE 180,B00,083141,Abi Samra; Nicholas Camill,0,4,30,30
1656304104634,MATH 10A,A01,083735,Patchell; Gregory David,0,0,30,30
1656304104634,MATH 10A,A02,083736,Patchell; Gregory David,22,0,30,8
1656304104634,MATH 10A,A03,083737,Patchell; Gregory David,16,0,30,14
1656304110666,MATH 10B,A01,083207,Lim; Seonhee,2,0,34,32
1656304110666,MATH 10B,A02,083208,Lim; Seonhee,5,0,35,30
1656304110666,MATH 10B,A03,093472,Staff,1,0,34,33
1656304110666,MATH 10B,B01,083739,Sinha; Shubham,11,0,30,19
1656304116691,MATH 18,A01,083743,Cinel; Cameron Alexander,7,0,30,23
1656304116691,MATH 18,A02,083744,Cinel; Cameron Alexander,10,0,30,20
1656304116691,MATH 18,A03,083745,Cinel; Cameron Alexander,5,0,30,25
1656304116691,MATH 18,B01,083748,Rideout; David Porter,0,0,36,36
1656304116691,MATH 18,B02,083749,Rideout; David Porter,0,0,36,36
1656304116691,MATH 18,B03,083750,Rideout; David Porter,0,0,36,36
1656304116691,MATH 18,B04,083751,Rideout; David Porter,0,1,36,36
1656304116691,MATH 18,B05,093473,Rideout; David Porter,0,0,36,36
1656304116691,MATH 18,B06,093474,Rideout; David Porter,2,0,36,34
1656304122718,MATH 20A,A01,083754,Zheng; Zequn,11,0,40,29
1656304128741,MATH 20B,A01,083756,Briones; Jor-el Thomas Caparas,0,0,36,36
1656304128741,MATH 20B,A02,083757,Briones; Jor-el Thomas Caparas,0,0,36,36
1656304128741,MATH 20B,A03,093475,Staff,1,0,36,35
1656304134775,MATH 20C,A01,083760,Briones; Jor-el Thomas Caparas,0,0,35,35
1656304134775,MATH 20C,A02,083761,Briones; Jor-el Thomas Caparas,9,1,35,26
1656304134775,MATH 20C,A03,093476,Staff,0,0,35,35
1656304134775,MATH 20C,B01,083762,Bach; Quang Tran,2,0,30,28
1656304140798,MATH 20D,A01,083765,Tran; Brian Kha,1,0,30,29
1656304140798,MATH 20D,A02,083766,Tran; Brian Kha,1,1,30,29
1656304140798,MATH 20D,A03,083767,Tran; Brian Kha,2,0,30,28
1656304146840,MATH 20E,A01,083771,Ganguly; Soumya,2,0,32,30
1656304146840,MATH 20E,A02,083772,Ganguly; Soumya,0,0,32,32
1656304146840,MATH 20E,B01,083773,Ciotti; Benjamin,18,0,35,17
1656304146840,MATH 20E,B02,083774,Ciotti; Benjamin,15,0,35,20
1656304152866,MATH 103A,A01,083777,Greenfeld; Be'Eri,2,0,36,34
1656304152866,MATH 103A,A02,083778,Greenfeld; Be'Eri,3,0,36,33
1656304152866,MATH 103A,A03,093561,Staff,3,0,36,33
1656304152866,MATH 103A,B01,083779,Greenfeld; Be'Eri,8,0,36,28
1656304152866,MATH 103A,B02,083780,Greenfeld; Be'Eri,0,0,36,36
1656304152866,MATH 103A,B03,093562,Staff,1,0,36,35
1656304158889,MATH 105,A01,085443,Carter; Anne Toulson,4,0,35,31
1656304158889,MATH 105,A02,093477,Staff,14,0,35,21
1656304164913,MATH 109,A01,083213,Ganzberger; Geoffrey Michael,0,0,34,34
1656304164913,MATH 109,A02,083214,Ganzberger; Geoffrey Michael,0,0,34,34
1656304164913,MATH 109,A03,093478,Staff,2,0,34,32
1656304164913,MATH 109,B01,083215,Ganzberger; Geoffrey Michael,4,0,32,28
1656304164913,MATH 109,B02,083216,Ganzberger; Geoffrey Michael,1,0,32,31
1656304164913,MATH 109,B03,093479,Staff,3,0,32,29
1656304170939,MATH 142A,A01,083219,Chow; Bennett,1,0,32,31
1656304170939,MATH 142A,A02,083220,Chow; Bennett,8,0,32,24
1656304170939,MATH 142A,A03,093480,Staff,5,0,32,27
1656304170939,MATH 142A,B03,093481,Staff,3,0,32,29
1656304170939,MATH 142A,B04,093558,Staff,6,0,32,26
1656304170939,MATH 142A,B05,093559,Staff,0,0,32,32
1656304176974,MATH 193A,A01,083224,Rotar; Vladimir,0,1,34,34
1656304176974,MATH 193A,A02,083225,Rotar; Vladimir,0,0,34,34
1656304176974,MATH 193A,A03,083781,Rotar; Vladimir,0,0,34,34
1656304176974,MATH 193A,A04,083782,Rotar; Vladimir,5,0,34,29
1656304176974,MATH 193A,A05,093482,Rotar; Vladimir,0,0,34,34
1656304182999,MATH 197,001,091859,McAuley; Julian John,9999,0,9999,0
1656304182999,MATH 197,002,095566,Kedlaya; Kiran S.,9997,0,9999,2
1656304182999,MATH 197,003,095567,Xiao; Ming,9999,0,9999,0
1656304182999,MATH 197,004,095571,Perols; Johan Lars,9998,0,9999,1
1656304190066,COGS 9,A01,083615,Shannon; Kyle Michael,3,0,75,72
1656304196089,COGS 11,A01,083617,Boyle; Mary E. T.,16,0,48,32
1656304202112,COGS 13,A01,083071,Bastos; Amalia Pinkusfeld,5,0,71,66
1656304208135,COGS 14A,A01,092681,Semenuks; Arturs,1,13,100,99
1656304214162,COGS 14B,A01,083073,Cheng; Tzu-Han,7,0,63,56
1656304220186,COGS 17,A01,092677,Semenuks; Arturs,6,0,81,75
1656304226212,COGS 100,A01,083619,Allen; Michael Gordon,2,0,70,68
1656304232240,COGS 101A,A01,083621,Davis; Joshua Daniel,4,0,68,64
1656304238263,COGS 101B,A01,091572,Allen; Michael Gordon,4,0,65,61
1656304244294,COGS 101C,A01,083625,Delgado; Tania,11,0,35,24
1656304250328,COGS 107A,A01,083627,Boyle; Mary E. T.,1,0,60,59
1656304256352,COGS 118A,A01,083075,Gupta; Anjum,8,0,76,68
1656304262383,CSE 3,A50,083646,Miranda; Gregory Joseph,18,0,50,32
1656304268412,CSE 8A,A50,083650,Miranda; Gregory Joseph,3,3,56,53
1656304274439,CSE 11,A01,083080,Cao; Yingjun,0,48,40,40
1656304280552,CSE 12,A01,083652,Krause-Levy; Sophia Louisa,5,1,120,115
1656304286577,CSE 15L,A01,083654,Morris; Justin Loren,2,0,50,48
1656304286577,CSE 15L,A02,083655,Morris; Justin Loren,4,0,50,46
1656304292603,CSE 20,A01,083657,Tran; Khoa Dang,30,0,80,50
1656304298634,CSE 21,A01,095574,Bach; Quang Tran,23,0,48,25
1656304304658,CSE 30,A01,083084,Eldon; John,2,6,80,78
1656304304658,CSE 30,B01,095061,Bhaskar; Nishant,0,1,50,50
1656304310683,CSE 100,A01,083659,Cao; Yingjun,1,18,70,69
1656304316711,CSE 134B,A01,083661,Powell; Thomas Allan,6,0,100,94
1656304322737,CSE 140,A01,083663,Gungor; Onat,9,0,85,76
1656304328762,CSE 140L,A01,083088,Eldon; John,10,0,100,90
1656304334785,CSE 175,A01,083665,Kumar; Rakesh,0,0,25,25
1656304340807,CSE 190,A00,092507,Dubnov; Shlomo,3,0,20,17
1656304346835,ECE 45,A01,083139,Congero; Spencer William,1,0,75,74
1656304352862,ECE 65,A50,083695,Saad; Andrew S,10,0,30,20
1656304352862,ECE 65,A51,095125,Staff,24,0,26,2
1656304358896,ECE 109,A01,091882,Touri; Behrouz,1,1,70,69
1656304364922,ECE 180,A00,083140,Abi Samra; Nicholas Camill,2,0,30,28
1656304364922,ECE 180,B00,083141,Abi Samra; Nicholas Camill,0,4,30,30
1656304370945,MATH 10A,A01,083735,Patchell; Gregory David,0,0,30,30
1656304370945,MATH 10A,A02,083736,Patchell; Gregory David,22,0,30,8
1656304370945,MATH 10A,A03,083737,Patchell; Gregory David,16,0,30,14
1656304376970,MATH 10B,A01,083207,Lim; Seonhee,2,0,34,32
1656304376970,MATH 10B,A02,083208,Lim; Seonhee,5,0,35,30
1656304376970,MATH 10B,A03,093472,Staff,1,0,34,33
1656304376970,MATH 10B,B01,083739,Sinha; Shubham,11,0,30,19
1656304382996,MATH 18,A01,083743,Cinel; Cameron Alexander,7,0,30,23
1656304382996,MATH 18,A02,083744,Cinel; Cameron Alexander,10,0,30,20
1656304382996,MATH 18,A03,083745,Cinel; Cameron Alexander,5,0,30,25
1656304382996,MATH 18,B01,083748,Rideout; David Porter,0,0,36,36
1656304382996,MATH 18,B02,083749,Rideout; David Porter,0,0,36,36
1656304382996,MATH 18,B03,083750,Rideout; David Porter,0,0,36,36
1656304382996,MATH 18,B04,083751,Rideout; David Porter,0,1,36,36
1656304382996,MATH 18,B05,093473,Rideout; David Porter,0,0,36,36
1656304382996,MATH 18,B06,093474,Rideout; David Porter,2,0,36,34
1656304389018,MATH 20A,A01,083754,Zheng; Zequn,11,0,40,29
1656304395051,MATH 20B,A01,083756,Briones; Jor-el Thomas Caparas,0,0,36,36
1656304395051,MATH 20B,A02,083757,Briones; Jor-el Thomas Caparas,0,0,36,36
1656304395051,MATH 20B,A03,093475,Staff,1,0,36,35
1656304401076,MATH 20C,A01,083760,Briones; Jor-el Thomas Caparas,0,0,35,35
1656304401076,MATH 20C,A02,083761,Briones; Jor-el Thomas Caparas,9,1,35,26
1656304401076,MATH 20C,A03,093476,Staff,0,0,35,35
1656304401076,MATH 20C,B01,083762,Bach; Quang Tran,2,0,30,28
1656304407100,MATH 20D,A01,083765,Tran; Brian Kha,1,0,30,29
1656304407100,MATH 20D,A02,083766,Tran; Brian Kha,1,1,30,29
1656304407100,MATH 20D,A03,083767,Tran; Brian Kha,2,0,30,28
1656304413125,MATH 20E,A01,083771,Ganguly; Soumya,2,0,32,30
1656304413125,MATH 20E,A02,083772,Ganguly; Soumya,0,0,32,32
1656304413125,MATH 20E,B01,083773,Ciotti; Benjamin,18,0,35,17
1656304413125,MATH 20E,B02,083774,Ciotti; Benjamin,15,0,35,20
1656304419149,MATH 103A,A01,083777,Greenfeld; Be'Eri,2,0,36,34
1656304419149,MATH 103A,A02,083778,Greenfeld; Be'Eri,3,0,36,33
1656304419149,MATH 103A,A03,093561,Staff,3,0,36,33
1656304419149,MATH 103A,B01,083779,Greenfeld; Be'Eri,8,0,36,28
1656304419149,MATH 103A,B02,083780,Greenfeld; Be'Eri,0,0,36,36
1656304419149,MATH 103A,B03,093562,Staff,1,0,36,35
1656304425178,MATH 105,A01,085443,Carter; Anne Toulson,4,0,35,31
1656304425178,MATH 105,A02,093477,Staff,14,0,35,21
1656304431211,MATH 109,A01,083213,Ganzberger; Geoffrey Michael,0,0,34,34
1656304431211,MATH 109,A02,083214,Ganzberger; Geoffrey Michael,0,0,34,34
1656304431211,MATH 109,A03,093478,Staff,2,0,34,32
1656304431211,MATH 109,B01,083215,Ganzberger; Geoffrey Michael,4,0,32,28
1656304431211,MATH 109,B02,083216,Ganzberger; Geoffrey Michael,1,0,32,31
1656304431211,MATH 109,B03,093479,Staff,3,0,32,29
1656304437235,MATH 142A,A01,083219,Chow; Bennett,1,0,32,31
1656304437235,MATH 142A,A02,083220,Chow; Bennett,8,0,32,24
1656304437235,MATH 142A,A03,093480,Staff,5,0,32,27
1656304437235,MATH 142A,B03,093481,Staff,3,0,32,29
1656304437235,MATH 142A,B04,093558,Staff,6,0,32,26
1656304437235,MATH 142A,B05,093559,Staff,0,0,32,32
1656304443259,MATH 193A,A01,083224,Rotar; Vladimir,0,1,34,34
1656304443259,MATH 193A,A02,083225,Rotar; Vladimir,0,0,34,34
1656304443259,MATH 193A,A03,083781,Rotar; Vladimir,0,0,34,34
1656304443259,MATH 193A,A04,083782,Rotar; Vladimir,5,0,34,29
1656304443259,MATH 193A,A05,093482,Rotar; Vladimir,0,0,34,34
1656304449285,MATH 197,001,091859,McAuley; Julian John,9999,0,9999,0
1656304449285,MATH 197,002,095566,Kedlaya; Kiran S.,9997,0,9999,2
1656304449285,MATH 197,003,095567,Xiao; Ming,9999,0,9999,0
1656304449285,MATH 197,004,095571,Perols; Johan Lars,9998,0,9999,1
1656304456352,COGS 9,A01,083615,Shannon; Kyle Michael,3,0,75,72
1656304462377,COGS 11,A01,083617,Boyle; Mary E. T.,16,0,48,32
1656304468403,COGS 13,A01,083071,Bastos; Amalia Pinkusfeld,5,0,71,66
1656304474426,COGS 14A,A01,092681,Semenuks; Arturs,1,13,100,99
1656304480454,COGS 14B,A01,083073,Cheng; Tzu-Han,7,0,63,56
1656304486479,COGS 17,A01,092677,Semenuks; Arturs,6,0,81,75
1656304492505,COGS 100,A01,083619,Allen; Michael Gordon,2,0,70,68
1656304498531,COGS 101A,A01,083621,Davis; Joshua Daniel,4,0,68,64
1656304504554,COGS 101B,A01,091572,Allen; Michael Gordon,4,0,65,61
1656304510577,COGS 101C,A01,083625,Delgado; Tania,11,0,35,24
1656304516600,COGS 107A,A01,083627,Boyle; Mary E. T.,1,0,60,59
1656304522624,COGS 118A,A01,083075,Gupta; Anjum,8,0,76,68
1656304528651,CSE 3,A50,083646,Miranda; Gregory Joseph,18,0,50,32
1656304534678,CSE 8A,A50,083650,Miranda; Gregory Joseph,3,3,56,53
1656304540704,CSE 11,A01,083080,Cao; Yingjun,0,48,40,40
1656304546734,CSE 12,A01,083652,Krause-Levy; Sophia Louisa,5,1,120,115
1656304552758,CSE 15L,A01,083654,Morris; Justin Loren,2,0,50,48
1656304552758,CSE 15L,A02,083655,Morris; Justin Loren,4,0,50,46
1656304558786,CSE 20,A01,083657,Tran; Khoa Dang,30,0,80,50
1656304564814,CSE 21,A01,095574,Bach; Quang Tran,23,0,48,25
1656304570839,CSE 30,A01,083084,Eldon; John,2,6,80,78
1656304570839,CSE 30,B01,095061,Bhaskar; Nishant,0,1,50,50
1656304576865,CSE 100,A01,083659,Cao; Yingjun,1,18,70,69
1656304582891,CSE 134B,A01,083661,Powell; Thomas Allan,6,0,100,94
1656304588919,CSE 140,A01,083663,Gungor; Onat,9,0,85,76
1656304594944,CSE 140L,A01,083088,Eldon; John,10,0,100,90
1656304600970,CSE 175,A01,083665,Kumar; Rakesh,0,0,25,25
1656304606996,CSE 190,A00,092507,Dubnov; Shlomo,3,0,20,17
1656304613028,ECE 45,A01,083139,Congero; Spencer William,1,0,75,74
1656304619051,ECE 65,A50,083695,Saad; Andrew S,10,0,30,20
1656304619051,ECE 65,A51,095125,Staff,24,0,26,2
1656304625074,ECE 109,A01,091882,Touri; Behrouz,1,1,70,69
1656304631098,ECE 180,A00,083140,Abi Samra; Nicholas Camill,2,0,30,28
1656304631098,ECE 180,B00,083141,Abi Samra; Nicholas Camill,0,4,30,30
1656304637126,MATH 10A,A01,083735,Patchell; Gregory David,0,0,30,30
1656304637126,MATH 10A,A02,083736,Patchell; Gregory David,22,0,30,8
1656304637126,MATH 10A,A03,083737,Patchell; Gregory David,16,0,30,14
1656304643153,MATH 10B,A01,083207,Lim; Seonhee,2,0,34,32
1656304643153,MATH 10B,A02,083208,Lim; Seonhee,5,0,35,30
1656304643153,MATH 10B,A03,093472,Staff,1,0,34,33
1656304643153,MATH 10B,B01,083739,Sinha; Shubham,11,0,30,19
1656304649188,MATH 18,A01,083743,Cinel; Cameron Alexander,7,0,30,23
1656304649188,MATH 18,A02,083744,Cinel; Cameron Alexander,10,0,30,20
1656304649188,MATH 18,A03,083745,Cinel; Cameron Alexander,5,0,30,25
1656304649188,MATH 18,B01,083748,Rideout; David Porter,0,0,36,36
1656304649188,MATH 18,B02,083749,Rideout; David Porter,0,0,36,36
1656304649188,MATH 18,B03,083750,Rideout; David Porter,0,0,36,36
1656304649188,MATH 18,B04,083751,Rideout; David Porter,0,1,36,36
1656304649188,MATH 18,B05,093473,Rideout; David Porter,0,0,36,36
1656304649188,MATH 18,B06,093474,Rideout; David Porter,2,0,36,34
1656304655210,MATH 20A,A01,083754,Zheng; Zequn,11,0,40,29
1656304661233,MATH 20B,A01,083756,Briones; Jor-el Thomas Caparas,0,0,36,36
1656304661233,MATH 20B,A02,083757,Briones; Jor-el Thomas Caparas,0,0,36,36
1656304661233,MATH 20B,A03,093475,Staff,1,0,36,35
1656304667262,MATH 20C,A01,083760,Briones; Jor-el Thomas Caparas,0,0,35,35
1656304667262,MATH 20C,A02,083761,Briones; Jor-el Thomas Caparas,9,1,35,26
1656304667262,MATH 20C,A03,093476,Staff,0,0,35,35
1656304667262,MATH 20C,B01,083762,Bach; Quang Tran,2,0,30,28
1656304673287,MATH 20D,A01,083765,Tran; Brian Kha,1,0,30,29
1656304673287,MATH 20D,A02,083766,Tran; Brian Kha,1,1,30,29
1656304673287,MATH 20D,A03,083767,Tran; Brian Kha,2,0,30,28
1656304679316,MATH 20E,A01,083771,Ganguly; Soumya,2,0,32,30
1656304679316,MATH 20E,A02,083772,Ganguly; Soumya,0,0,32,32
1656304679316,MATH 20E,B01,083773,Ciotti; Benjamin,18,0,35,17
1656304679316,MATH 20E,B02,083774,Ciotti; Benjamin,15,0,35,20
1656304685346,MATH 103A,A01,083777,Greenfeld; Be'Eri,2,0,36,34
1656304685346,MATH 103A,A02,083778,Greenfeld; Be'Eri,3,0,36,33
1656304685346,MATH 103A,A03,093561,Staff,3,0,36,33
1656304685346,MATH 103A,B01,083779,Greenfeld; Be'Eri,8,0,36,28
1656304685346,MATH 103A,B02,083780,Greenfeld; Be'Eri,0,0,36,36
1656304685346,MATH 103A,B03,093562,Staff,1,0,36,35
1656304691370,MATH 105,A01,085443,Carter; Anne Toulson,4,0,35,31
1656304691370,MATH 105,A02,093477,Staff,14,0,35,21
1656304697396,MATH 109,A01,083213,Ganzberger; Geoffrey Michael,0,0,34,34
1656304697396,MATH 109,A02,083214,Ganzberger; Geoffrey Michael,0,0,34,34
1656304697396,MATH 109,A03,093478,Staff,2,0,34,32
1656304697396,MATH 109,B01,083215,Ganzberger; Geoffrey Michael,4,0,32,28
1656304697396,MATH 109,B02,083216,Ganzberger; Geoffrey Michael,1,0,32,31
1656304697396,MATH 109,B03,093479,Staff,3,0,32,29
1656304703424,MATH 142A,A01,083219,Chow; Bennett,1,0,32,31
1656304703424,MATH 142A,A02,083220,Chow; Bennett,8,0,32,24
1656304703424,MATH 142A,A03,093480,Staff,5,0,32,27
1656304703424,MATH 142A,B03,093481,Staff,3,0,32,29
1656304703424,MATH 142A,B04,093558,Staff,6,0,32,26
1656304703424,MATH 142A,B05,093559,Staff,0,0,32,32
1656304709452,MATH 193A,A01,083224,Rotar; Vladimir,0,1,34,34
1656304709452,MATH 193A,A02,083225,Rotar; Vladimir,0,0,34,34
1656304709452,MATH 193A,A03,083781,Rotar; Vladimir,0,0,34,34
1656304709452,MATH 193A,A04,083782,Rotar; Vladimir,5,0,34,29
1656304709452,MATH 193A,A05,093482,Rotar; Vladimir,0,0,34,34
1656304715476,MATH 197,001,091859,McAuley; Julian John,9999,0,9999,0
1656304715476,MATH 197,002,095566,Kedlaya; Kiran S.,9997,0,9999,2
1656304715476,MATH 197,003,095567,Xiao; Ming,9999,0,9999,0
1656304715476,MATH 197,004,095571,Perols; Johan Lars,9998,0,9999,1
1656304722531,COGS 9,A01,083615,Shannon; Kyle Michael,3,0,75,72
1656304728557,COGS 11,A01,083617,Boyle; Mary E. T.,16,0,48,32
1656304734580,COGS 13,A01,083071,Bastos; Amalia Pinkusfeld,5,0,71,66
1656304740602,COGS 14A,A01,092681,Semenuks; Arturs,1,13,100,99
1656304746624,COGS 14B,A01,083073,Cheng; Tzu-Han,7,0,63,56
1656304752655,COGS 17,A01,092677,Semenuks; Arturs,6,0,81,75
1656304758679,COGS 100,A01,083619,Allen; Michael Gordon,2,0,70,68
1656304764702,COGS 101A,A01,083621,Davis; Joshua Daniel,4,0,68,64
1656304770726,COGS 101B,A01,091572,Allen; Michael Gordon,4,0,65,61
1656304776750,COGS 101C,A01,083625,Delgado; Tania,11,0,35,24
1656304782773,COGS 107A,A01,083627,Boyle; Mary E. T.,1,0,60,59
1656304788796,COGS 118A,A01,083075,Gupta; Anjum,8,0,76,68
1656304794822,CSE 3,A50,083646,Miranda; Gregory Joseph,18,0,50,32
1656304800850,CSE 8A,A50,083650,Miranda; Gregory Joseph,3,3,56,53
1656304806900,CSE 11,A01,083080,Cao; Yingjun,0,48,40,40
1656304812923,CSE 12,A01,083652,Krause-Levy; Sophia Louisa,5,1,120,115
1656304818948,CSE 15L,A01,083654,Morris; Justin Loren,2,0,50,48
1656304818948,CSE 15L,A02,083655,Morris; Justin Loren,4,0,50,46
1656304824971,CSE 20,A01,083657,Tran; Khoa Dang,30,0,80,50
1656304830996,CSE 21,A01,095574,Bach; Quang Tran,23,0,48,25
1656304837021,CSE 30,A01,083084,Eldon; John,2,6,80,78
1656304837021,CSE 30,B01,095061,Bhaskar; Nishant,0,1,50,50
1656304843046,CSE 100,A01,083659,Cao; Yingjun,1,18,70,69
1656304849073,CSE 134B,A01,083661,Powell; Thomas Allan,6,0,100,94
1656304855098,CSE 140,A01,083663,Gungor; Onat,9,0,85,76
1656304861132,CSE 140L,A01,083088,Eldon; John,10,0,100,90
1656304867166,CSE 175,A01,083665,Kumar; Rakesh,0,0,25,25
1656304873194,CSE 190,A00,092507,Dubnov; Shlomo,3,0,20,17
1656304879300,ECE 45,A01,083139,Congero; Spencer William,1,0,75,74
1656304885333,ECE 65,A50,083695,Saad; Andrew S,10,0,30,20
1656304885333,ECE 65,A51,095125,Staff,24,0,26,2
1656304891356,ECE 109,A01,091882,Touri; Behrouz,1,1,70,69
1656304897381,ECE 180,A00,083140,Abi Samra; Nicholas Camill,2,0,30,28
1656304897381,ECE 180,B00,083141,Abi Samra; Nicholas Camill,0,4,30,30
1656304903420,MATH 10A,A01,083735,Patchell; Gregory David,0,0,30,30
1656304903420,MATH 10A,A02,083736,Patchell; Gregory David,22,0,30,8
1656304903420,MATH 10A,A03,083737,Patchell; Gregory David,16,0,30,14
1656304909462,MATH 10B,A01,083207,Lim; Seonhee,2,0,34,32
1656304909462,MATH 10B,A02,083208,Lim; Seonhee,5,0,35,30
1656304909462,MATH 10B,A03,093472,Staff,1,0,34,33
1656304909462,MATH 10B,B01,083739,Sinha; Shubham,11,0,30,19
1656304915491,MATH 18,A01,083743,Cinel; Cameron Alexander,7,0,30,23
1656304915491,MATH 18,A02,083744,Cinel; Cameron Alexander,10,0,30,20
1656304915491,MATH 18,A03,083745,Cinel; Cameron Alexander,5,0,30,25
1656304915491,MATH 18,B01,083748,Rideout; David Porter,0,0,36,36
1656304915491,MATH 18,B02,083749,Rideout; David Porter,0,0,36,36
1656304915491,MATH 18,B03,083750,Rideout; David Porter,0,0,36,36
1656304915491,MATH 18,B04,083751,Rideout; David Porter,0,1,36,36
1656304915491,MATH 18,B05,093473,Rideout; David Porter,0,0,36,36
1656304915491,MATH 18,B06,093474,Rideout; David Porter,2,0,36,34
1656304921517,MATH 20A,A01,083754,Zheng; Zequn,11,0,40,29
1656304927542,MATH 20B,A01,083756,Briones; Jor-el Thomas Caparas,0,0,36,36
1656304927542,MATH 20B,A02,083757,Briones; Jor-el Thomas Caparas,0,0,36,36
1656304927542,MATH 20B,A03,093475,Staff,1,0,36,35
1656304933571,MATH 20C,A01,083760,Briones; Jor-el Thomas Caparas,0,0,35,35
1656304933571,MATH 20C,A02,083761,Briones; Jor-el Thomas Caparas,9,1,35,26
1656304933571,MATH 20C,A03,093476,Staff,0,0,35,35
1656304933571,MATH 20C,B01,083762,Bach; Quang Tran,2,0,30,28
1656304939596,MATH 20D,A01,083765,Tran; Brian Kha,1,0,30,29
1656304939596,MATH 20D,A02,083766,Tran; Brian Kha,1,1,30,29
1656304939596,MATH 20D,A03,083767,Tran; Brian Kha,2,0,30,28
1656304945628,MATH 20E,A01,083771,Ganguly; Soumya,2,0,32,30
1656304945628,MATH 20E,A02,083772,Ganguly; Soumya,0,0,32,32
1656304945628,MATH 20E,B01,083773,Ciotti; Benjamin,18,0,35,17
1656304945628,MATH 20E,B02,083774,Ciotti; Benjamin,15,0,35,20
1656304951657,MATH 103A,A01,083777,Greenfeld; Be'Eri,2,0,36,34
1656304951657,MATH 103A,A02,083778,Greenfeld; Be'Eri,3,0,36,33
1656304951657,MATH 103A,A03,093561,Staff,3,0,36,33
1656304951657,MATH 103A,B01,083779,Greenfeld; Be'Eri,8,0,36,28
1656304951657,MATH 103A,B02,083780,Greenfeld; Be'Eri,0,0,36,36
1656304951657,MATH 103A,B03,093562,Staff,1,0,36,35
1656304957686,MATH 105,A01,085443,Carter; Anne Toulson,4,0,35,31
1656304957686,MATH 105,A02,093477,Staff,14,0,35,21
1656304963708,MATH 109,A01,083213,Ganzberger; Geoffrey Michael,0,0,34,34
1656304963708,MATH 109,A02,083214,Ganzberger; Geoffrey Michael,0,0,34,34
1656304963708,MATH 109,A03,093478,Staff,2,0,34,32
1656304963708,MATH 109,B01,083215,Ganzberger; Geoffrey Michael,4,0,32,28
1656304963708,MATH 109,B02,083216,Ganzberger; Geoffrey Michael,1,0,32,31
1656304963708,MATH 109,B03,093479,Staff,3,0,32,29
1656304969732,MATH 142A,A01,083219,Chow; Bennett,1,0,32,31
1656304969732,MATH 142A,A02,083220,Chow; Bennett,8,0,32,24
1656304969732,MATH 142A,A03,093480,Staff,5,0,32,27
1656304969732,MATH 142A,B03,093481,Staff,3,0,32,29
1656304969732,MATH 142A,B04,093558,Staff,6,0,32,26
1656304969732,MATH 142A,B05,093559,Staff,0,0,32,32
1656304975755,MATH 193A,A01,083224,Rotar; Vladimir,0,1,34,34
1656304975755,MATH 193A,A02,083225,Rotar; Vladimir,0,0,34,34
1656304975755,MATH 193A,A03,083781,Rotar; Vladimir,0,0,34,34
1656304975755,MATH 193A,A04,083782,Rotar; Vladimir,5,0,34,29
1656304975755,MATH 193A,A05,093482,Rotar; Vladimir,0,0,34,34
1656304981781,MATH 197,001,091859,McAuley; Julian John,9999,0,9999,0
1656304981781,MATH 197,002,095566,Kedlaya; Kiran S.,9997,0,9999,2
1656304981781,MATH 197,003,095567,Xiao; Ming,9999,0,9999,0
1656304981781,MATH 197,004,095571,Perols; Johan Lars,9998,0,9999,1
1656304988840,COGS 9,A01,083615,Shannon; Kyle Michael,3,0,75,72
1656304994875,COGS 11,A01,083617,Boyle; Mary E. T.,16,0,48,32
1656305000898,COGS 13,A01,083071,Bastos; Amalia Pinkusfeld,5,0,71,66
1656305006925,COGS 14A,A01,092681,Semenuks; Arturs,1,13,100,99
1656305012950,COGS 14B,A01,083073,Cheng; Tzu-Han,7,0,63,56
1656305018974,COGS 17,A01,092677,Semenuks; Arturs,6,0,81,75
1656305025001,COGS 100,A01,083619,Allen; Michael Gordon,2,0,70,68
1656305031030,COGS 101A,A01,083621,Davis; Joshua Daniel,4,0,68,64
1656305037053,COGS 101B,A01,091572,Allen; Michael Gordon,4,0,65,61
1656305043076,COGS 101C,A01,083625,Delgado; Tania,11,0,35,24
1656305049099,COGS 107A,A01,083627,Boyle; Mary E. T.,2,0,60,58
1656305055123,COGS 118A,A01,083075,Gupta; Anjum,8,0,76,68
1656305061152,CSE 3,A50,083646,Miranda; Gregory Joseph,18,0,50,32
1656305067177,CSE 8A,A50,083650,Miranda; Gregory Joseph,3,3,56,53
1656305073205,CSE 11,A01,083080,Cao; Yingjun,0,48,40,40
1656305079237,CSE 12,A01,083652,Krause-Levy; Sophia Louisa,5,1,120,115
1656305085260,CSE 15L,A01,083654,Morris; Justin Loren,2,0,50,48
1656305085260,CSE 15L,A02,083655,Morris; Justin Loren,4,0,50,46
1656305091283,CSE 20,A01,083657,Tran; Khoa Dang,30,0,80,50
1656305097309,CSE 21,A01,095574,Bach; Quang Tran,23,0,48,25
1656305103336,CSE 30,A01,083084,Eldon; John,2,6,80,78
1656305103336,CSE 30,B01,095061,Bhaskar; Nishant,0,1,50,50
1656305109359,CSE 100,A01,083659,Cao; Yingjun,1,18,70,69
1656305115384,CSE 134B,A01,083661,Powell; Thomas Allan,6,0,100,94
1656305121407,CSE 140,A01,083663,Gungor; Onat,9,0,85,76
1656305127439,CSE 140L,A01,083088,Eldon; John,10,0,100,90
1656305133463,CSE 175,A01,083665,Kumar; Rakesh,0,0,25,25
1656305139488,CSE 190,A00,092507,Dubnov; Shlomo,3,0,20,17
1656305145525,ECE 45,A01,083139,Congero; Spencer William,1,0,75,74
1656305151557,ECE 65,A50,083695,Saad; Andrew S,10,0,30,20
1656305151557,ECE 65,A51,095125,Staff,24,0,26,2
1656305157586,ECE 109,A01,091882,Touri; Behrouz,1,1,70,69
1656305163611,ECE 180,A00,083140,Abi Samra; Nicholas Camill,2,0,30,28
1656305163611,ECE 180,B00,083141,Abi Samra; Nicholas Camill,0,4,30,30
1656305169634,MATH 10A,A01,083735,Patchell; Gregory David,0,0,30,30
1656305169634,MATH 10A,A02,083736,Patchell; Gregory David,22,0,30,8
1656305169634,MATH 10A,A03,083737,Patchell; Gregory David,16,0,30,14
1656305175659,MATH 10B,A01,083207,Lim; Seonhee,2,0,34,32
1656305175659,MATH 10B,A02,083208,Lim; Seonhee,5,0,35,30
1656305175659,MATH 10B,A03,093472,Staff,1,0,34,33
1656305175659,MATH 10B,B01,083739,Sinha; Shubham,11,0,30,19
1656305181692,MATH 18,A01,083743,Cinel; Cameron Alexander,7,0,30,23
1656305181692,MATH 18,A02,083744,Cinel; Cameron Alexander,10,0,30,20
1656305181692,MATH 18,A03,083745,Cinel; Cameron Alexander,5,0,30,25
1656305181692,MATH 18,B01,083748,Rideout; David Porter,0,0,36,36
1656305181692,MATH 18,B02,083749,Rideout; David Porter,0,0,36,36
1656305181692,MATH 18,B03,083750,Rideout; David Porter,0,0,36,36
1656305181692,MATH 18,B04,083751,Rideout; David Porter,0,1,36,36
1656305181692,MATH 18,B05,093473,Rideout; David Porter,0,0,36,36
1656305181692,MATH 18,B06,093474,Rideout; David Porter,2,0,36,34
1656305187715,MATH 20A,A01,083754,Zheng; Zequn,11,0,40,29
1656305193744,MATH 20B,A01,083756,Briones; Jor-el Thomas Caparas,0,0,36,36
1656305193744,MATH 20B,A02,083757,Briones; Jor-el Thomas Caparas,0,0,36,36
1656305193744,MATH 20B,A03,093475,Staff,1,0,36,35
1656305199766,MATH 20C,A01,083760,Briones; Jor-el Thomas Caparas,0,0,35,35
1656305199766,MATH 20C,A02,083761,Briones; Jor-el Thomas Caparas,9,1,35,26
1656305199766,MATH 20C,A03,093476,Staff,0,0,35,35
1656305199766,MATH 20C,B01,083762,Bach; Quang Tran,2,0,30,28
1656305205790,MATH 20D,A01,083765,Tran; Brian Kha,1,0,30,29
1656305205790,MATH 20D,A02,083766,Tran; Brian Kha,1,1,30,29
1656305205790,MATH 20D,A03,083767,Tran; Brian Kha,2,0,30,28
1656305211830,MATH 20E,A01,083771,Ganguly; Soumya,2,0,32,30
1656305211830,MATH 20E,A02,083772,Ganguly; Soumya,0,0,32,32
1656305211830,MATH 20E,B01,083773,Ciotti; Benjamin,18,0,35,17
1656305211830,MATH 20E,B02,083774,Ciotti; Benjamin,15,0,35,20
1656305217855,MATH 103A,A01,083777,Greenfeld; Be'Eri,2,0,36,34
1656305217855,MATH 103A,A02,083778,Greenfeld; Be'Eri,3,0,36,33
1656305217855,MATH 103A,A03,093561,Staff,3,0,36,33
1656305217855,MATH 103A,B01,083779,Greenfeld; Be'Eri,8,0,36,28
1656305217855,MATH 103A,B02,083780,Greenfeld; Be'Eri,0,0,36,36
1656305217855,MATH 103A,B03,093562,Staff,1,0,36,35
1656305223881,MATH 105,A01,085443,Carter; Anne Toulson,4,0,35,31
1656305223881,MATH 105,A02,093477,Staff,14,0,35,21
1656305229904,MATH 109,A01,083213,Ganzberger; Geoffrey Michael,0,0,34,34
1656305229904,MATH 109,A02,083214,Ganzberger; Geoffrey Michael,0,0,34,34
1656305229904,MATH 109,A03,093478,Staff,2,0,34,32
1656305229904,MATH 109,B01,083215,Ganzberger; Geoffrey Michael,4,0,32,28
1656305229904,MATH 109,B02,083216,Ganzberger; Geoffrey Michael,1,0,32,31
1656305229904,MATH 109,B03,093479,Staff,3,0,32,29
1656305235930,MATH 142A,A01,083219,Chow; Bennett,1,0,32,31
1656305235930,MATH 142A,A02,083220,Chow; Bennett,8,0,32,24
1656305235930,MATH 142A,A03,093480,Staff,5,0,32,27
1656305235930,MATH 142A,B03,093481,Staff,3,0,32,29
1656305235930,MATH 142A,B04,093558,Staff,6,0,32,26
1656305235930,MATH 142A,B05,093559,Staff,0,0,32,32
1656305241956,MATH 193A,A01,083224,Rotar; Vladimir,0,1,34,34
1656305241956,MATH 193A,A02,083225,Rotar; Vladimir,0,0,34,34
1656305241956,MATH 193A,A03,083781,Rotar; Vladimir,0,0,34,34
1656305241956,MATH 193A,A04,083782,Rotar; Vladimir,5,0,34,29
1656305241956,MATH 193A,A05,093482,Rotar; Vladimir,0,0,34,34
1656305247989,MATH 197,001,091859,McAuley; Julian John,9999,0,9999,0
1656305247989,MATH 197,002,095566,Kedlaya; Kiran S.,9997,0,9999,2
1656305247989,MATH 197,003,095567,Xiao; Ming,9999,0,9999,0
1656305247989,MATH 197,004,095571,Perols; Johan Lars,9998,0,9999,1
1656305255059,COGS 9,A01,083615,Shannon; Kyle Michael,3,0,75,72
1656305261081,COGS 11,A01,083617,Boyle; Mary E. T.,16,0,48,32
1656305267109,COGS 13,A01,083071,Bastos; Amalia Pinkusfeld,5,0,71,66
1656305273133,COGS 14A,A01,092681,Semenuks; Arturs,1,13,100,99
1656305279155,COGS 14B,A01,083073,Cheng; Tzu-Han,7,0,63,56
1656305285177,COGS 17,A01,092677,Semenuks; Arturs,6,0,81,75
1656305291204,COGS 100,A01,083619,Allen; Michael Gordon,2,0,70,68
1656305297232,COGS 101A,A01,083621,Davis; Joshua Daniel,4,0,68,64
1656305303256,COGS 101B,A01,091572,Allen; Michael Gordon,4,0,65,61
1656305309280,COGS 101C,A01,083625,Delgado; Tania,11,0,35,24
1656305315305,COGS 107A,A01,083627,Boyle; Mary E. T.,2,0,60,58
1656305321328,COGS 118A,A01,083075,Gupta; Anjum,8,0,76,68
1656305327360,CSE 3,A50,083646,Miranda; Gregory Joseph,18,0,50,32
1656305333388,CSE 8A,A50,083650,Miranda; Gregory Joseph,3,3,56,53
1656305339415,CSE 11,A01,083080,Cao; Yingjun,0,48,40,40
1656305345450,CSE 12,A01,083652,Krause-Levy; Sophia Louisa,5,1,120,115
1656305351475,CSE 15L,A01,083654,Morris; Justin Loren,2,0,50,48
1656305351475,CSE 15L,A02,083655,Morris; Justin Loren,4,0,50,46
1656305357506,CSE 20,A01,083657,Tran; Khoa Dang,30,0,80,50
1656305363530,CSE 21,A01,095574,Bach; Quang Tran,23,0,48,25
1656305369559,CSE 30,A01,083084,Eldon; John,2,6,80,78
1656305369559,CSE 30,B01,095061,Bhaskar; Nishant,0,1,50,50
1656305375582,CSE 100,A01,083659,Cao; Yingjun,1,18,70,69
1656305381606,CSE 134B,A01,083661,Powell; Thomas Allan,6,0,100,94
1656305387629,CSE 140,A01,083663,Gungor; Onat,9,0,85,76
1656305393652,CSE 140L,A01,083088,Eldon; John,10,0,100,90
1656305399679,CSE 175,A01,083665,Kumar; Rakesh,0,0,25,25
1656305405703,CSE 190,A00,092507,Dubnov; Shlomo,3,0,20,17
1656305411727,ECE 45,A01,083139,Congero; Spencer William,1,0,75,74
1656305417751,ECE 65,A50,083695,Saad; Andrew S,10,0,30,20
1656305417751,ECE 65,A51,095125,Staff,24,0,26,2
1656305423776,ECE 109,A01,091882,Touri; Behrouz,1,1,70,69
1656305429798,ECE 180,A00,083140,Abi Samra; Nicholas Camill,2,0,30,28
1656305429798,ECE 180,B00,083141,Abi Samra; Nicholas Camill,0,4,30,30
1656305435821,MATH 10A,A01,083735,Patchell; Gregory David,0,0,30,30
1656305435821,MATH 10A,A02,083736,Patchell; Gregory David,22,0,30,8
1656305435821,MATH 10A,A03,083737,Patchell; Gregory David,16,0,30,14
1656305441854,MATH 10B,A01,083207,Lim; Seonhee,2,0,34,32
1656305441854,MATH 10B,A02,083208,Lim; Seonhee,5,0,35,30
1656305441854,MATH 10B,A03,093472,Staff,1,0,34,33
1656305441854,MATH 10B,B01,083739,Sinha; Shubham,11,0,30,19
1656305447877,MATH 18,A01,083743,Cinel; Cameron Alexander,7,0,30,23
1656305447877,MATH 18,A02,083744,Cinel; Cameron Alexander,10,0,30,20
1656305447877,MATH 18,A03,083745,Cinel; Cameron Alexander,5,0,30,25
1656305447877,MATH 18,B01,083748,Rideout; David Porter,0,0,36,36
1656305447877,MATH 18,B02,083749,Rideout; David Porter,0,0,36,36
1656305447877,MATH 18,B03,083750,Rideout; David Porter,0,0,36,36
1656305447877,MATH 18,B04,083751,Rideout; David Porter,0,1,36,36
1656305447877,MATH 18,B05,093473,Rideout; David Porter,0,0,36,36
1656305447877,MATH 18,B06,093474,Rideout; David Porter,2,0,36,34
1656305453904,MATH 20A,A01,083754,Zheng; Zequn,11,0,40,29
1656305459934,MATH 20B,A01,083756,Briones; Jor-el Thomas Caparas,0,0,36,36
1656305459934,MATH 20B,A02,083757,Briones; Jor-el Thomas Caparas,0,0,36,36
1656305459934,MATH 20B,A03,093475,Staff,1,0,36,35
1656305465962,MATH 20C,A01,083760,Briones; Jor-el Thomas Caparas,0,0,35,35
1656305465962,MATH 20C,A02,083761,Briones; Jor-el Thomas Caparas,9,1,35,26
1656305465962,MATH 20C,A03,093476,Staff,0,0,35,35
1656305465962,MATH 20C,B01,083762,Bach; Quang Tran,2,0,30,28
1656305471991,MATH 20D,A01,083765,Tran; Brian Kha,1,0,30,29
1656305471991,MATH 20D,A02,083766,Tran; Brian Kha,1,1,30,29
1656305471991,MATH 20D,A03,083767,Tran; Brian Kha,2,0,30,28
1656305478117,MATH 20E,A01,083771,Ganguly; Soumya,2,0,32,30
1656305478117,MATH 20E,A02,083772,Ganguly; Soumya,0,0,32,32
1656305478117,MATH 20E,B01,083773,Ciotti; Benjamin,18,0,35,17
1656305478117,MATH 20E,B02,083774,Ciotti; Benjamin,15,0,35,20
1656305484147,MATH 103A,A01,083777,Greenfeld; Be'Eri,2,0,36,34
1656305484147,MATH 103A,A02,083778,Greenfeld; Be'Eri,3,0,36,33
1656305484147,MATH 103A,A03,093561,Staff,3,0,36,33
1656305484147,MATH 103A,B01,083779,Greenfeld; Be'Eri,8,0,36,28
1656305484147,MATH 103A,B02,083780,Greenfeld; Be'Eri,0,0,36,36
1656305484147,MATH 103A,B03,093562,Staff,1,0,36,35
1656305490176,MATH 105,A01,085443,Carter; Anne Toulson,4,0,35,31
1656305490176,MATH 105,A02,093477,Staff,14,0,35,21
1656305496207,MATH 109,A01,083213,Ganzberger; Geoffrey Michael,0,0,34,34
1656305496207,MATH 109,A02,083214,Ganzberger; Geoffrey Michael,0,0,34,34
1656305496207,MATH 109,A03,093478,Staff,2,0,34,32
1656305496207,MATH 109,B01,083215,Ganzberger; Geoffrey Michael,4,0,32,28
1656305496207,MATH 109,B02,083216,Ganzberger; Geoffrey Michael,1,0,32,31
1656305496207,MATH 109,B03,093479,Staff,3,0,32,29
1656305502239,MATH 142A,A01,083219,Chow; Bennett,1,0,32,31
1656305502239,MATH 142A,A02,083220,Chow; Bennett,8,0,32,24
1656305502239,MATH 142A,A03,093480,Staff,5,0,32,27
1656305502239,MATH 142A,B03,093481,Staff,3,0,32,29
1656305502239,MATH 142A,B04,093558,Staff,6,0,32,26
1656305502239,MATH 142A,B05,093559,Staff,0,0,32,32
1656305508263,MATH 193A,A01,083224,Rotar; Vladimir,0,1,34,34
1656305508263,MATH 193A,A02,083225,Rotar; Vladimir,0,0,34,34
1656305508263,MATH 193A,A03,083781,Rotar; Vladimir,0,0,34,34
1656305508263,MATH 193A,A04,083782,Rotar; Vladimir,5,0,34,29
1656305508263,MATH 193A,A05,093482,Rotar; Vladimir,0,0,34,34
1656305514288,MATH 197,001,091859,McAuley; Julian John,9999,0,9999,0
1656305514288,MATH 197,002,095566,Kedlaya; Kiran S.,9997,0,9999,2
1656305514288,MATH 197,003,095567,Xiao; Ming,9999,0,9999,0
1656305514288,MATH 197,004,095571,Perols; Johan Lars,9998,0,9999,1
1656305521354,COGS 9,A01,083615,Shannon; Kyle Michael,3,0,75,72
1656305527377,COGS 11,A01,083617,Boyle; Mary E. T.,16,0,48,32
1656305541517,COGS 13,A01,083071,Bastos; Amalia Pinkusfeld,5,0,71,66
1656305547543,COGS 14A,A01,092681,Semenuks; Arturs,1,13,100,99
1656305553566,COGS 14B,A01,083073,Cheng; Tzu-Han,7,0,63,56
1656305559590,COGS 17,A01,092677,Semenuks; Arturs,6,0,81,75
1656305565619,COGS 100,A01,083619,Allen; Michael Gordon,2,0,70,68
1656305571657,COGS 101A,A01,083621,Davis; Joshua Daniel,4,0,68,64
1656305577684,COGS 101B,A01,091572,Allen; Michael Gordon,4,0,65,61
1656305583707,COGS 101C,A01,083625,Delgado; Tania,11,0,35,24
1656305589730,COGS 107A,A01,083627,Boyle; Mary E. T.,2,0,60,58
1656305595754,COGS 118A,A01,083075,Gupta; Anjum,8,0,76,68
1656305601780,CSE 3,A50,083646,Miranda; Gregory Joseph,18,0,50,32
1656305607810,CSE 8A,A50,083650,Miranda; Gregory Joseph,3,3,56,53
1656305613834,CSE 11,A01,083080,Cao; Yingjun,0,48,40,40
1656305619870,CSE 12,A01,083652,Krause-Levy; Sophia Louisa,5,1,120,115
1656305625898,CSE 15L,A01,083654,Morris; Justin Loren,2,0,50,48
1656305625898,CSE 15L,A02,083655,Morris; Justin Loren,4,0,50,46
1656305631923,CSE 20,A01,083657,Tran; Khoa Dang,30,0,80,50
1656305637947,CSE 21,A01,095574,Bach; Quang Tran,23,0,48,25
1656305643976,CSE 30,A01,083084,Eldon; John,2,6,80,78
1656305643976,CSE 30,B01,095061,Bhaskar; Nishant,0,1,50,50
1656305650001,CSE 100,A01,083659,Cao; Yingjun,1,18,70,69
1656305656027,CSE 134B,A01,083661,Powell; Thomas Allan,6,0,100,94
1656305662050,CSE 140,A01,083663,Gungor; Onat,9,0,85,76
1656305668074,CSE 140L,A01,083088,Eldon; John,10,0,100,90
1656305674101,CSE 175,A01,083665,Kumar; Rakesh,0,0,25,25
1656305680127,CSE 190,A00,092507,Dubnov; Shlomo,3,0,20,17
1656305686155,ECE 45,A01,083139,Congero; Spencer William,1,0,75,74
1656305692178,ECE 65,A50,083695,Saad; Andrew S,10,0,30,20
1656305692178,ECE 65,A51,095125,Staff,25,0,26,1
1656305698204,ECE 109,A01,091882,Touri; Behrouz,1,1,70,69
1656305704240,ECE 180,A00,083140,Abi Samra; Nicholas Camill,2,0,30,28
1656305704240,ECE 180,B00,083141,Abi Samra; Nicholas Camill,0,4,30,30
1656305710262,MATH 10A,A01,083735,Patchell; Gregory David,0,0,30,30
1656305710262,MATH 10A,A02,083736,Patchell; Gregory David,22,0,30,8
1656305710262,MATH 10A,A03,083737,Patchell; Gregory David,16,0,30,14
1656305716299,MATH 10B,A01,083207,Lim; Seonhee,2,0,34,32
1656305716299,MATH 10B,A02,083208,Lim; Seonhee,5,0,35,30
1656305716299,MATH 10B,A03,093472,Staff,1,0,34,33
1656305716299,MATH 10B,B01,083739,Sinha; Shubham,11,0,30,19
1656305722330,MATH 18,A01,083743,Cinel; Cameron Alexander,7,0,30,23
1656305722330,MATH 18,A02,083744,Cinel; Cameron Alexander,10,0,30,20
1656305722330,MATH 18,A03,083745,Cinel; Cameron Alexander,5,0,30,25
1656305722330,MATH 18,B01,083748,Rideout; David Porter,0,0,36,36
1656305722330,MATH 18,B02,083749,Rideout; David Porter,0,0,36,36
1656305722330,MATH 18,B03,083750,Rideout; David Porter,0,0,36,36
1656305722330,MATH 18,B04,083751,Rideout; David Porter,0,1,36,36
1656305722330,MATH 18,B05,093473,Rideout; David Porter,0,0,36,36
1656305722330,MATH 18,B06,093474,Rideout; David Porter,2,0,36,34
1656305728356,MATH 20A,A01,083754,Zheng; Zequn,11,0,40,29
1656305734384,MATH 20B,A01,083756,Briones; Jor-el Thomas Caparas,0,0,36,36
1656305734384,MATH 20B,A02,083757,Briones; Jor-el Thomas Caparas,0,0,36,36
1656305734384,MATH 20B,A03,093475,Staff,1,0,36,35
1656305740412,MATH 20C,A01,083760,Briones; Jor-el Thomas Caparas,0,0,35,35
1656305740412,MATH 20C,A02,083761,Briones; Jor-el Thomas Caparas,9,1,35,26
1656305740412,MATH 20C,A03,093476,Staff,0,0,35,35
1656305740412,MATH 20C,B01,083762,Bach; Quang Tran,2,0,30,28
1656305746440,MATH 20D,A01,083765,Tran; Brian Kha,1,0,30,29
1656305746440,MATH 20D,A02,083766,Tran; Brian Kha,1,1,30,29
1656305746440,MATH 20D,A03,083767,Tran; Brian Kha,2,0,30,28
1656305752473,MATH 20E,A01,083771,Ganguly; Soumya,2,0,32,30
1656305752473,MATH 20E,A02,083772,Ganguly; Soumya,0,0,32,32
1656305752473,MATH 20E,B01,083773,Ciotti; Benjamin,18,0,35,17
1656305752473,MATH 20E,B02,083774,Ciotti; Benjamin,15,0,35,20
1656305758496,MATH 103A,A01,083777,Greenfeld; Be'Eri,2,0,36,34
1656305758496,MATH 103A,A02,083778,Greenfeld; Be'Eri,3,0,36,33
1656305758496,MATH 103A,A03,093561,Staff,3,0,36,33
1656305758496,MATH 103A,B01,083779,Greenfeld; Be'Eri,8,0,36,28
1656305758496,MATH 103A,B02,083780,Greenfeld; Be'Eri,0,0,36,36
1656305758496,MATH 103A,B03,093562,Staff,1,0,36,35
1656305764520,MATH 105,A01,085443,Carter; Anne Toulson,4,0,35,31
1656305764520,MATH 105,A02,093477,Staff,14,0,35,21
1656305770547,MATH 109,A01,083213,Ganzberger; Geoffrey Michael,0,0,34,34
1656305770547,MATH 109,A02,083214,Ganzberger; Geoffrey Michael,0,0,34,34
1656305770547,MATH 109,A03,093478,Staff,2,0,34,32
1656305770547,MATH 109,B01,083215,Ganzberger; Geoffrey Michael,4,0,32,28
1656305770547,MATH 109,B02,083216,Ganzberger; Geoffrey Michael,1,0,32,31
1656305770547,MATH 109,B03,093479,Staff,3,0,32,29
1656305776570,MATH 142A,A01,083219,Chow; Bennett,1,0,32,31
1656305776570,MATH 142A,A02,083220,Chow; Bennett,8,0,32,24
1656305776570,MATH 142A,A03,093480,Staff,5,0,32,27
1656305776570,MATH 142A,B03,093481,Staff,3,0,32,29
1656305776570,MATH 142A,B04,093558,Staff,6,0,32,26
1656305776570,MATH 142A,B05,093559,Staff,0,0,32,32
1656305782598,MATH 193A,A01,083224,Rotar; Vladimir,0,1,34,34
1656305782598,MATH 193A,A02,083225,Rotar; Vladimir,0,0,34,34
1656305782598,MATH 193A,A03,083781,Rotar; Vladimir,0,0,34,34
1656305782598,MATH 193A,A04,083782,Rotar; Vladimir,5,0,34,29
1656305782598,MATH 193A,A05,093482,Rotar; Vladimir,0,0,34,34
1656305788622,MATH 197,001,091859,McAuley; Julian John,9999,0,9999,0
1656305788622,MATH 197,002,095566,Kedlaya; Kiran S.,9997,0,9999,2
1656305788622,MATH 197,003,095567,Xiao; Ming,9999,0,9999,0
1656305788622,MATH 197,004,095571,Perols; Johan Lars,9998,0,9999,1
1656305795685,COGS 9,A01,083615,Shannon; Kyle Michael,3,0,75,72
1656305801708,COGS 11,A01,083617,Boyle; Mary E. T.,16,0,48,32
1656305807732,COGS 13,A01,083071,Bastos; Amalia Pinkusfeld,5,0,71,66
1656305813754,COGS 14A,A01,092681,Semenuks; Arturs,1,13,100,99
1656305819776,COGS 14B,A01,083073,Cheng; Tzu-Han,7,0,63,56
1656305825805,COGS 17,A01,092677,Semenuks; Arturs,6,0,81,75
1656305831828,COGS 100,A01,083619,Allen; Michael Gordon,2,0,70,68
1656305837855,COGS 101A,A01,083621,Davis; Joshua Daniel,4,0,68,64
1656305843879,COGS 101B,A01,091572,Allen; Michael Gordon,4,0,65,61
1656305849902,COGS 101C,A01,083625,Delgado; Tania,11,0,35,24
1656305855932,COGS 107A,A01,083627,Boyle; Mary E. T.,2,0,60,58
1656305861957,COGS 118A,A01,083075,Gupta; Anjum,8,0,76,68
1656305867983,CSE 3,A50,083646,Miranda; Gregory Joseph,18,0,50,32
1656305874007,CSE 8A,A50,083650,Miranda; Gregory Joseph,3,3,56,53
1656305880031,CSE 11,A01,083080,Cao; Yingjun,0,48,40,40
1656305886058,CSE 12,A01,083652,Krause-Levy; Sophia Louisa,5,1,120,115
1656305892080,CSE 15L,A01,083654,Morris; Justin Loren,2,0,50,48
1656305892080,CSE 15L,A02,083655,Morris; Justin Loren,4,0,50,46
1656305898104,CSE 20,A01,083657,Tran; Khoa Dang,30,0,80,50
1656305904132,CSE 21,A01,095574,Bach; Quang Tran,23,0,48,25
1656305910156,CSE 30,A01,083084,Eldon; John,2,6,80,78
1656305910156,CSE 30,B01,095061,Bhaskar; Nishant,0,1,50,50
1656305916180,CSE 100,A01,083659,Cao; Yingjun,1,18,70,69
1656305922205,CSE 134B,A01,083661,Powell; Thomas Allan,6,0,100,94
1656305928233,CSE 140,A01,083663,Gungor; Onat,9,0,85,76
1656305934257,CSE 140L,A01,083088,Eldon; John,10,0,100,90
1656305940280,CSE 175,A01,083665,Kumar; Rakesh,0,0,25,25
1656305946306,CSE 190,A00,092507,Dubnov; Shlomo,3,0,20,17
1656305952337,ECE 45,A01,083139,Congero; Spencer William,1,0,75,74
1656305958360,ECE 65,A50,083695,Saad; Andrew S,10,0,30,20
1656305958360,ECE 65,A51,095125,Staff,25,0,26,1
1656305964391,ECE 109,A01,091882,Touri; Behrouz,1,1,70,69
1656305970417,ECE 180,A00,083140,Abi Samra; Nicholas Camill,2,0,30,28
1656305970417,ECE 180,B00,083141,Abi Samra; Nicholas Camill,0,4,30,30
1656305976446,MATH 10A,A01,083735,Patchell; Gregory David,0,0,30,30
1656305976446,MATH 10A,A02,083736,Patchell; Gregory David,22,0,30,8
1656305976446,MATH 10A,A03,083737,Patchell; Gregory David,16,0,30,14
1656305982482,MATH 10B,A01,083207,Lim; Seonhee,2,0,34,32
1656305982482,MATH 10B,A02,083208,Lim; Seonhee,5,0,35,30
1656305982482,MATH 10B,A03,093472,Staff,1,0,34,33
1656305982482,MATH 10B,B01,083739,Sinha; Shubham,11,0,30,19
1656305988508,MATH 18,A01,083743,Cinel; Cameron Alexander,7,0,30,23
1656305988508,MATH 18,A02,083744,Cinel; Cameron Alexander,10,0,30,20
1656305988508,MATH 18,A03,083745,Cinel; Cameron Alexander,5,0,30,25
1656305988508,MATH 18,B01,083748,Rideout; David Porter,0,0,36,36
1656305988508,MATH 18,B02,083749,Rideout; David Porter,0,0,36,36
1656305988508,MATH 18,B03,083750,Rideout; David Porter,0,0,36,36
1656305988508,MATH 18,B04,083751,Rideout; David Porter,0,1,36,36
1656305988508,MATH 18,B05,093473,Rideout; David Porter,0,0,36,36
1656305988508,MATH 18,B06,093474,Rideout; David Porter,2,0,36,34
1656305994535,MATH 20A,A01,083754,Zheng; Zequn,11,0,40,29
1656306000573,MATH 20B,A01,083756,Briones; Jor-el Thomas Caparas,0,0,36,36
1656306000573,MATH 20B,A02,083757,Briones; Jor-el Thomas Caparas,0,0,36,36
1656306000573,MATH 20B,A03,093475,Staff,1,0,36,35
1656306006600,MATH 20C,A01,083760,Briones; Jor-el Thomas Caparas,0,0,35,35
1656306006600,MATH 20C,A02,083761,Briones; Jor-el Thomas Caparas,9,1,35,26
1656306006600,MATH 20C,A03,093476,Staff,0,0,35,35
1656306006600,MATH 20C,B01,083762,Bach; Quang Tran,2,0,30,28
1656306012622,MATH 20D,A01,083765,Tran; Brian Kha,1,0,30,29
1656306012622,MATH 20D,A02,083766,Tran; Brian Kha,1,1,30,29
1656306012622,MATH 20D,A03,083767,Tran; Brian Kha,2,0,30,28
1656306018647,MATH 20E,A01,083771,Ganguly; Soumya,2,0,32,30
1656306018647,MATH 20E,A02,083772,Ganguly; Soumya,0,0,32,32
1656306018647,MATH 20E,B01,083773,Ciotti; Benjamin,18,0,35,17
1656306018647,MATH 20E,B02,083774,Ciotti; Benjamin,15,0,35,20
1656306024677,MATH 103A,A01,083777,Greenfeld; Be'Eri,2,0,36,34
1656306024677,MATH 103A,A02,083778,Greenfeld; Be'Eri,3,0,36,33
1656306024677,MATH 103A,A03,093561,Staff,3,0,36,33
1656306024677,MATH 103A,B01,083779,Greenfeld; Be'Eri,8,0,36,28
1656306024677,MATH 103A,B02,083780,Greenfeld; Be'Eri,0,0,36,36
1656306024677,MATH 103A,B03,093562,Staff,1,0,36,35
1656306030701,MATH 105,A01,085443,Carter; Anne Toulson,4,0,35,31
1656306030701,MATH 105,A02,093477,Staff,14,0,35,21
1656306036726,MATH 109,A01,083213,Ganzberger; Geoffrey Michael,0,0,34,34
1656306036726,MATH 109,A02,083214,Ganzberger; Geoffrey Michael,0,0,34,34
1656306036726,MATH 109,A03,093478,Staff,2,0,34,32
1656306036726,MATH 109,B01,083215,Ganzberger; Geoffrey Michael,4,0,32,28
1656306036726,MATH 109,B02,083216,Ganzberger; Geoffrey Michael,1,0,32,31
1656306036726,MATH 109,B03,093479,Staff,3,0,32,29
1656306042751,MATH 142A,A01,083219,Chow; Bennett,1,0,32,31
1656306042751,MATH 142A,A02,083220,Chow; Bennett,8,0,32,24
1656306042751,MATH 142A,A03,093480,Staff,5,0,32,27
1656306042751,MATH 142A,B03,093481,Staff,3,0,32,29
1656306042751,MATH 142A,B04,093558,Staff,6,0,32,26
1656306042751,MATH 142A,B05,093559,Staff,0,0,32,32
1656306048779,MATH 193A,A01,083224,Rotar; Vladimir,0,1,34,34
1656306048779,MATH 193A,A02,083225,Rotar; Vladimir,0,0,34,34
1656306048779,MATH 193A,A03,083781,Rotar; Vladimir,0,0,34,34
1656306048779,MATH 193A,A04,083782,Rotar; Vladimir,5,0,34,29
1656306048779,MATH 193A,A05,093482,Rotar; Vladimir,0,0,34,34
1656306054804,MATH 197,001,091859,McAuley; Julian John,9999,0,9999,0
1656306054804,MATH 197,002,095566,Kedlaya; Kiran S.,9997,0,9999,2
1656306054804,MATH 197,003,095567,Xiao; Ming,9999,0,9999,0
1656306054804,MATH 197,004,095571,Perols; Johan Lars,9998,0,9999,1
1656306061872,COGS 9,A01,083615,Shannon; Kyle Michael,3,0,75,72
1656306067899,COGS 11,A01,083617,Boyle; Mary E. T.,16,0,48,32
1656306073921,COGS 13,A01,083071,Bastos; Amalia Pinkusfeld,5,0,71,66
1656306080052,COGS 14A,A01,092681,Semenuks; Arturs,1,13,100,99
1656306086075,COGS 14B,A01,083073,Cheng; Tzu-Han,7,0,63,56
1656306092098,COGS 17,A01,092677,Semenuks; Arturs,6,0,81,75
1656306098123,COGS 100,A01,083619,Allen; Michael Gordon,2,0,70,68
1656306104147,COGS 101A,A01,083621,Davis; Joshua Daniel,4,0,68,64
1656306110177,COGS 101B,A01,091572,Allen; Michael Gordon,4,0,65,61
1656306116200,COGS 101C,A01,083625,Delgado; Tania,11,0,35,24
1656306122224,COGS 107A,A01,083627,Boyle; Mary E. T.,2,0,60,58
1656306128246,COGS 118A,A01,083075,Gupta; Anjum,8,0,76,68
1656306134268,CSE 3,A50,083646,Miranda; Gregory Joseph,18,0,50,32
1656306140291,CSE 8A,A50,083650,Miranda; Gregory Joseph,4,3,56,52
1656306146318,CSE 11,A01,083080,Cao; Yingjun,0,48,40,40
1656306152344,CSE 12,A01,083652,Krause-Levy; Sophia Louisa,5,1,120,115
1656306158366,CSE 15L,A01,083654,Morris; Justin Loren,2,0,50,48
1656306158366,CSE 15L,A02,083655,Morris; Justin Loren,4,0,50,46
1656306164390,CSE 20,A01,083657,Tran; Khoa Dang,30,0,80,50
1656306170412,CSE 21,A01,095574,Bach; Quang Tran,23,0,48,25
1656306176436,CSE 30,A01,083084,Eldon; John,2,6,80,78
1656306176436,CSE 30,B01,095061,Bhaskar; Nishant,0,1,50,50
1656306182461,CSE 100,A01,083659,Cao; Yingjun,1,18,70,69
1656306188485,CSE 134B,A01,083661,Powell; Thomas Allan,6,0,100,94
1656306194514,CSE 140,A01,083663,Gungor; Onat,9,0,85,76
1656306200541,CSE 140L,A01,083088,Eldon; John,10,0,100,90
1656306206566,CSE 175,A01,083665,Kumar; Rakesh,0,0,25,25
1656306212592,CSE 190,A00,092507,Dubnov; Shlomo,3,0,20,17
1656306218618,ECE 45,A01,083139,Congero; Spencer William,1,0,75,74
1656306224640,ECE 65,A50,083695,Saad; Andrew S,10,0,30,20
1656306224640,ECE 65,A51,095125,Staff,25,0,26,1
1656306230665,ECE 109,A01,091882,Touri; Behrouz,1,1,70,69
1656306236688,ECE 180,A00,083140,Abi Samra; Nicholas Camill,2,0,30,28
1656306236688,ECE 180,B00,083141,Abi Samra; Nicholas Camill,0,4,30,30
1656306242716,MATH 10A,A01,083735,Patchell; Gregory David,0,0,30,30
1656306242716,MATH 10A,A02,083736,Patchell; Gregory David,22,0,30,8
1656306242716,MATH 10A,A03,083737,Patchell; Gregory David,16,0,30,14
1656306248749,MATH 10B,A01,083207,Lim; Seonhee,2,0,34,32
1656306248749,MATH 10B,A02,083208,Lim; Seonhee,5,0,35,30
1656306248749,MATH 10B,A03,093472,Staff,1,0,34,33
1656306248749,MATH 10B,B01,083739,Sinha; Shubham,11,0,30,19
1656306254775,MATH 18,A01,083743,Cinel; Cameron Alexander,7,0,30,23
1656306254775,MATH 18,A02,083744,Cinel; Cameron Alexander,10,0,30,20
1656306254775,MATH 18,A03,083745,Cinel; Cameron Alexander,5,0,30,25
1656306254775,MATH 18,B01,083748,Rideout; David Porter,0,0,36,36
1656306254775,MATH 18,B02,083749,Rideout; David Porter,0,0,36,36
1656306254775,MATH 18,B03,083750,Rideout; David Porter,0,0,36,36
1656306254775,MATH 18,B04,083751,Rideout; David Porter,0,1,36,36
1656306254775,MATH 18,B05,093473,Rideout; David Porter,0,0,36,36
1656306254775,MATH 18,B06,093474,Rideout; David Porter,2,0,36,34
1656306260803,MATH 20A,A01,083754,Zheng; Zequn,11,0,40,29
1656306266829,MATH 20B,A01,083756,Briones; Jor-el Thomas Caparas,0,0,36,36
1656306266829,MATH 20B,A02,083757,Briones; Jor-el Thomas Caparas,0,0,36,36
1656306266829,MATH 20B,A03,093475,Staff,1,0,36,35
1656306272858,MATH 20C,A01,083760,Briones; Jor-el Thomas Caparas,0,0,35,35
1656306272858,MATH 20C,A02,083761,Briones; Jor-el Thomas Caparas,9,1,35,26
1656306272858,MATH 20C,A03,093476,Staff,0,0,35,35
1656306272858,MATH 20C,B01,083762,Bach; Quang Tran,2,0,30,28
1656306278888,MATH 20D,A01,083765,Tran; Brian Kha,1,0,30,29
1656306278888,MATH 20D,A02,083766,Tran; Brian Kha,1,1,30,29
1656306278888,MATH 20D,A03,083767,Tran; Brian Kha,2,0,30,28
1656306284916,MATH 20E,A01,083771,Ganguly; Soumya,2,0,32,30
1656306284916,MATH 20E,A02,083772,Ganguly; Soumya,0,0,32,32
1656306284916,MATH 20E,B01,083773,Ciotti; Benjamin,18,0,35,17
1656306284916,MATH 20E,B02,083774,Ciotti; Benjamin,15,0,35,20
1656306290941,MATH 103A,A01,083777,Greenfeld; Be'Eri,2,0,36,34
1656306290941,MATH 103A,A02,083778,Greenfeld; Be'Eri,3,0,36,33
1656306290941,MATH 103A,A03,093561,Staff,3,0,36,33
1656306290941,MATH 103A,B01,083779,Greenfeld; Be'Eri,8,0,36,28
1656306290941,MATH 103A,B02,083780,Greenfeld; Be'Eri,0,0,36,36
1656306290941,MATH 103A,B03,093562,Staff,1,0,36,35
1656306296969,MATH 105,A01,085443,Carter; Anne Toulson,4,0,35,31
1656306296969,MATH 105,A02,093477,Staff,14,0,35,21
1656306302994,MATH 109,A01,083213,Ganzberger; Geoffrey Michael,0,0,34,34
1656306302994,MATH 109,A02,083214,Ganzberger; Geoffrey Michael,0,0,34,34
1656306302994,MATH 109,A03,093478,Staff,2,0,34,32
1656306302994,MATH 109,B01,083215,Ganzberger; Geoffrey Michael,4,0,32,28
1656306302994,MATH 109,B02,083216,Ganzberger; Geoffrey Michael,1,0,32,31
1656306302994,MATH 109,B03,093479,Staff,3,0,32,29
1656306309018,MATH 142A,A01,083219,Chow; Bennett,1,0,32,31
1656306309018,MATH 142A,A02,083220,Chow; Bennett,8,0,32,24
1656306309018,MATH 142A,A03,093480,Staff,5,0,32,27
1656306309018,MATH 142A,B03,093481,Staff,3,0,32,29
1656306309018,MATH 142A,B04,093558,Staff,6,0,32,26
1656306309018,MATH 142A,B05,093559,Staff,0,0,32,32
1656306315045,MATH 193A,A01,083224,Rotar; Vladimir,0,1,34,34
1656306315045,MATH 193A,A02,083225,Rotar; Vladimir,0,0,34,34
1656306315045,MATH 193A,A03,083781,Rotar; Vladimir,0,0,34,34
1656306315045,MATH 193A,A04,083782,Rotar; Vladimir,5,0,34,29
1656306315045,MATH 193A,A05,093482,Rotar; Vladimir,0,0,34,34
1656306321082,MATH 197,001,091859,McAuley; Julian John,9999,0,9999,0
1656306321082,MATH 197,002,095566,Kedlaya; Kiran S.,9997,0,9999,2
1656306321082,MATH 197,003,095567,Xiao; Ming,9999,0,9999,0
1656306321082,MATH 197,004,095571,Perols; Johan Lars,9998,0,9999,1
1656306328137,COGS 9,A01,083615,Shannon; Kyle Michael,3,0,75,72
1656306334167,COGS 11,A01,083617,Boyle; Mary E. T.,16,0,48,32
1656306340191,COGS 13,A01,083071,Bastos; Amalia Pinkusfeld,5,0,71,66
1656306346216,COGS 14A,A01,092681,Semenuks; Arturs,1,13,100,99
1656306352246,COGS 14B,A01,083073,Cheng; Tzu-Han,7,0,63,56
1656306358274,COGS 17,A01,092677,Semenuks; Arturs,6,0,81,75
1656306364300,COGS 100,A01,083619,Allen; Michael Gordon,2,0,70,68
1656306370330,COGS 101A,A01,083621,Davis; Joshua Daniel,4,0,68,64
1656306376352,COGS 101B,A01,091572,Allen; Michael Gordon,4,0,65,61
1656306382378,COGS 101C,A01,083625,Delgado; Tania,11,0,35,24
1656306388403,COGS 107A,A01,083627,Boyle; Mary E. T.,2,0,60,58
1656306394443,COGS 118A,A01,083075,Gupta; Anjum,8,0,76,68
1656306400465,CSE 3,A50,083646,Miranda; Gregory Joseph,18,0,50,32
1656306406492,CSE 8A,A50,083650,Miranda; Gregory Joseph,4,3,56,52
1656306412515,CSE 11,A01,083080,Cao; Yingjun,0,48,40,40
1656306418537,CSE 12,A01,083652,Krause-Levy; Sophia Louisa,5,1,120,115
1656306424561,CSE 15L,A01,083654,Morris; Justin Loren,2,0,50,48
1656306424561,CSE 15L,A02,083655,Morris; Justin Loren,4,0,50,46
1656306430585,CSE 20,A01,083657,Tran; Khoa Dang,30,0,80,50
1656306436608,CSE 21,A01,095574,Bach; Quang Tran,23,0,48,25
1656306442632,CSE 30,A01,083084,Eldon; John,2,6,80,78
1656306442632,CSE 30,B01,095061,Bhaskar; Nishant,0,1,50,50
1656306448658,CSE 100,A01,083659,Cao; Yingjun,1,18,70,69
1656306454681,CSE 134B,A01,083661,Powell; Thomas Allan,6,0,100,94
1656306460709,CSE 140,A01,083663,Gungor; Onat,9,0,85,76
1656306466734,CSE 140L,A01,083088,Eldon; John,10,0,100,90
1656306472765,CSE 175,A01,083665,Kumar; Rakesh,0,0,25,25
1656306478790,CSE 190,A00,092507,Dubnov; Shlomo,3,0,20,17
1656306484816,ECE 45,A01,083139,Congero; Spencer William,1,0,75,74
1656306490839,ECE 65,A50,083695,Saad; Andrew S,10,0,30,20
1656306490839,ECE 65,A51,095125,Staff,25,0,26,1
1656306496864,ECE 109,A01,091882,Touri; Behrouz,1,1,70,69
1656306502889,ECE 180,A00,083140,Abi Samra; Nicholas Camill,2,0,30,28
1656306502889,ECE 180,B00,083141,Abi Samra; Nicholas Camill,0,4,30,30
1656306508927,MATH 10A,A01,083735,Patchell; Gregory David,0,0,30,30
1656306508927,MATH 10A,A02,083736,Patchell; Gregory David,22,0,30,8
1656306508927,MATH 10A,A03,083737,Patchell; Gregory David,16,0,30,14
1656306514959,MATH 10B,A01,083207,Lim; Seonhee,2,0,34,32
1656306514959,MATH 10B,A02,083208,Lim; Seonhee,5,0,35,30
1656306514959,MATH 10B,A03,093472,Staff,1,0,34,33
1656306514959,MATH 10B,B01,083739,Sinha; Shubham,11,0,30,19
1656306520992,MATH 18,A01,083743,Cinel; Cameron Alexander,7,0,30,23
1656306520992,MATH 18,A02,083744,Cinel; Cameron Alexander,10,0,30,20
1656306520992,MATH 18,A03,083745,Cinel; Cameron Alexander,5,0,30,25
1656306520992,MATH 18,B01,083748,Rideout; David Porter,0,0,36,36
1656306520992,MATH 18,B02,083749,Rideout; David Porter,0,0,36,36
1656306520992,MATH 18,B03,083750,Rideout; David Porter,0,0,36,36
1656306520992,MATH 18,B04,083751,Rideout; David Porter,0,1,36,36
1656306520992,MATH 18,B05,093473,Rideout; David Porter,0,0,36,36
1656306520992,MATH 18,B06,093474,Rideout; David Porter,2,0,36,34
1656306527015,MATH 20A,A01,083754,Zheng; Zequn,11,0,40,29
1656306533044,MATH 20B,A01,083756,Briones; Jor-el Thomas Caparas,0,0,36,36
1656306533044,MATH 20B,A02,083757,Briones; Jor-el Thomas Caparas,0,0,36,36
1656306533044,MATH 20B,A03,093475,Staff,1,0,36,35
1656306539069,MATH 20C,A01,083760,Briones; Jor-el Thomas Caparas,0,0,35,35
1656306539069,MATH 20C,A02,083761,Briones; Jor-el Thomas Caparas,9,1,35,26
1656306539069,MATH 20C,A03,093476,Staff,0,0,35,35
1656306539069,MATH 20C,B01,083762,Bach; Quang Tran,2,0,30,28
1656306545093,MATH 20D,A01,083765,Tran; Brian Kha,1,0,30,29
1656306545093,MATH 20D,A02,083766,Tran; Brian Kha,1,1,30,29
1656306545093,MATH 20D,A03,083767,Tran; Brian Kha,2,0,30,28
1656306551117,MATH 20E,A01,083771,Ganguly; Soumya,2,0,32,30
1656306551117,MATH 20E,A02,083772,Ganguly; Soumya,0,0,32,32
1656306551117,MATH 20E,B01,083773,Ciotti; Benjamin,18,0,35,17
1656306551117,MATH 20E,B02,083774,Ciotti; Benjamin,15,0,35,20
1656306557151,MATH 103A,A01,083777,Greenfeld; Be'Eri,2,0,36,34
1656306557151,MATH 103A,A02,083778,Greenfeld; Be'Eri,3,0,36,33
1656306557151,MATH 103A,A03,093561,Staff,3,0,36,33
1656306557151,MATH 103A,B01,083779,Greenfeld; Be'Eri,8,0,36,28
1656306557151,MATH 103A,B02,083780,Greenfeld; Be'Eri,0,0,36,36
1656306557151,MATH 103A,B03,093562,Staff,1,0,36,35
1656306563184,MATH 105,A01,085443,Carter; Anne Toulson,4,0,35,31
1656306563184,MATH 105,A02,093477,Staff,14,0,35,21
1656306569213,MATH 109,A01,083213,Ganzberger; Geoffrey Michael,0,0,34,34
1656306569213,MATH 109,A02,083214,Ganzberger; Geoffrey Michael,0,0,34,34
1656306569213,MATH 109,A03,093478,Staff,2,0,34,32
1656306569213,MATH 109,B01,083215,Ganzberger; Geoffrey Michael,4,0,32,28
1656306569213,MATH 109,B02,083216,Ganzberger; Geoffrey Michael,1,0,32,31
1656306569213,MATH 109,B03,093479,Staff,3,0,32,29
1656306575245,MATH 142A,A01,083219,Chow; Bennett,1,0,32,31
1656306575245,MATH 142A,A02,083220,Chow; Bennett,8,0,32,24
1656306575245,MATH 142A,A03,093480,Staff,5,0,32,27
1656306575245,MATH 142A,B03,093481,Staff,3,0,32,29
1656306575245,MATH 142A,B04,093558,Staff,6,0,32,26
1656306575245,MATH 142A,B05,093559,Staff,0,0,32,32
1656306581269,MATH 193A,A01,083224,Rotar; Vladimir,0,1,34,34
1656306581269,MATH 193A,A02,083225,Rotar; Vladimir,0,0,34,34
1656306581269,MATH 193A,A03,083781,Rotar; Vladimir,0,0,34,34
1656306581269,MATH 193A,A04,083782,Rotar; Vladimir,5,0,34,29
1656306581269,MATH 193A,A05,093482,Rotar; Vladimir,0,0,34,34
1656306587291,MATH 197,001,091859,McAuley; Julian John,9999,0,9999,0
1656306587291,MATH 197,002,095566,Kedlaya; Kiran S.,9997,0,9999,2
1656306587291,MATH 197,003,095567,Xiao; Ming,9999,0,9999,0
1656306587291,MATH 197,004,095571,Perols; Johan Lars,9998,0,9999,1
1656306594347,COGS 9,A01,083615,Shannon; Kyle Michael,3,0,75,72
1656306600380,COGS 11,A01,083617,Boyle; Mary E. T.,16,0,48,32
1656306606408,COGS 13,A01,083071,Bastos; Amalia Pinkusfeld,5,0,71,66
1656306612432,COGS 14A,A01,092681,Semenuks; Arturs,1,13,100,99
1656306618459,COGS 14B,A01,083073,Cheng; Tzu-Han,7,0,63,56
1656306624486,COGS 17,A01,092677,Semenuks; Arturs,6,0,81,75
1656306630512,COGS 100,A01,083619,Allen; Michael Gordon,2,0,70,68
1656306636534,COGS 101A,A01,083621,Davis; Joshua Daniel,4,0,68,64
1656306642559,COGS 101B,A01,091572,Allen; Michael Gordon,4,0,65,61
1656306648584,COGS 101C,A01,083625,Delgado; Tania,11,0,35,24
1656306654607,COGS 107A,A01,083627,Boyle; Mary E. T.,2,0,60,58
1656306660636,COGS 118A,A01,083075,Gupta; Anjum,8,0,76,68
1656306666665,CSE 3,A50,083646,Miranda; Gregory Joseph,18,0,50,32
1656306672689,CSE 8A,A50,083650,Miranda; Gregory Joseph,4,3,56,52
1656306678794,CSE 11,A01,083080,Cao; Yingjun,0,48,40,40
1656306684820,CSE 12,A01,083652,Krause-Levy; Sophia Louisa,5,1,120,115
1656306690844,CSE 15L,A01,083654,Morris; Justin Loren,2,0,50,48
1656306690844,CSE 15L,A02,083655,Morris; Justin Loren,4,0,50,46
1656306696872,CSE 20,A01,083657,Tran; Khoa Dang,30,0,80,50
1656306702897,CSE 21,A01,095574,Bach; Quang Tran,23,0,48,25
1656306708922,CSE 30,A01,083084,Eldon; John,2,6,80,78
1656306708922,CSE 30,B01,095061,Bhaskar; Nishant,0,1,50,50
1656306714948,CSE 100,A01,083659,Cao; Yingjun,1,18,70,69
1656306720976,CSE 134B,A01,083661,Powell; Thomas Allan,6,0,100,94
1656306727001,CSE 140,A01,083663,Gungor; Onat,9,0,85,76
1656306733029,CSE 140L,A01,083088,Eldon; John,10,0,100,90
1656306739054,CSE 175,A01,083665,Kumar; Rakesh,0,0,25,25
1656306745078,CSE 190,A00,092507,Dubnov; Shlomo,3,0,20,17
1656306751101,ECE 45,A01,083139,Congero; Spencer William,1,0,75,74
1656306757125,ECE 65,A50,083695,Saad; Andrew S,10,0,30,20
1656306757125,ECE 65,A51,095125,Staff,25,0,26,1
1656306763147,ECE 109,A01,091882,Touri; Behrouz,1,1,70,69
1656306769172,ECE 180,A00,083140,Abi Samra; Nicholas Camill,2,0,30,28
1656306769172,ECE 180,B00,083141,Abi Samra; Nicholas Camill,0,4,30,30
1656306775200,MATH 10A,A01,083735,Patchell; Gregory David,0,0,30,30
1656306775200,MATH 10A,A02,083736,Patchell; Gregory David,22,0,30,8
1656306775200,MATH 10A,A03,083737,Patchell; Gregory David,16,0,30,14
1656306781241,MATH 10B,A01,083207,Lim; Seonhee,2,0,34,32
1656306781241,MATH 10B,A02,083208,Lim; Seonhee,5,0,35,30
1656306781241,MATH 10B,A03,093472,Staff,1,0,34,33
1656306781241,MATH 10B,B01,083739,Sinha; Shubham,11,0,30,19
1656306787265,MATH 18,A01,083743,Cinel; Cameron Alexander,7,0,30,23
1656306787265,MATH 18,A02,083744,Cinel; Cameron Alexander,10,0,30,20
1656306787265,MATH 18,A03,083745,Cinel; Cameron Alexander,5,0,30,25
1656306787265,MATH 18,B01,083748,Rideout; David Porter,0,0,36,36
1656306787265,MATH 18,B02,083749,Rideout; David Porter,0,0,36,36
1656306787265,MATH 18,B03,083750,Rideout; David Porter,0,0,36,36
1656306787265,MATH 18,B04,083751,Rideout; David Porter,0,1,36,36
1656306787265,MATH 18,B05,093473,Rideout; David Porter,0,0,36,36
1656306787265,MATH 18,B06,093474,Rideout; David Porter,2,0,36,34
1656306793289,MATH 20A,A01,083754,Zheng; Zequn,11,0,40,29
1656306799319,MATH 20B,A01,083756,Briones; Jor-el Thomas Caparas,0,0,36,36
1656306799319,MATH 20B,A02,083757,Briones; Jor-el Thomas Caparas,0,0,36,36
1656306799319,MATH 20B,A03,093475,Staff,1,0,36,35
1656306805348,MATH 20C,A01,083760,Briones; Jor-el Thomas Caparas,0,0,35,35
1656306805348,MATH 20C,A02,083761,Briones; Jor-el Thomas Caparas,9,1,35,26
1656306805348,MATH 20C,A03,093476,Staff,0,0,35,35
1656306805348,MATH 20C,B01,083762,Bach; Quang Tran,2,0,30,28
1656306811372,MATH 20D,A01,083765,Tran; Brian Kha,1,0,30,29
1656306811372,MATH 20D,A02,083766,Tran; Brian Kha,1,1,30,29
1656306811372,MATH 20D,A03,083767,Tran; Brian Kha,2,0,30,28
1656306817394,MATH 20E,A01,083771,Ganguly; Soumya,2,0,32,30
1656306817394,MATH 20E,A02,083772,Ganguly; Soumya,0,0,32,32
1656306817394,MATH 20E,B01,083773,Ciotti; Benjamin,18,0,35,17
1656306817394,MATH 20E,B02,083774,Ciotti; Benjamin,15,0,35,20
1656306823419,MATH 103A,A01,083777,Greenfeld; Be'Eri,2,0,36,34
1656306823419,MATH 103A,A02,083778,Greenfeld; Be'Eri,3,0,36,33
1656306823419,MATH 103A,A03,093561,Staff,3,0,36,33
1656306823419,MATH 103A,B01,083779,Greenfeld; Be'Eri,8,0,36,28
1656306823419,MATH 103A,B02,083780,Greenfeld; Be'Eri,0,0,36,36
1656306823419,MATH 103A,B03,093562,Staff,1,0,36,35
1656306829442,MATH 105,A01,085443,Carter; Anne Toulson,4,0,35,31
1656306829442,MATH 105,A02,093477,Staff,14,0,35,21
1656306835468,MATH 109,A01,083213,Ganzberger; Geoffrey Michael,0,0,34,34
1656306835468,MATH 109,A02,083214,Ganzberger; Geoffrey Michael,0,0,34,34
1656306835468,MATH 109,A03,093478,Staff,2,0,34,32
1656306835468,MATH 109,B01,083215,Ganzberger; Geoffrey Michael,4,0,32,28
1656306835468,MATH 109,B02,083216,Ganzberger; Geoffrey Michael,1,0,32,31
1656306835468,MATH 109,B03,093479,Staff,3,0,32,29
1656306841498,MATH 142A,A01,083219,Chow; Bennett,1,0,32,31
1656306841498,MATH 142A,A02,083220,Chow; Bennett,8,0,32,24
1656306841498,MATH 142A,A03,093480,Staff,5,0,32,27
1656306841498,MATH 142A,B03,093481,Staff,3,0,32,29
1656306841498,MATH 142A,B04,093558,Staff,6,0,32,26
1656306841498,MATH 142A,B05,093559,Staff,0,0,32,32
1656306847524,MATH 193A,A01,083224,Rotar; Vladimir,0,1,34,34
1656306847524,MATH 193A,A02,083225,Rotar; Vladimir,0,0,34,34
1656306847524,MATH 193A,A03,083781,Rotar; Vladimir,0,0,34,34
1656306847524,MATH 193A,A04,083782,Rotar; Vladimir,5,0,34,29
1656306847524,MATH 193A,A05,093482,Rotar; Vladimir,0,0,34,34
1656306853547,MATH 197,001,091859,McAuley; Julian John,9999,0,9999,0
1656306853547,MATH 197,002,095566,Kedlaya; Kiran S.,9997,0,9999,2
1656306853547,MATH 197,003,095567,Xiao; Ming,9999,0,9999,0
1656306853547,MATH 197,004,095571,Perols; Johan Lars,9998,0,9999,1
1656306860638,COGS 9,A01,083615,Shannon; Kyle Michael,3,0,75,72
1656306866661,COGS 11,A01,083617,Boyle; Mary E. T.,16,0,48,32
1656306872685,COGS 13,A01,083071,Bastos; Amalia Pinkusfeld,5,0,71,66
1656306878710,COGS 14A,A01,092681,Semenuks; Arturs,1,13,100,99
1656306884733,COGS 14B,A01,083073,Cheng; Tzu-Han,7,0,63,56
1656306890765,COGS 17,A01,092677,Semenuks; Arturs,6,0,81,75
1656306896788,COGS 100,A01,083619,Allen; Michael Gordon,2,0,70,68
1656306902815,COGS 101A,A01,083621,Davis; Joshua Daniel,4,0,68,64
1656306908837,COGS 101B,A01,091572,Allen; Michael Gordon,4,0,65,61
1656306914861,COGS 101C,A01,083625,Delgado; Tania,11,0,35,24
1656306920887,COGS 107A,A01,083627,Boyle; Mary E. T.,2,0,60,58
1656306926910,COGS 118A,A01,083075,Gupta; Anjum,8,0,76,68
1656306932955,CSE 3,A50,083646,Miranda; Gregory Joseph,18,0,50,32
1656306938979,CSE 8A,A50,083650,Miranda; Gregory Joseph,4,3,56,52
1656306945003,CSE 11,A01,083080,Cao; Yingjun,0,48,40,40
1656306951038,CSE 12,A01,083652,Krause-Levy; Sophia Louisa,5,1,120,115
1656306957062,CSE 15L,A01,083654,Morris; Justin Loren,2,0,50,48
1656306957062,CSE 15L,A02,083655,Morris; Justin Loren,4,0,50,46
1656306963089,CSE 20,A01,083657,Tran; Khoa Dang,30,0,80,50
1656306969112,CSE 21,A01,095574,Bach; Quang Tran,23,0,48,25
1656306975140,CSE 30,A01,083084,Eldon; John,2,6,80,78
1656306975140,CSE 30,B01,095061,Bhaskar; Nishant,0,1,50,50
1656306981163,CSE 100,A01,083659,Cao; Yingjun,1,18,70,69
1656306987191,CSE 134B,A01,083661,Powell; Thomas Allan,6,0,100,94
1656306993217,CSE 140,A01,083663,Gungor; Onat,9,0,85,76
1656306999243,CSE 140L,A01,083088,Eldon; John,10,0,100,90
1656307005266,CSE 175,A01,083665,Kumar; Rakesh,0,0,25,25
1656307011290,CSE 190,A00,092507,Dubnov; Shlomo,3,0,20,17
1656307017314,ECE 45,A01,083139,Congero; Spencer William,1,0,75,74
1656307023339,ECE 65,A50,083695,Saad; Andrew S,10,0,30,20
1656307023339,ECE 65,A51,095125,Staff,25,0,26,1
1656307029367,ECE 109,A01,091882,Touri; Behrouz,1,1,70,69
1656307035395,ECE 180,A00,083140,Abi Samra; Nicholas Camill,2,0,30,28
1656307035395,ECE 180,B00,083141,Abi Samra; Nicholas Camill,0,4,30,30
1656307041422,MATH 10A,A01,083735,Patchell; Gregory David,0,0,30,30
1656307041422,MATH 10A,A02,083736,Patchell; Gregory David,22,0,30,8
1656307041422,MATH 10A,A03,083737,Patchell; Gregory David,16,0,30,14
1656307047446,MATH 10B,A01,083207,Lim; Seonhee,2,0,34,32
1656307047446,MATH 10B,A02,083208,Lim; Seonhee,5,0,35,30
1656307047446,MATH 10B,A03,093472,Staff,1,0,34,33
1656307047446,MATH 10B,B01,083739,Sinha; Shubham,11,0,30,19
1656307053472,MATH 18,A01,083743,Cinel; Cameron Alexander,7,0,30,23
1656307053472,MATH 18,A02,083744,Cinel; Cameron Alexander,10,0,30,20
1656307053472,MATH 18,A03,083745,Cinel; Cameron Alexander,5,0,30,25
1656307053472,MATH 18,B01,083748,Rideout; David Porter,0,0,36,36
1656307053472,MATH 18,B02,083749,Rideout; David Porter,0,0,36,36
1656307053472,MATH 18,B03,083750,Rideout; David Porter,0,0,36,36
1656307053472,MATH 18,B04,083751,Rideout; David Porter,0,1,36,36
1656307053472,MATH 18,B05,093473,Rideout; David Porter,0,0,36,36
1656307053472,MATH 18,B06,093474,Rideout; David Porter,2,0,36,34
1656307059494,MATH 20A,A01,083754,Zheng; Zequn,11,0,40,29
1656307065521,MATH 20B,A01,083756,Briones; Jor-el Thomas Caparas,0,0,36,36
1656307065521,MATH 20B,A02,083757,Briones; Jor-el Thomas Caparas,0,0,36,36
1656307065521,MATH 20B,A03,093475,Staff,1,0,36,35
1656307071551,MATH 20C,A01,083760,Briones; Jor-el Thomas Caparas,0,0,35,35
1656307071551,MATH 20C,A02,083761,Briones; Jor-el Thomas Caparas,9,1,35,26
1656307071551,MATH 20C,A03,093476,Staff,0,0,35,35
1656307071551,MATH 20C,B01,083762,Bach; Quang Tran,2,0,30,28
1656307077577,MATH 20D,A01,083765,Tran; Brian Kha,1,0,30,29
1656307077577,MATH 20D,A02,083766,Tran; Brian Kha,1,1,30,29
1656307077577,MATH 20D,A03,083767,Tran; Brian Kha,2,0,30,28
1656307083600,MATH 20E,A01,083771,Ganguly; Soumya,2,0,32,30
1656307083600,MATH 20E,A02,083772,Ganguly; Soumya,0,0,32,32
1656307083600,MATH 20E,B01,083773,Ciotti; Benjamin,18,0,35,17
1656307083600,MATH 20E,B02,083774,Ciotti; Benjamin,15,0,35,20
1656307089630,MATH 103A,A01,083777,Greenfeld; Be'Eri,2,0,36,34
1656307089630,MATH 103A,A02,083778,Greenfeld; Be'Eri,3,0,36,33
1656307089630,MATH 103A,A03,093561,Staff,3,0,36,33
1656307089630,MATH 103A,B01,083779,Greenfeld; Be'Eri,8,0,36,28
1656307089630,MATH 103A,B02,083780,Greenfeld; Be'Eri,0,0,36,36
1656307089630,MATH 103A,B03,093562,Staff,1,0,36,35
1656307095662,MATH 105,A01,085443,Carter; Anne Toulson,4,0,35,31
1656307095662,MATH 105,A02,093477,Staff,14,0,35,21
1656307101691,MATH 109,A01,083213,Ganzberger; Geoffrey Michael,0,0,34,34
1656307101691,MATH 109,A02,083214,Ganzberger; Geoffrey Michael,0,0,34,34
1656307101691,MATH 109,A03,093478,Staff,2,0,34,32
1656307101691,MATH 109,B01,083215,Ganzberger; Geoffrey Michael,4,0,32,28
1656307101691,MATH 109,B02,083216,Ganzberger; Geoffrey Michael,1,0,32,31
1656307101691,MATH 109,B03,093479,Staff,3,0,32,29
1656307107720,MATH 142A,A01,083219,Chow; Bennett,1,0,32,31
1656307107720,MATH 142A,A02,083220,Chow; Bennett,8,0,32,24
1656307107720,MATH 142A,A03,093480,Staff,5,0,32,27
1656307107720,MATH 142A,B03,093481,Staff,3,0,32,29
1656307107720,MATH 142A,B04,093558,Staff,6,0,32,26
1656307107720,MATH 142A,B05,093559,Staff,0,0,32,32
1656307113744,MATH 193A,A01,083224,Rotar; Vladimir,0,1,34,34
1656307113744,MATH 193A,A02,083225,Rotar; Vladimir,0,0,34,34
1656307113744,MATH 193A,A03,083781,Rotar; Vladimir,0,0,34,34
1656307113744,MATH 193A,A04,083782,Rotar; Vladimir,5,0,34,29
1656307113744,MATH 193A,A05,093482,Rotar; Vladimir,0,0,34,34
1656307119770,MATH 197,001,091859,McAuley; Julian John,9999,0,9999,0
1656307119770,MATH 197,002,095566,Kedlaya; Kiran S.,9997,0,9999,2
1656307119770,MATH 197,003,095567,Xiao; Ming,9999,0,9999,0
1656307119770,MATH 197,004,095571,Perols; Johan Lars,9998,0,9999,1
1656307126835,COGS 9,A01,083615,Shannon; Kyle Michael,3,0,75,72
1656307132858,COGS 11,A01,083617,Boyle; Mary E. T.,16,0,48,32
1656307138882,COGS 13,A01,083071,Bastos; Amalia Pinkusfeld,5,0,71,66
1656307144904,COGS 14A,A01,092681,Semenuks; Arturs,1,13,100,99
1656307150930,COGS 14B,A01,083073,Cheng; Tzu-Han,7,0,63,56
1656307156954,COGS 17,A01,092677,Semenuks; Arturs,6,0,81,75
1656307162979,COGS 100,A01,083619,Allen; Michael Gordon,2,0,70,68
1656307169003,COGS 101A,A01,083621,Davis; Joshua Daniel,4,0,68,64
1656307175029,COGS 101B,A01,091572,Allen; Michael Gordon,4,0,65,61
1656307181054,COGS 101C,A01,083625,Delgado; Tania,11,0,35,24
1656307187078,COGS 107A,A01,083627,Boyle; Mary E. T.,2,0,60,58
1656307193102,COGS 118A,A01,083075,Gupta; Anjum,8,0,76,68
1656307199125,CSE 3,A50,083646,Miranda; Gregory Joseph,18,0,50,32
1656307205156,CSE 8A,A50,083650,Miranda; Gregory Joseph,4,3,56,52
1656307211178,CSE 11,A01,083080,Cao; Yingjun,0,48,40,40
1656307217201,CSE 12,A01,083652,Krause-Levy; Sophia Louisa,5,1,120,115
1656307223239,CSE 15L,A01,083654,Morris; Justin Loren,2,0,50,48
1656307223239,CSE 15L,A02,083655,Morris; Justin Loren,4,0,50,46
1656307229266,CSE 20,A01,083657,Tran; Khoa Dang,30,0,80,50
1656307235292,CSE 21,A01,095574,Bach; Quang Tran,23,0,48,25
1656307241316,CSE 30,A01,083084,Eldon; John,2,6,80,78
1656307241316,CSE 30,B01,095061,Bhaskar; Nishant,0,1,50,50
1656307247340,CSE 100,A01,083659,Cao; Yingjun,1,19,70,69
1656307253363,CSE 134B,A01,083661,Powell; Thomas Allan,6,0,100,94
1656307259393,CSE 140,A01,083663,Gungor; Onat,9,0,85,76
1656307265417,CSE 140L,A01,083088,Eldon; John,10,0,100,90
1656307271448,CSE 175,A01,083665,Kumar; Rakesh,0,0,25,25
1656307277560,CSE 190,A00,092507,Dubnov; Shlomo,3,0,20,17
1656307283584,ECE 45,A01,083139,Congero; Spencer William,1,0,75,74
1656307289611,ECE 65,A50,083695,Saad; Andrew S,10,0,30,20
1656307289611,ECE 65,A51,095125,Staff,25,0,26,1
1656307295637,ECE 109,A01,091882,Touri; Behrouz,1,1,70,69
1656307301671,ECE 180,A00,083140,Abi Samra; Nicholas Camill,2,0,30,28
1656307301671,ECE 180,B00,083141,Abi Samra; Nicholas Camill,0,4,30,30
1656307307720,MATH 10A,A01,083735,Patchell; Gregory David,0,0,30,30
1656307307720,MATH 10A,A02,083736,Patchell; Gregory David,22,0,30,8
1656307307720,MATH 10A,A03,083737,Patchell; Gregory David,16,0,30,14
1656307313744,MATH 10B,A01,083207,Lim; Seonhee,2,0,34,32
1656307313744,MATH 10B,A02,083208,Lim; Seonhee,5,0,35,30
1656307313744,MATH 10B,A03,093472,Staff,1,0,34,33
1656307313744,MATH 10B,B01,083739,Sinha; Shubham,11,0,30,19
1656307319769,MATH 18,A01,083743,Cinel; Cameron Alexander,7,0,30,23
1656307319769,MATH 18,A02,083744,Cinel; Cameron Alexander,10,0,30,20
1656307319769,MATH 18,A03,083745,Cinel; Cameron Alexander,5,0,30,25
1656307319769,MATH 18,B01,083748,Rideout; David Porter,0,0,36,36
1656307319769,MATH 18,B02,083749,Rideout; David Porter,0,0,36,36
1656307319769,MATH 18,B03,083750,Rideout; David Porter,0,0,36,36
1656307319769,MATH 18,B04,083751,Rideout; David Porter,0,1,36,36
1656307319769,MATH 18,B05,093473,Rideout; David Porter,0,0,36,36
1656307319769,MATH 18,B06,093474,Rideout; David Porter,2,0,36,34
1656307325793,MATH 20A,A01,083754,Zheng; Zequn,11,0,40,29
1656307331817,MATH 20B,A01,083756,Briones; Jor-el Thomas Caparas,0,0,36,36
1656307331817,MATH 20B,A02,083757,Briones; Jor-el Thomas Caparas,0,0,36,36
1656307331817,MATH 20B,A03,093475,Staff,1,0,36,35
1656307337844,MATH 20C,A01,083760,Briones; Jor-el Thomas Caparas,0,0,35,35
1656307337844,MATH 20C,A02,083761,Briones; Jor-el Thomas Caparas,9,1,35,26
1656307337844,MATH 20C,A03,093476,Staff,0,0,35,35
1656307337844,MATH 20C,B01,083762,Bach; Quang Tran,2,0,30,28
1656307343867,MATH 20D,A01,083765,Tran; Brian Kha,1,0,30,29
1656307343867,MATH 20D,A02,083766,Tran; Brian Kha,1,1,30,29
1656307343867,MATH 20D,A03,083767,Tran; Brian Kha,2,0,30,28
1656307349901,MATH 20E,A01,083771,Ganguly; Soumya,2,0,32,30
1656307349901,MATH 20E,A02,083772,Ganguly; Soumya,0,0,32,32
1656307349901,MATH 20E,B01,083773,Ciotti; Benjamin,18,0,35,17
1656307349901,MATH 20E,B02,083774,Ciotti; Benjamin,15,0,35,20
1656307355930,MATH 103A,A01,083777,Greenfeld; Be'Eri,2,0,36,34
1656307355930,MATH 103A,A02,083778,Greenfeld; Be'Eri,3,0,36,33
1656307355930,MATH 103A,A03,093561,Staff,3,0,36,33
1656307355930,MATH 103A,B01,083779,Greenfeld; Be'Eri,8,0,36,28
1656307355930,MATH 103A,B02,083780,Greenfeld; Be'Eri,0,0,36,36
1656307355930,MATH 103A,B03,093562,Staff,1,0,36,35
1656307361958,MATH 105,A01,085443,Carter; Anne Toulson,4,0,35,31
1656307361958,MATH 105,A02,093477,Staff,14,0,35,21
1656307367987,MATH 109,A01,083213,Ganzberger; Geoffrey Michael,0,0,34,34
1656307367987,MATH 109,A02,083214,Ganzberger; Geoffrey Michael,0,0,34,34
1656307367987,MATH 109,A03,093478,Staff,2,0,34,32
1656307367987,MATH 109,B01,083215,Ganzberger; Geoffrey Michael,4,0,32,28
1656307367987,MATH 109,B02,083216,Ganzberger; Geoffrey Michael,1,0,32,31
1656307367987,MATH 109,B03,093479,Staff,3,0,32,29
1656307374012,MATH 142A,A01,083219,Chow; Bennett,1,0,32,31
1656307374012,MATH 142A,A02,083220,Chow; Bennett,8,0,32,24
1656307374012,MATH 142A,A03,093480,Staff,5,0,32,27
1656307374012,MATH 142A,B03,093481,Staff,3,0,32,29
1656307374012,MATH 142A,B04,093558,Staff,6,0,32,26
1656307374012,MATH 142A,B05,093559,Staff,0,0,32,32
1656307380038,MATH 193A,A01,083224,Rotar; Vladimir,0,1,34,34
1656307380038,MATH 193A,A02,083225,Rotar; Vladimir,0,0,34,34
1656307380038,MATH 193A,A03,083781,Rotar; Vladimir,0,0,34,34
1656307380038,MATH 193A,A04,083782,Rotar; Vladimir,5,0,34,29
1656307380038,MATH 193A,A05,093482,Rotar; Vladimir,0,0,34,34
1656307386064,MATH 197,001,091859,McAuley; Julian John,9999,0,9999,0
1656307386064,MATH 197,002,095566,Kedlaya; Kiran S.,9997,0,9999,2
1656307386064,MATH 197,003,095567,Xiao; Ming,9999,0,9999,0
1656307386064,MATH 197,004,095571,Perols; Johan Lars,9998,0,9999,1
1656307393117,COGS 9,A01,083615,Shannon; Kyle Michael,3,0,75,72
1656307399149,COGS 11,A01,083617,Boyle; Mary E. T.,16,0,48,32
1656307405173,COGS 13,A01,083071,Bastos; Amalia Pinkusfeld,5,0,71,66
1656307411198,COGS 14A,A01,092681,Semenuks; Arturs,1,13,100,99
1656307417222,COGS 14B,A01,083073,Cheng; Tzu-Han,7,0,63,56
1656307423247,COGS 17,A01,092677,Semenuks; Arturs,6,0,81,75
1656307429271,COGS 100,A01,083619,Allen; Michael Gordon,2,0,70,68
1656307435298,COGS 101A,A01,083621,Davis; Joshua Daniel,4,0,68,64
1656307441326,COGS 101B,A01,091572,Allen; Michael Gordon,4,0,65,61
1656307447364,COGS 101C,A01,083625,Delgado; Tania,11,0,35,24
1656307453391,COGS 107A,A01,083627,Boyle; Mary E. T.,2,0,60,58
1656307459418,COGS 118A,A01,083075,Gupta; Anjum,8,0,76,68
1656307465442,CSE 3,A50,083646,Miranda; Gregory Joseph,18,0,50,32
1656307471466,CSE 8A,A50,083650,Miranda; Gregory Joseph,4,3,56,52
1656307477499,CSE 11,A01,083080,Cao; Yingjun,0,48,40,40
1656307483521,CSE 12,A01,083652,Krause-Levy; Sophia Louisa,5,1,120,115
1656307489544,CSE 15L,A01,083654,Morris; Justin Loren,2,0,50,48
1656307489544,CSE 15L,A02,083655,Morris; Justin Loren,4,0,50,46
1656307495568,CSE 20,A01,083657,Tran; Khoa Dang,30,0,80,50
1656307501598,CSE 21,A01,095574,Bach; Quang Tran,23,0,48,25
1656307507625,CSE 30,A01,083084,Eldon; John,2,6,80,78
1656307507625,CSE 30,B01,095061,Bhaskar; Nishant,0,1,50,50
1656307513649,CSE 100,A01,083659,Cao; Yingjun,1,19,70,69
1656307519673,CSE 134B,A01,083661,Powell; Thomas Allan,6,0,100,94
1656307525698,CSE 140,A01,083663,Gungor; Onat,9,0,85,76
1656307531725,CSE 140L,A01,083088,Eldon; John,10,0,100,90
1656307537750,CSE 175,A01,083665,Kumar; Rakesh,0,0,25,25
1656307543774,CSE 190,A00,092507,Dubnov; Shlomo,3,0,20,17
1656307549798,ECE 45,A01,083139,Congero; Spencer William,1,0,75,74
1656307555824,ECE 65,A50,083695,Saad; Andrew S,10,0,30,20
1656307555824,ECE 65,A51,095125,Staff,25,0,26,1
1656307561851,ECE 109,A01,091882,Touri; Behrouz,1,1,70,69
1656307567888,ECE 180,A00,083140,Abi Samra; Nicholas Camill,2,0,30,28
1656307567888,ECE 180,B00,083141,Abi Samra; Nicholas Camill,0,4,30,30
1656307573918,MATH 10A,A01,083735,Patchell; Gregory David,0,0,30,30
1656307573918,MATH 10A,A02,083736,Patchell; Gregory David,22,0,30,8
1656307573918,MATH 10A,A03,083737,Patchell; Gregory David,16,0,30,14
1656307579943,MATH 10B,A01,083207,Lim; Seonhee,2,0,34,32
1656307579943,MATH 10B,A02,083208,Lim; Seonhee,5,0,35,30
1656307579943,MATH 10B,A03,093472,Staff,1,0,34,33
1656307579943,MATH 10B,B01,083739,Sinha; Shubham,11,0,30,19
1656307585969,MATH 18,A01,083743,Cinel; Cameron Alexander,7,0,30,23
1656307585969,MATH 18,A02,083744,Cinel; Cameron Alexander,10,0,30,20
1656307585969,MATH 18,A03,083745,Cinel; Cameron Alexander,5,0,30,25
1656307585969,MATH 18,B01,083748,Rideout; David Porter,0,0,36,36
1656307585969,MATH 18,B02,083749,Rideout; David Porter,0,0,36,36
1656307585969,MATH 18,B03,083750,Rideout; David Porter,0,0,36,36
1656307585969,MATH 18,B04,083751,Rideout; David Porter,0,1,36,36
1656307585969,MATH 18,B05,093473,Rideout; David Porter,0,0,36,36
1656307585969,MATH 18,B06,093474,Rideout; David Porter,2,0,36,34
1656307591992,MATH 20A,A01,083754,Zheng; Zequn,11,0,40,29
1656307598019,MATH 20B,A01,083756,Briones; Jor-el Thomas Caparas,0,0,36,36
1656307598019,MATH 20B,A02,083757,Briones; Jor-el Thomas Caparas,0,0,36,36
1656307598019,MATH 20B,A03,093475,Staff,1,0,36,35
1656307604047,MATH 20C,A01,083760,Briones; Jor-el Thomas Caparas,0,0,35,35
1656307604047,MATH 20C,A02,083761,Briones; Jor-el Thomas Caparas,9,1,35,26
1656307604047,MATH 20C,A03,093476,Staff,0,0,35,35
1656307604047,MATH 20C,B01,083762,Bach; Quang Tran,2,0,30,28
1656307610081,MATH 20D,A01,083765,Tran; Brian Kha,1,0,30,29
1656307610081,MATH 20D,A02,083766,Tran; Brian Kha,0,0,30,30
1656307610081,MATH 20D,A03,083767,Tran; Brian Kha,2,0,30,28
1656307616105,MATH 20E,A01,083771,Ganguly; Soumya,2,0,32,30
1656307616105,MATH 20E,A02,083772,Ganguly; Soumya,0,0,32,32
1656307616105,MATH 20E,B01,083773,Ciotti; Benjamin,18,0,35,17
1656307616105,MATH 20E,B02,083774,Ciotti; Benjamin,15,0,35,20
1656307622135,MATH 103A,A01,083777,Greenfeld; Be'Eri,2,0,36,34
1656307622135,MATH 103A,A02,083778,Greenfeld; Be'Eri,3,0,36,33
1656307622135,MATH 103A,A03,093561,Staff,3,0,36,33
1656307622135,MATH 103A,B01,083779,Greenfeld; Be'Eri,8,0,36,28
1656307622135,MATH 103A,B02,083780,Greenfeld; Be'Eri,0,0,36,36
1656307622135,MATH 103A,B03,093562,Staff,1,0,36,35
1656307628162,MATH 105,A01,085443,Carter; Anne Toulson,4,0,35,31
1656307628162,MATH 105,A02,093477,Staff,14,0,35,21
1656307634188,MATH 109,A01,083213,Ganzberger; Geoffrey Michael,0,0,34,34
1656307634188,MATH 109,A02,083214,Ganzberger; Geoffrey Michael,0,0,34,34
1656307634188,MATH 109,A03,093478,Staff,2,0,34,32
1656307634188,MATH 109,B01,083215,Ganzberger; Geoffrey Michael,4,0,32,28
1656307634188,MATH 109,B02,083216,Ganzberger; Geoffrey Michael,1,0,32,31
1656307634188,MATH 109,B03,093479,Staff,3,0,32,29
1656307640219,MATH 142A,A01,083219,Chow; Bennett,1,0,32,31
1656307640219,MATH 142A,A02,083220,Chow; Bennett,8,0,32,24
1656307640219,MATH 142A,A03,093480,Staff,5,0,32,27
1656307640219,MATH 142A,B03,093481,Staff,3,0,32,29
1656307640219,MATH 142A,B04,093558,Staff,6,0,32,26
1656307640219,MATH 142A,B05,093559,Staff,0,0,32,32
1656307646252,MATH 193A,A01,083224,Rotar; Vladimir,0,1,34,34
1656307646252,MATH 193A,A02,083225,Rotar; Vladimir,0,0,34,34
1656307646252,MATH 193A,A03,083781,Rotar; Vladimir,0,0,34,34
1656307646252,MATH 193A,A04,083782,Rotar; Vladimir,5,0,34,29
1656307646252,MATH 193A,A05,093482,Rotar; Vladimir,0,0,34,34
1656307652276,MATH 197,001,091859,McAuley; Julian John,9999,0,9999,0
1656307652276,MATH 197,002,095566,Kedlaya; Kiran S.,9997,0,9999,2
1656307652276,MATH 197,003,095567,Xiao; Ming,9999,0,9999,0
1656307652276,MATH 197,004,095571,Perols; Johan Lars,9998,0,9999,1
1656307659329,COGS 9,A01,083615,Shannon; Kyle Michael,3,0,75,72
1656307665355,COGS 11,A01,083617,Boyle; Mary E. T.,16,0,48,32
1656307671378,COGS 13,A01,083071,Bastos; Amalia Pinkusfeld,5,0,71,66
1656307677415,COGS 14A,A01,092681,Semenuks; Arturs,0,12,100,100
1656307683445,COGS 14B,A01,083073,Cheng; Tzu-Han,7,0,63,56
1656307689473,COGS 17,A01,092677,Semenuks; Arturs,6,0,81,75
1656307695500,COGS 100,A01,083619,Allen; Michael Gordon,2,0,70,68
1656307701527,COGS 101A,A01,083621,Davis; Joshua Daniel,4,0,68,64
1656307707550,COGS 101B,A01,091572,Allen; Michael Gordon,4,0,65,61
1656307713574,COGS 101C,A01,083625,Delgado; Tania,11,0,35,24
1656307719597,COGS 107A,A01,083627,Boyle; Mary E. T.,2,0,60,58
1656307725624,COGS 118A,A01,083075,Gupta; Anjum,8,0,76,68
1656307731651,CSE 3,A50,083646,Miranda; Gregory Joseph,18,0,50,32
1656307737679,CSE 8A,A50,083650,Miranda; Gregory Joseph,3,2,56,53
1656307743701,CSE 11,A01,083080,Cao; Yingjun,0,48,40,40
1656307749725,CSE 12,A01,083652,Krause-Levy; Sophia Louisa,5,1,120,115
1656307755748,CSE 15L,A01,083654,Morris; Justin Loren,2,0,50,48
1656307755748,CSE 15L,A02,083655,Morris; Justin Loren,4,0,50,46
1656307761776,CSE 20,A01,083657,Tran; Khoa Dang,30,0,80,50
1656307767802,CSE 21,A01,095574,Bach; Quang Tran,23,0,48,25
1656307773829,CSE 30,A01,083084,Eldon; John,1,4,80,79
1656307773829,CSE 30,B01,095061,Bhaskar; Nishant,0,1,50,50
1656307779865,CSE 100,A01,083659,Cao; Yingjun,1,18,70,69
1656307785891,CSE 134B,A01,083661,Powell; Thomas Allan,6,0,100,94
1656307791914,CSE 140,A01,083663,Gungor; Onat,9,0,85,76
1656307797941,CSE 140L,A01,083088,Eldon; John,10,0,100,90
1656307803965,CSE 175,A01,083665,Kumar; Rakesh,0,0,25,25
1656307809989,CSE 190,A00,092507,Dubnov; Shlomo,3,0,20,17
1656307816012,ECE 45,A01,083139,Congero; Spencer William,1,0,75,74
1656307822035,ECE 65,A50,083695,Saad; Andrew S,10,0,30,20
1656307822035,ECE 65,A51,095125,Staff,25,0,26,1
1656307828058,ECE 109,A01,091882,Touri; Behrouz,0,0,70,70
1656307834082,ECE 180,A00,083140,Abi Samra; Nicholas Camill,2,0,30,28
1656307834082,ECE 180,B00,083141,Abi Samra; Nicholas Camill,0,4,30,30
1656307840107,MATH 10A,A01,083735,Patchell; Gregory David,0,0,30,30
1656307840107,MATH 10A,A02,083736,Patchell; Gregory David,22,0,30,8
1656307840107,MATH 10A,A03,083737,Patchell; Gregory David,16,0,30,14
1656307846139,MATH 10B,A01,083207,Lim; Seonhee,2,0,34,32
1656307846139,MATH 10B,A02,083208,Lim; Seonhee,5,0,35,30
1656307846139,MATH 10B,A03,093472,Staff,1,0,34,33
1656307846139,MATH 10B,B01,083739,Sinha; Shubham,11,0,30,19
1656307852171,MATH 18,A01,083743,Cinel; Cameron Alexander,7,0,30,23
1656307852171,MATH 18,A02,083744,Cinel; Cameron Alexander,10,0,30,20
1656307852171,MATH 18,A03,083745,Cinel; Cameron Alexander,5,0,30,25
1656307852171,MATH 18,B01,083748,Rideout; David Porter,0,0,36,36
1656307852171,MATH 18,B02,083749,Rideout; David Porter,0,0,36,36
1656307852171,MATH 18,B03,083750,Rideout; David Porter,0,0,36,36
1656307852171,MATH 18,B04,083751,Rideout; David Porter,0,1,36,36
1656307852171,MATH 18,B05,093473,Rideout; David Porter,0,0,36,36
1656307852171,MATH 18,B06,093474,Rideout; David Porter,2,0,36,34
1656307858194,MATH 20A,A01,083754,Zheng; Zequn,11,0,40,29
1656307864219,MATH 20B,A01,083756,Briones; Jor-el Thomas Caparas,0,0,36,36
1656307864219,MATH 20B,A02,083757,Briones; Jor-el Thomas Caparas,0,0,36,36
1656307864219,MATH 20B,A03,093475,Staff,1,0,36,35
1656307870242,MATH 20C,A01,083760,Briones; Jor-el Thomas Caparas,0,0,35,35
1656307870242,MATH 20C,A02,083761,Briones; Jor-el Thomas Caparas,9,1,35,26
1656307870242,MATH 20C,A03,093476,Staff,0,0,35,35
1656307870242,MATH 20C,B01,083762,Bach; Quang Tran,2,0,30,28
1656307876337,MATH 20D,A01,083765,Tran; Brian Kha,1,0,30,29
1656307876337,MATH 20D,A02,083766,Tran; Brian Kha,0,0,30,30
1656307876337,MATH 20D,A03,083767,Tran; Brian Kha,2,0,30,28
1656307882369,MATH 20E,A01,083771,Ganguly; Soumya,2,0,32,30
1656307882369,MATH 20E,A02,083772,Ganguly; Soumya,0,0,32,32
1656307882369,MATH 20E,B01,083773,Ciotti; Benjamin,18,0,35,17
1656307882369,MATH 20E,B02,083774,Ciotti; Benjamin,15,0,35,20
1656307888402,MATH 103A,A01,083777,Greenfeld; Be'Eri,2,0,36,34
1656307888402,MATH 103A,A02,083778,Greenfeld; Be'Eri,3,0,36,33
1656307888402,MATH 103A,A03,093561,Staff,3,0,36,33
1656307888402,MATH 103A,B01,083779,Greenfeld; Be'Eri,8,0,36,28
1656307888402,MATH 103A,B02,083780,Greenfeld; Be'Eri,0,0,36,36
1656307888402,MATH 103A,B03,093562,Staff,1,0,36,35
1656307894428,MATH 105,A01,085443,Carter; Anne Toulson,4,0,35,31
1656307894428,MATH 105,A02,093477,Staff,14,0,35,21
1656307900462,MATH 109,A01,083213,Ganzberger; Geoffrey Michael,0,0,34,34
1656307900462,MATH 109,A02,083214,Ganzberger; Geoffrey Michael,0,0,34,34
1656307900462,MATH 109,A03,093478,Staff,2,0,34,32
1656307900462,MATH 109,B01,083215,Ganzberger; Geoffrey Michael,4,0,32,28
1656307900462,MATH 109,B02,083216,Ganzberger; Geoffrey Michael,1,0,32,31
1656307900462,MATH 109,B03,093479,Staff,3,0,32,29
1656307906485,MATH 142A,A01,083219,Chow; Bennett,1,0,32,31
1656307906485,MATH 142A,A02,083220,Chow; Bennett,8,0,32,24
1656307906485,MATH 142A,A03,093480,Staff,5,0,32,27
1656307906485,MATH 142A,B03,093481,Staff,3,0,32,29
1656307906485,MATH 142A,B04,093558,Staff,6,0,32,26
1656307906485,MATH 142A,B05,093559,Staff,0,0,32,32
1656307912515,MATH 193A,A01,083224,Rotar; Vladimir,0,1,34,34
1656307912515,MATH 193A,A02,083225,Rotar; Vladimir,0,0,34,34
1656307912515,MATH 193A,A03,083781,Rotar; Vladimir,0,0,34,34
1656307912515,MATH 193A,A04,083782,Rotar; Vladimir,5,0,34,29
1656307912515,MATH 193A,A05,093482,Rotar; Vladimir,0,0,34,34
1656307918541,MATH 197,001,091859,McAuley; Julian John,9999,0,9999,0
1656307918541,MATH 197,002,095566,Kedlaya; Kiran S.,9997,0,9999,2
1656307918541,MATH 197,003,095567,Xiao; Ming,9999,0,9999,0
1656307918541,MATH 197,004,095571,Perols; Johan Lars,9998,0,9999,1
1656307925608,COGS 9,A01,083615,Shannon; Kyle Michael,3,0,75,72
1656307931632,COGS 11,A01,083617,Boyle; Mary E. T.,16,0,48,32
1656307937659,COGS 13,A01,083071,Bastos; Amalia Pinkusfeld,5,0,71,66
1656307943685,COGS 14A,A01,092681,Semenuks; Arturs,0,12,100,100
1656307949709,COGS 14B,A01,083073,Cheng; Tzu-Han,7,0,63,56
1656307955735,COGS 17,A01,092677,Semenuks; Arturs,6,0,81,75
1656307961762,COGS 100,A01,083619,Allen; Michael Gordon,2,0,70,68
1656307967785,COGS 101A,A01,083621,Davis; Joshua Daniel,4,0,68,64
1656307973809,COGS 101B,A01,091572,Allen; Michael Gordon,4,0,65,61
1656307979832,COGS 101C,A01,083625,Delgado; Tania,11,0,35,24
1656307985854,COGS 107A,A01,083627,Boyle; Mary E. T.,2,0,60,58
1656307991881,COGS 118A,A01,083075,Gupta; Anjum,8,0,76,68
1656307997904,CSE 3,A50,083646,Miranda; Gregory Joseph,18,0,50,32
1656308003937,CSE 8A,A50,083650,Miranda; Gregory Joseph,3,2,56,53
1656308009962,CSE 11,A01,083080,Cao; Yingjun,0,48,40,40
1656308015990,CSE 12,A01,083652,Krause-Levy; Sophia Louisa,5,1,120,115
1656308022016,CSE 15L,A01,083654,Morris; Justin Loren,2,0,50,48
1656308022016,CSE 15L,A02,083655,Morris; Justin Loren,4,0,50,46
1656308028043,CSE 20,A01,083657,Tran; Khoa Dang,30,0,80,50
1656308034067,CSE 21,A01,095574,Bach; Quang Tran,23,0,48,25
1656308040091,CSE 30,A01,083084,Eldon; John,1,4,80,79
1656308040091,CSE 30,B01,095061,Bhaskar; Nishant,0,1,50,50
1656308046115,CSE 100,A01,083659,Cao; Yingjun,1,18,70,69
1656308052138,CSE 134B,A01,083661,Powell; Thomas Allan,6,0,100,94
1656308058164,CSE 140,A01,083663,Gungor; Onat,9,0,85,76
1656308064191,CSE 140L,A01,083088,Eldon; John,10,0,100,90
1656308070214,CSE 175,A01,083665,Kumar; Rakesh,0,0,25,25
1656308076237,CSE 190,A00,092507,Dubnov; Shlomo,3,0,20,17
1656308082264,ECE 45,A01,083139,Congero; Spencer William,1,0,75,74
1656308088291,ECE 65,A50,083695,Saad; Andrew S,10,0,30,20
1656308088291,ECE 65,A51,095125,Staff,25,0,26,1
1656308094318,ECE 109,A01,091882,Touri; Behrouz,0,0,70,70
1656308100342,ECE 180,A00,083140,Abi Samra; Nicholas Camill,2,0,30,28
1656308100342,ECE 180,B00,083141,Abi Samra; Nicholas Camill,0,4,30,30
1656308106370,MATH 10A,A01,083735,Patchell; Gregory David,0,0,30,30
1656308106370,MATH 10A,A02,083736,Patchell; Gregory David,22,0,30,8
1656308106370,MATH 10A,A03,083737,Patchell; Gregory David,16,0,30,14
1656308112398,MATH 10B,A01,083207,Lim; Seonhee,2,0,34,32
1656308112398,MATH 10B,A02,083208,Lim; Seonhee,5,0,35,30
1656308112398,MATH 10B,A03,093472,Staff,1,0,34,33
1656308112398,MATH 10B,B01,083739,Sinha; Shubham,11,0,30,19
1656308118428,MATH 18,A01,083743,Cinel; Cameron Alexander,7,0,30,23
1656308118428,MATH 18,A02,083744,Cinel; Cameron Alexander,10,0,30,20
1656308118428,MATH 18,A03,083745,Cinel; Cameron Alexander,5,0,30,25
1656308118428,MATH 18,B01,083748,Rideout; David Porter,0,0,36,36
1656308118428,MATH 18,B02,083749,Rideout; David Porter,0,0,36,36
1656308118428,MATH 18,B03,083750,Rideout; David Porter,0,0,36,36
1656308118428,MATH 18,B04,083751,Rideout; David Porter,0,1,36,36
1656308118428,MATH 18,B05,093473,Rideout; David Porter,0,0,36,36
1656308118428,MATH 18,B06,093474,Rideout; David Porter,2,0,36,34
1656308124451,MATH 20A,A01,083754,Zheng; Zequn,11,0,40,29
1656308130478,MATH 20B,A01,083756,Briones; Jor-el Thomas Caparas,0,0,36,36
1656308130478,MATH 20B,A02,083757,Briones; Jor-el Thomas Caparas,0,0,36,36
1656308130478,MATH 20B,A03,093475,Staff,1,0,36,35
1656308136501,MATH 20C,A01,083760,Briones; Jor-el Thomas Caparas,0,0,35,35
1656308136501,MATH 20C,A02,083761,Briones; Jor-el Thomas Caparas,9,1,35,26
1656308136501,MATH 20C,A03,093476,Staff,0,0,35,35
1656308136501,MATH 20C,B01,083762,Bach; Quang Tran,2,0,30,28
1656308142523,MATH 20D,A01,083765,Tran; Brian Kha,1,0,30,29
1656308142523,MATH 20D,A02,083766,Tran; Brian Kha,0,0,30,30
1656308142523,MATH 20D,A03,083767,Tran; Brian Kha,2,0,30,28
1656308148548,MATH 20E,A01,083771,Ganguly; Soumya,2,0,32,30
1656308148548,MATH 20E,A02,083772,Ganguly; Soumya,0,0,32,32
1656308148548,MATH 20E,B01,083773,Ciotti; Benjamin,18,0,35,17
1656308148548,MATH 20E,B02,083774,Ciotti; Benjamin,15,0,35,20
1656308154577,MATH 103A,A01,083777,Greenfeld; Be'Eri,2,0,36,34
1656308154577,MATH 103A,A02,083778,Greenfeld; Be'Eri,3,0,36,33
1656308154577,MATH 103A,A03,093561,Staff,3,0,36,33
1656308154577,MATH 103A,B01,083779,Greenfeld; Be'Eri,8,0,36,28
1656308154577,MATH 103A,B02,083780,Greenfeld; Be'Eri,0,0,36,36
1656308154577,MATH 103A,B03,093562,Staff,1,0,36,35
1656308160601,MATH 105,A01,085443,Carter; Anne Toulson,4,0,35,31
1656308160601,MATH 105,A02,093477,Staff,14,0,35,21
1656308166625,MATH 109,A01,083213,Ganzberger; Geoffrey Michael,0,0,34,34
1656308166625,MATH 109,A02,083214,Ganzberger; Geoffrey Michael,0,0,34,34
1656308166625,MATH 109,A03,093478,Staff,2,0,34,32
1656308166625,MATH 109,B01,083215,Ganzberger; Geoffrey Michael,4,0,32,28
1656308166625,MATH 109,B02,083216,Ganzberger; Geoffrey Michael,1,0,32,31
1656308166625,MATH 109,B03,093479,Staff,3,0,32,29
1656308172652,MATH 142A,A01,083219,Chow; Bennett,1,0,32,31
1656308172652,MATH 142A,A02,083220,Chow; Bennett,8,0,32,24
1656308172652,MATH 142A,A03,093480,Staff,5,0,32,27
1656308172652,MATH 142A,B03,093481,Staff,3,0,32,29
1656308172652,MATH 142A,B04,093558,Staff,6,0,32,26
1656308172652,MATH 142A,B05,093559,Staff,0,0,32,32
1656308178675,MATH 193A,A01,083224,Rotar; Vladimir,0,1,34,34
1656308178675,MATH 193A,A02,083225,Rotar; Vladimir,0,0,34,34
1656308178675,MATH 193A,A03,083781,Rotar; Vladimir,0,0,34,34
1656308178675,MATH 193A,A04,083782,Rotar; Vladimir,5,0,34,29
1656308178675,MATH 193A,A05,093482,Rotar; Vladimir,0,0,34,34
1656308184701,MATH 197,001,091859,McAuley; Julian John,9999,0,9999,0
1656308184701,MATH 197,002,095566,Kedlaya; Kiran S.,9997,0,9999,2
1656308184701,MATH 197,003,095567,Xiao; Ming,9999,0,9999,0
1656308184701,MATH 197,004,095571,Perols; Johan Lars,9998,0,9999,1
1656308191757,COGS 9,A01,083615,Shannon; Kyle Michael,3,0,75,72
1656308197780,COGS 11,A01,083617,Boyle; Mary E. T.,16,0,48,32
1656308203816,COGS 13,A01,083071,Bastos; Amalia Pinkusfeld,5,0,71,66
1656308209838,COGS 14A,A01,092681,Semenuks; Arturs,0,12,100,100
1656308215869,COGS 14B,A01,083073,Cheng; Tzu-Han,7,0,63,56
1656308221895,COGS 17,A01,092677,Semenuks; Arturs,6,0,81,75
1656308227918,COGS 100,A01,083619,Allen; Michael Gordon,2,0,70,68
1656308233945,COGS 101A,A01,083621,Davis; Joshua Daniel,4,0,68,64
1656308239967,COGS 101B,A01,091572,Allen; Michael Gordon,4,0,65,61
1656308245990,COGS 101C,A01,083625,Delgado; Tania,11,0,35,24
1656308252017,COGS 107A,A01,083627,Boyle; Mary E. T.,2,0,60,58
1656308258043,COGS 118A,A01,083075,Gupta; Anjum,8,0,76,68
1656308264081,CSE 3,A50,083646,Miranda; Gregory Joseph,18,0,50,32
1656308270105,CSE 8A,A50,083650,Miranda; Gregory Joseph,3,2,56,53
1656308276134,CSE 11,A01,083080,Cao; Yingjun,0,48,40,40
1656308282162,CSE 12,A01,083652,Krause-Levy; Sophia Louisa,5,1,120,115
1656308288184,CSE 15L,A01,083654,Morris; Justin Loren,2,0,50,48
1656308288184,CSE 15L,A02,083655,Morris; Justin Loren,4,0,50,46
1656308294208,CSE 20,A01,083657,Tran; Khoa Dang,30,0,80,50
1656308300240,CSE 21,A01,095574,Bach; Quang Tran,23,0,48,25
1656308306264,CSE 30,A01,083084,Eldon; John,1,4,80,79
1656308306264,CSE 30,B01,095061,Bhaskar; Nishant,0,1,50,50
1656308312287,CSE 100,A01,083659,Cao; Yingjun,1,18,70,69
1656308318312,CSE 134B,A01,083661,Powell; Thomas Allan,6,0,100,94
1656308324336,CSE 140,A01,083663,Gungor; Onat,9,0,85,76
1656308330360,CSE 140L,A01,083088,Eldon; John,10,0,100,90
1656308336382,CSE 175,A01,083665,Kumar; Rakesh,0,0,25,25
1656308342405,CSE 190,A00,092507,Dubnov; Shlomo,3,0,20,17
1656308348432,ECE 45,A01,083139,Congero; Spencer William,1,0,75,74
1656308354456,ECE 65,A50,083695,Saad; Andrew S,10,0,30,20
1656308354456,ECE 65,A51,095125,Staff,25,0,26,1
1656308360482,ECE 109,A01,091882,Touri; Behrouz,0,0,70,70
1656308366507,ECE 180,A00,083140,Abi Samra; Nicholas Camill,2,0,30,28
1656308366507,ECE 180,B00,083141,Abi Samra; Nicholas Camill,0,4,30,30
1656308372530,MATH 10A,A01,083735,Patchell; Gregory David,0,0,30,30
1656308372530,MATH 10A,A02,083736,Patchell; Gregory David,22,0,30,8
1656308372530,MATH 10A,A03,083737,Patchell; Gregory David,16,0,30,14
1656308378555,MATH 10B,A01,083207,Lim; Seonhee,2,0,34,32
1656308378555,MATH 10B,A02,083208,Lim; Seonhee,5,0,35,30
1656308378555,MATH 10B,A03,093472,Staff,1,0,34,33
1656308378555,MATH 10B,B01,083739,Sinha; Shubham,11,0,30,19
1656308384580,MATH 18,A01,083743,Cinel; Cameron Alexander,7,0,30,23
1656308384580,MATH 18,A02,083744,Cinel; Cameron Alexander,10,0,30,20
1656308384580,MATH 18,A03,083745,Cinel; Cameron Alexander,5,0,30,25
1656308384580,MATH 18,B01,083748,Rideout; David Porter,0,0,36,36
1656308384580,MATH 18,B02,083749,Rideout; David Porter,0,0,36,36
1656308384580,MATH 18,B03,083750,Rideout; David Porter,0,0,36,36
1656308384580,MATH 18,B04,083751,Rideout; David Porter,0,1,36,36
1656308384580,MATH 18,B05,093473,Rideout; David Porter,0,0,36,36
1656308384580,MATH 18,B06,093474,Rideout; David Porter,2,0,36,34
1656308390605,MATH 20A,A01,083754,Zheng; Zequn,11,0,40,29
1656308396628,MATH 20B,A01,083756,Briones; Jor-el Thomas Caparas,0,0,36,36
1656308396628,MATH 20B,A02,083757,Briones; Jor-el Thomas Caparas,0,0,36,36
1656308396628,MATH 20B,A03,093475,Staff,1,0,36,35
1656308402653,MATH 20C,A01,083760,Briones; Jor-el Thomas Caparas,0,0,35,35
1656308402653,MATH 20C,A02,083761,Briones; Jor-el Thomas Caparas,9,1,35,26
1656308402653,MATH 20C,A03,093476,Staff,0,0,35,35
1656308402653,MATH 20C,B01,083762,Bach; Quang Tran,2,0,30,28
1656308408678,MATH 20D,A01,083765,Tran; Brian Kha,1,0,30,29
1656308408678,MATH 20D,A02,083766,Tran; Brian Kha,0,0,30,30
1656308408678,MATH 20D,A03,083767,Tran; Brian Kha,2,0,30,28
1656308414701,MATH 20E,A01,083771,Ganguly; Soumya,2,0,32,30
1656308414701,MATH 20E,A02,083772,Ganguly; Soumya,0,0,32,32
1656308414701,MATH 20E,B01,083773,Ciotti; Benjamin,18,0,35,17
1656308414701,MATH 20E,B02,083774,Ciotti; Benjamin,15,0,35,20
1656308420728,MATH 103A,A01,083777,Greenfeld; Be'Eri,2,0,36,34
1656308420728,MATH 103A,A02,083778,Greenfeld; Be'Eri,3,0,36,33
1656308420728,MATH 103A,A03,093561,Staff,3,0,36,33
1656308420728,MATH 103A,B01,083779,Greenfeld; Be'Eri,8,0,36,28
1656308420728,MATH 103A,B02,083780,Greenfeld; Be'Eri,0,0,36,36
1656308420728,MATH 103A,B03,093562,Staff,1,0,36,35
1656308426756,MATH 105,A01,085443,Carter; Anne Toulson,4,0,35,31
1656308426756,MATH 105,A02,093477,Staff,14,0,35,21
1656308432779,MATH 109,A01,083213,Ganzberger; Geoffrey Michael,0,0,34,34
1656308432779,MATH 109,A02,083214,Ganzberger; Geoffrey Michael,0,0,34,34
1656308432779,MATH 109,A03,093478,Staff,2,0,34,32
1656308432779,MATH 109,B01,083215,Ganzberger; Geoffrey Michael,4,0,32,28
1656308432779,MATH 109,B02,083216,Ganzberger; Geoffrey Michael,1,0,32,31
1656308432779,MATH 109,B03,093479,Staff,3,0,32,29
1656308438804,MATH 142A,A01,083219,Chow; Bennett,1,0,32,31
1656308438804,MATH 142A,A02,083220,Chow; Bennett,8,0,32,24
1656308438804,MATH 142A,A03,093480,Staff,5,0,32,27
1656308438804,MATH 142A,B03,093481,Staff,3,0,32,29
1656308438804,MATH 142A,B04,093558,Staff,6,0,32,26
1656308438804,MATH 142A,B05,093559,Staff,0,0,32,32
1656308444841,MATH 193A,A01,083224,Rotar; Vladimir,0,1,34,34
1656308444841,MATH 193A,A02,083225,Rotar; Vladimir,0,0,34,34
1656308444841,MATH 193A,A03,083781,Rotar; Vladimir,0,0,34,34
1656308444841,MATH 193A,A04,083782,Rotar; Vladimir,5,0,34,29
1656308444841,MATH 193A,A05,093482,Rotar; Vladimir,0,0,34,34
1656308450869,MATH 197,001,091859,McAuley; Julian John,9999,0,9999,0
1656308450869,MATH 197,002,095566,Kedlaya; Kiran S.,9997,0,9999,2
1656308450869,MATH 197,003,095567,Xiao; Ming,9999,0,9999,0
1656308450869,MATH 197,004,095571,Perols; Johan Lars,9998,0,9999,1
1656308457930,COGS 9,A01,083615,Shannon; Kyle Michael,3,0,75,72
1656308463961,COGS 11,A01,083617,Boyle; Mary E. T.,16,0,48,32
1656308470074,COGS 13,A01,083071,Bastos; Amalia Pinkusfeld,5,0,71,66
1656308476101,COGS 14A,A01,092681,Semenuks; Arturs,0,12,100,100
1656308482128,COGS 14B,A01,083073,Cheng; Tzu-Han,7,0,63,56
1656308488153,COGS 17,A01,092677,Semenuks; Arturs,6,0,81,75
1656308494174,COGS 100,A01,083619,Allen; Michael Gordon,2,0,70,68
1656308500197,COGS 101A,A01,083621,Davis; Joshua Daniel,4,0,68,64
1656308506222,COGS 101B,A01,091572,Allen; Michael Gordon,4,0,65,61
1656308512249,COGS 101C,A01,083625,Delgado; Tania,11,0,35,24
1656308518279,COGS 107A,A01,083627,Boyle; Mary E. T.,2,0,60,58
1656308524307,COGS 118A,A01,083075,Gupta; Anjum,8,0,76,68
1656308530331,CSE 3,A50,083646,Miranda; Gregory Joseph,18,0,50,32
1656308536354,CSE 8A,A50,083650,Miranda; Gregory Joseph,3,2,56,53
1656308542382,CSE 11,A01,083080,Cao; Yingjun,0,48,40,40
1656308548406,CSE 12,A01,083652,Krause-Levy; Sophia Louisa,5,1,120,115
1656308554429,CSE 15L,A01,083654,Morris; Justin Loren,2,0,50,48
1656308554429,CSE 15L,A02,083655,Morris; Justin Loren,4,0,50,46
1656308560452,CSE 20,A01,083657,Tran; Khoa Dang,30,0,80,50
1656308566475,CSE 21,A01,095574,Bach; Quang Tran,23,0,48,25
1656308572499,CSE 30,A01,083084,Eldon; John,1,4,80,79
1656308572499,CSE 30,B01,095061,Bhaskar; Nishant,0,1,50,50
1656308578522,CSE 100,A01,083659,Cao; Yingjun,1,18,70,69
1656308584546,CSE 134B,A01,083661,Powell; Thomas Allan,6,0,100,94
1656308590569,CSE 140,A01,083663,Gungor; Onat,9,0,85,76
1656308596592,CSE 140L,A01,083088,Eldon; John,10,0,100,90
1656308602625,CSE 175,A01,083665,Kumar; Rakesh,0,0,25,25
1656308608650,CSE 190,A00,092507,Dubnov; Shlomo,3,0,20,17
1656308614677,ECE 45,A01,083139,Congero; Spencer William,1,0,75,74
1656308620700,ECE 65,A50,083695,Saad; Andrew S,10,0,30,20
1656308620700,ECE 65,A51,095125,Staff,25,0,26,1
1656308626726,ECE 109,A01,091882,Touri; Behrouz,0,0,70,70
1656308632748,ECE 180,A00,083140,Abi Samra; Nicholas Camill,2,0,30,28
1656308632748,ECE 180,B00,083141,Abi Samra; Nicholas Camill,0,4,30,30
1656308638774,MATH 10A,A01,083735,Patchell; Gregory David,0,0,30,30
1656308638774,MATH 10A,A02,083736,Patchell; Gregory David,22,0,30,8
1656308638774,MATH 10A,A03,083737,Patchell; Gregory David,16,0,30,14
1656308644805,MATH 10B,A01,083207,Lim; Seonhee,2,0,34,32
1656308644805,MATH 10B,A02,083208,Lim; Seonhee,5,0,35,30
1656308644805,MATH 10B,A03,093472,Staff,1,0,34,33
1656308644805,MATH 10B,B01,083739,Sinha; Shubham,11,0,30,19
1656308650830,MATH 18,A01,083743,Cinel; Cameron Alexander,7,0,30,23
1656308650830,MATH 18,A02,083744,Cinel; Cameron Alexander,10,0,30,20
1656308650830,MATH 18,A03,083745,Cinel; Cameron Alexander,5,0,30,25
1656308650830,MATH 18,B01,083748,Rideout; David Porter,0,0,36,36
1656308650830,MATH 18,B02,083749,Rideout; David Porter,0,0,36,36
1656308650830,MATH 18,B03,083750,Rideout; David Porter,0,0,36,36
1656308650830,MATH 18,B04,083751,Rideout; David Porter,0,1,36,36
1656308650830,MATH 18,B05,093473,Rideout; David Porter,0,0,36,36
1656308650830,MATH 18,B06,093474,Rideout; David Porter,2,0,36,34
1656308656857,MATH 20A,A01,083754,Zheng; Zequn,11,0,40,29
1656308662884,MATH 20B,A01,083756,Briones; Jor-el Thomas Caparas,0,0,36,36
1656308662884,MATH 20B,A02,083757,Briones; Jor-el Thomas Caparas,0,0,36,36
1656308662884,MATH 20B,A03,093475,Staff,1,0,36,35
1656308668908,MATH 20C,A01,083760,Briones; Jor-el Thomas Caparas,0,0,35,35
1656308668908,MATH 20C,A02,083761,Briones; Jor-el Thomas Caparas,9,1,35,26
1656308668908,MATH 20C,A03,093476,Staff,0,0,35,35
1656308668908,MATH 20C,B01,083762,Bach; Quang Tran,2,0,30,28
1656308674938,MATH 20D,A01,083765,Tran; Brian Kha,1,0,30,29
1656308674938,MATH 20D,A02,083766,Tran; Brian Kha,0,0,30,30
1656308674938,MATH 20D,A03,083767,Tran; Brian Kha,2,0,30,28
1656308680961,MATH 20E,A01,083771,Ganguly; Soumya,2,0,32,30
1656308680961,MATH 20E,A02,083772,Ganguly; Soumya,0,0,32,32
1656308680961,MATH 20E,B01,083773,Ciotti; Benjamin,18,0,35,17
1656308680961,MATH 20E,B02,083774,Ciotti; Benjamin,15,0,35,20
1656308686984,MATH 103A,A01,083777,Greenfeld; Be'Eri,2,0,36,34
1656308686984,MATH 103A,A02,083778,Greenfeld; Be'Eri,3,0,36,33
1656308686984,MATH 103A,A03,093561,Staff,3,0,36,33
1656308686984,MATH 103A,B01,083779,Greenfeld; Be'Eri,8,0,36,28
1656308686984,MATH 103A,B02,083780,Greenfeld; Be'Eri,0,0,36,36
1656308686984,MATH 103A,B03,093562,Staff,1,0,36,35
1656308693008,MATH 105,A01,085443,Carter; Anne Toulson,4,0,35,31
1656308693008,MATH 105,A02,093477,Staff,14,0,35,21
1656308699033,MATH 109,A01,083213,Ganzberger; Geoffrey Michael,0,0,34,34
1656308699033,MATH 109,A02,083214,Ganzberger; Geoffrey Michael,0,0,34,34
1656308699033,MATH 109,A03,093478,Staff,2,0,34,32
1656308699033,MATH 109,B01,083215,Ganzberger; Geoffrey Michael,4,0,32,28
1656308699033,MATH 109,B02,083216,Ganzberger; Geoffrey Michael,1,0,32,31
1656308699033,MATH 109,B03,093479,Staff,3,0,32,29
1656308705061,MATH 142A,A01,083219,Chow; Bennett,1,0,32,31
1656308705061,MATH 142A,A02,083220,Chow; Bennett,8,0,32,24
1656308705061,MATH 142A,A03,093480,Staff,5,0,32,27
1656308705061,MATH 142A,B03,093481,Staff,3,0,32,29
1656308705061,MATH 142A,B04,093558,Staff,6,0,32,26
1656308705061,MATH 142A,B05,093559,Staff,0,0,32,32
1656308711090,MATH 193A,A01,083224,Rotar; Vladimir,0,1,34,34
1656308711090,MATH 193A,A02,083225,Rotar; Vladimir,0,0,34,34
1656308711090,MATH 193A,A03,083781,Rotar; Vladimir,0,0,34,34
1656308711090,MATH 193A,A04,083782,Rotar; Vladimir,5,0,34,29
1656308711090,MATH 193A,A05,093482,Rotar; Vladimir,0,0,34,34
1656308717112,MATH 197,001,091859,McAuley; Julian John,9999,0,9999,0
1656308717112,MATH 197,002,095566,Kedlaya; Kiran S.,9997,0,9999,2
1656308717112,MATH 197,003,095567,Xiao; Ming,9999,0,9999,0
1656308717112,MATH 197,004,095571,Perols; Johan Lars,9998,0,9999,1
1656308724172,COGS 9,A01,083615,Shannon; Kyle Michael,3,0,75,72
1656308730194,COGS 11,A01,083617,Boyle; Mary E. T.,16,0,48,32
1656308736217,COGS 13,A01,083071,Bastos; Amalia Pinkusfeld,5,0,71,66
1656308742244,COGS 14A,A01,092681,Semenuks; Arturs,0,12,100,100
1656308748271,COGS 14B,A01,083073,Cheng; Tzu-Han,7,0,63,56
1656308754298,COGS 17,A01,092677,Semenuks; Arturs,6,0,81,75
1656308760335,COGS 100,A01,083619,Allen; Michael Gordon,2,0,70,68
1656308766358,COGS 101A,A01,083621,Davis; Joshua Daniel,4,0,68,64
1656308772385,COGS 101B,A01,091572,Allen; Michael Gordon,4,0,65,61
1656308778408,COGS 101C,A01,083625,Delgado; Tania,11,0,35,24
1656308784444,COGS 107A,A01,083627,Boyle; Mary E. T.,2,0,60,58
1656308790468,COGS 118A,A01,083075,Gupta; Anjum,8,0,76,68
1656308796496,CSE 3,A50,083646,Miranda; Gregory Joseph,18,0,50,32
1656308802523,CSE 8A,A50,083650,Miranda; Gregory Joseph,3,2,56,53
1656308808552,CSE 11,A01,083080,Cao; Yingjun,0,48,40,40
1656308814575,CSE 12,A01,083652,Krause-Levy; Sophia Louisa,5,1,120,115
1656308820603,CSE 15L,A01,083654,Morris; Justin Loren,2,0,50,48
1656308820603,CSE 15L,A02,083655,Morris; Justin Loren,4,0,50,46
1656308826628,CSE 20,A01,083657,Tran; Khoa Dang,30,0,80,50
1656308832658,CSE 21,A01,095574,Bach; Quang Tran,23,0,48,25
1656308838683,CSE 30,A01,083084,Eldon; John,1,4,80,79
1656308838683,CSE 30,B01,095061,Bhaskar; Nishant,0,1,50,50
1656308844720,CSE 100,A01,083659,Cao; Yingjun,1,18,70,69
1656308850746,CSE 134B,A01,083661,Powell; Thomas Allan,6,0,100,94
1656308856774,CSE 140,A01,083663,Gungor; Onat,9,0,85,76
1656308862811,CSE 140L,A01,083088,Eldon; John,10,0,100,90
1656308868837,CSE 175,A01,083665,Kumar; Rakesh,0,0,25,25
1656308874858,CSE 190,A00,092507,Dubnov; Shlomo,3,0,20,17
1656308880885,ECE 45,A01,083139,Congero; Spencer William,1,0,75,74
1656308886918,ECE 65,A50,083695,Saad; Andrew S,10,0,30,20
1656308886918,ECE 65,A51,095125,Staff,25,0,26,1
1656308892941,ECE 109,A01,091882,Touri; Behrouz,0,0,70,70
1656308898964,ECE 180,A00,083140,Abi Samra; Nicholas Camill,2,0,30,28
1656308898964,ECE 180,B00,083141,Abi Samra; Nicholas Camill,0,4,30,30
1656308904993,MATH 10A,A01,083735,Patchell; Gregory David,0,0,30,30
1656308904993,MATH 10A,A02,083736,Patchell; Gregory David,22,0,30,8
1656308904993,MATH 10A,A03,083737,Patchell; Gregory David,16,0,30,14
1656308911017,MATH 10B,A01,083207,Lim; Seonhee,2,0,34,32
1656308911017,MATH 10B,A02,083208,Lim; Seonhee,4,0,35,31
1656308911017,MATH 10B,A03,093472,Staff,1,0,34,33
1656308911017,MATH 10B,B01,083739,Sinha; Shubham,11,0,30,19
1656308917042,MATH 18,A01,083743,Cinel; Cameron Alexander,7,0,30,23
1656308917042,MATH 18,A02,083744,Cinel; Cameron Alexander,10,0,30,20
1656308917042,MATH 18,A03,083745,Cinel; Cameron Alexander,5,0,30,25
1656308917042,MATH 18,B01,083748,Rideout; David Porter,0,0,36,36
1656308917042,MATH 18,B02,083749,Rideout; David Porter,0,0,36,36
1656308917042,MATH 18,B03,083750,Rideout; David Porter,0,0,36,36
1656308917042,MATH 18,B04,083751,Rideout; David Porter,0,1,36,36
1656308917042,MATH 18,B05,093473,Rideout; David Porter,0,0,36,36
1656308917042,MATH 18,B06,093474,Rideout; David Porter,2,0,36,34
1656308923067,MATH 20A,A01,083754,Zheng; Zequn,11,0,40,29
1656308929091,MATH 20B,A01,083756,Briones; Jor-el Thomas Caparas,0,0,36,36
1656308929091,MATH 20B,A02,083757,Briones; Jor-el Thomas Caparas,0,0,36,36
1656308929091,MATH 20B,A03,093475,Staff,1,0,36,35
1656308935120,MATH 20C,A01,083760,Briones; Jor-el Thomas Caparas,0,0,35,35
1656308935120,MATH 20C,A02,083761,Briones; Jor-el Thomas Caparas,9,1,35,26
1656308935120,MATH 20C,A03,093476,Staff,0,0,35,35
1656308935120,MATH 20C,B01,083762,Bach; Quang Tran,2,0,30,28
1656308941148,MATH 20D,A01,083765,Tran; Brian Kha,1,0,30,29
1656308941148,MATH 20D,A02,083766,Tran; Brian Kha,0,0,30,30
1656308941148,MATH 20D,A03,083767,Tran; Brian Kha,2,0,30,28
1656308947176,MATH 20E,A01,083771,Ganguly; Soumya,2,0,32,30
1656308947176,MATH 20E,A02,083772,Ganguly; Soumya,0,0,32,32
1656308947176,MATH 20E,B01,083773,Ciotti; Benjamin,18,0,35,17
1656308947176,MATH 20E,B02,083774,Ciotti; Benjamin,15,0,35,20
1656308953200,MATH 103A,A01,083777,Greenfeld; Be'Eri,2,0,36,34
1656308953200,MATH 103A,A02,083778,Greenfeld; Be'Eri,3,0,36,33
1656308953200,MATH 103A,A03,093561,Staff,3,0,36,33
1656308953200,MATH 103A,B01,083779,Greenfeld; Be'Eri,8,0,36,28
1656308953200,MATH 103A,B02,083780,Greenfeld; Be'Eri,0,0,36,36
1656308953200,MATH 103A,B03,093562,Staff,1,0,36,35
1656308959228,MATH 105,A01,085443,Carter; Anne Toulson,4,0,35,31
1656308959228,MATH 105,A02,093477,Staff,14,0,35,21
1656308965251,MATH 109,A01,083213,Ganzberger; Geoffrey Michael,0,0,34,34
1656308965251,MATH 109,A02,083214,Ganzberger; Geoffrey Michael,0,0,34,34
1656308965251,MATH 109,A03,093478,Staff,2,0,34,32
1656308965251,MATH 109,B01,083215,Ganzberger; Geoffrey Michael,4,0,32,28
1656308965251,MATH 109,B02,083216,Ganzberger; Geoffrey Michael,1,0,32,31
1656308965251,MATH 109,B03,093479,Staff,3,0,32,29
1656308971275,MATH 142A,A01,083219,Chow; Bennett,1,0,32,31
1656308971275,MATH 142A,A02,083220,Chow; Bennett,8,0,32,24
1656308971275,MATH 142A,A03,093480,Staff,5,0,32,27
1656308971275,MATH 142A,B03,093481,Staff,3,0,32,29
1656308971275,MATH 142A,B04,093558,Staff,6,0,32,26
1656308971275,MATH 142A,B05,093559,Staff,0,0,32,32
1656308977303,MATH 193A,A01,083224,Rotar; Vladimir,0,1,34,34
1656308977303,MATH 193A,A02,083225,Rotar; Vladimir,0,0,34,34
1656308977303,MATH 193A,A03,083781,Rotar; Vladimir,0,0,34,34
1656308977303,MATH 193A,A04,083782,Rotar; Vladimir,5,0,34,29
1656308977303,MATH 193A,A05,093482,Rotar; Vladimir,0,0,34,34
1656308983328,MATH 197,001,091859,McAuley; Julian John,9999,0,9999,0
1656308983328,MATH 197,002,095566,Kedlaya; Kiran S.,9997,0,9999,2
1656308983328,MATH 197,003,095567,Xiao; Ming,9999,0,9999,0
1656308983328,MATH 197,004,095571,Perols; Johan Lars,9998,0,9999,1
1656308990385,COGS 9,A01,083615,Shannon; Kyle Michael,3,0,75,72
1656308996408,COGS 11,A01,083617,Boyle; Mary E. T.,16,0,48,32
1656309002436,COGS 13,A01,083071,Bastos; Amalia Pinkusfeld,5,0,71,66
1656309008460,COGS 14A,A01,092681,Semenuks; Arturs,0,12,100,100
1656309014485,COGS 14B,A01,083073,Cheng; Tzu-Han,7,0,63,56
1656309020509,COGS 17,A01,092677,Semenuks; Arturs,6,0,81,75
1656309026532,COGS 100,A01,083619,Allen; Michael Gordon,2,0,70,68
1656309032568,COGS 101A,A01,083621,Davis; Joshua Daniel,4,0,68,64
1656309038593,COGS 101B,A01,091572,Allen; Michael Gordon,4,0,65,61
1656309044617,COGS 101C,A01,083625,Delgado; Tania,11,0,35,24
1656309050644,COGS 107A,A01,083627,Boyle; Mary E. T.,2,0,60,58
1656309056685,COGS 118A,A01,083075,Gupta; Anjum,8,0,76,68
1656309062709,CSE 3,A50,083646,Miranda; Gregory Joseph,18,0,50,32
1656309068825,CSE 8A,A50,083650,Miranda; Gregory Joseph,3,2,56,53
1656309074852,CSE 11,A01,083080,Cao; Yingjun,0,48,40,40
1656309080876,CSE 12,A01,083652,Krause-Levy; Sophia Louisa,5,1,120,115
1656309086902,CSE 15L,A01,083654,Morris; Justin Loren,2,0,50,48
1656309086902,CSE 15L,A02,083655,Morris; Justin Loren,4,0,50,46
1656309092930,CSE 20,A01,083657,Tran; Khoa Dang,30,0,80,50
1656309098956,CSE 21,A01,095574,Bach; Quang Tran,23,0,48,25
1656309104985,CSE 30,A01,083084,Eldon; John,1,4,80,79
1656309104985,CSE 30,B01,095061,Bhaskar; Nishant,0,1,50,50
1656309111013,CSE 100,A01,083659,Cao; Yingjun,1,18,70,69
1656309117050,CSE 134B,A01,083661,Powell; Thomas Allan,6,0,100,94
1656309123072,CSE 140,A01,083663,Gungor; Onat,9,0,85,76
1656309129096,CSE 140L,A01,083088,Eldon; John,10,0,100,90
1656309135123,CSE 175,A01,083665,Kumar; Rakesh,0,0,25,25
1656309141146,CSE 190,A00,092507,Dubnov; Shlomo,3,0,20,17
1656309147170,ECE 45,A01,083139,Congero; Spencer William,1,0,75,74
1656309153193,ECE 65,A50,083695,Saad; Andrew S,10,0,30,20
1656309153193,ECE 65,A51,095125,Staff,25,0,26,1
1656309159218,ECE 109,A01,091882,Touri; Behrouz,0,0,70,70
1656309165240,ECE 180,A00,083140,Abi Samra; Nicholas Camill,2,0,30,28
1656309165240,ECE 180,B00,083141,Abi Samra; Nicholas Camill,0,4,30,30
1656309171268,MATH 10A,A01,083735,Patchell; Gregory David,0,0,30,30
1656309171268,MATH 10A,A02,083736,Patchell; Gregory David,22,0,30,8
1656309171268,MATH 10A,A03,083737,Patchell; Gregory David,16,0,30,14
1656309177291,MATH 10B,A01,083207,Lim; Seonhee,2,0,34,32
1656309177291,MATH 10B,A02,083208,Lim; Seonhee,4,0,35,31
1656309177291,MATH 10B,A03,093472,Staff,1,0,34,33
1656309177291,MATH 10B,B01,083739,Sinha; Shubham,11,0,30,19
1656309183315,MATH 18,A01,083743,Cinel; Cameron Alexander,7,0,30,23
1656309183315,MATH 18,A02,083744,Cinel; Cameron Alexander,10,0,30,20
1656309183315,MATH 18,A03,083745,Cinel; Cameron Alexander,5,0,30,25
1656309183315,MATH 18,B01,083748,Rideout; David Porter,0,0,36,36
1656309183315,MATH 18,B02,083749,Rideout; David Porter,0,0,36,36
1656309183315,MATH 18,B03,083750,Rideout; David Porter,0,0,36,36
1656309183315,MATH 18,B04,083751,Rideout; David Porter,0,1,36,36
1656309183315,MATH 18,B05,093473,Rideout; David Porter,0,0,36,36
1656309183315,MATH 18,B06,093474,Rideout; David Porter,2,0,36,34
1656309189340,MATH 20A,A01,083754,Zheng; Zequn,11,0,40,29
1656309195367,MATH 20B,A01,083756,Briones; Jor-el Thomas Caparas,0,0,36,36
1656309195367,MATH 20B,A02,083757,Briones; Jor-el Thomas Caparas,0,0,36,36
1656309195367,MATH 20B,A03,093475,Staff,1,0,36,35
1656309201397,MATH 20C,A01,083760,Briones; Jor-el Thomas Caparas,0,0,35,35
1656309201397,MATH 20C,A02,083761,Briones; Jor-el Thomas Caparas,9,1,35,26
1656309201397,MATH 20C,A03,093476,Staff,0,0,35,35
1656309201397,MATH 20C,B01,083762,Bach; Quang Tran,2,0,30,28
1656309207421,MATH 20D,A01,083765,Tran; Brian Kha,1,0,30,29
1656309207421,MATH 20D,A02,083766,Tran; Brian Kha,0,0,30,30
1656309207421,MATH 20D,A03,083767,Tran; Brian Kha,2,0,30,28
1656309213449,MATH 20E,A01,083771,Ganguly; Soumya,2,0,32,30
1656309213449,MATH 20E,A02,083772,Ganguly; Soumya,0,0,32,32
1656309213449,MATH 20E,B01,083773,Ciotti; Benjamin,18,0,35,17
1656309213449,MATH 20E,B02,083774,Ciotti; Benjamin,15,0,35,20
1656309219477,MATH 103A,A01,083777,Greenfeld; Be'Eri,1,0,36,35
1656309219477,MATH 103A,A02,083778,Greenfeld; Be'Eri,3,0,36,33
1656309219477,MATH 103A,A03,093561,Staff,3,0,36,33
1656309219477,MATH 103A,B01,083779,Greenfeld; Be'Eri,8,0,36,28
1656309219477,MATH 103A,B02,083780,Greenfeld; Be'Eri,0,0,36,36
1656309219477,MATH 103A,B03,093562,Staff,1,0,36,35
1656309225505,MATH 105,A01,085443,Carter; Anne Toulson,4,0,35,31
1656309225505,MATH 105,A02,093477,Staff,14,0,35,21
1656309231534,MATH 109,A01,083213,Ganzberger; Geoffrey Michael,0,0,34,34
1656309231534,MATH 109,A02,083214,Ganzberger; Geoffrey Michael,0,0,34,34
1656309231534,MATH 109,A03,093478,Staff,2,0,34,32
1656309231534,MATH 109,B01,083215,Ganzberger; Geoffrey Michael,4,0,32,28
1656309231534,MATH 109,B02,083216,Ganzberger; Geoffrey Michael,1,0,32,31
1656309231534,MATH 109,B03,093479,Staff,3,0,32,29
1656309237564,MATH 142A,A01,083219,Chow; Bennett,1,0,32,31
1656309237564,MATH 142A,A02,083220,Chow; Bennett,8,0,32,24
1656309237564,MATH 142A,A03,093480,Staff,5,0,32,27
1656309237564,MATH 142A,B03,093481,Staff,3,0,32,29
1656309237564,MATH 142A,B04,093558,Staff,6,0,32,26
1656309237564,MATH 142A,B05,093559,Staff,0,0,32,32
1656309243595,MATH 193A,A01,083224,Rotar; Vladimir,0,1,34,34
1656309243595,MATH 193A,A02,083225,Rotar; Vladimir,0,0,34,34
1656309243595,MATH 193A,A03,083781,Rotar; Vladimir,0,0,34,34
1656309243595,MATH 193A,A04,083782,Rotar; Vladimir,5,0,34,29
1656309243595,MATH 193A,A05,093482,Rotar; Vladimir,0,0,34,34
1656309249620,MATH 197,001,091859,McAuley; Julian John,9999,0,9999,0
1656309249620,MATH 197,002,095566,Kedlaya; Kiran S.,9997,0,9999,2
1656309249620,MATH 197,003,095567,Xiao; Ming,9999,0,9999,0
1656309249620,MATH 197,004,095571,Perols; Johan Lars,9998,0,9999,1
1656309256689,COGS 9,A01,083615,Shannon; Kyle Michael,3,0,75,72
1656309262715,COGS 11,A01,083617,Boyle; Mary E. T.,16,0,48,32
1656309268742,COGS 13,A01,083071,Bastos; Amalia Pinkusfeld,5,0,71,66
1656309274769,COGS 14A,A01,092681,Semenuks; Arturs,0,12,100,100
1656309280797,COGS 14B,A01,083073,Cheng; Tzu-Han,7,0,63,56
1656309286820,COGS 17,A01,092677,Semenuks; Arturs,6,0,81,75
1656309292843,COGS 100,A01,083619,Allen; Michael Gordon,2,0,70,68
1656309298871,COGS 101A,A01,083621,Davis; Joshua Daniel,4,0,68,64
1656309304897,COGS 101B,A01,091572,Allen; Michael Gordon,4,0,65,61
1656309310921,COGS 101C,A01,083625,Delgado; Tania,11,0,35,24
1656309316948,COGS 107A,A01,083627,Boyle; Mary E. T.,2,0,60,58
1656309322975,COGS 118A,A01,083075,Gupta; Anjum,8,0,76,68
1656309329000,CSE 3,A50,083646,Miranda; Gregory Joseph,18,0,50,32
1656309335028,CSE 8A,A50,083650,Miranda; Gregory Joseph,3,2,56,53
1656309341050,CSE 11,A01,083080,Cao; Yingjun,0,48,40,40
1656309347074,CSE 12,A01,083652,Krause-Levy; Sophia Louisa,5,1,120,115
1656309353102,CSE 15L,A01,083654,Morris; Justin Loren,2,0,50,48
1656309353102,CSE 15L,A02,083655,Morris; Justin Loren,4,0,50,46
1656309359123,CSE 20,A01,083657,Tran; Khoa Dang,30,0,80,50
1656309365151,CSE 21,A01,095574,Bach; Quang Tran,23,0,48,25
1656309371174,CSE 30,A01,083084,Eldon; John,1,4,80,79
1656309371174,CSE 30,B01,095061,Bhaskar; Nishant,0,1,50,50
1656309377204,CSE 100,A01,083659,Cao; Yingjun,1,18,70,69
1656309383232,CSE 134B,A01,083661,Powell; Thomas Allan,6,0,100,94
1656309389266,CSE 140,A01,083663,Gungor; Onat,9,0,85,76
1656309395299,CSE 140L,A01,083088,Eldon; John,10,0,100,90
1656309401323,CSE 175,A01,083665,Kumar; Rakesh,0,0,25,25
1656309407347,CSE 190,A00,092507,Dubnov; Shlomo,3,0,20,17
1656309413373,ECE 45,A01,083139,Congero; Spencer William,1,0,75,74
1656309419401,ECE 65,A50,083695,Saad; Andrew S,10,0,30,20
1656309419401,ECE 65,A51,095125,Staff,25,0,26,1
1656309425425,ECE 109,A01,091882,Touri; Behrouz,0,0,70,70
1656309431449,ECE 180,A00,083140,Abi Samra; Nicholas Camill,2,0,30,28
1656309431449,ECE 180,B00,083141,Abi Samra; Nicholas Camill,0,4,30,30
1656309437491,MATH 10A,A01,083735,Patchell; Gregory David,0,0,30,30
1656309437491,MATH 10A,A02,083736,Patchell; Gregory David,22,0,30,8
1656309437491,MATH 10A,A03,083737,Patchell; Gregory David,16,0,30,14
1656309443516,MATH 10B,A01,083207,Lim; Seonhee,2,0,34,32
1656309443516,MATH 10B,A02,083208,Lim; Seonhee,4,0,35,31
1656309443516,MATH 10B,A03,093472,Staff,1,0,34,33
1656309443516,MATH 10B,B01,083739,Sinha; Shubham,11,0,30,19
1656309449547,MATH 18,A01,083743,Cinel; Cameron Alexander,7,0,30,23
1656309449547,MATH 18,A02,083744,Cinel; Cameron Alexander,10,0,30,20
1656309449547,MATH 18,A03,083745,Cinel; Cameron Alexander,5,0,30,25
1656309449547,MATH 18,B01,083748,Rideout; David Porter,0,0,36,36
1656309449547,MATH 18,B02,083749,Rideout; David Porter,0,0,36,36
1656309449547,MATH 18,B03,083750,Rideout; David Porter,0,0,36,36
1656309449547,MATH 18,B04,083751,Rideout; David Porter,0,1,36,36
1656309449547,MATH 18,B05,093473,Rideout; David Porter,0,0,36,36
1656309449547,MATH 18,B06,093474,Rideout; David Porter,2,0,36,34
1656309455571,MATH 20A,A01,083754,Zheng; Zequn,11,0,40,29
1656309461595,MATH 20B,A01,083756,Briones; Jor-el Thomas Caparas,0,0,36,36
1656309461595,MATH 20B,A02,083757,Briones; Jor-el Thomas Caparas,0,0,36,36
1656309461595,MATH 20B,A03,093475,Staff,1,0,36,35
1656309467621,MATH 20C,A01,083760,Briones; Jor-el Thomas Caparas,0,0,35,35
1656309467621,MATH 20C,A02,083761,Briones; Jor-el Thomas Caparas,9,1,35,26
1656309467621,MATH 20C,A03,093476,Staff,0,0,35,35
1656309467621,MATH 20C,B01,083762,Bach; Quang Tran,2,0,30,28
1656309473651,MATH 20D,A01,083765,Tran; Brian Kha,1,0,30,29
1656309473651,MATH 20D,A02,083766,Tran; Brian Kha,0,0,30,30
1656309473651,MATH 20D,A03,083767,Tran; Brian Kha,2,0,30,28
1656309479678,MATH 20E,A01,083771,Ganguly; Soumya,2,0,32,30
1656309479678,MATH 20E,A02,083772,Ganguly; Soumya,0,0,32,32
1656309479678,MATH 20E,B01,083773,Ciotti; Benjamin,18,0,35,17
1656309479678,MATH 20E,B02,083774,Ciotti; Benjamin,15,0,35,20
1656309485707,MATH 103A,A01,083777,Greenfeld; Be'Eri,1,0,36,35
1656309485707,MATH 103A,A02,083778,Greenfeld; Be'Eri,3,0,36,33
1656309485707,MATH 103A,A03,093561,Staff,3,0,36,33
1656309485707,MATH 103A,B01,083779,Greenfeld; Be'Eri,8,0,36,28
1656309485707,MATH 103A,B02,083780,Greenfeld; Be'Eri,0,0,36,36
1656309485707,MATH 103A,B03,093562,Staff,1,0,36,35
1656309491735,MATH 105,A01,085443,Carter; Anne Toulson,4,0,35,31
1656309491735,MATH 105,A02,093477,Staff,14,0,35,21
1656309497760,MATH 109,A01,083213,Ganzberger; Geoffrey Michael,0,0,34,34
1656309497760,MATH 109,A02,083214,Ganzberger; Geoffrey Michael,0,0,34,34
1656309497760,MATH 109,A03,093478,Staff,2,0,34,32
1656309497760,MATH 109,B01,083215,Ganzberger; Geoffrey Michael,4,0,32,28
1656309497760,MATH 109,B02,083216,Ganzberger; Geoffrey Michael,1,0,32,31
1656309497760,MATH 109,B03,093479,Staff,3,0,32,29
1656309503789,MATH 142A,A01,083219,Chow; Bennett,1,0,32,31
1656309503789,MATH 142A,A02,083220,Chow; Bennett,8,0,32,24
1656309503789,MATH 142A,A03,093480,Staff,5,0,32,27
1656309503789,MATH 142A,B03,093481,Staff,3,0,32,29
1656309503789,MATH 142A,B04,093558,Staff,6,0,32,26
1656309503789,MATH 142A,B05,093559,Staff,0,0,32,32
1656309509817,MATH 193A,A01,083224,Rotar; Vladimir,0,1,34,34
1656309509817,MATH 193A,A02,083225,Rotar; Vladimir,0,0,34,34
1656309509817,MATH 193A,A03,083781,Rotar; Vladimir,0,0,34,34
1656309509817,MATH 193A,A04,083782,Rotar; Vladimir,5,0,34,29
1656309509817,MATH 193A,A05,093482,Rotar; Vladimir,0,0,34,34
1656309515843,MATH 197,001,091859,McAuley; Julian John,9999,0,9999,0
1656309515843,MATH 197,002,095566,Kedlaya; Kiran S.,9997,0,9999,2
1656309515843,MATH 197,003,095567,Xiao; Ming,9999,0,9999,0
1656309515843,MATH 197,004,095571,Perols; Johan Lars,9998,0,9999,1
1656309522905,COGS 9,A01,083615,Shannon; Kyle Michael,3,0,75,72
1656309528932,COGS 11,A01,083617,Boyle; Mary E. T.,16,0,48,32
1656309534961,COGS 13,A01,083071,Bastos; Amalia Pinkusfeld,5,0,71,66
1656309540984,COGS 14A,A01,092681,Semenuks; Arturs,0,12,100,100
1656309547009,COGS 14B,A01,083073,Cheng; Tzu-Han,7,0,63,56
1656309553034,COGS 17,A01,092677,Semenuks; Arturs,6,0,81,75
1656309559058,COGS 100,A01,083619,Allen; Michael Gordon,2,0,70,68
1656309565085,COGS 101A,A01,083621,Davis; Joshua Daniel,4,0,68,64
1656309571111,COGS 101B,A01,091572,Allen; Michael Gordon,4,0,65,61
1656309577133,COGS 101C,A01,083625,Delgado; Tania,11,0,35,24
1656309583194,COGS 107A,A01,083627,Boyle; Mary E. T.,2,0,60,58
1656309589218,COGS 118A,A01,083075,Gupta; Anjum,7,0,76,69
1656309595241,CSE 3,A50,083646,Miranda; Gregory Joseph,18,0,50,32
1656309601270,CSE 8A,A50,083650,Miranda; Gregory Joseph,3,2,56,53
1656309607298,CSE 11,A01,083080,Cao; Yingjun,0,48,40,40
1656309613322,CSE 12,A01,083652,Krause-Levy; Sophia Louisa,5,1,120,115
1656309619345,CSE 15L,A01,083654,Morris; Justin Loren,2,0,50,48
1656309619345,CSE 15L,A02,083655,Morris; Justin Loren,4,0,50,46
1656309625370,CSE 20,A01,083657,Tran; Khoa Dang,30,0,80,50
1656309631396,CSE 21,A01,095574,Bach; Quang Tran,23,0,48,25
1656309637419,CSE 30,A01,083084,Eldon; John,1,4,80,79
1656309637419,CSE 30,B01,095061,Bhaskar; Nishant,0,1,50,50
1656309643446,CSE 100,A01,083659,Cao; Yingjun,1,18,70,69
1656309649474,CSE 134B,A01,083661,Powell; Thomas Allan,6,0,100,94
1656309655503,CSE 140,A01,083663,Gungor; Onat,9,0,85,76
1656309661526,CSE 140L,A01,083088,Eldon; John,10,0,100,90
1656309667636,CSE 175,A01,083665,Kumar; Rakesh,0,0,25,25
1656309673660,CSE 190,A00,092507,Dubnov; Shlomo,3,0,20,17
1656309679690,ECE 45,A01,083139,Congero; Spencer William,1,0,75,74
1656309685723,ECE 65,A50,083695,Saad; Andrew S,10,0,30,20
1656309685723,ECE 65,A51,095125,Staff,25,0,26,1
1656309691747,ECE 109,A01,091882,Touri; Behrouz,0,0,70,70
1656309697771,ECE 180,A00,083140,Abi Samra; Nicholas Camill,2,0,30,28
1656309697771,ECE 180,B00,083141,Abi Samra; Nicholas Camill,0,4,30,30
1656309703797,MATH 10A,A01,083735,Patchell; Gregory David,0,0,30,30
1656309703797,MATH 10A,A02,083736,Patchell; Gregory David,22,0,30,8
1656309703797,MATH 10A,A03,083737,Patchell; Gregory David,16,0,30,14
1656309709827,MATH 10B,A01,083207,Lim; Seonhee,2,0,34,32
1656309709827,MATH 10B,A02,083208,Lim; Seonhee,4,0,35,31
1656309709827,MATH 10B,A03,093472,Staff,1,0,34,33
1656309709827,MATH 10B,B01,083739,Sinha; Shubham,11,0,30,19
1656309715854,MATH 18,A01,083743,Cinel; Cameron Alexander,7,0,30,23
1656309715854,MATH 18,A02,083744,Cinel; Cameron Alexander,10,0,30,20
1656309715854,MATH 18,A03,083745,Cinel; Cameron Alexander,5,0,30,25
1656309715854,MATH 18,B01,083748,Rideout; David Porter,0,0,36,36
1656309715854,MATH 18,B02,083749,Rideout; David Porter,0,0,36,36
1656309715854,MATH 18,B03,083750,Rideout; David Porter,0,0,36,36
1656309715854,MATH 18,B04,083751,Rideout; David Porter,0,1,36,36
1656309715854,MATH 18,B05,093473,Rideout; David Porter,0,0,36,36
1656309715854,MATH 18,B06,093474,Rideout; David Porter,2,0,36,34
1656309721877,MATH 20A,A01,083754,Zheng; Zequn,11,0,40,29
1656309727912,MATH 20B,A01,083756,Briones; Jor-el Thomas Caparas,0,0,36,36
1656309727912,MATH 20B,A02,083757,Briones; Jor-el Thomas Caparas,0,0,36,36
1656309727912,MATH 20B,A03,093475,Staff,1,0,36,35
1656309733937,MATH 20C,A01,083760,Briones; Jor-el Thomas Caparas,0,0,35,35
1656309733937,MATH 20C,A02,083761,Briones; Jor-el Thomas Caparas,9,1,35,26
1656309733937,MATH 20C,A03,093476,Staff,0,0,35,35
1656309733937,MATH 20C,B01,083762,Bach; Quang Tran,2,0,30,28
1656309739962,MATH 20D,A01,083765,Tran; Brian Kha,1,0,30,29
1656309739962,MATH 20D,A02,083766,Tran; Brian Kha,0,0,30,30
1656309739962,MATH 20D,A03,083767,Tran; Brian Kha,2,0,30,28
1656309745988,MATH 20E,A01,083771,Ganguly; Soumya,2,0,32,30
1656309745988,MATH 20E,A02,083772,Ganguly; Soumya,0,0,32,32
1656309745988,MATH 20E,B01,083773,Ciotti; Benjamin,18,0,35,17
1656309745988,MATH 20E,B02,083774,Ciotti; Benjamin,15,0,35,20
1656309752015,MATH 103A,A01,083777,Greenfeld; Be'Eri,2,0,36,34
1656309752015,MATH 103A,A02,083778,Greenfeld; Be'Eri,3,0,36,33
1656309752015,MATH 103A,A03,093561,Staff,3,0,36,33
1656309752015,MATH 103A,B01,083779,Greenfeld; Be'Eri,8,0,36,28
1656309752015,MATH 103A,B02,083780,Greenfeld; Be'Eri,0,0,36,36
1656309752015,MATH 103A,B03,093562,Staff,1,0,36,35
1656309758044,MATH 105,A01,085443,Carter; Anne Toulson,4,0,35,31
1656309758044,MATH 105,A02,093477,Staff,14,0,35,21
1656309764073,MATH 109,A01,083213,Ganzberger; Geoffrey Michael,0,0,34,34
1656309764073,MATH 109,A02,083214,Ganzberger; Geoffrey Michael,0,0,34,34
1656309764073,MATH 109,A03,093478,Staff,2,0,34,32
1656309764073,MATH 109,B01,083215,Ganzberger; Geoffrey Michael,4,0,32,28
1656309764073,MATH 109,B02,083216,Ganzberger; Geoffrey Michael,1,0,32,31
1656309764073,MATH 109,B03,093479,Staff,3,0,32,29
1656309770108,MATH 142A,A01,083219,Chow; Bennett,1,0,32,31
1656309770108,MATH 142A,A02,083220,Chow; Bennett,8,0,32,24
1656309770108,MATH 142A,A03,093480,Staff,5,0,32,27
1656309770108,MATH 142A,B03,093481,Staff,3,0,32,29
1656309770108,MATH 142A,B04,093558,Staff,6,0,32,26
1656309770108,MATH 142A,B05,093559,Staff,0,0,32,32
1656309776137,MATH 193A,A01,083224,Rotar; Vladimir,0,1,34,34
1656309776137,MATH 193A,A02,083225,Rotar; Vladimir,0,0,34,34
1656309776137,MATH 193A,A03,083781,Rotar; Vladimir,0,0,34,34
1656309776137,MATH 193A,A04,083782,Rotar; Vladimir,5,0,34,29
1656309776137,MATH 193A,A05,093482,Rotar; Vladimir,0,0,34,34
1656309782170,MATH 197,001,091859,McAuley; Julian John,9999,0,9999,0
1656309782170,MATH 197,002,095566,Kedlaya; Kiran S.,9997,0,9999,2
1656309782170,MATH 197,003,095567,Xiao; Ming,9999,0,9999,0
1656309782170,MATH 197,004,095571,Perols; Johan Lars,9998,0,9999,1
1656309789233,COGS 9,A01,083615,Shannon; Kyle Michael,3,0,75,72
1656309795260,COGS 11,A01,083617,Boyle; Mary E. T.,16,0,48,32
1656309801288,COGS 13,A01,083071,Bastos; Amalia Pinkusfeld,5,0,71,66
1656309807312,COGS 14A,A01,092681,Semenuks; Arturs,0,12,100,100
1656309813341,COGS 14B,A01,083073,Cheng; Tzu-Han,7,0,63,56
1656309819366,COGS 17,A01,092677,Semenuks; Arturs,6,0,81,75
1656309825393,COGS 100,A01,083619,Allen; Michael Gordon,2,0,70,68
1656309831423,COGS 101A,A01,083621,Davis; Joshua Daniel,4,0,68,64
1656309837452,COGS 101B,A01,091572,Allen; Michael Gordon,4,0,65,61
1656309843475,COGS 101C,A01,083625,Delgado; Tania,11,0,35,24
1656309849498,COGS 107A,A01,083627,Boyle; Mary E. T.,2,0,60,58
1656309855524,COGS 118A,A01,083075,Gupta; Anjum,7,0,76,69
1656309861552,CSE 3,A50,083646,Miranda; Gregory Joseph,18,0,50,32
1656309867578,CSE 8A,A50,083650,Miranda; Gregory Joseph,3,2,56,53
1656309873600,CSE 11,A01,083080,Cao; Yingjun,0,48,40,40
1656309879626,CSE 12,A01,083652,Krause-Levy; Sophia Louisa,5,1,120,115
1656309885654,CSE 15L,A01,083654,Morris; Justin Loren,2,0,50,48
1656309885654,CSE 15L,A02,083655,Morris; Justin Loren,4,0,50,46
1656309891680,CSE 20,A01,083657,Tran; Khoa Dang,30,0,80,50
1656309897708,CSE 21,A01,095574,Bach; Quang Tran,23,0,48,25
1656309903738,CSE 30,A01,083084,Eldon; John,1,4,80,79
1656309903738,CSE 30,B01,095061,Bhaskar; Nishant,0,1,50,50
1656309909761,CSE 100,A01,083659,Cao; Yingjun,1,18,70,69
1656309915786,CSE 134B,A01,083661,Powell; Thomas Allan,6,0,100,94
1656309921813,CSE 140,A01,083663,Gungor; Onat,9,0,85,76
1656309927836,CSE 140L,A01,083088,Eldon; John,10,0,100,90
1656309933862,CSE 175,A01,083665,Kumar; Rakesh,0,0,25,25
1656309939888,CSE 190,A00,092507,Dubnov; Shlomo,3,0,20,17
1656309945912,ECE 45,A01,083139,Congero; Spencer William,1,0,75,74
1656309951940,ECE 65,A50,083695,Saad; Andrew S,10,0,30,20
1656309951940,ECE 65,A51,095125,Staff,25,0,26,1
1656309957969,ECE 109,A01,091882,Touri; Behrouz,0,0,70,70
1656309963996,ECE 180,A00,083140,Abi Samra; Nicholas Camill,2,0,30,28
1656309963996,ECE 180,B00,083141,Abi Samra; Nicholas Camill,0,4,30,30
1656309970020,MATH 10A,A01,083735,Patchell; Gregory David,0,0,30,30
1656309970020,MATH 10A,A02,083736,Patchell; Gregory David,22,0,30,8
1656309970020,MATH 10A,A03,083737,Patchell; Gregory David,16,0,30,14
1656309976065,MATH 10B,A01,083207,Lim; Seonhee,2,0,34,32
1656309976065,MATH 10B,A02,083208,Lim; Seonhee,4,0,35,31
1656309976065,MATH 10B,A03,093472,Staff,1,0,34,33
1656309976065,MATH 10B,B01,083739,Sinha; Shubham,11,0,30,19
1656309982094,MATH 18,A01,083743,Cinel; Cameron Alexander,7,0,30,23
1656309982094,MATH 18,A02,083744,Cinel; Cameron Alexander,10,0,30,20
1656309982094,MATH 18,A03,083745,Cinel; Cameron Alexander,5,0,30,25
1656309982094,MATH 18,B01,083748,Rideout; David Porter,0,0,36,36
1656309982094,MATH 18,B02,083749,Rideout; David Porter,0,0,36,36
1656309982094,MATH 18,B03,083750,Rideout; David Porter,0,0,36,36
1656309982094,MATH 18,B04,083751,Rideout; David Porter,0,1,36,36
1656309982094,MATH 18,B05,093473,Rideout; David Porter,0,0,36,36
1656309982094,MATH 18,B06,093474,Rideout; David Porter,2,0,36,34
1656309988118,MATH 20A,A01,083754,Zheng; Zequn,11,0,40,29
1656309994146,MATH 20B,A01,083756,Briones; Jor-el Thomas Caparas,0,0,36,36
1656309994146,MATH 20B,A02,083757,Briones; Jor-el Thomas Caparas,0,0,36,36
1656309994146,MATH 20B,A03,093475,Staff,1,0,36,35
1656310000171,MATH 20C,A01,083760,Briones; Jor-el Thomas Caparas,0,0,35,35
1656310000171,MATH 20C,A02,083761,Briones; Jor-el Thomas Caparas,9,1,35,26
1656310000171,MATH 20C,A03,093476,Staff,0,0,35,35
1656310000171,MATH 20C,B01,083762,Bach; Quang Tran,2,0,30,28
1656310006196,MATH 20D,A01,083765,Tran; Brian Kha,1,0,30,29
1656310006196,MATH 20D,A02,083766,Tran; Brian Kha,0,0,30,30
1656310006196,MATH 20D,A03,083767,Tran; Brian Kha,2,0,30,28
1656310012225,MATH 20E,A01,083771,Ganguly; Soumya,2,0,32,30
1656310012225,MATH 20E,A02,083772,Ganguly; Soumya,0,0,32,32
1656310012225,MATH 20E,B01,083773,Ciotti; Benjamin,18,0,35,17
1656310012225,MATH 20E,B02,083774,Ciotti; Benjamin,15,0,35,20
1656310018250,MATH 103A,A01,083777,Greenfeld; Be'Eri,2,0,36,34
1656310018250,MATH 103A,A02,083778,Greenfeld; Be'Eri,3,0,36,33
1656310018250,MATH 103A,A03,093561,Staff,3,0,36,33
1656310018250,MATH 103A,B01,083779,Greenfeld; Be'Eri,8,0,36,28
1656310018250,MATH 103A,B02,083780,Greenfeld; Be'Eri,0,0,36,36
1656310018250,MATH 103A,B03,093562,Staff,1,0,36,35
1656310024280,MATH 105,A01,085443,Carter; Anne Toulson,4,0,35,31
1656310024280,MATH 105,A02,093477,Staff,14,0,35,21
1656310030309,MATH 109,A01,083213,Ganzberger; Geoffrey Michael,0,0,34,34
1656310030309,MATH 109,A02,083214,Ganzberger; Geoffrey Michael,0,0,34,34
1656310030309,MATH 109,A03,093478,Staff,2,0,34,32
1656310030309,MATH 109,B01,083215,Ganzberger; Geoffrey Michael,4,0,32,28
1656310030309,MATH 109,B02,083216,Ganzberger; Geoffrey Michael,0,0,32,32
1656310030309,MATH 109,B03,093479,Staff,3,0,32,29
1656310036338,MATH 142A,A01,083219,Chow; Bennett,1,0,32,31
1656310036338,MATH 142A,A02,083220,Chow; Bennett,8,0,32,24
1656310036338,MATH 142A,A03,093480,Staff,5,0,32,27
1656310036338,MATH 142A,B03,093481,Staff,3,0,32,29
1656310036338,MATH 142A,B04,093558,Staff,6,0,32,26
1656310036338,MATH 142A,B05,093559,Staff,0,0,32,32
1656310042360,MATH 193A,A01,083224,Rotar; Vladimir,0,1,34,34
1656310042360,MATH 193A,A02,083225,Rotar; Vladimir,0,0,34,34
1656310042360,MATH 193A,A03,083781,Rotar; Vladimir,0,0,34,34
1656310042360,MATH 193A,A04,083782,Rotar; Vladimir,5,0,34,29
1656310042360,MATH 193A,A05,093482,Rotar; Vladimir,0,0,34,34
1656310048391,MATH 197,001,091859,McAuley; Julian John,9999,0,9999,0
1656310048391,MATH 197,002,095566,Kedlaya; Kiran S.,9997,0,9999,2
1656310048391,MATH 197,003,095567,Xiao; Ming,9999,0,9999,0
1656310048391,MATH 197,004,095571,Perols; Johan Lars,9998,0,9999,1
1656310055447,COGS 9,A01,083615,Shannon; Kyle Michael,3,0,75,72
1656310061472,COGS 11,A01,083617,Boyle; Mary E. T.,16,0,48,32
1656310067494,COGS 13,A01,083071,Bastos; Amalia Pinkusfeld,5,0,71,66
1656310073517,COGS 14A,A01,092681,Semenuks; Arturs,0,12,100,100
1656310079562,COGS 14B,A01,083073,Cheng; Tzu-Han,7,0,63,56
1656310085584,COGS 17,A01,092677,Semenuks; Arturs,6,0,81,75
1656310091608,COGS 100,A01,083619,Allen; Michael Gordon,2,0,70,68
1656310097633,COGS 101A,A01,083621,Davis; Joshua Daniel,4,0,68,64
1656310103664,COGS 101B,A01,091572,Allen; Michael Gordon,4,0,65,61
1656310109691,COGS 101C,A01,083625,Delgado; Tania,11,0,35,24
1656310115715,COGS 107A,A01,083627,Boyle; Mary E. T.,2,0,60,58
1656310121743,COGS 118A,A01,083075,Gupta; Anjum,7,0,76,69
1656310127767,CSE 3,A50,083646,Miranda; Gregory Joseph,18,0,50,32
1656310133790,CSE 8A,A50,083650,Miranda; Gregory Joseph,3,2,56,53
1656310139821,CSE 11,A01,083080,Cao; Yingjun,0,48,40,40
1656310145853,CSE 12,A01,083652,Krause-Levy; Sophia Louisa,5,1,120,115
1656310151876,CSE 15L,A01,083654,Morris; Justin Loren,2,0,50,48
1656310151876,CSE 15L,A02,083655,Morris; Justin Loren,4,0,50,46
1656310157899,CSE 20,A01,083657,Tran; Khoa Dang,30,0,80,50
1656310163928,CSE 21,A01,095574,Bach; Quang Tran,23,0,48,25
1656310169953,CSE 30,A01,083084,Eldon; John,1,4,80,79
1656310169953,CSE 30,B01,095061,Bhaskar; Nishant,0,1,50,50
1656310175976,CSE 100,A01,083659,Cao; Yingjun,1,18,70,69
1656310181998,CSE 134B,A01,083661,Powell; Thomas Allan,6,0,100,94
1656310188026,CSE 140,A01,083663,Gungor; Onat,9,0,85,76
1656310194048,CSE 140L,A01,083088,Eldon; John,10,0,100,90
1656310200072,CSE 175,A01,083665,Kumar; Rakesh,0,0,25,25
1656310206095,CSE 190,A00,092507,Dubnov; Shlomo,3,0,20,17
1656310212123,ECE 45,A01,083139,Congero; Spencer William,1,0,75,74
1656310218151,ECE 65,A50,083695,Saad; Andrew S,10,0,30,20
1656310218151,ECE 65,A51,095125,Staff,25,0,26,1
1656310224188,ECE 109,A01,091882,Touri; Behrouz,0,0,70,70
1656310230216,ECE 180,A00,083140,Abi Samra; Nicholas Camill,2,0,30,28
1656310230216,ECE 180,B00,083141,Abi Samra; Nicholas Camill,0,4,30,30
1656310236243,MATH 10A,A01,083735,Patchell; Gregory David,0,0,30,30
1656310236243,MATH 10A,A02,083736,Patchell; Gregory David,22,0,30,8
1656310236243,MATH 10A,A03,083737,Patchell; Gregory David,16,0,30,14
1656310242266,MATH 10B,A01,083207,Lim; Seonhee,2,0,34,32
1656310242266,MATH 10B,A02,083208,Lim; Seonhee,4,0,35,31
1656310242266,MATH 10B,A03,093472,Staff,1,0,34,33
1656310242266,MATH 10B,B01,083739,Sinha; Shubham,11,0,30,19
1656310248296,MATH 18,A01,083743,Cinel; Cameron Alexander,7,0,30,23
1656310248296,MATH 18,A02,083744,Cinel; Cameron Alexander,10,0,30,20
1656310248296,MATH 18,A03,083745,Cinel; Cameron Alexander,5,0,30,25
1656310248296,MATH 18,B01,083748,Rideout; David Porter,0,0,36,36
1656310248296,MATH 18,B02,083749,Rideout; David Porter,0,0,36,36
1656310248296,MATH 18,B03,083750,Rideout; David Porter,0,0,36,36
1656310248296,MATH 18,B04,083751,Rideout; David Porter,0,1,36,36
1656310248296,MATH 18,B05,093473,Rideout; David Porter,0,0,36,36
1656310248296,MATH 18,B06,093474,Rideout; David Porter,2,0,36,34
1656310254319,MATH 20A,A01,083754,Zheng; Zequn,11,0,40,29
1656310260342,MATH 20B,A01,083756,Briones; Jor-el Thomas Caparas,0,0,36,36
1656310260342,MATH 20B,A02,083757,Briones; Jor-el Thomas Caparas,0,0,36,36
1656310260342,MATH 20B,A03,093475,Staff,1,0,36,35
1656310266441,MATH 20C,A01,083760,Briones; Jor-el Thomas Caparas,0,0,35,35
1656310266441,MATH 20C,A02,083761,Briones; Jor-el Thomas Caparas,9,1,35,26
1656310266441,MATH 20C,A03,093476,Staff,0,0,35,35
1656310266441,MATH 20C,B01,083762,Bach; Quang Tran,2,0,30,28
1656310272487,MATH 20D,A01,083765,Tran; Brian Kha,1,0,30,29
1656310272487,MATH 20D,A02,083766,Tran; Brian Kha,0,0,30,30
1656310272487,MATH 20D,A03,083767,Tran; Brian Kha,2,0,30,28
1656310278516,MATH 20E,A01,083771,Ganguly; Soumya,2,0,32,30
1656310278516,MATH 20E,A02,083772,Ganguly; Soumya,0,0,32,32
1656310278516,MATH 20E,B01,083773,Ciotti; Benjamin,18,0,35,17
1656310278516,MATH 20E,B02,083774,Ciotti; Benjamin,15,0,35,20
1656310284539,MATH 103A,A01,083777,Greenfeld; Be'Eri,2,0,36,34
1656310284539,MATH 103A,A02,083778,Greenfeld; Be'Eri,3,0,36,33
1656310284539,MATH 103A,A03,093561,Staff,3,0,36,33
1656310284539,MATH 103A,B01,083779,Greenfeld; Be'Eri,8,0,36,28
1656310284539,MATH 103A,B02,083780,Greenfeld; Be'Eri,0,0,36,36
1656310284539,MATH 103A,B03,093562,Staff,1,0,36,35
1656310290575,MATH 105,A01,085443,Carter; Anne Toulson,4,0,35,31
1656310290575,MATH 105,A02,093477,Staff,14,0,35,21
1656310296599,MATH 109,A01,083213,Ganzberger; Geoffrey Michael,0,0,34,34
1656310296599,MATH 109,A02,083214,Ganzberger; Geoffrey Michael,0,0,34,34
1656310296599,MATH 109,A03,093478,Staff,2,0,34,32
1656310296599,MATH 109,B01,083215,Ganzberger; Geoffrey Michael,4,0,32,28
1656310296599,MATH 109,B02,083216,Ganzberger; Geoffrey Michael,0,0,32,32
1656310296599,MATH 109,B03,093479,Staff,3,0,32,29
1656310302629,MATH 142A,A01,083219,Chow; Bennett,1,0,32,31
1656310302629,MATH 142A,A02,083220,Chow; Bennett,8,0,32,24
1656310302629,MATH 142A,A03,093480,Staff,5,0,32,27
1656310302629,MATH 142A,B03,093481,Staff,3,0,32,29
1656310302629,MATH 142A,B04,093558,Staff,6,0,32,26
1656310302629,MATH 142A,B05,093559,Staff,0,0,32,32
1656310308653,MATH 193A,A01,083224,Rotar; Vladimir,0,1,34,34
1656310308653,MATH 193A,A02,083225,Rotar; Vladimir,0,0,34,34
1656310308653,MATH 193A,A03,083781,Rotar; Vladimir,0,0,34,34
1656310308653,MATH 193A,A04,083782,Rotar; Vladimir,5,0,34,29
1656310308653,MATH 193A,A05,093482,Rotar; Vladimir,0,0,34,34
1656310314690,MATH 197,001,091859,McAuley; Julian John,9999,0,9999,0
1656310314690,MATH 197,002,095566,Kedlaya; Kiran S.,9997,0,9999,2
1656310314690,MATH 197,003,095567,Xiao; Ming,9999,0,9999,0
1656310314690,MATH 197,004,095571,Perols; Johan Lars,9998,0,9999,1
1656310321746,COGS 9,A01,083615,Shannon; Kyle Michael,3,0,75,72
1656310327771,COGS 11,A01,083617,Boyle; Mary E. T.,16,0,48,32
1656310333801,COGS 13,A01,083071,Bastos; Amalia Pinkusfeld,5,0,71,66
1656310339824,COGS 14A,A01,092681,Semenuks; Arturs,0,12,100,100
1656310345853,COGS 14B,A01,083073,Cheng; Tzu-Han,7,0,63,56
1656310351876,COGS 17,A01,092677,Semenuks; Arturs,6,0,81,75
1656310357903,COGS 100,A01,083619,Allen; Michael Gordon,2,0,70,68
1656310363927,COGS 101A,A01,083621,Davis; Joshua Daniel,4,0,68,64
1656310369950,COGS 101B,A01,091572,Allen; Michael Gordon,4,0,65,61
1656310375974,COGS 101C,A01,083625,Delgado; Tania,11,0,35,24
1656310383863,COGS 107A,A01,083627,Boyle; Mary E. T.,2,0,60,58
1656310389886,COGS 118A,A01,083075,Gupta; Anjum,7,0,76,69
1656310395914,CSE 3,A50,083646,Miranda; Gregory Joseph,18,0,50,32
1656310401952,CSE 8A,A50,083650,Miranda; Gregory Joseph,3,2,56,53
1656310407975,CSE 11,A01,083080,Cao; Yingjun,0,48,40,40
1656310413999,CSE 12,A01,083652,Krause-Levy; Sophia Louisa,5,1,120,115
1656310420035,CSE 15L,A01,083654,Morris; Justin Loren,2,0,50,48
1656310420035,CSE 15L,A02,083655,Morris; Justin Loren,4,0,50,46
1656310426062,CSE 20,A01,083657,Tran; Khoa Dang,30,0,80,50
1656310432085,CSE 21,A01,095574,Bach; Quang Tran,23,0,48,25
1656310438109,CSE 30,A01,083084,Eldon; John,1,4,80,79
1656310438109,CSE 30,B01,095061,Bhaskar; Nishant,0,1,50,50
1656310444133,CSE 100,A01,083659,Cao; Yingjun,1,18,70,69
1656310450159,CSE 134B,A01,083661,Powell; Thomas Allan,6,0,100,94
1656310456186,CSE 140,A01,083663,Gungor; Onat,9,0,85,76
1656310462209,CSE 140L,A01,083088,Eldon; John,10,0,100,90
1656310468235,CSE 175,A01,083665,Kumar; Rakesh,0,0,25,25
1656310474259,CSE 190,A00,092507,Dubnov; Shlomo,3,0,20,17
1656310480288,ECE 45,A01,083139,Congero; Spencer William,1,0,75,74
1656310486315,ECE 65,A50,083695,Saad; Andrew S,10,0,30,20
1656310486315,ECE 65,A51,095125,Staff,25,0,26,1
1656310492339,ECE 109,A01,091882,Touri; Behrouz,0,0,70,70
1656310498365,ECE 180,A00,083140,Abi Samra; Nicholas Camill,2,0,30,28
1656310498365,ECE 180,B00,083141,Abi Samra; Nicholas Camill,0,4,30,30
1656310504388,MATH 10A,A01,083735,Patchell; Gregory David,0,0,30,30
1656310504388,MATH 10A,A02,083736,Patchell; Gregory David,22,0,30,8
1656310504388,MATH 10A,A03,083737,Patchell; Gregory David,16,0,30,14
1656310510417,MATH 10B,A01,083207,Lim; Seonhee,2,0,34,32
1656310510417,MATH 10B,A02,083208,Lim; Seonhee,4,0,35,31
1656310510417,MATH 10B,A03,093472,Staff,1,0,34,33
1656310510417,MATH 10B,B01,083739,Sinha; Shubham,11,0,30,19
1656310516441,MATH 18,A01,083743,Cinel; Cameron Alexander,7,0,30,23
1656310516441,MATH 18,A02,083744,Cinel; Cameron Alexander,10,0,30,20
1656310516441,MATH 18,A03,083745,Cinel; Cameron Alexander,5,0,30,25
1656310516441,MATH 18,B01,083748,Rideout; David Porter,0,0,36,36
1656310516441,MATH 18,B02,083749,Rideout; David Porter,0,0,36,36
1656310516441,MATH 18,B03,083750,Rideout; David Porter,0,0,36,36
1656310516441,MATH 18,B04,083751,Rideout; David Porter,0,1,36,36
1656310516441,MATH 18,B05,093473,Rideout; David Porter,0,0,36,36
1656310516441,MATH 18,B06,093474,Rideout; David Porter,2,0,36,34
1656310522464,MATH 20A,A01,083754,Zheng; Zequn,11,0,40,29
1656310528491,MATH 20B,A01,083756,Briones; Jor-el Thomas Caparas,0,0,36,36
1656310528491,MATH 20B,A02,083757,Briones; Jor-el Thomas Caparas,0,0,36,36
1656310528491,MATH 20B,A03,093475,Staff,1,0,36,35
1656310534518,MATH 20C,A01,083760,Briones; Jor-el Thomas Caparas,0,0,35,35
1656310534518,MATH 20C,A02,083761,Briones; Jor-el Thomas Caparas,9,1,35,26
1656310534518,MATH 20C,A03,093476,Staff,0,0,35,35
1656310534518,MATH 20C,B01,083762,Bach; Quang Tran,2,0,30,28
1656310540542,MATH 20D,A01,083765,Tran; Brian Kha,1,0,30,29
1656310540542,MATH 20D,A02,083766,Tran; Brian Kha,0,0,30,30
1656310540542,MATH 20D,A03,083767,Tran; Brian Kha,2,0,30,28
1656310546570,MATH 20E,A01,083771,Ganguly; Soumya,1,0,32,31
1656310546570,MATH 20E,A02,083772,Ganguly; Soumya,0,0,32,32
1656310546570,MATH 20E,B01,083773,Ciotti; Benjamin,18,0,35,17
1656310546570,MATH 20E,B02,083774,Ciotti; Benjamin,15,0,35,20
1656310552595,MATH 103A,A01,083777,Greenfeld; Be'Eri,2,0,36,34
1656310552595,MATH 103A,A02,083778,Greenfeld; Be'Eri,3,0,36,33
1656310552595,MATH 103A,A03,093561,Staff,3,0,36,33
1656310552595,MATH 103A,B01,083779,Greenfeld; Be'Eri,8,0,36,28
1656310552595,MATH 103A,B02,083780,Greenfeld; Be'Eri,0,0,36,36
1656310552595,MATH 103A,B03,093562,Staff,1,0,36,35
1656310558623,MATH 105,A01,085443,Carter; Anne Toulson,4,0,35,31
1656310558623,MATH 105,A02,093477,Staff,14,0,35,21
1656310564648,MATH 109,A01,083213,Ganzberger; Geoffrey Michael,0,0,34,34
1656310564648,MATH 109,A02,083214,Ganzberger; Geoffrey Michael,0,0,34,34
1656310564648,MATH 109,A03,093478,Staff,2,0,34,32
1656310564648,MATH 109,B01,083215,Ganzberger; Geoffrey Michael,4,0,32,28
1656310564648,MATH 109,B02,083216,Ganzberger; Geoffrey Michael,0,0,32,32
1656310564648,MATH 109,B03,093479,Staff,3,0,32,29
1656310570671,MATH 142A,A01,083219,Chow; Bennett,1,0,32,31
1656310570671,MATH 142A,A02,083220,Chow; Bennett,8,0,32,24
1656310570671,MATH 142A,A03,093480,Staff,5,0,32,27
1656310570671,MATH 142A,B03,093481,Staff,3,0,32,29
1656310570671,MATH 142A,B04,093558,Staff,6,0,32,26
1656310570671,MATH 142A,B05,093559,Staff,0,0,32,32
1656310576700,MATH 193A,A01,083224,Rotar; Vladimir,0,1,34,34
1656310576700,MATH 193A,A02,083225,Rotar; Vladimir,0,0,34,34
1656310576700,MATH 193A,A03,083781,Rotar; Vladimir,0,0,34,34
1656310576700,MATH 193A,A04,083782,Rotar; Vladimir,5,0,34,29
1656310576700,MATH 193A,A05,093482,Rotar; Vladimir,0,0,34,34
1656310582723,MATH 197,001,091859,McAuley; Julian John,9999,0,9999,0
1656310582723,MATH 197,002,095566,Kedlaya; Kiran S.,9997,0,9999,2
1656310582723,MATH 197,003,095567,Xiao; Ming,9999,0,9999,0
1656310582723,MATH 197,004,095571,Perols; Johan Lars,9998,0,9999,1
1656310589781,COGS 9,A01,083615,Shannon; Kyle Michael,3,0,75,72
1656310595805,COGS 11,A01,083617,Boyle; Mary E. T.,16,0,48,32
1656310601833,COGS 13,A01,083071,Bastos; Amalia Pinkusfeld,5,0,71,66
1656310607856,COGS 14A,A01,092681,Semenuks; Arturs,0,12,100,100
1656310613882,COGS 14B,A01,083073,Cheng; Tzu-Han,7,0,63,56
1656310619905,COGS 17,A01,092677,Semenuks; Arturs,6,0,81,75
1656310625941,COGS 100,A01,083619,Allen; Michael Gordon,2,0,70,68
1656310631965,COGS 101A,A01,083621,Davis; Joshua Daniel,4,0,68,64
1656310637989,COGS 101B,A01,091572,Allen; Michael Gordon,4,0,65,61
1656310644014,COGS 101C,A01,083625,Delgado; Tania,11,0,35,24
1656310650038,COGS 107A,A01,083627,Boyle; Mary E. T.,2,0,60,58
1656310656061,COGS 118A,A01,083075,Gupta; Anjum,7,0,76,69
1656310662090,CSE 3,A50,083646,Miranda; Gregory Joseph,18,0,50,32
1656310668114,CSE 8A,A50,083650,Miranda; Gregory Joseph,3,2,56,53
1656310674141,CSE 11,A01,083080,Cao; Yingjun,0,48,40,40
1656310680165,CSE 12,A01,083652,Krause-Levy; Sophia Louisa,5,1,120,115
1656310686193,CSE 15L,A01,083654,Morris; Justin Loren,2,0,50,48
1656310686193,CSE 15L,A02,083655,Morris; Justin Loren,4,0,50,46
1656310692221,CSE 20,A01,083657,Tran; Khoa Dang,30,0,80,50
1656310698243,CSE 21,A01,095574,Bach; Quang Tran,23,0,48,25
1656310704272,CSE 30,A01,083084,Eldon; John,1,4,80,79
1656310704272,CSE 30,B01,095061,Bhaskar; Nishant,0,1,50,50
1656310710295,CSE 100,A01,083659,Cao; Yingjun,1,18,70,69
1656310716325,CSE 134B,A01,083661,Powell; Thomas Allan,6,0,100,94
1656310722354,CSE 140,A01,083663,Gungor; Onat,9,0,85,76
1656310728382,CSE 140L,A01,083088,Eldon; John,10,0,100,90
1656310734410,CSE 175,A01,083665,Kumar; Rakesh,0,0,25,25
1656310740447,CSE 190,A00,092507,Dubnov; Shlomo,3,0,20,17
1656310746483,ECE 45,A01,083139,Congero; Spencer William,1,0,75,74
1656310752515,ECE 65,A50,083695,Saad; Andrew S,10,0,30,20
1656310752515,ECE 65,A51,095125,Staff,25,0,26,1
1656310758565,ECE 109,A01,091882,Touri; Behrouz,0,0,70,70
1656310764591,ECE 180,A00,083140,Abi Samra; Nicholas Camill,2,0,30,28
1656310764591,ECE 180,B00,083141,Abi Samra; Nicholas Camill,0,4,30,30
1656310770616,MATH 10A,A01,083735,Patchell; Gregory David,0,0,30,30
1656310770616,MATH 10A,A02,083736,Patchell; Gregory David,22,0,30,8
1656310770616,MATH 10A,A03,083737,Patchell; Gregory David,16,0,30,14
1656310776641,MATH 10B,A01,083207,Lim; Seonhee,2,0,34,32
1656310776641,MATH 10B,A02,083208,Lim; Seonhee,4,0,35,31
1656310776641,MATH 10B,A03,093472,Staff,1,0,34,33
1656310776641,MATH 10B,B01,083739,Sinha; Shubham,11,0,30,19
1656310782664,MATH 18,A01,083743,Cinel; Cameron Alexander,7,0,30,23
1656310782664,MATH 18,A02,083744,Cinel; Cameron Alexander,10,0,30,20
1656310782664,MATH 18,A03,083745,Cinel; Cameron Alexander,5,0,30,25
1656310782664,MATH 18,B01,083748,Rideout; David Porter,0,0,36,36
1656310782664,MATH 18,B02,083749,Rideout; David Porter,0,0,36,36
1656310782664,MATH 18,B03,083750,Rideout; David Porter,0,0,36,36
1656310782664,MATH 18,B04,083751,Rideout; David Porter,0,1,36,36
1656310782664,MATH 18,B05,093473,Rideout; David Porter,0,0,36,36
1656310782664,MATH 18,B06,093474,Rideout; David Porter,2,0,36,34
1656310788689,MATH 20A,A01,083754,Zheng; Zequn,11,0,40,29
1656310794714,MATH 20B,A01,083756,Briones; Jor-el Thomas Caparas,0,0,36,36
1656310794714,MATH 20B,A02,083757,Briones; Jor-el Thomas Caparas,0,0,36,36
1656310794714,MATH 20B,A03,093475,Staff,1,0,36,35
1656310800741,MATH 20C,A01,083760,Briones; Jor-el Thomas Caparas,0,0,35,35
1656310800741,MATH 20C,A02,083761,Briones; Jor-el Thomas Caparas,9,1,35,26
1656310800741,MATH 20C,A03,093476,Staff,0,0,35,35
1656310800741,MATH 20C,B01,083762,Bach; Quang Tran,2,0,30,28
1656310806771,MATH 20D,A01,083765,Tran; Brian Kha,1,0,30,29
1656310806771,MATH 20D,A02,083766,Tran; Brian Kha,0,0,30,30
1656310806771,MATH 20D,A03,083767,Tran; Brian Kha,2,0,30,28
1656310812800,MATH 20E,A01,083771,Ganguly; Soumya,1,0,32,31
1656310812800,MATH 20E,A02,083772,Ganguly; Soumya,0,0,32,32
1656310812800,MATH 20E,B01,083773,Ciotti; Benjamin,18,0,35,17
1656310812800,MATH 20E,B02,083774,Ciotti; Benjamin,15,0,35,20
1656310818824,MATH 103A,A01,083777,Greenfeld; Be'Eri,2,0,36,34
1656310818824,MATH 103A,A02,083778,Greenfeld; Be'Eri,3,0,36,33
1656310818824,MATH 103A,A03,093561,Staff,3,0,36,33
1656310818824,MATH 103A,B01,083779,Greenfeld; Be'Eri,8,0,36,28
1656310818824,MATH 103A,B02,083780,Greenfeld; Be'Eri,0,0,36,36
1656310818824,MATH 103A,B03,093562,Staff,1,0,36,35
1656310824848,MATH 105,A01,085443,Carter; Anne Toulson,4,0,35,31
1656310824848,MATH 105,A02,093477,Staff,14,0,35,21
1656310830872,MATH 109,A01,083213,Ganzberger; Geoffrey Michael,0,0,34,34
1656310830872,MATH 109,A02,083214,Ganzberger; Geoffrey Michael,0,0,34,34
1656310830872,MATH 109,A03,093478,Staff,2,0,34,32
1656310830872,MATH 109,B01,083215,Ganzberger; Geoffrey Michael,4,0,32,28
1656310830872,MATH 109,B02,083216,Ganzberger; Geoffrey Michael,0,0,32,32
1656310830872,MATH 109,B03,093479,Staff,3,0,32,29
1656310836900,MATH 142A,A01,083219,Chow; Bennett,1,0,32,31
1656310836900,MATH 142A,A02,083220,Chow; Bennett,8,0,32,24
1656310836900,MATH 142A,A03,093480,Staff,5,0,32,27
1656310836900,MATH 142A,B03,093481,Staff,3,0,32,29
1656310836900,MATH 142A,B04,093558,Staff,6,0,32,26
1656310836900,MATH 142A,B05,093559,Staff,0,0,32,32
1656310842923,MATH 193A,A01,083224,Rotar; Vladimir,0,1,34,34
1656310842923,MATH 193A,A02,083225,Rotar; Vladimir,0,0,34,34
1656310842923,MATH 193A,A03,083781,Rotar; Vladimir,0,0,34,34
1656310842923,MATH 193A,A04,083782,Rotar; Vladimir,5,0,34,29
1656310842923,MATH 193A,A05,093482,Rotar; Vladimir,0,0,34,34
1656310848961,MATH 197,001,091859,McAuley; Julian John,9999,0,9999,0
1656310848961,MATH 197,002,095566,Kedlaya; Kiran S.,9997,0,9999,2
1656310848961,MATH 197,003,095567,Xiao; Ming,9999,0,9999,0
1656310848961,MATH 197,004,095571,Perols; Johan Lars,9998,0,9999,1
1656310856024,COGS 9,A01,083615,Shannon; Kyle Michael,3,0,75,72
1656310862144,COGS 11,A01,083617,Boyle; Mary E. T.,16,0,48,32
1656310868177,COGS 13,A01,083071,Bastos; Amalia Pinkusfeld,5,0,71,66
1656310874200,COGS 14A,A01,092681,Semenuks; Arturs,0,12,100,100
1656310880229,COGS 14B,A01,083073,Cheng; Tzu-Han,7,0,63,56
1656310886253,COGS 17,A01,092677,Semenuks; Arturs,6,0,81,75
1656310892278,COGS 100,A01,083619,Allen; Michael Gordon,3,0,70,67
1656310898309,COGS 101A,A01,083621,Davis; Joshua Daniel,4,0,68,64
1656310904332,COGS 101B,A01,091572,Allen; Michael Gordon,4,0,65,61
1656310910355,COGS 101C,A01,083625,Delgado; Tania,11,0,35,24
1656310916377,COGS 107A,A01,083627,Boyle; Mary E. T.,2,0,60,58
1656310922401,COGS 118A,A01,083075,Gupta; Anjum,7,0,76,69
1656310928428,CSE 3,A50,083646,Miranda; Gregory Joseph,18,0,50,32
1656310934459,CSE 8A,A50,083650,Miranda; Gregory Joseph,3,2,56,53
1656310940491,CSE 11,A01,083080,Cao; Yingjun,0,48,40,40
1656310946514,CSE 12,A01,083652,Krause-Levy; Sophia Louisa,5,1,120,115
1656310952538,CSE 15L,A01,083654,Morris; Justin Loren,2,0,50,48
1656310952538,CSE 15L,A02,083655,Morris; Justin Loren,4,0,50,46
1656310958562,CSE 20,A01,083657,Tran; Khoa Dang,30,0,80,50
1656310964588,CSE 21,A01,095574,Bach; Quang Tran,23,0,48,25
1656310970611,CSE 30,A01,083084,Eldon; John,1,4,80,79
1656310970611,CSE 30,B01,095061,Bhaskar; Nishant,0,1,50,50
1656310976635,CSE 100,A01,083659,Cao; Yingjun,1,18,70,69
1656310982667,CSE 134B,A01,083661,Powell; Thomas Allan,6,0,100,94
1656310988692,CSE 140,A01,083663,Gungor; Onat,9,0,85,76
1656310994714,CSE 140L,A01,083088,Eldon; John,10,0,100,90
1656311000751,CSE 175,A01,083665,Kumar; Rakesh,0,0,25,25
1656311006775,CSE 190,A00,092507,Dubnov; Shlomo,3,0,20,17
1656311012800,ECE 45,A01,083139,Congero; Spencer William,1,0,75,74
1656311018831,ECE 65,A50,083695,Saad; Andrew S,10,0,30,20
1656311018831,ECE 65,A51,095125,Staff,25,0,26,1
1656311024853,ECE 109,A01,091882,Touri; Behrouz,0,0,70,70
1656311030877,ECE 180,A00,083140,Abi Samra; Nicholas Camill,2,0,30,28
1656311030877,ECE 180,B00,083141,Abi Samra; Nicholas Camill,0,4,30,30
1656311036900,MATH 10A,A01,083735,Patchell; Gregory David,0,0,30,30
1656311036900,MATH 10A,A02,083736,Patchell; Gregory David,22,0,30,8
1656311036900,MATH 10A,A03,083737,Patchell; Gregory David,16,0,30,14
1656311042954,MATH 10B,A01,083207,Lim; Seonhee,2,0,34,32
1656311042954,MATH 10B,A02,083208,Lim; Seonhee,4,0,35,31
1656311042954,MATH 10B,A03,093472,Staff,1,0,34,33
1656311042954,MATH 10B,B01,083739,Sinha; Shubham,11,0,30,19
1656311048978,MATH 18,A01,083743,Cinel; Cameron Alexander,7,0,30,23
1656311048978,MATH 18,A02,083744,Cinel; Cameron Alexander,10,0,30,20
1656311048978,MATH 18,A03,083745,Cinel; Cameron Alexander,5,0,30,25
1656311048978,MATH 18,B01,083748,Rideout; David Porter,0,0,36,36
1656311048978,MATH 18,B02,083749,Rideout; David Porter,0,0,36,36
1656311048978,MATH 18,B03,083750,Rideout; David Porter,0,0,36,36
1656311048978,MATH 18,B04,083751,Rideout; David Porter,0,1,36,36
1656311048978,MATH 18,B05,093473,Rideout; David Porter,0,0,36,36
1656311048978,MATH 18,B06,093474,Rideout; David Porter,2,0,36,34
1656311055002,MATH 20A,A01,083754,Zheng; Zequn,11,0,40,29
1656311061029,MATH 20B,A01,083756,Briones; Jor-el Thomas Caparas,0,0,36,36
1656311061029,MATH 20B,A02,083757,Briones; Jor-el Thomas Caparas,0,0,36,36
1656311061029,MATH 20B,A03,093475,Staff,1,0,36,35
1656311067055,MATH 20C,A01,083760,Briones; Jor-el Thomas Caparas,0,0,35,35
1656311067055,MATH 20C,A02,083761,Briones; Jor-el Thomas Caparas,9,1,35,26
1656311067055,MATH 20C,A03,093476,Staff,0,0,35,35
1656311067055,MATH 20C,B01,083762,Bach; Quang Tran,2,0,30,28
1656311073096,MATH 20D,A01,083765,Tran; Brian Kha,1,0,30,29
1656311073096,MATH 20D,A02,083766,Tran; Brian Kha,0,0,30,30
1656311073096,MATH 20D,A03,083767,Tran; Brian Kha,2,0,30,28
1656311079130,MATH 20E,A01,083771,Ganguly; Soumya,1,0,32,31
1656311079130,MATH 20E,A02,083772,Ganguly; Soumya,0,0,32,32
1656311079130,MATH 20E,B01,083773,Ciotti; Benjamin,18,0,35,17
1656311079130,MATH 20E,B02,083774,Ciotti; Benjamin,16,0,35,19
1656311085166,MATH 103A,A01,083777,Greenfeld; Be'Eri,2,0,36,34
1656311085166,MATH 103A,A02,083778,Greenfeld; Be'Eri,3,0,36,33
1656311085166,MATH 103A,A03,093561,Staff,3,0,36,33
1656311085166,MATH 103A,B01,083779,Greenfeld; Be'Eri,8,0,36,28
1656311085166,MATH 103A,B02,083780,Greenfeld; Be'Eri,0,0,36,36
1656311085166,MATH 103A,B03,093562,Staff,1,0,36,35
1656311091189,MATH 105,A01,085443,Carter; Anne Toulson,4,0,35,31
1656311091189,MATH 105,A02,093477,Staff,14,0,35,21
1656311097218,MATH 109,A01,083213,Ganzberger; Geoffrey Michael,0,0,34,34
1656311097218,MATH 109,A02,083214,Ganzberger; Geoffrey Michael,0,0,34,34
1656311097218,MATH 109,A03,093478,Staff,2,0,34,32
1656311097218,MATH 109,B01,083215,Ganzberger; Geoffrey Michael,4,0,32,28
1656311097218,MATH 109,B02,083216,Ganzberger; Geoffrey Michael,0,0,32,32
1656311097218,MATH 109,B03,093479,Staff,3,0,32,29
1656311103245,MATH 142A,A01,083219,Chow; Bennett,1,0,32,31
1656311103245,MATH 142A,A02,083220,Chow; Bennett,8,0,32,24
1656311103245,MATH 142A,A03,093480,Staff,5,0,32,27
1656311103245,MATH 142A,B03,093481,Staff,3,0,32,29
1656311103245,MATH 142A,B04,093558,Staff,6,0,32,26
1656311103245,MATH 142A,B05,093559,Staff,0,0,32,32
1656311109271,MATH 193A,A01,083224,Rotar; Vladimir,0,1,34,34
1656311109271,MATH 193A,A02,083225,Rotar; Vladimir,0,0,34,34
1656311109271,MATH 193A,A03,083781,Rotar; Vladimir,0,0,34,34
1656311109271,MATH 193A,A04,083782,Rotar; Vladimir,5,0,34,29
1656311109271,MATH 193A,A05,093482,Rotar; Vladimir,0,0,34,34
1656311115295,MATH 197,001,091859,McAuley; Julian John,9999,0,9999,0
1656311115295,MATH 197,002,095566,Kedlaya; Kiran S.,9997,0,9999,2
1656311115295,MATH 197,003,095567,Xiao; Ming,9999,0,9999,0
1656311115295,MATH 197,004,095571,Perols; Johan Lars,9998,0,9999,1
1656311122354,COGS 9,A01,083615,Shannon; Kyle Michael,3,0,75,72
1656311128378,COGS 11,A01,083617,Boyle; Mary E. T.,16,0,48,32
1656311134405,COGS 13,A01,083071,Bastos; Amalia Pinkusfeld,5,0,71,66
1656311140429,COGS 14A,A01,092681,Semenuks; Arturs,0,12,100,100
1656311146452,COGS 14B,A01,083073,Cheng; Tzu-Han,7,0,63,56
1656311152486,COGS 17,A01,092677,Semenuks; Arturs,6,0,81,75
1656311158510,COGS 100,A01,083619,Allen; Michael Gordon,3,0,70,67
1656311164538,COGS 101A,A01,083621,Davis; Joshua Daniel,5,0,68,63
1656311170566,COGS 101B,A01,091572,Allen; Michael Gordon,4,0,65,61
1656311176591,COGS 101C,A01,083625,Delgado; Tania,11,0,35,24
1656311182619,COGS 107A,A01,083627,Boyle; Mary E. T.,2,0,60,58
1656311188650,COGS 118A,A01,083075,Gupta; Anjum,7,0,76,69
1656311194678,CSE 3,A50,083646,Miranda; Gregory Joseph,18,0,50,32
1656311200700,CSE 8A,A50,083650,Miranda; Gregory Joseph,3,2,56,53
1656311206735,CSE 11,A01,083080,Cao; Yingjun,0,48,40,40
1656311212760,CSE 12,A01,083652,Krause-Levy; Sophia Louisa,5,1,120,115
1656311218783,CSE 15L,A01,083654,Morris; Justin Loren,2,0,50,48
1656311218783,CSE 15L,A02,083655,Morris; Justin Loren,4,0,50,46
1656311224811,CSE 20,A01,083657,Tran; Khoa Dang,30,0,80,50
1656311230840,CSE 21,A01,095574,Bach; Quang Tran,23,0,48,25
1656311236870,CSE 30,A01,083084,Eldon; John,1,4,80,79
1656311236870,CSE 30,B01,095061,Bhaskar; Nishant,0,1,50,50
1656311242893,CSE 100,A01,083659,Cao; Yingjun,1,18,70,69
1656311248924,CSE 134B,A01,083661,Powell; Thomas Allan,6,0,100,94
1656311254953,CSE 140,A01,083663,Gungor; Onat,9,0,85,76
1656311260982,CSE 140L,A01,083088,Eldon; John,10,0,100,90
1656311267010,CSE 175,A01,083665,Kumar; Rakesh,0,0,25,25
1656311273037,CSE 190,A00,092507,Dubnov; Shlomo,3,0,20,17
1656311279066,ECE 45,A01,083139,Congero; Spencer William,1,0,75,74
1656311285092,ECE 65,A50,083695,Saad; Andrew S,10,0,30,20
1656311285092,ECE 65,A51,095125,Staff,25,0,26,1
1656311291119,ECE 109,A01,091882,Touri; Behrouz,0,0,70,70
1656311297143,ECE 180,A00,083140,Abi Samra; Nicholas Camill,2,0,30,28
1656311297143,ECE 180,B00,083141,Abi Samra; Nicholas Camill,0,4,30,30
1656311303170,MATH 10A,A01,083735,Patchell; Gregory David,0,0,30,30
1656311303170,MATH 10A,A02,083736,Patchell; Gregory David,22,0,30,8
1656311303170,MATH 10A,A03,083737,Patchell; Gregory David,16,0,30,14
1656311309193,MATH 10B,A01,083207,Lim; Seonhee,2,0,34,32
1656311309193,MATH 10B,A02,083208,Lim; Seonhee,4,0,35,31
1656311309193,MATH 10B,A03,093472,Staff,1,0,34,33
1656311309193,MATH 10B,B01,083739,Sinha; Shubham,11,0,30,19
1656311315219,MATH 18,A01,083743,Cinel; Cameron Alexander,7,0,30,23
1656311315219,MATH 18,A02,083744,Cinel; Cameron Alexander,10,0,30,20
1656311315219,MATH 18,A03,083745,Cinel; Cameron Alexander,5,0,30,25
1656311315219,MATH 18,B01,083748,Rideout; David Porter,0,0,36,36
1656311315219,MATH 18,B02,083749,Rideout; David Porter,0,0,36,36
1656311315219,MATH 18,B03,083750,Rideout; David Porter,0,0,36,36
1656311315219,MATH 18,B04,083751,Rideout; David Porter,0,1,36,36
1656311315219,MATH 18,B05,093473,Rideout; David Porter,0,0,36,36
1656311315219,MATH 18,B06,093474,Rideout; David Porter,2,0,36,34
1656311321242,MATH 20A,A01,083754,Zheng; Zequn,11,0,40,29
1656311327264,MATH 20B,A01,083756,Briones; Jor-el Thomas Caparas,0,0,36,36
1656311327264,MATH 20B,A02,083757,Briones; Jor-el Thomas Caparas,0,0,36,36
1656311327264,MATH 20B,A03,093475,Staff,1,0,36,35
1656311333299,MATH 20C,A01,083760,Briones; Jor-el Thomas Caparas,0,0,35,35
1656311333299,MATH 20C,A02,083761,Briones; Jor-el Thomas Caparas,9,1,35,26
1656311333299,MATH 20C,A03,093476,Staff,0,0,35,35
1656311333299,MATH 20C,B01,083762,Bach; Quang Tran,2,0,30,28
1656311339331,MATH 20D,A01,083765,Tran; Brian Kha,1,0,30,29
1656311339331,MATH 20D,A02,083766,Tran; Brian Kha,0,0,30,30
1656311339331,MATH 20D,A03,083767,Tran; Brian Kha,2,0,30,28
1656311345362,MATH 20E,A01,083771,Ganguly; Soumya,1,0,32,31
1656311345362,MATH 20E,A02,083772,Ganguly; Soumya,0,0,32,32
1656311345362,MATH 20E,B01,083773,Ciotti; Benjamin,18,0,35,17
1656311345362,MATH 20E,B02,083774,Ciotti; Benjamin,16,0,35,19
1656311351388,MATH 103A,A01,083777,Greenfeld; Be'Eri,2,0,36,34
1656311351388,MATH 103A,A02,083778,Greenfeld; Be'Eri,3,0,36,33
1656311351388,MATH 103A,A03,093561,Staff,3,0,36,33
1656311351388,MATH 103A,B01,083779,Greenfeld; Be'Eri,8,0,36,28
1656311351388,MATH 103A,B02,083780,Greenfeld; Be'Eri,0,0,36,36
1656311351388,MATH 103A,B03,093562,Staff,1,0,36,35
1656311357413,MATH 105,A01,085443,Carter; Anne Toulson,3,0,35,32
1656311357413,MATH 105,A02,093477,Staff,15,0,35,20
1656311363443,MATH 109,A01,083213,Ganzberger; Geoffrey Michael,0,0,34,34
1656311363443,MATH 109,A02,083214,Ganzberger; Geoffrey Michael,0,0,34,34
1656311363443,MATH 109,A03,093478,Staff,2,0,34,32
1656311363443,MATH 109,B01,083215,Ganzberger; Geoffrey Michael,4,0,32,28
1656311363443,MATH 109,B02,083216,Ganzberger; Geoffrey Michael,0,0,32,32
1656311363443,MATH 109,B03,093479,Staff,3,0,32,29
1656311369468,MATH 142A,A01,083219,Chow; Bennett,1,0,32,31
1656311369468,MATH 142A,A02,083220,Chow; Bennett,8,0,32,24
1656311369468,MATH 142A,A03,093480,Staff,5,0,32,27
1656311369468,MATH 142A,B03,093481,Staff,3,0,32,29
1656311369468,MATH 142A,B04,093558,Staff,7,0,32,25
1656311369468,MATH 142A,B05,093559,Staff,0,0,32,32
1656311375498,MATH 193A,A01,083224,Rotar; Vladimir,0,1,34,34
1656311375498,MATH 193A,A02,083225,Rotar; Vladimir,0,0,34,34
1656311375498,MATH 193A,A03,083781,Rotar; Vladimir,0,0,34,34
1656311375498,MATH 193A,A04,083782,Rotar; Vladimir,5,0,34,29
1656311375498,MATH 193A,A05,093482,Rotar; Vladimir,0,0,34,34
1656311381521,MATH 197,001,091859,McAuley; Julian John,9999,0,9999,0
1656311381521,MATH 197,002,095566,Kedlaya; Kiran S.,9997,0,9999,2
1656311381521,MATH 197,003,095567,Xiao; Ming,9999,0,9999,0
1656311381521,MATH 197,004,095571,Perols; Johan Lars,9998,0,9999,1
1656311388575,COGS 9,A01,083615,Shannon; Kyle Michael,3,0,75,72
1656311394601,COGS 11,A01,083617,Boyle; Mary E. T.,16,0,48,32
1656311400637,COGS 13,A01,083071,Bastos; Amalia Pinkusfeld,5,0,71,66
1656311406665,COGS 14A,A01,092681,Semenuks; Arturs,0,12,100,100
1656311412692,COGS 14B,A01,083073,Cheng; Tzu-Han,7,0,63,56
1656311418716,COGS 17,A01,092677,Semenuks; Arturs,6,0,81,75
1656311424742,COGS 100,A01,083619,Allen; Michael Gordon,3,0,70,67
1656311430765,COGS 101A,A01,083621,Davis; Joshua Daniel,5,0,68,63
1656311436792,COGS 101B,A01,091572,Allen; Michael Gordon,4,0,65,61
1656311442833,COGS 101C,A01,083625,Delgado; Tania,11,0,35,24
1656311448860,COGS 107A,A01,083627,Boyle; Mary E. T.,2,0,60,58
1656311454883,COGS 118A,A01,083075,Gupta; Anjum,7,0,76,69
1656311460986,CSE 3,A50,083646,Miranda; Gregory Joseph,18,0,50,32
1656311467015,CSE 8A,A50,083650,Miranda; Gregory Joseph,3,2,56,53
1656311473040,CSE 11,A01,083080,Cao; Yingjun,0,48,40,40
1656311479071,CSE 12,A01,083652,Krause-Levy; Sophia Louisa,5,1,120,115
1656311485098,CSE 15L,A01,083654,Morris; Justin Loren,2,0,50,48
1656311485098,CSE 15L,A02,083655,Morris; Justin Loren,4,0,50,46
1656311491126,CSE 20,A01,083657,Tran; Khoa Dang,30,0,80,50
1656311497149,CSE 21,A01,095574,Bach; Quang Tran,23,0,48,25
1656311503173,CSE 30,A01,083084,Eldon; John,1,4,80,79
1656311503173,CSE 30,B01,095061,Bhaskar; Nishant,0,1,50,50
1656311509202,CSE 100,A01,083659,Cao; Yingjun,1,18,70,69
1656311515225,CSE 134B,A01,083661,Powell; Thomas Allan,6,0,100,94
1656311521248,CSE 140,A01,083663,Gungor; Onat,9,0,85,76
1656311527272,CSE 140L,A01,083088,Eldon; John,10,0,100,90
1656311533299,CSE 175,A01,083665,Kumar; Rakesh,0,0,25,25
1656311539324,CSE 190,A00,092507,Dubnov; Shlomo,3,0,20,17
1656311545359,ECE 45,A01,083139,Congero; Spencer William,1,0,75,74
1656311551386,ECE 65,A50,083695,Saad; Andrew S,10,0,30,20
1656311551386,ECE 65,A51,095125,Staff,25,0,26,1
1656311557413,ECE 109,A01,091882,Touri; Behrouz,0,0,70,70
1656311563435,ECE 180,A00,083140,Abi Samra; Nicholas Camill,2,0,30,28
1656311563435,ECE 180,B00,083141,Abi Samra; Nicholas Camill,0,4,30,30
1656311569463,MATH 10A,A01,083735,Patchell; Gregory David,0,0,30,30
1656311569463,MATH 10A,A02,083736,Patchell; Gregory David,22,0,30,8
1656311569463,MATH 10A,A03,083737,Patchell; Gregory David,16,0,30,14
1656311575490,MATH 10B,A01,083207,Lim; Seonhee,2,0,34,32
1656311575490,MATH 10B,A02,083208,Lim; Seonhee,4,0,35,31
1656311575490,MATH 10B,A03,093472,Staff,1,0,34,33
1656311575490,MATH 10B,B01,083739,Sinha; Shubham,11,0,30,19
1656311581521,MATH 18,A01,083743,Cinel; Cameron Alexander,7,0,30,23
1656311581521,MATH 18,A02,083744,Cinel; Cameron Alexander,10,0,30,20
1656311581521,MATH 18,A03,083745,Cinel; Cameron Alexander,5,0,30,25
1656311581521,MATH 18,B01,083748,Rideout; David Porter,0,0,36,36
1656311581521,MATH 18,B02,083749,Rideout; David Porter,0,0,36,36
1656311581521,MATH 18,B03,083750,Rideout; David Porter,0,0,36,36
1656311581521,MATH 18,B04,083751,Rideout; David Porter,0,1,36,36
1656311581521,MATH 18,B05,093473,Rideout; David Porter,0,0,36,36
1656311581521,MATH 18,B06,093474,Rideout; David Porter,2,0,36,34
1656311587546,MATH 20A,A01,083754,Zheng; Zequn,11,0,40,29
1656311593575,MATH 20B,A01,083756,Briones; Jor-el Thomas Caparas,0,0,36,36
1656311593575,MATH 20B,A02,083757,Briones; Jor-el Thomas Caparas,0,0,36,36
1656311593575,MATH 20B,A03,093475,Staff,1,0,36,35
1656311599599,MATH 20C,A01,083760,Briones; Jor-el Thomas Caparas,0,0,35,35
1656311599599,MATH 20C,A02,083761,Briones; Jor-el Thomas Caparas,9,1,35,26
1656311599599,MATH 20C,A03,093476,Staff,0,0,35,35
1656311599599,MATH 20C,B01,083762,Bach; Quang Tran,2,0,30,28
1656311605623,MATH 20D,A01,083765,Tran; Brian Kha,1,0,30,29
1656311605623,MATH 20D,A02,083766,Tran; Brian Kha,0,0,30,30
1656311605623,MATH 20D,A03,083767,Tran; Brian Kha,2,0,30,28
1656311611651,MATH 20E,A01,083771,Ganguly; Soumya,1,0,32,31
1656311611651,MATH 20E,A02,083772,Ganguly; Soumya,0,0,32,32
1656311611651,MATH 20E,B01,083773,Ciotti; Benjamin,18,0,35,17
1656311611651,MATH 20E,B02,083774,Ciotti; Benjamin,16,0,35,19
1656311617675,MATH 103A,A01,083777,Greenfeld; Be'Eri,2,0,36,34
1656311617675,MATH 103A,A02,083778,Greenfeld; Be'Eri,3,0,36,33
1656311617675,MATH 103A,A03,093561,Staff,3,0,36,33
1656311617675,MATH 103A,B01,083779,Greenfeld; Be'Eri,8,0,36,28
1656311617675,MATH 103A,B02,083780,Greenfeld; Be'Eri,0,0,36,36
1656311617675,MATH 103A,B03,093562,Staff,1,0,36,35
1656311623699,MATH 105,A01,085443,Carter; Anne Toulson,3,0,35,32
1656311623699,MATH 105,A02,093477,Staff,15,0,35,20
1656311629727,MATH 109,A01,083213,Ganzberger; Geoffrey Michael,0,0,34,34
1656311629727,MATH 109,A02,083214,Ganzberger; Geoffrey Michael,0,0,34,34
1656311629727,MATH 109,A03,093478,Staff,2,0,34,32
1656311629727,MATH 109,B01,083215,Ganzberger; Geoffrey Michael,4,0,32,28
1656311629727,MATH 109,B02,083216,Ganzberger; Geoffrey Michael,0,0,32,32
1656311629727,MATH 109,B03,093479,Staff,3,0,32,29
1656311635753,MATH 142A,A01,083219,Chow; Bennett,1,0,32,31
1656311635753,MATH 142A,A02,083220,Chow; Bennett,8,0,32,24
1656311635753,MATH 142A,A03,093480,Staff,5,0,32,27
1656311635753,MATH 142A,B03,093481,Staff,3,0,32,29
1656311635753,MATH 142A,B04,093558,Staff,7,0,32,25
1656311635753,MATH 142A,B05,093559,Staff,0,0,32,32
1656311641777,MATH 193A,A01,083224,Rotar; Vladimir,0,1,34,34
1656311641777,MATH 193A,A02,083225,Rotar; Vladimir,0,0,34,34
1656311641777,MATH 193A,A03,083781,Rotar; Vladimir,0,0,34,34
1656311641777,MATH 193A,A04,083782,Rotar; Vladimir,5,0,34,29
1656311641777,MATH 193A,A05,093482,Rotar; Vladimir,0,0,34,34
1656311647804,MATH 197,001,091859,McAuley; Julian John,9999,0,9999,0
1656311647804,MATH 197,002,095566,Kedlaya; Kiran S.,9997,0,9999,2
1656311647804,MATH 197,003,095567,Xiao; Ming,9999,0,9999,0
1656311647804,MATH 197,004,095571,Perols; Johan Lars,9998,0,9999,1
1656311654859,COGS 9,A01,083615,Shannon; Kyle Michael,3,0,75,72
1656311660885,COGS 11,A01,083617,Boyle; Mary E. T.,17,0,48,31
1656311666912,COGS 13,A01,083071,Bastos; Amalia Pinkusfeld,5,0,71,66
1656311672936,COGS 14A,A01,092681,Semenuks; Arturs,0,12,100,100
1656311678963,COGS 14B,A01,083073,Cheng; Tzu-Han,7,0,63,56
1656311684990,COGS 17,A01,092677,Semenuks; Arturs,6,0,81,75
1656311691017,COGS 100,A01,083619,Allen; Michael Gordon,3,0,70,67
1656311697040,COGS 101A,A01,083621,Davis; Joshua Daniel,5,0,68,63
1656311703067,COGS 101B,A01,091572,Allen; Michael Gordon,4,0,65,61
1656311709095,COGS 101C,A01,083625,Delgado; Tania,11,0,35,24
1656311715120,COGS 107A,A01,083627,Boyle; Mary E. T.,2,0,60,58
1656311721143,COGS 118A,A01,083075,Gupta; Anjum,7,0,76,69
1656311727182,CSE 3,A50,083646,Miranda; Gregory Joseph,18,0,50,32
1656311733215,CSE 8A,A50,083650,Miranda; Gregory Joseph,4,2,56,52
1656311739242,CSE 11,A01,083080,Cao; Yingjun,0,48,40,40
1656311745267,CSE 12,A01,083652,Krause-Levy; Sophia Louisa,5,1,120,115
1656311751291,CSE 15L,A01,083654,Morris; Justin Loren,2,0,50,48
1656311751291,CSE 15L,A02,083655,Morris; Justin Loren,4,0,50,46
1656311757318,CSE 20,A01,083657,Tran; Khoa Dang,31,0,80,49
1656311763345,CSE 21,A01,095574,Bach; Quang Tran,23,0,48,25
1656311769368,CSE 30,A01,083084,Eldon; John,1,4,80,79
1656311769368,CSE 30,B01,095061,Bhaskar; Nishant,0,1,50,50
1656311775395,CSE 100,A01,083659,Cao; Yingjun,1,18,70,69
1656311781422,CSE 134B,A01,083661,Powell; Thomas Allan,6,0,100,94
1656311787449,CSE 140,A01,083663,Gungor; Onat,9,0,85,76
1656311793478,CSE 140L,A01,083088,Eldon; John,10,0,100,90
1656311799501,CSE 175,A01,083665,Kumar; Rakesh,0,0,25,25
1656311805525,CSE 190,A00,092507,Dubnov; Shlomo,3,0,20,17
1656311811549,ECE 45,A01,083139,Congero; Spencer William,1,0,75,74
1656311817575,ECE 65,A50,083695,Saad; Andrew S,10,0,30,20
1656311817575,ECE 65,A51,095125,Staff,25,0,26,1
1656311823601,ECE 109,A01,091882,Touri; Behrouz,0,0,70,70
1656311829625,ECE 180,A00,083140,Abi Samra; Nicholas Camill,2,0,30,28
1656311829625,ECE 180,B00,083141,Abi Samra; Nicholas Camill,0,4,30,30
1656311835648,MATH 10A,A01,083735,Patchell; Gregory David,0,0,30,30
1656311835648,MATH 10A,A02,083736,Patchell; Gregory David,22,0,30,8
1656311835648,MATH 10A,A03,083737,Patchell; Gregory David,16,0,30,14
1656311841673,MATH 10B,A01,083207,Lim; Seonhee,2,0,34,32
1656311841673,MATH 10B,A02,083208,Lim; Seonhee,4,0,35,31
1656311841673,MATH 10B,A03,093472,Staff,1,0,34,33
1656311841673,MATH 10B,B01,083739,Sinha; Shubham,11,0,30,19
1656311847703,MATH 18,A01,083743,Cinel; Cameron Alexander,7,0,30,23
1656311847703,MATH 18,A02,083744,Cinel; Cameron Alexander,10,0,30,20
1656311847703,MATH 18,A03,083745,Cinel; Cameron Alexander,5,0,30,25
1656311847703,MATH 18,B01,083748,Rideout; David Porter,0,0,36,36
1656311847703,MATH 18,B02,083749,Rideout; David Porter,0,0,36,36
1656311847703,MATH 18,B03,083750,Rideout; David Porter,0,0,36,36
1656311847703,MATH 18,B04,083751,Rideout; David Porter,0,1,36,36
1656311847703,MATH 18,B05,093473,Rideout; David Porter,0,0,36,36
1656311847703,MATH 18,B06,093474,Rideout; David Porter,2,0,36,34
1656311853731,MATH 20A,A01,083754,Zheng; Zequn,11,0,40,29
1656311859755,MATH 20B,A01,083756,Briones; Jor-el Thomas Caparas,0,0,36,36
1656311859755,MATH 20B,A02,083757,Briones; Jor-el Thomas Caparas,0,0,36,36
1656311859755,MATH 20B,A03,093475,Staff,1,0,36,35
1656311865779,MATH 20C,A01,083760,Briones; Jor-el Thomas Caparas,0,0,35,35
1656311865779,MATH 20C,A02,083761,Briones; Jor-el Thomas Caparas,9,1,35,26
1656311865779,MATH 20C,A03,093476,Staff,0,0,35,35
1656311865779,MATH 20C,B01,083762,Bach; Quang Tran,2,0,30,28
1656311871808,MATH 20D,A01,083765,Tran; Brian Kha,1,0,30,29
1656311871808,MATH 20D,A02,083766,Tran; Brian Kha,0,0,30,30
1656311871808,MATH 20D,A03,083767,Tran; Brian Kha,2,0,30,28
1656311877838,MATH 20E,A01,083771,Ganguly; Soumya,1,0,32,31
1656311877838,MATH 20E,A02,083772,Ganguly; Soumya,0,0,32,32
1656311877838,MATH 20E,B01,083773,Ciotti; Benjamin,18,0,35,17
1656311877838,MATH 20E,B02,083774,Ciotti; Benjamin,16,0,35,19
1656311883868,MATH 103A,A01,083777,Greenfeld; Be'Eri,2,0,36,34
1656311883868,MATH 103A,A02,083778,Greenfeld; Be'Eri,3,0,36,33
1656311883868,MATH 103A,A03,093561,Staff,3,0,36,33
1656311883868,MATH 103A,B01,083779,Greenfeld; Be'Eri,8,0,36,28
1656311883868,MATH 103A,B02,083780,Greenfeld; Be'Eri,0,0,36,36
1656311883868,MATH 103A,B03,093562,Staff,1,0,36,35
1656311889898,MATH 105,A01,085443,Carter; Anne Toulson,3,0,35,32
1656311889898,MATH 105,A02,093477,Staff,15,0,35,20
1656311895924,MATH 109,A01,083213,Ganzberger; Geoffrey Michael,0,0,34,34
1656311895924,MATH 109,A02,083214,Ganzberger; Geoffrey Michael,0,0,34,34
1656311895924,MATH 109,A03,093478,Staff,1,0,34,33
1656311895924,MATH 109,B01,083215,Ganzberger; Geoffrey Michael,4,0,32,28
1656311895924,MATH 109,B02,083216,Ganzberger; Geoffrey Michael,0,0,32,32
1656311895924,MATH 109,B03,093479,Staff,3,0,32,29
1656311901946,MATH 142A,A01,083219,Chow; Bennett,1,0,32,31
1656311901946,MATH 142A,A02,083220,Chow; Bennett,8,0,32,24
1656311901946,MATH 142A,A03,093480,Staff,5,0,32,27
1656311901946,MATH 142A,B03,093481,Staff,3,0,32,29
1656311901946,MATH 142A,B04,093558,Staff,7,0,32,25
1656311901946,MATH 142A,B05,093559,Staff,0,0,32,32
1656311907981,MATH 193A,A01,083224,Rotar; Vladimir,0,1,34,34
1656311907981,MATH 193A,A02,083225,Rotar; Vladimir,0,0,34,34
1656311907981,MATH 193A,A03,083781,Rotar; Vladimir,0,0,34,34
1656311907981,MATH 193A,A04,083782,Rotar; Vladimir,5,0,34,29
1656311907981,MATH 193A,A05,093482,Rotar; Vladimir,0,0,34,34
1656311914005,MATH 197,001,091859,McAuley; Julian John,9999,0,9999,0
1656311914005,MATH 197,002,095566,Kedlaya; Kiran S.,9997,0,9999,2
1656311914005,MATH 197,003,095567,Xiao; Ming,9999,0,9999,0
1656311914005,MATH 197,004,095571,Perols; Johan Lars,9998,0,9999,1
1656311921071,COGS 9,A01,083615,Shannon; Kyle Michael,3,0,75,72
1656311927105,COGS 11,A01,083617,Boyle; Mary E. T.,17,0,48,31
1656311933134,COGS 13,A01,083071,Bastos; Amalia Pinkusfeld,5,0,71,66
1656311939161,COGS 14A,A01,092681,Semenuks; Arturs,0,12,100,100
1656311945189,COGS 14B,A01,083073,Cheng; Tzu-Han,7,0,63,56
1656311951218,COGS 17,A01,092677,Semenuks; Arturs,6,0,81,75
1656311957243,COGS 100,A01,083619,Allen; Michael Gordon,3,0,70,67
1656311963266,COGS 101A,A01,083621,Davis; Joshua Daniel,5,0,68,63
1656311969295,COGS 101B,A01,091572,Allen; Michael Gordon,4,0,65,61
1656311975322,COGS 101C,A01,083625,Delgado; Tania,11,0,35,24
1656311981348,COGS 107A,A01,083627,Boyle; Mary E. T.,2,0,60,58
1656311987370,COGS 118A,A01,083075,Gupta; Anjum,7,0,76,69
1656311993392,CSE 3,A50,083646,Miranda; Gregory Joseph,18,0,50,32
1656311999420,CSE 8A,A50,083650,Miranda; Gregory Joseph,4,2,56,52
1656312005447,CSE 11,A01,083080,Cao; Yingjun,0,48,40,40
1656312011470,CSE 12,A01,083652,Krause-Levy; Sophia Louisa,5,1,120,115
1656312017496,CSE 15L,A01,083654,Morris; Justin Loren,2,0,50,48
1656312017496,CSE 15L,A02,083655,Morris; Justin Loren,4,0,50,46
1656312023520,CSE 20,A01,083657,Tran; Khoa Dang,31,0,80,49
1656312029543,CSE 21,A01,095574,Bach; Quang Tran,23,0,48,25
1656312035568,CSE 30,A01,083084,Eldon; John,1,4,80,79
1656312035568,CSE 30,B01,095061,Bhaskar; Nishant,0,1,50,50
1656312041594,CSE 100,A01,083659,Cao; Yingjun,1,18,70,69
1656312047618,CSE 134B,A01,083661,Powell; Thomas Allan,6,0,100,94
1656312053647,CSE 140,A01,083663,Gungor; Onat,9,0,85,76
1656312059745,CSE 140L,A01,083088,Eldon; John,10,0,100,90
1656312065769,CSE 175,A01,083665,Kumar; Rakesh,0,0,25,25
1656312071793,CSE 190,A00,092507,Dubnov; Shlomo,3,0,20,17
1656312077815,ECE 45,A01,083139,Congero; Spencer William,1,0,75,74
1656312083840,ECE 65,A50,083695,Saad; Andrew S,10,0,30,20
1656312083840,ECE 65,A51,095125,Staff,25,0,26,1
1656312089863,ECE 109,A01,091882,Touri; Behrouz,0,0,70,70
1656312095886,ECE 180,A00,083140,Abi Samra; Nicholas Camill,2,0,30,28
1656312095886,ECE 180,B00,083141,Abi Samra; Nicholas Camill,0,4,30,30
1656312101910,MATH 10A,A01,083735,Patchell; Gregory David,0,0,30,30
1656312101910,MATH 10A,A02,083736,Patchell; Gregory David,22,0,30,8
1656312101910,MATH 10A,A03,083737,Patchell; Gregory David,16,0,30,14
1656312107939,MATH 10B,A01,083207,Lim; Seonhee,2,0,34,32
1656312107939,MATH 10B,A02,083208,Lim; Seonhee,4,0,35,31
1656312107939,MATH 10B,A03,093472,Staff,1,0,34,33
1656312107939,MATH 10B,B01,083739,Sinha; Shubham,11,0,30,19
1656312113964,MATH 18,A01,083743,Cinel; Cameron Alexander,7,0,30,23
1656312113964,MATH 18,A02,083744,Cinel; Cameron Alexander,10,0,30,20
1656312113964,MATH 18,A03,083745,Cinel; Cameron Alexander,5,0,30,25
1656312113964,MATH 18,B01,083748,Rideout; David Porter,0,0,36,36
1656312113964,MATH 18,B02,083749,Rideout; David Porter,0,0,36,36
1656312113964,MATH 18,B03,083750,Rideout; David Porter,0,0,36,36
1656312113964,MATH 18,B04,083751,Rideout; David Porter,0,1,36,36
1656312113964,MATH 18,B05,093473,Rideout; David Porter,0,0,36,36
1656312113964,MATH 18,B06,093474,Rideout; David Porter,2,0,36,34
1656312119990,MATH 20A,A01,083754,Zheng; Zequn,11,0,40,29
1656312126013,MATH 20B,A01,083756,Briones; Jor-el Thomas Caparas,0,0,36,36
1656312126013,MATH 20B,A02,083757,Briones; Jor-el Thomas Caparas,0,0,36,36
1656312126013,MATH 20B,A03,093475,Staff,1,0,36,35
1656312132039,MATH 20C,A01,083760,Briones; Jor-el Thomas Caparas,0,0,35,35
1656312132039,MATH 20C,A02,083761,Briones; Jor-el Thomas Caparas,9,1,35,26
1656312132039,MATH 20C,A03,093476,Staff,0,0,35,35
1656312132039,MATH 20C,B01,083762,Bach; Quang Tran,2,0,30,28
1656312138064,MATH 20D,A01,083765,Tran; Brian Kha,1,0,30,29
1656312138064,MATH 20D,A02,083766,Tran; Brian Kha,0,0,30,30
1656312138064,MATH 20D,A03,083767,Tran; Brian Kha,2,0,30,28
1656312144087,MATH 20E,A01,083771,Ganguly; Soumya,1,0,32,31
1656312144087,MATH 20E,A02,083772,Ganguly; Soumya,0,0,32,32
1656312144087,MATH 20E,B01,083773,Ciotti; Benjamin,18,0,35,17
1656312144087,MATH 20E,B02,083774,Ciotti; Benjamin,16,0,35,19
1656312150112,MATH 103A,A01,083777,Greenfeld; Be'Eri,2,0,36,34
1656312150112,MATH 103A,A02,083778,Greenfeld; Be'Eri,3,0,36,33
1656312150112,MATH 103A,A03,093561,Staff,3,0,36,33
1656312150112,MATH 103A,B01,083779,Greenfeld; Be'Eri,8,0,36,28
1656312150112,MATH 103A,B02,083780,Greenfeld; Be'Eri,0,0,36,36
1656312150112,MATH 103A,B03,093562,Staff,1,0,36,35
1656312156135,MATH 105,A01,085443,Carter; Anne Toulson,3,0,35,32
1656312156135,MATH 105,A02,093477,Staff,15,0,35,20
1656312162164,MATH 109,A01,083213,Ganzberger; Geoffrey Michael,1,0,34,33
1656312162164,MATH 109,A02,083214,Ganzberger; Geoffrey Michael,0,0,34,34
1656312162164,MATH 109,A03,093478,Staff,1,0,34,33
1656312162164,MATH 109,B01,083215,Ganzberger; Geoffrey Michael,3,0,32,29
1656312162164,MATH 109,B02,083216,Ganzberger; Geoffrey Michael,0,0,32,32
1656312162164,MATH 109,B03,093479,Staff,3,0,32,29
1656312168192,MATH 142A,A01,083219,Chow; Bennett,1,0,32,31
1656312168192,MATH 142A,A02,083220,Chow; Bennett,8,0,32,24
1656312168192,MATH 142A,A03,093480,Staff,4,0,32,28
1656312168192,MATH 142A,B03,093481,Staff,3,0,32,29
1656312168192,MATH 142A,B04,093558,Staff,7,0,32,25
1656312168192,MATH 142A,B05,093559,Staff,1,0,32,31
1656312174221,MATH 193A,A01,083224,Rotar; Vladimir,0,1,34,34
1656312174221,MATH 193A,A02,083225,Rotar; Vladimir,0,0,34,34
1656312174221,MATH 193A,A03,083781,Rotar; Vladimir,0,0,34,34
1656312174221,MATH 193A,A04,083782,Rotar; Vladimir,5,0,34,29
1656312174221,MATH 193A,A05,093482,Rotar; Vladimir,0,0,34,34
1656312180250,MATH 197,001,091859,McAuley; Julian John,9999,0,9999,0
1656312180250,MATH 197,002,095566,Kedlaya; Kiran S.,9997,0,9999,2
1656312180250,MATH 197,003,095567,Xiao; Ming,9999,0,9999,0
1656312180250,MATH 197,004,095571,Perols; Johan Lars,9998,0,9999,1
1656312187299,COGS 9,A01,083615,Shannon; Kyle Michael,3,0,75,72
1656312193321,COGS 11,A01,083617,Boyle; Mary E. T.,17,0,48,31
1656312199344,COGS 13,A01,083071,Bastos; Amalia Pinkusfeld,5,0,71,66
1656312212561,COGS 14A,A01,092681,Semenuks; Arturs,0,12,100,100
1656312218585,COGS 14B,A01,083073,Cheng; Tzu-Han,7,0,63,56
1656312224609,COGS 17,A01,092677,Semenuks; Arturs,6,0,81,75
1656312230634,COGS 100,A01,083619,Allen; Michael Gordon,3,0,70,67
1656312236659,COGS 101A,A01,083621,Davis; Joshua Daniel,5,0,68,63
1656312242688,COGS 101B,A01,091572,Allen; Michael Gordon,4,0,65,61
1656312248711,COGS 101C,A01,083625,Delgado; Tania,11,0,35,24
1656312254736,COGS 107A,A01,083627,Boyle; Mary E. T.,2,0,60,58
1656312260764,COGS 118A,A01,083075,Gupta; Anjum,7,0,76,69
1656312266804,CSE 3,A50,083646,Miranda; Gregory Joseph,18,0,50,32
1656312272827,CSE 8A,A50,083650,Miranda; Gregory Joseph,4,2,56,52
1656312278850,CSE 11,A01,083080,Cao; Yingjun,0,48,40,40
1656312284874,CSE 12,A01,083652,Krause-Levy; Sophia Louisa,5,1,120,115
1656312290902,CSE 15L,A01,083654,Morris; Justin Loren,2,0,50,48
1656312290902,CSE 15L,A02,083655,Morris; Justin Loren,4,0,50,46
1656312296929,CSE 20,A01,083657,Tran; Khoa Dang,31,0,80,49
1656312302958,CSE 21,A01,095574,Bach; Quang Tran,23,0,48,25
1656312308986,CSE 30,A01,083084,Eldon; John,1,4,80,79
1656312308986,CSE 30,B01,095061,Bhaskar; Nishant,0,1,50,50
1656312315013,CSE 100,A01,083659,Cao; Yingjun,1,18,70,69
1656312321037,CSE 134B,A01,083661,Powell; Thomas Allan,6,0,100,94
1656312327066,CSE 140,A01,083663,Gungor; Onat,9,0,85,76
1656312333089,CSE 140L,A01,083088,Eldon; John,10,0,100,90
1656312339117,CSE 175,A01,083665,Kumar; Rakesh,0,0,25,25
1656312345141,CSE 190,A00,092507,Dubnov; Shlomo,3,0,20,17
1656312351165,ECE 45,A01,083139,Congero; Spencer William,1,0,75,74
1656312357188,ECE 65,A50,083695,Saad; Andrew S,10,0,30,20
1656312357188,ECE 65,A51,095125,Staff,25,0,26,1
1656312363210,ECE 109,A01,091882,Touri; Behrouz,0,0,70,70
1656312369235,ECE 180,A00,083140,Abi Samra; Nicholas Camill,2,0,30,28
1656312369235,ECE 180,B00,083141,Abi Samra; Nicholas Camill,0,4,30,30
1656312375263,MATH 10A,A01,083735,Patchell; Gregory David,0,0,30,30
1656312375263,MATH 10A,A02,083736,Patchell; Gregory David,22,0,30,8
1656312375263,MATH 10A,A03,083737,Patchell; Gregory David,16,0,30,14
1656312381289,MATH 10B,A01,083207,Lim; Seonhee,2,0,34,32
1656312381289,MATH 10B,A02,083208,Lim; Seonhee,4,0,35,31
1656312381289,MATH 10B,A03,093472,Staff,1,0,34,33
1656312381289,MATH 10B,B01,083739,Sinha; Shubham,11,0,30,19
1656312387314,MATH 18,A01,083743,Cinel; Cameron Alexander,7,0,30,23
1656312387314,MATH 18,A02,083744,Cinel; Cameron Alexander,10,0,30,20
1656312387314,MATH 18,A03,083745,Cinel; Cameron Alexander,5,0,30,25
1656312387314,MATH 18,B01,083748,Rideout; David Porter,0,0,36,36
1656312387314,MATH 18,B02,083749,Rideout; David Porter,0,0,36,36
1656312387314,MATH 18,B03,083750,Rideout; David Porter,0,0,36,36
1656312387314,MATH 18,B04,083751,Rideout; David Porter,0,1,36,36
1656312387314,MATH 18,B05,093473,Rideout; David Porter,0,0,36,36
1656312387314,MATH 18,B06,093474,Rideout; David Porter,2,0,36,34
1656312393342,MATH 20A,A01,083754,Zheng; Zequn,11,0,40,29
1656312399369,MATH 20B,A01,083756,Briones; Jor-el Thomas Caparas,0,0,36,36
1656312399369,MATH 20B,A02,083757,Briones; Jor-el Thomas Caparas,0,0,36,36
1656312399369,MATH 20B,A03,093475,Staff,1,0,36,35
1656312405393,MATH 20C,A01,083760,Briones; Jor-el Thomas Caparas,0,0,35,35
1656312405393,MATH 20C,A02,083761,Briones; Jor-el Thomas Caparas,9,1,35,26
1656312405393,MATH 20C,A03,093476,Staff,0,0,35,35
1656312405393,MATH 20C,B01,083762,Bach; Quang Tran,2,0,30,28
1656312411418,MATH 20D,A01,083765,Tran; Brian Kha,1,0,30,29
1656312411418,MATH 20D,A02,083766,Tran; Brian Kha,0,0,30,30
1656312411418,MATH 20D,A03,083767,Tran; Brian Kha,2,0,30,28
1656312417449,MATH 20E,A01,083771,Ganguly; Soumya,1,0,32,31
1656312417449,MATH 20E,A02,083772,Ganguly; Soumya,0,0,32,32
1656312417449,MATH 20E,B01,083773,Ciotti; Benjamin,18,0,35,17
1656312417449,MATH 20E,B02,083774,Ciotti; Benjamin,16,0,35,19
1656312423475,MATH 103A,A01,083777,Greenfeld; Be'Eri,2,0,36,34
1656312423475,MATH 103A,A02,083778,Greenfeld; Be'Eri,3,0,36,33
1656312423475,MATH 103A,A03,093561,Staff,3,0,36,33
1656312423475,MATH 103A,B01,083779,Greenfeld; Be'Eri,8,0,36,28
1656312423475,MATH 103A,B02,083780,Greenfeld; Be'Eri,0,0,36,36
1656312423475,MATH 103A,B03,093562,Staff,1,0,36,35
1656312429497,MATH 105,A01,085443,Carter; Anne Toulson,3,0,35,32
1656312429497,MATH 105,A02,093477,Staff,15,0,35,20
1656312435522,MATH 109,A01,083213,Ganzberger; Geoffrey Michael,1,0,34,33
1656312435522,MATH 109,A02,083214,Ganzberger; Geoffrey Michael,0,0,34,34
1656312435522,MATH 109,A03,093478,Staff,1,0,34,33
1656312435522,MATH 109,B01,083215,Ganzberger; Geoffrey Michael,3,0,32,29
1656312435522,MATH 109,B02,083216,Ganzberger; Geoffrey Michael,0,0,32,32
1656312435522,MATH 109,B03,093479,Staff,3,0,32,29
1656312441547,MATH 142A,A01,083219,Chow; Bennett,1,0,32,31
1656312441547,MATH 142A,A02,083220,Chow; Bennett,8,0,32,24
1656312441547,MATH 142A,A03,093480,Staff,4,0,32,28
1656312441547,MATH 142A,B03,093481,Staff,3,0,32,29
1656312441547,MATH 142A,B04,093558,Staff,7,0,32,25
1656312441547,MATH 142A,B05,093559,Staff,1,0,32,31
1656312447576,MATH 193A,A01,083224,Rotar; Vladimir,0,1,34,34
1656312447576,MATH 193A,A02,083225,Rotar; Vladimir,0,0,34,34
1656312447576,MATH 193A,A03,083781,Rotar; Vladimir,0,0,34,34
1656312447576,MATH 193A,A04,083782,Rotar; Vladimir,5,0,34,29
1656312447576,MATH 193A,A05,093482,Rotar; Vladimir,0,0,34,34
1656312453611,MATH 197,001,091859,McAuley; Julian John,9999,0,9999,0
1656312453611,MATH 197,002,095566,Kedlaya; Kiran S.,9997,0,9999,2
1656312453611,MATH 197,003,095567,Xiao; Ming,9999,0,9999,0
1656312453611,MATH 197,004,095571,Perols; Johan Lars,9998,0,9999,1
1656312460674,COGS 9,A01,083615,Shannon; Kyle Michael,3,0,75,72
1656312466697,COGS 11,A01,083617,Boyle; Mary E. T.,17,0,48,31
1656312472734,COGS 13,A01,083071,Bastos; Amalia Pinkusfeld,5,0,71,66
1656312478761,COGS 14A,A01,092681,Semenuks; Arturs,0,12,100,100
1656312484790,COGS 14B,A01,083073,Cheng; Tzu-Han,7,0,63,56
1656312490824,COGS 17,A01,092677,Semenuks; Arturs,6,0,81,75
1656312496853,COGS 100,A01,083619,Allen; Michael Gordon,3,0,70,67
1656312502876,COGS 101A,A01,083621,Davis; Joshua Daniel,5,0,68,63
1656312508902,COGS 101B,A01,091572,Allen; Michael Gordon,4,0,65,61
1656312514925,COGS 101C,A01,083625,Delgado; Tania,11,0,35,24
1656312520950,COGS 107A,A01,083627,Boyle; Mary E. T.,2,0,60,58
1656312526973,COGS 118A,A01,083075,Gupta; Anjum,7,0,76,69
1656312532998,CSE 3,A50,083646,Miranda; Gregory Joseph,18,0,50,32
1656312539024,CSE 8A,A50,083650,Miranda; Gregory Joseph,4,2,56,52
1656312545057,CSE 11,A01,083080,Cao; Yingjun,0,48,40,40
1656312551085,CSE 12,A01,083652,Krause-Levy; Sophia Louisa,5,1,120,115
1656312557127,CSE 15L,A01,083654,Morris; Justin Loren,2,0,50,48
1656312557127,CSE 15L,A02,083655,Morris; Justin Loren,4,0,50,46
1656312563149,CSE 20,A01,083657,Tran; Khoa Dang,31,0,80,49
1656312569182,CSE 21,A01,095574,Bach; Quang Tran,23,0,48,25
1656312575211,CSE 30,A01,083084,Eldon; John,1,4,80,79
1656312575211,CSE 30,B01,095061,Bhaskar; Nishant,0,1,50,50
1656312581234,CSE 100,A01,083659,Cao; Yingjun,1,18,70,69
1656312587259,CSE 134B,A01,083661,Powell; Thomas Allan,6,0,100,94
1656312593287,CSE 140,A01,083663,Gungor; Onat,9,0,85,76
1656312599333,CSE 140L,A01,083088,Eldon; John,10,0,100,90
1656312605368,CSE 175,A01,083665,Kumar; Rakesh,0,0,25,25
1656312611395,CSE 190,A00,092507,Dubnov; Shlomo,4,0,20,16
1656312617423,ECE 45,A01,083139,Congero; Spencer William,1,0,75,74
1656312623450,ECE 65,A50,083695,Saad; Andrew S,10,0,30,20
1656312623450,ECE 65,A51,095125,Staff,25,0,26,1
1656312629477,ECE 109,A01,091882,Touri; Behrouz,0,0,70,70
1656312635508,ECE 180,A00,083140,Abi Samra; Nicholas Camill,2,0,30,28
1656312635508,ECE 180,B00,083141,Abi Samra; Nicholas Camill,0,4,30,30
1656312641532,MATH 10A,A01,083735,Patchell; Gregory David,0,0,30,30
1656312641532,MATH 10A,A02,083736,Patchell; Gregory David,22,0,30,8
1656312641532,MATH 10A,A03,083737,Patchell; Gregory David,16,0,30,14
1656312647555,MATH 10B,A01,083207,Lim; Seonhee,2,0,34,32
1656312647555,MATH 10B,A02,083208,Lim; Seonhee,4,0,35,31
1656312647555,MATH 10B,A03,093472,Staff,1,0,34,33
1656312647555,MATH 10B,B01,083739,Sinha; Shubham,11,0,30,19
1656312653588,MATH 18,A01,083743,Cinel; Cameron Alexander,7,0,30,23
1656312653588,MATH 18,A02,083744,Cinel; Cameron Alexander,10,0,30,20
1656312653588,MATH 18,A03,083745,Cinel; Cameron Alexander,5,0,30,25
1656312653588,MATH 18,B01,083748,Rideout; David Porter,0,0,36,36
1656312653588,MATH 18,B02,083749,Rideout; David Porter,0,0,36,36
1656312653588,MATH 18,B03,083750,Rideout; David Porter,0,0,36,36
1656312653588,MATH 18,B04,083751,Rideout; David Porter,0,1,36,36
1656312653588,MATH 18,B05,093473,Rideout; David Porter,0,0,36,36
1656312653588,MATH 18,B06,093474,Rideout; David Porter,2,0,36,34
1656312659614,MATH 20A,A01,083754,Zheng; Zequn,11,0,40,29
1656312665717,MATH 20B,A01,083756,Briones; Jor-el Thomas Caparas,0,0,36,36
1656312665717,MATH 20B,A02,083757,Briones; Jor-el Thomas Caparas,0,0,36,36
1656312665717,MATH 20B,A03,093475,Staff,1,0,36,35
1656312671750,MATH 20C,A01,083760,Briones; Jor-el Thomas Caparas,0,0,35,35
1656312671750,MATH 20C,A02,083761,Briones; Jor-el Thomas Caparas,9,1,35,26
1656312671750,MATH 20C,A03,093476,Staff,0,0,35,35
1656312671750,MATH 20C,B01,083762,Bach; Quang Tran,2,0,30,28
1656312677774,MATH 20D,A01,083765,Tran; Brian Kha,1,0,30,29
1656312677774,MATH 20D,A02,083766,Tran; Brian Kha,0,0,30,30
1656312677774,MATH 20D,A03,083767,Tran; Brian Kha,2,0,30,28
1656312683799,MATH 20E,A01,083771,Ganguly; Soumya,1,0,32,31
1656312683799,MATH 20E,A02,083772,Ganguly; Soumya,0,0,32,32
1656312683799,MATH 20E,B01,083773,Ciotti; Benjamin,18,0,35,17
1656312683799,MATH 20E,B02,083774,Ciotti; Benjamin,16,0,35,19
1656312689823,MATH 103A,A01,083777,Greenfeld; Be'Eri,2,0,36,34
1656312689823,MATH 103A,A02,083778,Greenfeld; Be'Eri,3,0,36,33
1656312689823,MATH 103A,A03,093561,Staff,3,0,36,33
1656312689823,MATH 103A,B01,083779,Greenfeld; Be'Eri,8,0,36,28
1656312689823,MATH 103A,B02,083780,Greenfeld; Be'Eri,0,0,36,36
1656312689823,MATH 103A,B03,093562,Staff,1,0,36,35
1656312695851,MATH 105,A01,085443,Carter; Anne Toulson,3,0,35,32
1656312695851,MATH 105,A02,093477,Staff,15,0,35,20
1656312701876,MATH 109,A01,083213,Ganzberger; Geoffrey Michael,1,0,34,33
1656312701876,MATH 109,A02,083214,Ganzberger; Geoffrey Michael,0,0,34,34
1656312701876,MATH 109,A03,093478,Staff,1,0,34,33
1656312701876,MATH 109,B01,083215,Ganzberger; Geoffrey Michael,3,0,32,29
1656312701876,MATH 109,B02,083216,Ganzberger; Geoffrey Michael,0,0,32,32
1656312701876,MATH 109,B03,093479,Staff,3,0,32,29
1656312707906,MATH 142A,A01,083219,Chow; Bennett,1,0,32,31
1656312707906,MATH 142A,A02,083220,Chow; Bennett,8,0,32,24
1656312707906,MATH 142A,A03,093480,Staff,4,0,32,28
1656312707906,MATH 142A,B03,093481,Staff,3,0,32,29
1656312707906,MATH 142A,B04,093558,Staff,7,0,32,25
1656312707906,MATH 142A,B05,093559,Staff,1,0,32,31
1656312713936,MATH 193A,A01,083224,Rotar; Vladimir,0,1,34,34
1656312713936,MATH 193A,A02,083225,Rotar; Vladimir,0,0,34,34
1656312713936,MATH 193A,A03,083781,Rotar; Vladimir,0,0,34,34
1656312713936,MATH 193A,A04,083782,Rotar; Vladimir,5,0,34,29
1656312713936,MATH 193A,A05,093482,Rotar; Vladimir,0,0,34,34
1656312719958,MATH 197,001,091859,McAuley; Julian John,9999,0,9999,0
1656312719958,MATH 197,002,095566,Kedlaya; Kiran S.,9997,0,9999,2
1656312719958,MATH 197,003,095567,Xiao; Ming,9999,0,9999,0
1656312719958,MATH 197,004,095571,Perols; Johan Lars,9998,0,9999,1
1656312727032,COGS 9,A01,083615,Shannon; Kyle Michael,3,0,75,72
1656312733059,COGS 11,A01,083617,Boyle; Mary E. T.,17,0,48,31
1656312739088,COGS 13,A01,083071,Bastos; Amalia Pinkusfeld,5,0,71,66
1656312745111,COGS 14A,A01,092681,Semenuks; Arturs,0,10,100,102
1656312751135,COGS 14B,A01,083073,Cheng; Tzu-Han,7,0,63,56
1656312757159,COGS 17,A01,092677,Semenuks; Arturs,6,0,81,75
1656312763187,COGS 100,A01,083619,Allen; Michael Gordon,3,0,70,67
1656312769211,COGS 101A,A01,083621,Davis; Joshua Daniel,5,0,68,63
1656312775235,COGS 101B,A01,091572,Allen; Michael Gordon,4,0,65,61
1656312781258,COGS 101C,A01,083625,Delgado; Tania,11,0,35,24
1656312787284,COGS 107A,A01,083627,Boyle; Mary E. T.,2,0,60,58
1656312793311,COGS 118A,A01,083075,Gupta; Anjum,7,0,76,69
1656312799336,CSE 3,A50,083646,Miranda; Gregory Joseph,18,0,50,32
1656312805363,CSE 8A,A50,083650,Miranda; Gregory Joseph,4,2,56,52
1656312811393,CSE 11,A01,083080,Cao; Yingjun,0,48,40,40
1656312817421,CSE 12,A01,083652,Krause-Levy; Sophia Louisa,5,1,120,115
1656312823447,CSE 15L,A01,083654,Morris; Justin Loren,2,0,50,48
1656312823447,CSE 15L,A02,083655,Morris; Justin Loren,4,0,50,46
1656312829471,CSE 20,A01,083657,Tran; Khoa Dang,31,0,80,49
1656312835496,CSE 21,A01,095574,Bach; Quang Tran,23,0,48,25
1656312841523,CSE 30,A01,083084,Eldon; John,1,4,80,79
1656312841523,CSE 30,B01,095061,Bhaskar; Nishant,0,1,50,50
1656312847548,CSE 100,A01,083659,Cao; Yingjun,1,18,70,69
1656312853571,CSE 134B,A01,083661,Powell; Thomas Allan,6,0,100,94
1656312859596,CSE 140,A01,083663,Gungor; Onat,9,0,85,76
1656312865623,CSE 140L,A01,083088,Eldon; John,10,0,100,90
1656312871650,CSE 175,A01,083665,Kumar; Rakesh,0,0,25,25
1656312877675,CSE 190,A00,092507,Dubnov; Shlomo,4,0,20,16
1656312883701,ECE 45,A01,083139,Congero; Spencer William,1,0,75,74
1656312889725,ECE 65,A50,083695,Saad; Andrew S,10,0,30,20
1656312889725,ECE 65,A51,095125,Staff,25,0,26,1
1656312895750,ECE 109,A01,091882,Touri; Behrouz,0,0,70,70
1656312901778,ECE 180,A00,083140,Abi Samra; Nicholas Camill,2,0,30,28
1656312901778,ECE 180,B00,083141,Abi Samra; Nicholas Camill,0,4,30,30
1656312907801,MATH 10A,A01,083735,Patchell; Gregory David,0,0,30,30
1656312907801,MATH 10A,A02,083736,Patchell; Gregory David,22,0,30,8
1656312907801,MATH 10A,A03,083737,Patchell; Gregory David,16,0,30,14
1656312913830,MATH 10B,A01,083207,Lim; Seonhee,2,0,34,32
1656312913830,MATH 10B,A02,083208,Lim; Seonhee,4,0,35,31
1656312913830,MATH 10B,A03,093472,Staff,1,0,34,33
1656312913830,MATH 10B,B01,083739,Sinha; Shubham,11,0,30,19
1656312919857,MATH 18,A01,083743,Cinel; Cameron Alexander,7,0,30,23
1656312919857,MATH 18,A02,083744,Cinel; Cameron Alexander,10,0,30,20
1656312919857,MATH 18,A03,083745,Cinel; Cameron Alexander,5,0,30,25
1656312919857,MATH 18,B01,083748,Rideout; David Porter,0,0,36,36
1656312919857,MATH 18,B02,083749,Rideout; David Porter,0,0,36,36
1656312919857,MATH 18,B03,083750,Rideout; David Porter,0,0,36,36
1656312919857,MATH 18,B04,083751,Rideout; David Porter,0,1,36,36
1656312919857,MATH 18,B05,093473,Rideout; David Porter,0,0,36,36
1656312919857,MATH 18,B06,093474,Rideout; David Porter,2,0,36,34
1656312925880,MATH 20A,A01,083754,Zheng; Zequn,11,0,40,29
1656312931908,MATH 20B,A01,083756,Briones; Jor-el Thomas Caparas,0,0,36,36
1656312931908,MATH 20B,A02,083757,Briones; Jor-el Thomas Caparas,0,0,36,36
1656312931908,MATH 20B,A03,093475,Staff,1,0,36,35
1656312937940,MATH 20C,A01,083760,Briones; Jor-el Thomas Caparas,0,0,35,35
1656312937940,MATH 20C,A02,083761,Briones; Jor-el Thomas Caparas,9,1,35,26
1656312937940,MATH 20C,A03,093476,Staff,0,0,35,35
1656312937940,MATH 20C,B01,083762,Bach; Quang Tran,2,0,30,28
1656312943965,MATH 20D,A01,083765,Tran; Brian Kha,1,0,30,29
1656312943965,MATH 20D,A02,083766,Tran; Brian Kha,0,0,30,30
1656312943965,MATH 20D,A03,083767,Tran; Brian Kha,2,0,30,28
1656312949989,MATH 20E,A01,083771,Ganguly; Soumya,1,0,32,31
1656312949989,MATH 20E,A02,083772,Ganguly; Soumya,0,0,32,32
1656312949989,MATH 20E,B01,083773,Ciotti; Benjamin,18,0,35,17
1656312949989,MATH 20E,B02,083774,Ciotti; Benjamin,16,0,35,19
1656312956013,MATH 103A,A01,083777,Greenfeld; Be'Eri,2,0,36,34
1656312956013,MATH 103A,A02,083778,Greenfeld; Be'Eri,3,0,36,33
1656312956013,MATH 103A,A03,093561,Staff,3,0,36,33
1656312956013,MATH 103A,B01,083779,Greenfeld; Be'Eri,8,0,36,28
1656312956013,MATH 103A,B02,083780,Greenfeld; Be'Eri,0,0,36,36
1656312956013,MATH 103A,B03,093562,Staff,1,0,36,35
1656312962040,MATH 105,A01,085443,Carter; Anne Toulson,3,0,35,32
1656312962040,MATH 105,A02,093477,Staff,15,0,35,20
1656312968070,MATH 109,A01,083213,Ganzberger; Geoffrey Michael,1,0,34,33
1656312968070,MATH 109,A02,083214,Ganzberger; Geoffrey Michael,0,0,34,34
1656312968070,MATH 109,A03,093478,Staff,1,0,34,33
1656312968070,MATH 109,B01,083215,Ganzberger; Geoffrey Michael,3,0,32,29
1656312968070,MATH 109,B02,083216,Ganzberger; Geoffrey Michael,0,0,32,32
1656312968070,MATH 109,B03,093479,Staff,3,0,32,29
1656312974095,MATH 142A,A01,083219,Chow; Bennett,1,0,32,31
1656312974095,MATH 142A,A02,083220,Chow; Bennett,8,0,32,24
1656312974095,MATH 142A,A03,093480,Staff,4,0,32,28
1656312974095,MATH 142A,B03,093481,Staff,3,0,32,29
1656312974095,MATH 142A,B04,093558,Staff,7,0,32,25
1656312974095,MATH 142A,B05,093559,Staff,1,0,32,31
1656312980125,MATH 193A,A01,083224,Rotar; Vladimir,0,1,34,34
1656312980125,MATH 193A,A02,083225,Rotar; Vladimir,0,0,34,34
1656312980125,MATH 193A,A03,083781,Rotar; Vladimir,0,0,34,34
1656312980125,MATH 193A,A04,083782,Rotar; Vladimir,5,0,34,29
1656312980125,MATH 193A,A05,093482,Rotar; Vladimir,0,0,34,34
1656312986153,MATH 197,001,091859,McAuley; Julian John,9999,0,9999,0
1656312986153,MATH 197,002,095566,Kedlaya; Kiran S.,9997,0,9999,2
1656312986153,MATH 197,003,095567,Xiao; Ming,9999,0,9999,0
1656312986153,MATH 197,004,095571,Perols; Johan Lars,9998,0,9999,1
1656312993207,COGS 9,A01,083615,Shannon; Kyle Michael,3,0,75,72
1656312999231,COGS 11,A01,083617,Boyle; Mary E. T.,17,0,48,31
1656313005258,COGS 13,A01,083071,Bastos; Amalia Pinkusfeld,5,0,71,66
1656313011288,COGS 14A,A01,092681,Semenuks; Arturs,0,10,100,102
1656313017310,COGS 14B,A01,083073,Cheng; Tzu-Han,7,0,63,56
1656313023341,COGS 17,A01,092677,Semenuks; Arturs,6,0,81,75
1656313029370,COGS 100,A01,083619,Allen; Michael Gordon,3,0,70,67
1656313035400,COGS 101A,A01,083621,Davis; Joshua Daniel,5,0,68,63
1656313041426,COGS 101B,A01,091572,Allen; Michael Gordon,4,0,65,61
1656313047450,COGS 101C,A01,083625,Delgado; Tania,11,0,35,24
1656313053474,COGS 107A,A01,083627,Boyle; Mary E. T.,2,0,60,58
1656313059502,COGS 118A,A01,083075,Gupta; Anjum,7,0,76,69
1656313065525,CSE 3,A50,083646,Miranda; Gregory Joseph,18,0,50,32
1656313071548,CSE 8A,A50,083650,Miranda; Gregory Joseph,4,2,56,52
1656313077573,CSE 11,A01,083080,Cao; Yingjun,0,47,40,40
1656313083598,CSE 12,A01,083652,Krause-Levy; Sophia Louisa,5,1,120,115
1656313089626,CSE 15L,A01,083654,Morris; Justin Loren,2,0,50,48
1656313089626,CSE 15L,A02,083655,Morris; Justin Loren,4,0,50,46
1656313095650,CSE 20,A01,083657,Tran; Khoa Dang,31,0,80,49
1656313101678,CSE 21,A01,095574,Bach; Quang Tran,23,0,48,25
1656313107701,CSE 30,A01,083084,Eldon; John,1,4,80,79
1656313107701,CSE 30,B01,095061,Bhaskar; Nishant,0,1,50,50
1656313113725,CSE 100,A01,083659,Cao; Yingjun,1,18,70,69
1656313119754,CSE 134B,A01,083661,Powell; Thomas Allan,6,0,100,94
1656313125778,CSE 140,A01,083663,Gungor; Onat,9,0,85,76
1656313131807,CSE 140L,A01,083088,Eldon; John,10,0,100,90
1656313137831,CSE 175,A01,083665,Kumar; Rakesh,0,0,25,25
1656313143860,CSE 190,A00,092507,Dubnov; Shlomo,4,0,20,16
1656313149884,ECE 45,A01,083139,Congero; Spencer William,1,0,75,74
1656313155911,ECE 65,A50,083695,Saad; Andrew S,10,0,30,20
1656313155911,ECE 65,A51,095125,Staff,25,0,26,1
1656313161936,ECE 109,A01,091882,Touri; Behrouz,0,0,70,70
1656313167968,ECE 180,A00,083140,Abi Samra; Nicholas Camill,2,0,30,28
1656313167968,ECE 180,B00,083141,Abi Samra; Nicholas Camill,0,4,30,30
1656313173993,MATH 10A,A01,083735,Patchell; Gregory David,0,0,30,30
1656313173993,MATH 10A,A02,083736,Patchell; Gregory David,22,0,30,8
1656313173993,MATH 10A,A03,083737,Patchell; Gregory David,16,0,30,14
1656313180017,MATH 10B,A01,083207,Lim; Seonhee,2,0,34,32
1656313180017,MATH 10B,A02,083208,Lim; Seonhee,4,0,35,31
1656313180017,MATH 10B,A03,093472,Staff,1,0,34,33
1656313180017,MATH 10B,B01,083739,Sinha; Shubham,11,0,30,19
1656313186042,MATH 18,A01,083743,Cinel; Cameron Alexander,7,0,30,23
1656313186042,MATH 18,A02,083744,Cinel; Cameron Alexander,10,0,30,20
1656313186042,MATH 18,A03,083745,Cinel; Cameron Alexander,5,0,30,25
1656313186042,MATH 18,B01,083748,Rideout; David Porter,0,0,36,36
1656313186042,MATH 18,B02,083749,Rideout; David Porter,0,0,36,36
1656313186042,MATH 18,B03,083750,Rideout; David Porter,0,0,36,36
1656313186042,MATH 18,B04,083751,Rideout; David Porter,0,1,36,36
1656313186042,MATH 18,B05,093473,Rideout; David Porter,0,0,36,36
1656313186042,MATH 18,B06,093474,Rideout; David Porter,2,0,36,34
1656313192073,MATH 20A,A01,083754,Zheng; Zequn,11,0,40,29
1656313198104,MATH 20B,A01,083756,Briones; Jor-el Thomas Caparas,0,0,36,36
1656313198104,MATH 20B,A02,083757,Briones; Jor-el Thomas Caparas,0,0,36,36
1656313198104,MATH 20B,A03,093475,Staff,1,0,36,35
1656313204134,MATH 20C,A01,083760,Briones; Jor-el Thomas Caparas,0,0,35,35
1656313204134,MATH 20C,A02,083761,Briones; Jor-el Thomas Caparas,9,1,35,26
1656313204134,MATH 20C,A03,093476,Staff,0,0,35,35
1656313204134,MATH 20C,B01,083762,Bach; Quang Tran,2,0,30,28
1656313210158,MATH 20D,A01,083765,Tran; Brian Kha,1,0,30,29
1656313210158,MATH 20D,A02,083766,Tran; Brian Kha,0,0,30,30
1656313210158,MATH 20D,A03,083767,Tran; Brian Kha,2,0,30,28
1656313216186,MATH 20E,A01,083771,Ganguly; Soumya,1,0,32,31
1656313216186,MATH 20E,A02,083772,Ganguly; Soumya,0,0,32,32
1656313216186,MATH 20E,B01,083773,Ciotti; Benjamin,18,0,35,17
1656313216186,MATH 20E,B02,083774,Ciotti; Benjamin,16,0,35,19
1656313222216,MATH 103A,A01,083777,Greenfeld; Be'Eri,2,0,36,34
1656313222216,MATH 103A,A02,083778,Greenfeld; Be'Eri,3,0,36,33
1656313222216,MATH 103A,A03,093561,Staff,3,0,36,33
1656313222216,MATH 103A,B01,083779,Greenfeld; Be'Eri,8,0,36,28
1656313222216,MATH 103A,B02,083780,Greenfeld; Be'Eri,0,0,36,36
1656313222216,MATH 103A,B03,093562,Staff,1,0,36,35
1656313228239,MATH 105,A01,085443,Carter; Anne Toulson,3,0,35,32
1656313228239,MATH 105,A02,093477,Staff,15,0,35,20
1656313234264,MATH 109,A01,083213,Ganzberger; Geoffrey Michael,1,0,34,33
1656313234264,MATH 109,A02,083214,Ganzberger; Geoffrey Michael,0,0,34,34
1656313234264,MATH 109,A03,093478,Staff,1,0,34,33
1656313234264,MATH 109,B01,083215,Ganzberger; Geoffrey Michael,3,0,32,29
1656313234264,MATH 109,B02,083216,Ganzberger; Geoffrey Michael,0,0,32,32
1656313234264,MATH 109,B03,093479,Staff,3,0,32,29
1656313240289,MATH 142A,A01,083219,Chow; Bennett,1,0,32,31
1656313240289,MATH 142A,A02,083220,Chow; Bennett,8,0,32,24
1656313240289,MATH 142A,A03,093480,Staff,4,0,32,28
1656313240289,MATH 142A,B03,093481,Staff,3,0,32,29
1656313240289,MATH 142A,B04,093558,Staff,7,0,32,25
1656313240289,MATH 142A,B05,093559,Staff,1,0,32,31
1656313246321,MATH 193A,A01,083224,Rotar; Vladimir,0,1,34,34
1656313246321,MATH 193A,A02,083225,Rotar; Vladimir,0,0,34,34
1656313246321,MATH 193A,A03,083781,Rotar; Vladimir,0,0,34,34
1656313246321,MATH 193A,A04,083782,Rotar; Vladimir,5,0,34,29
1656313246321,MATH 193A,A05,093482,Rotar; Vladimir,0,0,34,34
1656313252355,MATH 197,001,091859,McAuley; Julian John,9999,0,9999,0
1656313252355,MATH 197,002,095566,Kedlaya; Kiran S.,9997,0,9999,2
1656313252355,MATH 197,003,095567,Xiao; Ming,9999,0,9999,0
1656313252355,MATH 197,004,095571,Perols; Johan Lars,9998,0,9999,1
1656313259512,COGS 9,A01,083615,Shannon; Kyle Michael,3,0,75,72
1656313265539,COGS 11,A01,083617,Boyle; Mary E. T.,17,0,48,31
1656313271586,COGS 13,A01,083071,Bastos; Amalia Pinkusfeld,5,0,71,66
1656313277613,COGS 14A,A01,092681,Semenuks; Arturs,0,10,100,102
1656313283637,COGS 14B,A01,083073,Cheng; Tzu-Han,7,0,63,56
1656313289683,COGS 17,A01,092677,Semenuks; Arturs,6,0,81,75
1656313295709,COGS 100,A01,083619,Allen; Michael Gordon,3,0,70,67
1656313301732,COGS 101A,A01,083621,Davis; Joshua Daniel,5,0,68,63
1656313307757,COGS 101B,A01,091572,Allen; Michael Gordon,4,0,65,61
1656313313788,COGS 101C,A01,083625,Delgado; Tania,11,0,35,24
1656313319819,COGS 107A,A01,083627,Boyle; Mary E. T.,2,0,60,58
1656313325851,COGS 118A,A01,083075,Gupta; Anjum,7,0,76,69
1656313331881,CSE 3,A50,083646,Miranda; Gregory Joseph,18,0,50,32
1656313337919,CSE 8A,A50,083650,Miranda; Gregory Joseph,4,2,56,52
1656313343943,CSE 11,A01,083080,Cao; Yingjun,0,47,40,40
1656313349986,CSE 12,A01,083652,Krause-Levy; Sophia Louisa,5,1,120,115
1656313356010,CSE 15L,A01,083654,Morris; Justin Loren,2,0,50,48
1656313356010,CSE 15L,A02,083655,Morris; Justin Loren,4,0,50,46
1656313362040,CSE 20,A01,083657,Tran; Khoa Dang,31,0,80,49
1656313368064,CSE 21,A01,095574,Bach; Quang Tran,23,0,48,25
1656313374095,CSE 30,A01,083084,Eldon; John,1,4,80,79
1656313374095,CSE 30,B01,095061,Bhaskar; Nishant,0,1,50,50
1656313380126,CSE 100,A01,083659,Cao; Yingjun,1,18,70,69
1656313386151,CSE 134B,A01,083661,Powell; Thomas Allan,6,0,100,94
1656313392180,CSE 140,A01,083663,Gungor; Onat,9,0,85,76
1656313398204,CSE 140L,A01,083088,Eldon; John,10,0,100,90
1656313404235,CSE 175,A01,083665,Kumar; Rakesh,0,0,25,25
1656313410260,CSE 190,A00,092507,Dubnov; Shlomo,4,0,20,16
1656313416290,ECE 45,A01,083139,Congero; Spencer William,1,0,75,74
1656313422312,ECE 65,A50,083695,Saad; Andrew S,10,0,30,20
1656313422312,ECE 65,A51,095125,Staff,25,0,26,1
1656313428346,ECE 109,A01,091882,Touri; Behrouz,0,0,70,70
1656313434380,ECE 180,A00,083140,Abi Samra; Nicholas Camill,2,0,30,28
1656313434380,ECE 180,B00,083141,Abi Samra; Nicholas Camill,0,4,30,30
1656313440416,MATH 10A,A01,083735,Patchell; Gregory David,0,0,30,30
1656313440416,MATH 10A,A02,083736,Patchell; Gregory David,22,0,30,8
1656313440416,MATH 10A,A03,083737,Patchell; Gregory David,16,0,30,14
1656313446440,MATH 10B,A01,083207,Lim; Seonhee,2,0,34,32
1656313446440,MATH 10B,A02,083208,Lim; Seonhee,4,0,35,31
1656313446440,MATH 10B,A03,093472,Staff,1,0,34,33
1656313446440,MATH 10B,B01,083739,Sinha; Shubham,11,0,30,19
1656313452475,MATH 18,A01,083743,Cinel; Cameron Alexander,7,0,30,23
1656313452475,MATH 18,A02,083744,Cinel; Cameron Alexander,10,0,30,20
1656313452475,MATH 18,A03,083745,Cinel; Cameron Alexander,5,0,30,25
1656313452475,MATH 18,B01,083748,Rideout; David Porter,0,0,36,36
1656313452475,MATH 18,B02,083749,Rideout; David Porter,0,0,36,36
1656313452475,MATH 18,B03,083750,Rideout; David Porter,0,0,36,36
1656313452475,MATH 18,B04,083751,Rideout; David Porter,0,1,36,36
1656313452475,MATH 18,B05,093473,Rideout; David Porter,0,0,36,36
1656313452475,MATH 18,B06,093474,Rideout; David Porter,2,0,36,34
1656313458502,MATH 20A,A01,083754,Zheng; Zequn,11,0,40,29
1656313464526,MATH 20B,A01,083756,Briones; Jor-el Thomas Caparas,0,0,36,36
1656313464526,MATH 20B,A02,083757,Briones; Jor-el Thomas Caparas,0,0,36,36
1656313464526,MATH 20B,A03,093475,Staff,1,0,36,35
1656313470551,MATH 20C,A01,083760,Briones; Jor-el Thomas Caparas,0,0,35,35
1656313470551,MATH 20C,A02,083761,Briones; Jor-el Thomas Caparas,9,1,35,26
1656313470551,MATH 20C,A03,093476,Staff,0,0,35,35
1656313470551,MATH 20C,B01,083762,Bach; Quang Tran,2,0,30,28
1656313476583,MATH 20D,A01,083765,Tran; Brian Kha,1,0,30,29
1656313476583,MATH 20D,A02,083766,Tran; Brian Kha,0,0,30,30
1656313476583,MATH 20D,A03,083767,Tran; Brian Kha,2,0,30,28
1656313482631,MATH 20E,A01,083771,Ganguly; Soumya,1,0,32,31
1656313482631,MATH 20E,A02,083772,Ganguly; Soumya,0,0,32,32
1656313482631,MATH 20E,B01,083773,Ciotti; Benjamin,18,0,35,17
1656313482631,MATH 20E,B02,083774,Ciotti; Benjamin,16,0,35,19
1656313488665,MATH 103A,A01,083777,Greenfeld; Be'Eri,2,0,36,34
1656313488665,MATH 103A,A02,083778,Greenfeld; Be'Eri,3,0,36,33
1656313488665,MATH 103A,A03,093561,Staff,3,0,36,33
1656313488665,MATH 103A,B01,083779,Greenfeld; Be'Eri,8,0,36,28
1656313488665,MATH 103A,B02,083780,Greenfeld; Be'Eri,0,0,36,36
1656313488665,MATH 103A,B03,093562,Staff,1,0,36,35
1656313494689,MATH 105,A01,085443,Carter; Anne Toulson,3,0,35,32
1656313494689,MATH 105,A02,093477,Staff,15,0,35,20
1656313500721,MATH 109,A01,083213,Ganzberger; Geoffrey Michael,1,0,34,33
1656313500721,MATH 109,A02,083214,Ganzberger; Geoffrey Michael,0,0,34,34
1656313500721,MATH 109,A03,093478,Staff,1,0,34,33
1656313500721,MATH 109,B01,083215,Ganzberger; Geoffrey Michael,3,0,32,29
1656313500721,MATH 109,B02,083216,Ganzberger; Geoffrey Michael,0,0,32,32
1656313500721,MATH 109,B03,093479,Staff,3,0,32,29
1656313506753,MATH 142A,A01,083219,Chow; Bennett,1,0,32,31
1656313506753,MATH 142A,A02,083220,Chow; Bennett,8,0,32,24
1656313506753,MATH 142A,A03,093480,Staff,4,0,32,28
1656313506753,MATH 142A,B03,093481,Staff,3,0,32,29
1656313506753,MATH 142A,B04,093558,Staff,7,0,32,25
1656313506753,MATH 142A,B05,093559,Staff,1,0,32,31
1656313512778,MATH 193A,A01,083224,Rotar; Vladimir,0,1,34,34
1656313512778,MATH 193A,A02,083225,Rotar; Vladimir,0,0,34,34
1656313512778,MATH 193A,A03,083781,Rotar; Vladimir,0,0,34,34
1656313512778,MATH 193A,A04,083782,Rotar; Vladimir,5,0,34,29
1656313512778,MATH 193A,A05,093482,Rotar; Vladimir,0,0,34,34
1656313518801,MATH 197,001,091859,McAuley; Julian John,9999,0,9999,0
1656313518801,MATH 197,002,095566,Kedlaya; Kiran S.,9997,0,9999,2
1656313518801,MATH 197,003,095567,Xiao; Ming,9999,0,9999,0
1656313518801,MATH 197,004,095571,Perols; Johan Lars,9998,0,9999,1
1656313525875,COGS 9,A01,083615,Shannon; Kyle Michael,3,0,75,72
1656313531904,COGS 11,A01,083617,Boyle; Mary E. T.,17,0,48,31
1656313537927,COGS 13,A01,083071,Bastos; Amalia Pinkusfeld,5,0,71,66
1656313543955,COGS 14A,A01,092681,Semenuks; Arturs,0,10,100,102
1656313549979,COGS 14B,A01,083073,Cheng; Tzu-Han,7,0,63,56
1656313556002,COGS 17,A01,092677,Semenuks; Arturs,6,0,81,75
1656313562028,COGS 100,A01,083619,Allen; Michael Gordon,3,0,70,67
1656313568068,COGS 101A,A01,083621,Davis; Joshua Daniel,5,0,68,63
1656313574093,COGS 101B,A01,091572,Allen; Michael Gordon,4,0,65,61
1656313580117,COGS 101C,A01,083625,Delgado; Tania,11,0,35,24
1656313586146,COGS 107A,A01,083627,Boyle; Mary E. T.,2,0,60,58
1656313592178,COGS 118A,A01,083075,Gupta; Anjum,7,0,76,69
1656313598201,CSE 3,A50,083646,Miranda; Gregory Joseph,18,0,50,32
1656313604229,CSE 8A,A50,083650,Miranda; Gregory Joseph,4,2,56,52
1656313610257,CSE 11,A01,083080,Cao; Yingjun,0,47,40,40
1656313616281,CSE 12,A01,083652,Krause-Levy; Sophia Louisa,5,1,120,115
1656313622305,CSE 15L,A01,083654,Morris; Justin Loren,2,0,50,48
1656313622305,CSE 15L,A02,083655,Morris; Justin Loren,4,0,50,46
1656313628333,CSE 20,A01,083657,Tran; Khoa Dang,31,0,80,49
1656313634357,CSE 21,A01,095574,Bach; Quang Tran,23,0,48,25
1656313640405,CSE 30,A01,083084,Eldon; John,1,4,80,79
1656313640405,CSE 30,B01,095061,Bhaskar; Nishant,0,1,50,50
1656313646432,CSE 100,A01,083659,Cao; Yingjun,1,18,70,69
1656313652456,CSE 134B,A01,083661,Powell; Thomas Allan,6,0,100,94
1656313658488,CSE 140,A01,083663,Gungor; Onat,9,0,85,76
1656313664516,CSE 140L,A01,083088,Eldon; John,10,0,100,90
1656313670540,CSE 175,A01,083665,Kumar; Rakesh,0,0,25,25
1656313676564,CSE 190,A00,092507,Dubnov; Shlomo,4,0,20,16
1656313682587,ECE 45,A01,083139,Congero; Spencer William,1,0,75,74
1656313688616,ECE 65,A50,083695,Saad; Andrew S,10,0,30,20
1656313688616,ECE 65,A51,095125,Staff,25,0,26,1
1656313694639,ECE 109,A01,091882,Touri; Behrouz,0,0,70,70
1656313700673,ECE 180,A00,083140,Abi Samra; Nicholas Camill,2,0,30,28
1656313700673,ECE 180,B00,083141,Abi Samra; Nicholas Camill,0,4,30,30
1656313706701,MATH 10A,A01,083735,Patchell; Gregory David,0,0,30,30
1656313706701,MATH 10A,A02,083736,Patchell; Gregory David,22,0,30,8
1656313706701,MATH 10A,A03,083737,Patchell; Gregory David,16,0,30,14
1656313712725,MATH 10B,A01,083207,Lim; Seonhee,2,0,34,32
1656313712725,MATH 10B,A02,083208,Lim; Seonhee,4,0,35,31
1656313712725,MATH 10B,A03,093472,Staff,1,0,34,33
1656313712725,MATH 10B,B01,083739,Sinha; Shubham,11,0,30,19
1656313718761,MATH 18,A01,083743,Cinel; Cameron Alexander,7,0,30,23
1656313718761,MATH 18,A02,083744,Cinel; Cameron Alexander,10,0,30,20
1656313718761,MATH 18,A03,083745,Cinel; Cameron Alexander,5,0,30,25
1656313718761,MATH 18,B01,083748,Rideout; David Porter,0,0,36,36
1656313718761,MATH 18,B02,083749,Rideout; David Porter,0,0,36,36
1656313718761,MATH 18,B03,083750,Rideout; David Porter,0,0,36,36
1656313718761,MATH 18,B04,083751,Rideout; David Porter,0,1,36,36
1656313718761,MATH 18,B05,093473,Rideout; David Porter,0,0,36,36
1656313718761,MATH 18,B06,093474,Rideout; David Porter,2,0,36,34
1656313724790,MATH 20A,A01,083754,Zheng; Zequn,11,0,40,29
1656313730814,MATH 20B,A01,083756,Briones; Jor-el Thomas Caparas,0,0,36,36
1656313730814,MATH 20B,A02,083757,Briones; Jor-el Thomas Caparas,0,0,36,36
1656313730814,MATH 20B,A03,093475,Staff,1,0,36,35
1656313736844,MATH 20C,A01,083760,Briones; Jor-el Thomas Caparas,0,0,35,35
1656313736844,MATH 20C,A02,083761,Briones; Jor-el Thomas Caparas,9,1,35,26
1656313736844,MATH 20C,A03,093476,Staff,0,0,35,35
1656313736844,MATH 20C,B01,083762,Bach; Quang Tran,2,0,30,28
1656313742874,MATH 20D,A01,083765,Tran; Brian Kha,1,0,30,29
1656313742874,MATH 20D,A02,083766,Tran; Brian Kha,0,0,30,30
1656313742874,MATH 20D,A03,083767,Tran; Brian Kha,2,0,30,28
1656313748897,MATH 20E,A01,083771,Ganguly; Soumya,1,0,32,31
1656313748897,MATH 20E,A02,083772,Ganguly; Soumya,0,0,32,32
1656313748897,MATH 20E,B01,083773,Ciotti; Benjamin,18,0,35,17
1656313748897,MATH 20E,B02,083774,Ciotti; Benjamin,16,0,35,19
1656313754921,MATH 103A,A01,083777,Greenfeld; Be'Eri,2,0,36,34
1656313754921,MATH 103A,A02,083778,Greenfeld; Be'Eri,3,0,36,33
1656313754921,MATH 103A,A03,093561,Staff,3,0,36,33
1656313754921,MATH 103A,B01,083779,Greenfeld; Be'Eri,8,0,36,28
1656313754921,MATH 103A,B02,083780,Greenfeld; Be'Eri,0,0,36,36
1656313754921,MATH 103A,B03,093562,Staff,1,0,36,35
1656313760950,MATH 105,A01,085443,Carter; Anne Toulson,3,0,35,32
1656313760950,MATH 105,A02,093477,Staff,15,0,35,20
1656313766980,MATH 109,A01,083213,Ganzberger; Geoffrey Michael,1,0,34,33
1656313766980,MATH 109,A02,083214,Ganzberger; Geoffrey Michael,0,0,34,34
1656313766980,MATH 109,A03,093478,Staff,1,0,34,33
1656313766980,MATH 109,B01,083215,Ganzberger; Geoffrey Michael,3,0,32,29
1656313766980,MATH 109,B02,083216,Ganzberger; Geoffrey Michael,0,0,32,32
1656313766980,MATH 109,B03,093479,Staff,3,0,32,29
1656313773005,MATH 142A,A01,083219,Chow; Bennett,1,0,32,31
1656313773005,MATH 142A,A02,083220,Chow; Bennett,8,0,32,24
1656313773005,MATH 142A,A03,093480,Staff,4,0,32,28
1656313773005,MATH 142A,B03,093481,Staff,3,0,32,29
1656313773005,MATH 142A,B04,093558,Staff,7,0,32,25
1656313773005,MATH 142A,B05,093559,Staff,1,0,32,31
1656313779029,MATH 193A,A01,083224,Rotar; Vladimir,0,1,34,34
1656313779029,MATH 193A,A02,083225,Rotar; Vladimir,0,0,34,34
1656313779029,MATH 193A,A03,083781,Rotar; Vladimir,0,0,34,34
1656313779029,MATH 193A,A04,083782,Rotar; Vladimir,5,0,34,29
1656313779029,MATH 193A,A05,093482,Rotar; Vladimir,0,0,34,34
1656313785057,MATH 197,001,091859,McAuley; Julian John,9999,0,9999,0
1656313785057,MATH 197,002,095566,Kedlaya; Kiran S.,9997,0,9999,2
1656313785057,MATH 197,003,095567,Xiao; Ming,9999,0,9999,0
1656313785057,MATH 197,004,095571,Perols; Johan Lars,9998,0,9999,1
1656313792138,COGS 9,A01,083615,Shannon; Kyle Michael,3,0,75,72
1656313798162,COGS 11,A01,083617,Boyle; Mary E. T.,17,0,48,31
1656313804191,COGS 13,A01,083071,Bastos; Amalia Pinkusfeld,5,0,71,66
1656313810223,COGS 14A,A01,092681,Semenuks; Arturs,0,9,100,103
1656313816255,COGS 14B,A01,083073,Cheng; Tzu-Han,7,0,63,56
1656313822279,COGS 17,A01,092677,Semenuks; Arturs,6,0,81,75
1656313828307,COGS 100,A01,083619,Allen; Michael Gordon,3,0,70,67
1656313834331,COGS 101A,A01,083621,Davis; Joshua Daniel,5,0,68,63
1656313840358,COGS 101B,A01,091572,Allen; Michael Gordon,4,0,65,61
1656313846396,COGS 101C,A01,083625,Delgado; Tania,11,0,35,24
1656313852419,COGS 107A,A01,083627,Boyle; Mary E. T.,2,0,60,58
1656313858524,COGS 118A,A01,083075,Gupta; Anjum,7,0,76,69
1656313864546,CSE 3,A50,083646,Miranda; Gregory Joseph,18,0,50,32
1656313870570,CSE 8A,A50,083650,Miranda; Gregory Joseph,4,2,56,52
1656313876601,CSE 11,A01,083080,Cao; Yingjun,0,47,40,40
1656313882626,CSE 12,A01,083652,Krause-Levy; Sophia Louisa,5,1,120,115
1656313888650,CSE 15L,A01,083654,Morris; Justin Loren,2,0,50,48
1656313888650,CSE 15L,A02,083655,Morris; Justin Loren,4,0,50,46
1656313894691,CSE 20,A01,083657,Tran; Khoa Dang,31,0,80,49
1656313900723,CSE 21,A01,095574,Bach; Quang Tran,23,0,48,25
1656313906757,CSE 30,A01,083084,Eldon; John,1,4,80,79
1656313906757,CSE 30,B01,095061,Bhaskar; Nishant,0,1,50,50
1656313912783,CSE 100,A01,083659,Cao; Yingjun,1,18,70,69
1656313918812,CSE 134B,A01,083661,Powell; Thomas Allan,6,0,100,94
1656313924843,CSE 140,A01,083663,Gungor; Onat,9,0,85,76
1656313930873,CSE 140L,A01,083088,Eldon; John,10,0,100,90
1656313936905,CSE 175,A01,083665,Kumar; Rakesh,0,0,25,25
1656313942935,CSE 190,A00,092507,Dubnov; Shlomo,4,0,20,16
1656313948963,ECE 45,A01,083139,Congero; Spencer William,1,0,75,74
1656313954993,ECE 65,A50,083695,Saad; Andrew S,10,0,30,20
1656313954993,ECE 65,A51,095125,Staff,25,0,26,1
1656313961016,ECE 109,A01,091882,Touri; Behrouz,0,0,70,70
1656313967039,ECE 180,A00,083140,Abi Samra; Nicholas Camill,2,0,30,28
1656313967039,ECE 180,B00,083141,Abi Samra; Nicholas Camill,0,4,30,30
1656313973064,MATH 10A,A01,083735,Patchell; Gregory David,0,0,30,30
1656313973064,MATH 10A,A02,083736,Patchell; Gregory David,22,0,30,8
1656313973064,MATH 10A,A03,083737,Patchell; Gregory David,16,0,30,14
1656313979091,MATH 10B,A01,083207,Lim; Seonhee,2,0,34,32
1656313979091,MATH 10B,A02,083208,Lim; Seonhee,4,0,35,31
1656313979091,MATH 10B,A03,093472,Staff,1,0,34,33
1656313979091,MATH 10B,B01,083739,Sinha; Shubham,11,0,30,19
1656313985119,MATH 18,A01,083743,Cinel; Cameron Alexander,7,0,30,23
1656313985119,MATH 18,A02,083744,Cinel; Cameron Alexander,10,0,30,20
1656313985119,MATH 18,A03,083745,Cinel; Cameron Alexander,5,0,30,25
1656313985119,MATH 18,B01,083748,Rideout; David Porter,0,0,36,36
1656313985119,MATH 18,B02,083749,Rideout; David Porter,0,0,36,36
1656313985119,MATH 18,B03,083750,Rideout; David Porter,0,0,36,36
1656313985119,MATH 18,B04,083751,Rideout; David Porter,0,1,36,36
1656313985119,MATH 18,B05,093473,Rideout; David Porter,0,0,36,36
1656313985119,MATH 18,B06,093474,Rideout; David Porter,2,0,36,34
1656313991147,MATH 20A,A01,083754,Zheng; Zequn,11,0,40,29
1656313997176,MATH 20B,A01,083756,Briones; Jor-el Thomas Caparas,0,0,36,36
1656313997176,MATH 20B,A02,083757,Briones; Jor-el Thomas Caparas,0,0,36,36
1656313997176,MATH 20B,A03,093475,Staff,1,0,36,35
1656314003208,MATH 20C,A01,083760,Briones; Jor-el Thomas Caparas,0,0,35,35
1656314003208,MATH 20C,A02,083761,Briones; Jor-el Thomas Caparas,9,1,35,26
1656314003208,MATH 20C,A03,093476,Staff,0,0,35,35
1656314003208,MATH 20C,B01,083762,Bach; Quang Tran,2,0,30,28
1656314009232,MATH 20D,A01,083765,Tran; Brian Kha,1,0,30,29
1656314009232,MATH 20D,A02,083766,Tran; Brian Kha,0,0,30,30
1656314009232,MATH 20D,A03,083767,Tran; Brian Kha,2,0,30,28
1656314015255,MATH 20E,A01,083771,Ganguly; Soumya,1,0,32,31
1656314015255,MATH 20E,A02,083772,Ganguly; Soumya,0,0,32,32
1656314015255,MATH 20E,B01,083773,Ciotti; Benjamin,18,0,35,17
1656314015255,MATH 20E,B02,083774,Ciotti; Benjamin,16,0,35,19
1656314021277,MATH 103A,A01,083777,Greenfeld; Be'Eri,2,0,36,34
1656314021277,MATH 103A,A02,083778,Greenfeld; Be'Eri,3,0,36,33
1656314021277,MATH 103A,A03,093561,Staff,3,0,36,33
1656314021277,MATH 103A,B01,083779,Greenfeld; Be'Eri,8,0,36,28
1656314021277,MATH 103A,B02,083780,Greenfeld; Be'Eri,0,0,36,36
1656314021277,MATH 103A,B03,093562,Staff,1,0,36,35
1656314027301,MATH 105,A01,085443,Carter; Anne Toulson,3,0,35,32
1656314027301,MATH 105,A02,093477,Staff,15,0,35,20
1656314033331,MATH 109,A01,083213,Ganzberger; Geoffrey Michael,1,0,34,33
1656314033331,MATH 109,A02,083214,Ganzberger; Geoffrey Michael,0,0,34,34
1656314033331,MATH 109,A03,093478,Staff,1,0,34,33
1656314033331,MATH 109,B01,083215,Ganzberger; Geoffrey Michael,3,0,32,29
1656314033331,MATH 109,B02,083216,Ganzberger; Geoffrey Michael,0,0,32,32
1656314033331,MATH 109,B03,093479,Staff,3,0,32,29
1656314039359,MATH 142A,A01,083219,Chow; Bennett,1,0,32,31
1656314039359,MATH 142A,A02,083220,Chow; Bennett,8,0,32,24
1656314039359,MATH 142A,A03,093480,Staff,4,0,32,28
1656314039359,MATH 142A,B03,093481,Staff,3,0,32,29
1656314039359,MATH 142A,B04,093558,Staff,7,0,32,25
1656314039359,MATH 142A,B05,093559,Staff,1,0,32,31
1656314045391,MATH 193A,A01,083224,Rotar; Vladimir,0,1,34,34
1656314045391,MATH 193A,A02,083225,Rotar; Vladimir,0,0,34,34
1656314045391,MATH 193A,A03,083781,Rotar; Vladimir,0,0,34,34
1656314045391,MATH 193A,A04,083782,Rotar; Vladimir,5,0,34,29
1656314045391,MATH 193A,A05,093482,Rotar; Vladimir,0,0,34,34
1656314051415,MATH 197,001,091859,McAuley; Julian John,9999,0,9999,0
1656314051415,MATH 197,002,095566,Kedlaya; Kiran S.,9997,0,9999,2
1656314051415,MATH 197,003,095567,Xiao; Ming,9999,0,9999,0
1656314051415,MATH 197,004,095571,Perols; Johan Lars,9998,0,9999,1
1656314058514,COGS 9,A01,083615,Shannon; Kyle Michael,3,0,75,72
1656314064545,COGS 11,A01,083617,Boyle; Mary E. T.,17,0,48,31
1656314070569,COGS 13,A01,083071,Bastos; Amalia Pinkusfeld,5,0,71,66
1656314076594,COGS 14A,A01,092681,Semenuks; Arturs,0,9,100,103
1656314082620,COGS 14B,A01,083073,Cheng; Tzu-Han,7,0,63,56
1656314088648,COGS 17,A01,092677,Semenuks; Arturs,6,0,81,75
1656314094681,COGS 100,A01,083619,Allen; Michael Gordon,3,0,70,67
1656314100704,COGS 101A,A01,083621,Davis; Joshua Daniel,5,0,68,63
1656314106728,COGS 101B,A01,091572,Allen; Michael Gordon,4,0,65,61
1656314112752,COGS 101C,A01,083625,Delgado; Tania,11,0,35,24
1656314118776,COGS 107A,A01,083627,Boyle; Mary E. T.,2,0,60,58
1656314124818,COGS 118A,A01,083075,Gupta; Anjum,7,0,76,69
1656314130850,CSE 3,A50,083646,Miranda; Gregory Joseph,18,0,50,32
1656314136873,CSE 8A,A50,083650,Miranda; Gregory Joseph,4,2,56,52
1656314142897,CSE 11,A01,083080,Cao; Yingjun,0,47,40,40
1656314148921,CSE 12,A01,083652,Krause-Levy; Sophia Louisa,5,1,120,115
1656314154945,CSE 15L,A01,083654,Morris; Justin Loren,2,0,50,48
1656314154945,CSE 15L,A02,083655,Morris; Justin Loren,4,0,50,46
1656314160978,CSE 20,A01,083657,Tran; Khoa Dang,31,0,80,49
1656314167002,CSE 21,A01,095574,Bach; Quang Tran,23,0,48,25
1656314173030,CSE 30,A01,083084,Eldon; John,1,4,80,79
1656314173030,CSE 30,B01,095061,Bhaskar; Nishant,0,1,50,50
1656314179060,CSE 100,A01,083659,Cao; Yingjun,1,18,70,69
1656314185087,CSE 134B,A01,083661,Powell; Thomas Allan,6,0,100,94
1656314191111,CSE 140,A01,083663,Gungor; Onat,9,0,85,76
1656314197138,CSE 140L,A01,083088,Eldon; John,10,0,100,90
1656314203162,CSE 175,A01,083665,Kumar; Rakesh,0,0,25,25
1656314209187,CSE 190,A00,092507,Dubnov; Shlomo,4,0,20,16
1656314215215,ECE 45,A01,083139,Congero; Spencer William,1,0,75,74
1656314221244,ECE 65,A50,083695,Saad; Andrew S,10,0,30,20
1656314221244,ECE 65,A51,095125,Staff,25,0,26,1
1656314227271,ECE 109,A01,091882,Touri; Behrouz,0,0,70,70
1656314233301,ECE 180,A00,083140,Abi Samra; Nicholas Camill,2,0,30,28
1656314233301,ECE 180,B00,083141,Abi Samra; Nicholas Camill,0,4,30,30
1656314239330,MATH 10A,A01,083735,Patchell; Gregory David,0,0,30,30
1656314239330,MATH 10A,A02,083736,Patchell; Gregory David,22,0,30,8
1656314239330,MATH 10A,A03,083737,Patchell; Gregory David,16,0,30,14
1656314245360,MATH 10B,A01,083207,Lim; Seonhee,2,0,34,32
1656314245360,MATH 10B,A02,083208,Lim; Seonhee,4,0,35,31
1656314245360,MATH 10B,A03,093472,Staff,1,0,34,33
1656314245360,MATH 10B,B01,083739,Sinha; Shubham,11,0,30,19
1656314251391,MATH 18,A01,083743,Cinel; Cameron Alexander,7,0,30,23
1656314251391,MATH 18,A02,083744,Cinel; Cameron Alexander,10,0,30,20
1656314251391,MATH 18,A03,083745,Cinel; Cameron Alexander,5,0,30,25
1656314251391,MATH 18,B01,083748,Rideout; David Porter,0,0,36,36
1656314251391,MATH 18,B02,083749,Rideout; David Porter,0,0,36,36
1656314251391,MATH 18,B03,083750,Rideout; David Porter,0,0,36,36
1656314251391,MATH 18,B04,083751,Rideout; David Porter,0,1,36,36
1656314251391,MATH 18,B05,093473,Rideout; David Porter,0,0,36,36
1656314251391,MATH 18,B06,093474,Rideout; David Porter,2,0,36,34
1656314257418,MATH 20A,A01,083754,Zheng; Zequn,11,0,40,29
1656314263461,MATH 20B,A01,083756,Briones; Jor-el Thomas Caparas,0,0,36,36
1656314263461,MATH 20B,A02,083757,Briones; Jor-el Thomas Caparas,0,0,36,36
1656314263461,MATH 20B,A03,093475,Staff,1,0,36,35
1656314269490,MATH 20C,A01,083760,Briones; Jor-el Thomas Caparas,0,0,35,35
1656314269490,MATH 20C,A02,083761,Briones; Jor-el Thomas Caparas,9,1,35,26
1656314269490,MATH 20C,A03,093476,Staff,0,0,35,35
1656314269490,MATH 20C,B01,083762,Bach; Quang Tran,2,0,30,28
1656314275528,MATH 20D,A01,083765,Tran; Brian Kha,1,0,30,29
1656314275528,MATH 20D,A02,083766,Tran; Brian Kha,0,0,30,30
1656314275528,MATH 20D,A03,083767,Tran; Brian Kha,2,0,30,28
1656314281560,MATH 20E,A01,083771,Ganguly; Soumya,1,0,32,31
1656314281560,MATH 20E,A02,083772,Ganguly; Soumya,0,0,32,32
1656314281560,MATH 20E,B01,083773,Ciotti; Benjamin,18,0,35,17
1656314281560,MATH 20E,B02,083774,Ciotti; Benjamin,16,0,35,19
1656314287587,MATH 103A,A01,083777,Greenfeld; Be'Eri,2,0,36,34
1656314287587,MATH 103A,A02,083778,Greenfeld; Be'Eri,3,0,36,33
1656314287587,MATH 103A,A03,093561,Staff,3,0,36,33
1656314287587,MATH 103A,B01,083779,Greenfeld; Be'Eri,8,0,36,28
1656314287587,MATH 103A,B02,083780,Greenfeld; Be'Eri,0,0,36,36
1656314287587,MATH 103A,B03,093562,Staff,1,0,36,35
1656314293625,MATH 105,A01,085443,Carter; Anne Toulson,3,0,35,32
1656314293625,MATH 105,A02,093477,Staff,15,0,35,20
1656314299659,MATH 109,A01,083213,Ganzberger; Geoffrey Michael,1,0,34,33
1656314299659,MATH 109,A02,083214,Ganzberger; Geoffrey Michael,0,0,34,34
1656314299659,MATH 109,A03,093478,Staff,1,0,34,33
1656314299659,MATH 109,B01,083215,Ganzberger; Geoffrey Michael,3,0,32,29
1656314299659,MATH 109,B02,083216,Ganzberger; Geoffrey Michael,0,0,32,32
1656314299659,MATH 109,B03,093479,Staff,3,0,32,29
1656314305701,MATH 142A,A01,083219,Chow; Bennett,1,0,32,31
1656314305701,MATH 142A,A02,083220,Chow; Bennett,8,0,32,24
1656314305701,MATH 142A,A03,093480,Staff,4,0,32,28
1656314305701,MATH 142A,B03,093481,Staff,3,0,32,29
1656314305701,MATH 142A,B04,093558,Staff,7,0,32,25
1656314305701,MATH 142A,B05,093559,Staff,1,0,32,31
1656314311732,MATH 193A,A01,083224,Rotar; Vladimir,0,1,34,34
1656314311732,MATH 193A,A02,083225,Rotar; Vladimir,0,0,34,34
1656314311732,MATH 193A,A03,083781,Rotar; Vladimir,0,0,34,34
1656314311732,MATH 193A,A04,083782,Rotar; Vladimir,5,0,34,29
1656314311732,MATH 193A,A05,093482,Rotar; Vladimir,0,0,34,34
1656314317759,MATH 197,001,091859,McAuley; Julian John,9999,0,9999,0
1656314317759,MATH 197,002,095566,Kedlaya; Kiran S.,9997,0,9999,2
1656314317759,MATH 197,003,095567,Xiao; Ming,9999,0,9999,0
1656314317759,MATH 197,004,095571,Perols; Johan Lars,9998,0,9999,1
1656314324834,COGS 9,A01,083615,Shannon; Kyle Michael,3,0,75,72
1656314330861,COGS 11,A01,083617,Boyle; Mary E. T.,17,0,48,31
1656314336885,COGS 13,A01,083071,Bastos; Amalia Pinkusfeld,5,0,71,66
1656314342911,COGS 14A,A01,092681,Semenuks; Arturs,0,9,100,103
1656314348941,COGS 14B,A01,083073,Cheng; Tzu-Han,7,0,63,56
1656314354965,COGS 17,A01,092677,Semenuks; Arturs,6,0,81,75
1656314361005,COGS 100,A01,083619,Allen; Michael Gordon,3,0,70,67
1656314367028,COGS 101A,A01,083621,Davis; Joshua Daniel,5,0,68,63
1656314373058,COGS 101B,A01,091572,Allen; Michael Gordon,4,0,65,61
1656314379086,COGS 101C,A01,083625,Delgado; Tania,11,0,35,24
1656314385114,COGS 107A,A01,083627,Boyle; Mary E. T.,2,0,60,58
1656314391145,COGS 118A,A01,083075,Gupta; Anjum,7,0,76,69
1656314397170,CSE 3,A50,083646,Miranda; Gregory Joseph,18,0,50,32
1656314403198,CSE 8A,A50,083650,Miranda; Gregory Joseph,4,2,56,52
1656314409224,CSE 11,A01,083080,Cao; Yingjun,0,47,40,40
1656314415251,CSE 12,A01,083652,Krause-Levy; Sophia Louisa,5,1,120,115
1656314421290,CSE 15L,A01,083654,Morris; Justin Loren,2,0,50,48
1656314421290,CSE 15L,A02,083655,Morris; Justin Loren,4,0,50,46
1656314427317,CSE 20,A01,083657,Tran; Khoa Dang,31,0,80,49
1656314433345,CSE 21,A01,095574,Bach; Quang Tran,23,0,48,25
1656314439371,CSE 30,A01,083084,Eldon; John,1,4,80,79
1656314439371,CSE 30,B01,095061,Bhaskar; Nishant,0,1,50,50
1656314445405,CSE 100,A01,083659,Cao; Yingjun,1,18,70,69
1656314451429,CSE 134B,A01,083661,Powell; Thomas Allan,6,0,100,94
1656314457531,CSE 140,A01,083663,Gungor; Onat,9,0,85,76
1656314463556,CSE 140L,A01,083088,Eldon; John,10,0,100,90
1656314469582,CSE 175,A01,083665,Kumar; Rakesh,0,0,25,25
1656314475610,CSE 190,A00,092507,Dubnov; Shlomo,4,0,20,16
1656314481641,ECE 45,A01,083139,Congero; Spencer William,1,0,75,74
1656314487678,ECE 65,A50,083695,Saad; Andrew S,10,0,30,20
1656314487678,ECE 65,A51,095125,Staff,25,0,26,1
1656314493701,ECE 109,A01,091882,Touri; Behrouz,0,0,70,70
1656314499739,ECE 180,A00,083140,Abi Samra; Nicholas Camill,2,0,30,28
1656314499739,ECE 180,B00,083141,Abi Samra; Nicholas Camill,0,4,30,30
1656314505770,MATH 10A,A01,083735,Patchell; Gregory David,0,0,30,30
1656314505770,MATH 10A,A02,083736,Patchell; Gregory David,22,0,30,8
1656314505770,MATH 10A,A03,083737,Patchell; Gregory David,16,0,30,14
1656314511802,MATH 10B,A01,083207,Lim; Seonhee,2,0,34,32
1656314511802,MATH 10B,A02,083208,Lim; Seonhee,4,0,35,31
1656314511802,MATH 10B,A03,093472,Staff,1,0,34,33
1656314511802,MATH 10B,B01,083739,Sinha; Shubham,11,0,30,19
1656314517827,MATH 18,A01,083743,Cinel; Cameron Alexander,7,0,30,23
1656314517827,MATH 18,A02,083744,Cinel; Cameron Alexander,10,0,30,20
1656314517827,MATH 18,A03,083745,Cinel; Cameron Alexander,5,0,30,25
1656314517827,MATH 18,B01,083748,Rideout; David Porter,0,0,36,36
1656314517827,MATH 18,B02,083749,Rideout; David Porter,0,0,36,36
1656314517827,MATH 18,B03,083750,Rideout; David Porter,0,0,36,36
1656314517827,MATH 18,B04,083751,Rideout; David Porter,0,1,36,36
1656314517827,MATH 18,B05,093473,Rideout; David Porter,0,0,36,36
1656314517827,MATH 18,B06,093474,Rideout; David Porter,2,0,36,34
1656314523853,MATH 20A,A01,083754,Zheng; Zequn,11,0,40,29
1656314529880,MATH 20B,A01,083756,Briones; Jor-el Thomas Caparas,0,0,36,36
1656314529880,MATH 20B,A02,083757,Briones; Jor-el Thomas Caparas,0,0,36,36
1656314529880,MATH 20B,A03,093475,Staff,1,0,36,35
1656314535904,MATH 20C,A01,083760,Briones; Jor-el Thomas Caparas,0,0,35,35
1656314535904,MATH 20C,A02,083761,Briones; Jor-el Thomas Caparas,9,1,35,26
1656314535904,MATH 20C,A03,093476,Staff,0,0,35,35
1656314535904,MATH 20C,B01,083762,Bach; Quang Tran,2,0,30,28
1656314541941,MATH 20D,A01,083765,Tran; Brian Kha,1,0,30,29
1656314541941,MATH 20D,A02,083766,Tran; Brian Kha,0,0,30,30
1656314541941,MATH 20D,A03,083767,Tran; Brian Kha,2,0,30,28
1656314547976,MATH 20E,A01,083771,Ganguly; Soumya,1,0,32,31
1656314547976,MATH 20E,A02,083772,Ganguly; Soumya,0,0,32,32
1656314547976,MATH 20E,B01,083773,Ciotti; Benjamin,18,0,35,17
1656314547976,MATH 20E,B02,083774,Ciotti; Benjamin,16,0,35,19
1656314554000,MATH 103A,A01,083777,Greenfeld; Be'Eri,2,0,36,34
1656314554000,MATH 103A,A02,083778,Greenfeld; Be'Eri,3,0,36,33
1656314554000,MATH 103A,A03,093561,Staff,3,0,36,33
1656314554000,MATH 103A,B01,083779,Greenfeld; Be'Eri,8,0,36,28
1656314554000,MATH 103A,B02,083780,Greenfeld; Be'Eri,0,0,36,36
1656314554000,MATH 103A,B03,093562,Staff,1,0,36,35
1656314560024,MATH 105,A01,085443,Carter; Anne Toulson,3,0,35,32
1656314560024,MATH 105,A02,093477,Staff,15,0,35,20
1656314566049,MATH 109,A01,083213,Ganzberger; Geoffrey Michael,1,0,34,33
1656314566049,MATH 109,A02,083214,Ganzberger; Geoffrey Michael,0,0,34,34
1656314566049,MATH 109,A03,093478,Staff,1,0,34,33
1656314566049,MATH 109,B01,083215,Ganzberger; Geoffrey Michael,3,0,32,29
1656314566049,MATH 109,B02,083216,Ganzberger; Geoffrey Michael,0,0,32,32
1656314566049,MATH 109,B03,093479,Staff,3,0,32,29
1656314572079,MATH 142A,A01,083219,Chow; Bennett,1,0,32,31
1656314572079,MATH 142A,A02,083220,Chow; Bennett,8,0,32,24
1656314572079,MATH 142A,A03,093480,Staff,4,0,32,28
1656314572079,MATH 142A,B03,093481,Staff,3,0,32,29
1656314572079,MATH 142A,B04,093558,Staff,7,0,32,25
1656314572079,MATH 142A,B05,093559,Staff,1,0,32,31
1656314578102,MATH 193A,A01,083224,Rotar; Vladimir,0,1,34,34
1656314578102,MATH 193A,A02,083225,Rotar; Vladimir,0,0,34,34
1656314578102,MATH 193A,A03,083781,Rotar; Vladimir,0,0,34,34
1656314578102,MATH 193A,A04,083782,Rotar; Vladimir,5,0,34,29
1656314578102,MATH 193A,A05,093482,Rotar; Vladimir,0,0,34,34
1656314584126,MATH 197,001,091859,McAuley; Julian John,9999,0,9999,0
1656314584126,MATH 197,002,095566,Kedlaya; Kiran S.,9997,0,9999,2
1656314584126,MATH 197,003,095567,Xiao; Ming,9999,0,9999,0
1656314584126,MATH 197,004,095571,Perols; Johan Lars,9998,0,9999,1
1656314591188,COGS 9,A01,083615,Shannon; Kyle Michael,3,0,75,72
1656314597210,COGS 11,A01,083617,Boyle; Mary E. T.,17,0,48,31
1656314603234,COGS 13,A01,083071,Bastos; Amalia Pinkusfeld,5,0,71,66
1656314609262,COGS 14A,A01,092681,Semenuks; Arturs,0,9,100,103
1656314615295,COGS 14B,A01,083073,Cheng; Tzu-Han,7,0,63,56
1656314621319,COGS 17,A01,092677,Semenuks; Arturs,6,0,81,75
1656314627342,COGS 100,A01,083619,Allen; Michael Gordon,3,0,70,67
1656314633370,COGS 101A,A01,083621,Davis; Joshua Daniel,5,0,68,63
1656314639397,COGS 101B,A01,091572,Allen; Michael Gordon,4,0,65,61
1656314645444,COGS 101C,A01,083625,Delgado; Tania,11,0,35,24
1656314651469,COGS 107A,A01,083627,Boyle; Mary E. T.,2,0,60,58
1656314657506,COGS 118A,A01,083075,Gupta; Anjum,7,0,76,69
1656314663531,CSE 3,A50,083646,Miranda; Gregory Joseph,18,0,50,32
1656314669554,CSE 8A,A50,083650,Miranda; Gregory Joseph,4,2,56,52
1656314675585,CSE 11,A01,083080,Cao; Yingjun,0,47,40,40
1656314681610,CSE 12,A01,083652,Krause-Levy; Sophia Louisa,5,1,120,115
1656314687637,CSE 15L,A01,083654,Morris; Justin Loren,2,0,50,48
1656314687637,CSE 15L,A02,083655,Morris; Justin Loren,4,0,50,46
1656314693664,CSE 20,A01,083657,Tran; Khoa Dang,31,0,80,49
1656314699692,CSE 21,A01,095574,Bach; Quang Tran,23,0,48,25
1656314705722,CSE 30,A01,083084,Eldon; John,1,4,80,79
1656314705722,CSE 30,B01,095061,Bhaskar; Nishant,0,1,50,50
1656314711746,CSE 100,A01,083659,Cao; Yingjun,1,18,70,69
1656314717769,CSE 134B,A01,083661,Powell; Thomas Allan,6,0,100,94
1656314723796,CSE 140,A01,083663,Gungor; Onat,9,0,85,76
1656314729819,CSE 140L,A01,083088,Eldon; John,10,0,100,90
1656314735847,CSE 175,A01,083665,Kumar; Rakesh,0,0,25,25
1656314741875,CSE 190,A00,092507,Dubnov; Shlomo,4,0,20,16
1656314747899,ECE 45,A01,083139,Congero; Spencer William,1,0,75,74
1656314753933,ECE 65,A50,083695,Saad; Andrew S,10,0,30,20
1656314753933,ECE 65,A51,095125,Staff,25,0,26,1
1656314759956,ECE 109,A01,091882,Touri; Behrouz,0,0,70,70
1656314765984,ECE 180,A00,083140,Abi Samra; Nicholas Camill,2,0,30,28
1656314765984,ECE 180,B00,083141,Abi Samra; Nicholas Camill,0,4,30,30
1656314772008,MATH 10A,A01,083735,Patchell; Gregory David,0,0,30,30
1656314772008,MATH 10A,A02,083736,Patchell; Gregory David,22,0,30,8
1656314772008,MATH 10A,A03,083737,Patchell; Gregory David,16,0,30,14
1656314778034,MATH 10B,A01,083207,Lim; Seonhee,2,0,34,32
1656314778034,MATH 10B,A02,083208,Lim; Seonhee,4,0,35,31
1656314778034,MATH 10B,A03,093472,Staff,1,0,34,33
1656314778034,MATH 10B,B01,083739,Sinha; Shubham,11,0,30,19
1656314784069,MATH 18,A01,083743,Cinel; Cameron Alexander,7,0,30,23
1656314784069,MATH 18,A02,083744,Cinel; Cameron Alexander,10,0,30,20
1656314784069,MATH 18,A03,083745,Cinel; Cameron Alexander,5,0,30,25
1656314784069,MATH 18,B01,083748,Rideout; David Porter,0,0,36,36
1656314784069,MATH 18,B02,083749,Rideout; David Porter,0,0,36,36
1656314784069,MATH 18,B03,083750,Rideout; David Porter,0,0,36,36
1656314784069,MATH 18,B04,083751,Rideout; David Porter,0,1,36,36
1656314784069,MATH 18,B05,093473,Rideout; David Porter,0,0,36,36
1656314784069,MATH 18,B06,093474,Rideout; David Porter,2,0,36,34
1656314790098,MATH 20A,A01,083754,Zheng; Zequn,11,0,40,29
1656314796121,MATH 20B,A01,083756,Briones; Jor-el Thomas Caparas,0,0,36,36
1656314796121,MATH 20B,A02,083757,Briones; Jor-el Thomas Caparas,0,0,36,36
1656314796121,MATH 20B,A03,093475,Staff,1,0,36,35
1656314802147,MATH 20C,A01,083760,Briones; Jor-el Thomas Caparas,0,0,35,35
1656314802147,MATH 20C,A02,083761,Briones; Jor-el Thomas Caparas,9,1,35,26
1656314802147,MATH 20C,A03,093476,Staff,0,0,35,35
1656314802147,MATH 20C,B01,083762,Bach; Quang Tran,2,0,30,28
1656314808172,MATH 20D,A01,083765,Tran; Brian Kha,1,0,30,29
1656314808172,MATH 20D,A02,083766,Tran; Brian Kha,0,0,30,30
1656314808172,MATH 20D,A03,083767,Tran; Brian Kha,2,0,30,28
1656314814206,MATH 20E,A01,083771,Ganguly; Soumya,1,0,32,31
1656314814206,MATH 20E,A02,083772,Ganguly; Soumya,0,0,32,32
1656314814206,MATH 20E,B01,083773,Ciotti; Benjamin,18,0,35,17
1656314814206,MATH 20E,B02,083774,Ciotti; Benjamin,16,0,35,19
1656314820232,MATH 103A,A01,083777,Greenfeld; Be'Eri,2,0,36,34
1656314820232,MATH 103A,A02,083778,Greenfeld; Be'Eri,4,0,36,32
1656314820232,MATH 103A,A03,093561,Staff,3,0,36,33
1656314820232,MATH 103A,B01,083779,Greenfeld; Be'Eri,7,0,36,29
1656314820232,MATH 103A,B02,083780,Greenfeld; Be'Eri,0,0,36,36
1656314820232,MATH 103A,B03,093562,Staff,1,0,36,35
1656314826253,MATH 105,A01,085443,Carter; Anne Toulson,3,0,35,32
1656314826253,MATH 105,A02,093477,Staff,15,0,35,20
1656314832277,MATH 109,A01,083213,Ganzberger; Geoffrey Michael,1,0,34,33
1656314832277,MATH 109,A02,083214,Ganzberger; Geoffrey Michael,0,0,34,34
1656314832277,MATH 109,A03,093478,Staff,1,0,34,33
1656314832277,MATH 109,B01,083215,Ganzberger; Geoffrey Michael,3,0,32,29
1656314832277,MATH 109,B02,083216,Ganzberger; Geoffrey Michael,0,0,32,32
1656314832277,MATH 109,B03,093479,Staff,3,0,32,29
1656314838306,MATH 142A,A01,083219,Chow; Bennett,1,0,32,31
1656314838306,MATH 142A,A02,083220,Chow; Bennett,8,0,32,24
1656314838306,MATH 142A,A03,093480,Staff,4,0,32,28
1656314838306,MATH 142A,B03,093481,Staff,3,0,32,29
1656314838306,MATH 142A,B04,093558,Staff,7,0,32,25
1656314838306,MATH 142A,B05,093559,Staff,1,0,32,31
1656314844329,MATH 193A,A01,083224,Rotar; Vladimir,0,1,34,34
1656314844329,MATH 193A,A02,083225,Rotar; Vladimir,0,0,34,34
1656314844329,MATH 193A,A03,083781,Rotar; Vladimir,0,0,34,34
1656314844329,MATH 193A,A04,083782,Rotar; Vladimir,5,0,34,29
1656314844329,MATH 193A,A05,093482,Rotar; Vladimir,0,0,34,34
1656314850354,MATH 197,001,091859,McAuley; Julian John,9999,0,9999,0
1656314850354,MATH 197,002,095566,Kedlaya; Kiran S.,9997,0,9999,2
1656314850354,MATH 197,003,095567,Xiao; Ming,9999,0,9999,0
1656314850354,MATH 197,004,095571,Perols; Johan Lars,9998,0,9999,1
1656314857435,COGS 9,A01,083615,Shannon; Kyle Michael,3,0,75,72
1656314863457,COGS 11,A01,083617,Boyle; Mary E. T.,17,0,48,31
1656314869481,COGS 13,A01,083071,Bastos; Amalia Pinkusfeld,5,0,71,66
1656314875506,COGS 14A,A01,092681,Semenuks; Arturs,0,9,100,103
1656314881528,COGS 14B,A01,083073,Cheng; Tzu-Han,7,0,63,56
1656314887550,COGS 17,A01,092677,Semenuks; Arturs,6,0,81,75
1656314893574,COGS 100,A01,083619,Allen; Michael Gordon,3,0,70,67
1656314899605,COGS 101A,A01,083621,Davis; Joshua Daniel,5,0,68,63
1656314905628,COGS 101B,A01,091572,Allen; Michael Gordon,4,0,65,61
1656314911650,COGS 101C,A01,083625,Delgado; Tania,11,0,35,24
1656314917674,COGS 107A,A01,083627,Boyle; Mary E. T.,2,0,60,58
1656314923698,COGS 118A,A01,083075,Gupta; Anjum,7,0,76,69
1656314929722,CSE 3,A50,083646,Miranda; Gregory Joseph,18,0,50,32
1656314935754,CSE 8A,A50,083650,Miranda; Gregory Joseph,4,2,56,52
1656314941779,CSE 11,A01,083080,Cao; Yingjun,0,47,40,40
1656314947807,CSE 12,A01,083652,Krause-Levy; Sophia Louisa,5,1,120,115
1656314953829,CSE 15L,A01,083654,Morris; Justin Loren,2,0,50,48
1656314953829,CSE 15L,A02,083655,Morris; Justin Loren,4,0,50,46
1656314959859,CSE 20,A01,083657,Tran; Khoa Dang,31,0,80,49
1656314965940,CSE 21,A01,095574,Bach; Quang Tran,23,0,48,25
1656314971969,CSE 30,A01,083084,Eldon; John,1,4,80,79
1656314971969,CSE 30,B01,095061,Bhaskar; Nishant,0,1,50,50
1656314977991,CSE 100,A01,083659,Cao; Yingjun,1,18,70,69
1656314984022,CSE 134B,A01,083661,Powell; Thomas Allan,6,0,100,94
1656314990127,CSE 140,A01,083663,Gungor; Onat,9,0,85,76
1656314996151,CSE 140L,A01,083088,Eldon; John,10,0,100,90
1656315002172,CSE 175,A01,083665,Kumar; Rakesh,0,0,25,25
1656315008197,CSE 190,A00,092507,Dubnov; Shlomo,4,0,20,16
1656315014221,ECE 45,A01,083139,Congero; Spencer William,1,0,75,74
1656315020250,ECE 65,A50,083695,Saad; Andrew S,10,0,30,20
1656315020250,ECE 65,A51,095125,Staff,25,0,26,1
1656315026277,ECE 109,A01,091882,Touri; Behrouz,0,0,70,70
1656315032314,ECE 180,A00,083140,Abi Samra; Nicholas Camill,2,0,30,28
1656315032314,ECE 180,B00,083141,Abi Samra; Nicholas Camill,0,4,30,30
1656315038337,MATH 10A,A01,083735,Patchell; Gregory David,0,0,30,30
1656315038337,MATH 10A,A02,083736,Patchell; Gregory David,22,0,30,8
1656315038337,MATH 10A,A03,083737,Patchell; Gregory David,16,0,30,14
1656315044361,MATH 10B,A01,083207,Lim; Seonhee,2,0,34,32
1656315044361,MATH 10B,A02,083208,Lim; Seonhee,4,0,35,31
1656315044361,MATH 10B,A03,093472,Staff,1,0,34,33
1656315044361,MATH 10B,B01,083739,Sinha; Shubham,11,0,30,19
1656315050386,MATH 18,A01,083743,Cinel; Cameron Alexander,7,0,30,23
1656315050386,MATH 18,A02,083744,Cinel; Cameron Alexander,10,0,30,20
1656315050386,MATH 18,A03,083745,Cinel; Cameron Alexander,5,0,30,25
1656315050386,MATH 18,B01,083748,Rideout; David Porter,0,0,36,36
1656315050386,MATH 18,B02,083749,Rideout; David Porter,0,0,36,36
1656315050386,MATH 18,B03,083750,Rideout; David Porter,0,0,36,36
1656315050386,MATH 18,B04,083751,Rideout; David Porter,0,1,36,36
1656315050386,MATH 18,B05,093473,Rideout; David Porter,0,0,36,36
1656315050386,MATH 18,B06,093474,Rideout; David Porter,2,0,36,34
1656315056493,MATH 20A,A01,083754,Zheng; Zequn,11,0,40,29
1656315062518,MATH 20B,A01,083756,Briones; Jor-el Thomas Caparas,0,0,36,36
1656315062518,MATH 20B,A02,083757,Briones; Jor-el Thomas Caparas,0,0,36,36
1656315062518,MATH 20B,A03,093475,Staff,1,0,36,35
1656315068541,MATH 20C,A01,083760,Briones; Jor-el Thomas Caparas,0,0,35,35
1656315068541,MATH 20C,A02,083761,Briones; Jor-el Thomas Caparas,9,1,35,26
1656315068541,MATH 20C,A03,093476,Staff,0,0,35,35
1656315068541,MATH 20C,B01,083762,Bach; Quang Tran,2,0,30,28
1656315074568,MATH 20D,A01,083765,Tran; Brian Kha,1,0,30,29
1656315074568,MATH 20D,A02,083766,Tran; Brian Kha,0,0,30,30
1656315074568,MATH 20D,A03,083767,Tran; Brian Kha,2,0,30,28
1656315080599,MATH 20E,A01,083771,Ganguly; Soumya,1,0,32,31
1656315080599,MATH 20E,A02,083772,Ganguly; Soumya,0,0,32,32
1656315080599,MATH 20E,B01,083773,Ciotti; Benjamin,18,0,35,17
1656315080599,MATH 20E,B02,083774,Ciotti; Benjamin,16,0,35,19
1656315086629,MATH 103A,A01,083777,Greenfeld; Be'Eri,2,0,36,34
1656315086629,MATH 103A,A02,083778,Greenfeld; Be'Eri,4,0,36,32
1656315086629,MATH 103A,A03,093561,Staff,3,0,36,33
1656315086629,MATH 103A,B01,083779,Greenfeld; Be'Eri,7,0,36,29
1656315086629,MATH 103A,B02,083780,Greenfeld; Be'Eri,0,0,36,36
1656315086629,MATH 103A,B03,093562,Staff,1,0,36,35
1656315092656,MATH 105,A01,085443,Carter; Anne Toulson,3,0,35,32
1656315092656,MATH 105,A02,093477,Staff,15,0,35,20
1656315098687,MATH 109,A01,083213,Ganzberger; Geoffrey Michael,1,0,34,33
1656315098687,MATH 109,A02,083214,Ganzberger; Geoffrey Michael,0,0,34,34
1656315098687,MATH 109,A03,093478,Staff,1,0,34,33
1656315098687,MATH 109,B01,083215,Ganzberger; Geoffrey Michael,3,0,32,29
1656315098687,MATH 109,B02,083216,Ganzberger; Geoffrey Michael,0,0,32,32
1656315098687,MATH 109,B03,093479,Staff,3,0,32,29
1656315104724,MATH 142A,A01,083219,Chow; Bennett,1,0,32,31
1656315104724,MATH 142A,A02,083220,Chow; Bennett,8,0,32,24
1656315104724,MATH 142A,A03,093480,Staff,4,0,32,28
1656315104724,MATH 142A,B03,093481,Staff,3,0,32,29
1656315104724,MATH 142A,B04,093558,Staff,7,0,32,25
1656315104724,MATH 142A,B05,093559,Staff,1,0,32,31
1656315110751,MATH 193A,A01,083224,Rotar; Vladimir,0,1,34,34
1656315110751,MATH 193A,A02,083225,Rotar; Vladimir,0,0,34,34
1656315110751,MATH 193A,A03,083781,Rotar; Vladimir,0,0,34,34
1656315110751,MATH 193A,A04,083782,Rotar; Vladimir,5,0,34,29
1656315110751,MATH 193A,A05,093482,Rotar; Vladimir,0,0,34,34
1656315116774,MATH 197,001,091859,McAuley; Julian John,9999,0,9999,0
1656315116774,MATH 197,002,095566,Kedlaya; Kiran S.,9997,0,9999,2
1656315116774,MATH 197,003,095567,Xiao; Ming,9999,0,9999,0
1656315116774,MATH 197,004,095571,Perols; Johan Lars,9998,0,9999,1
1656315123842,COGS 9,A01,083615,Shannon; Kyle Michael,3,0,75,72
1656315129874,COGS 11,A01,083617,Boyle; Mary E. T.,17,0,48,31
1656315135899,COGS 13,A01,083071,Bastos; Amalia Pinkusfeld,5,0,71,66
1656315141922,COGS 14A,A01,092681,Semenuks; Arturs,0,9,100,103
1656315147947,COGS 14B,A01,083073,Cheng; Tzu-Han,7,0,63,56
1656315153978,COGS 17,A01,092677,Semenuks; Arturs,6,0,81,75
1656315160008,COGS 100,A01,083619,Allen; Michael Gordon,3,0,70,67
1656315166034,COGS 101A,A01,083621,Davis; Joshua Daniel,5,0,68,63
1656315172060,COGS 101B,A01,091572,Allen; Michael Gordon,4,0,65,61
1656315178086,COGS 101C,A01,083625,Delgado; Tania,11,0,35,24
1656315184109,COGS 107A,A01,083627,Boyle; Mary E. T.,2,0,60,58
1656315190137,COGS 118A,A01,083075,Gupta; Anjum,7,0,76,69
1656315196161,CSE 3,A50,083646,Miranda; Gregory Joseph,18,0,50,32
1656315202184,CSE 8A,A50,083650,Miranda; Gregory Joseph,4,2,56,52
1656315208217,CSE 11,A01,083080,Cao; Yingjun,0,47,40,40
1656315214243,CSE 12,A01,083652,Krause-Levy; Sophia Louisa,5,1,120,115
1656315220266,CSE 15L,A01,083654,Morris; Justin Loren,2,0,50,48
1656315220266,CSE 15L,A02,083655,Morris; Justin Loren,4,0,50,46
1656315226294,CSE 20,A01,083657,Tran; Khoa Dang,31,0,80,49
1656315232324,CSE 21,A01,095574,Bach; Quang Tran,23,0,48,25
1656315238352,CSE 30,A01,083084,Eldon; John,1,4,80,79
1656315238352,CSE 30,B01,095061,Bhaskar; Nishant,0,1,50,50
1656315244381,CSE 100,A01,083659,Cao; Yingjun,1,18,70,69
1656315250406,CSE 134B,A01,083661,Powell; Thomas Allan,6,0,100,94
1656315256435,CSE 140,A01,083663,Gungor; Onat,9,0,85,76
1656315262458,CSE 140L,A01,083088,Eldon; John,10,0,100,90
1656315268483,CSE 175,A01,083665,Kumar; Rakesh,0,0,25,25
1656315274508,CSE 190,A00,092507,Dubnov; Shlomo,4,0,20,16
1656315280540,ECE 45,A01,083139,Congero; Spencer William,1,0,75,74
1656315286568,ECE 65,A50,083695,Saad; Andrew S,10,0,30,20
1656315286568,ECE 65,A51,095125,Staff,25,0,26,1
1656315292591,ECE 109,A01,091882,Touri; Behrouz,0,0,70,70
1656315298614,ECE 180,A00,083140,Abi Samra; Nicholas Camill,2,0,30,28
1656315298614,ECE 180,B00,083141,Abi Samra; Nicholas Camill,0,4,30,30
1656315304646,MATH 10A,A01,083735,Patchell; Gregory David,0,0,30,30
1656315304646,MATH 10A,A02,083736,Patchell; Gregory David,22,0,30,8
1656315304646,MATH 10A,A03,083737,Patchell; Gregory David,16,0,30,14
1656315310670,MATH 10B,A01,083207,Lim; Seonhee,2,0,34,32
1656315310670,MATH 10B,A02,083208,Lim; Seonhee,4,0,35,31
1656315310670,MATH 10B,A03,093472,Staff,1,0,34,33
1656315310670,MATH 10B,B01,083739,Sinha; Shubham,11,0,30,19
1656315316693,MATH 18,A01,083743,Cinel; Cameron Alexander,7,0,30,23
1656315316693,MATH 18,A02,083744,Cinel; Cameron Alexander,10,0,30,20
1656315316693,MATH 18,A03,083745,Cinel; Cameron Alexander,5,0,30,25
1656315316693,MATH 18,B01,083748,Rideout; David Porter,0,0,36,36
1656315316693,MATH 18,B02,083749,Rideout; David Porter,0,0,36,36
1656315316693,MATH 18,B03,083750,Rideout; David Porter,0,0,36,36
1656315316693,MATH 18,B04,083751,Rideout; David Porter,0,1,36,36
1656315316693,MATH 18,B05,093473,Rideout; David Porter,0,0,36,36
1656315316693,MATH 18,B06,093474,Rideout; David Porter,2,0,36,34
1656315322720,MATH 20A,A01,083754,Zheng; Zequn,11,0,40,29
1656315328748,MATH 20B,A01,083756,Briones; Jor-el Thomas Caparas,0,0,36,36
1656315328748,MATH 20B,A02,083757,Briones; Jor-el Thomas Caparas,0,0,36,36
1656315328748,MATH 20B,A03,093475,Staff,1,0,36,35
1656315334775,MATH 20C,A01,083760,Briones; Jor-el Thomas Caparas,0,0,35,35
1656315334775,MATH 20C,A02,083761,Briones; Jor-el Thomas Caparas,9,1,35,26
1656315334775,MATH 20C,A03,093476,Staff,0,0,35,35
1656315334775,MATH 20C,B01,083762,Bach; Quang Tran,2,0,30,28
1656315340800,MATH 20D,A01,083765,Tran; Brian Kha,1,0,30,29
1656315340800,MATH 20D,A02,083766,Tran; Brian Kha,0,0,30,30
1656315340800,MATH 20D,A03,083767,Tran; Brian Kha,2,0,30,28
1656315346843,MATH 20E,A01,083771,Ganguly; Soumya,1,0,32,31
1656315346843,MATH 20E,A02,083772,Ganguly; Soumya,0,0,32,32
1656315346843,MATH 20E,B01,083773,Ciotti; Benjamin,18,0,35,17
1656315346843,MATH 20E,B02,083774,Ciotti; Benjamin,16,0,35,19
1656315352871,MATH 103A,A01,083777,Greenfeld; Be'Eri,2,0,36,34
1656315352871,MATH 103A,A02,083778,Greenfeld; Be'Eri,4,0,36,32
1656315352871,MATH 103A,A03,093561,Staff,3,0,36,33
1656315352871,MATH 103A,B01,083779,Greenfeld; Be'Eri,7,0,36,29
1656315352871,MATH 103A,B02,083780,Greenfeld; Be'Eri,0,0,36,36
1656315352871,MATH 103A,B03,093562,Staff,1,0,36,35
1656315358896,MATH 105,A01,085443,Carter; Anne Toulson,3,0,35,32
1656315358896,MATH 105,A02,093477,Staff,15,0,35,20
1656315364920,MATH 109,A01,083213,Ganzberger; Geoffrey Michael,1,0,34,33
1656315364920,MATH 109,A02,083214,Ganzberger; Geoffrey Michael,0,0,34,34
1656315364920,MATH 109,A03,093478,Staff,1,0,34,33
1656315364920,MATH 109,B01,083215,Ganzberger; Geoffrey Michael,3,0,32,29
1656315364920,MATH 109,B02,083216,Ganzberger; Geoffrey Michael,0,0,32,32
1656315364920,MATH 109,B03,093479,Staff,3,0,32,29
1656315370945,MATH 142A,A01,083219,Chow; Bennett,1,0,32,31
1656315370945,MATH 142A,A02,083220,Chow; Bennett,8,0,32,24
1656315370945,MATH 142A,A03,093480,Staff,4,0,32,28
1656315370945,MATH 142A,B03,093481,Staff,3,0,32,29
1656315370945,MATH 142A,B04,093558,Staff,7,0,32,25
1656315370945,MATH 142A,B05,093559,Staff,1,0,32,31
1656315376970,MATH 193A,A01,083224,Rotar; Vladimir,0,1,34,34
1656315376970,MATH 193A,A02,083225,Rotar; Vladimir,0,0,34,34
1656315376970,MATH 193A,A03,083781,Rotar; Vladimir,0,0,34,34
1656315376970,MATH 193A,A04,083782,Rotar; Vladimir,5,0,34,29
1656315376970,MATH 193A,A05,093482,Rotar; Vladimir,0,0,34,34
1656315382995,MATH 197,001,091859,McAuley; Julian John,9999,0,9999,0
1656315382995,MATH 197,002,095566,Kedlaya; Kiran S.,9997,0,9999,2
1656315382995,MATH 197,003,095567,Xiao; Ming,9999,0,9999,0
1656315382995,MATH 197,004,095571,Perols; Johan Lars,9998,0,9999,1
1656315390059,COGS 9,A01,083615,Shannon; Kyle Michael,3,0,75,72
1656315396086,COGS 11,A01,083617,Boyle; Mary E. T.,17,0,48,31
1656315402115,COGS 13,A01,083071,Bastos; Amalia Pinkusfeld,5,0,71,66
1656315408139,COGS 14A,A01,092681,Semenuks; Arturs,0,8,100,103
1656315414162,COGS 14B,A01,083073,Cheng; Tzu-Han,7,0,63,56
1656315420188,COGS 17,A01,092677,Semenuks; Arturs,6,0,81,75
1656315426212,COGS 100,A01,083619,Allen; Michael Gordon,3,0,70,67
1656315432234,COGS 101A,A01,083621,Davis; Joshua Daniel,5,0,68,63
1656315438261,COGS 101B,A01,091572,Allen; Michael Gordon,4,0,65,61
1656315444289,COGS 101C,A01,083625,Delgado; Tania,11,0,35,24
1656315450312,COGS 107A,A01,083627,Boyle; Mary E. T.,2,0,60,58
1656315456339,COGS 118A,A01,083075,Gupta; Anjum,7,0,76,69
1656315462370,CSE 3,A50,083646,Miranda; Gregory Joseph,18,0,50,32
1656315468398,CSE 8A,A50,083650,Miranda; Gregory Joseph,4,2,56,52
1656315474431,CSE 11,A01,083080,Cao; Yingjun,0,47,40,40
1656315480454,CSE 12,A01,083652,Krause-Levy; Sophia Louisa,5,1,120,115
1656315486486,CSE 15L,A01,083654,Morris; Justin Loren,2,0,50,48
1656315486486,CSE 15L,A02,083655,Morris; Justin Loren,4,0,50,46
1656315492519,CSE 20,A01,083657,Tran; Khoa Dang,31,0,80,49
1656315498546,CSE 21,A01,095574,Bach; Quang Tran,23,0,48,25
1656315504574,CSE 30,A01,083084,Eldon; John,1,4,80,79
1656315504574,CSE 30,B01,095061,Bhaskar; Nishant,0,1,50,50
1656315510598,CSE 100,A01,083659,Cao; Yingjun,1,18,70,69
1656315516625,CSE 134B,A01,083661,Powell; Thomas Allan,6,0,100,94
1656315522648,CSE 140,A01,083663,Gungor; Onat,9,0,85,76
1656315528674,CSE 140L,A01,083088,Eldon; John,10,0,100,90
1656315534706,CSE 175,A01,083665,Kumar; Rakesh,0,0,25,25
1656315540736,CSE 190,A00,092507,Dubnov; Shlomo,4,0,20,16
1656315546773,ECE 45,A01,083139,Congero; Spencer William,1,0,75,74
1656315552797,ECE 65,A50,083695,Saad; Andrew S,10,0,30,20
1656315552797,ECE 65,A51,095125,Staff,25,0,26,1
1656315558826,ECE 109,A01,091882,Touri; Behrouz,0,0,70,70
1656315564853,ECE 180,A00,083140,Abi Samra; Nicholas Camill,2,0,30,28
1656315564853,ECE 180,B00,083141,Abi Samra; Nicholas Camill,0,4,30,30
1656315570878,MATH 10A,A01,083735,Patchell; Gregory David,0,0,30,30
1656315570878,MATH 10A,A02,083736,Patchell; Gregory David,22,0,30,8
1656315570878,MATH 10A,A03,083737,Patchell; Gregory David,16,0,30,14
1656315576904,MATH 10B,A01,083207,Lim; Seonhee,2,0,34,32
1656315576904,MATH 10B,A02,083208,Lim; Seonhee,4,0,35,31
1656315576904,MATH 10B,A03,093472,Staff,1,0,34,33
1656315576904,MATH 10B,B01,083739,Sinha; Shubham,11,0,30,19
1656315582929,MATH 18,A01,083743,Cinel; Cameron Alexander,7,0,30,23
1656315582929,MATH 18,A02,083744,Cinel; Cameron Alexander,10,0,30,20
1656315582929,MATH 18,A03,083745,Cinel; Cameron Alexander,5,0,30,25
1656315582929,MATH 18,B01,083748,Rideout; David Porter,0,0,36,36
1656315582929,MATH 18,B02,083749,Rideout; David Porter,0,0,36,36
1656315582929,MATH 18,B03,083750,Rideout; David Porter,0,0,36,36
1656315582929,MATH 18,B04,083751,Rideout; David Porter,0,1,36,36
1656315582929,MATH 18,B05,093473,Rideout; David Porter,0,0,36,36
1656315582929,MATH 18,B06,093474,Rideout; David Porter,2,0,36,34
1656315588952,MATH 20A,A01,083754,Zheng; Zequn,11,0,40,29
1656315594981,MATH 20B,A01,083756,Briones; Jor-el Thomas Caparas,0,0,36,36
1656315594981,MATH 20B,A02,083757,Briones; Jor-el Thomas Caparas,0,0,36,36
1656315594981,MATH 20B,A03,093475,Staff,1,0,36,35
1656315601010,MATH 20C,A01,083760,Briones; Jor-el Thomas Caparas,0,0,35,35
1656315601010,MATH 20C,A02,083761,Briones; Jor-el Thomas Caparas,9,1,35,26
1656315601010,MATH 20C,A03,093476,Staff,0,0,35,35
1656315601010,MATH 20C,B01,083762,Bach; Quang Tran,2,0,30,28
1656315607043,MATH 20D,A01,083765,Tran; Brian Kha,1,0,30,29
1656315607043,MATH 20D,A02,083766,Tran; Brian Kha,0,0,30,30
1656315607043,MATH 20D,A03,083767,Tran; Brian Kha,2,0,30,28
1656315613065,MATH 20E,A01,083771,Ganguly; Soumya,1,0,32,31
1656315613065,MATH 20E,A02,083772,Ganguly; Soumya,0,0,32,32
1656315613065,MATH 20E,B01,083773,Ciotti; Benjamin,18,0,35,17
1656315613065,MATH 20E,B02,083774,Ciotti; Benjamin,16,0,35,19
1656315619099,MATH 103A,A01,083777,Greenfeld; Be'Eri,2,0,36,34
1656315619099,MATH 103A,A02,083778,Greenfeld; Be'Eri,4,0,36,32
1656315619099,MATH 103A,A03,093561,Staff,3,0,36,33
1656315619099,MATH 103A,B01,083779,Greenfeld; Be'Eri,7,0,36,29
1656315619099,MATH 103A,B02,083780,Greenfeld; Be'Eri,0,0,36,36
1656315619099,MATH 103A,B03,093562,Staff,1,0,36,35
1656315625128,MATH 105,A01,085443,Carter; Anne Toulson,3,0,35,32
1656315625128,MATH 105,A02,093477,Staff,15,0,35,20
1656315631153,MATH 109,A01,083213,Ganzberger; Geoffrey Michael,1,0,34,33
1656315631153,MATH 109,A02,083214,Ganzberger; Geoffrey Michael,0,0,34,34
1656315631153,MATH 109,A03,093478,Staff,1,0,34,33
1656315631153,MATH 109,B01,083215,Ganzberger; Geoffrey Michael,3,0,32,29
1656315631153,MATH 109,B02,083216,Ganzberger; Geoffrey Michael,0,0,32,32
1656315631153,MATH 109,B03,093479,Staff,3,0,32,29
1656315637189,MATH 142A,A01,083219,Chow; Bennett,1,0,32,31
1656315637189,MATH 142A,A02,083220,Chow; Bennett,8,0,32,24
1656315637189,MATH 142A,A03,093480,Staff,4,0,32,28
1656315637189,MATH 142A,B03,093481,Staff,3,0,32,29
1656315637189,MATH 142A,B04,093558,Staff,7,0,32,25
1656315637189,MATH 142A,B05,093559,Staff,1,0,32,31
1656315643217,MATH 193A,A01,083224,Rotar; Vladimir,0,1,34,34
1656315643217,MATH 193A,A02,083225,Rotar; Vladimir,0,0,34,34
1656315643217,MATH 193A,A03,083781,Rotar; Vladimir,0,0,34,34
1656315643217,MATH 193A,A04,083782,Rotar; Vladimir,5,0,34,29
1656315643217,MATH 193A,A05,093482,Rotar; Vladimir,0,0,34,34
1656315649246,MATH 197,001,091859,McAuley; Julian John,9999,0,9999,0
1656315649246,MATH 197,002,095566,Kedlaya; Kiran S.,9997,0,9999,2
1656315649246,MATH 197,003,095567,Xiao; Ming,9999,0,9999,0
1656315649246,MATH 197,004,095571,Perols; Johan Lars,9998,0,9999,1
1656315656394,COGS 9,A01,083615,Shannon; Kyle Michael,3,0,75,72
1656315662438,COGS 11,A01,083617,Boyle; Mary E. T.,17,0,48,31
1656315668468,COGS 13,A01,083071,Bastos; Amalia Pinkusfeld,5,0,71,66
1656315674497,COGS 14A,A01,092681,Semenuks; Arturs,0,8,100,103
1656315680527,COGS 14B,A01,083073,Cheng; Tzu-Han,7,0,63,56
1656315686552,COGS 17,A01,092677,Semenuks; Arturs,6,0,81,75
1656315692575,COGS 100,A01,083619,Allen; Michael Gordon,3,0,70,67
1656315698600,COGS 101A,A01,083621,Davis; Joshua Daniel,5,0,68,63
1656315704626,COGS 101B,A01,091572,Allen; Michael Gordon,4,0,65,61
1656315710649,COGS 101C,A01,083625,Delgado; Tania,11,0,35,24
1656315716673,COGS 107A,A01,083627,Boyle; Mary E. T.,2,0,60,58
1656315722698,COGS 118A,A01,083075,Gupta; Anjum,7,0,76,69
1656315728727,CSE 3,A50,083646,Miranda; Gregory Joseph,18,0,50,32
1656315734751,CSE 8A,A50,083650,Miranda; Gregory Joseph,4,2,56,52
1656315740782,CSE 11,A01,083080,Cao; Yingjun,0,47,40,40
1656315746809,CSE 12,A01,083652,Krause-Levy; Sophia Louisa,5,1,120,115
1656315752836,CSE 15L,A01,083654,Morris; Justin Loren,2,0,50,48
1656315752836,CSE 15L,A02,083655,Morris; Justin Loren,4,0,50,46
1656315758865,CSE 20,A01,083657,Tran; Khoa Dang,31,0,80,49
1656315764889,CSE 21,A01,095574,Bach; Quang Tran,23,0,48,25
1656315770914,CSE 30,A01,083084,Eldon; John,1,4,80,79
1656315770914,CSE 30,B01,095061,Bhaskar; Nishant,0,1,50,50
1656315776941,CSE 100,A01,083659,Cao; Yingjun,1,18,70,69
1656315782964,CSE 134B,A01,083661,Powell; Thomas Allan,6,0,100,94
1656315788989,CSE 140,A01,083663,Gungor; Onat,9,0,85,76
1656315795016,CSE 140L,A01,083088,Eldon; John,10,0,100,90
1656315801039,CSE 175,A01,083665,Kumar; Rakesh,0,0,25,25
1656315807070,CSE 190,A00,092507,Dubnov; Shlomo,4,0,20,16
1656315813098,ECE 45,A01,083139,Congero; Spencer William,1,0,75,74
1656315819132,ECE 65,A50,083695,Saad; Andrew S,10,0,30,20
1656315819132,ECE 65,A51,095125,Staff,25,0,26,1
1656315825161,ECE 109,A01,091882,Touri; Behrouz,0,0,70,70
1656315831188,ECE 180,A00,083140,Abi Samra; Nicholas Camill,2,0,30,28
1656315831188,ECE 180,B00,083141,Abi Samra; Nicholas Camill,0,4,30,30
1656315837223,MATH 10A,A01,083735,Patchell; Gregory David,0,0,30,30
1656315837223,MATH 10A,A02,083736,Patchell; Gregory David,22,0,30,8
1656315837223,MATH 10A,A03,083737,Patchell; Gregory David,16,0,30,14
1656315843256,MATH 10B,A01,083207,Lim; Seonhee,2,0,34,32
1656315843256,MATH 10B,A02,083208,Lim; Seonhee,4,0,35,31
1656315843256,MATH 10B,A03,093472,Staff,1,0,34,33
1656315843256,MATH 10B,B01,083739,Sinha; Shubham,11,0,30,19
1656315849286,MATH 18,A01,083743,Cinel; Cameron Alexander,7,0,30,23
1656315849286,MATH 18,A02,083744,Cinel; Cameron Alexander,10,0,30,20
1656315849286,MATH 18,A03,083745,Cinel; Cameron Alexander,5,0,30,25
1656315849286,MATH 18,B01,083748,Rideout; David Porter,0,0,36,36
1656315849286,MATH 18,B02,083749,Rideout; David Porter,0,0,36,36
1656315849286,MATH 18,B03,083750,Rideout; David Porter,0,0,36,36
1656315849286,MATH 18,B04,083751,Rideout; David Porter,0,1,36,36
1656315849286,MATH 18,B05,093473,Rideout; David Porter,0,0,36,36
1656315849286,MATH 18,B06,093474,Rideout; David Porter,2,0,36,34
1656315855317,MATH 20A,A01,083754,Zheng; Zequn,11,0,40,29
1656315861350,MATH 20B,A01,083756,Briones; Jor-el Thomas Caparas,0,0,36,36
1656315861350,MATH 20B,A02,083757,Briones; Jor-el Thomas Caparas,0,0,36,36
1656315861350,MATH 20B,A03,093475,Staff,1,0,36,35
1656315867380,MATH 20C,A01,083760,Briones; Jor-el Thomas Caparas,0,0,35,35
1656315867380,MATH 20C,A02,083761,Briones; Jor-el Thomas Caparas,9,1,35,26
1656315867380,MATH 20C,A03,093476,Staff,0,0,35,35
1656315867380,MATH 20C,B01,083762,Bach; Quang Tran,2,0,30,28
1656315873410,MATH 20D,A01,083765,Tran; Brian Kha,1,0,30,29
1656315873410,MATH 20D,A02,083766,Tran; Brian Kha,0,0,30,30
1656315873410,MATH 20D,A03,083767,Tran; Brian Kha,2,0,30,28
1656315879438,MATH 20E,A01,083771,Ganguly; Soumya,1,0,32,31
1656315879438,MATH 20E,A02,083772,Ganguly; Soumya,0,0,32,32
1656315879438,MATH 20E,B01,083773,Ciotti; Benjamin,18,0,35,17
1656315879438,MATH 20E,B02,083774,Ciotti; Benjamin,16,0,35,19
1656315885466,MATH 103A,A01,083777,Greenfeld; Be'Eri,2,0,36,34
1656315885466,MATH 103A,A02,083778,Greenfeld; Be'Eri,4,0,36,32
1656315885466,MATH 103A,A03,093561,Staff,3,0,36,33
1656315885466,MATH 103A,B01,083779,Greenfeld; Be'Eri,7,0,36,29
1656315885466,MATH 103A,B02,083780,Greenfeld; Be'Eri,0,0,36,36
1656315885466,MATH 103A,B03,093562,Staff,1,0,36,35
1656315891498,MATH 105,A01,085443,Carter; Anne Toulson,3,0,35,32
1656315891498,MATH 105,A02,093477,Staff,15,0,35,20
1656315897522,MATH 109,A01,083213,Ganzberger; Geoffrey Michael,1,0,34,33
1656315897522,MATH 109,A02,083214,Ganzberger; Geoffrey Michael,0,0,34,34
1656315897522,MATH 109,A03,093478,Staff,1,0,34,33
1656315897522,MATH 109,B01,083215,Ganzberger; Geoffrey Michael,3,0,32,29
1656315897522,MATH 109,B02,083216,Ganzberger; Geoffrey Michael,0,0,32,32
1656315897522,MATH 109,B03,093479,Staff,3,0,32,29
1656315903546,MATH 142A,A01,083219,Chow; Bennett,1,0,32,31
1656315903546,MATH 142A,A02,083220,Chow; Bennett,8,0,32,24
1656315903546,MATH 142A,A03,093480,Staff,4,0,32,28
1656315903546,MATH 142A,B03,093481,Staff,3,0,32,29
1656315903546,MATH 142A,B04,093558,Staff,7,0,32,25
1656315903546,MATH 142A,B05,093559,Staff,1,0,32,31
1656315909571,MATH 193A,A01,083224,Rotar; Vladimir,0,1,34,34
1656315909571,MATH 193A,A02,083225,Rotar; Vladimir,0,0,34,34
1656315909571,MATH 193A,A03,083781,Rotar; Vladimir,0,0,34,34
1656315909571,MATH 193A,A04,083782,Rotar; Vladimir,5,0,34,29
1656315909571,MATH 193A,A05,093482,Rotar; Vladimir,0,0,34,34
1656315915594,MATH 197,001,091859,McAuley; Julian John,9999,0,9999,0
1656315915594,MATH 197,002,095566,Kedlaya; Kiran S.,9997,0,9999,2
1656315915594,MATH 197,003,095567,Xiao; Ming,9999,0,9999,0
1656315915594,MATH 197,004,095571,Perols; Johan Lars,9998,0,9999,1
1656315922669,COGS 9,A01,083615,Shannon; Kyle Michael,3,0,75,72
1656315928693,COGS 11,A01,083617,Boyle; Mary E. T.,17,0,48,31
1656315934721,COGS 13,A01,083071,Bastos; Amalia Pinkusfeld,5,0,71,66
1656315940749,COGS 14A,A01,092681,Semenuks; Arturs,0,8,100,103
1656315946773,COGS 14B,A01,083073,Cheng; Tzu-Han,7,0,63,56
1656315952797,COGS 17,A01,092677,Semenuks; Arturs,6,0,81,75
1656315958824,COGS 100,A01,083619,Allen; Michael Gordon,3,0,70,67
1656315964849,COGS 101A,A01,083621,Davis; Joshua Daniel,5,0,68,63
1656315970875,COGS 101B,A01,091572,Allen; Michael Gordon,4,0,65,61
1656315976899,COGS 101C,A01,083625,Delgado; Tania,11,0,35,24
1656315982924,COGS 107A,A01,083627,Boyle; Mary E. T.,2,0,60,58
1656315988957,COGS 118A,A01,083075,Gupta; Anjum,7,0,76,69
1656315994982,CSE 3,A50,083646,Miranda; Gregory Joseph,18,0,50,32
1656316001005,CSE 8A,A50,083650,Miranda; Gregory Joseph,4,2,56,52
1656316007029,CSE 11,A01,083080,Cao; Yingjun,0,47,40,40
1656316013069,CSE 12,A01,083652,Krause-Levy; Sophia Louisa,5,1,120,115
1656316019096,CSE 15L,A01,083654,Morris; Justin Loren,2,0,50,48
1656316019096,CSE 15L,A02,083655,Morris; Justin Loren,4,0,50,46
1656316025120,CSE 20,A01,083657,Tran; Khoa Dang,31,0,80,49
1656316031146,CSE 21,A01,095574,Bach; Quang Tran,23,0,48,25
1656316037171,CSE 30,A01,083084,Eldon; John,1,4,80,79
1656316037171,CSE 30,B01,095061,Bhaskar; Nishant,0,1,50,50
1656316043199,CSE 100,A01,083659,Cao; Yingjun,1,18,70,69
1656316049223,CSE 134B,A01,083661,Powell; Thomas Allan,6,0,100,94
1656316055254,CSE 140,A01,083663,Gungor; Onat,9,0,85,76
1656316061279,CSE 140L,A01,083088,Eldon; John,10,0,100,90
1656316067321,CSE 175,A01,083665,Kumar; Rakesh,0,0,25,25
1656316073349,CSE 190,A00,092507,Dubnov; Shlomo,4,0,20,16
1656316079377,ECE 45,A01,083139,Congero; Spencer William,1,0,75,74
1656316085402,ECE 65,A50,083695,Saad; Andrew S,10,0,30,20
1656316085402,ECE 65,A51,095125,Staff,25,0,26,1
1656316091427,ECE 109,A01,091882,Touri; Behrouz,0,1,70,70
1656316097452,ECE 180,A00,083140,Abi Samra; Nicholas Camill,2,0,30,28
1656316097452,ECE 180,B00,083141,Abi Samra; Nicholas Camill,0,4,30,30
1656316103476,MATH 10A,A01,083735,Patchell; Gregory David,0,0,30,30
1656316103476,MATH 10A,A02,083736,Patchell; Gregory David,22,0,30,8
1656316103476,MATH 10A,A03,083737,Patchell; Gregory David,16,0,30,14
1656316109505,MATH 10B,A01,083207,Lim; Seonhee,2,0,34,32
1656316109505,MATH 10B,A02,083208,Lim; Seonhee,4,0,35,31
1656316109505,MATH 10B,A03,093472,Staff,1,0,34,33
1656316109505,MATH 10B,B01,083739,Sinha; Shubham,11,0,30,19
1656316115538,MATH 18,A01,083743,Cinel; Cameron Alexander,7,0,30,23
1656316115538,MATH 18,A02,083744,Cinel; Cameron Alexander,10,0,30,20
1656316115538,MATH 18,A03,083745,Cinel; Cameron Alexander,5,0,30,25
1656316115538,MATH 18,B01,083748,Rideout; David Porter,0,0,36,36
1656316115538,MATH 18,B02,083749,Rideout; David Porter,0,0,36,36
1656316115538,MATH 18,B03,083750,Rideout; David Porter,0,0,36,36
1656316115538,MATH 18,B04,083751,Rideout; David Porter,0,1,36,36
1656316115538,MATH 18,B05,093473,Rideout; David Porter,0,0,36,36
1656316115538,MATH 18,B06,093474,Rideout; David Porter,2,0,36,34
1656316121565,MATH 20A,A01,083754,Zheng; Zequn,11,0,40,29
1656316127589,MATH 20B,A01,083756,Briones; Jor-el Thomas Caparas,0,0,36,36
1656316127589,MATH 20B,A02,083757,Briones; Jor-el Thomas Caparas,0,0,36,36
1656316127589,MATH 20B,A03,093475,Staff,1,0,36,35
1656316133612,MATH 20C,A01,083760,Briones; Jor-el Thomas Caparas,0,0,35,35
1656316133612,MATH 20C,A02,083761,Briones; Jor-el Thomas Caparas,9,1,35,26
1656316133612,MATH 20C,A03,093476,Staff,0,0,35,35
1656316133612,MATH 20C,B01,083762,Bach; Quang Tran,2,0,30,28
1656316139640,MATH 20D,A01,083765,Tran; Brian Kha,1,0,30,29
1656316139640,MATH 20D,A02,083766,Tran; Brian Kha,0,0,30,30
1656316139640,MATH 20D,A03,083767,Tran; Brian Kha,2,0,30,28
1656316145670,MATH 20E,A01,083771,Ganguly; Soumya,1,0,32,31
1656316145670,MATH 20E,A02,083772,Ganguly; Soumya,0,0,32,32
1656316145670,MATH 20E,B01,083773,Ciotti; Benjamin,18,0,35,17
1656316145670,MATH 20E,B02,083774,Ciotti; Benjamin,16,0,35,19
1656316151700,MATH 103A,A01,083777,Greenfeld; Be'Eri,2,0,36,34
1656316151700,MATH 103A,A02,083778,Greenfeld; Be'Eri,4,0,36,32
1656316151700,MATH 103A,A03,093561,Staff,3,0,36,33
1656316151700,MATH 103A,B01,083779,Greenfeld; Be'Eri,7,0,36,29
1656316151700,MATH 103A,B02,083780,Greenfeld; Be'Eri,0,0,36,36
1656316151700,MATH 103A,B03,093562,Staff,1,0,36,35
1656316157724,MATH 105,A01,085443,Carter; Anne Toulson,3,0,35,32
1656316157724,MATH 105,A02,093477,Staff,15,0,35,20
1656316163750,MATH 109,A01,083213,Ganzberger; Geoffrey Michael,1,0,34,33
1656316163750,MATH 109,A02,083214,Ganzberger; Geoffrey Michael,0,0,34,34
1656316163750,MATH 109,A03,093478,Staff,1,0,34,33
1656316163750,MATH 109,B01,083215,Ganzberger; Geoffrey Michael,3,0,32,29
1656316163750,MATH 109,B02,083216,Ganzberger; Geoffrey Michael,0,0,32,32
1656316163750,MATH 109,B03,093479,Staff,3,0,32,29
1656316169776,MATH 142A,A01,083219,Chow; Bennett,1,0,32,31
1656316169776,MATH 142A,A02,083220,Chow; Bennett,8,0,32,24
1656316169776,MATH 142A,A03,093480,Staff,4,0,32,28
1656316169776,MATH 142A,B03,093481,Staff,3,0,32,29
1656316169776,MATH 142A,B04,093558,Staff,7,0,32,25
1656316169776,MATH 142A,B05,093559,Staff,1,0,32,31
1656316175800,MATH 193A,A01,083224,Rotar; Vladimir,0,1,34,34
1656316175800,MATH 193A,A02,083225,Rotar; Vladimir,0,0,34,34
1656316175800,MATH 193A,A03,083781,Rotar; Vladimir,0,0,34,34
1656316175800,MATH 193A,A04,083782,Rotar; Vladimir,5,0,34,29
1656316175800,MATH 193A,A05,093482,Rotar; Vladimir,0,0,34,34
1656316181821,MATH 197,001,091859,McAuley; Julian John,9999,0,9999,0
1656316181821,MATH 197,002,095566,Kedlaya; Kiran S.,9997,0,9999,2
1656316181821,MATH 197,003,095567,Xiao; Ming,9999,0,9999,0
1656316181821,MATH 197,004,095571,Perols; Johan Lars,9998,0,9999,1
1656316188884,COGS 9,A01,083615,Shannon; Kyle Michael,3,0,75,72
1656316194908,COGS 11,A01,083617,Boyle; Mary E. T.,17,0,48,31
1656316200941,COGS 13,A01,083071,Bastos; Amalia Pinkusfeld,5,0,71,66
1656316206972,COGS 14A,A01,092681,Semenuks; Arturs,0,8,100,103
1656316212996,COGS 14B,A01,083073,Cheng; Tzu-Han,7,0,63,56
1656316219028,COGS 17,A01,092677,Semenuks; Arturs,6,0,81,75
1656316225055,COGS 100,A01,083619,Allen; Michael Gordon,3,0,70,67
1656316231080,COGS 101A,A01,083621,Davis; Joshua Daniel,5,0,68,63
1656316237105,COGS 101B,A01,091572,Allen; Michael Gordon,4,0,65,61
1656316243137,COGS 101C,A01,083625,Delgado; Tania,11,0,35,24
1656316249253,COGS 107A,A01,083627,Boyle; Mary E. T.,2,0,60,58
1656316255280,COGS 118A,A01,083075,Gupta; Anjum,8,0,76,68
1656316261309,CSE 3,A50,083646,Miranda; Gregory Joseph,18,0,50,32
1656316267333,CSE 8A,A50,083650,Miranda; Gregory Joseph,4,2,56,52
1656316273361,CSE 11,A01,083080,Cao; Yingjun,0,47,40,40
1656316279397,CSE 12,A01,083652,Krause-Levy; Sophia Louisa,5,1,120,115
1656316285424,CSE 15L,A01,083654,Morris; Justin Loren,2,0,50,48
1656316285424,CSE 15L,A02,083655,Morris; Justin Loren,4,0,50,46
1656316291449,CSE 20,A01,083657,Tran; Khoa Dang,31,0,80,49
1656316297476,CSE 21,A01,095574,Bach; Quang Tran,23,0,48,25
1656316303498,CSE 30,A01,083084,Eldon; John,1,4,80,79
1656316303498,CSE 30,B01,095061,Bhaskar; Nishant,0,1,50,50
1656316309526,CSE 100,A01,083659,Cao; Yingjun,1,18,70,69
1656316315554,CSE 134B,A01,083661,Powell; Thomas Allan,6,0,100,94
1656316321581,CSE 140,A01,083663,Gungor; Onat,9,0,85,76
1656316327609,CSE 140L,A01,083088,Eldon; John,10,0,100,90
1656316333643,CSE 175,A01,083665,Kumar; Rakesh,0,0,25,25
1656316339669,CSE 190,A00,092507,Dubnov; Shlomo,4,0,20,16
1656316345701,ECE 45,A01,083139,Congero; Spencer William,1,0,75,74
1656316351738,ECE 65,A50,083695,Saad; Andrew S,10,0,30,20
1656316351738,ECE 65,A51,095125,Staff,25,0,26,1
1656316357770,ECE 109,A01,091882,Touri; Behrouz,0,1,70,70
1656316363794,ECE 180,A00,083140,Abi Samra; Nicholas Camill,2,0,30,28
1656316363794,ECE 180,B00,083141,Abi Samra; Nicholas Camill,0,4,30,30
1656316369828,MATH 10A,A01,083735,Patchell; Gregory David,0,0,30,30
1656316369828,MATH 10A,A02,083736,Patchell; Gregory David,22,0,30,8
1656316369828,MATH 10A,A03,083737,Patchell; Gregory David,16,0,30,14
1656316375860,MATH 10B,A01,083207,Lim; Seonhee,2,0,34,32
1656316375860,MATH 10B,A02,083208,Lim; Seonhee,4,0,35,31
1656316375860,MATH 10B,A03,093472,Staff,1,0,34,33
1656316375860,MATH 10B,B01,083739,Sinha; Shubham,11,0,30,19
1656316381890,MATH 18,A01,083743,Cinel; Cameron Alexander,7,0,30,23
1656316381890,MATH 18,A02,083744,Cinel; Cameron Alexander,10,0,30,20
1656316381890,MATH 18,A03,083745,Cinel; Cameron Alexander,5,0,30,25
1656316381890,MATH 18,B01,083748,Rideout; David Porter,0,0,36,36
1656316381890,MATH 18,B02,083749,Rideout; David Porter,0,0,36,36
1656316381890,MATH 18,B03,083750,Rideout; David Porter,0,0,36,36
1656316381890,MATH 18,B04,083751,Rideout; David Porter,0,1,36,36
1656316381890,MATH 18,B05,093473,Rideout; David Porter,0,0,36,36
1656316381890,MATH 18,B06,093474,Rideout; David Porter,2,0,36,34
1656316387926,MATH 20A,A01,083754,Zheng; Zequn,11,0,40,29
1656316393961,MATH 20B,A01,083756,Briones; Jor-el Thomas Caparas,0,0,36,36
1656316393961,MATH 20B,A02,083757,Briones; Jor-el Thomas Caparas,0,0,36,36
1656316393961,MATH 20B,A03,093475,Staff,1,0,36,35
1656316399993,MATH 20C,A01,083760,Briones; Jor-el Thomas Caparas,0,0,35,35
1656316399993,MATH 20C,A02,083761,Briones; Jor-el Thomas Caparas,9,1,35,26
1656316399993,MATH 20C,A03,093476,Staff,0,0,35,35
1656316399993,MATH 20C,B01,083762,Bach; Quang Tran,2,0,30,28
1656316406023,MATH 20D,A01,083765,Tran; Brian Kha,1,0,30,29
1656316406023,MATH 20D,A02,083766,Tran; Brian Kha,0,0,30,30
1656316406023,MATH 20D,A03,083767,Tran; Brian Kha,2,0,30,28
1656316412046,MATH 20E,A01,083771,Ganguly; Soumya,1,0,32,31
1656316412046,MATH 20E,A02,083772,Ganguly; Soumya,0,0,32,32
1656316412046,MATH 20E,B01,083773,Ciotti; Benjamin,18,0,35,17
1656316412046,MATH 20E,B02,083774,Ciotti; Benjamin,16,0,35,19
1656316418071,MATH 103A,A01,083777,Greenfeld; Be'Eri,2,0,36,34
1656316418071,MATH 103A,A02,083778,Greenfeld; Be'Eri,4,0,36,32
1656316418071,MATH 103A,A03,093561,Staff,3,0,36,33
1656316418071,MATH 103A,B01,083779,Greenfeld; Be'Eri,7,0,36,29
1656316418071,MATH 103A,B02,083780,Greenfeld; Be'Eri,0,0,36,36
1656316418071,MATH 103A,B03,093562,Staff,1,0,36,35
1656316424101,MATH 105,A01,085443,Carter; Anne Toulson,3,0,35,32
1656316424101,MATH 105,A02,093477,Staff,15,0,35,20
1656316430131,MATH 109,A01,083213,Ganzberger; Geoffrey Michael,1,0,34,33
1656316430131,MATH 109,A02,083214,Ganzberger; Geoffrey Michael,0,0,34,34
1656316430131,MATH 109,A03,093478,Staff,1,0,34,33
1656316430131,MATH 109,B01,083215,Ganzberger; Geoffrey Michael,3,0,32,29
1656316430131,MATH 109,B02,083216,Ganzberger; Geoffrey Michael,0,0,32,32
1656316430131,MATH 109,B03,093479,Staff,3,0,32,29
1656316436160,MATH 142A,A01,083219,Chow; Bennett,1,0,32,31
1656316436160,MATH 142A,A02,083220,Chow; Bennett,8,0,32,24
1656316436160,MATH 142A,A03,093480,Staff,4,0,32,28
1656316436160,MATH 142A,B03,093481,Staff,3,0,32,29
1656316436160,MATH 142A,B04,093558,Staff,7,0,32,25
1656316436160,MATH 142A,B05,093559,Staff,1,0,32,31
1656316442190,MATH 193A,A01,083224,Rotar; Vladimir,0,1,34,34
1656316442190,MATH 193A,A02,083225,Rotar; Vladimir,0,0,34,34
1656316442190,MATH 193A,A03,083781,Rotar; Vladimir,0,0,34,34
1656316442190,MATH 193A,A04,083782,Rotar; Vladimir,5,0,34,29
1656316442190,MATH 193A,A05,093482,Rotar; Vladimir,0,0,34,34
1656316448215,MATH 197,001,091859,McAuley; Julian John,9999,0,9999,0
1656316448215,MATH 197,002,095566,Kedlaya; Kiran S.,9997,0,9999,2
1656316448215,MATH 197,003,095567,Xiao; Ming,9999,0,9999,0
1656316448215,MATH 197,004,095571,Perols; Johan Lars,9998,0,9999,1
1656316455270,COGS 9,A01,083615,Shannon; Kyle Michael,3,0,75,72
1656316461298,COGS 11,A01,083617,Boyle; Mary E. T.,17,0,48,31
1656316467323,COGS 13,A01,083071,Bastos; Amalia Pinkusfeld,5,0,71,66
1656316473349,COGS 14A,A01,092681,Semenuks; Arturs,0,8,100,103
1656316479378,COGS 14B,A01,083073,Cheng; Tzu-Han,7,0,63,56
1656316485410,COGS 17,A01,092677,Semenuks; Arturs,6,0,81,75
1656316491438,COGS 100,A01,083619,Allen; Michael Gordon,3,0,70,67
1656316497459,COGS 101A,A01,083621,Davis; Joshua Daniel,5,0,68,63
1656316503482,COGS 101B,A01,091572,Allen; Michael Gordon,4,0,65,61
1656316509513,COGS 101C,A01,083625,Delgado; Tania,11,0,35,24
1656316515541,COGS 107A,A01,083627,Boyle; Mary E. T.,2,0,60,58
1656316521566,COGS 118A,A01,083075,Gupta; Anjum,8,0,76,68
1656316527589,CSE 3,A50,083646,Miranda; Gregory Joseph,18,0,50,32
1656316533618,CSE 8A,A50,083650,Miranda; Gregory Joseph,4,2,56,52
1656316539644,CSE 11,A01,083080,Cao; Yingjun,0,47,40,40
1656316545681,CSE 12,A01,083652,Krause-Levy; Sophia Louisa,5,1,120,115
1656316551711,CSE 15L,A01,083654,Morris; Justin Loren,2,0,50,48
1656316551711,CSE 15L,A02,083655,Morris; Justin Loren,4,0,50,46
1656316557738,CSE 20,A01,083657,Tran; Khoa Dang,31,0,80,49
1656316563761,CSE 21,A01,095574,Bach; Quang Tran,23,0,48,25
1656316569785,CSE 30,A01,083084,Eldon; John,1,4,80,79
1656316569785,CSE 30,B01,095061,Bhaskar; Nishant,0,1,50,50
1656316575813,CSE 100,A01,083659,Cao; Yingjun,1,18,70,69
1656316581835,CSE 134B,A01,083661,Powell; Thomas Allan,6,0,100,94
1656316587859,CSE 140,A01,083663,Gungor; Onat,9,0,85,76
1656316593887,CSE 140L,A01,083088,Eldon; John,10,0,100,90
1656316599914,CSE 175,A01,083665,Kumar; Rakesh,0,0,25,25
1656316605940,CSE 190,A00,092507,Dubnov; Shlomo,4,0,20,16
1656316611969,ECE 45,A01,083139,Congero; Spencer William,1,0,75,74
1656316617992,ECE 65,A50,083695,Saad; Andrew S,10,0,30,20
1656316617992,ECE 65,A51,095125,Staff,25,0,26,1
1656316624015,ECE 109,A01,091882,Touri; Behrouz,0,1,70,70
1656316630041,ECE 180,A00,083140,Abi Samra; Nicholas Camill,2,0,30,28
1656316630041,ECE 180,B00,083141,Abi Samra; Nicholas Camill,0,4,30,30
1656316636073,MATH 10A,A01,083735,Patchell; Gregory David,0,0,30,30
1656316636073,MATH 10A,A02,083736,Patchell; Gregory David,22,0,30,8
1656316636073,MATH 10A,A03,083737,Patchell; Gregory David,16,0,30,14
1656316642097,MATH 10B,A01,083207,Lim; Seonhee,2,0,34,32
1656316642097,MATH 10B,A02,083208,Lim; Seonhee,4,0,35,31
1656316642097,MATH 10B,A03,093472,Staff,1,0,34,33
1656316642097,MATH 10B,B01,083739,Sinha; Shubham,11,0,30,19
1656316648122,MATH 18,A01,083743,Cinel; Cameron Alexander,7,0,30,23
1656316648122,MATH 18,A02,083744,Cinel; Cameron Alexander,10,0,30,20
1656316648122,MATH 18,A03,083745,Cinel; Cameron Alexander,5,0,30,25
1656316648122,MATH 18,B01,083748,Rideout; David Porter,0,0,36,36
1656316648122,MATH 18,B02,083749,Rideout; David Porter,0,0,36,36
1656316648122,MATH 18,B03,083750,Rideout; David Porter,0,0,36,36
1656316648122,MATH 18,B04,083751,Rideout; David Porter,0,1,36,36
1656316648122,MATH 18,B05,093473,Rideout; David Porter,0,0,36,36
1656316648122,MATH 18,B06,093474,Rideout; David Porter,2,0,36,34
1656316654145,MATH 20A,A01,083754,Zheng; Zequn,11,0,40,29
1656316660168,MATH 20B,A01,083756,Briones; Jor-el Thomas Caparas,0,0,36,36
1656316660168,MATH 20B,A02,083757,Briones; Jor-el Thomas Caparas,0,0,36,36
1656316660168,MATH 20B,A03,093475,Staff,1,0,36,35
1656316666194,MATH 20C,A01,083760,Briones; Jor-el Thomas Caparas,0,0,35,35
1656316666194,MATH 20C,A02,083761,Briones; Jor-el Thomas Caparas,9,1,35,26
1656316666194,MATH 20C,A03,093476,Staff,0,0,35,35
1656316666194,MATH 20C,B01,083762,Bach; Quang Tran,2,0,30,28
1656316672231,MATH 20D,A01,083765,Tran; Brian Kha,1,0,30,29
1656316672231,MATH 20D,A02,083766,Tran; Brian Kha,0,0,30,30
1656316672231,MATH 20D,A03,083767,Tran; Brian Kha,2,0,30,28
1656316678258,MATH 20E,A01,083771,Ganguly; Soumya,1,0,32,31
1656316678258,MATH 20E,A02,083772,Ganguly; Soumya,0,0,32,32
1656316678258,MATH 20E,B01,083773,Ciotti; Benjamin,18,0,35,17
1656316678258,MATH 20E,B02,083774,Ciotti; Benjamin,16,0,35,19
1656316684283,MATH 103A,A01,083777,Greenfeld; Be'Eri,2,0,36,34
1656316684283,MATH 103A,A02,083778,Greenfeld; Be'Eri,4,0,36,32
1656316684283,MATH 103A,A03,093561,Staff,3,0,36,33
1656316684283,MATH 103A,B01,083779,Greenfeld; Be'Eri,7,0,36,29
1656316684283,MATH 103A,B02,083780,Greenfeld; Be'Eri,0,0,36,36
1656316684283,MATH 103A,B03,093562,Staff,1,0,36,35
1656316690307,MATH 105,A01,085443,Carter; Anne Toulson,3,0,35,32
1656316690307,MATH 105,A02,093477,Staff,15,0,35,20
1656316696335,MATH 109,A01,083213,Ganzberger; Geoffrey Michael,1,0,34,33
1656316696335,MATH 109,A02,083214,Ganzberger; Geoffrey Michael,0,0,34,34
1656316696335,MATH 109,A03,093478,Staff,1,0,34,33
1656316696335,MATH 109,B01,083215,Ganzberger; Geoffrey Michael,3,0,32,29
1656316696335,MATH 109,B02,083216,Ganzberger; Geoffrey Michael,0,0,32,32
1656316696335,MATH 109,B03,093479,Staff,3,0,32,29
1656316702358,MATH 142A,A01,083219,Chow; Bennett,1,0,32,31
1656316702358,MATH 142A,A02,083220,Chow; Bennett,8,0,32,24
1656316702358,MATH 142A,A03,093480,Staff,4,0,32,28
1656316702358,MATH 142A,B03,093481,Staff,3,0,32,29
1656316702358,MATH 142A,B04,093558,Staff,7,0,32,25
1656316702358,MATH 142A,B05,093559,Staff,1,0,32,31
1656316708380,MATH 193A,A01,083224,Rotar; Vladimir,0,1,34,34
1656316708380,MATH 193A,A02,083225,Rotar; Vladimir,0,0,34,34
1656316708380,MATH 193A,A03,083781,Rotar; Vladimir,0,0,34,34
1656316708380,MATH 193A,A04,083782,Rotar; Vladimir,5,0,34,29
1656316708380,MATH 193A,A05,093482,Rotar; Vladimir,0,0,34,34
1656316714406,MATH 197,001,091859,McAuley; Julian John,9999,0,9999,0
1656316714406,MATH 197,002,095566,Kedlaya; Kiran S.,9997,0,9999,2
1656316714406,MATH 197,003,095567,Xiao; Ming,9999,0,9999,0
1656316714406,MATH 197,004,095571,Perols; Johan Lars,9998,0,9999,1
1656316721475,COGS 9,A01,083615,Shannon; Kyle Michael,3,0,75,72
1656316727502,COGS 11,A01,083617,Boyle; Mary E. T.,17,0,48,31
1656316733526,COGS 13,A01,083071,Bastos; Amalia Pinkusfeld,5,0,71,66
1656316739549,COGS 14A,A01,092681,Semenuks; Arturs,0,8,100,103
1656316745572,COGS 14B,A01,083073,Cheng; Tzu-Han,7,0,63,56
1656316751596,COGS 17,A01,092677,Semenuks; Arturs,6,0,81,75
1656316757619,COGS 100,A01,083619,Allen; Michael Gordon,3,0,70,67
1656316763648,COGS 101A,A01,083621,Davis; Joshua Daniel,5,0,68,63
1656316769672,COGS 101B,A01,091572,Allen; Michael Gordon,4,0,65,61
1656316775700,COGS 101C,A01,083625,Delgado; Tania,11,0,35,24
1656316781722,COGS 107A,A01,083627,Boyle; Mary E. T.,2,0,60,58
1656316787784,COGS 118A,A01,083075,Gupta; Anjum,8,0,76,68
1656316793812,CSE 3,A50,083646,Miranda; Gregory Joseph,18,0,50,32
1656316799839,CSE 8A,A50,083650,Miranda; Gregory Joseph,4,2,56,52
1656316805864,CSE 11,A01,083080,Cao; Yingjun,0,47,40,40
1656316811898,CSE 12,A01,083652,Krause-Levy; Sophia Louisa,5,1,120,115
1656316817922,CSE 15L,A01,083654,Morris; Justin Loren,2,0,50,48
1656316817922,CSE 15L,A02,083655,Morris; Justin Loren,4,0,50,46
1656316823947,CSE 20,A01,083657,Tran; Khoa Dang,31,0,80,49
1656316829972,CSE 21,A01,095574,Bach; Quang Tran,23,0,48,25
1656316836014,CSE 30,A01,083084,Eldon; John,1,4,80,79
1656316836014,CSE 30,B01,095061,Bhaskar; Nishant,0,1,50,50
1656316842036,CSE 100,A01,083659,Cao; Yingjun,1,18,70,69
1656316848142,CSE 134B,A01,083661,Powell; Thomas Allan,6,0,100,94
1656316854171,CSE 140,A01,083663,Gungor; Onat,9,0,85,76
1656316860194,CSE 140L,A01,083088,Eldon; John,10,0,100,90
1656316866224,CSE 175,A01,083665,Kumar; Rakesh,0,0,25,25
1656316872253,CSE 190,A00,092507,Dubnov; Shlomo,4,0,20,16
1656316878277,ECE 45,A01,083139,Congero; Spencer William,1,0,75,74
1656316884301,ECE 65,A50,083695,Saad; Andrew S,10,0,30,20
1656316884301,ECE 65,A51,095125,Staff,25,0,26,1
1656316890328,ECE 109,A01,091882,Touri; Behrouz,0,1,70,70
1656316896352,ECE 180,A00,083140,Abi Samra; Nicholas Camill,2,0,30,28
1656316896352,ECE 180,B00,083141,Abi Samra; Nicholas Camill,0,4,30,30
1656316902381,MATH 10A,A01,083735,Patchell; Gregory David,0,0,30,30
1656316902381,MATH 10A,A02,083736,Patchell; Gregory David,22,0,30,8
1656316902381,MATH 10A,A03,083737,Patchell; Gregory David,16,0,30,14
1656316908404,MATH 10B,A01,083207,Lim; Seonhee,2,0,34,32
1656316908404,MATH 10B,A02,083208,Lim; Seonhee,4,0,35,31
1656316908404,MATH 10B,A03,093472,Staff,1,0,34,33
1656316908404,MATH 10B,B01,083739,Sinha; Shubham,11,0,30,19
1656316914435,MATH 18,A01,083743,Cinel; Cameron Alexander,7,0,30,23
1656316914435,MATH 18,A02,083744,Cinel; Cameron Alexander,10,0,30,20
1656316914435,MATH 18,A03,083745,Cinel; Cameron Alexander,5,0,30,25
1656316914435,MATH 18,B01,083748,Rideout; David Porter,0,0,36,36
1656316914435,MATH 18,B02,083749,Rideout; David Porter,0,0,36,36
1656316914435,MATH 18,B03,083750,Rideout; David Porter,0,0,36,36
1656316914435,MATH 18,B04,083751,Rideout; David Porter,0,1,36,36
1656316914435,MATH 18,B05,093473,Rideout; David Porter,0,0,36,36
1656316914435,MATH 18,B06,093474,Rideout; David Porter,2,0,36,34
1656316920458,MATH 20A,A01,083754,Zheng; Zequn,11,0,40,29
1656316926486,MATH 20B,A01,083756,Briones; Jor-el Thomas Caparas,0,0,36,36
1656316926486,MATH 20B,A02,083757,Briones; Jor-el Thomas Caparas,0,0,36,36
1656316926486,MATH 20B,A03,093475,Staff,1,0,36,35
1656316932510,MATH 20C,A01,083760,Briones; Jor-el Thomas Caparas,0,0,35,35
1656316932510,MATH 20C,A02,083761,Briones; Jor-el Thomas Caparas,9,1,35,26
1656316932510,MATH 20C,A03,093476,Staff,0,0,35,35
1656316932510,MATH 20C,B01,083762,Bach; Quang Tran,2,0,30,28
1656316938536,MATH 20D,A01,083765,Tran; Brian Kha,1,0,30,29
1656316938536,MATH 20D,A02,083766,Tran; Brian Kha,0,0,30,30
1656316938536,MATH 20D,A03,083767,Tran; Brian Kha,2,0,30,28
1656316944565,MATH 20E,A01,083771,Ganguly; Soumya,1,0,32,31
1656316944565,MATH 20E,A02,083772,Ganguly; Soumya,0,0,32,32
1656316944565,MATH 20E,B01,083773,Ciotti; Benjamin,18,0,35,17
1656316944565,MATH 20E,B02,083774,Ciotti; Benjamin,16,0,35,19
1656316950595,MATH 103A,A01,083777,Greenfeld; Be'Eri,2,0,36,34
1656316950595,MATH 103A,A02,083778,Greenfeld; Be'Eri,4,0,36,32
1656316950595,MATH 103A,A03,093561,Staff,3,0,36,33
1656316950595,MATH 103A,B01,083779,Greenfeld; Be'Eri,7,0,36,29
1656316950595,MATH 103A,B02,083780,Greenfeld; Be'Eri,0,0,36,36
1656316950595,MATH 103A,B03,093562,Staff,1,0,36,35
1656316956618,MATH 105,A01,085443,Carter; Anne Toulson,3,0,35,32
1656316956618,MATH 105,A02,093477,Staff,15,0,35,20
1656316962643,MATH 109,A01,083213,Ganzberger; Geoffrey Michael,1,0,34,33
1656316962643,MATH 109,A02,083214,Ganzberger; Geoffrey Michael,0,0,34,34
1656316962643,MATH 109,A03,093478,Staff,2,0,34,32
1656316962643,MATH 109,B01,083215,Ganzberger; Geoffrey Michael,3,0,32,29
1656316962643,MATH 109,B02,083216,Ganzberger; Geoffrey Michael,0,0,32,32
1656316962643,MATH 109,B03,093479,Staff,3,0,32,29
1656316968668,MATH 142A,A01,083219,Chow; Bennett,1,0,32,31
1656316968668,MATH 142A,A02,083220,Chow; Bennett,8,0,32,24
1656316968668,MATH 142A,A03,093480,Staff,4,0,32,28
1656316968668,MATH 142A,B03,093481,Staff,3,0,32,29
1656316968668,MATH 142A,B04,093558,Staff,7,0,32,25
1656316968668,MATH 142A,B05,093559,Staff,1,0,32,31
1656316974692,MATH 193A,A01,083224,Rotar; Vladimir,0,1,34,34
1656316974692,MATH 193A,A02,083225,Rotar; Vladimir,0,0,34,34
1656316974692,MATH 193A,A03,083781,Rotar; Vladimir,0,0,34,34
1656316974692,MATH 193A,A04,083782,Rotar; Vladimir,5,0,34,29
1656316974692,MATH 193A,A05,093482,Rotar; Vladimir,0,0,34,34
1656316980714,MATH 197,001,091859,McAuley; Julian John,9999,0,9999,0
1656316980714,MATH 197,002,095566,Kedlaya; Kiran S.,9997,0,9999,2
1656316980714,MATH 197,003,095567,Xiao; Ming,9999,0,9999,0
1656316980714,MATH 197,004,095571,Perols; Johan Lars,9998,0,9999,1
1656316987770,COGS 9,A01,083615,Shannon; Kyle Michael,3,0,75,72
1656316993798,COGS 11,A01,083617,Boyle; Mary E. T.,17,0,48,31
1656316999822,COGS 13,A01,083071,Bastos; Amalia Pinkusfeld,5,0,71,66
1656317005846,COGS 14A,A01,092681,Semenuks; Arturs,0,8,100,103
1656317011884,COGS 14B,A01,083073,Cheng; Tzu-Han,7,0,63,56
1656317017919,COGS 17,A01,092677,Semenuks; Arturs,6,0,81,75
1656317023944,COGS 100,A01,083619,Allen; Michael Gordon,2,0,70,68
1656317029970,COGS 101A,A01,083621,Davis; Joshua Daniel,5,0,68,63
1656317035996,COGS 101B,A01,091572,Allen; Michael Gordon,4,0,65,61
1656317042024,COGS 101C,A01,083625,Delgado; Tania,11,0,35,24
1656317048054,COGS 107A,A01,083627,Boyle; Mary E. T.,2,0,60,58
1656317054079,COGS 118A,A01,083075,Gupta; Anjum,8,0,76,68
1656317060103,CSE 3,A50,083646,Miranda; Gregory Joseph,18,0,50,32
1656317066131,CSE 8A,A50,083650,Miranda; Gregory Joseph,4,2,56,52
1656317072164,CSE 11,A01,083080,Cao; Yingjun,0,47,40,40
1656317078189,CSE 12,A01,083652,Krause-Levy; Sophia Louisa,5,1,120,115
1656317084212,CSE 15L,A01,083654,Morris; Justin Loren,2,0,50,48
1656317084212,CSE 15L,A02,083655,Morris; Justin Loren,4,0,50,46
1656317090236,CSE 20,A01,083657,Tran; Khoa Dang,31,0,80,49
1656317096263,CSE 21,A01,095574,Bach; Quang Tran,23,0,48,25
1656317102285,CSE 30,A01,083084,Eldon; John,1,4,80,79
1656317102285,CSE 30,B01,095061,Bhaskar; Nishant,0,1,50,50
1656317108311,CSE 100,A01,083659,Cao; Yingjun,1,18,70,69
1656317114339,CSE 134B,A01,083661,Powell; Thomas Allan,6,0,100,94
1656317120363,CSE 140,A01,083663,Gungor; Onat,9,0,85,76
1656317126390,CSE 140L,A01,083088,Eldon; John,10,0,100,90
1656317132413,CSE 175,A01,083665,Kumar; Rakesh,0,0,25,25
1656317138440,CSE 190,A00,092507,Dubnov; Shlomo,4,0,20,16
1656317144468,ECE 45,A01,083139,Congero; Spencer William,1,0,75,74
1656317150490,ECE 65,A50,083695,Saad; Andrew S,10,0,30,20
1656317150490,ECE 65,A51,095125,Staff,25,0,26,1
1656317156513,ECE 109,A01,091882,Touri; Behrouz,0,1,70,70
1656317162537,ECE 180,A00,083140,Abi Samra; Nicholas Camill,2,0,30,28
1656317162537,ECE 180,B00,083141,Abi Samra; Nicholas Camill,0,4,30,30
1656317168561,MATH 10A,A01,083735,Patchell; Gregory David,0,0,30,30
1656317168561,MATH 10A,A02,083736,Patchell; Gregory David,22,0,30,8
1656317168561,MATH 10A,A03,083737,Patchell; Gregory David,16,0,30,14
1656317174586,MATH 10B,A01,083207,Lim; Seonhee,2,0,34,32
1656317174586,MATH 10B,A02,083208,Lim; Seonhee,4,0,35,31
1656317174586,MATH 10B,A03,093472,Staff,1,0,34,33
1656317174586,MATH 10B,B01,083739,Sinha; Shubham,11,0,30,19
1656317180638,MATH 18,A01,083743,Cinel; Cameron Alexander,7,0,30,23
1656317180638,MATH 18,A02,083744,Cinel; Cameron Alexander,10,0,30,20
1656317180638,MATH 18,A03,083745,Cinel; Cameron Alexander,5,0,30,25
1656317180638,MATH 18,B01,083748,Rideout; David Porter,0,0,36,36
1656317180638,MATH 18,B02,083749,Rideout; David Porter,0,0,36,36
1656317180638,MATH 18,B03,083750,Rideout; David Porter,0,0,36,36
1656317180638,MATH 18,B04,083751,Rideout; David Porter,0,1,36,36
1656317180638,MATH 18,B05,093473,Rideout; David Porter,0,0,36,36
1656317180638,MATH 18,B06,093474,Rideout; David Porter,2,0,36,34
1656317186666,MATH 20A,A01,083754,Zheng; Zequn,11,0,40,29
1656317192689,MATH 20B,A01,083756,Briones; Jor-el Thomas Caparas,0,0,36,36
1656317192689,MATH 20B,A02,083757,Briones; Jor-el Thomas Caparas,0,0,36,36
1656317192689,MATH 20B,A03,093475,Staff,1,0,36,35
1656317198718,MATH 20C,A01,083760,Briones; Jor-el Thomas Caparas,0,0,35,35
1656317198718,MATH 20C,A02,083761,Briones; Jor-el Thomas Caparas,9,1,35,26
1656317198718,MATH 20C,A03,093476,Staff,0,0,35,35
1656317198718,MATH 20C,B01,083762,Bach; Quang Tran,2,0,30,28
1656317204744,MATH 20D,A01,083765,Tran; Brian Kha,1,0,30,29
1656317204744,MATH 20D,A02,083766,Tran; Brian Kha,0,0,30,30
1656317204744,MATH 20D,A03,083767,Tran; Brian Kha,2,0,30,28
1656317210775,MATH 20E,A01,083771,Ganguly; Soumya,1,0,32,31
1656317210775,MATH 20E,A02,083772,Ganguly; Soumya,0,0,32,32
1656317210775,MATH 20E,B01,083773,Ciotti; Benjamin,18,0,35,17
1656317210775,MATH 20E,B02,083774,Ciotti; Benjamin,16,0,35,19
1656317216806,MATH 103A,A01,083777,Greenfeld; Be'Eri,2,0,36,34
1656317216806,MATH 103A,A02,083778,Greenfeld; Be'Eri,4,0,36,32
1656317216806,MATH 103A,A03,093561,Staff,3,0,36,33
1656317216806,MATH 103A,B01,083779,Greenfeld; Be'Eri,7,0,36,29
1656317216806,MATH 103A,B02,083780,Greenfeld; Be'Eri,0,0,36,36
1656317216806,MATH 103A,B03,093562,Staff,1,0,36,35
1656317222834,MATH 105,A01,085443,Carter; Anne Toulson,3,0,35,32
1656317222834,MATH 105,A02,093477,Staff,15,0,35,20
1656317228864,MATH 109,A01,083213,Ganzberger; Geoffrey Michael,1,0,34,33
1656317228864,MATH 109,A02,083214,Ganzberger; Geoffrey Michael,0,0,34,34
1656317228864,MATH 109,A03,093478,Staff,2,0,34,32
1656317228864,MATH 109,B01,083215,Ganzberger; Geoffrey Michael,2,0,32,30
1656317228864,MATH 109,B02,083216,Ganzberger; Geoffrey Michael,0,0,32,32
1656317228864,MATH 109,B03,093479,Staff,4,0,32,28
1656317234890,MATH 142A,A01,083219,Chow; Bennett,1,0,32,31
1656317234890,MATH 142A,A02,083220,Chow; Bennett,8,0,32,24
1656317234890,MATH 142A,A03,093480,Staff,4,0,32,28
1656317234890,MATH 142A,B03,093481,Staff,3,0,32,29
1656317234890,MATH 142A,B04,093558,Staff,7,0,32,25
1656317234890,MATH 142A,B05,093559,Staff,1,0,32,31
1656317240933,MATH 193A,A01,083224,Rotar; Vladimir,0,1,34,34
1656317240933,MATH 193A,A02,083225,Rotar; Vladimir,0,0,34,34
1656317240933,MATH 193A,A03,083781,Rotar; Vladimir,0,0,34,34
1656317240933,MATH 193A,A04,083782,Rotar; Vladimir,5,0,34,29
1656317240933,MATH 193A,A05,093482,Rotar; Vladimir,0,0,34,34
1656317246958,MATH 197,001,091859,McAuley; Julian John,9999,0,9999,0
1656317246958,MATH 197,002,095566,Kedlaya; Kiran S.,9997,0,9999,2
1656317246958,MATH 197,003,095567,Xiao; Ming,9999,0,9999,0
1656317246958,MATH 197,004,095571,Perols; Johan Lars,9998,0,9999,1
1656317254020,COGS 9,A01,083615,Shannon; Kyle Michael,3,0,75,72
1656317260041,COGS 11,A01,083617,Boyle; Mary E. T.,17,0,48,31
1656317266065,COGS 13,A01,083071,Bastos; Amalia Pinkusfeld,5,0,71,66
1656317272090,COGS 14A,A01,092681,Semenuks; Arturs,0,8,100,103
1656317278116,COGS 14B,A01,083073,Cheng; Tzu-Han,7,0,63,56
1656317284140,COGS 17,A01,092677,Semenuks; Arturs,6,0,81,75
1656317290164,COGS 100,A01,083619,Allen; Michael Gordon,2,0,70,68
1656317296186,COGS 101A,A01,083621,Davis; Joshua Daniel,5,0,68,63
1656317302213,COGS 101B,A01,091572,Allen; Michael Gordon,4,0,65,61
1656317308236,COGS 101C,A01,083625,Delgado; Tania,11,0,35,24
1656317314260,COGS 107A,A01,083627,Boyle; Mary E. T.,2,0,60,58
1656317320283,COGS 118A,A01,083075,Gupta; Anjum,8,0,76,68
1656317326310,CSE 3,A50,083646,Miranda; Gregory Joseph,18,0,50,32
1656317332346,CSE 8A,A50,083650,Miranda; Gregory Joseph,5,2,56,51
1656317338369,CSE 11,A01,083080,Cao; Yingjun,0,47,40,40
1656317344395,CSE 12,A01,083652,Krause-Levy; Sophia Louisa,5,1,120,115
1656317350423,CSE 15L,A01,083654,Morris; Justin Loren,2,0,50,48
1656317350423,CSE 15L,A02,083655,Morris; Justin Loren,5,0,50,45
1656317356449,CSE 20,A01,083657,Tran; Khoa Dang,31,0,80,49
1656317362473,CSE 21,A01,095574,Bach; Quang Tran,23,0,48,25
1656317368496,CSE 30,A01,083084,Eldon; John,1,4,80,79
1656317368496,CSE 30,B01,095061,Bhaskar; Nishant,0,1,50,50
1656317374519,CSE 100,A01,083659,Cao; Yingjun,1,18,70,69
1656317380542,CSE 134B,A01,083661,Powell; Thomas Allan,6,0,100,94
1656317386567,CSE 140,A01,083663,Gungor; Onat,9,0,85,76
1656317392593,CSE 140L,A01,083088,Eldon; John,10,0,100,90
1656317398616,CSE 175,A01,083665,Kumar; Rakesh,0,0,25,25
1656317404639,CSE 190,A00,092507,Dubnov; Shlomo,4,0,20,16
1656317410666,ECE 45,A01,083139,Congero; Spencer William,1,0,75,74
1656317416693,ECE 65,A50,083695,Saad; Andrew S,10,0,30,20
1656317416693,ECE 65,A51,095125,Staff,25,0,26,1
1656317422716,ECE 109,A01,091882,Touri; Behrouz,0,1,70,70
1656317428745,ECE 180,A00,083140,Abi Samra; Nicholas Camill,2,0,30,28
1656317428745,ECE 180,B00,083141,Abi Samra; Nicholas Camill,0,4,30,30
1656317434772,MATH 10A,A01,083735,Patchell; Gregory David,0,0,30,30
1656317434772,MATH 10A,A02,083736,Patchell; Gregory David,22,0,30,8
1656317434772,MATH 10A,A03,083737,Patchell; Gregory David,16,0,30,14
1656317440806,MATH 10B,A01,083207,Lim; Seonhee,2,0,34,32
1656317440806,MATH 10B,A02,083208,Lim; Seonhee,4,0,35,31
1656317440806,MATH 10B,A03,093472,Staff,1,0,34,33
1656317440806,MATH 10B,B01,083739,Sinha; Shubham,11,0,30,19
1656317446926,MATH 18,A01,083743,Cinel; Cameron Alexander,7,0,30,23
1656317446926,MATH 18,A02,083744,Cinel; Cameron Alexander,10,0,30,20
1656317446926,MATH 18,A03,083745,Cinel; Cameron Alexander,5,0,30,25
1656317446926,MATH 18,B01,083748,Rideout; David Porter,0,0,36,36
1656317446926,MATH 18,B02,083749,Rideout; David Porter,0,0,36,36
1656317446926,MATH 18,B03,083750,Rideout; David Porter,0,0,36,36
1656317446926,MATH 18,B04,083751,Rideout; David Porter,0,1,36,36
1656317446926,MATH 18,B05,093473,Rideout; David Porter,0,0,36,36
1656317446926,MATH 18,B06,093474,Rideout; David Porter,2,0,36,34
1656317452954,MATH 20A,A01,083754,Zheng; Zequn,11,0,40,29
1656317458981,MATH 20B,A01,083756,Briones; Jor-el Thomas Caparas,0,0,36,36
1656317458981,MATH 20B,A02,083757,Briones; Jor-el Thomas Caparas,0,0,36,36
1656317458981,MATH 20B,A03,093475,Staff,1,0,36,35
1656317465009,MATH 20C,A01,083760,Briones; Jor-el Thomas Caparas,0,0,35,35
1656317465009,MATH 20C,A02,083761,Briones; Jor-el Thomas Caparas,9,1,35,26
1656317465009,MATH 20C,A03,093476,Staff,0,0,35,35
1656317465009,MATH 20C,B01,083762,Bach; Quang Tran,2,0,30,28
1656317471037,MATH 20D,A01,083765,Tran; Brian Kha,1,0,30,29
1656317471037,MATH 20D,A02,083766,Tran; Brian Kha,0,0,30,30
1656317471037,MATH 20D,A03,083767,Tran; Brian Kha,2,0,30,28
1656317477062,MATH 20E,A01,083771,Ganguly; Soumya,1,0,32,31
1656317477062,MATH 20E,A02,083772,Ganguly; Soumya,0,0,32,32
1656317477062,MATH 20E,B01,083773,Ciotti; Benjamin,18,0,35,17
1656317477062,MATH 20E,B02,083774,Ciotti; Benjamin,16,0,35,19
1656317483086,MATH 103A,A01,083777,Greenfeld; Be'Eri,2,0,36,34
1656317483086,MATH 103A,A02,083778,Greenfeld; Be'Eri,4,0,36,32
1656317483086,MATH 103A,A03,093561,Staff,3,0,36,33
1656317483086,MATH 103A,B01,083779,Greenfeld; Be'Eri,7,0,36,29
1656317483086,MATH 103A,B02,083780,Greenfeld; Be'Eri,0,0,36,36
1656317483086,MATH 103A,B03,093562,Staff,1,0,36,35
1656317489143,MATH 105,A01,085443,Carter; Anne Toulson,3,0,35,32
1656317489143,MATH 105,A02,093477,Staff,15,0,35,20
1656317495172,MATH 109,A01,083213,Ganzberger; Geoffrey Michael,1,0,34,33
1656317495172,MATH 109,A02,083214,Ganzberger; Geoffrey Michael,0,0,34,34
1656317495172,MATH 109,A03,093478,Staff,2,0,34,32
1656317495172,MATH 109,B01,083215,Ganzberger; Geoffrey Michael,2,0,32,30
1656317495172,MATH 109,B02,083216,Ganzberger; Geoffrey Michael,0,0,32,32
1656317495172,MATH 109,B03,093479,Staff,4,0,32,28
1656317501196,MATH 142A,A01,083219,Chow; Bennett,1,0,32,31
1656317501196,MATH 142A,A02,083220,Chow; Bennett,8,0,32,24
1656317501196,MATH 142A,A03,093480,Staff,4,0,32,28
1656317501196,MATH 142A,B03,093481,Staff,3,0,32,29
1656317501196,MATH 142A,B04,093558,Staff,7,0,32,25
1656317501196,MATH 142A,B05,093559,Staff,1,0,32,31
1656317507218,MATH 193A,A01,083224,Rotar; Vladimir,0,1,34,34
1656317507218,MATH 193A,A02,083225,Rotar; Vladimir,0,0,34,34
1656317507218,MATH 193A,A03,083781,Rotar; Vladimir,0,0,34,34
1656317507218,MATH 193A,A04,083782,Rotar; Vladimir,5,0,34,29
1656317507218,MATH 193A,A05,093482,Rotar; Vladimir,0,0,34,34
1656317513241,MATH 197,001,091859,McAuley; Julian John,9999,0,9999,0
1656317513241,MATH 197,002,095566,Kedlaya; Kiran S.,9997,0,9999,2
1656317513241,MATH 197,003,095567,Xiao; Ming,9999,0,9999,0
1656317513241,MATH 197,004,095571,Perols; Johan Lars,9998,0,9999,1
1656317520307,COGS 9,A01,083615,Shannon; Kyle Michael,3,0,75,72
1656317526331,COGS 11,A01,083617,Boyle; Mary E. T.,17,0,48,31
1656317532358,COGS 13,A01,083071,Bastos; Amalia Pinkusfeld,5,0,71,66
1656317538381,COGS 14A,A01,092681,Semenuks; Arturs,0,8,100,103
1656317544408,COGS 14B,A01,083073,Cheng; Tzu-Han,7,0,63,56
1656317550430,COGS 17,A01,092677,Semenuks; Arturs,6,0,81,75
1656317556454,COGS 100,A01,083619,Allen; Michael Gordon,2,0,70,68
1656317562477,COGS 101A,A01,083621,Davis; Joshua Daniel,5,0,68,63
1656317568501,COGS 101B,A01,091572,Allen; Michael Gordon,4,0,65,61
1656317574526,COGS 101C,A01,083625,Delgado; Tania,11,0,35,24
1656317580555,COGS 107A,A01,083627,Boyle; Mary E. T.,2,0,60,58
1656317586579,COGS 118A,A01,083075,Gupta; Anjum,8,0,76,68
1656317592603,CSE 3,A50,083646,Miranda; Gregory Joseph,18,0,50,32
1656317598626,CSE 8A,A50,083650,Miranda; Gregory Joseph,5,2,56,51
1656317604653,CSE 11,A01,083080,Cao; Yingjun,0,47,40,40
1656317610678,CSE 12,A01,083652,Krause-Levy; Sophia Louisa,5,1,120,115
1656317616701,CSE 15L,A01,083654,Morris; Justin Loren,2,0,50,48
1656317616701,CSE 15L,A02,083655,Morris; Justin Loren,4,0,50,46
1656317622725,CSE 20,A01,083657,Tran; Khoa Dang,31,0,80,49
1656317628749,CSE 21,A01,095574,Bach; Quang Tran,23,0,48,25
1656317634773,CSE 30,A01,083084,Eldon; John,1,4,80,79
1656317634773,CSE 30,B01,095061,Bhaskar; Nishant,0,1,50,50
1656317640801,CSE 100,A01,083659,Cao; Yingjun,1,18,70,69
1656317646828,CSE 134B,A01,083661,Powell; Thomas Allan,6,0,100,94
1656317652850,CSE 140,A01,083663,Gungor; Onat,9,0,85,76
1656317658877,CSE 140L,A01,083088,Eldon; John,10,0,100,90
1656317664904,CSE 175,A01,083665,Kumar; Rakesh,0,0,25,25
1656317670929,CSE 190,A00,092507,Dubnov; Shlomo,4,0,20,16
1656317676955,ECE 45,A01,083139,Congero; Spencer William,1,0,75,74
1656317682978,ECE 65,A50,083695,Saad; Andrew S,10,0,30,20
1656317682978,ECE 65,A51,095125,Staff,25,0,26,1
1656317689002,ECE 109,A01,091882,Touri; Behrouz,0,1,70,70
1656317695029,ECE 180,A00,083140,Abi Samra; Nicholas Camill,2,0,30,28
1656317695029,ECE 180,B00,083141,Abi Samra; Nicholas Camill,0,4,30,30
1656317701058,MATH 10A,A01,083735,Patchell; Gregory David,0,0,30,30
1656317701058,MATH 10A,A02,083736,Patchell; Gregory David,22,0,30,8
1656317701058,MATH 10A,A03,083737,Patchell; Gregory David,16,0,30,14
1656317707082,MATH 10B,A01,083207,Lim; Seonhee,2,0,34,32
1656317707082,MATH 10B,A02,083208,Lim; Seonhee,4,0,35,31
1656317707082,MATH 10B,A03,093472,Staff,1,0,34,33
1656317707082,MATH 10B,B01,083739,Sinha; Shubham,11,0,30,19
1656317713112,MATH 18,A01,083743,Cinel; Cameron Alexander,7,0,30,23
1656317713112,MATH 18,A02,083744,Cinel; Cameron Alexander,10,0,30,20
1656317713112,MATH 18,A03,083745,Cinel; Cameron Alexander,5,0,30,25
1656317713112,MATH 18,B01,083748,Rideout; David Porter,0,0,36,36
1656317713112,MATH 18,B02,083749,Rideout; David Porter,0,0,36,36
1656317713112,MATH 18,B03,083750,Rideout; David Porter,0,0,36,36
1656317713112,MATH 18,B04,083751,Rideout; David Porter,0,1,36,36
1656317713112,MATH 18,B05,093473,Rideout; David Porter,0,0,36,36
1656317713112,MATH 18,B06,093474,Rideout; David Porter,2,0,36,34
1656317719136,MATH 20A,A01,083754,Zheng; Zequn,11,0,40,29
1656317725162,MATH 20B,A01,083756,Briones; Jor-el Thomas Caparas,0,0,36,36
1656317725162,MATH 20B,A02,083757,Briones; Jor-el Thomas Caparas,0,0,36,36
1656317725162,MATH 20B,A03,093475,Staff,1,0,36,35
1656317731191,MATH 20C,A01,083760,Briones; Jor-el Thomas Caparas,0,0,35,35
1656317731191,MATH 20C,A02,083761,Briones; Jor-el Thomas Caparas,9,1,35,26
1656317731191,MATH 20C,A03,093476,Staff,0,0,35,35
1656317731191,MATH 20C,B01,083762,Bach; Quang Tran,2,0,30,28
1656317737219,MATH 20D,A01,083765,Tran; Brian Kha,1,0,30,29
1656317737219,MATH 20D,A02,083766,Tran; Brian Kha,0,0,30,30
1656317737219,MATH 20D,A03,083767,Tran; Brian Kha,2,0,30,28
1656317743242,MATH 20E,A01,083771,Ganguly; Soumya,1,0,32,31
1656317743242,MATH 20E,A02,083772,Ganguly; Soumya,0,0,32,32
1656317743242,MATH 20E,B01,083773,Ciotti; Benjamin,18,0,35,17
1656317743242,MATH 20E,B02,083774,Ciotti; Benjamin,16,0,35,19
1656317749271,MATH 103A,A01,083777,Greenfeld; Be'Eri,2,0,36,34
1656317749271,MATH 103A,A02,083778,Greenfeld; Be'Eri,4,0,36,32
1656317749271,MATH 103A,A03,093561,Staff,3,0,36,33
1656317749271,MATH 103A,B01,083779,Greenfeld; Be'Eri,7,0,36,29
1656317749271,MATH 103A,B02,083780,Greenfeld; Be'Eri,0,0,36,36
1656317749271,MATH 103A,B03,093562,Staff,1,0,36,35
1656317755298,MATH 105,A01,085443,Carter; Anne Toulson,3,0,35,32
1656317755298,MATH 105,A02,093477,Staff,15,0,35,20
1656317761323,MATH 109,A01,083213,Ganzberger; Geoffrey Michael,1,0,34,33
1656317761323,MATH 109,A02,083214,Ganzberger; Geoffrey Michael,0,0,34,34
1656317761323,MATH 109,A03,093478,Staff,2,0,34,32
1656317761323,MATH 109,B01,083215,Ganzberger; Geoffrey Michael,2,0,32,30
1656317761323,MATH 109,B02,083216,Ganzberger; Geoffrey Michael,0,0,32,32
1656317761323,MATH 109,B03,093479,Staff,4,0,32,28
1656317767357,MATH 142A,A01,083219,Chow; Bennett,1,0,32,31
1656317767357,MATH 142A,A02,083220,Chow; Bennett,8,0,32,24
1656317767357,MATH 142A,A03,093480,Staff,4,0,32,28
1656317767357,MATH 142A,B03,093481,Staff,3,0,32,29
1656317767357,MATH 142A,B04,093558,Staff,7,0,32,25
1656317767357,MATH 142A,B05,093559,Staff,1,0,32,31
1656317773381,MATH 193A,A01,083224,Rotar; Vladimir,0,1,34,34
1656317773381,MATH 193A,A02,083225,Rotar; Vladimir,0,0,34,34
1656317773381,MATH 193A,A03,083781,Rotar; Vladimir,0,0,34,34
1656317773381,MATH 193A,A04,083782,Rotar; Vladimir,5,0,34,29
1656317773381,MATH 193A,A05,093482,Rotar; Vladimir,0,0,34,34
1656317779404,MATH 197,001,091859,McAuley; Julian John,9999,0,9999,0
1656317779404,MATH 197,002,095566,Kedlaya; Kiran S.,9997,0,9999,2
1656317779404,MATH 197,003,095567,Xiao; Ming,9999,0,9999,0
1656317779404,MATH 197,004,095571,Perols; Johan Lars,9998,0,9999,1
1656317786466,COGS 9,A01,083615,Shannon; Kyle Michael,3,0,75,72
1656317792489,COGS 11,A01,083617,Boyle; Mary E. T.,17,0,48,31
1656317798515,COGS 13,A01,083071,Bastos; Amalia Pinkusfeld,5,0,71,66
1656317804540,COGS 14A,A01,092681,Semenuks; Arturs,0,8,100,103
1656317810566,COGS 14B,A01,083073,Cheng; Tzu-Han,7,0,63,56
1656317816589,COGS 17,A01,092677,Semenuks; Arturs,6,0,81,75
1656317822615,COGS 100,A01,083619,Allen; Michael Gordon,2,0,70,68
1656317828640,COGS 101A,A01,083621,Davis; Joshua Daniel,5,0,68,63
1656317834666,COGS 101B,A01,091572,Allen; Michael Gordon,4,0,65,61
1656317840688,COGS 101C,A01,083625,Delgado; Tania,11,0,35,24
1656317846712,COGS 107A,A01,083627,Boyle; Mary E. T.,2,0,60,58
1656317852736,COGS 118A,A01,083075,Gupta; Anjum,8,0,76,68
1656317858758,CSE 3,A50,083646,Miranda; Gregory Joseph,18,0,50,32
1656317864783,CSE 8A,A50,083650,Miranda; Gregory Joseph,5,2,56,51
1656317870811,CSE 11,A01,083080,Cao; Yingjun,0,47,40,40
1656317876836,CSE 12,A01,083652,Krause-Levy; Sophia Louisa,5,1,120,115
1656317882864,CSE 15L,A01,083654,Morris; Justin Loren,2,0,50,48
1656317882864,CSE 15L,A02,083655,Morris; Justin Loren,4,0,50,46
1656317888888,CSE 20,A01,083657,Tran; Khoa Dang,31,0,80,49
1656317894914,CSE 21,A01,095574,Bach; Quang Tran,23,0,48,25
1656317900939,CSE 30,A01,083084,Eldon; John,1,4,80,79
1656317900939,CSE 30,B01,095061,Bhaskar; Nishant,0,1,50,50
1656317906962,CSE 100,A01,083659,Cao; Yingjun,1,18,70,69
1656317912989,CSE 134B,A01,083661,Powell; Thomas Allan,6,0,100,94
1656317919017,CSE 140,A01,083663,Gungor; Onat,9,0,85,76
1656317925042,CSE 140L,A01,083088,Eldon; John,10,0,100,90
1656317931066,CSE 175,A01,083665,Kumar; Rakesh,0,0,25,25
1656317937090,CSE 190,A00,092507,Dubnov; Shlomo,4,0,20,16
1656317943114,ECE 45,A01,083139,Congero; Spencer William,1,0,75,74
1656317949144,ECE 65,A50,083695,Saad; Andrew S,10,0,30,20
1656317949144,ECE 65,A51,095125,Staff,25,0,26,1
1656317955169,ECE 109,A01,091882,Touri; Behrouz,0,1,70,70
1656317961203,ECE 180,A00,083140,Abi Samra; Nicholas Camill,2,0,30,28
1656317961203,ECE 180,B00,083141,Abi Samra; Nicholas Camill,0,4,30,30
1656317967228,MATH 10A,A01,083735,Patchell; Gregory David,0,0,30,30
1656317967228,MATH 10A,A02,083736,Patchell; Gregory David,22,0,30,8
1656317967228,MATH 10A,A03,083737,Patchell; Gregory David,16,0,30,14
1656317973253,MATH 10B,A01,083207,Lim; Seonhee,2,0,34,32
1656317973253,MATH 10B,A02,083208,Lim; Seonhee,4,0,35,31
1656317973253,MATH 10B,A03,093472,Staff,1,0,34,33
1656317973253,MATH 10B,B01,083739,Sinha; Shubham,11,0,30,19
1656317979288,MATH 18,A01,083743,Cinel; Cameron Alexander,7,0,30,23
1656317979288,MATH 18,A02,083744,Cinel; Cameron Alexander,10,0,30,20
1656317979288,MATH 18,A03,083745,Cinel; Cameron Alexander,5,0,30,25
1656317979288,MATH 18,B01,083748,Rideout; David Porter,0,0,36,36
1656317979288,MATH 18,B02,083749,Rideout; David Porter,0,0,36,36
1656317979288,MATH 18,B03,083750,Rideout; David Porter,0,0,36,36
1656317979288,MATH 18,B04,083751,Rideout; David Porter,0,1,36,36
1656317979288,MATH 18,B05,093473,Rideout; David Porter,0,0,36,36
1656317979288,MATH 18,B06,093474,Rideout; David Porter,2,0,36,34
1656317985321,MATH 20A,A01,083754,Zheng; Zequn,11,0,40,29
1656317991346,MATH 20B,A01,083756,Briones; Jor-el Thomas Caparas,0,0,36,36
1656317991346,MATH 20B,A02,083757,Briones; Jor-el Thomas Caparas,0,0,36,36
1656317991346,MATH 20B,A03,093475,Staff,1,0,36,35
1656317997370,MATH 20C,A01,083760,Briones; Jor-el Thomas Caparas,0,0,35,35
1656317997370,MATH 20C,A02,083761,Briones; Jor-el Thomas Caparas,9,1,35,26
1656317997370,MATH 20C,A03,093476,Staff,0,0,35,35
1656317997370,MATH 20C,B01,083762,Bach; Quang Tran,2,0,30,28
1656318003404,MATH 20D,A01,083765,Tran; Brian Kha,1,0,30,29
1656318003404,MATH 20D,A02,083766,Tran; Brian Kha,0,0,30,30
1656318003404,MATH 20D,A03,083767,Tran; Brian Kha,2,0,30,28
1656318009815,MATH 20E,A01,083771,Ganguly; Soumya,1,0,32,31
1656318009815,MATH 20E,A02,083772,Ganguly; Soumya,0,0,32,32
1656318009815,MATH 20E,B01,083773,Ciotti; Benjamin,18,0,35,17
1656318009815,MATH 20E,B02,083774,Ciotti; Benjamin,16,0,35,19
1656318017025,MATH 103A,A01,083777,Greenfeld; Be'Eri,2,0,36,34
1656318017025,MATH 103A,A02,083778,Greenfeld; Be'Eri,4,0,36,32
1656318017025,MATH 103A,A03,093561,Staff,3,0,36,33
1656318017025,MATH 103A,B01,083779,Greenfeld; Be'Eri,7,0,36,29
1656318017025,MATH 103A,B02,083780,Greenfeld; Be'Eri,0,0,36,36
1656318017025,MATH 103A,B03,093562,Staff,1,0,36,35
1656318023155,MATH 105,A01,085443,Carter; Anne Toulson,3,0,35,32
1656318023155,MATH 105,A02,093477,Staff,15,0,35,20
1656318029181,MATH 109,A01,083213,Ganzberger; Geoffrey Michael,1,0,34,33
1656318029181,MATH 109,A02,083214,Ganzberger; Geoffrey Michael,0,0,34,34
1656318029181,MATH 109,A03,093478,Staff,2,0,34,32
1656318029181,MATH 109,B01,083215,Ganzberger; Geoffrey Michael,2,0,32,30
1656318029181,MATH 109,B02,083216,Ganzberger; Geoffrey Michael,0,0,32,32
1656318029181,MATH 109,B03,093479,Staff,4,0,32,28
1656318035208,MATH 142A,A01,083219,Chow; Bennett,1,0,32,31
1656318035208,MATH 142A,A02,083220,Chow; Bennett,8,0,32,24
1656318035208,MATH 142A,A03,093480,Staff,4,0,32,28
1656318035208,MATH 142A,B03,093481,Staff,3,0,32,29
1656318035208,MATH 142A,B04,093558,Staff,7,0,32,25
1656318035208,MATH 142A,B05,093559,Staff,1,0,32,31
1656318041242,MATH 193A,A01,083224,Rotar; Vladimir,0,1,34,34
1656318041242,MATH 193A,A02,083225,Rotar; Vladimir,0,0,34,34
1656318041242,MATH 193A,A03,083781,Rotar; Vladimir,0,0,34,34
1656318041242,MATH 193A,A04,083782,Rotar; Vladimir,5,0,34,29
1656318041242,MATH 193A,A05,093482,Rotar; Vladimir,0,0,34,34
1656318047354,MATH 197,001,091859,McAuley; Julian John,9999,0,9999,0
1656318047354,MATH 197,002,095566,Kedlaya; Kiran S.,9997,0,9999,2
1656318047354,MATH 197,003,095567,Xiao; Ming,9999,0,9999,0
1656318047354,MATH 197,004,095571,Perols; Johan Lars,9998,0,9999,1
1656318054445,COGS 9,A01,083615,Shannon; Kyle Michael,3,0,75,72
1656318060473,COGS 11,A01,083617,Boyle; Mary E. T.,17,0,48,31
1656318066508,COGS 13,A01,083071,Bastos; Amalia Pinkusfeld,5,0,71,66
1656318072536,COGS 14A,A01,092681,Semenuks; Arturs,0,8,100,103
1656318078558,COGS 14B,A01,083073,Cheng; Tzu-Han,7,0,63,56
1656318084597,COGS 17,A01,092677,Semenuks; Arturs,6,0,81,75
1656318090622,COGS 100,A01,083619,Allen; Michael Gordon,2,0,70,68
1656318096655,COGS 101A,A01,083621,Davis; Joshua Daniel,5,0,68,63
1656318102689,COGS 101B,A01,091572,Allen; Michael Gordon,4,0,65,61
1656318108723,COGS 101C,A01,083625,Delgado; Tania,11,0,35,24
1656318114762,COGS 107A,A01,083627,Boyle; Mary E. T.,2,0,60,58
1656318120813,COGS 118A,A01,083075,Gupta; Anjum,8,0,76,68
1656318126858,CSE 3,A50,083646,Miranda; Gregory Joseph,18,0,50,32
1656318132896,CSE 8A,A50,083650,Miranda; Gregory Joseph,5,2,56,51
1656318138939,CSE 11,A01,083080,Cao; Yingjun,0,47,40,40
1656318144999,CSE 12,A01,083652,Krause-Levy; Sophia Louisa,5,1,120,115
1656318151032,CSE 15L,A01,083654,Morris; Justin Loren,2,0,50,48
1656318151032,CSE 15L,A02,083655,Morris; Justin Loren,4,0,50,46
1656318157057,CSE 20,A01,083657,Tran; Khoa Dang,31,0,80,49
1656318163092,CSE 21,A01,095574,Bach; Quang Tran,23,0,48,25
1656318169136,CSE 30,A01,083084,Eldon; John,1,4,80,79
1656318169136,CSE 30,B01,095061,Bhaskar; Nishant,0,1,50,50
1656318175162,CSE 100,A01,083659,Cao; Yingjun,1,18,70,69
1656318181186,CSE 134B,A01,083661,Powell; Thomas Allan,6,0,100,94
1656318187223,CSE 140,A01,083663,Gungor; Onat,9,0,85,76
1656318193258,CSE 140L,A01,083088,Eldon; John,10,0,100,90
1656318199283,CSE 175,A01,083665,Kumar; Rakesh,0,0,25,25
1656318205346,CSE 190,A00,092507,Dubnov; Shlomo,4,0,20,16
1656318211375,ECE 45,A01,083139,Congero; Spencer William,1,0,75,74
1656318217412,ECE 65,A50,083695,Saad; Andrew S,10,0,30,20
1656318217412,ECE 65,A51,095125,Staff,25,0,26,1
1656318223439,ECE 109,A01,091882,Touri; Behrouz,0,1,70,70
1656318229464,ECE 180,A00,083140,Abi Samra; Nicholas Camill,2,0,30,28
1656318229464,ECE 180,B00,083141,Abi Samra; Nicholas Camill,0,4,30,30
1656318235489,MATH 10A,A01,083735,Patchell; Gregory David,0,0,30,30
1656318235489,MATH 10A,A02,083736,Patchell; Gregory David,22,0,30,8
1656318235489,MATH 10A,A03,083737,Patchell; Gregory David,16,0,30,14
1656318241531,MATH 10B,A01,083207,Lim; Seonhee,2,0,34,32
1656318241531,MATH 10B,A02,083208,Lim; Seonhee,4,0,35,31
1656318241531,MATH 10B,A03,093472,Staff,1,0,34,33
1656318241531,MATH 10B,B01,083739,Sinha; Shubham,11,0,30,19
1656318247629,MATH 18,A01,083743,Cinel; Cameron Alexander,7,0,30,23
1656318247629,MATH 18,A02,083744,Cinel; Cameron Alexander,10,0,30,20
1656318247629,MATH 18,A03,083745,Cinel; Cameron Alexander,5,0,30,25
1656318247629,MATH 18,B01,083748,Rideout; David Porter,0,0,36,36
1656318247629,MATH 18,B02,083749,Rideout; David Porter,0,0,36,36
1656318247629,MATH 18,B03,083750,Rideout; David Porter,0,0,36,36
1656318247629,MATH 18,B04,083751,Rideout; David Porter,0,1,36,36
1656318247629,MATH 18,B05,093473,Rideout; David Porter,0,0,36,36
1656318247629,MATH 18,B06,093474,Rideout; David Porter,2,0,36,34
1656318253664,MATH 20A,A01,083754,Zheng; Zequn,11,0,40,29
1656318259721,MATH 20B,A01,083756,Briones; Jor-el Thomas Caparas,0,0,36,36
1656318259721,MATH 20B,A02,083757,Briones; Jor-el Thomas Caparas,0,0,36,36
1656318259721,MATH 20B,A03,093475,Staff,1,0,36,35
1656318265755,MATH 20C,A01,083760,Briones; Jor-el Thomas Caparas,0,0,35,35
1656318265755,MATH 20C,A02,083761,Briones; Jor-el Thomas Caparas,9,1,35,26
1656318265755,MATH 20C,A03,093476,Staff,0,0,35,35
1656318265755,MATH 20C,B01,083762,Bach; Quang Tran,2,0,30,28
1656318271783,MATH 20D,A01,083765,Tran; Brian Kha,1,0,30,29
1656318271783,MATH 20D,A02,083766,Tran; Brian Kha,0,0,30,30
1656318271783,MATH 20D,A03,083767,Tran; Brian Kha,2,0,30,28
1656318286383,MATH 20E,A01,083771,Ganguly; Soumya,1,0,32,31
1656318286383,MATH 20E,A02,083772,Ganguly; Soumya,0,0,32,32
1656318286383,MATH 20E,B01,083773,Ciotti; Benjamin,18,0,35,17
1656318286383,MATH 20E,B02,083774,Ciotti; Benjamin,16,0,35,19
1656318292411,MATH 103A,A01,083777,Greenfeld; Be'Eri,2,0,36,34
1656318292411,MATH 103A,A02,083778,Greenfeld; Be'Eri,4,0,36,32
1656318292411,MATH 103A,A03,093561,Staff,3,0,36,33
1656318292411,MATH 103A,B01,083779,Greenfeld; Be'Eri,7,0,36,29
1656318292411,MATH 103A,B02,083780,Greenfeld; Be'Eri,0,0,36,36
1656318292411,MATH 103A,B03,093562,Staff,1,0,36,35
1656318298502,MATH 105,A01,085443,Carter; Anne Toulson,3,0,35,32
1656318298502,MATH 105,A02,093477,Staff,15,0,35,20
1656318304527,MATH 109,A01,083213,Ganzberger; Geoffrey Michael,1,0,34,33
1656318304527,MATH 109,A02,083214,Ganzberger; Geoffrey Michael,0,0,34,34
1656318304527,MATH 109,A03,093478,Staff,2,0,34,32
1656318304527,MATH 109,B01,083215,Ganzberger; Geoffrey Michael,2,0,32,30
1656318304527,MATH 109,B02,083216,Ganzberger; Geoffrey Michael,0,0,32,32
1656318304527,MATH 109,B03,093479,Staff,4,0,32,28
1656318310563,MATH 142A,A01,083219,Chow; Bennett,1,0,32,31
1656318310563,MATH 142A,A02,083220,Chow; Bennett,8,0,32,24
1656318310563,MATH 142A,A03,093480,Staff,4,0,32,28
1656318310563,MATH 142A,B03,093481,Staff,3,0,32,29
1656318310563,MATH 142A,B04,093558,Staff,7,0,32,25
1656318310563,MATH 142A,B05,093559,Staff,1,0,32,31
1656318316596,MATH 193A,A01,083224,Rotar; Vladimir,0,1,34,34
1656318316596,MATH 193A,A02,083225,Rotar; Vladimir,0,0,34,34
1656318316596,MATH 193A,A03,083781,Rotar; Vladimir,0,0,34,34
1656318316596,MATH 193A,A04,083782,Rotar; Vladimir,5,0,34,29
1656318316596,MATH 193A,A05,093482,Rotar; Vladimir,0,0,34,34
1656318322626,MATH 197,001,091859,McAuley; Julian John,9999,0,9999,0
1656318322626,MATH 197,002,095566,Kedlaya; Kiran S.,9997,0,9999,2
1656318322626,MATH 197,003,095567,Xiao; Ming,9999,0,9999,0
1656318322626,MATH 197,004,095571,Perols; Johan Lars,9998,0,9999,1
1656318329718,COGS 9,A01,083615,Shannon; Kyle Michael,3,0,75,72
1656318335758,COGS 11,A01,083617,Boyle; Mary E. T.,17,0,48,31
1656318341798,COGS 13,A01,083071,Bastos; Amalia Pinkusfeld,5,0,71,66
1656318347832,COGS 14A,A01,092681,Semenuks; Arturs,0,8,100,103
1656318353858,COGS 14B,A01,083073,Cheng; Tzu-Han,7,0,63,56
1656318359884,COGS 17,A01,092677,Semenuks; Arturs,6,0,81,75
1656318365923,COGS 100,A01,083619,Allen; Michael Gordon,2,0,70,68
1656318371958,COGS 101A,A01,083621,Davis; Joshua Daniel,5,0,68,63
1656318377983,COGS 101B,A01,091572,Allen; Michael Gordon,4,0,65,61
1656318384015,COGS 101C,A01,083625,Delgado; Tania,11,0,35,24
1656318390046,COGS 107A,A01,083627,Boyle; Mary E. T.,2,0,60,58
1656318396071,COGS 118A,A01,083075,Gupta; Anjum,8,0,76,68
1656318402097,CSE 3,A50,083646,Miranda; Gregory Joseph,18,0,50,32
1656318408127,CSE 8A,A50,083650,Miranda; Gregory Joseph,5,2,56,51
1656318414157,CSE 11,A01,083080,Cao; Yingjun,0,47,40,40
1656318420188,CSE 12,A01,083652,Krause-Levy; Sophia Louisa,5,1,120,115
1656318426212,CSE 15L,A01,083654,Morris; Justin Loren,2,0,50,48
1656318426212,CSE 15L,A02,083655,Morris; Justin Loren,4,0,50,46
1656318432237,CSE 20,A01,083657,Tran; Khoa Dang,31,0,80,49
1656318438266,CSE 21,A01,095574,Bach; Quang Tran,23,0,48,25
1656318444307,CSE 30,A01,083084,Eldon; John,1,4,80,79
1656318444307,CSE 30,B01,095061,Bhaskar; Nishant,0,1,50,50
1656318450340,CSE 100,A01,083659,Cao; Yingjun,1,18,70,69
1656318456371,CSE 134B,A01,083661,Powell; Thomas Allan,6,0,100,94
1656318462401,CSE 140,A01,083663,Gungor; Onat,9,0,85,76
1656318468437,CSE 140L,A01,083088,Eldon; John,10,0,100,90
1656318474469,CSE 175,A01,083665,Kumar; Rakesh,0,0,25,25
1656318480502,CSE 190,A00,092507,Dubnov; Shlomo,4,0,20,16
1656318486537,ECE 45,A01,083139,Congero; Spencer William,1,0,75,74
1656318492564,ECE 65,A50,083695,Saad; Andrew S,10,0,30,20
1656318492564,ECE 65,A51,095125,Staff,25,0,26,1
1656318498589,ECE 109,A01,091882,Touri; Behrouz,0,1,70,70
1656318504619,ECE 180,A00,083140,Abi Samra; Nicholas Camill,2,0,30,28
1656318504619,ECE 180,B00,083141,Abi Samra; Nicholas Camill,0,4,30,30
1656318510646,MATH 10A,A01,083735,Patchell; Gregory David,0,0,30,30
1656318510646,MATH 10A,A02,083736,Patchell; Gregory David,22,0,30,8
1656318510646,MATH 10A,A03,083737,Patchell; Gregory David,16,0,30,14
1656318516675,MATH 10B,A01,083207,Lim; Seonhee,2,0,34,32
1656318516675,MATH 10B,A02,083208,Lim; Seonhee,4,0,35,31
1656318516675,MATH 10B,A03,093472,Staff,1,0,34,33
1656318516675,MATH 10B,B01,083739,Sinha; Shubham,11,0,30,19
1656318522723,MATH 18,A01,083743,Cinel; Cameron Alexander,7,0,30,23
1656318522723,MATH 18,A02,083744,Cinel; Cameron Alexander,10,0,30,20
1656318522723,MATH 18,A03,083745,Cinel; Cameron Alexander,5,0,30,25
1656318522723,MATH 18,B01,083748,Rideout; David Porter,0,0,36,36
1656318522723,MATH 18,B02,083749,Rideout; David Porter,0,0,36,36
1656318522723,MATH 18,B03,083750,Rideout; David Porter,0,0,36,36
1656318522723,MATH 18,B04,083751,Rideout; David Porter,0,1,36,36
1656318522723,MATH 18,B05,093473,Rideout; David Porter,0,0,36,36
1656318522723,MATH 18,B06,093474,Rideout; David Porter,2,0,36,34
1656318528746,MATH 20A,A01,083754,Zheng; Zequn,11,0,40,29
1656318534781,MATH 20B,A01,083756,Briones; Jor-el Thomas Caparas,0,0,36,36
1656318534781,MATH 20B,A02,083757,Briones; Jor-el Thomas Caparas,0,0,36,36
1656318534781,MATH 20B,A03,093475,Staff,1,0,36,35
1656318540814,MATH 20C,A01,083760,Briones; Jor-el Thomas Caparas,0,0,35,35
1656318540814,MATH 20C,A02,083761,Briones; Jor-el Thomas Caparas,9,1,35,26
1656318540814,MATH 20C,A03,093476,Staff,0,0,35,35
1656318540814,MATH 20C,B01,083762,Bach; Quang Tran,2,0,30,28
1656318546848,MATH 20D,A01,083765,Tran; Brian Kha,1,0,30,29
1656318546848,MATH 20D,A02,083766,Tran; Brian Kha,0,0,30,30
1656318546848,MATH 20D,A03,083767,Tran; Brian Kha,2,0,30,28
1656318552876,MATH 20E,A01,083771,Ganguly; Soumya,1,0,32,31
1656318552876,MATH 20E,A02,083772,Ganguly; Soumya,0,0,32,32
1656318552876,MATH 20E,B01,083773,Ciotti; Benjamin,18,0,35,17
1656318552876,MATH 20E,B02,083774,Ciotti; Benjamin,16,0,35,19
1656318558905,MATH 103A,A01,083777,Greenfeld; Be'Eri,2,0,36,34
1656318558905,MATH 103A,A02,083778,Greenfeld; Be'Eri,4,0,36,32
1656318558905,MATH 103A,A03,093561,Staff,3,0,36,33
1656318558905,MATH 103A,B01,083779,Greenfeld; Be'Eri,7,0,36,29
1656318558905,MATH 103A,B02,083780,Greenfeld; Be'Eri,0,0,36,36
1656318558905,MATH 103A,B03,093562,Staff,1,0,36,35
1656318564931,MATH 105,A01,085443,Carter; Anne Toulson,3,0,35,32
1656318564931,MATH 105,A02,093477,Staff,15,0,35,20
1656318570963,MATH 109,A01,083213,Ganzberger; Geoffrey Michael,1,0,34,33
1656318570963,MATH 109,A02,083214,Ganzberger; Geoffrey Michael,0,0,34,34
1656318570963,MATH 109,A03,093478,Staff,2,0,34,32
1656318570963,MATH 109,B01,083215,Ganzberger; Geoffrey Michael,2,0,32,30
1656318570963,MATH 109,B02,083216,Ganzberger; Geoffrey Michael,0,0,32,32
1656318570963,MATH 109,B03,093479,Staff,4,0,32,28
1656318577000,MATH 142A,A01,083219,Chow; Bennett,1,0,32,31
1656318577000,MATH 142A,A02,083220,Chow; Bennett,8,0,32,24
1656318577000,MATH 142A,A03,093480,Staff,4,0,32,28
1656318577000,MATH 142A,B03,093481,Staff,3,0,32,29
1656318577000,MATH 142A,B04,093558,Staff,7,0,32,25
1656318577000,MATH 142A,B05,093559,Staff,1,0,32,31
1656318583040,MATH 193A,A01,083224,Rotar; Vladimir,0,1,34,34
1656318583040,MATH 193A,A02,083225,Rotar; Vladimir,0,0,34,34
1656318583040,MATH 193A,A03,083781,Rotar; Vladimir,0,0,34,34
1656318583040,MATH 193A,A04,083782,Rotar; Vladimir,5,0,34,29
1656318583040,MATH 193A,A05,093482,Rotar; Vladimir,0,0,34,34
1656318589067,MATH 197,001,091859,McAuley; Julian John,9999,0,9999,0
1656318589067,MATH 197,002,095566,Kedlaya; Kiran S.,9997,0,9999,2
1656318589067,MATH 197,003,095567,Xiao; Ming,9999,0,9999,0
1656318589067,MATH 197,004,095571,Perols; Johan Lars,9998,0,9999,1
1656318596149,COGS 9,A01,083615,Shannon; Kyle Michael,3,0,75,72
1656318602178,COGS 11,A01,083617,Boyle; Mary E. T.,17,0,48,31
1656318608205,COGS 13,A01,083071,Bastos; Amalia Pinkusfeld,5,0,71,66
1656318614230,COGS 14A,A01,092681,Semenuks; Arturs,0,8,100,103
1656318620255,COGS 14B,A01,083073,Cheng; Tzu-Han,7,0,63,56
1656318626283,COGS 17,A01,092677,Semenuks; Arturs,6,0,81,75
1656318632308,COGS 100,A01,083619,Allen; Michael Gordon,2,0,70,68
1656318638333,COGS 101A,A01,083621,Davis; Joshua Daniel,5,0,68,63
1656318644363,COGS 101B,A01,091572,Allen; Michael Gordon,4,0,65,61
1656318650461,COGS 101C,A01,083625,Delgado; Tania,11,0,35,24
1656318656487,COGS 107A,A01,083627,Boyle; Mary E. T.,2,0,60,58
1656318662527,COGS 118A,A01,083075,Gupta; Anjum,8,0,76,68
1656318668554,CSE 3,A50,083646,Miranda; Gregory Joseph,18,0,50,32
1656318674584,CSE 8A,A50,083650,Miranda; Gregory Joseph,5,2,56,51
1656318680613,CSE 11,A01,083080,Cao; Yingjun,0,47,40,40
1656318686642,CSE 12,A01,083652,Krause-Levy; Sophia Louisa,5,1,120,115
1656318692668,CSE 15L,A01,083654,Morris; Justin Loren,2,0,50,48
1656318692668,CSE 15L,A02,083655,Morris; Justin Loren,4,0,50,46
1656318698700,CSE 20,A01,083657,Tran; Khoa Dang,31,0,80,49
1656318704726,CSE 21,A01,095574,Bach; Quang Tran,23,0,48,25
1656318710761,CSE 30,A01,083084,Eldon; John,1,4,80,79
1656318710761,CSE 30,B01,095061,Bhaskar; Nishant,0,1,50,50
1656318716787,CSE 100,A01,083659,Cao; Yingjun,1,18,70,69
1656318722818,CSE 134B,A01,083661,Powell; Thomas Allan,6,0,100,94
1656318728843,CSE 140,A01,083663,Gungor; Onat,9,0,85,76
1656318734868,CSE 140L,A01,083088,Eldon; John,10,0,100,90
1656318740893,CSE 175,A01,083665,Kumar; Rakesh,0,0,25,25
1656318746924,CSE 190,A00,092507,Dubnov; Shlomo,4,0,20,16
1656318752951,ECE 45,A01,083139,Congero; Spencer William,1,0,75,74
1656318758991,ECE 65,A50,083695,Saad; Andrew S,10,0,30,20
1656318758991,ECE 65,A51,095125,Staff,25,0,26,1
1656318765018,ECE 109,A01,091882,Touri; Behrouz,0,1,70,70
1656318771050,ECE 180,A00,083140,Abi Samra; Nicholas Camill,2,0,30,28
1656318771050,ECE 180,B00,083141,Abi Samra; Nicholas Camill,0,4,30,30
1656318777081,MATH 10A,A01,083735,Patchell; Gregory David,0,0,30,30
1656318777081,MATH 10A,A02,083736,Patchell; Gregory David,22,0,30,8
1656318777081,MATH 10A,A03,083737,Patchell; Gregory David,16,0,30,14
1656318783121,MATH 10B,A01,083207,Lim; Seonhee,2,0,34,32
1656318783121,MATH 10B,A02,083208,Lim; Seonhee,4,0,35,31
1656318783121,MATH 10B,A03,093472,Staff,1,0,34,33
1656318783121,MATH 10B,B01,083739,Sinha; Shubham,11,0,30,19
1656318789163,MATH 18,A01,083743,Cinel; Cameron Alexander,7,0,30,23
1656318789163,MATH 18,A02,083744,Cinel; Cameron Alexander,10,0,30,20
1656318789163,MATH 18,A03,083745,Cinel; Cameron Alexander,5,0,30,25
1656318789163,MATH 18,B01,083748,Rideout; David Porter,0,0,36,36
1656318789163,MATH 18,B02,083749,Rideout; David Porter,0,0,36,36
1656318789163,MATH 18,B03,083750,Rideout; David Porter,0,0,36,36
1656318789163,MATH 18,B04,083751,Rideout; David Porter,0,1,36,36
1656318789163,MATH 18,B05,093473,Rideout; David Porter,0,0,36,36
1656318789163,MATH 18,B06,093474,Rideout; David Porter,2,0,36,34
1656318795203,MATH 20A,A01,083754,Zheng; Zequn,11,0,40,29
1656318801230,MATH 20B,A01,083756,Briones; Jor-el Thomas Caparas,0,0,36,36
1656318801230,MATH 20B,A02,083757,Briones; Jor-el Thomas Caparas,0,0,36,36
1656318801230,MATH 20B,A03,093475,Staff,1,0,36,35
1656318807259,MATH 20C,A01,083760,Briones; Jor-el Thomas Caparas,0,0,35,35
1656318807259,MATH 20C,A02,083761,Briones; Jor-el Thomas Caparas,9,1,35,26
1656318807259,MATH 20C,A03,093476,Staff,0,0,35,35
1656318807259,MATH 20C,B01,083762,Bach; Quang Tran,2,0,30,28
1656318813290,MATH 20D,A01,083765,Tran; Brian Kha,1,0,30,29
1656318813290,MATH 20D,A02,083766,Tran; Brian Kha,0,0,30,30
1656318813290,MATH 20D,A03,083767,Tran; Brian Kha,2,0,30,28
1656318819315,MATH 20E,A01,083771,Ganguly; Soumya,1,0,32,31
1656318819315,MATH 20E,A02,083772,Ganguly; Soumya,0,0,32,32
1656318819315,MATH 20E,B01,083773,Ciotti; Benjamin,18,0,35,17
1656318819315,MATH 20E,B02,083774,Ciotti; Benjamin,16,0,35,19
1656318825344,MATH 103A,A01,083777,Greenfeld; Be'Eri,2,0,36,34
1656318825344,MATH 103A,A02,083778,Greenfeld; Be'Eri,4,0,36,32
1656318825344,MATH 103A,A03,093561,Staff,3,0,36,33
1656318825344,MATH 103A,B01,083779,Greenfeld; Be'Eri,7,0,36,29
1656318825344,MATH 103A,B02,083780,Greenfeld; Be'Eri,0,0,36,36
1656318825344,MATH 103A,B03,093562,Staff,1,0,36,35
1656318831376,MATH 105,A01,085443,Carter; Anne Toulson,3,0,35,32
1656318831376,MATH 105,A02,093477,Staff,15,0,35,20
1656318837414,MATH 109,A01,083213,Ganzberger; Geoffrey Michael,1,0,34,33
1656318837414,MATH 109,A02,083214,Ganzberger; Geoffrey Michael,0,0,34,34
1656318837414,MATH 109,A03,093478,Staff,2,0,34,32
1656318837414,MATH 109,B01,083215,Ganzberger; Geoffrey Michael,2,0,32,30
1656318837414,MATH 109,B02,083216,Ganzberger; Geoffrey Michael,0,0,32,32
1656318837414,MATH 109,B03,093479,Staff,4,0,32,28
1656318843447,MATH 142A,A01,083219,Chow; Bennett,1,0,32,31
1656318843447,MATH 142A,A02,083220,Chow; Bennett,8,0,32,24
1656318843447,MATH 142A,A03,093480,Staff,4,0,32,28
1656318843447,MATH 142A,B03,093481,Staff,3,0,32,29
1656318843447,MATH 142A,B04,093558,Staff,7,0,32,25
1656318843447,MATH 142A,B05,093559,Staff,1,0,32,31
1656318849476,MATH 193A,A01,083224,Rotar; Vladimir,0,1,34,34
1656318849476,MATH 193A,A02,083225,Rotar; Vladimir,0,0,34,34
1656318849476,MATH 193A,A03,083781,Rotar; Vladimir,0,0,34,34
1656318849476,MATH 193A,A04,083782,Rotar; Vladimir,5,0,34,29
1656318849476,MATH 193A,A05,093482,Rotar; Vladimir,0,0,34,34
1656318855502,MATH 197,001,091859,McAuley; Julian John,9999,0,9999,0
1656318855502,MATH 197,002,095566,Kedlaya; Kiran S.,9997,0,9999,2
1656318855502,MATH 197,003,095567,Xiao; Ming,9999,0,9999,0
1656318855502,MATH 197,004,095571,Perols; Johan Lars,9998,0,9999,1
1656318862571,COGS 9,A01,083615,Shannon; Kyle Michael,3,0,75,72
1656318868598,COGS 11,A01,083617,Boyle; Mary E. T.,17,0,48,31
1656318874623,COGS 13,A01,083071,Bastos; Amalia Pinkusfeld,5,0,71,66
1656318880649,COGS 14A,A01,092681,Semenuks; Arturs,0,8,100,103
1656318886680,COGS 14B,A01,083073,Cheng; Tzu-Han,7,0,63,56
1656318892709,COGS 17,A01,092677,Semenuks; Arturs,6,0,81,75
1656318898735,COGS 100,A01,083619,Allen; Michael Gordon,2,0,70,68
1656318904767,COGS 101A,A01,083621,Davis; Joshua Daniel,5,0,68,63
1656318910796,COGS 101B,A01,091572,Allen; Michael Gordon,4,0,65,61
1656318916835,COGS 101C,A01,083625,Delgado; Tania,11,0,35,24
1656318922868,COGS 107A,A01,083627,Boyle; Mary E. T.,2,0,60,58
1656318928900,COGS 118A,A01,083075,Gupta; Anjum,8,0,76,68
1656318934935,CSE 3,A50,083646,Miranda; Gregory Joseph,18,0,50,32
1656318940963,CSE 8A,A50,083650,Miranda; Gregory Joseph,5,2,56,51
1656318946992,CSE 11,A01,083080,Cao; Yingjun,0,47,40,40
1656318953018,CSE 12,A01,083652,Krause-Levy; Sophia Louisa,5,1,120,115
1656318959046,CSE 15L,A01,083654,Morris; Justin Loren,2,0,50,48
1656318959046,CSE 15L,A02,083655,Morris; Justin Loren,4,0,50,46
1656318965070,CSE 20,A01,083657,Tran; Khoa Dang,31,0,80,49
1656318971095,CSE 21,A01,095574,Bach; Quang Tran,23,0,48,25
1656318977128,CSE 30,A01,083084,Eldon; John,1,4,80,79
1656318977128,CSE 30,B01,095061,Bhaskar; Nishant,0,1,50,50
1656318983158,CSE 100,A01,083659,Cao; Yingjun,1,18,70,69
1656318989188,CSE 134B,A01,083661,Powell; Thomas Allan,6,0,100,94
1656318995214,CSE 140,A01,083663,Gungor; Onat,9,0,85,76
1656319001241,CSE 140L,A01,083088,Eldon; John,10,0,100,90
1656319007264,CSE 175,A01,083665,Kumar; Rakesh,0,0,25,25
1656319013294,CSE 190,A00,092507,Dubnov; Shlomo,4,0,20,16
1656319019320,ECE 45,A01,083139,Congero; Spencer William,1,0,75,74
1656319025350,ECE 65,A50,083695,Saad; Andrew S,10,0,30,20
1656319025350,ECE 65,A51,095125,Staff,25,0,26,1
1656319031385,ECE 109,A01,091882,Touri; Behrouz,0,1,70,70
1656319037410,ECE 180,A00,083140,Abi Samra; Nicholas Camill,2,0,30,28
1656319037410,ECE 180,B00,083141,Abi Samra; Nicholas Camill,0,4,30,30
1656319043441,MATH 10A,A01,083735,Patchell; Gregory David,0,0,30,30
1656319043441,MATH 10A,A02,083736,Patchell; Gregory David,22,0,30,8
1656319043441,MATH 10A,A03,083737,Patchell; Gregory David,16,0,30,14
1656319049485,MATH 10B,A01,083207,Lim; Seonhee,2,0,34,32
1656319049485,MATH 10B,A02,083208,Lim; Seonhee,4,0,35,31
1656319049485,MATH 10B,A03,093472,Staff,1,0,34,33
1656319049485,MATH 10B,B01,083739,Sinha; Shubham,11,0,30,19
1656319055522,MATH 18,A01,083743,Cinel; Cameron Alexander,7,0,30,23
1656319055522,MATH 18,A02,083744,Cinel; Cameron Alexander,10,0,30,20
1656319055522,MATH 18,A03,083745,Cinel; Cameron Alexander,5,0,30,25
1656319055522,MATH 18,B01,083748,Rideout; David Porter,0,0,36,36
1656319055522,MATH 18,B02,083749,Rideout; David Porter,0,0,36,36
1656319055522,MATH 18,B03,083750,Rideout; David Porter,0,0,36,36
1656319055522,MATH 18,B04,083751,Rideout; David Porter,0,1,36,36
1656319055522,MATH 18,B05,093473,Rideout; David Porter,0,0,36,36
1656319055522,MATH 18,B06,093474,Rideout; David Porter,2,0,36,34
1656319061554,MATH 20A,A01,083754,Zheng; Zequn,11,0,40,29
1656319067582,MATH 20B,A01,083756,Briones; Jor-el Thomas Caparas,0,0,36,36
1656319067582,MATH 20B,A02,083757,Briones; Jor-el Thomas Caparas,0,0,36,36
1656319067582,MATH 20B,A03,093475,Staff,1,0,36,35
1656319073614,MATH 20C,A01,083760,Briones; Jor-el Thomas Caparas,0,0,35,35
1656319073614,MATH 20C,A02,083761,Briones; Jor-el Thomas Caparas,9,1,35,26
1656319073614,MATH 20C,A03,093476,Staff,0,0,35,35
1656319073614,MATH 20C,B01,083762,Bach; Quang Tran,2,0,30,28
1656319079648,MATH 20D,A01,083765,Tran; Brian Kha,1,0,30,29
1656319079648,MATH 20D,A02,083766,Tran; Brian Kha,0,0,30,30
1656319079648,MATH 20D,A03,083767,Tran; Brian Kha,2,0,30,28
1656319085674,MATH 20E,A01,083771,Ganguly; Soumya,1,0,32,31
1656319085674,MATH 20E,A02,083772,Ganguly; Soumya,0,0,32,32
1656319085674,MATH 20E,B01,083773,Ciotti; Benjamin,18,0,35,17
1656319085674,MATH 20E,B02,083774,Ciotti; Benjamin,16,0,35,19
1656319091700,MATH 103A,A01,083777,Greenfeld; Be'Eri,2,0,36,34
1656319091700,MATH 103A,A02,083778,Greenfeld; Be'Eri,4,0,36,32
1656319091700,MATH 103A,A03,093561,Staff,3,0,36,33
1656319091700,MATH 103A,B01,083779,Greenfeld; Be'Eri,7,0,36,29
1656319091700,MATH 103A,B02,083780,Greenfeld; Be'Eri,0,0,36,36
1656319091700,MATH 103A,B03,093562,Staff,1,0,36,35
1656319097727,MATH 105,A01,085443,Carter; Anne Toulson,3,0,35,32
1656319097727,MATH 105,A02,093477,Staff,15,0,35,20
1656319103753,MATH 109,A01,083213,Ganzberger; Geoffrey Michael,1,0,34,33
1656319103753,MATH 109,A02,083214,Ganzberger; Geoffrey Michael,0,0,34,34
1656319103753,MATH 109,A03,093478,Staff,2,0,34,32
1656319103753,MATH 109,B01,083215,Ganzberger; Geoffrey Michael,2,0,32,30
1656319103753,MATH 109,B02,083216,Ganzberger; Geoffrey Michael,0,0,32,32
1656319103753,MATH 109,B03,093479,Staff,4,0,32,28
1656319109786,MATH 142A,A01,083219,Chow; Bennett,1,0,32,31
1656319109786,MATH 142A,A02,083220,Chow; Bennett,8,0,32,24
1656319109786,MATH 142A,A03,093480,Staff,4,0,32,28
1656319109786,MATH 142A,B03,093481,Staff,3,0,32,29
1656319109786,MATH 142A,B04,093558,Staff,7,0,32,25
1656319109786,MATH 142A,B05,093559,Staff,1,0,32,31
1656319115821,MATH 193A,A01,083224,Rotar; Vladimir,0,1,34,34
1656319115821,MATH 193A,A02,083225,Rotar; Vladimir,0,0,34,34
1656319115821,MATH 193A,A03,083781,Rotar; Vladimir,0,0,34,34
1656319115821,MATH 193A,A04,083782,Rotar; Vladimir,5,0,34,29
1656319115821,MATH 193A,A05,093482,Rotar; Vladimir,0,0,34,34
1656319121851,MATH 197,001,091859,McAuley; Julian John,9999,0,9999,0
1656319121851,MATH 197,002,095566,Kedlaya; Kiran S.,9997,0,9999,2
1656319121851,MATH 197,003,095567,Xiao; Ming,9999,0,9999,0
1656319121851,MATH 197,004,095571,Perols; Johan Lars,9998,0,9999,1
1656319128944,COGS 9,A01,083615,Shannon; Kyle Michael,3,0,75,72
1656319134969,COGS 11,A01,083617,Boyle; Mary E. T.,17,0,48,31
1656319141000,COGS 13,A01,083071,Bastos; Amalia Pinkusfeld,5,0,71,66
1656319147025,COGS 14A,A01,092681,Semenuks; Arturs,0,8,100,103
1656319153049,COGS 14B,A01,083073,Cheng; Tzu-Han,7,0,63,56
1656319159074,COGS 17,A01,092677,Semenuks; Arturs,6,0,81,75
1656319165103,COGS 100,A01,083619,Allen; Michael Gordon,2,0,70,68
1656319171128,COGS 101A,A01,083621,Davis; Joshua Daniel,5,0,68,63
1656319177153,COGS 101B,A01,091572,Allen; Michael Gordon,4,0,65,61
1656319183183,COGS 101C,A01,083625,Delgado; Tania,11,0,35,24
1656319189210,COGS 107A,A01,083627,Boyle; Mary E. T.,2,0,60,58
1656319195236,COGS 118A,A01,083075,Gupta; Anjum,8,0,76,68
1656319201265,CSE 3,A50,083646,Miranda; Gregory Joseph,18,0,50,32
1656319207295,CSE 8A,A50,083650,Miranda; Gregory Joseph,5,2,56,51
1656319213316,CSE 11,A01,083080,Cao; Yingjun,0,47,40,40
1656319219341,CSE 12,A01,083652,Krause-Levy; Sophia Louisa,5,1,120,115
1656319225370,CSE 15L,A01,083654,Morris; Justin Loren,2,0,50,48
1656319225370,CSE 15L,A02,083655,Morris; Justin Loren,4,0,50,46
1656319231402,CSE 20,A01,083657,Tran; Khoa Dang,31,0,80,49
1656319237433,CSE 21,A01,095574,Bach; Quang Tran,23,0,48,25
1656319243473,CSE 30,A01,083084,Eldon; John,1,4,80,79
1656319243473,CSE 30,B01,095061,Bhaskar; Nishant,0,1,50,50
1656319249586,CSE 100,A01,083659,Cao; Yingjun,1,18,70,69
1656319255614,CSE 134B,A01,083661,Powell; Thomas Allan,6,0,100,94
1656319261639,CSE 140,A01,083663,Gungor; Onat,9,0,85,76
1656319267669,CSE 140L,A01,083088,Eldon; John,10,0,100,90
1656319273695,CSE 175,A01,083665,Kumar; Rakesh,0,0,25,25
1656319279720,CSE 190,A00,092507,Dubnov; Shlomo,4,0,20,16
1656319285750,ECE 45,A01,083139,Congero; Spencer William,1,0,75,74
1656319291773,ECE 65,A50,083695,Saad; Andrew S,10,0,30,20
1656319291773,ECE 65,A51,095125,Staff,25,0,26,1
1656319297799,ECE 109,A01,091882,Touri; Behrouz,0,1,70,70
1656319303829,ECE 180,A00,083140,Abi Samra; Nicholas Camill,2,0,30,28
1656319303829,ECE 180,B00,083141,Abi Samra; Nicholas Camill,0,4,30,30
1656319309864,MATH 10A,A01,083735,Patchell; Gregory David,0,0,30,30
1656319309864,MATH 10A,A02,083736,Patchell; Gregory David,22,0,30,8
1656319309864,MATH 10A,A03,083737,Patchell; Gregory David,16,0,30,14
1656319315898,MATH 10B,A01,083207,Lim; Seonhee,2,0,34,32
1656319315898,MATH 10B,A02,083208,Lim; Seonhee,4,0,35,31
1656319315898,MATH 10B,A03,093472,Staff,1,0,34,33
1656319315898,MATH 10B,B01,083739,Sinha; Shubham,11,0,30,19
1656319321936,MATH 18,A01,083743,Cinel; Cameron Alexander,7,0,30,23
1656319321936,MATH 18,A02,083744,Cinel; Cameron Alexander,10,0,30,20
1656319321936,MATH 18,A03,083745,Cinel; Cameron Alexander,5,0,30,25
1656319321936,MATH 18,B01,083748,Rideout; David Porter,0,0,36,36
1656319321936,MATH 18,B02,083749,Rideout; David Porter,0,0,36,36
1656319321936,MATH 18,B03,083750,Rideout; David Porter,0,0,36,36
1656319321936,MATH 18,B04,083751,Rideout; David Porter,0,1,36,36
1656319321936,MATH 18,B05,093473,Rideout; David Porter,0,0,36,36
1656319321936,MATH 18,B06,093474,Rideout; David Porter,2,0,36,34
1656319327972,MATH 20A,A01,083754,Zheng; Zequn,11,0,40,29
1656319333999,MATH 20B,A01,083756,Briones; Jor-el Thomas Caparas,0,0,36,36
1656319333999,MATH 20B,A02,083757,Briones; Jor-el Thomas Caparas,0,0,36,36
1656319333999,MATH 20B,A03,093475,Staff,1,0,36,35
1656319340032,MATH 20C,A01,083760,Briones; Jor-el Thomas Caparas,0,0,35,35
1656319340032,MATH 20C,A02,083761,Briones; Jor-el Thomas Caparas,9,1,35,26
1656319340032,MATH 20C,A03,093476,Staff,0,0,35,35
1656319340032,MATH 20C,B01,083762,Bach; Quang Tran,2,0,30,28
1656319346058,MATH 20D,A01,083765,Tran; Brian Kha,1,0,30,29
1656319346058,MATH 20D,A02,083766,Tran; Brian Kha,0,0,30,30
1656319346058,MATH 20D,A03,083767,Tran; Brian Kha,2,0,30,28
1656319352099,MATH 20E,A01,083771,Ganguly; Soumya,1,0,32,31
1656319352099,MATH 20E,A02,083772,Ganguly; Soumya,0,0,32,32
1656319352099,MATH 20E,B01,083773,Ciotti; Benjamin,18,0,35,17
1656319352099,MATH 20E,B02,083774,Ciotti; Benjamin,16,0,35,19
1656319358129,MATH 103A,A01,083777,Greenfeld; Be'Eri,2,0,36,34
1656319358129,MATH 103A,A02,083778,Greenfeld; Be'Eri,4,0,36,32
1656319358129,MATH 103A,A03,093561,Staff,3,0,36,33
1656319358129,MATH 103A,B01,083779,Greenfeld; Be'Eri,7,0,36,29
1656319358129,MATH 103A,B02,083780,Greenfeld; Be'Eri,0,0,36,36
1656319358129,MATH 103A,B03,093562,Staff,1,0,36,35
1656319364154,MATH 105,A01,085443,Carter; Anne Toulson,3,0,35,32
1656319364154,MATH 105,A02,093477,Staff,15,0,35,20
1656319370183,MATH 109,A01,083213,Ganzberger; Geoffrey Michael,1,0,34,33
1656319370183,MATH 109,A02,083214,Ganzberger; Geoffrey Michael,0,0,34,34
1656319370183,MATH 109,A03,093478,Staff,2,0,34,32
1656319370183,MATH 109,B01,083215,Ganzberger; Geoffrey Michael,2,0,32,30
1656319370183,MATH 109,B02,083216,Ganzberger; Geoffrey Michael,0,0,32,32
1656319370183,MATH 109,B03,093479,Staff,4,0,32,28
1656319376225,MATH 142A,A01,083219,Chow; Bennett,1,0,32,31
1656319376225,MATH 142A,A02,083220,Chow; Bennett,8,0,32,24
1656319376225,MATH 142A,A03,093480,Staff,4,0,32,28
1656319376225,MATH 142A,B03,093481,Staff,3,0,32,29
1656319376225,MATH 142A,B04,093558,Staff,7,0,32,25
1656319376225,MATH 142A,B05,093559,Staff,1,0,32,31
1656319382254,MATH 193A,A01,083224,Rotar; Vladimir,0,1,34,34
1656319382254,MATH 193A,A02,083225,Rotar; Vladimir,0,0,34,34
1656319382254,MATH 193A,A03,083781,Rotar; Vladimir,0,0,34,34
1656319382254,MATH 193A,A04,083782,Rotar; Vladimir,5,0,34,29
1656319382254,MATH 193A,A05,093482,Rotar; Vladimir,0,0,34,34
1656319388281,MATH 197,001,091859,McAuley; Julian John,9999,0,9999,0
1656319388281,MATH 197,002,095566,Kedlaya; Kiran S.,9997,0,9999,2
1656319388281,MATH 197,003,095567,Xiao; Ming,9999,0,9999,0
1656319388281,MATH 197,004,095571,Perols; Johan Lars,9998,0,9999,1
1656319395345,COGS 9,A01,083615,Shannon; Kyle Michael,3,0,75,72
1656319401371,COGS 11,A01,083617,Boyle; Mary E. T.,17,0,48,31
1656319407400,COGS 13,A01,083071,Bastos; Amalia Pinkusfeld,5,0,71,66
1656319413426,COGS 14A,A01,092681,Semenuks; Arturs,0,8,100,103
1656319419462,COGS 14B,A01,083073,Cheng; Tzu-Han,7,0,63,56
1656319425486,COGS 17,A01,092677,Semenuks; Arturs,6,0,81,75
1656319431517,COGS 100,A01,083619,Allen; Michael Gordon,2,0,70,68
1656319437542,COGS 101A,A01,083621,Davis; Joshua Daniel,5,0,68,63
1656319443569,COGS 101B,A01,091572,Allen; Michael Gordon,4,0,65,61
1656319449594,COGS 101C,A01,083625,Delgado; Tania,11,0,35,24
1656319455630,COGS 107A,A01,083627,Boyle; Mary E. T.,2,0,60,58
1656319461653,COGS 118A,A01,083075,Gupta; Anjum,8,0,76,68
1656319467690,CSE 3,A50,083646,Miranda; Gregory Joseph,18,0,50,32
1656319473714,CSE 8A,A50,083650,Miranda; Gregory Joseph,5,2,56,51
1656319479740,CSE 11,A01,083080,Cao; Yingjun,0,47,40,40
1656319485768,CSE 12,A01,083652,Krause-Levy; Sophia Louisa,5,1,120,115
1656319491791,CSE 15L,A01,083654,Morris; Justin Loren,2,0,50,48
1656319491791,CSE 15L,A02,083655,Morris; Justin Loren,4,0,50,46
1656319497816,CSE 20,A01,083657,Tran; Khoa Dang,31,0,80,49
1656319503849,CSE 21,A01,095574,Bach; Quang Tran,23,0,48,25
1656319509883,CSE 30,A01,083084,Eldon; John,1,4,80,79
1656319509883,CSE 30,B01,095061,Bhaskar; Nishant,0,1,50,50
1656319515913,CSE 100,A01,083659,Cao; Yingjun,1,18,70,69
1656319521945,CSE 134B,A01,083661,Powell; Thomas Allan,6,0,100,94
1656319527987,CSE 140,A01,083663,Gungor; Onat,9,0,85,76
1656319534014,CSE 140L,A01,083088,Eldon; John,10,0,100,90
1656319540038,CSE 175,A01,083665,Kumar; Rakesh,0,0,25,25
1656319546066,CSE 190,A00,092507,Dubnov; Shlomo,4,0,20,16
1656319552093,ECE 45,A01,083139,Congero; Spencer William,1,0,75,74
1656319558123,ECE 65,A50,083695,Saad; Andrew S,10,0,30,20
1656319558123,ECE 65,A51,095125,Staff,25,0,26,1
1656319564152,ECE 109,A01,091882,Touri; Behrouz,0,1,70,70
1656319570185,ECE 180,A00,083140,Abi Samra; Nicholas Camill,2,0,30,28
1656319570185,ECE 180,B00,083141,Abi Samra; Nicholas Camill,0,4,30,30
1656319576211,MATH 10A,A01,083735,Patchell; Gregory David,0,0,30,30
1656319576211,MATH 10A,A02,083736,Patchell; Gregory David,22,0,30,8
1656319576211,MATH 10A,A03,083737,Patchell; Gregory David,16,0,30,14
1656319582239,MATH 10B,A01,083207,Lim; Seonhee,2,0,34,32
1656319582239,MATH 10B,A02,083208,Lim; Seonhee,4,0,35,31
1656319582239,MATH 10B,A03,093472,Staff,1,0,34,33
1656319582239,MATH 10B,B01,083739,Sinha; Shubham,11,0,30,19
1656319588273,MATH 18,A01,083743,Cinel; Cameron Alexander,7,0,30,23
1656319588273,MATH 18,A02,083744,Cinel; Cameron Alexander,10,0,30,20
1656319588273,MATH 18,A03,083745,Cinel; Cameron Alexander,5,0,30,25
1656319588273,MATH 18,B01,083748,Rideout; David Porter,0,0,36,36
1656319588273,MATH 18,B02,083749,Rideout; David Porter,0,0,36,36
1656319588273,MATH 18,B03,083750,Rideout; David Porter,0,0,36,36
1656319588273,MATH 18,B04,083751,Rideout; David Porter,0,1,36,36
1656319588273,MATH 18,B05,093473,Rideout; David Porter,0,0,36,36
1656319588273,MATH 18,B06,093474,Rideout; David Porter,2,0,36,34
1656319594304,MATH 20A,A01,083754,Zheng; Zequn,11,0,40,29
1656319600338,MATH 20B,A01,083756,Briones; Jor-el Thomas Caparas,0,0,36,36
1656319600338,MATH 20B,A02,083757,Briones; Jor-el Thomas Caparas,0,0,36,36
1656319600338,MATH 20B,A03,093475,Staff,1,0,36,35
1656319606371,MATH 20C,A01,083760,Briones; Jor-el Thomas Caparas,0,0,35,35
1656319606371,MATH 20C,A02,083761,Briones; Jor-el Thomas Caparas,9,1,35,26
1656319606371,MATH 20C,A03,093476,Staff,0,0,35,35
1656319606371,MATH 20C,B01,083762,Bach; Quang Tran,2,0,30,28
1656319612396,MATH 20D,A01,083765,Tran; Brian Kha,1,0,30,29
1656319612396,MATH 20D,A02,083766,Tran; Brian Kha,0,0,30,30
1656319612396,MATH 20D,A03,083767,Tran; Brian Kha,2,0,30,28
1656319618424,MATH 20E,A01,083771,Ganguly; Soumya,1,0,32,31
1656319618424,MATH 20E,A02,083772,Ganguly; Soumya,0,0,32,32
1656319618424,MATH 20E,B01,083773,Ciotti; Benjamin,18,0,35,17
1656319618424,MATH 20E,B02,083774,Ciotti; Benjamin,16,0,35,19
1656319624459,MATH 103A,A01,083777,Greenfeld; Be'Eri,2,0,36,34
1656319624459,MATH 103A,A02,083778,Greenfeld; Be'Eri,4,0,36,32
1656319624459,MATH 103A,A03,093561,Staff,3,0,36,33
1656319624459,MATH 103A,B01,083779,Greenfeld; Be'Eri,7,0,36,29
1656319624459,MATH 103A,B02,083780,Greenfeld; Be'Eri,0,0,36,36
1656319624459,MATH 103A,B03,093562,Staff,1,0,36,35
1656319630487,MATH 105,A01,085443,Carter; Anne Toulson,3,0,35,32
1656319630487,MATH 105,A02,093477,Staff,15,0,35,20
1656319636517,MATH 109,A01,083213,Ganzberger; Geoffrey Michael,1,0,34,33
1656319636517,MATH 109,A02,083214,Ganzberger; Geoffrey Michael,0,0,34,34
1656319636517,MATH 109,A03,093478,Staff,2,0,34,32
1656319636517,MATH 109,B01,083215,Ganzberger; Geoffrey Michael,2,0,32,30
1656319636517,MATH 109,B02,083216,Ganzberger; Geoffrey Michael,0,0,32,32
1656319636517,MATH 109,B03,093479,Staff,4,0,32,28
1656319642544,MATH 142A,A01,083219,Chow; Bennett,1,0,32,31
1656319642544,MATH 142A,A02,083220,Chow; Bennett,8,0,32,24
1656319642544,MATH 142A,A03,093480,Staff,4,0,32,28
1656319642544,MATH 142A,B03,093481,Staff,3,0,32,29
1656319642544,MATH 142A,B04,093558,Staff,7,0,32,25
1656319642544,MATH 142A,B05,093559,Staff,1,0,32,31
1656319648569,MATH 193A,A01,083224,Rotar; Vladimir,0,1,34,34
1656319648569,MATH 193A,A02,083225,Rotar; Vladimir,0,0,34,34
1656319648569,MATH 193A,A03,083781,Rotar; Vladimir,0,0,34,34
1656319648569,MATH 193A,A04,083782,Rotar; Vladimir,5,0,34,29
1656319648569,MATH 193A,A05,093482,Rotar; Vladimir,0,0,34,34
1656319654615,MATH 197,001,091859,McAuley; Julian John,9999,0,9999,0
1656319654615,MATH 197,002,095566,Kedlaya; Kiran S.,9997,0,9999,2
1656319654615,MATH 197,003,095567,Xiao; Ming,9999,0,9999,0
1656319654615,MATH 197,004,095571,Perols; Johan Lars,9998,0,9999,1
1656319661685,COGS 9,A01,083615,Shannon; Kyle Michael,3,0,75,72
1656319667715,COGS 11,A01,083617,Boyle; Mary E. T.,17,0,48,31
1656319673741,COGS 13,A01,083071,Bastos; Amalia Pinkusfeld,5,0,71,66
1656319679767,COGS 14A,A01,092681,Semenuks; Arturs,0,8,100,103
1656319685800,COGS 14B,A01,083073,Cheng; Tzu-Han,7,0,63,56
1656319691829,COGS 17,A01,092677,Semenuks; Arturs,6,0,81,75
1656319697858,COGS 100,A01,083619,Allen; Michael Gordon,2,0,70,68
1656319703895,COGS 101A,A01,083621,Davis; Joshua Daniel,5,0,68,63
1656319709922,COGS 101B,A01,091572,Allen; Michael Gordon,4,0,65,61
1656319715949,COGS 101C,A01,083625,Delgado; Tania,11,0,35,24
1656319721977,COGS 107A,A01,083627,Boyle; Mary E. T.,2,0,60,58
1656319728008,COGS 118A,A01,083075,Gupta; Anjum,8,0,76,68
1656319734035,CSE 3,A50,083646,Miranda; Gregory Joseph,18,0,50,32
1656319740064,CSE 8A,A50,083650,Miranda; Gregory Joseph,5,2,56,51
1656319746091,CSE 11,A01,083080,Cao; Yingjun,0,47,40,40
1656319752122,CSE 12,A01,083652,Krause-Levy; Sophia Louisa,5,1,120,115
1656319758153,CSE 15L,A01,083654,Morris; Justin Loren,2,0,50,48
1656319758153,CSE 15L,A02,083655,Morris; Justin Loren,4,0,50,46
1656319764183,CSE 20,A01,083657,Tran; Khoa Dang,31,0,80,49
1656319770212,CSE 21,A01,095574,Bach; Quang Tran,23,0,48,25
1656319776248,CSE 30,A01,083084,Eldon; John,1,4,80,79
1656319776248,CSE 30,B01,095061,Bhaskar; Nishant,0,1,50,50
1656319782275,CSE 100,A01,083659,Cao; Yingjun,1,18,70,69
1656319788300,CSE 134B,A01,083661,Powell; Thomas Allan,6,0,100,94
1656319794325,CSE 140,A01,083663,Gungor; Onat,9,0,85,76
1656319800358,CSE 140L,A01,083088,Eldon; John,10,0,100,90
1656319806384,CSE 175,A01,083665,Kumar; Rakesh,0,0,25,25
1656319812412,CSE 190,A00,092507,Dubnov; Shlomo,4,0,20,16
1656319818442,ECE 45,A01,083139,Congero; Spencer William,1,0,75,74
1656319824474,ECE 65,A50,083695,Saad; Andrew S,10,0,30,20
1656319824474,ECE 65,A51,095125,Staff,25,0,26,1
1656319830498,ECE 109,A01,091882,Touri; Behrouz,0,1,70,70
1656319836524,ECE 180,A00,083140,Abi Samra; Nicholas Camill,2,0,30,28
1656319836524,ECE 180,B00,083141,Abi Samra; Nicholas Camill,0,4,30,30
1656319842554,MATH 10A,A01,083735,Patchell; Gregory David,0,0,30,30
1656319842554,MATH 10A,A02,083736,Patchell; Gregory David,22,0,30,8
1656319842554,MATH 10A,A03,083737,Patchell; Gregory David,16,0,30,14
1656319848664,MATH 10B,A01,083207,Lim; Seonhee,2,0,34,32
1656319848664,MATH 10B,A02,083208,Lim; Seonhee,4,0,35,31
1656319848664,MATH 10B,A03,093472,Staff,1,0,34,33
1656319848664,MATH 10B,B01,083739,Sinha; Shubham,11,0,30,19
1656319854700,MATH 18,A01,083743,Cinel; Cameron Alexander,7,0,30,23
1656319854700,MATH 18,A02,083744,Cinel; Cameron Alexander,10,0,30,20
1656319854700,MATH 18,A03,083745,Cinel; Cameron Alexander,5,0,30,25
1656319854700,MATH 18,B01,083748,Rideout; David Porter,0,0,36,36
1656319854700,MATH 18,B02,083749,Rideout; David Porter,0,0,36,36
1656319854700,MATH 18,B03,083750,Rideout; David Porter,0,0,36,36
1656319854700,MATH 18,B04,083751,Rideout; David Porter,0,1,36,36
1656319854700,MATH 18,B05,093473,Rideout; David Porter,0,0,36,36
1656319854700,MATH 18,B06,093474,Rideout; David Porter,2,0,36,34
1656319860730,MATH 20A,A01,083754,Zheng; Zequn,11,0,40,29
1656319866756,MATH 20B,A01,083756,Briones; Jor-el Thomas Caparas,0,0,36,36
1656319866756,MATH 20B,A02,083757,Briones; Jor-el Thomas Caparas,0,0,36,36
1656319866756,MATH 20B,A03,093475,Staff,1,0,36,35
1656319872792,MATH 20C,A01,083760,Briones; Jor-el Thomas Caparas,0,0,35,35
1656319872792,MATH 20C,A02,083761,Briones; Jor-el Thomas Caparas,9,1,35,26
1656319872792,MATH 20C,A03,093476,Staff,0,0,35,35
1656319872792,MATH 20C,B01,083762,Bach; Quang Tran,2,0,30,28
1656319878818,MATH 20D,A01,083765,Tran; Brian Kha,1,0,30,29
1656319878818,MATH 20D,A02,083766,Tran; Brian Kha,0,0,30,30
1656319878818,MATH 20D,A03,083767,Tran; Brian Kha,2,0,30,28
1656319884844,MATH 20E,A01,083771,Ganguly; Soumya,1,0,32,31
1656319884844,MATH 20E,A02,083772,Ganguly; Soumya,0,0,32,32
1656319884844,MATH 20E,B01,083773,Ciotti; Benjamin,18,0,35,17
1656319884844,MATH 20E,B02,083774,Ciotti; Benjamin,16,0,35,19
1656319890871,MATH 103A,A01,083777,Greenfeld; Be'Eri,2,0,36,34
1656319890871,MATH 103A,A02,083778,Greenfeld; Be'Eri,4,0,36,32
1656319890871,MATH 103A,A03,093561,Staff,3,0,36,33
1656319890871,MATH 103A,B01,083779,Greenfeld; Be'Eri,7,0,36,29
1656319890871,MATH 103A,B02,083780,Greenfeld; Be'Eri,0,0,36,36
1656319890871,MATH 103A,B03,093562,Staff,1,0,36,35
1656319896896,MATH 105,A01,085443,Carter; Anne Toulson,3,0,35,32
1656319896896,MATH 105,A02,093477,Staff,15,0,35,20
1656319902927,MATH 109,A01,083213,Ganzberger; Geoffrey Michael,1,0,34,33
1656319902927,MATH 109,A02,083214,Ganzberger; Geoffrey Michael,0,0,34,34
1656319902927,MATH 109,A03,093478,Staff,2,0,34,32
1656319902927,MATH 109,B01,083215,Ganzberger; Geoffrey Michael,2,0,32,30
1656319902927,MATH 109,B02,083216,Ganzberger; Geoffrey Michael,0,0,32,32
1656319902927,MATH 109,B03,093479,Staff,4,0,32,28
1656319908960,MATH 142A,A01,083219,Chow; Bennett,1,0,32,31
1656319908960,MATH 142A,A02,083220,Chow; Bennett,8,0,32,24
1656319908960,MATH 142A,A03,093480,Staff,4,0,32,28
1656319908960,MATH 142A,B03,093481,Staff,3,0,32,29
1656319908960,MATH 142A,B04,093558,Staff,7,0,32,25
1656319908960,MATH 142A,B05,093559,Staff,1,0,32,31
1656319914983,MATH 193A,A01,083224,Rotar; Vladimir,0,1,34,34
1656319914983,MATH 193A,A02,083225,Rotar; Vladimir,0,0,34,34
1656319914983,MATH 193A,A03,083781,Rotar; Vladimir,0,0,34,34
1656319914983,MATH 193A,A04,083782,Rotar; Vladimir,5,0,34,29
1656319914983,MATH 193A,A05,093482,Rotar; Vladimir,0,0,34,34
1656319921008,MATH 197,001,091859,McAuley; Julian John,9999,0,9999,0
1656319921008,MATH 197,002,095566,Kedlaya; Kiran S.,9997,0,9999,2
1656319921008,MATH 197,003,095567,Xiao; Ming,9999,0,9999,0
1656319921008,MATH 197,004,095571,Perols; Johan Lars,9998,0,9999,1
1656319928068,COGS 9,A01,083615,Shannon; Kyle Michael,3,0,75,72
1656319934092,COGS 11,A01,083617,Boyle; Mary E. T.,17,0,48,31
1656319940122,COGS 13,A01,083071,Bastos; Amalia Pinkusfeld,5,0,71,66
1656319946148,COGS 14A,A01,092681,Semenuks; Arturs,0,8,100,103
1656319952173,COGS 14B,A01,083073,Cheng; Tzu-Han,7,0,63,56
1656319958197,COGS 17,A01,092677,Semenuks; Arturs,6,0,81,75
1656319964220,COGS 100,A01,083619,Allen; Michael Gordon,2,0,70,68
1656319970250,COGS 101A,A01,083621,Davis; Joshua Daniel,5,0,68,63
1656319976278,COGS 101B,A01,091572,Allen; Michael Gordon,4,0,65,61
1656319982307,COGS 101C,A01,083625,Delgado; Tania,11,0,35,24
1656319988337,COGS 107A,A01,083627,Boyle; Mary E. T.,2,0,60,58
1656319994361,COGS 118A,A01,083075,Gupta; Anjum,8,0,76,68
1656320000388,CSE 3,A50,083646,Miranda; Gregory Joseph,18,0,50,32
1656320006415,CSE 8A,A50,083650,Miranda; Gregory Joseph,5,2,56,51
1656320012442,CSE 11,A01,083080,Cao; Yingjun,0,47,40,40
1656320018473,CSE 12,A01,083652,Krause-Levy; Sophia Louisa,5,1,120,115
1656320024503,CSE 15L,A01,083654,Morris; Justin Loren,2,0,50,48
1656320024503,CSE 15L,A02,083655,Morris; Justin Loren,4,0,50,46
1656320030534,CSE 20,A01,083657,Tran; Khoa Dang,31,0,80,49
1656320036560,CSE 21,A01,095574,Bach; Quang Tran,23,0,48,25
1656320042598,CSE 30,A01,083084,Eldon; John,1,4,80,79
1656320042598,CSE 30,B01,095061,Bhaskar; Nishant,0,1,50,50
1656320048624,CSE 100,A01,083659,Cao; Yingjun,1,18,70,69
1656320054656,CSE 134B,A01,083661,Powell; Thomas Allan,6,0,100,94
1656320060687,CSE 140,A01,083663,Gungor; Onat,9,0,85,76
1656320066716,CSE 140L,A01,083088,Eldon; John,10,0,100,90
1656320072745,CSE 175,A01,083665,Kumar; Rakesh,0,0,25,25
1656320078779,CSE 190,A00,092507,Dubnov; Shlomo,4,0,20,16
1656320084806,ECE 45,A01,083139,Congero; Spencer William,1,0,75,74
1656320090834,ECE 65,A50,083695,Saad; Andrew S,10,0,30,20
1656320090834,ECE 65,A51,095125,Staff,25,0,26,1
1656320096862,ECE 109,A01,091882,Touri; Behrouz,0,1,70,70
1656320102888,ECE 180,A00,083140,Abi Samra; Nicholas Camill,2,0,30,28
1656320102888,ECE 180,B00,083141,Abi Samra; Nicholas Camill,0,4,30,30
1656320108927,MATH 10A,A01,083735,Patchell; Gregory David,0,0,30,30
1656320108927,MATH 10A,A02,083736,Patchell; Gregory David,22,0,30,8
1656320108927,MATH 10A,A03,083737,Patchell; Gregory David,16,0,30,14
1656320114954,MATH 10B,A01,083207,Lim; Seonhee,2,0,34,32
1656320114954,MATH 10B,A02,083208,Lim; Seonhee,4,0,35,31
1656320114954,MATH 10B,A03,093472,Staff,1,0,34,33
1656320114954,MATH 10B,B01,083739,Sinha; Shubham,11,0,30,19
1656320120986,MATH 18,A01,083743,Cinel; Cameron Alexander,7,0,30,23
1656320120986,MATH 18,A02,083744,Cinel; Cameron Alexander,10,0,30,20
1656320120986,MATH 18,A03,083745,Cinel; Cameron Alexander,5,0,30,25
1656320120986,MATH 18,B01,083748,Rideout; David Porter,0,0,36,36
1656320120986,MATH 18,B02,083749,Rideout; David Porter,0,0,36,36
1656320120986,MATH 18,B03,083750,Rideout; David Porter,0,0,36,36
1656320120986,MATH 18,B04,083751,Rideout; David Porter,0,1,36,36
1656320120986,MATH 18,B05,093473,Rideout; David Porter,0,0,36,36
1656320120986,MATH 18,B06,093474,Rideout; David Porter,2,0,36,34
1656320127010,MATH 20A,A01,083754,Zheng; Zequn,11,0,40,29
1656320133037,MATH 20B,A01,083756,Briones; Jor-el Thomas Caparas,0,0,36,36
1656320133037,MATH 20B,A02,083757,Briones; Jor-el Thomas Caparas,0,0,36,36
1656320133037,MATH 20B,A03,093475,Staff,1,0,36,35
1656320139063,MATH 20C,A01,083760,Briones; Jor-el Thomas Caparas,0,0,35,35
1656320139063,MATH 20C,A02,083761,Briones; Jor-el Thomas Caparas,9,1,35,26
1656320139063,MATH 20C,A03,093476,Staff,0,0,35,35
1656320139063,MATH 20C,B01,083762,Bach; Quang Tran,2,0,30,28
1656320145093,MATH 20D,A01,083765,Tran; Brian Kha,1,0,30,29
1656320145093,MATH 20D,A02,083766,Tran; Brian Kha,0,0,30,30
1656320145093,MATH 20D,A03,083767,Tran; Brian Kha,2,0,30,28
1656320151121,MATH 20E,A01,083771,Ganguly; Soumya,1,0,32,31
1656320151121,MATH 20E,A02,083772,Ganguly; Soumya,0,0,32,32
1656320151121,MATH 20E,B01,083773,Ciotti; Benjamin,18,0,35,17
1656320151121,MATH 20E,B02,083774,Ciotti; Benjamin,16,0,35,19
1656320157161,MATH 103A,A01,083777,Greenfeld; Be'Eri,2,0,36,34
1656320157161,MATH 103A,A02,083778,Greenfeld; Be'Eri,4,0,36,32
1656320157161,MATH 103A,A03,093561,Staff,3,0,36,33
1656320157161,MATH 103A,B01,083779,Greenfeld; Be'Eri,7,0,36,29
1656320157161,MATH 103A,B02,083780,Greenfeld; Be'Eri,0,0,36,36
1656320157161,MATH 103A,B03,093562,Staff,1,0,36,35
1656320163190,MATH 105,A01,085443,Carter; Anne Toulson,3,0,35,32
1656320163190,MATH 105,A02,093477,Staff,15,0,35,20
1656320169226,MATH 109,A01,083213,Ganzberger; Geoffrey Michael,1,0,34,33
1656320169226,MATH 109,A02,083214,Ganzberger; Geoffrey Michael,0,0,34,34
1656320169226,MATH 109,A03,093478,Staff,2,0,34,32
1656320169226,MATH 109,B01,083215,Ganzberger; Geoffrey Michael,2,0,32,30
1656320169226,MATH 109,B02,083216,Ganzberger; Geoffrey Michael,0,0,32,32
1656320169226,MATH 109,B03,093479,Staff,4,0,32,28
1656320175254,MATH 142A,A01,083219,Chow; Bennett,1,0,32,31
1656320175254,MATH 142A,A02,083220,Chow; Bennett,8,0,32,24
1656320175254,MATH 142A,A03,093480,Staff,4,0,32,28
1656320175254,MATH 142A,B03,093481,Staff,3,0,32,29
1656320175254,MATH 142A,B04,093558,Staff,7,0,32,25
1656320175254,MATH 142A,B05,093559,Staff,1,0,32,31
1656320181281,MATH 193A,A01,083224,Rotar; Vladimir,0,1,34,34
1656320181281,MATH 193A,A02,083225,Rotar; Vladimir,0,0,34,34
1656320181281,MATH 193A,A03,083781,Rotar; Vladimir,0,0,34,34
1656320181281,MATH 193A,A04,083782,Rotar; Vladimir,5,0,34,29
1656320181281,MATH 193A,A05,093482,Rotar; Vladimir,0,0,34,34
1656320187310,MATH 197,001,091859,McAuley; Julian John,9999,0,9999,0
1656320187310,MATH 197,002,095566,Kedlaya; Kiran S.,9997,0,9999,2
1656320187310,MATH 197,003,095567,Xiao; Ming,9999,0,9999,0
1656320187310,MATH 197,004,095571,Perols; Johan Lars,9998,0,9999,1
1656320194377,COGS 9,A01,083615,Shannon; Kyle Michael,3,0,75,72
1656320200408,COGS 11,A01,083617,Boyle; Mary E. T.,17,0,48,31
1656320206433,COGS 13,A01,083071,Bastos; Amalia Pinkusfeld,5,0,71,66
1656320212461,COGS 14A,A01,092681,Semenuks; Arturs,0,7,100,104
1656320218484,COGS 14B,A01,083073,Cheng; Tzu-Han,7,0,63,56
1656320224511,COGS 17,A01,092677,Semenuks; Arturs,6,0,81,75
1656320230541,COGS 100,A01,083619,Allen; Michael Gordon,2,0,70,68
1656320236567,COGS 101A,A01,083621,Davis; Joshua Daniel,5,0,68,63
1656320242592,COGS 101B,A01,091572,Allen; Michael Gordon,4,0,65,61
1656320248625,COGS 101C,A01,083625,Delgado; Tania,11,0,35,24
1656320254655,COGS 107A,A01,083627,Boyle; Mary E. T.,2,0,60,58
1656320260684,COGS 118A,A01,083075,Gupta; Anjum,8,0,76,68
1656320266719,CSE 3,A50,083646,Miranda; Gregory Joseph,18,0,50,32
1656320272745,CSE 8A,A50,083650,Miranda; Gregory Joseph,5,2,56,51
1656320278773,CSE 11,A01,083080,Cao; Yingjun,0,47,40,40
1656320284811,CSE 12,A01,083652,Krause-Levy; Sophia Louisa,5,1,120,115
1656320290836,CSE 15L,A01,083654,Morris; Justin Loren,2,0,50,48
1656320290836,CSE 15L,A02,083655,Morris; Justin Loren,4,0,50,46
1656320296865,CSE 20,A01,083657,Tran; Khoa Dang,31,0,80,49
1656320302897,CSE 21,A01,095574,Bach; Quang Tran,23,0,48,25
1656320308924,CSE 30,A01,083084,Eldon; John,1,4,80,79
1656320308924,CSE 30,B01,095061,Bhaskar; Nishant,0,1,50,50
1656320314950,CSE 100,A01,083659,Cao; Yingjun,1,18,70,69
1656320320978,CSE 134B,A01,083661,Powell; Thomas Allan,6,0,100,94
1656320327006,CSE 140,A01,083663,Gungor; Onat,9,0,85,76
1656320333032,CSE 140L,A01,083088,Eldon; John,10,0,100,90
1656320339058,CSE 175,A01,083665,Kumar; Rakesh,0,0,25,25
1656320345084,CSE 190,A00,092507,Dubnov; Shlomo,4,0,20,16
1656320351113,ECE 45,A01,083139,Congero; Spencer William,1,0,75,74
1656320357138,ECE 65,A50,083695,Saad; Andrew S,10,0,30,20
1656320357138,ECE 65,A51,095125,Staff,25,0,26,1
1656320363172,ECE 109,A01,091882,Touri; Behrouz,0,1,70,70
1656320369203,ECE 180,A00,083140,Abi Samra; Nicholas Camill,2,0,30,28
1656320369203,ECE 180,B00,083141,Abi Samra; Nicholas Camill,0,4,30,30
1656320375227,MATH 10A,A01,083735,Patchell; Gregory David,0,0,30,30
1656320375227,MATH 10A,A02,083736,Patchell; Gregory David,22,0,30,8
1656320375227,MATH 10A,A03,083737,Patchell; Gregory David,16,0,30,14
1656320381254,MATH 10B,A01,083207,Lim; Seonhee,2,0,34,32
1656320381254,MATH 10B,A02,083208,Lim; Seonhee,4,0,35,31
1656320381254,MATH 10B,A03,093472,Staff,1,0,34,33
1656320381254,MATH 10B,B01,083739,Sinha; Shubham,11,0,30,19
1656320387292,MATH 18,A01,083743,Cinel; Cameron Alexander,7,0,30,23
1656320387292,MATH 18,A02,083744,Cinel; Cameron Alexander,10,0,30,20
1656320387292,MATH 18,A03,083745,Cinel; Cameron Alexander,5,0,30,25
1656320387292,MATH 18,B01,083748,Rideout; David Porter,0,0,36,36
1656320387292,MATH 18,B02,083749,Rideout; David Porter,0,0,36,36
1656320387292,MATH 18,B03,083750,Rideout; David Porter,0,0,36,36
1656320387292,MATH 18,B04,083751,Rideout; David Porter,0,1,36,36
1656320387292,MATH 18,B05,093473,Rideout; David Porter,0,0,36,36
1656320387292,MATH 18,B06,093474,Rideout; David Porter,2,0,36,34
1656320393321,MATH 20A,A01,083754,Zheng; Zequn,11,0,40,29
1656320399348,MATH 20B,A01,083756,Briones; Jor-el Thomas Caparas,0,0,36,36
1656320399348,MATH 20B,A02,083757,Briones; Jor-el Thomas Caparas,0,0,36,36
1656320399348,MATH 20B,A03,093475,Staff,1,0,36,35
1656320405372,MATH 20C,A01,083760,Briones; Jor-el Thomas Caparas,0,0,35,35
1656320405372,MATH 20C,A02,083761,Briones; Jor-el Thomas Caparas,9,1,35,26
1656320405372,MATH 20C,A03,093476,Staff,0,0,35,35
1656320405372,MATH 20C,B01,083762,Bach; Quang Tran,2,0,30,28
1656320411397,MATH 20D,A01,083765,Tran; Brian Kha,1,0,30,29
1656320411397,MATH 20D,A02,083766,Tran; Brian Kha,0,0,30,30
1656320411397,MATH 20D,A03,083767,Tran; Brian Kha,2,0,30,28
1656320417433,MATH 20E,A01,083771,Ganguly; Soumya,1,0,32,31
1656320417433,MATH 20E,A02,083772,Ganguly; Soumya,0,0,32,32
1656320417433,MATH 20E,B01,083773,Ciotti; Benjamin,18,0,35,17
1656320417433,MATH 20E,B02,083774,Ciotti; Benjamin,16,0,35,19
1656320423464,MATH 103A,A01,083777,Greenfeld; Be'Eri,2,0,36,34
1656320423464,MATH 103A,A02,083778,Greenfeld; Be'Eri,4,0,36,32
1656320423464,MATH 103A,A03,093561,Staff,3,0,36,33
1656320423464,MATH 103A,B01,083779,Greenfeld; Be'Eri,7,0,36,29
1656320423464,MATH 103A,B02,083780,Greenfeld; Be'Eri,0,0,36,36
1656320423464,MATH 103A,B03,093562,Staff,1,0,36,35
1656320429497,MATH 105,A01,085443,Carter; Anne Toulson,3,0,35,32
1656320429497,MATH 105,A02,093477,Staff,15,0,35,20
1656320435539,MATH 109,A01,083213,Ganzberger; Geoffrey Michael,1,0,34,33
1656320435539,MATH 109,A02,083214,Ganzberger; Geoffrey Michael,0,0,34,34
1656320435539,MATH 109,A03,093478,Staff,2,0,34,32
1656320435539,MATH 109,B01,083215,Ganzberger; Geoffrey Michael,2,0,32,30
1656320435539,MATH 109,B02,083216,Ganzberger; Geoffrey Michael,0,0,32,32
1656320435539,MATH 109,B03,093479,Staff,4,0,32,28
1656320441565,MATH 142A,A01,083219,Chow; Bennett,1,0,32,31
1656320441565,MATH 142A,A02,083220,Chow; Bennett,8,0,32,24
1656320441565,MATH 142A,A03,093480,Staff,4,0,32,28
1656320441565,MATH 142A,B03,093481,Staff,3,0,32,29
1656320441565,MATH 142A,B04,093558,Staff,7,0,32,25
1656320441565,MATH 142A,B05,093559,Staff,1,0,32,31
1656320447666,MATH 193A,A01,083224,Rotar; Vladimir,0,1,34,34
1656320447666,MATH 193A,A02,083225,Rotar; Vladimir,0,0,34,34
1656320447666,MATH 193A,A03,083781,Rotar; Vladimir,0,0,34,34
1656320447666,MATH 193A,A04,083782,Rotar; Vladimir,5,0,34,29
1656320447666,MATH 193A,A05,093482,Rotar; Vladimir,0,0,34,34
1656320453692,MATH 197,001,091859,McAuley; Julian John,9999,0,9999,0
1656320453692,MATH 197,002,095566,Kedlaya; Kiran S.,9997,0,9999,2
1656320453692,MATH 197,003,095567,Xiao; Ming,9999,0,9999,0
1656320453692,MATH 197,004,095571,Perols; Johan Lars,9998,0,9999,1
1656320460763,COGS 9,A01,083615,Shannon; Kyle Michael,3,0,75,72
1656320466800,COGS 11,A01,083617,Boyle; Mary E. T.,17,0,48,31
1656320472824,COGS 13,A01,083071,Bastos; Amalia Pinkusfeld,5,0,71,66
1656320478852,COGS 14A,A01,092681,Semenuks; Arturs,0,7,100,104
1656320484875,COGS 14B,A01,083073,Cheng; Tzu-Han,7,0,63,56
1656320490904,COGS 17,A01,092677,Semenuks; Arturs,6,0,81,75
1656320496928,COGS 100,A01,083619,Allen; Michael Gordon,2,0,70,68
1656320502953,COGS 101A,A01,083621,Davis; Joshua Daniel,5,0,68,63
1656320508977,COGS 101B,A01,091572,Allen; Michael Gordon,4,0,65,61
1656320515007,COGS 101C,A01,083625,Delgado; Tania,11,0,35,24
1656320521034,COGS 107A,A01,083627,Boyle; Mary E. T.,2,0,60,58
1656320530011,COGS 118A,A01,083075,Gupta; Anjum,8,0,76,68
1656320536037,CSE 3,A50,083646,Miranda; Gregory Joseph,18,0,50,32
1656320542062,CSE 8A,A50,083650,Miranda; Gregory Joseph,5,2,56,51
1656320548091,CSE 11,A01,083080,Cao; Yingjun,0,47,40,40
1656320554116,CSE 12,A01,083652,Krause-Levy; Sophia Louisa,5,1,120,115
1656320560146,CSE 15L,A01,083654,Morris; Justin Loren,2,0,50,48
1656320560146,CSE 15L,A02,083655,Morris; Justin Loren,4,0,50,46
1656320566170,CSE 20,A01,083657,Tran; Khoa Dang,31,0,80,49
1656320572196,CSE 21,A01,095574,Bach; Quang Tran,23,0,48,25
1656320578219,CSE 30,A01,083084,Eldon; John,1,4,80,79
1656320578219,CSE 30,B01,095061,Bhaskar; Nishant,0,1,50,50
1656320584245,CSE 100,A01,083659,Cao; Yingjun,1,18,70,69
1656320590275,CSE 134B,A01,083661,Powell; Thomas Allan,6,0,100,94
1656320596299,CSE 140,A01,083663,Gungor; Onat,9,0,85,76
1656320602332,CSE 140L,A01,083088,Eldon; John,10,0,100,90
1656320608363,CSE 175,A01,083665,Kumar; Rakesh,0,0,25,25
1656320614395,CSE 190,A00,092507,Dubnov; Shlomo,4,0,20,16
1656320620430,ECE 45,A01,083139,Congero; Spencer William,1,0,75,74
1656320626463,ECE 65,A50,083695,Saad; Andrew S,10,0,30,20
1656320626463,ECE 65,A51,095125,Staff,25,0,26,1
1656320632493,ECE 109,A01,091882,Touri; Behrouz,0,1,70,70
1656320638526,ECE 180,A00,083140,Abi Samra; Nicholas Camill,2,0,30,28
1656320638526,ECE 180,B00,083141,Abi Samra; Nicholas Camill,0,4,30,30
1656320644560,MATH 10A,A01,083735,Patchell; Gregory David,0,0,30,30
1656320644560,MATH 10A,A02,083736,Patchell; Gregory David,22,0,30,8
1656320644560,MATH 10A,A03,083737,Patchell; Gregory David,16,0,30,14
1656320650588,MATH 10B,A01,083207,Lim; Seonhee,2,0,34,32
1656320650588,MATH 10B,A02,083208,Lim; Seonhee,4,0,35,31
1656320650588,MATH 10B,A03,093472,Staff,1,0,34,33
1656320650588,MATH 10B,B01,083739,Sinha; Shubham,11,0,30,19
1656320656627,MATH 18,A01,083743,Cinel; Cameron Alexander,7,0,30,23
1656320656627,MATH 18,A02,083744,Cinel; Cameron Alexander,10,0,30,20
1656320656627,MATH 18,A03,083745,Cinel; Cameron Alexander,5,0,30,25
1656320656627,MATH 18,B01,083748,Rideout; David Porter,0,0,36,36
1656320656627,MATH 18,B02,083749,Rideout; David Porter,0,0,36,36
1656320656627,MATH 18,B03,083750,Rideout; David Porter,0,0,36,36
1656320656627,MATH 18,B04,083751,Rideout; David Porter,0,1,36,36
1656320656627,MATH 18,B05,093473,Rideout; David Porter,0,0,36,36
1656320656627,MATH 18,B06,093474,Rideout; David Porter,2,0,36,34
1656320662653,MATH 20A,A01,083754,Zheng; Zequn,11,0,40,29
1656320668678,MATH 20B,A01,083756,Briones; Jor-el Thomas Caparas,0,0,36,36
1656320668678,MATH 20B,A02,083757,Briones; Jor-el Thomas Caparas,0,0,36,36
1656320668678,MATH 20B,A03,093475,Staff,1,0,36,35
1656320674709,MATH 20C,A01,083760,Briones; Jor-el Thomas Caparas,0,0,35,35
1656320674709,MATH 20C,A02,083761,Briones; Jor-el Thomas Caparas,9,1,35,26
1656320674709,MATH 20C,A03,093476,Staff,0,0,35,35
1656320674709,MATH 20C,B01,083762,Bach; Quang Tran,2,0,30,28
1656320680734,MATH 20D,A01,083765,Tran; Brian Kha,1,0,30,29
1656320680734,MATH 20D,A02,083766,Tran; Brian Kha,0,0,30,30
1656320680734,MATH 20D,A03,083767,Tran; Brian Kha,2,0,30,28
1656320686761,MATH 20E,A01,083771,Ganguly; Soumya,1,0,32,31
1656320686761,MATH 20E,A02,083772,Ganguly; Soumya,0,0,32,32
1656320686761,MATH 20E,B01,083773,Ciotti; Benjamin,18,0,35,17
1656320686761,MATH 20E,B02,083774,Ciotti; Benjamin,16,0,35,19
1656320692791,MATH 103A,A01,083777,Greenfeld; Be'Eri,2,0,36,34
1656320692791,MATH 103A,A02,083778,Greenfeld; Be'Eri,4,0,36,32
1656320692791,MATH 103A,A03,093561,Staff,3,0,36,33
1656320692791,MATH 103A,B01,083779,Greenfeld; Be'Eri,7,0,36,29
1656320692791,MATH 103A,B02,083780,Greenfeld; Be'Eri,0,0,36,36
1656320692791,MATH 103A,B03,093562,Staff,1,0,36,35
1656320698822,MATH 105,A01,085443,Carter; Anne Toulson,3,0,35,32
1656320698822,MATH 105,A02,093477,Staff,15,0,35,20
1656320704845,MATH 109,A01,083213,Ganzberger; Geoffrey Michael,1,0,34,33
1656320704845,MATH 109,A02,083214,Ganzberger; Geoffrey Michael,0,0,34,34
1656320704845,MATH 109,A03,093478,Staff,2,0,34,32
1656320704845,MATH 109,B01,083215,Ganzberger; Geoffrey Michael,2,0,32,30
1656320704845,MATH 109,B02,083216,Ganzberger; Geoffrey Michael,0,0,32,32
1656320704845,MATH 109,B03,093479,Staff,4,0,32,28
1656320710871,MATH 142A,A01,083219,Chow; Bennett,1,0,32,31
1656320710871,MATH 142A,A02,083220,Chow; Bennett,8,0,32,24
1656320710871,MATH 142A,A03,093480,Staff,4,0,32,28
1656320710871,MATH 142A,B03,093481,Staff,3,0,32,29
1656320710871,MATH 142A,B04,093558,Staff,7,0,32,25
1656320710871,MATH 142A,B05,093559,Staff,1,0,32,31
1656320716903,MATH 193A,A01,083224,Rotar; Vladimir,0,1,34,34
1656320716903,MATH 193A,A02,083225,Rotar; Vladimir,0,0,34,34
1656320716903,MATH 193A,A03,083781,Rotar; Vladimir,0,0,34,34
1656320716903,MATH 193A,A04,083782,Rotar; Vladimir,5,0,34,29
1656320716903,MATH 193A,A05,093482,Rotar; Vladimir,0,0,34,34
1656320722932,MATH 197,001,091859,McAuley; Julian John,9999,0,9999,0
1656320722932,MATH 197,002,095566,Kedlaya; Kiran S.,9997,0,9999,2
1656320722932,MATH 197,003,095567,Xiao; Ming,9999,0,9999,0
1656320722932,MATH 197,004,095571,Perols; Johan Lars,9998,0,9999,1
1656320730008,COGS 9,A01,083615,Shannon; Kyle Michael,3,0,75,72
1656320736039,COGS 11,A01,083617,Boyle; Mary E. T.,17,0,48,31
1656320742063,COGS 13,A01,083071,Bastos; Amalia Pinkusfeld,5,0,71,66
1656320748095,COGS 14A,A01,092681,Semenuks; Arturs,0,7,100,104
1656320754119,COGS 14B,A01,083073,Cheng; Tzu-Han,7,0,63,56
1656320760144,COGS 17,A01,092677,Semenuks; Arturs,6,0,81,75
1656320766181,COGS 100,A01,083619,Allen; Michael Gordon,2,0,70,68
1656320772208,COGS 101A,A01,083621,Davis; Joshua Daniel,5,0,68,63
1656320778232,COGS 101B,A01,091572,Allen; Michael Gordon,4,0,65,61
1656320784262,COGS 101C,A01,083625,Delgado; Tania,11,0,35,24
1656320790295,COGS 107A,A01,083627,Boyle; Mary E. T.,2,0,60,58
1656320796328,COGS 118A,A01,083075,Gupta; Anjum,8,0,76,68
1656320802359,CSE 3,A50,083646,Miranda; Gregory Joseph,18,0,50,32
1656320808386,CSE 8A,A50,083650,Miranda; Gregory Joseph,5,2,56,51
1656320814411,CSE 11,A01,083080,Cao; Yingjun,0,47,40,40
1656320820438,CSE 12,A01,083652,Krause-Levy; Sophia Louisa,5,1,120,115
1656320826469,CSE 15L,A01,083654,Morris; Justin Loren,2,0,50,48
1656320826469,CSE 15L,A02,083655,Morris; Justin Loren,4,0,50,46
1656320832493,CSE 20,A01,083657,Tran; Khoa Dang,31,0,80,49
1656320838523,CSE 21,A01,095574,Bach; Quang Tran,23,0,48,25
1656320844547,CSE 30,A01,083084,Eldon; John,1,4,80,79
1656320844547,CSE 30,B01,095061,Bhaskar; Nishant,0,1,50,50
1656320850572,CSE 100,A01,083659,Cao; Yingjun,1,18,70,69
1656320856599,CSE 134B,A01,083661,Powell; Thomas Allan,6,0,100,94
1656320862629,CSE 140,A01,083663,Gungor; Onat,9,0,85,76
1656320868663,CSE 140L,A01,083088,Eldon; John,10,0,100,90
1656320874691,CSE 175,A01,083665,Kumar; Rakesh,0,0,25,25
1656320880718,CSE 190,A00,092507,Dubnov; Shlomo,4,0,20,16
1656320886746,ECE 45,A01,083139,Congero; Spencer William,1,0,75,74
1656320892781,ECE 65,A50,083695,Saad; Andrew S,10,0,30,20
1656320892781,ECE 65,A51,095125,Staff,25,0,26,1
1656320898811,ECE 109,A01,091882,Touri; Behrouz,0,1,70,70
1656320904836,ECE 180,A00,083140,Abi Samra; Nicholas Camill,2,0,30,28
1656320904836,ECE 180,B00,083141,Abi Samra; Nicholas Camill,0,4,30,30
1656320910865,MATH 10A,A01,083735,Patchell; Gregory David,0,0,30,30
1656320910865,MATH 10A,A02,083736,Patchell; Gregory David,22,0,30,8
1656320910865,MATH 10A,A03,083737,Patchell; Gregory David,16,0,30,14
1656320916896,MATH 10B,A01,083207,Lim; Seonhee,2,0,34,32
1656320916896,MATH 10B,A02,083208,Lim; Seonhee,4,0,35,31
1656320916896,MATH 10B,A03,093472,Staff,1,0,34,33
1656320916896,MATH 10B,B01,083739,Sinha; Shubham,11,0,30,19
1656320922944,MATH 18,A01,083743,Cinel; Cameron Alexander,7,0,30,23
1656320922944,MATH 18,A02,083744,Cinel; Cameron Alexander,10,0,30,20
1656320922944,MATH 18,A03,083745,Cinel; Cameron Alexander,5,0,30,25
1656320922944,MATH 18,B01,083748,Rideout; David Porter,0,0,36,36
1656320922944,MATH 18,B02,083749,Rideout; David Porter,0,0,36,36
1656320922944,MATH 18,B03,083750,Rideout; David Porter,0,0,36,36
1656320922944,MATH 18,B04,083751,Rideout; David Porter,0,1,36,36
1656320922944,MATH 18,B05,093473,Rideout; David Porter,0,0,36,36
1656320922944,MATH 18,B06,093474,Rideout; David Porter,2,0,36,34
1656320928977,MATH 20A,A01,083754,Zheng; Zequn,11,0,40,29
1656320935013,MATH 20B,A01,083756,Briones; Jor-el Thomas Caparas,0,0,36,36
1656320935013,MATH 20B,A02,083757,Briones; Jor-el Thomas Caparas,0,0,36,36
1656320935013,MATH 20B,A03,093475,Staff,1,0,36,35
1656320941045,MATH 20C,A01,083760,Briones; Jor-el Thomas Caparas,0,0,35,35
1656320941045,MATH 20C,A02,083761,Briones; Jor-el Thomas Caparas,9,1,35,26
1656320941045,MATH 20C,A03,093476,Staff,0,0,35,35
1656320941045,MATH 20C,B01,083762,Bach; Quang Tran,2,0,30,28
1656320947081,MATH 20D,A01,083765,Tran; Brian Kha,1,0,30,29
1656320947081,MATH 20D,A02,083766,Tran; Brian Kha,0,0,30,30
1656320947081,MATH 20D,A03,083767,Tran; Brian Kha,2,0,30,28
1656320953112,MATH 20E,A01,083771,Ganguly; Soumya,1,0,32,31
1656320953112,MATH 20E,A02,083772,Ganguly; Soumya,0,0,32,32
1656320953112,MATH 20E,B01,083773,Ciotti; Benjamin,18,0,35,17
1656320953112,MATH 20E,B02,083774,Ciotti; Benjamin,16,0,35,19
1656320959159,MATH 103A,A01,083777,Greenfeld; Be'Eri,2,0,36,34
1656320959159,MATH 103A,A02,083778,Greenfeld; Be'Eri,4,0,36,32
1656320959159,MATH 103A,A03,093561,Staff,3,0,36,33
1656320959159,MATH 103A,B01,083779,Greenfeld; Be'Eri,7,0,36,29
1656320959159,MATH 103A,B02,083780,Greenfeld; Be'Eri,0,0,36,36
1656320959159,MATH 103A,B03,093562,Staff,1,0,36,35
1656320965189,MATH 105,A01,085443,Carter; Anne Toulson,3,0,35,32
1656320965189,MATH 105,A02,093477,Staff,15,0,35,20
1656320971216,MATH 109,A01,083213,Ganzberger; Geoffrey Michael,1,0,34,33
1656320971216,MATH 109,A02,083214,Ganzberger; Geoffrey Michael,0,0,34,34
1656320971216,MATH 109,A03,093478,Staff,2,0,34,32
1656320971216,MATH 109,B01,083215,Ganzberger; Geoffrey Michael,2,0,32,30
1656320971216,MATH 109,B02,083216,Ganzberger; Geoffrey Michael,0,0,32,32
1656320971216,MATH 109,B03,093479,Staff,4,0,32,28
1656320977255,MATH 142A,A01,083219,Chow; Bennett,1,0,32,31
1656320977255,MATH 142A,A02,083220,Chow; Bennett,8,0,32,24
1656320977255,MATH 142A,A03,093480,Staff,4,0,32,28
1656320977255,MATH 142A,B03,093481,Staff,3,0,32,29
1656320977255,MATH 142A,B04,093558,Staff,7,0,32,25
1656320977255,MATH 142A,B05,093559,Staff,1,0,32,31
1656320983291,MATH 193A,A01,083224,Rotar; Vladimir,0,1,34,34
1656320983291,MATH 193A,A02,083225,Rotar; Vladimir,0,0,34,34
1656320983291,MATH 193A,A03,083781,Rotar; Vladimir,0,0,34,34
1656320983291,MATH 193A,A04,083782,Rotar; Vladimir,5,0,34,29
1656320983291,MATH 193A,A05,093482,Rotar; Vladimir,0,0,34,34
1656320989316,MATH 197,001,091859,McAuley; Julian John,9999,0,9999,0
1656320989316,MATH 197,002,095566,Kedlaya; Kiran S.,9997,0,9999,2
1656320989316,MATH 197,003,095567,Xiao; Ming,9999,0,9999,0
1656320989316,MATH 197,004,095571,Perols; Johan Lars,9998,0,9999,1
1656320996391,COGS 9,A01,083615,Shannon; Kyle Michael,3,0,75,72
1656321002426,COGS 11,A01,083617,Boyle; Mary E. T.,17,0,48,31
1656321008450,COGS 13,A01,083071,Bastos; Amalia Pinkusfeld,5,0,71,66
1656321014480,COGS 14A,A01,092681,Semenuks; Arturs,0,7,100,104
1656321020509,COGS 14B,A01,083073,Cheng; Tzu-Han,7,0,63,56
1656321026534,COGS 17,A01,092677,Semenuks; Arturs,6,0,81,75
1656321032564,COGS 100,A01,083619,Allen; Michael Gordon,2,0,70,68
1656321038595,COGS 101A,A01,083621,Davis; Joshua Daniel,5,0,68,63
1656321044698,COGS 101B,A01,091572,Allen; Michael Gordon,4,0,65,61
1656321050725,COGS 101C,A01,083625,Delgado; Tania,11,0,35,24
1656321056749,COGS 107A,A01,083627,Boyle; Mary E. T.,2,0,60,58
1656321062775,COGS 118A,A01,083075,Gupta; Anjum,8,0,76,68
1656321068802,CSE 3,A50,083646,Miranda; Gregory Joseph,18,0,50,32
1656321074831,CSE 8A,A50,083650,Miranda; Gregory Joseph,5,2,56,51
1656321080855,CSE 11,A01,083080,Cao; Yingjun,0,47,40,40
1656321086891,CSE 12,A01,083652,Krause-Levy; Sophia Louisa,5,1,120,115
1656321092917,CSE 15L,A01,083654,Morris; Justin Loren,2,0,50,48
1656321092917,CSE 15L,A02,083655,Morris; Justin Loren,4,0,50,46
1656321098946,CSE 20,A01,083657,Tran; Khoa Dang,31,0,80,49
1656321104973,CSE 21,A01,095574,Bach; Quang Tran,23,0,48,25
1656321111001,CSE 30,A01,083084,Eldon; John,1,4,80,79
1656321111001,CSE 30,B01,095061,Bhaskar; Nishant,0,1,50,50
1656321117028,CSE 100,A01,083659,Cao; Yingjun,1,18,70,69
1656321123058,CSE 134B,A01,083661,Powell; Thomas Allan,6,0,100,94
1656321129083,CSE 140,A01,083663,Gungor; Onat,9,0,85,76
1656321135119,CSE 140L,A01,083088,Eldon; John,10,0,100,90
1656321141150,CSE 175,A01,083665,Kumar; Rakesh,0,0,25,25
1656321147174,CSE 190,A00,092507,Dubnov; Shlomo,4,0,20,16
1656321153206,ECE 45,A01,083139,Congero; Spencer William,1,0,75,74
1656321159231,ECE 65,A50,083695,Saad; Andrew S,10,0,30,20
1656321159231,ECE 65,A51,095125,Staff,25,0,26,1
1656321165256,ECE 109,A01,091882,Touri; Behrouz,0,1,70,70
1656321171285,ECE 180,A00,083140,Abi Samra; Nicholas Camill,2,0,30,28
1656321171285,ECE 180,B00,083141,Abi Samra; Nicholas Camill,0,4,30,30
1656321177312,MATH 10A,A01,083735,Patchell; Gregory David,0,0,30,30
1656321177312,MATH 10A,A02,083736,Patchell; Gregory David,22,0,30,8
1656321177312,MATH 10A,A03,083737,Patchell; Gregory David,16,0,30,14
1656321183339,MATH 10B,A01,083207,Lim; Seonhee,2,0,34,32
1656321183339,MATH 10B,A02,083208,Lim; Seonhee,4,0,35,31
1656321183339,MATH 10B,A03,093472,Staff,1,0,34,33
1656321183339,MATH 10B,B01,083739,Sinha; Shubham,11,0,30,19
1656321189367,MATH 18,A01,083743,Cinel; Cameron Alexander,7,0,30,23
1656321189367,MATH 18,A02,083744,Cinel; Cameron Alexander,10,0,30,20
1656321189367,MATH 18,A03,083745,Cinel; Cameron Alexander,5,0,30,25
1656321189367,MATH 18,B01,083748,Rideout; David Porter,0,0,36,36
1656321189367,MATH 18,B02,083749,Rideout; David Porter,0,0,36,36
1656321189367,MATH 18,B03,083750,Rideout; David Porter,0,0,36,36
1656321189367,MATH 18,B04,083751,Rideout; David Porter,0,1,36,36
1656321189367,MATH 18,B05,093473,Rideout; David Porter,0,0,36,36
1656321189367,MATH 18,B06,093474,Rideout; David Porter,2,0,36,34
1656321195393,MATH 20A,A01,083754,Zheng; Zequn,11,0,40,29
1656321201421,MATH 20B,A01,083756,Briones; Jor-el Thomas Caparas,0,0,36,36
1656321201421,MATH 20B,A02,083757,Briones; Jor-el Thomas Caparas,0,0,36,36
1656321201421,MATH 20B,A03,093475,Staff,1,0,36,35
1656321207450,MATH 20C,A01,083760,Briones; Jor-el Thomas Caparas,0,0,35,35
1656321207450,MATH 20C,A02,083761,Briones; Jor-el Thomas Caparas,9,1,35,26
1656321207450,MATH 20C,A03,093476,Staff,0,0,35,35
1656321207450,MATH 20C,B01,083762,Bach; Quang Tran,2,0,30,28
1656321213482,MATH 20D,A01,083765,Tran; Brian Kha,1,0,30,29
1656321213482,MATH 20D,A02,083766,Tran; Brian Kha,0,0,30,30
1656321213482,MATH 20D,A03,083767,Tran; Brian Kha,2,0,30,28
1656321219509,MATH 20E,A01,083771,Ganguly; Soumya,1,0,32,31
1656321219509,MATH 20E,A02,083772,Ganguly; Soumya,0,0,32,32
1656321219509,MATH 20E,B01,083773,Ciotti; Benjamin,18,0,35,17
1656321219509,MATH 20E,B02,083774,Ciotti; Benjamin,16,0,35,19
1656321225534,MATH 103A,A01,083777,Greenfeld; Be'Eri,2,0,36,34
1656321225534,MATH 103A,A02,083778,Greenfeld; Be'Eri,4,0,36,32
1656321225534,MATH 103A,A03,093561,Staff,3,0,36,33
1656321225534,MATH 103A,B01,083779,Greenfeld; Be'Eri,7,0,36,29
1656321225534,MATH 103A,B02,083780,Greenfeld; Be'Eri,0,0,36,36
1656321225534,MATH 103A,B03,093562,Staff,1,0,36,35
1656321231569,MATH 105,A01,085443,Carter; Anne Toulson,3,0,35,32
1656321231569,MATH 105,A02,093477,Staff,15,0,35,20
1656321237695,MATH 109,A01,083213,Ganzberger; Geoffrey Michael,1,0,34,33
1656321237695,MATH 109,A02,083214,Ganzberger; Geoffrey Michael,0,0,34,34
1656321237695,MATH 109,A03,093478,Staff,2,0,34,32
1656321237695,MATH 109,B01,083215,Ganzberger; Geoffrey Michael,2,0,32,30
1656321237695,MATH 109,B02,083216,Ganzberger; Geoffrey Michael,0,0,32,32
1656321237695,MATH 109,B03,093479,Staff,4,0,32,28
1656321243724,MATH 142A,A01,083219,Chow; Bennett,1,0,32,31
1656321243724,MATH 142A,A02,083220,Chow; Bennett,8,0,32,24
1656321243724,MATH 142A,A03,093480,Staff,4,0,32,28
1656321243724,MATH 142A,B03,093481,Staff,3,0,32,29
1656321243724,MATH 142A,B04,093558,Staff,7,0,32,25
1656321243724,MATH 142A,B05,093559,Staff,1,0,32,31
1656321249749,MATH 193A,A01,083224,Rotar; Vladimir,0,1,34,34
1656321249749,MATH 193A,A02,083225,Rotar; Vladimir,0,0,34,34
1656321249749,MATH 193A,A03,083781,Rotar; Vladimir,0,0,34,34
1656321249749,MATH 193A,A04,083782,Rotar; Vladimir,5,0,34,29
1656321249749,MATH 193A,A05,093482,Rotar; Vladimir,0,0,34,34
1656321255778,MATH 197,001,091859,McAuley; Julian John,9999,0,9999,0
1656321255778,MATH 197,002,095566,Kedlaya; Kiran S.,9997,0,9999,2
1656321255778,MATH 197,003,095567,Xiao; Ming,9999,0,9999,0
1656321255778,MATH 197,004,095571,Perols; Johan Lars,9998,0,9999,1
1656321262846,COGS 9,A01,083615,Shannon; Kyle Michael,3,0,75,72
1656321268871,COGS 11,A01,083617,Boyle; Mary E. T.,17,0,48,31
1656321274898,COGS 13,A01,083071,Bastos; Amalia Pinkusfeld,5,0,71,66
1656321280925,COGS 14A,A01,092681,Semenuks; Arturs,0,7,100,104
1656321286950,COGS 14B,A01,083073,Cheng; Tzu-Han,7,0,63,56
1656321292975,COGS 17,A01,092677,Semenuks; Arturs,6,0,81,75
1656321299004,COGS 100,A01,083619,Allen; Michael Gordon,2,0,70,68
1656321305032,COGS 101A,A01,083621,Davis; Joshua Daniel,5,0,68,63
1656321311057,COGS 101B,A01,091572,Allen; Michael Gordon,4,0,65,61
1656321317083,COGS 101C,A01,083625,Delgado; Tania,11,0,35,24
1656321323109,COGS 107A,A01,083627,Boyle; Mary E. T.,2,0,60,58
1656321329153,COGS 118A,A01,083075,Gupta; Anjum,8,0,76,68
1656321335184,CSE 3,A50,083646,Miranda; Gregory Joseph,18,0,50,32
1656321341207,CSE 8A,A50,083650,Miranda; Gregory Joseph,5,2,56,51
1656321347237,CSE 11,A01,083080,Cao; Yingjun,0,47,40,40
1656321353261,CSE 12,A01,083652,Krause-Levy; Sophia Louisa,5,1,120,115
1656321359291,CSE 15L,A01,083654,Morris; Justin Loren,2,0,50,48
1656321359291,CSE 15L,A02,083655,Morris; Justin Loren,4,0,50,46
1656321365315,CSE 20,A01,083657,Tran; Khoa Dang,31,0,80,49
1656321371344,CSE 21,A01,095574,Bach; Quang Tran,23,0,48,25
1656321377369,CSE 30,A01,083084,Eldon; John,1,4,80,79
1656321377369,CSE 30,B01,095061,Bhaskar; Nishant,0,1,50,50
1656321383396,CSE 100,A01,083659,Cao; Yingjun,1,18,70,69
1656321389433,CSE 134B,A01,083661,Powell; Thomas Allan,6,0,100,94
1656321395457,CSE 140,A01,083663,Gungor; Onat,9,0,85,76
1656321401483,CSE 140L,A01,083088,Eldon; John,10,0,100,90
1656321407511,CSE 175,A01,083665,Kumar; Rakesh,0,0,25,25
1656321413537,CSE 190,A00,092507,Dubnov; Shlomo,4,0,20,16
1656321419571,ECE 45,A01,083139,Congero; Spencer William,1,0,75,74
1656321425597,ECE 65,A50,083695,Saad; Andrew S,10,0,30,20
1656321425597,ECE 65,A51,095125,Staff,25,0,26,1
1656321431626,ECE 109,A01,091882,Touri; Behrouz,0,1,70,70
1656321437652,ECE 180,A00,083140,Abi Samra; Nicholas Camill,2,0,30,28
1656321437652,ECE 180,B00,083141,Abi Samra; Nicholas Camill,0,4,30,30
1656321443686,MATH 10A,A01,083735,Patchell; Gregory David,0,0,30,30
1656321443686,MATH 10A,A02,083736,Patchell; Gregory David,22,0,30,8
1656321443686,MATH 10A,A03,083737,Patchell; Gregory David,16,0,30,14
1656321449713,MATH 10B,A01,083207,Lim; Seonhee,2,0,34,32
1656321449713,MATH 10B,A02,083208,Lim; Seonhee,4,0,35,31
1656321449713,MATH 10B,A03,093472,Staff,1,0,34,33
1656321449713,MATH 10B,B01,083739,Sinha; Shubham,11,0,30,19
1656321455739,MATH 18,A01,083743,Cinel; Cameron Alexander,7,0,30,23
1656321455739,MATH 18,A02,083744,Cinel; Cameron Alexander,10,0,30,20
1656321455739,MATH 18,A03,083745,Cinel; Cameron Alexander,5,0,30,25
1656321455739,MATH 18,B01,083748,Rideout; David Porter,0,0,36,36
1656321455739,MATH 18,B02,083749,Rideout; David Porter,0,0,36,36
1656321455739,MATH 18,B03,083750,Rideout; David Porter,0,0,36,36
1656321455739,MATH 18,B04,083751,Rideout; David Porter,0,1,36,36
1656321455739,MATH 18,B05,093473,Rideout; David Porter,0,0,36,36
1656321455739,MATH 18,B06,093474,Rideout; David Porter,2,0,36,34
1656321461764,MATH 20A,A01,083754,Zheng; Zequn,11,0,40,29
1656321467797,MATH 20B,A01,083756,Briones; Jor-el Thomas Caparas,0,0,36,36
1656321467797,MATH 20B,A02,083757,Briones; Jor-el Thomas Caparas,0,0,36,36
1656321467797,MATH 20B,A03,093475,Staff,1,0,36,35
1656321473827,MATH 20C,A01,083760,Briones; Jor-el Thomas Caparas,0,0,35,35
1656321473827,MATH 20C,A02,083761,Briones; Jor-el Thomas Caparas,9,1,35,26
1656321473827,MATH 20C,A03,093476,Staff,0,0,35,35
1656321473827,MATH 20C,B01,083762,Bach; Quang Tran,2,0,30,28
1656321479859,MATH 20D,A01,083765,Tran; Brian Kha,1,0,30,29
1656321479859,MATH 20D,A02,083766,Tran; Brian Kha,0,0,30,30
1656321479859,MATH 20D,A03,083767,Tran; Brian Kha,2,0,30,28
1656321485894,MATH 20E,A01,083771,Ganguly; Soumya,1,0,32,31
1656321485894,MATH 20E,A02,083772,Ganguly; Soumya,0,0,32,32
1656321485894,MATH 20E,B01,083773,Ciotti; Benjamin,18,0,35,17
1656321485894,MATH 20E,B02,083774,Ciotti; Benjamin,16,0,35,19
1656321491922,MATH 103A,A01,083777,Greenfeld; Be'Eri,2,0,36,34
1656321491922,MATH 103A,A02,083778,Greenfeld; Be'Eri,4,0,36,32
1656321491922,MATH 103A,A03,093561,Staff,3,0,36,33
1656321491922,MATH 103A,B01,083779,Greenfeld; Be'Eri,7,0,36,29
1656321491922,MATH 103A,B02,083780,Greenfeld; Be'Eri,0,0,36,36
1656321491922,MATH 103A,B03,093562,Staff,1,0,36,35
1656321497953,MATH 105,A01,085443,Carter; Anne Toulson,3,0,35,32
1656321497953,MATH 105,A02,093477,Staff,15,0,35,20
1656321503980,MATH 109,A01,083213,Ganzberger; Geoffrey Michael,1,0,34,33
1656321503980,MATH 109,A02,083214,Ganzberger; Geoffrey Michael,0,0,34,34
1656321503980,MATH 109,A03,093478,Staff,2,0,34,32
1656321503980,MATH 109,B01,083215,Ganzberger; Geoffrey Michael,2,0,32,30
1656321503980,MATH 109,B02,083216,Ganzberger; Geoffrey Michael,0,0,32,32
1656321503980,MATH 109,B03,093479,Staff,4,0,32,28
1656321510006,MATH 142A,A01,083219,Chow; Bennett,0,0,32,32
1656321510006,MATH 142A,A02,083220,Chow; Bennett,8,0,32,24
1656321510006,MATH 142A,A03,093480,Staff,4,0,32,28
1656321510006,MATH 142A,B03,093481,Staff,3,0,32,29
1656321510006,MATH 142A,B04,093558,Staff,7,0,32,25
1656321510006,MATH 142A,B05,093559,Staff,1,0,32,31
1656321516030,MATH 193A,A01,083224,Rotar; Vladimir,0,1,34,34
1656321516030,MATH 193A,A02,083225,Rotar; Vladimir,0,0,34,34
1656321516030,MATH 193A,A03,083781,Rotar; Vladimir,0,0,34,34
1656321516030,MATH 193A,A04,083782,Rotar; Vladimir,5,0,34,29
1656321516030,MATH 193A,A05,093482,Rotar; Vladimir,0,0,34,34
1656321522060,MATH 197,001,091859,McAuley; Julian John,9999,0,9999,0
1656321522060,MATH 197,002,095566,Kedlaya; Kiran S.,9997,0,9999,2
1656321522060,MATH 197,003,095567,Xiao; Ming,9999,0,9999,0
1656321522060,MATH 197,004,095571,Perols; Johan Lars,9998,0,9999,1
1656321529122,COGS 9,A01,083615,Shannon; Kyle Michael,3,0,75,72
1656321535155,COGS 11,A01,083617,Boyle; Mary E. T.,17,0,48,31
1656321541180,COGS 13,A01,083071,Bastos; Amalia Pinkusfeld,5,0,71,66
1656321547212,COGS 14A,A01,092681,Semenuks; Arturs,0,7,100,104
1656321553243,COGS 14B,A01,083073,Cheng; Tzu-Han,7,0,63,56
1656321559268,COGS 17,A01,092677,Semenuks; Arturs,6,0,81,75
1656321565299,COGS 100,A01,083619,Allen; Michael Gordon,2,0,70,68
1656321571324,COGS 101A,A01,083621,Davis; Joshua Daniel,5,0,68,63
1656321577348,COGS 101B,A01,091572,Allen; Michael Gordon,4,0,65,61
1656321583372,COGS 101C,A01,083625,Delgado; Tania,11,0,35,24
1656321589401,COGS 107A,A01,083627,Boyle; Mary E. T.,2,0,60,58
1656321595427,COGS 118A,A01,083075,Gupta; Anjum,8,0,76,68
1656321601461,CSE 3,A50,083646,Miranda; Gregory Joseph,18,0,50,32
1656321607489,CSE 8A,A50,083650,Miranda; Gregory Joseph,5,2,56,51
1656321613514,CSE 11,A01,083080,Cao; Yingjun,0,46,40,40
1656321619555,CSE 12,A01,083652,Krause-Levy; Sophia Louisa,5,1,120,115
1656321625578,CSE 15L,A01,083654,Morris; Justin Loren,2,0,50,48
1656321625578,CSE 15L,A02,083655,Morris; Justin Loren,4,0,50,46
1656321631603,CSE 20,A01,083657,Tran; Khoa Dang,31,0,80,49
1656321637632,CSE 21,A01,095574,Bach; Quang Tran,23,0,48,25
1656321643736,CSE 30,A01,083084,Eldon; John,1,4,80,79
1656321643736,CSE 30,B01,095061,Bhaskar; Nishant,0,1,50,50
1656321649761,CSE 100,A01,083659,Cao; Yingjun,1,18,70,69
1656321655786,CSE 134B,A01,083661,Powell; Thomas Allan,6,0,100,94
1656321661816,CSE 140,A01,083663,Gungor; Onat,9,0,85,76
1656321667846,CSE 140L,A01,083088,Eldon; John,10,0,100,90
1656321673873,CSE 175,A01,083665,Kumar; Rakesh,0,0,25,25
1656321679898,CSE 190,A00,092507,Dubnov; Shlomo,4,0,20,16
1656321685924,ECE 45,A01,083139,Congero; Spencer William,1,0,75,74
1656321691954,ECE 65,A50,083695,Saad; Andrew S,10,0,30,20
1656321691954,ECE 65,A51,095125,Staff,25,0,26,1
1656321697991,ECE 109,A01,091882,Touri; Behrouz,0,1,70,70
1656321704017,ECE 180,A00,083140,Abi Samra; Nicholas Camill,2,0,30,28
1656321704017,ECE 180,B00,083141,Abi Samra; Nicholas Camill,0,4,30,30
1656321710049,MATH 10A,A01,083735,Patchell; Gregory David,0,0,30,30
1656321710049,MATH 10A,A02,083736,Patchell; Gregory David,22,0,30,8
1656321710049,MATH 10A,A03,083737,Patchell; Gregory David,16,0,30,14
1656321716076,MATH 10B,A01,083207,Lim; Seonhee,2,0,34,32
1656321716076,MATH 10B,A02,083208,Lim; Seonhee,4,0,35,31
1656321716076,MATH 10B,A03,093472,Staff,1,0,34,33
1656321716076,MATH 10B,B01,083739,Sinha; Shubham,11,0,30,19
1656321722108,MATH 18,A01,083743,Cinel; Cameron Alexander,7,0,30,23
1656321722108,MATH 18,A02,083744,Cinel; Cameron Alexander,10,0,30,20
1656321722108,MATH 18,A03,083745,Cinel; Cameron Alexander,5,0,30,25
1656321722108,MATH 18,B01,083748,Rideout; David Porter,0,0,36,36
1656321722108,MATH 18,B02,083749,Rideout; David Porter,0,0,36,36
1656321722108,MATH 18,B03,083750,Rideout; David Porter,0,0,36,36
1656321722108,MATH 18,B04,083751,Rideout; David Porter,0,1,36,36
1656321722108,MATH 18,B05,093473,Rideout; David Porter,0,0,36,36
1656321722108,MATH 18,B06,093474,Rideout; David Porter,2,0,36,34
1656321728134,MATH 20A,A01,083754,Zheng; Zequn,11,0,40,29
1656321734166,MATH 20B,A01,083756,Briones; Jor-el Thomas Caparas,0,0,36,36
1656321734166,MATH 20B,A02,083757,Briones; Jor-el Thomas Caparas,0,0,36,36
1656321734166,MATH 20B,A03,093475,Staff,1,0,36,35
1656321740193,MATH 20C,A01,083760,Briones; Jor-el Thomas Caparas,0,0,35,35
1656321740193,MATH 20C,A02,083761,Briones; Jor-el Thomas Caparas,9,1,35,26
1656321740193,MATH 20C,A03,093476,Staff,0,0,35,35
1656321740193,MATH 20C,B01,083762,Bach; Quang Tran,2,0,30,28
1656321746224,MATH 20D,A01,083765,Tran; Brian Kha,1,0,30,29
1656321746224,MATH 20D,A02,083766,Tran; Brian Kha,0,0,30,30
1656321746224,MATH 20D,A03,083767,Tran; Brian Kha,2,0,30,28
1656321752251,MATH 20E,A01,083771,Ganguly; Soumya,1,0,32,31
1656321752251,MATH 20E,A02,083772,Ganguly; Soumya,0,0,32,32
1656321752251,MATH 20E,B01,083773,Ciotti; Benjamin,18,0,35,17
1656321752251,MATH 20E,B02,083774,Ciotti; Benjamin,16,0,35,19
1656321758278,MATH 103A,A01,083777,Greenfeld; Be'Eri,2,0,36,34
1656321758278,MATH 103A,A02,083778,Greenfeld; Be'Eri,4,0,36,32
1656321758278,MATH 103A,A03,093561,Staff,3,0,36,33
1656321758278,MATH 103A,B01,083779,Greenfeld; Be'Eri,7,0,36,29
1656321758278,MATH 103A,B02,083780,Greenfeld; Be'Eri,0,0,36,36
1656321758278,MATH 103A,B03,093562,Staff,1,0,36,35
1656321764303,MATH 105,A01,085443,Carter; Anne Toulson,3,0,35,32
1656321764303,MATH 105,A02,093477,Staff,15,0,35,20
1656321770344,MATH 109,A01,083213,Ganzberger; Geoffrey Michael,1,0,34,33
1656321770344,MATH 109,A02,083214,Ganzberger; Geoffrey Michael,0,0,34,34
1656321770344,MATH 109,A03,093478,Staff,2,0,34,32
1656321770344,MATH 109,B01,083215,Ganzberger; Geoffrey Michael,2,0,32,30
1656321770344,MATH 109,B02,083216,Ganzberger; Geoffrey Michael,0,0,32,32
1656321770344,MATH 109,B03,093479,Staff,4,0,32,28
1656321776368,MATH 142A,A01,083219,Chow; Bennett,0,0,32,32
1656321776368,MATH 142A,A02,083220,Chow; Bennett,8,0,32,24
1656321776368,MATH 142A,A03,093480,Staff,4,0,32,28
1656321776368,MATH 142A,B03,093481,Staff,3,0,32,29
1656321776368,MATH 142A,B04,093558,Staff,7,0,32,25
1656321776368,MATH 142A,B05,093559,Staff,1,0,32,31
1656321782401,MATH 193A,A01,083224,Rotar; Vladimir,0,1,34,34
1656321782401,MATH 193A,A02,083225,Rotar; Vladimir,0,0,34,34
1656321782401,MATH 193A,A03,083781,Rotar; Vladimir,0,0,34,34
1656321782401,MATH 193A,A04,083782,Rotar; Vladimir,5,0,34,29
1656321782401,MATH 193A,A05,093482,Rotar; Vladimir,0,0,34,34
1656321788426,MATH 197,001,091859,McAuley; Julian John,9999,0,9999,0
1656321788426,MATH 197,002,095566,Kedlaya; Kiran S.,9997,0,9999,2
1656321788426,MATH 197,003,095567,Xiao; Ming,9999,0,9999,0
1656321788426,MATH 197,004,095571,Perols; Johan Lars,9998,0,9999,1
1656321795506,COGS 9,A01,083615,Shannon; Kyle Michael,3,0,75,72
1656321801530,COGS 11,A01,083617,Boyle; Mary E. T.,17,0,48,31
1656321807560,COGS 13,A01,083071,Bastos; Amalia Pinkusfeld,5,0,71,66
1656321813586,COGS 14A,A01,092681,Semenuks; Arturs,0,7,100,104
1656321819610,COGS 14B,A01,083073,Cheng; Tzu-Han,7,0,63,56
1656321825635,COGS 17,A01,092677,Semenuks; Arturs,6,0,81,75
1656321831660,COGS 100,A01,083619,Allen; Michael Gordon,2,0,70,68
1656321837687,COGS 101A,A01,083621,Davis; Joshua Daniel,5,0,68,63
1656321843713,COGS 101B,A01,091572,Allen; Michael Gordon,4,0,65,61
1656321849740,COGS 101C,A01,083625,Delgado; Tania,11,0,35,24
1656321855764,COGS 107A,A01,083627,Boyle; Mary E. T.,2,0,60,58
1656321861788,COGS 118A,A01,083075,Gupta; Anjum,8,0,76,68
1656321867813,CSE 3,A50,083646,Miranda; Gregory Joseph,18,0,50,32
1656321873837,CSE 8A,A50,083650,Miranda; Gregory Joseph,5,2,56,51
1656321879862,CSE 11,A01,083080,Cao; Yingjun,0,46,40,40
1656321885887,CSE 12,A01,083652,Krause-Levy; Sophia Louisa,5,1,120,115
1656321891917,CSE 15L,A01,083654,Morris; Justin Loren,2,0,50,48
1656321891917,CSE 15L,A02,083655,Morris; Justin Loren,4,0,50,46
1656321897946,CSE 20,A01,083657,Tran; Khoa Dang,31,0,80,49
1656321903972,CSE 21,A01,095574,Bach; Quang Tran,23,0,48,25
1656321909997,CSE 30,A01,083084,Eldon; John,1,4,80,79
1656321909997,CSE 30,B01,095061,Bhaskar; Nishant,0,1,50,50
1656321916020,CSE 100,A01,083659,Cao; Yingjun,1,18,70,69
1656321922044,CSE 134B,A01,083661,Powell; Thomas Allan,6,0,100,94
1656321928068,CSE 140,A01,083663,Gungor; Onat,9,0,85,76
1656321934095,CSE 140L,A01,083088,Eldon; John,10,0,100,90
1656321940120,CSE 175,A01,083665,Kumar; Rakesh,0,0,25,25
1656321946147,CSE 190,A00,092507,Dubnov; Shlomo,4,0,20,16
1656321952175,ECE 45,A01,083139,Congero; Spencer William,1,0,75,74
1656321958199,ECE 65,A50,083695,Saad; Andrew S,10,0,30,20
1656321958199,ECE 65,A51,095125,Staff,25,0,26,1
1656321964225,ECE 109,A01,091882,Touri; Behrouz,0,1,70,70
1656321970249,ECE 180,A00,083140,Abi Samra; Nicholas Camill,2,0,30,28
1656321970249,ECE 180,B00,083141,Abi Samra; Nicholas Camill,0,4,30,30
1656321976274,MATH 10A,A01,083735,Patchell; Gregory David,0,0,30,30
1656321976274,MATH 10A,A02,083736,Patchell; Gregory David,22,0,30,8
1656321976274,MATH 10A,A03,083737,Patchell; Gregory David,16,0,30,14
1656321982300,MATH 10B,A01,083207,Lim; Seonhee,2,0,34,32
1656321982300,MATH 10B,A02,083208,Lim; Seonhee,4,0,35,31
1656321982300,MATH 10B,A03,093472,Staff,1,0,34,33
1656321982300,MATH 10B,B01,083739,Sinha; Shubham,11,0,30,19
1656321988327,MATH 18,A01,083743,Cinel; Cameron Alexander,7,0,30,23
1656321988327,MATH 18,A02,083744,Cinel; Cameron Alexander,10,0,30,20
1656321988327,MATH 18,A03,083745,Cinel; Cameron Alexander,5,0,30,25
1656321988327,MATH 18,B01,083748,Rideout; David Porter,0,0,36,36
1656321988327,MATH 18,B02,083749,Rideout; David Porter,0,0,36,36
1656321988327,MATH 18,B03,083750,Rideout; David Porter,0,0,36,36
1656321988327,MATH 18,B04,083751,Rideout; David Porter,0,1,36,36
1656321988327,MATH 18,B05,093473,Rideout; David Porter,0,0,36,36
1656321988327,MATH 18,B06,093474,Rideout; David Porter,2,0,36,34
1656321994348,MATH 20A,A01,083754,Zheng; Zequn,11,0,40,29
1656322000374,MATH 20B,A01,083756,Briones; Jor-el Thomas Caparas,0,0,36,36
1656322000374,MATH 20B,A02,083757,Briones; Jor-el Thomas Caparas,0,0,36,36
1656322000374,MATH 20B,A03,093475,Staff,1,0,36,35
1656322006399,MATH 20C,A01,083760,Briones; Jor-el Thomas Caparas,0,1,35,35
1656322006399,MATH 20C,A02,083761,Briones; Jor-el Thomas Caparas,9,1,35,26
1656322006399,MATH 20C,A03,093476,Staff,0,0,35,35
1656322006399,MATH 20C,B01,083762,Bach; Quang Tran,2,0,30,28
1656322012430,MATH 20D,A01,083765,Tran; Brian Kha,1,0,30,29
1656322012430,MATH 20D,A02,083766,Tran; Brian Kha,0,0,30,30
1656322012430,MATH 20D,A03,083767,Tran; Brian Kha,2,0,30,28
1656322018454,MATH 20E,A01,083771,Ganguly; Soumya,1,0,32,31
1656322018454,MATH 20E,A02,083772,Ganguly; Soumya,0,0,32,32
1656322018454,MATH 20E,B01,083773,Ciotti; Benjamin,18,0,35,17
1656322018454,MATH 20E,B02,083774,Ciotti; Benjamin,16,0,35,19
1656322024484,MATH 103A,A01,083777,Greenfeld; Be'Eri,2,0,36,34
1656322024484,MATH 103A,A02,083778,Greenfeld; Be'Eri,4,0,36,32
1656322024484,MATH 103A,A03,093561,Staff,3,0,36,33
1656322024484,MATH 103A,B01,083779,Greenfeld; Be'Eri,7,0,36,29
1656322024484,MATH 103A,B02,083780,Greenfeld; Be'Eri,0,0,36,36
1656322024484,MATH 103A,B03,093562,Staff,1,0,36,35
1656322030508,MATH 105,A01,085443,Carter; Anne Toulson,3,0,35,32
1656322030508,MATH 105,A02,093477,Staff,15,0,35,20
1656322036532,MATH 109,A01,083213,Ganzberger; Geoffrey Michael,1,0,34,33
1656322036532,MATH 109,A02,083214,Ganzberger; Geoffrey Michael,0,0,34,34
1656322036532,MATH 109,A03,093478,Staff,2,0,34,32
1656322036532,MATH 109,B01,083215,Ganzberger; Geoffrey Michael,2,0,32,30
1656322036532,MATH 109,B02,083216,Ganzberger; Geoffrey Michael,0,0,32,32
1656322036532,MATH 109,B03,093479,Staff,4,0,32,28
1656322042557,MATH 142A,A01,083219,Chow; Bennett,0,0,32,32
1656322042557,MATH 142A,A02,083220,Chow; Bennett,8,0,32,24
1656322042557,MATH 142A,A03,093480,Staff,4,0,32,28
1656322042557,MATH 142A,B03,093481,Staff,3,0,32,29
1656322042557,MATH 142A,B04,093558,Staff,7,0,32,25
1656322042557,MATH 142A,B05,093559,Staff,1,0,32,31
1656322048580,MATH 193A,A01,083224,Rotar; Vladimir,0,1,34,34
1656322048580,MATH 193A,A02,083225,Rotar; Vladimir,0,0,34,34
1656322048580,MATH 193A,A03,083781,Rotar; Vladimir,0,0,34,34
1656322048580,MATH 193A,A04,083782,Rotar; Vladimir,5,0,34,29
1656322048580,MATH 193A,A05,093482,Rotar; Vladimir,0,0,34,34
1656322054606,MATH 197,001,091859,McAuley; Julian John,9999,0,9999,0
1656322054606,MATH 197,002,095566,Kedlaya; Kiran S.,9997,0,9999,2
1656322054606,MATH 197,003,095567,Xiao; Ming,9999,0,9999,0
1656322054606,MATH 197,004,095571,Perols; Johan Lars,9998,0,9999,1
1656322061683,COGS 9,A01,083615,Shannon; Kyle Michael,3,0,75,72
1656322067719,COGS 11,A01,083617,Boyle; Mary E. T.,17,0,48,31
1656322073748,COGS 13,A01,083071,Bastos; Amalia Pinkusfeld,5,0,71,66
1656322079771,COGS 14A,A01,092681,Semenuks; Arturs,0,7,100,104
1656322085796,COGS 14B,A01,083073,Cheng; Tzu-Han,7,0,63,56
1656322091823,COGS 17,A01,092677,Semenuks; Arturs,6,0,81,75
1656322097851,COGS 100,A01,083619,Allen; Michael Gordon,2,0,70,68
1656322103876,COGS 101A,A01,083621,Davis; Joshua Daniel,5,0,68,63
1656322109899,COGS 101B,A01,091572,Allen; Michael Gordon,4,0,65,61
1656322115927,COGS 101C,A01,083625,Delgado; Tania,11,0,35,24
1656322121951,COGS 107A,A01,083627,Boyle; Mary E. T.,2,0,60,58
1656322127981,COGS 118A,A01,083075,Gupta; Anjum,8,0,76,68
1656322134006,CSE 3,A50,083646,Miranda; Gregory Joseph,18,0,50,32
1656322140031,CSE 8A,A50,083650,Miranda; Gregory Joseph,5,2,56,51
1656322146058,CSE 11,A01,083080,Cao; Yingjun,0,46,40,40
1656322152088,CSE 12,A01,083652,Krause-Levy; Sophia Louisa,5,1,120,115
1656322158115,CSE 15L,A01,083654,Morris; Justin Loren,2,0,50,48
1656322158115,CSE 15L,A02,083655,Morris; Justin Loren,4,0,50,46
1656322164144,CSE 20,A01,083657,Tran; Khoa Dang,31,0,80,49
1656322170173,CSE 21,A01,095574,Bach; Quang Tran,23,0,48,25
1656322176198,CSE 30,A01,083084,Eldon; John,1,4,80,79
1656322176198,CSE 30,B01,095061,Bhaskar; Nishant,0,1,50,50
1656322182221,CSE 100,A01,083659,Cao; Yingjun,1,18,70,69
1656322188247,CSE 134B,A01,083661,Powell; Thomas Allan,6,0,100,94
1656322194276,CSE 140,A01,083663,Gungor; Onat,9,0,85,76
1656322200304,CSE 140L,A01,083088,Eldon; John,10,0,100,90
1656322206326,CSE 175,A01,083665,Kumar; Rakesh,0,0,25,25
1656322212354,CSE 190,A00,092507,Dubnov; Shlomo,4,0,20,16
1656322218380,ECE 45,A01,083139,Congero; Spencer William,1,0,75,74
1656322224409,ECE 65,A50,083695,Saad; Andrew S,10,0,30,20
1656322224409,ECE 65,A51,095125,Staff,25,0,26,1
1656322230436,ECE 109,A01,091882,Touri; Behrouz,0,1,70,70
1656322236461,ECE 180,A00,083140,Abi Samra; Nicholas Camill,2,0,30,28
1656322236461,ECE 180,B00,083141,Abi Samra; Nicholas Camill,0,4,30,30
1656322242797,MATH 10A,A01,083735,Patchell; Gregory David,0,0,30,30
1656322242797,MATH 10A,A02,083736,Patchell; Gregory David,22,0,30,8
1656322242797,MATH 10A,A03,083737,Patchell; Gregory David,16,0,30,14
1656322248835,MATH 10B,A01,083207,Lim; Seonhee,2,0,34,32
1656322248835,MATH 10B,A02,083208,Lim; Seonhee,4,0,35,31
1656322248835,MATH 10B,A03,093472,Staff,1,0,34,33
1656322248835,MATH 10B,B01,083739,Sinha; Shubham,11,0,30,19
1656322254870,MATH 18,A01,083743,Cinel; Cameron Alexander,7,0,30,23
1656322254870,MATH 18,A02,083744,Cinel; Cameron Alexander,10,0,30,20
1656322254870,MATH 18,A03,083745,Cinel; Cameron Alexander,5,0,30,25
1656322254870,MATH 18,B01,083748,Rideout; David Porter,0,0,36,36
1656322254870,MATH 18,B02,083749,Rideout; David Porter,0,0,36,36
1656322254870,MATH 18,B03,083750,Rideout; David Porter,0,0,36,36
1656322254870,MATH 18,B04,083751,Rideout; David Porter,0,1,36,36
1656322254870,MATH 18,B05,093473,Rideout; David Porter,0,0,36,36
1656322254870,MATH 18,B06,093474,Rideout; David Porter,2,0,36,34
1656322260906,MATH 20A,A01,083754,Zheng; Zequn,11,0,40,29
1656322266938,MATH 20B,A01,083756,Briones; Jor-el Thomas Caparas,0,0,36,36
1656322266938,MATH 20B,A02,083757,Briones; Jor-el Thomas Caparas,0,0,36,36
1656322266938,MATH 20B,A03,093475,Staff,1,0,36,35
1656322272964,MATH 20C,A01,083760,Briones; Jor-el Thomas Caparas,0,1,35,35
1656322272964,MATH 20C,A02,083761,Briones; Jor-el Thomas Caparas,9,1,35,26
1656322272964,MATH 20C,A03,093476,Staff,0,0,35,35
1656322272964,MATH 20C,B01,083762,Bach; Quang Tran,2,0,30,28
1656322278995,MATH 20D,A01,083765,Tran; Brian Kha,1,0,30,29
1656322278995,MATH 20D,A02,083766,Tran; Brian Kha,0,0,30,30
1656322278995,MATH 20D,A03,083767,Tran; Brian Kha,2,0,30,28
1656322285023,MATH 20E,A01,083771,Ganguly; Soumya,1,0,32,31
1656322285023,MATH 20E,A02,083772,Ganguly; Soumya,0,0,32,32
1656322285023,MATH 20E,B01,083773,Ciotti; Benjamin,18,0,35,17
1656322285023,MATH 20E,B02,083774,Ciotti; Benjamin,16,0,35,19
1656322291051,MATH 103A,A01,083777,Greenfeld; Be'Eri,2,0,36,34
1656322291051,MATH 103A,A02,083778,Greenfeld; Be'Eri,4,0,36,32
1656322291051,MATH 103A,A03,093561,Staff,3,0,36,33
1656322291051,MATH 103A,B01,083779,Greenfeld; Be'Eri,7,0,36,29
1656322291051,MATH 103A,B02,083780,Greenfeld; Be'Eri,0,0,36,36
1656322291051,MATH 103A,B03,093562,Staff,1,0,36,35
1656322297079,MATH 105,A01,085443,Carter; Anne Toulson,3,0,35,32
1656322297079,MATH 105,A02,093477,Staff,15,0,35,20
1656322303105,MATH 109,A01,083213,Ganzberger; Geoffrey Michael,1,0,34,33
1656322303105,MATH 109,A02,083214,Ganzberger; Geoffrey Michael,0,0,34,34
1656322303105,MATH 109,A03,093478,Staff,2,0,34,32
1656322303105,MATH 109,B01,083215,Ganzberger; Geoffrey Michael,2,0,32,30
1656322303105,MATH 109,B02,083216,Ganzberger; Geoffrey Michael,0,0,32,32
1656322303105,MATH 109,B03,093479,Staff,4,0,32,28
1656322309130,MATH 142A,A01,083219,Chow; Bennett,0,0,32,32
1656322309130,MATH 142A,A02,083220,Chow; Bennett,8,0,32,24
1656322309130,MATH 142A,A03,093480,Staff,4,0,32,28
1656322309130,MATH 142A,B03,093481,Staff,3,0,32,29
1656322309130,MATH 142A,B04,093558,Staff,7,0,32,25
1656322309130,MATH 142A,B05,093559,Staff,1,0,32,31
1656322315154,MATH 193A,A01,083224,Rotar; Vladimir,0,1,34,34
1656322315154,MATH 193A,A02,083225,Rotar; Vladimir,0,0,34,34
1656322315154,MATH 193A,A03,083781,Rotar; Vladimir,0,0,34,34
1656322315154,MATH 193A,A04,083782,Rotar; Vladimir,5,0,34,29
1656322315154,MATH 193A,A05,093482,Rotar; Vladimir,0,0,34,34
1656322321186,MATH 197,001,091859,McAuley; Julian John,9999,0,9999,0
1656322321186,MATH 197,002,095566,Kedlaya; Kiran S.,9997,0,9999,2
1656322321186,MATH 197,003,095567,Xiao; Ming,9999,0,9999,0
1656322321186,MATH 197,004,095571,Perols; Johan Lars,9998,0,9999,1
1656322328249,COGS 9,A01,083615,Shannon; Kyle Michael,3,0,75,72
1656322334279,COGS 11,A01,083617,Boyle; Mary E. T.,17,0,48,31
1656322340313,COGS 13,A01,083071,Bastos; Amalia Pinkusfeld,5,0,71,66
1656322346341,COGS 14A,A01,092681,Semenuks; Arturs,0,7,100,104
1656322352371,COGS 14B,A01,083073,Cheng; Tzu-Han,7,0,63,56
1656322358394,COGS 17,A01,092677,Semenuks; Arturs,6,0,81,75
1656322364416,COGS 100,A01,083619,Allen; Michael Gordon,2,0,70,68
1656322370447,COGS 101A,A01,083621,Davis; Joshua Daniel,5,0,68,63
1656322376475,COGS 101B,A01,091572,Allen; Michael Gordon,4,0,65,61
1656322382500,COGS 101C,A01,083625,Delgado; Tania,11,0,35,24
1656322388526,COGS 107A,A01,083627,Boyle; Mary E. T.,2,0,60,58
1656322394550,COGS 118A,A01,083075,Gupta; Anjum,8,0,76,68
1656322400576,CSE 3,A50,083646,Miranda; Gregory Joseph,18,0,50,32
1656322406605,CSE 8A,A50,083650,Miranda; Gregory Joseph,5,2,56,51
1656322412632,CSE 11,A01,083080,Cao; Yingjun,0,46,40,40
1656322418661,CSE 12,A01,083652,Krause-Levy; Sophia Louisa,5,1,120,115
1656322424689,CSE 15L,A01,083654,Morris; Justin Loren,2,0,50,48
1656322424689,CSE 15L,A02,083655,Morris; Justin Loren,4,0,50,46
1656322430714,CSE 20,A01,083657,Tran; Khoa Dang,31,0,80,49
1656322436736,CSE 21,A01,095574,Bach; Quang Tran,23,0,48,25
1656322442759,CSE 30,A01,083084,Eldon; John,1,4,80,79
1656322442759,CSE 30,B01,095061,Bhaskar; Nishant,0,1,50,50
1656322448785,CSE 100,A01,083659,Cao; Yingjun,1,18,70,69
1656322454814,CSE 134B,A01,083661,Powell; Thomas Allan,6,0,100,94
1656322460844,CSE 140,A01,083663,Gungor; Onat,9,0,85,76
1656322466868,CSE 140L,A01,083088,Eldon; John,10,0,100,90
1656322472900,CSE 175,A01,083665,Kumar; Rakesh,0,0,25,25
1656322478922,CSE 190,A00,092507,Dubnov; Shlomo,4,0,20,16
1656322484947,ECE 45,A01,083139,Congero; Spencer William,1,0,75,74
1656322490973,ECE 65,A50,083695,Saad; Andrew S,10,0,30,20
1656322490973,ECE 65,A51,095125,Staff,25,0,26,1
1656322496999,ECE 109,A01,091882,Touri; Behrouz,0,1,70,70
1656322503026,ECE 180,A00,083140,Abi Samra; Nicholas Camill,2,0,30,28
1656322503026,ECE 180,B00,083141,Abi Samra; Nicholas Camill,0,4,30,30
1656322509052,MATH 10A,A01,083735,Patchell; Gregory David,0,0,30,30
1656322509052,MATH 10A,A02,083736,Patchell; Gregory David,22,0,30,8
1656322509052,MATH 10A,A03,083737,Patchell; Gregory David,16,0,30,14
1656322515078,MATH 10B,A01,083207,Lim; Seonhee,2,0,34,32
1656322515078,MATH 10B,A02,083208,Lim; Seonhee,4,0,35,31
1656322515078,MATH 10B,A03,093472,Staff,1,0,34,33
1656322515078,MATH 10B,B01,083739,Sinha; Shubham,11,0,30,19
1656322521112,MATH 18,A01,083743,Cinel; Cameron Alexander,7,0,30,23
1656322521112,MATH 18,A02,083744,Cinel; Cameron Alexander,10,0,30,20
1656322521112,MATH 18,A03,083745,Cinel; Cameron Alexander,5,0,30,25
1656322521112,MATH 18,B01,083748,Rideout; David Porter,0,0,36,36
1656322521112,MATH 18,B02,083749,Rideout; David Porter,0,0,36,36
1656322521112,MATH 18,B03,083750,Rideout; David Porter,0,0,36,36
1656322521112,MATH 18,B04,083751,Rideout; David Porter,0,1,36,36
1656322521112,MATH 18,B05,093473,Rideout; David Porter,0,0,36,36
1656322521112,MATH 18,B06,093474,Rideout; David Porter,2,0,36,34
1656322527138,MATH 20A,A01,083754,Zheng; Zequn,11,0,40,29
1656322533168,MATH 20B,A01,083756,Briones; Jor-el Thomas Caparas,0,0,36,36
1656322533168,MATH 20B,A02,083757,Briones; Jor-el Thomas Caparas,0,0,36,36
1656322533168,MATH 20B,A03,093475,Staff,1,0,36,35
1656322539197,MATH 20C,A01,083760,Briones; Jor-el Thomas Caparas,0,1,35,35
1656322539197,MATH 20C,A02,083761,Briones; Jor-el Thomas Caparas,9,1,35,26
1656322539197,MATH 20C,A03,093476,Staff,0,0,35,35
1656322539197,MATH 20C,B01,083762,Bach; Quang Tran,2,0,30,28
1656322545221,MATH 20D,A01,083765,Tran; Brian Kha,1,0,30,29
1656322545221,MATH 20D,A02,083766,Tran; Brian Kha,0,0,30,30
1656322545221,MATH 20D,A03,083767,Tran; Brian Kha,2,0,30,28
1656322551245,MATH 20E,A01,083771,Ganguly; Soumya,1,0,32,31
1656322551245,MATH 20E,A02,083772,Ganguly; Soumya,0,0,32,32
1656322551245,MATH 20E,B01,083773,Ciotti; Benjamin,18,0,35,17
1656322551245,MATH 20E,B02,083774,Ciotti; Benjamin,16,0,35,19
1656322557277,MATH 103A,A01,083777,Greenfeld; Be'Eri,2,0,36,34
1656322557277,MATH 103A,A02,083778,Greenfeld; Be'Eri,4,0,36,32
1656322557277,MATH 103A,A03,093561,Staff,3,0,36,33
1656322557277,MATH 103A,B01,083779,Greenfeld; Be'Eri,7,0,36,29
1656322557277,MATH 103A,B02,083780,Greenfeld; Be'Eri,0,0,36,36
1656322557277,MATH 103A,B03,093562,Staff,1,0,36,35
1656322563316,MATH 105,A01,085443,Carter; Anne Toulson,3,0,35,32
1656322563316,MATH 105,A02,093477,Staff,15,0,35,20
1656322569349,MATH 109,A01,083213,Ganzberger; Geoffrey Michael,1,0,34,33
1656322569349,MATH 109,A02,083214,Ganzberger; Geoffrey Michael,0,0,34,34
1656322569349,MATH 109,A03,093478,Staff,2,0,34,32
1656322569349,MATH 109,B01,083215,Ganzberger; Geoffrey Michael,2,0,32,30
1656322569349,MATH 109,B02,083216,Ganzberger; Geoffrey Michael,0,0,32,32
1656322569349,MATH 109,B03,093479,Staff,4,0,32,28
1656322575382,MATH 142A,A01,083219,Chow; Bennett,0,0,32,32
1656322575382,MATH 142A,A02,083220,Chow; Bennett,8,0,32,24
1656322575382,MATH 142A,A03,093480,Staff,4,0,32,28
1656322575382,MATH 142A,B03,093481,Staff,3,0,32,29
1656322575382,MATH 142A,B04,093558,Staff,7,0,32,25
1656322575382,MATH 142A,B05,093559,Staff,1,0,32,31
1656322581413,MATH 193A,A01,083224,Rotar; Vladimir,0,1,34,34
1656322581413,MATH 193A,A02,083225,Rotar; Vladimir,0,0,34,34
1656322581413,MATH 193A,A03,083781,Rotar; Vladimir,0,0,34,34
1656322581413,MATH 193A,A04,083782,Rotar; Vladimir,5,0,34,29
1656322581413,MATH 193A,A05,093482,Rotar; Vladimir,0,0,34,34
1656322587440,MATH 197,001,091859,McAuley; Julian John,9999,0,9999,0
1656322587440,MATH 197,002,095566,Kedlaya; Kiran S.,9997,0,9999,2
1656322587440,MATH 197,003,095567,Xiao; Ming,9999,0,9999,0
1656322587440,MATH 197,004,095571,Perols; Johan Lars,9998,0,9999,1
1656322594506,COGS 9,A01,083615,Shannon; Kyle Michael,3,0,75,72
1656322600530,COGS 11,A01,083617,Boyle; Mary E. T.,17,0,48,31
1656322606555,COGS 13,A01,083071,Bastos; Amalia Pinkusfeld,5,0,71,66
1656322612587,COGS 14A,A01,092681,Semenuks; Arturs,0,7,100,104
1656322618619,COGS 14B,A01,083073,Cheng; Tzu-Han,7,0,63,56
1656322624642,COGS 17,A01,092677,Semenuks; Arturs,6,0,81,75
1656322630670,COGS 100,A01,083619,Allen; Michael Gordon,2,0,70,68
1656322636698,COGS 101A,A01,083621,Davis; Joshua Daniel,5,0,68,63
1656322642724,COGS 101B,A01,091572,Allen; Michael Gordon,4,0,65,61
1656322648754,COGS 101C,A01,083625,Delgado; Tania,11,0,35,24
1656322654782,COGS 107A,A01,083627,Boyle; Mary E. T.,2,0,60,58
1656322660811,COGS 118A,A01,083075,Gupta; Anjum,8,0,76,68
1656322666836,CSE 3,A50,083646,Miranda; Gregory Joseph,18,0,50,32
1656322672859,CSE 8A,A50,083650,Miranda; Gregory Joseph,5,2,56,51
1656322678883,CSE 11,A01,083080,Cao; Yingjun,0,46,40,40
1656322684913,CSE 12,A01,083652,Krause-Levy; Sophia Louisa,5,1,120,115
1656322690941,CSE 15L,A01,083654,Morris; Justin Loren,2,0,50,48
1656322690941,CSE 15L,A02,083655,Morris; Justin Loren,4,0,50,46
1656322696966,CSE 20,A01,083657,Tran; Khoa Dang,31,0,80,49
1656322702995,CSE 21,A01,095574,Bach; Quang Tran,23,0,48,25
1656322709020,CSE 30,A01,083084,Eldon; John,1,4,80,79
1656322709020,CSE 30,B01,095061,Bhaskar; Nishant,0,1,50,50
1656322715050,CSE 100,A01,083659,Cao; Yingjun,1,18,70,69
1656322721077,CSE 134B,A01,083661,Powell; Thomas Allan,6,0,100,94
1656322727102,CSE 140,A01,083663,Gungor; Onat,9,0,85,76
1656322733125,CSE 140L,A01,083088,Eldon; John,10,0,100,90
1656322739149,CSE 175,A01,083665,Kumar; Rakesh,0,0,25,25
1656322745178,CSE 190,A00,092507,Dubnov; Shlomo,4,0,20,16
1656322751203,ECE 45,A01,083139,Congero; Spencer William,1,0,75,74
1656322757234,ECE 65,A50,083695,Saad; Andrew S,10,0,30,20
1656322757234,ECE 65,A51,095125,Staff,25,0,26,1
1656322763263,ECE 109,A01,091882,Touri; Behrouz,0,1,70,70
1656322769293,ECE 180,A00,083140,Abi Samra; Nicholas Camill,2,0,30,28
1656322769293,ECE 180,B00,083141,Abi Samra; Nicholas Camill,0,4,30,30
1656322775325,MATH 10A,A01,083735,Patchell; Gregory David,0,0,30,30
1656322775325,MATH 10A,A02,083736,Patchell; Gregory David,22,0,30,8
1656322775325,MATH 10A,A03,083737,Patchell; Gregory David,16,0,30,14
1656322781348,MATH 10B,A01,083207,Lim; Seonhee,2,0,34,32
1656322781348,MATH 10B,A02,083208,Lim; Seonhee,4,0,35,31
1656322781348,MATH 10B,A03,093472,Staff,1,0,34,33
1656322781348,MATH 10B,B01,083739,Sinha; Shubham,11,0,30,19
1656322787374,MATH 18,A01,083743,Cinel; Cameron Alexander,7,0,30,23
1656322787374,MATH 18,A02,083744,Cinel; Cameron Alexander,10,0,30,20
1656322787374,MATH 18,A03,083745,Cinel; Cameron Alexander,5,0,30,25
1656322787374,MATH 18,B01,083748,Rideout; David Porter,0,0,36,36
1656322787374,MATH 18,B02,083749,Rideout; David Porter,0,0,36,36
1656322787374,MATH 18,B03,083750,Rideout; David Porter,0,0,36,36
1656322787374,MATH 18,B04,083751,Rideout; David Porter,0,1,36,36
1656322787374,MATH 18,B05,093473,Rideout; David Porter,0,0,36,36
1656322787374,MATH 18,B06,093474,Rideout; David Porter,2,0,36,34
1656322793401,MATH 20A,A01,083754,Zheng; Zequn,11,0,40,29
1656322799431,MATH 20B,A01,083756,Briones; Jor-el Thomas Caparas,0,0,36,36
1656322799431,MATH 20B,A02,083757,Briones; Jor-el Thomas Caparas,0,0,36,36
1656322799431,MATH 20B,A03,093475,Staff,1,0,36,35
1656322805455,MATH 20C,A01,083760,Briones; Jor-el Thomas Caparas,0,1,35,35
1656322805455,MATH 20C,A02,083761,Briones; Jor-el Thomas Caparas,9,1,35,26
1656322805455,MATH 20C,A03,093476,Staff,0,0,35,35
1656322805455,MATH 20C,B01,083762,Bach; Quang Tran,2,0,30,28
1656322811485,MATH 20D,A01,083765,Tran; Brian Kha,1,0,30,29
1656322811485,MATH 20D,A02,083766,Tran; Brian Kha,0,0,30,30
1656322811485,MATH 20D,A03,083767,Tran; Brian Kha,2,0,30,28
1656322817519,MATH 20E,A01,083771,Ganguly; Soumya,1,0,32,31
1656322817519,MATH 20E,A02,083772,Ganguly; Soumya,0,0,32,32
1656322817519,MATH 20E,B01,083773,Ciotti; Benjamin,18,0,35,17
1656322817519,MATH 20E,B02,083774,Ciotti; Benjamin,16,0,35,19
1656322823544,MATH 103A,A01,083777,Greenfeld; Be'Eri,2,0,36,34
1656322823544,MATH 103A,A02,083778,Greenfeld; Be'Eri,4,0,36,32
1656322823544,MATH 103A,A03,093561,Staff,3,0,36,33
1656322823544,MATH 103A,B01,083779,Greenfeld; Be'Eri,7,0,36,29
1656322823544,MATH 103A,B02,083780,Greenfeld; Be'Eri,0,0,36,36
1656322823544,MATH 103A,B03,093562,Staff,1,0,36,35
1656322829568,MATH 105,A01,085443,Carter; Anne Toulson,3,0,35,32
1656322829568,MATH 105,A02,093477,Staff,15,0,35,20
1656322835593,MATH 109,A01,083213,Ganzberger; Geoffrey Michael,1,0,34,33
1656322835593,MATH 109,A02,083214,Ganzberger; Geoffrey Michael,0,0,34,34
1656322835593,MATH 109,A03,093478,Staff,2,0,34,32
1656322835593,MATH 109,B01,083215,Ganzberger; Geoffrey Michael,2,0,32,30
1656322835593,MATH 109,B02,083216,Ganzberger; Geoffrey Michael,0,0,32,32
1656322835593,MATH 109,B03,093479,Staff,4,0,32,28
1656322841695,MATH 142A,A01,083219,Chow; Bennett,0,0,32,32
1656322841695,MATH 142A,A02,083220,Chow; Bennett,8,0,32,24
1656322841695,MATH 142A,A03,093480,Staff,4,0,32,28
1656322841695,MATH 142A,B03,093481,Staff,3,0,32,29
1656322841695,MATH 142A,B04,093558,Staff,7,0,32,25
1656322841695,MATH 142A,B05,093559,Staff,1,0,32,31
1656322847724,MATH 193A,A01,083224,Rotar; Vladimir,0,1,34,34
1656322847724,MATH 193A,A02,083225,Rotar; Vladimir,0,0,34,34
1656322847724,MATH 193A,A03,083781,Rotar; Vladimir,0,0,34,34
1656322847724,MATH 193A,A04,083782,Rotar; Vladimir,5,0,34,29
1656322847724,MATH 193A,A05,093482,Rotar; Vladimir,0,0,34,34
1656322853746,MATH 197,001,091859,McAuley; Julian John,9999,0,9999,0
1656322853746,MATH 197,002,095566,Kedlaya; Kiran S.,9997,0,9999,2
1656322853746,MATH 197,003,095567,Xiao; Ming,9999,0,9999,0
1656322853746,MATH 197,004,095571,Perols; Johan Lars,9998,0,9999,1
1656322860811,COGS 9,A01,083615,Shannon; Kyle Michael,3,0,75,72
1656322866836,COGS 11,A01,083617,Boyle; Mary E. T.,17,0,48,31
1656322872859,COGS 13,A01,083071,Bastos; Amalia Pinkusfeld,5,0,71,66
1656322878881,COGS 14A,A01,092681,Semenuks; Arturs,0,7,100,104
1656322884906,COGS 14B,A01,083073,Cheng; Tzu-Han,7,0,63,56
1656322890928,COGS 17,A01,092677,Semenuks; Arturs,6,0,81,75
1656322896951,COGS 100,A01,083619,Allen; Michael Gordon,2,0,70,68
1656322902979,COGS 101A,A01,083621,Davis; Joshua Daniel,5,0,68,63
1656322909003,COGS 101B,A01,091572,Allen; Michael Gordon,4,0,65,61
1656322915028,COGS 101C,A01,083625,Delgado; Tania,11,0,35,24
1656322921057,COGS 107A,A01,083627,Boyle; Mary E. T.,2,0,60,58
1656322927082,COGS 118A,A01,083075,Gupta; Anjum,8,0,76,68
1656322933111,CSE 3,A50,083646,Miranda; Gregory Joseph,18,0,50,32
1656322939136,CSE 8A,A50,083650,Miranda; Gregory Joseph,5,2,56,51
1656322945161,CSE 11,A01,083080,Cao; Yingjun,0,46,40,40
1656322951184,CSE 12,A01,083652,Krause-Levy; Sophia Louisa,5,1,120,115
1656322957209,CSE 15L,A01,083654,Morris; Justin Loren,2,0,50,48
1656322957209,CSE 15L,A02,083655,Morris; Justin Loren,4,0,50,46
1656322963231,CSE 20,A01,083657,Tran; Khoa Dang,31,0,80,49
1656322969255,CSE 21,A01,095574,Bach; Quang Tran,23,0,48,25
1656322975286,CSE 30,A01,083084,Eldon; John,1,4,80,79
1656322975286,CSE 30,B01,095061,Bhaskar; Nishant,0,1,50,50
1656322981310,CSE 100,A01,083659,Cao; Yingjun,1,18,70,69
1656322987340,CSE 134B,A01,083661,Powell; Thomas Allan,6,0,100,94
1656322993367,CSE 140,A01,083663,Gungor; Onat,9,0,85,76
1656322999395,CSE 140L,A01,083088,Eldon; John,10,0,100,90
1656323005421,CSE 175,A01,083665,Kumar; Rakesh,0,0,25,25
1656323011444,CSE 190,A00,092507,Dubnov; Shlomo,4,0,20,16
1656323017467,ECE 45,A01,083139,Congero; Spencer William,1,0,75,74
1656323023491,ECE 65,A50,083695,Saad; Andrew S,10,0,30,20
1656323023491,ECE 65,A51,095125,Staff,25,0,26,1
1656323029514,ECE 109,A01,091882,Touri; Behrouz,0,1,70,70
1656323035536,ECE 180,A00,083140,Abi Samra; Nicholas Camill,2,0,30,28
1656323035536,ECE 180,B00,083141,Abi Samra; Nicholas Camill,0,4,30,30
1656323041565,MATH 10A,A01,083735,Patchell; Gregory David,0,0,30,30
1656323041565,MATH 10A,A02,083736,Patchell; Gregory David,22,0,30,8
1656323041565,MATH 10A,A03,083737,Patchell; Gregory David,16,0,30,14
1656323047597,MATH 10B,A01,083207,Lim; Seonhee,2,0,34,32
1656323047597,MATH 10B,A02,083208,Lim; Seonhee,4,0,35,31
1656323047597,MATH 10B,A03,093472,Staff,1,0,34,33
1656323047597,MATH 10B,B01,083739,Sinha; Shubham,11,0,30,19
1656323053623,MATH 18,A01,083743,Cinel; Cameron Alexander,7,0,30,23
1656323053623,MATH 18,A02,083744,Cinel; Cameron Alexander,10,0,30,20
1656323053623,MATH 18,A03,083745,Cinel; Cameron Alexander,5,0,30,25
1656323053623,MATH 18,B01,083748,Rideout; David Porter,0,0,36,36
1656323053623,MATH 18,B02,083749,Rideout; David Porter,0,0,36,36
1656323053623,MATH 18,B03,083750,Rideout; David Porter,0,0,36,36
1656323053623,MATH 18,B04,083751,Rideout; David Porter,0,1,36,36
1656323053623,MATH 18,B05,093473,Rideout; David Porter,0,0,36,36
1656323053623,MATH 18,B06,093474,Rideout; David Porter,2,0,36,34
1656323059645,MATH 20A,A01,083754,Zheng; Zequn,11,0,40,29
1656323065676,MATH 20B,A01,083756,Briones; Jor-el Thomas Caparas,0,0,36,36
1656323065676,MATH 20B,A02,083757,Briones; Jor-el Thomas Caparas,0,0,36,36
1656323065676,MATH 20B,A03,093475,Staff,1,0,36,35
1656323071705,MATH 20C,A01,083760,Briones; Jor-el Thomas Caparas,0,1,35,35
1656323071705,MATH 20C,A02,083761,Briones; Jor-el Thomas Caparas,9,1,35,26
1656323071705,MATH 20C,A03,093476,Staff,0,0,35,35
1656323071705,MATH 20C,B01,083762,Bach; Quang Tran,2,0,30,28
1656323077730,MATH 20D,A01,083765,Tran; Brian Kha,1,0,30,29
1656323077730,MATH 20D,A02,083766,Tran; Brian Kha,0,0,30,30
1656323077730,MATH 20D,A03,083767,Tran; Brian Kha,2,0,30,28
1656323083755,MATH 20E,A01,083771,Ganguly; Soumya,1,0,32,31
1656323083755,MATH 20E,A02,083772,Ganguly; Soumya,0,0,32,32
1656323083755,MATH 20E,B01,083773,Ciotti; Benjamin,18,0,35,17
1656323083755,MATH 20E,B02,083774,Ciotti; Benjamin,16,0,35,19
1656323089781,MATH 103A,A01,083777,Greenfeld; Be'Eri,2,0,36,34
1656323089781,MATH 103A,A02,083778,Greenfeld; Be'Eri,4,0,36,32
1656323089781,MATH 103A,A03,093561,Staff,3,0,36,33
1656323089781,MATH 103A,B01,083779,Greenfeld; Be'Eri,7,0,36,29
1656323089781,MATH 103A,B02,083780,Greenfeld; Be'Eri,0,0,36,36
1656323089781,MATH 103A,B03,093562,Staff,1,0,36,35
1656323095805,MATH 105,A01,085443,Carter; Anne Toulson,3,0,35,32
1656323095805,MATH 105,A02,093477,Staff,15,0,35,20
1656323101836,MATH 109,A01,083213,Ganzberger; Geoffrey Michael,1,0,34,33
1656323101836,MATH 109,A02,083214,Ganzberger; Geoffrey Michael,0,0,34,34
1656323101836,MATH 109,A03,093478,Staff,2,0,34,32
1656323101836,MATH 109,B01,083215,Ganzberger; Geoffrey Michael,2,0,32,30
1656323101836,MATH 109,B02,083216,Ganzberger; Geoffrey Michael,0,0,32,32
1656323101836,MATH 109,B03,093479,Staff,4,0,32,28
1656323107862,MATH 142A,A01,083219,Chow; Bennett,0,0,32,32
1656323107862,MATH 142A,A02,083220,Chow; Bennett,8,0,32,24
1656323107862,MATH 142A,A03,093480,Staff,4,0,32,28
1656323107862,MATH 142A,B03,093481,Staff,3,0,32,29
1656323107862,MATH 142A,B04,093558,Staff,7,0,32,25
1656323107862,MATH 142A,B05,093559,Staff,1,0,32,31
1656323113893,MATH 193A,A01,083224,Rotar; Vladimir,0,1,34,34
1656323113893,MATH 193A,A02,083225,Rotar; Vladimir,0,0,34,34
1656323113893,MATH 193A,A03,083781,Rotar; Vladimir,0,0,34,34
1656323113893,MATH 193A,A04,083782,Rotar; Vladimir,5,0,34,29
1656323113893,MATH 193A,A05,093482,Rotar; Vladimir,0,0,34,34
1656323119922,MATH 197,001,091859,McAuley; Julian John,9999,0,9999,0
1656323119922,MATH 197,002,095566,Kedlaya; Kiran S.,9997,0,9999,2
1656323119922,MATH 197,003,095567,Xiao; Ming,9999,0,9999,0
1656323119922,MATH 197,004,095571,Perols; Johan Lars,9998,0,9999,1
1656323126988,COGS 9,A01,083615,Shannon; Kyle Michael,3,0,75,72
1656323133023,COGS 11,A01,083617,Boyle; Mary E. T.,17,0,48,31
1656323139052,COGS 13,A01,083071,Bastos; Amalia Pinkusfeld,5,0,71,66
1656323145077,COGS 14A,A01,092681,Semenuks; Arturs,0,7,100,104
1656323151102,COGS 14B,A01,083073,Cheng; Tzu-Han,7,0,63,56
1656323157124,COGS 17,A01,092677,Semenuks; Arturs,6,0,81,75
1656323163153,COGS 100,A01,083619,Allen; Michael Gordon,2,0,70,68
1656323169178,COGS 101A,A01,083621,Davis; Joshua Daniel,5,0,68,63
1656323175204,COGS 101B,A01,091572,Allen; Michael Gordon,4,0,65,61
1656323181232,COGS 101C,A01,083625,Delgado; Tania,11,0,35,24
1656323187256,COGS 107A,A01,083627,Boyle; Mary E. T.,2,0,60,58
1656323193280,COGS 118A,A01,083075,Gupta; Anjum,8,0,76,68
1656323199302,CSE 3,A50,083646,Miranda; Gregory Joseph,18,0,50,32
1656323205331,CSE 8A,A50,083650,Miranda; Gregory Joseph,5,2,56,51
1656323211359,CSE 11,A01,083080,Cao; Yingjun,0,46,40,40
1656323217388,CSE 12,A01,083652,Krause-Levy; Sophia Louisa,5,1,120,115
1656323223411,CSE 15L,A01,083654,Morris; Justin Loren,2,0,50,48
1656323223411,CSE 15L,A02,083655,Morris; Justin Loren,4,0,50,46
1656323229439,CSE 20,A01,083657,Tran; Khoa Dang,31,0,80,49
1656323235470,CSE 21,A01,095574,Bach; Quang Tran,23,0,48,25
1656323241500,CSE 30,A01,083084,Eldon; John,1,4,80,79
1656323241500,CSE 30,B01,095061,Bhaskar; Nishant,0,1,50,50
1656323247528,CSE 100,A01,083659,Cao; Yingjun,1,18,70,69
1656323253553,CSE 134B,A01,083661,Powell; Thomas Allan,7,0,100,93
1656323259578,CSE 140,A01,083663,Gungor; Onat,9,0,85,76
1656323265608,CSE 140L,A01,083088,Eldon; John,10,0,100,90
1656323271635,CSE 175,A01,083665,Kumar; Rakesh,0,0,25,25
1656323277661,CSE 190,A00,092507,Dubnov; Shlomo,4,0,20,16
1656323283686,ECE 45,A01,083139,Congero; Spencer William,1,0,75,74
1656323289710,ECE 65,A50,083695,Saad; Andrew S,10,0,30,20
1656323289710,ECE 65,A51,095125,Staff,25,0,26,1
1656323295740,ECE 109,A01,091882,Touri; Behrouz,0,1,70,70
1656323301762,ECE 180,A00,083140,Abi Samra; Nicholas Camill,2,0,30,28
1656323301762,ECE 180,B00,083141,Abi Samra; Nicholas Camill,0,4,30,30
1656323307790,MATH 10A,A01,083735,Patchell; Gregory David,0,0,30,30
1656323307790,MATH 10A,A02,083736,Patchell; Gregory David,22,0,30,8
1656323307790,MATH 10A,A03,083737,Patchell; Gregory David,16,0,30,14
1656323313825,MATH 10B,A01,083207,Lim; Seonhee,2,0,34,32
1656323313825,MATH 10B,A02,083208,Lim; Seonhee,4,0,35,31
1656323313825,MATH 10B,A03,093472,Staff,1,0,34,33
1656323313825,MATH 10B,B01,083739,Sinha; Shubham,11,0,30,19
1656323319850,MATH 18,A01,083743,Cinel; Cameron Alexander,7,0,30,23
1656323319850,MATH 18,A02,083744,Cinel; Cameron Alexander,10,0,30,20
1656323319850,MATH 18,A03,083745,Cinel; Cameron Alexander,5,0,30,25
1656323319850,MATH 18,B01,083748,Rideout; David Porter,0,0,36,36
1656323319850,MATH 18,B02,083749,Rideout; David Porter,0,0,36,36
1656323319850,MATH 18,B03,083750,Rideout; David Porter,0,0,36,36
1656323319850,MATH 18,B04,083751,Rideout; David Porter,0,1,36,36
1656323319850,MATH 18,B05,093473,Rideout; David Porter,0,0,36,36
1656323319850,MATH 18,B06,093474,Rideout; David Porter,2,0,36,34
1656323325876,MATH 20A,A01,083754,Zheng; Zequn,11,0,40,29
1656323331902,MATH 20B,A01,083756,Briones; Jor-el Thomas Caparas,0,0,36,36
1656323331902,MATH 20B,A02,083757,Briones; Jor-el Thomas Caparas,0,0,36,36
1656323331902,MATH 20B,A03,093475,Staff,1,0,36,35
1656323337925,MATH 20C,A01,083760,Briones; Jor-el Thomas Caparas,0,1,35,35
1656323337925,MATH 20C,A02,083761,Briones; Jor-el Thomas Caparas,9,1,35,26
1656323337925,MATH 20C,A03,093476,Staff,0,0,35,35
1656323337925,MATH 20C,B01,083762,Bach; Quang Tran,2,0,30,28
1656323343950,MATH 20D,A01,083765,Tran; Brian Kha,1,0,30,29
1656323343950,MATH 20D,A02,083766,Tran; Brian Kha,0,0,30,30
1656323343950,MATH 20D,A03,083767,Tran; Brian Kha,2,0,30,28
1656323349980,MATH 20E,A01,083771,Ganguly; Soumya,1,0,32,31
1656323349980,MATH 20E,A02,083772,Ganguly; Soumya,0,0,32,32
1656323349980,MATH 20E,B01,083773,Ciotti; Benjamin,18,0,35,17
1656323349980,MATH 20E,B02,083774,Ciotti; Benjamin,16,0,35,19
1656323356013,MATH 103A,A01,083777,Greenfeld; Be'Eri,2,0,36,34
1656323356013,MATH 103A,A02,083778,Greenfeld; Be'Eri,4,0,36,32
1656323356013,MATH 103A,A03,093561,Staff,3,0,36,33
1656323356013,MATH 103A,B01,083779,Greenfeld; Be'Eri,7,0,36,29
1656323356013,MATH 103A,B02,083780,Greenfeld; Be'Eri,0,0,36,36
1656323356013,MATH 103A,B03,093562,Staff,1,0,36,35
1656323362041,MATH 105,A01,085443,Carter; Anne Toulson,3,0,35,32
1656323362041,MATH 105,A02,093477,Staff,15,0,35,20
1656323368066,MATH 109,A01,083213,Ganzberger; Geoffrey Michael,1,0,34,33
1656323368066,MATH 109,A02,083214,Ganzberger; Geoffrey Michael,0,0,34,34
1656323368066,MATH 109,A03,093478,Staff,2,0,34,32
1656323368066,MATH 109,B01,083215,Ganzberger; Geoffrey Michael,2,0,32,30
1656323368066,MATH 109,B02,083216,Ganzberger; Geoffrey Michael,0,0,32,32
1656323368066,MATH 109,B03,093479,Staff,4,0,32,28
1656323374091,MATH 142A,A01,083219,Chow; Bennett,0,0,32,32
1656323374091,MATH 142A,A02,083220,Chow; Bennett,8,0,32,24
1656323374091,MATH 142A,A03,093480,Staff,4,0,32,28
1656323374091,MATH 142A,B03,093481,Staff,3,0,32,29
1656323374091,MATH 142A,B04,093558,Staff,7,0,32,25
1656323374091,MATH 142A,B05,093559,Staff,1,0,32,31
1656323380116,MATH 193A,A01,083224,Rotar; Vladimir,0,1,34,34
1656323380116,MATH 193A,A02,083225,Rotar; Vladimir,0,0,34,34
1656323380116,MATH 193A,A03,083781,Rotar; Vladimir,0,0,34,34
1656323380116,MATH 193A,A04,083782,Rotar; Vladimir,5,0,34,29
1656323380116,MATH 193A,A05,093482,Rotar; Vladimir,0,0,34,34
1656323386140,MATH 197,001,091859,McAuley; Julian John,9999,0,9999,0
1656323386140,MATH 197,002,095566,Kedlaya; Kiran S.,9997,0,9999,2
1656323386140,MATH 197,003,095567,Xiao; Ming,9999,0,9999,0
1656323386140,MATH 197,004,095571,Perols; Johan Lars,9998,0,9999,1
1656323393210,COGS 9,A01,083615,Shannon; Kyle Michael,3,0,75,72
1656323399236,COGS 11,A01,083617,Boyle; Mary E. T.,17,0,48,31
1656323405265,COGS 13,A01,083071,Bastos; Amalia Pinkusfeld,5,0,71,66
1656323411289,COGS 14A,A01,092681,Semenuks; Arturs,0,7,100,104
1656323417315,COGS 14B,A01,083073,Cheng; Tzu-Han,7,0,63,56
1656323423338,COGS 17,A01,092677,Semenuks; Arturs,6,0,81,75
1656323429362,COGS 100,A01,083619,Allen; Michael Gordon,2,0,70,68
1656323435478,COGS 101A,A01,083621,Davis; Joshua Daniel,5,0,68,63
1656323441502,COGS 101B,A01,091572,Allen; Michael Gordon,4,0,65,61
1656323447527,COGS 101C,A01,083625,Delgado; Tania,11,0,35,24
1656323453551,COGS 107A,A01,083627,Boyle; Mary E. T.,2,0,60,58
1656323459576,COGS 118A,A01,083075,Gupta; Anjum,8,0,76,68
1656323465599,CSE 3,A50,083646,Miranda; Gregory Joseph,18,0,50,32
1656323471627,CSE 8A,A50,083650,Miranda; Gregory Joseph,5,2,56,51
1656323477650,CSE 11,A01,083080,Cao; Yingjun,0,46,40,40
1656323483674,CSE 12,A01,083652,Krause-Levy; Sophia Louisa,5,1,120,115
1656323489701,CSE 15L,A01,083654,Morris; Justin Loren,2,0,50,48
1656323489701,CSE 15L,A02,083655,Morris; Justin Loren,4,0,50,46
1656323495725,CSE 20,A01,083657,Tran; Khoa Dang,31,0,80,49
1656323501753,CSE 21,A01,095574,Bach; Quang Tran,23,0,48,25
1656323507777,CSE 30,A01,083084,Eldon; John,1,4,80,79
1656323507777,CSE 30,B01,095061,Bhaskar; Nishant,0,1,50,50
1656323513805,CSE 100,A01,083659,Cao; Yingjun,1,18,70,69
1656323519828,CSE 134B,A01,083661,Powell; Thomas Allan,7,0,100,93
1656323525859,CSE 140,A01,083663,Gungor; Onat,9,0,85,76
1656323531887,CSE 140L,A01,083088,Eldon; John,10,0,100,90
1656323537911,CSE 175,A01,083665,Kumar; Rakesh,0,0,25,25
1656323543937,CSE 190,A00,092507,Dubnov; Shlomo,4,0,20,16
1656323549966,ECE 45,A01,083139,Congero; Spencer William,1,0,75,74
1656323555989,ECE 65,A50,083695,Saad; Andrew S,10,0,30,20
1656323555989,ECE 65,A51,095125,Staff,25,0,26,1
1656323562012,ECE 109,A01,091882,Touri; Behrouz,0,1,70,70
1656323568043,ECE 180,A00,083140,Abi Samra; Nicholas Camill,2,0,30,28
1656323568043,ECE 180,B00,083141,Abi Samra; Nicholas Camill,0,4,30,30
1656323574067,MATH 10A,A01,083735,Patchell; Gregory David,0,0,30,30
1656323574067,MATH 10A,A02,083736,Patchell; Gregory David,22,0,30,8
1656323574067,MATH 10A,A03,083737,Patchell; Gregory David,16,0,30,14
1656323580091,MATH 10B,A01,083207,Lim; Seonhee,2,0,34,32
1656323580091,MATH 10B,A02,083208,Lim; Seonhee,4,0,35,31
1656323580091,MATH 10B,A03,093472,Staff,1,0,34,33
1656323580091,MATH 10B,B01,083739,Sinha; Shubham,11,0,30,19
1656323586116,MATH 18,A01,083743,Cinel; Cameron Alexander,7,0,30,23
1656323586116,MATH 18,A02,083744,Cinel; Cameron Alexander,10,0,30,20
1656323586116,MATH 18,A03,083745,Cinel; Cameron Alexander,5,0,30,25
1656323586116,MATH 18,B01,083748,Rideout; David Porter,0,0,36,36
1656323586116,MATH 18,B02,083749,Rideout; David Porter,0,0,36,36
1656323586116,MATH 18,B03,083750,Rideout; David Porter,0,0,36,36
1656323586116,MATH 18,B04,083751,Rideout; David Porter,0,1,36,36
1656323586116,MATH 18,B05,093473,Rideout; David Porter,0,0,36,36
1656323586116,MATH 18,B06,093474,Rideout; David Porter,2,0,36,34
1656323592141,MATH 20A,A01,083754,Zheng; Zequn,11,0,40,29
1656323598165,MATH 20B,A01,083756,Briones; Jor-el Thomas Caparas,0,0,36,36
1656323598165,MATH 20B,A02,083757,Briones; Jor-el Thomas Caparas,0,0,36,36
1656323598165,MATH 20B,A03,093475,Staff,1,0,36,35
1656323604192,MATH 20C,A01,083760,Briones; Jor-el Thomas Caparas,0,1,35,35
1656323604192,MATH 20C,A02,083761,Briones; Jor-el Thomas Caparas,9,1,35,26
1656323604192,MATH 20C,A03,093476,Staff,0,0,35,35
1656323604192,MATH 20C,B01,083762,Bach; Quang Tran,2,0,30,28
1656323610221,MATH 20D,A01,083765,Tran; Brian Kha,1,0,30,29
1656323610221,MATH 20D,A02,083766,Tran; Brian Kha,0,0,30,30
1656323610221,MATH 20D,A03,083767,Tran; Brian Kha,2,0,30,28
1656323616245,MATH 20E,A01,083771,Ganguly; Soumya,1,0,32,31
1656323616245,MATH 20E,A02,083772,Ganguly; Soumya,0,0,32,32
1656323616245,MATH 20E,B01,083773,Ciotti; Benjamin,18,0,35,17
1656323616245,MATH 20E,B02,083774,Ciotti; Benjamin,16,0,35,19
1656323622270,MATH 103A,A01,083777,Greenfeld; Be'Eri,2,0,36,34
1656323622270,MATH 103A,A02,083778,Greenfeld; Be'Eri,4,0,36,32
1656323622270,MATH 103A,A03,093561,Staff,3,0,36,33
1656323622270,MATH 103A,B01,083779,Greenfeld; Be'Eri,7,0,36,29
1656323622270,MATH 103A,B02,083780,Greenfeld; Be'Eri,0,0,36,36
1656323622270,MATH 103A,B03,093562,Staff,1,0,36,35
1656323628294,MATH 105,A01,085443,Carter; Anne Toulson,3,0,35,32
1656323628294,MATH 105,A02,093477,Staff,15,0,35,20
1656323634344,MATH 109,A01,083213,Ganzberger; Geoffrey Michael,1,0,34,33
1656323634344,MATH 109,A02,083214,Ganzberger; Geoffrey Michael,0,0,34,34
1656323634344,MATH 109,A03,093478,Staff,2,0,34,32
1656323634344,MATH 109,B01,083215,Ganzberger; Geoffrey Michael,2,0,32,30
1656323634344,MATH 109,B02,083216,Ganzberger; Geoffrey Michael,0,0,32,32
1656323634344,MATH 109,B03,093479,Staff,4,0,32,28
1656323640369,MATH 142A,A01,083219,Chow; Bennett,0,0,32,32
1656323640369,MATH 142A,A02,083220,Chow; Bennett,8,0,32,24
1656323640369,MATH 142A,A03,093480,Staff,4,0,32,28
1656323640369,MATH 142A,B03,093481,Staff,3,0,32,29
1656323640369,MATH 142A,B04,093558,Staff,7,0,32,25
1656323640369,MATH 142A,B05,093559,Staff,1,0,32,31
1656323646390,MATH 193A,A01,083224,Rotar; Vladimir,0,1,34,34
1656323646390,MATH 193A,A02,083225,Rotar; Vladimir,0,0,34,34
1656323646390,MATH 193A,A03,083781,Rotar; Vladimir,0,0,34,34
1656323646390,MATH 193A,A04,083782,Rotar; Vladimir,5,0,34,29
1656323646390,MATH 193A,A05,093482,Rotar; Vladimir,0,0,34,34
1656323652413,MATH 197,001,091859,McAuley; Julian John,9999,0,9999,0
1656323652413,MATH 197,002,095566,Kedlaya; Kiran S.,9997,0,9999,2
1656323652413,MATH 197,003,095567,Xiao; Ming,9999,0,9999,0
1656323652413,MATH 197,004,095571,Perols; Johan Lars,9998,0,9999,1
1656323659484,COGS 9,A01,083615,Shannon; Kyle Michael,3,0,75,72
1656323665510,COGS 11,A01,083617,Boyle; Mary E. T.,17,0,48,31
1656323671532,COGS 13,A01,083071,Bastos; Amalia Pinkusfeld,5,0,71,66
1656323677554,COGS 14A,A01,092681,Semenuks; Arturs,0,7,100,104
1656323683581,COGS 14B,A01,083073,Cheng; Tzu-Han,7,0,63,56
1656323689603,COGS 17,A01,092677,Semenuks; Arturs,6,0,81,75
1656323695627,COGS 100,A01,083619,Allen; Michael Gordon,2,0,70,68
1656323701654,COGS 101A,A01,083621,Davis; Joshua Daniel,5,0,68,63
1656323707677,COGS 101B,A01,091572,Allen; Michael Gordon,4,0,65,61
1656323713706,COGS 101C,A01,083625,Delgado; Tania,11,0,35,24
1656323719729,COGS 107A,A01,083627,Boyle; Mary E. T.,2,0,60,58
1656323725753,COGS 118A,A01,083075,Gupta; Anjum,8,0,76,68
1656323731778,CSE 3,A50,083646,Miranda; Gregory Joseph,18,0,50,32
1656323737803,CSE 8A,A50,083650,Miranda; Gregory Joseph,5,2,56,51
1656323743831,CSE 11,A01,083080,Cao; Yingjun,0,46,40,40
1656323749853,CSE 12,A01,083652,Krause-Levy; Sophia Louisa,5,1,120,115
1656323755880,CSE 15L,A01,083654,Morris; Justin Loren,2,0,50,48
1656323755880,CSE 15L,A02,083655,Morris; Justin Loren,4,0,50,46
1656323761907,CSE 20,A01,083657,Tran; Khoa Dang,31,0,80,49
1656323767939,CSE 21,A01,095574,Bach; Quang Tran,23,0,48,25
1656323773970,CSE 30,A01,083084,Eldon; John,1,4,80,79
1656323773970,CSE 30,B01,095061,Bhaskar; Nishant,0,1,50,50
1656323779995,CSE 100,A01,083659,Cao; Yingjun,1,18,70,69
1656323786022,CSE 134B,A01,083661,Powell; Thomas Allan,7,0,100,93
1656323792049,CSE 140,A01,083663,Gungor; Onat,9,0,85,76
1656323798083,CSE 140L,A01,083088,Eldon; John,10,0,100,90
1656323804127,CSE 175,A01,083665,Kumar; Rakesh,0,0,25,25
1656323810154,CSE 190,A00,092507,Dubnov; Shlomo,4,0,20,16
1656323816178,ECE 45,A01,083139,Congero; Spencer William,1,0,75,74
1656323822203,ECE 65,A50,083695,Saad; Andrew S,10,0,30,20
1656323822203,ECE 65,A51,095125,Staff,25,0,26,1
1656323828225,ECE 109,A01,091882,Touri; Behrouz,0,1,70,70
1656323834252,ECE 180,A00,083140,Abi Samra; Nicholas Camill,2,0,30,28
1656323834252,ECE 180,B00,083141,Abi Samra; Nicholas Camill,0,4,30,30
1656323840280,MATH 10A,A01,083735,Patchell; Gregory David,0,0,30,30
1656323840280,MATH 10A,A02,083736,Patchell; Gregory David,22,0,30,8
1656323840280,MATH 10A,A03,083737,Patchell; Gregory David,16,0,30,14
1656323846305,MATH 10B,A01,083207,Lim; Seonhee,2,0,34,32
1656323846305,MATH 10B,A02,083208,Lim; Seonhee,4,0,35,31
1656323846305,MATH 10B,A03,093472,Staff,1,0,34,33
1656323846305,MATH 10B,B01,083739,Sinha; Shubham,11,0,30,19
1656323852331,MATH 18,A01,083743,Cinel; Cameron Alexander,7,0,30,23
1656323852331,MATH 18,A02,083744,Cinel; Cameron Alexander,10,0,30,20
1656323852331,MATH 18,A03,083745,Cinel; Cameron Alexander,5,0,30,25
1656323852331,MATH 18,B01,083748,Rideout; David Porter,0,0,36,36
1656323852331,MATH 18,B02,083749,Rideout; David Porter,0,0,36,36
1656323852331,MATH 18,B03,083750,Rideout; David Porter,0,0,36,36
1656323852331,MATH 18,B04,083751,Rideout; David Porter,0,1,36,36
1656323852331,MATH 18,B05,093473,Rideout; David Porter,0,0,36,36
1656323852331,MATH 18,B06,093474,Rideout; David Porter,2,0,36,34
1656323858354,MATH 20A,A01,083754,Zheng; Zequn,11,0,40,29
1656323864383,MATH 20B,A01,083756,Briones; Jor-el Thomas Caparas,0,0,36,36
1656323864383,MATH 20B,A02,083757,Briones; Jor-el Thomas Caparas,0,0,36,36
1656323864383,MATH 20B,A03,093475,Staff,1,0,36,35
1656323870407,MATH 20C,A01,083760,Briones; Jor-el Thomas Caparas,0,1,35,35
1656323870407,MATH 20C,A02,083761,Briones; Jor-el Thomas Caparas,9,1,35,26
1656323870407,MATH 20C,A03,093476,Staff,0,0,35,35
1656323870407,MATH 20C,B01,083762,Bach; Quang Tran,2,0,30,28
1656323876431,MATH 20D,A01,083765,Tran; Brian Kha,1,0,30,29
1656323876431,MATH 20D,A02,083766,Tran; Brian Kha,0,0,30,30
1656323876431,MATH 20D,A03,083767,Tran; Brian Kha,2,0,30,28
1656323882457,MATH 20E,A01,083771,Ganguly; Soumya,1,0,32,31
1656323882457,MATH 20E,A02,083772,Ganguly; Soumya,0,0,32,32
1656323882457,MATH 20E,B01,083773,Ciotti; Benjamin,18,0,35,17
1656323882457,MATH 20E,B02,083774,Ciotti; Benjamin,16,0,35,19
1656323888483,MATH 103A,A01,083777,Greenfeld; Be'Eri,2,0,36,34
1656323888483,MATH 103A,A02,083778,Greenfeld; Be'Eri,4,0,36,32
1656323888483,MATH 103A,A03,093561,Staff,3,0,36,33
1656323888483,MATH 103A,B01,083779,Greenfeld; Be'Eri,7,0,36,29
1656323888483,MATH 103A,B02,083780,Greenfeld; Be'Eri,0,0,36,36
1656323888483,MATH 103A,B03,093562,Staff,1,0,36,35
1656323894513,MATH 105,A01,085443,Carter; Anne Toulson,3,0,35,32
1656323894513,MATH 105,A02,093477,Staff,15,0,35,20
1656323900542,MATH 109,A01,083213,Ganzberger; Geoffrey Michael,1,0,34,33
1656323900542,MATH 109,A02,083214,Ganzberger; Geoffrey Michael,0,0,34,34
1656323900542,MATH 109,A03,093478,Staff,2,0,34,32
1656323900542,MATH 109,B01,083215,Ganzberger; Geoffrey Michael,2,0,32,30
1656323900542,MATH 109,B02,083216,Ganzberger; Geoffrey Michael,0,0,32,32
1656323900542,MATH 109,B03,093479,Staff,4,0,32,28
1656323906570,MATH 142A,A01,083219,Chow; Bennett,0,0,32,32
1656323906570,MATH 142A,A02,083220,Chow; Bennett,8,0,32,24
1656323906570,MATH 142A,A03,093480,Staff,4,0,32,28
1656323906570,MATH 142A,B03,093481,Staff,3,0,32,29
1656323906570,MATH 142A,B04,093558,Staff,7,0,32,25
1656323906570,MATH 142A,B05,093559,Staff,1,0,32,31
1656323912594,MATH 193A,A01,083224,Rotar; Vladimir,0,1,34,34
1656323912594,MATH 193A,A02,083225,Rotar; Vladimir,0,0,34,34
1656323912594,MATH 193A,A03,083781,Rotar; Vladimir,0,0,34,34
1656323912594,MATH 193A,A04,083782,Rotar; Vladimir,5,0,34,29
1656323912594,MATH 193A,A05,093482,Rotar; Vladimir,0,0,34,34
1656323918621,MATH 197,001,091859,McAuley; Julian John,9999,0,9999,0
1656323918621,MATH 197,002,095566,Kedlaya; Kiran S.,9997,0,9999,2
1656323918621,MATH 197,003,095567,Xiao; Ming,9999,0,9999,0
1656323918621,MATH 197,004,095571,Perols; Johan Lars,9998,0,9999,1
1656323925685,COGS 9,A01,083615,Shannon; Kyle Michael,3,0,75,72
1656323931707,COGS 11,A01,083617,Boyle; Mary E. T.,17,0,48,31
1656323937736,COGS 13,A01,083071,Bastos; Amalia Pinkusfeld,5,0,71,66
1656323943762,COGS 14A,A01,092681,Semenuks; Arturs,0,7,100,104
1656323949796,COGS 14B,A01,083073,Cheng; Tzu-Han,7,0,63,56
1656323955823,COGS 17,A01,092677,Semenuks; Arturs,6,0,81,75
1656323961845,COGS 100,A01,083619,Allen; Michael Gordon,2,0,70,68
1656323967873,COGS 101A,A01,083621,Davis; Joshua Daniel,5,0,68,63
1656323973896,COGS 101B,A01,091572,Allen; Michael Gordon,4,0,65,61
1656323979920,COGS 101C,A01,083625,Delgado; Tania,11,0,35,24
1656323985947,COGS 107A,A01,083627,Boyle; Mary E. T.,2,0,60,58
1656323991972,COGS 118A,A01,083075,Gupta; Anjum,8,0,76,68
1656323997995,CSE 3,A50,083646,Miranda; Gregory Joseph,18,0,50,32
1656324004025,CSE 8A,A50,083650,Miranda; Gregory Joseph,5,2,56,51
1656324010052,CSE 11,A01,083080,Cao; Yingjun,0,46,40,40
1656324016077,CSE 12,A01,083652,Krause-Levy; Sophia Louisa,5,1,120,115
1656324022104,CSE 15L,A01,083654,Morris; Justin Loren,2,0,50,48
1656324022104,CSE 15L,A02,083655,Morris; Justin Loren,4,0,50,46
1656324028129,CSE 20,A01,083657,Tran; Khoa Dang,31,0,80,49
1656324034236,CSE 21,A01,095574,Bach; Quang Tran,23,0,48,25
1656324040260,CSE 30,A01,083084,Eldon; John,1,4,80,79
1656324040260,CSE 30,B01,095061,Bhaskar; Nishant,0,1,50,50
1656324046287,CSE 100,A01,083659,Cao; Yingjun,1,18,70,69
1656324052315,CSE 134B,A01,083661,Powell; Thomas Allan,7,0,100,93
1656324058342,CSE 140,A01,083663,Gungor; Onat,9,0,85,76
1656324064367,CSE 140L,A01,083088,Eldon; John,10,0,100,90
1656324070396,CSE 175,A01,083665,Kumar; Rakesh,0,0,25,25
1656324076420,CSE 190,A00,092507,Dubnov; Shlomo,4,0,20,16
1656324082448,ECE 45,A01,083139,Congero; Spencer William,1,0,75,74
1656324088475,ECE 65,A50,083695,Saad; Andrew S,10,0,30,20
1656324088475,ECE 65,A51,095125,Staff,25,0,26,1
1656324094499,ECE 109,A01,091882,Touri; Behrouz,0,1,70,70
1656324100525,ECE 180,A00,083140,Abi Samra; Nicholas Camill,2,0,30,28
1656324100525,ECE 180,B00,083141,Abi Samra; Nicholas Camill,0,4,30,30
1656324106549,MATH 10A,A01,083735,Patchell; Gregory David,0,0,30,30
1656324106549,MATH 10A,A02,083736,Patchell; Gregory David,22,0,30,8
1656324106549,MATH 10A,A03,083737,Patchell; Gregory David,16,0,30,14
1656324112578,MATH 10B,A01,083207,Lim; Seonhee,2,0,34,32
1656324112578,MATH 10B,A02,083208,Lim; Seonhee,4,0,35,31
1656324112578,MATH 10B,A03,093472,Staff,1,0,34,33
1656324112578,MATH 10B,B01,083739,Sinha; Shubham,11,0,30,19
1656324118610,MATH 18,A01,083743,Cinel; Cameron Alexander,7,0,30,23
1656324118610,MATH 18,A02,083744,Cinel; Cameron Alexander,10,0,30,20
1656324118610,MATH 18,A03,083745,Cinel; Cameron Alexander,5,0,30,25
1656324118610,MATH 18,B01,083748,Rideout; David Porter,0,0,36,36
1656324118610,MATH 18,B02,083749,Rideout; David Porter,0,0,36,36
1656324118610,MATH 18,B03,083750,Rideout; David Porter,0,0,36,36
1656324118610,MATH 18,B04,083751,Rideout; David Porter,0,1,36,36
1656324118610,MATH 18,B05,093473,Rideout; David Porter,0,0,36,36
1656324118610,MATH 18,B06,093474,Rideout; David Porter,2,0,36,34
1656324124637,MATH 20A,A01,083754,Zheng; Zequn,11,0,40,29
1656324130662,MATH 20B,A01,083756,Briones; Jor-el Thomas Caparas,0,0,36,36
1656324130662,MATH 20B,A02,083757,Briones; Jor-el Thomas Caparas,0,0,36,36
1656324130662,MATH 20B,A03,093475,Staff,1,0,36,35
1656324136687,MATH 20C,A01,083760,Briones; Jor-el Thomas Caparas,0,1,35,35
1656324136687,MATH 20C,A02,083761,Briones; Jor-el Thomas Caparas,9,1,35,26
1656324136687,MATH 20C,A03,093476,Staff,0,0,35,35
1656324136687,MATH 20C,B01,083762,Bach; Quang Tran,2,0,30,28
1656324142712,MATH 20D,A01,083765,Tran; Brian Kha,1,0,30,29
1656324142712,MATH 20D,A02,083766,Tran; Brian Kha,0,0,30,30
1656324142712,MATH 20D,A03,083767,Tran; Brian Kha,2,0,30,28
1656324148736,MATH 20E,A01,083771,Ganguly; Soumya,1,0,32,31
1656324148736,MATH 20E,A02,083772,Ganguly; Soumya,0,0,32,32
1656324148736,MATH 20E,B01,083773,Ciotti; Benjamin,18,0,35,17
1656324148736,MATH 20E,B02,083774,Ciotti; Benjamin,16,0,35,19
1656324154767,MATH 103A,A01,083777,Greenfeld; Be'Eri,2,0,36,34
1656324154767,MATH 103A,A02,083778,Greenfeld; Be'Eri,4,0,36,32
1656324154767,MATH 103A,A03,093561,Staff,3,0,36,33
1656324154767,MATH 103A,B01,083779,Greenfeld; Be'Eri,7,0,36,29
1656324154767,MATH 103A,B02,083780,Greenfeld; Be'Eri,0,0,36,36
1656324154767,MATH 103A,B03,093562,Staff,1,0,36,35
1656324160796,MATH 105,A01,085443,Carter; Anne Toulson,4,0,35,31
1656324160796,MATH 105,A02,093477,Staff,15,0,35,20
1656324166825,MATH 109,A01,083213,Ganzberger; Geoffrey Michael,1,0,34,33
1656324166825,MATH 109,A02,083214,Ganzberger; Geoffrey Michael,0,0,34,34
1656324166825,MATH 109,A03,093478,Staff,2,0,34,32
1656324166825,MATH 109,B01,083215,Ganzberger; Geoffrey Michael,2,0,32,30
1656324166825,MATH 109,B02,083216,Ganzberger; Geoffrey Michael,0,0,32,32
1656324166825,MATH 109,B03,093479,Staff,4,0,32,28
1656324172855,MATH 142A,A01,083219,Chow; Bennett,0,0,32,32
1656324172855,MATH 142A,A02,083220,Chow; Bennett,8,0,32,24
1656324172855,MATH 142A,A03,093480,Staff,4,0,32,28
1656324172855,MATH 142A,B03,093481,Staff,3,0,32,29
1656324172855,MATH 142A,B04,093558,Staff,7,0,32,25
1656324172855,MATH 142A,B05,093559,Staff,1,0,32,31
1656324178878,MATH 193A,A01,083224,Rotar; Vladimir,0,1,34,34
1656324178878,MATH 193A,A02,083225,Rotar; Vladimir,0,0,34,34
1656324178878,MATH 193A,A03,083781,Rotar; Vladimir,0,0,34,34
1656324178878,MATH 193A,A04,083782,Rotar; Vladimir,5,0,34,29
1656324178878,MATH 193A,A05,093482,Rotar; Vladimir,0,0,34,34
1656324184902,MATH 197,001,091859,McAuley; Julian John,9999,0,9999,0
1656324184902,MATH 197,002,095566,Kedlaya; Kiran S.,9997,0,9999,2
1656324184902,MATH 197,003,095567,Xiao; Ming,9999,0,9999,0
1656324184902,MATH 197,004,095571,Perols; Johan Lars,9998,0,9999,1
1656324191970,COGS 9,A01,083615,Shannon; Kyle Michael,3,0,75,72
1656324197995,COGS 11,A01,083617,Boyle; Mary E. T.,17,0,48,31
1656324204022,COGS 13,A01,083071,Bastos; Amalia Pinkusfeld,5,0,71,66
1656324210050,COGS 14A,A01,092681,Semenuks; Arturs,0,7,100,104
1656324216072,COGS 14B,A01,083073,Cheng; Tzu-Han,7,0,63,56
1656324222095,COGS 17,A01,092677,Semenuks; Arturs,6,0,81,75
1656324228122,COGS 100,A01,083619,Allen; Michael Gordon,2,0,70,68
1656324234151,COGS 101A,A01,083621,Davis; Joshua Daniel,5,0,68,63
1656324240178,COGS 101B,A01,091572,Allen; Michael Gordon,4,0,65,61
1656324246202,COGS 101C,A01,083625,Delgado; Tania,11,0,35,24
1656324252228,COGS 107A,A01,083627,Boyle; Mary E. T.,2,0,60,58
1656324258256,COGS 118A,A01,083075,Gupta; Anjum,8,0,76,68
1656324264285,CSE 3,A50,083646,Miranda; Gregory Joseph,18,0,50,32
1656324270309,CSE 8A,A50,083650,Miranda; Gregory Joseph,5,2,56,51
1656324276335,CSE 11,A01,083080,Cao; Yingjun,0,46,40,40
1656324282359,CSE 12,A01,083652,Krause-Levy; Sophia Louisa,5,1,120,115
1656324288385,CSE 15L,A01,083654,Morris; Justin Loren,2,0,50,48
1656324288385,CSE 15L,A02,083655,Morris; Justin Loren,4,0,50,46
1656324294407,CSE 20,A01,083657,Tran; Khoa Dang,31,0,80,49
1656324300432,CSE 21,A01,095574,Bach; Quang Tran,23,0,48,25
1656324306457,CSE 30,A01,083084,Eldon; John,1,4,80,79
1656324306457,CSE 30,B01,095061,Bhaskar; Nishant,0,1,50,50
1656324312487,CSE 100,A01,083659,Cao; Yingjun,1,18,70,69
1656324318512,CSE 134B,A01,083661,Powell; Thomas Allan,7,0,100,93
1656324324537,CSE 140,A01,083663,Gungor; Onat,9,0,85,76
1656324330566,CSE 140L,A01,083088,Eldon; John,10,0,100,90
1656324336591,CSE 175,A01,083665,Kumar; Rakesh,0,0,25,25
1656324342615,CSE 190,A00,092507,Dubnov; Shlomo,4,0,20,16
1656324348641,ECE 45,A01,083139,Congero; Spencer William,1,0,75,74
1656324354666,ECE 65,A50,083695,Saad; Andrew S,10,0,30,20
1656324354666,ECE 65,A51,095125,Staff,25,0,26,1
1656324360700,ECE 109,A01,091882,Touri; Behrouz,0,1,70,70
1656324366727,ECE 180,A00,083140,Abi Samra; Nicholas Camill,2,0,30,28
1656324366727,ECE 180,B00,083141,Abi Samra; Nicholas Camill,0,4,30,30
1656324372756,MATH 10A,A01,083735,Patchell; Gregory David,0,0,30,30
1656324372756,MATH 10A,A02,083736,Patchell; Gregory David,22,0,30,8
1656324372756,MATH 10A,A03,083737,Patchell; Gregory David,16,0,30,14
1656324378782,MATH 10B,A01,083207,Lim; Seonhee,2,0,34,32
1656324378782,MATH 10B,A02,083208,Lim; Seonhee,4,0,35,31
1656324378782,MATH 10B,A03,093472,Staff,1,0,34,33
1656324378782,MATH 10B,B01,083739,Sinha; Shubham,11,0,30,19
1656324384808,MATH 18,A01,083743,Cinel; Cameron Alexander,7,0,30,23
1656324384808,MATH 18,A02,083744,Cinel; Cameron Alexander,10,0,30,20
1656324384808,MATH 18,A03,083745,Cinel; Cameron Alexander,5,0,30,25
1656324384808,MATH 18,B01,083748,Rideout; David Porter,0,0,36,36
1656324384808,MATH 18,B02,083749,Rideout; David Porter,0,0,36,36
1656324384808,MATH 18,B03,083750,Rideout; David Porter,0,0,36,36
1656324384808,MATH 18,B04,083751,Rideout; David Porter,0,1,36,36
1656324384808,MATH 18,B05,093473,Rideout; David Porter,0,0,36,36
1656324384808,MATH 18,B06,093474,Rideout; David Porter,2,0,36,34
1656324390836,MATH 20A,A01,083754,Zheng; Zequn,11,0,40,29
1656324396860,MATH 20B,A01,083756,Briones; Jor-el Thomas Caparas,0,0,36,36
1656324396860,MATH 20B,A02,083757,Briones; Jor-el Thomas Caparas,0,0,36,36
1656324396860,MATH 20B,A03,093475,Staff,1,0,36,35
1656324402883,MATH 20C,A01,083760,Briones; Jor-el Thomas Caparas,0,1,35,35
1656324402883,MATH 20C,A02,083761,Briones; Jor-el Thomas Caparas,9,1,35,26
1656324402883,MATH 20C,A03,093476,Staff,0,0,35,35
1656324402883,MATH 20C,B01,083762,Bach; Quang Tran,2,0,30,28
1656324408908,MATH 20D,A01,083765,Tran; Brian Kha,1,0,30,29
1656324408908,MATH 20D,A02,083766,Tran; Brian Kha,0,0,30,30
1656324408908,MATH 20D,A03,083767,Tran; Brian Kha,2,0,30,28
1656324414938,MATH 20E,A01,083771,Ganguly; Soumya,1,0,32,31
1656324414938,MATH 20E,A02,083772,Ganguly; Soumya,0,0,32,32
1656324414938,MATH 20E,B01,083773,Ciotti; Benjamin,18,0,35,17
1656324414938,MATH 20E,B02,083774,Ciotti; Benjamin,16,0,35,19
1656324420969,MATH 103A,A01,083777,Greenfeld; Be'Eri,2,0,36,34
1656324420969,MATH 103A,A02,083778,Greenfeld; Be'Eri,4,0,36,32
1656324420969,MATH 103A,A03,093561,Staff,3,0,36,33
1656324420969,MATH 103A,B01,083779,Greenfeld; Be'Eri,7,0,36,29
1656324420969,MATH 103A,B02,083780,Greenfeld; Be'Eri,0,0,36,36
1656324420969,MATH 103A,B03,093562,Staff,1,0,36,35
1656324426995,MATH 105,A01,085443,Carter; Anne Toulson,4,0,35,31
1656324426995,MATH 105,A02,093477,Staff,15,0,35,20
1656324433021,MATH 109,A01,083213,Ganzberger; Geoffrey Michael,1,0,34,33
1656324433021,MATH 109,A02,083214,Ganzberger; Geoffrey Michael,0,0,34,34
1656324433021,MATH 109,A03,093478,Staff,2,0,34,32
1656324433021,MATH 109,B01,083215,Ganzberger; Geoffrey Michael,2,0,32,30
1656324433021,MATH 109,B02,083216,Ganzberger; Geoffrey Michael,0,0,32,32
1656324433021,MATH 109,B03,093479,Staff,4,0,32,28
1656324439045,MATH 142A,A01,083219,Chow; Bennett,0,0,32,32
1656324439045,MATH 142A,A02,083220,Chow; Bennett,8,0,32,24
1656324439045,MATH 142A,A03,093480,Staff,4,0,32,28
1656324439045,MATH 142A,B03,093481,Staff,3,0,32,29
1656324439045,MATH 142A,B04,093558,Staff,7,0,32,25
1656324439045,MATH 142A,B05,093559,Staff,1,0,32,31
1656324445070,MATH 193A,A01,083224,Rotar; Vladimir,0,1,34,34
1656324445070,MATH 193A,A02,083225,Rotar; Vladimir,0,0,34,34
1656324445070,MATH 193A,A03,083781,Rotar; Vladimir,0,0,34,34
1656324445070,MATH 193A,A04,083782,Rotar; Vladimir,5,0,34,29
1656324445070,MATH 193A,A05,093482,Rotar; Vladimir,0,0,34,34
1656324451097,MATH 197,001,091859,McAuley; Julian John,9999,0,9999,0
1656324451097,MATH 197,002,095566,Kedlaya; Kiran S.,9997,0,9999,2
1656324451097,MATH 197,003,095567,Xiao; Ming,9999,0,9999,0
1656324451097,MATH 197,004,095571,Perols; Johan Lars,9998,0,9999,1
1656324458161,COGS 9,A01,083615,Shannon; Kyle Michael,3,0,75,72
1656324464193,COGS 11,A01,083617,Boyle; Mary E. T.,17,0,48,31
1656324470219,COGS 13,A01,083071,Bastos; Amalia Pinkusfeld,5,0,71,66
1656324476247,COGS 14A,A01,092681,Semenuks; Arturs,0,7,100,104
1656324482270,COGS 14B,A01,083073,Cheng; Tzu-Han,7,0,63,56
1656324488298,COGS 17,A01,092677,Semenuks; Arturs,6,0,81,75
1656324494326,COGS 100,A01,083619,Allen; Michael Gordon,2,0,70,68
1656324500353,COGS 101A,A01,083621,Davis; Joshua Daniel,5,0,68,63
1656324506379,COGS 101B,A01,091572,Allen; Michael Gordon,4,0,65,61
1656324512407,COGS 101C,A01,083625,Delgado; Tania,11,0,35,24
1656324518434,COGS 107A,A01,083627,Boyle; Mary E. T.,2,0,60,58
1656324524461,COGS 118A,A01,083075,Gupta; Anjum,8,0,76,68
1656324530490,CSE 3,A50,083646,Miranda; Gregory Joseph,18,0,50,32
1656324536519,CSE 8A,A50,083650,Miranda; Gregory Joseph,5,2,56,51
1656324542546,CSE 11,A01,083080,Cao; Yingjun,0,46,40,40
1656324548568,CSE 12,A01,083652,Krause-Levy; Sophia Louisa,5,1,120,115
1656324554595,CSE 15L,A01,083654,Morris; Justin Loren,2,0,50,48
1656324554595,CSE 15L,A02,083655,Morris; Justin Loren,4,0,50,46
1656324560625,CSE 20,A01,083657,Tran; Khoa Dang,31,0,80,49
1656324566654,CSE 21,A01,095574,Bach; Quang Tran,23,0,48,25
1656324572678,CSE 30,A01,083084,Eldon; John,1,4,80,79
1656324572678,CSE 30,B01,095061,Bhaskar; Nishant,0,1,50,50
1656324578701,CSE 100,A01,083659,Cao; Yingjun,1,18,70,69
1656324584725,CSE 134B,A01,083661,Powell; Thomas Allan,7,0,100,93
1656324590748,CSE 140,A01,083663,Gungor; Onat,9,0,85,76
1656324596771,CSE 140L,A01,083088,Eldon; John,10,0,100,90
1656324602798,CSE 175,A01,083665,Kumar; Rakesh,0,0,25,25
1656324608821,CSE 190,A00,092507,Dubnov; Shlomo,4,0,20,16
1656324614845,ECE 45,A01,083139,Congero; Spencer William,1,0,75,74
1656324620870,ECE 65,A50,083695,Saad; Andrew S,10,0,30,20
1656324620870,ECE 65,A51,095125,Staff,25,0,26,1
1656324626898,ECE 109,A01,091882,Touri; Behrouz,0,1,70,70
1656324633001,ECE 180,A00,083140,Abi Samra; Nicholas Camill,2,0,30,28
1656324633001,ECE 180,B00,083141,Abi Samra; Nicholas Camill,0,4,30,30
1656324639029,MATH 10A,A01,083735,Patchell; Gregory David,0,0,30,30
1656324639029,MATH 10A,A02,083736,Patchell; Gregory David,22,0,30,8
1656324639029,MATH 10A,A03,083737,Patchell; Gregory David,16,0,30,14
1656324645051,MATH 10B,A01,083207,Lim; Seonhee,2,0,34,32
1656324645051,MATH 10B,A02,083208,Lim; Seonhee,4,0,35,31
1656324645051,MATH 10B,A03,093472,Staff,1,0,34,33
1656324645051,MATH 10B,B01,083739,Sinha; Shubham,11,0,30,19
1656324651077,MATH 18,A01,083743,Cinel; Cameron Alexander,7,0,30,23
1656324651077,MATH 18,A02,083744,Cinel; Cameron Alexander,10,0,30,20
1656324651077,MATH 18,A03,083745,Cinel; Cameron Alexander,5,0,30,25
1656324651077,MATH 18,B01,083748,Rideout; David Porter,0,0,36,36
1656324651077,MATH 18,B02,083749,Rideout; David Porter,0,0,36,36
1656324651077,MATH 18,B03,083750,Rideout; David Porter,0,0,36,36
1656324651077,MATH 18,B04,083751,Rideout; David Porter,0,1,36,36
1656324651077,MATH 18,B05,093473,Rideout; David Porter,0,0,36,36
1656324651077,MATH 18,B06,093474,Rideout; David Porter,2,0,36,34
1656324657100,MATH 20A,A01,083754,Zheng; Zequn,11,0,40,29
1656324663133,MATH 20B,A01,083756,Briones; Jor-el Thomas Caparas,0,0,36,36
1656324663133,MATH 20B,A02,083757,Briones; Jor-el Thomas Caparas,0,0,36,36
1656324663133,MATH 20B,A03,093475,Staff,1,0,36,35
1656324669163,MATH 20C,A01,083760,Briones; Jor-el Thomas Caparas,0,1,35,35
1656324669163,MATH 20C,A02,083761,Briones; Jor-el Thomas Caparas,9,1,35,26
1656324669163,MATH 20C,A03,093476,Staff,0,0,35,35
1656324669163,MATH 20C,B01,083762,Bach; Quang Tran,2,0,30,28
1656324675188,MATH 20D,A01,083765,Tran; Brian Kha,1,0,30,29
1656324675188,MATH 20D,A02,083766,Tran; Brian Kha,0,0,30,30
1656324675188,MATH 20D,A03,083767,Tran; Brian Kha,2,0,30,28
1656324681218,MATH 20E,A01,083771,Ganguly; Soumya,1,0,32,31
1656324681218,MATH 20E,A02,083772,Ganguly; Soumya,0,0,32,32
1656324681218,MATH 20E,B01,083773,Ciotti; Benjamin,18,0,35,17
1656324681218,MATH 20E,B02,083774,Ciotti; Benjamin,16,0,35,19
1656324687243,MATH 103A,A01,083777,Greenfeld; Be'Eri,2,0,36,34
1656324687243,MATH 103A,A02,083778,Greenfeld; Be'Eri,4,0,36,32
1656324687243,MATH 103A,A03,093561,Staff,3,0,36,33
1656324687243,MATH 103A,B01,083779,Greenfeld; Be'Eri,7,0,36,29
1656324687243,MATH 103A,B02,083780,Greenfeld; Be'Eri,0,0,36,36
1656324687243,MATH 103A,B03,093562,Staff,1,0,36,35
1656324693267,MATH 105,A01,085443,Carter; Anne Toulson,4,0,35,31
1656324693267,MATH 105,A02,093477,Staff,15,0,35,20
1656324699292,MATH 109,A01,083213,Ganzberger; Geoffrey Michael,1,0,34,33
1656324699292,MATH 109,A02,083214,Ganzberger; Geoffrey Michael,0,0,34,34
1656324699292,MATH 109,A03,093478,Staff,2,0,34,32
1656324699292,MATH 109,B01,083215,Ganzberger; Geoffrey Michael,2,0,32,30
1656324699292,MATH 109,B02,083216,Ganzberger; Geoffrey Michael,0,0,32,32
1656324699292,MATH 109,B03,093479,Staff,4,0,32,28
1656324705318,MATH 142A,A01,083219,Chow; Bennett,0,0,32,32
1656324705318,MATH 142A,A02,083220,Chow; Bennett,8,0,32,24
1656324705318,MATH 142A,A03,093480,Staff,4,0,32,28
1656324705318,MATH 142A,B03,093481,Staff,3,0,32,29
1656324705318,MATH 142A,B04,093558,Staff,7,0,32,25
1656324705318,MATH 142A,B05,093559,Staff,1,0,32,31
1656324711348,MATH 193A,A01,083224,Rotar; Vladimir,0,1,34,34
1656324711348,MATH 193A,A02,083225,Rotar; Vladimir,0,0,34,34
1656324711348,MATH 193A,A03,083781,Rotar; Vladimir,0,0,34,34
1656324711348,MATH 193A,A04,083782,Rotar; Vladimir,5,0,34,29
1656324711348,MATH 193A,A05,093482,Rotar; Vladimir,0,0,34,34
1656324717372,MATH 197,001,091859,McAuley; Julian John,9999,0,9999,0
1656324717372,MATH 197,002,095566,Kedlaya; Kiran S.,9997,0,9999,2
1656324717372,MATH 197,003,095567,Xiao; Ming,9999,0,9999,0
1656324717372,MATH 197,004,095571,Perols; Johan Lars,9998,0,9999,1
1656324724429,COGS 9,A01,083615,Shannon; Kyle Michael,3,0,75,72
1656324730455,COGS 11,A01,083617,Boyle; Mary E. T.,17,0,48,31
1656324736482,COGS 13,A01,083071,Bastos; Amalia Pinkusfeld,5,0,71,66
1656324742514,COGS 14A,A01,092681,Semenuks; Arturs,0,7,100,104
1656324748537,COGS 14B,A01,083073,Cheng; Tzu-Han,7,0,63,56
1656324754560,COGS 17,A01,092677,Semenuks; Arturs,6,0,81,75
1656324760591,COGS 100,A01,083619,Allen; Michael Gordon,2,0,70,68
1656324766616,COGS 101A,A01,083621,Davis; Joshua Daniel,5,0,68,63
1656324772639,COGS 101B,A01,091572,Allen; Michael Gordon,4,0,65,61
1656324778667,COGS 101C,A01,083625,Delgado; Tania,11,0,35,24
1656324784691,COGS 107A,A01,083627,Boyle; Mary E. T.,2,0,60,58
1656324790719,COGS 118A,A01,083075,Gupta; Anjum,8,0,76,68
1656324796751,CSE 3,A50,083646,Miranda; Gregory Joseph,18,0,50,32
1656324802779,CSE 8A,A50,083650,Miranda; Gregory Joseph,5,2,56,51
1656324808804,CSE 11,A01,083080,Cao; Yingjun,0,46,40,40
1656324814826,CSE 12,A01,083652,Krause-Levy; Sophia Louisa,5,1,120,115
1656324820853,CSE 15L,A01,083654,Morris; Justin Loren,2,0,50,48
1656324820853,CSE 15L,A02,083655,Morris; Justin Loren,4,0,50,46
1656324826880,CSE 20,A01,083657,Tran; Khoa Dang,31,0,80,49
1656324832911,CSE 21,A01,095574,Bach; Quang Tran,23,0,48,25
1656324838939,CSE 30,A01,083084,Eldon; John,1,4,80,79
1656324838939,CSE 30,B01,095061,Bhaskar; Nishant,0,1,50,50
1656324844964,CSE 100,A01,083659,Cao; Yingjun,1,18,70,69
1656324850994,CSE 134B,A01,083661,Powell; Thomas Allan,7,0,100,93
1656324857022,CSE 140,A01,083663,Gungor; Onat,9,0,85,76
1656324863046,CSE 140L,A01,083088,Eldon; John,10,0,100,90
1656324869071,CSE 175,A01,083665,Kumar; Rakesh,0,0,25,25
1656324875100,CSE 190,A00,092507,Dubnov; Shlomo,4,0,20,16
1656324881130,ECE 45,A01,083139,Congero; Spencer William,1,0,75,74
1656324887159,ECE 65,A50,083695,Saad; Andrew S,10,0,30,20
1656324887159,ECE 65,A51,095125,Staff,25,0,26,1
1656324893182,ECE 109,A01,091882,Touri; Behrouz,0,1,70,70
1656324899209,ECE 180,A00,083140,Abi Samra; Nicholas Camill,2,0,30,28
1656324899209,ECE 180,B00,083141,Abi Samra; Nicholas Camill,0,4,30,30
1656324905234,MATH 10A,A01,083735,Patchell; Gregory David,0,0,30,30
1656324905234,MATH 10A,A02,083736,Patchell; Gregory David,22,0,30,8
1656324905234,MATH 10A,A03,083737,Patchell; Gregory David,16,0,30,14
1656324911268,MATH 10B,A01,083207,Lim; Seonhee,2,0,34,32
1656324911268,MATH 10B,A02,083208,Lim; Seonhee,4,0,35,31
1656324911268,MATH 10B,A03,093472,Staff,1,0,34,33
1656324911268,MATH 10B,B01,083739,Sinha; Shubham,11,0,30,19
1656324917295,MATH 18,A01,083743,Cinel; Cameron Alexander,7,0,30,23
1656324917295,MATH 18,A02,083744,Cinel; Cameron Alexander,10,0,30,20
1656324917295,MATH 18,A03,083745,Cinel; Cameron Alexander,5,0,30,25
1656324917295,MATH 18,B01,083748,Rideout; David Porter,0,0,36,36
1656324917295,MATH 18,B02,083749,Rideout; David Porter,0,0,36,36
1656324917295,MATH 18,B03,083750,Rideout; David Porter,0,0,36,36
1656324917295,MATH 18,B04,083751,Rideout; David Porter,0,1,36,36
1656324917295,MATH 18,B05,093473,Rideout; David Porter,0,0,36,36
1656324917295,MATH 18,B06,093474,Rideout; David Porter,2,0,36,34
1656324923326,MATH 20A,A01,083754,Zheng; Zequn,11,0,40,29
1656324929351,MATH 20B,A01,083756,Briones; Jor-el Thomas Caparas,0,0,36,36
1656324929351,MATH 20B,A02,083757,Briones; Jor-el Thomas Caparas,0,0,36,36
1656324929351,MATH 20B,A03,093475,Staff,1,0,36,35
1656324935373,MATH 20C,A01,083760,Briones; Jor-el Thomas Caparas,0,1,35,35
1656324935373,MATH 20C,A02,083761,Briones; Jor-el Thomas Caparas,9,1,35,26
1656324935373,MATH 20C,A03,093476,Staff,0,0,35,35
1656324935373,MATH 20C,B01,083762,Bach; Quang Tran,2,0,30,28
1656324941405,MATH 20D,A01,083765,Tran; Brian Kha,1,0,30,29
1656324941405,MATH 20D,A02,083766,Tran; Brian Kha,0,0,30,30
1656324941405,MATH 20D,A03,083767,Tran; Brian Kha,2,0,30,28
1656324947429,MATH 20E,A01,083771,Ganguly; Soumya,1,0,32,31
1656324947429,MATH 20E,A02,083772,Ganguly; Soumya,0,0,32,32
1656324947429,MATH 20E,B01,083773,Ciotti; Benjamin,18,0,35,17
1656324947429,MATH 20E,B02,083774,Ciotti; Benjamin,16,0,35,19
1656324953458,MATH 103A,A01,083777,Greenfeld; Be'Eri,2,0,36,34
1656324953458,MATH 103A,A02,083778,Greenfeld; Be'Eri,4,0,36,32
1656324953458,MATH 103A,A03,093561,Staff,3,0,36,33
1656324953458,MATH 103A,B01,083779,Greenfeld; Be'Eri,7,0,36,29
1656324953458,MATH 103A,B02,083780,Greenfeld; Be'Eri,0,0,36,36
1656324953458,MATH 103A,B03,093562,Staff,1,0,36,35
1656324959482,MATH 105,A01,085443,Carter; Anne Toulson,4,0,35,31
1656324959482,MATH 105,A02,093477,Staff,15,0,35,20
1656324965513,MATH 109,A01,083213,Ganzberger; Geoffrey Michael,1,0,34,33
1656324965513,MATH 109,A02,083214,Ganzberger; Geoffrey Michael,0,0,34,34
1656324965513,MATH 109,A03,093478,Staff,2,0,34,32
1656324965513,MATH 109,B01,083215,Ganzberger; Geoffrey Michael,2,0,32,30
1656324965513,MATH 109,B02,083216,Ganzberger; Geoffrey Michael,0,0,32,32
1656324965513,MATH 109,B03,093479,Staff,4,0,32,28
1656324971543,MATH 142A,A01,083219,Chow; Bennett,0,0,32,32
1656324971543,MATH 142A,A02,083220,Chow; Bennett,8,0,32,24
1656324971543,MATH 142A,A03,093480,Staff,4,0,32,28
1656324971543,MATH 142A,B03,093481,Staff,3,0,32,29
1656324971543,MATH 142A,B04,093558,Staff,7,0,32,25
1656324971543,MATH 142A,B05,093559,Staff,1,0,32,31
1656324977570,MATH 193A,A01,083224,Rotar; Vladimir,0,1,34,34
1656324977570,MATH 193A,A02,083225,Rotar; Vladimir,0,0,34,34
1656324977570,MATH 193A,A03,083781,Rotar; Vladimir,0,0,34,34
1656324977570,MATH 193A,A04,083782,Rotar; Vladimir,5,0,34,29
1656324977570,MATH 193A,A05,093482,Rotar; Vladimir,0,0,34,34
1656324983594,MATH 197,001,091859,McAuley; Julian John,9999,0,9999,0
1656324983594,MATH 197,002,095566,Kedlaya; Kiran S.,9997,0,9999,2
1656324983594,MATH 197,003,095567,Xiao; Ming,9999,0,9999,0
1656324983594,MATH 197,004,095571,Perols; Johan Lars,9998,0,9999,1
1656324990659,COGS 9,A01,083615,Shannon; Kyle Michael,3,0,75,72
1656324996683,COGS 11,A01,083617,Boyle; Mary E. T.,17,0,48,31
1656325002712,COGS 13,A01,083071,Bastos; Amalia Pinkusfeld,5,0,71,66
1656325008737,COGS 14A,A01,092681,Semenuks; Arturs,0,7,100,104
1656325014761,COGS 14B,A01,083073,Cheng; Tzu-Han,7,0,63,56
1656325020783,COGS 17,A01,092677,Semenuks; Arturs,6,0,81,75
1656325026817,COGS 100,A01,083619,Allen; Michael Gordon,2,0,70,68
1656325032842,COGS 101A,A01,083621,Davis; Joshua Daniel,5,0,68,63
1656325038869,COGS 101B,A01,091572,Allen; Michael Gordon,4,0,65,61
1656325044899,COGS 101C,A01,083625,Delgado; Tania,11,0,35,24
1656325050925,COGS 107A,A01,083627,Boyle; Mary E. T.,2,0,60,58
1656325056951,COGS 118A,A01,083075,Gupta; Anjum,8,0,76,68
1656325062974,CSE 3,A50,083646,Miranda; Gregory Joseph,18,0,50,32
1656325068996,CSE 8A,A50,083650,Miranda; Gregory Joseph,5,2,56,51
1656325075024,CSE 11,A01,083080,Cao; Yingjun,0,46,40,40
1656325081049,CSE 12,A01,083652,Krause-Levy; Sophia Louisa,5,1,120,115
1656325087074,CSE 15L,A01,083654,Morris; Justin Loren,2,0,50,48
1656325087074,CSE 15L,A02,083655,Morris; Justin Loren,4,0,50,46
1656325093101,CSE 20,A01,083657,Tran; Khoa Dang,31,0,80,49
1656325099133,CSE 21,A01,095574,Bach; Quang Tran,23,0,48,25
1656325105159,CSE 30,A01,083084,Eldon; John,1,4,80,79
1656325105159,CSE 30,B01,095061,Bhaskar; Nishant,0,1,50,50
1656325111183,CSE 100,A01,083659,Cao; Yingjun,1,18,70,69
1656325117211,CSE 134B,A01,083661,Powell; Thomas Allan,7,0,100,93
1656325123239,CSE 140,A01,083663,Gungor; Onat,9,0,85,76
1656325129263,CSE 140L,A01,083088,Eldon; John,10,0,100,90
1656325135289,CSE 175,A01,083665,Kumar; Rakesh,0,0,25,25
1656325141316,CSE 190,A00,092507,Dubnov; Shlomo,4,0,20,16
1656325147340,ECE 45,A01,083139,Congero; Spencer William,1,0,75,74
1656325153366,ECE 65,A50,083695,Saad; Andrew S,10,0,30,20
1656325153366,ECE 65,A51,095125,Staff,25,0,26,1
1656325159389,ECE 109,A01,091882,Touri; Behrouz,0,1,70,70
1656325165413,ECE 180,A00,083140,Abi Samra; Nicholas Camill,2,0,30,28
1656325165413,ECE 180,B00,083141,Abi Samra; Nicholas Camill,0,4,30,30
1656325171436,MATH 10A,A01,083735,Patchell; Gregory David,0,0,30,30
1656325171436,MATH 10A,A02,083736,Patchell; Gregory David,22,0,30,8
1656325171436,MATH 10A,A03,083737,Patchell; Gregory David,16,0,30,14
1656325177460,MATH 10B,A01,083207,Lim; Seonhee,2,0,34,32
1656325177460,MATH 10B,A02,083208,Lim; Seonhee,4,0,35,31
1656325177460,MATH 10B,A03,093472,Staff,1,0,34,33
1656325177460,MATH 10B,B01,083739,Sinha; Shubham,11,0,30,19
1656325183492,MATH 18,A01,083743,Cinel; Cameron Alexander,7,0,30,23
1656325183492,MATH 18,A02,083744,Cinel; Cameron Alexander,10,0,30,20
1656325183492,MATH 18,A03,083745,Cinel; Cameron Alexander,5,0,30,25
1656325183492,MATH 18,B01,083748,Rideout; David Porter,0,0,36,36
1656325183492,MATH 18,B02,083749,Rideout; David Porter,0,0,36,36
1656325183492,MATH 18,B03,083750,Rideout; David Porter,0,0,36,36
1656325183492,MATH 18,B04,083751,Rideout; David Porter,0,1,36,36
1656325183492,MATH 18,B05,093473,Rideout; David Porter,0,0,36,36
1656325183492,MATH 18,B06,093474,Rideout; David Porter,2,0,36,34
1656325189513,MATH 20A,A01,083754,Zheng; Zequn,11,0,40,29
1656325195537,MATH 20B,A01,083756,Briones; Jor-el Thomas Caparas,0,0,36,36
1656325195537,MATH 20B,A02,083757,Briones; Jor-el Thomas Caparas,0,0,36,36
1656325195537,MATH 20B,A03,093475,Staff,1,0,36,35
1656325201561,MATH 20C,A01,083760,Briones; Jor-el Thomas Caparas,0,1,35,35
1656325201561,MATH 20C,A02,083761,Briones; Jor-el Thomas Caparas,9,1,35,26
1656325201561,MATH 20C,A03,093476,Staff,0,0,35,35
1656325201561,MATH 20C,B01,083762,Bach; Quang Tran,2,0,30,28
1656325207584,MATH 20D,A01,083765,Tran; Brian Kha,1,0,30,29
1656325207584,MATH 20D,A02,083766,Tran; Brian Kha,0,0,30,30
1656325207584,MATH 20D,A03,083767,Tran; Brian Kha,2,0,30,28
1656325213623,MATH 20E,A01,083771,Ganguly; Soumya,1,0,32,31
1656325213623,MATH 20E,A02,083772,Ganguly; Soumya,0,0,32,32
1656325213623,MATH 20E,B01,083773,Ciotti; Benjamin,18,0,35,17
1656325213623,MATH 20E,B02,083774,Ciotti; Benjamin,16,0,35,19
1656325219648,MATH 103A,A01,083777,Greenfeld; Be'Eri,2,0,36,34
1656325219648,MATH 103A,A02,083778,Greenfeld; Be'Eri,4,0,36,32
1656325219648,MATH 103A,A03,093561,Staff,3,0,36,33
1656325219648,MATH 103A,B01,083779,Greenfeld; Be'Eri,7,0,36,29
1656325219648,MATH 103A,B02,083780,Greenfeld; Be'Eri,0,0,36,36
1656325219648,MATH 103A,B03,093562,Staff,1,0,36,35
1656325225679,MATH 105,A01,085443,Carter; Anne Toulson,3,0,35,32
1656325225679,MATH 105,A02,093477,Staff,15,0,35,20
1656325231785,MATH 109,A01,083213,Ganzberger; Geoffrey Michael,1,0,34,33
1656325231785,MATH 109,A02,083214,Ganzberger; Geoffrey Michael,0,0,34,34
1656325231785,MATH 109,A03,093478,Staff,2,0,34,32
1656325231785,MATH 109,B01,083215,Ganzberger; Geoffrey Michael,2,0,32,30
1656325231785,MATH 109,B02,083216,Ganzberger; Geoffrey Michael,0,0,32,32
1656325231785,MATH 109,B03,093479,Staff,4,0,32,28
1656325237810,MATH 142A,A01,083219,Chow; Bennett,0,0,32,32
1656325237810,MATH 142A,A02,083220,Chow; Bennett,8,0,32,24
1656325237810,MATH 142A,A03,093480,Staff,4,0,32,28
1656325237810,MATH 142A,B03,093481,Staff,3,0,32,29
1656325237810,MATH 142A,B04,093558,Staff,7,0,32,25
1656325237810,MATH 142A,B05,093559,Staff,1,0,32,31
1656325243847,MATH 193A,A01,083224,Rotar; Vladimir,0,1,34,34
1656325243847,MATH 193A,A02,083225,Rotar; Vladimir,0,0,34,34
1656325243847,MATH 193A,A03,083781,Rotar; Vladimir,0,0,34,34
1656325243847,MATH 193A,A04,083782,Rotar; Vladimir,5,0,34,29
1656325243847,MATH 193A,A05,093482,Rotar; Vladimir,0,0,34,34
1656325249876,MATH 197,001,091859,McAuley; Julian John,9999,0,9999,0
1656325249876,MATH 197,002,095566,Kedlaya; Kiran S.,9997,0,9999,2
1656325249876,MATH 197,003,095567,Xiao; Ming,9999,0,9999,0
1656325249876,MATH 197,004,095571,Perols; Johan Lars,9998,0,9999,1
1656325256933,COGS 9,A01,083615,Shannon; Kyle Michael,3,0,75,72
1656325262961,COGS 11,A01,083617,Boyle; Mary E. T.,17,0,48,31
1656325268986,COGS 13,A01,083071,Bastos; Amalia Pinkusfeld,5,0,71,66
1656325275010,COGS 14A,A01,092681,Semenuks; Arturs,0,7,100,104
1656325281035,COGS 14B,A01,083073,Cheng; Tzu-Han,7,0,63,56
1656325287063,COGS 17,A01,092677,Semenuks; Arturs,6,0,81,75
1656325293088,COGS 100,A01,083619,Allen; Michael Gordon,2,0,70,68
1656325299115,COGS 101A,A01,083621,Davis; Joshua Daniel,5,0,68,63
1656325305139,COGS 101B,A01,091572,Allen; Michael Gordon,4,0,65,61
1656325311170,COGS 101C,A01,083625,Delgado; Tania,11,0,35,24
1656325317203,COGS 107A,A01,083627,Boyle; Mary E. T.,2,0,60,58
1656325323230,COGS 118A,A01,083075,Gupta; Anjum,8,0,76,68
1656325329253,CSE 3,A50,083646,Miranda; Gregory Joseph,18,0,50,32
1656325335278,CSE 8A,A50,083650,Miranda; Gregory Joseph,5,2,56,51
1656325341314,CSE 11,A01,083080,Cao; Yingjun,0,46,40,40
1656325347336,CSE 12,A01,083652,Krause-Levy; Sophia Louisa,5,1,120,115
1656325353370,CSE 15L,A01,083654,Morris; Justin Loren,2,0,50,48
1656325353370,CSE 15L,A02,083655,Morris; Justin Loren,4,0,50,46
1656325359398,CSE 20,A01,083657,Tran; Khoa Dang,31,0,80,49
1656325365422,CSE 21,A01,095574,Bach; Quang Tran,23,0,48,25
1656325371450,CSE 30,A01,083084,Eldon; John,1,4,80,79
1656325371450,CSE 30,B01,095061,Bhaskar; Nishant,0,1,50,50
1656325377475,CSE 100,A01,083659,Cao; Yingjun,1,18,70,69
1656325383499,CSE 134B,A01,083661,Powell; Thomas Allan,7,0,100,93
1656325389527,CSE 140,A01,083663,Gungor; Onat,9,0,85,76
1656325395552,CSE 140L,A01,083088,Eldon; John,10,0,100,90
1656325401574,CSE 175,A01,083665,Kumar; Rakesh,0,0,25,25
1656325407602,CSE 190,A00,092507,Dubnov; Shlomo,4,0,20,16
1656325413629,ECE 45,A01,083139,Congero; Spencer William,1,0,75,74
1656325419669,ECE 65,A50,083695,Saad; Andrew S,10,0,30,20
1656325419669,ECE 65,A51,095125,Staff,25,0,26,1
1656325425692,ECE 109,A01,091882,Touri; Behrouz,0,1,70,70
1656325431720,ECE 180,A00,083140,Abi Samra; Nicholas Camill,2,0,30,28
1656325431720,ECE 180,B00,083141,Abi Samra; Nicholas Camill,0,4,30,30
1656325437744,MATH 10A,A01,083735,Patchell; Gregory David,0,0,30,30
1656325437744,MATH 10A,A02,083736,Patchell; Gregory David,22,0,30,8
1656325437744,MATH 10A,A03,083737,Patchell; Gregory David,16,0,30,14
1656325443775,MATH 10B,A01,083207,Lim; Seonhee,2,0,34,32
1656325443775,MATH 10B,A02,083208,Lim; Seonhee,4,0,35,31
1656325443775,MATH 10B,A03,093472,Staff,1,0,34,33
1656325443775,MATH 10B,B01,083739,Sinha; Shubham,11,0,30,19
1656325449809,MATH 18,A01,083743,Cinel; Cameron Alexander,7,0,30,23
1656325449809,MATH 18,A02,083744,Cinel; Cameron Alexander,10,0,30,20
1656325449809,MATH 18,A03,083745,Cinel; Cameron Alexander,5,0,30,25
1656325449809,MATH 18,B01,083748,Rideout; David Porter,0,0,36,36
1656325449809,MATH 18,B02,083749,Rideout; David Porter,0,0,36,36
1656325449809,MATH 18,B03,083750,Rideout; David Porter,0,0,36,36
1656325449809,MATH 18,B04,083751,Rideout; David Porter,0,1,36,36
1656325449809,MATH 18,B05,093473,Rideout; David Porter,0,0,36,36
1656325449809,MATH 18,B06,093474,Rideout; David Porter,2,0,36,34
1656325455831,MATH 20A,A01,083754,Zheng; Zequn,11,0,40,29
1656325461856,MATH 20B,A01,083756,Briones; Jor-el Thomas Caparas,0,0,36,36
1656325461856,MATH 20B,A02,083757,Briones; Jor-el Thomas Caparas,0,0,36,36
1656325461856,MATH 20B,A03,093475,Staff,1,0,36,35
1656325467880,MATH 20C,A01,083760,Briones; Jor-el Thomas Caparas,0,1,35,35
1656325467880,MATH 20C,A02,083761,Briones; Jor-el Thomas Caparas,9,1,35,26
1656325467880,MATH 20C,A03,093476,Staff,0,0,35,35
1656325467880,MATH 20C,B01,083762,Bach; Quang Tran,2,0,30,28
1656325473906,MATH 20D,A01,083765,Tran; Brian Kha,1,0,30,29
1656325473906,MATH 20D,A02,083766,Tran; Brian Kha,0,0,30,30
1656325473906,MATH 20D,A03,083767,Tran; Brian Kha,2,0,30,28
1656325479940,MATH 20E,A01,083771,Ganguly; Soumya,1,0,32,31
1656325479940,MATH 20E,A02,083772,Ganguly; Soumya,0,0,32,32
1656325479940,MATH 20E,B01,083773,Ciotti; Benjamin,18,0,35,17
1656325479940,MATH 20E,B02,083774,Ciotti; Benjamin,16,0,35,19
1656325485972,MATH 103A,A01,083777,Greenfeld; Be'Eri,2,0,36,34
1656325485972,MATH 103A,A02,083778,Greenfeld; Be'Eri,4,0,36,32
1656325485972,MATH 103A,A03,093561,Staff,3,0,36,33
1656325485972,MATH 103A,B01,083779,Greenfeld; Be'Eri,7,0,36,29
1656325485972,MATH 103A,B02,083780,Greenfeld; Be'Eri,0,0,36,36
1656325485972,MATH 103A,B03,093562,Staff,1,0,36,35
1656325492001,MATH 105,A01,085443,Carter; Anne Toulson,3,0,35,32
1656325492001,MATH 105,A02,093477,Staff,15,0,35,20
1656325498030,MATH 109,A01,083213,Ganzberger; Geoffrey Michael,1,0,34,33
1656325498030,MATH 109,A02,083214,Ganzberger; Geoffrey Michael,0,0,34,34
1656325498030,MATH 109,A03,093478,Staff,2,0,34,32
1656325498030,MATH 109,B01,083215,Ganzberger; Geoffrey Michael,2,0,32,30
1656325498030,MATH 109,B02,083216,Ganzberger; Geoffrey Michael,0,0,32,32
1656325498030,MATH 109,B03,093479,Staff,4,0,32,28
1656325504056,MATH 142A,A01,083219,Chow; Bennett,0,0,32,32
1656325504056,MATH 142A,A02,083220,Chow; Bennett,8,0,32,24
1656325504056,MATH 142A,A03,093480,Staff,4,0,32,28
1656325504056,MATH 142A,B03,093481,Staff,3,0,32,29
1656325504056,MATH 142A,B04,093558,Staff,7,0,32,25
1656325504056,MATH 142A,B05,093559,Staff,1,0,32,31
1656325510081,MATH 193A,A01,083224,Rotar; Vladimir,0,1,34,34
1656325510081,MATH 193A,A02,083225,Rotar; Vladimir,0,0,34,34
1656325510081,MATH 193A,A03,083781,Rotar; Vladimir,0,0,34,34
1656325510081,MATH 193A,A04,083782,Rotar; Vladimir,5,0,34,29
1656325510081,MATH 193A,A05,093482,Rotar; Vladimir,0,0,34,34
1656325516109,MATH 197,001,091859,McAuley; Julian John,9999,0,9999,0
1656325516109,MATH 197,002,095566,Kedlaya; Kiran S.,9997,0,9999,2
1656325516109,MATH 197,003,095567,Xiao; Ming,9999,0,9999,0
1656325516109,MATH 197,004,095571,Perols; Johan Lars,9998,0,9999,1
1656325523177,COGS 9,A01,083615,Shannon; Kyle Michael,3,0,75,72
1656325529204,COGS 11,A01,083617,Boyle; Mary E. T.,17,0,48,31
1656325535231,COGS 13,A01,083071,Bastos; Amalia Pinkusfeld,5,0,71,66
1656325541256,COGS 14A,A01,092681,Semenuks; Arturs,0,7,100,104
1656325547279,COGS 14B,A01,083073,Cheng; Tzu-Han,7,0,63,56
1656325553304,COGS 17,A01,092677,Semenuks; Arturs,6,0,81,75
1656325559329,COGS 100,A01,083619,Allen; Michael Gordon,2,0,70,68
1656325565356,COGS 101A,A01,083621,Davis; Joshua Daniel,5,0,68,63
1656325571382,COGS 101B,A01,091572,Allen; Michael Gordon,4,0,65,61
1656325577406,COGS 101C,A01,083625,Delgado; Tania,11,0,35,24
1656325583429,COGS 107A,A01,083627,Boyle; Mary E. T.,2,0,60,58
1656325589454,COGS 118A,A01,083075,Gupta; Anjum,8,0,76,68
1656325595482,CSE 3,A50,083646,Miranda; Gregory Joseph,18,0,50,32
1656325601511,CSE 8A,A50,083650,Miranda; Gregory Joseph,5,2,56,51
1656325607536,CSE 11,A01,083080,Cao; Yingjun,0,46,40,40
1656325613561,CSE 12,A01,083652,Krause-Levy; Sophia Louisa,5,1,120,115
1656325619586,CSE 15L,A01,083654,Morris; Justin Loren,2,0,50,48
1656325619586,CSE 15L,A02,083655,Morris; Justin Loren,4,0,50,46
1656325625609,CSE 20,A01,083657,Tran; Khoa Dang,31,0,80,49
1656325631634,CSE 21,A01,095574,Bach; Quang Tran,23,0,48,25
1656325637657,CSE 30,A01,083084,Eldon; John,1,4,80,79
1656325637657,CSE 30,B01,095061,Bhaskar; Nishant,0,1,50,50
1656325643682,CSE 100,A01,083659,Cao; Yingjun,1,18,70,69
1656325649707,CSE 134B,A01,083661,Powell; Thomas Allan,7,0,100,93
1656325655752,CSE 140,A01,083663,Gungor; Onat,9,0,85,76
1656325661775,CSE 140L,A01,083088,Eldon; John,10,0,100,90
1656325667801,CSE 175,A01,083665,Kumar; Rakesh,0,0,25,25
1656325673828,CSE 190,A00,092507,Dubnov; Shlomo,4,0,20,16
1656325679853,ECE 45,A01,083139,Congero; Spencer William,1,0,75,74
1656325685877,ECE 65,A50,083695,Saad; Andrew S,10,0,30,20
1656325685877,ECE 65,A51,095125,Staff,25,0,26,1
1656325691904,ECE 109,A01,091882,Touri; Behrouz,0,1,70,70
1656325697928,ECE 180,A00,083140,Abi Samra; Nicholas Camill,2,0,30,28
1656325697928,ECE 180,B00,083141,Abi Samra; Nicholas Camill,0,4,30,30
1656325703958,MATH 10A,A01,083735,Patchell; Gregory David,0,0,30,30
1656325703958,MATH 10A,A02,083736,Patchell; Gregory David,22,0,30,8
1656325703958,MATH 10A,A03,083737,Patchell; Gregory David,16,0,30,14
1656325709983,MATH 10B,A01,083207,Lim; Seonhee,2,0,34,32
1656325709983,MATH 10B,A02,083208,Lim; Seonhee,4,0,35,31
1656325709983,MATH 10B,A03,093472,Staff,1,0,34,33
1656325709983,MATH 10B,B01,083739,Sinha; Shubham,11,0,30,19
1656325716008,MATH 18,A01,083743,Cinel; Cameron Alexander,7,0,30,23
1656325716008,MATH 18,A02,083744,Cinel; Cameron Alexander,10,0,30,20
1656325716008,MATH 18,A03,083745,Cinel; Cameron Alexander,5,0,30,25
1656325716008,MATH 18,B01,083748,Rideout; David Porter,0,0,36,36
1656325716008,MATH 18,B02,083749,Rideout; David Porter,0,0,36,36
1656325716008,MATH 18,B03,083750,Rideout; David Porter,0,0,36,36
1656325716008,MATH 18,B04,083751,Rideout; David Porter,0,1,36,36
1656325716008,MATH 18,B05,093473,Rideout; David Porter,0,0,36,36
1656325716008,MATH 18,B06,093474,Rideout; David Porter,2,0,36,34
1656325722035,MATH 20A,A01,083754,Zheng; Zequn,11,0,40,29
1656325728061,MATH 20B,A01,083756,Briones; Jor-el Thomas Caparas,0,0,36,36
1656325728061,MATH 20B,A02,083757,Briones; Jor-el Thomas Caparas,0,0,36,36
1656325728061,MATH 20B,A03,093475,Staff,1,0,36,35
1656325734086,MATH 20C,A01,083760,Briones; Jor-el Thomas Caparas,0,1,35,35
1656325734086,MATH 20C,A02,083761,Briones; Jor-el Thomas Caparas,9,1,35,26
1656325734086,MATH 20C,A03,093476,Staff,0,0,35,35
1656325734086,MATH 20C,B01,083762,Bach; Quang Tran,2,0,30,28
1656325740115,MATH 20D,A01,083765,Tran; Brian Kha,1,0,30,29
1656325740115,MATH 20D,A02,083766,Tran; Brian Kha,0,0,30,30
1656325740115,MATH 20D,A03,083767,Tran; Brian Kha,2,0,30,28
1656325746145,MATH 20E,A01,083771,Ganguly; Soumya,1,0,32,31
1656325746145,MATH 20E,A02,083772,Ganguly; Soumya,0,0,32,32
1656325746145,MATH 20E,B01,083773,Ciotti; Benjamin,18,0,35,17
1656325746145,MATH 20E,B02,083774,Ciotti; Benjamin,16,0,35,19
1656325752175,MATH 103A,A01,083777,Greenfeld; Be'Eri,2,0,36,34
1656325752175,MATH 103A,A02,083778,Greenfeld; Be'Eri,4,0,36,32
1656325752175,MATH 103A,A03,093561,Staff,3,0,36,33
1656325752175,MATH 103A,B01,083779,Greenfeld; Be'Eri,7,0,36,29
1656325752175,MATH 103A,B02,083780,Greenfeld; Be'Eri,0,0,36,36
1656325752175,MATH 103A,B03,093562,Staff,1,0,36,35
1656325758198,MATH 105,A01,085443,Carter; Anne Toulson,3,0,35,32
1656325758198,MATH 105,A02,093477,Staff,15,0,35,20
1656325764222,MATH 109,A01,083213,Ganzberger; Geoffrey Michael,1,0,34,33
1656325764222,MATH 109,A02,083214,Ganzberger; Geoffrey Michael,0,0,34,34
1656325764222,MATH 109,A03,093478,Staff,2,0,34,32
1656325764222,MATH 109,B01,083215,Ganzberger; Geoffrey Michael,2,0,32,30
1656325764222,MATH 109,B02,083216,Ganzberger; Geoffrey Michael,0,0,32,32
1656325764222,MATH 109,B03,093479,Staff,4,0,32,28
1656325770249,MATH 142A,A01,083219,Chow; Bennett,0,0,32,32
1656325770249,MATH 142A,A02,083220,Chow; Bennett,8,0,32,24
1656325770249,MATH 142A,A03,093480,Staff,4,0,32,28
1656325770249,MATH 142A,B03,093481,Staff,3,0,32,29
1656325770249,MATH 142A,B04,093558,Staff,7,0,32,25
1656325770249,MATH 142A,B05,093559,Staff,1,0,32,31
1656325776273,MATH 193A,A01,083224,Rotar; Vladimir,0,1,34,34
1656325776273,MATH 193A,A02,083225,Rotar; Vladimir,0,0,34,34
1656325776273,MATH 193A,A03,083781,Rotar; Vladimir,0,0,34,34
1656325776273,MATH 193A,A04,083782,Rotar; Vladimir,5,0,34,29
1656325776273,MATH 193A,A05,093482,Rotar; Vladimir,0,0,34,34
1656325782300,MATH 197,001,091859,McAuley; Julian John,9999,0,9999,0
1656325782300,MATH 197,002,095566,Kedlaya; Kiran S.,9997,0,9999,2
1656325782300,MATH 197,003,095567,Xiao; Ming,9999,0,9999,0
1656325782300,MATH 197,004,095571,Perols; Johan Lars,9998,0,9999,1
1656325789368,COGS 9,A01,083615,Shannon; Kyle Michael,3,0,75,72
1656325795389,COGS 11,A01,083617,Boyle; Mary E. T.,17,0,48,31
1656325801415,COGS 13,A01,083071,Bastos; Amalia Pinkusfeld,5,0,71,66
1656325807438,COGS 14A,A01,092681,Semenuks; Arturs,0,7,100,104
1656325813461,COGS 14B,A01,083073,Cheng; Tzu-Han,7,0,63,56
1656325819487,COGS 17,A01,092677,Semenuks; Arturs,6,0,81,75
1656325825589,COGS 100,A01,083619,Allen; Michael Gordon,2,0,70,68
1656325831613,COGS 101A,A01,083621,Davis; Joshua Daniel,5,0,68,63
1656325837640,COGS 101B,A01,091572,Allen; Michael Gordon,4,0,65,61
1656325843667,COGS 101C,A01,083625,Delgado; Tania,11,0,35,24
1656325849699,COGS 107A,A01,083627,Boyle; Mary E. T.,2,0,60,58
1656325855726,COGS 118A,A01,083075,Gupta; Anjum,8,0,76,68
1656325861755,CSE 3,A50,083646,Miranda; Gregory Joseph,18,0,50,32
1656325867783,CSE 8A,A50,083650,Miranda; Gregory Joseph,5,2,56,51
1656325873807,CSE 11,A01,083080,Cao; Yingjun,0,46,40,40
1656325879831,CSE 12,A01,083652,Krause-Levy; Sophia Louisa,5,1,120,115
1656325885859,CSE 15L,A01,083654,Morris; Justin Loren,2,0,50,48
1656325885859,CSE 15L,A02,083655,Morris; Justin Loren,4,0,50,46
1656325891888,CSE 20,A01,083657,Tran; Khoa Dang,31,0,80,49
1656325897926,CSE 21,A01,095574,Bach; Quang Tran,23,0,48,25
1656325903950,CSE 30,A01,083084,Eldon; John,1,4,80,79
1656325903950,CSE 30,B01,095061,Bhaskar; Nishant,0,1,50,50
1656325909977,CSE 100,A01,083659,Cao; Yingjun,1,18,70,69
1656325916001,CSE 134B,A01,083661,Powell; Thomas Allan,7,0,100,93
1656325922032,CSE 140,A01,083663,Gungor; Onat,9,0,85,76
1656325928059,CSE 140L,A01,083088,Eldon; John,10,0,100,90
1656325934088,CSE 175,A01,083665,Kumar; Rakesh,0,0,25,25
1656325940116,CSE 190,A00,092507,Dubnov; Shlomo,4,0,20,16
1656325946139,ECE 45,A01,083139,Congero; Spencer William,1,0,75,74
1656325952168,ECE 65,A50,083695,Saad; Andrew S,10,0,30,20
1656325952168,ECE 65,A51,095125,Staff,25,0,26,1
1656325958196,ECE 109,A01,091882,Touri; Behrouz,0,1,70,70
1656325964233,ECE 180,A00,083140,Abi Samra; Nicholas Camill,2,0,30,28
1656325964233,ECE 180,B00,083141,Abi Samra; Nicholas Camill,0,4,30,30
1656325970260,MATH 10A,A01,083735,Patchell; Gregory David,0,0,30,30
1656325970260,MATH 10A,A02,083736,Patchell; Gregory David,22,0,30,8
1656325970260,MATH 10A,A03,083737,Patchell; Gregory David,16,0,30,14
1656325976292,MATH 10B,A01,083207,Lim; Seonhee,2,0,34,32
1656325976292,MATH 10B,A02,083208,Lim; Seonhee,4,0,35,31
1656325976292,MATH 10B,A03,093472,Staff,1,0,34,33
1656325976292,MATH 10B,B01,083739,Sinha; Shubham,11,0,30,19
1656325982318,MATH 18,A01,083743,Cinel; Cameron Alexander,7,0,30,23
1656325982318,MATH 18,A02,083744,Cinel; Cameron Alexander,10,0,30,20
1656325982318,MATH 18,A03,083745,Cinel; Cameron Alexander,5,0,30,25
1656325982318,MATH 18,B01,083748,Rideout; David Porter,0,0,36,36
1656325982318,MATH 18,B02,083749,Rideout; David Porter,0,0,36,36
1656325982318,MATH 18,B03,083750,Rideout; David Porter,0,0,36,36
1656325982318,MATH 18,B04,083751,Rideout; David Porter,0,1,36,36
1656325982318,MATH 18,B05,093473,Rideout; David Porter,0,0,36,36
1656325982318,MATH 18,B06,093474,Rideout; David Porter,2,0,36,34
1656325988345,MATH 20A,A01,083754,Zheng; Zequn,11,0,40,29
1656325994375,MATH 20B,A01,083756,Briones; Jor-el Thomas Caparas,0,0,36,36
1656325994375,MATH 20B,A02,083757,Briones; Jor-el Thomas Caparas,0,0,36,36
1656325994375,MATH 20B,A03,093475,Staff,1,0,36,35
1656326000400,MATH 20C,A01,083760,Briones; Jor-el Thomas Caparas,0,1,35,35
1656326000400,MATH 20C,A02,083761,Briones; Jor-el Thomas Caparas,9,1,35,26
1656326000400,MATH 20C,A03,093476,Staff,0,0,35,35
1656326000400,MATH 20C,B01,083762,Bach; Quang Tran,2,0,30,28
1656326006425,MATH 20D,A01,083765,Tran; Brian Kha,1,0,30,29
1656326006425,MATH 20D,A02,083766,Tran; Brian Kha,0,0,30,30
1656326006425,MATH 20D,A03,083767,Tran; Brian Kha,2,0,30,28
1656326012458,MATH 20E,A01,083771,Ganguly; Soumya,1,0,32,31
1656326012458,MATH 20E,A02,083772,Ganguly; Soumya,0,0,32,32
1656326012458,MATH 20E,B01,083773,Ciotti; Benjamin,18,0,35,17
1656326012458,MATH 20E,B02,083774,Ciotti; Benjamin,16,0,35,19
1656326018482,MATH 103A,A01,083777,Greenfeld; Be'Eri,2,0,36,34
1656326018482,MATH 103A,A02,083778,Greenfeld; Be'Eri,4,0,36,32
1656326018482,MATH 103A,A03,093561,Staff,3,0,36,33
1656326018482,MATH 103A,B01,083779,Greenfeld; Be'Eri,7,0,36,29
1656326018482,MATH 103A,B02,083780,Greenfeld; Be'Eri,0,0,36,36
1656326018482,MATH 103A,B03,093562,Staff,1,0,36,35
1656326024510,MATH 105,A01,085443,Carter; Anne Toulson,3,0,35,32
1656326024510,MATH 105,A02,093477,Staff,15,0,35,20
1656326030540,MATH 109,A01,083213,Ganzberger; Geoffrey Michael,1,0,34,33
1656326030540,MATH 109,A02,083214,Ganzberger; Geoffrey Michael,0,0,34,34
1656326030540,MATH 109,A03,093478,Staff,2,0,34,32
1656326030540,MATH 109,B01,083215,Ganzberger; Geoffrey Michael,2,0,32,30
1656326030540,MATH 109,B02,083216,Ganzberger; Geoffrey Michael,0,0,32,32
1656326030540,MATH 109,B03,093479,Staff,4,0,32,28
1656326036564,MATH 142A,A01,083219,Chow; Bennett,0,0,32,32
1656326036564,MATH 142A,A02,083220,Chow; Bennett,8,0,32,24
1656326036564,MATH 142A,A03,093480,Staff,4,0,32,28
1656326036564,MATH 142A,B03,093481,Staff,3,0,32,29
1656326036564,MATH 142A,B04,093558,Staff,7,0,32,25
1656326036564,MATH 142A,B05,093559,Staff,1,0,32,31
1656326042588,MATH 193A,A01,083224,Rotar; Vladimir,0,1,34,34
1656326042588,MATH 193A,A02,083225,Rotar; Vladimir,0,0,34,34
1656326042588,MATH 193A,A03,083781,Rotar; Vladimir,0,0,34,34
1656326042588,MATH 193A,A04,083782,Rotar; Vladimir,5,0,34,29
1656326042588,MATH 193A,A05,093482,Rotar; Vladimir,0,0,34,34
1656326048616,MATH 197,001,091859,McAuley; Julian John,9999,0,9999,0
1656326048616,MATH 197,002,095566,Kedlaya; Kiran S.,9997,0,9999,2
1656326048616,MATH 197,003,095567,Xiao; Ming,9999,0,9999,0
1656326048616,MATH 197,004,095571,Perols; Johan Lars,9998,0,9999,1
1656326055675,COGS 9,A01,083615,Shannon; Kyle Michael,3,0,75,72
1656326061698,COGS 11,A01,083617,Boyle; Mary E. T.,17,0,48,31
1656326067727,COGS 13,A01,083071,Bastos; Amalia Pinkusfeld,5,0,71,66
1656326073750,COGS 14A,A01,092681,Semenuks; Arturs,0,7,100,104
1656326079775,COGS 14B,A01,083073,Cheng; Tzu-Han,7,0,63,56
1656326085798,COGS 17,A01,092677,Semenuks; Arturs,6,0,81,75
1656326091821,COGS 100,A01,083619,Allen; Michael Gordon,2,0,70,68
1656326097846,COGS 101A,A01,083621,Davis; Joshua Daniel,5,0,68,63
1656326103877,COGS 101B,A01,091572,Allen; Michael Gordon,4,0,65,61
1656326109901,COGS 101C,A01,083625,Delgado; Tania,11,0,35,24
1656326115925,COGS 107A,A01,083627,Boyle; Mary E. T.,2,0,60,58
1656326121951,COGS 118A,A01,083075,Gupta; Anjum,8,0,76,68
1656326127980,CSE 3,A50,083646,Miranda; Gregory Joseph,18,0,50,32
1656326134008,CSE 8A,A50,083650,Miranda; Gregory Joseph,5,2,56,51
1656326140042,CSE 11,A01,083080,Cao; Yingjun,0,46,40,40
1656326146071,CSE 12,A01,083652,Krause-Levy; Sophia Louisa,5,1,120,115
1656326152095,CSE 15L,A01,083654,Morris; Justin Loren,2,0,50,48
1656326152095,CSE 15L,A02,083655,Morris; Justin Loren,4,0,50,46
1656326158127,CSE 20,A01,083657,Tran; Khoa Dang,31,0,80,49
1656326164151,CSE 21,A01,095574,Bach; Quang Tran,23,0,48,25
1656326170177,CSE 30,A01,083084,Eldon; John,1,4,80,79
1656326170177,CSE 30,B01,095061,Bhaskar; Nishant,0,1,50,50
1656326176205,CSE 100,A01,083659,Cao; Yingjun,1,18,70,69
1656326182234,CSE 134B,A01,083661,Powell; Thomas Allan,7,0,100,93
1656326188259,CSE 140,A01,083663,Gungor; Onat,9,0,85,76
1656326194287,CSE 140L,A01,083088,Eldon; John,10,0,100,90
1656326200316,CSE 175,A01,083665,Kumar; Rakesh,0,0,25,25
1656326206345,CSE 190,A00,092507,Dubnov; Shlomo,4,0,20,16
1656326212376,ECE 45,A01,083139,Congero; Spencer William,1,0,75,74
1656326218402,ECE 65,A50,083695,Saad; Andrew S,10,0,30,20
1656326218402,ECE 65,A51,095125,Staff,25,0,26,1
1656326224440,ECE 109,A01,091882,Touri; Behrouz,0,1,70,70
1656326230466,ECE 180,A00,083140,Abi Samra; Nicholas Camill,2,0,30,28
1656326230466,ECE 180,B00,083141,Abi Samra; Nicholas Camill,0,4,30,30
1656326236504,MATH 10A,A01,083735,Patchell; Gregory David,0,0,30,30
1656326236504,MATH 10A,A02,083736,Patchell; Gregory David,22,0,30,8
1656326236504,MATH 10A,A03,083737,Patchell; Gregory David,16,0,30,14
1656326242531,MATH 10B,A01,083207,Lim; Seonhee,2,0,34,32
1656326242531,MATH 10B,A02,083208,Lim; Seonhee,4,0,35,31
1656326242531,MATH 10B,A03,093472,Staff,1,0,34,33
1656326242531,MATH 10B,B01,083739,Sinha; Shubham,11,0,30,19
1656326248571,MATH 18,A01,083743,Cinel; Cameron Alexander,7,0,30,23
1656326248571,MATH 18,A02,083744,Cinel; Cameron Alexander,10,0,30,20
1656326248571,MATH 18,A03,083745,Cinel; Cameron Alexander,5,0,30,25
1656326248571,MATH 18,B01,083748,Rideout; David Porter,0,0,36,36
1656326248571,MATH 18,B02,083749,Rideout; David Porter,0,0,36,36
1656326248571,MATH 18,B03,083750,Rideout; David Porter,0,0,36,36
1656326248571,MATH 18,B04,083751,Rideout; David Porter,0,1,36,36
1656326248571,MATH 18,B05,093473,Rideout; David Porter,0,0,36,36
1656326248571,MATH 18,B06,093474,Rideout; David Porter,2,0,36,34
1656326254597,MATH 20A,A01,083754,Zheng; Zequn,11,0,40,29
1656326260622,MATH 20B,A01,083756,Briones; Jor-el Thomas Caparas,0,0,36,36
1656326260622,MATH 20B,A02,083757,Briones; Jor-el Thomas Caparas,0,0,36,36
1656326260622,MATH 20B,A03,093475,Staff,1,0,36,35
1656326266649,MATH 20C,A01,083760,Briones; Jor-el Thomas Caparas,0,1,35,35
1656326266649,MATH 20C,A02,083761,Briones; Jor-el Thomas Caparas,9,1,35,26
1656326266649,MATH 20C,A03,093476,Staff,0,0,35,35
1656326266649,MATH 20C,B01,083762,Bach; Quang Tran,2,0,30,28
1656326272672,MATH 20D,A01,083765,Tran; Brian Kha,1,0,30,29
1656326272672,MATH 20D,A02,083766,Tran; Brian Kha,0,0,30,30
1656326272672,MATH 20D,A03,083767,Tran; Brian Kha,2,0,30,28
1656326278697,MATH 20E,A01,083771,Ganguly; Soumya,1,0,32,31
1656326278697,MATH 20E,A02,083772,Ganguly; Soumya,0,0,32,32
1656326278697,MATH 20E,B01,083773,Ciotti; Benjamin,18,0,35,17
1656326278697,MATH 20E,B02,083774,Ciotti; Benjamin,16,0,35,19
1656326284730,MATH 103A,A01,083777,Greenfeld; Be'Eri,2,0,36,34
1656326284730,MATH 103A,A02,083778,Greenfeld; Be'Eri,4,0,36,32
1656326284730,MATH 103A,A03,093561,Staff,3,0,36,33
1656326284730,MATH 103A,B01,083779,Greenfeld; Be'Eri,7,0,36,29
1656326284730,MATH 103A,B02,083780,Greenfeld; Be'Eri,0,0,36,36
1656326284730,MATH 103A,B03,093562,Staff,1,0,36,35
1656326290762,MATH 105,A01,085443,Carter; Anne Toulson,3,0,35,32
1656326290762,MATH 105,A02,093477,Staff,15,0,35,20
1656326296787,MATH 109,A01,083213,Ganzberger; Geoffrey Michael,1,0,34,33
1656326296787,MATH 109,A02,083214,Ganzberger; Geoffrey Michael,0,0,34,34
1656326296787,MATH 109,A03,093478,Staff,2,0,34,32
1656326296787,MATH 109,B01,083215,Ganzberger; Geoffrey Michael,2,0,32,30
1656326296787,MATH 109,B02,083216,Ganzberger; Geoffrey Michael,0,0,32,32
1656326296787,MATH 109,B03,093479,Staff,4,0,32,28
1656326302820,MATH 142A,A01,083219,Chow; Bennett,0,0,32,32
1656326302820,MATH 142A,A02,083220,Chow; Bennett,8,0,32,24
1656326302820,MATH 142A,A03,093480,Staff,4,0,32,28
1656326302820,MATH 142A,B03,093481,Staff,3,0,32,29
1656326302820,MATH 142A,B04,093558,Staff,7,0,32,25
1656326302820,MATH 142A,B05,093559,Staff,1,0,32,31
1656326308845,MATH 193A,A01,083224,Rotar; Vladimir,0,1,34,34
1656326308845,MATH 193A,A02,083225,Rotar; Vladimir,0,0,34,34
1656326308845,MATH 193A,A03,083781,Rotar; Vladimir,0,0,34,34
1656326308845,MATH 193A,A04,083782,Rotar; Vladimir,5,0,34,29
1656326308845,MATH 193A,A05,093482,Rotar; Vladimir,0,0,34,34
1656326314879,MATH 197,001,091859,McAuley; Julian John,9999,0,9999,0
1656326314879,MATH 197,002,095566,Kedlaya; Kiran S.,9997,0,9999,2
1656326314879,MATH 197,003,095567,Xiao; Ming,9999,0,9999,0
1656326314879,MATH 197,004,095571,Perols; Johan Lars,9998,0,9999,1
1656326321943,COGS 9,A01,083615,Shannon; Kyle Michael,3,0,75,72
1656326327972,COGS 11,A01,083617,Boyle; Mary E. T.,17,0,48,31
1656326334008,COGS 13,A01,083071,Bastos; Amalia Pinkusfeld,5,0,71,66
1656326340035,COGS 14A,A01,092681,Semenuks; Arturs,0,7,100,104
1656326346064,COGS 14B,A01,083073,Cheng; Tzu-Han,7,0,63,56
1656326352088,COGS 17,A01,092677,Semenuks; Arturs,6,0,81,75
1656326358113,COGS 100,A01,083619,Allen; Michael Gordon,2,0,70,68
1656326364142,COGS 101A,A01,083621,Davis; Joshua Daniel,5,0,68,63
1656326370174,COGS 101B,A01,091572,Allen; Michael Gordon,4,0,65,61
1656326376200,COGS 101C,A01,083625,Delgado; Tania,11,0,35,24
1656326382227,COGS 107A,A01,083627,Boyle; Mary E. T.,2,0,60,58
1656326388252,COGS 118A,A01,083075,Gupta; Anjum,8,0,76,68
1656326394286,CSE 3,A50,083646,Miranda; Gregory Joseph,18,0,50,32
1656326400329,CSE 8A,A50,083650,Miranda; Gregory Joseph,5,2,56,51
1656326406357,CSE 11,A01,083080,Cao; Yingjun,0,46,40,40
1656326412383,CSE 12,A01,083652,Krause-Levy; Sophia Louisa,5,1,120,115
1656326418414,CSE 15L,A01,083654,Morris; Justin Loren,2,0,50,48
1656326418414,CSE 15L,A02,083655,Morris; Justin Loren,4,0,50,46
1656326424532,CSE 20,A01,083657,Tran; Khoa Dang,31,0,80,49
1656326430561,CSE 21,A01,095574,Bach; Quang Tran,23,0,48,25
1656326436592,CSE 30,A01,083084,Eldon; John,1,4,80,79
1656326436592,CSE 30,B01,095061,Bhaskar; Nishant,0,1,50,50
1656326442622,CSE 100,A01,083659,Cao; Yingjun,1,18,70,69
1656326448652,CSE 134B,A01,083661,Powell; Thomas Allan,7,0,100,93
1656326454678,CSE 140,A01,083663,Gungor; Onat,9,0,85,76
1656326460711,CSE 140L,A01,083088,Eldon; John,10,0,100,90
1656326466747,CSE 175,A01,083665,Kumar; Rakesh,0,0,25,25
1656326472773,CSE 190,A00,092507,Dubnov; Shlomo,4,0,20,16
1656326478800,ECE 45,A01,083139,Congero; Spencer William,1,0,75,74
1656326484832,ECE 65,A50,083695,Saad; Andrew S,10,0,30,20
1656326484832,ECE 65,A51,095125,Staff,25,0,26,1
1656326490858,ECE 109,A01,091882,Touri; Behrouz,0,1,70,70
1656326496886,ECE 180,A00,083140,Abi Samra; Nicholas Camill,2,0,30,28
1656326496886,ECE 180,B00,083141,Abi Samra; Nicholas Camill,0,4,30,30
1656326502925,MATH 10A,A01,083735,Patchell; Gregory David,0,0,30,30
1656326502925,MATH 10A,A02,083736,Patchell; Gregory David,22,0,30,8
1656326502925,MATH 10A,A03,083737,Patchell; Gregory David,16,0,30,14
1656326508954,MATH 10B,A01,083207,Lim; Seonhee,2,0,34,32
1656326508954,MATH 10B,A02,083208,Lim; Seonhee,4,0,35,31
1656326508954,MATH 10B,A03,093472,Staff,1,0,34,33
1656326508954,MATH 10B,B01,083739,Sinha; Shubham,11,0,30,19
1656326514985,MATH 18,A01,083743,Cinel; Cameron Alexander,7,0,30,23
1656326514985,MATH 18,A02,083744,Cinel; Cameron Alexander,10,0,30,20
1656326514985,MATH 18,A03,083745,Cinel; Cameron Alexander,5,0,30,25
1656326514985,MATH 18,B01,083748,Rideout; David Porter,0,0,36,36
1656326514985,MATH 18,B02,083749,Rideout; David Porter,0,0,36,36
1656326514985,MATH 18,B03,083750,Rideout; David Porter,0,0,36,36
1656326514985,MATH 18,B04,083751,Rideout; David Porter,0,1,36,36
1656326514985,MATH 18,B05,093473,Rideout; David Porter,0,0,36,36
1656326514985,MATH 18,B06,093474,Rideout; David Porter,2,0,36,34
1656326521018,MATH 20A,A01,083754,Zheng; Zequn,11,0,40,29
1656326527046,MATH 20B,A01,083756,Briones; Jor-el Thomas Caparas,0,0,36,36
1656326527046,MATH 20B,A02,083757,Briones; Jor-el Thomas Caparas,0,0,36,36
1656326527046,MATH 20B,A03,093475,Staff,1,0,36,35
1656326533072,MATH 20C,A01,083760,Briones; Jor-el Thomas Caparas,0,1,35,35
1656326533072,MATH 20C,A02,083761,Briones; Jor-el Thomas Caparas,9,1,35,26
1656326533072,MATH 20C,A03,093476,Staff,0,0,35,35
1656326533072,MATH 20C,B01,083762,Bach; Quang Tran,2,0,30,28
1656326539101,MATH 20D,A01,083765,Tran; Brian Kha,1,0,30,29
1656326539101,MATH 20D,A02,083766,Tran; Brian Kha,0,0,30,30
1656326539101,MATH 20D,A03,083767,Tran; Brian Kha,2,0,30,28
1656326545138,MATH 20E,A01,083771,Ganguly; Soumya,1,0,32,31
1656326545138,MATH 20E,A02,083772,Ganguly; Soumya,0,0,32,32
1656326545138,MATH 20E,B01,083773,Ciotti; Benjamin,18,0,35,17
1656326545138,MATH 20E,B02,083774,Ciotti; Benjamin,16,0,35,19
1656326551166,MATH 103A,A01,083777,Greenfeld; Be'Eri,2,0,36,34
1656326551166,MATH 103A,A02,083778,Greenfeld; Be'Eri,4,0,36,32
1656326551166,MATH 103A,A03,093561,Staff,3,0,36,33
1656326551166,MATH 103A,B01,083779,Greenfeld; Be'Eri,7,0,36,29
1656326551166,MATH 103A,B02,083780,Greenfeld; Be'Eri,0,0,36,36
1656326551166,MATH 103A,B03,093562,Staff,1,0,36,35
1656326557195,MATH 105,A01,085443,Carter; Anne Toulson,3,0,35,32
1656326557195,MATH 105,A02,093477,Staff,15,0,35,20
1656326563225,MATH 109,A01,083213,Ganzberger; Geoffrey Michael,1,0,34,33
1656326563225,MATH 109,A02,083214,Ganzberger; Geoffrey Michael,0,0,34,34
1656326563225,MATH 109,A03,093478,Staff,2,0,34,32
1656326563225,MATH 109,B01,083215,Ganzberger; Geoffrey Michael,2,0,32,30
1656326563225,MATH 109,B02,083216,Ganzberger; Geoffrey Michael,0,0,32,32
1656326563225,MATH 109,B03,093479,Staff,4,0,32,28
1656326569258,MATH 142A,A01,083219,Chow; Bennett,0,0,32,32
1656326569258,MATH 142A,A02,083220,Chow; Bennett,8,0,32,24
1656326569258,MATH 142A,A03,093480,Staff,4,0,32,28
1656326569258,MATH 142A,B03,093481,Staff,3,0,32,29
1656326569258,MATH 142A,B04,093558,Staff,7,0,32,25
1656326569258,MATH 142A,B05,093559,Staff,1,0,32,31
1656326575284,MATH 193A,A01,083224,Rotar; Vladimir,0,1,34,34
1656326575284,MATH 193A,A02,083225,Rotar; Vladimir,0,0,34,34
1656326575284,MATH 193A,A03,083781,Rotar; Vladimir,0,0,34,34
1656326575284,MATH 193A,A04,083782,Rotar; Vladimir,5,0,34,29
1656326575284,MATH 193A,A05,093482,Rotar; Vladimir,0,0,34,34
1656326581311,MATH 197,001,091859,McAuley; Julian John,9999,0,9999,0
1656326581311,MATH 197,002,095566,Kedlaya; Kiran S.,9997,0,9999,2
1656326581311,MATH 197,003,095567,Xiao; Ming,9999,0,9999,0
1656326581311,MATH 197,004,095571,Perols; Johan Lars,9998,0,9999,1
1656326588380,COGS 9,A01,083615,Shannon; Kyle Michael,3,0,75,72
1656326594405,COGS 11,A01,083617,Boyle; Mary E. T.,17,0,48,31
1656326600438,COGS 13,A01,083071,Bastos; Amalia Pinkusfeld,5,0,71,66
1656326606464,COGS 14A,A01,092681,Semenuks; Arturs,0,7,100,104
1656326612490,COGS 14B,A01,083073,Cheng; Tzu-Han,7,0,63,56
1656326618515,COGS 17,A01,092677,Semenuks; Arturs,6,0,81,75
1656326624539,COGS 100,A01,083619,Allen; Michael Gordon,2,0,70,68
1656326630564,COGS 101A,A01,083621,Davis; Joshua Daniel,5,0,68,63
1656326636602,COGS 101B,A01,091572,Allen; Michael Gordon,4,0,65,61
1656326642627,COGS 101C,A01,083625,Delgado; Tania,11,0,35,24
1656326648657,COGS 107A,A01,083627,Boyle; Mary E. T.,2,0,60,58
1656326654687,COGS 118A,A01,083075,Gupta; Anjum,8,0,76,68
1656326660724,CSE 3,A50,083646,Miranda; Gregory Joseph,18,0,50,32
1656326666754,CSE 8A,A50,083650,Miranda; Gregory Joseph,5,2,56,51
1656326672779,CSE 11,A01,083080,Cao; Yingjun,0,46,40,40
1656326678806,CSE 12,A01,083652,Krause-Levy; Sophia Louisa,5,1,120,115
1656326684834,CSE 15L,A01,083654,Morris; Justin Loren,2,0,50,48
1656326684834,CSE 15L,A02,083655,Morris; Justin Loren,4,0,50,46
1656326690859,CSE 20,A01,083657,Tran; Khoa Dang,31,0,80,49
1656326696890,CSE 21,A01,095574,Bach; Quang Tran,23,0,48,25
1656326702924,CSE 30,A01,083084,Eldon; John,1,4,80,79
1656326702924,CSE 30,B01,095061,Bhaskar; Nishant,0,1,50,50
1656326708958,CSE 100,A01,083659,Cao; Yingjun,1,18,70,69
1656326714983,CSE 134B,A01,083661,Powell; Thomas Allan,7,0,100,93
1656326721013,CSE 140,A01,083663,Gungor; Onat,9,0,85,76
1656326727041,CSE 140L,A01,083088,Eldon; John,10,0,100,90
1656326733081,CSE 175,A01,083665,Kumar; Rakesh,0,0,25,25
1656326739117,CSE 190,A00,092507,Dubnov; Shlomo,4,0,20,16
1656326745143,ECE 45,A01,083139,Congero; Spencer William,1,0,75,74
1656326751175,ECE 65,A50,083695,Saad; Andrew S,10,0,30,20
1656326751175,ECE 65,A51,095125,Staff,25,0,26,1
1656326757198,ECE 109,A01,091882,Touri; Behrouz,0,1,70,70
1656326763227,ECE 180,A00,083140,Abi Samra; Nicholas Camill,2,0,30,28
1656326763227,ECE 180,B00,083141,Abi Samra; Nicholas Camill,0,4,30,30
1656326769254,MATH 10A,A01,083735,Patchell; Gregory David,0,0,30,30
1656326769254,MATH 10A,A02,083736,Patchell; Gregory David,22,0,30,8
1656326769254,MATH 10A,A03,083737,Patchell; Gregory David,16,0,30,14
1656326775282,MATH 10B,A01,083207,Lim; Seonhee,2,0,34,32
1656326775282,MATH 10B,A02,083208,Lim; Seonhee,4,0,35,31
1656326775282,MATH 10B,A03,093472,Staff,1,0,34,33
1656326775282,MATH 10B,B01,083739,Sinha; Shubham,11,0,30,19
1656326781311,MATH 18,A01,083743,Cinel; Cameron Alexander,7,0,30,23
1656326781311,MATH 18,A02,083744,Cinel; Cameron Alexander,10,0,30,20
1656326781311,MATH 18,A03,083745,Cinel; Cameron Alexander,5,0,30,25
1656326781311,MATH 18,B01,083748,Rideout; David Porter,0,0,36,36
1656326781311,MATH 18,B02,083749,Rideout; David Porter,0,0,36,36
1656326781311,MATH 18,B03,083750,Rideout; David Porter,0,0,36,36
1656326781311,MATH 18,B04,083751,Rideout; David Porter,0,1,36,36
1656326781311,MATH 18,B05,093473,Rideout; David Porter,0,0,36,36
1656326781311,MATH 18,B06,093474,Rideout; David Porter,2,0,36,34
1656326787342,MATH 20A,A01,083754,Zheng; Zequn,11,0,40,29
1656326793368,MATH 20B,A01,083756,Briones; Jor-el Thomas Caparas,0,0,36,36
1656326793368,MATH 20B,A02,083757,Briones; Jor-el Thomas Caparas,0,0,36,36
1656326793368,MATH 20B,A03,093475,Staff,1,0,36,35
1656326799395,MATH 20C,A01,083760,Briones; Jor-el Thomas Caparas,0,1,35,35
1656326799395,MATH 20C,A02,083761,Briones; Jor-el Thomas Caparas,9,1,35,26
1656326799395,MATH 20C,A03,093476,Staff,0,0,35,35
1656326799395,MATH 20C,B01,083762,Bach; Quang Tran,2,0,30,28
1656326805422,MATH 20D,A01,083765,Tran; Brian Kha,1,0,30,29
1656326805422,MATH 20D,A02,083766,Tran; Brian Kha,0,0,30,30
1656326805422,MATH 20D,A03,083767,Tran; Brian Kha,2,0,30,28
1656326811448,MATH 20E,A01,083771,Ganguly; Soumya,1,0,32,31
1656326811448,MATH 20E,A02,083772,Ganguly; Soumya,0,0,32,32
1656326811448,MATH 20E,B01,083773,Ciotti; Benjamin,18,0,35,17
1656326811448,MATH 20E,B02,083774,Ciotti; Benjamin,16,0,35,19
1656326817484,MATH 103A,A01,083777,Greenfeld; Be'Eri,2,0,36,34
1656326817484,MATH 103A,A02,083778,Greenfeld; Be'Eri,4,0,36,32
1656326817484,MATH 103A,A03,093561,Staff,3,0,36,33
1656326817484,MATH 103A,B01,083779,Greenfeld; Be'Eri,7,0,36,29
1656326817484,MATH 103A,B02,083780,Greenfeld; Be'Eri,0,0,36,36
1656326817484,MATH 103A,B03,093562,Staff,1,0,36,35
1656326823509,MATH 105,A01,085443,Carter; Anne Toulson,3,0,35,32
1656326823509,MATH 105,A02,093477,Staff,15,0,35,20
1656326829537,MATH 109,A01,083213,Ganzberger; Geoffrey Michael,1,0,34,33
1656326829537,MATH 109,A02,083214,Ganzberger; Geoffrey Michael,0,0,34,34
1656326829537,MATH 109,A03,093478,Staff,2,0,34,32
1656326829537,MATH 109,B01,083215,Ganzberger; Geoffrey Michael,2,0,32,30
1656326829537,MATH 109,B02,083216,Ganzberger; Geoffrey Michael,0,0,32,32
1656326829537,MATH 109,B03,093479,Staff,4,0,32,28
1656326835562,MATH 142A,A01,083219,Chow; Bennett,0,0,32,32
1656326835562,MATH 142A,A02,083220,Chow; Bennett,8,0,32,24
1656326835562,MATH 142A,A03,093480,Staff,4,0,32,28
1656326835562,MATH 142A,B03,093481,Staff,3,0,32,29
1656326835562,MATH 142A,B04,093558,Staff,7,0,32,25
1656326835562,MATH 142A,B05,093559,Staff,1,0,32,31
1656326841593,MATH 193A,A01,083224,Rotar; Vladimir,0,1,34,34
1656326841593,MATH 193A,A02,083225,Rotar; Vladimir,0,0,34,34
1656326841593,MATH 193A,A03,083781,Rotar; Vladimir,0,0,34,34
1656326841593,MATH 193A,A04,083782,Rotar; Vladimir,5,0,34,29
1656326841593,MATH 193A,A05,093482,Rotar; Vladimir,0,0,34,34
1656326847625,MATH 197,001,091859,McAuley; Julian John,9999,0,9999,0
1656326847625,MATH 197,002,095566,Kedlaya; Kiran S.,9997,0,9999,2
1656326847625,MATH 197,003,095567,Xiao; Ming,9999,0,9999,0
1656326847625,MATH 197,004,095571,Perols; Johan Lars,9998,0,9999,1
1656326854701,COGS 9,A01,083615,Shannon; Kyle Michael,3,0,75,72
1656326860727,COGS 11,A01,083617,Boyle; Mary E. T.,17,0,48,31
1656326866752,COGS 13,A01,083071,Bastos; Amalia Pinkusfeld,5,0,71,66
1656326872781,COGS 14A,A01,092681,Semenuks; Arturs,0,7,100,104
1656326878809,COGS 14B,A01,083073,Cheng; Tzu-Han,7,0,63,56
1656326884838,COGS 17,A01,092677,Semenuks; Arturs,6,0,81,75
1656326890869,COGS 100,A01,083619,Allen; Michael Gordon,2,0,70,68
1656326896892,COGS 101A,A01,083621,Davis; Joshua Daniel,5,0,68,63
1656326902917,COGS 101B,A01,091572,Allen; Michael Gordon,4,0,65,61
1656326908943,COGS 101C,A01,083625,Delgado; Tania,11,0,35,24
1656326914974,COGS 107A,A01,083627,Boyle; Mary E. T.,2,0,60,58
1656326921000,COGS 118A,A01,083075,Gupta; Anjum,8,0,76,68
1656326927031,CSE 3,A50,083646,Miranda; Gregory Joseph,18,0,50,32
1656326933062,CSE 8A,A50,083650,Miranda; Gregory Joseph,5,2,56,51
1656326939088,CSE 11,A01,083080,Cao; Yingjun,0,46,40,40
1656326945114,CSE 12,A01,083652,Krause-Levy; Sophia Louisa,5,1,120,115
1656326951138,CSE 15L,A01,083654,Morris; Justin Loren,2,0,50,48
1656326951138,CSE 15L,A02,083655,Morris; Justin Loren,4,0,50,46
1656326957164,CSE 20,A01,083657,Tran; Khoa Dang,31,0,80,49
1656326963194,CSE 21,A01,095574,Bach; Quang Tran,23,0,48,25
1656326969220,CSE 30,A01,083084,Eldon; John,1,4,80,79
1656326969220,CSE 30,B01,095061,Bhaskar; Nishant,0,1,50,50
1656326975252,CSE 100,A01,083659,Cao; Yingjun,1,18,70,69
1656326981278,CSE 134B,A01,083661,Powell; Thomas Allan,7,0,100,93
1656326987304,CSE 140,A01,083663,Gungor; Onat,9,0,85,76
1656326993332,CSE 140L,A01,083088,Eldon; John,10,0,100,90
1656326999361,CSE 175,A01,083665,Kumar; Rakesh,0,0,25,25
1656327005387,CSE 190,A00,092507,Dubnov; Shlomo,4,0,20,16
1656327011412,ECE 45,A01,083139,Congero; Spencer William,1,0,75,74
1656327017438,ECE 65,A50,083695,Saad; Andrew S,10,0,30,20
1656327017438,ECE 65,A51,095125,Staff,25,0,26,1
1656327023560,ECE 109,A01,091882,Touri; Behrouz,0,1,70,70
1656327029584,ECE 180,A00,083140,Abi Samra; Nicholas Camill,2,0,30,28
1656327029584,ECE 180,B00,083141,Abi Samra; Nicholas Camill,0,4,30,30
1656327035611,MATH 10A,A01,083735,Patchell; Gregory David,0,0,30,30
1656327035611,MATH 10A,A02,083736,Patchell; Gregory David,22,0,30,8
1656327035611,MATH 10A,A03,083737,Patchell; Gregory David,16,0,30,14
1656327041639,MATH 10B,A01,083207,Lim; Seonhee,2,0,34,32
1656327041639,MATH 10B,A02,083208,Lim; Seonhee,4,0,35,31
1656327041639,MATH 10B,A03,093472,Staff,1,0,34,33
1656327041639,MATH 10B,B01,083739,Sinha; Shubham,11,0,30,19
1656327047668,MATH 18,A01,083743,Cinel; Cameron Alexander,7,0,30,23
1656327047668,MATH 18,A02,083744,Cinel; Cameron Alexander,10,0,30,20
1656327047668,MATH 18,A03,083745,Cinel; Cameron Alexander,5,0,30,25
1656327047668,MATH 18,B01,083748,Rideout; David Porter,0,0,36,36
1656327047668,MATH 18,B02,083749,Rideout; David Porter,0,0,36,36
1656327047668,MATH 18,B03,083750,Rideout; David Porter,0,0,36,36
1656327047668,MATH 18,B04,083751,Rideout; David Porter,0,1,36,36
1656327047668,MATH 18,B05,093473,Rideout; David Porter,0,0,36,36
1656327047668,MATH 18,B06,093474,Rideout; David Porter,2,0,36,34
1656327053691,MATH 20A,A01,083754,Zheng; Zequn,11,0,40,29
1656327059717,MATH 20B,A01,083756,Briones; Jor-el Thomas Caparas,0,0,36,36
1656327059717,MATH 20B,A02,083757,Briones; Jor-el Thomas Caparas,0,0,36,36
1656327059717,MATH 20B,A03,093475,Staff,1,0,36,35
1656327065741,MATH 20C,A01,083760,Briones; Jor-el Thomas Caparas,0,1,35,35
1656327065741,MATH 20C,A02,083761,Briones; Jor-el Thomas Caparas,9,1,35,26
1656327065741,MATH 20C,A03,093476,Staff,0,0,35,35
1656327065741,MATH 20C,B01,083762,Bach; Quang Tran,2,0,30,28
1656327071766,MATH 20D,A01,083765,Tran; Brian Kha,1,0,30,29
1656327071766,MATH 20D,A02,083766,Tran; Brian Kha,0,0,30,30
1656327071766,MATH 20D,A03,083767,Tran; Brian Kha,2,0,30,28
1656327077792,MATH 20E,A01,083771,Ganguly; Soumya,1,0,32,31
1656327077792,MATH 20E,A02,083772,Ganguly; Soumya,0,0,32,32
1656327077792,MATH 20E,B01,083773,Ciotti; Benjamin,18,0,35,17
1656327077792,MATH 20E,B02,083774,Ciotti; Benjamin,16,0,35,19
1656327083817,MATH 103A,A01,083777,Greenfeld; Be'Eri,2,0,36,34
1656327083817,MATH 103A,A02,083778,Greenfeld; Be'Eri,4,0,36,32
1656327083817,MATH 103A,A03,093561,Staff,3,0,36,33
1656327083817,MATH 103A,B01,083779,Greenfeld; Be'Eri,7,0,36,29
1656327083817,MATH 103A,B02,083780,Greenfeld; Be'Eri,0,0,36,36
1656327083817,MATH 103A,B03,093562,Staff,1,0,36,35
1656327089848,MATH 105,A01,085443,Carter; Anne Toulson,3,0,35,32
1656327089848,MATH 105,A02,093477,Staff,15,0,35,20
1656327095875,MATH 109,A01,083213,Ganzberger; Geoffrey Michael,1,0,34,33
1656327095875,MATH 109,A02,083214,Ganzberger; Geoffrey Michael,0,0,34,34
1656327095875,MATH 109,A03,093478,Staff,2,0,34,32
1656327095875,MATH 109,B01,083215,Ganzberger; Geoffrey Michael,2,0,32,30
1656327095875,MATH 109,B02,083216,Ganzberger; Geoffrey Michael,0,0,32,32
1656327095875,MATH 109,B03,093479,Staff,4,0,32,28
1656327101902,MATH 142A,A01,083219,Chow; Bennett,0,0,32,32
1656327101902,MATH 142A,A02,083220,Chow; Bennett,8,0,32,24
1656327101902,MATH 142A,A03,093480,Staff,4,0,32,28
1656327101902,MATH 142A,B03,093481,Staff,3,0,32,29
1656327101902,MATH 142A,B04,093558,Staff,7,0,32,25
1656327101902,MATH 142A,B05,093559,Staff,1,0,32,31
1656327107926,MATH 193A,A01,083224,Rotar; Vladimir,0,1,34,34
1656327107926,MATH 193A,A02,083225,Rotar; Vladimir,0,0,34,34
1656327107926,MATH 193A,A03,083781,Rotar; Vladimir,0,0,34,34
1656327107926,MATH 193A,A04,083782,Rotar; Vladimir,5,0,34,29
1656327107926,MATH 193A,A05,093482,Rotar; Vladimir,0,0,34,34
1656327113952,MATH 197,001,091859,McAuley; Julian John,9999,0,9999,0
1656327113952,MATH 197,002,095566,Kedlaya; Kiran S.,9997,0,9999,2
1656327113952,MATH 197,003,095567,Xiao; Ming,9999,0,9999,0
1656327113952,MATH 197,004,095571,Perols; Johan Lars,9998,0,9999,1
1656327121017,COGS 9,A01,083615,Shannon; Kyle Michael,3,0,75,72
1656327127042,COGS 11,A01,083617,Boyle; Mary E. T.,17,0,48,31
1656327133069,COGS 13,A01,083071,Bastos; Amalia Pinkusfeld,5,0,71,66
1656327139103,COGS 14A,A01,092681,Semenuks; Arturs,0,7,100,104
1656327145130,COGS 14B,A01,083073,Cheng; Tzu-Han,7,0,63,56
1656327151155,COGS 17,A01,092677,Semenuks; Arturs,6,0,81,75
1656327157179,COGS 100,A01,083619,Allen; Michael Gordon,2,0,70,68
1656327163210,COGS 101A,A01,083621,Davis; Joshua Daniel,5,0,68,63
1656327169244,COGS 101B,A01,091572,Allen; Michael Gordon,4,0,65,61
1656327175274,COGS 101C,A01,083625,Delgado; Tania,12,0,35,23
1656327181298,COGS 107A,A01,083627,Boyle; Mary E. T.,2,0,60,58
1656327187322,COGS 118A,A01,083075,Gupta; Anjum,8,0,76,68
1656327193348,CSE 3,A50,083646,Miranda; Gregory Joseph,18,0,50,32
1656327199374,CSE 8A,A50,083650,Miranda; Gregory Joseph,5,2,56,51
1656327205404,CSE 11,A01,083080,Cao; Yingjun,0,46,40,40
1656327211430,CSE 12,A01,083652,Krause-Levy; Sophia Louisa,5,1,120,115
1656327217453,CSE 15L,A01,083654,Morris; Justin Loren,2,0,50,48
1656327217453,CSE 15L,A02,083655,Morris; Justin Loren,4,0,50,46
1656327223478,CSE 20,A01,083657,Tran; Khoa Dang,31,0,80,49
1656327229508,CSE 21,A01,095574,Bach; Quang Tran,23,0,48,25
1656327235538,CSE 30,A01,083084,Eldon; John,1,4,80,79
1656327235538,CSE 30,B01,095061,Bhaskar; Nishant,0,1,50,50
1656327241564,CSE 100,A01,083659,Cao; Yingjun,1,18,70,69
1656327247593,CSE 134B,A01,083661,Powell; Thomas Allan,7,0,100,93
1656327253618,CSE 140,A01,083663,Gungor; Onat,9,0,85,76
1656327259642,CSE 140L,A01,083088,Eldon; John,10,0,100,90
1656327265668,CSE 175,A01,083665,Kumar; Rakesh,0,0,25,25
1656327271693,CSE 190,A00,092507,Dubnov; Shlomo,4,0,20,16
1656327277724,ECE 45,A01,083139,Congero; Spencer William,1,0,75,74
1656327283750,ECE 65,A50,083695,Saad; Andrew S,10,0,30,20
1656327283750,ECE 65,A51,095125,Staff,25,0,26,1
1656327289781,ECE 109,A01,091882,Touri; Behrouz,0,1,70,70
1656327295811,ECE 180,A00,083140,Abi Samra; Nicholas Camill,2,0,30,28
1656327295811,ECE 180,B00,083141,Abi Samra; Nicholas Camill,0,4,30,30
1656327301850,MATH 10A,A01,083735,Patchell; Gregory David,0,0,30,30
1656327301850,MATH 10A,A02,083736,Patchell; Gregory David,22,0,30,8
1656327301850,MATH 10A,A03,083737,Patchell; Gregory David,16,0,30,14
1656327307878,MATH 10B,A01,083207,Lim; Seonhee,2,0,34,32
1656327307878,MATH 10B,A02,083208,Lim; Seonhee,4,0,35,31
1656327307878,MATH 10B,A03,093472,Staff,1,0,34,33
1656327307878,MATH 10B,B01,083739,Sinha; Shubham,11,0,30,19
1656327313908,MATH 18,A01,083743,Cinel; Cameron Alexander,7,0,30,23
1656327313908,MATH 18,A02,083744,Cinel; Cameron Alexander,10,0,30,20
1656327313908,MATH 18,A03,083745,Cinel; Cameron Alexander,5,0,30,25
1656327313908,MATH 18,B01,083748,Rideout; David Porter,0,0,36,36
1656327313908,MATH 18,B02,083749,Rideout; David Porter,0,0,36,36
1656327313908,MATH 18,B03,083750,Rideout; David Porter,0,0,36,36
1656327313908,MATH 18,B04,083751,Rideout; David Porter,0,1,36,36
1656327313908,MATH 18,B05,093473,Rideout; David Porter,0,0,36,36
1656327313908,MATH 18,B06,093474,Rideout; David Porter,2,0,36,34
1656327319932,MATH 20A,A01,083754,Zheng; Zequn,11,0,40,29
1656327325965,MATH 20B,A01,083756,Briones; Jor-el Thomas Caparas,0,0,36,36
1656327325965,MATH 20B,A02,083757,Briones; Jor-el Thomas Caparas,0,0,36,36
1656327325965,MATH 20B,A03,093475,Staff,1,0,36,35
1656327331990,MATH 20C,A01,083760,Briones; Jor-el Thomas Caparas,0,1,35,35
1656327331990,MATH 20C,A02,083761,Briones; Jor-el Thomas Caparas,9,1,35,26
1656327331990,MATH 20C,A03,093476,Staff,0,0,35,35
1656327331990,MATH 20C,B01,083762,Bach; Quang Tran,2,0,30,28
1656327338014,MATH 20D,A01,083765,Tran; Brian Kha,1,0,30,29
1656327338014,MATH 20D,A02,083766,Tran; Brian Kha,0,0,30,30
1656327338014,MATH 20D,A03,083767,Tran; Brian Kha,2,0,30,28
1656327344050,MATH 20E,A01,083771,Ganguly; Soumya,1,0,32,31
1656327344050,MATH 20E,A02,083772,Ganguly; Soumya,0,0,32,32
1656327344050,MATH 20E,B01,083773,Ciotti; Benjamin,18,0,35,17
1656327344050,MATH 20E,B02,083774,Ciotti; Benjamin,16,0,35,19
1656327350076,MATH 103A,A01,083777,Greenfeld; Be'Eri,2,0,36,34
1656327350076,MATH 103A,A02,083778,Greenfeld; Be'Eri,4,0,36,32
1656327350076,MATH 103A,A03,093561,Staff,3,0,36,33
1656327350076,MATH 103A,B01,083779,Greenfeld; Be'Eri,7,0,36,29
1656327350076,MATH 103A,B02,083780,Greenfeld; Be'Eri,0,0,36,36
1656327350076,MATH 103A,B03,093562,Staff,1,0,36,35
1656327356100,MATH 105,A01,085443,Carter; Anne Toulson,3,0,35,32
1656327356100,MATH 105,A02,093477,Staff,15,0,35,20
1656327362127,MATH 109,A01,083213,Ganzberger; Geoffrey Michael,1,0,34,33
1656327362127,MATH 109,A02,083214,Ganzberger; Geoffrey Michael,0,0,34,34
1656327362127,MATH 109,A03,093478,Staff,2,0,34,32
1656327362127,MATH 109,B01,083215,Ganzberger; Geoffrey Michael,2,0,32,30
1656327362127,MATH 109,B02,083216,Ganzberger; Geoffrey Michael,0,0,32,32
1656327362127,MATH 109,B03,093479,Staff,4,0,32,28
1656327368160,MATH 142A,A01,083219,Chow; Bennett,0,0,32,32
1656327368160,MATH 142A,A02,083220,Chow; Bennett,8,0,32,24
1656327368160,MATH 142A,A03,093480,Staff,4,0,32,28
1656327368160,MATH 142A,B03,093481,Staff,3,0,32,29
1656327368160,MATH 142A,B04,093558,Staff,7,0,32,25
1656327368160,MATH 142A,B05,093559,Staff,1,0,32,31
1656327374185,MATH 193A,A01,083224,Rotar; Vladimir,0,1,34,34
1656327374185,MATH 193A,A02,083225,Rotar; Vladimir,0,0,34,34
1656327374185,MATH 193A,A03,083781,Rotar; Vladimir,0,0,34,34
1656327374185,MATH 193A,A04,083782,Rotar; Vladimir,5,0,34,29
1656327374185,MATH 193A,A05,093482,Rotar; Vladimir,0,0,34,34
1656327380226,MATH 197,001,091859,McAuley; Julian John,9999,0,9999,0
1656327380226,MATH 197,002,095566,Kedlaya; Kiran S.,9997,0,9999,2
1656327380226,MATH 197,003,095567,Xiao; Ming,9999,0,9999,0
1656327380226,MATH 197,004,095571,Perols; Johan Lars,9998,0,9999,1
1656327387283,COGS 9,A01,083615,Shannon; Kyle Michael,3,0,75,72
1656327393308,COGS 11,A01,083617,Boyle; Mary E. T.,17,0,48,31
1656327399338,COGS 13,A01,083071,Bastos; Amalia Pinkusfeld,5,0,71,66
1656327405363,COGS 14A,A01,092681,Semenuks; Arturs,0,7,100,104
1656327411391,COGS 14B,A01,083073,Cheng; Tzu-Han,7,0,63,56
1656327417416,COGS 17,A01,092677,Semenuks; Arturs,6,0,81,75
1656327423446,COGS 100,A01,083619,Allen; Michael Gordon,2,0,70,68
1656327429478,COGS 101A,A01,083621,Davis; Joshua Daniel,5,0,68,63
1656327435500,COGS 101B,A01,091572,Allen; Michael Gordon,4,0,65,61
1656327441529,COGS 101C,A01,083625,Delgado; Tania,12,0,35,23
1656327447554,COGS 107A,A01,083627,Boyle; Mary E. T.,2,0,60,58
1656327453583,COGS 118A,A01,083075,Gupta; Anjum,8,0,76,68
1656327459608,CSE 3,A50,083646,Miranda; Gregory Joseph,18,0,50,32
1656327465639,CSE 8A,A50,083650,Miranda; Gregory Joseph,5,2,56,51
1656327471666,CSE 11,A01,083080,Cao; Yingjun,0,46,40,40
1656327477691,CSE 12,A01,083652,Krause-Levy; Sophia Louisa,5,1,120,115
1656327483719,CSE 15L,A01,083654,Morris; Justin Loren,2,0,50,48
1656327483719,CSE 15L,A02,083655,Morris; Justin Loren,4,0,50,46
1656327489745,CSE 20,A01,083657,Tran; Khoa Dang,31,0,80,49
1656327495769,CSE 21,A01,095574,Bach; Quang Tran,23,0,48,25
1656327501794,CSE 30,A01,083084,Eldon; John,1,4,80,79
1656327501794,CSE 30,B01,095061,Bhaskar; Nishant,0,1,50,50
1656327507824,CSE 100,A01,083659,Cao; Yingjun,1,18,70,69
1656327513851,CSE 134B,A01,083661,Powell; Thomas Allan,7,0,100,93
1656327519875,CSE 140,A01,083663,Gungor; Onat,9,0,85,76
1656327525913,CSE 140L,A01,083088,Eldon; John,10,0,100,90
1656327531946,CSE 175,A01,083665,Kumar; Rakesh,0,0,25,25
1656327537971,CSE 190,A00,092507,Dubnov; Shlomo,4,0,20,16
1656327543996,ECE 45,A01,083139,Congero; Spencer William,1,0,75,74
1656327550031,ECE 65,A50,083695,Saad; Andrew S,10,0,30,20
1656327550031,ECE 65,A51,095125,Staff,25,0,26,1
1656327556054,ECE 109,A01,091882,Touri; Behrouz,0,1,70,70
1656327562079,ECE 180,A00,083140,Abi Samra; Nicholas Camill,2,0,30,28
1656327562079,ECE 180,B00,083141,Abi Samra; Nicholas Camill,0,4,30,30
1656327568105,MATH 10A,A01,083735,Patchell; Gregory David,0,0,30,30
1656327568105,MATH 10A,A02,083736,Patchell; Gregory David,22,0,30,8
1656327568105,MATH 10A,A03,083737,Patchell; Gregory David,16,0,30,14
1656327574132,MATH 10B,A01,083207,Lim; Seonhee,2,0,34,32
1656327574132,MATH 10B,A02,083208,Lim; Seonhee,4,0,35,31
1656327574132,MATH 10B,A03,093472,Staff,1,0,34,33
1656327574132,MATH 10B,B01,083739,Sinha; Shubham,11,0,30,19
1656327580159,MATH 18,A01,083743,Cinel; Cameron Alexander,7,0,30,23
1656327580159,MATH 18,A02,083744,Cinel; Cameron Alexander,10,0,30,20
1656327580159,MATH 18,A03,083745,Cinel; Cameron Alexander,5,0,30,25
1656327580159,MATH 18,B01,083748,Rideout; David Porter,0,0,36,36
1656327580159,MATH 18,B02,083749,Rideout; David Porter,0,0,36,36
1656327580159,MATH 18,B03,083750,Rideout; David Porter,0,0,36,36
1656327580159,MATH 18,B04,083751,Rideout; David Porter,0,1,36,36
1656327580159,MATH 18,B05,093473,Rideout; David Porter,0,0,36,36
1656327580159,MATH 18,B06,093474,Rideout; David Porter,1,0,36,35
1656327586188,MATH 20A,A01,083754,Zheng; Zequn,11,0,40,29
1656327592224,MATH 20B,A01,083756,Briones; Jor-el Thomas Caparas,0,0,36,36
1656327592224,MATH 20B,A02,083757,Briones; Jor-el Thomas Caparas,0,0,36,36
1656327592224,MATH 20B,A03,093475,Staff,1,0,36,35
1656327598250,MATH 20C,A01,083760,Briones; Jor-el Thomas Caparas,0,1,35,35
1656327598250,MATH 20C,A02,083761,Briones; Jor-el Thomas Caparas,9,1,35,26
1656327598250,MATH 20C,A03,093476,Staff,0,0,35,35
1656327598250,MATH 20C,B01,083762,Bach; Quang Tran,2,0,30,28
1656327604273,MATH 20D,A01,083765,Tran; Brian Kha,1,0,30,29
1656327604273,MATH 20D,A02,083766,Tran; Brian Kha,0,0,30,30
1656327604273,MATH 20D,A03,083767,Tran; Brian Kha,2,0,30,28
1656327610298,MATH 20E,A01,083771,Ganguly; Soumya,1,0,32,31
1656327610298,MATH 20E,A02,083772,Ganguly; Soumya,0,0,32,32
1656327610298,MATH 20E,B01,083773,Ciotti; Benjamin,18,0,35,17
1656327610298,MATH 20E,B02,083774,Ciotti; Benjamin,16,0,35,19
1656327616328,MATH 103A,A01,083777,Greenfeld; Be'Eri,2,0,36,34
1656327616328,MATH 103A,A02,083778,Greenfeld; Be'Eri,4,0,36,32
1656327616328,MATH 103A,A03,093561,Staff,3,0,36,33
1656327616328,MATH 103A,B01,083779,Greenfeld; Be'Eri,7,0,36,29
1656327616328,MATH 103A,B02,083780,Greenfeld; Be'Eri,0,0,36,36
1656327616328,MATH 103A,B03,093562,Staff,1,0,36,35
1656327622436,MATH 105,A01,085443,Carter; Anne Toulson,3,0,35,32
1656327622436,MATH 105,A02,093477,Staff,15,0,35,20
1656327628462,MATH 109,A01,083213,Ganzberger; Geoffrey Michael,1,0,34,33
1656327628462,MATH 109,A02,083214,Ganzberger; Geoffrey Michael,0,0,34,34
1656327628462,MATH 109,A03,093478,Staff,2,0,34,32
1656327628462,MATH 109,B01,083215,Ganzberger; Geoffrey Michael,2,0,32,30
1656327628462,MATH 109,B02,083216,Ganzberger; Geoffrey Michael,0,0,32,32
1656327628462,MATH 109,B03,093479,Staff,4,0,32,28
1656327634487,MATH 142A,A01,083219,Chow; Bennett,0,0,32,32
1656327634487,MATH 142A,A02,083220,Chow; Bennett,8,0,32,24
1656327634487,MATH 142A,A03,093480,Staff,4,0,32,28
1656327634487,MATH 142A,B03,093481,Staff,3,0,32,29
1656327634487,MATH 142A,B04,093558,Staff,7,0,32,25
1656327634487,MATH 142A,B05,093559,Staff,1,0,32,31
1656327640519,MATH 193A,A01,083224,Rotar; Vladimir,0,1,34,34
1656327640519,MATH 193A,A02,083225,Rotar; Vladimir,0,0,34,34
1656327640519,MATH 193A,A03,083781,Rotar; Vladimir,0,0,34,34
1656327640519,MATH 193A,A04,083782,Rotar; Vladimir,5,0,34,29
1656327640519,MATH 193A,A05,093482,Rotar; Vladimir,0,0,34,34
1656327646549,MATH 197,001,091859,McAuley; Julian John,9999,0,9999,0
1656327646549,MATH 197,002,095566,Kedlaya; Kiran S.,9997,0,9999,2
1656327646549,MATH 197,003,095567,Xiao; Ming,9999,0,9999,0
1656327646549,MATH 197,004,095571,Perols; Johan Lars,9998,0,9999,1
1656327653626,COGS 9,A01,083615,Shannon; Kyle Michael,3,0,75,72
1656327659650,COGS 11,A01,083617,Boyle; Mary E. T.,17,0,48,31
1656327665675,COGS 13,A01,083071,Bastos; Amalia Pinkusfeld,5,0,71,66
1656327671703,COGS 14A,A01,092681,Semenuks; Arturs,0,7,100,104
1656327677727,COGS 14B,A01,083073,Cheng; Tzu-Han,7,0,63,56
1656327683749,COGS 17,A01,092677,Semenuks; Arturs,6,0,81,75
1656327689779,COGS 100,A01,083619,Allen; Michael Gordon,2,0,70,68
1656327695805,COGS 101A,A01,083621,Davis; Joshua Daniel,5,0,68,63
1656327701829,COGS 101B,A01,091572,Allen; Michael Gordon,4,0,65,61
1656327707854,COGS 101C,A01,083625,Delgado; Tania,12,0,35,23
1656327713880,COGS 107A,A01,083627,Boyle; Mary E. T.,2,0,60,58
1656327719907,COGS 118A,A01,083075,Gupta; Anjum,8,0,76,68
1656327725932,CSE 3,A50,083646,Miranda; Gregory Joseph,18,0,50,32
1656327731957,CSE 8A,A50,083650,Miranda; Gregory Joseph,5,2,56,51
1656327737982,CSE 11,A01,083080,Cao; Yingjun,0,46,40,40
1656327744012,CSE 12,A01,083652,Krause-Levy; Sophia Louisa,5,1,120,115
1656327750039,CSE 15L,A01,083654,Morris; Justin Loren,2,0,50,48
1656327750039,CSE 15L,A02,083655,Morris; Justin Loren,4,0,50,46
1656327756062,CSE 20,A01,083657,Tran; Khoa Dang,31,0,80,49
1656327762088,CSE 21,A01,095574,Bach; Quang Tran,23,0,48,25
1656327768116,CSE 30,A01,083084,Eldon; John,1,4,80,79
1656327768116,CSE 30,B01,095061,Bhaskar; Nishant,0,1,50,50
1656327774147,CSE 100,A01,083659,Cao; Yingjun,1,18,70,69
1656327780170,CSE 134B,A01,083661,Powell; Thomas Allan,7,0,100,93
1656327786195,CSE 140,A01,083663,Gungor; Onat,9,0,85,76
1656327792225,CSE 140L,A01,083088,Eldon; John,10,0,100,90
1656327798255,CSE 175,A01,083665,Kumar; Rakesh,0,0,25,25
1656327804277,CSE 190,A00,092507,Dubnov; Shlomo,4,0,20,16
1656327810392,ECE 45,A01,083139,Congero; Spencer William,1,0,75,74
1656327816425,ECE 65,A50,083695,Saad; Andrew S,10,0,30,20
1656327816425,ECE 65,A51,095125,Staff,25,0,26,1
1656327822457,ECE 109,A01,091882,Touri; Behrouz,0,1,70,70
1656327828483,ECE 180,A00,083140,Abi Samra; Nicholas Camill,2,0,30,28
1656327828483,ECE 180,B00,083141,Abi Samra; Nicholas Camill,0,4,30,30
1656327834516,MATH 10A,A01,083735,Patchell; Gregory David,0,0,30,30
1656327834516,MATH 10A,A02,083736,Patchell; Gregory David,22,0,30,8
1656327834516,MATH 10A,A03,083737,Patchell; Gregory David,16,0,30,14
1656327840543,MATH 10B,A01,083207,Lim; Seonhee,2,0,34,32
1656327840543,MATH 10B,A02,083208,Lim; Seonhee,4,0,35,31
1656327840543,MATH 10B,A03,093472,Staff,1,0,34,33
1656327840543,MATH 10B,B01,083739,Sinha; Shubham,11,0,30,19
1656327846571,MATH 18,A01,083743,Cinel; Cameron Alexander,7,0,30,23
1656327846571,MATH 18,A02,083744,Cinel; Cameron Alexander,10,0,30,20
1656327846571,MATH 18,A03,083745,Cinel; Cameron Alexander,5,0,30,25
1656327846571,MATH 18,B01,083748,Rideout; David Porter,0,0,36,36
1656327846571,MATH 18,B02,083749,Rideout; David Porter,0,0,36,36
1656327846571,MATH 18,B03,083750,Rideout; David Porter,0,0,36,36
1656327846571,MATH 18,B04,083751,Rideout; David Porter,0,1,36,36
1656327846571,MATH 18,B05,093473,Rideout; David Porter,0,0,36,36
1656327846571,MATH 18,B06,093474,Rideout; David Porter,1,0,36,35
1656327852598,MATH 20A,A01,083754,Zheng; Zequn,11,0,40,29
1656327858623,MATH 20B,A01,083756,Briones; Jor-el Thomas Caparas,0,0,36,36
1656327858623,MATH 20B,A02,083757,Briones; Jor-el Thomas Caparas,0,0,36,36
1656327858623,MATH 20B,A03,093475,Staff,1,0,36,35
1656327864647,MATH 20C,A01,083760,Briones; Jor-el Thomas Caparas,0,1,35,35
1656327864647,MATH 20C,A02,083761,Briones; Jor-el Thomas Caparas,9,1,35,26
1656327864647,MATH 20C,A03,093476,Staff,0,0,35,35
1656327864647,MATH 20C,B01,083762,Bach; Quang Tran,2,0,30,28
1656327870674,MATH 20D,A01,083765,Tran; Brian Kha,1,0,30,29
1656327870674,MATH 20D,A02,083766,Tran; Brian Kha,0,0,30,30
1656327870674,MATH 20D,A03,083767,Tran; Brian Kha,2,0,30,28
1656327876705,MATH 20E,A01,083771,Ganguly; Soumya,1,0,32,31
1656327876705,MATH 20E,A02,083772,Ganguly; Soumya,0,0,32,32
1656327876705,MATH 20E,B01,083773,Ciotti; Benjamin,18,0,35,17
1656327876705,MATH 20E,B02,083774,Ciotti; Benjamin,16,0,35,19
1656327882742,MATH 103A,A01,083777,Greenfeld; Be'Eri,2,0,36,34
1656327882742,MATH 103A,A02,083778,Greenfeld; Be'Eri,4,0,36,32
1656327882742,MATH 103A,A03,093561,Staff,3,0,36,33
1656327882742,MATH 103A,B01,083779,Greenfeld; Be'Eri,7,0,36,29
1656327882742,MATH 103A,B02,083780,Greenfeld; Be'Eri,0,0,36,36
1656327882742,MATH 103A,B03,093562,Staff,1,0,36,35
1656327888767,MATH 105,A01,085443,Carter; Anne Toulson,3,0,35,32
1656327888767,MATH 105,A02,093477,Staff,15,0,35,20
1656327894790,MATH 109,A01,083213,Ganzberger; Geoffrey Michael,1,0,34,33
1656327894790,MATH 109,A02,083214,Ganzberger; Geoffrey Michael,0,0,34,34
1656327894790,MATH 109,A03,093478,Staff,2,0,34,32
1656327894790,MATH 109,B01,083215,Ganzberger; Geoffrey Michael,2,0,32,30
1656327894790,MATH 109,B02,083216,Ganzberger; Geoffrey Michael,0,0,32,32
1656327894790,MATH 109,B03,093479,Staff,4,0,32,28
1656327900817,MATH 142A,A01,083219,Chow; Bennett,0,0,32,32
1656327900817,MATH 142A,A02,083220,Chow; Bennett,8,0,32,24
1656327900817,MATH 142A,A03,093480,Staff,4,0,32,28
1656327900817,MATH 142A,B03,093481,Staff,3,0,32,29
1656327900817,MATH 142A,B04,093558,Staff,7,0,32,25
1656327900817,MATH 142A,B05,093559,Staff,1,0,32,31
1656327906843,MATH 193A,A01,083224,Rotar; Vladimir,0,1,34,34
1656327906843,MATH 193A,A02,083225,Rotar; Vladimir,0,0,34,34
1656327906843,MATH 193A,A03,083781,Rotar; Vladimir,0,0,34,34
1656327906843,MATH 193A,A04,083782,Rotar; Vladimir,5,0,34,29
1656327906843,MATH 193A,A05,093482,Rotar; Vladimir,0,0,34,34
1656327912867,MATH 197,001,091859,McAuley; Julian John,9999,0,9999,0
1656327912867,MATH 197,002,095566,Kedlaya; Kiran S.,9997,0,9999,2
1656327912867,MATH 197,003,095567,Xiao; Ming,9999,0,9999,0
1656327912867,MATH 197,004,095571,Perols; Johan Lars,9998,0,9999,1
1656327919937,COGS 9,A01,083615,Shannon; Kyle Michael,3,0,75,72
1656327925966,COGS 11,A01,083617,Boyle; Mary E. T.,17,0,48,31
