time,subj_course_id,sec_code,sec_id,prof,available,waitlist,total,enrolled_ct
1650798730728,COGS 9,A01,083615,Staff,0,17,60,60
1650798736757,COGS 11,A01,083617,Boyle; Mary E. T.,16,0,40,24
1650798742788,COGS 13,A01,083071,Staff,0,38,40,40
1650798748833,COGS 14A,A01,092681,Staff,0,36,100,100
1650798754863,COGS 14B,A01,083073,Cheng; Tzu-Han,0,12,50,50
1650798760897,COGS 17,A01,092677,Staff,11,0,75,64
1650798766948,COGS 100,A01,083619,Staff,0,29,60,60
1650798772973,COGS 101A,A01,083621,Davis; Joshua Daniel,0,28,60,60
1650798779004,COGS 101B,A01,091572,Staff,0,3,60,60
1650798785039,COGS 101C,A01,083625,Delgado; Tania,14,0,30,16
1650798791095,COGS 107A,A01,083627,Boyle; Mary E. T.,0,16,60,60
1650798797127,COGS 118A,A01,083075,Staff,0,8,60,60
1650798803173,CSE 3,A50,083646,Miranda; Gregory Joseph,18,0,38,20
1650798803173,CSE 3,A51,083647,Miranda; Gregory Joseph,36,0,37,1
1650798809211,CSE 8A,A50,083650,Miranda; Gregory Joseph,0,29,40,40
1650798815244,CSE 11,A01,083080,Cao; Yingjun,0,96,40,40
1650798821288,CSE 12,A01,083652,Staff,0,21,100,100
1650798827320,CSE 15L,A01,083654,Staff,0,3,50,50
1650798827320,CSE 15L,A02,083655,Staff,0,2,50,50
1650798833347,CSE 20,A01,083657,Staff,49,0,80,31
1650798839376,CSE 30,A01,083084,Eldon; John,0,75,40,40
1650798845445,CSE 100,A01,083659,Cao; Yingjun,0,71,50,50
1650798851472,CSE 134B,A01,083661,Powell; Thomas Allan,0,38,65,65
1650798857503,CSE 140,A01,083663,Staff,0,11,75,75
1650798863535,CSE 140L,A01,083088,Eldon; John,0,20,75,75
1650798869566,CSE 175,A01,083665,Kumar; Rakesh,7,0,25,18
1650798875596,CSE 190,A00,092507,Dubnov; Shlomo,10,0,20,10
1650798881634,ECE 45,A01,083139,Staff,0,1,60,60
1650798887664,ECE 65,A50,083695,Staff,0,5,30,30
1650798893702,ECE 109,A01,091882,Touri; Behrouz,32,0,70,38
1650798899738,ECE 180,A00,083140,Abi Samra; Nicholas Camill,20,0,30,10
1650798899738,ECE 180,B00,083141,Abi Samra; Nicholas Camill,0,0,30,30
1650798905768,MATH 10A,A01,083735,Patchell; Gregory David,2,0,30,28
1650798905768,MATH 10A,A02,083736,Patchell; Gregory David,27,0,30,3
1650798905768,MATH 10A,A03,083737,Patchell; Gregory David,24,0,30,6
1650798911799,MATH 10B,A01,083207,Staff,0,9,30,30
1650798911799,MATH 10B,A02,083208,Staff,0,6,30,30
1650798911799,MATH 10B,B01,083739,Staff,11,0,30,19
1650798911799,MATH 10B,B02,083740,Staff,28,0,30,2
1650798917843,MATH 18,A01,083743,Staff,0,0,30,30
1650798917843,MATH 18,A02,083744,Staff,23,0,30,7
1650798917843,MATH 18,A03,083745,Staff,21,0,30,9
1650798917843,MATH 18,A04,083746,Staff,26,0,30,4
1650798917843,MATH 18,B01,083748,Staff,0,15,30,30
1650798917843,MATH 18,B02,083749,Staff,0,12,30,30
1650798917843,MATH 18,B03,083750,Staff,0,12,30,30
1650798917843,MATH 18,B04,083751,Staff,0,12,30,30
1650798923874,MATH 20A,A01,083754,Staff,19,0,40,21
1650798929917,MATH 20B,A01,083756,Staff,0,13,30,30
1650798929917,MATH 20B,A02,083757,Staff,0,12,30,30
1650798935947,MATH 20C,A01,083760,Staff,0,17,30,30
1650798935947,MATH 20C,A02,083761,Staff,0,16,30,30
1650798935947,MATH 20C,B01,083762,Staff,9,0,30,21
1650798935947,MATH 20C,B02,083763,Staff,28,0,30,2
1650798941977,MATH 20D,A01,083765,Staff,2,1,30,28
1650798941977,MATH 20D,A02,083766,Staff,6,0,30,24
1650798941977,MATH 20D,A03,083767,Staff,24,0,30,6
1650798948005,MATH 20E,A01,083771,Staff,2,0,30,28
1650798948005,MATH 20E,A02,083772,Staff,15,0,30,15
1650798948005,MATH 20E,B01,083773,Staff,0,0,30,30
1650798948005,MATH 20E,B02,083774,Staff,5,0,30,25
1650798954043,MATH 103A,A01,083777,Staff,0,16,30,30
1650798954043,MATH 103A,A02,083778,Staff,0,15,30,30
1650798954043,MATH 103A,B01,083779,Staff,0,15,30,30
1650798954043,MATH 103A,B02,083780,Staff,0,15,30,30
1650798960077,MATH 105,A01,085443,Staff,0,22,30,30
1650798966108,MATH 109,A01,083213,Anzaldo; Leesa B,0,7,30,30
1650798966108,MATH 109,A02,083214,Anzaldo; Leesa B,0,7,30,30
1650798966108,MATH 109,B01,083215,Anzaldo; Leesa B,0,8,30,30
1650798966108,MATH 109,B02,083216,Anzaldo; Leesa B,0,7,30,30
1650798972139,MATH 142A,A01,083219,Chow; Bennett,0,16,30,30
1650798972139,MATH 142A,A02,083220,Chow; Bennett,0,15,30,30
1650798972139,MATH 142A,B01,083221,Chow; Bennett,0,16,30,30
1650798972139,MATH 142A,B02,083222,Chow; Bennett,0,14,30,30
1650798978169,MATH 193A,A01,083224,Staff,0,6,30,30
1650798978169,MATH 193A,A02,083225,Staff,0,6,30,30
1650798978169,MATH 193A,A03,083781,Staff,0,6,30,30
1650798978169,MATH 193A,A04,083782,Staff,0,7,30,30
1650798984195,MATH 197,001,091859,McAuley; Julian John,9998,0,9999,1
1650798990270,COGS 9,A01,083615,Staff,0,17,60,60
1650798996325,COGS 11,A01,083617,Boyle; Mary E. T.,16,0,40,24
1650799002359,COGS 13,A01,083071,Staff,0,38,40,40
1650799008390,COGS 14A,A01,092681,Staff,0,36,100,100
1650799014420,COGS 14B,A01,083073,Cheng; Tzu-Han,0,12,50,50
1650799020446,COGS 17,A01,092677,Staff,11,0,75,64
1650799026474,COGS 100,A01,083619,Staff,0,29,60,60
1650799032504,COGS 101A,A01,083621,Davis; Joshua Daniel,0,28,60,60
1650799038531,COGS 101B,A01,091572,Staff,0,3,60,60
1650799044558,COGS 101C,A01,083625,Delgado; Tania,14,0,30,16
1650799050604,COGS 107A,A01,083627,Boyle; Mary E. T.,0,16,60,60
1650799056632,COGS 118A,A01,083075,Staff,0,8,60,60
1650799062676,CSE 3,A50,083646,Miranda; Gregory Joseph,18,0,38,20
1650799062676,CSE 3,A51,083647,Miranda; Gregory Joseph,36,0,37,1
1650799068704,CSE 8A,A50,083650,Miranda; Gregory Joseph,0,29,40,40
1650799074743,CSE 11,A01,083080,Cao; Yingjun,0,96,40,40
1650799080777,CSE 12,A01,083652,Staff,0,21,100,100
1650799086810,CSE 15L,A01,083654,Staff,0,3,50,50
1650799086810,CSE 15L,A02,083655,Staff,0,2,50,50
1650799092838,CSE 20,A01,083657,Staff,49,0,80,31
1650799098887,CSE 30,A01,083084,Eldon; John,0,75,40,40
1650799104917,CSE 100,A01,083659,Cao; Yingjun,0,71,50,50
1650799110949,CSE 134B,A01,083661,Powell; Thomas Allan,0,38,65,65
1650799116987,CSE 140,A01,083663,Staff,0,11,75,75
1650799123015,CSE 140L,A01,083088,Eldon; John,0,20,75,75
1650799129048,CSE 175,A01,083665,Kumar; Rakesh,7,0,25,18
1650799135091,CSE 190,A00,092507,Dubnov; Shlomo,10,0,20,10
1650799141127,ECE 45,A01,083139,Staff,0,1,60,60
1650799147156,ECE 65,A50,083695,Staff,0,5,30,30
1650799153182,ECE 109,A01,091882,Touri; Behrouz,32,0,70,38
1650799159217,ECE 180,A00,083140,Abi Samra; Nicholas Camill,20,0,30,10
1650799159217,ECE 180,B00,083141,Abi Samra; Nicholas Camill,0,0,30,30
1650799165246,MATH 10A,A01,083735,Patchell; Gregory David,2,0,30,28
1650799165246,MATH 10A,A02,083736,Patchell; Gregory David,27,0,30,3
1650799165246,MATH 10A,A03,083737,Patchell; Gregory David,24,0,30,6
1650799171274,MATH 10B,A01,083207,Staff,0,9,30,30
1650799171274,MATH 10B,A02,083208,Staff,0,6,30,30
1650799171274,MATH 10B,B01,083739,Staff,11,0,30,19
1650799171274,MATH 10B,B02,083740,Staff,28,0,30,2
1650799177304,MATH 18,A01,083743,Staff,0,0,30,30
1650799177304,MATH 18,A02,083744,Staff,23,0,30,7
1650799177304,MATH 18,A03,083745,Staff,21,0,30,9
1650799177304,MATH 18,A04,083746,Staff,26,0,30,4
1650799177304,MATH 18,B01,083748,Staff,0,15,30,30
1650799177304,MATH 18,B02,083749,Staff,0,12,30,30
1650799177304,MATH 18,B03,083750,Staff,0,12,30,30
1650799177304,MATH 18,B04,083751,Staff,0,12,30,30
1650799183335,MATH 20A,A01,083754,Staff,19,0,40,21
1650799189367,MATH 20B,A01,083756,Staff,0,13,30,30
1650799189367,MATH 20B,A02,083757,Staff,0,12,30,30
1650799195400,MATH 20C,A01,083760,Staff,0,17,30,30
1650799195400,MATH 20C,A02,083761,Staff,0,16,30,30
1650799195400,MATH 20C,B01,083762,Staff,9,0,30,21
1650799195400,MATH 20C,B02,083763,Staff,28,0,30,2
1650799201425,MATH 20D,A01,083765,Staff,2,1,30,28
1650799201425,MATH 20D,A02,083766,Staff,6,0,30,24
1650799201425,MATH 20D,A03,083767,Staff,24,0,30,6
1650799207451,MATH 20E,A01,083771,Staff,2,0,30,28
1650799207451,MATH 20E,A02,083772,Staff,15,0,30,15
1650799207451,MATH 20E,B01,083773,Staff,0,0,30,30
1650799207451,MATH 20E,B02,083774,Staff,5,0,30,25
1650799213480,MATH 103A,A01,083777,Staff,0,16,30,30
1650799213480,MATH 103A,A02,083778,Staff,0,15,30,30
1650799213480,MATH 103A,B01,083779,Staff,0,15,30,30
1650799213480,MATH 103A,B02,083780,Staff,0,15,30,30
1650799219507,MATH 105,A01,085443,Staff,0,22,30,30
1650799225555,MATH 109,A01,083213,Anzaldo; Leesa B,0,7,30,30
1650799225555,MATH 109,A02,083214,Anzaldo; Leesa B,0,7,30,30
1650799225555,MATH 109,B01,083215,Anzaldo; Leesa B,0,8,30,30
1650799225555,MATH 109,B02,083216,Anzaldo; Leesa B,0,7,30,30
1650799231628,MATH 142A,A01,083219,Chow; Bennett,0,16,30,30
1650799231628,MATH 142A,A02,083220,Chow; Bennett,0,15,30,30
1650799231628,MATH 142A,B01,083221,Chow; Bennett,0,16,30,30
1650799231628,MATH 142A,B02,083222,Chow; Bennett,0,14,30,30
1650799237660,MATH 193A,A01,083224,Staff,0,6,30,30
1650799237660,MATH 193A,A02,083225,Staff,0,6,30,30
1650799237660,MATH 193A,A03,083781,Staff,0,6,30,30
1650799237660,MATH 193A,A04,083782,Staff,0,7,30,30
1650799243695,MATH 197,001,091859,McAuley; Julian John,9998,0,9999,1
1650799249776,COGS 9,A01,083615,Staff,0,17,60,60
1650799255810,COGS 11,A01,083617,Boyle; Mary E. T.,16,0,40,24
1650799261841,COGS 13,A01,083071,Staff,0,38,40,40
1650799267882,COGS 14A,A01,092681,Staff,0,36,100,100
1650799273916,COGS 14B,A01,083073,Cheng; Tzu-Han,0,12,50,50
1650799279943,COGS 17,A01,092677,Staff,11,0,75,64
1650799285970,COGS 100,A01,083619,Staff,0,29,60,60
1650799291998,COGS 101A,A01,083621,Davis; Joshua Daniel,0,28,60,60
1650799298041,COGS 101B,A01,091572,Staff,0,3,60,60
1650799304170,COGS 101C,A01,083625,Delgado; Tania,14,0,30,16
1650799310213,COGS 107A,A01,083627,Boyle; Mary E. T.,0,16,60,60
1650799316240,COGS 118A,A01,083075,Staff,0,8,60,60
1650799322277,CSE 3,A50,083646,Miranda; Gregory Joseph,18,0,38,20
1650799322277,CSE 3,A51,083647,Miranda; Gregory Joseph,36,0,37,1
1650799328300,CSE 8A,A50,083650,Miranda; Gregory Joseph,0,29,40,40
1650799334330,CSE 11,A01,083080,Cao; Yingjun,0,96,40,40
1650799340359,CSE 12,A01,083652,Staff,0,21,100,100
1650799346383,CSE 15L,A01,083654,Staff,0,3,50,50
1650799346383,CSE 15L,A02,083655,Staff,0,2,50,50
1650799352411,CSE 20,A01,083657,Staff,49,0,80,31
1650799358440,CSE 30,A01,083084,Eldon; John,0,75,40,40
1650799364469,CSE 100,A01,083659,Cao; Yingjun,0,71,50,50
1650799370493,CSE 134B,A01,083661,Powell; Thomas Allan,0,38,65,65
1650799376517,CSE 140,A01,083663,Staff,0,11,75,75
1650799382573,CSE 140L,A01,083088,Eldon; John,0,20,75,75
1650799388598,CSE 175,A01,083665,Kumar; Rakesh,7,0,25,18
1650799394622,CSE 190,A00,092507,Dubnov; Shlomo,10,0,20,10
1650799400661,ECE 45,A01,083139,Staff,0,1,60,60
1650799406699,ECE 65,A50,083695,Staff,0,5,30,30
1650799412738,ECE 109,A01,091882,Touri; Behrouz,32,0,70,38
1650799418781,ECE 180,A00,083140,Abi Samra; Nicholas Camill,20,0,30,10
1650799418781,ECE 180,B00,083141,Abi Samra; Nicholas Camill,0,0,30,30
1650799424817,MATH 10A,A01,083735,Patchell; Gregory David,2,0,30,28
1650799424817,MATH 10A,A02,083736,Patchell; Gregory David,27,0,30,3
1650799424817,MATH 10A,A03,083737,Patchell; Gregory David,24,0,30,6
1650799430858,MATH 10B,A01,083207,Staff,0,9,30,30
1650799430858,MATH 10B,A02,083208,Staff,0,6,30,30
1650799430858,MATH 10B,B01,083739,Staff,11,0,30,19
1650799430858,MATH 10B,B02,083740,Staff,28,0,30,2
1650799436892,MATH 18,A01,083743,Staff,0,0,30,30
1650799436892,MATH 18,A02,083744,Staff,23,0,30,7
1650799436892,MATH 18,A03,083745,Staff,21,0,30,9
1650799436892,MATH 18,A04,083746,Staff,26,0,30,4
1650799436892,MATH 18,B01,083748,Staff,0,15,30,30
1650799436892,MATH 18,B02,083749,Staff,0,12,30,30
1650799436892,MATH 18,B03,083750,Staff,0,12,30,30
1650799436892,MATH 18,B04,083751,Staff,0,12,30,30
1650799442917,MATH 20A,A01,083754,Staff,19,0,40,21
1650799448943,MATH 20B,A01,083756,Staff,0,13,30,30
1650799448943,MATH 20B,A02,083757,Staff,0,12,30,30
1650799454979,MATH 20C,A01,083760,Staff,0,17,30,30
1650799454979,MATH 20C,A02,083761,Staff,0,16,30,30
1650799454979,MATH 20C,B01,083762,Staff,9,0,30,21
1650799454979,MATH 20C,B02,083763,Staff,28,0,30,2
1650799461002,MATH 20D,A01,083765,Staff,2,1,30,28
1650799461002,MATH 20D,A02,083766,Staff,6,0,30,24
1650799461002,MATH 20D,A03,083767,Staff,24,0,30,6
1650799467028,MATH 20E,A01,083771,Staff,2,0,30,28
1650799467028,MATH 20E,A02,083772,Staff,15,0,30,15
1650799467028,MATH 20E,B01,083773,Staff,0,0,30,30
1650799467028,MATH 20E,B02,083774,Staff,5,0,30,25
1650799473060,MATH 103A,A01,083777,Staff,0,16,30,30
1650799473060,MATH 103A,A02,083778,Staff,0,15,30,30
1650799473060,MATH 103A,B01,083779,Staff,0,15,30,30
1650799473060,MATH 103A,B02,083780,Staff,0,15,30,30
1650799479086,MATH 105,A01,085443,Staff,0,22,30,30
1650799485115,MATH 109,A01,083213,Anzaldo; Leesa B,0,7,30,30
1650799485115,MATH 109,A02,083214,Anzaldo; Leesa B,0,7,30,30
1650799485115,MATH 109,B01,083215,Anzaldo; Leesa B,0,8,30,30
1650799485115,MATH 109,B02,083216,Anzaldo; Leesa B,0,7,30,30
1650799491150,MATH 142A,A01,083219,Chow; Bennett,0,16,30,30
1650799491150,MATH 142A,A02,083220,Chow; Bennett,0,15,30,30
1650799491150,MATH 142A,B01,083221,Chow; Bennett,0,16,30,30
1650799491150,MATH 142A,B02,083222,Chow; Bennett,0,14,30,30
1650799497179,MATH 193A,A01,083224,Staff,0,6,30,30
1650799497179,MATH 193A,A02,083225,Staff,0,6,30,30
1650799497179,MATH 193A,A03,083781,Staff,0,6,30,30
1650799497179,MATH 193A,A04,083782,Staff,0,7,30,30
1650799503203,MATH 197,001,091859,McAuley; Julian John,9998,0,9999,1
1650799509279,COGS 9,A01,083615,Staff,0,17,60,60
1650799515309,COGS 11,A01,083617,Boyle; Mary E. T.,16,0,40,24
1650799521347,COGS 13,A01,083071,Staff,0,38,40,40
1650799527379,COGS 14A,A01,092681,Staff,0,36,100,100
1650799533405,COGS 14B,A01,083073,Cheng; Tzu-Han,0,12,50,50
1650799539431,COGS 17,A01,092677,Staff,11,0,75,64
1650799545479,COGS 100,A01,083619,Staff,0,29,60,60
1650799551513,COGS 101A,A01,083621,Davis; Joshua Daniel,0,28,60,60
1650799557542,COGS 101B,A01,091572,Staff,0,3,60,60
1650799563570,COGS 101C,A01,083625,Delgado; Tania,14,0,30,16
1650799569599,COGS 107A,A01,083627,Boyle; Mary E. T.,0,16,60,60
1650799575632,COGS 118A,A01,083075,Staff,0,8,60,60
1650799581666,CSE 3,A50,083646,Miranda; Gregory Joseph,18,0,38,20
1650799581666,CSE 3,A51,083647,Miranda; Gregory Joseph,36,0,37,1
1650799587704,CSE 8A,A50,083650,Miranda; Gregory Joseph,0,29,40,40
1650799593730,CSE 11,A01,083080,Cao; Yingjun,0,96,40,40
1650799599761,CSE 12,A01,083652,Staff,0,21,100,100
1650799605799,CSE 15L,A01,083654,Staff,0,3,50,50
1650799605799,CSE 15L,A02,083655,Staff,0,2,50,50
1650799611826,CSE 20,A01,083657,Staff,49,0,80,31
1650799617854,CSE 30,A01,083084,Eldon; John,0,75,40,40
1650799623893,CSE 100,A01,083659,Cao; Yingjun,0,71,50,50
1650799629931,CSE 134B,A01,083661,Powell; Thomas Allan,0,38,65,65
1650799635955,CSE 140,A01,083663,Staff,0,11,75,75
1650799641980,CSE 140L,A01,083088,Eldon; John,0,20,75,75
1650799648023,CSE 175,A01,083665,Kumar; Rakesh,7,0,25,18
1650799654056,CSE 190,A00,092507,Dubnov; Shlomo,10,0,20,10
1650799660083,ECE 45,A01,083139,Staff,0,1,60,60
1650799666110,ECE 65,A50,083695,Staff,0,5,30,30
1650799672140,ECE 109,A01,091882,Touri; Behrouz,32,0,70,38
1650799678173,ECE 180,A00,083140,Abi Samra; Nicholas Camill,20,0,30,10
1650799678173,ECE 180,B00,083141,Abi Samra; Nicholas Camill,0,0,30,30
1650799684203,MATH 10A,A01,083735,Patchell; Gregory David,2,0,30,28
1650799684203,MATH 10A,A02,083736,Patchell; Gregory David,27,0,30,3
1650799684203,MATH 10A,A03,083737,Patchell; Gregory David,24,0,30,6
1650799690240,MATH 10B,A01,083207,Staff,0,9,30,30
1650799690240,MATH 10B,A02,083208,Staff,0,6,30,30
1650799690240,MATH 10B,B01,083739,Staff,11,0,30,19
1650799690240,MATH 10B,B02,083740,Staff,28,0,30,2
1650799696269,MATH 18,A01,083743,Staff,0,0,30,30
1650799696269,MATH 18,A02,083744,Staff,23,0,30,7
1650799696269,MATH 18,A03,083745,Staff,21,0,30,9
1650799696269,MATH 18,A04,083746,Staff,26,0,30,4
1650799696269,MATH 18,B01,083748,Staff,0,15,30,30
1650799696269,MATH 18,B02,083749,Staff,0,12,30,30
1650799696269,MATH 18,B03,083750,Staff,0,12,30,30
1650799696269,MATH 18,B04,083751,Staff,0,12,30,30
1650799702297,MATH 20A,A01,083754,Staff,19,0,40,21
1650799708322,MATH 20B,A01,083756,Staff,0,13,30,30
1650799708322,MATH 20B,A02,083757,Staff,0,12,30,30
1650799714348,MATH 20C,A01,083760,Staff,0,17,30,30
1650799714348,MATH 20C,A02,083761,Staff,0,16,30,30
1650799714348,MATH 20C,B01,083762,Staff,9,0,30,21
1650799714348,MATH 20C,B02,083763,Staff,28,0,30,2
1650799720374,MATH 20D,A01,083765,Staff,2,1,30,28
1650799720374,MATH 20D,A02,083766,Staff,6,0,30,24
1650799720374,MATH 20D,A03,083767,Staff,24,0,30,6
1650799726408,MATH 20E,A01,083771,Staff,2,0,30,28
1650799726408,MATH 20E,A02,083772,Staff,15,0,30,15
1650799726408,MATH 20E,B01,083773,Staff,0,0,30,30
1650799726408,MATH 20E,B02,083774,Staff,5,0,30,25
1650799732435,MATH 103A,A01,083777,Staff,0,16,30,30
1650799732435,MATH 103A,A02,083778,Staff,0,15,30,30
1650799732435,MATH 103A,B01,083779,Staff,0,15,30,30
1650799732435,MATH 103A,B02,083780,Staff,0,15,30,30
1650799738466,MATH 105,A01,085443,Staff,0,22,30,30
1650799744496,MATH 109,A01,083213,Anzaldo; Leesa B,0,7,30,30
1650799744496,MATH 109,A02,083214,Anzaldo; Leesa B,0,7,30,30
1650799744496,MATH 109,B01,083215,Anzaldo; Leesa B,0,8,30,30
1650799744496,MATH 109,B02,083216,Anzaldo; Leesa B,0,7,30,30
1650799750523,MATH 142A,A01,083219,Chow; Bennett,0,16,30,30
1650799750523,MATH 142A,A02,083220,Chow; Bennett,0,15,30,30
1650799750523,MATH 142A,B01,083221,Chow; Bennett,0,16,30,30
1650799750523,MATH 142A,B02,083222,Chow; Bennett,0,14,30,30
1650799756560,MATH 193A,A01,083224,Staff,0,6,30,30
1650799756560,MATH 193A,A02,083225,Staff,0,6,30,30
1650799756560,MATH 193A,A03,083781,Staff,0,6,30,30
1650799756560,MATH 193A,A04,083782,Staff,0,7,30,30
1650799762587,MATH 197,001,091859,McAuley; Julian John,9998,0,9999,1
1650799768655,COGS 9,A01,083615,Staff,0,17,60,60
1650799774685,COGS 11,A01,083617,Boyle; Mary E. T.,16,0,40,24
1650799780713,COGS 13,A01,083071,Staff,0,38,40,40
1650799786758,COGS 14A,A01,092681,Staff,0,36,100,100
1650799792781,COGS 14B,A01,083073,Cheng; Tzu-Han,0,12,50,50
1650799798821,COGS 17,A01,092677,Staff,11,0,75,64
1650799804850,COGS 100,A01,083619,Staff,0,29,60,60
1650799810876,COGS 101A,A01,083621,Davis; Joshua Daniel,0,28,60,60
1650799816905,COGS 101B,A01,091572,Staff,0,3,60,60
1650799822949,COGS 101C,A01,083625,Delgado; Tania,14,0,30,16
1650799828987,COGS 107A,A01,083627,Boyle; Mary E. T.,0,16,60,60
1650799835011,COGS 118A,A01,083075,Staff,0,8,60,60
1650799841039,CSE 3,A50,083646,Miranda; Gregory Joseph,18,0,38,20
1650799841039,CSE 3,A51,083647,Miranda; Gregory Joseph,36,0,37,1
1650799847077,CSE 8A,A50,083650,Miranda; Gregory Joseph,0,29,40,40
1650799853111,CSE 11,A01,083080,Cao; Yingjun,0,96,40,40
1650799859140,CSE 12,A01,083652,Staff,0,21,100,100
1650799865164,CSE 15L,A01,083654,Staff,0,3,50,50
1650799865164,CSE 15L,A02,083655,Staff,0,2,50,50
1650799871190,CSE 20,A01,083657,Staff,49,0,80,31
1650799877217,CSE 30,A01,083084,Eldon; John,0,75,40,40
1650799883243,CSE 100,A01,083659,Cao; Yingjun,0,71,50,50
1650799889273,CSE 134B,A01,083661,Powell; Thomas Allan,0,38,65,65
1650799895298,CSE 140,A01,083663,Staff,0,11,75,75
1650799901413,CSE 140L,A01,083088,Eldon; John,0,20,75,75
1650799907441,CSE 175,A01,083665,Kumar; Rakesh,7,0,25,18
1650799913466,CSE 190,A00,092507,Dubnov; Shlomo,10,0,20,10
1650799919491,ECE 45,A01,083139,Staff,0,1,60,60
1650799925517,ECE 65,A50,083695,Staff,0,5,30,30
1650799931541,ECE 109,A01,091882,Touri; Behrouz,32,0,70,38
1650799937566,ECE 180,A00,083140,Abi Samra; Nicholas Camill,20,0,30,10
1650799937566,ECE 180,B00,083141,Abi Samra; Nicholas Camill,0,0,30,30
1650799943600,MATH 10A,A01,083735,Patchell; Gregory David,2,0,30,28
1650799943600,MATH 10A,A02,083736,Patchell; Gregory David,27,0,30,3
1650799943600,MATH 10A,A03,083737,Patchell; Gregory David,24,0,30,6
1650799949626,MATH 10B,A01,083207,Staff,0,9,30,30
1650799949626,MATH 10B,A02,083208,Staff,0,6,30,30
1650799949626,MATH 10B,B01,083739,Staff,11,0,30,19
1650799949626,MATH 10B,B02,083740,Staff,28,0,30,2
1650799955658,MATH 18,A01,083743,Staff,0,0,30,30
1650799955658,MATH 18,A02,083744,Staff,23,0,30,7
1650799955658,MATH 18,A03,083745,Staff,21,0,30,9
1650799955658,MATH 18,A04,083746,Staff,26,0,30,4
1650799955658,MATH 18,B01,083748,Staff,0,15,30,30
1650799955658,MATH 18,B02,083749,Staff,0,12,30,30
1650799955658,MATH 18,B03,083750,Staff,0,12,30,30
1650799955658,MATH 18,B04,083751,Staff,0,12,30,30
1650799961682,MATH 20A,A01,083754,Staff,19,0,40,21
1650799967708,MATH 20B,A01,083756,Staff,0,13,30,30
1650799967708,MATH 20B,A02,083757,Staff,0,12,30,30
1650799973737,MATH 20C,A01,083760,Staff,0,17,30,30
1650799973737,MATH 20C,A02,083761,Staff,0,16,30,30
1650799973737,MATH 20C,B01,083762,Staff,9,0,30,21
1650799973737,MATH 20C,B02,083763,Staff,28,0,30,2
1650799979764,MATH 20D,A01,083765,Staff,2,1,30,28
1650799979764,MATH 20D,A02,083766,Staff,6,0,30,24
1650799979764,MATH 20D,A03,083767,Staff,24,0,30,6
1650799985795,MATH 20E,A01,083771,Staff,2,0,30,28
1650799985795,MATH 20E,A02,083772,Staff,15,0,30,15
1650799985795,MATH 20E,B01,083773,Staff,0,0,30,30
1650799985795,MATH 20E,B02,083774,Staff,5,0,30,25
1650799991827,MATH 103A,A01,083777,Staff,0,16,30,30
1650799991827,MATH 103A,A02,083778,Staff,0,15,30,30
1650799991827,MATH 103A,B01,083779,Staff,0,15,30,30
1650799991827,MATH 103A,B02,083780,Staff,0,15,30,30
1650799997854,MATH 105,A01,085443,Staff,0,22,30,30
1650800003886,MATH 109,A01,083213,Anzaldo; Leesa B,0,7,30,30
1650800003886,MATH 109,A02,083214,Anzaldo; Leesa B,0,7,30,30
1650800003886,MATH 109,B01,083215,Anzaldo; Leesa B,0,8,30,30
1650800003886,MATH 109,B02,083216,Anzaldo; Leesa B,0,7,30,30
1650800009912,MATH 142A,A01,083219,Chow; Bennett,0,16,30,30
1650800009912,MATH 142A,A02,083220,Chow; Bennett,0,15,30,30
1650800009912,MATH 142A,B01,083221,Chow; Bennett,0,16,30,30
1650800009912,MATH 142A,B02,083222,Chow; Bennett,0,14,30,30
1650800015948,MATH 193A,A01,083224,Staff,0,6,30,30
1650800015948,MATH 193A,A02,083225,Staff,0,6,30,30
1650800015948,MATH 193A,A03,083781,Staff,0,6,30,30
1650800015948,MATH 193A,A04,083782,Staff,0,7,30,30
1650800021972,MATH 197,001,091859,McAuley; Julian John,9998,0,9999,1
1650800028039,COGS 9,A01,083615,Staff,0,17,60,60
1650800034063,COGS 11,A01,083617,Boyle; Mary E. T.,16,0,40,24
1650800040092,COGS 13,A01,083071,Staff,0,38,40,40
1650800046127,COGS 14A,A01,092681,Staff,0,36,100,100
1650800052156,COGS 14B,A01,083073,Cheng; Tzu-Han,0,12,50,50
1650800058181,COGS 17,A01,092677,Staff,11,0,75,64
1650800064205,COGS 100,A01,083619,Staff,0,29,60,60
1650800070233,COGS 101A,A01,083621,Davis; Joshua Daniel,0,28,60,60
1650800076259,COGS 101B,A01,091572,Staff,0,3,60,60
1650800082286,COGS 101C,A01,083625,Delgado; Tania,14,0,30,16
1650800088312,COGS 107A,A01,083627,Boyle; Mary E. T.,0,16,60,60
1650800094336,COGS 118A,A01,083075,Staff,0,8,60,60
1650800100363,CSE 3,A50,083646,Miranda; Gregory Joseph,18,0,38,20
1650800100363,CSE 3,A51,083647,Miranda; Gregory Joseph,36,0,37,1
1650800106388,CSE 8A,A50,083650,Miranda; Gregory Joseph,0,29,40,40
1650800112413,CSE 11,A01,083080,Cao; Yingjun,0,96,40,40
1650800118438,CSE 12,A01,083652,Staff,0,21,100,100
1650800124463,CSE 15L,A01,083654,Staff,0,3,50,50
1650800124463,CSE 15L,A02,083655,Staff,0,2,50,50
1650800130488,CSE 20,A01,083657,Staff,49,0,80,31
1650800136521,CSE 30,A01,083084,Eldon; John,0,75,40,40
1650800142547,CSE 100,A01,083659,Cao; Yingjun,0,71,50,50
1650800148581,CSE 134B,A01,083661,Powell; Thomas Allan,0,38,65,65
1650800154608,CSE 140,A01,083663,Staff,0,11,75,75
1650800160634,CSE 140L,A01,083088,Eldon; John,0,20,75,75
1650800166659,CSE 175,A01,083665,Kumar; Rakesh,7,0,25,18
1650800172690,CSE 190,A00,092507,Dubnov; Shlomo,10,0,20,10
1650800178716,ECE 45,A01,083139,Staff,0,1,60,60
1650800184740,ECE 65,A50,083695,Staff,0,5,30,30
1650800190766,ECE 109,A01,091882,Touri; Behrouz,32,0,70,38
1650800196797,ECE 180,A00,083140,Abi Samra; Nicholas Camill,20,0,30,10
1650800196797,ECE 180,B00,083141,Abi Samra; Nicholas Camill,0,0,30,30
1650800202839,MATH 10A,A01,083735,Patchell; Gregory David,2,0,30,28
1650800202839,MATH 10A,A02,083736,Patchell; Gregory David,27,0,30,3
1650800202839,MATH 10A,A03,083737,Patchell; Gregory David,24,0,30,6
1650800208864,MATH 10B,A01,083207,Staff,0,9,30,30
1650800208864,MATH 10B,A02,083208,Staff,0,6,30,30
1650800208864,MATH 10B,B01,083739,Staff,11,0,30,19
1650800208864,MATH 10B,B02,083740,Staff,28,0,30,2
1650800214894,MATH 18,A01,083743,Staff,0,0,30,30
1650800214894,MATH 18,A02,083744,Staff,23,0,30,7
1650800214894,MATH 18,A03,083745,Staff,21,0,30,9
1650800214894,MATH 18,A04,083746,Staff,26,0,30,4
1650800214894,MATH 18,B01,083748,Staff,0,15,30,30
1650800214894,MATH 18,B02,083749,Staff,0,12,30,30
1650800214894,MATH 18,B03,083750,Staff,0,12,30,30
1650800214894,MATH 18,B04,083751,Staff,0,12,30,30
1650800220918,MATH 20A,A01,083754,Staff,19,0,40,21
1650800226944,MATH 20B,A01,083756,Staff,0,13,30,30
1650800226944,MATH 20B,A02,083757,Staff,0,12,30,30
1650800232970,MATH 20C,A01,083760,Staff,0,17,30,30
1650800232970,MATH 20C,A02,083761,Staff,0,16,30,30
1650800232970,MATH 20C,B01,083762,Staff,9,0,30,21
1650800232970,MATH 20C,B02,083763,Staff,28,0,30,2
1650800239005,MATH 20D,A01,083765,Staff,2,1,30,28
1650800239005,MATH 20D,A02,083766,Staff,6,0,30,24
1650800239005,MATH 20D,A03,083767,Staff,24,0,30,6
1650800245036,MATH 20E,A01,083771,Staff,2,0,30,28
1650800245036,MATH 20E,A02,083772,Staff,15,0,30,15
1650800245036,MATH 20E,B01,083773,Staff,0,0,30,30
1650800245036,MATH 20E,B02,083774,Staff,5,0,30,25
1650800251061,MATH 103A,A01,083777,Staff,0,16,30,30
1650800251061,MATH 103A,A02,083778,Staff,0,15,30,30
1650800251061,MATH 103A,B01,083779,Staff,0,15,30,30
1650800251061,MATH 103A,B02,083780,Staff,0,15,30,30
1650800257093,MATH 105,A01,085443,Staff,0,22,30,30
1650800263122,MATH 109,A01,083213,Anzaldo; Leesa B,0,7,30,30
1650800263122,MATH 109,A02,083214,Anzaldo; Leesa B,0,7,30,30
1650800263122,MATH 109,B01,083215,Anzaldo; Leesa B,0,8,30,30
1650800263122,MATH 109,B02,083216,Anzaldo; Leesa B,0,7,30,30
1650800269149,MATH 142A,A01,083219,Chow; Bennett,0,16,30,30
1650800269149,MATH 142A,A02,083220,Chow; Bennett,0,15,30,30
1650800269149,MATH 142A,B01,083221,Chow; Bennett,0,16,30,30
1650800269149,MATH 142A,B02,083222,Chow; Bennett,0,14,30,30
1650800275177,MATH 193A,A01,083224,Staff,0,6,30,30
1650800275177,MATH 193A,A02,083225,Staff,0,6,30,30
1650800275177,MATH 193A,A03,083781,Staff,0,6,30,30
1650800275177,MATH 193A,A04,083782,Staff,0,7,30,30
1650800281202,MATH 197,001,091859,McAuley; Julian John,9998,0,9999,1
1650800287264,COGS 9,A01,083615,Staff,0,17,60,60
1650800293290,COGS 11,A01,083617,Boyle; Mary E. T.,16,0,40,24
1650800299316,COGS 13,A01,083071,Staff,0,38,40,40
1650800305346,COGS 14A,A01,092681,Staff,0,36,100,100
1650800311371,COGS 14B,A01,083073,Cheng; Tzu-Han,0,12,50,50
1650800317396,COGS 17,A01,092677,Staff,11,0,75,64
1650800323421,COGS 100,A01,083619,Staff,0,29,60,60
1650800329446,COGS 101A,A01,083621,Davis; Joshua Daniel,0,28,60,60
1650800335476,COGS 101B,A01,091572,Staff,0,3,60,60
1650800341509,COGS 101C,A01,083625,Delgado; Tania,14,0,30,16
1650800347537,COGS 107A,A01,083627,Boyle; Mary E. T.,0,16,60,60
1650800361003,COGS 118A,A01,083075,Staff,0,8,60,60
1650800367109,CSE 3,A50,083646,Miranda; Gregory Joseph,18,0,38,20
1650800367109,CSE 3,A51,083647,Miranda; Gregory Joseph,36,0,37,1
1650800381879,CSE 8A,A50,083650,Miranda; Gregory Joseph,0,29,40,40
1650800387910,CSE 11,A01,083080,Cao; Yingjun,0,96,40,40
1650800402537,CSE 12,A01,083652,Staff,0,21,100,100
1650800408611,CSE 15L,A01,083654,Staff,0,3,50,50
1650800408611,CSE 15L,A02,083655,Staff,0,2,50,50
1650800423174,CSE 20,A01,083657,Staff,49,0,80,31
1650800429208,CSE 30,A01,083084,Eldon; John,0,75,40,40
1650800443876,CSE 100,A01,083659,Cao; Yingjun,0,71,50,50
1650800449907,CSE 134B,A01,083661,Powell; Thomas Allan,0,38,65,65
1650800464824,CSE 140,A01,083663,Staff,0,11,75,75
1650800470857,CSE 140L,A01,083088,Eldon; John,0,20,75,75
1650800485736,CSE 175,A01,083665,Kumar; Rakesh,7,0,25,18
1650800491772,CSE 190,A00,092507,Dubnov; Shlomo,10,0,20,10
1650800502023,ECE 45,A01,083139,Staff,0,1,60,60
1650800508059,ECE 65,A50,083695,Staff,0,5,30,30
1650800514092,ECE 109,A01,091882,Touri; Behrouz,32,0,70,38
1650800520124,ECE 180,A00,083140,Abi Samra; Nicholas Camill,20,0,30,10
1650800520124,ECE 180,B00,083141,Abi Samra; Nicholas Camill,0,0,30,30
1650800526160,MATH 10A,A01,083735,Patchell; Gregory David,2,0,30,28
1650800526160,MATH 10A,A02,083736,Patchell; Gregory David,27,0,30,3
1650800526160,MATH 10A,A03,083737,Patchell; Gregory David,24,0,30,6
1650800532192,MATH 10B,A01,083207,Staff,0,9,30,30
1650800532192,MATH 10B,A02,083208,Staff,0,6,30,30
1650800532192,MATH 10B,B01,083739,Staff,11,0,30,19
1650800532192,MATH 10B,B02,083740,Staff,28,0,30,2
1650800538221,MATH 18,A01,083743,Staff,0,0,30,30
1650800538221,MATH 18,A02,083744,Staff,23,0,30,7
1650800538221,MATH 18,A03,083745,Staff,21,0,30,9
1650800538221,MATH 18,A04,083746,Staff,26,0,30,4
1650800538221,MATH 18,B01,083748,Staff,0,15,30,30
1650800538221,MATH 18,B02,083749,Staff,0,12,30,30
1650800538221,MATH 18,B03,083750,Staff,0,12,30,30
1650800538221,MATH 18,B04,083751,Staff,0,12,30,30
1650800544246,MATH 20A,A01,083754,Staff,19,0,40,21
1650800550283,MATH 20B,A01,083756,Staff,0,13,30,30
1650800550283,MATH 20B,A02,083757,Staff,0,12,30,30
1650800556314,MATH 20C,A01,083760,Staff,0,17,30,30
1650800556314,MATH 20C,A02,083761,Staff,0,16,30,30
1650800556314,MATH 20C,B01,083762,Staff,9,0,30,21
1650800556314,MATH 20C,B02,083763,Staff,28,0,30,2
1650800562442,MATH 20D,A01,083765,Staff,2,1,30,28
1650800562442,MATH 20D,A02,083766,Staff,6,0,30,24
1650800562442,MATH 20D,A03,083767,Staff,24,0,30,6
1650800568479,MATH 20E,A01,083771,Staff,2,0,30,28
1650800568479,MATH 20E,A02,083772,Staff,15,0,30,15
1650800568479,MATH 20E,B01,083773,Staff,0,0,30,30
1650800568479,MATH 20E,B02,083774,Staff,5,0,30,25
1650800574512,MATH 103A,A01,083777,Staff,0,16,30,30
1650800574512,MATH 103A,A02,083778,Staff,0,15,30,30
1650800574512,MATH 103A,B01,083779,Staff,0,15,30,30
1650800574512,MATH 103A,B02,083780,Staff,0,15,30,30
1650800580538,MATH 105,A01,085443,Staff,0,22,30,30
1650800586564,MATH 109,A01,083213,Anzaldo; Leesa B,0,7,30,30
1650800586564,MATH 109,A02,083214,Anzaldo; Leesa B,0,7,30,30
1650800586564,MATH 109,B01,083215,Anzaldo; Leesa B,0,8,30,30
1650800586564,MATH 109,B02,083216,Anzaldo; Leesa B,0,7,30,30
1650800592590,MATH 142A,A01,083219,Chow; Bennett,0,16,30,30
1650800592590,MATH 142A,A02,083220,Chow; Bennett,0,15,30,30
1650800592590,MATH 142A,B01,083221,Chow; Bennett,0,16,30,30
1650800592590,MATH 142A,B02,083222,Chow; Bennett,0,14,30,30
1650800598620,MATH 193A,A01,083224,Staff,0,6,30,30
1650800598620,MATH 193A,A02,083225,Staff,0,6,30,30
1650800598620,MATH 193A,A03,083781,Staff,0,6,30,30
1650800598620,MATH 193A,A04,083782,Staff,0,7,30,30
1650800604667,MATH 197,001,091859,McAuley; Julian John,9998,0,9999,1
1650800610752,COGS 9,A01,083615,Staff,0,17,60,60
1650800616790,COGS 11,A01,083617,Boyle; Mary E. T.,16,0,40,24
1650800622815,COGS 13,A01,083071,Staff,0,38,40,40
1650800628841,COGS 14A,A01,092681,Staff,0,36,100,100
1650800634866,COGS 14B,A01,083073,Cheng; Tzu-Han,0,12,50,50
1650800640892,COGS 17,A01,092677,Staff,11,0,75,64
1650800646922,COGS 100,A01,083619,Staff,0,29,60,60
1650800652951,COGS 101A,A01,083621,Davis; Joshua Daniel,0,28,60,60
1650800658978,COGS 101B,A01,091572,Staff,0,3,60,60
1650800665004,COGS 101C,A01,083625,Delgado; Tania,14,0,30,16
1650800671030,COGS 107A,A01,083627,Boyle; Mary E. T.,0,16,60,60
1650800677054,COGS 118A,A01,083075,Staff,0,8,60,60
1650800683088,CSE 3,A50,083646,Miranda; Gregory Joseph,18,0,38,20
1650800683088,CSE 3,A51,083647,Miranda; Gregory Joseph,36,0,37,1
1650800689116,CSE 8A,A50,083650,Miranda; Gregory Joseph,0,29,40,40
1650800695144,CSE 11,A01,083080,Cao; Yingjun,0,96,40,40
1650800701176,CSE 12,A01,083652,Staff,0,21,100,100
1650800707212,CSE 15L,A01,083654,Staff,0,3,50,50
1650800707212,CSE 15L,A02,083655,Staff,0,2,50,50
1650800713238,CSE 20,A01,083657,Staff,49,0,80,31
1650800719273,CSE 30,A01,083084,Eldon; John,0,75,40,40
1650800725301,CSE 100,A01,083659,Cao; Yingjun,0,71,50,50
1650800731324,CSE 134B,A01,083661,Powell; Thomas Allan,0,38,65,65
1650800737348,CSE 140,A01,083663,Staff,0,11,75,75
1650800743373,CSE 140L,A01,083088,Eldon; John,0,20,75,75
1650800749398,CSE 175,A01,083665,Kumar; Rakesh,7,0,25,18
1650800755426,CSE 190,A00,092507,Dubnov; Shlomo,10,0,20,10
1650800761459,ECE 45,A01,083139,Staff,0,1,60,60
1650800767492,ECE 65,A50,083695,Staff,0,5,30,30
1650800773517,ECE 109,A01,091882,Touri; Behrouz,32,0,70,38
1650800779545,ECE 180,A00,083140,Abi Samra; Nicholas Camill,20,0,30,10
1650800779545,ECE 180,B00,083141,Abi Samra; Nicholas Camill,0,0,30,30
1650800785580,MATH 10A,A01,083735,Patchell; Gregory David,2,0,30,28
1650800785580,MATH 10A,A02,083736,Patchell; Gregory David,27,0,30,3
1650800785580,MATH 10A,A03,083737,Patchell; Gregory David,24,0,30,6
1650800791613,MATH 10B,A01,083207,Staff,0,9,30,30
1650800791613,MATH 10B,A02,083208,Staff,0,6,30,30
1650800791613,MATH 10B,B01,083739,Staff,11,0,30,19
1650800791613,MATH 10B,B02,083740,Staff,28,0,30,2
1650800797648,MATH 18,A01,083743,Staff,0,0,30,30
1650800797648,MATH 18,A02,083744,Staff,23,0,30,7
1650800797648,MATH 18,A03,083745,Staff,21,0,30,9
1650800797648,MATH 18,A04,083746,Staff,26,0,30,4
1650800797648,MATH 18,B01,083748,Staff,0,15,30,30
1650800797648,MATH 18,B02,083749,Staff,0,12,30,30
1650800797648,MATH 18,B03,083750,Staff,0,12,30,30
1650800797648,MATH 18,B04,083751,Staff,0,12,30,30
1650800803675,MATH 20A,A01,083754,Staff,19,0,40,21
1650800809702,MATH 20B,A01,083756,Staff,0,13,30,30
1650800809702,MATH 20B,A02,083757,Staff,0,12,30,30
1650800815734,MATH 20C,A01,083760,Staff,0,17,30,30
1650800815734,MATH 20C,A02,083761,Staff,0,16,30,30
1650800815734,MATH 20C,B01,083762,Staff,9,0,30,21
1650800815734,MATH 20C,B02,083763,Staff,28,0,30,2
1650800821765,MATH 20D,A01,083765,Staff,2,1,30,28
1650800821765,MATH 20D,A02,083766,Staff,6,0,30,24
1650800821765,MATH 20D,A03,083767,Staff,24,0,30,6
1650800827797,MATH 20E,A01,083771,Staff,2,0,30,28
1650800827797,MATH 20E,A02,083772,Staff,15,0,30,15
1650800827797,MATH 20E,B01,083773,Staff,0,0,30,30
1650800827797,MATH 20E,B02,083774,Staff,5,0,30,25
1650800833828,MATH 103A,A01,083777,Staff,0,16,30,30
1650800833828,MATH 103A,A02,083778,Staff,0,15,30,30
1650800833828,MATH 103A,B01,083779,Staff,0,15,30,30
1650800833828,MATH 103A,B02,083780,Staff,0,15,30,30
1650800839855,MATH 105,A01,085443,Staff,0,22,30,30
1650800845884,MATH 109,A01,083213,Anzaldo; Leesa B,0,7,30,30
1650800845884,MATH 109,A02,083214,Anzaldo; Leesa B,0,7,30,30
1650800845884,MATH 109,B01,083215,Anzaldo; Leesa B,0,8,30,30
1650800845884,MATH 109,B02,083216,Anzaldo; Leesa B,0,7,30,30
1650800851918,MATH 142A,A01,083219,Chow; Bennett,0,16,30,30
1650800851918,MATH 142A,A02,083220,Chow; Bennett,0,15,30,30
1650800851918,MATH 142A,B01,083221,Chow; Bennett,0,16,30,30
1650800851918,MATH 142A,B02,083222,Chow; Bennett,0,14,30,30
1650800857944,MATH 193A,A01,083224,Staff,0,6,30,30
1650800857944,MATH 193A,A02,083225,Staff,0,6,30,30
1650800857944,MATH 193A,A03,083781,Staff,0,6,30,30
1650800857944,MATH 193A,A04,083782,Staff,0,7,30,30
1650800863970,MATH 197,001,091859,McAuley; Julian John,9998,0,9999,1
1650800870033,COGS 9,A01,083615,Staff,0,17,60,60
1650800876063,COGS 11,A01,083617,Boyle; Mary E. T.,16,0,40,24
1650800890335,COGS 13,A01,083071,Staff,0,38,40,40
1650800896362,COGS 14A,A01,092681,Staff,0,36,100,100
1650800904973,COGS 14B,A01,083073,Cheng; Tzu-Han,0,12,50,50
1650800911008,COGS 17,A01,092677,Staff,11,0,75,64
1650800917032,COGS 100,A01,083619,Staff,0,29,60,60
1650800923059,COGS 101A,A01,083621,Davis; Joshua Daniel,0,28,60,60
1650800929083,COGS 101B,A01,091572,Staff,0,3,60,60
1650800935113,COGS 101C,A01,083625,Delgado; Tania,14,0,30,16
1650800941138,COGS 107A,A01,083627,Boyle; Mary E. T.,0,16,60,60
1650800947931,COGS 118A,A01,083075,Staff,0,8,60,60
1650800953962,CSE 3,A50,083646,Miranda; Gregory Joseph,18,0,38,20
1650800953962,CSE 3,A51,083647,Miranda; Gregory Joseph,36,0,37,1
1650800959986,CSE 8A,A50,083650,Miranda; Gregory Joseph,0,29,40,40
1650800966013,CSE 11,A01,083080,Cao; Yingjun,0,96,40,40
1650800972038,CSE 12,A01,083652,Staff,0,21,100,100
1650800978062,CSE 15L,A01,083654,Staff,0,3,50,50
1650800978062,CSE 15L,A02,083655,Staff,0,2,50,50
1650800984087,CSE 20,A01,083657,Staff,49,0,80,31
1650800990119,CSE 30,A01,083084,Eldon; John,0,75,40,40
1650800996144,CSE 100,A01,083659,Cao; Yingjun,0,71,50,50
1650801002171,CSE 134B,A01,083661,Powell; Thomas Allan,0,38,65,65
1650801008199,CSE 140,A01,083663,Staff,0,11,75,75
1650801014233,CSE 140L,A01,083088,Eldon; John,0,20,75,75
1650801020258,CSE 175,A01,083665,Kumar; Rakesh,7,0,25,18
1650801026285,CSE 190,A00,092507,Dubnov; Shlomo,10,0,20,10
1650801032312,ECE 45,A01,083139,Staff,0,1,60,60
1650801038340,ECE 65,A50,083695,Staff,0,5,30,30
1650801044367,ECE 109,A01,091882,Touri; Behrouz,32,0,70,38
1650801050390,ECE 180,A00,083140,Abi Samra; Nicholas Camill,20,0,30,10
1650801050390,ECE 180,B00,083141,Abi Samra; Nicholas Camill,0,0,30,30
1650801056419,MATH 10A,A01,083735,Patchell; Gregory David,2,0,30,28
1650801056419,MATH 10A,A02,083736,Patchell; Gregory David,27,0,30,3
1650801056419,MATH 10A,A03,083737,Patchell; Gregory David,24,0,30,6
1650801062445,MATH 10B,A01,083207,Staff,0,9,30,30
1650801062445,MATH 10B,A02,083208,Staff,0,6,30,30
1650801062445,MATH 10B,B01,083739,Staff,11,0,30,19
1650801062445,MATH 10B,B02,083740,Staff,28,0,30,2
1650801068478,MATH 18,A01,083743,Staff,0,0,30,30
1650801068478,MATH 18,A02,083744,Staff,23,0,30,7
1650801068478,MATH 18,A03,083745,Staff,21,0,30,9
1650801068478,MATH 18,A04,083746,Staff,26,0,30,4
1650801068478,MATH 18,B01,083748,Staff,0,15,30,30
1650801068478,MATH 18,B02,083749,Staff,0,12,30,30
1650801068478,MATH 18,B03,083750,Staff,0,12,30,30
1650801068478,MATH 18,B04,083751,Staff,0,12,30,30
1650801074505,MATH 20A,A01,083754,Staff,19,0,40,21
1650801080531,MATH 20B,A01,083756,Staff,0,13,30,30
1650801080531,MATH 20B,A02,083757,Staff,0,12,30,30
1650801086558,MATH 20C,A01,083760,Staff,0,17,30,30
1650801086558,MATH 20C,A02,083761,Staff,0,16,30,30
1650801086558,MATH 20C,B01,083762,Staff,9,0,30,21
1650801086558,MATH 20C,B02,083763,Staff,28,0,30,2
1650801092587,MATH 20D,A01,083765,Staff,2,1,30,28
1650801092587,MATH 20D,A02,083766,Staff,6,0,30,24
1650801092587,MATH 20D,A03,083767,Staff,24,0,30,6
1650801098613,MATH 20E,A01,083771,Staff,2,0,30,28
1650801098613,MATH 20E,A02,083772,Staff,15,0,30,15
1650801098613,MATH 20E,B01,083773,Staff,0,0,30,30
1650801098613,MATH 20E,B02,083774,Staff,5,0,30,25
1650801104645,MATH 103A,A01,083777,Staff,0,16,30,30
1650801104645,MATH 103A,A02,083778,Staff,0,15,30,30
1650801104645,MATH 103A,B01,083779,Staff,0,15,30,30
1650801104645,MATH 103A,B02,083780,Staff,0,15,30,30
1650801110677,MATH 105,A01,085443,Staff,0,22,30,30
1650801116708,MATH 109,A01,083213,Anzaldo; Leesa B,0,7,30,30
1650801116708,MATH 109,A02,083214,Anzaldo; Leesa B,0,7,30,30
1650801116708,MATH 109,B01,083215,Anzaldo; Leesa B,0,8,30,30
1650801116708,MATH 109,B02,083216,Anzaldo; Leesa B,0,7,30,30
1650801122735,MATH 142A,A01,083219,Chow; Bennett,0,16,30,30
1650801122735,MATH 142A,A02,083220,Chow; Bennett,0,15,30,30
1650801122735,MATH 142A,B01,083221,Chow; Bennett,0,16,30,30
1650801122735,MATH 142A,B02,083222,Chow; Bennett,0,14,30,30
1650801128765,MATH 193A,A01,083224,Staff,0,6,30,30
1650801128765,MATH 193A,A02,083225,Staff,0,6,30,30
1650801128765,MATH 193A,A03,083781,Staff,0,6,30,30
1650801128765,MATH 193A,A04,083782,Staff,0,7,30,30
1650801134789,MATH 197,001,091859,McAuley; Julian John,9998,0,9999,1
1650801140860,COGS 9,A01,083615,Staff,0,17,60,60
1650801146886,COGS 11,A01,083617,Boyle; Mary E. T.,16,0,40,24
1650801152911,COGS 13,A01,083071,Staff,0,38,40,40
1650801158939,COGS 14A,A01,092681,Staff,0,36,100,100
1650801165036,COGS 14B,A01,083073,Cheng; Tzu-Han,0,12,50,50
1650801171066,COGS 17,A01,092677,Staff,11,0,75,64
1650801177096,COGS 100,A01,083619,Staff,0,29,60,60
1650801183124,COGS 101A,A01,083621,Davis; Joshua Daniel,0,28,60,60
1650801189150,COGS 101B,A01,091572,Staff,0,3,60,60
1650801195176,COGS 101C,A01,083625,Delgado; Tania,14,0,30,16
1650801201202,COGS 107A,A01,083627,Boyle; Mary E. T.,0,16,60,60
1650801207230,COGS 118A,A01,083075,Staff,0,8,60,60
1650801213257,CSE 3,A50,083646,Miranda; Gregory Joseph,18,0,38,20
1650801213257,CSE 3,A51,083647,Miranda; Gregory Joseph,36,0,37,1
1650801219289,CSE 8A,A50,083650,Miranda; Gregory Joseph,0,29,40,40
1650801225313,CSE 11,A01,083080,Cao; Yingjun,0,96,40,40
1650801231368,CSE 12,A01,083652,Staff,0,21,100,100
1650801237392,CSE 15L,A01,083654,Staff,0,3,50,50
1650801237392,CSE 15L,A02,083655,Staff,0,2,50,50
1650801243420,CSE 20,A01,083657,Staff,49,0,80,31
1650801249447,CSE 30,A01,083084,Eldon; John,0,75,40,40
1650801255478,CSE 100,A01,083659,Cao; Yingjun,0,71,50,50
1650801261505,CSE 134B,A01,083661,Powell; Thomas Allan,0,38,65,65
1650801267532,CSE 140,A01,083663,Staff,0,11,75,75
1650801273560,CSE 140L,A01,083088,Eldon; John,0,20,75,75
1650801279584,CSE 175,A01,083665,Kumar; Rakesh,7,0,25,18
1650801285612,CSE 190,A00,092507,Dubnov; Shlomo,10,0,20,10
1650801291642,ECE 45,A01,083139,Staff,0,1,60,60
1650801297668,ECE 65,A50,083695,Staff,0,5,30,30
1650801303694,ECE 109,A01,091882,Touri; Behrouz,32,0,70,38
1650801309719,ECE 180,A00,083140,Abi Samra; Nicholas Camill,20,0,30,10
1650801309719,ECE 180,B00,083141,Abi Samra; Nicholas Camill,0,0,30,30
1650801315746,MATH 10A,A01,083735,Patchell; Gregory David,2,0,30,28
1650801315746,MATH 10A,A02,083736,Patchell; Gregory David,27,0,30,3
1650801315746,MATH 10A,A03,083737,Patchell; Gregory David,24,0,30,6
1650801321771,MATH 10B,A01,083207,Staff,0,9,30,30
1650801321771,MATH 10B,A02,083208,Staff,0,6,30,30
1650801321771,MATH 10B,B01,083739,Staff,11,0,30,19
1650801321771,MATH 10B,B02,083740,Staff,28,0,30,2
1650801327806,MATH 18,A01,083743,Staff,0,0,30,30
1650801327806,MATH 18,A02,083744,Staff,23,0,30,7
1650801327806,MATH 18,A03,083745,Staff,21,0,30,9
1650801327806,MATH 18,A04,083746,Staff,26,0,30,4
1650801327806,MATH 18,B01,083748,Staff,0,15,30,30
1650801327806,MATH 18,B02,083749,Staff,0,12,30,30
1650801327806,MATH 18,B03,083750,Staff,0,12,30,30
1650801327806,MATH 18,B04,083751,Staff,0,12,30,30
1650801333830,MATH 20A,A01,083754,Staff,19,0,40,21
1650801339856,MATH 20B,A01,083756,Staff,0,13,30,30
1650801339856,MATH 20B,A02,083757,Staff,0,12,30,30
1650801345885,MATH 20C,A01,083760,Staff,0,17,30,30
1650801345885,MATH 20C,A02,083761,Staff,0,16,30,30
1650801345885,MATH 20C,B01,083762,Staff,9,0,30,21
1650801345885,MATH 20C,B02,083763,Staff,28,0,30,2
1650801351912,MATH 20D,A01,083765,Staff,2,1,30,28
1650801351912,MATH 20D,A02,083766,Staff,6,0,30,24
1650801351912,MATH 20D,A03,083767,Staff,24,0,30,6
1650801357938,MATH 20E,A01,083771,Staff,2,0,30,28
1650801357938,MATH 20E,A02,083772,Staff,15,0,30,15
1650801357938,MATH 20E,B01,083773,Staff,0,0,30,30
1650801357938,MATH 20E,B02,083774,Staff,5,0,30,25
1650801363961,MATH 103A,A01,083777,Staff,0,16,30,30
1650801363961,MATH 103A,A02,083778,Staff,0,15,30,30
1650801363961,MATH 103A,B01,083779,Staff,0,15,30,30
1650801363961,MATH 103A,B02,083780,Staff,0,15,30,30
1650801369987,MATH 105,A01,085443,Staff,0,22,30,30
1650801376013,MATH 109,A01,083213,Anzaldo; Leesa B,0,7,30,30
1650801376013,MATH 109,A02,083214,Anzaldo; Leesa B,0,7,30,30
1650801376013,MATH 109,B01,083215,Anzaldo; Leesa B,0,8,30,30
1650801376013,MATH 109,B02,083216,Anzaldo; Leesa B,0,7,30,30
1650801382051,MATH 142A,A01,083219,Chow; Bennett,0,16,30,30
1650801382051,MATH 142A,A02,083220,Chow; Bennett,0,15,30,30
1650801382051,MATH 142A,B01,083221,Chow; Bennett,0,16,30,30
1650801382051,MATH 142A,B02,083222,Chow; Bennett,0,14,30,30
1650801388078,MATH 193A,A01,083224,Staff,0,6,30,30
1650801388078,MATH 193A,A02,083225,Staff,0,6,30,30
1650801388078,MATH 193A,A03,083781,Staff,0,6,30,30
1650801388078,MATH 193A,A04,083782,Staff,0,7,30,30
1650801394105,MATH 197,001,091859,McAuley; Julian John,9998,0,9999,1
1650801400180,COGS 9,A01,083615,Staff,0,17,60,60
1650801406207,COGS 11,A01,083617,Boyle; Mary E. T.,16,0,40,24
1650801412235,COGS 13,A01,083071,Staff,0,38,40,40
1650801418262,COGS 14A,A01,092681,Staff,0,36,100,100
1650801424286,COGS 14B,A01,083073,Cheng; Tzu-Han,0,12,50,50
1650801430313,COGS 17,A01,092677,Staff,11,0,75,64
1650801436337,COGS 100,A01,083619,Staff,0,29,60,60
1650801442362,COGS 101A,A01,083621,Davis; Joshua Daniel,0,28,60,60
1650801448388,COGS 101B,A01,091572,Staff,0,3,60,60
1650801454417,COGS 101C,A01,083625,Delgado; Tania,14,0,30,16
1650801460441,COGS 107A,A01,083627,Boyle; Mary E. T.,0,16,60,60
1650801466467,COGS 118A,A01,083075,Staff,0,8,60,60
1650801472495,CSE 3,A50,083646,Miranda; Gregory Joseph,18,0,38,20
1650801472495,CSE 3,A51,083647,Miranda; Gregory Joseph,36,0,37,1
1650801478521,CSE 8A,A50,083650,Miranda; Gregory Joseph,0,29,40,40
1650801484546,CSE 11,A01,083080,Cao; Yingjun,0,96,40,40
1650801490584,CSE 12,A01,083652,Staff,0,21,100,100
1650801496611,CSE 15L,A01,083654,Staff,0,3,50,50
1650801496611,CSE 15L,A02,083655,Staff,0,2,50,50
1650801502640,CSE 20,A01,083657,Staff,49,0,80,31
1650801508668,CSE 30,A01,083084,Eldon; John,0,75,40,40
1650801514694,CSE 100,A01,083659,Cao; Yingjun,0,71,50,50
1650801520722,CSE 134B,A01,083661,Powell; Thomas Allan,0,38,65,65
1650801526746,CSE 140,A01,083663,Staff,0,11,75,75
1650801532771,CSE 140L,A01,083088,Eldon; John,0,20,75,75
1650801538799,CSE 175,A01,083665,Kumar; Rakesh,7,0,25,18
1650801544824,CSE 190,A00,092507,Dubnov; Shlomo,10,0,20,10
1650801550853,ECE 45,A01,083139,Staff,0,1,60,60
1650801556893,ECE 65,A50,083695,Staff,0,5,30,30
1650801562918,ECE 109,A01,091882,Touri; Behrouz,32,0,70,38
1650801568946,ECE 180,A00,083140,Abi Samra; Nicholas Camill,20,0,30,10
1650801568946,ECE 180,B00,083141,Abi Samra; Nicholas Camill,0,0,30,30
1650801574975,MATH 10A,A01,083735,Patchell; Gregory David,2,0,30,28
1650801574975,MATH 10A,A02,083736,Patchell; Gregory David,27,0,30,3
1650801574975,MATH 10A,A03,083737,Patchell; Gregory David,24,0,30,6
1650801581005,MATH 10B,A01,083207,Staff,0,9,30,30
1650801581005,MATH 10B,A02,083208,Staff,0,6,30,30
1650801581005,MATH 10B,B01,083739,Staff,11,0,30,19
1650801581005,MATH 10B,B02,083740,Staff,28,0,30,2
1650801587037,MATH 18,A01,083743,Staff,0,0,30,30
1650801587037,MATH 18,A02,083744,Staff,23,0,30,7
1650801587037,MATH 18,A03,083745,Staff,21,0,30,9
1650801587037,MATH 18,A04,083746,Staff,26,0,30,4
1650801587037,MATH 18,B01,083748,Staff,0,15,30,30
1650801587037,MATH 18,B02,083749,Staff,0,12,30,30
1650801587037,MATH 18,B03,083750,Staff,0,12,30,30
1650801587037,MATH 18,B04,083751,Staff,0,12,30,30
1650801593061,MATH 20A,A01,083754,Staff,19,0,40,21
1650801599087,MATH 20B,A01,083756,Staff,0,13,30,30
1650801599087,MATH 20B,A02,083757,Staff,0,12,30,30
1650801605110,MATH 20C,A01,083760,Staff,0,17,30,30
1650801605110,MATH 20C,A02,083761,Staff,0,16,30,30
1650801605110,MATH 20C,B01,083762,Staff,9,0,30,21
1650801605110,MATH 20C,B02,083763,Staff,28,0,30,2
1650801611144,MATH 20D,A01,083765,Staff,2,1,30,28
1650801611144,MATH 20D,A02,083766,Staff,6,0,30,24
1650801611144,MATH 20D,A03,083767,Staff,24,0,30,6
1650801617173,MATH 20E,A01,083771,Staff,2,0,30,28
1650801617173,MATH 20E,A02,083772,Staff,15,0,30,15
1650801617173,MATH 20E,B01,083773,Staff,0,0,30,30
1650801617173,MATH 20E,B02,083774,Staff,5,0,30,25
1650801623199,MATH 103A,A01,083777,Staff,0,16,30,30
1650801623199,MATH 103A,A02,083778,Staff,0,15,30,30
1650801623199,MATH 103A,B01,083779,Staff,0,15,30,30
1650801623199,MATH 103A,B02,083780,Staff,0,15,30,30
1650801629229,MATH 105,A01,085443,Staff,0,22,30,30
1650801635254,MATH 109,A01,083213,Anzaldo; Leesa B,0,7,30,30
1650801635254,MATH 109,A02,083214,Anzaldo; Leesa B,0,7,30,30
1650801635254,MATH 109,B01,083215,Anzaldo; Leesa B,0,8,30,30
1650801635254,MATH 109,B02,083216,Anzaldo; Leesa B,0,7,30,30
1650801641278,MATH 142A,A01,083219,Chow; Bennett,0,16,30,30
1650801641278,MATH 142A,A02,083220,Chow; Bennett,0,15,30,30
1650801641278,MATH 142A,B01,083221,Chow; Bennett,0,16,30,30
1650801641278,MATH 142A,B02,083222,Chow; Bennett,0,14,30,30
1650801647302,MATH 193A,A01,083224,Staff,0,6,30,30
1650801647302,MATH 193A,A02,083225,Staff,0,6,30,30
1650801647302,MATH 193A,A03,083781,Staff,0,6,30,30
1650801647302,MATH 193A,A04,083782,Staff,0,7,30,30
1650801653328,MATH 197,001,091859,McAuley; Julian John,9998,0,9999,1
1650801659388,COGS 9,A01,083615,Staff,0,17,60,60
1650801665413,COGS 11,A01,083617,Boyle; Mary E. T.,16,0,40,24
1650801671437,COGS 13,A01,083071,Staff,0,38,40,40
1650801677465,COGS 14A,A01,092681,Staff,0,36,100,100
1650801683488,COGS 14B,A01,083073,Cheng; Tzu-Han,0,12,50,50
1650801689521,COGS 17,A01,092677,Staff,11,0,75,64
1650801695547,COGS 100,A01,083619,Staff,0,29,60,60
1650801701571,COGS 101A,A01,083621,Davis; Joshua Daniel,0,28,60,60
1650801707597,COGS 101B,A01,091572,Staff,0,3,60,60
1650801713624,COGS 101C,A01,083625,Delgado; Tania,14,0,30,16
1650801719651,COGS 107A,A01,083627,Boyle; Mary E. T.,0,16,60,60
1650801725675,COGS 118A,A01,083075,Staff,0,8,60,60
1650801731702,CSE 3,A50,083646,Miranda; Gregory Joseph,18,0,38,20
1650801731702,CSE 3,A51,083647,Miranda; Gregory Joseph,36,0,37,1
1650801737727,CSE 8A,A50,083650,Miranda; Gregory Joseph,0,29,40,40
1650801743753,CSE 11,A01,083080,Cao; Yingjun,0,96,40,40
1650801749781,CSE 12,A01,083652,Staff,0,21,100,100
1650801755811,CSE 15L,A01,083654,Staff,0,3,50,50
1650801755811,CSE 15L,A02,083655,Staff,0,2,50,50
1650801761928,CSE 20,A01,083657,Staff,49,0,80,31
1650801767956,CSE 30,A01,083084,Eldon; John,0,75,40,40
1650801773981,CSE 100,A01,083659,Cao; Yingjun,0,71,50,50
1650801780015,CSE 134B,A01,083661,Powell; Thomas Allan,0,38,65,65
1650801786040,CSE 140,A01,083663,Staff,0,11,75,75
1650801792069,CSE 140L,A01,083088,Eldon; John,0,20,75,75
1650801798091,CSE 175,A01,083665,Kumar; Rakesh,7,0,25,18
1650801804117,CSE 190,A00,092507,Dubnov; Shlomo,10,0,20,10
1650801810143,ECE 45,A01,083139,Staff,0,1,60,60
1650801816170,ECE 65,A50,083695,Staff,0,5,30,30
1650801822194,ECE 109,A01,091882,Touri; Behrouz,32,0,70,38
1650801828223,ECE 180,A00,083140,Abi Samra; Nicholas Camill,20,0,30,10
1650801828223,ECE 180,B00,083141,Abi Samra; Nicholas Camill,0,0,30,30
1650801834247,MATH 10A,A01,083735,Patchell; Gregory David,2,0,30,28
1650801834247,MATH 10A,A02,083736,Patchell; Gregory David,27,0,30,3
1650801834247,MATH 10A,A03,083737,Patchell; Gregory David,24,0,30,6
1650801840278,MATH 10B,A01,083207,Staff,0,9,30,30
1650801840278,MATH 10B,A02,083208,Staff,0,6,30,30
1650801840278,MATH 10B,B01,083739,Staff,11,0,30,19
1650801840278,MATH 10B,B02,083740,Staff,28,0,30,2
1650801846308,MATH 18,A01,083743,Staff,0,0,30,30
1650801846308,MATH 18,A02,083744,Staff,23,0,30,7
1650801846308,MATH 18,A03,083745,Staff,21,0,30,9
1650801846308,MATH 18,A04,083746,Staff,26,0,30,4
1650801846308,MATH 18,B01,083748,Staff,0,15,30,30
1650801846308,MATH 18,B02,083749,Staff,0,12,30,30
1650801846308,MATH 18,B03,083750,Staff,0,12,30,30
1650801846308,MATH 18,B04,083751,Staff,0,12,30,30
1650801852332,MATH 20A,A01,083754,Staff,19,0,40,21
1650801858363,MATH 20B,A01,083756,Staff,0,13,30,30
1650801858363,MATH 20B,A02,083757,Staff,0,12,30,30
1650801864400,MATH 20C,A01,083760,Staff,0,17,30,30
1650801864400,MATH 20C,A02,083761,Staff,0,16,30,30
1650801864400,MATH 20C,B01,083762,Staff,9,0,30,21
1650801864400,MATH 20C,B02,083763,Staff,28,0,30,2
1650801870427,MATH 20D,A01,083765,Staff,2,1,30,28
1650801870427,MATH 20D,A02,083766,Staff,6,0,30,24
1650801870427,MATH 20D,A03,083767,Staff,24,0,30,6
1650801876458,MATH 20E,A01,083771,Staff,2,0,30,28
1650801876458,MATH 20E,A02,083772,Staff,15,0,30,15
1650801876458,MATH 20E,B01,083773,Staff,0,0,30,30
1650801876458,MATH 20E,B02,083774,Staff,5,0,30,25
1650801882493,MATH 103A,A01,083777,Staff,0,16,30,30
1650801882493,MATH 103A,A02,083778,Staff,0,15,30,30
1650801882493,MATH 103A,B01,083779,Staff,0,15,30,30
1650801882493,MATH 103A,B02,083780,Staff,0,15,30,30
1650801888529,MATH 105,A01,085443,Staff,0,22,30,30
1650801894559,MATH 109,A01,083213,Anzaldo; Leesa B,0,7,30,30
1650801894559,MATH 109,A02,083214,Anzaldo; Leesa B,0,7,30,30
1650801894559,MATH 109,B01,083215,Anzaldo; Leesa B,0,8,30,30
1650801894559,MATH 109,B02,083216,Anzaldo; Leesa B,0,7,30,30
1650801900584,MATH 142A,A01,083219,Chow; Bennett,0,16,30,30
1650801900584,MATH 142A,A02,083220,Chow; Bennett,0,15,30,30
1650801900584,MATH 142A,B01,083221,Chow; Bennett,0,16,30,30
1650801900584,MATH 142A,B02,083222,Chow; Bennett,0,14,30,30
1650801906617,MATH 193A,A01,083224,Staff,0,6,30,30
1650801906617,MATH 193A,A02,083225,Staff,0,6,30,30
1650801906617,MATH 193A,A03,083781,Staff,0,6,30,30
1650801906617,MATH 193A,A04,083782,Staff,0,7,30,30
1650801912648,MATH 197,001,091859,McAuley; Julian John,9998,0,9999,1
1650801918722,COGS 9,A01,083615,Staff,0,17,60,60
1650801924747,COGS 11,A01,083617,Boyle; Mary E. T.,16,0,40,24
1650801930775,COGS 13,A01,083071,Staff,0,38,40,40
1650801936802,COGS 14A,A01,092681,Staff,0,36,100,100
1650801942829,COGS 14B,A01,083073,Cheng; Tzu-Han,0,12,50,50
1650801948854,COGS 17,A01,092677,Staff,11,0,75,64
1650801954879,COGS 100,A01,083619,Staff,0,29,60,60
1650801960914,COGS 101A,A01,083621,Davis; Joshua Daniel,0,28,60,60
1650801966938,COGS 101B,A01,091572,Staff,0,3,60,60
1650801972967,COGS 101C,A01,083625,Delgado; Tania,14,0,30,16
1650801978995,COGS 107A,A01,083627,Boyle; Mary E. T.,0,16,60,60
1650801985022,COGS 118A,A01,083075,Staff,0,8,60,60
1650801991052,CSE 3,A50,083646,Miranda; Gregory Joseph,18,0,38,20
1650801991052,CSE 3,A51,083647,Miranda; Gregory Joseph,36,0,37,1
1650801997075,CSE 8A,A50,083650,Miranda; Gregory Joseph,0,29,40,40
1650802003104,CSE 11,A01,083080,Cao; Yingjun,0,96,40,40
1650802009130,CSE 12,A01,083652,Staff,0,21,100,100
1650802015159,CSE 15L,A01,083654,Staff,0,3,50,50
1650802015159,CSE 15L,A02,083655,Staff,0,2,50,50
1650802021183,CSE 20,A01,083657,Staff,49,0,80,31
1650802027213,CSE 30,A01,083084,Eldon; John,0,75,40,40
1650802033238,CSE 100,A01,083659,Cao; Yingjun,0,71,50,50
1650802039268,CSE 134B,A01,083661,Powell; Thomas Allan,0,38,65,65
1650802045292,CSE 140,A01,083663,Staff,0,11,75,75
1650802051322,CSE 140L,A01,083088,Eldon; John,0,20,75,75
1650802057349,CSE 175,A01,083665,Kumar; Rakesh,7,0,25,18
1650802063384,CSE 190,A00,092507,Dubnov; Shlomo,10,0,20,10
1650802069415,ECE 45,A01,083139,Staff,0,1,60,60
1650802075450,ECE 65,A50,083695,Staff,0,5,30,30
1650802081479,ECE 109,A01,091882,Touri; Behrouz,32,0,70,38
1650802087511,ECE 180,A00,083140,Abi Samra; Nicholas Camill,20,0,30,10
1650802087511,ECE 180,B00,083141,Abi Samra; Nicholas Camill,0,0,30,30
1650802093537,MATH 10A,A01,083735,Patchell; Gregory David,2,0,30,28
1650802093537,MATH 10A,A02,083736,Patchell; Gregory David,27,0,30,3
1650802093537,MATH 10A,A03,083737,Patchell; Gregory David,24,0,30,6
1650802099563,MATH 10B,A01,083207,Staff,0,9,30,30
1650802099563,MATH 10B,A02,083208,Staff,0,6,30,30
1650802099563,MATH 10B,B01,083739,Staff,11,0,30,19
1650802099563,MATH 10B,B02,083740,Staff,28,0,30,2
1650802105599,MATH 18,A01,083743,Staff,0,0,30,30
1650802105599,MATH 18,A02,083744,Staff,23,0,30,7
1650802105599,MATH 18,A03,083745,Staff,21,0,30,9
1650802105599,MATH 18,A04,083746,Staff,26,0,30,4
1650802105599,MATH 18,B01,083748,Staff,0,15,30,30
1650802105599,MATH 18,B02,083749,Staff,0,12,30,30
1650802105599,MATH 18,B03,083750,Staff,0,12,30,30
1650802105599,MATH 18,B04,083751,Staff,0,12,30,30
1650802111623,MATH 20A,A01,083754,Staff,19,0,40,21
1650802117653,MATH 20B,A01,083756,Staff,0,13,30,30
1650802117653,MATH 20B,A02,083757,Staff,0,12,30,30
1650802123679,MATH 20C,A01,083760,Staff,0,17,30,30
1650802123679,MATH 20C,A02,083761,Staff,0,16,30,30
1650802123679,MATH 20C,B01,083762,Staff,9,0,30,21
1650802123679,MATH 20C,B02,083763,Staff,28,0,30,2
1650802129708,MATH 20D,A01,083765,Staff,2,1,30,28
1650802129708,MATH 20D,A02,083766,Staff,6,0,30,24
1650802129708,MATH 20D,A03,083767,Staff,24,0,30,6
1650802135734,MATH 20E,A01,083771,Staff,2,0,30,28
1650802135734,MATH 20E,A02,083772,Staff,15,0,30,15
1650802135734,MATH 20E,B01,083773,Staff,0,0,30,30
1650802135734,MATH 20E,B02,083774,Staff,5,0,30,25
1650802141766,MATH 103A,A01,083777,Staff,0,16,30,30
1650802141766,MATH 103A,A02,083778,Staff,0,15,30,30
1650802141766,MATH 103A,B01,083779,Staff,0,15,30,30
1650802141766,MATH 103A,B02,083780,Staff,0,15,30,30
1650802147795,MATH 105,A01,085443,Staff,0,22,30,30
1650802153835,MATH 109,A01,083213,Anzaldo; Leesa B,0,7,30,30
1650802153835,MATH 109,A02,083214,Anzaldo; Leesa B,0,7,30,30
1650802153835,MATH 109,B01,083215,Anzaldo; Leesa B,0,8,30,30
1650802153835,MATH 109,B02,083216,Anzaldo; Leesa B,0,7,30,30
1650802159872,MATH 142A,A01,083219,Chow; Bennett,0,16,30,30
1650802159872,MATH 142A,A02,083220,Chow; Bennett,0,15,30,30
1650802159872,MATH 142A,B01,083221,Chow; Bennett,0,16,30,30
1650802159872,MATH 142A,B02,083222,Chow; Bennett,0,14,30,30
1650802165902,MATH 193A,A01,083224,Staff,0,6,30,30
1650802165902,MATH 193A,A02,083225,Staff,0,6,30,30
1650802165902,MATH 193A,A03,083781,Staff,0,6,30,30
1650802165902,MATH 193A,A04,083782,Staff,0,7,30,30
1650802171928,MATH 197,001,091859,McAuley; Julian John,9998,0,9999,1
1650802178003,COGS 9,A01,083615,Staff,0,17,60,60
1650802184035,COGS 11,A01,083617,Boyle; Mary E. T.,16,0,40,24
1650802190066,COGS 13,A01,083071,Staff,0,38,40,40
1650802196091,COGS 14A,A01,092681,Staff,0,36,100,100
1650802202117,COGS 14B,A01,083073,Cheng; Tzu-Han,0,12,50,50
1650802208144,COGS 17,A01,092677,Staff,11,0,75,64
1650802214170,COGS 100,A01,083619,Staff,0,29,60,60
1650802220196,COGS 101A,A01,083621,Davis; Joshua Daniel,0,28,60,60
1650802226222,COGS 101B,A01,091572,Staff,0,3,60,60
1650802232249,COGS 101C,A01,083625,Delgado; Tania,14,0,30,16
1650802238277,COGS 107A,A01,083627,Boyle; Mary E. T.,0,16,60,60
1650802244303,COGS 118A,A01,083075,Staff,0,8,60,60
1650802250327,CSE 3,A50,083646,Miranda; Gregory Joseph,18,0,38,20
1650802250327,CSE 3,A51,083647,Miranda; Gregory Joseph,36,0,37,1
1650802256352,CSE 8A,A50,083650,Miranda; Gregory Joseph,0,29,40,40
1650802262376,CSE 11,A01,083080,Cao; Yingjun,0,96,40,40
1650802268402,CSE 12,A01,083652,Staff,0,21,100,100
1650802274431,CSE 15L,A01,083654,Staff,0,3,50,50
1650802274431,CSE 15L,A02,083655,Staff,0,2,50,50
1650802280454,CSE 20,A01,083657,Staff,49,0,80,31
1650802286477,CSE 30,A01,083084,Eldon; John,0,75,40,40
1650802292501,CSE 100,A01,083659,Cao; Yingjun,0,71,50,50
1650802298524,CSE 134B,A01,083661,Powell; Thomas Allan,0,38,65,65
1650802304547,CSE 140,A01,083663,Staff,0,11,75,75
1650802310577,CSE 140L,A01,083088,Eldon; John,0,20,75,75
1650802316604,CSE 175,A01,083665,Kumar; Rakesh,7,0,25,18
1650802322630,CSE 190,A00,092507,Dubnov; Shlomo,10,0,20,10
1650802328660,ECE 45,A01,083139,Staff,0,1,60,60
1650802334684,ECE 65,A50,083695,Staff,0,5,30,30
1650802340710,ECE 109,A01,091882,Touri; Behrouz,32,0,70,38
1650802346744,ECE 180,A00,083140,Abi Samra; Nicholas Camill,20,0,30,10
1650802346744,ECE 180,B00,083141,Abi Samra; Nicholas Camill,0,0,30,30
1650802352769,MATH 10A,A01,083735,Patchell; Gregory David,2,0,30,28
1650802352769,MATH 10A,A02,083736,Patchell; Gregory David,27,0,30,3
1650802352769,MATH 10A,A03,083737,Patchell; Gregory David,24,0,30,6
1650802358890,MATH 10B,A01,083207,Staff,0,9,30,30
1650802358890,MATH 10B,A02,083208,Staff,0,6,30,30
1650802358890,MATH 10B,B01,083739,Staff,11,0,30,19
1650802358890,MATH 10B,B02,083740,Staff,28,0,30,2
1650802364916,MATH 18,A01,083743,Staff,0,0,30,30
1650802364916,MATH 18,A02,083744,Staff,23,0,30,7
1650802364916,MATH 18,A03,083745,Staff,21,0,30,9
1650802364916,MATH 18,A04,083746,Staff,26,0,30,4
1650802364916,MATH 18,B01,083748,Staff,0,15,30,30
1650802364916,MATH 18,B02,083749,Staff,0,12,30,30
1650802364916,MATH 18,B03,083750,Staff,0,12,30,30
1650802364916,MATH 18,B04,083751,Staff,0,12,30,30
1650802370941,MATH 20A,A01,083754,Staff,19,0,40,21
1650802376968,MATH 20B,A01,083756,Staff,0,13,30,30
1650802376968,MATH 20B,A02,083757,Staff,0,12,30,30
1650802382994,MATH 20C,A01,083760,Staff,0,17,30,30
1650802382994,MATH 20C,A02,083761,Staff,0,16,30,30
1650802382994,MATH 20C,B01,083762,Staff,9,0,30,21
1650802382994,MATH 20C,B02,083763,Staff,28,0,30,2
1650802389022,MATH 20D,A01,083765,Staff,2,1,30,28
1650802389022,MATH 20D,A02,083766,Staff,6,0,30,24
1650802389022,MATH 20D,A03,083767,Staff,24,0,30,6
1650802395052,MATH 20E,A01,083771,Staff,2,0,30,28
1650802395052,MATH 20E,A02,083772,Staff,15,0,30,15
1650802395052,MATH 20E,B01,083773,Staff,0,0,30,30
1650802395052,MATH 20E,B02,083774,Staff,5,0,30,25
1650802401080,MATH 103A,A01,083777,Staff,0,16,30,30
1650802401080,MATH 103A,A02,083778,Staff,0,15,30,30
1650802401080,MATH 103A,B01,083779,Staff,0,15,30,30
1650802401080,MATH 103A,B02,083780,Staff,0,15,30,30
1650802407103,MATH 105,A01,085443,Staff,0,22,30,30
1650802413134,MATH 109,A01,083213,Anzaldo; Leesa B,0,7,30,30
1650802413134,MATH 109,A02,083214,Anzaldo; Leesa B,0,7,30,30
1650802413134,MATH 109,B01,083215,Anzaldo; Leesa B,0,8,30,30
1650802413134,MATH 109,B02,083216,Anzaldo; Leesa B,0,7,30,30
1650802419163,MATH 142A,A01,083219,Chow; Bennett,0,16,30,30
1650802419163,MATH 142A,A02,083220,Chow; Bennett,0,15,30,30
1650802419163,MATH 142A,B01,083221,Chow; Bennett,0,16,30,30
1650802419163,MATH 142A,B02,083222,Chow; Bennett,0,14,30,30
1650802425188,MATH 193A,A01,083224,Staff,0,6,30,30
1650802425188,MATH 193A,A02,083225,Staff,0,6,30,30
1650802425188,MATH 193A,A03,083781,Staff,0,6,30,30
1650802425188,MATH 193A,A04,083782,Staff,0,7,30,30
1650802431223,MATH 197,001,091859,McAuley; Julian John,9998,0,9999,1
1650802437292,COGS 9,A01,083615,Staff,0,17,60,60
1650802443320,COGS 11,A01,083617,Boyle; Mary E. T.,16,0,40,24
1650802449347,COGS 13,A01,083071,Staff,0,38,40,40
1650802455372,COGS 14A,A01,092681,Staff,0,36,100,100
1650802461414,COGS 14B,A01,083073,Cheng; Tzu-Han,0,12,50,50
1650802467442,COGS 17,A01,092677,Staff,11,0,75,64
1650802473471,COGS 100,A01,083619,Staff,0,29,60,60
1650802479500,COGS 101A,A01,083621,Davis; Joshua Daniel,0,28,60,60
1650802485523,COGS 101B,A01,091572,Staff,0,3,60,60
1650802491551,COGS 101C,A01,083625,Delgado; Tania,14,0,30,16
1650802497575,COGS 107A,A01,083627,Boyle; Mary E. T.,0,16,60,60
1650802503600,COGS 118A,A01,083075,Staff,0,8,60,60
1650802509626,CSE 3,A50,083646,Miranda; Gregory Joseph,18,0,38,20
1650802509626,CSE 3,A51,083647,Miranda; Gregory Joseph,36,0,37,1
1650802515665,CSE 8A,A50,083650,Miranda; Gregory Joseph,0,29,40,40
1650802521694,CSE 11,A01,083080,Cao; Yingjun,0,96,40,40
1650802527721,CSE 12,A01,083652,Staff,0,21,100,100
1650802533748,CSE 15L,A01,083654,Staff,0,3,50,50
1650802533748,CSE 15L,A02,083655,Staff,0,2,50,50
1650802539776,CSE 20,A01,083657,Staff,49,0,80,31
1650802545813,CSE 30,A01,083084,Eldon; John,0,75,40,40
1650802551838,CSE 100,A01,083659,Cao; Yingjun,0,71,50,50
1650802557865,CSE 134B,A01,083661,Powell; Thomas Allan,0,38,65,65
1650802563892,CSE 140,A01,083663,Staff,0,11,75,75
1650802569922,CSE 140L,A01,083088,Eldon; John,0,20,75,75
1650802575949,CSE 175,A01,083665,Kumar; Rakesh,7,0,25,18
1650802581976,CSE 190,A00,092507,Dubnov; Shlomo,10,0,20,10
1650802588007,ECE 45,A01,083139,Staff,0,1,60,60
1650802594034,ECE 65,A50,083695,Staff,0,5,30,30
1650802600058,ECE 109,A01,091882,Touri; Behrouz,32,0,70,38
1650802606095,ECE 180,A00,083140,Abi Samra; Nicholas Camill,20,0,30,10
1650802606095,ECE 180,B00,083141,Abi Samra; Nicholas Camill,0,0,30,30
1650802612133,MATH 10A,A01,083735,Patchell; Gregory David,2,0,30,28
1650802612133,MATH 10A,A02,083736,Patchell; Gregory David,27,0,30,3
1650802612133,MATH 10A,A03,083737,Patchell; Gregory David,24,0,30,6
1650802618157,MATH 10B,A01,083207,Staff,0,9,30,30
1650802618157,MATH 10B,A02,083208,Staff,0,6,30,30
1650802618157,MATH 10B,B01,083739,Staff,11,0,30,19
1650802618157,MATH 10B,B02,083740,Staff,28,0,30,2
1650802624189,MATH 18,A01,083743,Staff,0,0,30,30
1650802624189,MATH 18,A02,083744,Staff,23,0,30,7
1650802624189,MATH 18,A03,083745,Staff,21,0,30,9
1650802624189,MATH 18,A04,083746,Staff,26,0,30,4
1650802624189,MATH 18,B01,083748,Staff,0,15,30,30
1650802624189,MATH 18,B02,083749,Staff,0,12,30,30
1650802624189,MATH 18,B03,083750,Staff,0,12,30,30
1650802624189,MATH 18,B04,083751,Staff,0,12,30,30
1650802630214,MATH 20A,A01,083754,Staff,19,0,40,21
1650802636239,MATH 20B,A01,083756,Staff,0,13,30,30
1650802636239,MATH 20B,A02,083757,Staff,0,12,30,30
1650802642263,MATH 20C,A01,083760,Staff,0,17,30,30
1650802642263,MATH 20C,A02,083761,Staff,0,16,30,30
1650802642263,MATH 20C,B01,083762,Staff,9,0,30,21
1650802642263,MATH 20C,B02,083763,Staff,28,0,30,2
1650802648296,MATH 20D,A01,083765,Staff,2,1,30,28
1650802648296,MATH 20D,A02,083766,Staff,6,0,30,24
1650802648296,MATH 20D,A03,083767,Staff,24,0,30,6
1650802654320,MATH 20E,A01,083771,Staff,2,0,30,28
1650802654320,MATH 20E,A02,083772,Staff,15,0,30,15
1650802654320,MATH 20E,B01,083773,Staff,0,0,30,30
1650802654320,MATH 20E,B02,083774,Staff,5,0,30,25
1650802660346,MATH 103A,A01,083777,Staff,0,16,30,30
1650802660346,MATH 103A,A02,083778,Staff,0,15,30,30
1650802660346,MATH 103A,B01,083779,Staff,0,15,30,30
1650802660346,MATH 103A,B02,083780,Staff,0,15,30,30
1650802666374,MATH 105,A01,085443,Staff,0,22,30,30
1650802672407,MATH 109,A01,083213,Anzaldo; Leesa B,0,7,30,30
1650802672407,MATH 109,A02,083214,Anzaldo; Leesa B,0,7,30,30
1650802672407,MATH 109,B01,083215,Anzaldo; Leesa B,0,8,30,30
1650802672407,MATH 109,B02,083216,Anzaldo; Leesa B,0,7,30,30
1650802678433,MATH 142A,A01,083219,Chow; Bennett,0,16,30,30
1650802678433,MATH 142A,A02,083220,Chow; Bennett,0,15,30,30
1650802678433,MATH 142A,B01,083221,Chow; Bennett,0,16,30,30
1650802678433,MATH 142A,B02,083222,Chow; Bennett,0,14,30,30
1650802684458,MATH 193A,A01,083224,Staff,0,6,30,30
1650802684458,MATH 193A,A02,083225,Staff,0,6,30,30
1650802684458,MATH 193A,A03,083781,Staff,0,6,30,30
1650802684458,MATH 193A,A04,083782,Staff,0,7,30,30
1650802690486,MATH 197,001,091859,McAuley; Julian John,9998,0,9999,1
1650802696554,COGS 9,A01,083615,Staff,0,17,60,60
1650802702579,COGS 11,A01,083617,Boyle; Mary E. T.,16,0,40,24
1650802708608,COGS 13,A01,083071,Staff,0,38,40,40
1650802714631,COGS 14A,A01,092681,Staff,0,36,100,100
1650802720656,COGS 14B,A01,083073,Cheng; Tzu-Han,0,12,50,50
1650802726679,COGS 17,A01,092677,Staff,11,0,75,64
1650802732706,COGS 100,A01,083619,Staff,0,29,60,60
1650802738735,COGS 101A,A01,083621,Davis; Joshua Daniel,0,28,60,60
1650802744762,COGS 101B,A01,091572,Staff,0,3,60,60
1650802750789,COGS 101C,A01,083625,Delgado; Tania,14,0,30,16
1650802756817,COGS 107A,A01,083627,Boyle; Mary E. T.,0,16,60,60
1650802762841,COGS 118A,A01,083075,Staff,0,8,60,60
1650802768865,CSE 3,A50,083646,Miranda; Gregory Joseph,18,0,38,20
1650802768865,CSE 3,A51,083647,Miranda; Gregory Joseph,36,0,37,1
1650802774893,CSE 8A,A50,083650,Miranda; Gregory Joseph,0,29,40,40
1650802780919,CSE 11,A01,083080,Cao; Yingjun,0,96,40,40
1650802786949,CSE 12,A01,083652,Staff,0,21,100,100
1650802792974,CSE 15L,A01,083654,Staff,0,3,50,50
1650802792974,CSE 15L,A02,083655,Staff,0,2,50,50
1650802799000,CSE 20,A01,083657,Staff,49,0,80,31
1650802805027,CSE 30,A01,083084,Eldon; John,0,75,40,40
1650802811053,CSE 100,A01,083659,Cao; Yingjun,0,71,50,50
1650802817077,CSE 134B,A01,083661,Powell; Thomas Allan,0,38,65,65
1650802823103,CSE 140,A01,083663,Staff,0,11,75,75
1650802829126,CSE 140L,A01,083088,Eldon; John,0,20,75,75
1650802835151,CSE 175,A01,083665,Kumar; Rakesh,7,0,25,18
1650802841175,CSE 190,A00,092507,Dubnov; Shlomo,10,0,20,10
1650802847202,ECE 45,A01,083139,Staff,0,1,60,60
1650802853226,ECE 65,A50,083695,Staff,0,5,30,30
1650802859254,ECE 109,A01,091882,Touri; Behrouz,32,0,70,38
1650802865282,ECE 180,A00,083140,Abi Samra; Nicholas Camill,20,0,30,10
1650802865282,ECE 180,B00,083141,Abi Samra; Nicholas Camill,0,0,30,30
1650802871307,MATH 10A,A01,083735,Patchell; Gregory David,2,0,30,28
1650802871307,MATH 10A,A02,083736,Patchell; Gregory David,27,0,30,3
1650802871307,MATH 10A,A03,083737,Patchell; Gregory David,24,0,30,6
1650802877337,MATH 10B,A01,083207,Staff,0,9,30,30
1650802877337,MATH 10B,A02,083208,Staff,0,6,30,30
1650802877337,MATH 10B,B01,083739,Staff,11,0,30,19
1650802877337,MATH 10B,B02,083740,Staff,28,0,30,2
1650802883361,MATH 18,A01,083743,Staff,0,0,30,30
1650802883361,MATH 18,A02,083744,Staff,23,0,30,7
1650802883361,MATH 18,A03,083745,Staff,21,0,30,9
1650802883361,MATH 18,A04,083746,Staff,26,0,30,4
1650802883361,MATH 18,B01,083748,Staff,0,15,30,30
1650802883361,MATH 18,B02,083749,Staff,0,12,30,30
1650802883361,MATH 18,B03,083750,Staff,0,12,30,30
1650802883361,MATH 18,B04,083751,Staff,0,12,30,30
1650802889385,MATH 20A,A01,083754,Staff,19,0,40,21
1650802895410,MATH 20B,A01,083756,Staff,0,13,30,30
1650802895410,MATH 20B,A02,083757,Staff,0,12,30,30
1650802901438,MATH 20C,A01,083760,Staff,0,17,30,30
1650802901438,MATH 20C,A02,083761,Staff,0,16,30,30
1650802901438,MATH 20C,B01,083762,Staff,9,0,30,21
1650802901438,MATH 20C,B02,083763,Staff,28,0,30,2
1650802907465,MATH 20D,A01,083765,Staff,2,1,30,28
1650802907465,MATH 20D,A02,083766,Staff,6,0,30,24
1650802907465,MATH 20D,A03,083767,Staff,24,0,30,6
1650802913488,MATH 20E,A01,083771,Staff,2,0,30,28
1650802913488,MATH 20E,A02,083772,Staff,15,0,30,15
1650802913488,MATH 20E,B01,083773,Staff,0,0,30,30
1650802913488,MATH 20E,B02,083774,Staff,5,0,30,25
1650802919525,MATH 103A,A01,083777,Staff,0,16,30,30
1650802919525,MATH 103A,A02,083778,Staff,0,15,30,30
1650802919525,MATH 103A,B01,083779,Staff,0,15,30,30
1650802919525,MATH 103A,B02,083780,Staff,0,15,30,30
1650802925551,MATH 105,A01,085443,Staff,0,22,30,30
1650802931578,MATH 109,A01,083213,Anzaldo; Leesa B,0,7,30,30
1650802931578,MATH 109,A02,083214,Anzaldo; Leesa B,0,7,30,30
1650802931578,MATH 109,B01,083215,Anzaldo; Leesa B,0,8,30,30
1650802931578,MATH 109,B02,083216,Anzaldo; Leesa B,0,7,30,30
1650802937617,MATH 142A,A01,083219,Chow; Bennett,0,16,30,30
1650802937617,MATH 142A,A02,083220,Chow; Bennett,0,15,30,30
1650802937617,MATH 142A,B01,083221,Chow; Bennett,0,16,30,30
1650802937617,MATH 142A,B02,083222,Chow; Bennett,0,14,30,30
1650802943642,MATH 193A,A01,083224,Staff,0,6,30,30
1650802943642,MATH 193A,A02,083225,Staff,0,6,30,30
1650802943642,MATH 193A,A03,083781,Staff,0,6,30,30
1650802943642,MATH 193A,A04,083782,Staff,0,7,30,30
1650802949669,MATH 197,001,091859,McAuley; Julian John,9998,0,9999,1
1650802955815,COGS 9,A01,083615,Staff,0,17,60,60
1650802961840,COGS 11,A01,083617,Boyle; Mary E. T.,16,0,40,24
1650802967864,COGS 13,A01,083071,Staff,0,38,40,40
1650802973888,COGS 14A,A01,092681,Staff,0,36,100,100
1650802979916,COGS 14B,A01,083073,Cheng; Tzu-Han,0,12,50,50
1650802985940,COGS 17,A01,092677,Staff,11,0,75,64
1650802991964,COGS 100,A01,083619,Staff,0,29,60,60
1650802997989,COGS 101A,A01,083621,Davis; Joshua Daniel,0,28,60,60
1650803004015,COGS 101B,A01,091572,Staff,0,3,60,60
1650803010041,COGS 101C,A01,083625,Delgado; Tania,14,0,30,16
1650803016065,COGS 107A,A01,083627,Boyle; Mary E. T.,0,16,60,60
1650803022089,COGS 118A,A01,083075,Staff,0,8,60,60
1650803028116,CSE 3,A50,083646,Miranda; Gregory Joseph,18,0,38,20
1650803028116,CSE 3,A51,083647,Miranda; Gregory Joseph,36,0,37,1
1650803034143,CSE 8A,A50,083650,Miranda; Gregory Joseph,0,29,40,40
1650803040174,CSE 11,A01,083080,Cao; Yingjun,0,96,40,40
1650803046199,CSE 12,A01,083652,Staff,0,21,100,100
1650803052224,CSE 15L,A01,083654,Staff,0,3,50,50
1650803052224,CSE 15L,A02,083655,Staff,0,2,50,50
1650803058251,CSE 20,A01,083657,Staff,49,0,80,31
1650803064277,CSE 30,A01,083084,Eldon; John,0,75,40,40
1650803070304,CSE 100,A01,083659,Cao; Yingjun,0,71,50,50
1650803076329,CSE 134B,A01,083661,Powell; Thomas Allan,0,38,65,65
1650803082355,CSE 140,A01,083663,Staff,0,11,75,75
1650803088379,CSE 140L,A01,083088,Eldon; John,0,20,75,75
1650803094403,CSE 175,A01,083665,Kumar; Rakesh,7,0,25,18
1650803100430,CSE 190,A00,092507,Dubnov; Shlomo,10,0,20,10
1650803106455,ECE 45,A01,083139,Staff,0,1,60,60
1650803112479,ECE 65,A50,083695,Staff,0,5,30,30
1650803118504,ECE 109,A01,091882,Touri; Behrouz,32,0,70,38
1650803124528,ECE 180,A00,083140,Abi Samra; Nicholas Camill,20,0,30,10
1650803124528,ECE 180,B00,083141,Abi Samra; Nicholas Camill,0,0,30,30
1650803130553,MATH 10A,A01,083735,Patchell; Gregory David,2,0,30,28
1650803130553,MATH 10A,A02,083736,Patchell; Gregory David,27,0,30,3
1650803130553,MATH 10A,A03,083737,Patchell; Gregory David,24,0,30,6
1650803136581,MATH 10B,A01,083207,Staff,0,9,30,30
1650803136581,MATH 10B,A02,083208,Staff,0,6,30,30
1650803136581,MATH 10B,B01,083739,Staff,11,0,30,19
1650803136581,MATH 10B,B02,083740,Staff,28,0,30,2
1650803142620,MATH 18,A01,083743,Staff,0,0,30,30
1650803142620,MATH 18,A02,083744,Staff,23,0,30,7
1650803142620,MATH 18,A03,083745,Staff,21,0,30,9
1650803142620,MATH 18,A04,083746,Staff,26,0,30,4
1650803142620,MATH 18,B01,083748,Staff,0,15,30,30
1650803142620,MATH 18,B02,083749,Staff,0,12,30,30
1650803142620,MATH 18,B03,083750,Staff,0,12,30,30
1650803142620,MATH 18,B04,083751,Staff,0,12,30,30
1650803148643,MATH 20A,A01,083754,Staff,19,0,40,21
1650803154668,MATH 20B,A01,083756,Staff,0,13,30,30
1650803154668,MATH 20B,A02,083757,Staff,0,12,30,30
1650803160693,MATH 20C,A01,083760,Staff,0,17,30,30
1650803160693,MATH 20C,A02,083761,Staff,0,16,30,30
1650803160693,MATH 20C,B01,083762,Staff,9,0,30,21
1650803160693,MATH 20C,B02,083763,Staff,28,0,30,2
1650803166718,MATH 20D,A01,083765,Staff,2,1,30,28
1650803166718,MATH 20D,A02,083766,Staff,6,0,30,24
1650803166718,MATH 20D,A03,083767,Staff,24,0,30,6
1650803172745,MATH 20E,A01,083771,Staff,2,0,30,28
1650803172745,MATH 20E,A02,083772,Staff,15,0,30,15
1650803172745,MATH 20E,B01,083773,Staff,0,0,30,30
1650803172745,MATH 20E,B02,083774,Staff,5,0,30,25
1650803178769,MATH 103A,A01,083777,Staff,0,16,30,30
1650803178769,MATH 103A,A02,083778,Staff,0,15,30,30
1650803178769,MATH 103A,B01,083779,Staff,0,15,30,30
1650803178769,MATH 103A,B02,083780,Staff,0,15,30,30
1650803184797,MATH 105,A01,085443,Staff,0,22,30,30
1650803190827,MATH 109,A01,083213,Anzaldo; Leesa B,0,7,30,30
1650803190827,MATH 109,A02,083214,Anzaldo; Leesa B,0,7,30,30
1650803190827,MATH 109,B01,083215,Anzaldo; Leesa B,0,8,30,30
1650803190827,MATH 109,B02,083216,Anzaldo; Leesa B,0,7,30,30
1650803196850,MATH 142A,A01,083219,Chow; Bennett,0,16,30,30
1650803196850,MATH 142A,A02,083220,Chow; Bennett,0,15,30,30
1650803196850,MATH 142A,B01,083221,Chow; Bennett,0,16,30,30
1650803196850,MATH 142A,B02,083222,Chow; Bennett,0,14,30,30
1650803202884,MATH 193A,A01,083224,Staff,0,6,30,30
1650803202884,MATH 193A,A02,083225,Staff,0,6,30,30
1650803202884,MATH 193A,A03,083781,Staff,0,6,30,30
1650803202884,MATH 193A,A04,083782,Staff,0,7,30,30
1650803208911,MATH 197,001,091859,McAuley; Julian John,9998,0,9999,1
1650803214977,COGS 9,A01,083615,Staff,0,17,60,60
1650803221005,COGS 11,A01,083617,Boyle; Mary E. T.,16,0,40,24
1650803227029,COGS 13,A01,083071,Staff,0,38,40,40
1650803233054,COGS 14A,A01,092681,Staff,0,36,100,100
1650803239082,COGS 14B,A01,083073,Cheng; Tzu-Han,0,12,50,50
1650803245103,COGS 17,A01,092677,Staff,11,0,75,64
1650803251129,COGS 100,A01,083619,Staff,0,29,60,60
1650803257164,COGS 101A,A01,083621,Davis; Joshua Daniel,0,28,60,60
1650803263188,COGS 101B,A01,091572,Staff,0,3,60,60
1650803269216,COGS 101C,A01,083625,Delgado; Tania,14,0,30,16
1650803275252,COGS 107A,A01,083627,Boyle; Mary E. T.,0,16,60,60
1650803281277,COGS 118A,A01,083075,Staff,0,8,60,60
1650803287302,CSE 3,A50,083646,Miranda; Gregory Joseph,18,0,38,20
1650803287302,CSE 3,A51,083647,Miranda; Gregory Joseph,36,0,37,1
1650803293332,CSE 8A,A50,083650,Miranda; Gregory Joseph,0,29,40,40
1650803299357,CSE 11,A01,083080,Cao; Yingjun,0,96,40,40
1650803305385,CSE 12,A01,083652,Staff,0,21,100,100
1650803311410,CSE 15L,A01,083654,Staff,0,3,50,50
1650803311410,CSE 15L,A02,083655,Staff,0,2,50,50
1650803317436,CSE 20,A01,083657,Staff,49,0,80,31
1650803323463,CSE 30,A01,083084,Eldon; John,0,75,40,40
1650803329488,CSE 100,A01,083659,Cao; Yingjun,0,71,50,50
1650803335514,CSE 134B,A01,083661,Powell; Thomas Allan,0,38,65,65
1650803341542,CSE 140,A01,083663,Staff,0,11,75,75
1650803347570,CSE 140L,A01,083088,Eldon; John,0,20,75,75
1650803353595,CSE 175,A01,083665,Kumar; Rakesh,7,0,25,18
1650803359621,CSE 190,A00,092507,Dubnov; Shlomo,10,0,20,10
1650803365644,ECE 45,A01,083139,Staff,0,1,60,60
1650803371667,ECE 65,A50,083695,Staff,0,5,30,30
1650803377690,ECE 109,A01,091882,Touri; Behrouz,32,0,70,38
1650803383714,ECE 180,A00,083140,Abi Samra; Nicholas Camill,20,0,30,10
1650803383714,ECE 180,B00,083141,Abi Samra; Nicholas Camill,0,0,30,30
1650803389743,MATH 10A,A01,083735,Patchell; Gregory David,2,0,30,28
1650803389743,MATH 10A,A02,083736,Patchell; Gregory David,27,0,30,3
1650803389743,MATH 10A,A03,083737,Patchell; Gregory David,24,0,30,6
1650803395773,MATH 10B,A01,083207,Staff,0,9,30,30
1650803395773,MATH 10B,A02,083208,Staff,0,6,30,30
1650803395773,MATH 10B,B01,083739,Staff,11,0,30,19
1650803395773,MATH 10B,B02,083740,Staff,28,0,30,2
1650803401812,MATH 18,A01,083743,Staff,0,0,30,30
1650803401812,MATH 18,A02,083744,Staff,23,0,30,7
1650803401812,MATH 18,A03,083745,Staff,21,0,30,9
1650803401812,MATH 18,A04,083746,Staff,26,0,30,4
1650803401812,MATH 18,B01,083748,Staff,0,15,30,30
1650803401812,MATH 18,B02,083749,Staff,0,12,30,30
1650803401812,MATH 18,B03,083750,Staff,0,12,30,30
1650803401812,MATH 18,B04,083751,Staff,0,12,30,30
1650803407840,MATH 20A,A01,083754,Staff,19,0,40,21
1650803413867,MATH 20B,A01,083756,Staff,0,13,30,30
1650803413867,MATH 20B,A02,083757,Staff,0,12,30,30
1650803419906,MATH 20C,A01,083760,Staff,0,17,30,30
1650803419906,MATH 20C,A02,083761,Staff,0,16,30,30
1650803419906,MATH 20C,B01,083762,Staff,9,0,30,21
1650803419906,MATH 20C,B02,083763,Staff,28,0,30,2
1650803425936,MATH 20D,A01,083765,Staff,2,1,30,28
1650803425936,MATH 20D,A02,083766,Staff,6,0,30,24
1650803425936,MATH 20D,A03,083767,Staff,24,0,30,6
1650803431964,MATH 20E,A01,083771,Staff,2,0,30,28
1650803431964,MATH 20E,A02,083772,Staff,15,0,30,15
1650803431964,MATH 20E,B01,083773,Staff,0,0,30,30
1650803431964,MATH 20E,B02,083774,Staff,5,0,30,25
1650803437989,MATH 103A,A01,083777,Staff,0,16,30,30
1650803437989,MATH 103A,A02,083778,Staff,0,15,30,30
1650803437989,MATH 103A,B01,083779,Staff,0,15,30,30
1650803437989,MATH 103A,B02,083780,Staff,0,15,30,30
1650803444016,MATH 105,A01,085443,Staff,0,22,30,30
1650803450040,MATH 109,A01,083213,Anzaldo; Leesa B,0,7,30,30
1650803450040,MATH 109,A02,083214,Anzaldo; Leesa B,0,7,30,30
1650803450040,MATH 109,B01,083215,Anzaldo; Leesa B,0,8,30,30
1650803450040,MATH 109,B02,083216,Anzaldo; Leesa B,0,7,30,30
1650803456065,MATH 142A,A01,083219,Chow; Bennett,0,16,30,30
1650803456065,MATH 142A,A02,083220,Chow; Bennett,0,15,30,30
1650803456065,MATH 142A,B01,083221,Chow; Bennett,0,16,30,30
1650803456065,MATH 142A,B02,083222,Chow; Bennett,0,14,30,30
1650803462092,MATH 193A,A01,083224,Staff,0,6,30,30
1650803462092,MATH 193A,A02,083225,Staff,0,6,30,30
1650803462092,MATH 193A,A03,083781,Staff,0,6,30,30
1650803462092,MATH 193A,A04,083782,Staff,0,7,30,30
1650803468116,MATH 197,001,091859,McAuley; Julian John,9998,0,9999,1
1650803474184,COGS 9,A01,083615,Staff,0,17,60,60
1650803480206,COGS 11,A01,083617,Boyle; Mary E. T.,16,0,40,24
1650803486236,COGS 13,A01,083071,Staff,0,38,40,40
1650803492264,COGS 14A,A01,092681,Staff,0,36,100,100
1650803498288,COGS 14B,A01,083073,Cheng; Tzu-Han,0,12,50,50
1650803504312,COGS 17,A01,092677,Staff,11,0,75,64
1650803510336,COGS 100,A01,083619,Staff,0,29,60,60
1650803516364,COGS 101A,A01,083621,Davis; Joshua Daniel,0,28,60,60
1650803522389,COGS 101B,A01,091572,Staff,0,3,60,60
1650803528412,COGS 101C,A01,083625,Delgado; Tania,14,0,30,16
1650803534435,COGS 107A,A01,083627,Boyle; Mary E. T.,0,16,60,60
1650803540457,COGS 118A,A01,083075,Staff,0,8,60,60
1650803546589,CSE 3,A50,083646,Miranda; Gregory Joseph,18,0,38,20
1650803546589,CSE 3,A51,083647,Miranda; Gregory Joseph,36,0,37,1
1650803552612,CSE 8A,A50,083650,Miranda; Gregory Joseph,0,29,40,40
1650803558639,CSE 11,A01,083080,Cao; Yingjun,0,96,40,40
1650803564663,CSE 12,A01,083652,Staff,0,21,100,100
1650803570690,CSE 15L,A01,083654,Staff,0,3,50,50
1650803570690,CSE 15L,A02,083655,Staff,0,2,50,50
1650803576715,CSE 20,A01,083657,Staff,49,0,80,31
1650803582742,CSE 30,A01,083084,Eldon; John,0,75,40,40
1650803588766,CSE 100,A01,083659,Cao; Yingjun,0,71,50,50
1650803594792,CSE 134B,A01,083661,Powell; Thomas Allan,0,38,65,65
1650803600820,CSE 140,A01,083663,Staff,0,11,75,75
1650803606854,CSE 140L,A01,083088,Eldon; John,0,20,75,75
1650803612877,CSE 175,A01,083665,Kumar; Rakesh,7,0,25,18
1650803618901,CSE 190,A00,092507,Dubnov; Shlomo,10,0,20,10
1650803624928,ECE 45,A01,083139,Staff,0,1,60,60
1650803630952,ECE 65,A50,083695,Staff,0,5,30,30
1650803636980,ECE 109,A01,091882,Touri; Behrouz,32,0,70,38
1650803643008,ECE 180,A00,083140,Abi Samra; Nicholas Camill,20,0,30,10
1650803643008,ECE 180,B00,083141,Abi Samra; Nicholas Camill,0,0,30,30
1650803649031,MATH 10A,A01,083735,Patchell; Gregory David,2,0,30,28
1650803649031,MATH 10A,A02,083736,Patchell; Gregory David,27,0,30,3
1650803649031,MATH 10A,A03,083737,Patchell; Gregory David,24,0,30,6
1650803655069,MATH 10B,A01,083207,Staff,0,9,30,30
1650803655069,MATH 10B,A02,083208,Staff,0,6,30,30
1650803655069,MATH 10B,B01,083739,Staff,11,0,30,19
1650803655069,MATH 10B,B02,083740,Staff,28,0,30,2
1650803661094,MATH 18,A01,083743,Staff,0,0,30,30
1650803661094,MATH 18,A02,083744,Staff,23,0,30,7
1650803661094,MATH 18,A03,083745,Staff,21,0,30,9
1650803661094,MATH 18,A04,083746,Staff,26,0,30,4
1650803661094,MATH 18,B01,083748,Staff,0,15,30,30
1650803661094,MATH 18,B02,083749,Staff,0,12,30,30
1650803661094,MATH 18,B03,083750,Staff,0,12,30,30
1650803661094,MATH 18,B04,083751,Staff,0,12,30,30
1650803667118,MATH 20A,A01,083754,Staff,19,0,40,21
1650803673146,MATH 20B,A01,083756,Staff,0,13,30,30
1650803673146,MATH 20B,A02,083757,Staff,0,12,30,30
1650803679175,MATH 20C,A01,083760,Staff,0,17,30,30
1650803679175,MATH 20C,A02,083761,Staff,0,16,30,30
1650803679175,MATH 20C,B01,083762,Staff,9,0,30,21
1650803679175,MATH 20C,B02,083763,Staff,28,0,30,2
1650803685202,MATH 20D,A01,083765,Staff,2,1,30,28
1650803685202,MATH 20D,A02,083766,Staff,6,0,30,24
1650803685202,MATH 20D,A03,083767,Staff,24,0,30,6
1650803691233,MATH 20E,A01,083771,Staff,2,0,30,28
1650803691233,MATH 20E,A02,083772,Staff,15,0,30,15
1650803691233,MATH 20E,B01,083773,Staff,0,0,30,30
1650803691233,MATH 20E,B02,083774,Staff,5,0,30,25
1650803697257,MATH 103A,A01,083777,Staff,0,16,30,30
1650803697257,MATH 103A,A02,083778,Staff,0,15,30,30
1650803697257,MATH 103A,B01,083779,Staff,0,15,30,30
1650803697257,MATH 103A,B02,083780,Staff,0,15,30,30
1650803703284,MATH 105,A01,085443,Staff,0,22,30,30
1650803709307,MATH 109,A01,083213,Anzaldo; Leesa B,0,7,30,30
1650803709307,MATH 109,A02,083214,Anzaldo; Leesa B,0,7,30,30
1650803709307,MATH 109,B01,083215,Anzaldo; Leesa B,0,8,30,30
1650803709307,MATH 109,B02,083216,Anzaldo; Leesa B,0,7,30,30
1650803715333,MATH 142A,A01,083219,Chow; Bennett,0,16,30,30
1650803715333,MATH 142A,A02,083220,Chow; Bennett,0,15,30,30
1650803715333,MATH 142A,B01,083221,Chow; Bennett,0,16,30,30
1650803715333,MATH 142A,B02,083222,Chow; Bennett,0,14,30,30
1650803721361,MATH 193A,A01,083224,Staff,0,6,30,30
1650803721361,MATH 193A,A02,083225,Staff,0,6,30,30
1650803721361,MATH 193A,A03,083781,Staff,0,6,30,30
1650803721361,MATH 193A,A04,083782,Staff,0,7,30,30
1650803727386,MATH 197,001,091859,McAuley; Julian John,9998,0,9999,1
1650803733442,COGS 9,A01,083615,Staff,0,17,60,60
1650803739467,COGS 11,A01,083617,Boyle; Mary E. T.,16,0,40,24
1650803745490,COGS 13,A01,083071,Staff,0,38,40,40
1650803751519,COGS 14A,A01,092681,Staff,0,36,100,100
1650803757544,COGS 14B,A01,083073,Cheng; Tzu-Han,0,12,50,50
1650803763571,COGS 17,A01,092677,Staff,11,0,75,64
1650803769595,COGS 100,A01,083619,Staff,0,29,60,60
1650803775624,COGS 101A,A01,083621,Davis; Joshua Daniel,0,28,60,60
1650803781652,COGS 101B,A01,091572,Staff,0,3,60,60
1650803787675,COGS 101C,A01,083625,Delgado; Tania,14,0,30,16
1650803793704,COGS 107A,A01,083627,Boyle; Mary E. T.,0,16,60,60
1650803799726,COGS 118A,A01,083075,Staff,0,8,60,60
1650803805751,CSE 3,A50,083646,Miranda; Gregory Joseph,18,0,38,20
1650803805751,CSE 3,A51,083647,Miranda; Gregory Joseph,36,0,37,1
1650803811776,CSE 8A,A50,083650,Miranda; Gregory Joseph,0,29,40,40
1650803817803,CSE 11,A01,083080,Cao; Yingjun,0,96,40,40
1650803823828,CSE 12,A01,083652,Staff,0,21,100,100
1650803829850,CSE 15L,A01,083654,Staff,0,3,50,50
1650803829850,CSE 15L,A02,083655,Staff,0,2,50,50
1650803835874,CSE 20,A01,083657,Staff,49,0,80,31
1650803841902,CSE 30,A01,083084,Eldon; John,0,75,40,40
1650803847932,CSE 100,A01,083659,Cao; Yingjun,0,71,50,50
1650803853960,CSE 134B,A01,083661,Powell; Thomas Allan,0,38,65,65
1650803859983,CSE 140,A01,083663,Staff,0,11,75,75
1650803866011,CSE 140L,A01,083088,Eldon; John,0,20,75,75
1650803872036,CSE 175,A01,083665,Kumar; Rakesh,7,0,25,18
1650803878063,CSE 190,A00,092507,Dubnov; Shlomo,10,0,20,10
1650803884089,ECE 45,A01,083139,Staff,0,1,60,60
1650803890115,ECE 65,A50,083695,Staff,0,5,30,30
1650803896143,ECE 109,A01,091882,Touri; Behrouz,32,0,70,38
1650803902171,ECE 180,A00,083140,Abi Samra; Nicholas Camill,20,0,30,10
1650803902171,ECE 180,B00,083141,Abi Samra; Nicholas Camill,0,0,30,30
1650803908194,MATH 10A,A01,083735,Patchell; Gregory David,2,0,30,28
1650803908194,MATH 10A,A02,083736,Patchell; Gregory David,27,0,30,3
1650803908194,MATH 10A,A03,083737,Patchell; Gregory David,24,0,30,6
1650803914220,MATH 10B,A01,083207,Staff,0,9,30,30
1650803914220,MATH 10B,A02,083208,Staff,0,6,30,30
1650803914220,MATH 10B,B01,083739,Staff,11,0,30,19
1650803914220,MATH 10B,B02,083740,Staff,28,0,30,2
1650803920249,MATH 18,A01,083743,Staff,0,0,30,30
1650803920249,MATH 18,A02,083744,Staff,23,0,30,7
1650803920249,MATH 18,A03,083745,Staff,21,0,30,9
1650803920249,MATH 18,A04,083746,Staff,26,0,30,4
1650803920249,MATH 18,B01,083748,Staff,0,15,30,30
1650803920249,MATH 18,B02,083749,Staff,0,12,30,30
1650803920249,MATH 18,B03,083750,Staff,0,12,30,30
1650803920249,MATH 18,B04,083751,Staff,0,12,30,30
1650803926275,MATH 20A,A01,083754,Staff,19,0,40,21
1650803932299,MATH 20B,A01,083756,Staff,0,13,30,30
1650803932299,MATH 20B,A02,083757,Staff,0,12,30,30
1650803938328,MATH 20C,A01,083760,Staff,0,17,30,30
1650803938328,MATH 20C,A02,083761,Staff,0,16,30,30
1650803938328,MATH 20C,B01,083762,Staff,9,0,30,21
1650803938328,MATH 20C,B02,083763,Staff,28,0,30,2
1650803944358,MATH 20D,A01,083765,Staff,2,1,30,28
1650803944358,MATH 20D,A02,083766,Staff,6,0,30,24
1650803944358,MATH 20D,A03,083767,Staff,24,0,30,6
1650803950383,MATH 20E,A01,083771,Staff,2,0,30,28
1650803950383,MATH 20E,A02,083772,Staff,15,0,30,15
1650803950383,MATH 20E,B01,083773,Staff,0,0,30,30
1650803950383,MATH 20E,B02,083774,Staff,5,0,30,25
1650803956412,MATH 103A,A01,083777,Staff,0,16,30,30
1650803956412,MATH 103A,A02,083778,Staff,0,15,30,30
1650803956412,MATH 103A,B01,083779,Staff,0,15,30,30
1650803956412,MATH 103A,B02,083780,Staff,0,15,30,30
1650803962439,MATH 105,A01,085443,Staff,0,22,30,30
1650803968465,MATH 109,A01,083213,Anzaldo; Leesa B,0,7,30,30
1650803968465,MATH 109,A02,083214,Anzaldo; Leesa B,0,7,30,30
1650803968465,MATH 109,B01,083215,Anzaldo; Leesa B,0,8,30,30
1650803968465,MATH 109,B02,083216,Anzaldo; Leesa B,0,7,30,30
1650803974492,MATH 142A,A01,083219,Chow; Bennett,0,16,30,30
1650803974492,MATH 142A,A02,083220,Chow; Bennett,0,15,30,30
1650803974492,MATH 142A,B01,083221,Chow; Bennett,0,16,30,30
1650803974492,MATH 142A,B02,083222,Chow; Bennett,0,14,30,30
1650803980517,MATH 193A,A01,083224,Staff,0,6,30,30
1650803980517,MATH 193A,A02,083225,Staff,0,6,30,30
1650803980517,MATH 193A,A03,083781,Staff,0,6,30,30
1650803980517,MATH 193A,A04,083782,Staff,0,7,30,30
1650803986545,MATH 197,001,091859,McAuley; Julian John,9998,0,9999,1
1650803992601,COGS 9,A01,083615,Staff,0,17,60,60
1650803998625,COGS 11,A01,083617,Boyle; Mary E. T.,16,0,40,24
1650804004648,COGS 13,A01,083071,Staff,0,38,40,40
1650804010677,COGS 14A,A01,092681,Staff,0,36,100,100
1650804016703,COGS 14B,A01,083073,Cheng; Tzu-Han,0,12,50,50
1650804022728,COGS 17,A01,092677,Staff,11,0,75,64
1650804028758,COGS 100,A01,083619,Staff,0,29,60,60
1650804034780,COGS 101A,A01,083621,Davis; Joshua Daniel,0,28,60,60
1650804040806,COGS 101B,A01,091572,Staff,0,3,60,60
1650804046834,COGS 101C,A01,083625,Delgado; Tania,14,0,30,16
1650804052862,COGS 107A,A01,083627,Boyle; Mary E. T.,0,16,60,60
1650804058885,COGS 118A,A01,083075,Staff,0,8,60,60
1650804064910,CSE 3,A50,083646,Miranda; Gregory Joseph,18,0,38,20
1650804064910,CSE 3,A51,083647,Miranda; Gregory Joseph,36,0,37,1
1650804070939,CSE 8A,A50,083650,Miranda; Gregory Joseph,0,29,40,40
1650804076967,CSE 11,A01,083080,Cao; Yingjun,0,96,40,40
1650804082990,CSE 12,A01,083652,Staff,0,21,100,100
1650804089015,CSE 15L,A01,083654,Staff,0,3,50,50
1650804089015,CSE 15L,A02,083655,Staff,0,2,50,50
1650804095040,CSE 20,A01,083657,Staff,49,0,80,31
1650804101068,CSE 30,A01,083084,Eldon; John,0,75,40,40
1650804107092,CSE 100,A01,083659,Cao; Yingjun,0,71,50,50
1650804113119,CSE 134B,A01,083661,Powell; Thomas Allan,0,38,65,65
1650804119144,CSE 140,A01,083663,Staff,0,11,75,75
1650804125167,CSE 140L,A01,083088,Eldon; John,0,20,75,75
1650804131191,CSE 175,A01,083665,Kumar; Rakesh,7,0,25,18
1650804137217,CSE 190,A00,092507,Dubnov; Shlomo,10,0,20,10
1650804143334,ECE 45,A01,083139,Staff,0,1,60,60
1650804149360,ECE 65,A50,083695,Staff,0,5,30,30
1650804155383,ECE 109,A01,091882,Touri; Behrouz,32,0,70,38
1650804161406,ECE 180,A00,083140,Abi Samra; Nicholas Camill,20,0,30,10
1650804161406,ECE 180,B00,083141,Abi Samra; Nicholas Camill,0,0,30,30
1650804167429,MATH 10A,A01,083735,Patchell; Gregory David,2,0,30,28
1650804167429,MATH 10A,A02,083736,Patchell; Gregory David,27,0,30,3
1650804167429,MATH 10A,A03,083737,Patchell; Gregory David,24,0,30,6
1650804173454,MATH 10B,A01,083207,Staff,0,9,30,30
1650804173454,MATH 10B,A02,083208,Staff,0,6,30,30
1650804173454,MATH 10B,B01,083739,Staff,11,0,30,19
1650804173454,MATH 10B,B02,083740,Staff,28,0,30,2
1650804179477,MATH 18,A01,083743,Staff,0,0,30,30
1650804179477,MATH 18,A02,083744,Staff,23,0,30,7
1650804179477,MATH 18,A03,083745,Staff,21,0,30,9
1650804179477,MATH 18,A04,083746,Staff,26,0,30,4
1650804179477,MATH 18,B01,083748,Staff,0,15,30,30
1650804179477,MATH 18,B02,083749,Staff,0,12,30,30
1650804179477,MATH 18,B03,083750,Staff,0,12,30,30
1650804179477,MATH 18,B04,083751,Staff,0,12,30,30
1650804185499,MATH 20A,A01,083754,Staff,19,0,40,21
1650804191525,MATH 20B,A01,083756,Staff,0,13,30,30
1650804191525,MATH 20B,A02,083757,Staff,0,12,30,30
1650804197551,MATH 20C,A01,083760,Staff,0,17,30,30
1650804197551,MATH 20C,A02,083761,Staff,0,16,30,30
1650804197551,MATH 20C,B01,083762,Staff,9,0,30,21
1650804197551,MATH 20C,B02,083763,Staff,28,0,30,2
1650804203574,MATH 20D,A01,083765,Staff,2,1,30,28
1650804203574,MATH 20D,A02,083766,Staff,6,0,30,24
1650804203574,MATH 20D,A03,083767,Staff,24,0,30,6
1650804209603,MATH 20E,A01,083771,Staff,2,0,30,28
1650804209603,MATH 20E,A02,083772,Staff,15,0,30,15
1650804209603,MATH 20E,B01,083773,Staff,0,0,30,30
1650804209603,MATH 20E,B02,083774,Staff,5,0,30,25
1650804215631,MATH 103A,A01,083777,Staff,0,16,30,30
1650804215631,MATH 103A,A02,083778,Staff,0,15,30,30
1650804215631,MATH 103A,B01,083779,Staff,0,15,30,30
1650804215631,MATH 103A,B02,083780,Staff,0,15,30,30
1650804221653,MATH 105,A01,085443,Staff,0,22,30,30
1650804227676,MATH 109,A01,083213,Anzaldo; Leesa B,0,7,30,30
1650804227676,MATH 109,A02,083214,Anzaldo; Leesa B,0,7,30,30
1650804227676,MATH 109,B01,083215,Anzaldo; Leesa B,0,8,30,30
1650804227676,MATH 109,B02,083216,Anzaldo; Leesa B,0,7,30,30
1650804233701,MATH 142A,A01,083219,Chow; Bennett,0,16,30,30
1650804233701,MATH 142A,A02,083220,Chow; Bennett,0,15,30,30
1650804233701,MATH 142A,B01,083221,Chow; Bennett,0,16,30,30
1650804233701,MATH 142A,B02,083222,Chow; Bennett,0,14,30,30
1650804239726,MATH 193A,A01,083224,Staff,0,6,30,30
1650804239726,MATH 193A,A02,083225,Staff,0,6,30,30
1650804239726,MATH 193A,A03,083781,Staff,0,6,30,30
1650804239726,MATH 193A,A04,083782,Staff,0,7,30,30
1650804245750,MATH 197,001,091859,McAuley; Julian John,9998,0,9999,1
1650804251808,COGS 9,A01,083615,Staff,0,17,60,60
1650804257836,COGS 11,A01,083617,Boyle; Mary E. T.,16,0,40,24
1650804263863,COGS 13,A01,083071,Staff,0,38,40,40
1650804269890,COGS 14A,A01,092681,Staff,0,36,100,100
1650804275918,COGS 14B,A01,083073,Cheng; Tzu-Han,0,12,50,50
1650804281943,COGS 17,A01,092677,Staff,11,0,75,64
1650804287966,COGS 100,A01,083619,Staff,0,29,60,60
1650804293997,COGS 101A,A01,083621,Davis; Joshua Daniel,0,28,60,60
1650804300023,COGS 101B,A01,091572,Staff,0,3,60,60
1650804306047,COGS 101C,A01,083625,Delgado; Tania,14,0,30,16
1650804312069,COGS 107A,A01,083627,Boyle; Mary E. T.,0,16,60,60
1650804318094,COGS 118A,A01,083075,Staff,0,8,60,60
1650804324121,CSE 3,A50,083646,Miranda; Gregory Joseph,18,0,38,20
1650804324121,CSE 3,A51,083647,Miranda; Gregory Joseph,36,0,37,1
1650804330148,CSE 8A,A50,083650,Miranda; Gregory Joseph,0,29,40,40
1650804336173,CSE 11,A01,083080,Cao; Yingjun,0,96,40,40
1650804342200,CSE 12,A01,083652,Staff,0,21,100,100
1650804348227,CSE 15L,A01,083654,Staff,0,3,50,50
1650804348227,CSE 15L,A02,083655,Staff,0,2,50,50
1650804354251,CSE 20,A01,083657,Staff,49,0,80,31
1650804360274,CSE 30,A01,083084,Eldon; John,0,75,40,40
1650804366300,CSE 100,A01,083659,Cao; Yingjun,0,71,50,50
1650804372324,CSE 134B,A01,083661,Powell; Thomas Allan,0,38,65,65
1650804378349,CSE 140,A01,083663,Staff,0,11,75,75
1650804384378,CSE 140L,A01,083088,Eldon; John,0,20,75,75
1650804390402,CSE 175,A01,083665,Kumar; Rakesh,7,0,25,18
1650804396433,CSE 190,A00,092507,Dubnov; Shlomo,10,0,20,10
1650804402457,ECE 45,A01,083139,Staff,0,1,60,60
1650804408485,ECE 65,A50,083695,Staff,0,5,30,30
1650804414510,ECE 109,A01,091882,Touri; Behrouz,32,0,70,38
1650804420536,ECE 180,A00,083140,Abi Samra; Nicholas Camill,20,0,30,10
1650804420536,ECE 180,B00,083141,Abi Samra; Nicholas Camill,0,0,30,30
1650804426562,MATH 10A,A01,083735,Patchell; Gregory David,2,0,30,28
1650804426562,MATH 10A,A02,083736,Patchell; Gregory David,27,0,30,3
1650804426562,MATH 10A,A03,083737,Patchell; Gregory David,24,0,30,6
1650804432590,MATH 10B,A01,083207,Staff,0,9,30,30
1650804432590,MATH 10B,A02,083208,Staff,0,6,30,30
1650804432590,MATH 10B,B01,083739,Staff,11,0,30,19
1650804432590,MATH 10B,B02,083740,Staff,28,0,30,2
1650804438619,MATH 18,A01,083743,Staff,0,0,30,30
1650804438619,MATH 18,A02,083744,Staff,23,0,30,7
1650804438619,MATH 18,A03,083745,Staff,21,0,30,9
1650804438619,MATH 18,A04,083746,Staff,26,0,30,4
1650804438619,MATH 18,B01,083748,Staff,0,15,30,30
1650804438619,MATH 18,B02,083749,Staff,0,12,30,30
1650804438619,MATH 18,B03,083750,Staff,0,12,30,30
1650804438619,MATH 18,B04,083751,Staff,0,12,30,30
1650804444644,MATH 20A,A01,083754,Staff,19,0,40,21
1650804450668,MATH 20B,A01,083756,Staff,0,13,30,30
1650804450668,MATH 20B,A02,083757,Staff,0,12,30,30
1650804456693,MATH 20C,A01,083760,Staff,0,17,30,30
1650804456693,MATH 20C,A02,083761,Staff,0,16,30,30
1650804456693,MATH 20C,B01,083762,Staff,9,0,30,21
1650804456693,MATH 20C,B02,083763,Staff,28,0,30,2
1650804462721,MATH 20D,A01,083765,Staff,2,1,30,28
1650804462721,MATH 20D,A02,083766,Staff,6,0,30,24
1650804462721,MATH 20D,A03,083767,Staff,24,0,30,6
1650804468744,MATH 20E,A01,083771,Staff,2,0,30,28
1650804468744,MATH 20E,A02,083772,Staff,15,0,30,15
1650804468744,MATH 20E,B01,083773,Staff,0,0,30,30
1650804468744,MATH 20E,B02,083774,Staff,5,0,30,25
1650804474770,MATH 103A,A01,083777,Staff,0,16,30,30
1650804474770,MATH 103A,A02,083778,Staff,0,15,30,30
1650804474770,MATH 103A,B01,083779,Staff,0,15,30,30
1650804474770,MATH 103A,B02,083780,Staff,0,15,30,30
1650804480798,MATH 105,A01,085443,Staff,0,22,30,30
1650804486823,MATH 109,A01,083213,Anzaldo; Leesa B,0,7,30,30
1650804486823,MATH 109,A02,083214,Anzaldo; Leesa B,0,7,30,30
1650804486823,MATH 109,B01,083215,Anzaldo; Leesa B,0,8,30,30
1650804486823,MATH 109,B02,083216,Anzaldo; Leesa B,0,7,30,30
1650804492847,MATH 142A,A01,083219,Chow; Bennett,0,16,30,30
1650804492847,MATH 142A,A02,083220,Chow; Bennett,0,15,30,30
1650804492847,MATH 142A,B01,083221,Chow; Bennett,0,16,30,30
1650804492847,MATH 142A,B02,083222,Chow; Bennett,0,14,30,30
1650804498871,MATH 193A,A01,083224,Staff,0,6,30,30
1650804498871,MATH 193A,A02,083225,Staff,0,6,30,30
1650804498871,MATH 193A,A03,083781,Staff,0,6,30,30
1650804498871,MATH 193A,A04,083782,Staff,0,7,30,30
1650804504896,MATH 197,001,091859,McAuley; Julian John,9998,0,9999,1
1650804510953,COGS 9,A01,083615,Staff,0,17,60,60
1650804516978,COGS 11,A01,083617,Boyle; Mary E. T.,16,0,40,24
1650804523002,COGS 13,A01,083071,Staff,0,38,40,40
1650804529029,COGS 14A,A01,092681,Staff,0,36,100,100
1650804535057,COGS 14B,A01,083073,Cheng; Tzu-Han,0,12,50,50
1650804541083,COGS 17,A01,092677,Staff,11,0,75,64
1650804547110,COGS 100,A01,083619,Staff,0,29,60,60
1650804553134,COGS 101A,A01,083621,Davis; Joshua Daniel,0,28,60,60
1650804559168,COGS 101B,A01,091572,Staff,0,3,60,60
1650804565196,COGS 101C,A01,083625,Delgado; Tania,14,0,30,16
1650804571229,COGS 107A,A01,083627,Boyle; Mary E. T.,0,16,60,60
1650804577257,COGS 118A,A01,083075,Staff,0,8,60,60
1650804583282,CSE 3,A50,083646,Miranda; Gregory Joseph,18,0,38,20
1650804583282,CSE 3,A51,083647,Miranda; Gregory Joseph,36,0,37,1
1650804589305,CSE 8A,A50,083650,Miranda; Gregory Joseph,0,29,40,40
1650804595333,CSE 11,A01,083080,Cao; Yingjun,0,96,40,40
1650804601358,CSE 12,A01,083652,Staff,0,21,100,100
1650804607387,CSE 15L,A01,083654,Staff,0,3,50,50
1650804607387,CSE 15L,A02,083655,Staff,0,2,50,50
1650804613412,CSE 20,A01,083657,Staff,49,0,80,31
1650804619437,CSE 30,A01,083084,Eldon; John,0,75,40,40
1650804625462,CSE 100,A01,083659,Cao; Yingjun,0,71,50,50
1650804631495,CSE 134B,A01,083661,Powell; Thomas Allan,0,38,65,65
1650804637521,CSE 140,A01,083663,Staff,0,11,75,75
1650804643551,CSE 140L,A01,083088,Eldon; John,0,20,75,75
1650804649581,CSE 175,A01,083665,Kumar; Rakesh,7,0,25,18
1650804655610,CSE 190,A00,092507,Dubnov; Shlomo,10,0,20,10
1650804661635,ECE 45,A01,083139,Staff,0,1,60,60
1650804667671,ECE 65,A50,083695,Staff,0,5,30,30
1650804673701,ECE 109,A01,091882,Touri; Behrouz,32,0,70,38
1650804679735,ECE 180,A00,083140,Abi Samra; Nicholas Camill,20,0,30,10
1650804679735,ECE 180,B00,083141,Abi Samra; Nicholas Camill,0,0,30,30
1650804685762,MATH 10A,A01,083735,Patchell; Gregory David,2,0,30,28
1650804685762,MATH 10A,A02,083736,Patchell; Gregory David,27,0,30,3
1650804685762,MATH 10A,A03,083737,Patchell; Gregory David,24,0,30,6
1650804691792,MATH 10B,A01,083207,Staff,0,9,30,30
1650804691792,MATH 10B,A02,083208,Staff,0,6,30,30
1650804691792,MATH 10B,B01,083739,Staff,11,0,30,19
1650804691792,MATH 10B,B02,083740,Staff,28,0,30,2
1650804697822,MATH 18,A01,083743,Staff,0,0,30,30
1650804697822,MATH 18,A02,083744,Staff,23,0,30,7
1650804697822,MATH 18,A03,083745,Staff,21,0,30,9
1650804697822,MATH 18,A04,083746,Staff,26,0,30,4
1650804697822,MATH 18,B01,083748,Staff,0,15,30,30
1650804697822,MATH 18,B02,083749,Staff,0,12,30,30
1650804697822,MATH 18,B03,083750,Staff,0,12,30,30
1650804697822,MATH 18,B04,083751,Staff,0,12,30,30
1650804703848,MATH 20A,A01,083754,Staff,19,0,40,21
1650804709871,MATH 20B,A01,083756,Staff,0,13,30,30
1650804709871,MATH 20B,A02,083757,Staff,0,12,30,30
1650804715896,MATH 20C,A01,083760,Staff,0,17,30,30
1650804715896,MATH 20C,A02,083761,Staff,0,16,30,30
1650804715896,MATH 20C,B01,083762,Staff,9,0,30,21
1650804715896,MATH 20C,B02,083763,Staff,28,0,30,2
1650804721926,MATH 20D,A01,083765,Staff,2,1,30,28
1650804721926,MATH 20D,A02,083766,Staff,6,0,30,24
1650804721926,MATH 20D,A03,083767,Staff,24,0,30,6
1650804727953,MATH 20E,A01,083771,Staff,2,0,30,28
1650804727953,MATH 20E,A02,083772,Staff,15,0,30,15
1650804727953,MATH 20E,B01,083773,Staff,0,0,30,30
1650804727953,MATH 20E,B02,083774,Staff,5,0,30,25
1650804733984,MATH 103A,A01,083777,Staff,0,16,30,30
1650804733984,MATH 103A,A02,083778,Staff,0,15,30,30
1650804733984,MATH 103A,B01,083779,Staff,0,15,30,30
1650804733984,MATH 103A,B02,083780,Staff,0,15,30,30
1650804740099,MATH 105,A01,085443,Staff,0,22,30,30
1650804746124,MATH 109,A01,083213,Anzaldo; Leesa B,0,7,30,30
1650804746124,MATH 109,A02,083214,Anzaldo; Leesa B,0,7,30,30
1650804746124,MATH 109,B01,083215,Anzaldo; Leesa B,0,8,30,30
1650804746124,MATH 109,B02,083216,Anzaldo; Leesa B,0,7,30,30
1650804752155,MATH 142A,A01,083219,Chow; Bennett,0,16,30,30
1650804752155,MATH 142A,A02,083220,Chow; Bennett,0,15,30,30
1650804752155,MATH 142A,B01,083221,Chow; Bennett,0,16,30,30
1650804752155,MATH 142A,B02,083222,Chow; Bennett,0,14,30,30
1650804758183,MATH 193A,A01,083224,Staff,0,6,30,30
1650804758183,MATH 193A,A02,083225,Staff,0,6,30,30
1650804758183,MATH 193A,A03,083781,Staff,0,6,30,30
1650804758183,MATH 193A,A04,083782,Staff,0,7,30,30
1650804764209,MATH 197,001,091859,McAuley; Julian John,9998,0,9999,1
1650804770267,COGS 9,A01,083615,Staff,0,17,60,60
1650804776294,COGS 11,A01,083617,Boyle; Mary E. T.,16,0,40,24
1650804782322,COGS 13,A01,083071,Staff,0,38,40,40
1650804788344,COGS 14A,A01,092681,Staff,0,36,100,100
1650804794367,COGS 14B,A01,083073,Cheng; Tzu-Han,0,12,50,50
1650804800389,COGS 17,A01,092677,Staff,11,0,75,64
1650804806412,COGS 100,A01,083619,Staff,0,29,60,60
1650804812434,COGS 101A,A01,083621,Davis; Joshua Daniel,0,28,60,60
1650804818463,COGS 101B,A01,091572,Staff,0,3,60,60
1650804824488,COGS 101C,A01,083625,Delgado; Tania,14,0,30,16
1650804830512,COGS 107A,A01,083627,Boyle; Mary E. T.,0,16,60,60
1650804836534,COGS 118A,A01,083075,Staff,0,8,60,60
1650804842557,CSE 3,A50,083646,Miranda; Gregory Joseph,18,0,38,20
1650804842557,CSE 3,A51,083647,Miranda; Gregory Joseph,36,0,37,1
1650804848584,CSE 8A,A50,083650,Miranda; Gregory Joseph,0,29,40,40
1650804854613,CSE 11,A01,083080,Cao; Yingjun,0,96,40,40
1650804860641,CSE 12,A01,083652,Staff,0,21,100,100
1650804866667,CSE 15L,A01,083654,Staff,0,3,50,50
1650804866667,CSE 15L,A02,083655,Staff,0,2,50,50
1650804872690,CSE 20,A01,083657,Staff,49,0,80,31
1650804878716,CSE 30,A01,083084,Eldon; John,0,75,40,40
1650804884741,CSE 100,A01,083659,Cao; Yingjun,0,71,50,50
1650804890766,CSE 134B,A01,083661,Powell; Thomas Allan,0,38,65,65
1650804896793,CSE 140,A01,083663,Staff,0,11,75,75
1650804902827,CSE 140L,A01,083088,Eldon; John,0,20,75,75
1650804908851,CSE 175,A01,083665,Kumar; Rakesh,7,0,25,18
1650804914874,CSE 190,A00,092507,Dubnov; Shlomo,10,0,20,10
1650804920897,ECE 45,A01,083139,Staff,0,1,60,60
1650804926920,ECE 65,A50,083695,Staff,0,5,30,30
1650804932945,ECE 109,A01,091882,Touri; Behrouz,32,0,70,38
1650804938972,ECE 180,A00,083140,Abi Samra; Nicholas Camill,20,0,30,10
1650804938972,ECE 180,B00,083141,Abi Samra; Nicholas Camill,0,0,30,30
1650804944994,MATH 10A,A01,083735,Patchell; Gregory David,2,0,30,28
1650804944994,MATH 10A,A02,083736,Patchell; Gregory David,27,0,30,3
1650804944994,MATH 10A,A03,083737,Patchell; Gregory David,24,0,30,6
1650804951021,MATH 10B,A01,083207,Staff,0,9,30,30
1650804951021,MATH 10B,A02,083208,Staff,0,6,30,30
1650804951021,MATH 10B,B01,083739,Staff,11,0,30,19
1650804951021,MATH 10B,B02,083740,Staff,28,0,30,2
1650804957048,MATH 18,A01,083743,Staff,0,0,30,30
1650804957048,MATH 18,A02,083744,Staff,23,0,30,7
1650804957048,MATH 18,A03,083745,Staff,21,0,30,9
1650804957048,MATH 18,A04,083746,Staff,26,0,30,4
1650804957048,MATH 18,B01,083748,Staff,0,15,30,30
1650804957048,MATH 18,B02,083749,Staff,0,12,30,30
1650804957048,MATH 18,B03,083750,Staff,0,12,30,30
1650804957048,MATH 18,B04,083751,Staff,0,12,30,30
1650804963072,MATH 20A,A01,083754,Staff,19,0,40,21
1650804969101,MATH 20B,A01,083756,Staff,0,13,30,30
1650804969101,MATH 20B,A02,083757,Staff,0,12,30,30
1650804975125,MATH 20C,A01,083760,Staff,0,17,30,30
1650804975125,MATH 20C,A02,083761,Staff,0,16,30,30
1650804975125,MATH 20C,B01,083762,Staff,9,0,30,21
1650804975125,MATH 20C,B02,083763,Staff,28,0,30,2
1650804981147,MATH 20D,A01,083765,Staff,2,1,30,28
1650804981147,MATH 20D,A02,083766,Staff,6,0,30,24
1650804981147,MATH 20D,A03,083767,Staff,24,0,30,6
1650804987175,MATH 20E,A01,083771,Staff,2,0,30,28
1650804987175,MATH 20E,A02,083772,Staff,15,0,30,15
1650804987175,MATH 20E,B01,083773,Staff,0,0,30,30
1650804987175,MATH 20E,B02,083774,Staff,5,0,30,25
1650804993204,MATH 103A,A01,083777,Staff,0,16,30,30
1650804993204,MATH 103A,A02,083778,Staff,0,15,30,30
1650804993204,MATH 103A,B01,083779,Staff,0,15,30,30
1650804993204,MATH 103A,B02,083780,Staff,0,15,30,30
1650804999227,MATH 105,A01,085443,Staff,0,22,30,30
1650805005258,MATH 109,A01,083213,Anzaldo; Leesa B,0,7,30,30
1650805005258,MATH 109,A02,083214,Anzaldo; Leesa B,0,7,30,30
1650805005258,MATH 109,B01,083215,Anzaldo; Leesa B,0,8,30,30
1650805005258,MATH 109,B02,083216,Anzaldo; Leesa B,0,7,30,30
1650805011281,MATH 142A,A01,083219,Chow; Bennett,0,16,30,30
1650805011281,MATH 142A,A02,083220,Chow; Bennett,0,15,30,30
1650805011281,MATH 142A,B01,083221,Chow; Bennett,0,16,30,30
1650805011281,MATH 142A,B02,083222,Chow; Bennett,0,14,30,30
1650805017306,MATH 193A,A01,083224,Staff,0,6,30,30
1650805017306,MATH 193A,A02,083225,Staff,0,6,30,30
1650805017306,MATH 193A,A03,083781,Staff,0,6,30,30
1650805017306,MATH 193A,A04,083782,Staff,0,7,30,30
1650805023332,MATH 197,001,091859,McAuley; Julian John,9998,0,9999,1
1650805029390,COGS 9,A01,083615,Staff,0,17,60,60
1650805035427,COGS 11,A01,083617,Boyle; Mary E. T.,16,0,40,24
1650805041453,COGS 13,A01,083071,Staff,0,38,40,40
1650805047481,COGS 14A,A01,092681,Staff,0,36,100,100
1650805053512,COGS 14B,A01,083073,Cheng; Tzu-Han,0,12,50,50
1650805059539,COGS 17,A01,092677,Staff,11,0,75,64
1650805065563,COGS 100,A01,083619,Staff,0,29,60,60
1650805071587,COGS 101A,A01,083621,Davis; Joshua Daniel,0,28,60,60
1650805077612,COGS 101B,A01,091572,Staff,0,3,60,60
1650805083638,COGS 101C,A01,083625,Delgado; Tania,14,0,30,16
1650805089661,COGS 107A,A01,083627,Boyle; Mary E. T.,0,16,60,60
1650805095686,COGS 118A,A01,083075,Staff,0,8,60,60
1650805101712,CSE 3,A50,083646,Miranda; Gregory Joseph,18,0,38,20
1650805101712,CSE 3,A51,083647,Miranda; Gregory Joseph,36,0,37,1
1650805107740,CSE 8A,A50,083650,Miranda; Gregory Joseph,0,29,40,40
1650805113768,CSE 11,A01,083080,Cao; Yingjun,0,96,40,40
1650805119793,CSE 12,A01,083652,Staff,0,21,100,100
1650805125830,CSE 15L,A01,083654,Staff,0,3,50,50
1650805125830,CSE 15L,A02,083655,Staff,0,2,50,50
1650805131856,CSE 20,A01,083657,Staff,49,0,80,31
1650805137881,CSE 30,A01,083084,Eldon; John,0,75,40,40
1650805143912,CSE 100,A01,083659,Cao; Yingjun,0,71,50,50
1650805149943,CSE 134B,A01,083661,Powell; Thomas Allan,0,38,65,65
1650805155970,CSE 140,A01,083663,Staff,0,11,75,75
1650805162000,CSE 140L,A01,083088,Eldon; John,0,20,75,75
1650805168026,CSE 175,A01,083665,Kumar; Rakesh,7,0,25,18
1650805174051,CSE 190,A00,092507,Dubnov; Shlomo,10,0,20,10
1650805180077,ECE 45,A01,083139,Staff,0,1,60,60
1650805186108,ECE 65,A50,083695,Staff,0,5,30,30
1650805192134,ECE 109,A01,091882,Touri; Behrouz,32,0,70,38
1650805198159,ECE 180,A00,083140,Abi Samra; Nicholas Camill,20,0,30,10
1650805198159,ECE 180,B00,083141,Abi Samra; Nicholas Camill,0,0,30,30
1650805204187,MATH 10A,A01,083735,Patchell; Gregory David,2,0,30,28
1650805204187,MATH 10A,A02,083736,Patchell; Gregory David,27,0,30,3
1650805204187,MATH 10A,A03,083737,Patchell; Gregory David,24,0,30,6
1650805210213,MATH 10B,A01,083207,Staff,0,9,30,30
1650805210213,MATH 10B,A02,083208,Staff,0,6,30,30
1650805210213,MATH 10B,B01,083739,Staff,11,0,30,19
1650805210213,MATH 10B,B02,083740,Staff,28,0,30,2
1650805216248,MATH 18,A01,083743,Staff,0,0,30,30
1650805216248,MATH 18,A02,083744,Staff,23,0,30,7
1650805216248,MATH 18,A03,083745,Staff,21,0,30,9
1650805216248,MATH 18,A04,083746,Staff,26,0,30,4
1650805216248,MATH 18,B01,083748,Staff,0,15,30,30
1650805216248,MATH 18,B02,083749,Staff,0,12,30,30
1650805216248,MATH 18,B03,083750,Staff,0,12,30,30
1650805216248,MATH 18,B04,083751,Staff,0,12,30,30
1650805222275,MATH 20A,A01,083754,Staff,19,0,40,21
1650805228301,MATH 20B,A01,083756,Staff,0,13,30,30
1650805228301,MATH 20B,A02,083757,Staff,0,12,30,30
1650805234329,MATH 20C,A01,083760,Staff,0,17,30,30
1650805234329,MATH 20C,A02,083761,Staff,0,16,30,30
1650805234329,MATH 20C,B01,083762,Staff,9,0,30,21
1650805234329,MATH 20C,B02,083763,Staff,28,0,30,2
1650805240353,MATH 20D,A01,083765,Staff,2,1,30,28
1650805240353,MATH 20D,A02,083766,Staff,6,0,30,24
1650805240353,MATH 20D,A03,083767,Staff,24,0,30,6
1650805246383,MATH 20E,A01,083771,Staff,2,0,30,28
1650805246383,MATH 20E,A02,083772,Staff,15,0,30,15
1650805246383,MATH 20E,B01,083773,Staff,0,0,30,30
1650805246383,MATH 20E,B02,083774,Staff,5,0,30,25
1650805252407,MATH 103A,A01,083777,Staff,0,16,30,30
1650805252407,MATH 103A,A02,083778,Staff,0,15,30,30
1650805252407,MATH 103A,B01,083779,Staff,0,15,30,30
1650805252407,MATH 103A,B02,083780,Staff,0,15,30,30
1650805258434,MATH 105,A01,085443,Staff,0,22,30,30
1650805264460,MATH 109,A01,083213,Anzaldo; Leesa B,0,7,30,30
1650805264460,MATH 109,A02,083214,Anzaldo; Leesa B,0,7,30,30
1650805264460,MATH 109,B01,083215,Anzaldo; Leesa B,0,8,30,30
1650805264460,MATH 109,B02,083216,Anzaldo; Leesa B,0,7,30,30
1650805270490,MATH 142A,A01,083219,Chow; Bennett,0,16,30,30
1650805270490,MATH 142A,A02,083220,Chow; Bennett,0,15,30,30
1650805270490,MATH 142A,B01,083221,Chow; Bennett,0,16,30,30
1650805270490,MATH 142A,B02,083222,Chow; Bennett,0,14,30,30
1650805276519,MATH 193A,A01,083224,Staff,0,6,30,30
1650805276519,MATH 193A,A02,083225,Staff,0,6,30,30
1650805276519,MATH 193A,A03,083781,Staff,0,6,30,30
1650805276519,MATH 193A,A04,083782,Staff,0,7,30,30
1650805282543,MATH 197,001,091859,McAuley; Julian John,9998,0,9999,1
1650805288602,COGS 9,A01,083615,Staff,0,17,60,60
1650805294628,COGS 11,A01,083617,Boyle; Mary E. T.,16,0,40,24
1650805300652,COGS 13,A01,083071,Staff,0,38,40,40
1650805306677,COGS 14A,A01,092681,Staff,0,36,100,100
1650805312700,COGS 14B,A01,083073,Cheng; Tzu-Han,0,12,50,50
1650805318726,COGS 17,A01,092677,Staff,11,0,75,64
1650805324755,COGS 100,A01,083619,Staff,0,29,60,60
1650805330868,COGS 101A,A01,083621,Davis; Joshua Daniel,0,28,60,60
1650805336900,COGS 101B,A01,091572,Staff,0,3,60,60
1650805342926,COGS 101C,A01,083625,Delgado; Tania,14,0,30,16
1650805348950,COGS 107A,A01,083627,Boyle; Mary E. T.,0,16,60,60
1650805354974,COGS 118A,A01,083075,Staff,0,8,60,60
1650805361004,CSE 3,A50,083646,Miranda; Gregory Joseph,18,0,38,20
1650805361004,CSE 3,A51,083647,Miranda; Gregory Joseph,36,0,37,1
1650805367030,CSE 8A,A50,083650,Miranda; Gregory Joseph,0,29,40,40
1650805373058,CSE 11,A01,083080,Cao; Yingjun,0,96,40,40
1650805379084,CSE 12,A01,083652,Staff,0,21,100,100
1650805385110,CSE 15L,A01,083654,Staff,0,3,50,50
1650805385110,CSE 15L,A02,083655,Staff,0,2,50,50
1650805391136,CSE 20,A01,083657,Staff,49,0,80,31
1650805397166,CSE 30,A01,083084,Eldon; John,0,75,40,40
1650805403195,CSE 100,A01,083659,Cao; Yingjun,0,71,50,50
1650805409223,CSE 134B,A01,083661,Powell; Thomas Allan,0,38,65,65
1650805415248,CSE 140,A01,083663,Staff,0,11,75,75
1650805421271,CSE 140L,A01,083088,Eldon; John,0,20,75,75
1650805427297,CSE 175,A01,083665,Kumar; Rakesh,7,0,25,18
1650805433321,CSE 190,A00,092507,Dubnov; Shlomo,10,0,20,10
1650805439350,ECE 45,A01,083139,Staff,0,1,60,60
1650805445379,ECE 65,A50,083695,Staff,0,5,30,30
1650805451404,ECE 109,A01,091882,Touri; Behrouz,32,0,70,38
1650805457429,ECE 180,A00,083140,Abi Samra; Nicholas Camill,20,0,30,10
1650805457429,ECE 180,B00,083141,Abi Samra; Nicholas Camill,0,0,30,30
1650805463456,MATH 10A,A01,083735,Patchell; Gregory David,2,0,30,28
1650805463456,MATH 10A,A02,083736,Patchell; Gregory David,27,0,30,3
1650805463456,MATH 10A,A03,083737,Patchell; Gregory David,24,0,30,6
1650805469483,MATH 10B,A01,083207,Staff,0,9,30,30
1650805469483,MATH 10B,A02,083208,Staff,0,6,30,30
1650805469483,MATH 10B,B01,083739,Staff,11,0,30,19
1650805469483,MATH 10B,B02,083740,Staff,28,0,30,2
1650805475506,MATH 18,A01,083743,Staff,0,0,30,30
1650805475506,MATH 18,A02,083744,Staff,23,0,30,7
1650805475506,MATH 18,A03,083745,Staff,21,0,30,9
1650805475506,MATH 18,A04,083746,Staff,26,0,30,4
1650805475506,MATH 18,B01,083748,Staff,0,15,30,30
1650805475506,MATH 18,B02,083749,Staff,0,12,30,30
1650805475506,MATH 18,B03,083750,Staff,0,12,30,30
1650805475506,MATH 18,B04,083751,Staff,0,12,30,30
1650805481531,MATH 20A,A01,083754,Staff,19,0,40,21
1650805487559,MATH 20B,A01,083756,Staff,0,13,30,30
1650805487559,MATH 20B,A02,083757,Staff,0,12,30,30
1650805493587,MATH 20C,A01,083760,Staff,0,17,30,30
1650805493587,MATH 20C,A02,083761,Staff,0,16,30,30
1650805493587,MATH 20C,B01,083762,Staff,9,0,30,21
1650805493587,MATH 20C,B02,083763,Staff,28,0,30,2
1650805499612,MATH 20D,A01,083765,Staff,2,1,30,28
1650805499612,MATH 20D,A02,083766,Staff,6,0,30,24
1650805499612,MATH 20D,A03,083767,Staff,24,0,30,6
1650805505635,MATH 20E,A01,083771,Staff,2,0,30,28
1650805505635,MATH 20E,A02,083772,Staff,15,0,30,15
1650805505635,MATH 20E,B01,083773,Staff,0,0,30,30
1650805505635,MATH 20E,B02,083774,Staff,5,0,30,25
1650805511666,MATH 103A,A01,083777,Staff,0,16,30,30
1650805511666,MATH 103A,A02,083778,Staff,0,15,30,30
1650805511666,MATH 103A,B01,083779,Staff,0,15,30,30
1650805511666,MATH 103A,B02,083780,Staff,0,15,30,30
1650805517691,MATH 105,A01,085443,Staff,0,22,30,30
1650805523717,MATH 109,A01,083213,Anzaldo; Leesa B,0,7,30,30
1650805523717,MATH 109,A02,083214,Anzaldo; Leesa B,0,7,30,30
1650805523717,MATH 109,B01,083215,Anzaldo; Leesa B,0,8,30,30
1650805523717,MATH 109,B02,083216,Anzaldo; Leesa B,0,7,30,30
1650805529747,MATH 142A,A01,083219,Chow; Bennett,0,16,30,30
1650805529747,MATH 142A,A02,083220,Chow; Bennett,0,15,30,30
1650805529747,MATH 142A,B01,083221,Chow; Bennett,0,16,30,30
1650805529747,MATH 142A,B02,083222,Chow; Bennett,0,14,30,30
1650805535772,MATH 193A,A01,083224,Staff,0,6,30,30
1650805535772,MATH 193A,A02,083225,Staff,0,6,30,30
1650805535772,MATH 193A,A03,083781,Staff,0,6,30,30
1650805535772,MATH 193A,A04,083782,Staff,0,7,30,30
1650805541796,MATH 197,001,091859,McAuley; Julian John,9998,0,9999,1
1650805547855,COGS 9,A01,083615,Staff,0,17,60,60
1650805553883,COGS 11,A01,083617,Boyle; Mary E. T.,16,0,40,24
1650805559908,COGS 13,A01,083071,Staff,0,38,40,40
1650805565933,COGS 14A,A01,092681,Staff,0,36,100,100
1650805571958,COGS 14B,A01,083073,Cheng; Tzu-Han,0,12,50,50
1650805577982,COGS 17,A01,092677,Staff,11,0,75,64
1650805584008,COGS 100,A01,083619,Staff,0,29,60,60
1650805590033,COGS 101A,A01,083621,Davis; Joshua Daniel,0,28,60,60
1650805596059,COGS 101B,A01,091572,Staff,0,3,60,60
1650805602084,COGS 101C,A01,083625,Delgado; Tania,14,0,30,16
1650805608109,COGS 107A,A01,083627,Boyle; Mary E. T.,0,16,60,60
1650805614133,COGS 118A,A01,083075,Staff,0,8,60,60
1650805620164,CSE 3,A50,083646,Miranda; Gregory Joseph,18,0,38,20
1650805620164,CSE 3,A51,083647,Miranda; Gregory Joseph,36,0,37,1
1650805626189,CSE 8A,A50,083650,Miranda; Gregory Joseph,0,29,40,40
1650805632213,CSE 11,A01,083080,Cao; Yingjun,0,96,40,40
1650805638237,CSE 12,A01,083652,Staff,0,21,100,100
1650805644264,CSE 15L,A01,083654,Staff,0,3,50,50
1650805644264,CSE 15L,A02,083655,Staff,0,2,50,50
1650805650297,CSE 20,A01,083657,Staff,49,0,80,31
1650805656319,CSE 30,A01,083084,Eldon; John,0,75,40,40
1650805662344,CSE 100,A01,083659,Cao; Yingjun,0,71,50,50
1650805668370,CSE 134B,A01,083661,Powell; Thomas Allan,0,38,65,65
1650805674398,CSE 140,A01,083663,Staff,0,11,75,75
1650805680424,CSE 140L,A01,083088,Eldon; John,0,20,75,75
1650805686451,CSE 175,A01,083665,Kumar; Rakesh,7,0,25,18
1650805692474,CSE 190,A00,092507,Dubnov; Shlomo,10,0,20,10
1650805698501,ECE 45,A01,083139,Staff,0,1,60,60
1650805704526,ECE 65,A50,083695,Staff,0,5,30,30
1650805710550,ECE 109,A01,091882,Touri; Behrouz,32,0,70,38
1650805716574,ECE 180,A00,083140,Abi Samra; Nicholas Camill,20,0,30,10
1650805716574,ECE 180,B00,083141,Abi Samra; Nicholas Camill,0,0,30,30
1650805722601,MATH 10A,A01,083735,Patchell; Gregory David,2,0,30,28
1650805722601,MATH 10A,A02,083736,Patchell; Gregory David,27,0,30,3
1650805722601,MATH 10A,A03,083737,Patchell; Gregory David,24,0,30,6
1650805728625,MATH 10B,A01,083207,Staff,0,9,30,30
1650805728625,MATH 10B,A02,083208,Staff,0,6,30,30
1650805728625,MATH 10B,B01,083739,Staff,11,0,30,19
1650805728625,MATH 10B,B02,083740,Staff,28,0,30,2
1650805734652,MATH 18,A01,083743,Staff,0,0,30,30
1650805734652,MATH 18,A02,083744,Staff,23,0,30,7
1650805734652,MATH 18,A03,083745,Staff,21,0,30,9
1650805734652,MATH 18,A04,083746,Staff,26,0,30,4
1650805734652,MATH 18,B01,083748,Staff,0,15,30,30
1650805734652,MATH 18,B02,083749,Staff,0,12,30,30
1650805734652,MATH 18,B03,083750,Staff,0,12,30,30
1650805734652,MATH 18,B04,083751,Staff,0,12,30,30
1650805740677,MATH 20A,A01,083754,Staff,19,0,40,21
1650805746705,MATH 20B,A01,083756,Staff,0,13,30,30
1650805746705,MATH 20B,A02,083757,Staff,0,12,30,30
1650805752731,MATH 20C,A01,083760,Staff,0,17,30,30
1650805752731,MATH 20C,A02,083761,Staff,0,16,30,30
1650805752731,MATH 20C,B01,083762,Staff,9,0,30,21
1650805752731,MATH 20C,B02,083763,Staff,28,0,30,2
1650805758754,MATH 20D,A01,083765,Staff,2,1,30,28
1650805758754,MATH 20D,A02,083766,Staff,6,0,30,24
1650805758754,MATH 20D,A03,083767,Staff,24,0,30,6
1650805764778,MATH 20E,A01,083771,Staff,2,0,30,28
1650805764778,MATH 20E,A02,083772,Staff,15,0,30,15
1650805764778,MATH 20E,B01,083773,Staff,0,0,30,30
1650805764778,MATH 20E,B02,083774,Staff,5,0,30,25
1650805770807,MATH 103A,A01,083777,Staff,0,16,30,30
1650805770807,MATH 103A,A02,083778,Staff,0,15,30,30
1650805770807,MATH 103A,B01,083779,Staff,0,15,30,30
1650805770807,MATH 103A,B02,083780,Staff,0,15,30,30
1650805776833,MATH 105,A01,085443,Staff,0,22,30,30
1650805782857,MATH 109,A01,083213,Anzaldo; Leesa B,0,7,30,30
1650805782857,MATH 109,A02,083214,Anzaldo; Leesa B,0,7,30,30
1650805782857,MATH 109,B01,083215,Anzaldo; Leesa B,0,8,30,30
1650805782857,MATH 109,B02,083216,Anzaldo; Leesa B,0,7,30,30
1650805788883,MATH 142A,A01,083219,Chow; Bennett,0,16,30,30
1650805788883,MATH 142A,A02,083220,Chow; Bennett,0,15,30,30
1650805788883,MATH 142A,B01,083221,Chow; Bennett,0,16,30,30
1650805788883,MATH 142A,B02,083222,Chow; Bennett,0,14,30,30
1650805794909,MATH 193A,A01,083224,Staff,0,6,30,30
1650805794909,MATH 193A,A02,083225,Staff,0,6,30,30
1650805794909,MATH 193A,A03,083781,Staff,0,6,30,30
1650805794909,MATH 193A,A04,083782,Staff,0,7,30,30
1650805800932,MATH 197,001,091859,McAuley; Julian John,9998,0,9999,1
1650805806993,COGS 9,A01,083615,Staff,0,17,60,60
1650805813019,COGS 11,A01,083617,Boyle; Mary E. T.,16,0,40,24
1650805819045,COGS 13,A01,083071,Staff,0,38,40,40
1650805825068,COGS 14A,A01,092681,Staff,0,36,100,100
1650805831110,COGS 14B,A01,083073,Cheng; Tzu-Han,0,12,50,50
1650805837141,COGS 17,A01,092677,Staff,11,0,75,64
1650805843168,COGS 100,A01,083619,Staff,0,29,60,60
1650805849195,COGS 101A,A01,083621,Davis; Joshua Daniel,0,28,60,60
1650805855219,COGS 101B,A01,091572,Staff,0,3,60,60
1650805861244,COGS 101C,A01,083625,Delgado; Tania,14,0,30,16
1650805867279,COGS 107A,A01,083627,Boyle; Mary E. T.,0,16,60,60
1650805873308,COGS 118A,A01,083075,Staff,0,8,60,60
1650805879339,CSE 3,A50,083646,Miranda; Gregory Joseph,18,0,38,20
1650805879339,CSE 3,A51,083647,Miranda; Gregory Joseph,36,0,37,1
1650805885368,CSE 8A,A50,083650,Miranda; Gregory Joseph,0,29,40,40
1650805891393,CSE 11,A01,083080,Cao; Yingjun,0,96,40,40
1650805897416,CSE 12,A01,083652,Staff,0,21,100,100
1650805903441,CSE 15L,A01,083654,Staff,0,3,50,50
1650805903441,CSE 15L,A02,083655,Staff,0,2,50,50
1650805909468,CSE 20,A01,083657,Staff,49,0,80,31
1650805915495,CSE 30,A01,083084,Eldon; John,0,75,40,40
1650805921521,CSE 100,A01,083659,Cao; Yingjun,0,71,50,50
1650805927642,CSE 134B,A01,083661,Powell; Thomas Allan,0,38,65,65
1650805933667,CSE 140,A01,083663,Staff,0,11,75,75
1650805939692,CSE 140L,A01,083088,Eldon; John,0,20,75,75
1650805945721,CSE 175,A01,083665,Kumar; Rakesh,7,0,25,18
1650805951746,CSE 190,A00,092507,Dubnov; Shlomo,10,0,20,10
1650805957772,ECE 45,A01,083139,Staff,0,1,60,60
1650805963801,ECE 65,A50,083695,Staff,0,5,30,30
1650805969825,ECE 109,A01,091882,Touri; Behrouz,32,0,70,38
1650805975853,ECE 180,A00,083140,Abi Samra; Nicholas Camill,20,0,30,10
1650805975853,ECE 180,B00,083141,Abi Samra; Nicholas Camill,0,0,30,30
1650805981884,MATH 10A,A01,083735,Patchell; Gregory David,2,0,30,28
1650805981884,MATH 10A,A02,083736,Patchell; Gregory David,27,0,30,3
1650805981884,MATH 10A,A03,083737,Patchell; Gregory David,24,0,30,6
1650805987908,MATH 10B,A01,083207,Staff,0,9,30,30
1650805987908,MATH 10B,A02,083208,Staff,0,6,30,30
1650805987908,MATH 10B,B01,083739,Staff,11,0,30,19
1650805987908,MATH 10B,B02,083740,Staff,28,0,30,2
1650805993941,MATH 18,A01,083743,Staff,0,0,30,30
1650805993941,MATH 18,A02,083744,Staff,23,0,30,7
1650805993941,MATH 18,A03,083745,Staff,21,0,30,9
1650805993941,MATH 18,A04,083746,Staff,26,0,30,4
1650805993941,MATH 18,B01,083748,Staff,0,15,30,30
1650805993941,MATH 18,B02,083749,Staff,0,12,30,30
1650805993941,MATH 18,B03,083750,Staff,0,12,30,30
1650805993941,MATH 18,B04,083751,Staff,0,12,30,30
1650805999966,MATH 20A,A01,083754,Staff,19,0,40,21
1650806005990,MATH 20B,A01,083756,Staff,0,13,30,30
1650806005990,MATH 20B,A02,083757,Staff,0,12,30,30
1650806012013,MATH 20C,A01,083760,Staff,0,17,30,30
1650806012013,MATH 20C,A02,083761,Staff,0,16,30,30
1650806012013,MATH 20C,B01,083762,Staff,9,0,30,21
1650806012013,MATH 20C,B02,083763,Staff,28,0,30,2
1650806018042,MATH 20D,A01,083765,Staff,2,1,30,28
1650806018042,MATH 20D,A02,083766,Staff,6,0,30,24
1650806018042,MATH 20D,A03,083767,Staff,24,0,30,6
1650806024073,MATH 20E,A01,083771,Staff,2,0,30,28
1650806024073,MATH 20E,A02,083772,Staff,15,0,30,15
1650806024073,MATH 20E,B01,083773,Staff,0,0,30,30
1650806024073,MATH 20E,B02,083774,Staff,5,0,30,25
1650806030096,MATH 103A,A01,083777,Staff,0,16,30,30
1650806030096,MATH 103A,A02,083778,Staff,0,15,30,30
1650806030096,MATH 103A,B01,083779,Staff,0,15,30,30
1650806030096,MATH 103A,B02,083780,Staff,0,15,30,30
1650806036120,MATH 105,A01,085443,Staff,0,22,30,30
1650806042150,MATH 109,A01,083213,Anzaldo; Leesa B,0,7,30,30
1650806042150,MATH 109,A02,083214,Anzaldo; Leesa B,0,7,30,30
1650806042150,MATH 109,B01,083215,Anzaldo; Leesa B,0,8,30,30
1650806042150,MATH 109,B02,083216,Anzaldo; Leesa B,0,7,30,30
1650806048175,MATH 142A,A01,083219,Chow; Bennett,0,16,30,30
1650806048175,MATH 142A,A02,083220,Chow; Bennett,0,15,30,30
1650806048175,MATH 142A,B01,083221,Chow; Bennett,0,16,30,30
1650806048175,MATH 142A,B02,083222,Chow; Bennett,0,14,30,30
1650806054206,MATH 193A,A01,083224,Staff,0,6,30,30
1650806054206,MATH 193A,A02,083225,Staff,0,6,30,30
1650806054206,MATH 193A,A03,083781,Staff,0,6,30,30
1650806054206,MATH 193A,A04,083782,Staff,0,7,30,30
1650806060231,MATH 197,001,091859,McAuley; Julian John,9998,0,9999,1
1650806066292,COGS 9,A01,083615,Staff,0,17,60,60
1650806072315,COGS 11,A01,083617,Boyle; Mary E. T.,16,0,40,24
1650806078342,COGS 13,A01,083071,Staff,0,38,40,40
1650806084372,COGS 14A,A01,092681,Staff,0,36,100,100
1650806090398,COGS 14B,A01,083073,Cheng; Tzu-Han,0,12,50,50
1650806096426,COGS 17,A01,092677,Staff,11,0,75,64
1650806102450,COGS 100,A01,083619,Staff,0,29,60,60
1650806108474,COGS 101A,A01,083621,Davis; Joshua Daniel,0,28,60,60
1650806114501,COGS 101B,A01,091572,Staff,0,3,60,60
1650806120536,COGS 101C,A01,083625,Delgado; Tania,14,0,30,16
1650806126572,COGS 107A,A01,083627,Boyle; Mary E. T.,0,16,60,60
1650806132596,COGS 118A,A01,083075,Staff,0,8,60,60
1650806138626,CSE 3,A50,083646,Miranda; Gregory Joseph,18,0,38,20
1650806138626,CSE 3,A51,083647,Miranda; Gregory Joseph,36,0,37,1
1650806144653,CSE 8A,A50,083650,Miranda; Gregory Joseph,0,29,40,40
1650806150678,CSE 11,A01,083080,Cao; Yingjun,0,96,40,40
1650806156702,CSE 12,A01,083652,Staff,0,21,100,100
1650806162724,CSE 15L,A01,083654,Staff,0,3,50,50
1650806162724,CSE 15L,A02,083655,Staff,0,2,50,50
1650806168751,CSE 20,A01,083657,Staff,49,0,80,31
1650806174777,CSE 30,A01,083084,Eldon; John,0,75,40,40
1650806180801,CSE 100,A01,083659,Cao; Yingjun,0,71,50,50
1650806186827,CSE 134B,A01,083661,Powell; Thomas Allan,0,38,65,65
1650806192854,CSE 140,A01,083663,Staff,0,11,75,75
1650806198883,CSE 140L,A01,083088,Eldon; John,0,20,75,75
1650806204921,CSE 175,A01,083665,Kumar; Rakesh,7,0,25,18
1650806210949,CSE 190,A00,092507,Dubnov; Shlomo,10,0,20,10
1650806216988,ECE 45,A01,083139,Staff,0,1,60,60
1650806223016,ECE 65,A50,083695,Staff,0,5,30,30
1650806229058,ECE 109,A01,091882,Touri; Behrouz,32,0,70,38
1650806235096,ECE 180,A00,083140,Abi Samra; Nicholas Camill,20,0,30,10
1650806235096,ECE 180,B00,083141,Abi Samra; Nicholas Camill,0,0,30,30
1650806241136,MATH 10A,A01,083735,Patchell; Gregory David,2,0,30,28
1650806241136,MATH 10A,A02,083736,Patchell; Gregory David,27,0,30,3
1650806241136,MATH 10A,A03,083737,Patchell; Gregory David,24,0,30,6
1650806247165,MATH 10B,A01,083207,Staff,0,9,30,30
1650806247165,MATH 10B,A02,083208,Staff,0,6,30,30
1650806247165,MATH 10B,B01,083739,Staff,11,0,30,19
1650806247165,MATH 10B,B02,083740,Staff,28,0,30,2
1650806253198,MATH 18,A01,083743,Staff,0,0,30,30
1650806253198,MATH 18,A02,083744,Staff,23,0,30,7
1650806253198,MATH 18,A03,083745,Staff,21,0,30,9
1650806253198,MATH 18,A04,083746,Staff,26,0,30,4
1650806253198,MATH 18,B01,083748,Staff,0,15,30,30
1650806253198,MATH 18,B02,083749,Staff,0,12,30,30
1650806253198,MATH 18,B03,083750,Staff,0,12,30,30
1650806253198,MATH 18,B04,083751,Staff,0,12,30,30
1650806259225,MATH 20A,A01,083754,Staff,19,0,40,21
1650806265252,MATH 20B,A01,083756,Staff,0,13,30,30
1650806265252,MATH 20B,A02,083757,Staff,0,12,30,30
1650806271276,MATH 20C,A01,083760,Staff,0,17,30,30
1650806271276,MATH 20C,A02,083761,Staff,0,16,30,30
1650806271276,MATH 20C,B01,083762,Staff,9,0,30,21
1650806271276,MATH 20C,B02,083763,Staff,28,0,30,2
1650806277304,MATH 20D,A01,083765,Staff,2,1,30,28
1650806277304,MATH 20D,A02,083766,Staff,6,0,30,24
1650806277304,MATH 20D,A03,083767,Staff,24,0,30,6
1650806283327,MATH 20E,A01,083771,Staff,2,0,30,28
1650806283327,MATH 20E,A02,083772,Staff,15,0,30,15
1650806283327,MATH 20E,B01,083773,Staff,0,0,30,30
1650806283327,MATH 20E,B02,083774,Staff,5,0,30,25
1650806289351,MATH 103A,A01,083777,Staff,0,16,30,30
1650806289351,MATH 103A,A02,083778,Staff,0,15,30,30
1650806289351,MATH 103A,B01,083779,Staff,0,15,30,30
1650806289351,MATH 103A,B02,083780,Staff,0,15,30,30
1650806295378,MATH 105,A01,085443,Staff,0,22,30,30
1650806301408,MATH 109,A01,083213,Anzaldo; Leesa B,0,7,30,30
1650806301408,MATH 109,A02,083214,Anzaldo; Leesa B,0,7,30,30
1650806301408,MATH 109,B01,083215,Anzaldo; Leesa B,0,8,30,30
1650806301408,MATH 109,B02,083216,Anzaldo; Leesa B,0,7,30,30
1650806307434,MATH 142A,A01,083219,Chow; Bennett,0,16,30,30
1650806307434,MATH 142A,A02,083220,Chow; Bennett,0,15,30,30
1650806307434,MATH 142A,B01,083221,Chow; Bennett,0,16,30,30
1650806307434,MATH 142A,B02,083222,Chow; Bennett,0,14,30,30
1650806313461,MATH 193A,A01,083224,Staff,0,6,30,30
1650806313461,MATH 193A,A02,083225,Staff,0,6,30,30
1650806313461,MATH 193A,A03,083781,Staff,0,6,30,30
1650806313461,MATH 193A,A04,083782,Staff,0,7,30,30
1650806319488,MATH 197,001,091859,McAuley; Julian John,9998,0,9999,1
1650806325561,COGS 9,A01,083615,Staff,0,17,60,60
1650806331588,COGS 11,A01,083617,Boyle; Mary E. T.,16,0,40,24
1650806337613,COGS 13,A01,083071,Staff,0,38,40,40
1650806343637,COGS 14A,A01,092681,Staff,0,36,100,100
1650806349661,COGS 14B,A01,083073,Cheng; Tzu-Han,0,12,50,50
1650806355685,COGS 17,A01,092677,Staff,11,0,75,64
1650806361713,COGS 100,A01,083619,Staff,0,29,60,60
1650806367741,COGS 101A,A01,083621,Davis; Joshua Daniel,0,28,60,60
1650806373771,COGS 101B,A01,091572,Staff,0,3,60,60
1650806379796,COGS 101C,A01,083625,Delgado; Tania,14,0,30,16
1650806385825,COGS 107A,A01,083627,Boyle; Mary E. T.,0,16,60,60
1650806391851,COGS 118A,A01,083075,Staff,0,8,60,60
1650806397878,CSE 3,A50,083646,Miranda; Gregory Joseph,18,0,38,20
1650806397878,CSE 3,A51,083647,Miranda; Gregory Joseph,36,0,37,1
1650806403903,CSE 8A,A50,083650,Miranda; Gregory Joseph,0,29,40,40
1650806409926,CSE 11,A01,083080,Cao; Yingjun,0,96,40,40
1650806415951,CSE 12,A01,083652,Staff,0,21,100,100
1650806421978,CSE 15L,A01,083654,Staff,0,3,50,50
1650806421978,CSE 15L,A02,083655,Staff,0,2,50,50
1650806428006,CSE 20,A01,083657,Staff,49,0,80,31
1650806434033,CSE 30,A01,083084,Eldon; John,0,75,40,40
1650806440059,CSE 100,A01,083659,Cao; Yingjun,0,71,50,50
1650806446083,CSE 134B,A01,083661,Powell; Thomas Allan,0,38,65,65
1650806452109,CSE 140,A01,083663,Staff,0,11,75,75
1650806458134,CSE 140L,A01,083088,Eldon; John,0,20,75,75
1650806464157,CSE 175,A01,083665,Kumar; Rakesh,7,0,25,18
1650806470183,CSE 190,A00,092507,Dubnov; Shlomo,10,0,20,10
1650806476207,ECE 45,A01,083139,Staff,0,1,60,60
1650806482231,ECE 65,A50,083695,Staff,0,5,30,30
1650806488259,ECE 109,A01,091882,Touri; Behrouz,32,0,70,38
1650806494282,ECE 180,A00,083140,Abi Samra; Nicholas Camill,20,0,30,10
1650806494282,ECE 180,B00,083141,Abi Samra; Nicholas Camill,0,0,30,30
1650806500308,MATH 10A,A01,083735,Patchell; Gregory David,2,0,30,28
1650806500308,MATH 10A,A02,083736,Patchell; Gregory David,27,0,30,3
1650806500308,MATH 10A,A03,083737,Patchell; Gregory David,24,0,30,6
1650806506332,MATH 10B,A01,083207,Staff,0,9,30,30
1650806506332,MATH 10B,A02,083208,Staff,0,6,30,30
1650806506332,MATH 10B,B01,083739,Staff,11,0,30,19
1650806506332,MATH 10B,B02,083740,Staff,28,0,30,2
1650806512363,MATH 18,A01,083743,Staff,0,0,30,30
1650806512363,MATH 18,A02,083744,Staff,23,0,30,7
1650806512363,MATH 18,A03,083745,Staff,21,0,30,9
1650806512363,MATH 18,A04,083746,Staff,26,0,30,4
1650806512363,MATH 18,B01,083748,Staff,0,15,30,30
1650806512363,MATH 18,B02,083749,Staff,0,12,30,30
1650806512363,MATH 18,B03,083750,Staff,0,12,30,30
1650806512363,MATH 18,B04,083751,Staff,0,12,30,30
1650806518388,MATH 20A,A01,083754,Staff,19,0,40,21
1650806524514,MATH 20B,A01,083756,Staff,0,13,30,30
1650806524514,MATH 20B,A02,083757,Staff,0,12,30,30
1650806530541,MATH 20C,A01,083760,Staff,0,17,30,30
1650806530541,MATH 20C,A02,083761,Staff,0,16,30,30
1650806530541,MATH 20C,B01,083762,Staff,9,0,30,21
1650806530541,MATH 20C,B02,083763,Staff,28,0,30,2
1650806536565,MATH 20D,A01,083765,Staff,2,1,30,28
1650806536565,MATH 20D,A02,083766,Staff,6,0,30,24
1650806536565,MATH 20D,A03,083767,Staff,24,0,30,6
1650806542590,MATH 20E,A01,083771,Staff,2,0,30,28
1650806542590,MATH 20E,A02,083772,Staff,15,0,30,15
1650806542590,MATH 20E,B01,083773,Staff,0,0,30,30
1650806542590,MATH 20E,B02,083774,Staff,5,0,30,25
1650806548616,MATH 103A,A01,083777,Staff,0,16,30,30
1650806548616,MATH 103A,A02,083778,Staff,0,15,30,30
1650806548616,MATH 103A,B01,083779,Staff,0,15,30,30
1650806548616,MATH 103A,B02,083780,Staff,0,15,30,30
1650806554638,MATH 105,A01,085443,Staff,0,22,30,30
1650806560667,MATH 109,A01,083213,Anzaldo; Leesa B,0,7,30,30
1650806560667,MATH 109,A02,083214,Anzaldo; Leesa B,0,7,30,30
1650806560667,MATH 109,B01,083215,Anzaldo; Leesa B,0,8,30,30
1650806560667,MATH 109,B02,083216,Anzaldo; Leesa B,0,7,30,30
1650806566689,MATH 142A,A01,083219,Chow; Bennett,0,16,30,30
1650806566689,MATH 142A,A02,083220,Chow; Bennett,0,15,30,30
1650806566689,MATH 142A,B01,083221,Chow; Bennett,0,16,30,30
1650806566689,MATH 142A,B02,083222,Chow; Bennett,0,14,30,30
1650806572718,MATH 193A,A01,083224,Staff,0,6,30,30
1650806572718,MATH 193A,A02,083225,Staff,0,6,30,30
1650806572718,MATH 193A,A03,083781,Staff,0,6,30,30
1650806572718,MATH 193A,A04,083782,Staff,0,7,30,30
1650806578741,MATH 197,001,091859,McAuley; Julian John,9998,0,9999,1
1650806584810,COGS 9,A01,083615,Staff,0,17,60,60
1650806590835,COGS 11,A01,083617,Boyle; Mary E. T.,16,0,40,24
1650806596858,COGS 13,A01,083071,Staff,0,38,40,40
1650806602885,COGS 14A,A01,092681,Staff,0,36,100,100
1650806608909,COGS 14B,A01,083073,Cheng; Tzu-Han,0,12,50,50
1650806614936,COGS 17,A01,092677,Staff,11,0,75,64
1650806620962,COGS 100,A01,083619,Staff,0,29,60,60
1650806626986,COGS 101A,A01,083621,Davis; Joshua Daniel,0,28,60,60
1650806633014,COGS 101B,A01,091572,Staff,0,3,60,60
1650806639041,COGS 101C,A01,083625,Delgado; Tania,14,0,30,16
1650806645064,COGS 107A,A01,083627,Boyle; Mary E. T.,0,16,60,60
1650806651090,COGS 118A,A01,083075,Staff,0,8,60,60
1650806657115,CSE 3,A50,083646,Miranda; Gregory Joseph,18,0,38,20
1650806657115,CSE 3,A51,083647,Miranda; Gregory Joseph,36,0,37,1
1650806663143,CSE 8A,A50,083650,Miranda; Gregory Joseph,0,29,40,40
1650806669167,CSE 11,A01,083080,Cao; Yingjun,0,96,40,40
1650806675196,CSE 12,A01,083652,Staff,0,21,100,100
1650806681227,CSE 15L,A01,083654,Staff,0,3,50,50
1650806681227,CSE 15L,A02,083655,Staff,0,2,50,50
1650806687250,CSE 20,A01,083657,Staff,49,0,80,31
1650806693273,CSE 30,A01,083084,Eldon; John,0,75,40,40
1650806699295,CSE 100,A01,083659,Cao; Yingjun,0,71,50,50
1650806705326,CSE 134B,A01,083661,Powell; Thomas Allan,0,38,65,65
1650806711351,CSE 140,A01,083663,Staff,0,11,75,75
1650806717377,CSE 140L,A01,083088,Eldon; John,0,20,75,75
1650806723403,CSE 175,A01,083665,Kumar; Rakesh,7,0,25,18
1650806729428,CSE 190,A00,092507,Dubnov; Shlomo,10,0,20,10
1650806735460,ECE 45,A01,083139,Staff,0,1,60,60
1650806741482,ECE 65,A50,083695,Staff,0,5,30,30
1650806747506,ECE 109,A01,091882,Touri; Behrouz,32,0,70,38
1650806753530,ECE 180,A00,083140,Abi Samra; Nicholas Camill,20,0,30,10
1650806753530,ECE 180,B00,083141,Abi Samra; Nicholas Camill,0,0,30,30
1650806759553,MATH 10A,A01,083735,Patchell; Gregory David,2,0,30,28
1650806759553,MATH 10A,A02,083736,Patchell; Gregory David,27,0,30,3
1650806759553,MATH 10A,A03,083737,Patchell; Gregory David,24,0,30,6
1650806765576,MATH 10B,A01,083207,Staff,0,9,30,30
1650806765576,MATH 10B,A02,083208,Staff,0,6,30,30
1650806765576,MATH 10B,B01,083739,Staff,11,0,30,19
1650806765576,MATH 10B,B02,083740,Staff,28,0,30,2
1650806771605,MATH 18,A01,083743,Staff,0,0,30,30
1650806771605,MATH 18,A02,083744,Staff,23,0,30,7
1650806771605,MATH 18,A03,083745,Staff,21,0,30,9
1650806771605,MATH 18,A04,083746,Staff,26,0,30,4
1650806771605,MATH 18,B01,083748,Staff,0,15,30,30
1650806771605,MATH 18,B02,083749,Staff,0,12,30,30
1650806771605,MATH 18,B03,083750,Staff,0,12,30,30
1650806771605,MATH 18,B04,083751,Staff,0,12,30,30
1650806777628,MATH 20A,A01,083754,Staff,19,0,40,21
1650806783652,MATH 20B,A01,083756,Staff,0,13,30,30
1650806783652,MATH 20B,A02,083757,Staff,0,12,30,30
1650806789677,MATH 20C,A01,083760,Staff,0,17,30,30
1650806789677,MATH 20C,A02,083761,Staff,0,16,30,30
1650806789677,MATH 20C,B01,083762,Staff,9,0,30,21
1650806789677,MATH 20C,B02,083763,Staff,28,0,30,2
1650806795709,MATH 20D,A01,083765,Staff,2,1,30,28
1650806795709,MATH 20D,A02,083766,Staff,6,0,30,24
1650806795709,MATH 20D,A03,083767,Staff,24,0,30,6
1650806801732,MATH 20E,A01,083771,Staff,2,0,30,28
1650806801732,MATH 20E,A02,083772,Staff,15,0,30,15
1650806801732,MATH 20E,B01,083773,Staff,0,0,30,30
1650806801732,MATH 20E,B02,083774,Staff,5,0,30,25
1650806807761,MATH 103A,A01,083777,Staff,0,16,30,30
1650806807761,MATH 103A,A02,083778,Staff,0,15,30,30
1650806807761,MATH 103A,B01,083779,Staff,0,15,30,30
1650806807761,MATH 103A,B02,083780,Staff,0,15,30,30
1650806813784,MATH 105,A01,085443,Staff,0,22,30,30
1650806819809,MATH 109,A01,083213,Anzaldo; Leesa B,0,7,30,30
1650806819809,MATH 109,A02,083214,Anzaldo; Leesa B,0,7,30,30
1650806819809,MATH 109,B01,083215,Anzaldo; Leesa B,0,8,30,30
1650806819809,MATH 109,B02,083216,Anzaldo; Leesa B,0,7,30,30
1650806825834,MATH 142A,A01,083219,Chow; Bennett,0,16,30,30
1650806825834,MATH 142A,A02,083220,Chow; Bennett,0,15,30,30
1650806825834,MATH 142A,B01,083221,Chow; Bennett,0,16,30,30
1650806825834,MATH 142A,B02,083222,Chow; Bennett,0,14,30,30
1650806831858,MATH 193A,A01,083224,Staff,0,6,30,30
1650806831858,MATH 193A,A02,083225,Staff,0,6,30,30
1650806831858,MATH 193A,A03,083781,Staff,0,6,30,30
1650806831858,MATH 193A,A04,083782,Staff,0,7,30,30
1650806837882,MATH 197,001,091859,McAuley; Julian John,9998,0,9999,1
1650806843940,COGS 9,A01,083615,Staff,0,17,60,60
1650806849965,COGS 11,A01,083617,Boyle; Mary E. T.,16,0,40,24
1650806855990,COGS 13,A01,083071,Staff,0,38,40,40
1650806862012,COGS 14A,A01,092681,Staff,0,36,100,100
1650806868036,COGS 14B,A01,083073,Cheng; Tzu-Han,0,12,50,50
1650806874062,COGS 17,A01,092677,Staff,11,0,75,64
1650806880086,COGS 100,A01,083619,Staff,0,29,60,60
1650806886110,COGS 101A,A01,083621,Davis; Joshua Daniel,0,28,60,60
1650806892138,COGS 101B,A01,091572,Staff,0,3,60,60
1650806898162,COGS 101C,A01,083625,Delgado; Tania,14,0,30,16
1650806904189,COGS 107A,A01,083627,Boyle; Mary E. T.,0,16,60,60
1650806910215,COGS 118A,A01,083075,Staff,0,8,60,60
1650806916240,CSE 3,A50,083646,Miranda; Gregory Joseph,18,0,38,20
1650806916240,CSE 3,A51,083647,Miranda; Gregory Joseph,36,0,37,1
1650806922264,CSE 8A,A50,083650,Miranda; Gregory Joseph,0,29,40,40
1650806928294,CSE 11,A01,083080,Cao; Yingjun,0,96,40,40
1650806934325,CSE 12,A01,083652,Staff,0,21,100,100
1650806940351,CSE 15L,A01,083654,Staff,0,3,50,50
1650806940351,CSE 15L,A02,083655,Staff,0,2,50,50
1650806946375,CSE 20,A01,083657,Staff,49,0,80,31
1650806952406,CSE 30,A01,083084,Eldon; John,0,75,40,40
1650806958430,CSE 100,A01,083659,Cao; Yingjun,0,71,50,50
1650806964456,CSE 134B,A01,083661,Powell; Thomas Allan,0,38,65,65
1650806970478,CSE 140,A01,083663,Staff,0,11,75,75
1650806976505,CSE 140L,A01,083088,Eldon; John,0,20,75,75
1650806982530,CSE 175,A01,083665,Kumar; Rakesh,7,0,25,18
1650806988557,CSE 190,A00,092507,Dubnov; Shlomo,10,0,20,10
1650806994580,ECE 45,A01,083139,Staff,0,1,60,60
1650807000610,ECE 65,A50,083695,Staff,0,5,30,30
1650807006634,ECE 109,A01,091882,Touri; Behrouz,32,0,70,38
1650807012658,ECE 180,A00,083140,Abi Samra; Nicholas Camill,20,0,30,10
1650807012658,ECE 180,B00,083141,Abi Samra; Nicholas Camill,0,0,30,30
1650807018681,MATH 10A,A01,083735,Patchell; Gregory David,2,0,30,28
1650807018681,MATH 10A,A02,083736,Patchell; Gregory David,27,0,30,3
1650807018681,MATH 10A,A03,083737,Patchell; Gregory David,24,0,30,6
1650807024704,MATH 10B,A01,083207,Staff,0,9,30,30
1650807024704,MATH 10B,A02,083208,Staff,0,6,30,30
1650807024704,MATH 10B,B01,083739,Staff,11,0,30,19
1650807024704,MATH 10B,B02,083740,Staff,28,0,30,2
1650807033056,MATH 18,A01,083743,Staff,0,0,30,30
1650807033056,MATH 18,A02,083744,Staff,23,0,30,7
1650807033056,MATH 18,A03,083745,Staff,21,0,30,9
1650807033056,MATH 18,A04,083746,Staff,26,0,30,4
1650807033056,MATH 18,B01,083748,Staff,0,15,30,30
1650807033056,MATH 18,B02,083749,Staff,0,12,30,30
1650807033056,MATH 18,B03,083750,Staff,0,12,30,30
1650807033056,MATH 18,B04,083751,Staff,0,12,30,30
1650807039082,MATH 20A,A01,083754,Staff,19,0,40,21
1650807045110,MATH 20B,A01,083756,Staff,0,13,30,30
1650807045110,MATH 20B,A02,083757,Staff,0,12,30,30
1650807051134,MATH 20C,A01,083760,Staff,0,17,30,30
1650807051134,MATH 20C,A02,083761,Staff,0,16,30,30
1650807051134,MATH 20C,B01,083762,Staff,9,0,30,21
1650807051134,MATH 20C,B02,083763,Staff,28,0,30,2
1650807057159,MATH 20D,A01,083765,Staff,2,1,30,28
1650807057159,MATH 20D,A02,083766,Staff,6,0,30,24
1650807057159,MATH 20D,A03,083767,Staff,24,0,30,6
1650807063182,MATH 20E,A01,083771,Staff,2,0,30,28
1650807063182,MATH 20E,A02,083772,Staff,15,0,30,15
1650807063182,MATH 20E,B01,083773,Staff,0,0,30,30
1650807063182,MATH 20E,B02,083774,Staff,5,0,30,25
1650807069206,MATH 103A,A01,083777,Staff,0,16,30,30
1650807069206,MATH 103A,A02,083778,Staff,0,15,30,30
1650807069206,MATH 103A,B01,083779,Staff,0,15,30,30
1650807069206,MATH 103A,B02,083780,Staff,0,15,30,30
1650807075229,MATH 105,A01,085443,Staff,0,22,30,30
1650807081256,MATH 109,A01,083213,Anzaldo; Leesa B,0,7,30,30
1650807081256,MATH 109,A02,083214,Anzaldo; Leesa B,0,7,30,30
1650807081256,MATH 109,B01,083215,Anzaldo; Leesa B,0,8,30,30
1650807081256,MATH 109,B02,083216,Anzaldo; Leesa B,0,7,30,30
1650807087279,MATH 142A,A01,083219,Chow; Bennett,0,16,30,30
1650807087279,MATH 142A,A02,083220,Chow; Bennett,0,15,30,30
1650807087279,MATH 142A,B01,083221,Chow; Bennett,0,16,30,30
1650807087279,MATH 142A,B02,083222,Chow; Bennett,0,14,30,30
1650807093301,MATH 193A,A01,083224,Staff,0,6,30,30
1650807093301,MATH 193A,A02,083225,Staff,0,6,30,30
1650807093301,MATH 193A,A03,083781,Staff,0,6,30,30
1650807093301,MATH 193A,A04,083782,Staff,0,7,30,30
1650807099326,MATH 197,001,091859,McAuley; Julian John,9998,0,9999,1
1650807105376,COGS 9,A01,083615,Staff,0,17,60,60
1650807111402,COGS 11,A01,083617,Boyle; Mary E. T.,16,0,40,24
1650807117517,COGS 13,A01,083071,Staff,0,38,40,40
1650807123543,COGS 14A,A01,092681,Staff,0,36,100,100
1650807129570,COGS 14B,A01,083073,Cheng; Tzu-Han,0,12,50,50
1650807135592,COGS 17,A01,092677,Staff,11,0,75,64
1650807141617,COGS 100,A01,083619,Staff,0,29,60,60
1650807147647,COGS 101A,A01,083621,Davis; Joshua Daniel,0,28,60,60
1650807153668,COGS 101B,A01,091572,Staff,0,3,60,60
1650807159691,COGS 101C,A01,083625,Delgado; Tania,14,0,30,16
1650807165718,COGS 107A,A01,083627,Boyle; Mary E. T.,0,16,60,60
1650807171740,COGS 118A,A01,083075,Staff,0,8,60,60
1650807177764,CSE 3,A50,083646,Miranda; Gregory Joseph,18,0,38,20
1650807177764,CSE 3,A51,083647,Miranda; Gregory Joseph,36,0,37,1
1650807183786,CSE 8A,A50,083650,Miranda; Gregory Joseph,0,29,40,40
1650807189808,CSE 11,A01,083080,Cao; Yingjun,0,96,40,40
1650807195833,CSE 12,A01,083652,Staff,0,21,100,100
1650807201859,CSE 15L,A01,083654,Staff,0,3,50,50
1650807201859,CSE 15L,A02,083655,Staff,0,2,50,50
1650807207884,CSE 20,A01,083657,Staff,49,0,80,31
1650807213908,CSE 30,A01,083084,Eldon; John,0,75,40,40
1650807219932,CSE 100,A01,083659,Cao; Yingjun,0,71,50,50
1650807225957,CSE 134B,A01,083661,Powell; Thomas Allan,0,38,65,65
1650807231982,CSE 140,A01,083663,Staff,0,11,75,75
1650807238004,CSE 140L,A01,083088,Eldon; John,0,20,75,75
1650807244026,CSE 175,A01,083665,Kumar; Rakesh,7,0,25,18
1650807250049,CSE 190,A00,092507,Dubnov; Shlomo,10,0,20,10
1650807256073,ECE 45,A01,083139,Staff,0,1,60,60
1650807262099,ECE 65,A50,083695,Staff,0,5,30,30
1650807268124,ECE 109,A01,091882,Touri; Behrouz,32,0,70,38
1650807274148,ECE 180,A00,083140,Abi Samra; Nicholas Camill,20,0,30,10
1650807274148,ECE 180,B00,083141,Abi Samra; Nicholas Camill,0,0,30,30
1650807280171,MATH 10A,A01,083735,Patchell; Gregory David,2,0,30,28
1650807280171,MATH 10A,A02,083736,Patchell; Gregory David,27,0,30,3
1650807280171,MATH 10A,A03,083737,Patchell; Gregory David,24,0,30,6
1650807286194,MATH 10B,A01,083207,Staff,0,9,30,30
1650807286194,MATH 10B,A02,083208,Staff,0,6,30,30
1650807286194,MATH 10B,B01,083739,Staff,11,0,30,19
1650807286194,MATH 10B,B02,083740,Staff,28,0,30,2
1650807292217,MATH 18,A01,083743,Staff,0,0,30,30
1650807292217,MATH 18,A02,083744,Staff,23,0,30,7
1650807292217,MATH 18,A03,083745,Staff,21,0,30,9
1650807292217,MATH 18,A04,083746,Staff,26,0,30,4
1650807292217,MATH 18,B01,083748,Staff,0,15,30,30
1650807292217,MATH 18,B02,083749,Staff,0,12,30,30
1650807292217,MATH 18,B03,083750,Staff,0,12,30,30
1650807292217,MATH 18,B04,083751,Staff,0,12,30,30
1650807298243,MATH 20A,A01,083754,Staff,19,0,40,21
1650807304268,MATH 20B,A01,083756,Staff,0,13,30,30
1650807304268,MATH 20B,A02,083757,Staff,0,12,30,30
1650807310295,MATH 20C,A01,083760,Staff,0,17,30,30
1650807310295,MATH 20C,A02,083761,Staff,0,16,30,30
1650807310295,MATH 20C,B01,083762,Staff,9,0,30,21
1650807310295,MATH 20C,B02,083763,Staff,28,0,30,2
1650807316317,MATH 20D,A01,083765,Staff,2,1,30,28
1650807316317,MATH 20D,A02,083766,Staff,6,0,30,24
1650807316317,MATH 20D,A03,083767,Staff,24,0,30,6
1650807322341,MATH 20E,A01,083771,Staff,2,0,30,28
1650807322341,MATH 20E,A02,083772,Staff,15,0,30,15
1650807322341,MATH 20E,B01,083773,Staff,0,0,30,30
1650807322341,MATH 20E,B02,083774,Staff,5,0,30,25
1650807328363,MATH 103A,A01,083777,Staff,0,16,30,30
1650807328363,MATH 103A,A02,083778,Staff,0,15,30,30
1650807328363,MATH 103A,B01,083779,Staff,0,15,30,30
1650807328363,MATH 103A,B02,083780,Staff,0,15,30,30
1650807334386,MATH 105,A01,085443,Staff,0,22,30,30
1650807340414,MATH 109,A01,083213,Anzaldo; Leesa B,0,7,30,30
1650807340414,MATH 109,A02,083214,Anzaldo; Leesa B,0,7,30,30
1650807340414,MATH 109,B01,083215,Anzaldo; Leesa B,0,8,30,30
1650807340414,MATH 109,B02,083216,Anzaldo; Leesa B,0,7,30,30
1650807346438,MATH 142A,A01,083219,Chow; Bennett,0,16,30,30
1650807346438,MATH 142A,A02,083220,Chow; Bennett,0,15,30,30
1650807346438,MATH 142A,B01,083221,Chow; Bennett,0,16,30,30
1650807346438,MATH 142A,B02,083222,Chow; Bennett,0,14,30,30
1650807352464,MATH 193A,A01,083224,Staff,0,6,30,30
1650807352464,MATH 193A,A02,083225,Staff,0,6,30,30
1650807352464,MATH 193A,A03,083781,Staff,0,6,30,30
1650807352464,MATH 193A,A04,083782,Staff,0,7,30,30
1650807358487,MATH 197,001,091859,McAuley; Julian John,9998,0,9999,1
1650807364547,COGS 9,A01,083615,Staff,0,17,60,60
1650807370574,COGS 11,A01,083617,Boyle; Mary E. T.,16,0,40,24
1650807376597,COGS 13,A01,083071,Staff,0,38,40,40
1650807382620,COGS 14A,A01,092681,Staff,0,36,100,100
1650807388645,COGS 14B,A01,083073,Cheng; Tzu-Han,0,12,50,50
1650807394670,COGS 17,A01,092677,Staff,11,0,75,64
1650807400692,COGS 100,A01,083619,Staff,0,29,60,60
1650807406738,COGS 101A,A01,083621,Davis; Joshua Daniel,0,28,60,60
1650807412763,COGS 101B,A01,091572,Staff,0,3,60,60
1650807418791,COGS 101C,A01,083625,Delgado; Tania,14,0,30,16
1650807424816,COGS 107A,A01,083627,Boyle; Mary E. T.,0,16,60,60
1650807430843,COGS 118A,A01,083075,Staff,0,8,60,60
1650807436867,CSE 3,A50,083646,Miranda; Gregory Joseph,18,0,38,20
1650807436867,CSE 3,A51,083647,Miranda; Gregory Joseph,36,0,37,1
1650807442892,CSE 8A,A50,083650,Miranda; Gregory Joseph,0,29,40,40
1650807448917,CSE 11,A01,083080,Cao; Yingjun,0,96,40,40
1650807454941,CSE 12,A01,083652,Staff,0,21,100,100
1650807460966,CSE 15L,A01,083654,Staff,0,3,50,50
1650807460966,CSE 15L,A02,083655,Staff,0,2,50,50
1650807466992,CSE 20,A01,083657,Staff,49,0,80,31
1650807473016,CSE 30,A01,083084,Eldon; John,0,75,40,40
1650807479040,CSE 100,A01,083659,Cao; Yingjun,0,71,50,50
1650807485063,CSE 134B,A01,083661,Powell; Thomas Allan,0,38,65,65
1650807491089,CSE 140,A01,083663,Staff,0,11,75,75
1650807497112,CSE 140L,A01,083088,Eldon; John,0,20,75,75
1650807503136,CSE 175,A01,083665,Kumar; Rakesh,7,0,25,18
1650807509163,CSE 190,A00,092507,Dubnov; Shlomo,10,0,20,10
1650807515187,ECE 45,A01,083139,Staff,0,1,60,60
1650807521212,ECE 65,A50,083695,Staff,0,5,30,30
1650807527238,ECE 109,A01,091882,Touri; Behrouz,32,0,70,38
1650807533265,ECE 180,A00,083140,Abi Samra; Nicholas Camill,20,0,30,10
1650807533265,ECE 180,B00,083141,Abi Samra; Nicholas Camill,0,0,30,30
1650807539290,MATH 10A,A01,083735,Patchell; Gregory David,2,0,30,28
1650807539290,MATH 10A,A02,083736,Patchell; Gregory David,27,0,30,3
1650807539290,MATH 10A,A03,083737,Patchell; Gregory David,24,0,30,6
1650807545313,MATH 10B,A01,083207,Staff,0,9,30,30
1650807545313,MATH 10B,A02,083208,Staff,0,6,30,30
1650807545313,MATH 10B,B01,083739,Staff,11,0,30,19
1650807545313,MATH 10B,B02,083740,Staff,28,0,30,2
1650807551343,MATH 18,A01,083743,Staff,0,0,30,30
1650807551343,MATH 18,A02,083744,Staff,23,0,30,7
1650807551343,MATH 18,A03,083745,Staff,21,0,30,9
1650807551343,MATH 18,A04,083746,Staff,26,0,30,4
1650807551343,MATH 18,B01,083748,Staff,0,15,30,30
1650807551343,MATH 18,B02,083749,Staff,0,12,30,30
1650807551343,MATH 18,B03,083750,Staff,0,12,30,30
1650807551343,MATH 18,B04,083751,Staff,0,12,30,30
1650807557367,MATH 20A,A01,083754,Staff,19,0,40,21
1650807563389,MATH 20B,A01,083756,Staff,0,13,30,30
1650807563389,MATH 20B,A02,083757,Staff,0,12,30,30
1650807569418,MATH 20C,A01,083760,Staff,0,17,30,30
1650807569418,MATH 20C,A02,083761,Staff,0,16,30,30
1650807569418,MATH 20C,B01,083762,Staff,9,0,30,21
1650807569418,MATH 20C,B02,083763,Staff,28,0,30,2
1650807575444,MATH 20D,A01,083765,Staff,2,1,30,28
1650807575444,MATH 20D,A02,083766,Staff,6,0,30,24
1650807575444,MATH 20D,A03,083767,Staff,24,0,30,6
1650807581471,MATH 20E,A01,083771,Staff,2,0,30,28
1650807581471,MATH 20E,A02,083772,Staff,15,0,30,15
1650807581471,MATH 20E,B01,083773,Staff,0,0,30,30
1650807581471,MATH 20E,B02,083774,Staff,5,0,30,25
1650807587503,MATH 103A,A01,083777,Staff,0,16,30,30
1650807587503,MATH 103A,A02,083778,Staff,0,15,30,30
1650807587503,MATH 103A,B01,083779,Staff,0,15,30,30
1650807587503,MATH 103A,B02,083780,Staff,0,15,30,30
1650807593526,MATH 105,A01,085443,Staff,0,22,30,30
1650807599565,MATH 109,A01,083213,Anzaldo; Leesa B,0,7,30,30
1650807599565,MATH 109,A02,083214,Anzaldo; Leesa B,0,7,30,30
1650807599565,MATH 109,B01,083215,Anzaldo; Leesa B,0,8,30,30
1650807599565,MATH 109,B02,083216,Anzaldo; Leesa B,0,7,30,30
1650807605594,MATH 142A,A01,083219,Chow; Bennett,0,16,30,30
1650807605594,MATH 142A,A02,083220,Chow; Bennett,0,15,30,30
1650807605594,MATH 142A,B01,083221,Chow; Bennett,0,16,30,30
1650807605594,MATH 142A,B02,083222,Chow; Bennett,0,14,30,30
1650807611620,MATH 193A,A01,083224,Staff,0,6,30,30
1650807611620,MATH 193A,A02,083225,Staff,0,6,30,30
1650807611620,MATH 193A,A03,083781,Staff,0,6,30,30
1650807611620,MATH 193A,A04,083782,Staff,0,7,30,30
1650807617644,MATH 197,001,091859,McAuley; Julian John,9998,0,9999,1
1650807623699,COGS 9,A01,083615,Staff,0,17,60,60
1650807629723,COGS 11,A01,083617,Boyle; Mary E. T.,16,0,40,24
1650807635748,COGS 13,A01,083071,Staff,0,38,40,40
1650807641772,COGS 14A,A01,092681,Staff,0,36,100,100
1650807647796,COGS 14B,A01,083073,Cheng; Tzu-Han,0,12,50,50
1650807653828,COGS 17,A01,092677,Staff,11,0,75,64
1650807659852,COGS 100,A01,083619,Staff,0,29,60,60
1650807665876,COGS 101A,A01,083621,Davis; Joshua Daniel,0,28,60,60
1650807671907,COGS 101B,A01,091572,Staff,0,3,60,60
1650807677930,COGS 101C,A01,083625,Delgado; Tania,14,0,30,16
1650807683957,COGS 107A,A01,083627,Boyle; Mary E. T.,0,16,60,60
1650807689988,COGS 118A,A01,083075,Staff,0,8,60,60
1650807696018,CSE 3,A50,083646,Miranda; Gregory Joseph,18,0,38,20
1650807696018,CSE 3,A51,083647,Miranda; Gregory Joseph,36,0,37,1
1650807702041,CSE 8A,A50,083650,Miranda; Gregory Joseph,0,29,40,40
1650807708069,CSE 11,A01,083080,Cao; Yingjun,0,96,40,40
1650807714194,CSE 12,A01,083652,Staff,0,21,100,100
1650807720216,CSE 15L,A01,083654,Staff,0,3,50,50
1650807720216,CSE 15L,A02,083655,Staff,0,2,50,50
1650807726242,CSE 20,A01,083657,Staff,49,0,80,31
1650807732266,CSE 30,A01,083084,Eldon; John,0,75,40,40
1650807738290,CSE 100,A01,083659,Cao; Yingjun,0,71,50,50
1650807744315,CSE 134B,A01,083661,Powell; Thomas Allan,0,38,65,65
1650807750343,CSE 140,A01,083663,Staff,0,11,75,75
1650807756367,CSE 140L,A01,083088,Eldon; John,0,20,75,75
1650807762393,CSE 175,A01,083665,Kumar; Rakesh,7,0,25,18
1650807768420,CSE 190,A00,092507,Dubnov; Shlomo,10,0,20,10
1650807774446,ECE 45,A01,083139,Staff,0,1,60,60
1650807780474,ECE 65,A50,083695,Staff,0,5,30,30
1650807786498,ECE 109,A01,091882,Touri; Behrouz,32,0,70,38
1650807792523,ECE 180,A00,083140,Abi Samra; Nicholas Camill,20,0,30,10
1650807792523,ECE 180,B00,083141,Abi Samra; Nicholas Camill,0,0,30,30
1650807798548,MATH 10A,A01,083735,Patchell; Gregory David,2,0,30,28
1650807798548,MATH 10A,A02,083736,Patchell; Gregory David,27,0,30,3
1650807798548,MATH 10A,A03,083737,Patchell; Gregory David,24,0,30,6
1650807804572,MATH 10B,A01,083207,Staff,0,9,30,30
1650807804572,MATH 10B,A02,083208,Staff,0,6,30,30
1650807804572,MATH 10B,B01,083739,Staff,11,0,30,19
1650807804572,MATH 10B,B02,083740,Staff,28,0,30,2
1650807810603,MATH 18,A01,083743,Staff,0,0,30,30
1650807810603,MATH 18,A02,083744,Staff,23,0,30,7
1650807810603,MATH 18,A03,083745,Staff,21,0,30,9
1650807810603,MATH 18,A04,083746,Staff,26,0,30,4
1650807810603,MATH 18,B01,083748,Staff,0,15,30,30
1650807810603,MATH 18,B02,083749,Staff,0,12,30,30
1650807810603,MATH 18,B03,083750,Staff,0,12,30,30
1650807810603,MATH 18,B04,083751,Staff,0,12,30,30
1650807816629,MATH 20A,A01,083754,Staff,19,0,40,21
1650807822656,MATH 20B,A01,083756,Staff,0,13,30,30
1650807822656,MATH 20B,A02,083757,Staff,0,12,30,30
1650807828678,MATH 20C,A01,083760,Staff,0,17,30,30
1650807828678,MATH 20C,A02,083761,Staff,0,16,30,30
1650807828678,MATH 20C,B01,083762,Staff,9,0,30,21
1650807828678,MATH 20C,B02,083763,Staff,28,0,30,2
1650807834703,MATH 20D,A01,083765,Staff,2,1,30,28
1650807834703,MATH 20D,A02,083766,Staff,6,0,30,24
1650807834703,MATH 20D,A03,083767,Staff,24,0,30,6
1650807840726,MATH 20E,A01,083771,Staff,2,0,30,28
1650807840726,MATH 20E,A02,083772,Staff,15,0,30,15
1650807840726,MATH 20E,B01,083773,Staff,0,0,30,30
1650807840726,MATH 20E,B02,083774,Staff,5,0,30,25
1650807846750,MATH 103A,A01,083777,Staff,0,16,30,30
1650807846750,MATH 103A,A02,083778,Staff,0,15,30,30
1650807846750,MATH 103A,B01,083779,Staff,0,15,30,30
1650807846750,MATH 103A,B02,083780,Staff,0,15,30,30
1650807852779,MATH 105,A01,085443,Staff,0,22,30,30
1650807858806,MATH 109,A01,083213,Anzaldo; Leesa B,0,7,30,30
1650807858806,MATH 109,A02,083214,Anzaldo; Leesa B,0,7,30,30
1650807858806,MATH 109,B01,083215,Anzaldo; Leesa B,0,8,30,30
1650807858806,MATH 109,B02,083216,Anzaldo; Leesa B,0,7,30,30
1650807864834,MATH 142A,A01,083219,Chow; Bennett,0,16,30,30
1650807864834,MATH 142A,A02,083220,Chow; Bennett,0,15,30,30
1650807864834,MATH 142A,B01,083221,Chow; Bennett,0,16,30,30
1650807864834,MATH 142A,B02,083222,Chow; Bennett,0,14,30,30
1650807870859,MATH 193A,A01,083224,Staff,0,6,30,30
1650807870859,MATH 193A,A02,083225,Staff,0,6,30,30
1650807870859,MATH 193A,A03,083781,Staff,0,6,30,30
1650807870859,MATH 193A,A04,083782,Staff,0,7,30,30
1650807876886,MATH 197,001,091859,McAuley; Julian John,9998,0,9999,1
1650807882936,COGS 9,A01,083615,Staff,0,17,60,60
1650807888961,COGS 11,A01,083617,Boyle; Mary E. T.,16,0,40,24
1650807894986,COGS 13,A01,083071,Staff,0,38,40,40
1650807901013,COGS 14A,A01,092681,Staff,0,36,100,100
1650807907042,COGS 14B,A01,083073,Cheng; Tzu-Han,0,12,50,50
1650807913069,COGS 17,A01,092677,Staff,11,0,75,64
1650807919091,COGS 100,A01,083619,Staff,0,29,60,60
1650807925119,COGS 101A,A01,083621,Davis; Joshua Daniel,0,28,60,60
1650807931145,COGS 101B,A01,091572,Staff,0,3,60,60
1650807937170,COGS 101C,A01,083625,Delgado; Tania,14,0,30,16
1650807943192,COGS 107A,A01,083627,Boyle; Mary E. T.,0,16,60,60
1650807949216,COGS 118A,A01,083075,Staff,0,8,60,60
1650807955239,CSE 3,A50,083646,Miranda; Gregory Joseph,18,0,38,20
1650807955239,CSE 3,A51,083647,Miranda; Gregory Joseph,36,0,37,1
1650807961266,CSE 8A,A50,083650,Miranda; Gregory Joseph,0,29,40,40
1650807967290,CSE 11,A01,083080,Cao; Yingjun,0,96,40,40
1650807973316,CSE 12,A01,083652,Staff,0,21,100,100
1650807979343,CSE 15L,A01,083654,Staff,0,3,50,50
1650807979343,CSE 15L,A02,083655,Staff,0,2,50,50
1650807985366,CSE 20,A01,083657,Staff,49,0,80,31
1650807991389,CSE 30,A01,083084,Eldon; John,0,75,40,40
1650807997413,CSE 100,A01,083659,Cao; Yingjun,0,71,50,50
1650808003440,CSE 134B,A01,083661,Powell; Thomas Allan,0,38,65,65
1650808009463,CSE 140,A01,083663,Staff,0,11,75,75
1650808015491,CSE 140L,A01,083088,Eldon; John,0,20,75,75
1650808021520,CSE 175,A01,083665,Kumar; Rakesh,7,0,25,18
1650808027547,CSE 190,A00,092507,Dubnov; Shlomo,10,0,20,10
1650808033571,ECE 45,A01,083139,Staff,0,1,60,60
1650808039599,ECE 65,A50,083695,Staff,0,5,30,30
1650808045622,ECE 109,A01,091882,Touri; Behrouz,32,0,70,38
1650808051646,ECE 180,A00,083140,Abi Samra; Nicholas Camill,20,0,30,10
1650808051646,ECE 180,B00,083141,Abi Samra; Nicholas Camill,0,0,30,30
1650808057671,MATH 10A,A01,083735,Patchell; Gregory David,2,0,30,28
1650808057671,MATH 10A,A02,083736,Patchell; Gregory David,27,0,30,3
1650808057671,MATH 10A,A03,083737,Patchell; Gregory David,24,0,30,6
1650808063710,MATH 10B,A01,083207,Staff,0,9,30,30
1650808063710,MATH 10B,A02,083208,Staff,0,6,30,30
1650808063710,MATH 10B,B01,083739,Staff,11,0,30,19
1650808063710,MATH 10B,B02,083740,Staff,28,0,30,2
1650808069741,MATH 18,A01,083743,Staff,0,0,30,30
1650808069741,MATH 18,A02,083744,Staff,23,0,30,7
1650808069741,MATH 18,A03,083745,Staff,21,0,30,9
1650808069741,MATH 18,A04,083746,Staff,26,0,30,4
1650808069741,MATH 18,B01,083748,Staff,0,15,30,30
1650808069741,MATH 18,B02,083749,Staff,0,12,30,30
1650808069741,MATH 18,B03,083750,Staff,0,12,30,30
1650808069741,MATH 18,B04,083751,Staff,0,12,30,30
1650808075766,MATH 20A,A01,083754,Staff,19,0,40,21
1650808081790,MATH 20B,A01,083756,Staff,0,13,30,30
1650808081790,MATH 20B,A02,083757,Staff,0,12,30,30
1650808087814,MATH 20C,A01,083760,Staff,0,17,30,30
1650808087814,MATH 20C,A02,083761,Staff,0,16,30,30
1650808087814,MATH 20C,B01,083762,Staff,9,0,30,21
1650808087814,MATH 20C,B02,083763,Staff,28,0,30,2
1650808093837,MATH 20D,A01,083765,Staff,2,1,30,28
1650808093837,MATH 20D,A02,083766,Staff,6,0,30,24
1650808093837,MATH 20D,A03,083767,Staff,24,0,30,6
1650808099862,MATH 20E,A01,083771,Staff,2,0,30,28
1650808099862,MATH 20E,A02,083772,Staff,15,0,30,15
1650808099862,MATH 20E,B01,083773,Staff,0,0,30,30
1650808099862,MATH 20E,B02,083774,Staff,5,0,30,25
1650808105890,MATH 103A,A01,083777,Staff,0,16,30,30
1650808105890,MATH 103A,A02,083778,Staff,0,15,30,30
1650808105890,MATH 103A,B01,083779,Staff,0,15,30,30
1650808105890,MATH 103A,B02,083780,Staff,0,15,30,30
1650808111917,MATH 105,A01,085443,Staff,0,22,30,30
1650808117940,MATH 109,A01,083213,Anzaldo; Leesa B,0,7,30,30
1650808117940,MATH 109,A02,083214,Anzaldo; Leesa B,0,7,30,30
1650808117940,MATH 109,B01,083215,Anzaldo; Leesa B,0,8,30,30
1650808117940,MATH 109,B02,083216,Anzaldo; Leesa B,0,7,30,30
1650808123971,MATH 142A,A01,083219,Chow; Bennett,0,16,30,30
1650808123971,MATH 142A,A02,083220,Chow; Bennett,0,15,30,30
1650808123971,MATH 142A,B01,083221,Chow; Bennett,0,16,30,30
1650808123971,MATH 142A,B02,083222,Chow; Bennett,0,14,30,30
1650808129999,MATH 193A,A01,083224,Staff,0,6,30,30
1650808129999,MATH 193A,A02,083225,Staff,0,6,30,30
1650808129999,MATH 193A,A03,083781,Staff,0,6,30,30
1650808129999,MATH 193A,A04,083782,Staff,0,7,30,30
1650808136022,MATH 197,001,091859,McAuley; Julian John,9998,0,9999,1
1650808142083,COGS 9,A01,083615,Staff,0,17,60,60
1650808148108,COGS 11,A01,083617,Boyle; Mary E. T.,16,0,40,24
1650808154132,COGS 13,A01,083071,Staff,0,38,40,40
1650808160157,COGS 14A,A01,092681,Staff,0,36,100,100
1650808166180,COGS 14B,A01,083073,Cheng; Tzu-Han,0,12,50,50
1650808172204,COGS 17,A01,092677,Staff,11,0,75,64
1650808178229,COGS 100,A01,083619,Staff,0,29,60,60
1650808184267,COGS 101A,A01,083621,Davis; Joshua Daniel,0,28,60,60
1650808190294,COGS 101B,A01,091572,Staff,0,3,60,60
1650808196317,COGS 101C,A01,083625,Delgado; Tania,14,0,30,16
1650808202347,COGS 107A,A01,083627,Boyle; Mary E. T.,0,16,60,60
1650808208369,COGS 118A,A01,083075,Staff,0,8,60,60
1650808214396,CSE 3,A50,083646,Miranda; Gregory Joseph,18,0,38,20
1650808214396,CSE 3,A51,083647,Miranda; Gregory Joseph,36,0,37,1
1650808220424,CSE 8A,A50,083650,Miranda; Gregory Joseph,0,29,40,40
1650808226450,CSE 11,A01,083080,Cao; Yingjun,0,96,40,40
1650808232477,CSE 12,A01,083652,Staff,0,21,100,100
1650808238505,CSE 15L,A01,083654,Staff,0,3,50,50
1650808238505,CSE 15L,A02,083655,Staff,0,2,50,50
1650808244531,CSE 20,A01,083657,Staff,49,0,80,31
1650808250556,CSE 30,A01,083084,Eldon; John,0,75,40,40
1650808256582,CSE 100,A01,083659,Cao; Yingjun,0,71,50,50
1650808262605,CSE 134B,A01,083661,Powell; Thomas Allan,0,38,65,65
1650808268632,CSE 140,A01,083663,Staff,0,11,75,75
1650808274656,CSE 140L,A01,083088,Eldon; John,0,20,75,75
1650808280682,CSE 175,A01,083665,Kumar; Rakesh,7,0,25,18
1650808286705,CSE 190,A00,092507,Dubnov; Shlomo,10,0,20,10
1650808292732,ECE 45,A01,083139,Staff,0,1,60,60
1650808298757,ECE 65,A50,083695,Staff,0,5,30,30
1650808304783,ECE 109,A01,091882,Touri; Behrouz,32,0,70,38
1650808310896,ECE 180,A00,083140,Abi Samra; Nicholas Camill,20,0,30,10
1650808310896,ECE 180,B00,083141,Abi Samra; Nicholas Camill,0,0,30,30
1650808316929,MATH 10A,A01,083735,Patchell; Gregory David,2,0,30,28
1650808316929,MATH 10A,A02,083736,Patchell; Gregory David,27,0,30,3
1650808316929,MATH 10A,A03,083737,Patchell; Gregory David,24,0,30,6
1650808322955,MATH 10B,A01,083207,Staff,0,9,30,30
1650808322955,MATH 10B,A02,083208,Staff,0,6,30,30
1650808322955,MATH 10B,B01,083739,Staff,11,0,30,19
1650808322955,MATH 10B,B02,083740,Staff,28,0,30,2
1650808328986,MATH 18,A01,083743,Staff,0,0,30,30
1650808328986,MATH 18,A02,083744,Staff,23,0,30,7
1650808328986,MATH 18,A03,083745,Staff,21,0,30,9
1650808328986,MATH 18,A04,083746,Staff,26,0,30,4
1650808328986,MATH 18,B01,083748,Staff,0,15,30,30
1650808328986,MATH 18,B02,083749,Staff,0,12,30,30
1650808328986,MATH 18,B03,083750,Staff,0,12,30,30
1650808328986,MATH 18,B04,083751,Staff,0,12,30,30
1650808335013,MATH 20A,A01,083754,Staff,19,0,40,21
1650808341040,MATH 20B,A01,083756,Staff,0,13,30,30
1650808341040,MATH 20B,A02,083757,Staff,0,12,30,30
1650808347065,MATH 20C,A01,083760,Staff,0,17,30,30
1650808347065,MATH 20C,A02,083761,Staff,0,16,30,30
1650808347065,MATH 20C,B01,083762,Staff,9,0,30,21
1650808347065,MATH 20C,B02,083763,Staff,28,0,30,2
1650808353093,MATH 20D,A01,083765,Staff,2,1,30,28
1650808353093,MATH 20D,A02,083766,Staff,6,0,30,24
1650808353093,MATH 20D,A03,083767,Staff,24,0,30,6
1650808359118,MATH 20E,A01,083771,Staff,2,0,30,28
1650808359118,MATH 20E,A02,083772,Staff,15,0,30,15
1650808359118,MATH 20E,B01,083773,Staff,0,0,30,30
1650808359118,MATH 20E,B02,083774,Staff,5,0,30,25
1650808365146,MATH 103A,A01,083777,Staff,0,16,30,30
1650808365146,MATH 103A,A02,083778,Staff,0,15,30,30
1650808365146,MATH 103A,B01,083779,Staff,0,15,30,30
1650808365146,MATH 103A,B02,083780,Staff,0,15,30,30
1650808371173,MATH 105,A01,085443,Staff,0,22,30,30
1650808377200,MATH 109,A01,083213,Anzaldo; Leesa B,0,7,30,30
1650808377200,MATH 109,A02,083214,Anzaldo; Leesa B,0,7,30,30
1650808377200,MATH 109,B01,083215,Anzaldo; Leesa B,0,8,30,30
1650808377200,MATH 109,B02,083216,Anzaldo; Leesa B,0,7,30,30
1650808383224,MATH 142A,A01,083219,Chow; Bennett,0,16,30,30
1650808383224,MATH 142A,A02,083220,Chow; Bennett,0,15,30,30
1650808383224,MATH 142A,B01,083221,Chow; Bennett,0,16,30,30
1650808383224,MATH 142A,B02,083222,Chow; Bennett,0,14,30,30
1650808389248,MATH 193A,A01,083224,Staff,0,6,30,30
1650808389248,MATH 193A,A02,083225,Staff,0,6,30,30
1650808389248,MATH 193A,A03,083781,Staff,0,6,30,30
1650808389248,MATH 193A,A04,083782,Staff,0,7,30,30
1650808395274,MATH 197,001,091859,McAuley; Julian John,9998,0,9999,1
1650808401329,COGS 9,A01,083615,Staff,0,17,60,60
1650808407353,COGS 11,A01,083617,Boyle; Mary E. T.,16,0,40,24
1650808413379,COGS 13,A01,083071,Staff,0,38,40,40
1650808419405,COGS 14A,A01,092681,Staff,0,36,100,100
1650808425426,COGS 14B,A01,083073,Cheng; Tzu-Han,0,12,50,50
1650808431451,COGS 17,A01,092677,Staff,11,0,75,64
1650808437474,COGS 100,A01,083619,Staff,0,29,60,60
1650808443499,COGS 101A,A01,083621,Davis; Joshua Daniel,0,28,60,60
1650808449525,COGS 101B,A01,091572,Staff,0,3,60,60
1650808455558,COGS 101C,A01,083625,Delgado; Tania,14,0,30,16
1650808461582,COGS 107A,A01,083627,Boyle; Mary E. T.,0,16,60,60
1650808467604,COGS 118A,A01,083075,Staff,0,8,60,60
1650808473628,CSE 3,A50,083646,Miranda; Gregory Joseph,18,0,38,20
1650808473628,CSE 3,A51,083647,Miranda; Gregory Joseph,36,0,37,1
1650808479654,CSE 8A,A50,083650,Miranda; Gregory Joseph,0,29,40,40
1650808485677,CSE 11,A01,083080,Cao; Yingjun,0,96,40,40
1650808491701,CSE 12,A01,083652,Staff,0,21,100,100
1650808497728,CSE 15L,A01,083654,Staff,0,3,50,50
1650808497728,CSE 15L,A02,083655,Staff,0,2,50,50
1650808503753,CSE 20,A01,083657,Staff,49,0,80,31
1650808509779,CSE 30,A01,083084,Eldon; John,0,75,40,40
1650808515803,CSE 100,A01,083659,Cao; Yingjun,0,71,50,50
1650808521828,CSE 134B,A01,083661,Powell; Thomas Allan,0,38,65,65
1650808527861,CSE 140,A01,083663,Staff,0,11,75,75
1650808533887,CSE 140L,A01,083088,Eldon; John,0,20,75,75
1650808539911,CSE 175,A01,083665,Kumar; Rakesh,7,0,25,18
1650808545938,CSE 190,A00,092507,Dubnov; Shlomo,10,0,20,10
1650808551962,ECE 45,A01,083139,Staff,0,1,60,60
1650808557989,ECE 65,A50,083695,Staff,0,5,30,30
1650808564014,ECE 109,A01,091882,Touri; Behrouz,32,0,70,38
1650808570038,ECE 180,A00,083140,Abi Samra; Nicholas Camill,20,0,30,10
1650808570038,ECE 180,B00,083141,Abi Samra; Nicholas Camill,0,0,30,30
1650808576067,MATH 10A,A01,083735,Patchell; Gregory David,2,0,30,28
1650808576067,MATH 10A,A02,083736,Patchell; Gregory David,27,0,30,3
1650808576067,MATH 10A,A03,083737,Patchell; Gregory David,24,0,30,6
1650808582092,MATH 10B,A01,083207,Staff,0,9,30,30
1650808582092,MATH 10B,A02,083208,Staff,0,6,30,30
1650808582092,MATH 10B,B01,083739,Staff,11,0,30,19
1650808582092,MATH 10B,B02,083740,Staff,28,0,30,2
1650808588124,MATH 18,A01,083743,Staff,0,0,30,30
1650808588124,MATH 18,A02,083744,Staff,23,0,30,7
1650808588124,MATH 18,A03,083745,Staff,21,0,30,9
1650808588124,MATH 18,A04,083746,Staff,26,0,30,4
1650808588124,MATH 18,B01,083748,Staff,0,15,30,30
1650808588124,MATH 18,B02,083749,Staff,0,12,30,30
1650808588124,MATH 18,B03,083750,Staff,0,12,30,30
1650808588124,MATH 18,B04,083751,Staff,0,12,30,30
1650808594149,MATH 20A,A01,083754,Staff,19,0,40,21
1650808600175,MATH 20B,A01,083756,Staff,0,13,30,30
1650808600175,MATH 20B,A02,083757,Staff,0,12,30,30
1650808606199,MATH 20C,A01,083760,Staff,0,17,30,30
1650808606199,MATH 20C,A02,083761,Staff,0,16,30,30
1650808606199,MATH 20C,B01,083762,Staff,9,0,30,21
1650808606199,MATH 20C,B02,083763,Staff,28,0,30,2
1650808612226,MATH 20D,A01,083765,Staff,2,1,30,28
1650808612226,MATH 20D,A02,083766,Staff,6,0,30,24
1650808612226,MATH 20D,A03,083767,Staff,24,0,30,6
1650808618255,MATH 20E,A01,083771,Staff,2,0,30,28
1650808618255,MATH 20E,A02,083772,Staff,15,0,30,15
1650808618255,MATH 20E,B01,083773,Staff,0,0,30,30
1650808618255,MATH 20E,B02,083774,Staff,5,0,30,25
1650808624280,MATH 103A,A01,083777,Staff,0,16,30,30
1650808624280,MATH 103A,A02,083778,Staff,0,15,30,30
1650808624280,MATH 103A,B01,083779,Staff,0,15,30,30
1650808624280,MATH 103A,B02,083780,Staff,0,15,30,30
1650808630307,MATH 105,A01,085443,Staff,0,22,30,30
1650808636334,MATH 109,A01,083213,Anzaldo; Leesa B,0,7,30,30
1650808636334,MATH 109,A02,083214,Anzaldo; Leesa B,0,7,30,30
1650808636334,MATH 109,B01,083215,Anzaldo; Leesa B,0,8,30,30
1650808636334,MATH 109,B02,083216,Anzaldo; Leesa B,0,7,30,30
1650808642358,MATH 142A,A01,083219,Chow; Bennett,0,16,30,30
1650808642358,MATH 142A,A02,083220,Chow; Bennett,0,15,30,30
1650808642358,MATH 142A,B01,083221,Chow; Bennett,0,16,30,30
1650808642358,MATH 142A,B02,083222,Chow; Bennett,0,14,30,30
1650808648386,MATH 193A,A01,083224,Staff,0,6,30,30
1650808648386,MATH 193A,A02,083225,Staff,0,6,30,30
1650808648386,MATH 193A,A03,083781,Staff,0,6,30,30
1650808648386,MATH 193A,A04,083782,Staff,0,7,30,30
1650808654414,MATH 197,001,091859,McAuley; Julian John,9998,0,9999,1
1650808660462,COGS 9,A01,083615,Staff,0,17,60,60
1650808666486,COGS 11,A01,083617,Boyle; Mary E. T.,16,0,40,24
1650808672513,COGS 13,A01,083071,Staff,0,38,40,40
1650808678540,COGS 14A,A01,092681,Staff,0,36,100,100
1650808684564,COGS 14B,A01,083073,Cheng; Tzu-Han,0,12,50,50
1650808690588,COGS 17,A01,092677,Staff,11,0,75,64
1650808696612,COGS 100,A01,083619,Staff,0,29,60,60
1650808702638,COGS 101A,A01,083621,Davis; Joshua Daniel,0,28,60,60
1650808708671,COGS 101B,A01,091572,Staff,0,3,60,60
1650808714695,COGS 101C,A01,083625,Delgado; Tania,14,0,30,16
1650808720720,COGS 107A,A01,083627,Boyle; Mary E. T.,0,16,60,60
1650808726744,COGS 118A,A01,083075,Staff,0,8,60,60
1650808732769,CSE 3,A50,083646,Miranda; Gregory Joseph,18,0,38,20
1650808732769,CSE 3,A51,083647,Miranda; Gregory Joseph,36,0,37,1
1650808738796,CSE 8A,A50,083650,Miranda; Gregory Joseph,0,29,40,40
1650808744833,CSE 11,A01,083080,Cao; Yingjun,0,96,40,40
1650808750858,CSE 12,A01,083652,Staff,0,21,100,100
1650808756883,CSE 15L,A01,083654,Staff,0,3,50,50
1650808756883,CSE 15L,A02,083655,Staff,0,2,50,50
1650808762910,CSE 20,A01,083657,Staff,49,0,80,31
1650808768935,CSE 30,A01,083084,Eldon; John,0,75,40,40
1650808774959,CSE 100,A01,083659,Cao; Yingjun,0,71,50,50
1650808780987,CSE 134B,A01,083661,Powell; Thomas Allan,0,38,65,65
1650808787010,CSE 140,A01,083663,Staff,0,11,75,75
1650808793036,CSE 140L,A01,083088,Eldon; John,0,20,75,75
1650808799060,CSE 175,A01,083665,Kumar; Rakesh,7,0,25,18
1650808805086,CSE 190,A00,092507,Dubnov; Shlomo,10,0,20,10
1650808811111,ECE 45,A01,083139,Staff,0,1,60,60
1650808817138,ECE 65,A50,083695,Staff,0,5,30,30
1650808823166,ECE 109,A01,091882,Touri; Behrouz,32,0,70,38
1650808829192,ECE 180,A00,083140,Abi Samra; Nicholas Camill,20,0,30,10
1650808829192,ECE 180,B00,083141,Abi Samra; Nicholas Camill,0,0,30,30
1650808835221,MATH 10A,A01,083735,Patchell; Gregory David,2,0,30,28
1650808835221,MATH 10A,A02,083736,Patchell; Gregory David,27,0,30,3
1650808835221,MATH 10A,A03,083737,Patchell; Gregory David,24,0,30,6
1650808841244,MATH 10B,A01,083207,Staff,0,9,30,30
1650808841244,MATH 10B,A02,083208,Staff,0,6,30,30
1650808841244,MATH 10B,B01,083739,Staff,11,0,30,19
1650808841244,MATH 10B,B02,083740,Staff,28,0,30,2
1650808847276,MATH 18,A01,083743,Staff,0,0,30,30
1650808847276,MATH 18,A02,083744,Staff,23,0,30,7
1650808847276,MATH 18,A03,083745,Staff,21,0,30,9
1650808847276,MATH 18,A04,083746,Staff,26,0,30,4
1650808847276,MATH 18,B01,083748,Staff,0,15,30,30
1650808847276,MATH 18,B02,083749,Staff,0,12,30,30
1650808847276,MATH 18,B03,083750,Staff,0,12,30,30
1650808847276,MATH 18,B04,083751,Staff,0,12,30,30
1650808853305,MATH 20A,A01,083754,Staff,19,0,40,21
1650808859331,MATH 20B,A01,083756,Staff,0,13,30,30
1650808859331,MATH 20B,A02,083757,Staff,0,12,30,30
1650808865358,MATH 20C,A01,083760,Staff,0,17,30,30
1650808865358,MATH 20C,A02,083761,Staff,0,16,30,30
1650808865358,MATH 20C,B01,083762,Staff,9,0,30,21
1650808865358,MATH 20C,B02,083763,Staff,28,0,30,2
1650808871388,MATH 20D,A01,083765,Staff,2,1,30,28
1650808871388,MATH 20D,A02,083766,Staff,6,0,30,24
1650808871388,MATH 20D,A03,083767,Staff,24,0,30,6
1650808877415,MATH 20E,A01,083771,Staff,2,0,30,28
1650808877415,MATH 20E,A02,083772,Staff,15,0,30,15
1650808877415,MATH 20E,B01,083773,Staff,0,0,30,30
1650808877415,MATH 20E,B02,083774,Staff,5,0,30,25
1650808883443,MATH 103A,A01,083777,Staff,0,16,30,30
1650808883443,MATH 103A,A02,083778,Staff,0,15,30,30
1650808883443,MATH 103A,B01,083779,Staff,0,15,30,30
1650808883443,MATH 103A,B02,083780,Staff,0,15,30,30
1650808889470,MATH 105,A01,085443,Staff,0,22,30,30
1650808895499,MATH 109,A01,083213,Anzaldo; Leesa B,0,7,30,30
1650808895499,MATH 109,A02,083214,Anzaldo; Leesa B,0,7,30,30
1650808895499,MATH 109,B01,083215,Anzaldo; Leesa B,0,8,30,30
1650808895499,MATH 109,B02,083216,Anzaldo; Leesa B,0,7,30,30
1650808901526,MATH 142A,A01,083219,Chow; Bennett,0,16,30,30
1650808901526,MATH 142A,A02,083220,Chow; Bennett,0,15,30,30
1650808901526,MATH 142A,B01,083221,Chow; Bennett,0,16,30,30
1650808901526,MATH 142A,B02,083222,Chow; Bennett,0,14,30,30
1650808907641,MATH 193A,A01,083224,Staff,0,6,30,30
1650808907641,MATH 193A,A02,083225,Staff,0,6,30,30
1650808907641,MATH 193A,A03,083781,Staff,0,6,30,30
1650808907641,MATH 193A,A04,083782,Staff,0,7,30,30
1650808913665,MATH 197,001,091859,McAuley; Julian John,9998,0,9999,1
1650808919724,COGS 9,A01,083615,Staff,0,17,60,60
1650808925750,COGS 11,A01,083617,Boyle; Mary E. T.,16,0,40,24
1650808931773,COGS 13,A01,083071,Staff,0,38,40,40
1650808937801,COGS 14A,A01,092681,Staff,0,36,100,100
1650808943828,COGS 14B,A01,083073,Cheng; Tzu-Han,0,12,50,50
1650808949852,COGS 17,A01,092677,Staff,11,0,75,64
1650808955876,COGS 100,A01,083619,Staff,0,29,60,60
1650808961904,COGS 101A,A01,083621,Davis; Joshua Daniel,0,28,60,60
1650808967931,COGS 101B,A01,091572,Staff,0,3,60,60
1650808973956,COGS 101C,A01,083625,Delgado; Tania,14,0,30,16
1650808979980,COGS 107A,A01,083627,Boyle; Mary E. T.,0,16,60,60
1650808986005,COGS 118A,A01,083075,Staff,0,8,60,60
1650808992040,CSE 3,A50,083646,Miranda; Gregory Joseph,18,0,38,20
1650808992040,CSE 3,A51,083647,Miranda; Gregory Joseph,36,0,37,1
1650808998069,CSE 8A,A50,083650,Miranda; Gregory Joseph,0,29,40,40
1650809004096,CSE 11,A01,083080,Cao; Yingjun,0,96,40,40
1650809010122,CSE 12,A01,083652,Staff,0,21,100,100
1650809016148,CSE 15L,A01,083654,Staff,0,3,50,50
1650809016148,CSE 15L,A02,083655,Staff,0,2,50,50
1650809022177,CSE 20,A01,083657,Staff,49,0,80,31
1650809028204,CSE 30,A01,083084,Eldon; John,0,75,40,40
1650809034229,CSE 100,A01,083659,Cao; Yingjun,0,71,50,50
1650809040254,CSE 134B,A01,083661,Powell; Thomas Allan,0,38,65,65
1650809046277,CSE 140,A01,083663,Staff,0,11,75,75
1650809052302,CSE 140L,A01,083088,Eldon; John,0,20,75,75
1650809058323,CSE 175,A01,083665,Kumar; Rakesh,7,0,25,18
1650809064347,CSE 190,A00,092507,Dubnov; Shlomo,10,0,20,10
1650809070371,ECE 45,A01,083139,Staff,0,1,60,60
1650809076399,ECE 65,A50,083695,Staff,0,5,30,30
1650809082425,ECE 109,A01,091882,Touri; Behrouz,32,0,70,38
1650809088460,ECE 180,A00,083140,Abi Samra; Nicholas Camill,20,0,30,10
1650809088460,ECE 180,B00,083141,Abi Samra; Nicholas Camill,0,0,30,30
1650809094482,MATH 10A,A01,083735,Patchell; Gregory David,2,0,30,28
1650809094482,MATH 10A,A02,083736,Patchell; Gregory David,27,0,30,3
1650809094482,MATH 10A,A03,083737,Patchell; Gregory David,24,0,30,6
1650809100506,MATH 10B,A01,083207,Staff,0,9,30,30
1650809100506,MATH 10B,A02,083208,Staff,0,6,30,30
1650809100506,MATH 10B,B01,083739,Staff,11,0,30,19
1650809100506,MATH 10B,B02,083740,Staff,28,0,30,2
1650809106531,MATH 18,A01,083743,Staff,0,0,30,30
1650809106531,MATH 18,A02,083744,Staff,23,0,30,7
1650809106531,MATH 18,A03,083745,Staff,21,0,30,9
1650809106531,MATH 18,A04,083746,Staff,26,0,30,4
1650809106531,MATH 18,B01,083748,Staff,0,15,30,30
1650809106531,MATH 18,B02,083749,Staff,0,12,30,30
1650809106531,MATH 18,B03,083750,Staff,0,12,30,30
1650809106531,MATH 18,B04,083751,Staff,0,12,30,30
1650809112554,MATH 20A,A01,083754,Staff,19,0,40,21
1650809118579,MATH 20B,A01,083756,Staff,0,13,30,30
1650809118579,MATH 20B,A02,083757,Staff,0,12,30,30
1650809124609,MATH 20C,A01,083760,Staff,0,17,30,30
1650809124609,MATH 20C,A02,083761,Staff,0,16,30,30
1650809124609,MATH 20C,B01,083762,Staff,9,0,30,21
1650809124609,MATH 20C,B02,083763,Staff,28,0,30,2
1650809130633,MATH 20D,A01,083765,Staff,2,1,30,28
1650809130633,MATH 20D,A02,083766,Staff,6,0,30,24
1650809130633,MATH 20D,A03,083767,Staff,24,0,30,6
1650809136659,MATH 20E,A01,083771,Staff,2,0,30,28
1650809136659,MATH 20E,A02,083772,Staff,15,0,30,15
1650809136659,MATH 20E,B01,083773,Staff,0,0,30,30
1650809136659,MATH 20E,B02,083774,Staff,5,0,30,25
1650809142688,MATH 103A,A01,083777,Staff,0,16,30,30
1650809142688,MATH 103A,A02,083778,Staff,0,15,30,30
1650809142688,MATH 103A,B01,083779,Staff,0,15,30,30
1650809142688,MATH 103A,B02,083780,Staff,0,15,30,30
1650809148716,MATH 105,A01,085443,Staff,0,22,30,30
1650809154740,MATH 109,A01,083213,Anzaldo; Leesa B,0,7,30,30
1650809154740,MATH 109,A02,083214,Anzaldo; Leesa B,0,7,30,30
1650809154740,MATH 109,B01,083215,Anzaldo; Leesa B,0,8,30,30
1650809154740,MATH 109,B02,083216,Anzaldo; Leesa B,0,7,30,30
1650809160765,MATH 142A,A01,083219,Chow; Bennett,0,16,30,30
1650809160765,MATH 142A,A02,083220,Chow; Bennett,0,15,30,30
1650809160765,MATH 142A,B01,083221,Chow; Bennett,0,16,30,30
1650809160765,MATH 142A,B02,083222,Chow; Bennett,0,14,30,30
1650809166800,MATH 193A,A01,083224,Staff,0,6,30,30
1650809166800,MATH 193A,A02,083225,Staff,0,6,30,30
1650809166800,MATH 193A,A03,083781,Staff,0,6,30,30
1650809166800,MATH 193A,A04,083782,Staff,0,7,30,30
1650809172825,MATH 197,001,091859,McAuley; Julian John,9998,0,9999,1
1650809178873,COGS 9,A01,083615,Staff,0,17,60,60
1650809184900,COGS 11,A01,083617,Boyle; Mary E. T.,16,0,40,24
1650809190926,COGS 13,A01,083071,Staff,0,38,40,40
1650809196948,COGS 14A,A01,092681,Staff,0,36,100,100
1650809202972,COGS 14B,A01,083073,Cheng; Tzu-Han,0,12,50,50
1650809209012,COGS 17,A01,092677,Staff,11,0,75,64
1650809215036,COGS 100,A01,083619,Staff,0,29,60,60
1650809221064,COGS 101A,A01,083621,Davis; Joshua Daniel,0,28,60,60
1650809227091,COGS 101B,A01,091572,Staff,0,3,60,60
1650809233118,COGS 101C,A01,083625,Delgado; Tania,14,0,30,16
1650809239142,COGS 107A,A01,083627,Boyle; Mary E. T.,0,16,60,60
1650809245168,COGS 118A,A01,083075,Staff,0,8,60,60
1650809251198,CSE 3,A50,083646,Miranda; Gregory Joseph,18,0,38,20
1650809251198,CSE 3,A51,083647,Miranda; Gregory Joseph,36,0,37,1
1650809257222,CSE 8A,A50,083650,Miranda; Gregory Joseph,0,29,40,40
1650809263261,CSE 11,A01,083080,Cao; Yingjun,0,96,40,40
1650809269289,CSE 12,A01,083652,Staff,0,21,100,100
1650809275316,CSE 15L,A01,083654,Staff,0,3,50,50
1650809275316,CSE 15L,A02,083655,Staff,0,2,50,50
1650809281353,CSE 20,A01,083657,Staff,49,0,80,31
1650809287376,CSE 30,A01,083084,Eldon; John,0,75,40,40
1650809293402,CSE 100,A01,083659,Cao; Yingjun,0,71,50,50
1650809299423,CSE 134B,A01,083661,Powell; Thomas Allan,0,38,65,65
1650809305447,CSE 140,A01,083663,Staff,0,11,75,75
1650809311474,CSE 140L,A01,083088,Eldon; John,0,20,75,75
1650809317498,CSE 175,A01,083665,Kumar; Rakesh,7,0,25,18
1650809323525,CSE 190,A00,092507,Dubnov; Shlomo,10,0,20,10
1650809329555,ECE 45,A01,083139,Staff,0,1,60,60
1650809335579,ECE 65,A50,083695,Staff,0,5,30,30
1650809341604,ECE 109,A01,091882,Touri; Behrouz,32,0,70,38
1650809347626,ECE 180,A00,083140,Abi Samra; Nicholas Camill,20,0,30,10
1650809347626,ECE 180,B00,083141,Abi Samra; Nicholas Camill,0,0,30,30
1650809353654,MATH 10A,A01,083735,Patchell; Gregory David,2,0,30,28
1650809353654,MATH 10A,A02,083736,Patchell; Gregory David,27,0,30,3
1650809353654,MATH 10A,A03,083737,Patchell; Gregory David,24,0,30,6
1650809359678,MATH 10B,A01,083207,Staff,0,9,30,30
1650809359678,MATH 10B,A02,083208,Staff,0,6,30,30
1650809359678,MATH 10B,B01,083739,Staff,11,0,30,19
1650809359678,MATH 10B,B02,083740,Staff,28,0,30,2
1650809365727,MATH 18,A01,083743,Staff,0,0,30,30
1650809365727,MATH 18,A02,083744,Staff,23,0,30,7
1650809365727,MATH 18,A03,083745,Staff,21,0,30,9
1650809365727,MATH 18,A04,083746,Staff,26,0,30,4
1650809365727,MATH 18,B01,083748,Staff,0,15,30,30
1650809365727,MATH 18,B02,083749,Staff,0,12,30,30
1650809365727,MATH 18,B03,083750,Staff,0,12,30,30
1650809365727,MATH 18,B04,083751,Staff,0,12,30,30
1650809371752,MATH 20A,A01,083754,Staff,19,0,40,21
1650809377778,MATH 20B,A01,083756,Staff,0,13,30,30
1650809377778,MATH 20B,A02,083757,Staff,0,12,30,30
1650809383803,MATH 20C,A01,083760,Staff,0,17,30,30
1650809383803,MATH 20C,A02,083761,Staff,0,16,30,30
1650809383803,MATH 20C,B01,083762,Staff,9,0,30,21
1650809383803,MATH 20C,B02,083763,Staff,28,0,30,2
1650809389831,MATH 20D,A01,083765,Staff,2,1,30,28
1650809389831,MATH 20D,A02,083766,Staff,6,0,30,24
1650809389831,MATH 20D,A03,083767,Staff,24,0,30,6
1650809395862,MATH 20E,A01,083771,Staff,2,0,30,28
1650809395862,MATH 20E,A02,083772,Staff,15,0,30,15
1650809395862,MATH 20E,B01,083773,Staff,0,0,30,30
1650809395862,MATH 20E,B02,083774,Staff,5,0,30,25
1650809401891,MATH 103A,A01,083777,Staff,0,16,30,30
1650809401891,MATH 103A,A02,083778,Staff,0,15,30,30
1650809401891,MATH 103A,B01,083779,Staff,0,15,30,30
1650809401891,MATH 103A,B02,083780,Staff,0,15,30,30
1650809407919,MATH 105,A01,085443,Staff,0,22,30,30
1650809413943,MATH 109,A01,083213,Anzaldo; Leesa B,0,7,30,30
1650809413943,MATH 109,A02,083214,Anzaldo; Leesa B,0,7,30,30
1650809413943,MATH 109,B01,083215,Anzaldo; Leesa B,0,8,30,30
1650809413943,MATH 109,B02,083216,Anzaldo; Leesa B,0,7,30,30
1650809419967,MATH 142A,A01,083219,Chow; Bennett,0,16,30,30
1650809419967,MATH 142A,A02,083220,Chow; Bennett,0,15,30,30
1650809419967,MATH 142A,B01,083221,Chow; Bennett,0,16,30,30
1650809419967,MATH 142A,B02,083222,Chow; Bennett,0,14,30,30
1650809425990,MATH 193A,A01,083224,Staff,0,6,30,30
1650809425990,MATH 193A,A02,083225,Staff,0,6,30,30
1650809425990,MATH 193A,A03,083781,Staff,0,6,30,30
1650809425990,MATH 193A,A04,083782,Staff,0,7,30,30
1650809432019,MATH 197,001,091859,McAuley; Julian John,9998,0,9999,1
1650809438080,COGS 9,A01,083615,Staff,0,17,60,60
1650809444104,COGS 11,A01,083617,Boyle; Mary E. T.,16,0,40,24
1650809450128,COGS 13,A01,083071,Staff,0,38,40,40
1650809456152,COGS 14A,A01,092681,Staff,0,36,100,100
1650809462178,COGS 14B,A01,083073,Cheng; Tzu-Han,0,12,50,50
1650809468210,COGS 17,A01,092677,Staff,11,0,75,64
1650809474233,COGS 100,A01,083619,Staff,0,29,60,60
1650809480255,COGS 101A,A01,083621,Davis; Joshua Daniel,0,28,60,60
1650809486283,COGS 101B,A01,091572,Staff,0,3,60,60
1650809492306,COGS 101C,A01,083625,Delgado; Tania,14,0,30,16
1650809498421,COGS 107A,A01,083627,Boyle; Mary E. T.,0,16,60,60
1650809504447,COGS 118A,A01,083075,Staff,0,8,60,60
1650809510473,CSE 3,A50,083646,Miranda; Gregory Joseph,18,0,38,20
1650809510473,CSE 3,A51,083647,Miranda; Gregory Joseph,36,0,37,1
1650809516497,CSE 8A,A50,083650,Miranda; Gregory Joseph,0,29,40,40
1650809522522,CSE 11,A01,083080,Cao; Yingjun,0,96,40,40
1650809528549,CSE 12,A01,083652,Staff,0,21,100,100
1650809534573,CSE 15L,A01,083654,Staff,0,3,50,50
1650809534573,CSE 15L,A02,083655,Staff,0,2,50,50
1650809540608,CSE 20,A01,083657,Staff,49,0,80,31
1650809546634,CSE 30,A01,083084,Eldon; John,0,75,40,40
1650809552658,CSE 100,A01,083659,Cao; Yingjun,0,71,50,50
1650809558681,CSE 134B,A01,083661,Powell; Thomas Allan,0,38,65,65
1650809564704,CSE 140,A01,083663,Staff,0,11,75,75
1650809570729,CSE 140L,A01,083088,Eldon; John,0,20,75,75
1650809576760,CSE 175,A01,083665,Kumar; Rakesh,7,0,25,18
1650809582799,CSE 190,A00,092507,Dubnov; Shlomo,10,0,20,10
1650809588822,ECE 45,A01,083139,Staff,0,1,60,60
1650809594853,ECE 65,A50,083695,Staff,0,5,30,30
1650809600882,ECE 109,A01,091882,Touri; Behrouz,32,0,70,38
1650809606909,ECE 180,A00,083140,Abi Samra; Nicholas Camill,20,0,30,10
1650809606909,ECE 180,B00,083141,Abi Samra; Nicholas Camill,0,0,30,30
1650809612934,MATH 10A,A01,083735,Patchell; Gregory David,2,0,30,28
1650809612934,MATH 10A,A02,083736,Patchell; Gregory David,27,0,30,3
1650809612934,MATH 10A,A03,083737,Patchell; Gregory David,24,0,30,6
1650809618961,MATH 10B,A01,083207,Staff,0,9,30,30
1650809618961,MATH 10B,A02,083208,Staff,0,6,30,30
1650809618961,MATH 10B,B01,083739,Staff,11,0,30,19
1650809618961,MATH 10B,B02,083740,Staff,28,0,30,2
1650809624991,MATH 18,A01,083743,Staff,0,0,30,30
1650809624991,MATH 18,A02,083744,Staff,23,0,30,7
1650809624991,MATH 18,A03,083745,Staff,21,0,30,9
1650809624991,MATH 18,A04,083746,Staff,26,0,30,4
1650809624991,MATH 18,B01,083748,Staff,0,15,30,30
1650809624991,MATH 18,B02,083749,Staff,0,12,30,30
1650809624991,MATH 18,B03,083750,Staff,0,12,30,30
1650809624991,MATH 18,B04,083751,Staff,0,12,30,30
1650809631014,MATH 20A,A01,083754,Staff,19,0,40,21
1650809637042,MATH 20B,A01,083756,Staff,0,13,30,30
1650809637042,MATH 20B,A02,083757,Staff,0,12,30,30
1650809643080,MATH 20C,A01,083760,Staff,0,17,30,30
1650809643080,MATH 20C,A02,083761,Staff,0,16,30,30
1650809643080,MATH 20C,B01,083762,Staff,9,0,30,21
1650809643080,MATH 20C,B02,083763,Staff,28,0,30,2
1650809649106,MATH 20D,A01,083765,Staff,2,1,30,28
1650809649106,MATH 20D,A02,083766,Staff,6,0,30,24
1650809649106,MATH 20D,A03,083767,Staff,24,0,30,6
1650809655134,MATH 20E,A01,083771,Staff,2,0,30,28
1650809655134,MATH 20E,A02,083772,Staff,15,0,30,15
1650809655134,MATH 20E,B01,083773,Staff,0,0,30,30
1650809655134,MATH 20E,B02,083774,Staff,5,0,30,25
1650809661156,MATH 103A,A01,083777,Staff,0,16,30,30
1650809661156,MATH 103A,A02,083778,Staff,0,15,30,30
1650809661156,MATH 103A,B01,083779,Staff,0,15,30,30
1650809661156,MATH 103A,B02,083780,Staff,0,15,30,30
1650809667192,MATH 105,A01,085443,Staff,0,22,30,30
1650809673220,MATH 109,A01,083213,Anzaldo; Leesa B,0,7,30,30
1650809673220,MATH 109,A02,083214,Anzaldo; Leesa B,0,7,30,30
1650809673220,MATH 109,B01,083215,Anzaldo; Leesa B,0,8,30,30
1650809673220,MATH 109,B02,083216,Anzaldo; Leesa B,0,7,30,30
1650809679243,MATH 142A,A01,083219,Chow; Bennett,0,16,30,30
1650809679243,MATH 142A,A02,083220,Chow; Bennett,0,15,30,30
1650809679243,MATH 142A,B01,083221,Chow; Bennett,0,16,30,30
1650809679243,MATH 142A,B02,083222,Chow; Bennett,0,14,30,30
1650809685268,MATH 193A,A01,083224,Staff,0,6,30,30
1650809685268,MATH 193A,A02,083225,Staff,0,6,30,30
1650809685268,MATH 193A,A03,083781,Staff,0,6,30,30
1650809685268,MATH 193A,A04,083782,Staff,0,7,30,30
1650809691293,MATH 197,001,091859,McAuley; Julian John,9998,0,9999,1
1650809697369,COGS 9,A01,083615,Staff,0,17,60,60
1650809703404,COGS 11,A01,083617,Boyle; Mary E. T.,16,0,40,24
1650809709431,COGS 13,A01,083071,Staff,0,38,40,40
1650809715460,COGS 14A,A01,092681,Staff,0,36,100,100
1650809721487,COGS 14B,A01,083073,Cheng; Tzu-Han,0,12,50,50
1650809727510,COGS 17,A01,092677,Staff,11,0,75,64
1650809733533,COGS 100,A01,083619,Staff,0,29,60,60
1650809739561,COGS 101A,A01,083621,Davis; Joshua Daniel,0,28,60,60
1650809745589,COGS 101B,A01,091572,Staff,0,3,60,60
1650809751613,COGS 101C,A01,083625,Delgado; Tania,14,0,30,16
1650809757638,COGS 107A,A01,083627,Boyle; Mary E. T.,0,16,60,60
1650809763668,COGS 118A,A01,083075,Staff,0,8,60,60
1650809769697,CSE 3,A50,083646,Miranda; Gregory Joseph,18,0,38,20
1650809769697,CSE 3,A51,083647,Miranda; Gregory Joseph,36,0,37,1
1650809775722,CSE 8A,A50,083650,Miranda; Gregory Joseph,0,29,40,40
1650809781746,CSE 11,A01,083080,Cao; Yingjun,0,96,40,40
1650809787771,CSE 12,A01,083652,Staff,0,21,100,100
1650809793797,CSE 15L,A01,083654,Staff,0,3,50,50
1650809793797,CSE 15L,A02,083655,Staff,0,2,50,50
1650809799821,CSE 20,A01,083657,Staff,49,0,80,31
1650809805846,CSE 30,A01,083084,Eldon; John,0,75,40,40
1650809811873,CSE 100,A01,083659,Cao; Yingjun,0,71,50,50
1650809817902,CSE 134B,A01,083661,Powell; Thomas Allan,0,38,65,65
1650809823931,CSE 140,A01,083663,Staff,0,11,75,75
1650809829958,CSE 140L,A01,083088,Eldon; John,0,20,75,75
1650809835989,CSE 175,A01,083665,Kumar; Rakesh,7,0,25,18
1650809842013,CSE 190,A00,092507,Dubnov; Shlomo,10,0,20,10
1650809848042,ECE 45,A01,083139,Staff,0,1,60,60
1650809854070,ECE 65,A50,083695,Staff,0,5,30,30
1650809860097,ECE 109,A01,091882,Touri; Behrouz,32,0,70,38
1650809866122,ECE 180,A00,083140,Abi Samra; Nicholas Camill,20,0,30,10
1650809866122,ECE 180,B00,083141,Abi Samra; Nicholas Camill,0,0,30,30
1650809872151,MATH 10A,A01,083735,Patchell; Gregory David,2,0,30,28
1650809872151,MATH 10A,A02,083736,Patchell; Gregory David,27,0,30,3
1650809872151,MATH 10A,A03,083737,Patchell; Gregory David,24,0,30,6
1650809878180,MATH 10B,A01,083207,Staff,0,9,30,30
1650809878180,MATH 10B,A02,083208,Staff,0,6,30,30
1650809878180,MATH 10B,B01,083739,Staff,11,0,30,19
1650809878180,MATH 10B,B02,083740,Staff,28,0,30,2
1650809884212,MATH 18,A01,083743,Staff,0,0,30,30
1650809884212,MATH 18,A02,083744,Staff,23,0,30,7
1650809884212,MATH 18,A03,083745,Staff,21,0,30,9
1650809884212,MATH 18,A04,083746,Staff,26,0,30,4
1650809884212,MATH 18,B01,083748,Staff,0,15,30,30
1650809884212,MATH 18,B02,083749,Staff,0,12,30,30
1650809884212,MATH 18,B03,083750,Staff,0,12,30,30
1650809884212,MATH 18,B04,083751,Staff,0,12,30,30
1650809890239,MATH 20A,A01,083754,Staff,19,0,40,21
1650809896266,MATH 20B,A01,083756,Staff,0,13,30,30
1650809896266,MATH 20B,A02,083757,Staff,0,12,30,30
1650809902290,MATH 20C,A01,083760,Staff,0,17,30,30
1650809902290,MATH 20C,A02,083761,Staff,0,16,30,30
1650809902290,MATH 20C,B01,083762,Staff,9,0,30,21
1650809902290,MATH 20C,B02,083763,Staff,28,0,30,2
1650809917699,MATH 20D,A01,083765,Staff,2,1,30,28
1650809917699,MATH 20D,A02,083766,Staff,6,0,30,24
1650809917699,MATH 20D,A03,083767,Staff,24,0,30,6
1650809923723,MATH 20E,A01,083771,Staff,2,0,30,28
1650809923723,MATH 20E,A02,083772,Staff,15,0,30,15
1650809923723,MATH 20E,B01,083773,Staff,0,0,30,30
1650809923723,MATH 20E,B02,083774,Staff,5,0,30,25
1650809929749,MATH 103A,A01,083777,Staff,0,16,30,30
1650809929749,MATH 103A,A02,083778,Staff,0,15,30,30
1650809929749,MATH 103A,B01,083779,Staff,0,15,30,30
1650809929749,MATH 103A,B02,083780,Staff,0,15,30,30
1650809935772,MATH 105,A01,085443,Staff,0,22,30,30
1650809941804,MATH 109,A01,083213,Anzaldo; Leesa B,0,7,30,30
1650809941804,MATH 109,A02,083214,Anzaldo; Leesa B,0,7,30,30
1650809941804,MATH 109,B01,083215,Anzaldo; Leesa B,0,8,30,30
1650809941804,MATH 109,B02,083216,Anzaldo; Leesa B,0,7,30,30
1650809947830,MATH 142A,A01,083219,Chow; Bennett,0,16,30,30
1650809947830,MATH 142A,A02,083220,Chow; Bennett,0,15,30,30
1650809947830,MATH 142A,B01,083221,Chow; Bennett,0,16,30,30
1650809947830,MATH 142A,B02,083222,Chow; Bennett,0,14,30,30
1650809953852,MATH 193A,A01,083224,Staff,0,6,30,30
1650809953852,MATH 193A,A02,083225,Staff,0,6,30,30
1650809953852,MATH 193A,A03,083781,Staff,0,6,30,30
1650809953852,MATH 193A,A04,083782,Staff,0,7,30,30
1650809959878,MATH 197,001,091859,McAuley; Julian John,9998,0,9999,1
1650809965933,COGS 9,A01,083615,Staff,0,17,60,60
1650809971956,COGS 11,A01,083617,Boyle; Mary E. T.,16,0,40,24
1650809977982,COGS 13,A01,083071,Staff,0,38,40,40
1650809984010,COGS 14A,A01,092681,Staff,0,36,100,100
1650809990035,COGS 14B,A01,083073,Cheng; Tzu-Han,0,12,50,50
1650809996059,COGS 17,A01,092677,Staff,11,0,75,64
1650810002082,COGS 100,A01,083619,Staff,0,29,60,60
1650810008112,COGS 101A,A01,083621,Davis; Joshua Daniel,0,28,60,60
1650810014139,COGS 101B,A01,091572,Staff,0,3,60,60
1650810020169,COGS 101C,A01,083625,Delgado; Tania,14,0,30,16
1650810026196,COGS 107A,A01,083627,Boyle; Mary E. T.,0,16,60,60
1650810032220,COGS 118A,A01,083075,Staff,0,8,60,60
1650810038248,CSE 3,A50,083646,Miranda; Gregory Joseph,18,0,38,20
1650810038248,CSE 3,A51,083647,Miranda; Gregory Joseph,36,0,37,1
1650810044283,CSE 8A,A50,083650,Miranda; Gregory Joseph,0,29,40,40
1650810050307,CSE 11,A01,083080,Cao; Yingjun,0,96,40,40
1650810056337,CSE 12,A01,083652,Staff,0,21,100,100
1650810062361,CSE 15L,A01,083654,Staff,0,3,50,50
1650810062361,CSE 15L,A02,083655,Staff,0,2,50,50
1650810068386,CSE 20,A01,083657,Staff,49,0,80,31
1650810074409,CSE 30,A01,083084,Eldon; John,0,75,40,40
1650810080451,CSE 100,A01,083659,Cao; Yingjun,0,71,50,50
1650810086480,CSE 134B,A01,083661,Powell; Thomas Allan,0,38,65,65
1650810092505,CSE 140,A01,083663,Staff,0,11,75,75
1650810098528,CSE 140L,A01,083088,Eldon; John,0,20,75,75
1650810104690,CSE 175,A01,083665,Kumar; Rakesh,7,0,25,18
1650810110713,CSE 190,A00,092507,Dubnov; Shlomo,10,0,20,10
1650810116737,ECE 45,A01,083139,Staff,0,1,60,60
1650810122764,ECE 65,A50,083695,Staff,0,5,30,30
1650810128786,ECE 109,A01,091882,Touri; Behrouz,32,0,70,38
1650810134810,ECE 180,A00,083140,Abi Samra; Nicholas Camill,20,0,30,10
1650810134810,ECE 180,B00,083141,Abi Samra; Nicholas Camill,0,0,30,30
1650810140833,MATH 10A,A01,083735,Patchell; Gregory David,2,0,30,28
1650810140833,MATH 10A,A02,083736,Patchell; Gregory David,27,0,30,3
1650810140833,MATH 10A,A03,083737,Patchell; Gregory David,24,0,30,6
1650810146860,MATH 10B,A01,083207,Staff,0,9,30,30
1650810146860,MATH 10B,A02,083208,Staff,0,6,30,30
1650810146860,MATH 10B,B01,083739,Staff,11,0,30,19
1650810146860,MATH 10B,B02,083740,Staff,28,0,30,2
1650810152887,MATH 18,A01,083743,Staff,0,0,30,30
1650810152887,MATH 18,A02,083744,Staff,23,0,30,7
1650810152887,MATH 18,A03,083745,Staff,21,0,30,9
1650810152887,MATH 18,A04,083746,Staff,26,0,30,4
1650810152887,MATH 18,B01,083748,Staff,0,15,30,30
1650810152887,MATH 18,B02,083749,Staff,0,12,30,30
1650810152887,MATH 18,B03,083750,Staff,0,12,30,30
1650810152887,MATH 18,B04,083751,Staff,0,12,30,30
1650810158917,MATH 20A,A01,083754,Staff,19,0,40,21
1650810164940,MATH 20B,A01,083756,Staff,0,13,30,30
1650810164940,MATH 20B,A02,083757,Staff,0,12,30,30
1650810170962,MATH 20C,A01,083760,Staff,0,17,30,30
1650810170962,MATH 20C,A02,083761,Staff,0,16,30,30
1650810170962,MATH 20C,B01,083762,Staff,9,0,30,21
1650810170962,MATH 20C,B02,083763,Staff,28,0,30,2
1650810176989,MATH 20D,A01,083765,Staff,2,1,30,28
1650810176989,MATH 20D,A02,083766,Staff,6,0,30,24
1650810176989,MATH 20D,A03,083767,Staff,24,0,30,6
1650810183014,MATH 20E,A01,083771,Staff,2,0,30,28
1650810183014,MATH 20E,A02,083772,Staff,15,0,30,15
1650810183014,MATH 20E,B01,083773,Staff,0,0,30,30
1650810183014,MATH 20E,B02,083774,Staff,5,0,30,25
1650810189043,MATH 103A,A01,083777,Staff,0,16,30,30
1650810189043,MATH 103A,A02,083778,Staff,0,15,30,30
1650810189043,MATH 103A,B01,083779,Staff,0,15,30,30
1650810189043,MATH 103A,B02,083780,Staff,0,15,30,30
1650810195068,MATH 105,A01,085443,Staff,0,22,30,30
1650810201092,MATH 109,A01,083213,Anzaldo; Leesa B,0,7,30,30
1650810201092,MATH 109,A02,083214,Anzaldo; Leesa B,0,7,30,30
1650810201092,MATH 109,B01,083215,Anzaldo; Leesa B,0,8,30,30
1650810201092,MATH 109,B02,083216,Anzaldo; Leesa B,0,7,30,30
1650810207124,MATH 142A,A01,083219,Chow; Bennett,0,16,30,30
1650810207124,MATH 142A,A02,083220,Chow; Bennett,0,15,30,30
1650810207124,MATH 142A,B01,083221,Chow; Bennett,0,16,30,30
1650810207124,MATH 142A,B02,083222,Chow; Bennett,0,14,30,30
1650810213152,MATH 193A,A01,083224,Staff,0,6,30,30
1650810213152,MATH 193A,A02,083225,Staff,0,6,30,30
1650810213152,MATH 193A,A03,083781,Staff,0,6,30,30
1650810213152,MATH 193A,A04,083782,Staff,0,7,30,30
1650810219175,MATH 197,001,091859,McAuley; Julian John,9998,0,9999,1
1650810225258,COGS 9,A01,083615,Staff,0,17,60,60
1650810231283,COGS 11,A01,083617,Boyle; Mary E. T.,16,0,40,24
1650810237306,COGS 13,A01,083071,Staff,0,38,40,40
1650810243333,COGS 14A,A01,092681,Staff,0,36,100,100
1650810249359,COGS 14B,A01,083073,Cheng; Tzu-Han,0,12,50,50
1650810255382,COGS 17,A01,092677,Staff,11,0,75,64
1650810261408,COGS 100,A01,083619,Staff,0,29,60,60
1650810267441,COGS 101A,A01,083621,Davis; Joshua Daniel,0,28,60,60
1650810273468,COGS 101B,A01,091572,Staff,0,3,60,60
1650810279496,COGS 101C,A01,083625,Delgado; Tania,14,0,30,16
1650810285518,COGS 107A,A01,083627,Boyle; Mary E. T.,0,16,60,60
1650810291542,COGS 118A,A01,083075,Staff,0,8,60,60
1650810297574,CSE 3,A50,083646,Miranda; Gregory Joseph,18,0,38,20
1650810297574,CSE 3,A51,083647,Miranda; Gregory Joseph,36,0,37,1
1650810303610,CSE 8A,A50,083650,Miranda; Gregory Joseph,0,29,40,40
1650810309639,CSE 11,A01,083080,Cao; Yingjun,0,96,40,40
1650810315666,CSE 12,A01,083652,Staff,0,21,100,100
1650810321689,CSE 15L,A01,083654,Staff,0,3,50,50
1650810321689,CSE 15L,A02,083655,Staff,0,2,50,50
1650810327716,CSE 20,A01,083657,Staff,49,0,80,31
1650810333754,CSE 30,A01,083084,Eldon; John,0,75,40,40
1650810339776,CSE 100,A01,083659,Cao; Yingjun,0,71,50,50
1650810345810,CSE 134B,A01,083661,Powell; Thomas Allan,0,38,65,65
1650810351838,CSE 140,A01,083663,Staff,0,11,75,75
1650810357876,CSE 140L,A01,083088,Eldon; John,0,20,75,75
1650810363901,CSE 175,A01,083665,Kumar; Rakesh,7,0,25,18
1650810369925,CSE 190,A00,092507,Dubnov; Shlomo,10,0,20,10
1650810375956,ECE 45,A01,083139,Staff,0,1,60,60
1650810381987,ECE 65,A50,083695,Staff,0,5,30,30
1650810388015,ECE 109,A01,091882,Touri; Behrouz,32,0,70,38
1650810394049,ECE 180,A00,083140,Abi Samra; Nicholas Camill,20,0,30,10
1650810394049,ECE 180,B00,083141,Abi Samra; Nicholas Camill,0,0,30,30
1650810400073,MATH 10A,A01,083735,Patchell; Gregory David,2,0,30,28
1650810400073,MATH 10A,A02,083736,Patchell; Gregory David,27,0,30,3
1650810400073,MATH 10A,A03,083737,Patchell; Gregory David,24,0,30,6
1650810406097,MATH 10B,A01,083207,Staff,0,9,30,30
1650810406097,MATH 10B,A02,083208,Staff,0,6,30,30
1650810406097,MATH 10B,B01,083739,Staff,11,0,30,19
1650810406097,MATH 10B,B02,083740,Staff,28,0,30,2
1650810412128,MATH 18,A01,083743,Staff,0,0,30,30
1650810412128,MATH 18,A02,083744,Staff,23,0,30,7
1650810412128,MATH 18,A03,083745,Staff,21,0,30,9
1650810412128,MATH 18,A04,083746,Staff,26,0,30,4
1650810412128,MATH 18,B01,083748,Staff,0,15,30,30
1650810412128,MATH 18,B02,083749,Staff,0,12,30,30
1650810412128,MATH 18,B03,083750,Staff,0,12,30,30
1650810412128,MATH 18,B04,083751,Staff,0,12,30,30
1650810418158,MATH 20A,A01,083754,Staff,19,0,40,21
1650810424182,MATH 20B,A01,083756,Staff,0,13,30,30
1650810424182,MATH 20B,A02,083757,Staff,0,12,30,30
1650810430211,MATH 20C,A01,083760,Staff,0,17,30,30
1650810430211,MATH 20C,A02,083761,Staff,0,16,30,30
1650810430211,MATH 20C,B01,083762,Staff,9,0,30,21
1650810430211,MATH 20C,B02,083763,Staff,28,0,30,2
1650810436240,MATH 20D,A01,083765,Staff,2,1,30,28
1650810436240,MATH 20D,A02,083766,Staff,6,0,30,24
1650810436240,MATH 20D,A03,083767,Staff,24,0,30,6
1650810442264,MATH 20E,A01,083771,Staff,2,0,30,28
1650810442264,MATH 20E,A02,083772,Staff,15,0,30,15
1650810442264,MATH 20E,B01,083773,Staff,0,0,30,30
1650810442264,MATH 20E,B02,083774,Staff,5,0,30,25
1650810448289,MATH 103A,A01,083777,Staff,0,16,30,30
1650810448289,MATH 103A,A02,083778,Staff,0,15,30,30
1650810448289,MATH 103A,B01,083779,Staff,0,15,30,30
1650810448289,MATH 103A,B02,083780,Staff,0,15,30,30
1650810454316,MATH 105,A01,085443,Staff,0,22,30,30
1650810460343,MATH 109,A01,083213,Anzaldo; Leesa B,0,7,30,30
1650810460343,MATH 109,A02,083214,Anzaldo; Leesa B,0,7,30,30
1650810460343,MATH 109,B01,083215,Anzaldo; Leesa B,0,8,30,30
1650810460343,MATH 109,B02,083216,Anzaldo; Leesa B,0,7,30,30
1650810466373,MATH 142A,A01,083219,Chow; Bennett,0,16,30,30
1650810466373,MATH 142A,A02,083220,Chow; Bennett,0,15,30,30
1650810466373,MATH 142A,B01,083221,Chow; Bennett,0,16,30,30
1650810466373,MATH 142A,B02,083222,Chow; Bennett,0,14,30,30
1650810472400,MATH 193A,A01,083224,Staff,0,6,30,30
1650810472400,MATH 193A,A02,083225,Staff,0,6,30,30
1650810472400,MATH 193A,A03,083781,Staff,0,6,30,30
1650810472400,MATH 193A,A04,083782,Staff,0,7,30,30
1650810478431,MATH 197,001,091859,McAuley; Julian John,9998,0,9999,1
1650810484496,COGS 9,A01,083615,Staff,0,17,60,60
1650810490524,COGS 11,A01,083617,Boyle; Mary E. T.,16,0,40,24
1650810496549,COGS 13,A01,083071,Staff,0,38,40,40
1650810502574,COGS 14A,A01,092681,Staff,0,36,100,100
1650810508605,COGS 14B,A01,083073,Cheng; Tzu-Han,0,12,50,50
1650810514630,COGS 17,A01,092677,Staff,11,0,75,64
1650810520654,COGS 100,A01,083619,Staff,0,29,60,60
1650810526678,COGS 101A,A01,083621,Davis; Joshua Daniel,0,28,60,60
1650810532703,COGS 101B,A01,091572,Staff,0,3,60,60
1650810538729,COGS 101C,A01,083625,Delgado; Tania,14,0,30,16
1650810544753,COGS 107A,A01,083627,Boyle; Mary E. T.,0,16,60,60
1650810550780,COGS 118A,A01,083075,Staff,0,8,60,60
1650810556809,CSE 3,A50,083646,Miranda; Gregory Joseph,18,0,38,20
1650810556809,CSE 3,A51,083647,Miranda; Gregory Joseph,36,0,37,1
1650810562833,CSE 8A,A50,083650,Miranda; Gregory Joseph,0,29,40,40
1650810568856,CSE 11,A01,083080,Cao; Yingjun,0,96,40,40
1650810574884,CSE 12,A01,083652,Staff,0,21,100,100
1650810580909,CSE 15L,A01,083654,Staff,0,3,50,50
1650810580909,CSE 15L,A02,083655,Staff,0,2,50,50
1650810586936,CSE 20,A01,083657,Staff,49,0,80,31
1650810592961,CSE 30,A01,083084,Eldon; John,0,75,40,40
1650810598989,CSE 100,A01,083659,Cao; Yingjun,0,71,50,50
1650810605017,CSE 134B,A01,083661,Powell; Thomas Allan,0,38,65,65
1650810611043,CSE 140,A01,083663,Staff,0,11,75,75
1650810617066,CSE 140L,A01,083088,Eldon; John,0,20,75,75
1650810623091,CSE 175,A01,083665,Kumar; Rakesh,7,0,25,18
1650810629116,CSE 190,A00,092507,Dubnov; Shlomo,10,0,20,10
1650810635141,ECE 45,A01,083139,Staff,0,1,60,60
1650810641166,ECE 65,A50,083695,Staff,0,5,30,30
1650810647189,ECE 109,A01,091882,Touri; Behrouz,32,0,70,38
1650810653214,ECE 180,A00,083140,Abi Samra; Nicholas Camill,20,0,30,10
1650810653214,ECE 180,B00,083141,Abi Samra; Nicholas Camill,0,0,30,30
1650810659246,MATH 10A,A01,083735,Patchell; Gregory David,2,0,30,28
1650810659246,MATH 10A,A02,083736,Patchell; Gregory David,27,0,30,3
1650810659246,MATH 10A,A03,083737,Patchell; Gregory David,24,0,30,6
1650810665278,MATH 10B,A01,083207,Staff,0,9,30,30
1650810665278,MATH 10B,A02,083208,Staff,0,6,30,30
1650810665278,MATH 10B,B01,083739,Staff,11,0,30,19
1650810665278,MATH 10B,B02,083740,Staff,28,0,30,2
1650810671308,MATH 18,A01,083743,Staff,0,0,30,30
1650810671308,MATH 18,A02,083744,Staff,23,0,30,7
1650810671308,MATH 18,A03,083745,Staff,21,0,30,9
1650810671308,MATH 18,A04,083746,Staff,26,0,30,4
1650810671308,MATH 18,B01,083748,Staff,0,15,30,30
1650810671308,MATH 18,B02,083749,Staff,0,12,30,30
1650810671308,MATH 18,B03,083750,Staff,0,12,30,30
1650810671308,MATH 18,B04,083751,Staff,0,12,30,30
1650810677340,MATH 20A,A01,083754,Staff,19,0,40,21
1650810683363,MATH 20B,A01,083756,Staff,0,13,30,30
1650810683363,MATH 20B,A02,083757,Staff,0,12,30,30
1650810689387,MATH 20C,A01,083760,Staff,0,17,30,30
1650810689387,MATH 20C,A02,083761,Staff,0,16,30,30
1650810689387,MATH 20C,B01,083762,Staff,9,0,30,21
1650810689387,MATH 20C,B02,083763,Staff,28,0,30,2
1650810695418,MATH 20D,A01,083765,Staff,2,1,30,28
1650810695418,MATH 20D,A02,083766,Staff,6,0,30,24
1650810695418,MATH 20D,A03,083767,Staff,24,0,30,6
1650810701526,MATH 20E,A01,083771,Staff,2,0,30,28
1650810701526,MATH 20E,A02,083772,Staff,15,0,30,15
1650810701526,MATH 20E,B01,083773,Staff,0,0,30,30
1650810701526,MATH 20E,B02,083774,Staff,5,0,30,25
1650810707550,MATH 103A,A01,083777,Staff,0,16,30,30
1650810707550,MATH 103A,A02,083778,Staff,0,15,30,30
1650810707550,MATH 103A,B01,083779,Staff,0,15,30,30
1650810707550,MATH 103A,B02,083780,Staff,0,15,30,30
1650810713573,MATH 105,A01,085443,Staff,0,22,30,30
1650810719596,MATH 109,A01,083213,Anzaldo; Leesa B,0,7,30,30
1650810719596,MATH 109,A02,083214,Anzaldo; Leesa B,0,7,30,30
1650810719596,MATH 109,B01,083215,Anzaldo; Leesa B,0,8,30,30
1650810719596,MATH 109,B02,083216,Anzaldo; Leesa B,0,7,30,30
1650810725619,MATH 142A,A01,083219,Chow; Bennett,0,16,30,30
1650810725619,MATH 142A,A02,083220,Chow; Bennett,0,15,30,30
1650810725619,MATH 142A,B01,083221,Chow; Bennett,0,16,30,30
1650810725619,MATH 142A,B02,083222,Chow; Bennett,0,14,30,30
1650810731642,MATH 193A,A01,083224,Staff,0,6,30,30
1650810731642,MATH 193A,A02,083225,Staff,0,6,30,30
1650810731642,MATH 193A,A03,083781,Staff,0,6,30,30
1650810731642,MATH 193A,A04,083782,Staff,0,7,30,30
1650810737664,MATH 197,001,091859,McAuley; Julian John,9998,0,9999,1
1650810743717,COGS 9,A01,083615,Staff,0,17,60,60
1650810749740,COGS 11,A01,083617,Boyle; Mary E. T.,16,0,40,24
1650810755769,COGS 13,A01,083071,Staff,0,38,40,40
1650810761793,COGS 14A,A01,092681,Staff,0,36,100,100
1650810767841,COGS 14B,A01,083073,Cheng; Tzu-Han,0,12,50,50
1650810773871,COGS 17,A01,092677,Staff,11,0,75,64
1650810779901,COGS 100,A01,083619,Staff,0,29,60,60
1650810785933,COGS 101A,A01,083621,Davis; Joshua Daniel,0,28,60,60
1650810791957,COGS 101B,A01,091572,Staff,0,3,60,60
1650810797982,COGS 101C,A01,083625,Delgado; Tania,14,0,30,16
1650810804012,COGS 107A,A01,083627,Boyle; Mary E. T.,0,16,60,60
1650810810035,COGS 118A,A01,083075,Staff,0,8,60,60
1650810816063,CSE 3,A50,083646,Miranda; Gregory Joseph,18,0,38,20
1650810816063,CSE 3,A51,083647,Miranda; Gregory Joseph,36,0,37,1
1650810822091,CSE 8A,A50,083650,Miranda; Gregory Joseph,0,29,40,40
1650810828115,CSE 11,A01,083080,Cao; Yingjun,0,96,40,40
1650810834139,CSE 12,A01,083652,Staff,0,21,100,100
1650810840164,CSE 15L,A01,083654,Staff,0,3,50,50
1650810840164,CSE 15L,A02,083655,Staff,0,2,50,50
1650810846187,CSE 20,A01,083657,Staff,49,0,80,31
1650810852213,CSE 30,A01,083084,Eldon; John,0,75,40,40
1650810858238,CSE 100,A01,083659,Cao; Yingjun,0,71,50,50
1650810864262,CSE 134B,A01,083661,Powell; Thomas Allan,0,38,65,65
1650810870286,CSE 140,A01,083663,Staff,0,11,75,75
1650810876313,CSE 140L,A01,083088,Eldon; John,0,20,75,75
1650810882336,CSE 175,A01,083665,Kumar; Rakesh,7,0,25,18
1650810888362,CSE 190,A00,092507,Dubnov; Shlomo,10,0,20,10
1650810894387,ECE 45,A01,083139,Staff,0,1,60,60
1650810900408,ECE 65,A50,083695,Staff,0,5,30,30
1650810906433,ECE 109,A01,091882,Touri; Behrouz,32,0,70,38
1650810912468,ECE 180,A00,083140,Abi Samra; Nicholas Camill,20,0,30,10
1650810912468,ECE 180,B00,083141,Abi Samra; Nicholas Camill,0,0,30,30
1650810918496,MATH 10A,A01,083735,Patchell; Gregory David,2,0,30,28
1650810918496,MATH 10A,A02,083736,Patchell; Gregory David,27,0,30,3
1650810918496,MATH 10A,A03,083737,Patchell; Gregory David,24,0,30,6
1650810924524,MATH 10B,A01,083207,Staff,0,9,30,30
1650810924524,MATH 10B,A02,083208,Staff,0,6,30,30
1650810924524,MATH 10B,B01,083739,Staff,11,0,30,19
1650810924524,MATH 10B,B02,083740,Staff,28,0,30,2
1650810930550,MATH 18,A01,083743,Staff,0,0,30,30
1650810930550,MATH 18,A02,083744,Staff,23,0,30,7
1650810930550,MATH 18,A03,083745,Staff,21,0,30,9
1650810930550,MATH 18,A04,083746,Staff,26,0,30,4
1650810930550,MATH 18,B01,083748,Staff,0,15,30,30
1650810930550,MATH 18,B02,083749,Staff,0,12,30,30
1650810930550,MATH 18,B03,083750,Staff,0,12,30,30
1650810930550,MATH 18,B04,083751,Staff,0,12,30,30
1650810936574,MATH 20A,A01,083754,Staff,19,0,40,21
1650810942599,MATH 20B,A01,083756,Staff,0,13,30,30
1650810942599,MATH 20B,A02,083757,Staff,0,12,30,30
1650810948628,MATH 20C,A01,083760,Staff,0,17,30,30
1650810948628,MATH 20C,A02,083761,Staff,0,16,30,30
1650810948628,MATH 20C,B01,083762,Staff,9,0,30,21
1650810948628,MATH 20C,B02,083763,Staff,28,0,30,2
1650810954652,MATH 20D,A01,083765,Staff,2,1,30,28
1650810954652,MATH 20D,A02,083766,Staff,6,0,30,24
1650810954652,MATH 20D,A03,083767,Staff,24,0,30,6
1650810960677,MATH 20E,A01,083771,Staff,2,0,30,28
1650810960677,MATH 20E,A02,083772,Staff,15,0,30,15
1650810960677,MATH 20E,B01,083773,Staff,0,0,30,30
1650810960677,MATH 20E,B02,083774,Staff,5,0,30,25
1650810966704,MATH 103A,A01,083777,Staff,0,16,30,30
1650810966704,MATH 103A,A02,083778,Staff,0,15,30,30
1650810966704,MATH 103A,B01,083779,Staff,0,15,30,30
1650810966704,MATH 103A,B02,083780,Staff,0,15,30,30
1650810972728,MATH 105,A01,085443,Staff,0,22,30,30
1650810978751,MATH 109,A01,083213,Anzaldo; Leesa B,0,7,30,30
1650810978751,MATH 109,A02,083214,Anzaldo; Leesa B,0,7,30,30
1650810978751,MATH 109,B01,083215,Anzaldo; Leesa B,0,8,30,30
1650810978751,MATH 109,B02,083216,Anzaldo; Leesa B,0,7,30,30
1650810984779,MATH 142A,A01,083219,Chow; Bennett,0,16,30,30
1650810984779,MATH 142A,A02,083220,Chow; Bennett,0,15,30,30
1650810984779,MATH 142A,B01,083221,Chow; Bennett,0,16,30,30
1650810984779,MATH 142A,B02,083222,Chow; Bennett,0,14,30,30
1650810990807,MATH 193A,A01,083224,Staff,0,6,30,30
1650810990807,MATH 193A,A02,083225,Staff,0,6,30,30
1650810990807,MATH 193A,A03,083781,Staff,0,6,30,30
1650810990807,MATH 193A,A04,083782,Staff,0,7,30,30
1650810996833,MATH 197,001,091859,McAuley; Julian John,9998,0,9999,1
1650811002891,COGS 9,A01,083615,Staff,0,17,60,60
1650811008918,COGS 11,A01,083617,Boyle; Mary E. T.,16,0,40,24
1650811014943,COGS 13,A01,083071,Staff,0,38,40,40
1650811020967,COGS 14A,A01,092681,Staff,0,36,100,100
1650811026991,COGS 14B,A01,083073,Cheng; Tzu-Han,0,12,50,50
1650811033015,COGS 17,A01,092677,Staff,11,0,75,64
1650811039040,COGS 100,A01,083619,Staff,0,29,60,60
1650811045066,COGS 101A,A01,083621,Davis; Joshua Daniel,0,28,60,60
1650811051091,COGS 101B,A01,091572,Staff,0,3,60,60
1650811057117,COGS 101C,A01,083625,Delgado; Tania,14,0,30,16
1650811063142,COGS 107A,A01,083627,Boyle; Mary E. T.,0,16,60,60
1650811069170,COGS 118A,A01,083075,Staff,0,8,60,60
1650811075205,CSE 3,A50,083646,Miranda; Gregory Joseph,18,0,38,20
1650811075205,CSE 3,A51,083647,Miranda; Gregory Joseph,36,0,37,1
1650811081231,CSE 8A,A50,083650,Miranda; Gregory Joseph,0,29,40,40
1650811087257,CSE 11,A01,083080,Cao; Yingjun,0,96,40,40
1650811093280,CSE 12,A01,083652,Staff,0,21,100,100
1650811099302,CSE 15L,A01,083654,Staff,0,3,50,50
1650811099302,CSE 15L,A02,083655,Staff,0,2,50,50
1650811105326,CSE 20,A01,083657,Staff,49,0,80,31
1650811111351,CSE 30,A01,083084,Eldon; John,0,75,40,40
1650811117375,CSE 100,A01,083659,Cao; Yingjun,0,71,50,50
1650811123399,CSE 134B,A01,083661,Powell; Thomas Allan,0,38,65,65
1650811129425,CSE 140,A01,083663,Staff,0,11,75,75
1650811135465,CSE 140L,A01,083088,Eldon; John,0,20,75,75
1650811141488,CSE 175,A01,083665,Kumar; Rakesh,7,0,25,18
1650811147512,CSE 190,A00,092507,Dubnov; Shlomo,10,0,20,10
1650811153539,ECE 45,A01,083139,Staff,0,1,60,60
1650811159566,ECE 65,A50,083695,Staff,0,5,30,30
1650811165591,ECE 109,A01,091882,Touri; Behrouz,32,0,70,38
1650811171616,ECE 180,A00,083140,Abi Samra; Nicholas Camill,20,0,30,10
1650811171616,ECE 180,B00,083141,Abi Samra; Nicholas Camill,0,0,30,30
1650811177642,MATH 10A,A01,083735,Patchell; Gregory David,2,0,30,28
1650811177642,MATH 10A,A02,083736,Patchell; Gregory David,27,0,30,3
1650811177642,MATH 10A,A03,083737,Patchell; Gregory David,24,0,30,6
1650811183667,MATH 10B,A01,083207,Staff,0,9,30,30
1650811183667,MATH 10B,A02,083208,Staff,0,6,30,30
1650811183667,MATH 10B,B01,083739,Staff,11,0,30,19
1650811183667,MATH 10B,B02,083740,Staff,28,0,30,2
1650811189692,MATH 18,A01,083743,Staff,0,0,30,30
1650811189692,MATH 18,A02,083744,Staff,23,0,30,7
1650811189692,MATH 18,A03,083745,Staff,21,0,30,9
1650811189692,MATH 18,A04,083746,Staff,26,0,30,4
1650811189692,MATH 18,B01,083748,Staff,0,15,30,30
1650811189692,MATH 18,B02,083749,Staff,0,12,30,30
1650811189692,MATH 18,B03,083750,Staff,0,12,30,30
1650811189692,MATH 18,B04,083751,Staff,0,12,30,30
1650811195720,MATH 20A,A01,083754,Staff,19,0,40,21
1650811201743,MATH 20B,A01,083756,Staff,0,13,30,30
1650811201743,MATH 20B,A02,083757,Staff,0,12,30,30
1650811207771,MATH 20C,A01,083760,Staff,0,17,30,30
1650811207771,MATH 20C,A02,083761,Staff,0,16,30,30
1650811207771,MATH 20C,B01,083762,Staff,9,0,30,21
1650811207771,MATH 20C,B02,083763,Staff,28,0,30,2
1650811213802,MATH 20D,A01,083765,Staff,2,1,30,28
1650811213802,MATH 20D,A02,083766,Staff,6,0,30,24
1650811213802,MATH 20D,A03,083767,Staff,24,0,30,6
1650811219837,MATH 20E,A01,083771,Staff,2,0,30,28
1650811219837,MATH 20E,A02,083772,Staff,15,0,30,15
1650811219837,MATH 20E,B01,083773,Staff,0,0,30,30
1650811219837,MATH 20E,B02,083774,Staff,5,0,30,25
1650811225862,MATH 103A,A01,083777,Staff,0,16,30,30
1650811225862,MATH 103A,A02,083778,Staff,0,15,30,30
1650811225862,MATH 103A,B01,083779,Staff,0,15,30,30
1650811225862,MATH 103A,B02,083780,Staff,0,15,30,30
1650811231889,MATH 105,A01,085443,Staff,0,22,30,30
1650811237918,MATH 109,A01,083213,Anzaldo; Leesa B,0,7,30,30
1650811237918,MATH 109,A02,083214,Anzaldo; Leesa B,0,7,30,30
1650811237918,MATH 109,B01,083215,Anzaldo; Leesa B,0,8,30,30
1650811237918,MATH 109,B02,083216,Anzaldo; Leesa B,0,7,30,30
1650811243942,MATH 142A,A01,083219,Chow; Bennett,0,16,30,30
1650811243942,MATH 142A,A02,083220,Chow; Bennett,0,15,30,30
1650811243942,MATH 142A,B01,083221,Chow; Bennett,0,16,30,30
1650811243942,MATH 142A,B02,083222,Chow; Bennett,0,14,30,30
1650811249967,MATH 193A,A01,083224,Staff,0,6,30,30
1650811249967,MATH 193A,A02,083225,Staff,0,6,30,30
1650811249967,MATH 193A,A03,083781,Staff,0,6,30,30
1650811249967,MATH 193A,A04,083782,Staff,0,7,30,30
1650811255991,MATH 197,001,091859,McAuley; Julian John,9998,0,9999,1
1650811262059,COGS 9,A01,083615,Staff,0,17,60,60
1650811268083,COGS 11,A01,083617,Boyle; Mary E. T.,16,0,40,24
1650811274111,COGS 13,A01,083071,Staff,0,38,40,40
1650811280138,COGS 14A,A01,092681,Staff,0,36,100,100
1650811286166,COGS 14B,A01,083073,Cheng; Tzu-Han,0,12,50,50
1650811292261,COGS 17,A01,092677,Staff,11,0,75,64
1650811298286,COGS 100,A01,083619,Staff,0,29,60,60
1650811304308,COGS 101A,A01,083621,Davis; Joshua Daniel,0,28,60,60
1650811310335,COGS 101B,A01,091572,Staff,0,3,60,60
1650811316359,COGS 101C,A01,083625,Delgado; Tania,14,0,30,16
1650811322384,COGS 107A,A01,083627,Boyle; Mary E. T.,0,16,60,60
1650811328410,COGS 118A,A01,083075,Staff,0,8,60,60
1650811334434,CSE 3,A50,083646,Miranda; Gregory Joseph,18,0,38,20
1650811334434,CSE 3,A51,083647,Miranda; Gregory Joseph,36,0,37,1
1650811340457,CSE 8A,A50,083650,Miranda; Gregory Joseph,0,29,40,40
1650811346482,CSE 11,A01,083080,Cao; Yingjun,0,96,40,40
1650811352505,CSE 12,A01,083652,Staff,0,21,100,100
1650811358540,CSE 15L,A01,083654,Staff,0,3,50,50
1650811358540,CSE 15L,A02,083655,Staff,0,2,50,50
1650811364565,CSE 20,A01,083657,Staff,49,0,80,31
1650811370588,CSE 30,A01,083084,Eldon; John,0,75,40,40
1650811376612,CSE 100,A01,083659,Cao; Yingjun,0,71,50,50
1650811382635,CSE 134B,A01,083661,Powell; Thomas Allan,0,38,65,65
1650811388667,CSE 140,A01,083663,Staff,0,11,75,75
1650811394694,CSE 140L,A01,083088,Eldon; John,0,20,75,75
1650811400720,CSE 175,A01,083665,Kumar; Rakesh,7,0,25,18
1650811406747,CSE 190,A00,092507,Dubnov; Shlomo,10,0,20,10
1650811412771,ECE 45,A01,083139,Staff,0,1,60,60
1650811418794,ECE 65,A50,083695,Staff,0,5,30,30
1650811424821,ECE 109,A01,091882,Touri; Behrouz,32,0,70,38
1650811430862,ECE 180,A00,083140,Abi Samra; Nicholas Camill,20,0,30,10
1650811430862,ECE 180,B00,083141,Abi Samra; Nicholas Camill,0,0,30,30
1650811436885,MATH 10A,A01,083735,Patchell; Gregory David,2,0,30,28
1650811436885,MATH 10A,A02,083736,Patchell; Gregory David,27,0,30,3
1650811436885,MATH 10A,A03,083737,Patchell; Gregory David,24,0,30,6
1650811442909,MATH 10B,A01,083207,Staff,0,9,30,30
1650811442909,MATH 10B,A02,083208,Staff,0,6,30,30
1650811442909,MATH 10B,B01,083739,Staff,11,0,30,19
1650811442909,MATH 10B,B02,083740,Staff,28,0,30,2
1650811448936,MATH 18,A01,083743,Staff,0,0,30,30
1650811448936,MATH 18,A02,083744,Staff,23,0,30,7
1650811448936,MATH 18,A03,083745,Staff,21,0,30,9
1650811448936,MATH 18,A04,083746,Staff,26,0,30,4
1650811448936,MATH 18,B01,083748,Staff,0,15,30,30
1650811448936,MATH 18,B02,083749,Staff,0,12,30,30
1650811448936,MATH 18,B03,083750,Staff,0,12,30,30
1650811448936,MATH 18,B04,083751,Staff,0,12,30,30
1650811454966,MATH 20A,A01,083754,Staff,19,0,40,21
1650811460989,MATH 20B,A01,083756,Staff,0,13,30,30
1650811460989,MATH 20B,A02,083757,Staff,0,12,30,30
1650811467014,MATH 20C,A01,083760,Staff,0,17,30,30
1650811467014,MATH 20C,A02,083761,Staff,0,16,30,30
1650811467014,MATH 20C,B01,083762,Staff,9,0,30,21
1650811467014,MATH 20C,B02,083763,Staff,28,0,30,2
1650811473041,MATH 20D,A01,083765,Staff,2,1,30,28
1650811473041,MATH 20D,A02,083766,Staff,6,0,30,24
1650811473041,MATH 20D,A03,083767,Staff,24,0,30,6
1650811479069,MATH 20E,A01,083771,Staff,2,0,30,28
1650811479069,MATH 20E,A02,083772,Staff,15,0,30,15
1650811479069,MATH 20E,B01,083773,Staff,0,0,30,30
1650811479069,MATH 20E,B02,083774,Staff,5,0,30,25
1650811485097,MATH 103A,A01,083777,Staff,0,16,30,30
1650811485097,MATH 103A,A02,083778,Staff,0,15,30,30
1650811485097,MATH 103A,B01,083779,Staff,0,15,30,30
1650811485097,MATH 103A,B02,083780,Staff,0,15,30,30
1650811491124,MATH 105,A01,085443,Staff,0,22,30,30
1650811497149,MATH 109,A01,083213,Anzaldo; Leesa B,0,7,30,30
1650811497149,MATH 109,A02,083214,Anzaldo; Leesa B,0,7,30,30
1650811497149,MATH 109,B01,083215,Anzaldo; Leesa B,0,8,30,30
1650811497149,MATH 109,B02,083216,Anzaldo; Leesa B,0,7,30,30
1650811503177,MATH 142A,A01,083219,Chow; Bennett,0,16,30,30
1650811503177,MATH 142A,A02,083220,Chow; Bennett,0,15,30,30
1650811503177,MATH 142A,B01,083221,Chow; Bennett,0,16,30,30
1650811503177,MATH 142A,B02,083222,Chow; Bennett,0,14,30,30
1650811509200,MATH 193A,A01,083224,Staff,0,6,30,30
1650811509200,MATH 193A,A02,083225,Staff,0,6,30,30
1650811509200,MATH 193A,A03,083781,Staff,0,6,30,30
1650811509200,MATH 193A,A04,083782,Staff,0,7,30,30
1650811515224,MATH 197,001,091859,McAuley; Julian John,9998,0,9999,1
1650811521283,COGS 9,A01,083615,Staff,0,17,60,60
1650811527308,COGS 11,A01,083617,Boyle; Mary E. T.,16,0,40,24
1650811533334,COGS 13,A01,083071,Staff,0,38,40,40
1650811539358,COGS 14A,A01,092681,Staff,0,36,100,100
1650811545395,COGS 14B,A01,083073,Cheng; Tzu-Han,0,12,50,50
1650811551421,COGS 17,A01,092677,Staff,11,0,75,64
1650811557452,COGS 100,A01,083619,Staff,0,29,60,60
1650811563476,COGS 101A,A01,083621,Davis; Joshua Daniel,0,28,60,60
1650811569502,COGS 101B,A01,091572,Staff,0,3,60,60
1650811575527,COGS 101C,A01,083625,Delgado; Tania,14,0,30,16
1650811581552,COGS 107A,A01,083627,Boyle; Mary E. T.,0,16,60,60
1650811587576,COGS 118A,A01,083075,Staff,0,8,60,60
1650811593600,CSE 3,A50,083646,Miranda; Gregory Joseph,18,0,38,20
1650811593600,CSE 3,A51,083647,Miranda; Gregory Joseph,36,0,37,1
1650811599623,CSE 8A,A50,083650,Miranda; Gregory Joseph,0,29,40,40
1650811605649,CSE 11,A01,083080,Cao; Yingjun,0,96,40,40
1650811611673,CSE 12,A01,083652,Staff,0,21,100,100
1650811617697,CSE 15L,A01,083654,Staff,0,3,50,50
1650811617697,CSE 15L,A02,083655,Staff,0,2,50,50
1650811623725,CSE 20,A01,083657,Staff,49,0,80,31
1650811629752,CSE 30,A01,083084,Eldon; John,0,75,40,40
1650811635777,CSE 100,A01,083659,Cao; Yingjun,0,71,50,50
1650811641800,CSE 134B,A01,083661,Powell; Thomas Allan,0,38,65,65
1650811647827,CSE 140,A01,083663,Staff,0,11,75,75
1650811653855,CSE 140L,A01,083088,Eldon; John,0,20,75,75
1650811659882,CSE 175,A01,083665,Kumar; Rakesh,7,0,25,18
1650811665906,CSE 190,A00,092507,Dubnov; Shlomo,10,0,20,10
1650811671930,ECE 45,A01,083139,Staff,0,1,60,60
1650811677954,ECE 65,A50,083695,Staff,0,5,30,30
1650811683985,ECE 109,A01,091882,Touri; Behrouz,32,0,70,38
1650811690011,ECE 180,A00,083140,Abi Samra; Nicholas Camill,20,0,30,10
1650811690011,ECE 180,B00,083141,Abi Samra; Nicholas Camill,0,0,30,30
1650811696039,MATH 10A,A01,083735,Patchell; Gregory David,2,0,30,28
1650811696039,MATH 10A,A02,083736,Patchell; Gregory David,27,0,30,3
1650811696039,MATH 10A,A03,083737,Patchell; Gregory David,24,0,30,6
1650811702066,MATH 10B,A01,083207,Staff,0,9,30,30
1650811702066,MATH 10B,A02,083208,Staff,0,6,30,30
1650811702066,MATH 10B,B01,083739,Staff,11,0,30,19
1650811702066,MATH 10B,B02,083740,Staff,28,0,30,2
1650811708092,MATH 18,A01,083743,Staff,0,0,30,30
1650811708092,MATH 18,A02,083744,Staff,23,0,30,7
1650811708092,MATH 18,A03,083745,Staff,21,0,30,9
1650811708092,MATH 18,A04,083746,Staff,26,0,30,4
1650811708092,MATH 18,B01,083748,Staff,0,15,30,30
1650811708092,MATH 18,B02,083749,Staff,0,12,30,30
1650811708092,MATH 18,B03,083750,Staff,0,12,30,30
1650811708092,MATH 18,B04,083751,Staff,0,12,30,30
1650811714117,MATH 20A,A01,083754,Staff,19,0,40,21
1650811720143,MATH 20B,A01,083756,Staff,0,13,30,30
1650811720143,MATH 20B,A02,083757,Staff,0,12,30,30
1650811726173,MATH 20C,A01,083760,Staff,0,17,30,30
1650811726173,MATH 20C,A02,083761,Staff,0,16,30,30
1650811726173,MATH 20C,B01,083762,Staff,9,0,30,21
1650811726173,MATH 20C,B02,083763,Staff,28,0,30,2
1650811732197,MATH 20D,A01,083765,Staff,2,1,30,28
1650811732197,MATH 20D,A02,083766,Staff,6,0,30,24
1650811732197,MATH 20D,A03,083767,Staff,24,0,30,6
1650811738223,MATH 20E,A01,083771,Staff,2,0,30,28
1650811738223,MATH 20E,A02,083772,Staff,15,0,30,15
1650811738223,MATH 20E,B01,083773,Staff,0,0,30,30
1650811738223,MATH 20E,B02,083774,Staff,5,0,30,25
1650811744248,MATH 103A,A01,083777,Staff,0,16,30,30
1650811744248,MATH 103A,A02,083778,Staff,0,15,30,30
1650811744248,MATH 103A,B01,083779,Staff,0,15,30,30
1650811744248,MATH 103A,B02,083780,Staff,0,15,30,30
1650811750271,MATH 105,A01,085443,Staff,0,22,30,30
1650811756301,MATH 109,A01,083213,Anzaldo; Leesa B,0,7,30,30
1650811756301,MATH 109,A02,083214,Anzaldo; Leesa B,0,7,30,30
1650811756301,MATH 109,B01,083215,Anzaldo; Leesa B,0,8,30,30
1650811756301,MATH 109,B02,083216,Anzaldo; Leesa B,0,7,30,30
1650811762325,MATH 142A,A01,083219,Chow; Bennett,0,16,30,30
1650811762325,MATH 142A,A02,083220,Chow; Bennett,0,15,30,30
1650811762325,MATH 142A,B01,083221,Chow; Bennett,0,16,30,30
1650811762325,MATH 142A,B02,083222,Chow; Bennett,0,14,30,30
1650811768352,MATH 193A,A01,083224,Staff,0,6,30,30
1650811768352,MATH 193A,A02,083225,Staff,0,6,30,30
1650811768352,MATH 193A,A03,083781,Staff,0,6,30,30
1650811768352,MATH 193A,A04,083782,Staff,0,7,30,30
1650811774379,MATH 197,001,091859,McAuley; Julian John,9998,0,9999,1
1650811780431,COGS 9,A01,083615,Staff,0,17,60,60
1650811786455,COGS 11,A01,083617,Boyle; Mary E. T.,16,0,40,24
1650811792483,COGS 13,A01,083071,Staff,0,38,40,40
1650811798508,COGS 14A,A01,092681,Staff,0,36,100,100
1650811804530,COGS 14B,A01,083073,Cheng; Tzu-Han,0,12,50,50
1650811810557,COGS 17,A01,092677,Staff,11,0,75,64
1650811816578,COGS 100,A01,083619,Staff,0,29,60,60
1650811822606,COGS 101A,A01,083621,Davis; Joshua Daniel,0,28,60,60
1650811828629,COGS 101B,A01,091572,Staff,0,3,60,60
1650811834655,COGS 101C,A01,083625,Delgado; Tania,14,0,30,16
1650811840678,COGS 107A,A01,083627,Boyle; Mary E. T.,0,16,60,60
1650811846708,COGS 118A,A01,083075,Staff,0,8,60,60
1650811852737,CSE 3,A50,083646,Miranda; Gregory Joseph,18,0,38,20
1650811852737,CSE 3,A51,083647,Miranda; Gregory Joseph,36,0,37,1
1650811858760,CSE 8A,A50,083650,Miranda; Gregory Joseph,0,29,40,40
1650811864786,CSE 11,A01,083080,Cao; Yingjun,0,96,40,40
1650811870811,CSE 12,A01,083652,Staff,0,21,100,100
1650811876833,CSE 15L,A01,083654,Staff,0,3,50,50
1650811876833,CSE 15L,A02,083655,Staff,0,2,50,50
1650811882857,CSE 20,A01,083657,Staff,49,0,80,31
1650811888969,CSE 30,A01,083084,Eldon; John,0,75,40,40
1650811894994,CSE 100,A01,083659,Cao; Yingjun,0,71,50,50
1650811901021,CSE 134B,A01,083661,Powell; Thomas Allan,0,38,65,65
1650811907052,CSE 140,A01,083663,Staff,0,11,75,75
1650811913076,CSE 140L,A01,083088,Eldon; John,0,20,75,75
1650811919101,CSE 175,A01,083665,Kumar; Rakesh,7,0,25,18
1650811925123,CSE 190,A00,092507,Dubnov; Shlomo,10,0,20,10
1650811931146,ECE 45,A01,083139,Staff,0,1,60,60
1650811937186,ECE 65,A50,083695,Staff,0,5,30,30
1650811943209,ECE 109,A01,091882,Touri; Behrouz,32,0,70,38
1650811949242,ECE 180,A00,083140,Abi Samra; Nicholas Camill,20,0,30,10
1650811949242,ECE 180,B00,083141,Abi Samra; Nicholas Camill,0,0,30,30
1650811955267,MATH 10A,A01,083735,Patchell; Gregory David,2,0,30,28
1650811955267,MATH 10A,A02,083736,Patchell; Gregory David,27,0,30,3
1650811955267,MATH 10A,A03,083737,Patchell; Gregory David,24,0,30,6
1650811961291,MATH 10B,A01,083207,Staff,0,9,30,30
1650811961291,MATH 10B,A02,083208,Staff,0,6,30,30
1650811961291,MATH 10B,B01,083739,Staff,11,0,30,19
1650811961291,MATH 10B,B02,083740,Staff,28,0,30,2
1650811967322,MATH 18,A01,083743,Staff,0,0,30,30
1650811967322,MATH 18,A02,083744,Staff,23,0,30,7
1650811967322,MATH 18,A03,083745,Staff,21,0,30,9
1650811967322,MATH 18,A04,083746,Staff,26,0,30,4
1650811967322,MATH 18,B01,083748,Staff,0,15,30,30
1650811967322,MATH 18,B02,083749,Staff,0,12,30,30
1650811967322,MATH 18,B03,083750,Staff,0,12,30,30
1650811967322,MATH 18,B04,083751,Staff,0,12,30,30
1650811973348,MATH 20A,A01,083754,Staff,19,0,40,21
1650811979372,MATH 20B,A01,083756,Staff,0,13,30,30
1650811979372,MATH 20B,A02,083757,Staff,0,12,30,30
1650811985399,MATH 20C,A01,083760,Staff,0,17,30,30
1650811985399,MATH 20C,A02,083761,Staff,0,16,30,30
1650811985399,MATH 20C,B01,083762,Staff,9,0,30,21
1650811985399,MATH 20C,B02,083763,Staff,28,0,30,2
1650811991421,MATH 20D,A01,083765,Staff,2,1,30,28
1650811991421,MATH 20D,A02,083766,Staff,6,0,30,24
1650811991421,MATH 20D,A03,083767,Staff,24,0,30,6
1650811997445,MATH 20E,A01,083771,Staff,2,0,30,28
1650811997445,MATH 20E,A02,083772,Staff,15,0,30,15
1650811997445,MATH 20E,B01,083773,Staff,0,0,30,30
1650811997445,MATH 20E,B02,083774,Staff,5,0,30,25
1650812003470,MATH 103A,A01,083777,Staff,0,16,30,30
1650812003470,MATH 103A,A02,083778,Staff,0,15,30,30
1650812003470,MATH 103A,B01,083779,Staff,0,15,30,30
1650812003470,MATH 103A,B02,083780,Staff,0,15,30,30
1650812009492,MATH 105,A01,085443,Staff,0,22,30,30
1650812015514,MATH 109,A01,083213,Anzaldo; Leesa B,0,7,30,30
1650812015514,MATH 109,A02,083214,Anzaldo; Leesa B,0,7,30,30
1650812015514,MATH 109,B01,083215,Anzaldo; Leesa B,0,8,30,30
1650812015514,MATH 109,B02,083216,Anzaldo; Leesa B,0,7,30,30
1650812021541,MATH 142A,A01,083219,Chow; Bennett,0,16,30,30
1650812021541,MATH 142A,A02,083220,Chow; Bennett,0,15,30,30
1650812021541,MATH 142A,B01,083221,Chow; Bennett,0,16,30,30
1650812021541,MATH 142A,B02,083222,Chow; Bennett,0,14,30,30
1650812027568,MATH 193A,A01,083224,Staff,0,6,30,30
1650812027568,MATH 193A,A02,083225,Staff,0,6,30,30
1650812027568,MATH 193A,A03,083781,Staff,0,6,30,30
1650812027568,MATH 193A,A04,083782,Staff,0,7,30,30
1650812033590,MATH 197,001,091859,McAuley; Julian John,9998,0,9999,1
1650812039644,COGS 9,A01,083615,Staff,0,17,60,60
1650812045667,COGS 11,A01,083617,Boyle; Mary E. T.,16,0,40,24
1650812051690,COGS 13,A01,083071,Staff,0,38,40,40
1650812057714,COGS 14A,A01,092681,Staff,0,36,100,100
1650812063738,COGS 14B,A01,083073,Cheng; Tzu-Han,0,12,50,50
1650812069765,COGS 17,A01,092677,Staff,11,0,75,64
1650812075789,COGS 100,A01,083619,Staff,0,29,60,60
1650812081812,COGS 101A,A01,083621,Davis; Joshua Daniel,0,28,60,60
1650812087836,COGS 101B,A01,091572,Staff,0,3,60,60
1650812093860,COGS 101C,A01,083625,Delgado; Tania,14,0,30,16
1650812099885,COGS 107A,A01,083627,Boyle; Mary E. T.,0,16,60,60
1650812105908,COGS 118A,A01,083075,Staff,0,8,60,60
1650812111937,CSE 3,A50,083646,Miranda; Gregory Joseph,18,0,38,20
1650812111937,CSE 3,A51,083647,Miranda; Gregory Joseph,36,0,37,1
1650812117959,CSE 8A,A50,083650,Miranda; Gregory Joseph,0,29,40,40
1650812123986,CSE 11,A01,083080,Cao; Yingjun,0,96,40,40
1650812130018,CSE 12,A01,083652,Staff,0,21,100,100
1650812136045,CSE 15L,A01,083654,Staff,0,3,50,50
1650812136045,CSE 15L,A02,083655,Staff,0,2,50,50
1650812142068,CSE 20,A01,083657,Staff,49,0,80,31
1650812148092,CSE 30,A01,083084,Eldon; John,0,75,40,40
1650812154116,CSE 100,A01,083659,Cao; Yingjun,0,71,50,50
1650812160140,CSE 134B,A01,083661,Powell; Thomas Allan,0,38,65,65
1650812166164,CSE 140,A01,083663,Staff,0,11,75,75
1650812172191,CSE 140L,A01,083088,Eldon; John,0,20,75,75
1650812178215,CSE 175,A01,083665,Kumar; Rakesh,7,0,25,18
1650812184240,CSE 190,A00,092507,Dubnov; Shlomo,10,0,20,10
1650812190264,ECE 45,A01,083139,Staff,0,1,60,60
1650812196290,ECE 65,A50,083695,Staff,0,5,30,30
1650812202317,ECE 109,A01,091882,Touri; Behrouz,32,0,70,38
1650812208342,ECE 180,A00,083140,Abi Samra; Nicholas Camill,20,0,30,10
1650812208342,ECE 180,B00,083141,Abi Samra; Nicholas Camill,0,0,30,30
1650812214369,MATH 10A,A01,083735,Patchell; Gregory David,2,0,30,28
1650812214369,MATH 10A,A02,083736,Patchell; Gregory David,27,0,30,3
1650812214369,MATH 10A,A03,083737,Patchell; Gregory David,24,0,30,6
1650812220394,MATH 10B,A01,083207,Staff,0,9,30,30
1650812220394,MATH 10B,A02,083208,Staff,0,6,30,30
1650812220394,MATH 10B,B01,083739,Staff,11,0,30,19
1650812220394,MATH 10B,B02,083740,Staff,28,0,30,2
1650812226419,MATH 18,A01,083743,Staff,0,0,30,30
1650812226419,MATH 18,A02,083744,Staff,23,0,30,7
1650812226419,MATH 18,A03,083745,Staff,21,0,30,9
1650812226419,MATH 18,A04,083746,Staff,26,0,30,4
1650812226419,MATH 18,B01,083748,Staff,0,15,30,30
1650812226419,MATH 18,B02,083749,Staff,0,12,30,30
1650812226419,MATH 18,B03,083750,Staff,0,12,30,30
1650812226419,MATH 18,B04,083751,Staff,0,12,30,30
1650812232445,MATH 20A,A01,083754,Staff,19,0,40,21
1650812238468,MATH 20B,A01,083756,Staff,0,13,30,30
1650812238468,MATH 20B,A02,083757,Staff,0,12,30,30
1650812244497,MATH 20C,A01,083760,Staff,0,17,30,30
1650812244497,MATH 20C,A02,083761,Staff,0,16,30,30
1650812244497,MATH 20C,B01,083762,Staff,9,0,30,21
1650812244497,MATH 20C,B02,083763,Staff,28,0,30,2
1650812250524,MATH 20D,A01,083765,Staff,2,1,30,28
1650812250524,MATH 20D,A02,083766,Staff,6,0,30,24
1650812250524,MATH 20D,A03,083767,Staff,24,0,30,6
1650812256553,MATH 20E,A01,083771,Staff,2,0,30,28
1650812256553,MATH 20E,A02,083772,Staff,15,0,30,15
1650812256553,MATH 20E,B01,083773,Staff,0,0,30,30
1650812256553,MATH 20E,B02,083774,Staff,5,0,30,25
1650812262584,MATH 103A,A01,083777,Staff,0,16,30,30
1650812262584,MATH 103A,A02,083778,Staff,0,15,30,30
1650812262584,MATH 103A,B01,083779,Staff,0,15,30,30
1650812262584,MATH 103A,B02,083780,Staff,0,15,30,30
1650812268608,MATH 105,A01,085443,Staff,0,22,30,30
1650812274638,MATH 109,A01,083213,Anzaldo; Leesa B,0,7,30,30
1650812274638,MATH 109,A02,083214,Anzaldo; Leesa B,0,7,30,30
1650812274638,MATH 109,B01,083215,Anzaldo; Leesa B,0,8,30,30
1650812274638,MATH 109,B02,083216,Anzaldo; Leesa B,0,7,30,30
1650812280663,MATH 142A,A01,083219,Chow; Bennett,0,16,30,30
1650812280663,MATH 142A,A02,083220,Chow; Bennett,0,15,30,30
1650812280663,MATH 142A,B01,083221,Chow; Bennett,0,16,30,30
1650812280663,MATH 142A,B02,083222,Chow; Bennett,0,14,30,30
1650812286688,MATH 193A,A01,083224,Staff,0,6,30,30
1650812286688,MATH 193A,A02,083225,Staff,0,6,30,30
1650812286688,MATH 193A,A03,083781,Staff,0,6,30,30
1650812286688,MATH 193A,A04,083782,Staff,0,7,30,30
1650812292711,MATH 197,001,091859,McAuley; Julian John,9998,0,9999,1
1650812298765,COGS 9,A01,083615,Staff,0,17,60,60
1650812304789,COGS 11,A01,083617,Boyle; Mary E. T.,16,0,40,24
1650812310813,COGS 13,A01,083071,Staff,0,38,40,40
1650812316837,COGS 14A,A01,092681,Staff,0,36,100,100
1650812322860,COGS 14B,A01,083073,Cheng; Tzu-Han,0,12,50,50
1650812328884,COGS 17,A01,092677,Staff,11,0,75,64
1650812334907,COGS 100,A01,083619,Staff,0,29,60,60
1650812340931,COGS 101A,A01,083621,Davis; Joshua Daniel,0,28,60,60
1650812346957,COGS 101B,A01,091572,Staff,0,3,60,60
1650812352985,COGS 101C,A01,083625,Delgado; Tania,14,0,30,16
1650812359012,COGS 107A,A01,083627,Boyle; Mary E. T.,0,16,60,60
1650812365039,COGS 118A,A01,083075,Staff,0,8,60,60
1650812371064,CSE 3,A50,083646,Miranda; Gregory Joseph,18,0,38,20
1650812371064,CSE 3,A51,083647,Miranda; Gregory Joseph,36,0,37,1
1650812377087,CSE 8A,A50,083650,Miranda; Gregory Joseph,0,29,40,40
1650812383113,CSE 11,A01,083080,Cao; Yingjun,0,96,40,40
1650812389137,CSE 12,A01,083652,Staff,0,21,100,100
1650812395164,CSE 15L,A01,083654,Staff,0,3,50,50
1650812395164,CSE 15L,A02,083655,Staff,0,2,50,50
1650812401189,CSE 20,A01,083657,Staff,49,0,80,31
1650812407216,CSE 30,A01,083084,Eldon; John,0,75,40,40
1650812413250,CSE 100,A01,083659,Cao; Yingjun,0,71,50,50
1650812419277,CSE 134B,A01,083661,Powell; Thomas Allan,0,38,65,65
1650812425300,CSE 140,A01,083663,Staff,0,11,75,75
1650812431325,CSE 140L,A01,083088,Eldon; John,0,20,75,75
1650812437349,CSE 175,A01,083665,Kumar; Rakesh,7,0,25,18
1650812443375,CSE 190,A00,092507,Dubnov; Shlomo,10,0,20,10
1650812449399,ECE 45,A01,083139,Staff,0,1,60,60
1650812455422,ECE 65,A50,083695,Staff,0,5,30,30
1650812461447,ECE 109,A01,091882,Touri; Behrouz,32,0,70,38
1650812467473,ECE 180,A00,083140,Abi Samra; Nicholas Camill,20,0,30,10
1650812467473,ECE 180,B00,083141,Abi Samra; Nicholas Camill,0,0,30,30
1650812473501,MATH 10A,A01,083735,Patchell; Gregory David,2,0,30,28
1650812473501,MATH 10A,A02,083736,Patchell; Gregory David,27,0,30,3
1650812473501,MATH 10A,A03,083737,Patchell; Gregory David,24,0,30,6
1650812479525,MATH 10B,A01,083207,Staff,0,9,30,30
1650812479525,MATH 10B,A02,083208,Staff,0,6,30,30
1650812479525,MATH 10B,B01,083739,Staff,11,0,30,19
1650812479525,MATH 10B,B02,083740,Staff,28,0,30,2
1650812485622,MATH 18,A01,083743,Staff,0,0,30,30
1650812485622,MATH 18,A02,083744,Staff,23,0,30,7
1650812485622,MATH 18,A03,083745,Staff,21,0,30,9
1650812485622,MATH 18,A04,083746,Staff,26,0,30,4
1650812485622,MATH 18,B01,083748,Staff,0,15,30,30
1650812485622,MATH 18,B02,083749,Staff,0,12,30,30
1650812485622,MATH 18,B03,083750,Staff,0,12,30,30
1650812485622,MATH 18,B04,083751,Staff,0,12,30,30
1650812491646,MATH 20A,A01,083754,Staff,19,0,40,21
1650812497670,MATH 20B,A01,083756,Staff,0,13,30,30
1650812497670,MATH 20B,A02,083757,Staff,0,12,30,30
1650812503694,MATH 20C,A01,083760,Staff,0,17,30,30
1650812503694,MATH 20C,A02,083761,Staff,0,16,30,30
1650812503694,MATH 20C,B01,083762,Staff,9,0,30,21
1650812503694,MATH 20C,B02,083763,Staff,28,0,30,2
1650812509718,MATH 20D,A01,083765,Staff,2,1,30,28
1650812509718,MATH 20D,A02,083766,Staff,6,0,30,24
1650812509718,MATH 20D,A03,083767,Staff,24,0,30,6
1650812515744,MATH 20E,A01,083771,Staff,2,0,30,28
1650812515744,MATH 20E,A02,083772,Staff,15,0,30,15
1650812515744,MATH 20E,B01,083773,Staff,0,0,30,30
1650812515744,MATH 20E,B02,083774,Staff,5,0,30,25
1650812521769,MATH 103A,A01,083777,Staff,0,16,30,30
1650812521769,MATH 103A,A02,083778,Staff,0,15,30,30
1650812521769,MATH 103A,B01,083779,Staff,0,15,30,30
1650812521769,MATH 103A,B02,083780,Staff,0,15,30,30
1650812527794,MATH 105,A01,085443,Staff,0,22,30,30
1650812533820,MATH 109,A01,083213,Anzaldo; Leesa B,0,7,30,30
1650812533820,MATH 109,A02,083214,Anzaldo; Leesa B,0,7,30,30
1650812533820,MATH 109,B01,083215,Anzaldo; Leesa B,0,8,30,30
1650812533820,MATH 109,B02,083216,Anzaldo; Leesa B,0,7,30,30
1650812539849,MATH 142A,A01,083219,Chow; Bennett,0,16,30,30
1650812539849,MATH 142A,A02,083220,Chow; Bennett,0,15,30,30
1650812539849,MATH 142A,B01,083221,Chow; Bennett,0,16,30,30
1650812539849,MATH 142A,B02,083222,Chow; Bennett,0,14,30,30
1650812545873,MATH 193A,A01,083224,Staff,0,6,30,30
1650812545873,MATH 193A,A02,083225,Staff,0,6,30,30
1650812545873,MATH 193A,A03,083781,Staff,0,6,30,30
1650812545873,MATH 193A,A04,083782,Staff,0,7,30,30
1650812551898,MATH 197,001,091859,McAuley; Julian John,9998,0,9999,1
1650812557958,COGS 9,A01,083615,Staff,0,17,60,60
1650812563981,COGS 11,A01,083617,Boyle; Mary E. T.,16,0,40,24
1650812570008,COGS 13,A01,083071,Staff,0,38,40,40
1650812576032,COGS 14A,A01,092681,Staff,0,36,100,100
1650812582059,COGS 14B,A01,083073,Cheng; Tzu-Han,0,12,50,50
1650812588084,COGS 17,A01,092677,Staff,11,0,75,64
1650812594108,COGS 100,A01,083619,Staff,0,29,60,60
1650812600131,COGS 101A,A01,083621,Davis; Joshua Daniel,0,28,60,60
1650812606157,COGS 101B,A01,091572,Staff,0,3,60,60
1650812612181,COGS 101C,A01,083625,Delgado; Tania,14,0,30,16
1650812618208,COGS 107A,A01,083627,Boyle; Mary E. T.,0,16,60,60
1650812624234,COGS 118A,A01,083075,Staff,0,8,60,60
1650812630262,CSE 3,A50,083646,Miranda; Gregory Joseph,18,0,38,20
1650812630262,CSE 3,A51,083647,Miranda; Gregory Joseph,36,0,37,1
1650812636285,CSE 8A,A50,083650,Miranda; Gregory Joseph,0,29,40,40
1650812642309,CSE 11,A01,083080,Cao; Yingjun,0,96,40,40
1650812648340,CSE 12,A01,083652,Staff,0,21,100,100
1650812654378,CSE 15L,A01,083654,Staff,0,3,50,50
1650812654378,CSE 15L,A02,083655,Staff,0,2,50,50
1650812660405,CSE 20,A01,083657,Staff,49,0,80,31
1650812666427,CSE 30,A01,083084,Eldon; John,0,75,40,40
1650812672451,CSE 100,A01,083659,Cao; Yingjun,0,71,50,50
1650812678481,CSE 134B,A01,083661,Powell; Thomas Allan,0,38,65,65
1650812684503,CSE 140,A01,083663,Staff,0,11,75,75
1650812690527,CSE 140L,A01,083088,Eldon; John,0,20,75,75
1650812696550,CSE 175,A01,083665,Kumar; Rakesh,7,0,25,18
1650812702575,CSE 190,A00,092507,Dubnov; Shlomo,10,0,20,10
1650812708598,ECE 45,A01,083139,Staff,0,1,60,60
1650812714621,ECE 65,A50,083695,Staff,0,5,30,30
1650812720653,ECE 109,A01,091882,Touri; Behrouz,32,0,70,38
1650812726683,ECE 180,A00,083140,Abi Samra; Nicholas Camill,20,0,30,10
1650812726683,ECE 180,B00,083141,Abi Samra; Nicholas Camill,0,0,30,30
1650812732714,MATH 10A,A01,083735,Patchell; Gregory David,2,0,30,28
1650812732714,MATH 10A,A02,083736,Patchell; Gregory David,27,0,30,3
1650812732714,MATH 10A,A03,083737,Patchell; Gregory David,24,0,30,6
1650812738741,MATH 10B,A01,083207,Staff,0,9,30,30
1650812738741,MATH 10B,A02,083208,Staff,0,6,30,30
1650812738741,MATH 10B,B01,083739,Staff,11,0,30,19
1650812738741,MATH 10B,B02,083740,Staff,28,0,30,2
1650812744767,MATH 18,A01,083743,Staff,0,0,30,30
1650812744767,MATH 18,A02,083744,Staff,23,0,30,7
1650812744767,MATH 18,A03,083745,Staff,21,0,30,9
1650812744767,MATH 18,A04,083746,Staff,26,0,30,4
1650812744767,MATH 18,B01,083748,Staff,0,15,30,30
1650812744767,MATH 18,B02,083749,Staff,0,12,30,30
1650812744767,MATH 18,B03,083750,Staff,0,12,30,30
1650812744767,MATH 18,B04,083751,Staff,0,12,30,30
1650812750790,MATH 20A,A01,083754,Staff,19,0,40,21
1650812756817,MATH 20B,A01,083756,Staff,0,13,30,30
1650812756817,MATH 20B,A02,083757,Staff,0,12,30,30
1650812762845,MATH 20C,A01,083760,Staff,0,17,30,30
1650812762845,MATH 20C,A02,083761,Staff,0,16,30,30
1650812762845,MATH 20C,B01,083762,Staff,9,0,30,21
1650812762845,MATH 20C,B02,083763,Staff,28,0,30,2
1650812768871,MATH 20D,A01,083765,Staff,2,1,30,28
1650812768871,MATH 20D,A02,083766,Staff,6,0,30,24
1650812768871,MATH 20D,A03,083767,Staff,24,0,30,6
1650812774898,MATH 20E,A01,083771,Staff,2,0,30,28
1650812774898,MATH 20E,A02,083772,Staff,15,0,30,15
1650812774898,MATH 20E,B01,083773,Staff,0,0,30,30
1650812774898,MATH 20E,B02,083774,Staff,5,0,30,25
1650812780922,MATH 103A,A01,083777,Staff,0,16,30,30
1650812780922,MATH 103A,A02,083778,Staff,0,15,30,30
1650812780922,MATH 103A,B01,083779,Staff,0,15,30,30
1650812780922,MATH 103A,B02,083780,Staff,0,15,30,30
1650812786946,MATH 105,A01,085443,Staff,0,22,30,30
1650812792969,MATH 109,A01,083213,Anzaldo; Leesa B,0,7,30,30
1650812792969,MATH 109,A02,083214,Anzaldo; Leesa B,0,7,30,30
1650812792969,MATH 109,B01,083215,Anzaldo; Leesa B,0,8,30,30
1650812792969,MATH 109,B02,083216,Anzaldo; Leesa B,0,7,30,30
1650812798993,MATH 142A,A01,083219,Chow; Bennett,0,16,30,30
1650812798993,MATH 142A,A02,083220,Chow; Bennett,0,15,30,30
1650812798993,MATH 142A,B01,083221,Chow; Bennett,0,16,30,30
1650812798993,MATH 142A,B02,083222,Chow; Bennett,0,14,30,30
1650812805022,MATH 193A,A01,083224,Staff,0,6,30,30
1650812805022,MATH 193A,A02,083225,Staff,0,6,30,30
1650812805022,MATH 193A,A03,083781,Staff,0,6,30,30
1650812805022,MATH 193A,A04,083782,Staff,0,7,30,30
1650812811047,MATH 197,001,091859,McAuley; Julian John,9998,0,9999,1
1650812817100,COGS 9,A01,083615,Staff,0,17,60,60
1650812823125,COGS 11,A01,083617,Boyle; Mary E. T.,16,0,40,24
1650812829148,COGS 13,A01,083071,Staff,0,38,40,40
1650812835170,COGS 14A,A01,092681,Staff,0,36,100,100
1650812841196,COGS 14B,A01,083073,Cheng; Tzu-Han,0,12,50,50
1650812847220,COGS 17,A01,092677,Staff,11,0,75,64
1650812853244,COGS 100,A01,083619,Staff,0,29,60,60
1650812859267,COGS 101A,A01,083621,Davis; Joshua Daniel,0,28,60,60
1650812865294,COGS 101B,A01,091572,Staff,0,3,60,60
1650812871321,COGS 101C,A01,083625,Delgado; Tania,14,0,30,16
1650812877349,COGS 107A,A01,083627,Boyle; Mary E. T.,0,16,60,60
1650812883374,COGS 118A,A01,083075,Staff,0,8,60,60
1650812889401,CSE 3,A50,083646,Miranda; Gregory Joseph,18,0,38,20
1650812889401,CSE 3,A51,083647,Miranda; Gregory Joseph,36,0,37,1
1650812895424,CSE 8A,A50,083650,Miranda; Gregory Joseph,0,29,40,40
1650812901456,CSE 11,A01,083080,Cao; Yingjun,0,96,40,40
1650812907480,CSE 12,A01,083652,Staff,0,21,100,100
1650812913506,CSE 15L,A01,083654,Staff,0,3,50,50
1650812913506,CSE 15L,A02,083655,Staff,0,2,50,50
1650812919529,CSE 20,A01,083657,Staff,49,0,80,31
1650812925553,CSE 30,A01,083084,Eldon; John,0,75,40,40
1650812931576,CSE 100,A01,083659,Cao; Yingjun,0,71,50,50
1650812937600,CSE 134B,A01,083661,Powell; Thomas Allan,0,38,65,65
1650812943627,CSE 140,A01,083663,Staff,0,11,75,75
1650812949650,CSE 140L,A01,083088,Eldon; John,0,20,75,75
1650812955677,CSE 175,A01,083665,Kumar; Rakesh,7,0,25,18
1650812961703,CSE 190,A00,092507,Dubnov; Shlomo,10,0,20,10
1650812967728,ECE 45,A01,083139,Staff,0,1,60,60
1650812973762,ECE 65,A50,083695,Staff,0,5,30,30
1650812979789,ECE 109,A01,091882,Touri; Behrouz,32,0,70,38
1650812985816,ECE 180,A00,083140,Abi Samra; Nicholas Camill,20,0,30,10
1650812985816,ECE 180,B00,083141,Abi Samra; Nicholas Camill,0,0,30,30
1650812991840,MATH 10A,A01,083735,Patchell; Gregory David,2,0,30,28
1650812991840,MATH 10A,A02,083736,Patchell; Gregory David,27,0,30,3
1650812991840,MATH 10A,A03,083737,Patchell; Gregory David,24,0,30,6
1650812997868,MATH 10B,A01,083207,Staff,0,9,30,30
1650812997868,MATH 10B,A02,083208,Staff,0,6,30,30
1650812997868,MATH 10B,B01,083739,Staff,11,0,30,19
1650812997868,MATH 10B,B02,083740,Staff,28,0,30,2
1650813003898,MATH 18,A01,083743,Staff,0,0,30,30
1650813003898,MATH 18,A02,083744,Staff,23,0,30,7
1650813003898,MATH 18,A03,083745,Staff,21,0,30,9
1650813003898,MATH 18,A04,083746,Staff,26,0,30,4
1650813003898,MATH 18,B01,083748,Staff,0,15,30,30
1650813003898,MATH 18,B02,083749,Staff,0,12,30,30
1650813003898,MATH 18,B03,083750,Staff,0,12,30,30
1650813003898,MATH 18,B04,083751,Staff,0,12,30,30
1650813009922,MATH 20A,A01,083754,Staff,19,0,40,21
1650813015944,MATH 20B,A01,083756,Staff,0,13,30,30
1650813015944,MATH 20B,A02,083757,Staff,0,12,30,30
1650813021971,MATH 20C,A01,083760,Staff,0,17,30,30
1650813021971,MATH 20C,A02,083761,Staff,0,16,30,30
1650813021971,MATH 20C,B01,083762,Staff,9,0,30,21
1650813021971,MATH 20C,B02,083763,Staff,28,0,30,2
1650813027998,MATH 20D,A01,083765,Staff,2,1,30,28
1650813027998,MATH 20D,A02,083766,Staff,6,0,30,24
1650813027998,MATH 20D,A03,083767,Staff,24,0,30,6
1650813034026,MATH 20E,A01,083771,Staff,2,0,30,28
1650813034026,MATH 20E,A02,083772,Staff,15,0,30,15
1650813034026,MATH 20E,B01,083773,Staff,0,0,30,30
1650813034026,MATH 20E,B02,083774,Staff,5,0,30,25
1650813040053,MATH 103A,A01,083777,Staff,0,16,30,30
1650813040053,MATH 103A,A02,083778,Staff,0,15,30,30
1650813040053,MATH 103A,B01,083779,Staff,0,15,30,30
1650813040053,MATH 103A,B02,083780,Staff,0,15,30,30
1650813046077,MATH 105,A01,085443,Staff,0,22,30,30
1650813052100,MATH 109,A01,083213,Anzaldo; Leesa B,0,7,30,30
1650813052100,MATH 109,A02,083214,Anzaldo; Leesa B,0,7,30,30
1650813052100,MATH 109,B01,083215,Anzaldo; Leesa B,0,8,30,30
1650813052100,MATH 109,B02,083216,Anzaldo; Leesa B,0,7,30,30
1650813058123,MATH 142A,A01,083219,Chow; Bennett,0,16,30,30
1650813058123,MATH 142A,A02,083220,Chow; Bennett,0,15,30,30
1650813058123,MATH 142A,B01,083221,Chow; Bennett,0,16,30,30
1650813058123,MATH 142A,B02,083222,Chow; Bennett,0,14,30,30
1650813064151,MATH 193A,A01,083224,Staff,0,6,30,30
1650813064151,MATH 193A,A02,083225,Staff,0,6,30,30
1650813064151,MATH 193A,A03,083781,Staff,0,6,30,30
1650813064151,MATH 193A,A04,083782,Staff,0,7,30,30
1650813070176,MATH 197,001,091859,McAuley; Julian John,9998,0,9999,1
1650813076307,COGS 9,A01,083615,Staff,0,17,60,60
1650813082331,COGS 11,A01,083617,Boyle; Mary E. T.,16,0,40,24
1650813088355,COGS 13,A01,083071,Staff,0,38,40,40
1650813094380,COGS 14A,A01,092681,Staff,0,36,100,100
1650813100405,COGS 14B,A01,083073,Cheng; Tzu-Han,0,12,50,50
1650813106429,COGS 17,A01,092677,Staff,11,0,75,64
1650813112452,COGS 100,A01,083619,Staff,0,29,60,60
1650813118474,COGS 101A,A01,083621,Davis; Joshua Daniel,0,28,60,60
1650813124500,COGS 101B,A01,091572,Staff,0,3,60,60
1650813130523,COGS 101C,A01,083625,Delgado; Tania,14,0,30,16
1650813136550,COGS 107A,A01,083627,Boyle; Mary E. T.,0,16,60,60
1650813142575,COGS 118A,A01,083075,Staff,0,8,60,60
1650813148604,CSE 3,A50,083646,Miranda; Gregory Joseph,18,0,38,20
1650813148604,CSE 3,A51,083647,Miranda; Gregory Joseph,36,0,37,1
1650813154631,CSE 8A,A50,083650,Miranda; Gregory Joseph,0,29,40,40
1650813160655,CSE 11,A01,083080,Cao; Yingjun,0,96,40,40
1650813166681,CSE 12,A01,083652,Staff,0,21,100,100
1650813172710,CSE 15L,A01,083654,Staff,0,3,50,50
1650813172710,CSE 15L,A02,083655,Staff,0,2,50,50
1650813178737,CSE 20,A01,083657,Staff,49,0,80,31
1650813184761,CSE 30,A01,083084,Eldon; John,0,75,40,40
1650813190788,CSE 100,A01,083659,Cao; Yingjun,0,71,50,50
1650813196812,CSE 134B,A01,083661,Powell; Thomas Allan,0,38,65,65
1650813202838,CSE 140,A01,083663,Staff,0,11,75,75
1650813208864,CSE 140L,A01,083088,Eldon; John,0,20,75,75
1650813214887,CSE 175,A01,083665,Kumar; Rakesh,7,0,25,18
1650813220910,CSE 190,A00,092507,Dubnov; Shlomo,10,0,20,10
1650813226936,ECE 45,A01,083139,Staff,0,1,60,60
1650813232963,ECE 65,A50,083695,Staff,0,5,30,30
1650813238989,ECE 109,A01,091882,Touri; Behrouz,32,0,70,38
1650813245015,ECE 180,A00,083140,Abi Samra; Nicholas Camill,20,0,30,10
1650813245015,ECE 180,B00,083141,Abi Samra; Nicholas Camill,0,0,30,30
1650813251040,MATH 10A,A01,083735,Patchell; Gregory David,2,0,30,28
1650813251040,MATH 10A,A02,083736,Patchell; Gregory David,27,0,30,3
1650813251040,MATH 10A,A03,083737,Patchell; Gregory David,24,0,30,6
1650813257063,MATH 10B,A01,083207,Staff,0,9,30,30
1650813257063,MATH 10B,A02,083208,Staff,0,6,30,30
1650813257063,MATH 10B,B01,083739,Staff,11,0,30,19
1650813257063,MATH 10B,B02,083740,Staff,28,0,30,2
1650813263089,MATH 18,A01,083743,Staff,0,0,30,30
1650813263089,MATH 18,A02,083744,Staff,23,0,30,7
1650813263089,MATH 18,A03,083745,Staff,21,0,30,9
1650813263089,MATH 18,A04,083746,Staff,26,0,30,4
1650813263089,MATH 18,B01,083748,Staff,0,15,30,30
1650813263089,MATH 18,B02,083749,Staff,0,12,30,30
1650813263089,MATH 18,B03,083750,Staff,0,12,30,30
1650813263089,MATH 18,B04,083751,Staff,0,12,30,30
1650813269112,MATH 20A,A01,083754,Staff,19,0,40,21
1650813275136,MATH 20B,A01,083756,Staff,0,13,30,30
1650813275136,MATH 20B,A02,083757,Staff,0,12,30,30
1650813281162,MATH 20C,A01,083760,Staff,0,17,30,30
1650813281162,MATH 20C,A02,083761,Staff,0,16,30,30
1650813281162,MATH 20C,B01,083762,Staff,9,0,30,21
1650813281162,MATH 20C,B02,083763,Staff,28,0,30,2
1650813287186,MATH 20D,A01,083765,Staff,2,1,30,28
1650813287186,MATH 20D,A02,083766,Staff,6,0,30,24
1650813287186,MATH 20D,A03,083767,Staff,24,0,30,6
1650813293209,MATH 20E,A01,083771,Staff,2,0,30,28
1650813293209,MATH 20E,A02,083772,Staff,15,0,30,15
1650813293209,MATH 20E,B01,083773,Staff,0,0,30,30
1650813293209,MATH 20E,B02,083774,Staff,5,0,30,25
1650813299233,MATH 103A,A01,083777,Staff,0,16,30,30
1650813299233,MATH 103A,A02,083778,Staff,0,15,30,30
1650813299233,MATH 103A,B01,083779,Staff,0,15,30,30
1650813299233,MATH 103A,B02,083780,Staff,0,15,30,30
1650813305259,MATH 105,A01,085443,Staff,0,22,30,30
1650813311283,MATH 109,A01,083213,Anzaldo; Leesa B,0,7,30,30
1650813311283,MATH 109,A02,083214,Anzaldo; Leesa B,0,7,30,30
1650813311283,MATH 109,B01,083215,Anzaldo; Leesa B,0,8,30,30
1650813311283,MATH 109,B02,083216,Anzaldo; Leesa B,0,7,30,30
1650813317308,MATH 142A,A01,083219,Chow; Bennett,0,16,30,30
1650813317308,MATH 142A,A02,083220,Chow; Bennett,0,15,30,30
1650813317308,MATH 142A,B01,083221,Chow; Bennett,0,16,30,30
1650813317308,MATH 142A,B02,083222,Chow; Bennett,0,14,30,30
1650813323332,MATH 193A,A01,083224,Staff,0,6,30,30
1650813323332,MATH 193A,A02,083225,Staff,0,6,30,30
1650813323332,MATH 193A,A03,083781,Staff,0,6,30,30
1650813323332,MATH 193A,A04,083782,Staff,0,7,30,30
1650813329357,MATH 197,001,091859,McAuley; Julian John,9998,0,9999,1
1650813335414,COGS 9,A01,083615,Staff,0,17,60,60
1650813341437,COGS 11,A01,083617,Boyle; Mary E. T.,16,0,40,24
1650813347460,COGS 13,A01,083071,Staff,0,38,40,40
1650813353481,COGS 14A,A01,092681,Staff,0,36,100,100
1650813359505,COGS 14B,A01,083073,Cheng; Tzu-Han,0,12,50,50
1650813365528,COGS 17,A01,092677,Staff,11,0,75,64
1650813371550,COGS 100,A01,083619,Staff,0,29,60,60
1650813377572,COGS 101A,A01,083621,Davis; Joshua Daniel,0,28,60,60
1650813383596,COGS 101B,A01,091572,Staff,0,3,60,60
1650813389622,COGS 101C,A01,083625,Delgado; Tania,14,0,30,16
1650813395645,COGS 107A,A01,083627,Boyle; Mary E. T.,0,16,60,60
1650813401668,COGS 118A,A01,083075,Staff,0,8,60,60
1650813407696,CSE 3,A50,083646,Miranda; Gregory Joseph,18,0,38,20
1650813407696,CSE 3,A51,083647,Miranda; Gregory Joseph,36,0,37,1
1650813413727,CSE 8A,A50,083650,Miranda; Gregory Joseph,0,29,40,40
1650813419751,CSE 11,A01,083080,Cao; Yingjun,0,96,40,40
1650813425778,CSE 12,A01,083652,Staff,0,21,100,100
1650813431805,CSE 15L,A01,083654,Staff,0,3,50,50
1650813431805,CSE 15L,A02,083655,Staff,0,2,50,50
1650813437829,CSE 20,A01,083657,Staff,49,0,80,31
1650813443852,CSE 30,A01,083084,Eldon; John,0,75,40,40
1650813449875,CSE 100,A01,083659,Cao; Yingjun,0,71,50,50
1650813455898,CSE 134B,A01,083661,Powell; Thomas Allan,0,38,65,65
1650813461924,CSE 140,A01,083663,Staff,0,11,75,75
1650813467951,CSE 140L,A01,083088,Eldon; John,0,20,75,75
1650813473977,CSE 175,A01,083665,Kumar; Rakesh,7,0,25,18
1650813479998,CSE 190,A00,092507,Dubnov; Shlomo,10,0,20,10
1650813486025,ECE 45,A01,083139,Staff,0,1,60,60
1650813492048,ECE 65,A50,083695,Staff,0,5,30,30
1650813498069,ECE 109,A01,091882,Touri; Behrouz,32,0,70,38
1650813504095,ECE 180,A00,083140,Abi Samra; Nicholas Camill,20,0,30,10
1650813504095,ECE 180,B00,083141,Abi Samra; Nicholas Camill,0,0,30,30
1650813510121,MATH 10A,A01,083735,Patchell; Gregory David,2,0,30,28
1650813510121,MATH 10A,A02,083736,Patchell; Gregory David,27,0,30,3
1650813510121,MATH 10A,A03,083737,Patchell; Gregory David,24,0,30,6
1650813516149,MATH 10B,A01,083207,Staff,0,9,30,30
1650813516149,MATH 10B,A02,083208,Staff,0,6,30,30
1650813516149,MATH 10B,B01,083739,Staff,11,0,30,19
1650813516149,MATH 10B,B02,083740,Staff,28,0,30,2
1650813522172,MATH 18,A01,083743,Staff,0,0,30,30
1650813522172,MATH 18,A02,083744,Staff,23,0,30,7
1650813522172,MATH 18,A03,083745,Staff,21,0,30,9
1650813522172,MATH 18,A04,083746,Staff,26,0,30,4
1650813522172,MATH 18,B01,083748,Staff,0,15,30,30
1650813522172,MATH 18,B02,083749,Staff,0,12,30,30
1650813522172,MATH 18,B03,083750,Staff,0,12,30,30
1650813522172,MATH 18,B04,083751,Staff,0,12,30,30
1650813528196,MATH 20A,A01,083754,Staff,19,0,40,21
1650813534220,MATH 20B,A01,083756,Staff,0,13,30,30
1650813534220,MATH 20B,A02,083757,Staff,0,12,30,30
1650813540245,MATH 20C,A01,083760,Staff,0,17,30,30
1650813540245,MATH 20C,A02,083761,Staff,0,16,30,30
1650813540245,MATH 20C,B01,083762,Staff,9,0,30,21
1650813540245,MATH 20C,B02,083763,Staff,28,0,30,2
1650813546269,MATH 20D,A01,083765,Staff,2,1,30,28
1650813546269,MATH 20D,A02,083766,Staff,6,0,30,24
1650813546269,MATH 20D,A03,083767,Staff,24,0,30,6
1650813552297,MATH 20E,A01,083771,Staff,2,0,30,28
1650813552297,MATH 20E,A02,083772,Staff,15,0,30,15
1650813552297,MATH 20E,B01,083773,Staff,0,0,30,30
1650813552297,MATH 20E,B02,083774,Staff,5,0,30,25
1650813558320,MATH 103A,A01,083777,Staff,0,16,30,30
1650813558320,MATH 103A,A02,083778,Staff,0,15,30,30
1650813558320,MATH 103A,B01,083779,Staff,0,15,30,30
1650813558320,MATH 103A,B02,083780,Staff,0,15,30,30
1650813564351,MATH 105,A01,085443,Staff,0,22,30,30
1650813570388,MATH 109,A01,083213,Anzaldo; Leesa B,0,7,30,30
1650813570388,MATH 109,A02,083214,Anzaldo; Leesa B,0,7,30,30
1650813570388,MATH 109,B01,083215,Anzaldo; Leesa B,0,8,30,30
1650813570388,MATH 109,B02,083216,Anzaldo; Leesa B,0,7,30,30
1650813576415,MATH 142A,A01,083219,Chow; Bennett,0,16,30,30
1650813576415,MATH 142A,A02,083220,Chow; Bennett,0,15,30,30
1650813576415,MATH 142A,B01,083221,Chow; Bennett,0,16,30,30
1650813576415,MATH 142A,B02,083222,Chow; Bennett,0,14,30,30
1650813582437,MATH 193A,A01,083224,Staff,0,6,30,30
1650813582437,MATH 193A,A02,083225,Staff,0,6,30,30
1650813582437,MATH 193A,A03,083781,Staff,0,6,30,30
1650813582437,MATH 193A,A04,083782,Staff,0,7,30,30
1650813588460,MATH 197,001,091859,McAuley; Julian John,9998,0,9999,1
1650813594522,COGS 9,A01,083615,Staff,0,17,60,60
1650813600548,COGS 11,A01,083617,Boyle; Mary E. T.,16,0,40,24
1650813606570,COGS 13,A01,083071,Staff,0,38,40,40
1650813612594,COGS 14A,A01,092681,Staff,0,36,100,100
1650813618621,COGS 14B,A01,083073,Cheng; Tzu-Han,0,12,50,50
1650813624647,COGS 17,A01,092677,Staff,11,0,75,64
1650813630672,COGS 100,A01,083619,Staff,0,29,60,60
1650813636699,COGS 101A,A01,083621,Davis; Joshua Daniel,0,28,60,60
1650813642727,COGS 101B,A01,091572,Staff,0,3,60,60
1650813648754,COGS 101C,A01,083625,Delgado; Tania,14,0,30,16
1650813654778,COGS 107A,A01,083627,Boyle; Mary E. T.,0,16,60,60
1650813660801,COGS 118A,A01,083075,Staff,0,8,60,60
1650813666825,CSE 3,A50,083646,Miranda; Gregory Joseph,18,0,38,20
1650813666825,CSE 3,A51,083647,Miranda; Gregory Joseph,36,0,37,1
1650813672935,CSE 8A,A50,083650,Miranda; Gregory Joseph,0,29,40,40
1650813678962,CSE 11,A01,083080,Cao; Yingjun,0,96,40,40
1650813684985,CSE 12,A01,083652,Staff,0,21,100,100
1650813691011,CSE 15L,A01,083654,Staff,0,3,50,50
1650813691011,CSE 15L,A02,083655,Staff,0,2,50,50
1650813697035,CSE 20,A01,083657,Staff,49,0,80,31
1650813703058,CSE 30,A01,083084,Eldon; John,0,75,40,40
1650813709082,CSE 100,A01,083659,Cao; Yingjun,0,71,50,50
1650813715113,CSE 134B,A01,083661,Powell; Thomas Allan,0,38,65,65
1650813721140,CSE 140,A01,083663,Staff,0,11,75,75
1650813727164,CSE 140L,A01,083088,Eldon; John,0,20,75,75
1650813733189,CSE 175,A01,083665,Kumar; Rakesh,7,0,25,18
1650813739212,CSE 190,A00,092507,Dubnov; Shlomo,10,0,20,10
1650813745234,ECE 45,A01,083139,Staff,0,1,60,60
1650813751260,ECE 65,A50,083695,Staff,0,5,30,30
1650813757292,ECE 109,A01,091882,Touri; Behrouz,32,0,70,38
1650813763317,ECE 180,A00,083140,Abi Samra; Nicholas Camill,20,0,30,10
1650813763317,ECE 180,B00,083141,Abi Samra; Nicholas Camill,0,0,30,30
1650813769358,MATH 10A,A01,083735,Patchell; Gregory David,2,0,30,28
1650813769358,MATH 10A,A02,083736,Patchell; Gregory David,27,0,30,3
1650813769358,MATH 10A,A03,083737,Patchell; Gregory David,24,0,30,6
1650813775384,MATH 10B,A01,083207,Staff,0,9,30,30
1650813775384,MATH 10B,A02,083208,Staff,0,6,30,30
1650813775384,MATH 10B,B01,083739,Staff,11,0,30,19
1650813775384,MATH 10B,B02,083740,Staff,28,0,30,2
1650813781411,MATH 18,A01,083743,Staff,0,0,30,30
1650813781411,MATH 18,A02,083744,Staff,23,0,30,7
1650813781411,MATH 18,A03,083745,Staff,21,0,30,9
1650813781411,MATH 18,A04,083746,Staff,26,0,30,4
1650813781411,MATH 18,B01,083748,Staff,0,15,30,30
1650813781411,MATH 18,B02,083749,Staff,0,12,30,30
1650813781411,MATH 18,B03,083750,Staff,0,12,30,30
1650813781411,MATH 18,B04,083751,Staff,0,12,30,30
1650813787436,MATH 20A,A01,083754,Staff,19,0,40,21
1650813793462,MATH 20B,A01,083756,Staff,0,13,30,30
1650813793462,MATH 20B,A02,083757,Staff,0,12,30,30
1650813799486,MATH 20C,A01,083760,Staff,0,17,30,30
1650813799486,MATH 20C,A02,083761,Staff,0,16,30,30
1650813799486,MATH 20C,B01,083762,Staff,9,0,30,21
1650813799486,MATH 20C,B02,083763,Staff,28,0,30,2
1650813805513,MATH 20D,A01,083765,Staff,2,1,30,28
1650813805513,MATH 20D,A02,083766,Staff,6,0,30,24
1650813805513,MATH 20D,A03,083767,Staff,24,0,30,6
1650813811541,MATH 20E,A01,083771,Staff,2,0,30,28
1650813811541,MATH 20E,A02,083772,Staff,15,0,30,15
1650813811541,MATH 20E,B01,083773,Staff,0,0,30,30
1650813811541,MATH 20E,B02,083774,Staff,5,0,30,25
1650813817575,MATH 103A,A01,083777,Staff,0,16,30,30
1650813817575,MATH 103A,A02,083778,Staff,0,15,30,30
1650813817575,MATH 103A,B01,083779,Staff,0,15,30,30
1650813817575,MATH 103A,B02,083780,Staff,0,15,30,30
1650813823600,MATH 105,A01,085443,Staff,0,22,30,30
1650813829655,MATH 109,A01,083213,Anzaldo; Leesa B,0,7,30,30
1650813829655,MATH 109,A02,083214,Anzaldo; Leesa B,0,7,30,30
1650813829655,MATH 109,B01,083215,Anzaldo; Leesa B,0,8,30,30
1650813829655,MATH 109,B02,083216,Anzaldo; Leesa B,0,7,30,30
1650813835680,MATH 142A,A01,083219,Chow; Bennett,0,16,30,30
1650813835680,MATH 142A,A02,083220,Chow; Bennett,0,15,30,30
1650813835680,MATH 142A,B01,083221,Chow; Bennett,0,16,30,30
1650813835680,MATH 142A,B02,083222,Chow; Bennett,0,14,30,30
1650813841730,MATH 193A,A01,083224,Staff,0,6,30,30
1650813841730,MATH 193A,A02,083225,Staff,0,6,30,30
1650813841730,MATH 193A,A03,083781,Staff,0,6,30,30
1650813841730,MATH 193A,A04,083782,Staff,0,7,30,30
1650813847755,MATH 197,001,091859,McAuley; Julian John,9998,0,9999,1
1650813853859,COGS 9,A01,083615,Staff,0,17,60,60
1650813859887,COGS 11,A01,083617,Boyle; Mary E. T.,16,0,40,24
1650813865935,COGS 13,A01,083071,Staff,0,38,40,40
1650813871957,COGS 14A,A01,092681,Staff,0,36,100,100
1650813877985,COGS 14B,A01,083073,Cheng; Tzu-Han,0,12,50,50
1650813884010,COGS 17,A01,092677,Staff,11,0,75,64
1650813890037,COGS 100,A01,083619,Staff,0,29,60,60
1650813896061,COGS 101A,A01,083621,Davis; Joshua Daniel,0,28,60,60
1650813902086,COGS 101B,A01,091572,Staff,0,3,60,60
1650813908108,COGS 101C,A01,083625,Delgado; Tania,14,0,30,16
1650813914135,COGS 107A,A01,083627,Boyle; Mary E. T.,0,16,60,60
1650813920159,COGS 118A,A01,083075,Staff,0,8,60,60
1650813926185,CSE 3,A50,083646,Miranda; Gregory Joseph,18,0,38,20
1650813926185,CSE 3,A51,083647,Miranda; Gregory Joseph,36,0,37,1
1650813932209,CSE 8A,A50,083650,Miranda; Gregory Joseph,0,29,40,40
1650813938236,CSE 11,A01,083080,Cao; Yingjun,0,96,40,40
1650813944261,CSE 12,A01,083652,Staff,0,21,100,100
1650813950284,CSE 15L,A01,083654,Staff,0,3,50,50
1650813950284,CSE 15L,A02,083655,Staff,0,2,50,50
1650813956314,CSE 20,A01,083657,Staff,49,0,80,31
1650813962348,CSE 30,A01,083084,Eldon; John,0,75,40,40
1650813968375,CSE 100,A01,083659,Cao; Yingjun,0,71,50,50
1650813974402,CSE 134B,A01,083661,Powell; Thomas Allan,0,38,65,65
1650813980423,CSE 140,A01,083663,Staff,0,11,75,75
1650813986448,CSE 140L,A01,083088,Eldon; John,0,20,75,75
1650813992474,CSE 175,A01,083665,Kumar; Rakesh,7,0,25,18
1650813998498,CSE 190,A00,092507,Dubnov; Shlomo,10,0,20,10
1650814004523,ECE 45,A01,083139,Staff,0,1,60,60
1650814010549,ECE 65,A50,083695,Staff,0,5,30,30
1650814016571,ECE 109,A01,091882,Touri; Behrouz,32,0,70,38
1650814022605,ECE 180,A00,083140,Abi Samra; Nicholas Camill,20,0,30,10
1650814022605,ECE 180,B00,083141,Abi Samra; Nicholas Camill,0,0,30,30
1650814028632,MATH 10A,A01,083735,Patchell; Gregory David,2,0,30,28
1650814028632,MATH 10A,A02,083736,Patchell; Gregory David,27,0,30,3
1650814028632,MATH 10A,A03,083737,Patchell; Gregory David,24,0,30,6
1650814034657,MATH 10B,A01,083207,Staff,0,9,30,30
1650814034657,MATH 10B,A02,083208,Staff,0,6,30,30
1650814034657,MATH 10B,B01,083739,Staff,11,0,30,19
1650814034657,MATH 10B,B02,083740,Staff,28,0,30,2
1650814040685,MATH 18,A01,083743,Staff,0,0,30,30
1650814040685,MATH 18,A02,083744,Staff,23,0,30,7
1650814040685,MATH 18,A03,083745,Staff,21,0,30,9
1650814040685,MATH 18,A04,083746,Staff,26,0,30,4
1650814040685,MATH 18,B01,083748,Staff,0,15,30,30
1650814040685,MATH 18,B02,083749,Staff,0,12,30,30
1650814040685,MATH 18,B03,083750,Staff,0,12,30,30
1650814040685,MATH 18,B04,083751,Staff,0,12,30,30
1650814046710,MATH 20A,A01,083754,Staff,19,0,40,21
1650814052734,MATH 20B,A01,083756,Staff,0,13,30,30
1650814052734,MATH 20B,A02,083757,Staff,0,12,30,30
1650814058763,MATH 20C,A01,083760,Staff,0,17,30,30
1650814058763,MATH 20C,A02,083761,Staff,0,16,30,30
1650814058763,MATH 20C,B01,083762,Staff,9,0,30,21
1650814058763,MATH 20C,B02,083763,Staff,28,0,30,2
1650814064786,MATH 20D,A01,083765,Staff,2,1,30,28
1650814064786,MATH 20D,A02,083766,Staff,6,0,30,24
1650814064786,MATH 20D,A03,083767,Staff,24,0,30,6
1650814070823,MATH 20E,A01,083771,Staff,2,0,30,28
1650814070823,MATH 20E,A02,083772,Staff,15,0,30,15
1650814070823,MATH 20E,B01,083773,Staff,0,0,30,30
1650814070823,MATH 20E,B02,083774,Staff,5,0,30,25
1650814076846,MATH 103A,A01,083777,Staff,0,16,30,30
1650814076846,MATH 103A,A02,083778,Staff,0,15,30,30
1650814076846,MATH 103A,B01,083779,Staff,0,15,30,30
1650814076846,MATH 103A,B02,083780,Staff,0,15,30,30
1650814082871,MATH 105,A01,085443,Staff,0,22,30,30
1650814088895,MATH 109,A01,083213,Anzaldo; Leesa B,0,7,30,30
1650814088895,MATH 109,A02,083214,Anzaldo; Leesa B,0,7,30,30
1650814088895,MATH 109,B01,083215,Anzaldo; Leesa B,0,8,30,30
1650814088895,MATH 109,B02,083216,Anzaldo; Leesa B,0,7,30,30
1650814094921,MATH 142A,A01,083219,Chow; Bennett,0,16,30,30
1650814094921,MATH 142A,A02,083220,Chow; Bennett,0,15,30,30
1650814094921,MATH 142A,B01,083221,Chow; Bennett,0,16,30,30
1650814094921,MATH 142A,B02,083222,Chow; Bennett,0,14,30,30
1650814100948,MATH 193A,A01,083224,Staff,0,6,30,30
1650814100948,MATH 193A,A02,083225,Staff,0,6,30,30
1650814100948,MATH 193A,A03,083781,Staff,0,6,30,30
1650814100948,MATH 193A,A04,083782,Staff,0,7,30,30
1650814106973,MATH 197,001,091859,McAuley; Julian John,9998,0,9999,1
1650814113024,COGS 9,A01,083615,Staff,0,17,60,60
1650814119052,COGS 11,A01,083617,Boyle; Mary E. T.,16,0,40,24
1650814125075,COGS 13,A01,083071,Staff,0,38,40,40
1650814131098,COGS 14A,A01,092681,Staff,0,36,100,100
1650814137124,COGS 14B,A01,083073,Cheng; Tzu-Han,0,12,50,50
1650814143146,COGS 17,A01,092677,Staff,11,0,75,64
1650814149173,COGS 100,A01,083619,Staff,0,29,60,60
1650814155208,COGS 101A,A01,083621,Davis; Joshua Daniel,0,28,60,60
1650814161232,COGS 101B,A01,091572,Staff,0,3,60,60
1650814167262,COGS 101C,A01,083625,Delgado; Tania,14,0,30,16
1650814173288,COGS 107A,A01,083627,Boyle; Mary E. T.,0,16,60,60
1650814179311,COGS 118A,A01,083075,Staff,0,8,60,60
1650814185342,CSE 3,A50,083646,Miranda; Gregory Joseph,18,0,38,20
1650814185342,CSE 3,A51,083647,Miranda; Gregory Joseph,36,0,37,1
1650814191370,CSE 8A,A50,083650,Miranda; Gregory Joseph,0,29,40,40
1650814197401,CSE 11,A01,083080,Cao; Yingjun,0,96,40,40
1650814203424,CSE 12,A01,083652,Staff,0,21,100,100
1650814209449,CSE 15L,A01,083654,Staff,0,3,50,50
1650814209449,CSE 15L,A02,083655,Staff,0,2,50,50
1650814215474,CSE 20,A01,083657,Staff,49,0,80,31
1650814221501,CSE 30,A01,083084,Eldon; John,0,75,40,40
1650814227527,CSE 100,A01,083659,Cao; Yingjun,0,71,50,50
1650814233552,CSE 134B,A01,083661,Powell; Thomas Allan,0,38,65,65
1650814239575,CSE 140,A01,083663,Staff,0,11,75,75
1650814245599,CSE 140L,A01,083088,Eldon; John,0,20,75,75
1650814251627,CSE 175,A01,083665,Kumar; Rakesh,7,0,25,18
1650814257653,CSE 190,A00,092507,Dubnov; Shlomo,10,0,20,10
1650814263677,ECE 45,A01,083139,Staff,0,1,60,60
1650814269779,ECE 65,A50,083695,Staff,0,5,30,30
1650814275804,ECE 109,A01,091882,Touri; Behrouz,32,0,70,38
1650814281831,ECE 180,A00,083140,Abi Samra; Nicholas Camill,20,0,30,10
1650814281831,ECE 180,B00,083141,Abi Samra; Nicholas Camill,0,0,30,30
1650814287857,MATH 10A,A01,083735,Patchell; Gregory David,2,0,30,28
1650814287857,MATH 10A,A02,083736,Patchell; Gregory David,27,0,30,3
1650814287857,MATH 10A,A03,083737,Patchell; Gregory David,24,0,30,6
1650814293885,MATH 10B,A01,083207,Staff,0,9,30,30
1650814293885,MATH 10B,A02,083208,Staff,0,6,30,30
1650814293885,MATH 10B,B01,083739,Staff,11,0,30,19
1650814293885,MATH 10B,B02,083740,Staff,28,0,30,2
1650814299911,MATH 18,A01,083743,Staff,0,0,30,30
1650814299911,MATH 18,A02,083744,Staff,23,0,30,7
1650814299911,MATH 18,A03,083745,Staff,21,0,30,9
1650814299911,MATH 18,A04,083746,Staff,26,0,30,4
1650814299911,MATH 18,B01,083748,Staff,0,15,30,30
1650814299911,MATH 18,B02,083749,Staff,0,12,30,30
1650814299911,MATH 18,B03,083750,Staff,0,12,30,30
1650814299911,MATH 18,B04,083751,Staff,0,12,30,30
1650814305935,MATH 20A,A01,083754,Staff,19,0,40,21
1650814311959,MATH 20B,A01,083756,Staff,0,13,30,30
1650814311959,MATH 20B,A02,083757,Staff,0,12,30,30
1650814317983,MATH 20C,A01,083760,Staff,0,17,30,30
1650814317983,MATH 20C,A02,083761,Staff,0,16,30,30
1650814317983,MATH 20C,B01,083762,Staff,9,0,30,21
1650814317983,MATH 20C,B02,083763,Staff,28,0,30,2
1650814324012,MATH 20D,A01,083765,Staff,2,1,30,28
1650814324012,MATH 20D,A02,083766,Staff,6,0,30,24
1650814324012,MATH 20D,A03,083767,Staff,24,0,30,6
1650814330042,MATH 20E,A01,083771,Staff,2,0,30,28
1650814330042,MATH 20E,A02,083772,Staff,15,0,30,15
1650814330042,MATH 20E,B01,083773,Staff,0,0,30,30
1650814330042,MATH 20E,B02,083774,Staff,5,0,30,25
1650814336072,MATH 103A,A01,083777,Staff,0,16,30,30
1650814336072,MATH 103A,A02,083778,Staff,0,15,30,30
1650814336072,MATH 103A,B01,083779,Staff,0,15,30,30
1650814336072,MATH 103A,B02,083780,Staff,0,15,30,30
1650814342099,MATH 105,A01,085443,Staff,0,22,30,30
1650814348128,MATH 109,A01,083213,Anzaldo; Leesa B,0,7,30,30
1650814348128,MATH 109,A02,083214,Anzaldo; Leesa B,0,7,30,30
1650814348128,MATH 109,B01,083215,Anzaldo; Leesa B,0,8,30,30
1650814348128,MATH 109,B02,083216,Anzaldo; Leesa B,0,7,30,30
1650814354153,MATH 142A,A01,083219,Chow; Bennett,0,16,30,30
1650814354153,MATH 142A,A02,083220,Chow; Bennett,0,15,30,30
1650814354153,MATH 142A,B01,083221,Chow; Bennett,0,16,30,30
1650814354153,MATH 142A,B02,083222,Chow; Bennett,0,14,30,30
1650814360183,MATH 193A,A01,083224,Staff,0,6,30,30
1650814360183,MATH 193A,A02,083225,Staff,0,6,30,30
1650814360183,MATH 193A,A03,083781,Staff,0,6,30,30
1650814360183,MATH 193A,A04,083782,Staff,0,7,30,30
1650814366212,MATH 197,001,091859,McAuley; Julian John,9998,0,9999,1
1650814372264,COGS 9,A01,083615,Staff,0,17,60,60
1650814378293,COGS 11,A01,083617,Boyle; Mary E. T.,16,0,40,24
1650814384318,COGS 13,A01,083071,Staff,0,38,40,40
1650814390341,COGS 14A,A01,092681,Staff,0,36,100,100
1650814396365,COGS 14B,A01,083073,Cheng; Tzu-Han,0,12,50,50
1650814402390,COGS 17,A01,092677,Staff,11,0,75,64
1650814408417,COGS 100,A01,083619,Staff,0,29,60,60
1650814414443,COGS 101A,A01,083621,Davis; Joshua Daniel,0,28,60,60
1650814420466,COGS 101B,A01,091572,Staff,0,3,60,60
1650814426491,COGS 101C,A01,083625,Delgado; Tania,14,0,30,16
1650814432518,COGS 107A,A01,083627,Boyle; Mary E. T.,0,16,60,60
1650814438543,COGS 118A,A01,083075,Staff,0,8,60,60
1650814444572,CSE 3,A50,083646,Miranda; Gregory Joseph,18,0,38,20
1650814444572,CSE 3,A51,083647,Miranda; Gregory Joseph,36,0,37,1
1650814450597,CSE 8A,A50,083650,Miranda; Gregory Joseph,0,29,40,40
1650814456620,CSE 11,A01,083080,Cao; Yingjun,0,96,40,40
1650814462644,CSE 12,A01,083652,Staff,0,21,100,100
1650814468666,CSE 15L,A01,083654,Staff,0,3,50,50
1650814468666,CSE 15L,A02,083655,Staff,0,2,50,50
1650814474693,CSE 20,A01,083657,Staff,49,0,80,31
1650814480717,CSE 30,A01,083084,Eldon; John,0,75,40,40
1650814486744,CSE 100,A01,083659,Cao; Yingjun,0,71,50,50
1650814492781,CSE 134B,A01,083661,Powell; Thomas Allan,0,38,65,65
1650814498805,CSE 140,A01,083663,Staff,0,11,75,75
1650814504831,CSE 140L,A01,083088,Eldon; John,0,20,75,75
1650814510855,CSE 175,A01,083665,Kumar; Rakesh,7,0,25,18
1650814516877,CSE 190,A00,092507,Dubnov; Shlomo,10,0,20,10
1650814522903,ECE 45,A01,083139,Staff,0,1,60,60
1650814528927,ECE 65,A50,083695,Staff,0,5,30,30
1650814534958,ECE 109,A01,091882,Touri; Behrouz,32,0,70,38
1650814540985,ECE 180,A00,083140,Abi Samra; Nicholas Camill,20,0,30,10
1650814540985,ECE 180,B00,083141,Abi Samra; Nicholas Camill,0,0,30,30
1650814547011,MATH 10A,A01,083735,Patchell; Gregory David,2,0,30,28
1650814547011,MATH 10A,A02,083736,Patchell; Gregory David,27,0,30,3
1650814547011,MATH 10A,A03,083737,Patchell; Gregory David,24,0,30,6
1650814553034,MATH 10B,A01,083207,Staff,0,9,30,30
1650814553034,MATH 10B,A02,083208,Staff,0,6,30,30
1650814553034,MATH 10B,B01,083739,Staff,11,0,30,19
1650814553034,MATH 10B,B02,083740,Staff,28,0,30,2
1650814559059,MATH 18,A01,083743,Staff,0,0,30,30
1650814559059,MATH 18,A02,083744,Staff,23,0,30,7
1650814559059,MATH 18,A03,083745,Staff,21,0,30,9
1650814559059,MATH 18,A04,083746,Staff,26,0,30,4
1650814559059,MATH 18,B01,083748,Staff,0,15,30,30
1650814559059,MATH 18,B02,083749,Staff,0,12,30,30
1650814559059,MATH 18,B03,083750,Staff,0,12,30,30
1650814559059,MATH 18,B04,083751,Staff,0,12,30,30
1650814565083,MATH 20A,A01,083754,Staff,19,0,40,21
1650814571107,MATH 20B,A01,083756,Staff,0,13,30,30
1650814571107,MATH 20B,A02,083757,Staff,0,12,30,30
1650814577131,MATH 20C,A01,083760,Staff,0,17,30,30
1650814577131,MATH 20C,A02,083761,Staff,0,16,30,30
1650814577131,MATH 20C,B01,083762,Staff,9,0,30,21
1650814577131,MATH 20C,B02,083763,Staff,28,0,30,2
1650814583158,MATH 20D,A01,083765,Staff,2,1,30,28
1650814583158,MATH 20D,A02,083766,Staff,6,0,30,24
1650814583158,MATH 20D,A03,083767,Staff,24,0,30,6
1650814589187,MATH 20E,A01,083771,Staff,2,0,30,28
1650814589187,MATH 20E,A02,083772,Staff,15,0,30,15
1650814589187,MATH 20E,B01,083773,Staff,0,0,30,30
1650814589187,MATH 20E,B02,083774,Staff,5,0,30,25
1650814595215,MATH 103A,A01,083777,Staff,0,16,30,30
1650814595215,MATH 103A,A02,083778,Staff,0,15,30,30
1650814595215,MATH 103A,B01,083779,Staff,0,15,30,30
1650814595215,MATH 103A,B02,083780,Staff,0,15,30,30
1650814601242,MATH 105,A01,085443,Staff,0,22,30,30
1650814607270,MATH 109,A01,083213,Anzaldo; Leesa B,0,7,30,30
1650814607270,MATH 109,A02,083214,Anzaldo; Leesa B,0,7,30,30
1650814607270,MATH 109,B01,083215,Anzaldo; Leesa B,0,8,30,30
1650814607270,MATH 109,B02,083216,Anzaldo; Leesa B,0,7,30,30
1650814613295,MATH 142A,A01,083219,Chow; Bennett,0,16,30,30
1650814613295,MATH 142A,A02,083220,Chow; Bennett,0,15,30,30
1650814613295,MATH 142A,B01,083221,Chow; Bennett,0,16,30,30
1650814613295,MATH 142A,B02,083222,Chow; Bennett,0,14,30,30
1650814619319,MATH 193A,A01,083224,Staff,0,6,30,30
1650814619319,MATH 193A,A02,083225,Staff,0,6,30,30
1650814619319,MATH 193A,A03,083781,Staff,0,6,30,30
1650814619319,MATH 193A,A04,083782,Staff,0,7,30,30
1650814625343,MATH 197,001,091859,McAuley; Julian John,9998,0,9999,1
1650814631394,COGS 9,A01,083615,Staff,0,17,60,60
1650814637427,COGS 11,A01,083617,Boyle; Mary E. T.,16,0,40,24
1650814643454,COGS 13,A01,083071,Staff,0,38,40,40
1650814649478,COGS 14A,A01,092681,Staff,0,36,100,100
1650814655500,COGS 14B,A01,083073,Cheng; Tzu-Han,0,12,50,50
1650814661522,COGS 17,A01,092677,Staff,11,0,75,64
1650814667545,COGS 100,A01,083619,Staff,0,29,60,60
1650814673568,COGS 101A,A01,083621,Davis; Joshua Daniel,0,28,60,60
1650814679594,COGS 101B,A01,091572,Staff,0,3,60,60
1650814685618,COGS 101C,A01,083625,Delgado; Tania,14,0,30,16
1650814691640,COGS 107A,A01,083627,Boyle; Mary E. T.,0,16,60,60
1650814697663,COGS 118A,A01,083075,Staff,0,8,60,60
1650814703697,CSE 3,A50,083646,Miranda; Gregory Joseph,18,0,38,20
1650814703697,CSE 3,A51,083647,Miranda; Gregory Joseph,36,0,37,1
1650814709725,CSE 8A,A50,083650,Miranda; Gregory Joseph,0,29,40,40
1650814715749,CSE 11,A01,083080,Cao; Yingjun,0,96,40,40
1650814721777,CSE 12,A01,083652,Staff,0,21,100,100
1650814727801,CSE 15L,A01,083654,Staff,0,3,50,50
1650814727801,CSE 15L,A02,083655,Staff,0,2,50,50
1650814733825,CSE 20,A01,083657,Staff,49,0,80,31
1650814739847,CSE 30,A01,083084,Eldon; John,0,75,40,40
1650814745874,CSE 100,A01,083659,Cao; Yingjun,0,71,50,50
1650814751898,CSE 134B,A01,083661,Powell; Thomas Allan,0,38,65,65
1650814757922,CSE 140,A01,083663,Staff,0,11,75,75
1650814763947,CSE 140L,A01,083088,Eldon; John,0,20,75,75
1650814769970,CSE 175,A01,083665,Kumar; Rakesh,7,0,25,18
1650814775995,CSE 190,A00,092507,Dubnov; Shlomo,10,0,20,10
1650814782020,ECE 45,A01,083139,Staff,0,1,60,60
1650814788051,ECE 65,A50,083695,Staff,0,5,30,30
1650814794079,ECE 109,A01,091882,Touri; Behrouz,32,0,70,38
1650814800104,ECE 180,A00,083140,Abi Samra; Nicholas Camill,20,0,30,10
1650814800104,ECE 180,B00,083141,Abi Samra; Nicholas Camill,0,0,30,30
1650814806128,MATH 10A,A01,083735,Patchell; Gregory David,2,0,30,28
1650814806128,MATH 10A,A02,083736,Patchell; Gregory David,27,0,30,3
1650814806128,MATH 10A,A03,083737,Patchell; Gregory David,24,0,30,6
1650814812155,MATH 10B,A01,083207,Staff,0,9,30,30
1650814812155,MATH 10B,A02,083208,Staff,0,6,30,30
1650814812155,MATH 10B,B01,083739,Staff,11,0,30,19
1650814812155,MATH 10B,B02,083740,Staff,28,0,30,2
1650814818180,MATH 18,A01,083743,Staff,0,0,30,30
1650814818180,MATH 18,A02,083744,Staff,23,0,30,7
1650814818180,MATH 18,A03,083745,Staff,21,0,30,9
1650814818180,MATH 18,A04,083746,Staff,26,0,30,4
1650814818180,MATH 18,B01,083748,Staff,0,15,30,30
1650814818180,MATH 18,B02,083749,Staff,0,12,30,30
1650814818180,MATH 18,B03,083750,Staff,0,12,30,30
1650814818180,MATH 18,B04,083751,Staff,0,12,30,30
1650814824207,MATH 20A,A01,083754,Staff,19,0,40,21
1650814830230,MATH 20B,A01,083756,Staff,0,13,30,30
1650814830230,MATH 20B,A02,083757,Staff,0,12,30,30
1650814836258,MATH 20C,A01,083760,Staff,0,17,30,30
1650814836258,MATH 20C,A02,083761,Staff,0,16,30,30
1650814836258,MATH 20C,B01,083762,Staff,9,0,30,21
1650814836258,MATH 20C,B02,083763,Staff,28,0,30,2
1650814842281,MATH 20D,A01,083765,Staff,2,1,30,28
1650814842281,MATH 20D,A02,083766,Staff,6,0,30,24
1650814842281,MATH 20D,A03,083767,Staff,24,0,30,6
1650814848308,MATH 20E,A01,083771,Staff,2,0,30,28
1650814848308,MATH 20E,A02,083772,Staff,15,0,30,15
1650814848308,MATH 20E,B01,083773,Staff,0,0,30,30
1650814848308,MATH 20E,B02,083774,Staff,5,0,30,25
1650814854333,MATH 103A,A01,083777,Staff,0,16,30,30
1650814854333,MATH 103A,A02,083778,Staff,0,15,30,30
1650814854333,MATH 103A,B01,083779,Staff,0,15,30,30
1650814854333,MATH 103A,B02,083780,Staff,0,15,30,30
1650814860358,MATH 105,A01,085443,Staff,0,22,30,30
1650814866461,MATH 109,A01,083213,Anzaldo; Leesa B,0,7,30,30
1650814866461,MATH 109,A02,083214,Anzaldo; Leesa B,0,7,30,30
1650814866461,MATH 109,B01,083215,Anzaldo; Leesa B,0,8,30,30
1650814866461,MATH 109,B02,083216,Anzaldo; Leesa B,0,7,30,30
1650814872484,MATH 142A,A01,083219,Chow; Bennett,0,16,30,30
1650814872484,MATH 142A,A02,083220,Chow; Bennett,0,15,30,30
1650814872484,MATH 142A,B01,083221,Chow; Bennett,0,16,30,30
1650814872484,MATH 142A,B02,083222,Chow; Bennett,0,14,30,30
1650814878514,MATH 193A,A01,083224,Staff,0,6,30,30
1650814878514,MATH 193A,A02,083225,Staff,0,6,30,30
1650814878514,MATH 193A,A03,083781,Staff,0,6,30,30
1650814878514,MATH 193A,A04,083782,Staff,0,7,30,30
1650814884541,MATH 197,001,091859,McAuley; Julian John,9998,0,9999,1
1650814890603,COGS 9,A01,083615,Staff,0,17,60,60
1650814896629,COGS 11,A01,083617,Boyle; Mary E. T.,16,0,40,24
1650814902654,COGS 13,A01,083071,Staff,0,38,40,40
1650814908681,COGS 14A,A01,092681,Staff,0,36,100,100
1650814914703,COGS 14B,A01,083073,Cheng; Tzu-Han,0,12,50,50
1650814920729,COGS 17,A01,092677,Staff,11,0,75,64
1650814926752,COGS 100,A01,083619,Staff,0,29,60,60
1650814932781,COGS 101A,A01,083621,Davis; Joshua Daniel,0,28,60,60
1650814938804,COGS 101B,A01,091572,Staff,0,3,60,60
1650814944828,COGS 101C,A01,083625,Delgado; Tania,14,0,30,16
1650814950850,COGS 107A,A01,083627,Boyle; Mary E. T.,0,16,60,60
1650814956873,COGS 118A,A01,083075,Staff,0,8,60,60
1650814962908,CSE 3,A50,083646,Miranda; Gregory Joseph,18,0,38,20
1650814962908,CSE 3,A51,083647,Miranda; Gregory Joseph,36,0,37,1
1650814968930,CSE 8A,A50,083650,Miranda; Gregory Joseph,0,29,40,40
1650814974955,CSE 11,A01,083080,Cao; Yingjun,0,96,40,40
1650814981049,CSE 12,A01,083652,Staff,0,21,100,100
1650814987074,CSE 15L,A01,083654,Staff,0,3,50,50
1650814987074,CSE 15L,A02,083655,Staff,0,2,50,50
1650814993101,CSE 20,A01,083657,Staff,49,0,80,31
1650814999126,CSE 30,A01,083084,Eldon; John,0,75,40,40
1650815005150,CSE 100,A01,083659,Cao; Yingjun,0,71,50,50
1650815011176,CSE 134B,A01,083661,Powell; Thomas Allan,0,38,65,65
1650815017201,CSE 140,A01,083663,Staff,0,11,75,75
1650815023224,CSE 140L,A01,083088,Eldon; John,0,20,75,75
1650815029249,CSE 175,A01,083665,Kumar; Rakesh,7,0,25,18
1650815035270,CSE 190,A00,092507,Dubnov; Shlomo,10,0,20,10
1650815041295,ECE 45,A01,083139,Staff,0,1,60,60
1650815047321,ECE 65,A50,083695,Staff,0,5,30,30
1650815053347,ECE 109,A01,091882,Touri; Behrouz,32,0,70,38
1650815059374,ECE 180,A00,083140,Abi Samra; Nicholas Camill,20,0,30,10
1650815059374,ECE 180,B00,083141,Abi Samra; Nicholas Camill,0,0,30,30
1650815065401,MATH 10A,A01,083735,Patchell; Gregory David,2,0,30,28
1650815065401,MATH 10A,A02,083736,Patchell; Gregory David,27,0,30,3
1650815065401,MATH 10A,A03,083737,Patchell; Gregory David,24,0,30,6
1650815071439,MATH 10B,A01,083207,Staff,0,9,30,30
1650815071439,MATH 10B,A02,083208,Staff,0,6,30,30
1650815071439,MATH 10B,B01,083739,Staff,11,0,30,19
1650815071439,MATH 10B,B02,083740,Staff,28,0,30,2
1650815077469,MATH 18,A01,083743,Staff,0,0,30,30
1650815077469,MATH 18,A02,083744,Staff,23,0,30,7
1650815077469,MATH 18,A03,083745,Staff,21,0,30,9
1650815077469,MATH 18,A04,083746,Staff,26,0,30,4
1650815077469,MATH 18,B01,083748,Staff,0,15,30,30
1650815077469,MATH 18,B02,083749,Staff,0,12,30,30
1650815077469,MATH 18,B03,083750,Staff,0,12,30,30
1650815077469,MATH 18,B04,083751,Staff,0,12,30,30
1650815083494,MATH 20A,A01,083754,Staff,19,0,40,21
1650815089518,MATH 20B,A01,083756,Staff,0,13,30,30
1650815089518,MATH 20B,A02,083757,Staff,0,12,30,30
1650815095544,MATH 20C,A01,083760,Staff,0,17,30,30
1650815095544,MATH 20C,A02,083761,Staff,0,16,30,30
1650815095544,MATH 20C,B01,083762,Staff,9,0,30,21
1650815095544,MATH 20C,B02,083763,Staff,28,0,30,2
1650815101572,MATH 20D,A01,083765,Staff,2,1,30,28
1650815101572,MATH 20D,A02,083766,Staff,6,0,30,24
1650815101572,MATH 20D,A03,083767,Staff,24,0,30,6
1650815107595,MATH 20E,A01,083771,Staff,2,0,30,28
1650815107595,MATH 20E,A02,083772,Staff,15,0,30,15
1650815107595,MATH 20E,B01,083773,Staff,0,0,30,30
1650815107595,MATH 20E,B02,083774,Staff,5,0,30,25
1650815113618,MATH 103A,A01,083777,Staff,0,16,30,30
1650815113618,MATH 103A,A02,083778,Staff,0,15,30,30
1650815113618,MATH 103A,B01,083779,Staff,0,15,30,30
1650815113618,MATH 103A,B02,083780,Staff,0,15,30,30
1650815119640,MATH 105,A01,085443,Staff,0,22,30,30
1650815125668,MATH 109,A01,083213,Anzaldo; Leesa B,0,7,30,30
1650815125668,MATH 109,A02,083214,Anzaldo; Leesa B,0,7,30,30
1650815125668,MATH 109,B01,083215,Anzaldo; Leesa B,0,8,30,30
1650815125668,MATH 109,B02,083216,Anzaldo; Leesa B,0,7,30,30
1650815131696,MATH 142A,A01,083219,Chow; Bennett,0,16,30,30
1650815131696,MATH 142A,A02,083220,Chow; Bennett,0,15,30,30
1650815131696,MATH 142A,B01,083221,Chow; Bennett,0,16,30,30
1650815131696,MATH 142A,B02,083222,Chow; Bennett,0,14,30,30
1650815137728,MATH 193A,A01,083224,Staff,0,6,30,30
1650815137728,MATH 193A,A02,083225,Staff,0,6,30,30
1650815137728,MATH 193A,A03,083781,Staff,0,6,30,30
1650815137728,MATH 193A,A04,083782,Staff,0,7,30,30
1650815143752,MATH 197,001,091859,McAuley; Julian John,9998,0,9999,1
1650815149820,COGS 9,A01,083615,Staff,0,17,60,60
1650815155844,COGS 11,A01,083617,Boyle; Mary E. T.,16,0,40,24
1650815161871,COGS 13,A01,083071,Staff,0,38,40,40
1650815167908,COGS 14A,A01,092681,Staff,0,36,100,100
1650815173932,COGS 14B,A01,083073,Cheng; Tzu-Han,0,12,50,50
1650815179954,COGS 17,A01,092677,Staff,11,0,75,64
1650815185977,COGS 100,A01,083619,Staff,0,29,60,60
1650815192000,COGS 101A,A01,083621,Davis; Joshua Daniel,0,28,60,60
1650815198027,COGS 101B,A01,091572,Staff,0,3,60,60
1650815204052,COGS 101C,A01,083625,Delgado; Tania,14,0,30,16
1650815210075,COGS 107A,A01,083627,Boyle; Mary E. T.,0,16,60,60
1650815216097,COGS 118A,A01,083075,Staff,0,8,60,60
1650815222121,CSE 3,A50,083646,Miranda; Gregory Joseph,18,0,38,20
1650815222121,CSE 3,A51,083647,Miranda; Gregory Joseph,36,0,37,1
1650815228147,CSE 8A,A50,083650,Miranda; Gregory Joseph,0,29,40,40
1650815234173,CSE 11,A01,083080,Cao; Yingjun,0,96,40,40
1650815240201,CSE 12,A01,083652,Staff,0,21,100,100
1650815246223,CSE 15L,A01,083654,Staff,0,3,50,50
1650815246223,CSE 15L,A02,083655,Staff,0,2,50,50
1650815252247,CSE 20,A01,083657,Staff,49,0,80,31
1650815258273,CSE 30,A01,083084,Eldon; John,0,75,40,40
1650815264296,CSE 100,A01,083659,Cao; Yingjun,0,71,50,50
1650815270319,CSE 134B,A01,083661,Powell; Thomas Allan,0,38,65,65
1650815276345,CSE 140,A01,083663,Staff,0,11,75,75
1650815282370,CSE 140L,A01,083088,Eldon; John,0,20,75,75
1650815288396,CSE 175,A01,083665,Kumar; Rakesh,7,0,25,18
1650815294421,CSE 190,A00,092507,Dubnov; Shlomo,10,0,20,10
1650815300476,ECE 45,A01,083139,Staff,0,1,60,60
1650815306499,ECE 65,A50,083695,Staff,0,5,30,30
1650815312525,ECE 109,A01,091882,Touri; Behrouz,32,0,70,38
1650815318547,ECE 180,A00,083140,Abi Samra; Nicholas Camill,20,0,30,10
1650815318547,ECE 180,B00,083141,Abi Samra; Nicholas Camill,0,0,30,30
1650815324571,MATH 10A,A01,083735,Patchell; Gregory David,2,0,30,28
1650815324571,MATH 10A,A02,083736,Patchell; Gregory David,27,0,30,3
1650815324571,MATH 10A,A03,083737,Patchell; Gregory David,24,0,30,6
1650815330595,MATH 10B,A01,083207,Staff,0,9,30,30
1650815330595,MATH 10B,A02,083208,Staff,0,6,30,30
1650815330595,MATH 10B,B01,083739,Staff,11,0,30,19
1650815330595,MATH 10B,B02,083740,Staff,28,0,30,2
1650815336624,MATH 18,A01,083743,Staff,0,0,30,30
1650815336624,MATH 18,A02,083744,Staff,23,0,30,7
1650815336624,MATH 18,A03,083745,Staff,21,0,30,9
1650815336624,MATH 18,A04,083746,Staff,26,0,30,4
1650815336624,MATH 18,B01,083748,Staff,0,15,30,30
1650815336624,MATH 18,B02,083749,Staff,0,12,30,30
1650815336624,MATH 18,B03,083750,Staff,0,12,30,30
1650815336624,MATH 18,B04,083751,Staff,0,12,30,30
1650815342645,MATH 20A,A01,083754,Staff,19,0,40,21
1650815348677,MATH 20B,A01,083756,Staff,0,13,30,30
1650815348677,MATH 20B,A02,083757,Staff,0,12,30,30
1650815354699,MATH 20C,A01,083760,Staff,0,17,30,30
1650815354699,MATH 20C,A02,083761,Staff,0,16,30,30
1650815354699,MATH 20C,B01,083762,Staff,9,0,30,21
1650815354699,MATH 20C,B02,083763,Staff,28,0,30,2
1650815360722,MATH 20D,A01,083765,Staff,2,1,30,28
1650815360722,MATH 20D,A02,083766,Staff,6,0,30,24
1650815360722,MATH 20D,A03,083767,Staff,24,0,30,6
1650815366747,MATH 20E,A01,083771,Staff,2,0,30,28
1650815366747,MATH 20E,A02,083772,Staff,15,0,30,15
1650815366747,MATH 20E,B01,083773,Staff,0,0,30,30
1650815366747,MATH 20E,B02,083774,Staff,5,0,30,25
1650815372770,MATH 103A,A01,083777,Staff,0,16,30,30
1650815372770,MATH 103A,A02,083778,Staff,0,15,30,30
1650815372770,MATH 103A,B01,083779,Staff,0,15,30,30
1650815372770,MATH 103A,B02,083780,Staff,0,15,30,30
1650815378795,MATH 105,A01,085443,Staff,0,22,30,30
1650815384821,MATH 109,A01,083213,Anzaldo; Leesa B,0,7,30,30
1650815384821,MATH 109,A02,083214,Anzaldo; Leesa B,0,7,30,30
1650815384821,MATH 109,B01,083215,Anzaldo; Leesa B,0,8,30,30
1650815384821,MATH 109,B02,083216,Anzaldo; Leesa B,0,7,30,30
1650815390862,MATH 142A,A01,083219,Chow; Bennett,0,16,30,30
1650815390862,MATH 142A,A02,083220,Chow; Bennett,0,15,30,30
1650815390862,MATH 142A,B01,083221,Chow; Bennett,0,16,30,30
1650815390862,MATH 142A,B02,083222,Chow; Bennett,0,14,30,30
1650815396889,MATH 193A,A01,083224,Staff,0,6,30,30
1650815396889,MATH 193A,A02,083225,Staff,0,6,30,30
1650815396889,MATH 193A,A03,083781,Staff,0,6,30,30
1650815396889,MATH 193A,A04,083782,Staff,0,7,30,30
1650815402912,MATH 197,001,091859,McAuley; Julian John,9998,0,9999,1
1650815408974,COGS 9,A01,083615,Staff,0,17,60,60
1650815415000,COGS 11,A01,083617,Boyle; Mary E. T.,16,0,40,24
1650815421027,COGS 13,A01,083071,Staff,0,38,40,40
1650815427053,COGS 14A,A01,092681,Staff,0,36,100,100
1650815433079,COGS 14B,A01,083073,Cheng; Tzu-Han,0,12,50,50
1650815439103,COGS 17,A01,092677,Staff,11,0,75,64
1650815445130,COGS 100,A01,083619,Staff,0,29,60,60
1650815451155,COGS 101A,A01,083621,Davis; Joshua Daniel,0,28,60,60
1650815457272,COGS 101B,A01,091572,Staff,0,3,60,60
1650815463298,COGS 101C,A01,083625,Delgado; Tania,14,0,30,16
1650815469322,COGS 107A,A01,083627,Boyle; Mary E. T.,0,16,60,60
1650815475346,COGS 118A,A01,083075,Staff,0,8,60,60
1650815481375,CSE 3,A50,083646,Miranda; Gregory Joseph,18,0,38,20
1650815481375,CSE 3,A51,083647,Miranda; Gregory Joseph,36,0,37,1
1650815487399,CSE 8A,A50,083650,Miranda; Gregory Joseph,0,29,40,40
1650815493422,CSE 11,A01,083080,Cao; Yingjun,0,96,40,40
1650815499449,CSE 12,A01,083652,Staff,0,21,100,100
1650815505471,CSE 15L,A01,083654,Staff,0,3,50,50
1650815505471,CSE 15L,A02,083655,Staff,0,2,50,50
1650815511495,CSE 20,A01,083657,Staff,49,0,80,31
1650815517518,CSE 30,A01,083084,Eldon; John,0,75,40,40
1650815523544,CSE 100,A01,083659,Cao; Yingjun,0,71,50,50
1650815529569,CSE 134B,A01,083661,Powell; Thomas Allan,0,38,65,65
1650815535596,CSE 140,A01,083663,Staff,0,11,75,75
1650815541621,CSE 140L,A01,083088,Eldon; John,0,20,75,75
1650815547654,CSE 175,A01,083665,Kumar; Rakesh,7,0,25,18
1650815553680,CSE 190,A00,092507,Dubnov; Shlomo,10,0,20,10
1650815559703,ECE 45,A01,083139,Staff,0,1,60,60
1650815565724,ECE 65,A50,083695,Staff,0,5,30,30
1650815571749,ECE 109,A01,091882,Touri; Behrouz,32,0,70,38
1650815577776,ECE 180,A00,083140,Abi Samra; Nicholas Camill,20,0,30,10
1650815577776,ECE 180,B00,083141,Abi Samra; Nicholas Camill,0,0,30,30
1650815583805,MATH 10A,A01,083735,Patchell; Gregory David,2,0,30,28
1650815583805,MATH 10A,A02,083736,Patchell; Gregory David,27,0,30,3
1650815583805,MATH 10A,A03,083737,Patchell; Gregory David,24,0,30,6
1650815589831,MATH 10B,A01,083207,Staff,0,9,30,30
1650815589831,MATH 10B,A02,083208,Staff,0,6,30,30
1650815589831,MATH 10B,B01,083739,Staff,11,0,30,19
1650815589831,MATH 10B,B02,083740,Staff,28,0,30,2
1650815595855,MATH 18,A01,083743,Staff,0,0,30,30
1650815595855,MATH 18,A02,083744,Staff,23,0,30,7
1650815595855,MATH 18,A03,083745,Staff,21,0,30,9
1650815595855,MATH 18,A04,083746,Staff,26,0,30,4
1650815595855,MATH 18,B01,083748,Staff,0,15,30,30
1650815595855,MATH 18,B02,083749,Staff,0,12,30,30
1650815595855,MATH 18,B03,083750,Staff,0,12,30,30
1650815595855,MATH 18,B04,083751,Staff,0,12,30,30
1650815601881,MATH 20A,A01,083754,Staff,19,0,40,21
1650815607907,MATH 20B,A01,083756,Staff,0,13,30,30
1650815607907,MATH 20B,A02,083757,Staff,0,12,30,30
1650815613935,MATH 20C,A01,083760,Staff,0,17,30,30
1650815613935,MATH 20C,A02,083761,Staff,0,16,30,30
1650815613935,MATH 20C,B01,083762,Staff,9,0,30,21
1650815613935,MATH 20C,B02,083763,Staff,28,0,30,2
1650815619959,MATH 20D,A01,083765,Staff,2,1,30,28
1650815619959,MATH 20D,A02,083766,Staff,6,0,30,24
1650815619959,MATH 20D,A03,083767,Staff,24,0,30,6
1650815625983,MATH 20E,A01,083771,Staff,2,0,30,28
1650815625983,MATH 20E,A02,083772,Staff,15,0,30,15
1650815625983,MATH 20E,B01,083773,Staff,0,0,30,30
1650815625983,MATH 20E,B02,083774,Staff,5,0,30,25
1650815632007,MATH 103A,A01,083777,Staff,0,16,30,30
1650815632007,MATH 103A,A02,083778,Staff,0,15,30,30
1650815632007,MATH 103A,B01,083779,Staff,0,15,30,30
1650815632007,MATH 103A,B02,083780,Staff,0,15,30,30
1650815638028,MATH 105,A01,085443,Staff,0,22,30,30
1650815644056,MATH 109,A01,083213,Anzaldo; Leesa B,0,7,30,30
1650815644056,MATH 109,A02,083214,Anzaldo; Leesa B,0,7,30,30
1650815644056,MATH 109,B01,083215,Anzaldo; Leesa B,0,8,30,30
1650815644056,MATH 109,B02,083216,Anzaldo; Leesa B,0,7,30,30
1650815650081,MATH 142A,A01,083219,Chow; Bennett,0,16,30,30
1650815650081,MATH 142A,A02,083220,Chow; Bennett,0,15,30,30
1650815650081,MATH 142A,B01,083221,Chow; Bennett,0,16,30,30
1650815650081,MATH 142A,B02,083222,Chow; Bennett,0,14,30,30
1650815656104,MATH 193A,A01,083224,Staff,0,6,30,30
1650815656104,MATH 193A,A02,083225,Staff,0,6,30,30
1650815656104,MATH 193A,A03,083781,Staff,0,6,30,30
1650815656104,MATH 193A,A04,083782,Staff,0,7,30,30
1650815662128,MATH 197,001,091859,McAuley; Julian John,9998,0,9999,1
1650815668184,COGS 9,A01,083615,Staff,0,17,60,60
1650815674209,COGS 11,A01,083617,Boyle; Mary E. T.,16,0,40,24
1650815680237,COGS 13,A01,083071,Staff,0,38,40,40
1650815686258,COGS 14A,A01,092681,Staff,0,36,100,100
1650815692283,COGS 14B,A01,083073,Cheng; Tzu-Han,0,12,50,50
1650815698306,COGS 17,A01,092677,Staff,11,0,75,64
1650815704329,COGS 100,A01,083619,Staff,0,29,60,60
1650815710352,COGS 101A,A01,083621,Davis; Joshua Daniel,0,28,60,60
1650815716380,COGS 101B,A01,091572,Staff,0,3,60,60
1650815722406,COGS 101C,A01,083625,Delgado; Tania,14,0,30,16
1650815728432,COGS 107A,A01,083627,Boyle; Mary E. T.,0,16,60,60
1650815734459,COGS 118A,A01,083075,Staff,0,8,60,60
1650815740482,CSE 3,A50,083646,Miranda; Gregory Joseph,18,0,38,20
1650815740482,CSE 3,A51,083647,Miranda; Gregory Joseph,36,0,37,1
1650815746508,CSE 8A,A50,083650,Miranda; Gregory Joseph,0,29,40,40
1650815752535,CSE 11,A01,083080,Cao; Yingjun,0,96,40,40
1650815758561,CSE 12,A01,083652,Staff,0,21,100,100
1650815764585,CSE 15L,A01,083654,Staff,0,3,50,50
1650815764585,CSE 15L,A02,083655,Staff,0,2,50,50
1650815770609,CSE 20,A01,083657,Staff,49,0,80,31
1650815776631,CSE 30,A01,083084,Eldon; John,0,75,40,40
1650815782654,CSE 100,A01,083659,Cao; Yingjun,0,71,50,50
1650815788680,CSE 134B,A01,083661,Powell; Thomas Allan,0,38,65,65
1650815794716,CSE 140,A01,083663,Staff,0,11,75,75
1650815800745,CSE 140L,A01,083088,Eldon; John,0,20,75,75
1650815806773,CSE 175,A01,083665,Kumar; Rakesh,7,0,25,18
1650815812800,CSE 190,A00,092507,Dubnov; Shlomo,10,0,20,10
1650815818830,ECE 45,A01,083139,Staff,0,1,60,60
1650815824854,ECE 65,A50,083695,Staff,0,5,30,30
1650815830877,ECE 109,A01,091882,Touri; Behrouz,32,0,70,38
1650815836900,ECE 180,A00,083140,Abi Samra; Nicholas Camill,20,0,30,10
1650815836900,ECE 180,B00,083141,Abi Samra; Nicholas Camill,0,0,30,30
1650815842925,MATH 10A,A01,083735,Patchell; Gregory David,2,0,30,28
1650815842925,MATH 10A,A02,083736,Patchell; Gregory David,27,0,30,3
1650815842925,MATH 10A,A03,083737,Patchell; Gregory David,24,0,30,6
1650815848948,MATH 10B,A01,083207,Staff,0,9,30,30
1650815848948,MATH 10B,A02,083208,Staff,0,6,30,30
1650815848948,MATH 10B,B01,083739,Staff,11,0,30,19
1650815848948,MATH 10B,B02,083740,Staff,28,0,30,2
1650815854973,MATH 18,A01,083743,Staff,0,0,30,30
1650815854973,MATH 18,A02,083744,Staff,23,0,30,7
1650815854973,MATH 18,A03,083745,Staff,21,0,30,9
1650815854973,MATH 18,A04,083746,Staff,26,0,30,4
1650815854973,MATH 18,B01,083748,Staff,0,15,30,30
1650815854973,MATH 18,B02,083749,Staff,0,12,30,30
1650815854973,MATH 18,B03,083750,Staff,0,12,30,30
1650815854973,MATH 18,B04,083751,Staff,0,12,30,30
1650815860997,MATH 20A,A01,083754,Staff,19,0,40,21
1650815867025,MATH 20B,A01,083756,Staff,0,13,30,30
1650815867025,MATH 20B,A02,083757,Staff,0,12,30,30
1650815873053,MATH 20C,A01,083760,Staff,0,17,30,30
1650815873053,MATH 20C,A02,083761,Staff,0,16,30,30
1650815873053,MATH 20C,B01,083762,Staff,9,0,30,21
1650815873053,MATH 20C,B02,083763,Staff,28,0,30,2
1650815879078,MATH 20D,A01,083765,Staff,2,1,30,28
1650815879078,MATH 20D,A02,083766,Staff,6,0,30,24
1650815879078,MATH 20D,A03,083767,Staff,24,0,30,6
1650815885105,MATH 20E,A01,083771,Staff,2,0,30,28
1650815885105,MATH 20E,A02,083772,Staff,15,0,30,15
1650815885105,MATH 20E,B01,083773,Staff,0,0,30,30
1650815885105,MATH 20E,B02,083774,Staff,5,0,30,25
1650815891131,MATH 103A,A01,083777,Staff,0,16,30,30
1650815891131,MATH 103A,A02,083778,Staff,0,15,30,30
1650815891131,MATH 103A,B01,083779,Staff,0,15,30,30
1650815891131,MATH 103A,B02,083780,Staff,0,15,30,30
1650815897156,MATH 105,A01,085443,Staff,0,22,30,30
1650815903182,MATH 109,A01,083213,Anzaldo; Leesa B,0,7,30,30
1650815903182,MATH 109,A02,083214,Anzaldo; Leesa B,0,7,30,30
1650815903182,MATH 109,B01,083215,Anzaldo; Leesa B,0,8,30,30
1650815903182,MATH 109,B02,083216,Anzaldo; Leesa B,0,7,30,30
1650815909211,MATH 142A,A01,083219,Chow; Bennett,0,16,30,30
1650815909211,MATH 142A,A02,083220,Chow; Bennett,0,15,30,30
1650815909211,MATH 142A,B01,083221,Chow; Bennett,0,16,30,30
1650815909211,MATH 142A,B02,083222,Chow; Bennett,0,14,30,30
1650815915233,MATH 193A,A01,083224,Staff,0,6,30,30
1650815915233,MATH 193A,A02,083225,Staff,0,6,30,30
1650815915233,MATH 193A,A03,083781,Staff,0,6,30,30
1650815915233,MATH 193A,A04,083782,Staff,0,7,30,30
1650815921256,MATH 197,001,091859,McAuley; Julian John,9998,0,9999,1
1650815927306,COGS 9,A01,083615,Staff,0,17,60,60
1650815933340,COGS 11,A01,083617,Boyle; Mary E. T.,16,0,40,24
1650815939362,COGS 13,A01,083071,Staff,0,38,40,40
1650815945387,COGS 14A,A01,092681,Staff,0,36,100,100
1650815951411,COGS 14B,A01,083073,Cheng; Tzu-Han,0,12,50,50
1650815957435,COGS 17,A01,092677,Staff,11,0,75,64
1650815963462,COGS 100,A01,083619,Staff,0,29,60,60
1650815969484,COGS 101A,A01,083621,Davis; Joshua Daniel,0,28,60,60
1650815975507,COGS 101B,A01,091572,Staff,0,3,60,60
1650815981529,COGS 101C,A01,083625,Delgado; Tania,14,0,30,16
1650815987551,COGS 107A,A01,083627,Boyle; Mary E. T.,0,16,60,60
1650815993573,COGS 118A,A01,083075,Staff,0,8,60,60
1650815999599,CSE 3,A50,083646,Miranda; Gregory Joseph,18,0,38,20
1650815999599,CSE 3,A51,083647,Miranda; Gregory Joseph,36,0,37,1
1650816005621,CSE 8A,A50,083650,Miranda; Gregory Joseph,0,29,40,40
1650816011647,CSE 11,A01,083080,Cao; Yingjun,0,96,40,40
1650816017673,CSE 12,A01,083652,Staff,0,21,100,100
1650816023696,CSE 15L,A01,083654,Staff,0,3,50,50
1650816023696,CSE 15L,A02,083655,Staff,0,2,50,50
1650816029720,CSE 20,A01,083657,Staff,49,0,80,31
1650816035742,CSE 30,A01,083084,Eldon; John,0,75,40,40
1650816041770,CSE 100,A01,083659,Cao; Yingjun,0,71,50,50
1650816047793,CSE 134B,A01,083661,Powell; Thomas Allan,0,38,65,65
1650816053904,CSE 140,A01,083663,Staff,0,11,75,75
1650816059927,CSE 140L,A01,083088,Eldon; John,0,20,75,75
1650816065954,CSE 175,A01,083665,Kumar; Rakesh,7,0,25,18
1650816071978,CSE 190,A00,092507,Dubnov; Shlomo,10,0,20,10
1650816078007,ECE 45,A01,083139,Staff,0,1,60,60
1650816084033,ECE 65,A50,083695,Staff,0,5,30,30
1650816090057,ECE 109,A01,091882,Touri; Behrouz,32,0,70,38
1650816096082,ECE 180,A00,083140,Abi Samra; Nicholas Camill,20,0,30,10
1650816096082,ECE 180,B00,083141,Abi Samra; Nicholas Camill,0,0,30,30
1650816102110,MATH 10A,A01,083735,Patchell; Gregory David,2,0,30,28
1650816102110,MATH 10A,A02,083736,Patchell; Gregory David,27,0,30,3
1650816102110,MATH 10A,A03,083737,Patchell; Gregory David,24,0,30,6
1650816108135,MATH 10B,A01,083207,Staff,0,9,30,30
1650816108135,MATH 10B,A02,083208,Staff,0,6,30,30
1650816108135,MATH 10B,B01,083739,Staff,11,0,30,19
1650816108135,MATH 10B,B02,083740,Staff,28,0,30,2
1650816114163,MATH 18,A01,083743,Staff,0,0,30,30
1650816114163,MATH 18,A02,083744,Staff,23,0,30,7
1650816114163,MATH 18,A03,083745,Staff,21,0,30,9
1650816114163,MATH 18,A04,083746,Staff,26,0,30,4
1650816114163,MATH 18,B01,083748,Staff,0,15,30,30
1650816114163,MATH 18,B02,083749,Staff,0,12,30,30
1650816114163,MATH 18,B03,083750,Staff,0,12,30,30
1650816114163,MATH 18,B04,083751,Staff,0,12,30,30
1650816120195,MATH 20A,A01,083754,Staff,19,0,40,21
1650816126218,MATH 20B,A01,083756,Staff,0,13,30,30
1650816126218,MATH 20B,A02,083757,Staff,0,12,30,30
1650816132245,MATH 20C,A01,083760,Staff,0,17,30,30
1650816132245,MATH 20C,A02,083761,Staff,0,16,30,30
1650816132245,MATH 20C,B01,083762,Staff,9,0,30,21
1650816132245,MATH 20C,B02,083763,Staff,28,0,30,2
1650816138269,MATH 20D,A01,083765,Staff,2,1,30,28
1650816138269,MATH 20D,A02,083766,Staff,6,0,30,24
1650816138269,MATH 20D,A03,083767,Staff,24,0,30,6
1650816144295,MATH 20E,A01,083771,Staff,2,0,30,28
1650816144295,MATH 20E,A02,083772,Staff,15,0,30,15
1650816144295,MATH 20E,B01,083773,Staff,0,0,30,30
1650816144295,MATH 20E,B02,083774,Staff,5,0,30,25
1650816150321,MATH 103A,A01,083777,Staff,0,16,30,30
1650816150321,MATH 103A,A02,083778,Staff,0,15,30,30
1650816150321,MATH 103A,B01,083779,Staff,0,15,30,30
1650816150321,MATH 103A,B02,083780,Staff,0,15,30,30
1650816156351,MATH 105,A01,085443,Staff,0,22,30,30
1650816162375,MATH 109,A01,083213,Anzaldo; Leesa B,0,7,30,30
1650816162375,MATH 109,A02,083214,Anzaldo; Leesa B,0,7,30,30
1650816162375,MATH 109,B01,083215,Anzaldo; Leesa B,0,8,30,30
1650816162375,MATH 109,B02,083216,Anzaldo; Leesa B,0,7,30,30
1650816168404,MATH 142A,A01,083219,Chow; Bennett,0,16,30,30
1650816168404,MATH 142A,A02,083220,Chow; Bennett,0,15,30,30
1650816168404,MATH 142A,B01,083221,Chow; Bennett,0,16,30,30
1650816168404,MATH 142A,B02,083222,Chow; Bennett,0,14,30,30
1650816174435,MATH 193A,A01,083224,Staff,0,6,30,30
1650816174435,MATH 193A,A02,083225,Staff,0,6,30,30
1650816174435,MATH 193A,A03,083781,Staff,0,6,30,30
1650816174435,MATH 193A,A04,083782,Staff,0,7,30,30
1650816180457,MATH 197,001,091859,McAuley; Julian John,9998,0,9999,1
1650816186519,COGS 9,A01,083615,Staff,0,17,60,60
1650816192543,COGS 11,A01,083617,Boyle; Mary E. T.,16,0,40,24
1650816198566,COGS 13,A01,083071,Staff,0,38,40,40
1650816204589,COGS 14A,A01,092681,Staff,0,36,100,100
1650816210616,COGS 14B,A01,083073,Cheng; Tzu-Han,0,12,50,50
1650816216642,COGS 17,A01,092677,Staff,11,0,75,64
1650816222664,COGS 100,A01,083619,Staff,0,29,60,60
1650816228687,COGS 101A,A01,083621,Davis; Joshua Daniel,0,28,60,60
1650816234709,COGS 101B,A01,091572,Staff,0,3,60,60
1650816240733,COGS 101C,A01,083625,Delgado; Tania,14,0,30,16
1650816246759,COGS 107A,A01,083627,Boyle; Mary E. T.,0,16,60,60
1650816252782,COGS 118A,A01,083075,Staff,0,8,60,60
1650816258805,CSE 3,A50,083646,Miranda; Gregory Joseph,18,0,38,20
1650816258805,CSE 3,A51,083647,Miranda; Gregory Joseph,36,0,37,1
1650816264833,CSE 8A,A50,083650,Miranda; Gregory Joseph,0,29,40,40
1650816270857,CSE 11,A01,083080,Cao; Yingjun,0,96,40,40
1650816276884,CSE 12,A01,083652,Staff,0,21,100,100
1650816282909,CSE 15L,A01,083654,Staff,0,3,50,50
1650816282909,CSE 15L,A02,083655,Staff,0,2,50,50
1650816288932,CSE 20,A01,083657,Staff,49,0,80,31
1650816294956,CSE 30,A01,083084,Eldon; John,0,75,40,40
1650816300982,CSE 100,A01,083659,Cao; Yingjun,0,71,50,50
1650816307007,CSE 134B,A01,083661,Powell; Thomas Allan,0,38,65,65
1650816313030,CSE 140,A01,083663,Staff,0,11,75,75
1650816319055,CSE 140L,A01,083088,Eldon; John,0,20,75,75
1650816325078,CSE 175,A01,083665,Kumar; Rakesh,7,0,25,18
1650816331106,CSE 190,A00,092507,Dubnov; Shlomo,10,0,20,10
1650816337142,ECE 45,A01,083139,Staff,0,1,60,60
1650816343177,ECE 65,A50,083695,Staff,0,5,30,30
1650816349200,ECE 109,A01,091882,Touri; Behrouz,32,0,70,38
1650816355224,ECE 180,A00,083140,Abi Samra; Nicholas Camill,20,0,30,10
1650816355224,ECE 180,B00,083141,Abi Samra; Nicholas Camill,0,0,30,30
1650816361248,MATH 10A,A01,083735,Patchell; Gregory David,2,0,30,28
1650816361248,MATH 10A,A02,083736,Patchell; Gregory David,27,0,30,3
1650816361248,MATH 10A,A03,083737,Patchell; Gregory David,24,0,30,6
1650816367277,MATH 10B,A01,083207,Staff,0,9,30,30
1650816367277,MATH 10B,A02,083208,Staff,0,6,30,30
1650816367277,MATH 10B,B01,083739,Staff,11,0,30,19
1650816367277,MATH 10B,B02,083740,Staff,28,0,30,2
1650816373307,MATH 18,A01,083743,Staff,0,0,30,30
1650816373307,MATH 18,A02,083744,Staff,23,0,30,7
1650816373307,MATH 18,A03,083745,Staff,21,0,30,9
1650816373307,MATH 18,A04,083746,Staff,26,0,30,4
1650816373307,MATH 18,B01,083748,Staff,0,15,30,30
1650816373307,MATH 18,B02,083749,Staff,0,12,30,30
1650816373307,MATH 18,B03,083750,Staff,0,12,30,30
1650816373307,MATH 18,B04,083751,Staff,0,12,30,30
1650816379334,MATH 20A,A01,083754,Staff,19,0,40,21
1650816385358,MATH 20B,A01,083756,Staff,0,13,30,30
1650816385358,MATH 20B,A02,083757,Staff,0,12,30,30
1650816391390,MATH 20C,A01,083760,Staff,0,17,30,30
1650816391390,MATH 20C,A02,083761,Staff,0,16,30,30
1650816391390,MATH 20C,B01,083762,Staff,9,0,30,21
1650816391390,MATH 20C,B02,083763,Staff,28,0,30,2
1650816397414,MATH 20D,A01,083765,Staff,2,1,30,28
1650816397414,MATH 20D,A02,083766,Staff,6,0,30,24
1650816397414,MATH 20D,A03,083767,Staff,24,0,30,6
1650816403446,MATH 20E,A01,083771,Staff,2,0,30,28
1650816403446,MATH 20E,A02,083772,Staff,15,0,30,15
1650816403446,MATH 20E,B01,083773,Staff,0,0,30,30
1650816403446,MATH 20E,B02,083774,Staff,5,0,30,25
1650816409470,MATH 103A,A01,083777,Staff,0,16,30,30
1650816409470,MATH 103A,A02,083778,Staff,0,15,30,30
1650816409470,MATH 103A,B01,083779,Staff,0,15,30,30
1650816409470,MATH 103A,B02,083780,Staff,0,15,30,30
1650816415507,MATH 105,A01,085443,Staff,0,22,30,30
1650816421532,MATH 109,A01,083213,Anzaldo; Leesa B,0,7,30,30
1650816421532,MATH 109,A02,083214,Anzaldo; Leesa B,0,7,30,30
1650816421532,MATH 109,B01,083215,Anzaldo; Leesa B,0,8,30,30
1650816421532,MATH 109,B02,083216,Anzaldo; Leesa B,0,7,30,30
1650816427560,MATH 142A,A01,083219,Chow; Bennett,0,16,30,30
1650816427560,MATH 142A,A02,083220,Chow; Bennett,0,15,30,30
1650816427560,MATH 142A,B01,083221,Chow; Bennett,0,16,30,30
1650816427560,MATH 142A,B02,083222,Chow; Bennett,0,14,30,30
1650816433582,MATH 193A,A01,083224,Staff,0,6,30,30
1650816433582,MATH 193A,A02,083225,Staff,0,6,30,30
1650816433582,MATH 193A,A03,083781,Staff,0,6,30,30
1650816433582,MATH 193A,A04,083782,Staff,0,7,30,30
1650816439607,MATH 197,001,091859,McAuley; Julian John,9998,0,9999,1
1650816445664,COGS 9,A01,083615,Staff,0,17,60,60
1650816451690,COGS 11,A01,083617,Boyle; Mary E. T.,16,0,40,24
1650816457717,COGS 13,A01,083071,Staff,0,38,40,40
1650816463742,COGS 14A,A01,092681,Staff,0,36,100,100
1650816469765,COGS 14B,A01,083073,Cheng; Tzu-Han,0,12,50,50
1650816475790,COGS 17,A01,092677,Staff,11,0,75,64
1650816481815,COGS 100,A01,083619,Staff,0,29,60,60
1650816487847,COGS 101A,A01,083621,Davis; Joshua Daniel,0,28,60,60
1650816493873,COGS 101B,A01,091572,Staff,0,3,60,60
1650816499906,COGS 101C,A01,083625,Delgado; Tania,14,0,30,16
1650816505937,COGS 107A,A01,083627,Boyle; Mary E. T.,0,16,60,60
1650816511960,COGS 118A,A01,083075,Staff,0,8,60,60
1650816517988,CSE 3,A50,083646,Miranda; Gregory Joseph,18,0,38,20
1650816517988,CSE 3,A51,083647,Miranda; Gregory Joseph,36,0,37,1
1650816524011,CSE 8A,A50,083650,Miranda; Gregory Joseph,0,29,40,40
1650816530034,CSE 11,A01,083080,Cao; Yingjun,0,96,40,40
1650816536061,CSE 12,A01,083652,Staff,0,21,100,100
1650816542086,CSE 15L,A01,083654,Staff,0,3,50,50
1650816542086,CSE 15L,A02,083655,Staff,0,2,50,50
1650816548110,CSE 20,A01,083657,Staff,49,0,80,31
1650816554137,CSE 30,A01,083084,Eldon; John,0,75,40,40
1650816560164,CSE 100,A01,083659,Cao; Yingjun,0,71,50,50
1650816566187,CSE 134B,A01,083661,Powell; Thomas Allan,0,38,65,65
1650816572211,CSE 140,A01,083663,Staff,0,11,75,75
1650816578234,CSE 140L,A01,083088,Eldon; John,0,20,75,75
1650816584258,CSE 175,A01,083665,Kumar; Rakesh,7,0,25,18
1650816590286,CSE 190,A00,092507,Dubnov; Shlomo,10,0,20,10
1650816596311,ECE 45,A01,083139,Staff,0,1,60,60
1650816602339,ECE 65,A50,083695,Staff,0,5,30,30
1650816608362,ECE 109,A01,091882,Touri; Behrouz,32,0,70,38
1650816614386,ECE 180,A00,083140,Abi Samra; Nicholas Camill,20,0,30,10
1650816614386,ECE 180,B00,083141,Abi Samra; Nicholas Camill,0,0,30,30
1650816620410,MATH 10A,A01,083735,Patchell; Gregory David,2,0,30,28
1650816620410,MATH 10A,A02,083736,Patchell; Gregory David,27,0,30,3
1650816620410,MATH 10A,A03,083737,Patchell; Gregory David,24,0,30,6
1650816626439,MATH 10B,A01,083207,Staff,0,9,30,30
1650816626439,MATH 10B,A02,083208,Staff,0,6,30,30
1650816626439,MATH 10B,B01,083739,Staff,11,0,30,19
1650816626439,MATH 10B,B02,083740,Staff,28,0,30,2
1650816632469,MATH 18,A01,083743,Staff,0,0,30,30
1650816632469,MATH 18,A02,083744,Staff,23,0,30,7
1650816632469,MATH 18,A03,083745,Staff,21,0,30,9
1650816632469,MATH 18,A04,083746,Staff,26,0,30,4
1650816632469,MATH 18,B01,083748,Staff,0,15,30,30
1650816632469,MATH 18,B02,083749,Staff,0,12,30,30
1650816632469,MATH 18,B03,083750,Staff,0,12,30,30
1650816632469,MATH 18,B04,083751,Staff,0,12,30,30
1650816638491,MATH 20A,A01,083754,Staff,19,0,40,21
1650816644514,MATH 20B,A01,083756,Staff,0,13,30,30
1650816644514,MATH 20B,A02,083757,Staff,0,12,30,30
1650816650626,MATH 20C,A01,083760,Staff,0,17,30,30
1650816650626,MATH 20C,A02,083761,Staff,0,16,30,30
1650816650626,MATH 20C,B01,083762,Staff,9,0,30,21
1650816650626,MATH 20C,B02,083763,Staff,28,0,30,2
1650816656652,MATH 20D,A01,083765,Staff,2,1,30,28
1650816656652,MATH 20D,A02,083766,Staff,6,0,30,24
1650816656652,MATH 20D,A03,083767,Staff,24,0,30,6
1650816662680,MATH 20E,A01,083771,Staff,2,0,30,28
1650816662680,MATH 20E,A02,083772,Staff,15,0,30,15
1650816662680,MATH 20E,B01,083773,Staff,0,0,30,30
1650816662680,MATH 20E,B02,083774,Staff,5,0,30,25
1650816668710,MATH 103A,A01,083777,Staff,0,16,30,30
1650816668710,MATH 103A,A02,083778,Staff,0,15,30,30
1650816668710,MATH 103A,B01,083779,Staff,0,15,30,30
1650816668710,MATH 103A,B02,083780,Staff,0,15,30,30
1650816674746,MATH 105,A01,085443,Staff,0,22,30,30
1650816680770,MATH 109,A01,083213,Anzaldo; Leesa B,0,7,30,30
1650816680770,MATH 109,A02,083214,Anzaldo; Leesa B,0,7,30,30
1650816680770,MATH 109,B01,083215,Anzaldo; Leesa B,0,8,30,30
1650816680770,MATH 109,B02,083216,Anzaldo; Leesa B,0,7,30,30
1650816686801,MATH 142A,A01,083219,Chow; Bennett,0,16,30,30
1650816686801,MATH 142A,A02,083220,Chow; Bennett,0,15,30,30
1650816686801,MATH 142A,B01,083221,Chow; Bennett,0,16,30,30
1650816686801,MATH 142A,B02,083222,Chow; Bennett,0,14,30,30
1650816692825,MATH 193A,A01,083224,Staff,0,6,30,30
1650816692825,MATH 193A,A02,083225,Staff,0,6,30,30
1650816692825,MATH 193A,A03,083781,Staff,0,6,30,30
1650816692825,MATH 193A,A04,083782,Staff,0,7,30,30
1650816698848,MATH 197,001,091859,McAuley; Julian John,9998,0,9999,1
1650816704905,COGS 9,A01,083615,Staff,0,17,60,60
1650816710929,COGS 11,A01,083617,Boyle; Mary E. T.,16,0,40,24
1650816716953,COGS 13,A01,083071,Staff,0,38,40,40
1650816722984,COGS 14A,A01,092681,Staff,0,36,100,100
1650816729008,COGS 14B,A01,083073,Cheng; Tzu-Han,0,12,50,50
1650816735038,COGS 17,A01,092677,Staff,11,0,75,64
1650816741065,COGS 100,A01,083619,Staff,0,29,60,60
1650816747092,COGS 101A,A01,083621,Davis; Joshua Daniel,0,28,60,60
1650816753114,COGS 101B,A01,091572,Staff,0,3,60,60
1650816759141,COGS 101C,A01,083625,Delgado; Tania,14,0,30,16
1650816765165,COGS 107A,A01,083627,Boyle; Mary E. T.,0,16,60,60
1650816771197,COGS 118A,A01,083075,Staff,0,8,60,60
1650816777225,CSE 3,A50,083646,Miranda; Gregory Joseph,18,0,38,20
1650816777225,CSE 3,A51,083647,Miranda; Gregory Joseph,36,0,37,1
1650816783255,CSE 8A,A50,083650,Miranda; Gregory Joseph,0,29,40,40
1650816789279,CSE 11,A01,083080,Cao; Yingjun,0,96,40,40
1650816795304,CSE 12,A01,083652,Staff,0,21,100,100
1650816801331,CSE 15L,A01,083654,Staff,0,3,50,50
1650816801331,CSE 15L,A02,083655,Staff,0,2,50,50
1650816807354,CSE 20,A01,083657,Staff,49,0,80,31
1650816813377,CSE 30,A01,083084,Eldon; John,0,75,40,40
1650816819411,CSE 100,A01,083659,Cao; Yingjun,0,71,50,50
1650816825438,CSE 134B,A01,083661,Powell; Thomas Allan,0,38,65,65
1650816831465,CSE 140,A01,083663,Staff,0,11,75,75
1650816837489,CSE 140L,A01,083088,Eldon; John,0,20,75,75
1650816843515,CSE 175,A01,083665,Kumar; Rakesh,7,0,25,18
1650816849538,CSE 190,A00,092507,Dubnov; Shlomo,10,0,20,10
1650816855566,ECE 45,A01,083139,Staff,0,1,60,60
1650816861589,ECE 65,A50,083695,Staff,0,5,30,30
1650816867614,ECE 109,A01,091882,Touri; Behrouz,32,0,70,38
1650816873642,ECE 180,A00,083140,Abi Samra; Nicholas Camill,20,0,30,10
1650816873642,ECE 180,B00,083141,Abi Samra; Nicholas Camill,0,0,30,30
1650816879666,MATH 10A,A01,083735,Patchell; Gregory David,2,0,30,28
1650816879666,MATH 10A,A02,083736,Patchell; Gregory David,27,0,30,3
1650816879666,MATH 10A,A03,083737,Patchell; Gregory David,24,0,30,6
1650816885701,MATH 10B,A01,083207,Staff,0,9,30,30
1650816885701,MATH 10B,A02,083208,Staff,0,6,30,30
1650816885701,MATH 10B,B01,083739,Staff,11,0,30,19
1650816885701,MATH 10B,B02,083740,Staff,28,0,30,2
1650816891728,MATH 18,A01,083743,Staff,0,0,30,30
1650816891728,MATH 18,A02,083744,Staff,23,0,30,7
1650816891728,MATH 18,A03,083745,Staff,21,0,30,9
1650816891728,MATH 18,A04,083746,Staff,26,0,30,4
1650816891728,MATH 18,B01,083748,Staff,0,15,30,30
1650816891728,MATH 18,B02,083749,Staff,0,12,30,30
1650816891728,MATH 18,B03,083750,Staff,0,12,30,30
1650816891728,MATH 18,B04,083751,Staff,0,12,30,30
1650816897755,MATH 20A,A01,083754,Staff,19,0,40,21
1650816903778,MATH 20B,A01,083756,Staff,0,13,30,30
1650816903778,MATH 20B,A02,083757,Staff,0,12,30,30
1650816909801,MATH 20C,A01,083760,Staff,0,17,30,30
1650816909801,MATH 20C,A02,083761,Staff,0,16,30,30
1650816909801,MATH 20C,B01,083762,Staff,9,0,30,21
1650816909801,MATH 20C,B02,083763,Staff,28,0,30,2
1650816915827,MATH 20D,A01,083765,Staff,2,1,30,28
1650816915827,MATH 20D,A02,083766,Staff,6,0,30,24
1650816915827,MATH 20D,A03,083767,Staff,24,0,30,6
1650816921853,MATH 20E,A01,083771,Staff,2,0,30,28
1650816921853,MATH 20E,A02,083772,Staff,15,0,30,15
1650816921853,MATH 20E,B01,083773,Staff,0,0,30,30
1650816921853,MATH 20E,B02,083774,Staff,5,0,30,25
1650816927881,MATH 103A,A01,083777,Staff,0,16,30,30
1650816927881,MATH 103A,A02,083778,Staff,0,15,30,30
1650816927881,MATH 103A,B01,083779,Staff,0,15,30,30
1650816927881,MATH 103A,B02,083780,Staff,0,15,30,30
1650816933904,MATH 105,A01,085443,Staff,0,22,30,30
1650816939928,MATH 109,A01,083213,Anzaldo; Leesa B,0,7,30,30
1650816939928,MATH 109,A02,083214,Anzaldo; Leesa B,0,7,30,30
1650816939928,MATH 109,B01,083215,Anzaldo; Leesa B,0,8,30,30
1650816939928,MATH 109,B02,083216,Anzaldo; Leesa B,0,7,30,30
1650816945952,MATH 142A,A01,083219,Chow; Bennett,0,16,30,30
1650816945952,MATH 142A,A02,083220,Chow; Bennett,0,15,30,30
1650816945952,MATH 142A,B01,083221,Chow; Bennett,0,16,30,30
1650816945952,MATH 142A,B02,083222,Chow; Bennett,0,14,30,30
1650816951979,MATH 193A,A01,083224,Staff,0,6,30,30
1650816951979,MATH 193A,A02,083225,Staff,0,6,30,30
1650816951979,MATH 193A,A03,083781,Staff,0,6,30,30
1650816951979,MATH 193A,A04,083782,Staff,0,7,30,30
1650816958006,MATH 197,001,091859,McAuley; Julian John,9998,0,9999,1
1650816964057,COGS 9,A01,083615,Staff,0,17,60,60
1650816970081,COGS 11,A01,083617,Boyle; Mary E. T.,16,0,40,24
1650816976110,COGS 13,A01,083071,Staff,0,38,40,40
1650816982134,COGS 14A,A01,092681,Staff,0,36,100,100
1650816988161,COGS 14B,A01,083073,Cheng; Tzu-Han,0,12,50,50
1650816994185,COGS 17,A01,092677,Staff,11,0,75,64
1650817000209,COGS 100,A01,083619,Staff,0,29,60,60
1650817006235,COGS 101A,A01,083621,Davis; Joshua Daniel,0,28,60,60
1650817012259,COGS 101B,A01,091572,Staff,0,3,60,60
1650817018284,COGS 101C,A01,083625,Delgado; Tania,14,0,30,16
1650817024308,COGS 107A,A01,083627,Boyle; Mary E. T.,0,16,60,60
1650817030332,COGS 118A,A01,083075,Staff,0,8,60,60
1650817036364,CSE 3,A50,083646,Miranda; Gregory Joseph,18,0,38,20
1650817036364,CSE 3,A51,083647,Miranda; Gregory Joseph,36,0,37,1
1650817042388,CSE 8A,A50,083650,Miranda; Gregory Joseph,0,29,40,40
1650817048415,CSE 11,A01,083080,Cao; Yingjun,0,96,40,40
1650817054451,CSE 12,A01,083652,Staff,0,21,100,100
1650817060489,CSE 15L,A01,083654,Staff,0,3,50,50
1650817060489,CSE 15L,A02,083655,Staff,0,2,50,50
1650817066516,CSE 20,A01,083657,Staff,49,0,80,31
1650817072540,CSE 30,A01,083084,Eldon; John,0,75,40,40
1650817078564,CSE 100,A01,083659,Cao; Yingjun,0,71,50,50
1650817084592,CSE 134B,A01,083661,Powell; Thomas Allan,0,38,65,65
1650817090615,CSE 140,A01,083663,Staff,0,11,75,75
1650817096640,CSE 140L,A01,083088,Eldon; John,0,20,75,75
1650817102665,CSE 175,A01,083665,Kumar; Rakesh,7,0,25,18
1650817108689,CSE 190,A00,092507,Dubnov; Shlomo,10,0,20,10
1650817114717,ECE 45,A01,083139,Staff,0,1,60,60
1650817120743,ECE 65,A50,083695,Staff,0,5,30,30
1650817126765,ECE 109,A01,091882,Touri; Behrouz,32,0,70,38
1650817132789,ECE 180,A00,083140,Abi Samra; Nicholas Camill,20,0,30,10
1650817132789,ECE 180,B00,083141,Abi Samra; Nicholas Camill,0,0,30,30
1650817138816,MATH 10A,A01,083735,Patchell; Gregory David,2,0,30,28
1650817138816,MATH 10A,A02,083736,Patchell; Gregory David,27,0,30,3
1650817138816,MATH 10A,A03,083737,Patchell; Gregory David,24,0,30,6
1650817144839,MATH 10B,A01,083207,Staff,0,9,30,30
1650817144839,MATH 10B,A02,083208,Staff,0,6,30,30
1650817144839,MATH 10B,B01,083739,Staff,11,0,30,19
1650817144839,MATH 10B,B02,083740,Staff,28,0,30,2
1650817150868,MATH 18,A01,083743,Staff,0,0,30,30
1650817150868,MATH 18,A02,083744,Staff,23,0,30,7
1650817150868,MATH 18,A03,083745,Staff,21,0,30,9
1650817150868,MATH 18,A04,083746,Staff,26,0,30,4
1650817150868,MATH 18,B01,083748,Staff,0,15,30,30
1650817150868,MATH 18,B02,083749,Staff,0,12,30,30
1650817150868,MATH 18,B03,083750,Staff,0,12,30,30
1650817150868,MATH 18,B04,083751,Staff,0,12,30,30
1650817156890,MATH 20A,A01,083754,Staff,19,0,40,21
1650817162927,MATH 20B,A01,083756,Staff,0,13,30,30
1650817162927,MATH 20B,A02,083757,Staff,0,12,30,30
1650817168953,MATH 20C,A01,083760,Staff,0,17,30,30
1650817168953,MATH 20C,A02,083761,Staff,0,16,30,30
1650817168953,MATH 20C,B01,083762,Staff,9,0,30,21
1650817168953,MATH 20C,B02,083763,Staff,28,0,30,2
1650817174979,MATH 20D,A01,083765,Staff,2,1,30,28
1650817174979,MATH 20D,A02,083766,Staff,6,0,30,24
1650817174979,MATH 20D,A03,083767,Staff,24,0,30,6
1650817181004,MATH 20E,A01,083771,Staff,2,0,30,28
1650817181004,MATH 20E,A02,083772,Staff,15,0,30,15
1650817181004,MATH 20E,B01,083773,Staff,0,0,30,30
1650817181004,MATH 20E,B02,083774,Staff,5,0,30,25
1650817187029,MATH 103A,A01,083777,Staff,0,16,30,30
1650817187029,MATH 103A,A02,083778,Staff,0,15,30,30
1650817187029,MATH 103A,B01,083779,Staff,0,15,30,30
1650817187029,MATH 103A,B02,083780,Staff,0,15,30,30
1650817193053,MATH 105,A01,085443,Staff,0,22,30,30
1650817199078,MATH 109,A01,083213,Anzaldo; Leesa B,0,7,30,30
1650817199078,MATH 109,A02,083214,Anzaldo; Leesa B,0,7,30,30
1650817199078,MATH 109,B01,083215,Anzaldo; Leesa B,0,8,30,30
1650817199078,MATH 109,B02,083216,Anzaldo; Leesa B,0,7,30,30
1650817205102,MATH 142A,A01,083219,Chow; Bennett,0,16,30,30
1650817205102,MATH 142A,A02,083220,Chow; Bennett,0,15,30,30
1650817205102,MATH 142A,B01,083221,Chow; Bennett,0,16,30,30
1650817205102,MATH 142A,B02,083222,Chow; Bennett,0,14,30,30
1650817211126,MATH 193A,A01,083224,Staff,0,6,30,30
1650817211126,MATH 193A,A02,083225,Staff,0,6,30,30
1650817211126,MATH 193A,A03,083781,Staff,0,6,30,30
1650817211126,MATH 193A,A04,083782,Staff,0,7,30,30
1650817217150,MATH 197,001,091859,McAuley; Julian John,9998,0,9999,1
1650817223210,COGS 9,A01,083615,Staff,0,17,60,60
1650817229235,COGS 11,A01,083617,Boyle; Mary E. T.,16,0,40,24
1650817235267,COGS 13,A01,083071,Staff,0,38,40,40
1650817241382,COGS 14A,A01,092681,Staff,0,36,100,100
1650817247418,COGS 14B,A01,083073,Cheng; Tzu-Han,0,12,50,50
1650817253444,COGS 17,A01,092677,Staff,11,0,75,64
1650817259474,COGS 100,A01,083619,Staff,0,29,60,60
1650817265499,COGS 101A,A01,083621,Davis; Joshua Daniel,0,28,60,60
1650817271524,COGS 101B,A01,091572,Staff,0,3,60,60
1650817277547,COGS 101C,A01,083625,Delgado; Tania,14,0,30,16
1650817283574,COGS 107A,A01,083627,Boyle; Mary E. T.,0,16,60,60
1650817289606,COGS 118A,A01,083075,Staff,0,8,60,60
1650817295629,CSE 3,A50,083646,Miranda; Gregory Joseph,18,0,38,20
1650817295629,CSE 3,A51,083647,Miranda; Gregory Joseph,36,0,37,1
1650817301663,CSE 8A,A50,083650,Miranda; Gregory Joseph,0,29,40,40
1650817307705,CSE 11,A01,083080,Cao; Yingjun,0,96,40,40
1650817313727,CSE 12,A01,083652,Staff,0,21,100,100
1650817319761,CSE 15L,A01,083654,Staff,0,3,50,50
1650817319761,CSE 15L,A02,083655,Staff,0,2,50,50
1650817325788,CSE 20,A01,083657,Staff,49,0,80,31
1650817331812,CSE 30,A01,083084,Eldon; John,0,75,40,40
1650817337839,CSE 100,A01,083659,Cao; Yingjun,0,71,50,50
1650817343867,CSE 134B,A01,083661,Powell; Thomas Allan,0,38,65,65
1650817349891,CSE 140,A01,083663,Staff,0,11,75,75
1650817355919,CSE 140L,A01,083088,Eldon; John,0,20,75,75
1650817361942,CSE 175,A01,083665,Kumar; Rakesh,7,0,25,18
1650817367967,CSE 190,A00,092507,Dubnov; Shlomo,10,0,20,10
1650817373997,ECE 45,A01,083139,Staff,0,1,60,60
1650817380020,ECE 65,A50,083695,Staff,0,5,30,30
1650817386045,ECE 109,A01,091882,Touri; Behrouz,32,0,70,38
1650817392069,ECE 180,A00,083140,Abi Samra; Nicholas Camill,20,0,30,10
1650817392069,ECE 180,B00,083141,Abi Samra; Nicholas Camill,0,0,30,30
1650817398091,MATH 10A,A01,083735,Patchell; Gregory David,2,0,30,28
1650817398091,MATH 10A,A02,083736,Patchell; Gregory David,27,0,30,3
1650817398091,MATH 10A,A03,083737,Patchell; Gregory David,24,0,30,6
1650817404118,MATH 10B,A01,083207,Staff,0,9,30,30
1650817404118,MATH 10B,A02,083208,Staff,0,6,30,30
1650817404118,MATH 10B,B01,083739,Staff,11,0,30,19
1650817404118,MATH 10B,B02,083740,Staff,28,0,30,2
1650817410147,MATH 18,A01,083743,Staff,0,0,30,30
1650817410147,MATH 18,A02,083744,Staff,23,0,30,7
1650817410147,MATH 18,A03,083745,Staff,21,0,30,9
1650817410147,MATH 18,A04,083746,Staff,26,0,30,4
1650817410147,MATH 18,B01,083748,Staff,0,15,30,30
1650817410147,MATH 18,B02,083749,Staff,0,12,30,30
1650817410147,MATH 18,B03,083750,Staff,0,12,30,30
1650817410147,MATH 18,B04,083751,Staff,0,12,30,30
1650817416170,MATH 20A,A01,083754,Staff,19,0,40,21
1650817422193,MATH 20B,A01,083756,Staff,0,13,30,30
1650817422193,MATH 20B,A02,083757,Staff,0,12,30,30
1650817428221,MATH 20C,A01,083760,Staff,0,17,30,30
1650817428221,MATH 20C,A02,083761,Staff,0,16,30,30
1650817428221,MATH 20C,B01,083762,Staff,9,0,30,21
1650817428221,MATH 20C,B02,083763,Staff,28,0,30,2
1650817434249,MATH 20D,A01,083765,Staff,2,1,30,28
1650817434249,MATH 20D,A02,083766,Staff,6,0,30,24
1650817434249,MATH 20D,A03,083767,Staff,24,0,30,6
1650817440276,MATH 20E,A01,083771,Staff,2,0,30,28
1650817440276,MATH 20E,A02,083772,Staff,15,0,30,15
1650817440276,MATH 20E,B01,083773,Staff,0,0,30,30
1650817440276,MATH 20E,B02,083774,Staff,5,0,30,25
1650817446300,MATH 103A,A01,083777,Staff,0,16,30,30
1650817446300,MATH 103A,A02,083778,Staff,0,15,30,30
1650817446300,MATH 103A,B01,083779,Staff,0,15,30,30
1650817446300,MATH 103A,B02,083780,Staff,0,15,30,30
1650817452327,MATH 105,A01,085443,Staff,0,22,30,30
1650817458352,MATH 109,A01,083213,Anzaldo; Leesa B,0,7,30,30
1650817458352,MATH 109,A02,083214,Anzaldo; Leesa B,0,7,30,30
1650817458352,MATH 109,B01,083215,Anzaldo; Leesa B,0,8,30,30
1650817458352,MATH 109,B02,083216,Anzaldo; Leesa B,0,7,30,30
1650817464373,MATH 142A,A01,083219,Chow; Bennett,0,16,30,30
1650817464373,MATH 142A,A02,083220,Chow; Bennett,0,15,30,30
1650817464373,MATH 142A,B01,083221,Chow; Bennett,0,16,30,30
1650817464373,MATH 142A,B02,083222,Chow; Bennett,0,14,30,30
1650817470398,MATH 193A,A01,083224,Staff,0,6,30,30
1650817470398,MATH 193A,A02,083225,Staff,0,6,30,30
1650817470398,MATH 193A,A03,083781,Staff,0,6,30,30
1650817470398,MATH 193A,A04,083782,Staff,0,7,30,30
1650817476425,MATH 197,001,091859,McAuley; Julian John,9998,0,9999,1
1650817482488,COGS 9,A01,083615,Staff,0,17,60,60
1650817488525,COGS 11,A01,083617,Boyle; Mary E. T.,16,0,40,24
1650817494560,COGS 13,A01,083071,Staff,0,38,40,40
1650817500591,COGS 14A,A01,092681,Staff,0,36,100,100
1650817506620,COGS 14B,A01,083073,Cheng; Tzu-Han,0,12,50,50
1650817512644,COGS 17,A01,092677,Staff,11,0,75,64
1650817518669,COGS 100,A01,083619,Staff,0,29,60,60
1650817524693,COGS 101A,A01,083621,Davis; Joshua Daniel,0,28,60,60
1650817530725,COGS 101B,A01,091572,Staff,0,3,60,60
1650817536748,COGS 101C,A01,083625,Delgado; Tania,14,0,30,16
1650817542773,COGS 107A,A01,083627,Boyle; Mary E. T.,0,16,60,60
1650817548796,COGS 118A,A01,083075,Staff,0,8,60,60
1650817554821,CSE 3,A50,083646,Miranda; Gregory Joseph,18,0,38,20
1650817554821,CSE 3,A51,083647,Miranda; Gregory Joseph,36,0,37,1
1650817560849,CSE 8A,A50,083650,Miranda; Gregory Joseph,0,29,40,40
1650817566877,CSE 11,A01,083080,Cao; Yingjun,0,96,40,40
1650817572907,CSE 12,A01,083652,Staff,0,21,100,100
1650817578931,CSE 15L,A01,083654,Staff,0,3,50,50
1650817578931,CSE 15L,A02,083655,Staff,0,2,50,50
1650817584955,CSE 20,A01,083657,Staff,49,0,80,31
1650817590979,CSE 30,A01,083084,Eldon; John,0,75,40,40
1650817597002,CSE 100,A01,083659,Cao; Yingjun,0,71,50,50
1650817603030,CSE 134B,A01,083661,Powell; Thomas Allan,0,38,65,65
1650817609059,CSE 140,A01,083663,Staff,0,11,75,75
1650817615092,CSE 140L,A01,083088,Eldon; John,0,20,75,75
1650817621116,CSE 175,A01,083665,Kumar; Rakesh,7,0,25,18
1650817627137,CSE 190,A00,092507,Dubnov; Shlomo,10,0,20,10
1650817633163,ECE 45,A01,083139,Staff,0,1,60,60
1650817639195,ECE 65,A50,083695,Staff,0,5,30,30
1650817645220,ECE 109,A01,091882,Touri; Behrouz,32,0,70,38
1650817651245,ECE 180,A00,083140,Abi Samra; Nicholas Camill,20,0,30,10
1650817651245,ECE 180,B00,083141,Abi Samra; Nicholas Camill,0,0,30,30
1650817657269,MATH 10A,A01,083735,Patchell; Gregory David,2,0,30,28
1650817657269,MATH 10A,A02,083736,Patchell; Gregory David,27,0,30,3
1650817657269,MATH 10A,A03,083737,Patchell; Gregory David,24,0,30,6
1650817663296,MATH 10B,A01,083207,Staff,0,9,30,30
1650817663296,MATH 10B,A02,083208,Staff,0,6,30,30
1650817663296,MATH 10B,B01,083739,Staff,11,0,30,19
1650817663296,MATH 10B,B02,083740,Staff,28,0,30,2
1650817669321,MATH 18,A01,083743,Staff,0,0,30,30
1650817669321,MATH 18,A02,083744,Staff,23,0,30,7
1650817669321,MATH 18,A03,083745,Staff,21,0,30,9
1650817669321,MATH 18,A04,083746,Staff,26,0,30,4
1650817669321,MATH 18,B01,083748,Staff,0,15,30,30
1650817669321,MATH 18,B02,083749,Staff,0,12,30,30
1650817669321,MATH 18,B03,083750,Staff,0,12,30,30
1650817669321,MATH 18,B04,083751,Staff,0,12,30,30
1650817675356,MATH 20A,A01,083754,Staff,19,0,40,21
1650817681382,MATH 20B,A01,083756,Staff,0,13,30,30
1650817681382,MATH 20B,A02,083757,Staff,0,12,30,30
1650817687406,MATH 20C,A01,083760,Staff,0,17,30,30
1650817687406,MATH 20C,A02,083761,Staff,0,16,30,30
1650817687406,MATH 20C,B01,083762,Staff,9,0,30,21
1650817687406,MATH 20C,B02,083763,Staff,28,0,30,2
1650817693433,MATH 20D,A01,083765,Staff,2,1,30,28
1650817693433,MATH 20D,A02,083766,Staff,6,0,30,24
1650817693433,MATH 20D,A03,083767,Staff,24,0,30,6
1650817699460,MATH 20E,A01,083771,Staff,2,0,30,28
1650817699460,MATH 20E,A02,083772,Staff,15,0,30,15
1650817699460,MATH 20E,B01,083773,Staff,0,0,30,30
1650817699460,MATH 20E,B02,083774,Staff,5,0,30,25
1650817705485,MATH 103A,A01,083777,Staff,0,16,30,30
1650817705485,MATH 103A,A02,083778,Staff,0,15,30,30
1650817705485,MATH 103A,B01,083779,Staff,0,15,30,30
1650817705485,MATH 103A,B02,083780,Staff,0,15,30,30
1650817711509,MATH 105,A01,085443,Staff,0,22,30,30
1650817717541,MATH 109,A01,083213,Anzaldo; Leesa B,0,7,30,30
1650817717541,MATH 109,A02,083214,Anzaldo; Leesa B,0,7,30,30
1650817717541,MATH 109,B01,083215,Anzaldo; Leesa B,0,8,30,30
1650817717541,MATH 109,B02,083216,Anzaldo; Leesa B,0,7,30,30
1650817723569,MATH 142A,A01,083219,Chow; Bennett,0,16,30,30
1650817723569,MATH 142A,A02,083220,Chow; Bennett,0,15,30,30
1650817723569,MATH 142A,B01,083221,Chow; Bennett,0,16,30,30
1650817723569,MATH 142A,B02,083222,Chow; Bennett,0,14,30,30
1650817729601,MATH 193A,A01,083224,Staff,0,6,30,30
1650817729601,MATH 193A,A02,083225,Staff,0,6,30,30
1650817729601,MATH 193A,A03,083781,Staff,0,6,30,30
1650817729601,MATH 193A,A04,083782,Staff,0,7,30,30
1650817735637,MATH 197,001,091859,McAuley; Julian John,9998,0,9999,1
1650817741722,COGS 9,A01,083615,Staff,0,17,60,60
1650817747767,COGS 11,A01,083617,Boyle; Mary E. T.,16,0,40,24
1650817753797,COGS 13,A01,083071,Staff,0,38,40,40
1650817759824,COGS 14A,A01,092681,Staff,0,36,100,100
1650817765847,COGS 14B,A01,083073,Cheng; Tzu-Han,0,12,50,50
1650817771872,COGS 17,A01,092677,Staff,11,0,75,64
1650817777897,COGS 100,A01,083619,Staff,0,29,60,60
1650817783924,COGS 101A,A01,083621,Davis; Joshua Daniel,0,28,60,60
1650817789949,COGS 101B,A01,091572,Staff,0,3,60,60
1650817795972,COGS 101C,A01,083625,Delgado; Tania,14,0,30,16
1650817801998,COGS 107A,A01,083627,Boyle; Mary E. T.,0,16,60,60
1650817808026,COGS 118A,A01,083075,Staff,0,8,60,60
1650817814051,CSE 3,A50,083646,Miranda; Gregory Joseph,18,0,38,20
1650817814051,CSE 3,A51,083647,Miranda; Gregory Joseph,36,0,37,1
1650817820076,CSE 8A,A50,083650,Miranda; Gregory Joseph,0,29,40,40
1650817826101,CSE 11,A01,083080,Cao; Yingjun,0,96,40,40
1650817832128,CSE 12,A01,083652,Staff,0,21,100,100
1650817838241,CSE 15L,A01,083654,Staff,0,3,50,50
1650817838241,CSE 15L,A02,083655,Staff,0,2,50,50
1650817844268,CSE 20,A01,083657,Staff,49,0,80,31
1650817850292,CSE 30,A01,083084,Eldon; John,0,75,40,40
1650817856320,CSE 100,A01,083659,Cao; Yingjun,0,71,50,50
1650817862344,CSE 134B,A01,083661,Powell; Thomas Allan,0,38,65,65
1650817868367,CSE 140,A01,083663,Staff,0,11,75,75
1650817874393,CSE 140L,A01,083088,Eldon; John,0,20,75,75
1650817880416,CSE 175,A01,083665,Kumar; Rakesh,7,0,25,18
1650817886443,CSE 190,A00,092507,Dubnov; Shlomo,10,0,20,10
1650817892471,ECE 45,A01,083139,Staff,0,1,60,60
1650817898494,ECE 65,A50,083695,Staff,0,5,30,30
1650817904517,ECE 109,A01,091882,Touri; Behrouz,32,0,70,38
1650817910543,ECE 180,A00,083140,Abi Samra; Nicholas Camill,20,0,30,10
1650817910543,ECE 180,B00,083141,Abi Samra; Nicholas Camill,0,0,30,30
1650817916566,MATH 10A,A01,083735,Patchell; Gregory David,2,0,30,28
1650817916566,MATH 10A,A02,083736,Patchell; Gregory David,27,0,30,3
1650817916566,MATH 10A,A03,083737,Patchell; Gregory David,24,0,30,6
1650817922593,MATH 10B,A01,083207,Staff,0,9,30,30
1650817922593,MATH 10B,A02,083208,Staff,0,6,30,30
1650817922593,MATH 10B,B01,083739,Staff,11,0,30,19
1650817922593,MATH 10B,B02,083740,Staff,28,0,30,2
1650817928617,MATH 18,A01,083743,Staff,0,0,30,30
1650817928617,MATH 18,A02,083744,Staff,23,0,30,7
1650817928617,MATH 18,A03,083745,Staff,21,0,30,9
1650817928617,MATH 18,A04,083746,Staff,26,0,30,4
1650817928617,MATH 18,B01,083748,Staff,0,15,30,30
1650817928617,MATH 18,B02,083749,Staff,0,12,30,30
1650817928617,MATH 18,B03,083750,Staff,0,12,30,30
1650817928617,MATH 18,B04,083751,Staff,0,12,30,30
1650817934641,MATH 20A,A01,083754,Staff,19,0,40,21
1650817940678,MATH 20B,A01,083756,Staff,0,13,30,30
1650817940678,MATH 20B,A02,083757,Staff,0,12,30,30
1650817946702,MATH 20C,A01,083760,Staff,0,17,30,30
1650817946702,MATH 20C,A02,083761,Staff,0,16,30,30
1650817946702,MATH 20C,B01,083762,Staff,9,0,30,21
1650817946702,MATH 20C,B02,083763,Staff,28,0,30,2
1650817952723,MATH 20D,A01,083765,Staff,2,1,30,28
1650817952723,MATH 20D,A02,083766,Staff,6,0,30,24
1650817952723,MATH 20D,A03,083767,Staff,24,0,30,6
1650817958748,MATH 20E,A01,083771,Staff,2,0,30,28
1650817958748,MATH 20E,A02,083772,Staff,15,0,30,15
1650817958748,MATH 20E,B01,083773,Staff,0,0,30,30
1650817958748,MATH 20E,B02,083774,Staff,5,0,30,25
1650817964777,MATH 103A,A01,083777,Staff,0,16,30,30
1650817964777,MATH 103A,A02,083778,Staff,0,15,30,30
1650817964777,MATH 103A,B01,083779,Staff,0,15,30,30
1650817964777,MATH 103A,B02,083780,Staff,0,15,30,30
1650817970805,MATH 105,A01,085443,Staff,0,22,30,30
1650817976834,MATH 109,A01,083213,Anzaldo; Leesa B,0,7,30,30
1650817976834,MATH 109,A02,083214,Anzaldo; Leesa B,0,7,30,30
1650817976834,MATH 109,B01,083215,Anzaldo; Leesa B,0,8,30,30
1650817976834,MATH 109,B02,083216,Anzaldo; Leesa B,0,7,30,30
1650817982867,MATH 142A,A01,083219,Chow; Bennett,0,16,30,30
1650817982867,MATH 142A,A02,083220,Chow; Bennett,0,15,30,30
1650817982867,MATH 142A,B01,083221,Chow; Bennett,0,16,30,30
1650817982867,MATH 142A,B02,083222,Chow; Bennett,0,14,30,30
1650817988893,MATH 193A,A01,083224,Staff,0,6,30,30
1650817988893,MATH 193A,A02,083225,Staff,0,6,30,30
1650817988893,MATH 193A,A03,083781,Staff,0,6,30,30
1650817988893,MATH 193A,A04,083782,Staff,0,7,30,30
1650817994918,MATH 197,001,091859,McAuley; Julian John,9998,0,9999,1
1650818000973,COGS 9,A01,083615,Staff,0,17,60,60
1650818006999,COGS 11,A01,083617,Boyle; Mary E. T.,16,0,40,24
1650818013024,COGS 13,A01,083071,Staff,0,38,40,40
1650818019050,COGS 14A,A01,092681,Staff,0,36,100,100
1650818025084,COGS 14B,A01,083073,Cheng; Tzu-Han,0,12,50,50
1650818031111,COGS 17,A01,092677,Staff,11,0,75,64
1650818037136,COGS 100,A01,083619,Staff,0,29,60,60
1650818043164,COGS 101A,A01,083621,Davis; Joshua Daniel,0,28,60,60
1650818049187,COGS 101B,A01,091572,Staff,0,3,60,60
1650818055211,COGS 101C,A01,083625,Delgado; Tania,14,0,30,16
1650818061235,COGS 107A,A01,083627,Boyle; Mary E. T.,0,16,60,60
1650818067261,COGS 118A,A01,083075,Staff,0,8,60,60
1650818073285,CSE 3,A50,083646,Miranda; Gregory Joseph,18,0,38,20
1650818073285,CSE 3,A51,083647,Miranda; Gregory Joseph,36,0,37,1
1650818079315,CSE 8A,A50,083650,Miranda; Gregory Joseph,0,29,40,40
1650818085342,CSE 11,A01,083080,Cao; Yingjun,0,96,40,40
1650818091366,CSE 12,A01,083652,Staff,0,21,100,100
1650818097393,CSE 15L,A01,083654,Staff,0,3,50,50
1650818097393,CSE 15L,A02,083655,Staff,0,2,50,50
1650818103426,CSE 20,A01,083657,Staff,49,0,80,31
1650818109449,CSE 30,A01,083084,Eldon; John,0,75,40,40
1650818115475,CSE 100,A01,083659,Cao; Yingjun,0,71,50,50
1650818121499,CSE 134B,A01,083661,Powell; Thomas Allan,0,38,65,65
1650818127522,CSE 140,A01,083663,Staff,0,11,75,75
1650818133549,CSE 140L,A01,083088,Eldon; John,0,20,75,75
1650818139571,CSE 175,A01,083665,Kumar; Rakesh,7,0,25,18
1650818145605,CSE 190,A00,092507,Dubnov; Shlomo,10,0,20,10
1650818151631,ECE 45,A01,083139,Staff,0,1,60,60
1650818157655,ECE 65,A50,083695,Staff,0,5,30,30
1650818163679,ECE 109,A01,091882,Touri; Behrouz,32,0,70,38
1650818169706,ECE 180,A00,083140,Abi Samra; Nicholas Camill,20,0,30,10
1650818169706,ECE 180,B00,083141,Abi Samra; Nicholas Camill,0,0,30,30
1650818175737,MATH 10A,A01,083735,Patchell; Gregory David,2,0,30,28
1650818175737,MATH 10A,A02,083736,Patchell; Gregory David,27,0,30,3
1650818175737,MATH 10A,A03,083737,Patchell; Gregory David,24,0,30,6
1650818181770,MATH 10B,A01,083207,Staff,0,9,30,30
1650818181770,MATH 10B,A02,083208,Staff,0,6,30,30
1650818181770,MATH 10B,B01,083739,Staff,11,0,30,19
1650818181770,MATH 10B,B02,083740,Staff,28,0,30,2
1650818187800,MATH 18,A01,083743,Staff,0,0,30,30
1650818187800,MATH 18,A02,083744,Staff,23,0,30,7
1650818187800,MATH 18,A03,083745,Staff,21,0,30,9
1650818187800,MATH 18,A04,083746,Staff,26,0,30,4
1650818187800,MATH 18,B01,083748,Staff,0,15,30,30
1650818187800,MATH 18,B02,083749,Staff,0,12,30,30
1650818187800,MATH 18,B03,083750,Staff,0,12,30,30
1650818187800,MATH 18,B04,083751,Staff,0,12,30,30
1650818193821,MATH 20A,A01,083754,Staff,19,0,40,21
1650818199848,MATH 20B,A01,083756,Staff,0,13,30,30
1650818199848,MATH 20B,A02,083757,Staff,0,12,30,30
1650818205876,MATH 20C,A01,083760,Staff,0,17,30,30
1650818205876,MATH 20C,A02,083761,Staff,0,16,30,30
1650818205876,MATH 20C,B01,083762,Staff,9,0,30,21
1650818205876,MATH 20C,B02,083763,Staff,28,0,30,2
1650818211900,MATH 20D,A01,083765,Staff,2,1,30,28
1650818211900,MATH 20D,A02,083766,Staff,6,0,30,24
1650818211900,MATH 20D,A03,083767,Staff,24,0,30,6
1650818217923,MATH 20E,A01,083771,Staff,2,0,30,28
1650818217923,MATH 20E,A02,083772,Staff,15,0,30,15
1650818217923,MATH 20E,B01,083773,Staff,0,0,30,30
1650818217923,MATH 20E,B02,083774,Staff,5,0,30,25
1650818223946,MATH 103A,A01,083777,Staff,0,16,30,30
1650818223946,MATH 103A,A02,083778,Staff,0,15,30,30
1650818223946,MATH 103A,B01,083779,Staff,0,15,30,30
1650818223946,MATH 103A,B02,083780,Staff,0,15,30,30
1650818229972,MATH 105,A01,085443,Staff,0,22,30,30
1650818235999,MATH 109,A01,083213,Anzaldo; Leesa B,0,7,30,30
1650818235999,MATH 109,A02,083214,Anzaldo; Leesa B,0,7,30,30
1650818235999,MATH 109,B01,083215,Anzaldo; Leesa B,0,8,30,30
1650818235999,MATH 109,B02,083216,Anzaldo; Leesa B,0,7,30,30
1650818242031,MATH 142A,A01,083219,Chow; Bennett,0,16,30,30
1650818242031,MATH 142A,A02,083220,Chow; Bennett,0,15,30,30
1650818242031,MATH 142A,B01,083221,Chow; Bennett,0,16,30,30
1650818242031,MATH 142A,B02,083222,Chow; Bennett,0,14,30,30
1650818248057,MATH 193A,A01,083224,Staff,0,6,30,30
1650818248057,MATH 193A,A02,083225,Staff,0,6,30,30
1650818248057,MATH 193A,A03,083781,Staff,0,6,30,30
1650818248057,MATH 193A,A04,083782,Staff,0,7,30,30
1650818254083,MATH 197,001,091859,McAuley; Julian John,9998,0,9999,1
1650818260137,COGS 9,A01,083615,Staff,0,17,60,60
1650818266161,COGS 11,A01,083617,Boyle; Mary E. T.,16,0,40,24
1650818272187,COGS 13,A01,083071,Staff,0,38,40,40
1650818278213,COGS 14A,A01,092681,Staff,0,36,100,100
1650818284240,COGS 14B,A01,083073,Cheng; Tzu-Han,0,12,50,50
1650818290264,COGS 17,A01,092677,Staff,11,0,75,64
1650818296288,COGS 100,A01,083619,Staff,0,29,60,60
1650818302311,COGS 101A,A01,083621,Davis; Joshua Daniel,0,28,60,60
1650818308341,COGS 101B,A01,091572,Staff,0,3,60,60
1650818314376,COGS 101C,A01,083625,Delgado; Tania,14,0,30,16
1650818320403,COGS 107A,A01,083627,Boyle; Mary E. T.,0,16,60,60
1650818326431,COGS 118A,A01,083075,Staff,0,8,60,60
1650818332463,CSE 3,A50,083646,Miranda; Gregory Joseph,18,0,38,20
1650818332463,CSE 3,A51,083647,Miranda; Gregory Joseph,36,0,37,1
1650818338487,CSE 8A,A50,083650,Miranda; Gregory Joseph,0,29,40,40
1650818344513,CSE 11,A01,083080,Cao; Yingjun,0,96,40,40
1650818350537,CSE 12,A01,083652,Staff,0,21,100,100
1650818356561,CSE 15L,A01,083654,Staff,0,3,50,50
1650818356561,CSE 15L,A02,083655,Staff,0,2,50,50
1650818362586,CSE 20,A01,083657,Staff,49,0,80,31
1650818368610,CSE 30,A01,083084,Eldon; John,0,75,40,40
1650818374634,CSE 100,A01,083659,Cao; Yingjun,0,71,50,50
1650818380661,CSE 134B,A01,083661,Powell; Thomas Allan,0,38,65,65
1650818386688,CSE 140,A01,083663,Staff,0,11,75,75
1650818392716,CSE 140L,A01,083088,Eldon; John,0,20,75,75
1650818398753,CSE 175,A01,083665,Kumar; Rakesh,7,0,25,18
1650818404783,CSE 190,A00,092507,Dubnov; Shlomo,10,0,20,10
1650818410811,ECE 45,A01,083139,Staff,0,1,60,60
1650818416835,ECE 65,A50,083695,Staff,0,5,30,30
1650818422863,ECE 109,A01,091882,Touri; Behrouz,32,0,70,38
1650818428887,ECE 180,A00,083140,Abi Samra; Nicholas Camill,20,0,30,10
1650818428887,ECE 180,B00,083141,Abi Samra; Nicholas Camill,0,0,30,30
1650818434986,MATH 10A,A01,083735,Patchell; Gregory David,2,0,30,28
1650818434986,MATH 10A,A02,083736,Patchell; Gregory David,27,0,30,3
1650818434986,MATH 10A,A03,083737,Patchell; Gregory David,24,0,30,6
1650818441011,MATH 10B,A01,083207,Staff,0,9,30,30
1650818441011,MATH 10B,A02,083208,Staff,0,6,30,30
1650818441011,MATH 10B,B01,083739,Staff,11,0,30,19
1650818441011,MATH 10B,B02,083740,Staff,28,0,30,2
1650818447035,MATH 18,A01,083743,Staff,0,0,30,30
1650818447035,MATH 18,A02,083744,Staff,23,0,30,7
1650818447035,MATH 18,A03,083745,Staff,21,0,30,9
1650818447035,MATH 18,A04,083746,Staff,26,0,30,4
1650818447035,MATH 18,B01,083748,Staff,0,15,30,30
1650818447035,MATH 18,B02,083749,Staff,0,12,30,30
1650818447035,MATH 18,B03,083750,Staff,0,12,30,30
1650818447035,MATH 18,B04,083751,Staff,0,12,30,30
1650818453073,MATH 20A,A01,083754,Staff,19,0,40,21
1650818459121,MATH 20B,A01,083756,Staff,0,13,30,30
1650818459121,MATH 20B,A02,083757,Staff,0,12,30,30
1650818465143,MATH 20C,A01,083760,Staff,0,17,30,30
1650818465143,MATH 20C,A02,083761,Staff,0,16,30,30
1650818465143,MATH 20C,B01,083762,Staff,9,0,30,21
1650818465143,MATH 20C,B02,083763,Staff,28,0,30,2
1650818471170,MATH 20D,A01,083765,Staff,2,1,30,28
1650818471170,MATH 20D,A02,083766,Staff,6,0,30,24
1650818471170,MATH 20D,A03,083767,Staff,24,0,30,6
1650818477197,MATH 20E,A01,083771,Staff,2,0,30,28
1650818477197,MATH 20E,A02,083772,Staff,15,0,30,15
1650818477197,MATH 20E,B01,083773,Staff,0,0,30,30
1650818477197,MATH 20E,B02,083774,Staff,5,0,30,25
1650818483226,MATH 103A,A01,083777,Staff,0,16,30,30
1650818483226,MATH 103A,A02,083778,Staff,0,15,30,30
1650818483226,MATH 103A,B01,083779,Staff,0,15,30,30
1650818483226,MATH 103A,B02,083780,Staff,0,15,30,30
1650818489258,MATH 105,A01,085443,Staff,0,22,30,30
1650818495291,MATH 109,A01,083213,Anzaldo; Leesa B,0,7,30,30
1650818495291,MATH 109,A02,083214,Anzaldo; Leesa B,0,7,30,30
1650818495291,MATH 109,B01,083215,Anzaldo; Leesa B,0,8,30,30
1650818495291,MATH 109,B02,083216,Anzaldo; Leesa B,0,7,30,30
1650818501319,MATH 142A,A01,083219,Chow; Bennett,0,16,30,30
1650818501319,MATH 142A,A02,083220,Chow; Bennett,0,15,30,30
1650818501319,MATH 142A,B01,083221,Chow; Bennett,0,16,30,30
1650818501319,MATH 142A,B02,083222,Chow; Bennett,0,14,30,30
1650818507355,MATH 193A,A01,083224,Staff,0,6,30,30
1650818507355,MATH 193A,A02,083225,Staff,0,6,30,30
1650818507355,MATH 193A,A03,083781,Staff,0,6,30,30
1650818507355,MATH 193A,A04,083782,Staff,0,7,30,30
1650818513380,MATH 197,001,091859,McAuley; Julian John,9998,0,9999,1
1650818519440,COGS 9,A01,083615,Staff,0,17,60,60
1650818525462,COGS 11,A01,083617,Boyle; Mary E. T.,16,0,40,24
1650818531487,COGS 13,A01,083071,Staff,0,38,40,40
1650818537512,COGS 14A,A01,092681,Staff,0,36,100,100
1650818543539,COGS 14B,A01,083073,Cheng; Tzu-Han,0,12,50,50
1650818549563,COGS 17,A01,092677,Staff,11,0,75,64
1650818555588,COGS 100,A01,083619,Staff,0,29,60,60
1650818561609,COGS 101A,A01,083621,Davis; Joshua Daniel,0,28,60,60
1650818567632,COGS 101B,A01,091572,Staff,0,3,60,60
1650818573655,COGS 101C,A01,083625,Delgado; Tania,14,0,30,16
1650818579676,COGS 107A,A01,083627,Boyle; Mary E. T.,0,16,60,60
1650818585698,COGS 118A,A01,083075,Staff,0,8,60,60
1650818591728,CSE 3,A50,083646,Miranda; Gregory Joseph,18,0,38,20
1650818591728,CSE 3,A51,083647,Miranda; Gregory Joseph,36,0,37,1
1650818597750,CSE 8A,A50,083650,Miranda; Gregory Joseph,0,29,40,40
1650818603774,CSE 11,A01,083080,Cao; Yingjun,0,96,40,40
1650818609797,CSE 12,A01,083652,Staff,0,21,100,100
1650818615821,CSE 15L,A01,083654,Staff,0,3,50,50
1650818615821,CSE 15L,A02,083655,Staff,0,2,50,50
1650818621844,CSE 20,A01,083657,Staff,49,0,80,31
1650818627891,CSE 30,A01,083084,Eldon; John,0,75,40,40
1650818633917,CSE 100,A01,083659,Cao; Yingjun,0,71,50,50
1650818639941,CSE 134B,A01,083661,Powell; Thomas Allan,0,38,65,65
1650818645967,CSE 140,A01,083663,Staff,0,11,75,75
1650818651991,CSE 140L,A01,083088,Eldon; John,0,20,75,75
1650818658014,CSE 175,A01,083665,Kumar; Rakesh,7,0,25,18
1650818664044,CSE 190,A00,092507,Dubnov; Shlomo,10,0,20,10
1650818670070,ECE 45,A01,083139,Staff,0,1,60,60
1650818676105,ECE 65,A50,083695,Staff,0,5,30,30
1650818682134,ECE 109,A01,091882,Touri; Behrouz,32,0,70,38
1650818688167,ECE 180,A00,083140,Abi Samra; Nicholas Camill,20,0,30,10
1650818688167,ECE 180,B00,083141,Abi Samra; Nicholas Camill,0,0,30,30
1650818694194,MATH 10A,A01,083735,Patchell; Gregory David,2,0,30,28
1650818694194,MATH 10A,A02,083736,Patchell; Gregory David,27,0,30,3
1650818694194,MATH 10A,A03,083737,Patchell; Gregory David,24,0,30,6
1650818700222,MATH 10B,A01,083207,Staff,0,9,30,30
1650818700222,MATH 10B,A02,083208,Staff,0,6,30,30
1650818700222,MATH 10B,B01,083739,Staff,11,0,30,19
1650818700222,MATH 10B,B02,083740,Staff,28,0,30,2
1650818706254,MATH 18,A01,083743,Staff,0,0,30,30
1650818706254,MATH 18,A02,083744,Staff,23,0,30,7
1650818706254,MATH 18,A03,083745,Staff,21,0,30,9
1650818706254,MATH 18,A04,083746,Staff,26,0,30,4
1650818706254,MATH 18,B01,083748,Staff,0,15,30,30
1650818706254,MATH 18,B02,083749,Staff,0,12,30,30
1650818706254,MATH 18,B03,083750,Staff,0,12,30,30
1650818706254,MATH 18,B04,083751,Staff,0,12,30,30
1650818712277,MATH 20A,A01,083754,Staff,19,0,40,21
1650818718299,MATH 20B,A01,083756,Staff,0,13,30,30
1650818718299,MATH 20B,A02,083757,Staff,0,12,30,30
1650818724324,MATH 20C,A01,083760,Staff,0,17,30,30
1650818724324,MATH 20C,A02,083761,Staff,0,16,30,30
1650818724324,MATH 20C,B01,083762,Staff,9,0,30,21
1650818724324,MATH 20C,B02,083763,Staff,28,0,30,2
1650818730352,MATH 20D,A01,083765,Staff,2,1,30,28
1650818730352,MATH 20D,A02,083766,Staff,6,0,30,24
1650818730352,MATH 20D,A03,083767,Staff,24,0,30,6
1650818736375,MATH 20E,A01,083771,Staff,2,0,30,28
1650818736375,MATH 20E,A02,083772,Staff,15,0,30,15
1650818736375,MATH 20E,B01,083773,Staff,0,0,30,30
1650818736375,MATH 20E,B02,083774,Staff,5,0,30,25
1650818742404,MATH 103A,A01,083777,Staff,0,16,30,30
1650818742404,MATH 103A,A02,083778,Staff,0,15,30,30
1650818742404,MATH 103A,B01,083779,Staff,0,15,30,30
1650818742404,MATH 103A,B02,083780,Staff,0,15,30,30
1650818748428,MATH 105,A01,085443,Staff,0,22,30,30
1650818754452,MATH 109,A01,083213,Anzaldo; Leesa B,0,7,30,30
1650818754452,MATH 109,A02,083214,Anzaldo; Leesa B,0,7,30,30
1650818754452,MATH 109,B01,083215,Anzaldo; Leesa B,0,8,30,30
1650818754452,MATH 109,B02,083216,Anzaldo; Leesa B,0,7,30,30
1650818760491,MATH 142A,A01,083219,Chow; Bennett,0,16,30,30
1650818760491,MATH 142A,A02,083220,Chow; Bennett,0,15,30,30
1650818760491,MATH 142A,B01,083221,Chow; Bennett,0,16,30,30
1650818760491,MATH 142A,B02,083222,Chow; Bennett,0,14,30,30
1650818766514,MATH 193A,A01,083224,Staff,0,6,30,30
1650818766514,MATH 193A,A02,083225,Staff,0,6,30,30
1650818766514,MATH 193A,A03,083781,Staff,0,6,30,30
1650818766514,MATH 193A,A04,083782,Staff,0,7,30,30
1650818772540,MATH 197,001,091859,McAuley; Julian John,9998,0,9999,1
1650818778592,COGS 9,A01,083615,Staff,0,17,60,60
1650818784616,COGS 11,A01,083617,Boyle; Mary E. T.,16,0,40,24
1650818790643,COGS 13,A01,083071,Staff,0,38,40,40
1650818796681,COGS 14A,A01,092681,Staff,0,36,100,100
1650818802704,COGS 14B,A01,083073,Cheng; Tzu-Han,0,12,50,50
1650818808726,COGS 17,A01,092677,Staff,11,0,75,64
1650818814764,COGS 100,A01,083619,Staff,0,29,60,60
1650818820785,COGS 101A,A01,083621,Davis; Joshua Daniel,0,28,60,60
1650818826807,COGS 101B,A01,091572,Staff,0,3,60,60
1650818832829,COGS 101C,A01,083625,Delgado; Tania,14,0,30,16
1650818838856,COGS 107A,A01,083627,Boyle; Mary E. T.,0,16,60,60
1650818844885,COGS 118A,A01,083075,Staff,0,8,60,60
1650818850910,CSE 3,A50,083646,Miranda; Gregory Joseph,18,0,38,20
1650818850910,CSE 3,A51,083647,Miranda; Gregory Joseph,36,0,37,1
1650818856940,CSE 8A,A50,083650,Miranda; Gregory Joseph,0,29,40,40
1650818862962,CSE 11,A01,083080,Cao; Yingjun,0,96,40,40
1650818868988,CSE 12,A01,083652,Staff,0,21,100,100
1650818875015,CSE 15L,A01,083654,Staff,0,3,50,50
1650818875015,CSE 15L,A02,083655,Staff,0,2,50,50
1650818881039,CSE 20,A01,083657,Staff,49,0,80,31
1650818887064,CSE 30,A01,083084,Eldon; John,0,75,40,40
1650818893091,CSE 100,A01,083659,Cao; Yingjun,0,71,50,50
1650818899120,CSE 134B,A01,083661,Powell; Thomas Allan,0,38,65,65
1650818905149,CSE 140,A01,083663,Staff,0,11,75,75
1650818911173,CSE 140L,A01,083088,Eldon; John,0,20,75,75
1650818917197,CSE 175,A01,083665,Kumar; Rakesh,7,0,25,18
1650818923225,CSE 190,A00,092507,Dubnov; Shlomo,10,0,20,10
1650818929247,ECE 45,A01,083139,Staff,0,1,60,60
1650818935270,ECE 65,A50,083695,Staff,0,5,30,30
1650818941295,ECE 109,A01,091882,Touri; Behrouz,32,0,70,38
1650818947321,ECE 180,A00,083140,Abi Samra; Nicholas Camill,20,0,30,10
1650818947321,ECE 180,B00,083141,Abi Samra; Nicholas Camill,0,0,30,30
1650818953345,MATH 10A,A01,083735,Patchell; Gregory David,2,0,30,28
1650818953345,MATH 10A,A02,083736,Patchell; Gregory David,27,0,30,3
1650818953345,MATH 10A,A03,083737,Patchell; Gregory David,24,0,30,6
1650818959368,MATH 10B,A01,083207,Staff,0,9,30,30
1650818959368,MATH 10B,A02,083208,Staff,0,6,30,30
1650818959368,MATH 10B,B01,083739,Staff,11,0,30,19
1650818959368,MATH 10B,B02,083740,Staff,28,0,30,2
1650818965394,MATH 18,A01,083743,Staff,0,0,30,30
1650818965394,MATH 18,A02,083744,Staff,23,0,30,7
1650818965394,MATH 18,A03,083745,Staff,21,0,30,9
1650818965394,MATH 18,A04,083746,Staff,26,0,30,4
1650818965394,MATH 18,B01,083748,Staff,0,15,30,30
1650818965394,MATH 18,B02,083749,Staff,0,12,30,30
1650818965394,MATH 18,B03,083750,Staff,0,12,30,30
1650818965394,MATH 18,B04,083751,Staff,0,12,30,30
1650818971417,MATH 20A,A01,083754,Staff,19,0,40,21
1650818977445,MATH 20B,A01,083756,Staff,0,13,30,30
1650818977445,MATH 20B,A02,083757,Staff,0,12,30,30
1650818983472,MATH 20C,A01,083760,Staff,0,17,30,30
1650818983472,MATH 20C,A02,083761,Staff,0,16,30,30
1650818983472,MATH 20C,B01,083762,Staff,9,0,30,21
1650818983472,MATH 20C,B02,083763,Staff,28,0,30,2
1650818989499,MATH 20D,A01,083765,Staff,2,1,30,28
1650818989499,MATH 20D,A02,083766,Staff,6,0,30,24
1650818989499,MATH 20D,A03,083767,Staff,24,0,30,6
1650818995525,MATH 20E,A01,083771,Staff,2,0,30,28
1650818995525,MATH 20E,A02,083772,Staff,15,0,30,15
1650818995525,MATH 20E,B01,083773,Staff,0,0,30,30
1650818995525,MATH 20E,B02,083774,Staff,5,0,30,25
1650819001550,MATH 103A,A01,083777,Staff,0,16,30,30
1650819001550,MATH 103A,A02,083778,Staff,0,15,30,30
1650819001550,MATH 103A,B01,083779,Staff,0,15,30,30
1650819001550,MATH 103A,B02,083780,Staff,0,15,30,30
1650819007573,MATH 105,A01,085443,Staff,0,22,30,30
1650819013599,MATH 109,A01,083213,Anzaldo; Leesa B,0,7,30,30
1650819013599,MATH 109,A02,083214,Anzaldo; Leesa B,0,7,30,30
1650819013599,MATH 109,B01,083215,Anzaldo; Leesa B,0,8,30,30
1650819013599,MATH 109,B02,083216,Anzaldo; Leesa B,0,7,30,30
1650819019625,MATH 142A,A01,083219,Chow; Bennett,0,16,30,30
1650819019625,MATH 142A,A02,083220,Chow; Bennett,0,15,30,30
1650819019625,MATH 142A,B01,083221,Chow; Bennett,0,16,30,30
1650819019625,MATH 142A,B02,083222,Chow; Bennett,0,14,30,30
1650819025650,MATH 193A,A01,083224,Staff,0,6,30,30
1650819025650,MATH 193A,A02,083225,Staff,0,6,30,30
1650819025650,MATH 193A,A03,083781,Staff,0,6,30,30
1650819025650,MATH 193A,A04,083782,Staff,0,7,30,30
1650819031771,MATH 197,001,091859,McAuley; Julian John,9998,0,9999,1
1650819037828,COGS 9,A01,083615,Staff,0,17,60,60
1650819043855,COGS 11,A01,083617,Boyle; Mary E. T.,16,0,40,24
1650819049880,COGS 13,A01,083071,Staff,0,38,40,40
1650819055907,COGS 14A,A01,092681,Staff,0,36,100,100
1650819061939,COGS 14B,A01,083073,Cheng; Tzu-Han,0,12,50,50
1650819067964,COGS 17,A01,092677,Staff,11,0,75,64
1650819074004,COGS 100,A01,083619,Staff,0,29,60,60
1650819080028,COGS 101A,A01,083621,Davis; Joshua Daniel,0,28,60,60
1650819086053,COGS 101B,A01,091572,Staff,0,3,60,60
1650819092087,COGS 101C,A01,083625,Delgado; Tania,14,0,30,16
1650819098114,COGS 107A,A01,083627,Boyle; Mary E. T.,0,16,60,60
1650819104138,COGS 118A,A01,083075,Staff,0,8,60,60
1650819110160,CSE 3,A50,083646,Miranda; Gregory Joseph,18,0,38,20
1650819110160,CSE 3,A51,083647,Miranda; Gregory Joseph,36,0,37,1
1650819116188,CSE 8A,A50,083650,Miranda; Gregory Joseph,0,29,40,40
1650819122213,CSE 11,A01,083080,Cao; Yingjun,0,96,40,40
1650819128240,CSE 12,A01,083652,Staff,0,21,100,100
1650819134266,CSE 15L,A01,083654,Staff,0,3,50,50
1650819134266,CSE 15L,A02,083655,Staff,0,2,50,50
1650819140289,CSE 20,A01,083657,Staff,49,0,80,31
1650819146315,CSE 30,A01,083084,Eldon; John,0,75,40,40
1650819152340,CSE 100,A01,083659,Cao; Yingjun,0,71,50,50
1650819158364,CSE 134B,A01,083661,Powell; Thomas Allan,0,38,65,65
1650819164388,CSE 140,A01,083663,Staff,0,11,75,75
1650819170412,CSE 140L,A01,083088,Eldon; John,0,20,75,75
1650819176435,CSE 175,A01,083665,Kumar; Rakesh,7,0,25,18
1650819182461,CSE 190,A00,092507,Dubnov; Shlomo,10,0,20,10
1650819188487,ECE 45,A01,083139,Staff,0,1,60,60
1650819194510,ECE 65,A50,083695,Staff,0,5,30,30
1650819200535,ECE 109,A01,091882,Touri; Behrouz,32,0,70,38
1650819206558,ECE 180,A00,083140,Abi Samra; Nicholas Camill,20,0,30,10
1650819206558,ECE 180,B00,083141,Abi Samra; Nicholas Camill,0,0,30,30
1650819212582,MATH 10A,A01,083735,Patchell; Gregory David,2,0,30,28
1650819212582,MATH 10A,A02,083736,Patchell; Gregory David,27,0,30,3
1650819212582,MATH 10A,A03,083737,Patchell; Gregory David,24,0,30,6
1650819218609,MATH 10B,A01,083207,Staff,0,9,30,30
1650819218609,MATH 10B,A02,083208,Staff,0,6,30,30
1650819218609,MATH 10B,B01,083739,Staff,11,0,30,19
1650819218609,MATH 10B,B02,083740,Staff,28,0,30,2
1650819224640,MATH 18,A01,083743,Staff,0,0,30,30
1650819224640,MATH 18,A02,083744,Staff,23,0,30,7
1650819224640,MATH 18,A03,083745,Staff,21,0,30,9
1650819224640,MATH 18,A04,083746,Staff,26,0,30,4
1650819224640,MATH 18,B01,083748,Staff,0,15,30,30
1650819224640,MATH 18,B02,083749,Staff,0,12,30,30
1650819224640,MATH 18,B03,083750,Staff,0,12,30,30
1650819224640,MATH 18,B04,083751,Staff,0,12,30,30
1650819230665,MATH 20A,A01,083754,Staff,19,0,40,21
1650819236688,MATH 20B,A01,083756,Staff,0,13,30,30
1650819236688,MATH 20B,A02,083757,Staff,0,12,30,30
1650819242713,MATH 20C,A01,083760,Staff,0,17,30,30
1650819242713,MATH 20C,A02,083761,Staff,0,16,30,30
1650819242713,MATH 20C,B01,083762,Staff,9,0,30,21
1650819242713,MATH 20C,B02,083763,Staff,28,0,30,2
1650819248737,MATH 20D,A01,083765,Staff,2,1,30,28
1650819248737,MATH 20D,A02,083766,Staff,6,0,30,24
1650819248737,MATH 20D,A03,083767,Staff,24,0,30,6
1650819254760,MATH 20E,A01,083771,Staff,2,0,30,28
1650819254760,MATH 20E,A02,083772,Staff,15,0,30,15
1650819254760,MATH 20E,B01,083773,Staff,0,0,30,30
1650819254760,MATH 20E,B02,083774,Staff,5,0,30,25
1650819260787,MATH 103A,A01,083777,Staff,0,16,30,30
1650819260787,MATH 103A,A02,083778,Staff,0,15,30,30
1650819260787,MATH 103A,B01,083779,Staff,0,15,30,30
1650819260787,MATH 103A,B02,083780,Staff,0,15,30,30
1650819266812,MATH 105,A01,085443,Staff,0,22,30,30
1650819272837,MATH 109,A01,083213,Anzaldo; Leesa B,0,7,30,30
1650819272837,MATH 109,A02,083214,Anzaldo; Leesa B,0,7,30,30
1650819272837,MATH 109,B01,083215,Anzaldo; Leesa B,0,8,30,30
1650819272837,MATH 109,B02,083216,Anzaldo; Leesa B,0,7,30,30
1650819278862,MATH 142A,A01,083219,Chow; Bennett,0,16,30,30
1650819278862,MATH 142A,A02,083220,Chow; Bennett,0,15,30,30
1650819278862,MATH 142A,B01,083221,Chow; Bennett,0,16,30,30
1650819278862,MATH 142A,B02,083222,Chow; Bennett,0,14,30,30
1650819284886,MATH 193A,A01,083224,Staff,0,6,30,30
1650819284886,MATH 193A,A02,083225,Staff,0,6,30,30
1650819284886,MATH 193A,A03,083781,Staff,0,6,30,30
1650819284886,MATH 193A,A04,083782,Staff,0,7,30,30
1650819290909,MATH 197,001,091859,McAuley; Julian John,9998,0,9999,1
1650819296967,COGS 9,A01,083615,Staff,0,17,60,60
1650819302990,COGS 11,A01,083617,Boyle; Mary E. T.,16,0,40,24
1650819309014,COGS 13,A01,083071,Staff,0,38,40,40
1650819315041,COGS 14A,A01,092681,Staff,0,36,100,100
1650819321066,COGS 14B,A01,083073,Cheng; Tzu-Han,0,12,50,50
1650819327090,COGS 17,A01,092677,Staff,11,0,75,64
1650819333116,COGS 100,A01,083619,Staff,0,29,60,60
1650819339139,COGS 101A,A01,083621,Davis; Joshua Daniel,0,28,60,60
1650819345164,COGS 101B,A01,091572,Staff,0,3,60,60
1650819351188,COGS 101C,A01,083625,Delgado; Tania,14,0,30,16
1650819357214,COGS 107A,A01,083627,Boyle; Mary E. T.,0,16,60,60
1650819363240,COGS 118A,A01,083075,Staff,0,8,60,60
1650819369268,CSE 3,A50,083646,Miranda; Gregory Joseph,18,0,38,20
1650819369268,CSE 3,A51,083647,Miranda; Gregory Joseph,36,0,37,1
1650819375290,CSE 8A,A50,083650,Miranda; Gregory Joseph,0,29,40,40
1650819381317,CSE 11,A01,083080,Cao; Yingjun,0,96,40,40
1650819387344,CSE 12,A01,083652,Staff,0,21,100,100
1650819393368,CSE 15L,A01,083654,Staff,0,3,50,50
1650819393368,CSE 15L,A02,083655,Staff,0,2,50,50
1650819399400,CSE 20,A01,083657,Staff,49,0,80,31
1650819405424,CSE 30,A01,083084,Eldon; John,0,75,40,40
1650819411448,CSE 100,A01,083659,Cao; Yingjun,0,71,50,50
1650819417477,CSE 134B,A01,083661,Powell; Thomas Allan,0,38,65,65
1650819423504,CSE 140,A01,083663,Staff,0,11,75,75
1650819429528,CSE 140L,A01,083088,Eldon; John,0,20,75,75
1650819435552,CSE 175,A01,083665,Kumar; Rakesh,7,0,25,18
1650819441587,CSE 190,A00,092507,Dubnov; Shlomo,10,0,20,10
1650819447617,ECE 45,A01,083139,Staff,0,1,60,60
1650819453640,ECE 65,A50,083695,Staff,0,5,30,30
1650819459663,ECE 109,A01,091882,Touri; Behrouz,32,0,70,38
1650819465686,ECE 180,A00,083140,Abi Samra; Nicholas Camill,20,0,30,10
1650819465686,ECE 180,B00,083141,Abi Samra; Nicholas Camill,0,0,30,30
1650819471716,MATH 10A,A01,083735,Patchell; Gregory David,2,0,30,28
1650819471716,MATH 10A,A02,083736,Patchell; Gregory David,27,0,30,3
1650819471716,MATH 10A,A03,083737,Patchell; Gregory David,24,0,30,6
1650819477743,MATH 10B,A01,083207,Staff,0,9,30,30
1650819477743,MATH 10B,A02,083208,Staff,0,6,30,30
1650819477743,MATH 10B,B01,083739,Staff,11,0,30,19
1650819477743,MATH 10B,B02,083740,Staff,28,0,30,2
1650819483772,MATH 18,A01,083743,Staff,0,0,30,30
1650819483772,MATH 18,A02,083744,Staff,23,0,30,7
1650819483772,MATH 18,A03,083745,Staff,21,0,30,9
1650819483772,MATH 18,A04,083746,Staff,26,0,30,4
1650819483772,MATH 18,B01,083748,Staff,0,15,30,30
1650819483772,MATH 18,B02,083749,Staff,0,12,30,30
1650819483772,MATH 18,B03,083750,Staff,0,12,30,30
1650819483772,MATH 18,B04,083751,Staff,0,12,30,30
1650819489798,MATH 20A,A01,083754,Staff,19,0,40,21
1650819495824,MATH 20B,A01,083756,Staff,0,13,30,30
1650819495824,MATH 20B,A02,083757,Staff,0,12,30,30
1650819501855,MATH 20C,A01,083760,Staff,0,17,30,30
1650819501855,MATH 20C,A02,083761,Staff,0,16,30,30
1650819501855,MATH 20C,B01,083762,Staff,9,0,30,21
1650819501855,MATH 20C,B02,083763,Staff,28,0,30,2
1650819507881,MATH 20D,A01,083765,Staff,2,1,30,28
1650819507881,MATH 20D,A02,083766,Staff,6,0,30,24
1650819507881,MATH 20D,A03,083767,Staff,24,0,30,6
1650819513905,MATH 20E,A01,083771,Staff,2,0,30,28
1650819513905,MATH 20E,A02,083772,Staff,15,0,30,15
1650819513905,MATH 20E,B01,083773,Staff,0,0,30,30
1650819513905,MATH 20E,B02,083774,Staff,5,0,30,25
1650819519938,MATH 103A,A01,083777,Staff,0,16,30,30
1650819519938,MATH 103A,A02,083778,Staff,0,15,30,30
1650819519938,MATH 103A,B01,083779,Staff,0,15,30,30
1650819519938,MATH 103A,B02,083780,Staff,0,15,30,30
1650819525962,MATH 105,A01,085443,Staff,0,22,30,30
1650819531986,MATH 109,A01,083213,Anzaldo; Leesa B,0,7,30,30
1650819531986,MATH 109,A02,083214,Anzaldo; Leesa B,0,7,30,30
1650819531986,MATH 109,B01,083215,Anzaldo; Leesa B,0,8,30,30
1650819531986,MATH 109,B02,083216,Anzaldo; Leesa B,0,7,30,30
1650819538014,MATH 142A,A01,083219,Chow; Bennett,0,16,30,30
1650819538014,MATH 142A,A02,083220,Chow; Bennett,0,15,30,30
1650819538014,MATH 142A,B01,083221,Chow; Bennett,0,16,30,30
1650819538014,MATH 142A,B02,083222,Chow; Bennett,0,14,30,30
1650819544044,MATH 193A,A01,083224,Staff,0,6,30,30
1650819544044,MATH 193A,A02,083225,Staff,0,6,30,30
1650819544044,MATH 193A,A03,083781,Staff,0,6,30,30
1650819544044,MATH 193A,A04,083782,Staff,0,7,30,30
1650819550070,MATH 197,001,091859,McAuley; Julian John,9998,0,9999,1
1650819556130,COGS 9,A01,083615,Staff,0,17,60,60
1650819562156,COGS 11,A01,083617,Boyle; Mary E. T.,16,0,40,24
1650819568181,COGS 13,A01,083071,Staff,0,38,40,40
1650819574207,COGS 14A,A01,092681,Staff,0,36,100,100
1650819580234,COGS 14B,A01,083073,Cheng; Tzu-Han,0,12,50,50
1650819586257,COGS 17,A01,092677,Staff,11,0,75,64
1650819592280,COGS 100,A01,083619,Staff,0,29,60,60
1650819598303,COGS 101A,A01,083621,Davis; Joshua Daniel,0,28,60,60
1650819604326,COGS 101B,A01,091572,Staff,0,3,60,60
1650819610349,COGS 101C,A01,083625,Delgado; Tania,14,0,30,16
1650819616375,COGS 107A,A01,083627,Boyle; Mary E. T.,0,16,60,60
1650819622516,COGS 118A,A01,083075,Staff,0,8,60,60
1650819628539,CSE 3,A50,083646,Miranda; Gregory Joseph,18,0,38,20
1650819628539,CSE 3,A51,083647,Miranda; Gregory Joseph,36,0,37,1
1650819634566,CSE 8A,A50,083650,Miranda; Gregory Joseph,0,29,40,40
1650819640593,CSE 11,A01,083080,Cao; Yingjun,0,96,40,40
1650819646620,CSE 12,A01,083652,Staff,0,21,100,100
1650819652643,CSE 15L,A01,083654,Staff,0,3,50,50
1650819652643,CSE 15L,A02,083655,Staff,0,2,50,50
1650819658667,CSE 20,A01,083657,Staff,49,0,80,31
1650819664690,CSE 30,A01,083084,Eldon; John,0,75,40,40
1650819670714,CSE 100,A01,083659,Cao; Yingjun,0,71,50,50
1650819676740,CSE 134B,A01,083661,Powell; Thomas Allan,0,38,65,65
1650819682765,CSE 140,A01,083663,Staff,0,11,75,75
1650819688796,CSE 140L,A01,083088,Eldon; John,0,20,75,75
1650819694821,CSE 175,A01,083665,Kumar; Rakesh,7,0,25,18
1650819700846,CSE 190,A00,092507,Dubnov; Shlomo,10,0,20,10
1650819706873,ECE 45,A01,083139,Staff,0,1,60,60
1650819712897,ECE 65,A50,083695,Staff,0,5,30,30
1650819718920,ECE 109,A01,091882,Touri; Behrouz,32,0,70,38
1650819724947,ECE 180,A00,083140,Abi Samra; Nicholas Camill,20,0,30,10
1650819724947,ECE 180,B00,083141,Abi Samra; Nicholas Camill,0,0,30,30
1650819730977,MATH 10A,A01,083735,Patchell; Gregory David,2,0,30,28
1650819730977,MATH 10A,A02,083736,Patchell; Gregory David,27,0,30,3
1650819730977,MATH 10A,A03,083737,Patchell; Gregory David,24,0,30,6
1650819737005,MATH 10B,A01,083207,Staff,0,9,30,30
1650819737005,MATH 10B,A02,083208,Staff,0,6,30,30
1650819737005,MATH 10B,B01,083739,Staff,11,0,30,19
1650819737005,MATH 10B,B02,083740,Staff,28,0,30,2
1650819743033,MATH 18,A01,083743,Staff,0,0,30,30
1650819743033,MATH 18,A02,083744,Staff,23,0,30,7
1650819743033,MATH 18,A03,083745,Staff,21,0,30,9
1650819743033,MATH 18,A04,083746,Staff,26,0,30,4
1650819743033,MATH 18,B01,083748,Staff,0,15,30,30
1650819743033,MATH 18,B02,083749,Staff,0,12,30,30
1650819743033,MATH 18,B03,083750,Staff,0,12,30,30
1650819743033,MATH 18,B04,083751,Staff,0,12,30,30
1650819749057,MATH 20A,A01,083754,Staff,19,0,40,21
1650819755090,MATH 20B,A01,083756,Staff,0,13,30,30
1650819755090,MATH 20B,A02,083757,Staff,0,12,30,30
1650819761114,MATH 20C,A01,083760,Staff,0,17,30,30
1650819761114,MATH 20C,A02,083761,Staff,0,16,30,30
1650819761114,MATH 20C,B01,083762,Staff,9,0,30,21
1650819761114,MATH 20C,B02,083763,Staff,28,0,30,2
1650819767139,MATH 20D,A01,083765,Staff,2,1,30,28
1650819767139,MATH 20D,A02,083766,Staff,6,0,30,24
1650819767139,MATH 20D,A03,083767,Staff,24,0,30,6
1650819773166,MATH 20E,A01,083771,Staff,2,0,30,28
1650819773166,MATH 20E,A02,083772,Staff,15,0,30,15
1650819773166,MATH 20E,B01,083773,Staff,0,0,30,30
1650819773166,MATH 20E,B02,083774,Staff,5,0,30,25
1650819779212,MATH 103A,A01,083777,Staff,0,16,30,30
1650819779212,MATH 103A,A02,083778,Staff,0,15,30,30
1650819779212,MATH 103A,B01,083779,Staff,0,15,30,30
1650819779212,MATH 103A,B02,083780,Staff,0,15,30,30
1650819785236,MATH 105,A01,085443,Staff,0,22,30,30
1650819791264,MATH 109,A01,083213,Anzaldo; Leesa B,0,7,30,30
1650819791264,MATH 109,A02,083214,Anzaldo; Leesa B,0,7,30,30
1650819791264,MATH 109,B01,083215,Anzaldo; Leesa B,0,8,30,30
1650819791264,MATH 109,B02,083216,Anzaldo; Leesa B,0,7,30,30
1650819797292,MATH 142A,A01,083219,Chow; Bennett,0,16,30,30
1650819797292,MATH 142A,A02,083220,Chow; Bennett,0,15,30,30
1650819797292,MATH 142A,B01,083221,Chow; Bennett,0,16,30,30
1650819797292,MATH 142A,B02,083222,Chow; Bennett,0,14,30,30
1650819803319,MATH 193A,A01,083224,Staff,0,6,30,30
1650819803319,MATH 193A,A02,083225,Staff,0,6,30,30
1650819803319,MATH 193A,A03,083781,Staff,0,6,30,30
1650819803319,MATH 193A,A04,083782,Staff,0,7,30,30
1650819809341,MATH 197,001,091859,McAuley; Julian John,9998,0,9999,1
1650819815389,COGS 9,A01,083615,Staff,0,17,60,60
1650819821411,COGS 11,A01,083617,Boyle; Mary E. T.,16,0,40,24
1650819827437,COGS 13,A01,083071,Staff,0,38,40,40
1650819833461,COGS 14A,A01,092681,Staff,0,36,100,100
1650819839486,COGS 14B,A01,083073,Cheng; Tzu-Han,0,12,50,50
1650819845510,COGS 17,A01,092677,Staff,11,0,75,64
1650819851534,COGS 100,A01,083619,Staff,0,29,60,60
1650819857563,COGS 101A,A01,083621,Davis; Joshua Daniel,0,28,60,60
1650819863589,COGS 101B,A01,091572,Staff,0,3,60,60
1650819869613,COGS 101C,A01,083625,Delgado; Tania,14,0,30,16
1650819875641,COGS 107A,A01,083627,Boyle; Mary E. T.,0,16,60,60
1650819881665,COGS 118A,A01,083075,Staff,0,8,60,60
1650819887693,CSE 3,A50,083646,Miranda; Gregory Joseph,18,0,38,20
1650819887693,CSE 3,A51,083647,Miranda; Gregory Joseph,36,0,37,1
1650819893722,CSE 8A,A50,083650,Miranda; Gregory Joseph,0,29,40,40
1650819899748,CSE 11,A01,083080,Cao; Yingjun,0,96,40,40
1650819905774,CSE 12,A01,083652,Staff,0,21,100,100
1650819911797,CSE 15L,A01,083654,Staff,0,3,50,50
1650819911797,CSE 15L,A02,083655,Staff,0,2,50,50
1650819917829,CSE 20,A01,083657,Staff,49,0,80,31
1650819923852,CSE 30,A01,083084,Eldon; John,0,75,40,40
1650819929876,CSE 100,A01,083659,Cao; Yingjun,0,71,50,50
1650819935906,CSE 134B,A01,083661,Powell; Thomas Allan,0,38,65,65
1650819941930,CSE 140,A01,083663,Staff,0,11,75,75
1650819947954,CSE 140L,A01,083088,Eldon; John,0,20,75,75
1650819953978,CSE 175,A01,083665,Kumar; Rakesh,7,0,25,18
1650819960003,CSE 190,A00,092507,Dubnov; Shlomo,10,0,20,10
1650819966027,ECE 45,A01,083139,Staff,0,1,60,60
1650819972050,ECE 65,A50,083695,Staff,0,5,30,30
1650819978077,ECE 109,A01,091882,Touri; Behrouz,32,0,70,38
1650819984101,ECE 180,A00,083140,Abi Samra; Nicholas Camill,20,0,30,10
1650819984101,ECE 180,B00,083141,Abi Samra; Nicholas Camill,0,0,30,30
1650819990125,MATH 10A,A01,083735,Patchell; Gregory David,2,0,30,28
1650819990125,MATH 10A,A02,083736,Patchell; Gregory David,27,0,30,3
1650819990125,MATH 10A,A03,083737,Patchell; Gregory David,24,0,30,6
1650819996147,MATH 10B,A01,083207,Staff,0,9,30,30
1650819996147,MATH 10B,A02,083208,Staff,0,6,30,30
1650819996147,MATH 10B,B01,083739,Staff,11,0,30,19
1650819996147,MATH 10B,B02,083740,Staff,28,0,30,2
1650820002175,MATH 18,A01,083743,Staff,0,0,30,30
1650820002175,MATH 18,A02,083744,Staff,23,0,30,7
1650820002175,MATH 18,A03,083745,Staff,21,0,30,9
1650820002175,MATH 18,A04,083746,Staff,26,0,30,4
1650820002175,MATH 18,B01,083748,Staff,0,15,30,30
1650820002175,MATH 18,B02,083749,Staff,0,12,30,30
1650820002175,MATH 18,B03,083750,Staff,0,12,30,30
1650820002175,MATH 18,B04,083751,Staff,0,12,30,30
1650820008199,MATH 20A,A01,083754,Staff,19,0,40,21
1650820014222,MATH 20B,A01,083756,Staff,0,13,30,30
1650820014222,MATH 20B,A02,083757,Staff,0,12,30,30
1650820020250,MATH 20C,A01,083760,Staff,0,17,30,30
1650820020250,MATH 20C,A02,083761,Staff,0,16,30,30
1650820020250,MATH 20C,B01,083762,Staff,9,0,30,21
1650820020250,MATH 20C,B02,083763,Staff,28,0,30,2
1650820026288,MATH 20D,A01,083765,Staff,2,1,30,28
1650820026288,MATH 20D,A02,083766,Staff,6,0,30,24
1650820026288,MATH 20D,A03,083767,Staff,24,0,30,6
1650820032316,MATH 20E,A01,083771,Staff,2,0,30,28
1650820032316,MATH 20E,A02,083772,Staff,15,0,30,15
1650820032316,MATH 20E,B01,083773,Staff,0,0,30,30
1650820032316,MATH 20E,B02,083774,Staff,5,0,30,25
1650820038345,MATH 103A,A01,083777,Staff,0,16,30,30
1650820038345,MATH 103A,A02,083778,Staff,0,15,30,30
1650820038345,MATH 103A,B01,083779,Staff,0,15,30,30
1650820038345,MATH 103A,B02,083780,Staff,0,15,30,30
1650820044371,MATH 105,A01,085443,Staff,0,22,30,30
1650820050399,MATH 109,A01,083213,Anzaldo; Leesa B,0,7,30,30
1650820050399,MATH 109,A02,083214,Anzaldo; Leesa B,0,7,30,30
1650820050399,MATH 109,B01,083215,Anzaldo; Leesa B,0,8,30,30
1650820050399,MATH 109,B02,083216,Anzaldo; Leesa B,0,7,30,30
1650820056430,MATH 142A,A01,083219,Chow; Bennett,0,16,30,30
1650820056430,MATH 142A,A02,083220,Chow; Bennett,0,15,30,30
1650820056430,MATH 142A,B01,083221,Chow; Bennett,0,16,30,30
1650820056430,MATH 142A,B02,083222,Chow; Bennett,0,14,30,30
1650820074663,MATH 193A,A01,083224,Staff,0,6,30,30
1650820074663,MATH 193A,A02,083225,Staff,0,6,30,30
1650820074663,MATH 193A,A03,083781,Staff,0,6,30,30
1650820074663,MATH 193A,A04,083782,Staff,0,7,30,30
1650820080689,MATH 197,001,091859,McAuley; Julian John,9998,0,9999,1
1650820086736,COGS 9,A01,083615,Staff,0,17,60,60
1650820092760,COGS 11,A01,083617,Boyle; Mary E. T.,16,0,40,24
1650820098783,COGS 13,A01,083071,Staff,0,38,40,40
1650820104810,COGS 14A,A01,092681,Staff,0,36,100,100
1650820110834,COGS 14B,A01,083073,Cheng; Tzu-Han,0,12,50,50
1650820116861,COGS 17,A01,092677,Staff,11,0,75,64
1650820122885,COGS 100,A01,083619,Staff,0,29,60,60
1650820128911,COGS 101A,A01,083621,Davis; Joshua Daniel,0,28,60,60
1650820134939,COGS 101B,A01,091572,Staff,0,3,60,60
1650820140977,COGS 101C,A01,083625,Delgado; Tania,14,0,30,16
1650820147008,COGS 107A,A01,083627,Boyle; Mary E. T.,0,16,60,60
1650820153031,COGS 118A,A01,083075,Staff,0,8,60,60
1650820159056,CSE 3,A50,083646,Miranda; Gregory Joseph,18,0,38,20
1650820159056,CSE 3,A51,083647,Miranda; Gregory Joseph,36,0,37,1
1650820165083,CSE 8A,A50,083650,Miranda; Gregory Joseph,0,29,40,40
1650820171108,CSE 11,A01,083080,Cao; Yingjun,0,96,40,40
1650820177131,CSE 12,A01,083652,Staff,0,21,100,100
1650820183157,CSE 15L,A01,083654,Staff,0,3,50,50
1650820183157,CSE 15L,A02,083655,Staff,0,2,50,50
1650820189181,CSE 20,A01,083657,Staff,49,0,80,31
1650820195204,CSE 30,A01,083084,Eldon; John,0,75,40,40
1650820201230,CSE 100,A01,083659,Cao; Yingjun,0,71,50,50
1650820207269,CSE 134B,A01,083661,Powell; Thomas Allan,0,38,65,65
1650820213293,CSE 140,A01,083663,Staff,0,11,75,75
1650820219316,CSE 140L,A01,083088,Eldon; John,0,20,75,75
1650820225350,CSE 175,A01,083665,Kumar; Rakesh,7,0,25,18
1650820231465,CSE 190,A00,092507,Dubnov; Shlomo,10,0,20,10
1650820237489,ECE 45,A01,083139,Staff,0,1,60,60
1650820243514,ECE 65,A50,083695,Staff,0,5,30,30
1650820249543,ECE 109,A01,091882,Touri; Behrouz,32,0,70,38
1650820255573,ECE 180,A00,083140,Abi Samra; Nicholas Camill,20,0,30,10
1650820255573,ECE 180,B00,083141,Abi Samra; Nicholas Camill,0,0,30,30
1650820261600,MATH 10A,A01,083735,Patchell; Gregory David,2,0,30,28
1650820261600,MATH 10A,A02,083736,Patchell; Gregory David,27,0,30,3
1650820261600,MATH 10A,A03,083737,Patchell; Gregory David,24,0,30,6
1650820267625,MATH 10B,A01,083207,Staff,0,9,30,30
1650820267625,MATH 10B,A02,083208,Staff,0,6,30,30
1650820267625,MATH 10B,B01,083739,Staff,11,0,30,19
1650820267625,MATH 10B,B02,083740,Staff,28,0,30,2
1650820273656,MATH 18,A01,083743,Staff,0,0,30,30
1650820273656,MATH 18,A02,083744,Staff,23,0,30,7
1650820273656,MATH 18,A03,083745,Staff,21,0,30,9
1650820273656,MATH 18,A04,083746,Staff,26,0,30,4
1650820273656,MATH 18,B01,083748,Staff,0,15,30,30
1650820273656,MATH 18,B02,083749,Staff,0,12,30,30
1650820273656,MATH 18,B03,083750,Staff,0,12,30,30
1650820273656,MATH 18,B04,083751,Staff,0,12,30,30
1650820279679,MATH 20A,A01,083754,Staff,19,0,40,21
1650820285703,MATH 20B,A01,083756,Staff,0,13,30,30
1650820285703,MATH 20B,A02,083757,Staff,0,12,30,30
1650820291731,MATH 20C,A01,083760,Staff,0,17,30,30
1650820291731,MATH 20C,A02,083761,Staff,0,16,30,30
1650820291731,MATH 20C,B01,083762,Staff,9,0,30,21
1650820291731,MATH 20C,B02,083763,Staff,28,0,30,2
1650820297758,MATH 20D,A01,083765,Staff,2,1,30,28
1650820297758,MATH 20D,A02,083766,Staff,6,0,30,24
1650820297758,MATH 20D,A03,083767,Staff,24,0,30,6
1650820303786,MATH 20E,A01,083771,Staff,2,0,30,28
1650820303786,MATH 20E,A02,083772,Staff,15,0,30,15
1650820303786,MATH 20E,B01,083773,Staff,0,0,30,30
1650820303786,MATH 20E,B02,083774,Staff,5,0,30,25
1650820309810,MATH 103A,A01,083777,Staff,0,16,30,30
1650820309810,MATH 103A,A02,083778,Staff,0,15,30,30
1650820309810,MATH 103A,B01,083779,Staff,0,15,30,30
1650820309810,MATH 103A,B02,083780,Staff,0,15,30,30
1650820315833,MATH 105,A01,085443,Staff,0,22,30,30
1650820321856,MATH 109,A01,083213,Anzaldo; Leesa B,0,7,30,30
1650820321856,MATH 109,A02,083214,Anzaldo; Leesa B,0,7,30,30
1650820321856,MATH 109,B01,083215,Anzaldo; Leesa B,0,8,30,30
1650820321856,MATH 109,B02,083216,Anzaldo; Leesa B,0,7,30,30
1650820327881,MATH 142A,A01,083219,Chow; Bennett,0,16,30,30
1650820327881,MATH 142A,A02,083220,Chow; Bennett,0,15,30,30
1650820327881,MATH 142A,B01,083221,Chow; Bennett,0,16,30,30
1650820327881,MATH 142A,B02,083222,Chow; Bennett,0,14,30,30
1650820333903,MATH 193A,A01,083224,Staff,0,6,30,30
1650820333903,MATH 193A,A02,083225,Staff,0,6,30,30
1650820333903,MATH 193A,A03,083781,Staff,0,6,30,30
1650820333903,MATH 193A,A04,083782,Staff,0,7,30,30
1650820339927,MATH 197,001,091859,McAuley; Julian John,9998,0,9999,1
1650820345984,COGS 9,A01,083615,Staff,0,17,60,60
1650820352012,COGS 11,A01,083617,Boyle; Mary E. T.,16,0,40,24
1650820358035,COGS 13,A01,083071,Staff,0,38,40,40
1650820364062,COGS 14A,A01,092681,Staff,0,36,100,100
1650820370088,COGS 14B,A01,083073,Cheng; Tzu-Han,0,12,50,50
1650820376115,COGS 17,A01,092677,Staff,11,0,75,64
1650820382143,COGS 100,A01,083619,Staff,0,29,60,60
1650820388166,COGS 101A,A01,083621,Davis; Joshua Daniel,0,28,60,60
1650820394190,COGS 101B,A01,091572,Staff,0,3,60,60
1650820400215,COGS 101C,A01,083625,Delgado; Tania,14,0,30,16
1650820406238,COGS 107A,A01,083627,Boyle; Mary E. T.,0,16,60,60
1650820412268,COGS 118A,A01,083075,Staff,0,8,60,60
1650820418297,CSE 3,A50,083646,Miranda; Gregory Joseph,18,0,38,20
1650820418297,CSE 3,A51,083647,Miranda; Gregory Joseph,36,0,37,1
1650820424321,CSE 8A,A50,083650,Miranda; Gregory Joseph,0,29,40,40
1650820430346,CSE 11,A01,083080,Cao; Yingjun,0,96,40,40
1650820436374,CSE 12,A01,083652,Staff,0,21,100,100
1650820442398,CSE 15L,A01,083654,Staff,0,3,50,50
1650820442398,CSE 15L,A02,083655,Staff,0,2,50,50
1650820448423,CSE 20,A01,083657,Staff,49,0,80,31
1650820454448,CSE 30,A01,083084,Eldon; John,0,75,40,40
1650820460472,CSE 100,A01,083659,Cao; Yingjun,0,71,50,50
1650820466494,CSE 134B,A01,083661,Powell; Thomas Allan,0,38,65,65
1650820472516,CSE 140,A01,083663,Staff,0,11,75,75
1650820478541,CSE 140L,A01,083088,Eldon; John,0,20,75,75
1650820484571,CSE 175,A01,083665,Kumar; Rakesh,7,0,25,18
1650820490595,CSE 190,A00,092507,Dubnov; Shlomo,10,0,20,10
1650820496631,ECE 45,A01,083139,Staff,0,1,60,60
1650820502658,ECE 65,A50,083695,Staff,0,5,30,30
1650820508680,ECE 109,A01,091882,Touri; Behrouz,32,0,70,38
1650820514704,ECE 180,A00,083140,Abi Samra; Nicholas Camill,20,0,30,10
1650820514704,ECE 180,B00,083141,Abi Samra; Nicholas Camill,0,0,30,30
1650820520730,MATH 10A,A01,083735,Patchell; Gregory David,2,0,30,28
1650820520730,MATH 10A,A02,083736,Patchell; Gregory David,27,0,30,3
1650820520730,MATH 10A,A03,083737,Patchell; Gregory David,24,0,30,6
1650820526761,MATH 10B,A01,083207,Staff,0,9,30,30
1650820526761,MATH 10B,A02,083208,Staff,0,6,30,30
1650820526761,MATH 10B,B01,083739,Staff,11,0,30,19
1650820526761,MATH 10B,B02,083740,Staff,28,0,30,2
1650820532801,MATH 18,A01,083743,Staff,0,0,30,30
1650820532801,MATH 18,A02,083744,Staff,23,0,30,7
1650820532801,MATH 18,A03,083745,Staff,21,0,30,9
1650820532801,MATH 18,A04,083746,Staff,26,0,30,4
1650820532801,MATH 18,B01,083748,Staff,0,15,30,30
1650820532801,MATH 18,B02,083749,Staff,0,12,30,30
1650820532801,MATH 18,B03,083750,Staff,0,12,30,30
1650820532801,MATH 18,B04,083751,Staff,0,12,30,30
1650820538823,MATH 20A,A01,083754,Staff,19,0,40,21
1650820544846,MATH 20B,A01,083756,Staff,0,13,30,30
1650820544846,MATH 20B,A02,083757,Staff,0,12,30,30
1650820550874,MATH 20C,A01,083760,Staff,0,17,30,30
1650820550874,MATH 20C,A02,083761,Staff,0,16,30,30
1650820550874,MATH 20C,B01,083762,Staff,9,0,30,21
1650820550874,MATH 20C,B02,083763,Staff,28,0,30,2
1650820556900,MATH 20D,A01,083765,Staff,2,1,30,28
1650820556900,MATH 20D,A02,083766,Staff,6,0,30,24
1650820556900,MATH 20D,A03,083767,Staff,24,0,30,6
1650820562923,MATH 20E,A01,083771,Staff,2,0,30,28
1650820562923,MATH 20E,A02,083772,Staff,15,0,30,15
1650820562923,MATH 20E,B01,083773,Staff,0,0,30,30
1650820562923,MATH 20E,B02,083774,Staff,5,0,30,25
1650820568948,MATH 103A,A01,083777,Staff,0,16,30,30
1650820568948,MATH 103A,A02,083778,Staff,0,15,30,30
1650820568948,MATH 103A,B01,083779,Staff,0,15,30,30
1650820568948,MATH 103A,B02,083780,Staff,0,15,30,30
1650820574972,MATH 105,A01,085443,Staff,0,22,30,30
1650820581003,MATH 109,A01,083213,Anzaldo; Leesa B,0,7,30,30
1650820581003,MATH 109,A02,083214,Anzaldo; Leesa B,0,7,30,30
1650820581003,MATH 109,B01,083215,Anzaldo; Leesa B,0,8,30,30
1650820581003,MATH 109,B02,083216,Anzaldo; Leesa B,0,7,30,30
1650820587030,MATH 142A,A01,083219,Chow; Bennett,0,16,30,30
1650820587030,MATH 142A,A02,083220,Chow; Bennett,0,15,30,30
1650820587030,MATH 142A,B01,083221,Chow; Bennett,0,16,30,30
1650820587030,MATH 142A,B02,083222,Chow; Bennett,0,14,30,30
1650820593052,MATH 193A,A01,083224,Staff,0,6,30,30
1650820593052,MATH 193A,A02,083225,Staff,0,6,30,30
1650820593052,MATH 193A,A03,083781,Staff,0,6,30,30
1650820593052,MATH 193A,A04,083782,Staff,0,7,30,30
1650820599075,MATH 197,001,091859,McAuley; Julian John,9998,0,9999,1
1650820605128,COGS 9,A01,083615,Staff,0,17,60,60
1650820611155,COGS 11,A01,083617,Boyle; Mary E. T.,16,0,40,24
1650820617179,COGS 13,A01,083071,Staff,0,38,40,40
1650820623206,COGS 14A,A01,092681,Staff,0,36,100,100
1650820629233,COGS 14B,A01,083073,Cheng; Tzu-Han,0,12,50,50
1650820635256,COGS 17,A01,092677,Staff,11,0,75,64
1650820641282,COGS 100,A01,083619,Staff,0,29,60,60
1650820647306,COGS 101A,A01,083621,Davis; Joshua Daniel,0,28,60,60
1650820653333,COGS 101B,A01,091572,Staff,0,3,60,60
1650820659358,COGS 101C,A01,083625,Delgado; Tania,14,0,30,16
1650820665386,COGS 107A,A01,083627,Boyle; Mary E. T.,0,16,60,60
1650820671413,COGS 118A,A01,083075,Staff,0,8,60,60
1650820677437,CSE 3,A50,083646,Miranda; Gregory Joseph,18,0,38,20
1650820677437,CSE 3,A51,083647,Miranda; Gregory Joseph,36,0,37,1
1650820683460,CSE 8A,A50,083650,Miranda; Gregory Joseph,0,29,40,40
1650820689484,CSE 11,A01,083080,Cao; Yingjun,0,96,40,40
1650820695507,CSE 12,A01,083652,Staff,0,21,100,100
1650820701529,CSE 15L,A01,083654,Staff,0,3,50,50
1650820701529,CSE 15L,A02,083655,Staff,0,2,50,50
1650820707552,CSE 20,A01,083657,Staff,49,0,80,31
1650820713579,CSE 30,A01,083084,Eldon; John,0,75,40,40
1650820719603,CSE 100,A01,083659,Cao; Yingjun,0,71,50,50
1650820725631,CSE 134B,A01,083661,Powell; Thomas Allan,0,38,65,65
1650820731667,CSE 140,A01,083663,Staff,0,11,75,75
1650820737694,CSE 140L,A01,083088,Eldon; John,0,20,75,75
1650820743720,CSE 175,A01,083665,Kumar; Rakesh,7,0,25,18
1650820749751,CSE 190,A00,092507,Dubnov; Shlomo,10,0,20,10
1650820755779,ECE 45,A01,083139,Staff,0,1,60,60
1650820761806,ECE 65,A50,083695,Staff,0,5,30,30
1650820767828,ECE 109,A01,091882,Touri; Behrouz,32,0,70,38
1650820773856,ECE 180,A00,083140,Abi Samra; Nicholas Camill,20,0,30,10
1650820773856,ECE 180,B00,083141,Abi Samra; Nicholas Camill,0,0,30,30
1650820779881,MATH 10A,A01,083735,Patchell; Gregory David,2,0,30,28
1650820779881,MATH 10A,A02,083736,Patchell; Gregory David,27,0,30,3
1650820779881,MATH 10A,A03,083737,Patchell; Gregory David,24,0,30,6
1650820785911,MATH 10B,A01,083207,Staff,0,9,30,30
1650820785911,MATH 10B,A02,083208,Staff,0,6,30,30
1650820785911,MATH 10B,B01,083739,Staff,11,0,30,19
1650820785911,MATH 10B,B02,083740,Staff,28,0,30,2
1650820791941,MATH 18,A01,083743,Staff,0,0,30,30
1650820791941,MATH 18,A02,083744,Staff,23,0,30,7
1650820791941,MATH 18,A03,083745,Staff,21,0,30,9
1650820791941,MATH 18,A04,083746,Staff,26,0,30,4
1650820791941,MATH 18,B01,083748,Staff,0,15,30,30
1650820791941,MATH 18,B02,083749,Staff,0,12,30,30
1650820791941,MATH 18,B03,083750,Staff,0,12,30,30
1650820791941,MATH 18,B04,083751,Staff,0,12,30,30
1650820797964,MATH 20A,A01,083754,Staff,19,0,40,21
1650820803987,MATH 20B,A01,083756,Staff,0,13,30,30
1650820803987,MATH 20B,A02,083757,Staff,0,12,30,30
1650820810010,MATH 20C,A01,083760,Staff,0,17,30,30
1650820810010,MATH 20C,A02,083761,Staff,0,16,30,30
1650820810010,MATH 20C,B01,083762,Staff,9,0,30,21
1650820810010,MATH 20C,B02,083763,Staff,28,0,30,2
1650820816034,MATH 20D,A01,083765,Staff,2,1,30,28
1650820816034,MATH 20D,A02,083766,Staff,6,0,30,24
1650820816034,MATH 20D,A03,083767,Staff,24,0,30,6
1650820822061,MATH 20E,A01,083771,Staff,2,0,30,28
1650820822061,MATH 20E,A02,083772,Staff,15,0,30,15
1650820822061,MATH 20E,B01,083773,Staff,0,0,30,30
1650820822061,MATH 20E,B02,083774,Staff,5,0,30,25
1650820828173,MATH 103A,A01,083777,Staff,0,16,30,30
1650820828173,MATH 103A,A02,083778,Staff,0,15,30,30
1650820828173,MATH 103A,B01,083779,Staff,0,15,30,30
1650820828173,MATH 103A,B02,083780,Staff,0,15,30,30
1650820834199,MATH 105,A01,085443,Staff,0,22,30,30
1650820840224,MATH 109,A01,083213,Anzaldo; Leesa B,0,7,30,30
1650820840224,MATH 109,A02,083214,Anzaldo; Leesa B,0,7,30,30
1650820840224,MATH 109,B01,083215,Anzaldo; Leesa B,0,8,30,30
1650820840224,MATH 109,B02,083216,Anzaldo; Leesa B,0,7,30,30
1650820846248,MATH 142A,A01,083219,Chow; Bennett,0,16,30,30
1650820846248,MATH 142A,A02,083220,Chow; Bennett,0,15,30,30
1650820846248,MATH 142A,B01,083221,Chow; Bennett,0,16,30,30
1650820846248,MATH 142A,B02,083222,Chow; Bennett,0,14,30,30
1650820852271,MATH 193A,A01,083224,Staff,0,6,30,30
1650820852271,MATH 193A,A02,083225,Staff,0,6,30,30
1650820852271,MATH 193A,A03,083781,Staff,0,6,30,30
1650820852271,MATH 193A,A04,083782,Staff,0,7,30,30
1650820858297,MATH 197,001,091859,McAuley; Julian John,9998,0,9999,1
1650820864351,COGS 9,A01,083615,Staff,0,17,60,60
1650820870378,COGS 11,A01,083617,Boyle; Mary E. T.,16,0,40,24
1650820876404,COGS 13,A01,083071,Staff,0,38,40,40
1650820882431,COGS 14A,A01,092681,Staff,0,36,100,100
1650820888458,COGS 14B,A01,083073,Cheng; Tzu-Han,0,12,50,50
1650820894482,COGS 17,A01,092677,Staff,11,0,75,64
1650820900506,COGS 100,A01,083619,Staff,0,29,60,60
1650820906532,COGS 101A,A01,083621,Davis; Joshua Daniel,0,28,60,60
1650820912556,COGS 101B,A01,091572,Staff,0,3,60,60
1650820918584,COGS 101C,A01,083625,Delgado; Tania,14,0,30,16
1650820924611,COGS 107A,A01,083627,Boyle; Mary E. T.,0,16,60,60
1650820930633,COGS 118A,A01,083075,Staff,0,8,60,60
1650820936662,CSE 3,A50,083646,Miranda; Gregory Joseph,18,0,38,20
1650820936662,CSE 3,A51,083647,Miranda; Gregory Joseph,36,0,37,1
1650820942701,CSE 8A,A50,083650,Miranda; Gregory Joseph,0,29,40,40
1650820948729,CSE 11,A01,083080,Cao; Yingjun,0,96,40,40
1650820954753,CSE 12,A01,083652,Staff,0,21,100,100
1650820960778,CSE 15L,A01,083654,Staff,0,3,50,50
1650820960778,CSE 15L,A02,083655,Staff,0,2,50,50
1650820966809,CSE 20,A01,083657,Staff,49,0,80,31
1650820972844,CSE 30,A01,083084,Eldon; John,0,75,40,40
1650820978870,CSE 100,A01,083659,Cao; Yingjun,0,71,50,50
1650820984897,CSE 134B,A01,083661,Powell; Thomas Allan,0,38,65,65
1650820990920,CSE 140,A01,083663,Staff,0,11,75,75
1650820996947,CSE 140L,A01,083088,Eldon; John,0,20,75,75
1650821002974,CSE 175,A01,083665,Kumar; Rakesh,7,0,25,18
1650821009000,CSE 190,A00,092507,Dubnov; Shlomo,10,0,20,10
1650821015024,ECE 45,A01,083139,Staff,0,1,60,60
1650821021048,ECE 65,A50,083695,Staff,0,5,30,30
1650821027071,ECE 109,A01,091882,Touri; Behrouz,32,0,70,38
1650821033094,ECE 180,A00,083140,Abi Samra; Nicholas Camill,20,0,30,10
1650821033094,ECE 180,B00,083141,Abi Samra; Nicholas Camill,0,0,30,30
1650821039118,MATH 10A,A01,083735,Patchell; Gregory David,2,0,30,28
1650821039118,MATH 10A,A02,083736,Patchell; Gregory David,27,0,30,3
1650821039118,MATH 10A,A03,083737,Patchell; Gregory David,24,0,30,6
1650821045148,MATH 10B,A01,083207,Staff,0,9,30,30
1650821045148,MATH 10B,A02,083208,Staff,0,6,30,30
1650821045148,MATH 10B,B01,083739,Staff,11,0,30,19
1650821045148,MATH 10B,B02,083740,Staff,28,0,30,2
1650821051178,MATH 18,A01,083743,Staff,0,0,30,30
1650821051178,MATH 18,A02,083744,Staff,23,0,30,7
1650821051178,MATH 18,A03,083745,Staff,21,0,30,9
1650821051178,MATH 18,A04,083746,Staff,26,0,30,4
1650821051178,MATH 18,B01,083748,Staff,0,15,30,30
1650821051178,MATH 18,B02,083749,Staff,0,12,30,30
1650821051178,MATH 18,B03,083750,Staff,0,12,30,30
1650821051178,MATH 18,B04,083751,Staff,0,12,30,30
1650821057205,MATH 20A,A01,083754,Staff,19,0,40,21
1650821063229,MATH 20B,A01,083756,Staff,0,13,30,30
1650821063229,MATH 20B,A02,083757,Staff,0,12,30,30
1650821069257,MATH 20C,A01,083760,Staff,0,17,30,30
1650821069257,MATH 20C,A02,083761,Staff,0,16,30,30
1650821069257,MATH 20C,B01,083762,Staff,9,0,30,21
1650821069257,MATH 20C,B02,083763,Staff,28,0,30,2
1650821075281,MATH 20D,A01,083765,Staff,2,1,30,28
1650821075281,MATH 20D,A02,083766,Staff,6,0,30,24
1650821075281,MATH 20D,A03,083767,Staff,24,0,30,6
1650821081309,MATH 20E,A01,083771,Staff,2,0,30,28
1650821081309,MATH 20E,A02,083772,Staff,15,0,30,15
1650821081309,MATH 20E,B01,083773,Staff,0,0,30,30
1650821081309,MATH 20E,B02,083774,Staff,5,0,30,25
1650821087332,MATH 103A,A01,083777,Staff,0,16,30,30
1650821087332,MATH 103A,A02,083778,Staff,0,15,30,30
1650821087332,MATH 103A,B01,083779,Staff,0,15,30,30
1650821087332,MATH 103A,B02,083780,Staff,0,15,30,30
1650821093356,MATH 105,A01,085443,Staff,0,22,30,30
1650821099383,MATH 109,A01,083213,Anzaldo; Leesa B,0,7,30,30
1650821099383,MATH 109,A02,083214,Anzaldo; Leesa B,0,7,30,30
1650821099383,MATH 109,B01,083215,Anzaldo; Leesa B,0,8,30,30
1650821099383,MATH 109,B02,083216,Anzaldo; Leesa B,0,7,30,30
1650821105408,MATH 142A,A01,083219,Chow; Bennett,0,16,30,30
1650821105408,MATH 142A,A02,083220,Chow; Bennett,0,15,30,30
1650821105408,MATH 142A,B01,083221,Chow; Bennett,0,16,30,30
1650821105408,MATH 142A,B02,083222,Chow; Bennett,0,14,30,30
1650821111431,MATH 193A,A01,083224,Staff,0,6,30,30
1650821111431,MATH 193A,A02,083225,Staff,0,6,30,30
1650821111431,MATH 193A,A03,083781,Staff,0,6,30,30
1650821111431,MATH 193A,A04,083782,Staff,0,7,30,30
1650821117460,MATH 197,001,091859,McAuley; Julian John,9998,0,9999,1
1650821123512,COGS 9,A01,083615,Staff,0,17,60,60
1650821129540,COGS 11,A01,083617,Boyle; Mary E. T.,16,0,40,24
1650821135563,COGS 13,A01,083071,Staff,0,38,40,40
1650821141585,COGS 14A,A01,092681,Staff,0,36,100,100
1650821147607,COGS 14B,A01,083073,Cheng; Tzu-Han,0,12,50,50
1650821153631,COGS 17,A01,092677,Staff,11,0,75,64
1650821159657,COGS 100,A01,083619,Staff,0,29,60,60
1650821165685,COGS 101A,A01,083621,Davis; Joshua Daniel,0,28,60,60
1650821171707,COGS 101B,A01,091572,Staff,0,3,60,60
1650821177733,COGS 101C,A01,083625,Delgado; Tania,14,0,30,16
1650821183761,COGS 107A,A01,083627,Boyle; Mary E. T.,0,16,60,60
1650821189787,COGS 118A,A01,083075,Staff,0,8,60,60
1650821195815,CSE 3,A50,083646,Miranda; Gregory Joseph,18,0,38,20
1650821195815,CSE 3,A51,083647,Miranda; Gregory Joseph,36,0,37,1
1650821201840,CSE 8A,A50,083650,Miranda; Gregory Joseph,0,29,40,40
1650821207866,CSE 11,A01,083080,Cao; Yingjun,0,96,40,40
1650821213891,CSE 12,A01,083652,Staff,0,21,100,100
1650821219915,CSE 15L,A01,083654,Staff,0,3,50,50
1650821219915,CSE 15L,A02,083655,Staff,0,2,50,50
1650821225951,CSE 20,A01,083657,Staff,49,0,80,31
1650821231977,CSE 30,A01,083084,Eldon; John,0,75,40,40
1650821238003,CSE 100,A01,083659,Cao; Yingjun,0,71,50,50
1650821244027,CSE 134B,A01,083661,Powell; Thomas Allan,0,38,65,65
1650821250050,CSE 140,A01,083663,Staff,0,11,75,75
1650821256085,CSE 140L,A01,083088,Eldon; John,0,20,75,75
1650821262109,CSE 175,A01,083665,Kumar; Rakesh,7,0,25,18
1650821268138,CSE 190,A00,092507,Dubnov; Shlomo,10,0,20,10
1650821274164,ECE 45,A01,083139,Staff,0,1,60,60
1650821280187,ECE 65,A50,083695,Staff,0,5,30,30
1650821286211,ECE 109,A01,091882,Touri; Behrouz,32,0,70,38
1650821292235,ECE 180,A00,083140,Abi Samra; Nicholas Camill,20,0,30,10
1650821292235,ECE 180,B00,083141,Abi Samra; Nicholas Camill,0,0,30,30
1650821298262,MATH 10A,A01,083735,Patchell; Gregory David,2,0,30,28
1650821298262,MATH 10A,A02,083736,Patchell; Gregory David,27,0,30,3
1650821298262,MATH 10A,A03,083737,Patchell; Gregory David,24,0,30,6
1650821304288,MATH 10B,A01,083207,Staff,0,9,30,30
1650821304288,MATH 10B,A02,083208,Staff,0,6,30,30
1650821304288,MATH 10B,B01,083739,Staff,11,0,30,19
1650821304288,MATH 10B,B02,083740,Staff,28,0,30,2
1650821310314,MATH 18,A01,083743,Staff,0,0,30,30
1650821310314,MATH 18,A02,083744,Staff,23,0,30,7
1650821310314,MATH 18,A03,083745,Staff,21,0,30,9
1650821310314,MATH 18,A04,083746,Staff,26,0,30,4
1650821310314,MATH 18,B01,083748,Staff,0,15,30,30
1650821310314,MATH 18,B02,083749,Staff,0,12,30,30
1650821310314,MATH 18,B03,083750,Staff,0,12,30,30
1650821310314,MATH 18,B04,083751,Staff,0,12,30,30
1650821316339,MATH 20A,A01,083754,Staff,19,0,40,21
1650821322365,MATH 20B,A01,083756,Staff,0,13,30,30
1650821322365,MATH 20B,A02,083757,Staff,0,12,30,30
1650821328394,MATH 20C,A01,083760,Staff,0,17,30,30
1650821328394,MATH 20C,A02,083761,Staff,0,16,30,30
1650821328394,MATH 20C,B01,083762,Staff,9,0,30,21
1650821328394,MATH 20C,B02,083763,Staff,28,0,30,2
1650821334417,MATH 20D,A01,083765,Staff,2,1,30,28
1650821334417,MATH 20D,A02,083766,Staff,6,0,30,24
1650821334417,MATH 20D,A03,083767,Staff,24,0,30,6
1650821340442,MATH 20E,A01,083771,Staff,2,0,30,28
1650821340442,MATH 20E,A02,083772,Staff,15,0,30,15
1650821340442,MATH 20E,B01,083773,Staff,0,0,30,30
1650821340442,MATH 20E,B02,083774,Staff,5,0,30,25
1650821346467,MATH 103A,A01,083777,Staff,0,16,30,30
1650821346467,MATH 103A,A02,083778,Staff,0,15,30,30
1650821346467,MATH 103A,B01,083779,Staff,0,15,30,30
1650821346467,MATH 103A,B02,083780,Staff,0,15,30,30
1650821352490,MATH 105,A01,085443,Staff,0,22,30,30
1650821358537,MATH 109,A01,083213,Anzaldo; Leesa B,0,7,30,30
1650821358537,MATH 109,A02,083214,Anzaldo; Leesa B,0,7,30,30
1650821358537,MATH 109,B01,083215,Anzaldo; Leesa B,0,8,30,30
1650821358537,MATH 109,B02,083216,Anzaldo; Leesa B,0,7,30,30
1650821364561,MATH 142A,A01,083219,Chow; Bennett,0,16,30,30
1650821364561,MATH 142A,A02,083220,Chow; Bennett,0,15,30,30
1650821364561,MATH 142A,B01,083221,Chow; Bennett,0,16,30,30
1650821364561,MATH 142A,B02,083222,Chow; Bennett,0,14,30,30
1650821370585,MATH 193A,A01,083224,Staff,0,6,30,30
1650821370585,MATH 193A,A02,083225,Staff,0,6,30,30
1650821370585,MATH 193A,A03,083781,Staff,0,6,30,30
1650821370585,MATH 193A,A04,083782,Staff,0,7,30,30
1650821376609,MATH 197,001,091859,McAuley; Julian John,9998,0,9999,1
1650821382669,COGS 9,A01,083615,Staff,0,17,60,60
1650821388692,COGS 11,A01,083617,Boyle; Mary E. T.,16,0,40,24
1650821394718,COGS 13,A01,083071,Staff,0,38,40,40
1650821400742,COGS 14A,A01,092681,Staff,0,36,100,100
1650821406765,COGS 14B,A01,083073,Cheng; Tzu-Han,0,12,50,50
1650821412791,COGS 17,A01,092677,Staff,11,0,75,64
1650821418906,COGS 100,A01,083619,Staff,0,29,60,60
1650821424931,COGS 101A,A01,083621,Davis; Joshua Daniel,0,28,60,60
1650821430954,COGS 101B,A01,091572,Staff,0,3,60,60
1650821436982,COGS 101C,A01,083625,Delgado; Tania,14,0,30,16
1650821443015,COGS 107A,A01,083627,Boyle; Mary E. T.,0,16,60,60
1650821449040,COGS 118A,A01,083075,Staff,0,8,60,60
1650821455071,CSE 3,A50,083646,Miranda; Gregory Joseph,18,0,38,20
1650821455071,CSE 3,A51,083647,Miranda; Gregory Joseph,36,0,37,1
1650821461095,CSE 8A,A50,083650,Miranda; Gregory Joseph,0,29,40,40
1650821467119,CSE 11,A01,083080,Cao; Yingjun,0,96,40,40
1650821473143,CSE 12,A01,083652,Staff,0,21,100,100
1650821479164,CSE 15L,A01,083654,Staff,0,3,50,50
1650821479164,CSE 15L,A02,083655,Staff,0,2,50,50
1650821485188,CSE 20,A01,083657,Staff,49,0,80,31
1650821491217,CSE 30,A01,083084,Eldon; John,0,75,40,40
1650821497243,CSE 100,A01,083659,Cao; Yingjun,0,71,50,50
1650821503270,CSE 134B,A01,083661,Powell; Thomas Allan,0,38,65,65
1650821509295,CSE 140,A01,083663,Staff,0,11,75,75
1650821515330,CSE 140L,A01,083088,Eldon; John,0,20,75,75
1650821521356,CSE 175,A01,083665,Kumar; Rakesh,7,0,25,18
1650821527382,CSE 190,A00,092507,Dubnov; Shlomo,10,0,20,10
1650821533405,ECE 45,A01,083139,Staff,0,1,60,60
1650821539428,ECE 65,A50,083695,Staff,0,5,30,30
1650821545453,ECE 109,A01,091882,Touri; Behrouz,32,0,70,38
1650821551476,ECE 180,A00,083140,Abi Samra; Nicholas Camill,20,0,30,10
1650821551476,ECE 180,B00,083141,Abi Samra; Nicholas Camill,0,0,30,30
1650821557501,MATH 10A,A01,083735,Patchell; Gregory David,2,0,30,28
1650821557501,MATH 10A,A02,083736,Patchell; Gregory David,27,0,30,3
1650821557501,MATH 10A,A03,083737,Patchell; Gregory David,24,0,30,6
1650821563553,MATH 10B,A01,083207,Staff,0,9,30,30
1650821563553,MATH 10B,A02,083208,Staff,0,6,30,30
1650821563553,MATH 10B,B01,083739,Staff,11,0,30,19
1650821563553,MATH 10B,B02,083740,Staff,28,0,30,2
1650821569583,MATH 18,A01,083743,Staff,0,0,30,30
1650821569583,MATH 18,A02,083744,Staff,23,0,30,7
1650821569583,MATH 18,A03,083745,Staff,21,0,30,9
1650821569583,MATH 18,A04,083746,Staff,26,0,30,4
1650821569583,MATH 18,B01,083748,Staff,0,15,30,30
1650821569583,MATH 18,B02,083749,Staff,0,12,30,30
1650821569583,MATH 18,B03,083750,Staff,0,12,30,30
1650821569583,MATH 18,B04,083751,Staff,0,12,30,30
1650821575607,MATH 20A,A01,083754,Staff,19,0,40,21
1650821581630,MATH 20B,A01,083756,Staff,0,13,30,30
1650821581630,MATH 20B,A02,083757,Staff,0,12,30,30
1650821587653,MATH 20C,A01,083760,Staff,0,17,30,30
1650821587653,MATH 20C,A02,083761,Staff,0,16,30,30
1650821587653,MATH 20C,B01,083762,Staff,9,0,30,21
1650821587653,MATH 20C,B02,083763,Staff,28,0,30,2
1650821593677,MATH 20D,A01,083765,Staff,2,1,30,28
1650821593677,MATH 20D,A02,083766,Staff,6,0,30,24
1650821593677,MATH 20D,A03,083767,Staff,24,0,30,6
1650821599704,MATH 20E,A01,083771,Staff,2,0,30,28
1650821599704,MATH 20E,A02,083772,Staff,15,0,30,15
1650821599704,MATH 20E,B01,083773,Staff,0,0,30,30
1650821599704,MATH 20E,B02,083774,Staff,5,0,30,25
1650821605733,MATH 103A,A01,083777,Staff,0,16,30,30
1650821605733,MATH 103A,A02,083778,Staff,0,15,30,30
1650821605733,MATH 103A,B01,083779,Staff,0,15,30,30
1650821605733,MATH 103A,B02,083780,Staff,0,15,30,30
1650821611759,MATH 105,A01,085443,Staff,0,22,30,30
1650821617781,MATH 109,A01,083213,Anzaldo; Leesa B,0,7,30,30
1650821617781,MATH 109,A02,083214,Anzaldo; Leesa B,0,7,30,30
1650821617781,MATH 109,B01,083215,Anzaldo; Leesa B,0,8,30,30
1650821617781,MATH 109,B02,083216,Anzaldo; Leesa B,0,7,30,30
1650821623809,MATH 142A,A01,083219,Chow; Bennett,0,16,30,30
1650821623809,MATH 142A,A02,083220,Chow; Bennett,0,15,30,30
1650821623809,MATH 142A,B01,083221,Chow; Bennett,0,16,30,30
1650821623809,MATH 142A,B02,083222,Chow; Bennett,0,14,30,30
1650821629833,MATH 193A,A01,083224,Staff,0,6,30,30
1650821629833,MATH 193A,A02,083225,Staff,0,6,30,30
1650821629833,MATH 193A,A03,083781,Staff,0,6,30,30
1650821629833,MATH 193A,A04,083782,Staff,0,7,30,30
1650821635856,MATH 197,001,091859,McAuley; Julian John,9998,0,9999,1
1650821641915,COGS 9,A01,083615,Staff,0,17,60,60
1650821647939,COGS 11,A01,083617,Boyle; Mary E. T.,16,0,40,24
1650821653963,COGS 13,A01,083071,Staff,0,38,40,40
1650821659990,COGS 14A,A01,092681,Staff,0,36,100,100
1650821666011,COGS 14B,A01,083073,Cheng; Tzu-Han,0,12,50,50
1650821672037,COGS 17,A01,092677,Staff,11,0,75,64
1650821678065,COGS 100,A01,083619,Staff,0,29,60,60
1650821684100,COGS 101A,A01,083621,Davis; Joshua Daniel,0,28,60,60
1650821690126,COGS 101B,A01,091572,Staff,0,3,60,60
1650821696153,COGS 101C,A01,083625,Delgado; Tania,14,0,30,16
1650821702177,COGS 107A,A01,083627,Boyle; Mary E. T.,0,16,60,60
1650821708202,COGS 118A,A01,083075,Staff,0,8,60,60
1650821714230,CSE 3,A50,083646,Miranda; Gregory Joseph,18,0,38,20
1650821714230,CSE 3,A51,083647,Miranda; Gregory Joseph,36,0,37,1
1650821720257,CSE 8A,A50,083650,Miranda; Gregory Joseph,0,29,40,40
1650821726285,CSE 11,A01,083080,Cao; Yingjun,0,96,40,40
1650821732310,CSE 12,A01,083652,Staff,0,21,100,100
1650821738334,CSE 15L,A01,083654,Staff,0,3,50,50
1650821738334,CSE 15L,A02,083655,Staff,0,2,50,50
1650821744360,CSE 20,A01,083657,Staff,49,0,80,31
1650821750393,CSE 30,A01,083084,Eldon; John,0,75,40,40
1650821756417,CSE 100,A01,083659,Cao; Yingjun,0,71,50,50
1650821762442,CSE 134B,A01,083661,Powell; Thomas Allan,0,38,65,65
1650821768464,CSE 140,A01,083663,Staff,0,11,75,75
1650821774488,CSE 140L,A01,083088,Eldon; John,0,20,75,75
1650821780511,CSE 175,A01,083665,Kumar; Rakesh,7,0,25,18
1650821786535,CSE 190,A00,092507,Dubnov; Shlomo,10,0,20,10
1650821792557,ECE 45,A01,083139,Staff,0,1,60,60
1650821798585,ECE 65,A50,083695,Staff,0,5,30,30
1650821804627,ECE 109,A01,091882,Touri; Behrouz,32,0,70,38
1650821810651,ECE 180,A00,083140,Abi Samra; Nicholas Camill,20,0,30,10
1650821810651,ECE 180,B00,083141,Abi Samra; Nicholas Camill,0,0,30,30
1650821816676,MATH 10A,A01,083735,Patchell; Gregory David,2,0,30,28
1650821816676,MATH 10A,A02,083736,Patchell; Gregory David,27,0,30,3
1650821816676,MATH 10A,A03,083737,Patchell; Gregory David,24,0,30,6
1650821822701,MATH 10B,A01,083207,Staff,0,9,30,30
1650821822701,MATH 10B,A02,083208,Staff,0,6,30,30
1650821822701,MATH 10B,B01,083739,Staff,11,0,30,19
1650821822701,MATH 10B,B02,083740,Staff,28,0,30,2
1650821828731,MATH 18,A01,083743,Staff,0,0,30,30
1650821828731,MATH 18,A02,083744,Staff,23,0,30,7
1650821828731,MATH 18,A03,083745,Staff,21,0,30,9
1650821828731,MATH 18,A04,083746,Staff,26,0,30,4
1650821828731,MATH 18,B01,083748,Staff,0,15,30,30
1650821828731,MATH 18,B02,083749,Staff,0,12,30,30
1650821828731,MATH 18,B03,083750,Staff,0,12,30,30
1650821828731,MATH 18,B04,083751,Staff,0,12,30,30
1650821834756,MATH 20A,A01,083754,Staff,19,0,40,21
1650821840780,MATH 20B,A01,083756,Staff,0,13,30,30
1650821840780,MATH 20B,A02,083757,Staff,0,12,30,30
1650821846804,MATH 20C,A01,083760,Staff,0,17,30,30
1650821846804,MATH 20C,A02,083761,Staff,0,16,30,30
1650821846804,MATH 20C,B01,083762,Staff,9,0,30,21
1650821846804,MATH 20C,B02,083763,Staff,28,0,30,2
1650821852829,MATH 20D,A01,083765,Staff,2,1,30,28
1650821852829,MATH 20D,A02,083766,Staff,6,0,30,24
1650821852829,MATH 20D,A03,083767,Staff,24,0,30,6
1650821858857,MATH 20E,A01,083771,Staff,2,0,30,28
1650821858857,MATH 20E,A02,083772,Staff,15,0,30,15
1650821858857,MATH 20E,B01,083773,Staff,0,0,30,30
1650821858857,MATH 20E,B02,083774,Staff,5,0,30,25
1650821864885,MATH 103A,A01,083777,Staff,0,16,30,30
1650821864885,MATH 103A,A02,083778,Staff,0,15,30,30
1650821864885,MATH 103A,B01,083779,Staff,0,15,30,30
1650821864885,MATH 103A,B02,083780,Staff,0,15,30,30
1650821870909,MATH 105,A01,085443,Staff,0,22,30,30
1650821876936,MATH 109,A01,083213,Anzaldo; Leesa B,0,7,30,30
1650821876936,MATH 109,A02,083214,Anzaldo; Leesa B,0,7,30,30
1650821876936,MATH 109,B01,083215,Anzaldo; Leesa B,0,8,30,30
1650821876936,MATH 109,B02,083216,Anzaldo; Leesa B,0,7,30,30
1650821882961,MATH 142A,A01,083219,Chow; Bennett,0,16,30,30
1650821882961,MATH 142A,A02,083220,Chow; Bennett,0,15,30,30
1650821882961,MATH 142A,B01,083221,Chow; Bennett,0,16,30,30
1650821882961,MATH 142A,B02,083222,Chow; Bennett,0,14,30,30
1650821888984,MATH 193A,A01,083224,Staff,0,6,30,30
1650821888984,MATH 193A,A02,083225,Staff,0,6,30,30
1650821888984,MATH 193A,A03,083781,Staff,0,6,30,30
1650821888984,MATH 193A,A04,083782,Staff,0,7,30,30
1650821895010,MATH 197,001,091859,McAuley; Julian John,9998,0,9999,1
1650821901061,COGS 9,A01,083615,Staff,0,17,60,60
1650821907083,COGS 11,A01,083617,Boyle; Mary E. T.,16,0,40,24
1650821913105,COGS 13,A01,083071,Staff,0,38,40,40
1650821919141,COGS 14A,A01,092681,Staff,0,36,100,100
1650821925168,COGS 14B,A01,083073,Cheng; Tzu-Han,0,12,50,50
1650821931191,COGS 17,A01,092677,Staff,11,0,75,64
1650821937217,COGS 100,A01,083619,Staff,0,29,60,60
1650821943242,COGS 101A,A01,083621,Davis; Joshua Daniel,0,28,60,60
1650821949265,COGS 101B,A01,091572,Staff,0,3,60,60
1650821955291,COGS 101C,A01,083625,Delgado; Tania,14,0,30,16
1650821961315,COGS 107A,A01,083627,Boyle; Mary E. T.,0,16,60,60
1650821967346,COGS 118A,A01,083075,Staff,0,8,60,60
1650821973375,CSE 3,A50,083646,Miranda; Gregory Joseph,18,0,38,20
1650821973375,CSE 3,A51,083647,Miranda; Gregory Joseph,36,0,37,1
1650821979403,CSE 8A,A50,083650,Miranda; Gregory Joseph,0,29,40,40
1650821985429,CSE 11,A01,083080,Cao; Yingjun,0,96,40,40
1650821991452,CSE 12,A01,083652,Staff,0,21,100,100
1650821997479,CSE 15L,A01,083654,Staff,0,3,50,50
1650821997479,CSE 15L,A02,083655,Staff,0,2,50,50
1650822003506,CSE 20,A01,083657,Staff,49,0,80,31
1650822009534,CSE 30,A01,083084,Eldon; John,0,75,40,40
1650822015643,CSE 100,A01,083659,Cao; Yingjun,0,71,50,50
1650822021666,CSE 134B,A01,083661,Powell; Thomas Allan,0,38,65,65
1650822027689,CSE 140,A01,083663,Staff,0,11,75,75
1650822033712,CSE 140L,A01,083088,Eldon; John,0,20,75,75
1650822039734,CSE 175,A01,083665,Kumar; Rakesh,7,0,25,18
1650822045764,CSE 190,A00,092507,Dubnov; Shlomo,10,0,20,10
1650822051788,ECE 45,A01,083139,Staff,0,1,60,60
1650822057811,ECE 65,A50,083695,Staff,0,5,30,30
1650822063837,ECE 109,A01,091882,Touri; Behrouz,32,0,70,38
1650822069860,ECE 180,A00,083140,Abi Samra; Nicholas Camill,20,0,30,10
1650822069860,ECE 180,B00,083141,Abi Samra; Nicholas Camill,0,0,30,30
1650822075883,MATH 10A,A01,083735,Patchell; Gregory David,2,0,30,28
1650822075883,MATH 10A,A02,083736,Patchell; Gregory David,27,0,30,3
1650822075883,MATH 10A,A03,083737,Patchell; Gregory David,24,0,30,6
1650822081906,MATH 10B,A01,083207,Staff,0,9,30,30
1650822081906,MATH 10B,A02,083208,Staff,0,6,30,30
1650822081906,MATH 10B,B01,083739,Staff,11,0,30,19
1650822081906,MATH 10B,B02,083740,Staff,28,0,30,2
1650822087931,MATH 18,A01,083743,Staff,0,0,30,30
1650822087931,MATH 18,A02,083744,Staff,23,0,30,7
1650822087931,MATH 18,A03,083745,Staff,21,0,30,9
1650822087931,MATH 18,A04,083746,Staff,26,0,30,4
1650822087931,MATH 18,B01,083748,Staff,0,15,30,30
1650822087931,MATH 18,B02,083749,Staff,0,12,30,30
1650822087931,MATH 18,B03,083750,Staff,0,12,30,30
1650822087931,MATH 18,B04,083751,Staff,0,12,30,30
1650822093955,MATH 20A,A01,083754,Staff,19,0,40,21
1650822099982,MATH 20B,A01,083756,Staff,0,13,30,30
1650822099982,MATH 20B,A02,083757,Staff,0,12,30,30
1650822106009,MATH 20C,A01,083760,Staff,0,17,30,30
1650822106009,MATH 20C,A02,083761,Staff,0,16,30,30
1650822106009,MATH 20C,B01,083762,Staff,9,0,30,21
1650822106009,MATH 20C,B02,083763,Staff,28,0,30,2
1650822112034,MATH 20D,A01,083765,Staff,2,1,30,28
1650822112034,MATH 20D,A02,083766,Staff,6,0,30,24
1650822112034,MATH 20D,A03,083767,Staff,24,0,30,6
1650822118058,MATH 20E,A01,083771,Staff,2,0,30,28
1650822118058,MATH 20E,A02,083772,Staff,15,0,30,15
1650822118058,MATH 20E,B01,083773,Staff,0,0,30,30
1650822118058,MATH 20E,B02,083774,Staff,5,0,30,25
1650822124083,MATH 103A,A01,083777,Staff,0,16,30,30
1650822124083,MATH 103A,A02,083778,Staff,0,15,30,30
1650822124083,MATH 103A,B01,083779,Staff,0,15,30,30
1650822124083,MATH 103A,B02,083780,Staff,0,15,30,30
1650822130105,MATH 105,A01,085443,Staff,0,22,30,30
1650822136133,MATH 109,A01,083213,Anzaldo; Leesa B,0,7,30,30
1650822136133,MATH 109,A02,083214,Anzaldo; Leesa B,0,7,30,30
1650822136133,MATH 109,B01,083215,Anzaldo; Leesa B,0,8,30,30
1650822136133,MATH 109,B02,083216,Anzaldo; Leesa B,0,7,30,30
1650822142157,MATH 142A,A01,083219,Chow; Bennett,0,16,30,30
1650822142157,MATH 142A,A02,083220,Chow; Bennett,0,15,30,30
1650822142157,MATH 142A,B01,083221,Chow; Bennett,0,16,30,30
1650822142157,MATH 142A,B02,083222,Chow; Bennett,0,14,30,30
1650822148180,MATH 193A,A01,083224,Staff,0,6,30,30
1650822148180,MATH 193A,A02,083225,Staff,0,6,30,30
1650822148180,MATH 193A,A03,083781,Staff,0,6,30,30
1650822148180,MATH 193A,A04,083782,Staff,0,7,30,30
1650822154204,MATH 197,001,091859,McAuley; Julian John,9998,0,9999,1
1650822160258,COGS 9,A01,083615,Staff,0,17,60,60
1650822166282,COGS 11,A01,083617,Boyle; Mary E. T.,16,0,40,24
1650822172304,COGS 13,A01,083071,Staff,0,38,40,40
1650822178330,COGS 14A,A01,092681,Staff,0,36,100,100
1650822184353,COGS 14B,A01,083073,Cheng; Tzu-Han,0,12,50,50
1650822190379,COGS 17,A01,092677,Staff,11,0,75,64
1650822196402,COGS 100,A01,083619,Staff,0,29,60,60
1650822202425,COGS 101A,A01,083621,Davis; Joshua Daniel,0,28,60,60
1650822208455,COGS 101B,A01,091572,Staff,0,3,60,60
1650822214479,COGS 101C,A01,083625,Delgado; Tania,14,0,30,16
1650822220502,COGS 107A,A01,083627,Boyle; Mary E. T.,0,16,60,60
1650822226529,COGS 118A,A01,083075,Staff,0,8,60,60
1650822232554,CSE 3,A50,083646,Miranda; Gregory Joseph,18,0,38,20
1650822232554,CSE 3,A51,083647,Miranda; Gregory Joseph,36,0,37,1
1650822238585,CSE 8A,A50,083650,Miranda; Gregory Joseph,0,29,40,40
1650822244609,CSE 11,A01,083080,Cao; Yingjun,0,96,40,40
1650822250636,CSE 12,A01,083652,Staff,0,21,100,100
1650822256660,CSE 15L,A01,083654,Staff,0,3,50,50
1650822256660,CSE 15L,A02,083655,Staff,0,2,50,50
1650822262686,CSE 20,A01,083657,Staff,49,0,80,31
1650822268712,CSE 30,A01,083084,Eldon; John,0,75,40,40
1650822274734,CSE 100,A01,083659,Cao; Yingjun,0,71,50,50
1650822280758,CSE 134B,A01,083661,Powell; Thomas Allan,0,38,65,65
1650822286783,CSE 140,A01,083663,Staff,0,11,75,75
1650822292813,CSE 140L,A01,083088,Eldon; John,0,20,75,75
1650822298836,CSE 175,A01,083665,Kumar; Rakesh,7,0,25,18
1650822304870,CSE 190,A00,092507,Dubnov; Shlomo,10,0,20,10
1650822310892,ECE 45,A01,083139,Staff,0,1,60,60
1650822316916,ECE 65,A50,083695,Staff,0,5,30,30
1650822322940,ECE 109,A01,091882,Touri; Behrouz,32,0,70,38
1650822328966,ECE 180,A00,083140,Abi Samra; Nicholas Camill,20,0,30,10
1650822328966,ECE 180,B00,083141,Abi Samra; Nicholas Camill,0,0,30,30
1650822334993,MATH 10A,A01,083735,Patchell; Gregory David,2,0,30,28
1650822334993,MATH 10A,A02,083736,Patchell; Gregory David,27,0,30,3
1650822334993,MATH 10A,A03,083737,Patchell; Gregory David,24,0,30,6
1650822341018,MATH 10B,A01,083207,Staff,0,9,30,30
1650822341018,MATH 10B,A02,083208,Staff,0,6,30,30
1650822341018,MATH 10B,B01,083739,Staff,11,0,30,19
1650822341018,MATH 10B,B02,083740,Staff,28,0,30,2
1650822347048,MATH 18,A01,083743,Staff,0,0,30,30
1650822347048,MATH 18,A02,083744,Staff,23,0,30,7
1650822347048,MATH 18,A03,083745,Staff,21,0,30,9
1650822347048,MATH 18,A04,083746,Staff,26,0,30,4
1650822347048,MATH 18,B01,083748,Staff,0,15,30,30
1650822347048,MATH 18,B02,083749,Staff,0,12,30,30
1650822347048,MATH 18,B03,083750,Staff,0,12,30,30
1650822347048,MATH 18,B04,083751,Staff,0,12,30,30
1650822353074,MATH 20A,A01,083754,Staff,19,0,40,21
1650822359098,MATH 20B,A01,083756,Staff,0,13,30,30
1650822359098,MATH 20B,A02,083757,Staff,0,12,30,30
1650822365121,MATH 20C,A01,083760,Staff,0,17,30,30
1650822365121,MATH 20C,A02,083761,Staff,0,16,30,30
1650822365121,MATH 20C,B01,083762,Staff,9,0,30,21
1650822365121,MATH 20C,B02,083763,Staff,28,0,30,2
1650822371143,MATH 20D,A01,083765,Staff,2,1,30,28
1650822371143,MATH 20D,A02,083766,Staff,6,0,30,24
1650822371143,MATH 20D,A03,083767,Staff,24,0,30,6
1650822377171,MATH 20E,A01,083771,Staff,2,0,30,28
1650822377171,MATH 20E,A02,083772,Staff,15,0,30,15
1650822377171,MATH 20E,B01,083773,Staff,0,0,30,30
1650822377171,MATH 20E,B02,083774,Staff,5,0,30,25
1650822383196,MATH 103A,A01,083777,Staff,0,16,30,30
1650822383196,MATH 103A,A02,083778,Staff,0,15,30,30
1650822383196,MATH 103A,B01,083779,Staff,0,15,30,30
1650822383196,MATH 103A,B02,083780,Staff,0,15,30,30
1650822389217,MATH 105,A01,085443,Staff,0,22,30,30
1650822395241,MATH 109,A01,083213,Anzaldo; Leesa B,0,7,30,30
1650822395241,MATH 109,A02,083214,Anzaldo; Leesa B,0,7,30,30
1650822395241,MATH 109,B01,083215,Anzaldo; Leesa B,0,8,30,30
1650822395241,MATH 109,B02,083216,Anzaldo; Leesa B,0,7,30,30
1650822401265,MATH 142A,A01,083219,Chow; Bennett,0,16,30,30
1650822401265,MATH 142A,A02,083220,Chow; Bennett,0,15,30,30
1650822401265,MATH 142A,B01,083221,Chow; Bennett,0,16,30,30
1650822401265,MATH 142A,B02,083222,Chow; Bennett,0,14,30,30
1650822407289,MATH 193A,A01,083224,Staff,0,6,30,30
1650822407289,MATH 193A,A02,083225,Staff,0,6,30,30
1650822407289,MATH 193A,A03,083781,Staff,0,6,30,30
1650822407289,MATH 193A,A04,083782,Staff,0,7,30,30
1650822413316,MATH 197,001,091859,McAuley; Julian John,9998,0,9999,1
1650822419385,COGS 9,A01,083615,Staff,0,17,60,60
1650822425411,COGS 11,A01,083617,Boyle; Mary E. T.,16,0,40,24
1650822431438,COGS 13,A01,083071,Staff,0,38,40,40
1650822437485,COGS 14A,A01,092681,Staff,0,36,100,100
1650822443510,COGS 14B,A01,083073,Cheng; Tzu-Han,0,12,50,50
1650822449532,COGS 17,A01,092677,Staff,11,0,75,64
1650822455555,COGS 100,A01,083619,Staff,0,29,60,60
1650822461579,COGS 101A,A01,083621,Davis; Joshua Daniel,0,28,60,60
1650822467605,COGS 101B,A01,091572,Staff,0,3,60,60
1650822473629,COGS 101C,A01,083625,Delgado; Tania,14,0,30,16
1650822479651,COGS 107A,A01,083627,Boyle; Mary E. T.,0,16,60,60
1650822485673,COGS 118A,A01,083075,Staff,0,8,60,60
1650822491701,CSE 3,A50,083646,Miranda; Gregory Joseph,18,0,38,20
1650822491701,CSE 3,A51,083647,Miranda; Gregory Joseph,36,0,37,1
1650822497725,CSE 8A,A50,083650,Miranda; Gregory Joseph,0,29,40,40
1650822503747,CSE 11,A01,083080,Cao; Yingjun,0,96,40,40
1650822509771,CSE 12,A01,083652,Staff,0,21,100,100
1650822515798,CSE 15L,A01,083654,Staff,0,3,50,50
1650822515798,CSE 15L,A02,083655,Staff,0,2,50,50
1650822521825,CSE 20,A01,083657,Staff,49,0,80,31
1650822527851,CSE 30,A01,083084,Eldon; John,0,75,40,40
1650822533874,CSE 100,A01,083659,Cao; Yingjun,0,71,50,50
1650822539901,CSE 134B,A01,083661,Powell; Thomas Allan,0,38,65,65
1650822545924,CSE 140,A01,083663,Staff,0,11,75,75
1650822551951,CSE 140L,A01,083088,Eldon; John,0,20,75,75
1650822557978,CSE 175,A01,083665,Kumar; Rakesh,7,0,25,18
1650822564011,CSE 190,A00,092507,Dubnov; Shlomo,10,0,20,10
1650822570034,ECE 45,A01,083139,Staff,0,1,60,60
1650822576058,ECE 65,A50,083695,Staff,0,5,30,30
1650822582082,ECE 109,A01,091882,Touri; Behrouz,32,0,70,38
1650822588104,ECE 180,A00,083140,Abi Samra; Nicholas Camill,20,0,30,10
1650822588104,ECE 180,B00,083141,Abi Samra; Nicholas Camill,0,0,30,30
1650822594127,MATH 10A,A01,083735,Patchell; Gregory David,2,0,30,28
1650822594127,MATH 10A,A02,083736,Patchell; Gregory David,27,0,30,3
1650822594127,MATH 10A,A03,083737,Patchell; Gregory David,24,0,30,6
1650822600157,MATH 10B,A01,083207,Staff,0,9,30,30
1650822600157,MATH 10B,A02,083208,Staff,0,6,30,30
1650822600157,MATH 10B,B01,083739,Staff,11,0,30,19
1650822600157,MATH 10B,B02,083740,Staff,28,0,30,2
1650822606188,MATH 18,A01,083743,Staff,0,0,30,30
1650822606188,MATH 18,A02,083744,Staff,23,0,30,7
1650822606188,MATH 18,A03,083745,Staff,21,0,30,9
1650822606188,MATH 18,A04,083746,Staff,26,0,30,4
1650822606188,MATH 18,B01,083748,Staff,0,15,30,30
1650822606188,MATH 18,B02,083749,Staff,0,12,30,30
1650822606188,MATH 18,B03,083750,Staff,0,12,30,30
1650822606188,MATH 18,B04,083751,Staff,0,12,30,30
1650822613518,MATH 20A,A01,083754,Staff,19,0,40,21
1650822619541,MATH 20B,A01,083756,Staff,0,13,30,30
1650822619541,MATH 20B,A02,083757,Staff,0,12,30,30
1650822625565,MATH 20C,A01,083760,Staff,0,17,30,30
1650822625565,MATH 20C,A02,083761,Staff,0,16,30,30
1650822625565,MATH 20C,B01,083762,Staff,9,0,30,21
1650822625565,MATH 20C,B02,083763,Staff,28,0,30,2
1650822631589,MATH 20D,A01,083765,Staff,2,1,30,28
1650822631589,MATH 20D,A02,083766,Staff,6,0,30,24
1650822631589,MATH 20D,A03,083767,Staff,24,0,30,6
1650822637618,MATH 20E,A01,083771,Staff,2,0,30,28
1650822637618,MATH 20E,A02,083772,Staff,15,0,30,15
1650822637618,MATH 20E,B01,083773,Staff,0,0,30,30
1650822637618,MATH 20E,B02,083774,Staff,5,0,30,25
1650822643640,MATH 103A,A01,083777,Staff,0,16,30,30
1650822643640,MATH 103A,A02,083778,Staff,0,15,30,30
1650822643640,MATH 103A,B01,083779,Staff,0,15,30,30
1650822643640,MATH 103A,B02,083780,Staff,0,15,30,30
1650822649663,MATH 105,A01,085443,Staff,0,22,30,30
1650822655686,MATH 109,A01,083213,Anzaldo; Leesa B,0,7,30,30
1650822655686,MATH 109,A02,083214,Anzaldo; Leesa B,0,7,30,30
1650822655686,MATH 109,B01,083215,Anzaldo; Leesa B,0,8,30,30
1650822655686,MATH 109,B02,083216,Anzaldo; Leesa B,0,7,30,30
1650822661715,MATH 142A,A01,083219,Chow; Bennett,0,16,30,30
1650822661715,MATH 142A,A02,083220,Chow; Bennett,0,15,30,30
1650822661715,MATH 142A,B01,083221,Chow; Bennett,0,16,30,30
1650822661715,MATH 142A,B02,083222,Chow; Bennett,0,14,30,30
1650822667738,MATH 193A,A01,083224,Staff,0,6,30,30
1650822667738,MATH 193A,A02,083225,Staff,0,6,30,30
1650822667738,MATH 193A,A03,083781,Staff,0,6,30,30
1650822667738,MATH 193A,A04,083782,Staff,0,7,30,30
1650822673761,MATH 197,001,091859,McAuley; Julian John,9998,0,9999,1
1650822679815,COGS 9,A01,083615,Staff,0,17,60,60
1650822685839,COGS 11,A01,083617,Boyle; Mary E. T.,15,0,40,25
1650822691865,COGS 13,A01,083071,Staff,0,38,40,40
1650822697889,COGS 14A,A01,092681,Staff,0,36,100,100
1650822703913,COGS 14B,A01,083073,Cheng; Tzu-Han,0,12,50,50
1650822709939,COGS 17,A01,092677,Staff,11,0,75,64
1650822715964,COGS 100,A01,083619,Staff,0,29,60,60
1650822721991,COGS 101A,A01,083621,Davis; Joshua Daniel,0,28,60,60
1650822728016,COGS 101B,A01,091572,Staff,0,3,60,60
1650822734038,COGS 101C,A01,083625,Delgado; Tania,14,0,30,16
1650822740063,COGS 107A,A01,083627,Boyle; Mary E. T.,0,16,60,60
1650822746089,COGS 118A,A01,083075,Staff,0,8,60,60
1650822752113,CSE 3,A50,083646,Miranda; Gregory Joseph,18,0,38,20
1650822752113,CSE 3,A51,083647,Miranda; Gregory Joseph,36,0,37,1
1650822758137,CSE 8A,A50,083650,Miranda; Gregory Joseph,0,29,40,40
1650822764161,CSE 11,A01,083080,Cao; Yingjun,0,96,40,40
1650822770185,CSE 12,A01,083652,Staff,0,21,100,100
1650822776209,CSE 15L,A01,083654,Staff,0,3,50,50
1650822776209,CSE 15L,A02,083655,Staff,0,2,50,50
1650822782233,CSE 20,A01,083657,Staff,49,0,80,31
1650822788258,CSE 30,A01,083084,Eldon; John,0,75,40,40
1650822794282,CSE 100,A01,083659,Cao; Yingjun,0,71,50,50
1650822800317,CSE 134B,A01,083661,Powell; Thomas Allan,0,38,65,65
1650822806339,CSE 140,A01,083663,Staff,0,11,75,75
1650822812361,CSE 140L,A01,083088,Eldon; John,0,20,75,75
1650822818385,CSE 175,A01,083665,Kumar; Rakesh,7,0,25,18
1650822824406,CSE 190,A00,092507,Dubnov; Shlomo,10,0,20,10
1650822830430,ECE 45,A01,083139,Staff,0,1,60,60
1650822836456,ECE 65,A50,083695,Staff,0,5,30,30
1650822842479,ECE 109,A01,091882,Touri; Behrouz,32,0,70,38
1650822848501,ECE 180,A00,083140,Abi Samra; Nicholas Camill,20,0,30,10
1650822848501,ECE 180,B00,083141,Abi Samra; Nicholas Camill,0,0,30,30
1650822854527,MATH 10A,A01,083735,Patchell; Gregory David,2,0,30,28
1650822854527,MATH 10A,A02,083736,Patchell; Gregory David,27,0,30,3
1650822854527,MATH 10A,A03,083737,Patchell; Gregory David,24,0,30,6
1650822860550,MATH 10B,A01,083207,Staff,0,9,30,30
1650822860550,MATH 10B,A02,083208,Staff,0,6,30,30
1650822860550,MATH 10B,B01,083739,Staff,11,0,30,19
1650822860550,MATH 10B,B02,083740,Staff,28,0,30,2
1650822866579,MATH 18,A01,083743,Staff,0,0,30,30
1650822866579,MATH 18,A02,083744,Staff,23,0,30,7
1650822866579,MATH 18,A03,083745,Staff,21,0,30,9
1650822866579,MATH 18,A04,083746,Staff,26,0,30,4
1650822866579,MATH 18,B01,083748,Staff,0,15,30,30
1650822866579,MATH 18,B02,083749,Staff,0,12,30,30
1650822866579,MATH 18,B03,083750,Staff,0,12,30,30
1650822866579,MATH 18,B04,083751,Staff,0,12,30,30
1650822872604,MATH 20A,A01,083754,Staff,19,0,40,21
1650822878631,MATH 20B,A01,083756,Staff,0,13,30,30
1650822878631,MATH 20B,A02,083757,Staff,0,12,30,30
1650822884653,MATH 20C,A01,083760,Staff,0,17,30,30
1650822884653,MATH 20C,A02,083761,Staff,0,16,30,30
1650822884653,MATH 20C,B01,083762,Staff,9,0,30,21
1650822884653,MATH 20C,B02,083763,Staff,28,0,30,2
1650822890675,MATH 20D,A01,083765,Staff,2,1,30,28
1650822890675,MATH 20D,A02,083766,Staff,6,0,30,24
1650822890675,MATH 20D,A03,083767,Staff,24,0,30,6
1650822896699,MATH 20E,A01,083771,Staff,2,0,30,28
1650822896699,MATH 20E,A02,083772,Staff,15,0,30,15
1650822896699,MATH 20E,B01,083773,Staff,0,0,30,30
1650822896699,MATH 20E,B02,083774,Staff,5,0,30,25
1650822902722,MATH 103A,A01,083777,Staff,0,16,30,30
1650822902722,MATH 103A,A02,083778,Staff,0,15,30,30
1650822902722,MATH 103A,B01,083779,Staff,0,15,30,30
1650822902722,MATH 103A,B02,083780,Staff,0,15,30,30
1650822908746,MATH 105,A01,085443,Staff,0,22,30,30
1650822914770,MATH 109,A01,083213,Anzaldo; Leesa B,0,7,30,30
1650822914770,MATH 109,A02,083214,Anzaldo; Leesa B,0,7,30,30
1650822914770,MATH 109,B01,083215,Anzaldo; Leesa B,0,8,30,30
1650822914770,MATH 109,B02,083216,Anzaldo; Leesa B,0,7,30,30
1650822920798,MATH 142A,A01,083219,Chow; Bennett,0,16,30,30
1650822920798,MATH 142A,A02,083220,Chow; Bennett,0,15,30,30
1650822920798,MATH 142A,B01,083221,Chow; Bennett,0,16,30,30
1650822920798,MATH 142A,B02,083222,Chow; Bennett,0,14,30,30
1650822926828,MATH 193A,A01,083224,Staff,0,6,30,30
1650822926828,MATH 193A,A02,083225,Staff,0,6,30,30
1650822926828,MATH 193A,A03,083781,Staff,0,6,30,30
1650822926828,MATH 193A,A04,083782,Staff,0,7,30,30
1650822932852,MATH 197,001,091859,McAuley; Julian John,9998,0,9999,1
1650822938903,COGS 9,A01,083615,Staff,0,17,60,60
1650822944927,COGS 11,A01,083617,Boyle; Mary E. T.,15,0,40,25
1650822950959,COGS 13,A01,083071,Staff,0,38,40,40
1650822956982,COGS 14A,A01,092681,Staff,0,36,100,100
1650822963007,COGS 14B,A01,083073,Cheng; Tzu-Han,0,12,50,50
1650822969029,COGS 17,A01,092677,Staff,11,0,75,64
1650822975051,COGS 100,A01,083619,Staff,0,29,60,60
1650822981075,COGS 101A,A01,083621,Davis; Joshua Daniel,0,28,60,60
1650822987099,COGS 101B,A01,091572,Staff,0,3,60,60
1650822993123,COGS 101C,A01,083625,Delgado; Tania,14,0,30,16
1650822999147,COGS 107A,A01,083627,Boyle; Mary E. T.,0,16,60,60
1650823005170,COGS 118A,A01,083075,Staff,0,8,60,60
1650823011198,CSE 3,A50,083646,Miranda; Gregory Joseph,18,0,38,20
1650823011198,CSE 3,A51,083647,Miranda; Gregory Joseph,36,0,37,1
1650823017222,CSE 8A,A50,083650,Miranda; Gregory Joseph,0,29,40,40
1650823023254,CSE 11,A01,083080,Cao; Yingjun,0,96,40,40
1650823029277,CSE 12,A01,083652,Staff,0,21,100,100
1650823035300,CSE 15L,A01,083654,Staff,0,3,50,50
1650823035300,CSE 15L,A02,083655,Staff,0,2,50,50
1650823041328,CSE 20,A01,083657,Staff,49,0,80,31
1650823047354,CSE 30,A01,083084,Eldon; John,0,75,40,40
1650823053381,CSE 100,A01,083659,Cao; Yingjun,0,71,50,50
1650823059409,CSE 134B,A01,083661,Powell; Thomas Allan,0,38,65,65
1650823065432,CSE 140,A01,083663,Staff,0,11,75,75
1650823071454,CSE 140L,A01,083088,Eldon; John,0,20,75,75
1650823077479,CSE 175,A01,083665,Kumar; Rakesh,7,0,25,18
1650823083506,CSE 190,A00,092507,Dubnov; Shlomo,10,0,20,10
1650823089532,ECE 45,A01,083139,Staff,0,1,60,60
1650823095559,ECE 65,A50,083695,Staff,0,5,30,30
1650823101588,ECE 109,A01,091882,Touri; Behrouz,32,0,70,38
1650823107615,ECE 180,A00,083140,Abi Samra; Nicholas Camill,20,0,30,10
1650823107615,ECE 180,B00,083141,Abi Samra; Nicholas Camill,0,0,30,30
1650823113639,MATH 10A,A01,083735,Patchell; Gregory David,2,0,30,28
1650823113639,MATH 10A,A02,083736,Patchell; Gregory David,27,0,30,3
1650823113639,MATH 10A,A03,083737,Patchell; Gregory David,24,0,30,6
1650823119667,MATH 10B,A01,083207,Staff,0,9,30,30
1650823119667,MATH 10B,A02,083208,Staff,0,6,30,30
1650823119667,MATH 10B,B01,083739,Staff,11,0,30,19
1650823119667,MATH 10B,B02,083740,Staff,28,0,30,2
1650823125692,MATH 18,A01,083743,Staff,0,0,30,30
1650823125692,MATH 18,A02,083744,Staff,23,0,30,7
1650823125692,MATH 18,A03,083745,Staff,21,0,30,9
1650823125692,MATH 18,A04,083746,Staff,26,0,30,4
1650823125692,MATH 18,B01,083748,Staff,0,15,30,30
1650823125692,MATH 18,B02,083749,Staff,0,12,30,30
1650823125692,MATH 18,B03,083750,Staff,0,12,30,30
1650823125692,MATH 18,B04,083751,Staff,0,12,30,30
1650823131720,MATH 20A,A01,083754,Staff,19,0,40,21
1650823137754,MATH 20B,A01,083756,Staff,0,13,30,30
1650823137754,MATH 20B,A02,083757,Staff,0,12,30,30
1650823143777,MATH 20C,A01,083760,Staff,0,17,30,30
1650823143777,MATH 20C,A02,083761,Staff,0,16,30,30
1650823143777,MATH 20C,B01,083762,Staff,9,0,30,21
1650823143777,MATH 20C,B02,083763,Staff,28,0,30,2
1650823149801,MATH 20D,A01,083765,Staff,2,1,30,28
1650823149801,MATH 20D,A02,083766,Staff,6,0,30,24
1650823149801,MATH 20D,A03,083767,Staff,24,0,30,6
1650823155829,MATH 20E,A01,083771,Staff,2,0,30,28
1650823155829,MATH 20E,A02,083772,Staff,15,0,30,15
1650823155829,MATH 20E,B01,083773,Staff,0,0,30,30
1650823155829,MATH 20E,B02,083774,Staff,5,0,30,25
1650823161858,MATH 103A,A01,083777,Staff,0,16,30,30
1650823161858,MATH 103A,A02,083778,Staff,0,15,30,30
1650823161858,MATH 103A,B01,083779,Staff,0,15,30,30
1650823161858,MATH 103A,B02,083780,Staff,0,15,30,30
1650823167886,MATH 105,A01,085443,Staff,0,22,30,30
1650823173911,MATH 109,A01,083213,Anzaldo; Leesa B,0,7,30,30
1650823173911,MATH 109,A02,083214,Anzaldo; Leesa B,0,7,30,30
1650823173911,MATH 109,B01,083215,Anzaldo; Leesa B,0,8,30,30
1650823173911,MATH 109,B02,083216,Anzaldo; Leesa B,0,7,30,30
1650823179936,MATH 142A,A01,083219,Chow; Bennett,0,16,30,30
1650823179936,MATH 142A,A02,083220,Chow; Bennett,0,15,30,30
1650823179936,MATH 142A,B01,083221,Chow; Bennett,0,16,30,30
1650823179936,MATH 142A,B02,083222,Chow; Bennett,0,14,30,30
1650823185960,MATH 193A,A01,083224,Staff,0,6,30,30
1650823185960,MATH 193A,A02,083225,Staff,0,6,30,30
1650823185960,MATH 193A,A03,083781,Staff,0,6,30,30
1650823185960,MATH 193A,A04,083782,Staff,0,7,30,30
1650823191983,MATH 197,001,091859,McAuley; Julian John,9998,0,9999,1
1650823198034,COGS 9,A01,083615,Staff,0,17,60,60
1650823204887,COGS 11,A01,083617,Boyle; Mary E. T.,15,0,40,25
1650823210914,COGS 13,A01,083071,Staff,0,38,40,40
1650823216937,COGS 14A,A01,092681,Staff,0,36,100,100
1650823222960,COGS 14B,A01,083073,Cheng; Tzu-Han,0,12,50,50
1650823228982,COGS 17,A01,092677,Staff,11,0,75,64
1650823235015,COGS 100,A01,083619,Staff,0,29,60,60
1650823241042,COGS 101A,A01,083621,Davis; Joshua Daniel,0,28,60,60
1650823247066,COGS 101B,A01,091572,Staff,0,3,60,60
1650823253089,COGS 101C,A01,083625,Delgado; Tania,14,0,30,16
1650823259114,COGS 107A,A01,083627,Boyle; Mary E. T.,0,16,60,60
1650823265140,COGS 118A,A01,083075,Staff,0,8,60,60
1650823271166,CSE 3,A50,083646,Miranda; Gregory Joseph,18,0,38,20
1650823271166,CSE 3,A51,083647,Miranda; Gregory Joseph,36,0,37,1
1650823277189,CSE 8A,A50,083650,Miranda; Gregory Joseph,0,29,40,40
1650823283224,CSE 11,A01,083080,Cao; Yingjun,0,96,40,40
1650823289247,CSE 12,A01,083652,Staff,0,21,100,100
1650823295274,CSE 15L,A01,083654,Staff,0,3,50,50
1650823295274,CSE 15L,A02,083655,Staff,0,2,50,50
1650823301296,CSE 20,A01,083657,Staff,49,0,80,31
1650823307319,CSE 30,A01,083084,Eldon; John,0,75,40,40
1650823313345,CSE 100,A01,083659,Cao; Yingjun,0,71,50,50
1650823319368,CSE 134B,A01,083661,Powell; Thomas Allan,0,38,65,65
1650823325392,CSE 140,A01,083663,Staff,0,11,75,75
1650823331426,CSE 140L,A01,083088,Eldon; John,0,20,75,75
1650823337449,CSE 175,A01,083665,Kumar; Rakesh,7,0,25,18
1650823343475,CSE 190,A00,092507,Dubnov; Shlomo,10,0,20,10
1650823349501,ECE 45,A01,083139,Staff,0,1,60,60
1650823355526,ECE 65,A50,083695,Staff,0,5,30,30
1650823361547,ECE 109,A01,091882,Touri; Behrouz,32,0,70,38
1650823367570,ECE 180,A00,083140,Abi Samra; Nicholas Camill,20,0,30,10
1650823367570,ECE 180,B00,083141,Abi Samra; Nicholas Camill,0,0,30,30
1650823373603,MATH 10A,A01,083735,Patchell; Gregory David,2,0,30,28
1650823373603,MATH 10A,A02,083736,Patchell; Gregory David,27,0,30,3
1650823373603,MATH 10A,A03,083737,Patchell; Gregory David,24,0,30,6
1650823379625,MATH 10B,A01,083207,Staff,0,9,30,30
1650823379625,MATH 10B,A02,083208,Staff,0,6,30,30
1650823379625,MATH 10B,B01,083739,Staff,11,0,30,19
1650823379625,MATH 10B,B02,083740,Staff,28,0,30,2
1650823385656,MATH 18,A01,083743,Staff,0,0,30,30
1650823385656,MATH 18,A02,083744,Staff,23,0,30,7
1650823385656,MATH 18,A03,083745,Staff,21,0,30,9
1650823385656,MATH 18,A04,083746,Staff,26,0,30,4
1650823385656,MATH 18,B01,083748,Staff,0,15,30,30
1650823385656,MATH 18,B02,083749,Staff,0,12,30,30
1650823385656,MATH 18,B03,083750,Staff,0,12,30,30
1650823385656,MATH 18,B04,083751,Staff,0,12,30,30
1650823391680,MATH 20A,A01,083754,Staff,19,0,40,21
1650823397703,MATH 20B,A01,083756,Staff,0,13,30,30
1650823397703,MATH 20B,A02,083757,Staff,0,12,30,30
1650823403726,MATH 20C,A01,083760,Staff,0,17,30,30
1650823403726,MATH 20C,A02,083761,Staff,0,16,30,30
1650823403726,MATH 20C,B01,083762,Staff,9,0,30,21
1650823403726,MATH 20C,B02,083763,Staff,28,0,30,2
1650823409749,MATH 20D,A01,083765,Staff,2,1,30,28
1650823409749,MATH 20D,A02,083766,Staff,6,0,30,24
1650823409749,MATH 20D,A03,083767,Staff,24,0,30,6
1650823415772,MATH 20E,A01,083771,Staff,2,0,30,28
1650823415772,MATH 20E,A02,083772,Staff,15,0,30,15
1650823415772,MATH 20E,B01,083773,Staff,0,0,30,30
1650823415772,MATH 20E,B02,083774,Staff,5,0,30,25
1650823421801,MATH 103A,A01,083777,Staff,0,16,30,30
1650823421801,MATH 103A,A02,083778,Staff,0,15,30,30
1650823421801,MATH 103A,B01,083779,Staff,0,15,30,30
1650823421801,MATH 103A,B02,083780,Staff,0,15,30,30
1650823427830,MATH 105,A01,085443,Staff,0,22,30,30
1650823433856,MATH 109,A01,083213,Anzaldo; Leesa B,0,7,30,30
1650823433856,MATH 109,A02,083214,Anzaldo; Leesa B,0,7,30,30
1650823433856,MATH 109,B01,083215,Anzaldo; Leesa B,0,8,30,30
1650823433856,MATH 109,B02,083216,Anzaldo; Leesa B,0,7,30,30
1650823439883,MATH 142A,A01,083219,Chow; Bennett,0,16,30,30
1650823439883,MATH 142A,A02,083220,Chow; Bennett,0,15,30,30
1650823439883,MATH 142A,B01,083221,Chow; Bennett,0,16,30,30
1650823439883,MATH 142A,B02,083222,Chow; Bennett,0,14,30,30
1650823445911,MATH 193A,A01,083224,Staff,0,6,30,30
1650823445911,MATH 193A,A02,083225,Staff,0,6,30,30
1650823445911,MATH 193A,A03,083781,Staff,0,6,30,30
1650823445911,MATH 193A,A04,083782,Staff,0,7,30,30
1650823451937,MATH 197,001,091859,McAuley; Julian John,9998,0,9999,1
1650823457996,COGS 9,A01,083615,Staff,0,17,60,60
1650823464018,COGS 11,A01,083617,Boyle; Mary E. T.,15,0,40,25
1650823470042,COGS 13,A01,083071,Staff,0,38,40,40
1650823476069,COGS 14A,A01,092681,Staff,0,36,100,100
1650823482095,COGS 14B,A01,083073,Cheng; Tzu-Han,0,12,50,50
1650823488123,COGS 17,A01,092677,Staff,11,0,75,64
1650823494157,COGS 100,A01,083619,Staff,0,29,60,60
1650823500179,COGS 101A,A01,083621,Davis; Joshua Daniel,0,28,60,60
1650823506202,COGS 101B,A01,091572,Staff,0,3,60,60
1650823512229,COGS 101C,A01,083625,Delgado; Tania,14,0,30,16
1650823518252,COGS 107A,A01,083627,Boyle; Mary E. T.,0,16,60,60
1650823524277,COGS 118A,A01,083075,Staff,0,8,60,60
1650823530301,CSE 3,A50,083646,Miranda; Gregory Joseph,18,0,38,20
1650823530301,CSE 3,A51,083647,Miranda; Gregory Joseph,36,0,37,1
1650823536324,CSE 8A,A50,083650,Miranda; Gregory Joseph,0,29,40,40
1650823542346,CSE 11,A01,083080,Cao; Yingjun,0,96,40,40
1650823548369,CSE 12,A01,083652,Staff,0,21,100,100
1650823554400,CSE 15L,A01,083654,Staff,0,3,50,50
1650823554400,CSE 15L,A02,083655,Staff,0,2,50,50
1650823560428,CSE 20,A01,083657,Staff,49,0,80,31
1650823566453,CSE 30,A01,083084,Eldon; John,0,75,40,40
1650823572476,CSE 100,A01,083659,Cao; Yingjun,0,71,50,50
1650823578499,CSE 134B,A01,083661,Powell; Thomas Allan,0,38,65,65
1650823584526,CSE 140,A01,083663,Staff,0,11,75,75
1650823590550,CSE 140L,A01,083088,Eldon; John,0,20,75,75
1650823596573,CSE 175,A01,083665,Kumar; Rakesh,7,0,25,18
1650823602597,CSE 190,A00,092507,Dubnov; Shlomo,10,0,20,10
1650823608621,ECE 45,A01,083139,Staff,0,1,60,60
1650823614649,ECE 65,A50,083695,Staff,0,5,30,30
1650823620676,ECE 109,A01,091882,Touri; Behrouz,32,0,70,38
1650823626699,ECE 180,A00,083140,Abi Samra; Nicholas Camill,20,0,30,10
1650823626699,ECE 180,B00,083141,Abi Samra; Nicholas Camill,0,0,30,30
1650823632721,MATH 10A,A01,083735,Patchell; Gregory David,2,0,30,28
1650823632721,MATH 10A,A02,083736,Patchell; Gregory David,27,0,30,3
1650823632721,MATH 10A,A03,083737,Patchell; Gregory David,24,0,30,6
1650823638749,MATH 10B,A01,083207,Staff,0,9,30,30
1650823638749,MATH 10B,A02,083208,Staff,0,6,30,30
1650823638749,MATH 10B,B01,083739,Staff,11,0,30,19
1650823638749,MATH 10B,B02,083740,Staff,28,0,30,2
1650823644772,MATH 18,A01,083743,Staff,0,0,30,30
1650823644772,MATH 18,A02,083744,Staff,23,0,30,7
1650823644772,MATH 18,A03,083745,Staff,21,0,30,9
1650823644772,MATH 18,A04,083746,Staff,26,0,30,4
1650823644772,MATH 18,B01,083748,Staff,0,15,30,30
1650823644772,MATH 18,B02,083749,Staff,0,12,30,30
1650823644772,MATH 18,B03,083750,Staff,0,12,30,30
1650823644772,MATH 18,B04,083751,Staff,0,12,30,30
1650823650797,MATH 20A,A01,083754,Staff,19,0,40,21
1650823656821,MATH 20B,A01,083756,Staff,0,13,30,30
1650823656821,MATH 20B,A02,083757,Staff,0,12,30,30
1650823662845,MATH 20C,A01,083760,Staff,0,17,30,30
1650823662845,MATH 20C,A02,083761,Staff,0,16,30,30
1650823662845,MATH 20C,B01,083762,Staff,9,0,30,21
1650823662845,MATH 20C,B02,083763,Staff,28,0,30,2
1650823668876,MATH 20D,A01,083765,Staff,2,1,30,28
1650823668876,MATH 20D,A02,083766,Staff,6,0,30,24
1650823668876,MATH 20D,A03,083767,Staff,24,0,30,6
1650823674900,MATH 20E,A01,083771,Staff,2,0,30,28
1650823674900,MATH 20E,A02,083772,Staff,15,0,30,15
1650823674900,MATH 20E,B01,083773,Staff,0,0,30,30
1650823674900,MATH 20E,B02,083774,Staff,5,0,30,25
1650823680925,MATH 103A,A01,083777,Staff,0,16,30,30
1650823680925,MATH 103A,A02,083778,Staff,0,15,30,30
1650823680925,MATH 103A,B01,083779,Staff,0,15,30,30
1650823680925,MATH 103A,B02,083780,Staff,0,15,30,30
1650823686951,MATH 105,A01,085443,Staff,0,22,30,30
1650823692979,MATH 109,A01,083213,Anzaldo; Leesa B,0,7,30,30
1650823692979,MATH 109,A02,083214,Anzaldo; Leesa B,0,7,30,30
1650823692979,MATH 109,B01,083215,Anzaldo; Leesa B,0,8,30,30
1650823692979,MATH 109,B02,083216,Anzaldo; Leesa B,0,7,30,30
1650823699007,MATH 142A,A01,083219,Chow; Bennett,0,16,30,30
1650823699007,MATH 142A,A02,083220,Chow; Bennett,0,15,30,30
1650823699007,MATH 142A,B01,083221,Chow; Bennett,0,16,30,30
1650823699007,MATH 142A,B02,083222,Chow; Bennett,0,14,30,30
1650823705035,MATH 193A,A01,083224,Staff,0,6,30,30
1650823705035,MATH 193A,A02,083225,Staff,0,6,30,30
1650823705035,MATH 193A,A03,083781,Staff,0,6,30,30
1650823705035,MATH 193A,A04,083782,Staff,0,7,30,30
1650823711057,MATH 197,001,091859,McAuley; Julian John,9998,0,9999,1
1650823717108,COGS 9,A01,083615,Staff,0,17,60,60
1650823723131,COGS 11,A01,083617,Boyle; Mary E. T.,15,0,40,25
1650823729157,COGS 13,A01,083071,Staff,0,38,40,40
1650823735180,COGS 14A,A01,092681,Staff,0,36,100,100
1650823741204,COGS 14B,A01,083073,Cheng; Tzu-Han,0,12,50,50
1650823747230,COGS 17,A01,092677,Staff,11,0,75,64
1650823753255,COGS 100,A01,083619,Staff,0,29,60,60
1650823759280,COGS 101A,A01,083621,Davis; Joshua Daniel,0,28,60,60
1650823765308,COGS 101B,A01,091572,Staff,0,3,60,60
1650823771330,COGS 101C,A01,083625,Delgado; Tania,14,0,30,16
1650823777356,COGS 107A,A01,083627,Boyle; Mary E. T.,0,16,60,60
1650823783383,COGS 118A,A01,083075,Staff,0,8,60,60
1650823789405,CSE 3,A50,083646,Miranda; Gregory Joseph,18,0,38,20
1650823789405,CSE 3,A51,083647,Miranda; Gregory Joseph,36,0,37,1
1650823795429,CSE 8A,A50,083650,Miranda; Gregory Joseph,0,29,40,40
1650823801541,CSE 11,A01,083080,Cao; Yingjun,0,96,40,40
1650823807568,CSE 12,A01,083652,Staff,0,21,100,100
1650823813594,CSE 15L,A01,083654,Staff,0,3,50,50
1650823813594,CSE 15L,A02,083655,Staff,0,2,50,50
1650823819630,CSE 20,A01,083657,Staff,49,0,80,31
1650823825662,CSE 30,A01,083084,Eldon; John,0,75,40,40
1650823831686,CSE 100,A01,083659,Cao; Yingjun,0,71,50,50
1650823837708,CSE 134B,A01,083661,Powell; Thomas Allan,0,38,65,65
1650823843733,CSE 140,A01,083663,Staff,0,11,75,75
1650823849755,CSE 140L,A01,083088,Eldon; John,0,20,75,75
1650823855781,CSE 175,A01,083665,Kumar; Rakesh,7,0,25,18
1650823861808,CSE 190,A00,092507,Dubnov; Shlomo,10,0,20,10
1650823867831,ECE 45,A01,083139,Staff,0,1,60,60
1650823873854,ECE 65,A50,083695,Staff,0,5,30,30
1650823879880,ECE 109,A01,091882,Touri; Behrouz,32,0,70,38
1650823885907,ECE 180,A00,083140,Abi Samra; Nicholas Camill,20,0,30,10
1650823885907,ECE 180,B00,083141,Abi Samra; Nicholas Camill,0,0,30,30
1650823891930,MATH 10A,A01,083735,Patchell; Gregory David,2,0,30,28
1650823891930,MATH 10A,A02,083736,Patchell; Gregory David,27,0,30,3
1650823891930,MATH 10A,A03,083737,Patchell; Gregory David,24,0,30,6
1650823897956,MATH 10B,A01,083207,Staff,0,9,30,30
1650823897956,MATH 10B,A02,083208,Staff,0,6,30,30
1650823897956,MATH 10B,B01,083739,Staff,11,0,30,19
1650823897956,MATH 10B,B02,083740,Staff,28,0,30,2
1650823903982,MATH 18,A01,083743,Staff,0,0,30,30
1650823903982,MATH 18,A02,083744,Staff,23,0,30,7
1650823903982,MATH 18,A03,083745,Staff,21,0,30,9
1650823903982,MATH 18,A04,083746,Staff,26,0,30,4
1650823903982,MATH 18,B01,083748,Staff,0,15,30,30
1650823903982,MATH 18,B02,083749,Staff,0,12,30,30
1650823903982,MATH 18,B03,083750,Staff,0,12,30,30
1650823903982,MATH 18,B04,083751,Staff,0,12,30,30
1650823910011,MATH 20A,A01,083754,Staff,19,0,40,21
1650823916044,MATH 20B,A01,083756,Staff,0,13,30,30
1650823916044,MATH 20B,A02,083757,Staff,0,12,30,30
1650823922073,MATH 20C,A01,083760,Staff,0,17,30,30
1650823922073,MATH 20C,A02,083761,Staff,0,16,30,30
1650823922073,MATH 20C,B01,083762,Staff,9,0,30,21
1650823922073,MATH 20C,B02,083763,Staff,28,0,30,2
1650823928098,MATH 20D,A01,083765,Staff,2,1,30,28
1650823928098,MATH 20D,A02,083766,Staff,6,0,30,24
1650823928098,MATH 20D,A03,083767,Staff,24,0,30,6
1650823934121,MATH 20E,A01,083771,Staff,2,0,30,28
1650823934121,MATH 20E,A02,083772,Staff,15,0,30,15
1650823934121,MATH 20E,B01,083773,Staff,0,0,30,30
1650823934121,MATH 20E,B02,083774,Staff,5,0,30,25
1650823940150,MATH 103A,A01,083777,Staff,0,16,30,30
1650823940150,MATH 103A,A02,083778,Staff,0,15,30,30
1650823940150,MATH 103A,B01,083779,Staff,0,15,30,30
1650823940150,MATH 103A,B02,083780,Staff,0,15,30,30
1650823946173,MATH 105,A01,085443,Staff,0,22,30,30
1650823952196,MATH 109,A01,083213,Anzaldo; Leesa B,0,7,30,30
1650823952196,MATH 109,A02,083214,Anzaldo; Leesa B,0,7,30,30
1650823952196,MATH 109,B01,083215,Anzaldo; Leesa B,0,8,30,30
1650823952196,MATH 109,B02,083216,Anzaldo; Leesa B,0,7,30,30
1650823958219,MATH 142A,A01,083219,Chow; Bennett,0,16,30,30
1650823958219,MATH 142A,A02,083220,Chow; Bennett,0,15,30,30
1650823958219,MATH 142A,B01,083221,Chow; Bennett,0,16,30,30
1650823958219,MATH 142A,B02,083222,Chow; Bennett,0,14,30,30
1650823964248,MATH 193A,A01,083224,Staff,0,6,30,30
1650823964248,MATH 193A,A02,083225,Staff,0,6,30,30
1650823964248,MATH 193A,A03,083781,Staff,0,6,30,30
1650823964248,MATH 193A,A04,083782,Staff,0,7,30,30
1650823970275,MATH 197,001,091859,McAuley; Julian John,9998,0,9999,1
1650823976342,COGS 9,A01,083615,Staff,0,17,60,60
1650823982365,COGS 11,A01,083617,Boyle; Mary E. T.,15,0,40,25
1650823988388,COGS 13,A01,083071,Staff,0,38,40,40
1650823994413,COGS 14A,A01,092681,Staff,0,36,100,100
1650824000438,COGS 14B,A01,083073,Cheng; Tzu-Han,0,12,50,50
1650824006461,COGS 17,A01,092677,Staff,11,0,75,64
1650824012486,COGS 100,A01,083619,Staff,0,29,60,60
1650824018513,COGS 101A,A01,083621,Davis; Joshua Daniel,0,28,60,60
1650824024537,COGS 101B,A01,091572,Staff,0,3,60,60
1650824030560,COGS 101C,A01,083625,Delgado; Tania,14,0,30,16
1650824036584,COGS 107A,A01,083627,Boyle; Mary E. T.,0,16,60,60
1650824042610,COGS 118A,A01,083075,Staff,0,8,60,60
1650824048643,CSE 3,A50,083646,Miranda; Gregory Joseph,18,0,38,20
1650824048643,CSE 3,A51,083647,Miranda; Gregory Joseph,36,0,37,1
1650824054669,CSE 8A,A50,083650,Miranda; Gregory Joseph,0,29,40,40
1650824060696,CSE 11,A01,083080,Cao; Yingjun,0,96,40,40
1650824066722,CSE 12,A01,083652,Staff,0,21,100,100
1650824072746,CSE 15L,A01,083654,Staff,0,3,50,50
1650824072746,CSE 15L,A02,083655,Staff,0,2,50,50
1650824078769,CSE 20,A01,083657,Staff,49,0,80,31
1650824084797,CSE 30,A01,083084,Eldon; John,0,75,40,40
1650824090819,CSE 100,A01,083659,Cao; Yingjun,0,71,50,50
1650824096845,CSE 134B,A01,083661,Powell; Thomas Allan,0,38,65,65
1650824102872,CSE 140,A01,083663,Staff,0,11,75,75
1650824108906,CSE 140L,A01,083088,Eldon; John,0,20,75,75
1650824114929,CSE 175,A01,083665,Kumar; Rakesh,7,0,25,18
1650824120955,CSE 190,A00,092507,Dubnov; Shlomo,10,0,20,10
1650824126983,ECE 45,A01,083139,Staff,0,1,60,60
1650824133015,ECE 65,A50,083695,Staff,0,5,30,30
1650824139040,ECE 109,A01,091882,Touri; Behrouz,32,0,70,38
1650824145067,ECE 180,A00,083140,Abi Samra; Nicholas Camill,20,0,30,10
1650824145067,ECE 180,B00,083141,Abi Samra; Nicholas Camill,0,0,30,30
1650824151095,MATH 10A,A01,083735,Patchell; Gregory David,2,0,30,28
1650824151095,MATH 10A,A02,083736,Patchell; Gregory David,27,0,30,3
1650824151095,MATH 10A,A03,083737,Patchell; Gregory David,24,0,30,6
1650824157123,MATH 10B,A01,083207,Staff,0,9,30,30
1650824157123,MATH 10B,A02,083208,Staff,0,6,30,30
1650824157123,MATH 10B,B01,083739,Staff,11,0,30,19
1650824157123,MATH 10B,B02,083740,Staff,28,0,30,2
1650824163160,MATH 18,A01,083743,Staff,0,0,30,30
1650824163160,MATH 18,A02,083744,Staff,23,0,30,7
1650824163160,MATH 18,A03,083745,Staff,21,0,30,9
1650824163160,MATH 18,A04,083746,Staff,26,0,30,4
1650824163160,MATH 18,B01,083748,Staff,0,15,30,30
1650824163160,MATH 18,B02,083749,Staff,0,12,30,30
1650824163160,MATH 18,B03,083750,Staff,0,12,30,30
1650824163160,MATH 18,B04,083751,Staff,0,12,30,30
1650824169183,MATH 20A,A01,083754,Staff,19,0,40,21
1650824175211,MATH 20B,A01,083756,Staff,0,13,30,30
1650824175211,MATH 20B,A02,083757,Staff,0,12,30,30
1650824181235,MATH 20C,A01,083760,Staff,0,17,30,30
1650824181235,MATH 20C,A02,083761,Staff,0,16,30,30
1650824181235,MATH 20C,B01,083762,Staff,9,0,30,21
1650824181235,MATH 20C,B02,083763,Staff,28,0,30,2
1650824187259,MATH 20D,A01,083765,Staff,2,1,30,28
1650824187259,MATH 20D,A02,083766,Staff,6,0,30,24
1650824187259,MATH 20D,A03,083767,Staff,24,0,30,6
1650824193287,MATH 20E,A01,083771,Staff,2,0,30,28
1650824193287,MATH 20E,A02,083772,Staff,15,0,30,15
1650824193287,MATH 20E,B01,083773,Staff,0,0,30,30
1650824193287,MATH 20E,B02,083774,Staff,5,0,30,25
1650824199313,MATH 103A,A01,083777,Staff,0,16,30,30
1650824199313,MATH 103A,A02,083778,Staff,0,15,30,30
1650824199313,MATH 103A,B01,083779,Staff,0,15,30,30
1650824199313,MATH 103A,B02,083780,Staff,0,15,30,30
1650824205337,MATH 105,A01,085443,Staff,0,22,30,30
1650824211362,MATH 109,A01,083213,Anzaldo; Leesa B,0,7,30,30
1650824211362,MATH 109,A02,083214,Anzaldo; Leesa B,0,7,30,30
1650824211362,MATH 109,B01,083215,Anzaldo; Leesa B,0,8,30,30
1650824211362,MATH 109,B02,083216,Anzaldo; Leesa B,0,7,30,30
1650824217389,MATH 142A,A01,083219,Chow; Bennett,0,16,30,30
1650824217389,MATH 142A,A02,083220,Chow; Bennett,0,15,30,30
1650824217389,MATH 142A,B01,083221,Chow; Bennett,0,16,30,30
1650824217389,MATH 142A,B02,083222,Chow; Bennett,0,14,30,30
1650824223413,MATH 193A,A01,083224,Staff,0,6,30,30
1650824223413,MATH 193A,A02,083225,Staff,0,6,30,30
1650824223413,MATH 193A,A03,083781,Staff,0,6,30,30
1650824223413,MATH 193A,A04,083782,Staff,0,7,30,30
1650824229444,MATH 197,001,091859,McAuley; Julian John,9998,0,9999,1
1650824235507,COGS 9,A01,083615,Staff,0,17,60,60
1650824241530,COGS 11,A01,083617,Boyle; Mary E. T.,15,0,40,25
1650824247553,COGS 13,A01,083071,Staff,0,38,40,40
1650824253580,COGS 14A,A01,092681,Staff,0,36,100,100
1650824259604,COGS 14B,A01,083073,Cheng; Tzu-Han,0,12,50,50
1650824265627,COGS 17,A01,092677,Staff,11,0,75,64
1650824271651,COGS 100,A01,083619,Staff,0,29,60,60
1650824277675,COGS 101A,A01,083621,Davis; Joshua Daniel,0,28,60,60
1650824283703,COGS 101B,A01,091572,Staff,0,3,60,60
1650824289730,COGS 101C,A01,083625,Delgado; Tania,14,0,30,16
1650824295756,COGS 107A,A01,083627,Boyle; Mary E. T.,0,16,60,60
1650824301780,COGS 118A,A01,083075,Staff,0,8,60,60
1650824307802,CSE 3,A50,083646,Miranda; Gregory Joseph,18,0,38,20
1650824307802,CSE 3,A51,083647,Miranda; Gregory Joseph,36,0,37,1
1650824313830,CSE 8A,A50,083650,Miranda; Gregory Joseph,0,29,40,40
1650824319857,CSE 11,A01,083080,Cao; Yingjun,0,96,40,40
1650824325885,CSE 12,A01,083652,Staff,0,21,100,100
1650824331911,CSE 15L,A01,083654,Staff,0,3,50,50
1650824331911,CSE 15L,A02,083655,Staff,0,2,50,50
1650824337935,CSE 20,A01,083657,Staff,49,0,80,31
1650824343959,CSE 30,A01,083084,Eldon; John,0,75,40,40
1650824349986,CSE 100,A01,083659,Cao; Yingjun,0,71,50,50
1650824356009,CSE 134B,A01,083661,Powell; Thomas Allan,0,38,65,65
1650824362041,CSE 140,A01,083663,Staff,0,11,75,75
1650824368064,CSE 140L,A01,083088,Eldon; John,0,20,75,75
1650824374088,CSE 175,A01,083665,Kumar; Rakesh,7,0,25,18
1650824380122,CSE 190,A00,092507,Dubnov; Shlomo,10,0,20,10
1650824386146,ECE 45,A01,083139,Staff,0,1,60,60
1650824392170,ECE 65,A50,083695,Staff,0,5,30,30
1650824398295,ECE 109,A01,091882,Touri; Behrouz,32,0,70,38
1650824404321,ECE 180,A00,083140,Abi Samra; Nicholas Camill,20,0,30,10
1650824404321,ECE 180,B00,083141,Abi Samra; Nicholas Camill,0,0,30,30
1650824410349,MATH 10A,A01,083735,Patchell; Gregory David,2,0,30,28
1650824410349,MATH 10A,A02,083736,Patchell; Gregory David,27,0,30,3
1650824410349,MATH 10A,A03,083737,Patchell; Gregory David,24,0,30,6
1650824416377,MATH 10B,A01,083207,Staff,0,9,30,30
1650824416377,MATH 10B,A02,083208,Staff,0,6,30,30
1650824416377,MATH 10B,B01,083739,Staff,11,0,30,19
1650824416377,MATH 10B,B02,083740,Staff,28,0,30,2
1650824422402,MATH 18,A01,083743,Staff,0,0,30,30
1650824422402,MATH 18,A02,083744,Staff,23,0,30,7
1650824422402,MATH 18,A03,083745,Staff,21,0,30,9
1650824422402,MATH 18,A04,083746,Staff,26,0,30,4
1650824422402,MATH 18,B01,083748,Staff,0,15,30,30
1650824422402,MATH 18,B02,083749,Staff,0,12,30,30
1650824422402,MATH 18,B03,083750,Staff,0,12,30,30
1650824422402,MATH 18,B04,083751,Staff,0,12,30,30
1650824428434,MATH 20A,A01,083754,Staff,19,0,40,21
1650824434480,MATH 20B,A01,083756,Staff,0,13,30,30
1650824434480,MATH 20B,A02,083757,Staff,0,12,30,30
1650824440508,MATH 20C,A01,083760,Staff,0,17,30,30
1650824440508,MATH 20C,A02,083761,Staff,0,16,30,30
1650824440508,MATH 20C,B01,083762,Staff,9,0,30,21
1650824440508,MATH 20C,B02,083763,Staff,28,0,30,2
1650824446531,MATH 20D,A01,083765,Staff,2,1,30,28
1650824446531,MATH 20D,A02,083766,Staff,6,0,30,24
1650824446531,MATH 20D,A03,083767,Staff,24,0,30,6
1650824452564,MATH 20E,A01,083771,Staff,2,0,30,28
1650824452564,MATH 20E,A02,083772,Staff,15,0,30,15
1650824452564,MATH 20E,B01,083773,Staff,0,0,30,30
1650824452564,MATH 20E,B02,083774,Staff,5,0,30,25
1650824458592,MATH 103A,A01,083777,Staff,0,16,30,30
1650824458592,MATH 103A,A02,083778,Staff,0,15,30,30
1650824458592,MATH 103A,B01,083779,Staff,0,15,30,30
1650824458592,MATH 103A,B02,083780,Staff,0,15,30,30
1650824464615,MATH 105,A01,085443,Staff,0,22,30,30
1650824470639,MATH 109,A01,083213,Anzaldo; Leesa B,0,7,30,30
1650824470639,MATH 109,A02,083214,Anzaldo; Leesa B,0,7,30,30
1650824470639,MATH 109,B01,083215,Anzaldo; Leesa B,0,8,30,30
1650824470639,MATH 109,B02,083216,Anzaldo; Leesa B,0,7,30,30
1650824476663,MATH 142A,A01,083219,Chow; Bennett,0,16,30,30
1650824476663,MATH 142A,A02,083220,Chow; Bennett,0,15,30,30
1650824476663,MATH 142A,B01,083221,Chow; Bennett,0,16,30,30
1650824476663,MATH 142A,B02,083222,Chow; Bennett,0,14,30,30
1650824482688,MATH 193A,A01,083224,Staff,0,6,30,30
1650824482688,MATH 193A,A02,083225,Staff,0,6,30,30
1650824482688,MATH 193A,A03,083781,Staff,0,6,30,30
1650824482688,MATH 193A,A04,083782,Staff,0,7,30,30
1650824488714,MATH 197,001,091859,McAuley; Julian John,9998,0,9999,1
1650824494779,COGS 9,A01,083615,Staff,0,17,60,60
1650824500802,COGS 11,A01,083617,Boyle; Mary E. T.,15,0,40,25
1650824506825,COGS 13,A01,083071,Staff,0,38,40,40
1650824512850,COGS 14A,A01,092681,Staff,0,36,100,100
1650824518878,COGS 14B,A01,083073,Cheng; Tzu-Han,0,12,50,50
1650824524903,COGS 17,A01,092677,Staff,11,0,75,64
1650824530931,COGS 100,A01,083619,Staff,0,29,60,60
1650824536954,COGS 101A,A01,083621,Davis; Joshua Daniel,0,28,60,60
1650824542978,COGS 101B,A01,091572,Staff,0,3,60,60
1650824549003,COGS 101C,A01,083625,Delgado; Tania,14,0,30,16
1650824555043,COGS 107A,A01,083627,Boyle; Mary E. T.,0,16,60,60
1650824561069,COGS 118A,A01,083075,Staff,0,8,60,60
1650824567093,CSE 3,A50,083646,Miranda; Gregory Joseph,18,0,38,20
1650824567093,CSE 3,A51,083647,Miranda; Gregory Joseph,36,0,37,1
1650824573116,CSE 8A,A50,083650,Miranda; Gregory Joseph,0,29,40,40
1650824579138,CSE 11,A01,083080,Cao; Yingjun,0,96,40,40
1650824585164,CSE 12,A01,083652,Staff,0,21,100,100
1650824591190,CSE 15L,A01,083654,Staff,0,3,50,50
1650824591190,CSE 15L,A02,083655,Staff,0,2,50,50
1650824597213,CSE 20,A01,083657,Staff,49,0,80,31
1650824603243,CSE 30,A01,083084,Eldon; John,0,75,40,40
1650824609274,CSE 100,A01,083659,Cao; Yingjun,0,71,50,50
1650824615301,CSE 134B,A01,083661,Powell; Thomas Allan,0,38,65,65
1650824621323,CSE 140,A01,083663,Staff,0,11,75,75
1650824627347,CSE 140L,A01,083088,Eldon; John,0,20,75,75
1650824633382,CSE 175,A01,083665,Kumar; Rakesh,7,0,25,18
1650824639406,CSE 190,A00,092507,Dubnov; Shlomo,10,0,20,10
1650824645432,ECE 45,A01,083139,Staff,0,1,60,60
1650824651461,ECE 65,A50,083695,Staff,0,5,30,30
1650824657483,ECE 109,A01,091882,Touri; Behrouz,32,0,70,38
1650824663506,ECE 180,A00,083140,Abi Samra; Nicholas Camill,20,0,30,10
1650824663506,ECE 180,B00,083141,Abi Samra; Nicholas Camill,0,0,30,30
1650824669529,MATH 10A,A01,083735,Patchell; Gregory David,2,0,30,28
1650824669529,MATH 10A,A02,083736,Patchell; Gregory David,27,0,30,3
1650824669529,MATH 10A,A03,083737,Patchell; Gregory David,24,0,30,6
1650824675557,MATH 10B,A01,083207,Staff,0,9,30,30
1650824675557,MATH 10B,A02,083208,Staff,0,6,30,30
1650824675557,MATH 10B,B01,083739,Staff,11,0,30,19
1650824675557,MATH 10B,B02,083740,Staff,28,0,30,2
1650824681584,MATH 18,A01,083743,Staff,0,0,30,30
1650824681584,MATH 18,A02,083744,Staff,23,0,30,7
1650824681584,MATH 18,A03,083745,Staff,21,0,30,9
1650824681584,MATH 18,A04,083746,Staff,26,0,30,4
1650824681584,MATH 18,B01,083748,Staff,0,15,30,30
1650824681584,MATH 18,B02,083749,Staff,0,12,30,30
1650824681584,MATH 18,B03,083750,Staff,0,12,30,30
1650824681584,MATH 18,B04,083751,Staff,0,12,30,30
1650824687612,MATH 20A,A01,083754,Staff,19,0,40,21
1650824693635,MATH 20B,A01,083756,Staff,0,13,30,30
1650824693635,MATH 20B,A02,083757,Staff,0,12,30,30
1650824699659,MATH 20C,A01,083760,Staff,0,17,30,30
1650824699659,MATH 20C,A02,083761,Staff,0,16,30,30
1650824699659,MATH 20C,B01,083762,Staff,9,0,30,21
1650824699659,MATH 20C,B02,083763,Staff,28,0,30,2
1650824705681,MATH 20D,A01,083765,Staff,2,1,30,28
1650824705681,MATH 20D,A02,083766,Staff,6,0,30,24
1650824705681,MATH 20D,A03,083767,Staff,24,0,30,6
1650824711703,MATH 20E,A01,083771,Staff,2,0,30,28
1650824711703,MATH 20E,A02,083772,Staff,15,0,30,15
1650824711703,MATH 20E,B01,083773,Staff,0,0,30,30
1650824711703,MATH 20E,B02,083774,Staff,5,0,30,25
1650824717726,MATH 103A,A01,083777,Staff,0,16,30,30
1650824717726,MATH 103A,A02,083778,Staff,0,15,30,30
1650824717726,MATH 103A,B01,083779,Staff,0,15,30,30
1650824717726,MATH 103A,B02,083780,Staff,0,15,30,30
1650824723754,MATH 105,A01,085443,Staff,0,22,30,30
1650824729780,MATH 109,A01,083213,Anzaldo; Leesa B,0,7,30,30
1650824729780,MATH 109,A02,083214,Anzaldo; Leesa B,0,7,30,30
1650824729780,MATH 109,B01,083215,Anzaldo; Leesa B,0,8,30,30
1650824729780,MATH 109,B02,083216,Anzaldo; Leesa B,0,7,30,30
1650824735804,MATH 142A,A01,083219,Chow; Bennett,0,16,30,30
1650824735804,MATH 142A,A02,083220,Chow; Bennett,0,15,30,30
1650824735804,MATH 142A,B01,083221,Chow; Bennett,0,16,30,30
1650824735804,MATH 142A,B02,083222,Chow; Bennett,0,14,30,30
1650824741827,MATH 193A,A01,083224,Staff,0,6,30,30
1650824741827,MATH 193A,A02,083225,Staff,0,6,30,30
1650824741827,MATH 193A,A03,083781,Staff,0,6,30,30
1650824741827,MATH 193A,A04,083782,Staff,0,7,30,30
1650824747852,MATH 197,001,091859,McAuley; Julian John,9998,0,9999,1
1650824753907,COGS 9,A01,083615,Staff,0,17,60,60
1650824759930,COGS 11,A01,083617,Boyle; Mary E. T.,15,0,40,25
1650824765958,COGS 13,A01,083071,Staff,0,38,40,40
1650824771979,COGS 14A,A01,092681,Staff,0,36,100,100
1650824778003,COGS 14B,A01,083073,Cheng; Tzu-Han,0,12,50,50
1650824784027,COGS 17,A01,092677,Staff,11,0,75,64
1650824790051,COGS 100,A01,083619,Staff,0,29,60,60
1650824796077,COGS 101A,A01,083621,Davis; Joshua Daniel,0,28,60,60
1650824802105,COGS 101B,A01,091572,Staff,0,3,60,60
1650824808128,COGS 101C,A01,083625,Delgado; Tania,14,0,30,16
1650824814153,COGS 107A,A01,083627,Boyle; Mary E. T.,0,16,60,60
1650824820176,COGS 118A,A01,083075,Staff,0,8,60,60
1650824826205,CSE 3,A50,083646,Miranda; Gregory Joseph,18,0,38,20
1650824826205,CSE 3,A51,083647,Miranda; Gregory Joseph,36,0,37,1
1650824832233,CSE 8A,A50,083650,Miranda; Gregory Joseph,0,29,40,40
1650824838258,CSE 11,A01,083080,Cao; Yingjun,0,96,40,40
1650824844282,CSE 12,A01,083652,Staff,0,21,100,100
1650824850305,CSE 15L,A01,083654,Staff,0,3,50,50
1650824850305,CSE 15L,A02,083655,Staff,0,2,50,50
1650824856328,CSE 20,A01,083657,Staff,49,0,80,31
1650824862350,CSE 30,A01,083084,Eldon; John,0,75,40,40
1650824868378,CSE 100,A01,083659,Cao; Yingjun,0,71,50,50
1650824874401,CSE 134B,A01,083661,Powell; Thomas Allan,0,38,65,65
1650824880424,CSE 140,A01,083663,Staff,0,11,75,75
1650824886447,CSE 140L,A01,083088,Eldon; John,0,20,75,75
1650824892476,CSE 175,A01,083665,Kumar; Rakesh,7,0,25,18
1650824898501,CSE 190,A00,092507,Dubnov; Shlomo,10,0,20,10
1650824904527,ECE 45,A01,083139,Staff,0,1,60,60
1650824910551,ECE 65,A50,083695,Staff,0,5,30,30
1650824916575,ECE 109,A01,091882,Touri; Behrouz,32,0,70,38
1650824922600,ECE 180,A00,083140,Abi Samra; Nicholas Camill,20,0,30,10
1650824922600,ECE 180,B00,083141,Abi Samra; Nicholas Camill,0,0,30,30
1650824928624,MATH 10A,A01,083735,Patchell; Gregory David,2,0,30,28
1650824928624,MATH 10A,A02,083736,Patchell; Gregory David,27,0,30,3
1650824928624,MATH 10A,A03,083737,Patchell; Gregory David,24,0,30,6
1650824934647,MATH 10B,A01,083207,Staff,0,9,30,30
1650824934647,MATH 10B,A02,083208,Staff,0,6,30,30
1650824934647,MATH 10B,B01,083739,Staff,11,0,30,19
1650824934647,MATH 10B,B02,083740,Staff,28,0,30,2
1650824940676,MATH 18,A01,083743,Staff,0,0,30,30
1650824940676,MATH 18,A02,083744,Staff,23,0,30,7
1650824940676,MATH 18,A03,083745,Staff,21,0,30,9
1650824940676,MATH 18,A04,083746,Staff,26,0,30,4
1650824940676,MATH 18,B01,083748,Staff,0,15,30,30
1650824940676,MATH 18,B02,083749,Staff,0,12,30,30
1650824940676,MATH 18,B03,083750,Staff,0,12,30,30
1650824940676,MATH 18,B04,083751,Staff,0,12,30,30
1650824946700,MATH 20A,A01,083754,Staff,19,0,40,21
1650824952728,MATH 20B,A01,083756,Staff,0,13,30,30
1650824952728,MATH 20B,A02,083757,Staff,0,12,30,30
1650824958753,MATH 20C,A01,083760,Staff,0,17,30,30
1650824958753,MATH 20C,A02,083761,Staff,0,16,30,30
1650824958753,MATH 20C,B01,083762,Staff,9,0,30,21
1650824958753,MATH 20C,B02,083763,Staff,28,0,30,2
1650824964778,MATH 20D,A01,083765,Staff,2,1,30,28
1650824964778,MATH 20D,A02,083766,Staff,6,0,30,24
1650824964778,MATH 20D,A03,083767,Staff,24,0,30,6
1650824970804,MATH 20E,A01,083771,Staff,2,0,30,28
1650824970804,MATH 20E,A02,083772,Staff,15,0,30,15
1650824970804,MATH 20E,B01,083773,Staff,0,0,30,30
1650824970804,MATH 20E,B02,083774,Staff,5,0,30,25
1650824976832,MATH 103A,A01,083777,Staff,0,16,30,30
1650824976832,MATH 103A,A02,083778,Staff,0,15,30,30
1650824976832,MATH 103A,B01,083779,Staff,0,15,30,30
1650824976832,MATH 103A,B02,083780,Staff,0,15,30,30
1650824982858,MATH 105,A01,085443,Staff,0,22,30,30
1650824988891,MATH 109,A01,083213,Anzaldo; Leesa B,0,7,30,30
1650824988891,MATH 109,A02,083214,Anzaldo; Leesa B,0,7,30,30
1650824988891,MATH 109,B01,083215,Anzaldo; Leesa B,0,8,30,30
1650824988891,MATH 109,B02,083216,Anzaldo; Leesa B,0,7,30,30
1650824995003,MATH 142A,A01,083219,Chow; Bennett,0,16,30,30
1650824995003,MATH 142A,A02,083220,Chow; Bennett,0,15,30,30
1650824995003,MATH 142A,B01,083221,Chow; Bennett,0,16,30,30
1650824995003,MATH 142A,B02,083222,Chow; Bennett,0,14,30,30
1650825001027,MATH 193A,A01,083224,Staff,0,6,30,30
1650825001027,MATH 193A,A02,083225,Staff,0,6,30,30
1650825001027,MATH 193A,A03,083781,Staff,0,6,30,30
1650825001027,MATH 193A,A04,083782,Staff,0,7,30,30
1650825007058,MATH 197,001,091859,McAuley; Julian John,9998,0,9999,1
1650825013117,COGS 9,A01,083615,Staff,0,17,60,60
1650825019150,COGS 11,A01,083617,Boyle; Mary E. T.,15,0,40,25
1650825025176,COGS 13,A01,083071,Staff,0,38,40,40
1650825031200,COGS 14A,A01,092681,Staff,0,36,100,100
1650825037224,COGS 14B,A01,083073,Cheng; Tzu-Han,0,12,50,50
1650825043250,COGS 17,A01,092677,Staff,11,0,75,64
1650825049276,COGS 100,A01,083619,Staff,0,29,60,60
1650825055300,COGS 101A,A01,083621,Davis; Joshua Daniel,0,28,60,60
1650825061324,COGS 101B,A01,091572,Staff,0,3,60,60
1650825067347,COGS 101C,A01,083625,Delgado; Tania,14,0,30,16
1650825073371,COGS 107A,A01,083627,Boyle; Mary E. T.,0,16,60,60
1650825079394,COGS 118A,A01,083075,Staff,0,8,60,60
1650825085417,CSE 3,A50,083646,Miranda; Gregory Joseph,18,0,38,20
1650825085417,CSE 3,A51,083647,Miranda; Gregory Joseph,36,0,37,1
1650825091444,CSE 8A,A50,083650,Miranda; Gregory Joseph,0,29,40,40
1650825097468,CSE 11,A01,083080,Cao; Yingjun,0,96,40,40
1650825103494,CSE 12,A01,083652,Staff,0,21,100,100
1650825109526,CSE 15L,A01,083654,Staff,0,3,50,50
1650825109526,CSE 15L,A02,083655,Staff,0,2,50,50
1650825115551,CSE 20,A01,083657,Staff,49,0,80,31
1650825121576,CSE 30,A01,083084,Eldon; John,0,75,40,40
1650825127615,CSE 100,A01,083659,Cao; Yingjun,0,71,50,50
1650825133641,CSE 134B,A01,083661,Powell; Thomas Allan,0,38,65,65
1650825139665,CSE 140,A01,083663,Staff,0,11,75,75
1650825145689,CSE 140L,A01,083088,Eldon; John,0,20,75,75
1650825151711,CSE 175,A01,083665,Kumar; Rakesh,7,0,25,18
1650825157734,CSE 190,A00,092507,Dubnov; Shlomo,10,0,20,10
1650825163756,ECE 45,A01,083139,Staff,0,1,60,60
1650825169781,ECE 65,A50,083695,Staff,0,5,30,30
1650825175807,ECE 109,A01,091882,Touri; Behrouz,32,0,70,38
1650825181829,ECE 180,A00,083140,Abi Samra; Nicholas Camill,20,0,30,10
1650825181829,ECE 180,B00,083141,Abi Samra; Nicholas Camill,0,0,30,30
1650825187853,MATH 10A,A01,083735,Patchell; Gregory David,2,0,30,28
1650825187853,MATH 10A,A02,083736,Patchell; Gregory David,27,0,30,3
1650825187853,MATH 10A,A03,083737,Patchell; Gregory David,24,0,30,6
1650825193877,MATH 10B,A01,083207,Staff,0,9,30,30
1650825193877,MATH 10B,A02,083208,Staff,0,6,30,30
1650825193877,MATH 10B,B01,083739,Staff,11,0,30,19
1650825193877,MATH 10B,B02,083740,Staff,28,0,30,2
1650825199905,MATH 18,A01,083743,Staff,0,0,30,30
1650825199905,MATH 18,A02,083744,Staff,23,0,30,7
1650825199905,MATH 18,A03,083745,Staff,21,0,30,9
1650825199905,MATH 18,A04,083746,Staff,26,0,30,4
1650825199905,MATH 18,B01,083748,Staff,0,15,30,30
1650825199905,MATH 18,B02,083749,Staff,0,12,30,30
1650825199905,MATH 18,B03,083750,Staff,0,12,30,30
1650825199905,MATH 18,B04,083751,Staff,0,12,30,30
1650825205933,MATH 20A,A01,083754,Staff,19,0,40,21
1650825211960,MATH 20B,A01,083756,Staff,0,13,30,30
1650825211960,MATH 20B,A02,083757,Staff,0,12,30,30
1650825217982,MATH 20C,A01,083760,Staff,0,17,30,30
1650825217982,MATH 20C,A02,083761,Staff,0,16,30,30
1650825217982,MATH 20C,B01,083762,Staff,9,0,30,21
1650825217982,MATH 20C,B02,083763,Staff,28,0,30,2
1650825224006,MATH 20D,A01,083765,Staff,2,1,30,28
1650825224006,MATH 20D,A02,083766,Staff,6,0,30,24
1650825224006,MATH 20D,A03,083767,Staff,24,0,30,6
1650825230030,MATH 20E,A01,083771,Staff,2,0,30,28
1650825230030,MATH 20E,A02,083772,Staff,15,0,30,15
1650825230030,MATH 20E,B01,083773,Staff,0,0,30,30
1650825230030,MATH 20E,B02,083774,Staff,5,0,30,25
1650825236057,MATH 103A,A01,083777,Staff,0,16,30,30
1650825236057,MATH 103A,A02,083778,Staff,0,15,30,30
1650825236057,MATH 103A,B01,083779,Staff,0,15,30,30
1650825236057,MATH 103A,B02,083780,Staff,0,15,30,30
1650825242080,MATH 105,A01,085443,Staff,0,22,30,30
1650825248109,MATH 109,A01,083213,Anzaldo; Leesa B,0,7,30,30
1650825248109,MATH 109,A02,083214,Anzaldo; Leesa B,0,7,30,30
1650825248109,MATH 109,B01,083215,Anzaldo; Leesa B,0,8,30,30
1650825248109,MATH 109,B02,083216,Anzaldo; Leesa B,0,7,30,30
1650825254131,MATH 142A,A01,083219,Chow; Bennett,0,16,30,30
1650825254131,MATH 142A,A02,083220,Chow; Bennett,0,15,30,30
1650825254131,MATH 142A,B01,083221,Chow; Bennett,0,16,30,30
1650825254131,MATH 142A,B02,083222,Chow; Bennett,0,14,30,30
1650825260154,MATH 193A,A01,083224,Staff,0,6,30,30
1650825260154,MATH 193A,A02,083225,Staff,0,6,30,30
1650825260154,MATH 193A,A03,083781,Staff,0,6,30,30
1650825260154,MATH 193A,A04,083782,Staff,0,7,30,30
1650825266184,MATH 197,001,091859,McAuley; Julian John,9998,0,9999,1
1650825272232,COGS 9,A01,083615,Staff,0,17,60,60
1650825278258,COGS 11,A01,083617,Boyle; Mary E. T.,15,0,40,25
1650825284282,COGS 13,A01,083071,Staff,0,38,40,40
1650825290305,COGS 14A,A01,092681,Staff,0,36,100,100
1650825296344,COGS 14B,A01,083073,Cheng; Tzu-Han,0,12,50,50
1650825302366,COGS 17,A01,092677,Staff,11,0,75,64
1650825308388,COGS 100,A01,083619,Staff,0,29,60,60
1650825314414,COGS 101A,A01,083621,Davis; Joshua Daniel,0,28,60,60
1650825320435,COGS 101B,A01,091572,Staff,0,3,60,60
1650825326465,COGS 101C,A01,083625,Delgado; Tania,14,0,30,16
1650825332488,COGS 107A,A01,083627,Boyle; Mary E. T.,0,16,60,60
1650825338509,COGS 118A,A01,083075,Staff,0,8,60,60
1650825344536,CSE 3,A50,083646,Miranda; Gregory Joseph,18,0,38,20
1650825344536,CSE 3,A51,083647,Miranda; Gregory Joseph,36,0,37,1
1650825350568,CSE 8A,A50,083650,Miranda; Gregory Joseph,0,29,40,40
1650825356590,CSE 11,A01,083080,Cao; Yingjun,0,96,40,40
1650825362614,CSE 12,A01,083652,Staff,0,21,100,100
1650825368640,CSE 15L,A01,083654,Staff,0,3,50,50
1650825368640,CSE 15L,A02,083655,Staff,0,2,50,50
1650825374667,CSE 20,A01,083657,Staff,49,0,80,31
1650825380703,CSE 30,A01,083084,Eldon; John,0,75,40,40
1650825386730,CSE 100,A01,083659,Cao; Yingjun,0,71,50,50
1650825392754,CSE 134B,A01,083661,Powell; Thomas Allan,0,38,65,65
1650825398793,CSE 140,A01,083663,Staff,0,11,75,75
1650825404820,CSE 140L,A01,083088,Eldon; John,0,20,75,75
1650825410841,CSE 175,A01,083665,Kumar; Rakesh,7,0,25,18
1650825416869,CSE 190,A00,092507,Dubnov; Shlomo,10,0,20,10
1650825422892,ECE 45,A01,083139,Staff,0,1,60,60
1650825428916,ECE 65,A50,083695,Staff,0,5,30,30
1650825434940,ECE 109,A01,091882,Touri; Behrouz,32,0,70,38
1650825440964,ECE 180,A00,083140,Abi Samra; Nicholas Camill,20,0,30,10
1650825440964,ECE 180,B00,083141,Abi Samra; Nicholas Camill,0,0,30,30
1650825446988,MATH 10A,A01,083735,Patchell; Gregory David,2,0,30,28
1650825446988,MATH 10A,A02,083736,Patchell; Gregory David,27,0,30,3
1650825446988,MATH 10A,A03,083737,Patchell; Gregory David,24,0,30,6
1650825453012,MATH 10B,A01,083207,Staff,0,9,30,30
1650825453012,MATH 10B,A02,083208,Staff,0,6,30,30
1650825453012,MATH 10B,B01,083739,Staff,11,0,30,19
1650825453012,MATH 10B,B02,083740,Staff,28,0,30,2
1650825459043,MATH 18,A01,083743,Staff,0,0,30,30
1650825459043,MATH 18,A02,083744,Staff,23,0,30,7
1650825459043,MATH 18,A03,083745,Staff,21,0,30,9
1650825459043,MATH 18,A04,083746,Staff,26,0,30,4
1650825459043,MATH 18,B01,083748,Staff,0,15,30,30
1650825459043,MATH 18,B02,083749,Staff,0,12,30,30
1650825459043,MATH 18,B03,083750,Staff,0,12,30,30
1650825459043,MATH 18,B04,083751,Staff,0,12,30,30
1650825465066,MATH 20A,A01,083754,Staff,19,0,40,21
1650825471095,MATH 20B,A01,083756,Staff,0,13,30,30
1650825471095,MATH 20B,A02,083757,Staff,0,12,30,30
1650825477132,MATH 20C,A01,083760,Staff,0,17,30,30
1650825477132,MATH 20C,A02,083761,Staff,0,16,30,30
1650825477132,MATH 20C,B01,083762,Staff,9,0,30,21
1650825477132,MATH 20C,B02,083763,Staff,28,0,30,2
1650825483159,MATH 20D,A01,083765,Staff,2,1,30,28
1650825483159,MATH 20D,A02,083766,Staff,6,0,30,24
1650825483159,MATH 20D,A03,083767,Staff,24,0,30,6
1650825489183,MATH 20E,A01,083771,Staff,2,0,30,28
1650825489183,MATH 20E,A02,083772,Staff,15,0,30,15
1650825489183,MATH 20E,B01,083773,Staff,0,0,30,30
1650825489183,MATH 20E,B02,083774,Staff,5,0,30,25
1650825495208,MATH 103A,A01,083777,Staff,0,16,30,30
1650825495208,MATH 103A,A02,083778,Staff,0,15,30,30
1650825495208,MATH 103A,B01,083779,Staff,0,15,30,30
1650825495208,MATH 103A,B02,083780,Staff,0,15,30,30
1650825501231,MATH 105,A01,085443,Staff,0,22,30,30
1650825507263,MATH 109,A01,083213,Anzaldo; Leesa B,0,7,30,30
1650825507263,MATH 109,A02,083214,Anzaldo; Leesa B,0,7,30,30
1650825507263,MATH 109,B01,083215,Anzaldo; Leesa B,0,8,30,30
1650825507263,MATH 109,B02,083216,Anzaldo; Leesa B,0,7,30,30
1650825513291,MATH 142A,A01,083219,Chow; Bennett,0,16,30,30
1650825513291,MATH 142A,A02,083220,Chow; Bennett,0,15,30,30
1650825513291,MATH 142A,B01,083221,Chow; Bennett,0,16,30,30
1650825513291,MATH 142A,B02,083222,Chow; Bennett,0,14,30,30
1650825519313,MATH 193A,A01,083224,Staff,0,6,30,30
1650825519313,MATH 193A,A02,083225,Staff,0,6,30,30
1650825519313,MATH 193A,A03,083781,Staff,0,6,30,30
1650825519313,MATH 193A,A04,083782,Staff,0,7,30,30
1650825525337,MATH 197,001,091859,McAuley; Julian John,9998,0,9999,1
1650825531385,COGS 9,A01,083615,Staff,0,17,60,60
1650825537412,COGS 11,A01,083617,Boyle; Mary E. T.,15,0,40,25
1650825543439,COGS 13,A01,083071,Staff,0,38,40,40
1650825549463,COGS 14A,A01,092681,Staff,0,36,100,100
1650825555488,COGS 14B,A01,083073,Cheng; Tzu-Han,0,12,50,50
1650825561509,COGS 17,A01,092677,Staff,11,0,75,64
1650825567531,COGS 100,A01,083619,Staff,0,29,60,60
1650825573555,COGS 101A,A01,083621,Davis; Joshua Daniel,0,28,60,60
1650825579578,COGS 101B,A01,091572,Staff,0,3,60,60
1650825585688,COGS 101C,A01,083625,Delgado; Tania,14,0,30,16
1650825591712,COGS 107A,A01,083627,Boyle; Mary E. T.,0,16,60,60
1650825597735,COGS 118A,A01,083075,Staff,0,8,60,60
1650825603758,CSE 3,A50,083646,Miranda; Gregory Joseph,18,0,38,20
1650825603758,CSE 3,A51,083647,Miranda; Gregory Joseph,36,0,37,1
1650825609786,CSE 8A,A50,083650,Miranda; Gregory Joseph,0,29,40,40
1650825615808,CSE 11,A01,083080,Cao; Yingjun,0,96,40,40
1650825621832,CSE 12,A01,083652,Staff,0,21,100,100
1650825627856,CSE 15L,A01,083654,Staff,0,3,50,50
1650825627856,CSE 15L,A02,083655,Staff,0,2,50,50
1650825633878,CSE 20,A01,083657,Staff,49,0,80,31
1650825639912,CSE 30,A01,083084,Eldon; John,0,75,40,40
1650825645945,CSE 100,A01,083659,Cao; Yingjun,0,71,50,50
1650825651968,CSE 134B,A01,083661,Powell; Thomas Allan,0,38,65,65
1650825657997,CSE 140,A01,083663,Staff,0,11,75,75
1650825664029,CSE 140L,A01,083088,Eldon; John,0,20,75,75
1650825670054,CSE 175,A01,083665,Kumar; Rakesh,7,0,25,18
1650825676077,CSE 190,A00,092507,Dubnov; Shlomo,10,0,20,10
1650825682100,ECE 45,A01,083139,Staff,0,1,60,60
1650825688126,ECE 65,A50,083695,Staff,0,5,30,30
1650825694150,ECE 109,A01,091882,Touri; Behrouz,32,0,70,38
1650825700186,ECE 180,A00,083140,Abi Samra; Nicholas Camill,20,0,30,10
1650825700186,ECE 180,B00,083141,Abi Samra; Nicholas Camill,0,0,30,30
1650825706209,MATH 10A,A01,083735,Patchell; Gregory David,2,0,30,28
1650825706209,MATH 10A,A02,083736,Patchell; Gregory David,27,0,30,3
1650825706209,MATH 10A,A03,083737,Patchell; Gregory David,24,0,30,6
1650825712235,MATH 10B,A01,083207,Staff,0,9,30,30
1650825712235,MATH 10B,A02,083208,Staff,0,6,30,30
1650825712235,MATH 10B,B01,083739,Staff,11,0,30,19
1650825712235,MATH 10B,B02,083740,Staff,28,0,30,2
1650825718266,MATH 18,A01,083743,Staff,0,0,30,30
1650825718266,MATH 18,A02,083744,Staff,23,0,30,7
1650825718266,MATH 18,A03,083745,Staff,21,0,30,9
1650825718266,MATH 18,A04,083746,Staff,26,0,30,4
1650825718266,MATH 18,B01,083748,Staff,0,15,30,30
1650825718266,MATH 18,B02,083749,Staff,0,12,30,30
1650825718266,MATH 18,B03,083750,Staff,0,12,30,30
1650825718266,MATH 18,B04,083751,Staff,0,12,30,30
1650825724291,MATH 20A,A01,083754,Staff,19,0,40,21
1650825730313,MATH 20B,A01,083756,Staff,0,13,30,30
1650825730313,MATH 20B,A02,083757,Staff,0,12,30,30
1650825736336,MATH 20C,A01,083760,Staff,0,17,30,30
1650825736336,MATH 20C,A02,083761,Staff,0,16,30,30
1650825736336,MATH 20C,B01,083762,Staff,9,0,30,21
1650825736336,MATH 20C,B02,083763,Staff,28,0,30,2
1650825742363,MATH 20D,A01,083765,Staff,2,1,30,28
1650825742363,MATH 20D,A02,083766,Staff,6,0,30,24
1650825742363,MATH 20D,A03,083767,Staff,24,0,30,6
1650825748386,MATH 20E,A01,083771,Staff,2,0,30,28
1650825748386,MATH 20E,A02,083772,Staff,15,0,30,15
1650825748386,MATH 20E,B01,083773,Staff,0,0,30,30
1650825748386,MATH 20E,B02,083774,Staff,5,0,30,25
1650825754410,MATH 103A,A01,083777,Staff,0,16,30,30
1650825754410,MATH 103A,A02,083778,Staff,0,15,30,30
1650825754410,MATH 103A,B01,083779,Staff,0,15,30,30
1650825754410,MATH 103A,B02,083780,Staff,0,15,30,30
1650825760433,MATH 105,A01,085443,Staff,0,22,30,30
1650825766461,MATH 109,A01,083213,Anzaldo; Leesa B,0,7,30,30
1650825766461,MATH 109,A02,083214,Anzaldo; Leesa B,0,7,30,30
1650825766461,MATH 109,B01,083215,Anzaldo; Leesa B,0,8,30,30
1650825766461,MATH 109,B02,083216,Anzaldo; Leesa B,0,7,30,30
1650825772484,MATH 142A,A01,083219,Chow; Bennett,0,16,30,30
1650825772484,MATH 142A,A02,083220,Chow; Bennett,0,15,30,30
1650825772484,MATH 142A,B01,083221,Chow; Bennett,0,16,30,30
1650825772484,MATH 142A,B02,083222,Chow; Bennett,0,14,30,30
1650825778518,MATH 193A,A01,083224,Staff,0,6,30,30
1650825778518,MATH 193A,A02,083225,Staff,0,6,30,30
1650825778518,MATH 193A,A03,083781,Staff,0,6,30,30
1650825778518,MATH 193A,A04,083782,Staff,0,7,30,30
1650825784539,MATH 197,001,091859,McAuley; Julian John,9998,0,9999,1
1650825790588,COGS 9,A01,083615,Staff,0,17,60,60
1650825796615,COGS 11,A01,083617,Boyle; Mary E. T.,15,0,40,25
1650825802637,COGS 13,A01,083071,Staff,0,38,40,40
1650825808663,COGS 14A,A01,092681,Staff,0,36,100,100
1650825814686,COGS 14B,A01,083073,Cheng; Tzu-Han,0,12,50,50
1650825820715,COGS 17,A01,092677,Staff,11,0,75,64
1650825826748,COGS 100,A01,083619,Staff,0,29,60,60
1650825832773,COGS 101A,A01,083621,Davis; Joshua Daniel,0,28,60,60
1650825838798,COGS 101B,A01,091572,Staff,0,3,60,60
1650825844821,COGS 101C,A01,083625,Delgado; Tania,14,0,30,16
1650825850846,COGS 107A,A01,083627,Boyle; Mary E. T.,0,16,60,60
1650825856873,COGS 118A,A01,083075,Staff,0,8,60,60
1650825862903,CSE 3,A50,083646,Miranda; Gregory Joseph,18,0,38,20
1650825862903,CSE 3,A51,083647,Miranda; Gregory Joseph,36,0,37,1
1650825868927,CSE 8A,A50,083650,Miranda; Gregory Joseph,0,29,40,40
1650825874951,CSE 11,A01,083080,Cao; Yingjun,0,96,40,40
1650825880972,CSE 12,A01,083652,Staff,0,21,100,100
1650825886996,CSE 15L,A01,083654,Staff,0,3,50,50
1650825886996,CSE 15L,A02,083655,Staff,0,2,50,50
1650825893022,CSE 20,A01,083657,Staff,49,0,80,31
1650825899045,CSE 30,A01,083084,Eldon; John,0,75,40,40
1650825905072,CSE 100,A01,083659,Cao; Yingjun,0,71,50,50
1650825911096,CSE 134B,A01,083661,Powell; Thomas Allan,0,38,65,65
1650825917119,CSE 140,A01,083663,Staff,0,11,75,75
1650825923141,CSE 140L,A01,083088,Eldon; John,0,20,75,75
1650825929165,CSE 175,A01,083665,Kumar; Rakesh,7,0,25,18
1650825935191,CSE 190,A00,092507,Dubnov; Shlomo,10,0,20,10
1650825941214,ECE 45,A01,083139,Staff,0,1,60,60
1650825947238,ECE 65,A50,083695,Staff,0,5,30,30
1650825953266,ECE 109,A01,091882,Touri; Behrouz,32,0,70,38
1650825959292,ECE 180,A00,083140,Abi Samra; Nicholas Camill,20,0,30,10
1650825959292,ECE 180,B00,083141,Abi Samra; Nicholas Camill,0,0,30,30
1650825965316,MATH 10A,A01,083735,Patchell; Gregory David,2,0,30,28
1650825965316,MATH 10A,A02,083736,Patchell; Gregory David,27,0,30,3
1650825965316,MATH 10A,A03,083737,Patchell; Gregory David,24,0,30,6
1650825971342,MATH 10B,A01,083207,Staff,0,9,30,30
1650825971342,MATH 10B,A02,083208,Staff,0,6,30,30
1650825971342,MATH 10B,B01,083739,Staff,11,0,30,19
1650825971342,MATH 10B,B02,083740,Staff,28,0,30,2
1650825977367,MATH 18,A01,083743,Staff,0,0,30,30
1650825977367,MATH 18,A02,083744,Staff,23,0,30,7
1650825977367,MATH 18,A03,083745,Staff,21,0,30,9
1650825977367,MATH 18,A04,083746,Staff,26,0,30,4
1650825977367,MATH 18,B01,083748,Staff,0,15,30,30
1650825977367,MATH 18,B02,083749,Staff,0,12,30,30
1650825977367,MATH 18,B03,083750,Staff,0,12,30,30
1650825977367,MATH 18,B04,083751,Staff,0,12,30,30
1650825983389,MATH 20A,A01,083754,Staff,19,0,40,21
1650825989410,MATH 20B,A01,083756,Staff,0,13,30,30
1650825989410,MATH 20B,A02,083757,Staff,0,12,30,30
1650825995437,MATH 20C,A01,083760,Staff,0,17,30,30
1650825995437,MATH 20C,A02,083761,Staff,0,16,30,30
1650825995437,MATH 20C,B01,083762,Staff,9,0,30,21
1650825995437,MATH 20C,B02,083763,Staff,28,0,30,2
1650826001468,MATH 20D,A01,083765,Staff,2,1,30,28
1650826001468,MATH 20D,A02,083766,Staff,6,0,30,24
1650826001468,MATH 20D,A03,083767,Staff,24,0,30,6
1650826007495,MATH 20E,A01,083771,Staff,2,0,30,28
1650826007495,MATH 20E,A02,083772,Staff,15,0,30,15
1650826007495,MATH 20E,B01,083773,Staff,0,0,30,30
1650826007495,MATH 20E,B02,083774,Staff,5,0,30,25
1650826013517,MATH 103A,A01,083777,Staff,0,16,30,30
1650826013517,MATH 103A,A02,083778,Staff,0,15,30,30
1650826013517,MATH 103A,B01,083779,Staff,0,15,30,30
1650826013517,MATH 103A,B02,083780,Staff,0,15,30,30
1650826019541,MATH 105,A01,085443,Staff,0,22,30,30
1650826025568,MATH 109,A01,083213,Anzaldo; Leesa B,0,7,30,30
1650826025568,MATH 109,A02,083214,Anzaldo; Leesa B,0,7,30,30
1650826025568,MATH 109,B01,083215,Anzaldo; Leesa B,0,8,30,30
1650826025568,MATH 109,B02,083216,Anzaldo; Leesa B,0,7,30,30
1650826031589,MATH 142A,A01,083219,Chow; Bennett,0,16,30,30
1650826031589,MATH 142A,A02,083220,Chow; Bennett,0,15,30,30
1650826031589,MATH 142A,B01,083221,Chow; Bennett,0,16,30,30
1650826031589,MATH 142A,B02,083222,Chow; Bennett,0,14,30,30
1650826037612,MATH 193A,A01,083224,Staff,0,6,30,30
1650826037612,MATH 193A,A02,083225,Staff,0,6,30,30
1650826037612,MATH 193A,A03,083781,Staff,0,6,30,30
1650826037612,MATH 193A,A04,083782,Staff,0,7,30,30
1650826043635,MATH 197,001,091859,McAuley; Julian John,9998,0,9999,1
1650826049692,COGS 9,A01,083615,Staff,0,17,60,60
1650826055716,COGS 11,A01,083617,Boyle; Mary E. T.,15,0,40,25
1650826061742,COGS 13,A01,083071,Staff,0,38,40,40
1650826067767,COGS 14A,A01,092681,Staff,0,36,100,100
1650826073807,COGS 14B,A01,083073,Cheng; Tzu-Han,0,12,50,50
1650826079830,COGS 17,A01,092677,Staff,11,0,75,64
1650826085852,COGS 100,A01,083619,Staff,0,29,60,60
1650826091875,COGS 101A,A01,083621,Davis; Joshua Daniel,0,28,60,60
1650826097899,COGS 101B,A01,091572,Staff,0,3,60,60
1650826103923,COGS 101C,A01,083625,Delgado; Tania,14,0,30,16
1650826109949,COGS 107A,A01,083627,Boyle; Mary E. T.,0,16,60,60
1650826115972,COGS 118A,A01,083075,Staff,0,8,60,60
1650826121999,CSE 3,A50,083646,Miranda; Gregory Joseph,18,0,38,20
1650826121999,CSE 3,A51,083647,Miranda; Gregory Joseph,36,0,37,1
1650826128023,CSE 8A,A50,083650,Miranda; Gregory Joseph,0,29,40,40
1650826134048,CSE 11,A01,083080,Cao; Yingjun,0,96,40,40
1650826140071,CSE 12,A01,083652,Staff,0,21,100,100
1650826146092,CSE 15L,A01,083654,Staff,0,3,50,50
1650826146092,CSE 15L,A02,083655,Staff,0,2,50,50
1650826152114,CSE 20,A01,083657,Staff,49,0,80,31
1650826158137,CSE 30,A01,083084,Eldon; John,0,75,40,40
1650826164161,CSE 100,A01,083659,Cao; Yingjun,0,71,50,50
1650826170184,CSE 134B,A01,083661,Powell; Thomas Allan,0,38,65,65
1650826176207,CSE 140,A01,083663,Staff,0,11,75,75
1650826182346,CSE 140L,A01,083088,Eldon; John,0,20,75,75
1650826188368,CSE 175,A01,083665,Kumar; Rakesh,7,0,25,18
1650826194394,CSE 190,A00,092507,Dubnov; Shlomo,10,0,20,10
1650826200422,ECE 45,A01,083139,Staff,0,1,60,60
1650826206454,ECE 65,A50,083695,Staff,0,5,30,30
1650826212481,ECE 109,A01,091882,Touri; Behrouz,32,0,70,38
1650826218511,ECE 180,A00,083140,Abi Samra; Nicholas Camill,20,0,30,10
1650826218511,ECE 180,B00,083141,Abi Samra; Nicholas Camill,0,0,30,30
1650826224542,MATH 10A,A01,083735,Patchell; Gregory David,2,0,30,28
1650826224542,MATH 10A,A02,083736,Patchell; Gregory David,27,0,30,3
1650826224542,MATH 10A,A03,083737,Patchell; Gregory David,24,0,30,6
1650826230569,MATH 10B,A01,083207,Staff,0,9,30,30
1650826230569,MATH 10B,A02,083208,Staff,0,6,30,30
1650826230569,MATH 10B,B01,083739,Staff,11,0,30,19
1650826230569,MATH 10B,B02,083740,Staff,28,0,30,2
1650826236594,MATH 18,A01,083743,Staff,0,0,30,30
1650826236594,MATH 18,A02,083744,Staff,23,0,30,7
1650826236594,MATH 18,A03,083745,Staff,21,0,30,9
1650826236594,MATH 18,A04,083746,Staff,26,0,30,4
1650826236594,MATH 18,B01,083748,Staff,0,15,30,30
1650826236594,MATH 18,B02,083749,Staff,0,12,30,30
1650826236594,MATH 18,B03,083750,Staff,0,12,30,30
1650826236594,MATH 18,B04,083751,Staff,0,12,30,30
1650826242616,MATH 20A,A01,083754,Staff,19,0,40,21
1650826248649,MATH 20B,A01,083756,Staff,0,13,30,30
1650826248649,MATH 20B,A02,083757,Staff,0,12,30,30
1650826254673,MATH 20C,A01,083760,Staff,0,17,30,30
1650826254673,MATH 20C,A02,083761,Staff,0,16,30,30
1650826254673,MATH 20C,B01,083762,Staff,9,0,30,21
1650826254673,MATH 20C,B02,083763,Staff,28,0,30,2
1650826260698,MATH 20D,A01,083765,Staff,2,1,30,28
1650826260698,MATH 20D,A02,083766,Staff,6,0,30,24
1650826260698,MATH 20D,A03,083767,Staff,24,0,30,6
1650826266722,MATH 20E,A01,083771,Staff,2,0,30,28
1650826266722,MATH 20E,A02,083772,Staff,15,0,30,15
1650826266722,MATH 20E,B01,083773,Staff,0,0,30,30
1650826266722,MATH 20E,B02,083774,Staff,5,0,30,25
1650826272746,MATH 103A,A01,083777,Staff,0,16,30,30
1650826272746,MATH 103A,A02,083778,Staff,0,15,30,30
1650826272746,MATH 103A,B01,083779,Staff,0,15,30,30
1650826272746,MATH 103A,B02,083780,Staff,0,15,30,30
1650826278773,MATH 105,A01,085443,Staff,0,22,30,30
1650826284797,MATH 109,A01,083213,Anzaldo; Leesa B,0,7,30,30
1650826284797,MATH 109,A02,083214,Anzaldo; Leesa B,0,7,30,30
1650826284797,MATH 109,B01,083215,Anzaldo; Leesa B,0,8,30,30
1650826284797,MATH 109,B02,083216,Anzaldo; Leesa B,0,7,30,30
1650826290821,MATH 142A,A01,083219,Chow; Bennett,0,16,30,30
1650826290821,MATH 142A,A02,083220,Chow; Bennett,0,15,30,30
1650826290821,MATH 142A,B01,083221,Chow; Bennett,0,16,30,30
1650826290821,MATH 142A,B02,083222,Chow; Bennett,0,14,30,30
1650826296864,MATH 193A,A01,083224,Staff,0,6,30,30
1650826296864,MATH 193A,A02,083225,Staff,0,6,30,30
1650826296864,MATH 193A,A03,083781,Staff,0,6,30,30
1650826296864,MATH 193A,A04,083782,Staff,0,7,30,30
1650826302886,MATH 197,001,091859,McAuley; Julian John,9998,0,9999,1
1650826308937,COGS 9,A01,083615,Staff,0,17,60,60
1650826314961,COGS 11,A01,083617,Boyle; Mary E. T.,15,0,40,25
1650826320992,COGS 13,A01,083071,Staff,0,38,40,40
1650826327020,COGS 14A,A01,092681,Staff,0,36,100,100
1650826333047,COGS 14B,A01,083073,Cheng; Tzu-Han,0,12,50,50
1650826339071,COGS 17,A01,092677,Staff,11,0,75,64
1650826345094,COGS 100,A01,083619,Staff,0,29,60,60
1650826351118,COGS 101A,A01,083621,Davis; Joshua Daniel,0,28,60,60
1650826357152,COGS 101B,A01,091572,Staff,0,3,60,60
1650826363184,COGS 101C,A01,083625,Delgado; Tania,14,0,30,16
1650826369210,COGS 107A,A01,083627,Boyle; Mary E. T.,0,16,60,60
1650826375245,COGS 118A,A01,083075,Staff,0,8,60,60
1650826381269,CSE 3,A50,083646,Miranda; Gregory Joseph,18,0,38,20
1650826381269,CSE 3,A51,083647,Miranda; Gregory Joseph,36,0,37,1
1650826387293,CSE 8A,A50,083650,Miranda; Gregory Joseph,0,29,40,40
1650826393316,CSE 11,A01,083080,Cao; Yingjun,0,96,40,40
1650826399340,CSE 12,A01,083652,Staff,0,21,100,100
1650826405362,CSE 15L,A01,083654,Staff,0,3,50,50
1650826405362,CSE 15L,A02,083655,Staff,0,2,50,50
1650826411388,CSE 20,A01,083657,Staff,49,0,80,31
1650826417410,CSE 30,A01,083084,Eldon; John,0,75,40,40
1650826423432,CSE 100,A01,083659,Cao; Yingjun,0,71,50,50
1650826429473,CSE 134B,A01,083661,Powell; Thomas Allan,0,38,65,65
1650826435496,CSE 140,A01,083663,Staff,0,11,75,75
1650826441524,CSE 140L,A01,083088,Eldon; John,0,20,75,75
1650826447547,CSE 175,A01,083665,Kumar; Rakesh,7,0,25,18
1650826453579,CSE 190,A00,092507,Dubnov; Shlomo,10,0,20,10
1650826459605,ECE 45,A01,083139,Staff,0,1,60,60
1650826465629,ECE 65,A50,083695,Staff,0,5,30,30
1650826471652,ECE 109,A01,091882,Touri; Behrouz,32,0,70,38
1650826477678,ECE 180,A00,083140,Abi Samra; Nicholas Camill,20,0,30,10
1650826477678,ECE 180,B00,083141,Abi Samra; Nicholas Camill,0,0,30,30
1650826483700,MATH 10A,A01,083735,Patchell; Gregory David,2,0,30,28
1650826483700,MATH 10A,A02,083736,Patchell; Gregory David,27,0,30,3
1650826483700,MATH 10A,A03,083737,Patchell; Gregory David,24,0,30,6
1650826489726,MATH 10B,A01,083207,Staff,0,9,30,30
1650826489726,MATH 10B,A02,083208,Staff,0,6,30,30
1650826489726,MATH 10B,B01,083739,Staff,11,0,30,19
1650826489726,MATH 10B,B02,083740,Staff,28,0,30,2
1650826495753,MATH 18,A01,083743,Staff,0,0,30,30
1650826495753,MATH 18,A02,083744,Staff,23,0,30,7
1650826495753,MATH 18,A03,083745,Staff,21,0,30,9
1650826495753,MATH 18,A04,083746,Staff,26,0,30,4
1650826495753,MATH 18,B01,083748,Staff,0,15,30,30
1650826495753,MATH 18,B02,083749,Staff,0,12,30,30
1650826495753,MATH 18,B03,083750,Staff,0,12,30,30
1650826495753,MATH 18,B04,083751,Staff,0,12,30,30
1650826501777,MATH 20A,A01,083754,Staff,19,0,40,21
1650826507801,MATH 20B,A01,083756,Staff,0,13,30,30
1650826507801,MATH 20B,A02,083757,Staff,0,12,30,30
1650826513824,MATH 20C,A01,083760,Staff,0,17,30,30
1650826513824,MATH 20C,A02,083761,Staff,0,16,30,30
1650826513824,MATH 20C,B01,083762,Staff,9,0,30,21
1650826513824,MATH 20C,B02,083763,Staff,28,0,30,2
1650826519846,MATH 20D,A01,083765,Staff,2,1,30,28
1650826519846,MATH 20D,A02,083766,Staff,6,0,30,24
1650826519846,MATH 20D,A03,083767,Staff,24,0,30,6
1650826525876,MATH 20E,A01,083771,Staff,2,0,30,28
1650826525876,MATH 20E,A02,083772,Staff,15,0,30,15
1650826525876,MATH 20E,B01,083773,Staff,0,0,30,30
1650826525876,MATH 20E,B02,083774,Staff,5,0,30,25
1650826531904,MATH 103A,A01,083777,Staff,0,16,30,30
1650826531904,MATH 103A,A02,083778,Staff,0,15,30,30
1650826531904,MATH 103A,B01,083779,Staff,0,15,30,30
1650826531904,MATH 103A,B02,083780,Staff,0,15,30,30
1650826537927,MATH 105,A01,085443,Staff,0,22,30,30
1650826543954,MATH 109,A01,083213,Anzaldo; Leesa B,0,7,30,30
1650826543954,MATH 109,A02,083214,Anzaldo; Leesa B,0,7,30,30
1650826543954,MATH 109,B01,083215,Anzaldo; Leesa B,0,8,30,30
1650826543954,MATH 109,B02,083216,Anzaldo; Leesa B,0,7,30,30
1650826549981,MATH 142A,A01,083219,Chow; Bennett,0,16,30,30
1650826549981,MATH 142A,A02,083220,Chow; Bennett,0,15,30,30
1650826549981,MATH 142A,B01,083221,Chow; Bennett,0,16,30,30
1650826549981,MATH 142A,B02,083222,Chow; Bennett,0,14,30,30
1650826556005,MATH 193A,A01,083224,Staff,0,6,30,30
1650826556005,MATH 193A,A02,083225,Staff,0,6,30,30
1650826556005,MATH 193A,A03,083781,Staff,0,6,30,30
1650826556005,MATH 193A,A04,083782,Staff,0,7,30,30
1650826562029,MATH 197,001,091859,McAuley; Julian John,9998,0,9999,1
1650826568085,COGS 9,A01,083615,Staff,0,17,60,60
1650826574111,COGS 11,A01,083617,Boyle; Mary E. T.,15,0,40,25
1650826580137,COGS 13,A01,083071,Staff,0,38,40,40
1650826586161,COGS 14A,A01,092681,Staff,0,36,100,100
1650826592186,COGS 14B,A01,083073,Cheng; Tzu-Han,0,12,50,50
1650826598213,COGS 17,A01,092677,Staff,11,0,75,64
1650826604236,COGS 100,A01,083619,Staff,0,29,60,60
1650826610260,COGS 101A,A01,083621,Davis; Joshua Daniel,0,28,60,60
1650826616283,COGS 101B,A01,091572,Staff,0,3,60,60
1650826622309,COGS 101C,A01,083625,Delgado; Tania,14,0,30,16
1650826628332,COGS 107A,A01,083627,Boyle; Mary E. T.,0,16,60,60
1650826634355,COGS 118A,A01,083075,Staff,0,8,60,60
1650826640382,CSE 3,A50,083646,Miranda; Gregory Joseph,18,0,38,20
1650826640382,CSE 3,A51,083647,Miranda; Gregory Joseph,36,0,37,1
1650826646410,CSE 8A,A50,083650,Miranda; Gregory Joseph,0,29,40,40
1650826652433,CSE 11,A01,083080,Cao; Yingjun,0,96,40,40
1650826658460,CSE 12,A01,083652,Staff,0,21,100,100
1650826664484,CSE 15L,A01,083654,Staff,0,3,50,50
1650826664484,CSE 15L,A02,083655,Staff,0,2,50,50
1650826670507,CSE 20,A01,083657,Staff,49,0,80,31
1650826676532,CSE 30,A01,083084,Eldon; John,0,75,40,40
1650826682555,CSE 100,A01,083659,Cao; Yingjun,0,71,50,50
1650826688578,CSE 134B,A01,083661,Powell; Thomas Allan,0,38,65,65
1650826694601,CSE 140,A01,083663,Staff,0,11,75,75
1650826700636,CSE 140L,A01,083088,Eldon; John,0,20,75,75
1650826706658,CSE 175,A01,083665,Kumar; Rakesh,7,0,25,18
1650826712680,CSE 190,A00,092507,Dubnov; Shlomo,10,0,20,10
1650826718703,ECE 45,A01,083139,Staff,0,1,60,60
1650826724734,ECE 65,A50,083695,Staff,0,5,30,30
1650826730760,ECE 109,A01,091882,Touri; Behrouz,32,0,70,38
1650826736785,ECE 180,A00,083140,Abi Samra; Nicholas Camill,20,0,30,10
1650826736785,ECE 180,B00,083141,Abi Samra; Nicholas Camill,0,0,30,30
1650826742822,MATH 10A,A01,083735,Patchell; Gregory David,2,0,30,28
1650826742822,MATH 10A,A02,083736,Patchell; Gregory David,27,0,30,3
1650826742822,MATH 10A,A03,083737,Patchell; Gregory David,24,0,30,6
1650826748850,MATH 10B,A01,083207,Staff,0,9,30,30
1650826748850,MATH 10B,A02,083208,Staff,0,6,30,30
1650826748850,MATH 10B,B01,083739,Staff,11,0,30,19
1650826748850,MATH 10B,B02,083740,Staff,28,0,30,2
1650826754874,MATH 18,A01,083743,Staff,0,0,30,30
1650826754874,MATH 18,A02,083744,Staff,23,0,30,7
1650826754874,MATH 18,A03,083745,Staff,21,0,30,9
1650826754874,MATH 18,A04,083746,Staff,26,0,30,4
1650826754874,MATH 18,B01,083748,Staff,0,15,30,30
1650826754874,MATH 18,B02,083749,Staff,0,12,30,30
1650826754874,MATH 18,B03,083750,Staff,0,12,30,30
1650826754874,MATH 18,B04,083751,Staff,0,12,30,30
1650826760900,MATH 20A,A01,083754,Staff,19,0,40,21
1650826766924,MATH 20B,A01,083756,Staff,0,13,30,30
1650826766924,MATH 20B,A02,083757,Staff,0,12,30,30
1650826772948,MATH 20C,A01,083760,Staff,0,17,30,30
1650826772948,MATH 20C,A02,083761,Staff,0,16,30,30
1650826772948,MATH 20C,B01,083762,Staff,9,0,30,21
1650826772948,MATH 20C,B02,083763,Staff,28,0,30,2
1650826779059,MATH 20D,A01,083765,Staff,2,1,30,28
1650826779059,MATH 20D,A02,083766,Staff,6,0,30,24
1650826779059,MATH 20D,A03,083767,Staff,24,0,30,6
1650826785082,MATH 20E,A01,083771,Staff,2,0,30,28
1650826785082,MATH 20E,A02,083772,Staff,15,0,30,15
1650826785082,MATH 20E,B01,083773,Staff,0,0,30,30
1650826785082,MATH 20E,B02,083774,Staff,5,0,30,25
1650826791116,MATH 103A,A01,083777,Staff,0,16,30,30
1650826791116,MATH 103A,A02,083778,Staff,0,15,30,30
1650826791116,MATH 103A,B01,083779,Staff,0,15,30,30
1650826791116,MATH 103A,B02,083780,Staff,0,15,30,30
1650826797140,MATH 105,A01,085443,Staff,0,22,30,30
1650826803162,MATH 109,A01,083213,Anzaldo; Leesa B,0,7,30,30
1650826803162,MATH 109,A02,083214,Anzaldo; Leesa B,0,7,30,30
1650826803162,MATH 109,B01,083215,Anzaldo; Leesa B,0,8,30,30
1650826803162,MATH 109,B02,083216,Anzaldo; Leesa B,0,7,30,30
1650826809184,MATH 142A,A01,083219,Chow; Bennett,0,16,30,30
1650826809184,MATH 142A,A02,083220,Chow; Bennett,0,15,30,30
1650826809184,MATH 142A,B01,083221,Chow; Bennett,0,16,30,30
1650826809184,MATH 142A,B02,083222,Chow; Bennett,0,14,30,30
1650826815208,MATH 193A,A01,083224,Staff,0,6,30,30
1650826815208,MATH 193A,A02,083225,Staff,0,6,30,30
1650826815208,MATH 193A,A03,083781,Staff,0,6,30,30
1650826815208,MATH 193A,A04,083782,Staff,0,7,30,30
1650826821233,MATH 197,001,091859,McAuley; Julian John,9998,0,9999,1
1650826827285,COGS 9,A01,083615,Staff,0,17,60,60
1650826833306,COGS 11,A01,083617,Boyle; Mary E. T.,15,0,40,25
1650826839328,COGS 13,A01,083071,Staff,0,38,40,40
1650826845351,COGS 14A,A01,092681,Staff,0,36,100,100
1650826851373,COGS 14B,A01,083073,Cheng; Tzu-Han,0,12,50,50
1650826857395,COGS 17,A01,092677,Staff,11,0,75,64
1650826863420,COGS 100,A01,083619,Staff,0,29,60,60
1650826869455,COGS 101A,A01,083621,Davis; Joshua Daniel,0,28,60,60
1650826875484,COGS 101B,A01,091572,Staff,0,3,60,60
1650826881506,COGS 101C,A01,083625,Delgado; Tania,14,0,30,16
1650826887529,COGS 107A,A01,083627,Boyle; Mary E. T.,0,16,60,60
1650826893552,COGS 118A,A01,083075,Staff,0,8,60,60
1650826899579,CSE 3,A50,083646,Miranda; Gregory Joseph,18,0,38,20
1650826899579,CSE 3,A51,083647,Miranda; Gregory Joseph,36,0,37,1
1650826905605,CSE 8A,A50,083650,Miranda; Gregory Joseph,0,29,40,40
1650826911629,CSE 11,A01,083080,Cao; Yingjun,0,96,40,40
1650826917653,CSE 12,A01,083652,Staff,0,21,100,100
1650826923680,CSE 15L,A01,083654,Staff,0,3,50,50
1650826923680,CSE 15L,A02,083655,Staff,0,2,50,50
1650826929703,CSE 20,A01,083657,Staff,49,0,80,31
1650826935730,CSE 30,A01,083084,Eldon; John,0,75,40,40
1650826941756,CSE 100,A01,083659,Cao; Yingjun,0,71,50,50
1650826947779,CSE 134B,A01,083661,Powell; Thomas Allan,0,38,65,65
1650826953804,CSE 140,A01,083663,Staff,0,11,75,75
1650826959832,CSE 140L,A01,083088,Eldon; John,0,20,75,75
1650826965855,CSE 175,A01,083665,Kumar; Rakesh,7,0,25,18
1650826971879,CSE 190,A00,092507,Dubnov; Shlomo,10,0,20,10
1650826977900,ECE 45,A01,083139,Staff,0,1,60,60
1650826983927,ECE 65,A50,083695,Staff,0,5,30,30
1650826989961,ECE 109,A01,091882,Touri; Behrouz,32,0,70,38
1650826995984,ECE 180,A00,083140,Abi Samra; Nicholas Camill,20,0,30,10
1650826995984,ECE 180,B00,083141,Abi Samra; Nicholas Camill,0,0,30,30
1650827002008,MATH 10A,A01,083735,Patchell; Gregory David,2,0,30,28
1650827002008,MATH 10A,A02,083736,Patchell; Gregory David,27,0,30,3
1650827002008,MATH 10A,A03,083737,Patchell; Gregory David,24,0,30,6
1650827008033,MATH 10B,A01,083207,Staff,0,9,30,30
1650827008033,MATH 10B,A02,083208,Staff,0,6,30,30
1650827008033,MATH 10B,B01,083739,Staff,11,0,30,19
1650827008033,MATH 10B,B02,083740,Staff,28,0,30,2
1650827014056,MATH 18,A01,083743,Staff,0,0,30,30
1650827014056,MATH 18,A02,083744,Staff,23,0,30,7
1650827014056,MATH 18,A03,083745,Staff,21,0,30,9
1650827014056,MATH 18,A04,083746,Staff,26,0,30,4
1650827014056,MATH 18,B01,083748,Staff,0,15,30,30
1650827014056,MATH 18,B02,083749,Staff,0,12,30,30
1650827014056,MATH 18,B03,083750,Staff,0,12,30,30
1650827014056,MATH 18,B04,083751,Staff,0,12,30,30
1650827020079,MATH 20A,A01,083754,Staff,19,0,40,21
1650827026117,MATH 20B,A01,083756,Staff,0,13,30,30
1650827026117,MATH 20B,A02,083757,Staff,0,12,30,30
1650827032139,MATH 20C,A01,083760,Staff,0,17,30,30
1650827032139,MATH 20C,A02,083761,Staff,0,16,30,30
1650827032139,MATH 20C,B01,083762,Staff,9,0,30,21
1650827032139,MATH 20C,B02,083763,Staff,28,0,30,2
1650827038162,MATH 20D,A01,083765,Staff,2,1,30,28
1650827038162,MATH 20D,A02,083766,Staff,6,0,30,24
1650827038162,MATH 20D,A03,083767,Staff,24,0,30,6
1650827044185,MATH 20E,A01,083771,Staff,2,0,30,28
1650827044185,MATH 20E,A02,083772,Staff,15,0,30,15
1650827044185,MATH 20E,B01,083773,Staff,0,0,30,30
1650827044185,MATH 20E,B02,083774,Staff,5,0,30,25
1650827050210,MATH 103A,A01,083777,Staff,0,16,30,30
1650827050210,MATH 103A,A02,083778,Staff,0,15,30,30
1650827050210,MATH 103A,B01,083779,Staff,0,15,30,30
1650827050210,MATH 103A,B02,083780,Staff,0,15,30,30
1650827056245,MATH 105,A01,085443,Staff,0,22,30,30
1650827062271,MATH 109,A01,083213,Anzaldo; Leesa B,0,7,30,30
1650827062271,MATH 109,A02,083214,Anzaldo; Leesa B,0,7,30,30
1650827062271,MATH 109,B01,083215,Anzaldo; Leesa B,0,8,30,30
1650827062271,MATH 109,B02,083216,Anzaldo; Leesa B,0,7,30,30
1650827068293,MATH 142A,A01,083219,Chow; Bennett,0,16,30,30
1650827068293,MATH 142A,A02,083220,Chow; Bennett,0,15,30,30
1650827068293,MATH 142A,B01,083221,Chow; Bennett,0,16,30,30
1650827068293,MATH 142A,B02,083222,Chow; Bennett,0,14,30,30
1650827074319,MATH 193A,A01,083224,Staff,0,6,30,30
1650827074319,MATH 193A,A02,083225,Staff,0,6,30,30
1650827074319,MATH 193A,A03,083781,Staff,0,6,30,30
1650827074319,MATH 193A,A04,083782,Staff,0,7,30,30
1650827080341,MATH 197,001,091859,McAuley; Julian John,9998,0,9999,1
1650827086404,COGS 9,A01,083615,Staff,0,17,60,60
1650827092444,COGS 11,A01,083617,Boyle; Mary E. T.,15,0,40,25
1650827098466,COGS 13,A01,083071,Staff,0,38,40,40
1650827104489,COGS 14A,A01,092681,Staff,0,36,100,100
1650827110516,COGS 14B,A01,083073,Cheng; Tzu-Han,0,12,50,50
1650827116539,COGS 17,A01,092677,Staff,11,0,75,64
1650827122563,COGS 100,A01,083619,Staff,0,29,60,60
1650827128589,COGS 101A,A01,083621,Davis; Joshua Daniel,0,28,60,60
1650827134615,COGS 101B,A01,091572,Staff,0,3,60,60
1650827140649,COGS 101C,A01,083625,Delgado; Tania,14,0,30,16
1650827146672,COGS 107A,A01,083627,Boyle; Mary E. T.,0,16,60,60
1650827152709,COGS 118A,A01,083075,Staff,0,8,60,60
1650827158732,CSE 3,A50,083646,Miranda; Gregory Joseph,18,0,38,20
1650827158732,CSE 3,A51,083647,Miranda; Gregory Joseph,36,0,37,1
1650827164755,CSE 8A,A50,083650,Miranda; Gregory Joseph,0,29,40,40
1650827170782,CSE 11,A01,083080,Cao; Yingjun,0,96,40,40
1650827176807,CSE 12,A01,083652,Staff,0,21,100,100
1650827182836,CSE 15L,A01,083654,Staff,0,3,50,50
1650827182836,CSE 15L,A02,083655,Staff,0,2,50,50
1650827188862,CSE 20,A01,083657,Staff,49,0,80,31
1650827194891,CSE 30,A01,083084,Eldon; John,0,75,40,40
1650827200915,CSE 100,A01,083659,Cao; Yingjun,0,71,50,50
1650827206939,CSE 134B,A01,083661,Powell; Thomas Allan,0,38,65,65
1650827212966,CSE 140,A01,083663,Staff,0,11,75,75
1650827218992,CSE 140L,A01,083088,Eldon; John,0,20,75,75
1650827225016,CSE 175,A01,083665,Kumar; Rakesh,7,0,25,18
1650827231039,CSE 190,A00,092507,Dubnov; Shlomo,10,0,20,10
1650827237065,ECE 45,A01,083139,Staff,0,1,60,60
1650827243092,ECE 65,A50,083695,Staff,0,5,30,30
1650827249115,ECE 109,A01,091882,Touri; Behrouz,32,0,70,38
1650827255142,ECE 180,A00,083140,Abi Samra; Nicholas Camill,20,0,30,10
1650827255142,ECE 180,B00,083141,Abi Samra; Nicholas Camill,0,0,30,30
1650827261181,MATH 10A,A01,083735,Patchell; Gregory David,2,0,30,28
1650827261181,MATH 10A,A02,083736,Patchell; Gregory David,27,0,30,3
1650827261181,MATH 10A,A03,083737,Patchell; Gregory David,24,0,30,6
1650827267208,MATH 10B,A01,083207,Staff,0,9,30,30
1650827267208,MATH 10B,A02,083208,Staff,0,6,30,30
1650827267208,MATH 10B,B01,083739,Staff,11,0,30,19
1650827267208,MATH 10B,B02,083740,Staff,28,0,30,2
1650827273232,MATH 18,A01,083743,Staff,0,0,30,30
1650827273232,MATH 18,A02,083744,Staff,23,0,30,7
1650827273232,MATH 18,A03,083745,Staff,21,0,30,9
1650827273232,MATH 18,A04,083746,Staff,26,0,30,4
1650827273232,MATH 18,B01,083748,Staff,0,15,30,30
1650827273232,MATH 18,B02,083749,Staff,0,12,30,30
1650827273232,MATH 18,B03,083750,Staff,0,12,30,30
1650827273232,MATH 18,B04,083751,Staff,0,12,30,30
1650827279254,MATH 20A,A01,083754,Staff,19,0,40,21
1650827285280,MATH 20B,A01,083756,Staff,0,13,30,30
1650827285280,MATH 20B,A02,083757,Staff,0,12,30,30
1650827291320,MATH 20C,A01,083760,Staff,0,17,30,30
1650827291320,MATH 20C,A02,083761,Staff,0,16,30,30
1650827291320,MATH 20C,B01,083762,Staff,9,0,30,21
1650827291320,MATH 20C,B02,083763,Staff,28,0,30,2
1650827297345,MATH 20D,A01,083765,Staff,2,1,30,28
1650827297345,MATH 20D,A02,083766,Staff,6,0,30,24
1650827297345,MATH 20D,A03,083767,Staff,24,0,30,6
1650827303369,MATH 20E,A01,083771,Staff,2,0,30,28
1650827303369,MATH 20E,A02,083772,Staff,15,0,30,15
1650827303369,MATH 20E,B01,083773,Staff,0,0,30,30
1650827303369,MATH 20E,B02,083774,Staff,5,0,30,25
1650827309393,MATH 103A,A01,083777,Staff,0,16,30,30
1650827309393,MATH 103A,A02,083778,Staff,0,15,30,30
1650827309393,MATH 103A,B01,083779,Staff,0,15,30,30
1650827309393,MATH 103A,B02,083780,Staff,0,15,30,30
1650827315416,MATH 105,A01,085443,Staff,0,22,30,30
1650827321439,MATH 109,A01,083213,Anzaldo; Leesa B,0,7,30,30
1650827321439,MATH 109,A02,083214,Anzaldo; Leesa B,0,7,30,30
1650827321439,MATH 109,B01,083215,Anzaldo; Leesa B,0,8,30,30
1650827321439,MATH 109,B02,083216,Anzaldo; Leesa B,0,7,30,30
1650827327473,MATH 142A,A01,083219,Chow; Bennett,0,16,30,30
1650827327473,MATH 142A,A02,083220,Chow; Bennett,0,15,30,30
1650827327473,MATH 142A,B01,083221,Chow; Bennett,0,16,30,30
1650827327473,MATH 142A,B02,083222,Chow; Bennett,0,14,30,30
1650827333506,MATH 193A,A01,083224,Staff,0,6,30,30
1650827333506,MATH 193A,A02,083225,Staff,0,6,30,30
1650827333506,MATH 193A,A03,083781,Staff,0,6,30,30
1650827333506,MATH 193A,A04,083782,Staff,0,7,30,30
1650827339529,MATH 197,001,091859,McAuley; Julian John,9998,0,9999,1
1650827345581,COGS 9,A01,083615,Staff,0,17,60,60
1650827351606,COGS 11,A01,083617,Boyle; Mary E. T.,15,0,40,25
1650827357630,COGS 13,A01,083071,Staff,0,38,40,40
1650827363655,COGS 14A,A01,092681,Staff,0,36,100,100
1650827369774,COGS 14B,A01,083073,Cheng; Tzu-Han,0,12,50,50
1650827375799,COGS 17,A01,092677,Staff,11,0,75,64
1650827381831,COGS 100,A01,083619,Staff,0,29,60,60
1650827387856,COGS 101A,A01,083621,Davis; Joshua Daniel,0,28,60,60
1650827393878,COGS 101B,A01,091572,Staff,0,3,60,60
1650827399902,COGS 101C,A01,083625,Delgado; Tania,14,0,30,16
1650827405934,COGS 107A,A01,083627,Boyle; Mary E. T.,0,16,60,60
1650827411957,COGS 118A,A01,083075,Staff,0,8,60,60
1650827417981,CSE 3,A50,083646,Miranda; Gregory Joseph,18,0,38,20
1650827417981,CSE 3,A51,083647,Miranda; Gregory Joseph,36,0,37,1
1650827424014,CSE 8A,A50,083650,Miranda; Gregory Joseph,0,29,40,40
1650827430040,CSE 11,A01,083080,Cao; Yingjun,0,96,40,40
1650827436064,CSE 12,A01,083652,Staff,0,21,100,100
1650827442095,CSE 15L,A01,083654,Staff,0,3,50,50
1650827442095,CSE 15L,A02,083655,Staff,0,2,50,50
1650827448122,CSE 20,A01,083657,Staff,49,0,80,31
1650827454146,CSE 30,A01,083084,Eldon; John,0,75,40,40
1650827460170,CSE 100,A01,083659,Cao; Yingjun,0,71,50,50
1650827466195,CSE 134B,A01,083661,Powell; Thomas Allan,0,38,65,65
1650827472225,CSE 140,A01,083663,Staff,0,11,75,75
1650827478248,CSE 140L,A01,083088,Eldon; John,0,20,75,75
1650827484279,CSE 175,A01,083665,Kumar; Rakesh,7,0,25,18
1650827490302,CSE 190,A00,092507,Dubnov; Shlomo,10,0,20,10
1650827496326,ECE 45,A01,083139,Staff,0,1,60,60
1650827502366,ECE 65,A50,083695,Staff,0,5,30,30
1650827508390,ECE 109,A01,091882,Touri; Behrouz,32,0,70,38
1650827514413,ECE 180,A00,083140,Abi Samra; Nicholas Camill,20,0,30,10
1650827514413,ECE 180,B00,083141,Abi Samra; Nicholas Camill,0,0,30,30
1650827520442,MATH 10A,A01,083735,Patchell; Gregory David,2,0,30,28
1650827520442,MATH 10A,A02,083736,Patchell; Gregory David,27,0,30,3
1650827520442,MATH 10A,A03,083737,Patchell; Gregory David,24,0,30,6
1650827526465,MATH 10B,A01,083207,Staff,0,9,30,30
1650827526465,MATH 10B,A02,083208,Staff,0,6,30,30
1650827526465,MATH 10B,B01,083739,Staff,11,0,30,19
1650827526465,MATH 10B,B02,083740,Staff,28,0,30,2
1650827532489,MATH 18,A01,083743,Staff,0,0,30,30
1650827532489,MATH 18,A02,083744,Staff,23,0,30,7
1650827532489,MATH 18,A03,083745,Staff,21,0,30,9
1650827532489,MATH 18,A04,083746,Staff,26,0,30,4
1650827532489,MATH 18,B01,083748,Staff,0,15,30,30
1650827532489,MATH 18,B02,083749,Staff,0,12,30,30
1650827532489,MATH 18,B03,083750,Staff,0,12,30,30
1650827532489,MATH 18,B04,083751,Staff,0,12,30,30
1650827538514,MATH 20A,A01,083754,Staff,19,0,40,21
1650827544537,MATH 20B,A01,083756,Staff,0,13,30,30
1650827544537,MATH 20B,A02,083757,Staff,0,12,30,30
1650827550560,MATH 20C,A01,083760,Staff,0,17,30,30
1650827550560,MATH 20C,A02,083761,Staff,0,16,30,30
1650827550560,MATH 20C,B01,083762,Staff,9,0,30,21
1650827550560,MATH 20C,B02,083763,Staff,28,0,30,2
1650827556586,MATH 20D,A01,083765,Staff,2,1,30,28
1650827556586,MATH 20D,A02,083766,Staff,6,0,30,24
1650827556586,MATH 20D,A03,083767,Staff,24,0,30,6
1650827562612,MATH 20E,A01,083771,Staff,2,0,30,28
1650827562612,MATH 20E,A02,083772,Staff,15,0,30,15
1650827562612,MATH 20E,B01,083773,Staff,0,0,30,30
1650827562612,MATH 20E,B02,083774,Staff,5,0,30,25
1650827568646,MATH 103A,A01,083777,Staff,0,16,30,30
1650827568646,MATH 103A,A02,083778,Staff,0,15,30,30
1650827568646,MATH 103A,B01,083779,Staff,0,15,30,30
1650827568646,MATH 103A,B02,083780,Staff,0,15,30,30
1650827574674,MATH 105,A01,085443,Staff,0,22,30,30
1650827580697,MATH 109,A01,083213,Anzaldo; Leesa B,0,7,30,30
1650827580697,MATH 109,A02,083214,Anzaldo; Leesa B,0,7,30,30
1650827580697,MATH 109,B01,083215,Anzaldo; Leesa B,0,8,30,30
1650827580697,MATH 109,B02,083216,Anzaldo; Leesa B,0,7,30,30
1650827586725,MATH 142A,A01,083219,Chow; Bennett,0,16,30,30
1650827586725,MATH 142A,A02,083220,Chow; Bennett,0,15,30,30
1650827586725,MATH 142A,B01,083221,Chow; Bennett,0,16,30,30
1650827586725,MATH 142A,B02,083222,Chow; Bennett,0,14,30,30
1650827592750,MATH 193A,A01,083224,Staff,0,6,30,30
1650827592750,MATH 193A,A02,083225,Staff,0,6,30,30
1650827592750,MATH 193A,A03,083781,Staff,0,6,30,30
1650827592750,MATH 193A,A04,083782,Staff,0,7,30,30
1650827598773,MATH 197,001,091859,McAuley; Julian John,9998,0,9999,1
1650827604837,COGS 9,A01,083615,Staff,0,17,60,60
1650827610863,COGS 11,A01,083617,Boyle; Mary E. T.,15,0,40,25
1650827616887,COGS 13,A01,083071,Staff,0,38,40,40
1650827622910,COGS 14A,A01,092681,Staff,0,36,100,100
1650827628937,COGS 14B,A01,083073,Cheng; Tzu-Han,0,12,50,50
1650827634961,COGS 17,A01,092677,Staff,11,0,75,64
1650827640984,COGS 100,A01,083619,Staff,0,29,60,60
1650827647020,COGS 101A,A01,083621,Davis; Joshua Daniel,0,28,60,60
1650827653055,COGS 101B,A01,091572,Staff,0,3,60,60
1650827659082,COGS 101C,A01,083625,Delgado; Tania,14,0,30,16
1650827665105,COGS 107A,A01,083627,Boyle; Mary E. T.,0,16,60,60
1650827671128,COGS 118A,A01,083075,Staff,0,8,60,60
1650827677151,CSE 3,A50,083646,Miranda; Gregory Joseph,18,0,38,20
1650827677151,CSE 3,A51,083647,Miranda; Gregory Joseph,36,0,37,1
1650827683175,CSE 8A,A50,083650,Miranda; Gregory Joseph,0,29,40,40
1650827689198,CSE 11,A01,083080,Cao; Yingjun,0,96,40,40
1650827695228,CSE 12,A01,083652,Staff,0,21,100,100
1650827701253,CSE 15L,A01,083654,Staff,0,3,50,50
1650827701253,CSE 15L,A02,083655,Staff,0,2,50,50
1650827707275,CSE 20,A01,083657,Staff,49,0,80,31
1650827713300,CSE 30,A01,083084,Eldon; John,0,75,40,40
1650827719325,CSE 100,A01,083659,Cao; Yingjun,0,71,50,50
1650827725351,CSE 134B,A01,083661,Powell; Thomas Allan,0,38,65,65
1650827731373,CSE 140,A01,083663,Staff,0,11,75,75
1650827737397,CSE 140L,A01,083088,Eldon; John,0,20,75,75
1650827743420,CSE 175,A01,083665,Kumar; Rakesh,7,0,25,18
1650827749443,CSE 190,A00,092507,Dubnov; Shlomo,10,0,20,10
1650827755467,ECE 45,A01,083139,Staff,0,1,60,60
1650827761492,ECE 65,A50,083695,Staff,0,5,30,30
1650827767518,ECE 109,A01,091882,Touri; Behrouz,32,0,70,38
1650827773542,ECE 180,A00,083140,Abi Samra; Nicholas Camill,20,0,30,10
1650827773542,ECE 180,B00,083141,Abi Samra; Nicholas Camill,0,0,30,30
1650827779566,MATH 10A,A01,083735,Patchell; Gregory David,2,0,30,28
1650827779566,MATH 10A,A02,083736,Patchell; Gregory David,27,0,30,3
1650827779566,MATH 10A,A03,083737,Patchell; Gregory David,24,0,30,6
1650827785590,MATH 10B,A01,083207,Staff,0,9,30,30
1650827785590,MATH 10B,A02,083208,Staff,0,6,30,30
1650827785590,MATH 10B,B01,083739,Staff,11,0,30,19
1650827785590,MATH 10B,B02,083740,Staff,28,0,30,2
1650827791618,MATH 18,A01,083743,Staff,0,0,30,30
1650827791618,MATH 18,A02,083744,Staff,23,0,30,7
1650827791618,MATH 18,A03,083745,Staff,21,0,30,9
1650827791618,MATH 18,A04,083746,Staff,26,0,30,4
1650827791618,MATH 18,B01,083748,Staff,0,15,30,30
1650827791618,MATH 18,B02,083749,Staff,0,12,30,30
1650827791618,MATH 18,B03,083750,Staff,0,12,30,30
1650827791618,MATH 18,B04,083751,Staff,0,12,30,30
1650827797644,MATH 20A,A01,083754,Staff,19,0,40,21
1650827803668,MATH 20B,A01,083756,Staff,0,13,30,30
1650827803668,MATH 20B,A02,083757,Staff,0,12,30,30
1650827809695,MATH 20C,A01,083760,Staff,0,17,30,30
1650827809695,MATH 20C,A02,083761,Staff,0,16,30,30
1650827809695,MATH 20C,B01,083762,Staff,9,0,30,21
1650827809695,MATH 20C,B02,083763,Staff,28,0,30,2
1650827815717,MATH 20D,A01,083765,Staff,2,1,30,28
1650827815717,MATH 20D,A02,083766,Staff,6,0,30,24
1650827815717,MATH 20D,A03,083767,Staff,24,0,30,6
1650827821743,MATH 20E,A01,083771,Staff,2,0,30,28
1650827821743,MATH 20E,A02,083772,Staff,15,0,30,15
1650827821743,MATH 20E,B01,083773,Staff,0,0,30,30
1650827821743,MATH 20E,B02,083774,Staff,5,0,30,25
1650827827767,MATH 103A,A01,083777,Staff,0,16,30,30
1650827827767,MATH 103A,A02,083778,Staff,0,15,30,30
1650827827767,MATH 103A,B01,083779,Staff,0,15,30,30
1650827827767,MATH 103A,B02,083780,Staff,0,15,30,30
1650827833791,MATH 105,A01,085443,Staff,0,22,30,30
1650827839815,MATH 109,A01,083213,Anzaldo; Leesa B,0,7,30,30
1650827839815,MATH 109,A02,083214,Anzaldo; Leesa B,0,7,30,30
1650827839815,MATH 109,B01,083215,Anzaldo; Leesa B,0,8,30,30
1650827839815,MATH 109,B02,083216,Anzaldo; Leesa B,0,7,30,30
1650827845839,MATH 142A,A01,083219,Chow; Bennett,0,16,30,30
1650827845839,MATH 142A,A02,083220,Chow; Bennett,0,15,30,30
1650827845839,MATH 142A,B01,083221,Chow; Bennett,0,16,30,30
1650827845839,MATH 142A,B02,083222,Chow; Bennett,0,14,30,30
1650827851863,MATH 193A,A01,083224,Staff,0,6,30,30
1650827851863,MATH 193A,A02,083225,Staff,0,6,30,30
1650827851863,MATH 193A,A03,083781,Staff,0,6,30,30
1650827851863,MATH 193A,A04,083782,Staff,0,7,30,30
1650827857887,MATH 197,001,091859,McAuley; Julian John,9998,0,9999,1
1650827863938,COGS 9,A01,083615,Staff,0,17,60,60
1650827869964,COGS 11,A01,083617,Boyle; Mary E. T.,15,0,40,25
1650827875988,COGS 13,A01,083071,Staff,0,38,40,40
1650827882011,COGS 14A,A01,092681,Staff,0,36,100,100
1650827888034,COGS 14B,A01,083073,Cheng; Tzu-Han,0,12,50,50
1650827894060,COGS 17,A01,092677,Staff,11,0,75,64
1650827900085,COGS 100,A01,083619,Staff,0,29,60,60
1650827906108,COGS 101A,A01,083621,Davis; Joshua Daniel,0,28,60,60
1650827912132,COGS 101B,A01,091572,Staff,0,3,60,60
1650827918155,COGS 101C,A01,083625,Delgado; Tania,14,0,30,16
1650827924181,COGS 107A,A01,083627,Boyle; Mary E. T.,0,16,60,60
1650827930204,COGS 118A,A01,083075,Staff,0,8,60,60
1650827936228,CSE 3,A50,083646,Miranda; Gregory Joseph,18,0,38,20
1650827936228,CSE 3,A51,083647,Miranda; Gregory Joseph,36,0,37,1
1650827942252,CSE 8A,A50,083650,Miranda; Gregory Joseph,0,29,40,40
1650827948275,CSE 11,A01,083080,Cao; Yingjun,0,96,40,40
1650827954299,CSE 12,A01,083652,Staff,0,21,100,100
1650827960327,CSE 15L,A01,083654,Staff,0,3,50,50
1650827960327,CSE 15L,A02,083655,Staff,0,2,50,50
1650827966452,CSE 20,A01,083657,Staff,49,0,80,31
1650827972474,CSE 30,A01,083084,Eldon; John,0,75,40,40
1650827978498,CSE 100,A01,083659,Cao; Yingjun,0,71,50,50
1650827984524,CSE 134B,A01,083661,Powell; Thomas Allan,0,38,65,65
1650827990549,CSE 140,A01,083663,Staff,0,11,75,75
1650827996575,CSE 140L,A01,083088,Eldon; John,0,20,75,75
1650828002600,CSE 175,A01,083665,Kumar; Rakesh,7,0,25,18
1650828008625,CSE 190,A00,092507,Dubnov; Shlomo,10,0,20,10
1650828014648,ECE 45,A01,083139,Staff,0,1,60,60
1650828020671,ECE 65,A50,083695,Staff,0,5,30,30
1650828026697,ECE 109,A01,091882,Touri; Behrouz,32,0,70,38
1650828032723,ECE 180,A00,083140,Abi Samra; Nicholas Camill,20,0,30,10
1650828032723,ECE 180,B00,083141,Abi Samra; Nicholas Camill,0,0,30,30
1650828038748,MATH 10A,A01,083735,Patchell; Gregory David,2,0,30,28
1650828038748,MATH 10A,A02,083736,Patchell; Gregory David,27,0,30,3
1650828038748,MATH 10A,A03,083737,Patchell; Gregory David,24,0,30,6
1650828044771,MATH 10B,A01,083207,Staff,0,9,30,30
1650828044771,MATH 10B,A02,083208,Staff,0,6,30,30
1650828044771,MATH 10B,B01,083739,Staff,11,0,30,19
1650828044771,MATH 10B,B02,083740,Staff,28,0,30,2
1650828050800,MATH 18,A01,083743,Staff,0,0,30,30
1650828050800,MATH 18,A02,083744,Staff,23,0,30,7
1650828050800,MATH 18,A03,083745,Staff,21,0,30,9
1650828050800,MATH 18,A04,083746,Staff,26,0,30,4
1650828050800,MATH 18,B01,083748,Staff,0,15,30,30
1650828050800,MATH 18,B02,083749,Staff,0,12,30,30
1650828050800,MATH 18,B03,083750,Staff,0,12,30,30
1650828050800,MATH 18,B04,083751,Staff,0,12,30,30
1650828056824,MATH 20A,A01,083754,Staff,19,0,40,21
1650828062848,MATH 20B,A01,083756,Staff,0,13,30,30
1650828062848,MATH 20B,A02,083757,Staff,0,12,30,30
1650828068875,MATH 20C,A01,083760,Staff,0,17,30,30
1650828068875,MATH 20C,A02,083761,Staff,0,16,30,30
1650828068875,MATH 20C,B01,083762,Staff,9,0,30,21
1650828068875,MATH 20C,B02,083763,Staff,28,0,30,2
1650828074900,MATH 20D,A01,083765,Staff,2,1,30,28
1650828074900,MATH 20D,A02,083766,Staff,6,0,30,24
1650828074900,MATH 20D,A03,083767,Staff,24,0,30,6
1650828080928,MATH 20E,A01,083771,Staff,2,0,30,28
1650828080928,MATH 20E,A02,083772,Staff,15,0,30,15
1650828080928,MATH 20E,B01,083773,Staff,0,0,30,30
1650828080928,MATH 20E,B02,083774,Staff,5,0,30,25
1650828086953,MATH 103A,A01,083777,Staff,0,16,30,30
1650828086953,MATH 103A,A02,083778,Staff,0,15,30,30
1650828086953,MATH 103A,B01,083779,Staff,0,15,30,30
1650828086953,MATH 103A,B02,083780,Staff,0,15,30,30
1650828092976,MATH 105,A01,085443,Staff,0,22,30,30
1650828099003,MATH 109,A01,083213,Anzaldo; Leesa B,0,7,30,30
1650828099003,MATH 109,A02,083214,Anzaldo; Leesa B,0,7,30,30
1650828099003,MATH 109,B01,083215,Anzaldo; Leesa B,0,8,30,30
1650828099003,MATH 109,B02,083216,Anzaldo; Leesa B,0,7,30,30
1650828105031,MATH 142A,A01,083219,Chow; Bennett,0,16,30,30
1650828105031,MATH 142A,A02,083220,Chow; Bennett,0,15,30,30
1650828105031,MATH 142A,B01,083221,Chow; Bennett,0,16,30,30
1650828105031,MATH 142A,B02,083222,Chow; Bennett,0,14,30,30
1650828111056,MATH 193A,A01,083224,Staff,0,6,30,30
1650828111056,MATH 193A,A02,083225,Staff,0,6,30,30
1650828111056,MATH 193A,A03,083781,Staff,0,6,30,30
1650828111056,MATH 193A,A04,083782,Staff,0,7,30,30
1650828117078,MATH 197,001,091859,McAuley; Julian John,9998,0,9999,1
1650828123128,COGS 9,A01,083615,Staff,0,17,60,60
1650828129152,COGS 11,A01,083617,Boyle; Mary E. T.,15,0,40,25
1650828135176,COGS 13,A01,083071,Staff,0,38,40,40
1650828141200,COGS 14A,A01,092681,Staff,0,36,100,100
1650828147224,COGS 14B,A01,083073,Cheng; Tzu-Han,0,12,50,50
1650828153246,COGS 17,A01,092677,Staff,11,0,75,64
1650828159272,COGS 100,A01,083619,Staff,0,29,60,60
1650828165300,COGS 101A,A01,083621,Davis; Joshua Daniel,0,28,60,60
1650828171323,COGS 101B,A01,091572,Staff,0,3,60,60
1650828177350,COGS 101C,A01,083625,Delgado; Tania,14,0,30,16
1650828183377,COGS 107A,A01,083627,Boyle; Mary E. T.,0,16,60,60
1650828189402,COGS 118A,A01,083075,Staff,0,8,60,60
1650828195429,CSE 3,A50,083646,Miranda; Gregory Joseph,18,0,38,20
1650828195429,CSE 3,A51,083647,Miranda; Gregory Joseph,36,0,37,1
1650828201454,CSE 8A,A50,083650,Miranda; Gregory Joseph,0,29,40,40
1650828207481,CSE 11,A01,083080,Cao; Yingjun,0,96,40,40
1650828213506,CSE 12,A01,083652,Staff,0,21,100,100
1650828219531,CSE 15L,A01,083654,Staff,0,3,50,50
1650828219531,CSE 15L,A02,083655,Staff,0,2,50,50
1650828225553,CSE 20,A01,083657,Staff,49,0,80,31
1650828231588,CSE 30,A01,083084,Eldon; John,0,75,40,40
1650828237614,CSE 100,A01,083659,Cao; Yingjun,0,71,50,50
1650828243638,CSE 134B,A01,083661,Powell; Thomas Allan,0,38,65,65
1650828249664,CSE 140,A01,083663,Staff,0,11,75,75
1650828255688,CSE 140L,A01,083088,Eldon; John,0,20,75,75
1650828261724,CSE 175,A01,083665,Kumar; Rakesh,7,0,25,18
1650828267745,CSE 190,A00,092507,Dubnov; Shlomo,10,0,20,10
1650828273767,ECE 45,A01,083139,Staff,0,1,60,60
1650828279793,ECE 65,A50,083695,Staff,0,5,30,30
1650828285819,ECE 109,A01,091882,Touri; Behrouz,32,0,70,38
1650828291844,ECE 180,A00,083140,Abi Samra; Nicholas Camill,20,0,30,10
1650828291844,ECE 180,B00,083141,Abi Samra; Nicholas Camill,0,0,30,30
1650828297870,MATH 10A,A01,083735,Patchell; Gregory David,2,0,30,28
1650828297870,MATH 10A,A02,083736,Patchell; Gregory David,27,0,30,3
1650828297870,MATH 10A,A03,083737,Patchell; Gregory David,24,0,30,6
1650828303898,MATH 10B,A01,083207,Staff,0,9,30,30
1650828303898,MATH 10B,A02,083208,Staff,0,6,30,30
1650828303898,MATH 10B,B01,083739,Staff,11,0,30,19
1650828303898,MATH 10B,B02,083740,Staff,28,0,30,2
1650828309935,MATH 18,A01,083743,Staff,0,0,30,30
1650828309935,MATH 18,A02,083744,Staff,23,0,30,7
1650828309935,MATH 18,A03,083745,Staff,21,0,30,9
1650828309935,MATH 18,A04,083746,Staff,26,0,30,4
1650828309935,MATH 18,B01,083748,Staff,0,15,30,30
1650828309935,MATH 18,B02,083749,Staff,0,12,30,30
1650828309935,MATH 18,B03,083750,Staff,0,12,30,30
1650828309935,MATH 18,B04,083751,Staff,0,12,30,30
1650828315958,MATH 20A,A01,083754,Staff,19,0,40,21
1650828321984,MATH 20B,A01,083756,Staff,0,13,30,30
1650828321984,MATH 20B,A02,083757,Staff,0,12,30,30
1650828328007,MATH 20C,A01,083760,Staff,0,17,30,30
1650828328007,MATH 20C,A02,083761,Staff,0,16,30,30
1650828328007,MATH 20C,B01,083762,Staff,9,0,30,21
1650828328007,MATH 20C,B02,083763,Staff,28,0,30,2
1650828334033,MATH 20D,A01,083765,Staff,2,1,30,28
1650828334033,MATH 20D,A02,083766,Staff,6,0,30,24
1650828334033,MATH 20D,A03,083767,Staff,24,0,30,6
1650828340066,MATH 20E,A01,083771,Staff,2,0,30,28
1650828340066,MATH 20E,A02,083772,Staff,15,0,30,15
1650828340066,MATH 20E,B01,083773,Staff,0,0,30,30
1650828340066,MATH 20E,B02,083774,Staff,5,0,30,25
1650828346092,MATH 103A,A01,083777,Staff,0,16,30,30
1650828346092,MATH 103A,A02,083778,Staff,0,15,30,30
1650828346092,MATH 103A,B01,083779,Staff,0,15,30,30
1650828346092,MATH 103A,B02,083780,Staff,0,15,30,30
1650828352116,MATH 105,A01,085443,Staff,0,22,30,30
1650828358140,MATH 109,A01,083213,Anzaldo; Leesa B,0,7,30,30
1650828358140,MATH 109,A02,083214,Anzaldo; Leesa B,0,7,30,30
1650828358140,MATH 109,B01,083215,Anzaldo; Leesa B,0,8,30,30
1650828358140,MATH 109,B02,083216,Anzaldo; Leesa B,0,7,30,30
1650828364164,MATH 142A,A01,083219,Chow; Bennett,0,16,30,30
1650828364164,MATH 142A,A02,083220,Chow; Bennett,0,15,30,30
1650828364164,MATH 142A,B01,083221,Chow; Bennett,0,16,30,30
1650828364164,MATH 142A,B02,083222,Chow; Bennett,0,14,30,30
1650828370187,MATH 193A,A01,083224,Staff,0,6,30,30
1650828370187,MATH 193A,A02,083225,Staff,0,6,30,30
1650828370187,MATH 193A,A03,083781,Staff,0,6,30,30
1650828370187,MATH 193A,A04,083782,Staff,0,7,30,30
1650828376209,MATH 197,001,091859,McAuley; Julian John,9998,0,9999,1
1650828382260,COGS 9,A01,083615,Staff,0,17,60,60
1650828388284,COGS 11,A01,083617,Boyle; Mary E. T.,15,0,40,25
1650828394310,COGS 13,A01,083071,Staff,0,38,40,40
1650828400334,COGS 14A,A01,092681,Staff,0,36,100,100
1650828406366,COGS 14B,A01,083073,Cheng; Tzu-Han,0,12,50,50
1650828412389,COGS 17,A01,092677,Staff,11,0,75,64
1650828418413,COGS 100,A01,083619,Staff,0,29,60,60
1650828424434,COGS 101A,A01,083621,Davis; Joshua Daniel,0,28,60,60
1650828430461,COGS 101B,A01,091572,Staff,0,3,60,60
1650828436487,COGS 101C,A01,083625,Delgado; Tania,14,0,30,16
1650828442512,COGS 107A,A01,083627,Boyle; Mary E. T.,0,16,60,60
1650828448535,COGS 118A,A01,083075,Staff,0,8,60,60
1650828454568,CSE 3,A50,083646,Miranda; Gregory Joseph,18,0,38,20
1650828454568,CSE 3,A51,083647,Miranda; Gregory Joseph,36,0,37,1
1650828460592,CSE 8A,A50,083650,Miranda; Gregory Joseph,0,29,40,40
1650828466615,CSE 11,A01,083080,Cao; Yingjun,0,96,40,40
1650828472638,CSE 12,A01,083652,Staff,0,21,100,100
1650828478665,CSE 15L,A01,083654,Staff,0,3,50,50
1650828478665,CSE 15L,A02,083655,Staff,0,2,50,50
1650828484688,CSE 20,A01,083657,Staff,49,0,80,31
1650828490710,CSE 30,A01,083084,Eldon; John,0,75,40,40
1650828496736,CSE 100,A01,083659,Cao; Yingjun,0,71,50,50
1650828502762,CSE 134B,A01,083661,Powell; Thomas Allan,0,38,65,65
1650828508785,CSE 140,A01,083663,Staff,0,11,75,75
1650828514808,CSE 140L,A01,083088,Eldon; John,0,20,75,75
1650828520833,CSE 175,A01,083665,Kumar; Rakesh,7,0,25,18
1650828526855,CSE 190,A00,092507,Dubnov; Shlomo,10,0,20,10
1650828532886,ECE 45,A01,083139,Staff,0,1,60,60
1650828538909,ECE 65,A50,083695,Staff,0,5,30,30
1650828544933,ECE 109,A01,091882,Touri; Behrouz,32,0,70,38
1650828550970,ECE 180,A00,083140,Abi Samra; Nicholas Camill,20,0,30,10
1650828550970,ECE 180,B00,083141,Abi Samra; Nicholas Camill,0,0,30,30
1650828556997,MATH 10A,A01,083735,Patchell; Gregory David,2,0,30,28
1650828556997,MATH 10A,A02,083736,Patchell; Gregory David,27,0,30,3
1650828556997,MATH 10A,A03,083737,Patchell; Gregory David,24,0,30,6
1650828563096,MATH 10B,A01,083207,Staff,0,9,30,30
1650828563096,MATH 10B,A02,083208,Staff,0,6,30,30
1650828563096,MATH 10B,B01,083739,Staff,11,0,30,19
1650828563096,MATH 10B,B02,083740,Staff,28,0,30,2
1650828569126,MATH 18,A01,083743,Staff,0,0,30,30
1650828569126,MATH 18,A02,083744,Staff,23,0,30,7
1650828569126,MATH 18,A03,083745,Staff,21,0,30,9
1650828569126,MATH 18,A04,083746,Staff,26,0,30,4
1650828569126,MATH 18,B01,083748,Staff,0,15,30,30
1650828569126,MATH 18,B02,083749,Staff,0,12,30,30
1650828569126,MATH 18,B03,083750,Staff,0,12,30,30
1650828569126,MATH 18,B04,083751,Staff,0,12,30,30
1650828575150,MATH 20A,A01,083754,Staff,19,0,40,21
1650828581176,MATH 20B,A01,083756,Staff,0,13,30,30
1650828581176,MATH 20B,A02,083757,Staff,0,12,30,30
1650828587202,MATH 20C,A01,083760,Staff,0,17,30,30
1650828587202,MATH 20C,A02,083761,Staff,0,16,30,30
1650828587202,MATH 20C,B01,083762,Staff,9,0,30,21
1650828587202,MATH 20C,B02,083763,Staff,28,0,30,2
1650828593225,MATH 20D,A01,083765,Staff,2,1,30,28
1650828593225,MATH 20D,A02,083766,Staff,6,0,30,24
1650828593225,MATH 20D,A03,083767,Staff,24,0,30,6
1650828599248,MATH 20E,A01,083771,Staff,2,0,30,28
1650828599248,MATH 20E,A02,083772,Staff,15,0,30,15
1650828599248,MATH 20E,B01,083773,Staff,0,0,30,30
1650828599248,MATH 20E,B02,083774,Staff,5,0,30,25
1650828605274,MATH 103A,A01,083777,Staff,0,16,30,30
1650828605274,MATH 103A,A02,083778,Staff,0,15,30,30
1650828605274,MATH 103A,B01,083779,Staff,0,15,30,30
1650828605274,MATH 103A,B02,083780,Staff,0,15,30,30
1650828611297,MATH 105,A01,085443,Staff,0,22,30,30
1650828617328,MATH 109,A01,083213,Anzaldo; Leesa B,0,7,30,30
1650828617328,MATH 109,A02,083214,Anzaldo; Leesa B,0,7,30,30
1650828617328,MATH 109,B01,083215,Anzaldo; Leesa B,0,8,30,30
1650828617328,MATH 109,B02,083216,Anzaldo; Leesa B,0,7,30,30
1650828623349,MATH 142A,A01,083219,Chow; Bennett,0,16,30,30
1650828623349,MATH 142A,A02,083220,Chow; Bennett,0,15,30,30
1650828623349,MATH 142A,B01,083221,Chow; Bennett,0,16,30,30
1650828623349,MATH 142A,B02,083222,Chow; Bennett,0,14,30,30
1650828629383,MATH 193A,A01,083224,Staff,0,6,30,30
1650828629383,MATH 193A,A02,083225,Staff,0,6,30,30
1650828629383,MATH 193A,A03,083781,Staff,0,6,30,30
1650828629383,MATH 193A,A04,083782,Staff,0,7,30,30
1650828635406,MATH 197,001,091859,McAuley; Julian John,9998,0,9999,1
1650828641461,COGS 9,A01,083615,Staff,0,17,60,60
1650828647493,COGS 11,A01,083617,Boyle; Mary E. T.,15,0,40,25
1650828653516,COGS 13,A01,083071,Staff,0,38,40,40
1650828659540,COGS 14A,A01,092681,Staff,0,36,100,100
1650828665567,COGS 14B,A01,083073,Cheng; Tzu-Han,0,12,50,50
1650828671591,COGS 17,A01,092677,Staff,11,0,75,64
1650828677621,COGS 100,A01,083619,Staff,0,29,60,60
1650828683644,COGS 101A,A01,083621,Davis; Joshua Daniel,0,28,60,60
1650828689667,COGS 101B,A01,091572,Staff,0,3,60,60
1650828695692,COGS 101C,A01,083625,Delgado; Tania,14,0,30,16
1650828701717,COGS 107A,A01,083627,Boyle; Mary E. T.,0,16,60,60
1650828707742,COGS 118A,A01,083075,Staff,0,8,60,60
1650828713772,CSE 3,A50,083646,Miranda; Gregory Joseph,18,0,38,20
1650828713772,CSE 3,A51,083647,Miranda; Gregory Joseph,36,0,37,1
1650828719795,CSE 8A,A50,083650,Miranda; Gregory Joseph,0,29,40,40
1650828725819,CSE 11,A01,083080,Cao; Yingjun,0,96,40,40
1650828731842,CSE 12,A01,083652,Staff,0,21,100,100
1650828737866,CSE 15L,A01,083654,Staff,0,3,50,50
1650828737866,CSE 15L,A02,083655,Staff,0,2,50,50
1650828743891,CSE 20,A01,083657,Staff,49,0,80,31
1650828749915,CSE 30,A01,083084,Eldon; John,0,75,40,40
1650828755941,CSE 100,A01,083659,Cao; Yingjun,0,71,50,50
1650828761967,CSE 134B,A01,083661,Powell; Thomas Allan,0,38,65,65
1650828767993,CSE 140,A01,083663,Staff,0,11,75,75
1650828774016,CSE 140L,A01,083088,Eldon; John,0,20,75,75
1650828780041,CSE 175,A01,083665,Kumar; Rakesh,7,0,25,18
1650828786068,CSE 190,A00,092507,Dubnov; Shlomo,10,0,20,10
1650828792094,ECE 45,A01,083139,Staff,0,1,60,60
1650828798119,ECE 65,A50,083695,Staff,0,5,30,30
1650828804142,ECE 109,A01,091882,Touri; Behrouz,32,0,70,38
1650828810167,ECE 180,A00,083140,Abi Samra; Nicholas Camill,20,0,30,10
1650828810167,ECE 180,B00,083141,Abi Samra; Nicholas Camill,0,0,30,30
1650828816194,MATH 10A,A01,083735,Patchell; Gregory David,2,0,30,28
1650828816194,MATH 10A,A02,083736,Patchell; Gregory David,27,0,30,3
1650828816194,MATH 10A,A03,083737,Patchell; Gregory David,24,0,30,6
1650828822218,MATH 10B,A01,083207,Staff,0,9,30,30
1650828822218,MATH 10B,A02,083208,Staff,0,6,30,30
1650828822218,MATH 10B,B01,083739,Staff,11,0,30,19
1650828822218,MATH 10B,B02,083740,Staff,28,0,30,2
1650828828247,MATH 18,A01,083743,Staff,0,0,30,30
1650828828247,MATH 18,A02,083744,Staff,23,0,30,7
1650828828247,MATH 18,A03,083745,Staff,21,0,30,9
1650828828247,MATH 18,A04,083746,Staff,26,0,30,4
1650828828247,MATH 18,B01,083748,Staff,0,15,30,30
1650828828247,MATH 18,B02,083749,Staff,0,12,30,30
1650828828247,MATH 18,B03,083750,Staff,0,12,30,30
1650828828247,MATH 18,B04,083751,Staff,0,12,30,30
1650828834274,MATH 20A,A01,083754,Staff,19,0,40,21
1650828840306,MATH 20B,A01,083756,Staff,0,13,30,30
1650828840306,MATH 20B,A02,083757,Staff,0,12,30,30
1650828846333,MATH 20C,A01,083760,Staff,0,17,30,30
1650828846333,MATH 20C,A02,083761,Staff,0,16,30,30
1650828846333,MATH 20C,B01,083762,Staff,9,0,30,21
1650828846333,MATH 20C,B02,083763,Staff,28,0,30,2
1650828852369,MATH 20D,A01,083765,Staff,2,1,30,28
1650828852369,MATH 20D,A02,083766,Staff,6,0,30,24
1650828852369,MATH 20D,A03,083767,Staff,24,0,30,6
1650828858392,MATH 20E,A01,083771,Staff,2,0,30,28
1650828858392,MATH 20E,A02,083772,Staff,15,0,30,15
1650828858392,MATH 20E,B01,083773,Staff,0,0,30,30
1650828858392,MATH 20E,B02,083774,Staff,5,0,30,25
1650828864416,MATH 103A,A01,083777,Staff,0,16,30,30
1650828864416,MATH 103A,A02,083778,Staff,0,15,30,30
1650828864416,MATH 103A,B01,083779,Staff,0,15,30,30
1650828864416,MATH 103A,B02,083780,Staff,0,15,30,30
1650828870443,MATH 105,A01,085443,Staff,0,22,30,30
1650828876466,MATH 109,A01,083213,Anzaldo; Leesa B,0,7,30,30
1650828876466,MATH 109,A02,083214,Anzaldo; Leesa B,0,7,30,30
1650828876466,MATH 109,B01,083215,Anzaldo; Leesa B,0,8,30,30
1650828876466,MATH 109,B02,083216,Anzaldo; Leesa B,0,7,30,30
1650828882497,MATH 142A,A01,083219,Chow; Bennett,0,16,30,30
1650828882497,MATH 142A,A02,083220,Chow; Bennett,0,15,30,30
1650828882497,MATH 142A,B01,083221,Chow; Bennett,0,16,30,30
1650828882497,MATH 142A,B02,083222,Chow; Bennett,0,14,30,30
1650828888520,MATH 193A,A01,083224,Staff,0,6,30,30
1650828888520,MATH 193A,A02,083225,Staff,0,6,30,30
1650828888520,MATH 193A,A03,083781,Staff,0,6,30,30
1650828888520,MATH 193A,A04,083782,Staff,0,7,30,30
1650828894549,MATH 197,001,091859,McAuley; Julian John,9998,0,9999,1
1650828900602,COGS 9,A01,083615,Staff,0,17,60,60
1650828906630,COGS 11,A01,083617,Boyle; Mary E. T.,15,0,40,25
1650828912656,COGS 13,A01,083071,Staff,0,38,40,40
1650828918682,COGS 14A,A01,092681,Staff,0,36,100,100
1650828924707,COGS 14B,A01,083073,Cheng; Tzu-Han,0,12,50,50
1650828930733,COGS 17,A01,092677,Staff,11,0,75,64
1650828936760,COGS 100,A01,083619,Staff,0,29,60,60
1650828942782,COGS 101A,A01,083621,Davis; Joshua Daniel,0,28,60,60
1650828948808,COGS 101B,A01,091572,Staff,0,3,60,60
1650828954834,COGS 101C,A01,083625,Delgado; Tania,14,0,30,16
1650828960857,COGS 107A,A01,083627,Boyle; Mary E. T.,0,16,60,60
1650828966880,COGS 118A,A01,083075,Staff,0,8,60,60
1650828972909,CSE 3,A50,083646,Miranda; Gregory Joseph,18,0,38,20
1650828972909,CSE 3,A51,083647,Miranda; Gregory Joseph,36,0,37,1
1650828978937,CSE 8A,A50,083650,Miranda; Gregory Joseph,0,29,40,40
1650828984960,CSE 11,A01,083080,Cao; Yingjun,0,96,40,40
1650828990984,CSE 12,A01,083652,Staff,0,21,100,100
1650828997011,CSE 15L,A01,083654,Staff,0,3,50,50
1650828997011,CSE 15L,A02,083655,Staff,0,2,50,50
1650829003033,CSE 20,A01,083657,Staff,49,0,80,31
1650829009057,CSE 30,A01,083084,Eldon; John,0,75,40,40
1650829015083,CSE 100,A01,083659,Cao; Yingjun,0,71,50,50
1650829021109,CSE 134B,A01,083661,Powell; Thomas Allan,0,38,65,65
1650829027138,CSE 140,A01,083663,Staff,0,11,75,75
1650829033163,CSE 140L,A01,083088,Eldon; John,0,20,75,75
1650829039185,CSE 175,A01,083665,Kumar; Rakesh,7,0,25,18
1650829045210,CSE 190,A00,092507,Dubnov; Shlomo,10,0,20,10
1650829051233,ECE 45,A01,083139,Staff,0,1,60,60
1650829057257,ECE 65,A50,083695,Staff,0,5,30,30
1650829063281,ECE 109,A01,091882,Touri; Behrouz,32,0,70,38
1650829069307,ECE 180,A00,083140,Abi Samra; Nicholas Camill,20,0,30,10
1650829069307,ECE 180,B00,083141,Abi Samra; Nicholas Camill,0,0,30,30
1650829075334,MATH 10A,A01,083735,Patchell; Gregory David,2,0,30,28
1650829075334,MATH 10A,A02,083736,Patchell; Gregory David,27,0,30,3
1650829075334,MATH 10A,A03,083737,Patchell; Gregory David,24,0,30,6
1650829081358,MATH 10B,A01,083207,Staff,0,9,30,30
1650829081358,MATH 10B,A02,083208,Staff,0,6,30,30
1650829081358,MATH 10B,B01,083739,Staff,11,0,30,19
1650829081358,MATH 10B,B02,083740,Staff,28,0,30,2
1650829087390,MATH 18,A01,083743,Staff,0,0,30,30
1650829087390,MATH 18,A02,083744,Staff,23,0,30,7
1650829087390,MATH 18,A03,083745,Staff,21,0,30,9
1650829087390,MATH 18,A04,083746,Staff,26,0,30,4
1650829087390,MATH 18,B01,083748,Staff,0,15,30,30
1650829087390,MATH 18,B02,083749,Staff,0,12,30,30
1650829087390,MATH 18,B03,083750,Staff,0,12,30,30
1650829087390,MATH 18,B04,083751,Staff,0,12,30,30
1650829093418,MATH 20A,A01,083754,Staff,19,0,40,21
1650829099442,MATH 20B,A01,083756,Staff,0,13,30,30
1650829099442,MATH 20B,A02,083757,Staff,0,12,30,30
1650829105466,MATH 20C,A01,083760,Staff,0,17,30,30
1650829105466,MATH 20C,A02,083761,Staff,0,16,30,30
1650829105466,MATH 20C,B01,083762,Staff,9,0,30,21
1650829105466,MATH 20C,B02,083763,Staff,28,0,30,2
1650829111494,MATH 20D,A01,083765,Staff,2,1,30,28
1650829111494,MATH 20D,A02,083766,Staff,6,0,30,24
1650829111494,MATH 20D,A03,083767,Staff,24,0,30,6
1650829117518,MATH 20E,A01,083771,Staff,2,0,30,28
1650829117518,MATH 20E,A02,083772,Staff,15,0,30,15
1650829117518,MATH 20E,B01,083773,Staff,0,0,30,30
1650829117518,MATH 20E,B02,083774,Staff,5,0,30,25
1650829123541,MATH 103A,A01,083777,Staff,0,16,30,30
1650829123541,MATH 103A,A02,083778,Staff,0,15,30,30
1650829123541,MATH 103A,B01,083779,Staff,0,15,30,30
1650829123541,MATH 103A,B02,083780,Staff,0,15,30,30
1650829129568,MATH 105,A01,085443,Staff,0,22,30,30
1650829135595,MATH 109,A01,083213,Anzaldo; Leesa B,0,7,30,30
1650829135595,MATH 109,A02,083214,Anzaldo; Leesa B,0,7,30,30
1650829135595,MATH 109,B01,083215,Anzaldo; Leesa B,0,8,30,30
1650829135595,MATH 109,B02,083216,Anzaldo; Leesa B,0,7,30,30
1650829141619,MATH 142A,A01,083219,Chow; Bennett,0,16,30,30
1650829141619,MATH 142A,A02,083220,Chow; Bennett,0,15,30,30
1650829141619,MATH 142A,B01,083221,Chow; Bennett,0,16,30,30
1650829141619,MATH 142A,B02,083222,Chow; Bennett,0,14,30,30
1650829147642,MATH 193A,A01,083224,Staff,0,6,30,30
1650829147642,MATH 193A,A02,083225,Staff,0,6,30,30
1650829147642,MATH 193A,A03,083781,Staff,0,6,30,30
1650829147642,MATH 193A,A04,083782,Staff,0,7,30,30
1650829153668,MATH 197,001,091859,McAuley; Julian John,9998,0,9999,1
1650829159818,COGS 9,A01,083615,Staff,0,17,60,60
1650829165841,COGS 11,A01,083617,Boyle; Mary E. T.,15,0,40,25
1650829171864,COGS 13,A01,083071,Staff,0,38,40,40
1650829177889,COGS 14A,A01,092681,Staff,0,36,100,100
1650829183921,COGS 14B,A01,083073,Cheng; Tzu-Han,0,12,50,50
1650829189944,COGS 17,A01,092677,Staff,11,0,75,64
1650829195970,COGS 100,A01,083619,Staff,0,29,60,60
1650829202000,COGS 101A,A01,083621,Davis; Joshua Daniel,0,28,60,60
1650829208023,COGS 101B,A01,091572,Staff,0,3,60,60
1650829214046,COGS 101C,A01,083625,Delgado; Tania,14,0,30,16
1650829220067,COGS 107A,A01,083627,Boyle; Mary E. T.,0,16,60,60
1650829226091,COGS 118A,A01,083075,Staff,0,8,60,60
1650829232119,CSE 3,A50,083646,Miranda; Gregory Joseph,18,0,38,20
1650829232119,CSE 3,A51,083647,Miranda; Gregory Joseph,36,0,37,1
1650829238141,CSE 8A,A50,083650,Miranda; Gregory Joseph,0,29,40,40
1650829244165,CSE 11,A01,083080,Cao; Yingjun,0,96,40,40
1650829250188,CSE 12,A01,083652,Staff,0,21,100,100
1650829256211,CSE 15L,A01,083654,Staff,0,3,50,50
1650829256211,CSE 15L,A02,083655,Staff,0,2,50,50
1650829262233,CSE 20,A01,083657,Staff,49,0,80,31
1650829268257,CSE 30,A01,083084,Eldon; John,0,75,40,40
1650829274281,CSE 100,A01,083659,Cao; Yingjun,0,71,50,50
1650829280304,CSE 134B,A01,083661,Powell; Thomas Allan,0,38,65,65
1650829286328,CSE 140,A01,083663,Staff,0,11,75,75
1650829292368,CSE 140L,A01,083088,Eldon; John,0,20,75,75
1650829298392,CSE 175,A01,083665,Kumar; Rakesh,7,0,25,18
1650829304415,CSE 190,A00,092507,Dubnov; Shlomo,10,0,20,10
1650829310441,ECE 45,A01,083139,Staff,0,1,60,60
1650829316465,ECE 65,A50,083695,Staff,0,5,30,30
1650829322490,ECE 109,A01,091882,Touri; Behrouz,32,0,70,38
1650829328516,ECE 180,A00,083140,Abi Samra; Nicholas Camill,20,0,30,10
1650829328516,ECE 180,B00,083141,Abi Samra; Nicholas Camill,0,0,30,30
1650829334541,MATH 10A,A01,083735,Patchell; Gregory David,2,0,30,28
1650829334541,MATH 10A,A02,083736,Patchell; Gregory David,27,0,30,3
1650829334541,MATH 10A,A03,083737,Patchell; Gregory David,24,0,30,6
1650829340564,MATH 10B,A01,083207,Staff,0,9,30,30
1650829340564,MATH 10B,A02,083208,Staff,0,6,30,30
1650829340564,MATH 10B,B01,083739,Staff,11,0,30,19
1650829340564,MATH 10B,B02,083740,Staff,28,0,30,2
1650829346593,MATH 18,A01,083743,Staff,0,0,30,30
1650829346593,MATH 18,A02,083744,Staff,23,0,30,7
1650829346593,MATH 18,A03,083745,Staff,21,0,30,9
1650829346593,MATH 18,A04,083746,Staff,26,0,30,4
1650829346593,MATH 18,B01,083748,Staff,0,15,30,30
1650829346593,MATH 18,B02,083749,Staff,0,12,30,30
1650829346593,MATH 18,B03,083750,Staff,0,12,30,30
1650829346593,MATH 18,B04,083751,Staff,0,12,30,30
1650829352619,MATH 20A,A01,083754,Staff,19,0,40,21
1650829358646,MATH 20B,A01,083756,Staff,0,13,30,30
1650829358646,MATH 20B,A02,083757,Staff,0,12,30,30
1650829364667,MATH 20C,A01,083760,Staff,0,17,30,30
1650829364667,MATH 20C,A02,083761,Staff,0,16,30,30
1650829364667,MATH 20C,B01,083762,Staff,9,0,30,21
1650829364667,MATH 20C,B02,083763,Staff,28,0,30,2
1650829370688,MATH 20D,A01,083765,Staff,2,1,30,28
1650829370688,MATH 20D,A02,083766,Staff,6,0,30,24
1650829370688,MATH 20D,A03,083767,Staff,24,0,30,6
1650829376711,MATH 20E,A01,083771,Staff,2,0,30,28
1650829376711,MATH 20E,A02,083772,Staff,15,0,30,15
1650829376711,MATH 20E,B01,083773,Staff,0,0,30,30
1650829376711,MATH 20E,B02,083774,Staff,5,0,30,25
1650829382739,MATH 103A,A01,083777,Staff,0,16,30,30
1650829382739,MATH 103A,A02,083778,Staff,0,15,30,30
1650829382739,MATH 103A,B01,083779,Staff,0,15,30,30
1650829382739,MATH 103A,B02,083780,Staff,0,15,30,30
1650829388763,MATH 105,A01,085443,Staff,0,22,30,30
1650829394787,MATH 109,A01,083213,Anzaldo; Leesa B,0,7,30,30
1650829394787,MATH 109,A02,083214,Anzaldo; Leesa B,0,7,30,30
1650829394787,MATH 109,B01,083215,Anzaldo; Leesa B,0,8,30,30
1650829394787,MATH 109,B02,083216,Anzaldo; Leesa B,0,7,30,30
1650829400819,MATH 142A,A01,083219,Chow; Bennett,0,16,30,30
1650829400819,MATH 142A,A02,083220,Chow; Bennett,0,15,30,30
1650829400819,MATH 142A,B01,083221,Chow; Bennett,0,16,30,30
1650829400819,MATH 142A,B02,083222,Chow; Bennett,0,14,30,30
1650829406846,MATH 193A,A01,083224,Staff,0,6,30,30
1650829406846,MATH 193A,A02,083225,Staff,0,6,30,30
1650829406846,MATH 193A,A03,083781,Staff,0,6,30,30
1650829406846,MATH 193A,A04,083782,Staff,0,7,30,30
1650829412872,MATH 197,001,091859,McAuley; Julian John,9998,0,9999,1
1650829418920,COGS 9,A01,083615,Staff,0,17,60,60
1650829424946,COGS 11,A01,083617,Boyle; Mary E. T.,15,0,40,25
1650829430973,COGS 13,A01,083071,Staff,0,38,40,40
1650829437004,COGS 14A,A01,092681,Staff,0,36,100,100
1650829443031,COGS 14B,A01,083073,Cheng; Tzu-Han,0,12,50,50
1650829449062,COGS 17,A01,092677,Staff,11,0,75,64
1650829455088,COGS 100,A01,083619,Staff,0,29,60,60
1650829461112,COGS 101A,A01,083621,Davis; Joshua Daniel,0,28,60,60
1650829467136,COGS 101B,A01,091572,Staff,0,3,60,60
1650829473159,COGS 101C,A01,083625,Delgado; Tania,14,0,30,16
1650829479183,COGS 107A,A01,083627,Boyle; Mary E. T.,0,16,60,60
1650829485207,COGS 118A,A01,083075,Staff,0,8,60,60
1650829491230,CSE 3,A50,083646,Miranda; Gregory Joseph,18,0,38,20
1650829491230,CSE 3,A51,083647,Miranda; Gregory Joseph,36,0,37,1
1650829497255,CSE 8A,A50,083650,Miranda; Gregory Joseph,0,29,40,40
1650829503277,CSE 11,A01,083080,Cao; Yingjun,0,96,40,40
1650829509302,CSE 12,A01,083652,Staff,0,21,100,100
1650829515326,CSE 15L,A01,083654,Staff,0,3,50,50
1650829515326,CSE 15L,A02,083655,Staff,0,2,50,50
1650829521352,CSE 20,A01,083657,Staff,49,0,80,31
1650829527375,CSE 30,A01,083084,Eldon; John,0,75,40,40
1650829533406,CSE 100,A01,083659,Cao; Yingjun,0,71,50,50
1650829539435,CSE 134B,A01,083661,Powell; Thomas Allan,0,38,65,65
1650829545457,CSE 140,A01,083663,Staff,0,11,75,75
1650829551486,CSE 140L,A01,083088,Eldon; John,0,20,75,75
1650829557517,CSE 175,A01,083665,Kumar; Rakesh,7,0,25,18
1650829563541,CSE 190,A00,092507,Dubnov; Shlomo,10,0,20,10
1650829569562,ECE 45,A01,083139,Staff,0,1,60,60
1650829575588,ECE 65,A50,083695,Staff,0,5,30,30
1650829581614,ECE 109,A01,091882,Touri; Behrouz,32,0,70,38
1650829587638,ECE 180,A00,083140,Abi Samra; Nicholas Camill,20,0,30,10
1650829587638,ECE 180,B00,083141,Abi Samra; Nicholas Camill,0,0,30,30
1650829593665,MATH 10A,A01,083735,Patchell; Gregory David,2,0,30,28
1650829593665,MATH 10A,A02,083736,Patchell; Gregory David,27,0,30,3
1650829593665,MATH 10A,A03,083737,Patchell; Gregory David,24,0,30,6
1650829599690,MATH 10B,A01,083207,Staff,0,9,30,30
1650829599690,MATH 10B,A02,083208,Staff,0,6,30,30
1650829599690,MATH 10B,B01,083739,Staff,11,0,30,19
1650829599690,MATH 10B,B02,083740,Staff,28,0,30,2
1650829605715,MATH 18,A01,083743,Staff,0,0,30,30
1650829605715,MATH 18,A02,083744,Staff,23,0,30,7
1650829605715,MATH 18,A03,083745,Staff,21,0,30,9
1650829605715,MATH 18,A04,083746,Staff,26,0,30,4
1650829605715,MATH 18,B01,083748,Staff,0,15,30,30
1650829605715,MATH 18,B02,083749,Staff,0,12,30,30
1650829605715,MATH 18,B03,083750,Staff,0,12,30,30
1650829605715,MATH 18,B04,083751,Staff,0,12,30,30
1650829611738,MATH 20A,A01,083754,Staff,19,0,40,21
1650829617761,MATH 20B,A01,083756,Staff,0,13,30,30
1650829617761,MATH 20B,A02,083757,Staff,0,12,30,30
1650829623790,MATH 20C,A01,083760,Staff,0,17,30,30
1650829623790,MATH 20C,A02,083761,Staff,0,16,30,30
1650829623790,MATH 20C,B01,083762,Staff,9,0,30,21
1650829623790,MATH 20C,B02,083763,Staff,28,0,30,2
1650829629817,MATH 20D,A01,083765,Staff,2,1,30,28
1650829629817,MATH 20D,A02,083766,Staff,6,0,30,24
1650829629817,MATH 20D,A03,083767,Staff,24,0,30,6
1650829635841,MATH 20E,A01,083771,Staff,2,0,30,28
1650829635841,MATH 20E,A02,083772,Staff,15,0,30,15
1650829635841,MATH 20E,B01,083773,Staff,0,0,30,30
1650829635841,MATH 20E,B02,083774,Staff,5,0,30,25
1650829641870,MATH 103A,A01,083777,Staff,0,16,30,30
1650829641870,MATH 103A,A02,083778,Staff,0,15,30,30
1650829641870,MATH 103A,B01,083779,Staff,0,15,30,30
1650829641870,MATH 103A,B02,083780,Staff,0,15,30,30
1650829647894,MATH 105,A01,085443,Staff,0,22,30,30
1650829653936,MATH 109,A01,083213,Anzaldo; Leesa B,0,7,30,30
1650829653936,MATH 109,A02,083214,Anzaldo; Leesa B,0,7,30,30
1650829653936,MATH 109,B01,083215,Anzaldo; Leesa B,0,8,30,30
1650829653936,MATH 109,B02,083216,Anzaldo; Leesa B,0,7,30,30
1650829659961,MATH 142A,A01,083219,Chow; Bennett,0,16,30,30
1650829659961,MATH 142A,A02,083220,Chow; Bennett,0,15,30,30
1650829659961,MATH 142A,B01,083221,Chow; Bennett,0,16,30,30
1650829659961,MATH 142A,B02,083222,Chow; Bennett,0,14,30,30
1650829665984,MATH 193A,A01,083224,Staff,0,6,30,30
1650829665984,MATH 193A,A02,083225,Staff,0,6,30,30
1650829665984,MATH 193A,A03,083781,Staff,0,6,30,30
1650829665984,MATH 193A,A04,083782,Staff,0,7,30,30
1650829672008,MATH 197,001,091859,McAuley; Julian John,9998,0,9999,1
1650829678057,COGS 9,A01,083615,Staff,0,17,60,60
1650829684081,COGS 11,A01,083617,Boyle; Mary E. T.,15,0,40,25
1650829690103,COGS 13,A01,083071,Staff,0,38,40,40
1650829696126,COGS 14A,A01,092681,Staff,0,36,100,100
1650829702153,COGS 14B,A01,083073,Cheng; Tzu-Han,0,12,50,50
1650829708181,COGS 17,A01,092677,Staff,11,0,75,64
1650829714206,COGS 100,A01,083619,Staff,0,29,60,60
1650829720230,COGS 101A,A01,083621,Davis; Joshua Daniel,0,28,60,60
1650829726253,COGS 101B,A01,091572,Staff,0,3,60,60
1650829732281,COGS 101C,A01,083625,Delgado; Tania,14,0,30,16
1650829738308,COGS 107A,A01,083627,Boyle; Mary E. T.,0,16,60,60
1650829744331,COGS 118A,A01,083075,Staff,0,8,60,60
1650829750460,CSE 3,A50,083646,Miranda; Gregory Joseph,18,0,38,20
1650829750460,CSE 3,A51,083647,Miranda; Gregory Joseph,36,0,37,1
1650829756488,CSE 8A,A50,083650,Miranda; Gregory Joseph,0,29,40,40
1650829762516,CSE 11,A01,083080,Cao; Yingjun,0,96,40,40
1650829768551,CSE 12,A01,083652,Staff,0,21,100,100
1650829774575,CSE 15L,A01,083654,Staff,0,3,50,50
1650829774575,CSE 15L,A02,083655,Staff,0,2,50,50
1650829780597,CSE 20,A01,083657,Staff,49,0,80,31
1650829786625,CSE 30,A01,083084,Eldon; John,0,75,40,40
1650829792647,CSE 100,A01,083659,Cao; Yingjun,0,71,50,50
1650829798670,CSE 134B,A01,083661,Powell; Thomas Allan,0,38,65,65
1650829804693,CSE 140,A01,083663,Staff,0,11,75,75
1650829810718,CSE 140L,A01,083088,Eldon; John,0,20,75,75
1650829816743,CSE 175,A01,083665,Kumar; Rakesh,7,0,25,18
1650829822766,CSE 190,A00,092507,Dubnov; Shlomo,10,0,20,10
1650829828793,ECE 45,A01,083139,Staff,0,1,60,60
1650829834816,ECE 65,A50,083695,Staff,0,5,30,30
1650829840842,ECE 109,A01,091882,Touri; Behrouz,32,0,70,38
1650829846870,ECE 180,A00,083140,Abi Samra; Nicholas Camill,20,0,30,10
1650829846870,ECE 180,B00,083141,Abi Samra; Nicholas Camill,0,0,30,30
1650829852896,MATH 10A,A01,083735,Patchell; Gregory David,2,0,30,28
1650829852896,MATH 10A,A02,083736,Patchell; Gregory David,27,0,30,3
1650829852896,MATH 10A,A03,083737,Patchell; Gregory David,24,0,30,6
1650829858936,MATH 10B,A01,083207,Staff,0,9,30,30
1650829858936,MATH 10B,A02,083208,Staff,0,6,30,30
1650829858936,MATH 10B,B01,083739,Staff,11,0,30,19
1650829858936,MATH 10B,B02,083740,Staff,28,0,30,2
1650829864960,MATH 18,A01,083743,Staff,0,0,30,30
1650829864960,MATH 18,A02,083744,Staff,23,0,30,7
1650829864960,MATH 18,A03,083745,Staff,21,0,30,9
1650829864960,MATH 18,A04,083746,Staff,26,0,30,4
1650829864960,MATH 18,B01,083748,Staff,0,15,30,30
1650829864960,MATH 18,B02,083749,Staff,0,12,30,30
1650829864960,MATH 18,B03,083750,Staff,0,12,30,30
1650829864960,MATH 18,B04,083751,Staff,0,12,30,30
1650829870986,MATH 20A,A01,083754,Staff,19,0,40,21
1650829877009,MATH 20B,A01,083756,Staff,0,13,30,30
1650829877009,MATH 20B,A02,083757,Staff,0,12,30,30
1650829883037,MATH 20C,A01,083760,Staff,0,17,30,30
1650829883037,MATH 20C,A02,083761,Staff,0,16,30,30
1650829883037,MATH 20C,B01,083762,Staff,9,0,30,21
1650829883037,MATH 20C,B02,083763,Staff,28,0,30,2
1650829889065,MATH 20D,A01,083765,Staff,2,1,30,28
1650829889065,MATH 20D,A02,083766,Staff,6,0,30,24
1650829889065,MATH 20D,A03,083767,Staff,24,0,30,6
1650829895088,MATH 20E,A01,083771,Staff,2,0,30,28
1650829895088,MATH 20E,A02,083772,Staff,15,0,30,15
1650829895088,MATH 20E,B01,083773,Staff,0,0,30,30
1650829895088,MATH 20E,B02,083774,Staff,5,0,30,25
1650829901117,MATH 103A,A01,083777,Staff,0,16,30,30
1650829901117,MATH 103A,A02,083778,Staff,0,15,30,30
1650829901117,MATH 103A,B01,083779,Staff,0,15,30,30
1650829901117,MATH 103A,B02,083780,Staff,0,15,30,30
1650829907141,MATH 105,A01,085443,Staff,0,22,30,30
1650829913169,MATH 109,A01,083213,Anzaldo; Leesa B,0,7,30,30
1650829913169,MATH 109,A02,083214,Anzaldo; Leesa B,0,7,30,30
1650829913169,MATH 109,B01,083215,Anzaldo; Leesa B,0,8,30,30
1650829913169,MATH 109,B02,083216,Anzaldo; Leesa B,0,7,30,30
1650829919193,MATH 142A,A01,083219,Chow; Bennett,0,16,30,30
1650829919193,MATH 142A,A02,083220,Chow; Bennett,0,15,30,30
1650829919193,MATH 142A,B01,083221,Chow; Bennett,0,16,30,30
1650829919193,MATH 142A,B02,083222,Chow; Bennett,0,14,30,30
1650829925217,MATH 193A,A01,083224,Staff,0,6,30,30
1650829925217,MATH 193A,A02,083225,Staff,0,6,30,30
1650829925217,MATH 193A,A03,083781,Staff,0,6,30,30
1650829925217,MATH 193A,A04,083782,Staff,0,7,30,30
1650829931249,MATH 197,001,091859,McAuley; Julian John,9998,0,9999,1
1650829937325,COGS 9,A01,083615,Staff,0,17,60,60
1650829943350,COGS 11,A01,083617,Boyle; Mary E. T.,15,0,40,25
1650829949386,COGS 13,A01,083071,Staff,0,38,40,40
1650829955412,COGS 14A,A01,092681,Staff,0,36,100,100
1650829961453,COGS 14B,A01,083073,Cheng; Tzu-Han,0,12,50,50
1650829967495,COGS 17,A01,092677,Staff,11,0,75,64
1650829973523,COGS 100,A01,083619,Staff,0,29,60,60
1650829979545,COGS 101A,A01,083621,Davis; Joshua Daniel,0,28,60,60
1650829985570,COGS 101B,A01,091572,Staff,0,3,60,60
1650829991596,COGS 101C,A01,083625,Delgado; Tania,14,0,30,16
1650829997621,COGS 107A,A01,083627,Boyle; Mary E. T.,0,16,60,60
1650830003644,COGS 118A,A01,083075,Staff,0,8,60,60
1650830009668,CSE 3,A50,083646,Miranda; Gregory Joseph,18,0,38,20
1650830009668,CSE 3,A51,083647,Miranda; Gregory Joseph,36,0,37,1
1650830015696,CSE 8A,A50,083650,Miranda; Gregory Joseph,0,29,40,40
1650830021718,CSE 11,A01,083080,Cao; Yingjun,0,96,40,40
1650830027741,CSE 12,A01,083652,Staff,0,21,100,100
1650830033765,CSE 15L,A01,083654,Staff,0,3,50,50
1650830033765,CSE 15L,A02,083655,Staff,0,2,50,50
1650830039792,CSE 20,A01,083657,Staff,49,0,80,31
1650830045818,CSE 30,A01,083084,Eldon; John,0,75,40,40
1650830051842,CSE 100,A01,083659,Cao; Yingjun,0,71,50,50
1650830057868,CSE 134B,A01,083661,Powell; Thomas Allan,0,38,65,65
1650830063892,CSE 140,A01,083663,Staff,0,11,75,75
1650830069916,CSE 140L,A01,083088,Eldon; John,0,20,75,75
1650830075939,CSE 175,A01,083665,Kumar; Rakesh,7,0,25,18
1650830081963,CSE 190,A00,092507,Dubnov; Shlomo,10,0,20,10
1650830087990,ECE 45,A01,083139,Staff,0,1,60,60
1650830094013,ECE 65,A50,083695,Staff,0,5,30,30
1650830100039,ECE 109,A01,091882,Touri; Behrouz,32,0,70,38
1650830106063,ECE 180,A00,083140,Abi Samra; Nicholas Camill,20,0,30,10
1650830106063,ECE 180,B00,083141,Abi Samra; Nicholas Camill,0,0,30,30
1650830112086,MATH 10A,A01,083735,Patchell; Gregory David,2,0,30,28
1650830112086,MATH 10A,A02,083736,Patchell; Gregory David,27,0,30,3
1650830112086,MATH 10A,A03,083737,Patchell; Gregory David,24,0,30,6
1650830118113,MATH 10B,A01,083207,Staff,0,9,30,30
1650830118113,MATH 10B,A02,083208,Staff,0,6,30,30
1650830118113,MATH 10B,B01,083739,Staff,11,0,30,19
1650830118113,MATH 10B,B02,083740,Staff,28,0,30,2
1650830124141,MATH 18,A01,083743,Staff,0,0,30,30
1650830124141,MATH 18,A02,083744,Staff,23,0,30,7
1650830124141,MATH 18,A03,083745,Staff,21,0,30,9
1650830124141,MATH 18,A04,083746,Staff,26,0,30,4
1650830124141,MATH 18,B01,083748,Staff,0,15,30,30
1650830124141,MATH 18,B02,083749,Staff,0,12,30,30
1650830124141,MATH 18,B03,083750,Staff,0,12,30,30
1650830124141,MATH 18,B04,083751,Staff,0,12,30,30
1650830130173,MATH 20A,A01,083754,Staff,19,0,40,21
1650830136197,MATH 20B,A01,083756,Staff,0,13,30,30
1650830136197,MATH 20B,A02,083757,Staff,0,12,30,30
1650830142224,MATH 20C,A01,083760,Staff,0,17,30,30
1650830142224,MATH 20C,A02,083761,Staff,0,16,30,30
1650830142224,MATH 20C,B01,083762,Staff,9,0,30,21
1650830142224,MATH 20C,B02,083763,Staff,28,0,30,2
1650830148248,MATH 20D,A01,083765,Staff,2,1,30,28
1650830148248,MATH 20D,A02,083766,Staff,6,0,30,24
1650830148248,MATH 20D,A03,083767,Staff,24,0,30,6
1650830154272,MATH 20E,A01,083771,Staff,2,0,30,28
1650830154272,MATH 20E,A02,083772,Staff,15,0,30,15
1650830154272,MATH 20E,B01,083773,Staff,0,0,30,30
1650830154272,MATH 20E,B02,083774,Staff,5,0,30,25
1650830160301,MATH 103A,A01,083777,Staff,0,16,30,30
1650830160301,MATH 103A,A02,083778,Staff,0,15,30,30
1650830160301,MATH 103A,B01,083779,Staff,0,15,30,30
1650830160301,MATH 103A,B02,083780,Staff,0,15,30,30
1650830166323,MATH 105,A01,085443,Staff,0,22,30,30
1650830172347,MATH 109,A01,083213,Anzaldo; Leesa B,0,7,30,30
1650830172347,MATH 109,A02,083214,Anzaldo; Leesa B,0,7,30,30
1650830172347,MATH 109,B01,083215,Anzaldo; Leesa B,0,8,30,30
1650830172347,MATH 109,B02,083216,Anzaldo; Leesa B,0,7,30,30
1650830178371,MATH 142A,A01,083219,Chow; Bennett,0,16,30,30
1650830178371,MATH 142A,A02,083220,Chow; Bennett,0,15,30,30
1650830178371,MATH 142A,B01,083221,Chow; Bennett,0,16,30,30
1650830178371,MATH 142A,B02,083222,Chow; Bennett,0,14,30,30
1650830184393,MATH 193A,A01,083224,Staff,0,6,30,30
1650830184393,MATH 193A,A02,083225,Staff,0,6,30,30
1650830184393,MATH 193A,A03,083781,Staff,0,6,30,30
1650830184393,MATH 193A,A04,083782,Staff,0,7,30,30
1650830190417,MATH 197,001,091859,McAuley; Julian John,9998,0,9999,1
1650830196475,COGS 9,A01,083615,Staff,0,17,60,60
1650830202501,COGS 11,A01,083617,Boyle; Mary E. T.,15,0,40,25
1650830208529,COGS 13,A01,083071,Staff,0,38,40,40
1650830214553,COGS 14A,A01,092681,Staff,0,36,100,100
1650830220576,COGS 14B,A01,083073,Cheng; Tzu-Han,0,12,50,50
1650830226612,COGS 17,A01,092677,Staff,11,0,75,64
1650830232638,COGS 100,A01,083619,Staff,0,29,60,60
1650830238664,COGS 101A,A01,083621,Davis; Joshua Daniel,0,28,60,60
1650830244688,COGS 101B,A01,091572,Staff,0,3,60,60
1650830250714,COGS 101C,A01,083625,Delgado; Tania,14,0,30,16
1650830256738,COGS 107A,A01,083627,Boyle; Mary E. T.,0,16,60,60
1650830262759,COGS 118A,A01,083075,Staff,0,8,60,60
1650830268788,CSE 3,A50,083646,Miranda; Gregory Joseph,18,0,38,20
1650830268788,CSE 3,A51,083647,Miranda; Gregory Joseph,36,0,37,1
1650830274813,CSE 8A,A50,083650,Miranda; Gregory Joseph,0,29,40,40
1650830280837,CSE 11,A01,083080,Cao; Yingjun,0,96,40,40
1650830286860,CSE 12,A01,083652,Staff,0,21,100,100
1650830292884,CSE 15L,A01,083654,Staff,0,3,50,50
1650830292884,CSE 15L,A02,083655,Staff,0,2,50,50
1650830298910,CSE 20,A01,083657,Staff,49,0,80,31
1650830304942,CSE 30,A01,083084,Eldon; John,0,75,40,40
1650830310966,CSE 100,A01,083659,Cao; Yingjun,0,71,50,50
1650830317106,CSE 134B,A01,083661,Powell; Thomas Allan,0,38,65,65
1650830323133,CSE 140,A01,083663,Staff,0,11,75,75
1650830329155,CSE 140L,A01,083088,Eldon; John,0,20,75,75
1650830335180,CSE 175,A01,083665,Kumar; Rakesh,7,0,25,18
1650830341210,CSE 190,A00,092507,Dubnov; Shlomo,10,0,20,10
1650830347326,ECE 45,A01,083139,Staff,0,1,60,60
1650830353352,ECE 65,A50,083695,Staff,0,5,30,30
1650830359375,ECE 109,A01,091882,Touri; Behrouz,32,0,70,38
1650830365399,ECE 180,A00,083140,Abi Samra; Nicholas Camill,20,0,30,10
1650830365399,ECE 180,B00,083141,Abi Samra; Nicholas Camill,0,0,30,30
1650830371426,MATH 10A,A01,083735,Patchell; Gregory David,2,0,30,28
1650830371426,MATH 10A,A02,083736,Patchell; Gregory David,27,0,30,3
1650830371426,MATH 10A,A03,083737,Patchell; Gregory David,24,0,30,6
1650830377450,MATH 10B,A01,083207,Staff,0,9,30,30
1650830377450,MATH 10B,A02,083208,Staff,0,6,30,30
1650830377450,MATH 10B,B01,083739,Staff,11,0,30,19
1650830377450,MATH 10B,B02,083740,Staff,28,0,30,2
1650830383475,MATH 18,A01,083743,Staff,0,0,30,30
1650830383475,MATH 18,A02,083744,Staff,23,0,30,7
1650830383475,MATH 18,A03,083745,Staff,21,0,30,9
1650830383475,MATH 18,A04,083746,Staff,26,0,30,4
1650830383475,MATH 18,B01,083748,Staff,0,15,30,30
1650830383475,MATH 18,B02,083749,Staff,0,12,30,30
1650830383475,MATH 18,B03,083750,Staff,0,12,30,30
1650830383475,MATH 18,B04,083751,Staff,0,12,30,30
1650830389498,MATH 20A,A01,083754,Staff,19,0,40,21
1650830395520,MATH 20B,A01,083756,Staff,0,13,30,30
1650830395520,MATH 20B,A02,083757,Staff,0,12,30,30
1650830401546,MATH 20C,A01,083760,Staff,0,17,30,30
1650830401546,MATH 20C,A02,083761,Staff,0,16,30,30
1650830401546,MATH 20C,B01,083762,Staff,9,0,30,21
1650830401546,MATH 20C,B02,083763,Staff,28,0,30,2
1650830407576,MATH 20D,A01,083765,Staff,2,1,30,28
1650830407576,MATH 20D,A02,083766,Staff,6,0,30,24
1650830407576,MATH 20D,A03,083767,Staff,24,0,30,6
1650830413600,MATH 20E,A01,083771,Staff,2,0,30,28
1650830413600,MATH 20E,A02,083772,Staff,15,0,30,15
1650830413600,MATH 20E,B01,083773,Staff,0,0,30,30
1650830413600,MATH 20E,B02,083774,Staff,5,0,30,25
1650830419625,MATH 103A,A01,083777,Staff,0,16,30,30
1650830419625,MATH 103A,A02,083778,Staff,0,15,30,30
1650830419625,MATH 103A,B01,083779,Staff,0,15,30,30
1650830419625,MATH 103A,B02,083780,Staff,0,15,30,30
1650830425652,MATH 105,A01,085443,Staff,0,22,30,30
1650830431680,MATH 109,A01,083213,Anzaldo; Leesa B,0,7,30,30
1650830431680,MATH 109,A02,083214,Anzaldo; Leesa B,0,7,30,30
1650830431680,MATH 109,B01,083215,Anzaldo; Leesa B,0,8,30,30
1650830431680,MATH 109,B02,083216,Anzaldo; Leesa B,0,7,30,30
1650830437706,MATH 142A,A01,083219,Chow; Bennett,0,16,30,30
1650830437706,MATH 142A,A02,083220,Chow; Bennett,0,15,30,30
1650830437706,MATH 142A,B01,083221,Chow; Bennett,0,16,30,30
1650830437706,MATH 142A,B02,083222,Chow; Bennett,0,14,30,30
1650830443737,MATH 193A,A01,083224,Staff,0,6,30,30
1650830443737,MATH 193A,A02,083225,Staff,0,6,30,30
1650830443737,MATH 193A,A03,083781,Staff,0,6,30,30
1650830443737,MATH 193A,A04,083782,Staff,0,7,30,30
1650830449760,MATH 197,001,091859,McAuley; Julian John,9998,0,9999,1
1650830455819,COGS 9,A01,083615,Staff,0,17,60,60
1650830461841,COGS 11,A01,083617,Boyle; Mary E. T.,15,0,40,25
1650830467864,COGS 13,A01,083071,Staff,0,38,40,40
1650830473887,COGS 14A,A01,092681,Staff,0,36,100,100
1650830479910,COGS 14B,A01,083073,Cheng; Tzu-Han,0,12,50,50
1650830485935,COGS 17,A01,092677,Staff,11,0,75,64
1650830491957,COGS 100,A01,083619,Staff,0,29,60,60
1650830497984,COGS 101A,A01,083621,Davis; Joshua Daniel,0,28,60,60
1650830504017,COGS 101B,A01,091572,Staff,0,3,60,60
1650830510043,COGS 101C,A01,083625,Delgado; Tania,14,0,30,16
1650830516066,COGS 107A,A01,083627,Boyle; Mary E. T.,0,16,60,60
1650830522093,COGS 118A,A01,083075,Staff,0,8,60,60
1650830528116,CSE 3,A50,083646,Miranda; Gregory Joseph,18,0,38,20
1650830528116,CSE 3,A51,083647,Miranda; Gregory Joseph,36,0,37,1
1650830534142,CSE 8A,A50,083650,Miranda; Gregory Joseph,0,29,40,40
1650830540170,CSE 11,A01,083080,Cao; Yingjun,0,96,40,40
1650830546196,CSE 12,A01,083652,Staff,0,21,100,100
1650830552221,CSE 15L,A01,083654,Staff,0,3,50,50
1650830552221,CSE 15L,A02,083655,Staff,0,2,50,50
1650830558244,CSE 20,A01,083657,Staff,49,0,80,31
1650830564268,CSE 30,A01,083084,Eldon; John,0,75,40,40
1650830570292,CSE 100,A01,083659,Cao; Yingjun,0,71,50,50
1650830576320,CSE 134B,A01,083661,Powell; Thomas Allan,0,38,65,65
1650830582350,CSE 140,A01,083663,Staff,0,11,75,75
1650830588377,CSE 140L,A01,083088,Eldon; John,0,20,75,75
1650830594400,CSE 175,A01,083665,Kumar; Rakesh,7,0,25,18
1650830600424,CSE 190,A00,092507,Dubnov; Shlomo,10,0,20,10
1650830606447,ECE 45,A01,083139,Staff,0,1,60,60
1650830612469,ECE 65,A50,083695,Staff,0,5,30,30
1650830618502,ECE 109,A01,091882,Touri; Behrouz,32,0,70,38
1650830624529,ECE 180,A00,083140,Abi Samra; Nicholas Camill,20,0,30,10
1650830624529,ECE 180,B00,083141,Abi Samra; Nicholas Camill,0,0,30,30
1650830630556,MATH 10A,A01,083735,Patchell; Gregory David,2,0,30,28
1650830630556,MATH 10A,A02,083736,Patchell; Gregory David,27,0,30,3
1650830630556,MATH 10A,A03,083737,Patchell; Gregory David,24,0,30,6
1650830636579,MATH 10B,A01,083207,Staff,0,9,30,30
1650830636579,MATH 10B,A02,083208,Staff,0,6,30,30
1650830636579,MATH 10B,B01,083739,Staff,11,0,30,19
1650830636579,MATH 10B,B02,083740,Staff,28,0,30,2
1650830642606,MATH 18,A01,083743,Staff,0,0,30,30
1650830642606,MATH 18,A02,083744,Staff,23,0,30,7
1650830642606,MATH 18,A03,083745,Staff,21,0,30,9
1650830642606,MATH 18,A04,083746,Staff,26,0,30,4
1650830642606,MATH 18,B01,083748,Staff,0,15,30,30
1650830642606,MATH 18,B02,083749,Staff,0,12,30,30
1650830642606,MATH 18,B03,083750,Staff,0,12,30,30
1650830642606,MATH 18,B04,083751,Staff,0,12,30,30
1650830648630,MATH 20A,A01,083754,Staff,19,0,40,21
1650830654659,MATH 20B,A01,083756,Staff,0,13,30,30
1650830654659,MATH 20B,A02,083757,Staff,0,12,30,30
1650830660685,MATH 20C,A01,083760,Staff,0,17,30,30
1650830660685,MATH 20C,A02,083761,Staff,0,16,30,30
1650830660685,MATH 20C,B01,083762,Staff,9,0,30,21
1650830660685,MATH 20C,B02,083763,Staff,28,0,30,2
1650830666708,MATH 20D,A01,083765,Staff,2,1,30,28
1650830666708,MATH 20D,A02,083766,Staff,6,0,30,24
1650830666708,MATH 20D,A03,083767,Staff,24,0,30,6
1650830672737,MATH 20E,A01,083771,Staff,2,0,30,28
1650830672737,MATH 20E,A02,083772,Staff,15,0,30,15
1650830672737,MATH 20E,B01,083773,Staff,0,0,30,30
1650830672737,MATH 20E,B02,083774,Staff,5,0,30,25
1650830678768,MATH 103A,A01,083777,Staff,0,16,30,30
1650830678768,MATH 103A,A02,083778,Staff,0,15,30,30
1650830678768,MATH 103A,B01,083779,Staff,0,15,30,30
1650830678768,MATH 103A,B02,083780,Staff,0,15,30,30
1650830684792,MATH 105,A01,085443,Staff,0,22,30,30
1650830690816,MATH 109,A01,083213,Anzaldo; Leesa B,0,7,30,30
1650830690816,MATH 109,A02,083214,Anzaldo; Leesa B,0,7,30,30
1650830690816,MATH 109,B01,083215,Anzaldo; Leesa B,0,8,30,30
1650830690816,MATH 109,B02,083216,Anzaldo; Leesa B,0,7,30,30
1650830696841,MATH 142A,A01,083219,Chow; Bennett,0,16,30,30
1650830696841,MATH 142A,A02,083220,Chow; Bennett,0,15,30,30
1650830696841,MATH 142A,B01,083221,Chow; Bennett,0,16,30,30
1650830696841,MATH 142A,B02,083222,Chow; Bennett,0,14,30,30
1650830702863,MATH 193A,A01,083224,Staff,0,6,30,30
1650830702863,MATH 193A,A02,083225,Staff,0,6,30,30
1650830702863,MATH 193A,A03,083781,Staff,0,6,30,30
1650830702863,MATH 193A,A04,083782,Staff,0,7,30,30
1650830708886,MATH 197,001,091859,McAuley; Julian John,9998,0,9999,1
1650830714939,COGS 9,A01,083615,Staff,0,17,60,60
1650830720963,COGS 11,A01,083617,Boyle; Mary E. T.,15,0,40,25
1650830726990,COGS 13,A01,083071,Staff,0,38,40,40
1650830733014,COGS 14A,A01,092681,Staff,0,36,100,100
1650830739041,COGS 14B,A01,083073,Cheng; Tzu-Han,0,12,50,50
1650830745064,COGS 17,A01,092677,Staff,11,0,75,64
1650830751091,COGS 100,A01,083619,Staff,0,29,60,60
1650830757118,COGS 101A,A01,083621,Davis; Joshua Daniel,0,28,60,60
1650830763152,COGS 101B,A01,091572,Staff,0,3,60,60
1650830769179,COGS 101C,A01,083625,Delgado; Tania,14,0,30,16
1650830775214,COGS 107A,A01,083627,Boyle; Mary E. T.,0,16,60,60
1650830781241,COGS 118A,A01,083075,Staff,0,8,60,60
1650830787263,CSE 3,A50,083646,Miranda; Gregory Joseph,18,0,38,20
1650830787263,CSE 3,A51,083647,Miranda; Gregory Joseph,36,0,37,1
1650830793288,CSE 8A,A50,083650,Miranda; Gregory Joseph,0,29,40,40
1650830799312,CSE 11,A01,083080,Cao; Yingjun,0,96,40,40
1650830805336,CSE 12,A01,083652,Staff,0,21,100,100
1650830811363,CSE 15L,A01,083654,Staff,0,3,50,50
1650830811363,CSE 15L,A02,083655,Staff,0,2,50,50
1650830817391,CSE 20,A01,083657,Staff,49,0,80,31
1650830823419,CSE 30,A01,083084,Eldon; John,0,75,40,40
1650830829446,CSE 100,A01,083659,Cao; Yingjun,0,71,50,50
1650830835469,CSE 134B,A01,083661,Powell; Thomas Allan,0,38,65,65
1650830841497,CSE 140,A01,083663,Staff,0,11,75,75
1650830847531,CSE 140L,A01,083088,Eldon; John,0,20,75,75
1650830853555,CSE 175,A01,083665,Kumar; Rakesh,7,0,25,18
1650830859577,CSE 190,A00,092507,Dubnov; Shlomo,10,0,20,10
1650830865601,ECE 45,A01,083139,Staff,0,1,60,60
1650830871627,ECE 65,A50,083695,Staff,0,5,30,30
1650830877654,ECE 109,A01,091882,Touri; Behrouz,32,0,70,38
1650830883681,ECE 180,A00,083140,Abi Samra; Nicholas Camill,20,0,30,10
1650830883681,ECE 180,B00,083141,Abi Samra; Nicholas Camill,0,0,30,30
1650830889704,MATH 10A,A01,083735,Patchell; Gregory David,2,0,30,28
1650830889704,MATH 10A,A02,083736,Patchell; Gregory David,27,0,30,3
1650830889704,MATH 10A,A03,083737,Patchell; Gregory David,24,0,30,6
1650830895740,MATH 10B,A01,083207,Staff,0,9,30,30
1650830895740,MATH 10B,A02,083208,Staff,0,6,30,30
1650830895740,MATH 10B,B01,083739,Staff,11,0,30,19
1650830895740,MATH 10B,B02,083740,Staff,28,0,30,2
1650830901772,MATH 18,A01,083743,Staff,0,0,30,30
1650830901772,MATH 18,A02,083744,Staff,23,0,30,7
1650830901772,MATH 18,A03,083745,Staff,21,0,30,9
1650830901772,MATH 18,A04,083746,Staff,26,0,30,4
1650830901772,MATH 18,B01,083748,Staff,0,15,30,30
1650830901772,MATH 18,B02,083749,Staff,0,12,30,30
1650830901772,MATH 18,B03,083750,Staff,0,12,30,30
1650830901772,MATH 18,B04,083751,Staff,0,12,30,30
1650830907799,MATH 20A,A01,083754,Staff,19,0,40,21
1650830913822,MATH 20B,A01,083756,Staff,0,13,30,30
1650830913822,MATH 20B,A02,083757,Staff,0,12,30,30
1650830919850,MATH 20C,A01,083760,Staff,0,17,30,30
1650830919850,MATH 20C,A02,083761,Staff,0,16,30,30
1650830919850,MATH 20C,B01,083762,Staff,9,0,30,21
1650830919850,MATH 20C,B02,083763,Staff,28,0,30,2
1650830925873,MATH 20D,A01,083765,Staff,2,1,30,28
1650830925873,MATH 20D,A02,083766,Staff,6,0,30,24
1650830925873,MATH 20D,A03,083767,Staff,24,0,30,6
1650830931896,MATH 20E,A01,083771,Staff,2,0,30,28
1650830931896,MATH 20E,A02,083772,Staff,15,0,30,15
1650830931896,MATH 20E,B01,083773,Staff,0,0,30,30
1650830931896,MATH 20E,B02,083774,Staff,5,0,30,25
1650830937924,MATH 103A,A01,083777,Staff,0,16,30,30
1650830937924,MATH 103A,A02,083778,Staff,0,15,30,30
1650830937924,MATH 103A,B01,083779,Staff,0,15,30,30
1650830937924,MATH 103A,B02,083780,Staff,0,15,30,30
1650830944062,MATH 105,A01,085443,Staff,0,22,30,30
1650830950087,MATH 109,A01,083213,Anzaldo; Leesa B,0,7,30,30
1650830950087,MATH 109,A02,083214,Anzaldo; Leesa B,0,7,30,30
1650830950087,MATH 109,B01,083215,Anzaldo; Leesa B,0,8,30,30
1650830950087,MATH 109,B02,083216,Anzaldo; Leesa B,0,7,30,30
1650830956114,MATH 142A,A01,083219,Chow; Bennett,0,16,30,30
1650830956114,MATH 142A,A02,083220,Chow; Bennett,0,15,30,30
1650830956114,MATH 142A,B01,083221,Chow; Bennett,0,16,30,30
1650830956114,MATH 142A,B02,083222,Chow; Bennett,0,14,30,30
1650830962142,MATH 193A,A01,083224,Staff,0,6,30,30
1650830962142,MATH 193A,A02,083225,Staff,0,6,30,30
1650830962142,MATH 193A,A03,083781,Staff,0,6,30,30
1650830962142,MATH 193A,A04,083782,Staff,0,7,30,30
1650830968166,MATH 197,001,091859,McAuley; Julian John,9998,0,9999,1
1650830974218,COGS 9,A01,083615,Staff,0,17,60,60
1650830980244,COGS 11,A01,083617,Boyle; Mary E. T.,15,0,40,25
1650830986268,COGS 13,A01,083071,Staff,0,38,40,40
1650830992294,COGS 14A,A01,092681,Staff,0,36,100,100
1650830998318,COGS 14B,A01,083073,Cheng; Tzu-Han,0,12,50,50
1650831004352,COGS 17,A01,092677,Staff,11,0,75,64
1650831010381,COGS 100,A01,083619,Staff,0,29,60,60
1650831016405,COGS 101A,A01,083621,Davis; Joshua Daniel,0,28,60,60
1650831022428,COGS 101B,A01,091572,Staff,0,3,60,60
1650831028464,COGS 101C,A01,083625,Delgado; Tania,14,0,30,16
1650831034488,COGS 107A,A01,083627,Boyle; Mary E. T.,0,16,60,60
1650831040512,COGS 118A,A01,083075,Staff,0,8,60,60
1650831046536,CSE 3,A50,083646,Miranda; Gregory Joseph,18,0,38,20
1650831046536,CSE 3,A51,083647,Miranda; Gregory Joseph,36,0,37,1
1650831069116,CSE 8A,A50,083650,Miranda; Gregory Joseph,0,29,40,40
1650831075145,CSE 11,A01,083080,Cao; Yingjun,0,96,40,40
1650831081180,CSE 12,A01,083652,Staff,0,21,100,100
1650831087206,CSE 15L,A01,083654,Staff,0,3,50,50
1650831087206,CSE 15L,A02,083655,Staff,0,2,50,50
1650831093231,CSE 20,A01,083657,Staff,49,0,80,31
1650831099257,CSE 30,A01,083084,Eldon; John,0,75,40,40
1650831105281,CSE 100,A01,083659,Cao; Yingjun,0,71,50,50
1650831111305,CSE 134B,A01,083661,Powell; Thomas Allan,0,38,65,65
1650831117329,CSE 140,A01,083663,Staff,0,11,75,75
1650831123352,CSE 140L,A01,083088,Eldon; John,0,20,75,75
1650831129375,CSE 175,A01,083665,Kumar; Rakesh,7,0,25,18
1650831135403,CSE 190,A00,092507,Dubnov; Shlomo,10,0,20,10
1650831141425,ECE 45,A01,083139,Staff,0,1,60,60
1650831147451,ECE 65,A50,083695,Staff,0,5,30,30
1650831153477,ECE 109,A01,091882,Touri; Behrouz,32,0,70,38
1650831159500,ECE 180,A00,083140,Abi Samra; Nicholas Camill,20,0,30,10
1650831159500,ECE 180,B00,083141,Abi Samra; Nicholas Camill,0,0,30,30
1650831165525,MATH 10A,A01,083735,Patchell; Gregory David,2,0,30,28
1650831165525,MATH 10A,A02,083736,Patchell; Gregory David,27,0,30,3
1650831165525,MATH 10A,A03,083737,Patchell; Gregory David,24,0,30,6
1650831171553,MATH 10B,A01,083207,Staff,0,9,30,30
1650831171553,MATH 10B,A02,083208,Staff,0,6,30,30
1650831171553,MATH 10B,B01,083739,Staff,11,0,30,19
1650831171553,MATH 10B,B02,083740,Staff,28,0,30,2
1650831177579,MATH 18,A01,083743,Staff,0,0,30,30
1650831177579,MATH 18,A02,083744,Staff,23,0,30,7
1650831177579,MATH 18,A03,083745,Staff,21,0,30,9
1650831177579,MATH 18,A04,083746,Staff,26,0,30,4
1650831177579,MATH 18,B01,083748,Staff,0,15,30,30
1650831177579,MATH 18,B02,083749,Staff,0,12,30,30
1650831177579,MATH 18,B03,083750,Staff,0,12,30,30
1650831177579,MATH 18,B04,083751,Staff,0,12,30,30
1650831183602,MATH 20A,A01,083754,Staff,19,0,40,21
1650831189625,MATH 20B,A01,083756,Staff,0,13,30,30
1650831189625,MATH 20B,A02,083757,Staff,0,12,30,30
1650831195653,MATH 20C,A01,083760,Staff,0,17,30,30
1650831195653,MATH 20C,A02,083761,Staff,0,16,30,30
1650831195653,MATH 20C,B01,083762,Staff,9,0,30,21
1650831195653,MATH 20C,B02,083763,Staff,28,0,30,2
1650831201676,MATH 20D,A01,083765,Staff,2,1,30,28
1650831201676,MATH 20D,A02,083766,Staff,6,0,30,24
1650831201676,MATH 20D,A03,083767,Staff,24,0,30,6
1650831207700,MATH 20E,A01,083771,Staff,2,0,30,28
1650831207700,MATH 20E,A02,083772,Staff,15,0,30,15
1650831207700,MATH 20E,B01,083773,Staff,0,0,30,30
1650831207700,MATH 20E,B02,083774,Staff,5,0,30,25
1650831213723,MATH 103A,A01,083777,Staff,0,16,30,30
1650831213723,MATH 103A,A02,083778,Staff,0,15,30,30
1650831213723,MATH 103A,B01,083779,Staff,0,15,30,30
1650831213723,MATH 103A,B02,083780,Staff,0,15,30,30
1650831219747,MATH 105,A01,085443,Staff,0,22,30,30
1650831225779,MATH 109,A01,083213,Anzaldo; Leesa B,0,7,30,30
1650831225779,MATH 109,A02,083214,Anzaldo; Leesa B,0,7,30,30
1650831225779,MATH 109,B01,083215,Anzaldo; Leesa B,0,8,30,30
1650831225779,MATH 109,B02,083216,Anzaldo; Leesa B,0,7,30,30
1650831231806,MATH 142A,A01,083219,Chow; Bennett,0,16,30,30
1650831231806,MATH 142A,A02,083220,Chow; Bennett,0,15,30,30
1650831231806,MATH 142A,B01,083221,Chow; Bennett,0,16,30,30
1650831231806,MATH 142A,B02,083222,Chow; Bennett,0,14,30,30
1650831237830,MATH 193A,A01,083224,Staff,0,6,30,30
1650831237830,MATH 193A,A02,083225,Staff,0,6,30,30
1650831237830,MATH 193A,A03,083781,Staff,0,6,30,30
1650831237830,MATH 193A,A04,083782,Staff,0,7,30,30
1650831243854,MATH 197,001,091859,McAuley; Julian John,9998,0,9999,1
1650831249918,COGS 9,A01,083615,Staff,0,17,60,60
1650831255941,COGS 11,A01,083617,Boyle; Mary E. T.,15,0,40,25
1650831261965,COGS 13,A01,083071,Staff,0,38,40,40
1650831267993,COGS 14A,A01,092681,Staff,0,36,100,100
1650831274015,COGS 14B,A01,083073,Cheng; Tzu-Han,0,12,50,50
1650831280039,COGS 17,A01,092677,Staff,11,0,75,64
1650831286063,COGS 100,A01,083619,Staff,0,29,60,60
1650831292085,COGS 101A,A01,083621,Davis; Joshua Daniel,0,28,60,60
1650831298109,COGS 101B,A01,091572,Staff,0,3,60,60
1650831304136,COGS 101C,A01,083625,Delgado; Tania,14,0,30,16
1650831310162,COGS 107A,A01,083627,Boyle; Mary E. T.,0,16,60,60
1650831316187,COGS 118A,A01,083075,Staff,0,8,60,60
1650831322210,CSE 3,A50,083646,Miranda; Gregory Joseph,18,0,38,20
1650831322210,CSE 3,A51,083647,Miranda; Gregory Joseph,36,0,37,1
1650831328280,CSE 8A,A50,083650,Miranda; Gregory Joseph,0,29,40,40
1650831334306,CSE 11,A01,083080,Cao; Yingjun,0,96,40,40
1650831340330,CSE 12,A01,083652,Staff,0,21,100,100
1650831346353,CSE 15L,A01,083654,Staff,0,3,50,50
1650831346353,CSE 15L,A02,083655,Staff,0,2,50,50
1650831352385,CSE 20,A01,083657,Staff,49,0,80,31
1650831358408,CSE 30,A01,083084,Eldon; John,0,75,40,40
1650831364431,CSE 100,A01,083659,Cao; Yingjun,0,71,50,50
1650831370453,CSE 134B,A01,083661,Powell; Thomas Allan,0,38,65,65
1650831376477,CSE 140,A01,083663,Staff,0,11,75,75
1650831382508,CSE 140L,A01,083088,Eldon; John,0,20,75,75
1650831388535,CSE 175,A01,083665,Kumar; Rakesh,7,0,25,18
1650831394566,CSE 190,A00,092507,Dubnov; Shlomo,10,0,20,10
1650831400591,ECE 45,A01,083139,Staff,0,1,60,60
1650831406617,ECE 65,A50,083695,Staff,0,5,30,30
1650831412645,ECE 109,A01,091882,Touri; Behrouz,32,0,70,38
1650831418670,ECE 180,A00,083140,Abi Samra; Nicholas Camill,20,0,30,10
1650831418670,ECE 180,B00,083141,Abi Samra; Nicholas Camill,0,0,30,30
1650831424695,MATH 10A,A01,083735,Patchell; Gregory David,2,0,30,28
1650831424695,MATH 10A,A02,083736,Patchell; Gregory David,27,0,30,3
1650831424695,MATH 10A,A03,083737,Patchell; Gregory David,24,0,30,6
1650831430717,MATH 10B,A01,083207,Staff,0,9,30,30
1650831430717,MATH 10B,A02,083208,Staff,0,6,30,30
1650831430717,MATH 10B,B01,083739,Staff,11,0,30,19
1650831430717,MATH 10B,B02,083740,Staff,28,0,30,2
1650831436743,MATH 18,A01,083743,Staff,0,0,30,30
1650831436743,MATH 18,A02,083744,Staff,23,0,30,7
1650831436743,MATH 18,A03,083745,Staff,21,0,30,9
1650831436743,MATH 18,A04,083746,Staff,26,0,30,4
1650831436743,MATH 18,B01,083748,Staff,0,15,30,30
1650831436743,MATH 18,B02,083749,Staff,0,12,30,30
1650831436743,MATH 18,B03,083750,Staff,0,12,30,30
1650831436743,MATH 18,B04,083751,Staff,0,12,30,30
1650831442771,MATH 20A,A01,083754,Staff,19,0,40,21
1650831448795,MATH 20B,A01,083756,Staff,0,13,30,30
1650831448795,MATH 20B,A02,083757,Staff,0,12,30,30
1650831454820,MATH 20C,A01,083760,Staff,0,17,30,30
1650831454820,MATH 20C,A02,083761,Staff,0,16,30,30
1650831454820,MATH 20C,B01,083762,Staff,9,0,30,21
1650831454820,MATH 20C,B02,083763,Staff,28,0,30,2
1650831460848,MATH 20D,A01,083765,Staff,2,1,30,28
1650831460848,MATH 20D,A02,083766,Staff,6,0,30,24
1650831460848,MATH 20D,A03,083767,Staff,24,0,30,6
1650831466876,MATH 20E,A01,083771,Staff,2,0,30,28
1650831466876,MATH 20E,A02,083772,Staff,15,0,30,15
1650831466876,MATH 20E,B01,083773,Staff,0,0,30,30
1650831466876,MATH 20E,B02,083774,Staff,5,0,30,25
1650831472911,MATH 103A,A01,083777,Staff,0,16,30,30
1650831472911,MATH 103A,A02,083778,Staff,0,15,30,30
1650831472911,MATH 103A,B01,083779,Staff,0,15,30,30
1650831472911,MATH 103A,B02,083780,Staff,0,15,30,30
1650831478936,MATH 105,A01,085443,Staff,0,22,30,30
1650831484965,MATH 109,A01,083213,Anzaldo; Leesa B,0,7,30,30
1650831484965,MATH 109,A02,083214,Anzaldo; Leesa B,0,7,30,30
1650831484965,MATH 109,B01,083215,Anzaldo; Leesa B,0,8,30,30
1650831484965,MATH 109,B02,083216,Anzaldo; Leesa B,0,7,30,30
1650831491001,MATH 142A,A01,083219,Chow; Bennett,0,16,30,30
1650831491001,MATH 142A,A02,083220,Chow; Bennett,0,15,30,30
1650831491001,MATH 142A,B01,083221,Chow; Bennett,0,16,30,30
1650831491001,MATH 142A,B02,083222,Chow; Bennett,0,14,30,30
1650831497025,MATH 193A,A01,083224,Staff,0,6,30,30
1650831497025,MATH 193A,A02,083225,Staff,0,6,30,30
1650831497025,MATH 193A,A03,083781,Staff,0,6,30,30
1650831497025,MATH 193A,A04,083782,Staff,0,7,30,30
1650831503049,MATH 197,001,091859,McAuley; Julian John,9998,0,9999,1
1650831509104,COGS 9,A01,083615,Staff,0,17,60,60
1650831515128,COGS 11,A01,083617,Boyle; Mary E. T.,15,0,40,25
1650831521152,COGS 13,A01,083071,Staff,0,38,40,40
1650831527174,COGS 14A,A01,092681,Staff,0,36,100,100
1650831533197,COGS 14B,A01,083073,Cheng; Tzu-Han,0,12,50,50
1650831539219,COGS 17,A01,092677,Staff,11,0,75,64
1650831545252,COGS 100,A01,083619,Staff,0,29,60,60
1650831551407,COGS 101A,A01,083621,Davis; Joshua Daniel,0,28,60,60
1650831557432,COGS 101B,A01,091572,Staff,0,3,60,60
1650831563461,COGS 101C,A01,083625,Delgado; Tania,14,0,30,16
1650831569484,COGS 107A,A01,083627,Boyle; Mary E. T.,0,16,60,60
1650831575509,COGS 118A,A01,083075,Staff,0,8,60,60
1650831581531,CSE 3,A50,083646,Miranda; Gregory Joseph,18,0,38,20
1650831581531,CSE 3,A51,083647,Miranda; Gregory Joseph,36,0,37,1
1650831587556,CSE 8A,A50,083650,Miranda; Gregory Joseph,0,29,40,40
1650831593582,CSE 11,A01,083080,Cao; Yingjun,0,96,40,40
1650831599605,CSE 12,A01,083652,Staff,0,21,100,100
1650831605627,CSE 15L,A01,083654,Staff,0,3,50,50
1650831605627,CSE 15L,A02,083655,Staff,0,2,50,50
1650831611650,CSE 20,A01,083657,Staff,49,0,80,31
1650831617672,CSE 30,A01,083084,Eldon; John,0,75,40,40
1650831623721,CSE 100,A01,083659,Cao; Yingjun,0,71,50,50
1650831629745,CSE 134B,A01,083661,Powell; Thomas Allan,0,38,65,65
1650831635775,CSE 140,A01,083663,Staff,0,11,75,75
1650831641800,CSE 140L,A01,083088,Eldon; John,0,20,75,75
1650831647826,CSE 175,A01,083665,Kumar; Rakesh,7,0,25,18
1650831653852,CSE 190,A00,092507,Dubnov; Shlomo,10,0,20,10
1650831659875,ECE 45,A01,083139,Staff,0,1,60,60
1650831665905,ECE 65,A50,083695,Staff,0,5,30,30
1650831671932,ECE 109,A01,091882,Touri; Behrouz,32,0,70,38
1650831677959,ECE 180,A00,083140,Abi Samra; Nicholas Camill,20,0,30,10
1650831677959,ECE 180,B00,083141,Abi Samra; Nicholas Camill,0,0,30,30
1650831683987,MATH 10A,A01,083735,Patchell; Gregory David,2,0,30,28
1650831683987,MATH 10A,A02,083736,Patchell; Gregory David,27,0,30,3
1650831683987,MATH 10A,A03,083737,Patchell; Gregory David,24,0,30,6
1650831690019,MATH 10B,A01,083207,Staff,0,9,30,30
1650831690019,MATH 10B,A02,083208,Staff,0,6,30,30
1650831690019,MATH 10B,B01,083739,Staff,11,0,30,19
1650831690019,MATH 10B,B02,083740,Staff,28,0,30,2
1650831696043,MATH 18,A01,083743,Staff,0,0,30,30
1650831696043,MATH 18,A02,083744,Staff,23,0,30,7
1650831696043,MATH 18,A03,083745,Staff,21,0,30,9
1650831696043,MATH 18,A04,083746,Staff,26,0,30,4
1650831696043,MATH 18,B01,083748,Staff,0,15,30,30
1650831696043,MATH 18,B02,083749,Staff,0,12,30,30
1650831696043,MATH 18,B03,083750,Staff,0,12,30,30
1650831696043,MATH 18,B04,083751,Staff,0,12,30,30
1650831702072,MATH 20A,A01,083754,Staff,19,0,40,21
1650831708098,MATH 20B,A01,083756,Staff,0,13,30,30
1650831708098,MATH 20B,A02,083757,Staff,0,12,30,30
1650831714125,MATH 20C,A01,083760,Staff,0,17,30,30
1650831714125,MATH 20C,A02,083761,Staff,0,16,30,30
1650831714125,MATH 20C,B01,083762,Staff,9,0,30,21
1650831714125,MATH 20C,B02,083763,Staff,28,0,30,2
1650831720149,MATH 20D,A01,083765,Staff,2,1,30,28
1650831720149,MATH 20D,A02,083766,Staff,6,0,30,24
1650831720149,MATH 20D,A03,083767,Staff,24,0,30,6
1650831726174,MATH 20E,A01,083771,Staff,2,0,30,28
1650831726174,MATH 20E,A02,083772,Staff,15,0,30,15
1650831726174,MATH 20E,B01,083773,Staff,0,0,30,30
1650831726174,MATH 20E,B02,083774,Staff,5,0,30,25
1650831732197,MATH 103A,A01,083777,Staff,0,16,30,30
1650831732197,MATH 103A,A02,083778,Staff,0,15,30,30
1650831732197,MATH 103A,B01,083779,Staff,0,15,30,30
1650831732197,MATH 103A,B02,083780,Staff,0,15,30,30
1650831738220,MATH 105,A01,085443,Staff,0,22,30,30
1650831744249,MATH 109,A01,083213,Anzaldo; Leesa B,0,7,30,30
1650831744249,MATH 109,A02,083214,Anzaldo; Leesa B,0,7,30,30
1650831744249,MATH 109,B01,083215,Anzaldo; Leesa B,0,8,30,30
1650831744249,MATH 109,B02,083216,Anzaldo; Leesa B,0,7,30,30
1650831750277,MATH 142A,A01,083219,Chow; Bennett,0,16,30,30
1650831750277,MATH 142A,A02,083220,Chow; Bennett,0,15,30,30
1650831750277,MATH 142A,B01,083221,Chow; Bennett,0,16,30,30
1650831750277,MATH 142A,B02,083222,Chow; Bennett,0,14,30,30
1650831756301,MATH 193A,A01,083224,Staff,0,6,30,30
1650831756301,MATH 193A,A02,083225,Staff,0,6,30,30
1650831756301,MATH 193A,A03,083781,Staff,0,6,30,30
1650831756301,MATH 193A,A04,083782,Staff,0,7,30,30
1650831762326,MATH 197,001,091859,McAuley; Julian John,9998,0,9999,1
1650831768375,COGS 9,A01,083615,Staff,0,17,60,60
1650831774398,COGS 11,A01,083617,Boyle; Mary E. T.,15,0,40,25
1650831780422,COGS 13,A01,083071,Staff,0,38,40,40
1650831786447,COGS 14A,A01,092681,Staff,0,36,100,100
1650831792474,COGS 14B,A01,083073,Cheng; Tzu-Han,0,12,50,50
1650831798498,COGS 17,A01,092677,Staff,11,0,75,64
1650831804523,COGS 100,A01,083619,Staff,0,29,60,60
1650831810547,COGS 101A,A01,083621,Davis; Joshua Daniel,0,28,60,60
1650831816577,COGS 101B,A01,091572,Staff,0,3,60,60
1650831822604,COGS 101C,A01,083625,Delgado; Tania,14,0,30,16
1650831828627,COGS 107A,A01,083627,Boyle; Mary E. T.,0,16,60,60
1650831834649,COGS 118A,A01,083075,Staff,0,8,60,60
1650831840681,CSE 3,A50,083646,Miranda; Gregory Joseph,18,0,38,20
1650831840681,CSE 3,A51,083647,Miranda; Gregory Joseph,36,0,37,1
1650831846707,CSE 8A,A50,083650,Miranda; Gregory Joseph,0,29,40,40
1650831852731,CSE 11,A01,083080,Cao; Yingjun,0,96,40,40
1650831858757,CSE 12,A01,083652,Staff,0,21,100,100
1650831864782,CSE 15L,A01,083654,Staff,0,3,50,50
1650831864782,CSE 15L,A02,083655,Staff,0,2,50,50
1650831870808,CSE 20,A01,083657,Staff,49,0,80,31
1650831876835,CSE 30,A01,083084,Eldon; John,0,75,40,40
1650831882859,CSE 100,A01,083659,Cao; Yingjun,0,71,50,50
1650831888882,CSE 134B,A01,083661,Powell; Thomas Allan,0,38,65,65
1650831894906,CSE 140,A01,083663,Staff,0,11,75,75
1650831900928,CSE 140L,A01,083088,Eldon; John,0,20,75,75
1650831906951,CSE 175,A01,083665,Kumar; Rakesh,7,0,25,18
1650831912973,CSE 190,A00,092507,Dubnov; Shlomo,10,0,20,10
1650831918999,ECE 45,A01,083139,Staff,0,1,60,60
1650831925024,ECE 65,A50,083695,Staff,0,5,30,30
1650831931055,ECE 109,A01,091882,Touri; Behrouz,32,0,70,38
1650831937085,ECE 180,A00,083140,Abi Samra; Nicholas Camill,20,0,30,10
1650831937085,ECE 180,B00,083141,Abi Samra; Nicholas Camill,0,0,30,30
1650831943109,MATH 10A,A01,083735,Patchell; Gregory David,2,0,30,28
1650831943109,MATH 10A,A02,083736,Patchell; Gregory David,27,0,30,3
1650831943109,MATH 10A,A03,083737,Patchell; Gregory David,24,0,30,6
1650831949133,MATH 10B,A01,083207,Staff,0,9,30,30
1650831949133,MATH 10B,A02,083208,Staff,0,6,30,30
1650831949133,MATH 10B,B01,083739,Staff,11,0,30,19
1650831949133,MATH 10B,B02,083740,Staff,28,0,30,2
1650831955162,MATH 18,A01,083743,Staff,0,0,30,30
1650831955162,MATH 18,A02,083744,Staff,23,0,30,7
1650831955162,MATH 18,A03,083745,Staff,21,0,30,9
1650831955162,MATH 18,A04,083746,Staff,26,0,30,4
1650831955162,MATH 18,B01,083748,Staff,0,15,30,30
1650831955162,MATH 18,B02,083749,Staff,0,12,30,30
1650831955162,MATH 18,B03,083750,Staff,0,12,30,30
1650831955162,MATH 18,B04,083751,Staff,0,12,30,30
1650831961185,MATH 20A,A01,083754,Staff,19,0,40,21
1650831967209,MATH 20B,A01,083756,Staff,0,13,30,30
1650831967209,MATH 20B,A02,083757,Staff,0,12,30,30
1650831973233,MATH 20C,A01,083760,Staff,0,17,30,30
1650831973233,MATH 20C,A02,083761,Staff,0,16,30,30
1650831973233,MATH 20C,B01,083762,Staff,9,0,30,21
1650831973233,MATH 20C,B02,083763,Staff,28,0,30,2
1650831979258,MATH 20D,A01,083765,Staff,2,1,30,28
1650831979258,MATH 20D,A02,083766,Staff,6,0,30,24
1650831979258,MATH 20D,A03,083767,Staff,24,0,30,6
1650831985283,MATH 20E,A01,083771,Staff,2,0,30,28
1650831985283,MATH 20E,A02,083772,Staff,15,0,30,15
1650831985283,MATH 20E,B01,083773,Staff,0,0,30,30
1650831985283,MATH 20E,B02,083774,Staff,5,0,30,25
1650831991308,MATH 103A,A01,083777,Staff,0,16,30,30
1650831991308,MATH 103A,A02,083778,Staff,0,15,30,30
1650831991308,MATH 103A,B01,083779,Staff,0,15,30,30
1650831991308,MATH 103A,B02,083780,Staff,0,15,30,30
1650831997333,MATH 105,A01,085443,Staff,0,22,30,30
1650832003357,MATH 109,A01,083213,Anzaldo; Leesa B,0,7,30,30
1650832003357,MATH 109,A02,083214,Anzaldo; Leesa B,0,7,30,30
1650832003357,MATH 109,B01,083215,Anzaldo; Leesa B,0,8,30,30
1650832003357,MATH 109,B02,083216,Anzaldo; Leesa B,0,7,30,30
1650832009381,MATH 142A,A01,083219,Chow; Bennett,0,16,30,30
1650832009381,MATH 142A,A02,083220,Chow; Bennett,0,15,30,30
1650832009381,MATH 142A,B01,083221,Chow; Bennett,0,16,30,30
1650832009381,MATH 142A,B02,083222,Chow; Bennett,0,14,30,30
1650832015404,MATH 193A,A01,083224,Staff,0,6,30,30
1650832015404,MATH 193A,A02,083225,Staff,0,6,30,30
1650832015404,MATH 193A,A03,083781,Staff,0,6,30,30
1650832015404,MATH 193A,A04,083782,Staff,0,7,30,30
1650832021431,MATH 197,001,091859,McAuley; Julian John,9998,0,9999,1
1650832027481,COGS 9,A01,083615,Staff,0,17,60,60
1650832033512,COGS 11,A01,083617,Boyle; Mary E. T.,15,0,40,25
1650832039536,COGS 13,A01,083071,Staff,0,38,40,40
1650832045561,COGS 14A,A01,092681,Staff,0,36,100,100
1650832051585,COGS 14B,A01,083073,Cheng; Tzu-Han,0,12,50,50
1650832057612,COGS 17,A01,092677,Staff,11,0,75,64
1650832063642,COGS 100,A01,083619,Staff,0,29,60,60
1650832069665,COGS 101A,A01,083621,Davis; Joshua Daniel,0,28,60,60
1650832075687,COGS 101B,A01,091572,Staff,0,3,60,60
1650832081711,COGS 101C,A01,083625,Delgado; Tania,14,0,30,16
1650832087738,COGS 107A,A01,083627,Boyle; Mary E. T.,0,16,60,60
1650832093761,COGS 118A,A01,083075,Staff,0,8,60,60
1650832099784,CSE 3,A50,083646,Miranda; Gregory Joseph,18,0,38,20
1650832099784,CSE 3,A51,083647,Miranda; Gregory Joseph,36,0,37,1
1650832105807,CSE 8A,A50,083650,Miranda; Gregory Joseph,0,29,40,40
1650832111832,CSE 11,A01,083080,Cao; Yingjun,0,96,40,40
1650832117863,CSE 12,A01,083652,Staff,0,21,100,100
1650832123889,CSE 15L,A01,083654,Staff,0,3,50,50
1650832123889,CSE 15L,A02,083655,Staff,0,2,50,50
1650832129915,CSE 20,A01,083657,Staff,49,0,80,31
1650832135941,CSE 30,A01,083084,Eldon; John,0,75,40,40
1650832141968,CSE 100,A01,083659,Cao; Yingjun,0,71,50,50
1650832148074,CSE 134B,A01,083661,Powell; Thomas Allan,0,38,65,65
1650832154100,CSE 140,A01,083663,Staff,0,11,75,75
1650832160124,CSE 140L,A01,083088,Eldon; John,0,20,75,75
1650832166148,CSE 175,A01,083665,Kumar; Rakesh,7,0,25,18
1650832172170,CSE 190,A00,092507,Dubnov; Shlomo,10,0,20,10
1650832178194,ECE 45,A01,083139,Staff,0,1,60,60
1650832184224,ECE 65,A50,083695,Staff,0,5,30,30
1650832190248,ECE 109,A01,091882,Touri; Behrouz,32,0,70,38
1650832196270,ECE 180,A00,083140,Abi Samra; Nicholas Camill,20,0,30,10
1650832196270,ECE 180,B00,083141,Abi Samra; Nicholas Camill,0,0,30,30
1650832202294,MATH 10A,A01,083735,Patchell; Gregory David,2,0,30,28
1650832202294,MATH 10A,A02,083736,Patchell; Gregory David,27,0,30,3
1650832202294,MATH 10A,A03,083737,Patchell; Gregory David,24,0,30,6
1650832208320,MATH 10B,A01,083207,Staff,0,9,30,30
1650832208320,MATH 10B,A02,083208,Staff,0,6,30,30
1650832208320,MATH 10B,B01,083739,Staff,11,0,30,19
1650832208320,MATH 10B,B02,083740,Staff,28,0,30,2
1650832214352,MATH 18,A01,083743,Staff,0,0,30,30
1650832214352,MATH 18,A02,083744,Staff,23,0,30,7
1650832214352,MATH 18,A03,083745,Staff,21,0,30,9
1650832214352,MATH 18,A04,083746,Staff,26,0,30,4
1650832214352,MATH 18,B01,083748,Staff,0,15,30,30
1650832214352,MATH 18,B02,083749,Staff,0,12,30,30
1650832214352,MATH 18,B03,083750,Staff,0,12,30,30
1650832214352,MATH 18,B04,083751,Staff,0,12,30,30
1650832220373,MATH 20A,A01,083754,Staff,19,0,40,21
1650832226399,MATH 20B,A01,083756,Staff,0,13,30,30
1650832226399,MATH 20B,A02,083757,Staff,0,12,30,30
1650832232427,MATH 20C,A01,083760,Staff,0,17,30,30
1650832232427,MATH 20C,A02,083761,Staff,0,16,30,30
1650832232427,MATH 20C,B01,083762,Staff,9,0,30,21
1650832232427,MATH 20C,B02,083763,Staff,28,0,30,2
1650832238450,MATH 20D,A01,083765,Staff,2,1,30,28
1650832238450,MATH 20D,A02,083766,Staff,6,0,30,24
1650832238450,MATH 20D,A03,083767,Staff,24,0,30,6
1650832244473,MATH 20E,A01,083771,Staff,2,0,30,28
1650832244473,MATH 20E,A02,083772,Staff,15,0,30,15
1650832244473,MATH 20E,B01,083773,Staff,0,0,30,30
1650832244473,MATH 20E,B02,083774,Staff,5,0,30,25
1650832250495,MATH 103A,A01,083777,Staff,0,16,30,30
1650832250495,MATH 103A,A02,083778,Staff,0,15,30,30
1650832250495,MATH 103A,B01,083779,Staff,0,15,30,30
1650832250495,MATH 103A,B02,083780,Staff,0,15,30,30
1650832256521,MATH 105,A01,085443,Staff,0,22,30,30
1650832262548,MATH 109,A01,083213,Anzaldo; Leesa B,0,7,30,30
1650832262548,MATH 109,A02,083214,Anzaldo; Leesa B,0,7,30,30
1650832262548,MATH 109,B01,083215,Anzaldo; Leesa B,0,8,30,30
1650832262548,MATH 109,B02,083216,Anzaldo; Leesa B,0,7,30,30
1650832268575,MATH 142A,A01,083219,Chow; Bennett,0,16,30,30
1650832268575,MATH 142A,A02,083220,Chow; Bennett,0,15,30,30
1650832268575,MATH 142A,B01,083221,Chow; Bennett,0,16,30,30
1650832268575,MATH 142A,B02,083222,Chow; Bennett,0,14,30,30
1650832274606,MATH 193A,A01,083224,Staff,0,6,30,30
1650832274606,MATH 193A,A02,083225,Staff,0,6,30,30
1650832274606,MATH 193A,A03,083781,Staff,0,6,30,30
1650832274606,MATH 193A,A04,083782,Staff,0,7,30,30
1650832280632,MATH 197,001,091859,McAuley; Julian John,9998,0,9999,1
1650832286686,COGS 9,A01,083615,Staff,0,17,60,60
1650832292725,COGS 11,A01,083617,Boyle; Mary E. T.,15,0,40,25
1650832298748,COGS 13,A01,083071,Staff,0,38,40,40
1650832304775,COGS 14A,A01,092681,Staff,0,36,100,100
1650832310800,COGS 14B,A01,083073,Cheng; Tzu-Han,0,12,50,50
1650832316823,COGS 17,A01,092677,Staff,11,0,75,64
1650832322846,COGS 100,A01,083619,Staff,0,29,60,60
1650832328874,COGS 101A,A01,083621,Davis; Joshua Daniel,0,28,60,60
1650832334901,COGS 101B,A01,091572,Staff,0,3,60,60
1650832340924,COGS 101C,A01,083625,Delgado; Tania,14,0,30,16
1650832346951,COGS 107A,A01,083627,Boyle; Mary E. T.,0,16,60,60
1650832352973,COGS 118A,A01,083075,Staff,0,8,60,60
1650832359000,CSE 3,A50,083646,Miranda; Gregory Joseph,18,0,38,20
1650832359000,CSE 3,A51,083647,Miranda; Gregory Joseph,36,0,37,1
1650832365027,CSE 8A,A50,083650,Miranda; Gregory Joseph,0,29,40,40
1650832371052,CSE 11,A01,083080,Cao; Yingjun,0,96,40,40
1650832377076,CSE 12,A01,083652,Staff,0,21,100,100
1650832383103,CSE 15L,A01,083654,Staff,0,3,50,50
1650832383103,CSE 15L,A02,083655,Staff,0,2,50,50
1650832389129,CSE 20,A01,083657,Staff,49,0,80,31
1650832395152,CSE 30,A01,083084,Eldon; John,0,75,40,40
1650832401174,CSE 100,A01,083659,Cao; Yingjun,0,71,50,50
1650832407201,CSE 134B,A01,083661,Powell; Thomas Allan,0,38,65,65
1650832413227,CSE 140,A01,083663,Staff,0,11,75,75
1650832419249,CSE 140L,A01,083088,Eldon; John,0,20,75,75
1650832425275,CSE 175,A01,083665,Kumar; Rakesh,7,0,25,18
1650832431301,CSE 190,A00,092507,Dubnov; Shlomo,10,0,20,10
1650832437324,ECE 45,A01,083139,Staff,0,1,60,60
1650832443349,ECE 65,A50,083695,Staff,0,5,30,30
1650832449383,ECE 109,A01,091882,Touri; Behrouz,32,0,70,38
1650832455410,ECE 180,A00,083140,Abi Samra; Nicholas Camill,20,0,30,10
1650832455410,ECE 180,B00,083141,Abi Samra; Nicholas Camill,0,0,30,30
1650832461436,MATH 10A,A01,083735,Patchell; Gregory David,2,0,30,28
1650832461436,MATH 10A,A02,083736,Patchell; Gregory David,27,0,30,3
1650832461436,MATH 10A,A03,083737,Patchell; Gregory David,24,0,30,6
1650832467462,MATH 10B,A01,083207,Staff,0,9,30,30
1650832467462,MATH 10B,A02,083208,Staff,0,6,30,30
1650832467462,MATH 10B,B01,083739,Staff,11,0,30,19
1650832467462,MATH 10B,B02,083740,Staff,28,0,30,2
1650832473486,MATH 18,A01,083743,Staff,0,0,30,30
1650832473486,MATH 18,A02,083744,Staff,23,0,30,7
1650832473486,MATH 18,A03,083745,Staff,21,0,30,9
1650832473486,MATH 18,A04,083746,Staff,26,0,30,4
1650832473486,MATH 18,B01,083748,Staff,0,15,30,30
1650832473486,MATH 18,B02,083749,Staff,0,12,30,30
1650832473486,MATH 18,B03,083750,Staff,0,12,30,30
1650832473486,MATH 18,B04,083751,Staff,0,12,30,30
1650832479509,MATH 20A,A01,083754,Staff,19,0,40,21
1650832485535,MATH 20B,A01,083756,Staff,0,13,30,30
1650832485535,MATH 20B,A02,083757,Staff,0,12,30,30
1650832491563,MATH 20C,A01,083760,Staff,0,17,30,30
1650832491563,MATH 20C,A02,083761,Staff,0,16,30,30
1650832491563,MATH 20C,B01,083762,Staff,9,0,30,21
1650832491563,MATH 20C,B02,083763,Staff,28,0,30,2
1650832497587,MATH 20D,A01,083765,Staff,2,1,30,28
1650832497587,MATH 20D,A02,083766,Staff,6,0,30,24
1650832497587,MATH 20D,A03,083767,Staff,24,0,30,6
1650832503613,MATH 20E,A01,083771,Staff,2,0,30,28
1650832503613,MATH 20E,A02,083772,Staff,15,0,30,15
1650832503613,MATH 20E,B01,083773,Staff,0,0,30,30
1650832503613,MATH 20E,B02,083774,Staff,5,0,30,25
1650832509640,MATH 103A,A01,083777,Staff,0,16,30,30
1650832509640,MATH 103A,A02,083778,Staff,0,15,30,30
1650832509640,MATH 103A,B01,083779,Staff,0,15,30,30
1650832509640,MATH 103A,B02,083780,Staff,0,15,30,30
1650832515666,MATH 105,A01,085443,Staff,0,22,30,30
1650832521689,MATH 109,A01,083213,Anzaldo; Leesa B,0,7,30,30
1650832521689,MATH 109,A02,083214,Anzaldo; Leesa B,0,7,30,30
1650832521689,MATH 109,B01,083215,Anzaldo; Leesa B,0,8,30,30
1650832521689,MATH 109,B02,083216,Anzaldo; Leesa B,0,7,30,30
1650832527720,MATH 142A,A01,083219,Chow; Bennett,0,16,30,30
1650832527720,MATH 142A,A02,083220,Chow; Bennett,0,15,30,30
1650832527720,MATH 142A,B01,083221,Chow; Bennett,0,16,30,30
1650832527720,MATH 142A,B02,083222,Chow; Bennett,0,14,30,30
1650832533758,MATH 193A,A01,083224,Staff,0,6,30,30
1650832533758,MATH 193A,A02,083225,Staff,0,6,30,30
1650832533758,MATH 193A,A03,083781,Staff,0,6,30,30
1650832533758,MATH 193A,A04,083782,Staff,0,7,30,30
1650832539783,MATH 197,001,091859,McAuley; Julian John,9998,0,9999,1
1650832545830,COGS 9,A01,083615,Staff,0,17,60,60
1650832551854,COGS 11,A01,083617,Boyle; Mary E. T.,15,0,40,25
1650832557885,COGS 13,A01,083071,Staff,0,38,40,40
1650832563908,COGS 14A,A01,092681,Staff,0,36,100,100
1650832569933,COGS 14B,A01,083073,Cheng; Tzu-Han,0,12,50,50
1650832575964,COGS 17,A01,092677,Staff,11,0,75,64
1650832581998,COGS 100,A01,083619,Staff,0,29,60,60
1650832588025,COGS 101A,A01,083621,Davis; Joshua Daniel,0,28,60,60
1650832594051,COGS 101B,A01,091572,Staff,0,3,60,60
1650832600082,COGS 101C,A01,083625,Delgado; Tania,14,0,30,16
1650832606106,COGS 107A,A01,083627,Boyle; Mary E. T.,0,16,60,60
1650832612128,COGS 118A,A01,083075,Staff,0,8,60,60
1650832618151,CSE 3,A50,083646,Miranda; Gregory Joseph,18,0,38,20
1650832618151,CSE 3,A51,083647,Miranda; Gregory Joseph,36,0,37,1
1650832624182,CSE 8A,A50,083650,Miranda; Gregory Joseph,0,29,40,40
1650832630209,CSE 11,A01,083080,Cao; Yingjun,0,96,40,40
1650832636233,CSE 12,A01,083652,Staff,0,21,100,100
1650832642262,CSE 15L,A01,083654,Staff,0,3,50,50
1650832642262,CSE 15L,A02,083655,Staff,0,2,50,50
1650832648289,CSE 20,A01,083657,Staff,49,0,80,31
1650832654316,CSE 30,A01,083084,Eldon; John,0,75,40,40
1650832660338,CSE 100,A01,083659,Cao; Yingjun,0,71,50,50
1650832666364,CSE 134B,A01,083661,Powell; Thomas Allan,0,38,65,65
1650832672388,CSE 140,A01,083663,Staff,0,11,75,75
1650832678415,CSE 140L,A01,083088,Eldon; John,0,20,75,75
1650832684439,CSE 175,A01,083665,Kumar; Rakesh,7,0,25,18
1650832690470,CSE 190,A00,092507,Dubnov; Shlomo,10,0,20,10
1650832696497,ECE 45,A01,083139,Staff,0,1,60,60
1650832702523,ECE 65,A50,083695,Staff,0,5,30,30
1650832708549,ECE 109,A01,091882,Touri; Behrouz,32,0,70,38
1650832714574,ECE 180,A00,083140,Abi Samra; Nicholas Camill,20,0,30,10
1650832714574,ECE 180,B00,083141,Abi Samra; Nicholas Camill,0,0,30,30
1650832720601,MATH 10A,A01,083735,Patchell; Gregory David,2,0,30,28
1650832720601,MATH 10A,A02,083736,Patchell; Gregory David,27,0,30,3
1650832720601,MATH 10A,A03,083737,Patchell; Gregory David,24,0,30,6
1650832726625,MATH 10B,A01,083207,Staff,0,9,30,30
1650832726625,MATH 10B,A02,083208,Staff,0,6,30,30
1650832726625,MATH 10B,B01,083739,Staff,11,0,30,19
1650832726625,MATH 10B,B02,083740,Staff,28,0,30,2
1650832732652,MATH 18,A01,083743,Staff,0,0,30,30
1650832732652,MATH 18,A02,083744,Staff,23,0,30,7
1650832732652,MATH 18,A03,083745,Staff,21,0,30,9
1650832732652,MATH 18,A04,083746,Staff,26,0,30,4
1650832732652,MATH 18,B01,083748,Staff,0,15,30,30
1650832732652,MATH 18,B02,083749,Staff,0,12,30,30
1650832732652,MATH 18,B03,083750,Staff,0,12,30,30
1650832732652,MATH 18,B04,083751,Staff,0,12,30,30
1650832738677,MATH 20A,A01,083754,Staff,19,0,40,21
1650832744815,MATH 20B,A01,083756,Staff,0,13,30,30
1650832744815,MATH 20B,A02,083757,Staff,0,12,30,30
1650832750839,MATH 20C,A01,083760,Staff,0,17,30,30
1650832750839,MATH 20C,A02,083761,Staff,0,16,30,30
1650832750839,MATH 20C,B01,083762,Staff,9,0,30,21
1650832750839,MATH 20C,B02,083763,Staff,28,0,30,2
1650832756865,MATH 20D,A01,083765,Staff,2,1,30,28
1650832756865,MATH 20D,A02,083766,Staff,6,0,30,24
1650832756865,MATH 20D,A03,083767,Staff,24,0,30,6
1650832762896,MATH 20E,A01,083771,Staff,2,0,30,28
1650832762896,MATH 20E,A02,083772,Staff,15,0,30,15
1650832762896,MATH 20E,B01,083773,Staff,0,0,30,30
1650832762896,MATH 20E,B02,083774,Staff,5,0,30,25
1650832768925,MATH 103A,A01,083777,Staff,0,16,30,30
1650832768925,MATH 103A,A02,083778,Staff,0,15,30,30
1650832768925,MATH 103A,B01,083779,Staff,0,15,30,30
1650832768925,MATH 103A,B02,083780,Staff,0,15,30,30
1650832774949,MATH 105,A01,085443,Staff,0,22,30,30
1650832781001,MATH 109,A01,083213,Anzaldo; Leesa B,0,7,30,30
1650832781001,MATH 109,A02,083214,Anzaldo; Leesa B,0,7,30,30
1650832781001,MATH 109,B01,083215,Anzaldo; Leesa B,0,8,30,30
1650832781001,MATH 109,B02,083216,Anzaldo; Leesa B,0,7,30,30
1650832787030,MATH 142A,A01,083219,Chow; Bennett,0,16,30,30
1650832787030,MATH 142A,A02,083220,Chow; Bennett,0,15,30,30
1650832787030,MATH 142A,B01,083221,Chow; Bennett,0,16,30,30
1650832787030,MATH 142A,B02,083222,Chow; Bennett,0,14,30,30
1650832793053,MATH 193A,A01,083224,Staff,0,6,30,30
1650832793053,MATH 193A,A02,083225,Staff,0,6,30,30
1650832793053,MATH 193A,A03,083781,Staff,0,6,30,30
1650832793053,MATH 193A,A04,083782,Staff,0,7,30,30
1650832799076,MATH 197,001,091859,McAuley; Julian John,9998,0,9999,1
1650832805141,COGS 9,A01,083615,Staff,0,17,60,60
1650832811165,COGS 11,A01,083617,Boyle; Mary E. T.,15,0,40,25
1650832817189,COGS 13,A01,083071,Staff,0,38,40,40
1650832823211,COGS 14A,A01,092681,Staff,0,36,100,100
1650832829242,COGS 14B,A01,083073,Cheng; Tzu-Han,0,12,50,50
1650832835272,COGS 17,A01,092677,Staff,11,0,75,64
1650832841297,COGS 100,A01,083619,Staff,0,29,60,60
1650832847326,COGS 101A,A01,083621,Davis; Joshua Daniel,0,28,60,60
1650832853352,COGS 101B,A01,091572,Staff,0,3,60,60
1650832859379,COGS 101C,A01,083625,Delgado; Tania,14,0,30,16
1650832865410,COGS 107A,A01,083627,Boyle; Mary E. T.,0,16,60,60
1650832871434,COGS 118A,A01,083075,Staff,0,8,60,60
1650832877459,CSE 3,A50,083646,Miranda; Gregory Joseph,18,0,38,20
1650832877459,CSE 3,A51,083647,Miranda; Gregory Joseph,36,0,37,1
1650832883484,CSE 8A,A50,083650,Miranda; Gregory Joseph,0,29,40,40
1650832889508,CSE 11,A01,083080,Cao; Yingjun,0,96,40,40
1650832895532,CSE 12,A01,083652,Staff,0,21,100,100
1650832901555,CSE 15L,A01,083654,Staff,0,3,50,50
1650832901555,CSE 15L,A02,083655,Staff,0,2,50,50
1650832907581,CSE 20,A01,083657,Staff,49,0,80,31
1650832913607,CSE 30,A01,083084,Eldon; John,0,75,40,40
1650832919634,CSE 100,A01,083659,Cao; Yingjun,0,71,50,50
1650832925657,CSE 134B,A01,083661,Powell; Thomas Allan,0,38,65,65
1650832931684,CSE 140,A01,083663,Staff,0,11,75,75
1650832937712,CSE 140L,A01,083088,Eldon; John,0,20,75,75
1650832943739,CSE 175,A01,083665,Kumar; Rakesh,7,0,25,18
1650832949767,CSE 190,A00,092507,Dubnov; Shlomo,10,0,20,10
1650832955790,ECE 45,A01,083139,Staff,0,1,60,60
1650832961818,ECE 65,A50,083695,Staff,0,5,30,30
1650832967867,ECE 109,A01,091882,Touri; Behrouz,32,0,70,38
1650832973893,ECE 180,A00,083140,Abi Samra; Nicholas Camill,20,0,30,10
1650832973893,ECE 180,B00,083141,Abi Samra; Nicholas Camill,0,0,30,30
1650832979924,MATH 10A,A01,083735,Patchell; Gregory David,2,0,30,28
1650832979924,MATH 10A,A02,083736,Patchell; Gregory David,27,0,30,3
1650832979924,MATH 10A,A03,083737,Patchell; Gregory David,24,0,30,6
1650832985951,MATH 10B,A01,083207,Staff,0,9,30,30
1650832985951,MATH 10B,A02,083208,Staff,0,6,30,30
1650832985951,MATH 10B,B01,083739,Staff,11,0,30,19
1650832985951,MATH 10B,B02,083740,Staff,28,0,30,2
1650832991979,MATH 18,A01,083743,Staff,0,0,30,30
1650832991979,MATH 18,A02,083744,Staff,23,0,30,7
1650832991979,MATH 18,A03,083745,Staff,21,0,30,9
1650832991979,MATH 18,A04,083746,Staff,26,0,30,4
1650832991979,MATH 18,B01,083748,Staff,0,15,30,30
1650832991979,MATH 18,B02,083749,Staff,0,12,30,30
1650832991979,MATH 18,B03,083750,Staff,0,12,30,30
1650832991979,MATH 18,B04,083751,Staff,0,12,30,30
1650832998004,MATH 20A,A01,083754,Staff,19,0,40,21
1650833004029,MATH 20B,A01,083756,Staff,0,13,30,30
1650833004029,MATH 20B,A02,083757,Staff,0,12,30,30
1650833010056,MATH 20C,A01,083760,Staff,0,17,30,30
1650833010056,MATH 20C,A02,083761,Staff,0,16,30,30
1650833010056,MATH 20C,B01,083762,Staff,9,0,30,21
1650833010056,MATH 20C,B02,083763,Staff,28,0,30,2
1650833016083,MATH 20D,A01,083765,Staff,2,1,30,28
1650833016083,MATH 20D,A02,083766,Staff,6,0,30,24
1650833016083,MATH 20D,A03,083767,Staff,24,0,30,6
1650833022106,MATH 20E,A01,083771,Staff,2,0,30,28
1650833022106,MATH 20E,A02,083772,Staff,15,0,30,15
1650833022106,MATH 20E,B01,083773,Staff,0,0,30,30
1650833022106,MATH 20E,B02,083774,Staff,5,0,30,25
1650833028134,MATH 103A,A01,083777,Staff,0,16,30,30
1650833028134,MATH 103A,A02,083778,Staff,0,15,30,30
1650833028134,MATH 103A,B01,083779,Staff,0,15,30,30
1650833028134,MATH 103A,B02,083780,Staff,0,15,30,30
1650833034159,MATH 105,A01,085443,Staff,0,22,30,30
1650833040187,MATH 109,A01,083213,Anzaldo; Leesa B,0,7,30,30
1650833040187,MATH 109,A02,083214,Anzaldo; Leesa B,0,7,30,30
1650833040187,MATH 109,B01,083215,Anzaldo; Leesa B,0,8,30,30
1650833040187,MATH 109,B02,083216,Anzaldo; Leesa B,0,7,30,30
1650833046215,MATH 142A,A01,083219,Chow; Bennett,0,16,30,30
1650833046215,MATH 142A,A02,083220,Chow; Bennett,0,15,30,30
1650833046215,MATH 142A,B01,083221,Chow; Bennett,0,16,30,30
1650833046215,MATH 142A,B02,083222,Chow; Bennett,0,14,30,30
1650833052242,MATH 193A,A01,083224,Staff,0,6,30,30
1650833052242,MATH 193A,A02,083225,Staff,0,6,30,30
1650833052242,MATH 193A,A03,083781,Staff,0,6,30,30
1650833052242,MATH 193A,A04,083782,Staff,0,7,30,30
1650833058267,MATH 197,001,091859,McAuley; Julian John,9998,0,9999,1
1650833064315,COGS 9,A01,083615,Staff,0,17,60,60
1650833070339,COGS 11,A01,083617,Boyle; Mary E. T.,15,0,40,25
1650833076370,COGS 13,A01,083071,Staff,0,38,40,40
1650833082399,COGS 14A,A01,092681,Staff,0,36,100,100
1650833088425,COGS 14B,A01,083073,Cheng; Tzu-Han,0,12,50,50
1650833094448,COGS 17,A01,092677,Staff,11,0,75,64
1650833100472,COGS 100,A01,083619,Staff,0,29,60,60
1650833106494,COGS 101A,A01,083621,Davis; Joshua Daniel,0,28,60,60
1650833112525,COGS 101B,A01,091572,Staff,0,3,60,60
1650833118551,COGS 101C,A01,083625,Delgado; Tania,14,0,30,16
1650833124577,COGS 107A,A01,083627,Boyle; Mary E. T.,0,16,60,60
1650833130602,COGS 118A,A01,083075,Staff,0,8,60,60
1650833136626,CSE 3,A50,083646,Miranda; Gregory Joseph,18,0,38,20
1650833136626,CSE 3,A51,083647,Miranda; Gregory Joseph,36,0,37,1
1650833142650,CSE 8A,A50,083650,Miranda; Gregory Joseph,0,29,40,40
1650833148677,CSE 11,A01,083080,Cao; Yingjun,0,96,40,40
1650833154700,CSE 12,A01,083652,Staff,0,21,100,100
1650833160724,CSE 15L,A01,083654,Staff,0,3,50,50
1650833160724,CSE 15L,A02,083655,Staff,0,2,50,50
1650833166748,CSE 20,A01,083657,Staff,49,0,80,31
1650833172770,CSE 30,A01,083084,Eldon; John,0,75,40,40
1650833178796,CSE 100,A01,083659,Cao; Yingjun,0,71,50,50
1650833184819,CSE 134B,A01,083661,Powell; Thomas Allan,0,38,65,65
1650833190846,CSE 140,A01,083663,Staff,0,11,75,75
1650833196874,CSE 140L,A01,083088,Eldon; John,0,20,75,75
1650833202898,CSE 175,A01,083665,Kumar; Rakesh,7,0,25,18
1650833208933,CSE 190,A00,092507,Dubnov; Shlomo,10,0,20,10
1650833214958,ECE 45,A01,083139,Staff,0,1,60,60
1650833220981,ECE 65,A50,083695,Staff,0,5,30,30
1650833227004,ECE 109,A01,091882,Touri; Behrouz,32,0,70,38
1650833233031,ECE 180,A00,083140,Abi Samra; Nicholas Camill,20,0,30,10
1650833233031,ECE 180,B00,083141,Abi Samra; Nicholas Camill,0,0,30,30
1650833239055,MATH 10A,A01,083735,Patchell; Gregory David,2,0,30,28
1650833239055,MATH 10A,A02,083736,Patchell; Gregory David,27,0,30,3
1650833239055,MATH 10A,A03,083737,Patchell; Gregory David,24,0,30,6
1650833245079,MATH 10B,A01,083207,Staff,0,9,30,30
1650833245079,MATH 10B,A02,083208,Staff,0,6,30,30
1650833245079,MATH 10B,B01,083739,Staff,11,0,30,19
1650833245079,MATH 10B,B02,083740,Staff,28,0,30,2
1650833251104,MATH 18,A01,083743,Staff,0,0,30,30
1650833251104,MATH 18,A02,083744,Staff,23,0,30,7
1650833251104,MATH 18,A03,083745,Staff,21,0,30,9
1650833251104,MATH 18,A04,083746,Staff,26,0,30,4
1650833251104,MATH 18,B01,083748,Staff,0,15,30,30
1650833251104,MATH 18,B02,083749,Staff,0,12,30,30
1650833251104,MATH 18,B03,083750,Staff,0,12,30,30
1650833251104,MATH 18,B04,083751,Staff,0,12,30,30
1650833257131,MATH 20A,A01,083754,Staff,19,0,40,21
1650833263165,MATH 20B,A01,083756,Staff,0,13,30,30
1650833263165,MATH 20B,A02,083757,Staff,0,12,30,30
1650833269189,MATH 20C,A01,083760,Staff,0,17,30,30
1650833269189,MATH 20C,A02,083761,Staff,0,16,30,30
1650833269189,MATH 20C,B01,083762,Staff,9,0,30,21
1650833269189,MATH 20C,B02,083763,Staff,28,0,30,2
1650833275216,MATH 20D,A01,083765,Staff,2,1,30,28
1650833275216,MATH 20D,A02,083766,Staff,6,0,30,24
1650833275216,MATH 20D,A03,083767,Staff,24,0,30,6
1650833281245,MATH 20E,A01,083771,Staff,2,0,30,28
1650833281245,MATH 20E,A02,083772,Staff,14,0,30,16
1650833281245,MATH 20E,B01,083773,Staff,0,0,30,30
1650833281245,MATH 20E,B02,083774,Staff,5,0,30,25
1650833287268,MATH 103A,A01,083777,Staff,0,16,30,30
1650833287268,MATH 103A,A02,083778,Staff,0,15,30,30
1650833287268,MATH 103A,B01,083779,Staff,0,15,30,30
1650833287268,MATH 103A,B02,083780,Staff,0,15,30,30
1650833293292,MATH 105,A01,085443,Staff,0,22,30,30
1650833299315,MATH 109,A01,083213,Anzaldo; Leesa B,0,7,30,30
1650833299315,MATH 109,A02,083214,Anzaldo; Leesa B,0,7,30,30
1650833299315,MATH 109,B01,083215,Anzaldo; Leesa B,0,8,30,30
1650833299315,MATH 109,B02,083216,Anzaldo; Leesa B,0,7,30,30
1650833305338,MATH 142A,A01,083219,Chow; Bennett,0,16,30,30
1650833305338,MATH 142A,A02,083220,Chow; Bennett,0,15,30,30
1650833305338,MATH 142A,B01,083221,Chow; Bennett,0,16,30,30
1650833305338,MATH 142A,B02,083222,Chow; Bennett,0,14,30,30
1650833311363,MATH 193A,A01,083224,Staff,0,6,30,30
1650833311363,MATH 193A,A02,083225,Staff,0,6,30,30
1650833311363,MATH 193A,A03,083781,Staff,0,6,30,30
1650833311363,MATH 193A,A04,083782,Staff,0,7,30,30
1650833317388,MATH 197,001,091859,McAuley; Julian John,9998,0,9999,1
1650833323438,COGS 9,A01,083615,Staff,0,17,60,60
1650833329463,COGS 11,A01,083617,Boyle; Mary E. T.,15,0,40,25
1650833335581,COGS 13,A01,083071,Staff,0,38,40,40
1650833341611,COGS 14A,A01,092681,Staff,0,36,100,100
1650833347637,COGS 14B,A01,083073,Cheng; Tzu-Han,0,12,50,50
1650833353661,COGS 17,A01,092677,Staff,11,0,75,64
1650833359688,COGS 100,A01,083619,Staff,0,29,60,60
1650833365715,COGS 101A,A01,083621,Davis; Joshua Daniel,0,28,60,60
1650833371745,COGS 101B,A01,091572,Staff,0,3,60,60
1650833377770,COGS 101C,A01,083625,Delgado; Tania,14,0,30,16
1650833383796,COGS 107A,A01,083627,Boyle; Mary E. T.,0,16,60,60
1650833389819,COGS 118A,A01,083075,Staff,0,8,60,60
1650833395844,CSE 3,A50,083646,Miranda; Gregory Joseph,18,0,38,20
1650833395844,CSE 3,A51,083647,Miranda; Gregory Joseph,36,0,37,1
1650833401871,CSE 8A,A50,083650,Miranda; Gregory Joseph,0,29,40,40
1650833407893,CSE 11,A01,083080,Cao; Yingjun,0,96,40,40
1650833413916,CSE 12,A01,083652,Staff,0,21,100,100
1650833419939,CSE 15L,A01,083654,Staff,0,3,50,50
1650833419939,CSE 15L,A02,083655,Staff,0,2,50,50
1650833425962,CSE 20,A01,083657,Staff,49,0,80,31
1650833431984,CSE 30,A01,083084,Eldon; John,0,75,40,40
1650833438009,CSE 100,A01,083659,Cao; Yingjun,0,71,50,50
1650833444031,CSE 134B,A01,083661,Powell; Thomas Allan,0,38,65,65
1650833450054,CSE 140,A01,083663,Staff,0,11,75,75
1650833456078,CSE 140L,A01,083088,Eldon; John,0,20,75,75
1650833462102,CSE 175,A01,083665,Kumar; Rakesh,7,0,25,18
1650833468125,CSE 190,A00,092507,Dubnov; Shlomo,10,0,20,10
1650833474150,ECE 45,A01,083139,Staff,0,1,60,60
1650833480172,ECE 65,A50,083695,Staff,0,5,30,30
1650833486196,ECE 109,A01,091882,Touri; Behrouz,32,0,70,38
1650833492222,ECE 180,A00,083140,Abi Samra; Nicholas Camill,20,0,30,10
1650833492222,ECE 180,B00,083141,Abi Samra; Nicholas Camill,0,0,30,30
1650833498251,MATH 10A,A01,083735,Patchell; Gregory David,2,0,30,28
1650833498251,MATH 10A,A02,083736,Patchell; Gregory David,27,0,30,3
1650833498251,MATH 10A,A03,083737,Patchell; Gregory David,24,0,30,6
1650833504278,MATH 10B,A01,083207,Staff,0,9,30,30
1650833504278,MATH 10B,A02,083208,Staff,0,6,30,30
1650833504278,MATH 10B,B01,083739,Staff,11,0,30,19
1650833504278,MATH 10B,B02,083740,Staff,28,0,30,2
1650833510307,MATH 18,A01,083743,Staff,0,0,30,30
1650833510307,MATH 18,A02,083744,Staff,23,0,30,7
1650833510307,MATH 18,A03,083745,Staff,21,0,30,9
1650833510307,MATH 18,A04,083746,Staff,26,0,30,4
1650833510307,MATH 18,B01,083748,Staff,0,15,30,30
1650833510307,MATH 18,B02,083749,Staff,0,12,30,30
1650833510307,MATH 18,B03,083750,Staff,0,12,30,30
1650833510307,MATH 18,B04,083751,Staff,0,12,30,30
1650833516333,MATH 20A,A01,083754,Staff,19,0,40,21
1650833522359,MATH 20B,A01,083756,Staff,0,13,30,30
1650833522359,MATH 20B,A02,083757,Staff,0,12,30,30
1650833528381,MATH 20C,A01,083760,Staff,0,17,30,30
1650833528381,MATH 20C,A02,083761,Staff,0,16,30,30
1650833528381,MATH 20C,B01,083762,Staff,9,0,30,21
1650833528381,MATH 20C,B02,083763,Staff,28,0,30,2
1650833534408,MATH 20D,A01,083765,Staff,2,1,30,28
1650833534408,MATH 20D,A02,083766,Staff,6,0,30,24
1650833534408,MATH 20D,A03,083767,Staff,24,0,30,6
1650833540437,MATH 20E,A01,083771,Staff,2,0,30,28
1650833540437,MATH 20E,A02,083772,Staff,14,0,30,16
1650833540437,MATH 20E,B01,083773,Staff,0,0,30,30
1650833540437,MATH 20E,B02,083774,Staff,5,0,30,25
1650833546459,MATH 103A,A01,083777,Staff,0,16,30,30
1650833546459,MATH 103A,A02,083778,Staff,0,15,30,30
1650833546459,MATH 103A,B01,083779,Staff,0,15,30,30
1650833546459,MATH 103A,B02,083780,Staff,0,15,30,30
1650833552481,MATH 105,A01,085443,Staff,0,22,30,30
1650833558505,MATH 109,A01,083213,Anzaldo; Leesa B,0,7,30,30
1650833558505,MATH 109,A02,083214,Anzaldo; Leesa B,0,7,30,30
1650833558505,MATH 109,B01,083215,Anzaldo; Leesa B,0,8,30,30
1650833558505,MATH 109,B02,083216,Anzaldo; Leesa B,0,7,30,30
1650833564529,MATH 142A,A01,083219,Chow; Bennett,0,16,30,30
1650833564529,MATH 142A,A02,083220,Chow; Bennett,0,15,30,30
1650833564529,MATH 142A,B01,083221,Chow; Bennett,0,16,30,30
1650833564529,MATH 142A,B02,083222,Chow; Bennett,0,14,30,30
1650833570551,MATH 193A,A01,083224,Staff,0,6,30,30
1650833570551,MATH 193A,A02,083225,Staff,0,6,30,30
1650833570551,MATH 193A,A03,083781,Staff,0,6,30,30
1650833570551,MATH 193A,A04,083782,Staff,0,7,30,30
1650833576576,MATH 197,001,091859,McAuley; Julian John,9998,0,9999,1
1650833582626,COGS 9,A01,083615,Staff,0,17,60,60
1650833588649,COGS 11,A01,083617,Boyle; Mary E. T.,15,0,40,25
1650833594671,COGS 13,A01,083071,Staff,0,38,40,40
1650833600696,COGS 14A,A01,092681,Staff,0,36,100,100
1650833606722,COGS 14B,A01,083073,Cheng; Tzu-Han,0,12,50,50
1650833612748,COGS 17,A01,092677,Staff,11,0,75,64
1650833618772,COGS 100,A01,083619,Staff,0,29,60,60
1650833624794,COGS 101A,A01,083621,Davis; Joshua Daniel,0,28,60,60
1650833630821,COGS 101B,A01,091572,Staff,0,3,60,60
1650833636848,COGS 101C,A01,083625,Delgado; Tania,14,0,30,16
1650833642882,COGS 107A,A01,083627,Boyle; Mary E. T.,0,16,60,60
1650833648905,COGS 118A,A01,083075,Staff,0,8,60,60
1650833654929,CSE 3,A50,083646,Miranda; Gregory Joseph,18,0,38,20
1650833654929,CSE 3,A51,083647,Miranda; Gregory Joseph,36,0,37,1
1650833660959,CSE 8A,A50,083650,Miranda; Gregory Joseph,0,29,40,40
1650833666985,CSE 11,A01,083080,Cao; Yingjun,0,96,40,40
1650833673012,CSE 12,A01,083652,Staff,0,21,100,100
1650833679039,CSE 15L,A01,083654,Staff,0,3,50,50
1650833679039,CSE 15L,A02,083655,Staff,0,2,50,50
1650833685062,CSE 20,A01,083657,Staff,49,0,80,31
1650833691087,CSE 30,A01,083084,Eldon; John,0,75,40,40
1650833697111,CSE 100,A01,083659,Cao; Yingjun,0,71,50,50
1650833703135,CSE 134B,A01,083661,Powell; Thomas Allan,0,38,65,65
1650833709159,CSE 140,A01,083663,Staff,0,11,75,75
1650833715184,CSE 140L,A01,083088,Eldon; John,0,20,75,75
1650833721207,CSE 175,A01,083665,Kumar; Rakesh,7,0,25,18
1650833727234,CSE 190,A00,092507,Dubnov; Shlomo,10,0,20,10
1650833733257,ECE 45,A01,083139,Staff,0,1,60,60
1650833739282,ECE 65,A50,083695,Staff,0,5,30,30
1650833745306,ECE 109,A01,091882,Touri; Behrouz,32,0,70,38
1650833751327,ECE 180,A00,083140,Abi Samra; Nicholas Camill,20,0,30,10
1650833751327,ECE 180,B00,083141,Abi Samra; Nicholas Camill,0,0,30,30
1650833757353,MATH 10A,A01,083735,Patchell; Gregory David,2,0,30,28
1650833757353,MATH 10A,A02,083736,Patchell; Gregory David,27,0,30,3
1650833757353,MATH 10A,A03,083737,Patchell; Gregory David,24,0,30,6
1650833763379,MATH 10B,A01,083207,Staff,0,9,30,30
1650833763379,MATH 10B,A02,083208,Staff,0,6,30,30
1650833763379,MATH 10B,B01,083739,Staff,11,0,30,19
1650833763379,MATH 10B,B02,083740,Staff,28,0,30,2
1650833769405,MATH 18,A01,083743,Staff,0,0,30,30
1650833769405,MATH 18,A02,083744,Staff,23,0,30,7
1650833769405,MATH 18,A03,083745,Staff,21,0,30,9
1650833769405,MATH 18,A04,083746,Staff,26,0,30,4
1650833769405,MATH 18,B01,083748,Staff,0,15,30,30
1650833769405,MATH 18,B02,083749,Staff,0,12,30,30
1650833769405,MATH 18,B03,083750,Staff,0,12,30,30
1650833769405,MATH 18,B04,083751,Staff,0,12,30,30
1650833775430,MATH 20A,A01,083754,Staff,19,0,40,21
1650833781457,MATH 20B,A01,083756,Staff,0,13,30,30
1650833781457,MATH 20B,A02,083757,Staff,0,12,30,30
1650833787482,MATH 20C,A01,083760,Staff,0,17,30,30
1650833787482,MATH 20C,A02,083761,Staff,0,16,30,30
1650833787482,MATH 20C,B01,083762,Staff,9,0,30,21
1650833787482,MATH 20C,B02,083763,Staff,28,0,30,2
1650833793509,MATH 20D,A01,083765,Staff,2,1,30,28
1650833793509,MATH 20D,A02,083766,Staff,6,0,30,24
1650833793509,MATH 20D,A03,083767,Staff,24,0,30,6
1650833799533,MATH 20E,A01,083771,Staff,2,0,30,28
1650833799533,MATH 20E,A02,083772,Staff,14,0,30,16
1650833799533,MATH 20E,B01,083773,Staff,0,0,30,30
1650833799533,MATH 20E,B02,083774,Staff,5,0,30,25
1650833805558,MATH 103A,A01,083777,Staff,0,16,30,30
1650833805558,MATH 103A,A02,083778,Staff,0,15,30,30
1650833805558,MATH 103A,B01,083779,Staff,0,15,30,30
1650833805558,MATH 103A,B02,083780,Staff,0,15,30,30
1650833811597,MATH 105,A01,085443,Staff,0,22,30,30
1650833817627,MATH 109,A01,083213,Anzaldo; Leesa B,0,7,30,30
1650833817627,MATH 109,A02,083214,Anzaldo; Leesa B,0,7,30,30
1650833817627,MATH 109,B01,083215,Anzaldo; Leesa B,0,8,30,30
1650833817627,MATH 109,B02,083216,Anzaldo; Leesa B,0,7,30,30
1650833823654,MATH 142A,A01,083219,Chow; Bennett,0,16,30,30
1650833823654,MATH 142A,A02,083220,Chow; Bennett,0,15,30,30
1650833823654,MATH 142A,B01,083221,Chow; Bennett,0,16,30,30
1650833823654,MATH 142A,B02,083222,Chow; Bennett,0,14,30,30
1650833829677,MATH 193A,A01,083224,Staff,0,6,30,30
1650833829677,MATH 193A,A02,083225,Staff,0,6,30,30
1650833829677,MATH 193A,A03,083781,Staff,0,6,30,30
1650833829677,MATH 193A,A04,083782,Staff,0,7,30,30
1650833835704,MATH 197,001,091859,McAuley; Julian John,9998,0,9999,1
1650833841762,COGS 9,A01,083615,Staff,0,17,60,60
1650833847789,COGS 11,A01,083617,Boyle; Mary E. T.,15,0,40,25
1650833853812,COGS 13,A01,083071,Staff,0,38,40,40
1650833859839,COGS 14A,A01,092681,Staff,0,36,100,100
1650833865872,COGS 14B,A01,083073,Cheng; Tzu-Han,0,12,50,50
1650833871901,COGS 17,A01,092677,Staff,11,0,75,64
1650833877924,COGS 100,A01,083619,Staff,0,29,60,60
1650833883952,COGS 101A,A01,083621,Davis; Joshua Daniel,0,28,60,60
1650833889976,COGS 101B,A01,091572,Staff,0,3,60,60
1650833895999,COGS 101C,A01,083625,Delgado; Tania,14,0,30,16
1650833902025,COGS 107A,A01,083627,Boyle; Mary E. T.,0,16,60,60
1650833908051,COGS 118A,A01,083075,Staff,0,8,60,60
1650833914075,CSE 3,A50,083646,Miranda; Gregory Joseph,18,0,38,20
1650833914075,CSE 3,A51,083647,Miranda; Gregory Joseph,36,0,37,1
1650833920099,CSE 8A,A50,083650,Miranda; Gregory Joseph,0,29,40,40
1650833926125,CSE 11,A01,083080,Cao; Yingjun,0,96,40,40
1650833932250,CSE 12,A01,083652,Staff,0,21,100,100
1650833938275,CSE 15L,A01,083654,Staff,0,3,50,50
1650833938275,CSE 15L,A02,083655,Staff,0,2,50,50
1650833944304,CSE 20,A01,083657,Staff,49,0,80,31
1650833950328,CSE 30,A01,083084,Eldon; John,0,75,40,40
1650833956359,CSE 100,A01,083659,Cao; Yingjun,0,71,50,50
1650833962386,CSE 134B,A01,083661,Powell; Thomas Allan,0,38,65,65
1650833968410,CSE 140,A01,083663,Staff,0,11,75,75
1650833974452,CSE 140L,A01,083088,Eldon; John,0,20,75,75
1650833980474,CSE 175,A01,083665,Kumar; Rakesh,7,0,25,18
1650833986497,CSE 190,A00,092507,Dubnov; Shlomo,10,0,20,10
1650833992524,ECE 45,A01,083139,Staff,0,1,60,60
1650833998547,ECE 65,A50,083695,Staff,0,5,30,30
1650834004570,ECE 109,A01,091882,Touri; Behrouz,32,0,70,38
1650834010593,ECE 180,A00,083140,Abi Samra; Nicholas Camill,20,0,30,10
1650834010593,ECE 180,B00,083141,Abi Samra; Nicholas Camill,0,0,30,30
1650834016617,MATH 10A,A01,083735,Patchell; Gregory David,2,0,30,28
1650834016617,MATH 10A,A02,083736,Patchell; Gregory David,27,0,30,3
1650834016617,MATH 10A,A03,083737,Patchell; Gregory David,24,0,30,6
1650834022640,MATH 10B,A01,083207,Staff,0,9,30,30
1650834022640,MATH 10B,A02,083208,Staff,0,6,30,30
1650834022640,MATH 10B,B01,083739,Staff,11,0,30,19
1650834022640,MATH 10B,B02,083740,Staff,28,0,30,2
1650834028666,MATH 18,A01,083743,Staff,0,0,30,30
1650834028666,MATH 18,A02,083744,Staff,23,0,30,7
1650834028666,MATH 18,A03,083745,Staff,21,0,30,9
1650834028666,MATH 18,A04,083746,Staff,26,0,30,4
1650834028666,MATH 18,B01,083748,Staff,0,15,30,30
1650834028666,MATH 18,B02,083749,Staff,0,12,30,30
1650834028666,MATH 18,B03,083750,Staff,0,12,30,30
1650834028666,MATH 18,B04,083751,Staff,0,12,30,30
1650834034687,MATH 20A,A01,083754,Staff,19,0,40,21
1650834040714,MATH 20B,A01,083756,Staff,0,13,30,30
1650834040714,MATH 20B,A02,083757,Staff,0,12,30,30
1650834046739,MATH 20C,A01,083760,Staff,0,17,30,30
1650834046739,MATH 20C,A02,083761,Staff,0,16,30,30
1650834046739,MATH 20C,B01,083762,Staff,9,0,30,21
1650834046739,MATH 20C,B02,083763,Staff,28,0,30,2
1650834052762,MATH 20D,A01,083765,Staff,2,1,30,28
1650834052762,MATH 20D,A02,083766,Staff,6,0,30,24
1650834052762,MATH 20D,A03,083767,Staff,24,0,30,6
1650834058788,MATH 20E,A01,083771,Staff,2,0,30,28
1650834058788,MATH 20E,A02,083772,Staff,14,0,30,16
1650834058788,MATH 20E,B01,083773,Staff,0,0,30,30
1650834058788,MATH 20E,B02,083774,Staff,5,0,30,25
1650834064813,MATH 103A,A01,083777,Staff,0,16,30,30
1650834064813,MATH 103A,A02,083778,Staff,0,15,30,30
1650834064813,MATH 103A,B01,083779,Staff,0,15,30,30
1650834064813,MATH 103A,B02,083780,Staff,0,15,30,30
1650834070841,MATH 105,A01,085443,Staff,0,22,30,30
1650834076873,MATH 109,A01,083213,Anzaldo; Leesa B,0,7,30,30
1650834076873,MATH 109,A02,083214,Anzaldo; Leesa B,0,7,30,30
1650834076873,MATH 109,B01,083215,Anzaldo; Leesa B,0,8,30,30
1650834076873,MATH 109,B02,083216,Anzaldo; Leesa B,0,7,30,30
1650834082902,MATH 142A,A01,083219,Chow; Bennett,0,16,30,30
1650834082902,MATH 142A,A02,083220,Chow; Bennett,0,15,30,30
1650834082902,MATH 142A,B01,083221,Chow; Bennett,0,16,30,30
1650834082902,MATH 142A,B02,083222,Chow; Bennett,0,14,30,30
1650834088927,MATH 193A,A01,083224,Staff,0,6,30,30
1650834088927,MATH 193A,A02,083225,Staff,0,6,30,30
1650834088927,MATH 193A,A03,083781,Staff,0,6,30,30
1650834088927,MATH 193A,A04,083782,Staff,0,7,30,30
1650834094959,MATH 197,001,091859,McAuley; Julian John,9998,0,9999,1
1650834101049,COGS 9,A01,083615,Staff,0,17,60,60
1650834107074,COGS 11,A01,083617,Boyle; Mary E. T.,15,0,40,25
1650834113095,COGS 13,A01,083071,Staff,0,38,40,40
1650834119117,COGS 14A,A01,092681,Staff,0,36,100,100
1650834125141,COGS 14B,A01,083073,Cheng; Tzu-Han,0,12,50,50
1650834131166,COGS 17,A01,092677,Staff,11,0,75,64
1650834137189,COGS 100,A01,083619,Staff,0,29,60,60
1650834143214,COGS 101A,A01,083621,Davis; Joshua Daniel,0,28,60,60
1650834149237,COGS 101B,A01,091572,Staff,0,3,60,60
1650834155261,COGS 101C,A01,083625,Delgado; Tania,14,0,30,16
1650834161284,COGS 107A,A01,083627,Boyle; Mary E. T.,0,16,60,60
1650834167309,COGS 118A,A01,083075,Staff,0,8,60,60
1650834173337,CSE 3,A50,083646,Miranda; Gregory Joseph,18,0,38,20
1650834173337,CSE 3,A51,083647,Miranda; Gregory Joseph,36,0,37,1
1650834179360,CSE 8A,A50,083650,Miranda; Gregory Joseph,0,29,40,40
1650834185393,CSE 11,A01,083080,Cao; Yingjun,0,96,40,40
1650834191417,CSE 12,A01,083652,Staff,0,21,100,100
1650834197455,CSE 15L,A01,083654,Staff,0,3,50,50
1650834197455,CSE 15L,A02,083655,Staff,0,2,50,50
1650834203484,CSE 20,A01,083657,Staff,49,0,80,31
1650834209506,CSE 30,A01,083084,Eldon; John,0,75,40,40
1650834215529,CSE 100,A01,083659,Cao; Yingjun,0,71,50,50
1650834221554,CSE 134B,A01,083661,Powell; Thomas Allan,0,38,65,65
1650834227577,CSE 140,A01,083663,Staff,0,11,75,75
1650834233602,CSE 140L,A01,083088,Eldon; John,0,20,75,75
1650834239626,CSE 175,A01,083665,Kumar; Rakesh,7,0,25,18
1650834245652,CSE 190,A00,092507,Dubnov; Shlomo,10,0,20,10
1650834251673,ECE 45,A01,083139,Staff,0,1,60,60
1650834257696,ECE 65,A50,083695,Staff,0,5,30,30
1650834263719,ECE 109,A01,091882,Touri; Behrouz,32,0,70,38
1650834269745,ECE 180,A00,083140,Abi Samra; Nicholas Camill,20,0,30,10
1650834269745,ECE 180,B00,083141,Abi Samra; Nicholas Camill,0,0,30,30
1650834275779,MATH 10A,A01,083735,Patchell; Gregory David,2,0,30,28
1650834275779,MATH 10A,A02,083736,Patchell; Gregory David,27,0,30,3
1650834275779,MATH 10A,A03,083737,Patchell; Gregory David,24,0,30,6
1650834281805,MATH 10B,A01,083207,Staff,0,9,30,30
1650834281805,MATH 10B,A02,083208,Staff,0,6,30,30
1650834281805,MATH 10B,B01,083739,Staff,11,0,30,19
1650834281805,MATH 10B,B02,083740,Staff,28,0,30,2
1650834287831,MATH 18,A01,083743,Staff,0,0,30,30
1650834287831,MATH 18,A02,083744,Staff,23,0,30,7
1650834287831,MATH 18,A03,083745,Staff,21,0,30,9
1650834287831,MATH 18,A04,083746,Staff,26,0,30,4
1650834287831,MATH 18,B01,083748,Staff,0,15,30,30
1650834287831,MATH 18,B02,083749,Staff,0,12,30,30
1650834287831,MATH 18,B03,083750,Staff,0,12,30,30
1650834287831,MATH 18,B04,083751,Staff,0,12,30,30
1650834293854,MATH 20A,A01,083754,Staff,19,0,40,21
1650834299879,MATH 20B,A01,083756,Staff,0,13,30,30
1650834299879,MATH 20B,A02,083757,Staff,0,12,30,30
1650834305905,MATH 20C,A01,083760,Staff,0,17,30,30
1650834305905,MATH 20C,A02,083761,Staff,0,16,30,30
1650834305905,MATH 20C,B01,083762,Staff,9,0,30,21
1650834305905,MATH 20C,B02,083763,Staff,28,0,30,2
1650834311932,MATH 20D,A01,083765,Staff,2,1,30,28
1650834311932,MATH 20D,A02,083766,Staff,6,0,30,24
1650834311932,MATH 20D,A03,083767,Staff,24,0,30,6
1650834317958,MATH 20E,A01,083771,Staff,2,0,30,28
1650834317958,MATH 20E,A02,083772,Staff,14,0,30,16
1650834317958,MATH 20E,B01,083773,Staff,0,0,30,30
1650834317958,MATH 20E,B02,083774,Staff,5,0,30,25
1650834323985,MATH 103A,A01,083777,Staff,0,16,30,30
1650834323985,MATH 103A,A02,083778,Staff,0,15,30,30
1650834323985,MATH 103A,B01,083779,Staff,0,15,30,30
1650834323985,MATH 103A,B02,083780,Staff,0,15,30,30
1650834330012,MATH 105,A01,085443,Staff,0,22,30,30
1650834336042,MATH 109,A01,083213,Anzaldo; Leesa B,0,7,30,30
1650834336042,MATH 109,A02,083214,Anzaldo; Leesa B,0,7,30,30
1650834336042,MATH 109,B01,083215,Anzaldo; Leesa B,0,8,30,30
1650834336042,MATH 109,B02,083216,Anzaldo; Leesa B,0,7,30,30
1650834342069,MATH 142A,A01,083219,Chow; Bennett,0,16,30,30
1650834342069,MATH 142A,A02,083220,Chow; Bennett,0,15,30,30
1650834342069,MATH 142A,B01,083221,Chow; Bennett,0,16,30,30
1650834342069,MATH 142A,B02,083222,Chow; Bennett,0,14,30,30
1650834348096,MATH 193A,A01,083224,Staff,0,6,30,30
1650834348096,MATH 193A,A02,083225,Staff,0,6,30,30
1650834348096,MATH 193A,A03,083781,Staff,0,6,30,30
1650834348096,MATH 193A,A04,083782,Staff,0,7,30,30
1650834354124,MATH 197,001,091859,McAuley; Julian John,9998,0,9999,1
1650834360200,COGS 9,A01,083615,Staff,0,17,60,60
1650834366223,COGS 11,A01,083617,Boyle; Mary E. T.,15,0,40,25
1650834372247,COGS 13,A01,083071,Staff,0,38,40,40
1650834378274,COGS 14A,A01,092681,Staff,0,36,100,100
1650834384299,COGS 14B,A01,083073,Cheng; Tzu-Han,0,12,50,50
1650834390324,COGS 17,A01,092677,Staff,11,0,75,64
1650834396348,COGS 100,A01,083619,Staff,0,29,60,60
1650834402372,COGS 101A,A01,083621,Davis; Joshua Daniel,0,28,60,60
1650834408399,COGS 101B,A01,091572,Staff,0,3,60,60
1650834414423,COGS 101C,A01,083625,Delgado; Tania,14,0,30,16
1650834420457,COGS 107A,A01,083627,Boyle; Mary E. T.,0,16,60,60
1650834426480,COGS 118A,A01,083075,Staff,0,8,60,60
1650834432508,CSE 3,A50,083646,Miranda; Gregory Joseph,18,0,38,20
1650834432508,CSE 3,A51,083647,Miranda; Gregory Joseph,36,0,37,1
1650834438536,CSE 8A,A50,083650,Miranda; Gregory Joseph,0,29,40,40
1650834444567,CSE 11,A01,083080,Cao; Yingjun,0,96,40,40
1650834450594,CSE 12,A01,083652,Staff,0,21,100,100
1650834456623,CSE 15L,A01,083654,Staff,0,3,50,50
1650834456623,CSE 15L,A02,083655,Staff,0,2,50,50
1650834462647,CSE 20,A01,083657,Staff,49,0,80,31
1650834468671,CSE 30,A01,083084,Eldon; John,0,75,40,40
1650834474695,CSE 100,A01,083659,Cao; Yingjun,0,71,50,50
1650834480718,CSE 134B,A01,083661,Powell; Thomas Allan,0,38,65,65
1650834486741,CSE 140,A01,083663,Staff,0,11,75,75
1650834492766,CSE 140L,A01,083088,Eldon; John,0,20,75,75
1650834498794,CSE 175,A01,083665,Kumar; Rakesh,7,0,25,18
1650834504821,CSE 190,A00,092507,Dubnov; Shlomo,10,0,20,10
1650834510847,ECE 45,A01,083139,Staff,0,1,60,60
1650834516876,ECE 65,A50,083695,Staff,0,5,30,30
1650834522902,ECE 109,A01,091882,Touri; Behrouz,32,0,70,38
1650834529022,ECE 180,A00,083140,Abi Samra; Nicholas Camill,20,0,30,10
1650834529022,ECE 180,B00,083141,Abi Samra; Nicholas Camill,0,0,30,30
1650834535044,MATH 10A,A01,083735,Patchell; Gregory David,2,0,30,28
1650834535044,MATH 10A,A02,083736,Patchell; Gregory David,27,0,30,3
1650834535044,MATH 10A,A03,083737,Patchell; Gregory David,24,0,30,6
1650834541071,MATH 10B,A01,083207,Staff,0,9,30,30
1650834541071,MATH 10B,A02,083208,Staff,0,6,30,30
1650834541071,MATH 10B,B01,083739,Staff,11,0,30,19
1650834541071,MATH 10B,B02,083740,Staff,28,0,30,2
1650834547101,MATH 18,A01,083743,Staff,0,0,30,30
1650834547101,MATH 18,A02,083744,Staff,23,0,30,7
1650834547101,MATH 18,A03,083745,Staff,21,0,30,9
1650834547101,MATH 18,A04,083746,Staff,26,0,30,4
1650834547101,MATH 18,B01,083748,Staff,0,15,30,30
1650834547101,MATH 18,B02,083749,Staff,0,12,30,30
1650834547101,MATH 18,B03,083750,Staff,0,12,30,30
1650834547101,MATH 18,B04,083751,Staff,0,12,30,30
1650834553125,MATH 20A,A01,083754,Staff,19,0,40,21
1650834559148,MATH 20B,A01,083756,Staff,0,13,30,30
1650834559148,MATH 20B,A02,083757,Staff,0,12,30,30
1650834565175,MATH 20C,A01,083760,Staff,0,17,30,30
1650834565175,MATH 20C,A02,083761,Staff,0,16,30,30
1650834565175,MATH 20C,B01,083762,Staff,9,0,30,21
1650834565175,MATH 20C,B02,083763,Staff,28,0,30,2
1650834571203,MATH 20D,A01,083765,Staff,2,1,30,28
1650834571203,MATH 20D,A02,083766,Staff,6,0,30,24
1650834571203,MATH 20D,A03,083767,Staff,24,0,30,6
1650834577230,MATH 20E,A01,083771,Staff,2,0,30,28
1650834577230,MATH 20E,A02,083772,Staff,14,0,30,16
1650834577230,MATH 20E,B01,083773,Staff,0,0,30,30
1650834577230,MATH 20E,B02,083774,Staff,5,0,30,25
1650834583259,MATH 103A,A01,083777,Staff,0,16,30,30
1650834583259,MATH 103A,A02,083778,Staff,0,15,30,30
1650834583259,MATH 103A,B01,083779,Staff,0,15,30,30
1650834583259,MATH 103A,B02,083780,Staff,0,15,30,30
1650834589296,MATH 105,A01,085443,Staff,0,22,30,30
1650834595324,MATH 109,A01,083213,Anzaldo; Leesa B,0,7,30,30
1650834595324,MATH 109,A02,083214,Anzaldo; Leesa B,0,7,30,30
1650834595324,MATH 109,B01,083215,Anzaldo; Leesa B,0,8,30,30
1650834595324,MATH 109,B02,083216,Anzaldo; Leesa B,0,7,30,30
1650834601348,MATH 142A,A01,083219,Chow; Bennett,0,16,30,30
1650834601348,MATH 142A,A02,083220,Chow; Bennett,0,15,30,30
1650834601348,MATH 142A,B01,083221,Chow; Bennett,0,16,30,30
1650834601348,MATH 142A,B02,083222,Chow; Bennett,0,14,30,30
1650834607375,MATH 193A,A01,083224,Staff,0,6,30,30
1650834607375,MATH 193A,A02,083225,Staff,0,6,30,30
1650834607375,MATH 193A,A03,083781,Staff,0,6,30,30
1650834607375,MATH 193A,A04,083782,Staff,0,7,30,30
1650834613400,MATH 197,001,091859,McAuley; Julian John,9998,0,9999,1
1650834619458,COGS 9,A01,083615,Staff,0,17,60,60
1650834625485,COGS 11,A01,083617,Boyle; Mary E. T.,15,0,40,25
1650834631510,COGS 13,A01,083071,Staff,0,38,40,40
1650834637536,COGS 14A,A01,092681,Staff,0,36,100,100
1650834643560,COGS 14B,A01,083073,Cheng; Tzu-Han,0,12,50,50
1650834649583,COGS 17,A01,092677,Staff,11,0,75,64
1650834655624,COGS 100,A01,083619,Staff,0,29,60,60
1650834661647,COGS 101A,A01,083621,Davis; Joshua Daniel,0,28,60,60
1650834667672,COGS 101B,A01,091572,Staff,0,3,60,60
1650834673698,COGS 101C,A01,083625,Delgado; Tania,14,0,30,16
1650834679721,COGS 107A,A01,083627,Boyle; Mary E. T.,0,16,60,60
1650834685747,COGS 118A,A01,083075,Staff,0,8,60,60
1650834691772,CSE 3,A50,083646,Miranda; Gregory Joseph,18,0,38,20
1650834691772,CSE 3,A51,083647,Miranda; Gregory Joseph,36,0,37,1
1650834697800,CSE 8A,A50,083650,Miranda; Gregory Joseph,0,29,40,40
1650834703826,CSE 11,A01,083080,Cao; Yingjun,0,96,40,40
1650834709850,CSE 12,A01,083652,Staff,0,21,100,100
1650834715876,CSE 15L,A01,083654,Staff,0,3,50,50
1650834715876,CSE 15L,A02,083655,Staff,0,2,50,50
1650834721902,CSE 20,A01,083657,Staff,49,0,80,31
1650834727930,CSE 30,A01,083084,Eldon; John,0,75,40,40
1650834733953,CSE 100,A01,083659,Cao; Yingjun,0,71,50,50
1650834739981,CSE 134B,A01,083661,Powell; Thomas Allan,0,38,65,65
1650834746004,CSE 140,A01,083663,Staff,0,11,75,75
1650834752030,CSE 140L,A01,083088,Eldon; John,0,20,75,75
1650834758059,CSE 175,A01,083665,Kumar; Rakesh,7,0,25,18
1650834764084,CSE 190,A00,092507,Dubnov; Shlomo,10,0,20,10
1650834770110,ECE 45,A01,083139,Staff,0,1,60,60
1650834776142,ECE 65,A50,083695,Staff,0,5,30,30
1650834782168,ECE 109,A01,091882,Touri; Behrouz,32,0,70,38
1650834788195,ECE 180,A00,083140,Abi Samra; Nicholas Camill,20,0,30,10
1650834788195,ECE 180,B00,083141,Abi Samra; Nicholas Camill,0,0,30,30
1650834794220,MATH 10A,A01,083735,Patchell; Gregory David,2,0,30,28
1650834794220,MATH 10A,A02,083736,Patchell; Gregory David,27,0,30,3
1650834794220,MATH 10A,A03,083737,Patchell; Gregory David,24,0,30,6
1650834800242,MATH 10B,A01,083207,Staff,0,9,30,30
1650834800242,MATH 10B,A02,083208,Staff,0,6,30,30
1650834800242,MATH 10B,B01,083739,Staff,11,0,30,19
1650834800242,MATH 10B,B02,083740,Staff,28,0,30,2
1650834806272,MATH 18,A01,083743,Staff,0,0,30,30
1650834806272,MATH 18,A02,083744,Staff,23,0,30,7
1650834806272,MATH 18,A03,083745,Staff,21,0,30,9
1650834806272,MATH 18,A04,083746,Staff,26,0,30,4
1650834806272,MATH 18,B01,083748,Staff,0,15,30,30
1650834806272,MATH 18,B02,083749,Staff,0,12,30,30
1650834806272,MATH 18,B03,083750,Staff,0,13,30,30
1650834806272,MATH 18,B04,083751,Staff,0,12,30,30
1650834812302,MATH 20A,A01,083754,Staff,19,0,40,21
1650834818331,MATH 20B,A01,083756,Staff,0,13,30,30
1650834818331,MATH 20B,A02,083757,Staff,0,12,30,30
1650834824355,MATH 20C,A01,083760,Staff,0,17,30,30
1650834824355,MATH 20C,A02,083761,Staff,0,16,30,30
1650834824355,MATH 20C,B01,083762,Staff,9,0,30,21
1650834824355,MATH 20C,B02,083763,Staff,28,0,30,2
1650834830380,MATH 20D,A01,083765,Staff,2,1,30,28
1650834830380,MATH 20D,A02,083766,Staff,6,0,30,24
1650834830380,MATH 20D,A03,083767,Staff,24,0,30,6
1650834836407,MATH 20E,A01,083771,Staff,2,0,30,28
1650834836407,MATH 20E,A02,083772,Staff,14,0,30,16
1650834836407,MATH 20E,B01,083773,Staff,0,0,30,30
1650834836407,MATH 20E,B02,083774,Staff,5,0,30,25
1650834842430,MATH 103A,A01,083777,Staff,0,16,30,30
1650834842430,MATH 103A,A02,083778,Staff,0,15,30,30
1650834842430,MATH 103A,B01,083779,Staff,0,15,30,30
1650834842430,MATH 103A,B02,083780,Staff,0,15,30,30
1650834848454,MATH 105,A01,085443,Staff,0,22,30,30
1650834854478,MATH 109,A01,083213,Anzaldo; Leesa B,0,7,30,30
1650834854478,MATH 109,A02,083214,Anzaldo; Leesa B,0,7,30,30
1650834854478,MATH 109,B01,083215,Anzaldo; Leesa B,0,8,30,30
1650834854478,MATH 109,B02,083216,Anzaldo; Leesa B,0,7,30,30
1650834860501,MATH 142A,A01,083219,Chow; Bennett,0,16,30,30
1650834860501,MATH 142A,A02,083220,Chow; Bennett,0,15,30,30
1650834860501,MATH 142A,B01,083221,Chow; Bennett,0,16,30,30
1650834860501,MATH 142A,B02,083222,Chow; Bennett,0,14,30,30
1650834866535,MATH 193A,A01,083224,Staff,0,6,30,30
1650834866535,MATH 193A,A02,083225,Staff,0,6,30,30
1650834866535,MATH 193A,A03,083781,Staff,0,6,30,30
1650834866535,MATH 193A,A04,083782,Staff,0,7,30,30
1650834872557,MATH 197,001,091859,McAuley; Julian John,9998,0,9999,1
1650834878616,COGS 9,A01,083615,Staff,0,17,60,60
1650834884639,COGS 11,A01,083617,Boyle; Mary E. T.,15,0,40,25
1650834890664,COGS 13,A01,083071,Staff,0,38,40,40
1650834896687,COGS 14A,A01,092681,Staff,0,36,100,100
1650834902710,COGS 14B,A01,083073,Cheng; Tzu-Han,0,12,50,50
1650834908736,COGS 17,A01,092677,Staff,11,0,75,64
1650834914760,COGS 100,A01,083619,Staff,0,29,60,60
1650834920789,COGS 101A,A01,083621,Davis; Joshua Daniel,0,28,60,60
1650834926814,COGS 101B,A01,091572,Staff,0,3,60,60
1650834932841,COGS 101C,A01,083625,Delgado; Tania,14,0,30,16
1650834938863,COGS 107A,A01,083627,Boyle; Mary E. T.,0,16,60,60
1650834944886,COGS 118A,A01,083075,Staff,0,8,60,60
1650834950910,CSE 3,A50,083646,Miranda; Gregory Joseph,18,0,38,20
1650834950910,CSE 3,A51,083647,Miranda; Gregory Joseph,36,0,37,1
1650834956935,CSE 8A,A50,083650,Miranda; Gregory Joseph,0,29,40,40
1650834962963,CSE 11,A01,083080,Cao; Yingjun,0,96,40,40
1650834968990,CSE 12,A01,083652,Staff,0,21,100,100
1650834975015,CSE 15L,A01,083654,Staff,0,3,50,50
1650834975015,CSE 15L,A02,083655,Staff,0,2,50,50
1650834981038,CSE 20,A01,083657,Staff,49,0,80,31
1650834987067,CSE 30,A01,083084,Eldon; John,0,75,40,40
1650834993093,CSE 100,A01,083659,Cao; Yingjun,0,71,50,50
1650834999132,CSE 134B,A01,083661,Powell; Thomas Allan,0,38,65,65
1650835005158,CSE 140,A01,083663,Staff,0,11,75,75
1650835011184,CSE 140L,A01,083088,Eldon; John,0,20,75,75
1650835017211,CSE 175,A01,083665,Kumar; Rakesh,7,0,25,18
1650835023238,CSE 190,A00,092507,Dubnov; Shlomo,10,0,20,10
1650835029261,ECE 45,A01,083139,Staff,0,1,60,60
1650835035285,ECE 65,A50,083695,Staff,0,5,30,30
1650835041312,ECE 109,A01,091882,Touri; Behrouz,32,0,70,38
1650835047339,ECE 180,A00,083140,Abi Samra; Nicholas Camill,20,0,30,10
1650835047339,ECE 180,B00,083141,Abi Samra; Nicholas Camill,0,0,30,30
1650835053370,MATH 10A,A01,083735,Patchell; Gregory David,2,0,30,28
1650835053370,MATH 10A,A02,083736,Patchell; Gregory David,27,0,30,3
1650835053370,MATH 10A,A03,083737,Patchell; Gregory David,24,0,30,6
1650835059395,MATH 10B,A01,083207,Staff,0,9,30,30
1650835059395,MATH 10B,A02,083208,Staff,0,6,30,30
1650835059395,MATH 10B,B01,083739,Staff,11,0,30,19
1650835059395,MATH 10B,B02,083740,Staff,28,0,30,2
1650835065427,MATH 18,A01,083743,Staff,0,0,30,30
1650835065427,MATH 18,A02,083744,Staff,23,0,30,7
1650835065427,MATH 18,A03,083745,Staff,21,0,30,9
1650835065427,MATH 18,A04,083746,Staff,26,0,30,4
1650835065427,MATH 18,B01,083748,Staff,0,15,30,30
1650835065427,MATH 18,B02,083749,Staff,0,12,30,30
1650835065427,MATH 18,B03,083750,Staff,0,13,30,30
1650835065427,MATH 18,B04,083751,Staff,0,12,30,30
1650835071450,MATH 20A,A01,083754,Staff,19,0,40,21
1650835077473,MATH 20B,A01,083756,Staff,0,13,30,30
1650835077473,MATH 20B,A02,083757,Staff,0,12,30,30
1650835083504,MATH 20C,A01,083760,Staff,0,17,30,30
1650835083504,MATH 20C,A02,083761,Staff,0,16,30,30
1650835083504,MATH 20C,B01,083762,Staff,9,0,30,21
1650835083504,MATH 20C,B02,083763,Staff,28,0,30,2
1650835089534,MATH 20D,A01,083765,Staff,2,1,30,28
1650835089534,MATH 20D,A02,083766,Staff,6,0,30,24
1650835089534,MATH 20D,A03,083767,Staff,24,0,30,6
1650835095562,MATH 20E,A01,083771,Staff,2,0,30,28
1650835095562,MATH 20E,A02,083772,Staff,14,0,30,16
1650835095562,MATH 20E,B01,083773,Staff,0,0,30,30
1650835095562,MATH 20E,B02,083774,Staff,5,0,30,25
1650835101591,MATH 103A,A01,083777,Staff,0,16,30,30
1650835101591,MATH 103A,A02,083778,Staff,0,15,30,30
1650835101591,MATH 103A,B01,083779,Staff,0,15,30,30
1650835101591,MATH 103A,B02,083780,Staff,0,15,30,30
1650835107617,MATH 105,A01,085443,Staff,0,22,30,30
1650835113645,MATH 109,A01,083213,Anzaldo; Leesa B,0,7,30,30
1650835113645,MATH 109,A02,083214,Anzaldo; Leesa B,0,7,30,30
1650835113645,MATH 109,B01,083215,Anzaldo; Leesa B,0,8,30,30
1650835113645,MATH 109,B02,083216,Anzaldo; Leesa B,0,7,30,30
1650835119672,MATH 142A,A01,083219,Chow; Bennett,0,16,30,30
1650835119672,MATH 142A,A02,083220,Chow; Bennett,0,15,30,30
1650835119672,MATH 142A,B01,083221,Chow; Bennett,0,16,30,30
1650835119672,MATH 142A,B02,083222,Chow; Bennett,0,14,30,30
1650835125788,MATH 193A,A01,083224,Staff,0,6,30,30
1650835125788,MATH 193A,A02,083225,Staff,0,6,30,30
1650835125788,MATH 193A,A03,083781,Staff,0,6,30,30
1650835125788,MATH 193A,A04,083782,Staff,0,7,30,30
1650835131814,MATH 197,001,091859,McAuley; Julian John,9998,0,9999,1
1650835137869,COGS 9,A01,083615,Staff,0,17,60,60
1650835143892,COGS 11,A01,083617,Boyle; Mary E. T.,15,0,40,25
1650835149919,COGS 13,A01,083071,Staff,0,38,40,40
1650835155945,COGS 14A,A01,092681,Staff,0,36,100,100
1650835161971,COGS 14B,A01,083073,Cheng; Tzu-Han,0,12,50,50
1650835168000,COGS 17,A01,092677,Staff,11,0,75,64
1650835174027,COGS 100,A01,083619,Staff,0,29,60,60
1650835180050,COGS 101A,A01,083621,Davis; Joshua Daniel,0,28,60,60
1650835186077,COGS 101B,A01,091572,Staff,0,3,60,60
1650835192100,COGS 101C,A01,083625,Delgado; Tania,14,0,30,16
1650835198126,COGS 107A,A01,083627,Boyle; Mary E. T.,0,16,60,60
1650835204150,COGS 118A,A01,083075,Staff,0,8,60,60
1650835210179,CSE 3,A50,083646,Miranda; Gregory Joseph,18,0,38,20
1650835210179,CSE 3,A51,083647,Miranda; Gregory Joseph,36,0,37,1
1650835216206,CSE 8A,A50,083650,Miranda; Gregory Joseph,0,29,40,40
1650835222228,CSE 11,A01,083080,Cao; Yingjun,0,96,40,40
1650835228252,CSE 12,A01,083652,Staff,0,21,100,100
1650835234281,CSE 15L,A01,083654,Staff,0,3,50,50
1650835234281,CSE 15L,A02,083655,Staff,0,2,50,50
1650835240307,CSE 20,A01,083657,Staff,49,0,80,31
1650835246330,CSE 30,A01,083084,Eldon; John,0,75,40,40
1650835252353,CSE 100,A01,083659,Cao; Yingjun,0,71,50,50
1650835258376,CSE 134B,A01,083661,Powell; Thomas Allan,0,38,65,65
1650835264402,CSE 140,A01,083663,Staff,0,11,75,75
1650835270424,CSE 140L,A01,083088,Eldon; John,0,20,75,75
1650835276450,CSE 175,A01,083665,Kumar; Rakesh,7,0,25,18
1650835282480,CSE 190,A00,092507,Dubnov; Shlomo,10,0,20,10
1650835288507,ECE 45,A01,083139,Staff,0,1,60,60
1650835294535,ECE 65,A50,083695,Staff,0,5,30,30
1650835300559,ECE 109,A01,091882,Touri; Behrouz,32,0,70,38
1650835306586,ECE 180,A00,083140,Abi Samra; Nicholas Camill,20,0,30,10
1650835306586,ECE 180,B00,083141,Abi Samra; Nicholas Camill,0,0,30,30
1650835312610,MATH 10A,A01,083735,Patchell; Gregory David,2,0,30,28
1650835312610,MATH 10A,A02,083736,Patchell; Gregory David,27,0,30,3
1650835312610,MATH 10A,A03,083737,Patchell; Gregory David,24,0,30,6
1650835318638,MATH 10B,A01,083207,Staff,0,9,30,30
1650835318638,MATH 10B,A02,083208,Staff,0,6,30,30
1650835318638,MATH 10B,B01,083739,Staff,11,0,30,19
1650835318638,MATH 10B,B02,083740,Staff,28,0,30,2
1650835324668,MATH 18,A01,083743,Staff,0,0,30,30
1650835324668,MATH 18,A02,083744,Staff,23,0,30,7
1650835324668,MATH 18,A03,083745,Staff,21,0,30,9
1650835324668,MATH 18,A04,083746,Staff,26,0,30,4
1650835324668,MATH 18,B01,083748,Staff,0,15,30,30
1650835324668,MATH 18,B02,083749,Staff,0,12,30,30
1650835324668,MATH 18,B03,083750,Staff,0,13,30,30
1650835324668,MATH 18,B04,083751,Staff,0,12,30,30
1650835330694,MATH 20A,A01,083754,Staff,19,0,40,21
1650835336717,MATH 20B,A01,083756,Staff,0,13,30,30
1650835336717,MATH 20B,A02,083757,Staff,0,12,30,30
1650835342740,MATH 20C,A01,083760,Staff,0,17,30,30
1650835342740,MATH 20C,A02,083761,Staff,0,16,30,30
1650835342740,MATH 20C,B01,083762,Staff,9,0,30,21
1650835342740,MATH 20C,B02,083763,Staff,28,0,30,2
1650835348768,MATH 20D,A01,083765,Staff,2,1,30,28
1650835348768,MATH 20D,A02,083766,Staff,6,0,30,24
1650835348768,MATH 20D,A03,083767,Staff,24,0,30,6
1650835354796,MATH 20E,A01,083771,Staff,2,0,30,28
1650835354796,MATH 20E,A02,083772,Staff,14,0,30,16
1650835354796,MATH 20E,B01,083773,Staff,0,0,30,30
1650835354796,MATH 20E,B02,083774,Staff,5,0,30,25
1650835360820,MATH 103A,A01,083777,Staff,0,16,30,30
1650835360820,MATH 103A,A02,083778,Staff,0,15,30,30
1650835360820,MATH 103A,B01,083779,Staff,0,15,30,30
1650835360820,MATH 103A,B02,083780,Staff,0,15,30,30
1650835366847,MATH 105,A01,085443,Staff,0,22,30,30
1650835372876,MATH 109,A01,083213,Anzaldo; Leesa B,0,7,30,30
1650835372876,MATH 109,A02,083214,Anzaldo; Leesa B,0,7,30,30
1650835372876,MATH 109,B01,083215,Anzaldo; Leesa B,0,8,30,30
1650835372876,MATH 109,B02,083216,Anzaldo; Leesa B,0,7,30,30
1650835378899,MATH 142A,A01,083219,Chow; Bennett,0,16,30,30
1650835378899,MATH 142A,A02,083220,Chow; Bennett,0,15,30,30
1650835378899,MATH 142A,B01,083221,Chow; Bennett,0,16,30,30
1650835378899,MATH 142A,B02,083222,Chow; Bennett,0,14,30,30
1650835384927,MATH 193A,A01,083224,Staff,0,6,30,30
1650835384927,MATH 193A,A02,083225,Staff,0,6,30,30
1650835384927,MATH 193A,A03,083781,Staff,0,6,30,30
1650835384927,MATH 193A,A04,083782,Staff,0,7,30,30
1650835390954,MATH 197,001,091859,McAuley; Julian John,9998,0,9999,1
1650835397017,COGS 9,A01,083615,Staff,0,17,60,60
1650835403041,COGS 11,A01,083617,Boyle; Mary E. T.,15,0,40,25
1650835409070,COGS 13,A01,083071,Staff,0,38,40,40
1650835415097,COGS 14A,A01,092681,Staff,0,36,100,100
1650835421120,COGS 14B,A01,083073,Cheng; Tzu-Han,0,12,50,50
1650835427145,COGS 17,A01,092677,Staff,11,0,75,64
1650835433171,COGS 100,A01,083619,Staff,0,29,60,60
1650835439198,COGS 101A,A01,083621,Davis; Joshua Daniel,0,28,60,60
1650835445224,COGS 101B,A01,091572,Staff,0,3,60,60
1650835451250,COGS 101C,A01,083625,Delgado; Tania,14,0,30,16
1650835457274,COGS 107A,A01,083627,Boyle; Mary E. T.,0,16,60,60
1650835463297,COGS 118A,A01,083075,Staff,0,8,60,60
1650835469324,CSE 3,A50,083646,Miranda; Gregory Joseph,18,0,38,20
1650835469324,CSE 3,A51,083647,Miranda; Gregory Joseph,36,0,37,1
1650835475351,CSE 8A,A50,083650,Miranda; Gregory Joseph,0,29,40,40
1650835481373,CSE 11,A01,083080,Cao; Yingjun,0,96,40,40
1650835487399,CSE 12,A01,083652,Staff,0,21,100,100
1650835493427,CSE 15L,A01,083654,Staff,0,3,50,50
1650835493427,CSE 15L,A02,083655,Staff,0,2,50,50
1650835499458,CSE 20,A01,083657,Staff,49,0,80,31
1650835505481,CSE 30,A01,083084,Eldon; John,0,75,40,40
1650835511503,CSE 100,A01,083659,Cao; Yingjun,0,71,50,50
1650835517525,CSE 134B,A01,083661,Powell; Thomas Allan,0,38,65,65
1650835523550,CSE 140,A01,083663,Staff,0,11,75,75
1650835529581,CSE 140L,A01,083088,Eldon; John,0,20,75,75
1650835535606,CSE 175,A01,083665,Kumar; Rakesh,7,0,25,18
1650835541629,CSE 190,A00,092507,Dubnov; Shlomo,10,0,20,10
1650835547655,ECE 45,A01,083139,Staff,0,1,60,60
1650835553682,ECE 65,A50,083695,Staff,0,5,30,30
1650835559705,ECE 109,A01,091882,Touri; Behrouz,32,0,70,38
1650835565736,ECE 180,A00,083140,Abi Samra; Nicholas Camill,20,0,30,10
1650835565736,ECE 180,B00,083141,Abi Samra; Nicholas Camill,0,0,30,30
1650835571770,MATH 10A,A01,083735,Patchell; Gregory David,2,0,30,28
1650835571770,MATH 10A,A02,083736,Patchell; Gregory David,27,0,30,3
1650835571770,MATH 10A,A03,083737,Patchell; Gregory David,24,0,30,6
1650835577794,MATH 10B,A01,083207,Staff,0,9,30,30
1650835577794,MATH 10B,A02,083208,Staff,0,6,30,30
1650835577794,MATH 10B,B01,083739,Staff,11,0,30,19
1650835577794,MATH 10B,B02,083740,Staff,28,0,30,2
1650835583823,MATH 18,A01,083743,Staff,0,0,30,30
1650835583823,MATH 18,A02,083744,Staff,23,0,30,7
1650835583823,MATH 18,A03,083745,Staff,21,0,30,9
1650835583823,MATH 18,A04,083746,Staff,26,0,30,4
1650835583823,MATH 18,B01,083748,Staff,0,15,30,30
1650835583823,MATH 18,B02,083749,Staff,0,12,30,30
1650835583823,MATH 18,B03,083750,Staff,0,13,30,30
1650835583823,MATH 18,B04,083751,Staff,0,12,30,30
1650835589849,MATH 20A,A01,083754,Staff,19,0,40,21
1650835595878,MATH 20B,A01,083756,Staff,0,13,30,30
1650835595878,MATH 20B,A02,083757,Staff,0,12,30,30
1650835601902,MATH 20C,A01,083760,Staff,0,17,30,30
1650835601902,MATH 20C,A02,083761,Staff,0,16,30,30
1650835601902,MATH 20C,B01,083762,Staff,9,0,30,21
1650835601902,MATH 20C,B02,083763,Staff,28,0,30,2
1650835607927,MATH 20D,A01,083765,Staff,2,1,30,28
1650835607927,MATH 20D,A02,083766,Staff,6,0,30,24
1650835607927,MATH 20D,A03,083767,Staff,24,0,30,6
1650835613955,MATH 20E,A01,083771,Staff,2,0,30,28
1650835613955,MATH 20E,A02,083772,Staff,13,0,30,17
1650835613955,MATH 20E,B01,083773,Staff,0,0,30,30
1650835613955,MATH 20E,B02,083774,Staff,5,0,30,25
1650835619992,MATH 103A,A01,083777,Staff,0,16,30,30
1650835619992,MATH 103A,A02,083778,Staff,0,15,30,30
1650835619992,MATH 103A,B01,083779,Staff,0,15,30,30
1650835619992,MATH 103A,B02,083780,Staff,1,15,30,29
1650835626019,MATH 105,A01,085443,Staff,0,22,30,30
1650835632048,MATH 109,A01,083213,Anzaldo; Leesa B,0,7,30,30
1650835632048,MATH 109,A02,083214,Anzaldo; Leesa B,0,7,30,30
1650835632048,MATH 109,B01,083215,Anzaldo; Leesa B,0,8,30,30
1650835632048,MATH 109,B02,083216,Anzaldo; Leesa B,0,7,30,30
1650835638077,MATH 142A,A01,083219,Chow; Bennett,0,16,30,30
1650835638077,MATH 142A,A02,083220,Chow; Bennett,0,15,30,30
1650835638077,MATH 142A,B01,083221,Chow; Bennett,0,16,30,30
1650835638077,MATH 142A,B02,083222,Chow; Bennett,0,14,30,30
1650835644101,MATH 193A,A01,083224,Staff,0,6,30,30
1650835644101,MATH 193A,A02,083225,Staff,0,6,30,30
1650835644101,MATH 193A,A03,083781,Staff,0,6,30,30
1650835644101,MATH 193A,A04,083782,Staff,0,7,30,30
1650835650132,MATH 197,001,091859,McAuley; Julian John,9998,0,9999,1
1650835656186,COGS 9,A01,083615,Staff,0,17,60,60
1650835662209,COGS 11,A01,083617,Boyle; Mary E. T.,15,0,40,25
1650835668234,COGS 13,A01,083071,Staff,0,38,40,40
1650835674258,COGS 14A,A01,092681,Staff,0,36,100,100
1650835680281,COGS 14B,A01,083073,Cheng; Tzu-Han,0,12,50,50
1650835686308,COGS 17,A01,092677,Staff,12,0,75,63
1650835692331,COGS 100,A01,083619,Staff,0,29,60,60
1650835698357,COGS 101A,A01,083621,Davis; Joshua Daniel,0,28,60,60
1650835704382,COGS 101B,A01,091572,Staff,0,3,60,60
1650835710419,COGS 101C,A01,083625,Delgado; Tania,14,0,30,16
1650835716522,COGS 107A,A01,083627,Boyle; Mary E. T.,0,16,60,60
1650835722546,COGS 118A,A01,083075,Staff,0,8,60,60
1650835728570,CSE 3,A50,083646,Miranda; Gregory Joseph,18,0,38,20
1650835728570,CSE 3,A51,083647,Miranda; Gregory Joseph,36,0,37,1
1650835734597,CSE 8A,A50,083650,Miranda; Gregory Joseph,0,29,40,40
1650835740621,CSE 11,A01,083080,Cao; Yingjun,0,96,40,40
1650835746644,CSE 12,A01,083652,Staff,0,21,100,100
1650835752670,CSE 15L,A01,083654,Staff,0,3,50,50
1650835752670,CSE 15L,A02,083655,Staff,0,2,50,50
1650835758696,CSE 20,A01,083657,Staff,49,0,80,31
1650835764722,CSE 30,A01,083084,Eldon; John,0,75,40,40
1650835770746,CSE 100,A01,083659,Cao; Yingjun,0,71,50,50
1650835776770,CSE 134B,A01,083661,Powell; Thomas Allan,0,38,65,65
1650835782795,CSE 140,A01,083663,Staff,0,11,75,75
1650835788818,CSE 140L,A01,083088,Eldon; John,0,20,75,75
1650835794844,CSE 175,A01,083665,Kumar; Rakesh,7,0,25,18
1650835800869,CSE 190,A00,092507,Dubnov; Shlomo,10,0,20,10
1650835806890,ECE 45,A01,083139,Staff,0,1,60,60
1650835812914,ECE 65,A50,083695,Staff,0,5,30,30
1650835818937,ECE 109,A01,091882,Touri; Behrouz,32,0,70,38
1650835824962,ECE 180,A00,083140,Abi Samra; Nicholas Camill,20,0,30,10
1650835824962,ECE 180,B00,083141,Abi Samra; Nicholas Camill,0,0,30,30
1650835830986,MATH 10A,A01,083735,Patchell; Gregory David,2,0,30,28
1650835830986,MATH 10A,A02,083736,Patchell; Gregory David,27,0,30,3
1650835830986,MATH 10A,A03,083737,Patchell; Gregory David,24,0,30,6
1650835837012,MATH 10B,A01,083207,Staff,0,9,30,30
1650835837012,MATH 10B,A02,083208,Staff,0,6,30,30
1650835837012,MATH 10B,B01,083739,Staff,11,0,30,19
1650835837012,MATH 10B,B02,083740,Staff,28,0,30,2
1650835843035,MATH 18,A01,083743,Staff,0,0,30,30
1650835843035,MATH 18,A02,083744,Staff,23,0,30,7
1650835843035,MATH 18,A03,083745,Staff,21,0,30,9
1650835843035,MATH 18,A04,083746,Staff,26,0,30,4
1650835843035,MATH 18,B01,083748,Staff,0,15,30,30
1650835843035,MATH 18,B02,083749,Staff,0,12,30,30
1650835843035,MATH 18,B03,083750,Staff,0,13,30,30
1650835843035,MATH 18,B04,083751,Staff,0,12,30,30
1650835849059,MATH 20A,A01,083754,Staff,19,0,40,21
1650835855085,MATH 20B,A01,083756,Staff,0,13,30,30
1650835855085,MATH 20B,A02,083757,Staff,0,12,30,30
1650835861110,MATH 20C,A01,083760,Staff,0,17,30,30
1650835861110,MATH 20C,A02,083761,Staff,0,16,30,30
1650835861110,MATH 20C,B01,083762,Staff,9,0,30,21
1650835861110,MATH 20C,B02,083763,Staff,28,0,30,2
1650835867139,MATH 20D,A01,083765,Staff,2,1,30,28
1650835867139,MATH 20D,A02,083766,Staff,6,0,30,24
1650835867139,MATH 20D,A03,083767,Staff,24,0,30,6
1650835873162,MATH 20E,A01,083771,Staff,2,0,30,28
1650835873162,MATH 20E,A02,083772,Staff,13,0,30,17
1650835873162,MATH 20E,B01,083773,Staff,0,0,30,30
1650835873162,MATH 20E,B02,083774,Staff,5,0,30,25
1650835879185,MATH 103A,A01,083777,Staff,0,16,30,30
1650835879185,MATH 103A,A02,083778,Staff,0,15,30,30
1650835879185,MATH 103A,B01,083779,Staff,0,15,30,30
1650835879185,MATH 103A,B02,083780,Staff,1,15,30,29
1650835885212,MATH 105,A01,085443,Staff,0,22,30,30
1650835891235,MATH 109,A01,083213,Anzaldo; Leesa B,0,7,30,30
1650835891235,MATH 109,A02,083214,Anzaldo; Leesa B,0,7,30,30
1650835891235,MATH 109,B01,083215,Anzaldo; Leesa B,0,8,30,30
1650835891235,MATH 109,B02,083216,Anzaldo; Leesa B,0,7,30,30
1650835897259,MATH 142A,A01,083219,Chow; Bennett,0,16,30,30
1650835897259,MATH 142A,A02,083220,Chow; Bennett,0,15,30,30
1650835897259,MATH 142A,B01,083221,Chow; Bennett,0,16,30,30
1650835897259,MATH 142A,B02,083222,Chow; Bennett,0,14,30,30
1650835903285,MATH 193A,A01,083224,Staff,0,6,30,30
1650835903285,MATH 193A,A02,083225,Staff,0,6,30,30
1650835903285,MATH 193A,A03,083781,Staff,0,6,30,30
1650835903285,MATH 193A,A04,083782,Staff,0,7,30,30
1650835909320,MATH 197,001,091859,McAuley; Julian John,9998,0,9999,1
1650835915368,COGS 9,A01,083615,Staff,0,17,60,60
1650835921395,COGS 11,A01,083617,Boyle; Mary E. T.,15,0,40,25
1650835927417,COGS 13,A01,083071,Staff,0,38,40,40
1650835933441,COGS 14A,A01,092681,Staff,0,36,100,100
1650835939469,COGS 14B,A01,083073,Cheng; Tzu-Han,0,12,50,50
1650835945491,COGS 17,A01,092677,Staff,12,0,75,63
1650835951517,COGS 100,A01,083619,Staff,0,29,60,60
1650835957540,COGS 101A,A01,083621,Davis; Joshua Daniel,0,28,60,60
1650835963566,COGS 101B,A01,091572,Staff,0,3,60,60
1650835969611,COGS 101C,A01,083625,Delgado; Tania,14,0,30,16
1650835975637,COGS 107A,A01,083627,Boyle; Mary E. T.,0,16,60,60
1650835981663,COGS 118A,A01,083075,Staff,0,8,60,60
1650835987685,CSE 3,A50,083646,Miranda; Gregory Joseph,18,0,38,20
1650835987685,CSE 3,A51,083647,Miranda; Gregory Joseph,36,0,37,1
1650835993713,CSE 8A,A50,083650,Miranda; Gregory Joseph,0,29,40,40
1650835999737,CSE 11,A01,083080,Cao; Yingjun,0,96,40,40
1650836005763,CSE 12,A01,083652,Staff,0,21,100,100
1650836011789,CSE 15L,A01,083654,Staff,0,3,50,50
1650836011789,CSE 15L,A02,083655,Staff,0,2,50,50
1650836017810,CSE 20,A01,083657,Staff,49,0,80,31
1650836023834,CSE 30,A01,083084,Eldon; John,0,75,40,40
1650836029860,CSE 100,A01,083659,Cao; Yingjun,0,71,50,50
1650836035886,CSE 134B,A01,083661,Powell; Thomas Allan,0,38,65,65
1650836041907,CSE 140,A01,083663,Staff,0,11,75,75
1650836047930,CSE 140L,A01,083088,Eldon; John,0,20,75,75
1650836053955,CSE 175,A01,083665,Kumar; Rakesh,7,0,25,18
1650836059978,CSE 190,A00,092507,Dubnov; Shlomo,10,0,20,10
1650836066002,ECE 45,A01,083139,Staff,0,1,60,60
1650836072027,ECE 65,A50,083695,Staff,0,5,30,30
1650836078050,ECE 109,A01,091882,Touri; Behrouz,32,0,70,38
1650836084077,ECE 180,A00,083140,Abi Samra; Nicholas Camill,20,0,30,10
1650836084077,ECE 180,B00,083141,Abi Samra; Nicholas Camill,0,0,30,30
1650836090102,MATH 10A,A01,083735,Patchell; Gregory David,2,0,30,28
1650836090102,MATH 10A,A02,083736,Patchell; Gregory David,27,0,30,3
1650836090102,MATH 10A,A03,083737,Patchell; Gregory David,24,0,30,6
1650836096130,MATH 10B,A01,083207,Staff,0,9,30,30
1650836096130,MATH 10B,A02,083208,Staff,0,6,30,30
1650836096130,MATH 10B,B01,083739,Staff,11,0,30,19
1650836096130,MATH 10B,B02,083740,Staff,28,0,30,2
1650836102160,MATH 18,A01,083743,Staff,0,0,30,30
1650836102160,MATH 18,A02,083744,Staff,23,0,30,7
1650836102160,MATH 18,A03,083745,Staff,21,0,30,9
1650836102160,MATH 18,A04,083746,Staff,26,0,30,4
1650836102160,MATH 18,B01,083748,Staff,0,15,30,30
1650836102160,MATH 18,B02,083749,Staff,0,12,30,30
1650836102160,MATH 18,B03,083750,Staff,0,13,30,30
1650836102160,MATH 18,B04,083751,Staff,0,12,30,30
1650836108183,MATH 20A,A01,083754,Staff,19,0,40,21
1650836114206,MATH 20B,A01,083756,Staff,0,13,30,30
1650836114206,MATH 20B,A02,083757,Staff,0,12,30,30
1650836120232,MATH 20C,A01,083760,Staff,0,17,30,30
1650836120232,MATH 20C,A02,083761,Staff,0,16,30,30
1650836120232,MATH 20C,B01,083762,Staff,9,0,30,21
1650836120232,MATH 20C,B02,083763,Staff,28,0,30,2
1650836126257,MATH 20D,A01,083765,Staff,2,1,30,28
1650836126257,MATH 20D,A02,083766,Staff,6,0,30,24
1650836126257,MATH 20D,A03,083767,Staff,24,0,30,6
1650836132280,MATH 20E,A01,083771,Staff,2,0,30,28
1650836132280,MATH 20E,A02,083772,Staff,13,0,30,17
1650836132280,MATH 20E,B01,083773,Staff,0,0,30,30
1650836132280,MATH 20E,B02,083774,Staff,5,0,30,25
1650836138309,MATH 103A,A01,083777,Staff,0,16,30,30
1650836138309,MATH 103A,A02,083778,Staff,0,15,30,30
1650836138309,MATH 103A,B01,083779,Staff,0,15,30,30
1650836138309,MATH 103A,B02,083780,Staff,1,15,30,29
1650836144331,MATH 105,A01,085443,Staff,0,22,30,30
1650836150354,MATH 109,A01,083213,Anzaldo; Leesa B,0,7,30,30
1650836150354,MATH 109,A02,083214,Anzaldo; Leesa B,0,7,30,30
1650836150354,MATH 109,B01,083215,Anzaldo; Leesa B,0,8,30,30
1650836150354,MATH 109,B02,083216,Anzaldo; Leesa B,0,7,30,30
1650836156381,MATH 142A,A01,083219,Chow; Bennett,0,16,30,30
1650836156381,MATH 142A,A02,083220,Chow; Bennett,0,15,30,30
1650836156381,MATH 142A,B01,083221,Chow; Bennett,0,16,30,30
1650836156381,MATH 142A,B02,083222,Chow; Bennett,0,14,30,30
1650836162406,MATH 193A,A01,083224,Staff,0,6,30,30
1650836162406,MATH 193A,A02,083225,Staff,0,6,30,30
1650836162406,MATH 193A,A03,083781,Staff,0,6,30,30
1650836162406,MATH 193A,A04,083782,Staff,0,7,30,30
1650836168430,MATH 197,001,091859,McAuley; Julian John,9998,0,9999,1
1650836174488,COGS 9,A01,083615,Staff,0,17,60,60
1650836180516,COGS 11,A01,083617,Boyle; Mary E. T.,15,0,40,25
1650836186537,COGS 13,A01,083071,Staff,0,38,40,40
1650836192560,COGS 14A,A01,092681,Staff,0,36,100,100
1650836198587,COGS 14B,A01,083073,Cheng; Tzu-Han,0,12,50,50
1650836204618,COGS 17,A01,092677,Staff,12,0,75,63
1650836210642,COGS 100,A01,083619,Staff,0,29,60,60
1650836216667,COGS 101A,A01,083621,Davis; Joshua Daniel,0,28,60,60
1650836222696,COGS 101B,A01,091572,Staff,0,3,60,60
1650836228719,COGS 101C,A01,083625,Delgado; Tania,14,0,30,16
1650836234743,COGS 107A,A01,083627,Boyle; Mary E. T.,0,16,60,60
1650836240775,COGS 118A,A01,083075,Staff,0,8,60,60
1650836246799,CSE 3,A50,083646,Miranda; Gregory Joseph,18,0,38,20
1650836246799,CSE 3,A51,083647,Miranda; Gregory Joseph,36,0,37,1
1650836252828,CSE 8A,A50,083650,Miranda; Gregory Joseph,0,29,40,40
1650836258855,CSE 11,A01,083080,Cao; Yingjun,0,96,40,40
1650836264890,CSE 12,A01,083652,Staff,0,21,100,100
1650836270914,CSE 15L,A01,083654,Staff,0,3,50,50
1650836270914,CSE 15L,A02,083655,Staff,0,2,50,50
1650836276937,CSE 20,A01,083657,Staff,49,0,80,31
1650836282962,CSE 30,A01,083084,Eldon; John,0,75,40,40
1650836288988,CSE 100,A01,083659,Cao; Yingjun,0,71,50,50
1650836295016,CSE 134B,A01,083661,Powell; Thomas Allan,0,38,65,65
1650836301042,CSE 140,A01,083663,Staff,0,11,75,75
1650836307071,CSE 140L,A01,083088,Eldon; John,0,20,75,75
1650836313185,CSE 175,A01,083665,Kumar; Rakesh,7,0,25,18
1650836319217,CSE 190,A00,092507,Dubnov; Shlomo,10,0,20,10
1650836325245,ECE 45,A01,083139,Staff,0,1,60,60
1650836331267,ECE 65,A50,083695,Staff,0,5,30,30
1650836337292,ECE 109,A01,091882,Touri; Behrouz,32,0,70,38
1650836343318,ECE 180,A00,083140,Abi Samra; Nicholas Camill,20,0,30,10
1650836343318,ECE 180,B00,083141,Abi Samra; Nicholas Camill,0,0,30,30
1650836349340,MATH 10A,A01,083735,Patchell; Gregory David,2,0,30,28
1650836349340,MATH 10A,A02,083736,Patchell; Gregory David,27,0,30,3
1650836349340,MATH 10A,A03,083737,Patchell; Gregory David,24,0,30,6
1650836355364,MATH 10B,A01,083207,Staff,0,9,30,30
1650836355364,MATH 10B,A02,083208,Staff,0,6,30,30
1650836355364,MATH 10B,B01,083739,Staff,11,0,30,19
1650836355364,MATH 10B,B02,083740,Staff,28,0,30,2
1650836361396,MATH 18,A01,083743,Staff,0,0,30,30
1650836361396,MATH 18,A02,083744,Staff,23,0,30,7
1650836361396,MATH 18,A03,083745,Staff,21,0,30,9
1650836361396,MATH 18,A04,083746,Staff,26,0,30,4
1650836361396,MATH 18,B01,083748,Staff,0,15,30,30
1650836361396,MATH 18,B02,083749,Staff,0,12,30,30
1650836361396,MATH 18,B03,083750,Staff,0,13,30,30
1650836361396,MATH 18,B04,083751,Staff,0,12,30,30
1650836367419,MATH 20A,A01,083754,Staff,19,0,40,21
1650836373443,MATH 20B,A01,083756,Staff,0,13,30,30
1650836373443,MATH 20B,A02,083757,Staff,0,12,30,30
1650836379466,MATH 20C,A01,083760,Staff,0,17,30,30
1650836379466,MATH 20C,A02,083761,Staff,0,16,30,30
1650836379466,MATH 20C,B01,083762,Staff,9,0,30,21
1650836379466,MATH 20C,B02,083763,Staff,28,0,30,2
1650836385494,MATH 20D,A01,083765,Staff,2,1,30,28
1650836385494,MATH 20D,A02,083766,Staff,6,0,30,24
1650836385494,MATH 20D,A03,083767,Staff,24,0,30,6
1650836391521,MATH 20E,A01,083771,Staff,2,0,30,28
1650836391521,MATH 20E,A02,083772,Staff,13,0,30,17
1650836391521,MATH 20E,B01,083773,Staff,0,0,30,30
1650836391521,MATH 20E,B02,083774,Staff,5,0,30,25
1650836397548,MATH 103A,A01,083777,Staff,0,16,30,30
1650836397548,MATH 103A,A02,083778,Staff,0,15,30,30
1650836397548,MATH 103A,B01,083779,Staff,0,15,30,30
1650836397548,MATH 103A,B02,083780,Staff,1,15,30,29
1650836403571,MATH 105,A01,085443,Staff,0,22,30,30
1650836409596,MATH 109,A01,083213,Anzaldo; Leesa B,0,7,30,30
1650836409596,MATH 109,A02,083214,Anzaldo; Leesa B,0,7,30,30
1650836409596,MATH 109,B01,083215,Anzaldo; Leesa B,0,8,30,30
1650836409596,MATH 109,B02,083216,Anzaldo; Leesa B,0,7,30,30
1650836415620,MATH 142A,A01,083219,Chow; Bennett,0,16,30,30
1650836415620,MATH 142A,A02,083220,Chow; Bennett,0,15,30,30
1650836415620,MATH 142A,B01,083221,Chow; Bennett,0,16,30,30
1650836415620,MATH 142A,B02,083222,Chow; Bennett,0,14,30,30
1650836421643,MATH 193A,A01,083224,Staff,0,6,30,30
1650836421643,MATH 193A,A02,083225,Staff,0,6,30,30
1650836421643,MATH 193A,A03,083781,Staff,0,6,30,30
1650836421643,MATH 193A,A04,083782,Staff,0,7,30,30
1650836427676,MATH 197,001,091859,McAuley; Julian John,9998,0,9999,1
1650836433727,COGS 9,A01,083615,Staff,0,17,60,60
1650836439751,COGS 11,A01,083617,Boyle; Mary E. T.,15,0,40,25
1650836445775,COGS 13,A01,083071,Staff,0,38,40,40
1650836451799,COGS 14A,A01,092681,Staff,0,36,100,100
1650836457824,COGS 14B,A01,083073,Cheng; Tzu-Han,0,12,50,50
1650836463848,COGS 17,A01,092677,Staff,12,0,75,63
1650836469873,COGS 100,A01,083619,Staff,0,29,60,60
1650836475897,COGS 101A,A01,083621,Davis; Joshua Daniel,0,28,60,60
1650836481920,COGS 101B,A01,091572,Staff,0,3,60,60
1650836487947,COGS 101C,A01,083625,Delgado; Tania,14,0,30,16
1650836493971,COGS 107A,A01,083627,Boyle; Mary E. T.,0,16,60,60
1650836499997,COGS 118A,A01,083075,Staff,0,8,60,60
1650836506032,CSE 3,A50,083646,Miranda; Gregory Joseph,18,0,38,20
1650836506032,CSE 3,A51,083647,Miranda; Gregory Joseph,36,0,37,1
1650836512065,CSE 8A,A50,083650,Miranda; Gregory Joseph,0,29,40,40
1650836518097,CSE 11,A01,083080,Cao; Yingjun,0,96,40,40
1650836524123,CSE 12,A01,083652,Staff,0,21,100,100
1650836530150,CSE 15L,A01,083654,Staff,0,3,50,50
1650836530150,CSE 15L,A02,083655,Staff,0,2,50,50
1650836536175,CSE 20,A01,083657,Staff,49,0,80,31
1650836542207,CSE 30,A01,083084,Eldon; John,0,75,40,40
1650836548240,CSE 100,A01,083659,Cao; Yingjun,0,71,50,50
1650836554270,CSE 134B,A01,083661,Powell; Thomas Allan,0,38,65,65
1650836560295,CSE 140,A01,083663,Staff,0,11,75,75
1650836566318,CSE 140L,A01,083088,Eldon; John,0,20,75,75
1650836572341,CSE 175,A01,083665,Kumar; Rakesh,7,0,25,18
1650836578372,CSE 190,A00,092507,Dubnov; Shlomo,10,0,20,10
1650836584394,ECE 45,A01,083139,Staff,0,1,60,60
1650836590415,ECE 65,A50,083695,Staff,0,5,30,30
1650836596442,ECE 109,A01,091882,Touri; Behrouz,32,0,70,38
1650836602464,ECE 180,A00,083140,Abi Samra; Nicholas Camill,20,0,30,10
1650836602464,ECE 180,B00,083141,Abi Samra; Nicholas Camill,0,0,30,30
1650836608492,MATH 10A,A01,083735,Patchell; Gregory David,2,0,30,28
1650836608492,MATH 10A,A02,083736,Patchell; Gregory David,27,0,30,3
1650836608492,MATH 10A,A03,083737,Patchell; Gregory David,24,0,30,6
1650836614527,MATH 10B,A01,083207,Staff,0,9,30,30
1650836614527,MATH 10B,A02,083208,Staff,0,6,30,30
1650836614527,MATH 10B,B01,083739,Staff,11,0,30,19
1650836614527,MATH 10B,B02,083740,Staff,28,0,30,2
1650836620564,MATH 18,A01,083743,Staff,0,0,30,30
1650836620564,MATH 18,A02,083744,Staff,23,0,30,7
1650836620564,MATH 18,A03,083745,Staff,21,0,30,9
1650836620564,MATH 18,A04,083746,Staff,26,0,30,4
1650836620564,MATH 18,B01,083748,Staff,0,15,30,30
1650836620564,MATH 18,B02,083749,Staff,0,12,30,30
1650836620564,MATH 18,B03,083750,Staff,0,13,30,30
1650836620564,MATH 18,B04,083751,Staff,0,12,30,30
1650836626586,MATH 20A,A01,083754,Staff,19,0,40,21
1650836632614,MATH 20B,A01,083756,Staff,0,13,30,30
1650836632614,MATH 20B,A02,083757,Staff,0,12,30,30
1650836638638,MATH 20C,A01,083760,Staff,0,17,30,30
1650836638638,MATH 20C,A02,083761,Staff,0,16,30,30
1650836638638,MATH 20C,B01,083762,Staff,9,0,30,21
1650836638638,MATH 20C,B02,083763,Staff,28,0,30,2
1650836644661,MATH 20D,A01,083765,Staff,2,1,30,28
1650836644661,MATH 20D,A02,083766,Staff,6,0,30,24
1650836644661,MATH 20D,A03,083767,Staff,24,0,30,6
1650836650684,MATH 20E,A01,083771,Staff,2,0,30,28
1650836650684,MATH 20E,A02,083772,Staff,13,0,30,17
1650836650684,MATH 20E,B01,083773,Staff,0,0,30,30
1650836650684,MATH 20E,B02,083774,Staff,5,0,30,25
1650836656712,MATH 103A,A01,083777,Staff,0,16,30,30
1650836656712,MATH 103A,A02,083778,Staff,0,15,30,30
1650836656712,MATH 103A,B01,083779,Staff,0,15,30,30
1650836656712,MATH 103A,B02,083780,Staff,1,15,30,29
1650836662736,MATH 105,A01,085443,Staff,0,22,30,30
1650836668759,MATH 109,A01,083213,Anzaldo; Leesa B,0,7,30,30
1650836668759,MATH 109,A02,083214,Anzaldo; Leesa B,0,7,30,30
1650836668759,MATH 109,B01,083215,Anzaldo; Leesa B,0,8,30,30
1650836668759,MATH 109,B02,083216,Anzaldo; Leesa B,0,7,30,30
1650836674783,MATH 142A,A01,083219,Chow; Bennett,0,16,30,30
1650836674783,MATH 142A,A02,083220,Chow; Bennett,0,15,30,30
1650836674783,MATH 142A,B01,083221,Chow; Bennett,0,16,30,30
1650836674783,MATH 142A,B02,083222,Chow; Bennett,0,14,30,30
1650836680806,MATH 193A,A01,083224,Staff,0,6,30,30
1650836680806,MATH 193A,A02,083225,Staff,0,6,30,30
1650836680806,MATH 193A,A03,083781,Staff,0,6,30,30
1650836680806,MATH 193A,A04,083782,Staff,0,7,30,30
1650836686829,MATH 197,001,091859,McAuley; Julian John,9998,0,9999,1
1650836692880,COGS 9,A01,083615,Staff,0,17,60,60
1650836698904,COGS 11,A01,083617,Boyle; Mary E. T.,15,0,40,25
1650836704929,COGS 13,A01,083071,Staff,0,38,40,40
1650836710955,COGS 14A,A01,092681,Staff,0,36,100,100
1650836716981,COGS 14B,A01,083073,Cheng; Tzu-Han,0,12,50,50
1650836723007,COGS 17,A01,092677,Staff,12,0,75,63
1650836729029,COGS 100,A01,083619,Staff,0,29,60,60
1650836735057,COGS 101A,A01,083621,Davis; Joshua Daniel,0,28,60,60
1650836741080,COGS 101B,A01,091572,Staff,0,3,60,60
1650836747107,COGS 101C,A01,083625,Delgado; Tania,14,0,30,16
1650836753130,COGS 107A,A01,083627,Boyle; Mary E. T.,0,16,60,60
1650836759156,COGS 118A,A01,083075,Staff,0,8,60,60
1650836765179,CSE 3,A50,083646,Miranda; Gregory Joseph,18,0,38,20
1650836765179,CSE 3,A51,083647,Miranda; Gregory Joseph,36,0,37,1
1650836771204,CSE 8A,A50,083650,Miranda; Gregory Joseph,0,29,40,40
1650836777229,CSE 11,A01,083080,Cao; Yingjun,0,96,40,40
1650836783253,CSE 12,A01,083652,Staff,0,21,100,100
1650836789279,CSE 15L,A01,083654,Staff,0,3,50,50
1650836789279,CSE 15L,A02,083655,Staff,0,2,50,50
1650836795303,CSE 20,A01,083657,Staff,49,0,80,31
1650836801325,CSE 30,A01,083084,Eldon; John,0,75,40,40
1650836807349,CSE 100,A01,083659,Cao; Yingjun,0,71,50,50
1650836813371,CSE 134B,A01,083661,Powell; Thomas Allan,0,38,65,65
1650836819393,CSE 140,A01,083663,Staff,0,11,75,75
1650836825415,CSE 140L,A01,083088,Eldon; John,0,20,75,75
1650836831452,CSE 175,A01,083665,Kumar; Rakesh,7,0,25,18
1650836837474,CSE 190,A00,092507,Dubnov; Shlomo,10,0,20,10
1650836843498,ECE 45,A01,083139,Staff,0,1,60,60
1650836849523,ECE 65,A50,083695,Staff,0,5,30,30
1650836855549,ECE 109,A01,091882,Touri; Behrouz,32,0,70,38
1650836861575,ECE 180,A00,083140,Abi Samra; Nicholas Camill,20,0,30,10
1650836861575,ECE 180,B00,083141,Abi Samra; Nicholas Camill,0,0,30,30
1650836867612,MATH 10A,A01,083735,Patchell; Gregory David,2,0,30,28
1650836867612,MATH 10A,A02,083736,Patchell; Gregory David,27,0,30,3
1650836867612,MATH 10A,A03,083737,Patchell; Gregory David,24,0,30,6
1650836873635,MATH 10B,A01,083207,Staff,0,9,30,30
1650836873635,MATH 10B,A02,083208,Staff,0,6,30,30
1650836873635,MATH 10B,B01,083739,Staff,11,0,30,19
1650836873635,MATH 10B,B02,083740,Staff,28,0,30,2
1650836879661,MATH 18,A01,083743,Staff,0,0,30,30
1650836879661,MATH 18,A02,083744,Staff,23,0,30,7
1650836879661,MATH 18,A03,083745,Staff,21,0,30,9
1650836879661,MATH 18,A04,083746,Staff,26,0,30,4
1650836879661,MATH 18,B01,083748,Staff,0,15,30,30
1650836879661,MATH 18,B02,083749,Staff,0,12,30,30
1650836879661,MATH 18,B03,083750,Staff,0,13,30,30
1650836879661,MATH 18,B04,083751,Staff,0,12,30,30
1650836885687,MATH 20A,A01,083754,Staff,19,0,40,21
1650836891713,MATH 20B,A01,083756,Staff,0,13,30,30
1650836891713,MATH 20B,A02,083757,Staff,0,12,30,30
1650836897745,MATH 20C,A01,083760,Staff,0,17,30,30
1650836897745,MATH 20C,A02,083761,Staff,0,16,30,30
1650836897745,MATH 20C,B01,083762,Staff,9,0,30,21
1650836897745,MATH 20C,B02,083763,Staff,28,0,30,2
1650836903772,MATH 20D,A01,083765,Staff,2,1,30,28
1650836903772,MATH 20D,A02,083766,Staff,6,0,30,24
1650836903772,MATH 20D,A03,083767,Staff,24,0,30,6
1650836909887,MATH 20E,A01,083771,Staff,2,0,30,28
1650836909887,MATH 20E,A02,083772,Staff,13,0,30,17
1650836909887,MATH 20E,B01,083773,Staff,0,0,30,30
1650836909887,MATH 20E,B02,083774,Staff,5,0,30,25
1650836915914,MATH 103A,A01,083777,Staff,0,16,30,30
1650836915914,MATH 103A,A02,083778,Staff,0,15,30,30
1650836915914,MATH 103A,B01,083779,Staff,0,15,30,30
1650836915914,MATH 103A,B02,083780,Staff,1,15,30,29
1650836921937,MATH 105,A01,085443,Staff,0,22,30,30
1650836927963,MATH 109,A01,083213,Anzaldo; Leesa B,0,7,30,30
1650836927963,MATH 109,A02,083214,Anzaldo; Leesa B,0,7,30,30
1650836927963,MATH 109,B01,083215,Anzaldo; Leesa B,0,8,30,30
1650836927963,MATH 109,B02,083216,Anzaldo; Leesa B,0,7,30,30
1650836933991,MATH 142A,A01,083219,Chow; Bennett,0,16,30,30
1650836933991,MATH 142A,A02,083220,Chow; Bennett,0,15,30,30
1650836933991,MATH 142A,B01,083221,Chow; Bennett,0,16,30,30
1650836933991,MATH 142A,B02,083222,Chow; Bennett,0,14,30,30
1650836940015,MATH 193A,A01,083224,Staff,0,6,30,30
1650836940015,MATH 193A,A02,083225,Staff,0,6,30,30
1650836940015,MATH 193A,A03,083781,Staff,0,6,30,30
1650836940015,MATH 193A,A04,083782,Staff,0,7,30,30
1650836946040,MATH 197,001,091859,McAuley; Julian John,9998,0,9999,1
1650836952101,COGS 9,A01,083615,Staff,0,17,60,60
1650836958127,COGS 11,A01,083617,Boyle; Mary E. T.,15,0,40,25
1650836964150,COGS 13,A01,083071,Staff,0,38,40,40
1650836970173,COGS 14A,A01,092681,Staff,0,36,100,100
1650836976196,COGS 14B,A01,083073,Cheng; Tzu-Han,0,12,50,50
1650836982217,COGS 17,A01,092677,Staff,12,0,75,63
1650836988242,COGS 100,A01,083619,Staff,0,29,60,60
1650836994264,COGS 101A,A01,083621,Davis; Joshua Daniel,0,28,60,60
1650837000287,COGS 101B,A01,091572,Staff,0,3,60,60
1650837006315,COGS 101C,A01,083625,Delgado; Tania,14,0,30,16
1650837012337,COGS 107A,A01,083627,Boyle; Mary E. T.,0,16,60,60
1650837018360,COGS 118A,A01,083075,Staff,0,8,60,60
1650837024383,CSE 3,A50,083646,Miranda; Gregory Joseph,18,0,38,20
1650837024383,CSE 3,A51,083647,Miranda; Gregory Joseph,36,0,37,1
1650837030411,CSE 8A,A50,083650,Miranda; Gregory Joseph,0,29,40,40
1650837036434,CSE 11,A01,083080,Cao; Yingjun,0,96,40,40
1650837042457,CSE 12,A01,083652,Staff,0,21,100,100
1650837048481,CSE 15L,A01,083654,Staff,0,3,50,50
1650837048481,CSE 15L,A02,083655,Staff,0,2,50,50
1650837054505,CSE 20,A01,083657,Staff,49,0,80,31
1650837060532,CSE 30,A01,083084,Eldon; John,0,75,40,40
1650837066555,CSE 100,A01,083659,Cao; Yingjun,0,71,50,50
1650837072579,CSE 134B,A01,083661,Powell; Thomas Allan,0,38,65,65
1650837078602,CSE 140,A01,083663,Staff,0,11,75,75
1650837084626,CSE 140L,A01,083088,Eldon; John,0,20,75,75
1650837090650,CSE 175,A01,083665,Kumar; Rakesh,7,0,25,18
1650837096677,CSE 190,A00,092507,Dubnov; Shlomo,10,0,20,10
1650837102701,ECE 45,A01,083139,Staff,0,1,60,60
1650837108726,ECE 65,A50,083695,Staff,0,5,30,30
1650837114753,ECE 109,A01,091882,Touri; Behrouz,32,0,70,38
1650837120777,ECE 180,A00,083140,Abi Samra; Nicholas Camill,20,0,30,10
1650837120777,ECE 180,B00,083141,Abi Samra; Nicholas Camill,0,0,30,30
1650837126801,MATH 10A,A01,083735,Patchell; Gregory David,2,0,30,28
1650837126801,MATH 10A,A02,083736,Patchell; Gregory David,27,0,30,3
1650837126801,MATH 10A,A03,083737,Patchell; Gregory David,24,0,30,6
1650837132831,MATH 10B,A01,083207,Staff,0,9,30,30
1650837132831,MATH 10B,A02,083208,Staff,0,6,30,30
1650837132831,MATH 10B,B01,083739,Staff,11,0,30,19
1650837132831,MATH 10B,B02,083740,Staff,28,0,30,2
1650837138858,MATH 18,A01,083743,Staff,0,0,30,30
1650837138858,MATH 18,A02,083744,Staff,23,0,30,7
1650837138858,MATH 18,A03,083745,Staff,21,0,30,9
1650837138858,MATH 18,A04,083746,Staff,26,0,30,4
1650837138858,MATH 18,B01,083748,Staff,0,15,30,30
1650837138858,MATH 18,B02,083749,Staff,0,12,30,30
1650837138858,MATH 18,B03,083750,Staff,0,13,30,30
1650837138858,MATH 18,B04,083751,Staff,0,12,30,30
1650837144881,MATH 20A,A01,083754,Staff,19,0,40,21
1650837150907,MATH 20B,A01,083756,Staff,0,13,30,30
1650837150907,MATH 20B,A02,083757,Staff,0,12,30,30
1650837156932,MATH 20C,A01,083760,Staff,0,17,30,30
1650837156932,MATH 20C,A02,083761,Staff,0,16,30,30
1650837156932,MATH 20C,B01,083762,Staff,9,0,30,21
1650837156932,MATH 20C,B02,083763,Staff,28,0,30,2
1650837162955,MATH 20D,A01,083765,Staff,2,1,30,28
1650837162955,MATH 20D,A02,083766,Staff,6,0,30,24
1650837162955,MATH 20D,A03,083767,Staff,24,0,30,6
1650837168978,MATH 20E,A01,083771,Staff,2,0,30,28
1650837168978,MATH 20E,A02,083772,Staff,13,0,30,17
1650837168978,MATH 20E,B01,083773,Staff,0,0,30,30
1650837168978,MATH 20E,B02,083774,Staff,5,0,30,25
1650837175002,MATH 103A,A01,083777,Staff,0,16,30,30
1650837175002,MATH 103A,A02,083778,Staff,0,15,30,30
1650837175002,MATH 103A,B01,083779,Staff,0,15,30,30
1650837175002,MATH 103A,B02,083780,Staff,1,15,30,29
1650837181028,MATH 105,A01,085443,Staff,0,22,30,30
1650837187063,MATH 109,A01,083213,Anzaldo; Leesa B,0,7,30,30
1650837187063,MATH 109,A02,083214,Anzaldo; Leesa B,0,7,30,30
1650837187063,MATH 109,B01,083215,Anzaldo; Leesa B,0,8,30,30
1650837187063,MATH 109,B02,083216,Anzaldo; Leesa B,0,7,30,30
1650837193091,MATH 142A,A01,083219,Chow; Bennett,0,16,30,30
1650837193091,MATH 142A,A02,083220,Chow; Bennett,0,15,30,30
1650837193091,MATH 142A,B01,083221,Chow; Bennett,0,16,30,30
1650837193091,MATH 142A,B02,083222,Chow; Bennett,0,14,30,30
1650837199116,MATH 193A,A01,083224,Staff,0,6,30,30
1650837199116,MATH 193A,A02,083225,Staff,0,6,30,30
1650837199116,MATH 193A,A03,083781,Staff,0,6,30,30
1650837199116,MATH 193A,A04,083782,Staff,0,7,30,30
1650837205145,MATH 197,001,091859,McAuley; Julian John,9998,0,9999,1
1650837211193,COGS 9,A01,083615,Staff,0,17,60,60
1650837217220,COGS 11,A01,083617,Boyle; Mary E. T.,15,0,40,25
1650837223249,COGS 13,A01,083071,Staff,0,38,40,40
1650837229276,COGS 14A,A01,092681,Staff,0,36,100,100
1650837235299,COGS 14B,A01,083073,Cheng; Tzu-Han,0,12,50,50
1650837241326,COGS 17,A01,092677,Staff,12,0,75,63
1650837247348,COGS 100,A01,083619,Staff,0,29,60,60
1650837253380,COGS 101A,A01,083621,Davis; Joshua Daniel,0,28,60,60
1650837259405,COGS 101B,A01,091572,Staff,0,3,60,60
1650837265437,COGS 101C,A01,083625,Delgado; Tania,14,0,30,16
1650837271462,COGS 107A,A01,083627,Boyle; Mary E. T.,0,16,60,60
1650837277495,COGS 118A,A01,083075,Staff,0,8,60,60
1650837283522,CSE 3,A50,083646,Miranda; Gregory Joseph,18,0,38,20
1650837283522,CSE 3,A51,083647,Miranda; Gregory Joseph,36,0,37,1
1650837289549,CSE 8A,A50,083650,Miranda; Gregory Joseph,0,29,40,40
1650837295572,CSE 11,A01,083080,Cao; Yingjun,0,96,40,40
1650837301599,CSE 12,A01,083652,Staff,0,21,100,100
1650837307623,CSE 15L,A01,083654,Staff,0,3,50,50
1650837307623,CSE 15L,A02,083655,Staff,0,2,50,50
1650837313647,CSE 20,A01,083657,Staff,49,0,80,31
1650837319673,CSE 30,A01,083084,Eldon; John,0,75,40,40
1650837325700,CSE 100,A01,083659,Cao; Yingjun,0,71,50,50
1650837331724,CSE 134B,A01,083661,Powell; Thomas Allan,0,38,65,65
1650837337751,CSE 140,A01,083663,Staff,0,11,75,75
1650837343773,CSE 140L,A01,083088,Eldon; John,0,20,75,75
1650837349795,CSE 175,A01,083665,Kumar; Rakesh,7,0,25,18
1650837355819,CSE 190,A00,092507,Dubnov; Shlomo,10,0,20,10
1650837361844,ECE 45,A01,083139,Staff,0,1,60,60
1650837367868,ECE 65,A50,083695,Staff,0,5,30,30
1650837373892,ECE 109,A01,091882,Touri; Behrouz,32,0,70,38
1650837379915,ECE 180,A00,083140,Abi Samra; Nicholas Camill,20,0,30,10
1650837379915,ECE 180,B00,083141,Abi Samra; Nicholas Camill,0,0,30,30
1650837385939,MATH 10A,A01,083735,Patchell; Gregory David,2,0,30,28
1650837385939,MATH 10A,A02,083736,Patchell; Gregory David,27,0,30,3
1650837385939,MATH 10A,A03,083737,Patchell; Gregory David,24,0,30,6
1650837391967,MATH 10B,A01,083207,Staff,0,9,30,30
1650837391967,MATH 10B,A02,083208,Staff,0,6,30,30
1650837391967,MATH 10B,B01,083739,Staff,11,0,30,19
1650837391967,MATH 10B,B02,083740,Staff,28,0,30,2
1650837397998,MATH 18,A01,083743,Staff,0,0,30,30
1650837397998,MATH 18,A02,083744,Staff,23,0,30,7
1650837397998,MATH 18,A03,083745,Staff,21,0,30,9
1650837397998,MATH 18,A04,083746,Staff,26,0,30,4
1650837397998,MATH 18,B01,083748,Staff,0,15,30,30
1650837397998,MATH 18,B02,083749,Staff,0,12,30,30
1650837397998,MATH 18,B03,083750,Staff,0,13,30,30
1650837397998,MATH 18,B04,083751,Staff,0,12,30,30
1650837404022,MATH 20A,A01,083754,Staff,19,0,40,21
1650837410049,MATH 20B,A01,083756,Staff,0,13,30,30
1650837410049,MATH 20B,A02,083757,Staff,0,12,30,30
1650837416078,MATH 20C,A01,083760,Staff,0,17,30,30
1650837416078,MATH 20C,A02,083761,Staff,0,16,30,30
1650837416078,MATH 20C,B01,083762,Staff,9,0,30,21
1650837416078,MATH 20C,B02,083763,Staff,28,0,30,2
1650837422102,MATH 20D,A01,083765,Staff,2,1,30,28
1650837422102,MATH 20D,A02,083766,Staff,6,0,30,24
1650837422102,MATH 20D,A03,083767,Staff,24,0,30,6
1650837428130,MATH 20E,A01,083771,Staff,2,0,30,28
1650837428130,MATH 20E,A02,083772,Staff,13,0,30,17
1650837428130,MATH 20E,B01,083773,Staff,0,0,30,30
1650837428130,MATH 20E,B02,083774,Staff,5,0,30,25
1650837434158,MATH 103A,A01,083777,Staff,0,16,30,30
1650837434158,MATH 103A,A02,083778,Staff,0,15,30,30
1650837434158,MATH 103A,B01,083779,Staff,0,15,30,30
1650837434158,MATH 103A,B02,083780,Staff,1,15,30,29
1650837440185,MATH 105,A01,085443,Staff,0,22,30,30
1650837446210,MATH 109,A01,083213,Anzaldo; Leesa B,0,7,30,30
1650837446210,MATH 109,A02,083214,Anzaldo; Leesa B,0,7,30,30
1650837446210,MATH 109,B01,083215,Anzaldo; Leesa B,0,8,30,30
1650837446210,MATH 109,B02,083216,Anzaldo; Leesa B,0,7,30,30
1650837452234,MATH 142A,A01,083219,Chow; Bennett,0,16,30,30
1650837452234,MATH 142A,A02,083220,Chow; Bennett,0,15,30,30
1650837452234,MATH 142A,B01,083221,Chow; Bennett,0,16,30,30
1650837452234,MATH 142A,B02,083222,Chow; Bennett,0,14,30,30
1650837458258,MATH 193A,A01,083224,Staff,0,6,30,30
1650837458258,MATH 193A,A02,083225,Staff,0,6,30,30
1650837458258,MATH 193A,A03,083781,Staff,0,6,30,30
1650837458258,MATH 193A,A04,083782,Staff,0,7,30,30
1650837464284,MATH 197,001,091859,McAuley; Julian John,9998,0,9999,1
1650837470331,COGS 9,A01,083615,Staff,0,17,60,60
1650837476354,COGS 11,A01,083617,Boyle; Mary E. T.,15,0,40,25
1650837482381,COGS 13,A01,083071,Staff,0,38,40,40
1650837488411,COGS 14A,A01,092681,Staff,0,36,100,100
1650837494433,COGS 14B,A01,083073,Cheng; Tzu-Han,0,12,50,50
1650837500560,COGS 17,A01,092677,Staff,12,0,75,63
1650837506585,COGS 100,A01,083619,Staff,0,29,60,60
1650837512609,COGS 101A,A01,083621,Davis; Joshua Daniel,0,28,60,60
1650837518633,COGS 101B,A01,091572,Staff,0,3,60,60
1650837524655,COGS 101C,A01,083625,Delgado; Tania,14,0,30,16
1650837530679,COGS 107A,A01,083627,Boyle; Mary E. T.,0,16,60,60
1650837536705,COGS 118A,A01,083075,Staff,0,8,60,60
1650837542734,CSE 3,A50,083646,Miranda; Gregory Joseph,18,0,38,20
1650837542734,CSE 3,A51,083647,Miranda; Gregory Joseph,36,0,37,1
1650837548762,CSE 8A,A50,083650,Miranda; Gregory Joseph,0,29,40,40
1650837554789,CSE 11,A01,083080,Cao; Yingjun,0,96,40,40
1650837560813,CSE 12,A01,083652,Staff,0,21,100,100
1650837566840,CSE 15L,A01,083654,Staff,0,3,50,50
1650837566840,CSE 15L,A02,083655,Staff,0,2,50,50
1650837572862,CSE 20,A01,083657,Staff,49,0,80,31
1650837578887,CSE 30,A01,083084,Eldon; John,0,75,40,40
1650837584910,CSE 100,A01,083659,Cao; Yingjun,0,71,50,50
1650837590935,CSE 134B,A01,083661,Powell; Thomas Allan,0,38,65,65
1650837596958,CSE 140,A01,083663,Staff,0,11,75,75
1650837602985,CSE 140L,A01,083088,Eldon; John,0,20,75,75
1650837609011,CSE 175,A01,083665,Kumar; Rakesh,7,0,25,18
1650837615040,CSE 190,A00,092507,Dubnov; Shlomo,10,0,20,10
1650837621067,ECE 45,A01,083139,Staff,0,1,60,60
1650837627090,ECE 65,A50,083695,Staff,0,5,30,30
1650837633113,ECE 109,A01,091882,Touri; Behrouz,32,0,70,38
1650837639139,ECE 180,A00,083140,Abi Samra; Nicholas Camill,20,0,30,10
1650837639139,ECE 180,B00,083141,Abi Samra; Nicholas Camill,0,0,30,30
1650837645161,MATH 10A,A01,083735,Patchell; Gregory David,2,0,30,28
1650837645161,MATH 10A,A02,083736,Patchell; Gregory David,27,0,30,3
1650837645161,MATH 10A,A03,083737,Patchell; Gregory David,24,0,30,6
1650837651189,MATH 10B,A01,083207,Staff,0,9,30,30
1650837651189,MATH 10B,A02,083208,Staff,0,6,30,30
1650837651189,MATH 10B,B01,083739,Staff,11,0,30,19
1650837651189,MATH 10B,B02,083740,Staff,28,0,30,2
1650837657220,MATH 18,A01,083743,Staff,0,0,30,30
1650837657220,MATH 18,A02,083744,Staff,23,0,30,7
1650837657220,MATH 18,A03,083745,Staff,21,0,30,9
1650837657220,MATH 18,A04,083746,Staff,26,0,30,4
1650837657220,MATH 18,B01,083748,Staff,0,15,30,30
1650837657220,MATH 18,B02,083749,Staff,0,12,30,30
1650837657220,MATH 18,B03,083750,Staff,0,13,30,30
1650837657220,MATH 18,B04,083751,Staff,0,12,30,30
1650837663268,MATH 20A,A01,083754,Staff,19,0,40,21
1650837669292,MATH 20B,A01,083756,Staff,0,13,30,30
1650837669292,MATH 20B,A02,083757,Staff,0,12,30,30
1650837675317,MATH 20C,A01,083760,Staff,0,17,30,30
1650837675317,MATH 20C,A02,083761,Staff,0,16,30,30
1650837675317,MATH 20C,B01,083762,Staff,9,0,30,21
1650837675317,MATH 20C,B02,083763,Staff,28,0,30,2
1650837681341,MATH 20D,A01,083765,Staff,2,1,30,28
1650837681341,MATH 20D,A02,083766,Staff,6,0,30,24
1650837681341,MATH 20D,A03,083767,Staff,24,0,30,6
1650837687366,MATH 20E,A01,083771,Staff,2,0,30,28
1650837687366,MATH 20E,A02,083772,Staff,13,0,30,17
1650837687366,MATH 20E,B01,083773,Staff,0,0,30,30
1650837687366,MATH 20E,B02,083774,Staff,5,0,30,25
1650837693389,MATH 103A,A01,083777,Staff,0,16,30,30
1650837693389,MATH 103A,A02,083778,Staff,0,15,30,30
1650837693389,MATH 103A,B01,083779,Staff,0,15,30,30
1650837693389,MATH 103A,B02,083780,Staff,1,15,30,29
1650837699413,MATH 105,A01,085443,Staff,0,22,30,30
1650837705437,MATH 109,A01,083213,Anzaldo; Leesa B,0,7,30,30
1650837705437,MATH 109,A02,083214,Anzaldo; Leesa B,0,7,30,30
1650837705437,MATH 109,B01,083215,Anzaldo; Leesa B,0,8,30,30
1650837705437,MATH 109,B02,083216,Anzaldo; Leesa B,0,7,30,30
1650837711474,MATH 142A,A01,083219,Chow; Bennett,0,16,30,30
1650837711474,MATH 142A,A02,083220,Chow; Bennett,0,15,30,30
1650837711474,MATH 142A,B01,083221,Chow; Bennett,0,16,30,30
1650837711474,MATH 142A,B02,083222,Chow; Bennett,0,14,30,30
1650837717498,MATH 193A,A01,083224,Staff,0,6,30,30
1650837717498,MATH 193A,A02,083225,Staff,0,6,30,30
1650837717498,MATH 193A,A03,083781,Staff,0,6,30,30
1650837717498,MATH 193A,A04,083782,Staff,0,7,30,30
1650837723524,MATH 197,001,091859,McAuley; Julian John,9998,0,9999,1
1650837729576,COGS 9,A01,083615,Staff,0,17,60,60
1650837735603,COGS 11,A01,083617,Boyle; Mary E. T.,15,0,40,25
1650837741629,COGS 13,A01,083071,Staff,0,38,40,40
1650837747654,COGS 14A,A01,092681,Staff,0,36,100,100
1650837753681,COGS 14B,A01,083073,Cheng; Tzu-Han,0,12,50,50
1650837759708,COGS 17,A01,092677,Staff,12,0,75,63
1650837765734,COGS 100,A01,083619,Staff,0,29,60,60
1650837771761,COGS 101A,A01,083621,Davis; Joshua Daniel,0,28,60,60
1650837777783,COGS 101B,A01,091572,Staff,0,3,60,60
1650837783807,COGS 101C,A01,083625,Delgado; Tania,14,0,30,16
1650837789830,COGS 107A,A01,083627,Boyle; Mary E. T.,0,16,60,60
1650837795853,COGS 118A,A01,083075,Staff,0,8,60,60
1650837801877,CSE 3,A50,083646,Miranda; Gregory Joseph,18,0,38,20
1650837801877,CSE 3,A51,083647,Miranda; Gregory Joseph,36,0,37,1
1650837807908,CSE 8A,A50,083650,Miranda; Gregory Joseph,0,29,40,40
1650837813934,CSE 11,A01,083080,Cao; Yingjun,0,96,40,40
1650837819962,CSE 12,A01,083652,Staff,0,21,100,100
1650837825987,CSE 15L,A01,083654,Staff,0,3,50,50
1650837825987,CSE 15L,A02,083655,Staff,0,2,50,50
1650837832011,CSE 20,A01,083657,Staff,49,0,80,31
1650837838035,CSE 30,A01,083084,Eldon; John,0,75,40,40
1650837844058,CSE 100,A01,083659,Cao; Yingjun,0,71,50,50
1650837850082,CSE 134B,A01,083661,Powell; Thomas Allan,0,38,65,65
1650837856104,CSE 140,A01,083663,Staff,0,11,75,75
1650837862134,CSE 140L,A01,083088,Eldon; John,0,20,75,75
1650837868156,CSE 175,A01,083665,Kumar; Rakesh,7,0,25,18
1650837874180,CSE 190,A00,092507,Dubnov; Shlomo,10,0,20,10
1650837880204,ECE 45,A01,083139,Staff,0,1,60,60
1650837886229,ECE 65,A50,083695,Staff,0,5,30,30
1650837892258,ECE 109,A01,091882,Touri; Behrouz,32,0,70,38
1650837898281,ECE 180,A00,083140,Abi Samra; Nicholas Camill,20,0,30,10
1650837898281,ECE 180,B00,083141,Abi Samra; Nicholas Camill,0,0,30,30
1650837904309,MATH 10A,A01,083735,Patchell; Gregory David,2,0,30,28
1650837904309,MATH 10A,A02,083736,Patchell; Gregory David,27,0,30,3
1650837904309,MATH 10A,A03,083737,Patchell; Gregory David,24,0,30,6
1650837910334,MATH 10B,A01,083207,Staff,0,9,30,30
1650837910334,MATH 10B,A02,083208,Staff,0,6,30,30
1650837910334,MATH 10B,B01,083739,Staff,11,0,30,19
1650837910334,MATH 10B,B02,083740,Staff,28,0,30,2
1650837916359,MATH 18,A01,083743,Staff,0,0,30,30
1650837916359,MATH 18,A02,083744,Staff,23,0,30,7
1650837916359,MATH 18,A03,083745,Staff,21,0,30,9
1650837916359,MATH 18,A04,083746,Staff,26,0,30,4
1650837916359,MATH 18,B01,083748,Staff,0,15,30,30
1650837916359,MATH 18,B02,083749,Staff,0,12,30,30
1650837916359,MATH 18,B03,083750,Staff,0,13,30,30
1650837916359,MATH 18,B04,083751,Staff,0,12,30,30
1650837922384,MATH 20A,A01,083754,Staff,19,0,40,21
1650837928410,MATH 20B,A01,083756,Staff,0,13,30,30
1650837928410,MATH 20B,A02,083757,Staff,0,12,30,30
1650837934436,MATH 20C,A01,083760,Staff,0,17,30,30
1650837934436,MATH 20C,A02,083761,Staff,0,16,30,30
1650837934436,MATH 20C,B01,083762,Staff,9,0,30,21
1650837934436,MATH 20C,B02,083763,Staff,28,0,30,2
1650837940458,MATH 20D,A01,083765,Staff,2,1,30,28
1650837940458,MATH 20D,A02,083766,Staff,6,0,30,24
1650837940458,MATH 20D,A03,083767,Staff,24,0,30,6
1650837946485,MATH 20E,A01,083771,Staff,2,0,30,28
1650837946485,MATH 20E,A02,083772,Staff,13,0,30,17
1650837946485,MATH 20E,B01,083773,Staff,0,0,30,30
1650837946485,MATH 20E,B02,083774,Staff,5,0,30,25
1650837952514,MATH 103A,A01,083777,Staff,0,16,30,30
1650837952514,MATH 103A,A02,083778,Staff,0,15,30,30
1650837952514,MATH 103A,B01,083779,Staff,0,15,30,30
1650837952514,MATH 103A,B02,083780,Staff,1,15,30,29
1650837958537,MATH 105,A01,085443,Staff,0,22,30,30
1650837973957,MATH 109,A01,083213,Anzaldo; Leesa B,0,7,30,30
1650837973957,MATH 109,A02,083214,Anzaldo; Leesa B,0,7,30,30
1650837973957,MATH 109,B01,083215,Anzaldo; Leesa B,0,8,30,30
1650837973957,MATH 109,B02,083216,Anzaldo; Leesa B,0,7,30,30
1650837979982,MATH 142A,A01,083219,Chow; Bennett,0,16,30,30
1650837979982,MATH 142A,A02,083220,Chow; Bennett,0,15,30,30
1650837979982,MATH 142A,B01,083221,Chow; Bennett,0,16,30,30
1650837979982,MATH 142A,B02,083222,Chow; Bennett,0,14,30,30
1650837986007,MATH 193A,A01,083224,Staff,0,6,30,30
1650837986007,MATH 193A,A02,083225,Staff,0,6,30,30
1650837986007,MATH 193A,A03,083781,Staff,0,6,30,30
1650837986007,MATH 193A,A04,083782,Staff,0,7,30,30
1650837992033,MATH 197,001,091859,McAuley; Julian John,9998,0,9999,1
1650837998090,COGS 9,A01,083615,Staff,0,17,60,60
1650838004117,COGS 11,A01,083617,Boyle; Mary E. T.,15,0,40,25
1650838010141,COGS 13,A01,083071,Staff,0,38,40,40
1650838016162,COGS 14A,A01,092681,Staff,0,36,100,100
1650838022190,COGS 14B,A01,083073,Cheng; Tzu-Han,0,12,50,50
1650838028217,COGS 17,A01,092677,Staff,12,0,75,63
1650838034245,COGS 100,A01,083619,Staff,0,29,60,60
1650838040272,COGS 101A,A01,083621,Davis; Joshua Daniel,0,28,60,60
1650838046296,COGS 101B,A01,091572,Staff,0,3,60,60
1650838052327,COGS 101C,A01,083625,Delgado; Tania,14,0,30,16
1650838058348,COGS 107A,A01,083627,Boyle; Mary E. T.,0,16,60,60
1650838064373,COGS 118A,A01,083075,Staff,0,8,60,60
1650838070399,CSE 3,A50,083646,Miranda; Gregory Joseph,18,0,38,20
1650838070399,CSE 3,A51,083647,Miranda; Gregory Joseph,36,0,37,1
1650838076427,CSE 8A,A50,083650,Miranda; Gregory Joseph,0,29,40,40
1650838082449,CSE 11,A01,083080,Cao; Yingjun,0,96,40,40
1650838088482,CSE 12,A01,083652,Staff,0,21,100,100
1650838094506,CSE 15L,A01,083654,Staff,0,3,50,50
1650838094506,CSE 15L,A02,083655,Staff,0,2,50,50
1650838100532,CSE 20,A01,083657,Staff,49,0,80,31
1650838106660,CSE 30,A01,083084,Eldon; John,0,75,40,40
1650838112687,CSE 100,A01,083659,Cao; Yingjun,0,71,50,50
1650838118710,CSE 134B,A01,083661,Powell; Thomas Allan,0,38,65,65
1650838124735,CSE 140,A01,083663,Staff,0,11,75,75
1650838130760,CSE 140L,A01,083088,Eldon; John,0,20,75,75
1650838136784,CSE 175,A01,083665,Kumar; Rakesh,7,0,25,18
1650838142806,CSE 190,A00,092507,Dubnov; Shlomo,10,0,20,10
1650838148833,ECE 45,A01,083139,Staff,0,1,60,60
1650838154860,ECE 65,A50,083695,Staff,0,5,30,30
1650838160886,ECE 109,A01,091882,Touri; Behrouz,32,0,70,38
1650838166913,ECE 180,A00,083140,Abi Samra; Nicholas Camill,20,0,30,10
1650838166913,ECE 180,B00,083141,Abi Samra; Nicholas Camill,0,0,30,30
1650838172937,MATH 10A,A01,083735,Patchell; Gregory David,2,0,30,28
1650838172937,MATH 10A,A02,083736,Patchell; Gregory David,27,0,30,3
1650838172937,MATH 10A,A03,083737,Patchell; Gregory David,24,0,30,6
1650838178961,MATH 10B,A01,083207,Staff,0,9,30,30
1650838178961,MATH 10B,A02,083208,Staff,0,6,30,30
1650838178961,MATH 10B,B01,083739,Staff,11,0,30,19
1650838178961,MATH 10B,B02,083740,Staff,28,0,30,2
1650838184991,MATH 18,A01,083743,Staff,0,0,30,30
1650838184991,MATH 18,A02,083744,Staff,23,0,30,7
1650838184991,MATH 18,A03,083745,Staff,21,0,30,9
1650838184991,MATH 18,A04,083746,Staff,26,0,30,4
1650838184991,MATH 18,B01,083748,Staff,0,15,30,30
1650838184991,MATH 18,B02,083749,Staff,0,12,30,30
1650838184991,MATH 18,B03,083750,Staff,0,13,30,30
1650838184991,MATH 18,B04,083751,Staff,0,12,30,30
1650838191017,MATH 20A,A01,083754,Staff,19,0,40,21
1650838197041,MATH 20B,A01,083756,Staff,0,13,30,30
1650838197041,MATH 20B,A02,083757,Staff,0,12,30,30
1650838203065,MATH 20C,A01,083760,Staff,0,17,30,30
1650838203065,MATH 20C,A02,083761,Staff,0,16,30,30
1650838203065,MATH 20C,B01,083762,Staff,9,0,30,21
1650838203065,MATH 20C,B02,083763,Staff,28,0,30,2
1650838209096,MATH 20D,A01,083765,Staff,2,1,30,28
1650838209096,MATH 20D,A02,083766,Staff,6,0,30,24
1650838209096,MATH 20D,A03,083767,Staff,24,0,30,6
1650838215118,MATH 20E,A01,083771,Staff,2,0,30,28
1650838215118,MATH 20E,A02,083772,Staff,13,0,30,17
1650838215118,MATH 20E,B01,083773,Staff,0,0,30,30
1650838215118,MATH 20E,B02,083774,Staff,5,0,30,25
1650838221146,MATH 103A,A01,083777,Staff,0,16,30,30
1650838221146,MATH 103A,A02,083778,Staff,0,15,30,30
1650838221146,MATH 103A,B01,083779,Staff,0,15,30,30
1650838221146,MATH 103A,B02,083780,Staff,1,15,30,29
1650838227169,MATH 105,A01,085443,Staff,0,22,30,30
1650838233192,MATH 109,A01,083213,Anzaldo; Leesa B,0,7,30,30
1650838233192,MATH 109,A02,083214,Anzaldo; Leesa B,0,7,30,30
1650838233192,MATH 109,B01,083215,Anzaldo; Leesa B,0,8,30,30
1650838233192,MATH 109,B02,083216,Anzaldo; Leesa B,0,7,30,30
1650838239217,MATH 142A,A01,083219,Chow; Bennett,0,16,30,30
1650838239217,MATH 142A,A02,083220,Chow; Bennett,0,15,30,30
1650838239217,MATH 142A,B01,083221,Chow; Bennett,0,16,30,30
1650838239217,MATH 142A,B02,083222,Chow; Bennett,0,14,30,30
1650838245242,MATH 193A,A01,083224,Staff,0,6,30,30
1650838245242,MATH 193A,A02,083225,Staff,0,6,30,30
1650838245242,MATH 193A,A03,083781,Staff,0,6,30,30
1650838245242,MATH 193A,A04,083782,Staff,0,7,30,30
1650838251266,MATH 197,001,091859,McAuley; Julian John,9998,0,9999,1
1650838257317,COGS 9,A01,083615,Staff,0,17,60,60
1650838263341,COGS 11,A01,083617,Boyle; Mary E. T.,15,0,40,25
1650838269365,COGS 13,A01,083071,Staff,0,38,40,40
1650838275389,COGS 14A,A01,092681,Staff,0,36,100,100
1650838281417,COGS 14B,A01,083073,Cheng; Tzu-Han,0,12,50,50
1650838287439,COGS 17,A01,092677,Staff,12,0,75,63
1650838293464,COGS 100,A01,083619,Staff,0,29,60,60
1650838299504,COGS 101A,A01,083621,Davis; Joshua Daniel,0,28,60,60
1650838305527,COGS 101B,A01,091572,Staff,0,3,60,60
1650838311551,COGS 101C,A01,083625,Delgado; Tania,14,0,30,16
1650838317575,COGS 107A,A01,083627,Boyle; Mary E. T.,0,16,60,60
1650838323598,COGS 118A,A01,083075,Staff,0,8,60,60
1650838329621,CSE 3,A50,083646,Miranda; Gregory Joseph,18,0,38,20
1650838329621,CSE 3,A51,083647,Miranda; Gregory Joseph,36,0,37,1
1650838335645,CSE 8A,A50,083650,Miranda; Gregory Joseph,0,29,40,40
1650838341671,CSE 11,A01,083080,Cao; Yingjun,0,96,40,40
1650838347698,CSE 12,A01,083652,Staff,0,21,100,100
1650838353722,CSE 15L,A01,083654,Staff,0,3,50,50
1650838353722,CSE 15L,A02,083655,Staff,0,2,50,50
1650838359746,CSE 20,A01,083657,Staff,49,0,80,31
1650838365770,CSE 30,A01,083084,Eldon; John,0,75,40,40
1650838371803,CSE 100,A01,083659,Cao; Yingjun,0,71,50,50
1650838377827,CSE 134B,A01,083661,Powell; Thomas Allan,0,38,65,65
1650838383852,CSE 140,A01,083663,Staff,0,11,75,75
1650838389874,CSE 140L,A01,083088,Eldon; John,0,20,75,75
1650838395899,CSE 175,A01,083665,Kumar; Rakesh,7,0,25,18
1650838401923,CSE 190,A00,092507,Dubnov; Shlomo,10,0,20,10
1650838407950,ECE 45,A01,083139,Staff,0,1,60,60
1650838413976,ECE 65,A50,083695,Staff,0,5,30,30
1650838420000,ECE 109,A01,091882,Touri; Behrouz,32,0,70,38
1650838426025,ECE 180,A00,083140,Abi Samra; Nicholas Camill,20,0,30,10
1650838426025,ECE 180,B00,083141,Abi Samra; Nicholas Camill,0,0,30,30
1650838432050,MATH 10A,A01,083735,Patchell; Gregory David,2,0,30,28
1650838432050,MATH 10A,A02,083736,Patchell; Gregory David,27,0,30,3
1650838432050,MATH 10A,A03,083737,Patchell; Gregory David,24,0,30,6
1650838438074,MATH 10B,A01,083207,Staff,0,9,30,30
1650838438074,MATH 10B,A02,083208,Staff,0,6,30,30
1650838438074,MATH 10B,B01,083739,Staff,11,0,30,19
1650838438074,MATH 10B,B02,083740,Staff,28,0,30,2
1650838444097,MATH 18,A01,083743,Staff,0,0,30,30
1650838444097,MATH 18,A02,083744,Staff,23,0,30,7
1650838444097,MATH 18,A03,083745,Staff,21,0,30,9
1650838444097,MATH 18,A04,083746,Staff,26,0,30,4
1650838444097,MATH 18,B01,083748,Staff,0,15,30,30
1650838444097,MATH 18,B02,083749,Staff,0,13,30,30
1650838444097,MATH 18,B03,083750,Staff,0,13,30,30
1650838444097,MATH 18,B04,083751,Staff,0,12,30,30
1650838450122,MATH 20A,A01,083754,Staff,19,0,40,21
1650838456149,MATH 20B,A01,083756,Staff,0,13,30,30
1650838456149,MATH 20B,A02,083757,Staff,0,12,30,30
1650838462172,MATH 20C,A01,083760,Staff,0,17,30,30
1650838462172,MATH 20C,A02,083761,Staff,0,16,30,30
1650838462172,MATH 20C,B01,083762,Staff,9,0,30,21
1650838462172,MATH 20C,B02,083763,Staff,28,0,30,2
1650838468196,MATH 20D,A01,083765,Staff,2,1,30,28
1650838468196,MATH 20D,A02,083766,Staff,6,0,30,24
1650838468196,MATH 20D,A03,083767,Staff,24,0,30,6
1650838474224,MATH 20E,A01,083771,Staff,2,0,30,28
1650838474224,MATH 20E,A02,083772,Staff,13,0,30,17
1650838474224,MATH 20E,B01,083773,Staff,0,0,30,30
1650838474224,MATH 20E,B02,083774,Staff,5,0,30,25
1650838480258,MATH 103A,A01,083777,Staff,0,16,30,30
1650838480258,MATH 103A,A02,083778,Staff,0,15,30,30
1650838480258,MATH 103A,B01,083779,Staff,0,15,30,30
1650838480258,MATH 103A,B02,083780,Staff,1,15,30,29
1650838486284,MATH 105,A01,085443,Staff,0,22,30,30
1650838492312,MATH 109,A01,083213,Anzaldo; Leesa B,0,7,30,30
1650838492312,MATH 109,A02,083214,Anzaldo; Leesa B,0,7,30,30
1650838492312,MATH 109,B01,083215,Anzaldo; Leesa B,0,8,30,30
1650838492312,MATH 109,B02,083216,Anzaldo; Leesa B,0,7,30,30
1650838498355,MATH 142A,A01,083219,Chow; Bennett,0,16,30,30
1650838498355,MATH 142A,A02,083220,Chow; Bennett,0,15,30,30
1650838498355,MATH 142A,B01,083221,Chow; Bennett,0,16,30,30
1650838498355,MATH 142A,B02,083222,Chow; Bennett,0,14,30,30
1650838504378,MATH 193A,A01,083224,Staff,0,6,30,30
1650838504378,MATH 193A,A02,083225,Staff,0,6,30,30
1650838504378,MATH 193A,A03,083781,Staff,0,6,30,30
1650838504378,MATH 193A,A04,083782,Staff,0,7,30,30
1650838510405,MATH 197,001,091859,McAuley; Julian John,9998,0,9999,1
1650838516455,COGS 9,A01,083615,Staff,0,17,60,60
1650838522478,COGS 11,A01,083617,Boyle; Mary E. T.,15,0,40,25
1650838528503,COGS 13,A01,083071,Staff,0,38,40,40
1650838534529,COGS 14A,A01,092681,Staff,0,36,100,100
1650838540553,COGS 14B,A01,083073,Cheng; Tzu-Han,0,12,50,50
1650838546577,COGS 17,A01,092677,Staff,12,0,75,63
1650838552601,COGS 100,A01,083619,Staff,0,29,60,60
1650838558626,COGS 101A,A01,083621,Davis; Joshua Daniel,0,28,60,60
1650838564650,COGS 101B,A01,091572,Staff,0,3,60,60
1650838570678,COGS 101C,A01,083625,Delgado; Tania,14,0,30,16
1650838576712,COGS 107A,A01,083627,Boyle; Mary E. T.,0,16,60,60
1650838582735,COGS 118A,A01,083075,Staff,0,8,60,60
1650838588763,CSE 3,A50,083646,Miranda; Gregory Joseph,18,0,38,20
1650838588763,CSE 3,A51,083647,Miranda; Gregory Joseph,36,0,37,1
1650838594788,CSE 8A,A50,083650,Miranda; Gregory Joseph,0,29,40,40
1650838600816,CSE 11,A01,083080,Cao; Yingjun,0,96,40,40
1650838606839,CSE 12,A01,083652,Staff,0,21,100,100
1650838612863,CSE 15L,A01,083654,Staff,0,3,50,50
1650838612863,CSE 15L,A02,083655,Staff,0,2,50,50
1650838618887,CSE 20,A01,083657,Staff,49,0,80,31
1650838624913,CSE 30,A01,083084,Eldon; John,0,75,40,40
1650838630941,CSE 100,A01,083659,Cao; Yingjun,0,71,50,50
1650838636965,CSE 134B,A01,083661,Powell; Thomas Allan,0,38,65,65
1650838642994,CSE 140,A01,083663,Staff,0,11,75,75
1650838649025,CSE 140L,A01,083088,Eldon; John,0,20,75,75
1650838655065,CSE 175,A01,083665,Kumar; Rakesh,7,0,25,18
1650838661088,CSE 190,A00,092507,Dubnov; Shlomo,10,0,20,10
1650838667115,ECE 45,A01,083139,Staff,0,1,60,60
1650838673145,ECE 65,A50,083695,Staff,0,5,30,30
1650838679169,ECE 109,A01,091882,Touri; Behrouz,32,0,70,38
1650838685192,ECE 180,A00,083140,Abi Samra; Nicholas Camill,20,0,30,10
1650838685192,ECE 180,B00,083141,Abi Samra; Nicholas Camill,0,0,30,30
1650838691216,MATH 10A,A01,083735,Patchell; Gregory David,2,0,30,28
1650838691216,MATH 10A,A02,083736,Patchell; Gregory David,27,0,30,3
1650838691216,MATH 10A,A03,083737,Patchell; Gregory David,24,0,30,6
1650838697244,MATH 10B,A01,083207,Staff,0,9,30,30
1650838697244,MATH 10B,A02,083208,Staff,0,6,30,30
1650838697244,MATH 10B,B01,083739,Staff,11,0,30,19
1650838697244,MATH 10B,B02,083740,Staff,28,0,30,2
1650838703359,MATH 18,A01,083743,Staff,0,0,30,30
1650838703359,MATH 18,A02,083744,Staff,23,0,30,7
1650838703359,MATH 18,A03,083745,Staff,21,0,30,9
1650838703359,MATH 18,A04,083746,Staff,26,0,30,4
1650838703359,MATH 18,B01,083748,Staff,0,15,30,30
1650838703359,MATH 18,B02,083749,Staff,0,13,30,30
1650838703359,MATH 18,B03,083750,Staff,0,13,30,30
1650838703359,MATH 18,B04,083751,Staff,0,12,30,30
1650838709380,MATH 20A,A01,083754,Staff,19,0,40,21
1650838715403,MATH 20B,A01,083756,Staff,0,14,30,30
1650838715403,MATH 20B,A02,083757,Staff,0,12,30,30
1650838721424,MATH 20C,A01,083760,Staff,0,17,30,30
1650838721424,MATH 20C,A02,083761,Staff,0,16,30,30
1650838721424,MATH 20C,B01,083762,Staff,9,0,30,21
1650838721424,MATH 20C,B02,083763,Staff,28,0,30,2
1650838727448,MATH 20D,A01,083765,Staff,2,1,30,28
1650838727448,MATH 20D,A02,083766,Staff,6,0,30,24
1650838727448,MATH 20D,A03,083767,Staff,24,0,30,6
1650838733473,MATH 20E,A01,083771,Staff,2,0,30,28
1650838733473,MATH 20E,A02,083772,Staff,13,0,30,17
1650838733473,MATH 20E,B01,083773,Staff,0,0,30,30
1650838733473,MATH 20E,B02,083774,Staff,5,0,30,25
1650838739498,MATH 103A,A01,083777,Staff,0,16,30,30
1650838739498,MATH 103A,A02,083778,Staff,0,15,30,30
1650838739498,MATH 103A,B01,083779,Staff,0,15,30,30
1650838739498,MATH 103A,B02,083780,Staff,1,15,30,29
1650838745524,MATH 105,A01,085443,Staff,0,22,30,30
1650838751549,MATH 109,A01,083213,Anzaldo; Leesa B,0,7,30,30
1650838751549,MATH 109,A02,083214,Anzaldo; Leesa B,0,7,30,30
1650838751549,MATH 109,B01,083215,Anzaldo; Leesa B,0,8,30,30
1650838751549,MATH 109,B02,083216,Anzaldo; Leesa B,0,7,30,30
1650838757573,MATH 142A,A01,083219,Chow; Bennett,0,16,30,30
1650838757573,MATH 142A,A02,083220,Chow; Bennett,0,15,30,30
1650838757573,MATH 142A,B01,083221,Chow; Bennett,0,16,30,30
1650838757573,MATH 142A,B02,083222,Chow; Bennett,0,14,30,30
1650838763600,MATH 193A,A01,083224,Staff,0,6,30,30
1650838763600,MATH 193A,A02,083225,Staff,0,6,30,30
1650838763600,MATH 193A,A03,083781,Staff,0,6,30,30
1650838763600,MATH 193A,A04,083782,Staff,0,7,30,30
1650838769623,MATH 197,001,091859,McAuley; Julian John,9998,0,9999,1
1650838775691,COGS 9,A01,083615,Staff,0,17,60,60
1650838781715,COGS 11,A01,083617,Boyle; Mary E. T.,15,0,40,25
1650838787744,COGS 13,A01,083071,Staff,0,38,40,40
1650838793768,COGS 14A,A01,092681,Staff,0,36,100,100
1650838799792,COGS 14B,A01,083073,Cheng; Tzu-Han,0,12,50,50
1650838805819,COGS 17,A01,092677,Staff,12,0,75,63
1650838811843,COGS 100,A01,083619,Staff,0,29,60,60
1650838817866,COGS 101A,A01,083621,Davis; Joshua Daniel,0,28,60,60
1650838823889,COGS 101B,A01,091572,Staff,0,3,60,60
1650838829913,COGS 101C,A01,083625,Delgado; Tania,14,0,30,16
1650838835936,COGS 107A,A01,083627,Boyle; Mary E. T.,0,16,60,60
1650838841958,COGS 118A,A01,083075,Staff,0,8,60,60
1650838847982,CSE 3,A50,083646,Miranda; Gregory Joseph,18,0,38,20
1650838847982,CSE 3,A51,083647,Miranda; Gregory Joseph,36,0,37,1
1650838854007,CSE 8A,A50,083650,Miranda; Gregory Joseph,0,29,40,40
1650838860037,CSE 11,A01,083080,Cao; Yingjun,0,96,40,40
1650838866066,CSE 12,A01,083652,Staff,0,21,100,100
1650838872092,CSE 15L,A01,083654,Staff,0,3,50,50
1650838872092,CSE 15L,A02,083655,Staff,0,2,50,50
1650838878114,CSE 20,A01,083657,Staff,49,0,80,31
1650838884141,CSE 30,A01,083084,Eldon; John,0,75,40,40
1650838890177,CSE 100,A01,083659,Cao; Yingjun,0,71,50,50
1650838896202,CSE 134B,A01,083661,Powell; Thomas Allan,0,38,65,65
1650838902224,CSE 140,A01,083663,Staff,0,11,75,75
1650838908250,CSE 140L,A01,083088,Eldon; John,0,20,75,75
1650838914275,CSE 175,A01,083665,Kumar; Rakesh,7,0,25,18
1650838920302,CSE 190,A00,092507,Dubnov; Shlomo,10,0,20,10
1650838926329,ECE 45,A01,083139,Staff,0,1,60,60
1650838932356,ECE 65,A50,083695,Staff,0,5,30,30
1650838938379,ECE 109,A01,091882,Touri; Behrouz,32,0,70,38
1650838944403,ECE 180,A00,083140,Abi Samra; Nicholas Camill,20,0,30,10
1650838944403,ECE 180,B00,083141,Abi Samra; Nicholas Camill,0,0,30,30
1650838950426,MATH 10A,A01,083735,Patchell; Gregory David,2,0,30,28
1650838950426,MATH 10A,A02,083736,Patchell; Gregory David,27,0,30,3
1650838950426,MATH 10A,A03,083737,Patchell; Gregory David,24,0,30,6
1650838956457,MATH 10B,A01,083207,Staff,0,9,30,30
1650838956457,MATH 10B,A02,083208,Staff,0,6,30,30
1650838956457,MATH 10B,B01,083739,Staff,11,0,30,19
1650838956457,MATH 10B,B02,083740,Staff,28,0,30,2
1650838962482,MATH 18,A01,083743,Staff,0,0,30,30
1650838962482,MATH 18,A02,083744,Staff,23,0,30,7
1650838962482,MATH 18,A03,083745,Staff,21,0,30,9
1650838962482,MATH 18,A04,083746,Staff,26,0,30,4
1650838962482,MATH 18,B01,083748,Staff,0,15,30,30
1650838962482,MATH 18,B02,083749,Staff,0,13,30,30
1650838962482,MATH 18,B03,083750,Staff,0,13,30,30
1650838962482,MATH 18,B04,083751,Staff,0,12,30,30
1650838968508,MATH 20A,A01,083754,Staff,19,0,40,21
1650838974534,MATH 20B,A01,083756,Staff,0,14,30,30
1650838974534,MATH 20B,A02,083757,Staff,0,12,30,30
1650838980559,MATH 20C,A01,083760,Staff,0,17,30,30
1650838980559,MATH 20C,A02,083761,Staff,0,16,30,30
1650838980559,MATH 20C,B01,083762,Staff,9,0,30,21
1650838980559,MATH 20C,B02,083763,Staff,28,0,30,2
1650838986590,MATH 20D,A01,083765,Staff,2,1,30,28
1650838986590,MATH 20D,A02,083766,Staff,6,0,30,24
1650838986590,MATH 20D,A03,083767,Staff,24,0,30,6
1650838992615,MATH 20E,A01,083771,Staff,2,0,30,28
1650838992615,MATH 20E,A02,083772,Staff,13,0,30,17
1650838992615,MATH 20E,B01,083773,Staff,0,0,30,30
1650838992615,MATH 20E,B02,083774,Staff,5,0,30,25
1650838998638,MATH 103A,A01,083777,Staff,0,16,30,30
1650838998638,MATH 103A,A02,083778,Staff,0,15,30,30
1650838998638,MATH 103A,B01,083779,Staff,0,15,30,30
1650838998638,MATH 103A,B02,083780,Staff,1,15,30,29
1650839004662,MATH 105,A01,085443,Staff,0,22,30,30
1650839010690,MATH 109,A01,083213,Anzaldo; Leesa B,0,7,30,30
1650839010690,MATH 109,A02,083214,Anzaldo; Leesa B,0,7,30,30
1650839010690,MATH 109,B01,083215,Anzaldo; Leesa B,0,8,30,30
1650839010690,MATH 109,B02,083216,Anzaldo; Leesa B,0,7,30,30
1650839016714,MATH 142A,A01,083219,Chow; Bennett,0,16,30,30
1650839016714,MATH 142A,A02,083220,Chow; Bennett,0,15,30,30
1650839016714,MATH 142A,B01,083221,Chow; Bennett,0,16,30,30
1650839016714,MATH 142A,B02,083222,Chow; Bennett,0,14,30,30
1650839022747,MATH 193A,A01,083224,Staff,0,6,30,30
1650839022747,MATH 193A,A02,083225,Staff,0,6,30,30
1650839022747,MATH 193A,A03,083781,Staff,0,6,30,30
1650839022747,MATH 193A,A04,083782,Staff,0,7,30,30
1650839028773,MATH 197,001,091859,McAuley; Julian John,9998,0,9999,1
1650839034823,COGS 9,A01,083615,Staff,0,17,60,60
1650839040857,COGS 11,A01,083617,Boyle; Mary E. T.,15,0,40,25
1650839046882,COGS 13,A01,083071,Staff,0,38,40,40
1650839052911,COGS 14A,A01,092681,Staff,0,36,100,100
1650839058935,COGS 14B,A01,083073,Cheng; Tzu-Han,0,12,50,50
1650839064960,COGS 17,A01,092677,Staff,12,0,75,63
1650839070984,COGS 100,A01,083619,Staff,0,29,60,60
1650839077007,COGS 101A,A01,083621,Davis; Joshua Daniel,0,28,60,60
1650839083031,COGS 101B,A01,091572,Staff,0,3,60,60
1650839089059,COGS 101C,A01,083625,Delgado; Tania,14,0,30,16
1650839095082,COGS 107A,A01,083627,Boyle; Mary E. T.,0,16,60,60
1650839101113,COGS 118A,A01,083075,Staff,0,8,60,60
1650839107138,CSE 3,A50,083646,Miranda; Gregory Joseph,18,0,38,20
1650839107138,CSE 3,A51,083647,Miranda; Gregory Joseph,36,0,37,1
1650839113167,CSE 8A,A50,083650,Miranda; Gregory Joseph,0,29,40,40
1650839119190,CSE 11,A01,083080,Cao; Yingjun,0,96,40,40
1650839125218,CSE 12,A01,083652,Staff,0,21,100,100
1650839131244,CSE 15L,A01,083654,Staff,0,3,50,50
1650839131244,CSE 15L,A02,083655,Staff,0,2,50,50
1650839137267,CSE 20,A01,083657,Staff,49,0,80,31
1650839143292,CSE 30,A01,083084,Eldon; John,0,75,40,40
1650839149321,CSE 100,A01,083659,Cao; Yingjun,0,71,50,50
1650839155343,CSE 134B,A01,083661,Powell; Thomas Allan,0,38,65,65
1650839161383,CSE 140,A01,083663,Staff,0,11,75,75
1650839167405,CSE 140L,A01,083088,Eldon; John,0,20,75,75
1650839173429,CSE 175,A01,083665,Kumar; Rakesh,7,0,25,18
1650839179452,CSE 190,A00,092507,Dubnov; Shlomo,10,0,20,10
1650839185476,ECE 45,A01,083139,Staff,0,1,60,60
1650839191500,ECE 65,A50,083695,Staff,0,5,30,30
1650839197524,ECE 109,A01,091882,Touri; Behrouz,32,0,70,38
1650839203547,ECE 180,A00,083140,Abi Samra; Nicholas Camill,20,0,30,10
1650839203547,ECE 180,B00,083141,Abi Samra; Nicholas Camill,0,0,30,30
1650839209571,MATH 10A,A01,083735,Patchell; Gregory David,2,0,30,28
1650839209571,MATH 10A,A02,083736,Patchell; Gregory David,27,0,30,3
1650839209571,MATH 10A,A03,083737,Patchell; Gregory David,24,0,30,6
1650839215599,MATH 10B,A01,083207,Staff,0,9,30,30
1650839215599,MATH 10B,A02,083208,Staff,0,6,30,30
1650839215599,MATH 10B,B01,083739,Staff,11,0,30,19
1650839215599,MATH 10B,B02,083740,Staff,28,0,30,2
1650839221624,MATH 18,A01,083743,Staff,0,0,30,30
1650839221624,MATH 18,A02,083744,Staff,23,0,30,7
1650839221624,MATH 18,A03,083745,Staff,21,0,30,9
1650839221624,MATH 18,A04,083746,Staff,26,0,30,4
1650839221624,MATH 18,B01,083748,Staff,0,15,30,30
1650839221624,MATH 18,B02,083749,Staff,0,13,30,30
1650839221624,MATH 18,B03,083750,Staff,0,13,30,30
1650839221624,MATH 18,B04,083751,Staff,0,12,30,30
1650839227647,MATH 20A,A01,083754,Staff,19,0,40,21
1650839233675,MATH 20B,A01,083756,Staff,0,14,30,30
1650839233675,MATH 20B,A02,083757,Staff,0,12,30,30
1650839239701,MATH 20C,A01,083760,Staff,0,17,30,30
1650839239701,MATH 20C,A02,083761,Staff,0,16,30,30
1650839239701,MATH 20C,B01,083762,Staff,9,0,30,21
1650839239701,MATH 20C,B02,083763,Staff,28,0,30,2
1650839245724,MATH 20D,A01,083765,Staff,2,1,30,28
1650839245724,MATH 20D,A02,083766,Staff,6,0,30,24
1650839245724,MATH 20D,A03,083767,Staff,24,0,30,6
1650839251748,MATH 20E,A01,083771,Staff,2,0,30,28
1650839251748,MATH 20E,A02,083772,Staff,13,0,30,17
1650839251748,MATH 20E,B01,083773,Staff,0,0,30,30
1650839251748,MATH 20E,B02,083774,Staff,5,0,30,25
1650839257777,MATH 103A,A01,083777,Staff,0,16,30,30
1650839257777,MATH 103A,A02,083778,Staff,0,15,30,30
1650839257777,MATH 103A,B01,083779,Staff,0,15,30,30
1650839257777,MATH 103A,B02,083780,Staff,1,15,30,29
1650839263800,MATH 105,A01,085443,Staff,0,22,30,30
1650839269825,MATH 109,A01,083213,Anzaldo; Leesa B,0,7,30,30
1650839269825,MATH 109,A02,083214,Anzaldo; Leesa B,0,7,30,30
1650839269825,MATH 109,B01,083215,Anzaldo; Leesa B,0,8,30,30
1650839269825,MATH 109,B02,083216,Anzaldo; Leesa B,0,7,30,30
1650839275847,MATH 142A,A01,083219,Chow; Bennett,0,16,30,30
1650839275847,MATH 142A,A02,083220,Chow; Bennett,0,15,30,30
1650839275847,MATH 142A,B01,083221,Chow; Bennett,0,16,30,30
1650839275847,MATH 142A,B02,083222,Chow; Bennett,0,14,30,30
1650839281870,MATH 193A,A01,083224,Staff,0,6,30,30
1650839281870,MATH 193A,A02,083225,Staff,0,6,30,30
1650839281870,MATH 193A,A03,083781,Staff,0,6,30,30
1650839281870,MATH 193A,A04,083782,Staff,0,7,30,30
1650839287895,MATH 197,001,091859,McAuley; Julian John,9998,0,9999,1
1650839294033,COGS 9,A01,083615,Staff,0,17,60,60
1650839300059,COGS 11,A01,083617,Boyle; Mary E. T.,15,0,40,25
1650839306082,COGS 13,A01,083071,Staff,0,38,40,40
1650839312106,COGS 14A,A01,092681,Staff,0,36,100,100
1650839318129,COGS 14B,A01,083073,Cheng; Tzu-Han,0,12,50,50
1650839324151,COGS 17,A01,092677,Staff,12,0,75,63
1650839330175,COGS 100,A01,083619,Staff,0,29,60,60
1650839336197,COGS 101A,A01,083621,Davis; Joshua Daniel,0,28,60,60
1650839342222,COGS 101B,A01,091572,Staff,0,3,60,60
1650839348253,COGS 101C,A01,083625,Delgado; Tania,14,0,30,16
1650839354277,COGS 107A,A01,083627,Boyle; Mary E. T.,0,16,60,60
1650839360299,COGS 118A,A01,083075,Staff,0,8,60,60
1650839366325,CSE 3,A50,083646,Miranda; Gregory Joseph,18,0,38,20
1650839366325,CSE 3,A51,083647,Miranda; Gregory Joseph,36,0,37,1
1650839372359,CSE 8A,A50,083650,Miranda; Gregory Joseph,0,29,40,40
1650839378385,CSE 11,A01,083080,Cao; Yingjun,0,96,40,40
1650839384407,CSE 12,A01,083652,Staff,0,21,100,100
1650839390434,CSE 15L,A01,083654,Staff,0,3,50,50
1650839390434,CSE 15L,A02,083655,Staff,0,2,50,50
1650839396456,CSE 20,A01,083657,Staff,49,0,80,31
1650839402481,CSE 30,A01,083084,Eldon; John,0,75,40,40
1650839408504,CSE 100,A01,083659,Cao; Yingjun,0,71,50,50
1650839414529,CSE 134B,A01,083661,Powell; Thomas Allan,0,38,65,65
1650839420551,CSE 140,A01,083663,Staff,0,11,75,75
1650839426577,CSE 140L,A01,083088,Eldon; John,0,20,75,75
1650839432599,CSE 175,A01,083665,Kumar; Rakesh,7,0,25,18
1650839438619,CSE 190,A00,092507,Dubnov; Shlomo,10,0,20,10
1650839444645,ECE 45,A01,083139,Staff,0,1,60,60
1650839450669,ECE 65,A50,083695,Staff,0,5,30,30
1650839456691,ECE 109,A01,091882,Touri; Behrouz,32,0,70,38
1650839462713,ECE 180,A00,083140,Abi Samra; Nicholas Camill,20,0,30,10
1650839462713,ECE 180,B00,083141,Abi Samra; Nicholas Camill,0,0,30,30
1650839468736,MATH 10A,A01,083735,Patchell; Gregory David,2,0,30,28
1650839468736,MATH 10A,A02,083736,Patchell; Gregory David,27,0,30,3
1650839468736,MATH 10A,A03,083737,Patchell; Gregory David,24,0,30,6
1650839474762,MATH 10B,A01,083207,Staff,0,9,30,30
1650839474762,MATH 10B,A02,083208,Staff,0,6,30,30
1650839474762,MATH 10B,B01,083739,Staff,11,0,30,19
1650839474762,MATH 10B,B02,083740,Staff,28,0,30,2
1650839480795,MATH 18,A01,083743,Staff,0,0,30,30
1650839480795,MATH 18,A02,083744,Staff,23,0,30,7
1650839480795,MATH 18,A03,083745,Staff,21,0,30,9
1650839480795,MATH 18,A04,083746,Staff,26,0,30,4
1650839480795,MATH 18,B01,083748,Staff,0,15,30,30
1650839480795,MATH 18,B02,083749,Staff,0,13,30,30
1650839480795,MATH 18,B03,083750,Staff,0,13,30,30
1650839480795,MATH 18,B04,083751,Staff,0,12,30,30
1650839486818,MATH 20A,A01,083754,Staff,19,0,40,21
1650839492848,MATH 20B,A01,083756,Staff,0,14,30,30
1650839492848,MATH 20B,A02,083757,Staff,0,12,30,30
1650839498876,MATH 20C,A01,083760,Staff,0,17,30,30
1650839498876,MATH 20C,A02,083761,Staff,0,16,30,30
1650839498876,MATH 20C,B01,083762,Staff,9,0,30,21
1650839498876,MATH 20C,B02,083763,Staff,28,0,30,2
1650839504902,MATH 20D,A01,083765,Staff,2,1,30,28
1650839504902,MATH 20D,A02,083766,Staff,6,0,30,24
1650839504902,MATH 20D,A03,083767,Staff,24,0,30,6
1650839510928,MATH 20E,A01,083771,Staff,2,0,30,28
1650839510928,MATH 20E,A02,083772,Staff,13,0,30,17
1650839510928,MATH 20E,B01,083773,Staff,0,0,30,30
1650839510928,MATH 20E,B02,083774,Staff,5,0,30,25
1650839516974,MATH 103A,A01,083777,Staff,0,16,30,30
1650839516974,MATH 103A,A02,083778,Staff,0,15,30,30
1650839516974,MATH 103A,B01,083779,Staff,0,15,30,30
1650839516974,MATH 103A,B02,083780,Staff,1,15,30,29
1650839523001,MATH 105,A01,085443,Staff,0,22,30,30
1650839529024,MATH 109,A01,083213,Anzaldo; Leesa B,0,7,30,30
1650839529024,MATH 109,A02,083214,Anzaldo; Leesa B,0,7,30,30
1650839529024,MATH 109,B01,083215,Anzaldo; Leesa B,0,8,30,30
1650839529024,MATH 109,B02,083216,Anzaldo; Leesa B,0,7,30,30
1650839535131,MATH 142A,A01,083219,Chow; Bennett,0,16,30,30
1650839535131,MATH 142A,A02,083220,Chow; Bennett,0,15,30,30
1650839535131,MATH 142A,B01,083221,Chow; Bennett,0,16,30,30
1650839535131,MATH 142A,B02,083222,Chow; Bennett,0,14,30,30
1650839541159,MATH 193A,A01,083224,Staff,0,6,30,30
1650839541159,MATH 193A,A02,083225,Staff,0,6,30,30
1650839541159,MATH 193A,A03,083781,Staff,0,6,30,30
1650839541159,MATH 193A,A04,083782,Staff,0,7,30,30
1650839547182,MATH 197,001,091859,McAuley; Julian John,9998,0,9999,1
1650839553232,COGS 9,A01,083615,Staff,0,17,60,60
1650839559263,COGS 11,A01,083617,Boyle; Mary E. T.,15,0,40,25
1650839565290,COGS 13,A01,083071,Staff,0,38,40,40
1650839571314,COGS 14A,A01,092681,Staff,0,36,100,100
1650839577343,COGS 14B,A01,083073,Cheng; Tzu-Han,0,12,50,50
1650839583372,COGS 17,A01,092677,Staff,12,0,75,63
1650839589397,COGS 100,A01,083619,Staff,0,29,60,60
1650839595423,COGS 101A,A01,083621,Davis; Joshua Daniel,0,28,60,60
1650839601447,COGS 101B,A01,091572,Staff,0,3,60,60
1650839607472,COGS 101C,A01,083625,Delgado; Tania,14,0,30,16
1650839613499,COGS 107A,A01,083627,Boyle; Mary E. T.,0,16,60,60
1650839619521,COGS 118A,A01,083075,Staff,0,8,60,60
1650839625548,CSE 3,A50,083646,Miranda; Gregory Joseph,18,0,38,20
1650839625548,CSE 3,A51,083647,Miranda; Gregory Joseph,36,0,37,1
1650839631569,CSE 8A,A50,083650,Miranda; Gregory Joseph,0,29,40,40
1650839637592,CSE 11,A01,083080,Cao; Yingjun,0,96,40,40
1650839643620,CSE 12,A01,083652,Staff,0,21,100,100
1650839649643,CSE 15L,A01,083654,Staff,0,3,50,50
1650839649643,CSE 15L,A02,083655,Staff,0,2,50,50
1650839655679,CSE 20,A01,083657,Staff,49,0,80,31
1650839661711,CSE 30,A01,083084,Eldon; John,0,75,40,40
1650839667734,CSE 100,A01,083659,Cao; Yingjun,0,71,50,50
1650839673757,CSE 134B,A01,083661,Powell; Thomas Allan,0,38,65,65
1650839679779,CSE 140,A01,083663,Staff,0,11,75,75
1650839685809,CSE 140L,A01,083088,Eldon; John,0,20,75,75
1650839691830,CSE 175,A01,083665,Kumar; Rakesh,7,0,25,18
1650839697852,CSE 190,A00,092507,Dubnov; Shlomo,10,0,20,10
1650839703874,ECE 45,A01,083139,Staff,0,1,60,60
1650839709898,ECE 65,A50,083695,Staff,0,5,30,30
1650839715922,ECE 109,A01,091882,Touri; Behrouz,32,0,70,38
1650839721946,ECE 180,A00,083140,Abi Samra; Nicholas Camill,20,0,30,10
1650839721946,ECE 180,B00,083141,Abi Samra; Nicholas Camill,0,0,30,30
1650839727968,MATH 10A,A01,083735,Patchell; Gregory David,2,0,30,28
1650839727968,MATH 10A,A02,083736,Patchell; Gregory David,27,0,30,3
1650839727968,MATH 10A,A03,083737,Patchell; Gregory David,24,0,30,6
1650839733993,MATH 10B,A01,083207,Staff,0,9,30,30
1650839733993,MATH 10B,A02,083208,Staff,0,6,30,30
1650839733993,MATH 10B,B01,083739,Staff,11,0,30,19
1650839733993,MATH 10B,B02,083740,Staff,28,0,30,2
1650839740017,MATH 18,A01,083743,Staff,0,0,30,30
1650839740017,MATH 18,A02,083744,Staff,23,0,30,7
1650839740017,MATH 18,A03,083745,Staff,21,0,30,9
1650839740017,MATH 18,A04,083746,Staff,26,0,30,4
1650839740017,MATH 18,B01,083748,Staff,0,15,30,30
1650839740017,MATH 18,B02,083749,Staff,0,13,30,30
1650839740017,MATH 18,B03,083750,Staff,0,13,30,30
1650839740017,MATH 18,B04,083751,Staff,0,12,30,30
1650839746043,MATH 20A,A01,083754,Staff,19,0,40,21
1650839752066,MATH 20B,A01,083756,Staff,0,14,30,30
1650839752066,MATH 20B,A02,083757,Staff,0,12,30,30
1650839758088,MATH 20C,A01,083760,Staff,0,17,30,30
1650839758088,MATH 20C,A02,083761,Staff,0,16,30,30
1650839758088,MATH 20C,B01,083762,Staff,9,0,30,21
1650839758088,MATH 20C,B02,083763,Staff,28,0,30,2
1650839764111,MATH 20D,A01,083765,Staff,2,1,30,28
1650839764111,MATH 20D,A02,083766,Staff,6,0,30,24
1650839764111,MATH 20D,A03,083767,Staff,24,0,30,6
1650839770135,MATH 20E,A01,083771,Staff,2,0,30,28
1650839770135,MATH 20E,A02,083772,Staff,13,0,30,17
1650839770135,MATH 20E,B01,083773,Staff,0,0,30,30
1650839770135,MATH 20E,B02,083774,Staff,5,0,30,25
1650839776158,MATH 103A,A01,083777,Staff,0,16,30,30
1650839776158,MATH 103A,A02,083778,Staff,0,15,30,30
1650839776158,MATH 103A,B01,083779,Staff,0,15,30,30
1650839776158,MATH 103A,B02,083780,Staff,1,15,30,29
1650839782185,MATH 105,A01,085443,Staff,0,22,30,30
1650839788215,MATH 109,A01,083213,Anzaldo; Leesa B,0,7,30,30
1650839788215,MATH 109,A02,083214,Anzaldo; Leesa B,0,7,30,30
1650839788215,MATH 109,B01,083215,Anzaldo; Leesa B,0,8,30,30
1650839788215,MATH 109,B02,083216,Anzaldo; Leesa B,0,7,30,30
1650839794247,MATH 142A,A01,083219,Chow; Bennett,0,16,30,30
1650839794247,MATH 142A,A02,083220,Chow; Bennett,0,15,30,30
1650839794247,MATH 142A,B01,083221,Chow; Bennett,0,16,30,30
1650839794247,MATH 142A,B02,083222,Chow; Bennett,0,14,30,30
1650839800271,MATH 193A,A01,083224,Staff,0,6,30,30
1650839800271,MATH 193A,A02,083225,Staff,0,6,30,30
1650839800271,MATH 193A,A03,083781,Staff,0,6,30,30
1650839800271,MATH 193A,A04,083782,Staff,0,7,30,30
1650839806299,MATH 197,001,091859,McAuley; Julian John,9998,0,9999,1
1650839812359,COGS 9,A01,083615,Staff,0,17,60,60
1650839818385,COGS 11,A01,083617,Boyle; Mary E. T.,15,0,40,25
1650839824413,COGS 13,A01,083071,Staff,0,38,40,40
1650839830437,COGS 14A,A01,092681,Staff,0,36,100,100
1650839836459,COGS 14B,A01,083073,Cheng; Tzu-Han,0,12,50,50
1650839842483,COGS 17,A01,092677,Staff,12,0,75,63
1650839848504,COGS 100,A01,083619,Staff,0,29,60,60
1650839854534,COGS 101A,A01,083621,Davis; Joshua Daniel,0,28,60,60
1650839860559,COGS 101B,A01,091572,Staff,0,3,60,60
1650839866586,COGS 101C,A01,083625,Delgado; Tania,14,0,30,16
1650839872611,COGS 107A,A01,083627,Boyle; Mary E. T.,0,16,60,60
1650839878634,COGS 118A,A01,083075,Staff,0,8,60,60
1650839884658,CSE 3,A50,083646,Miranda; Gregory Joseph,18,0,38,20
1650839884658,CSE 3,A51,083647,Miranda; Gregory Joseph,36,0,37,1
1650839890775,CSE 8A,A50,083650,Miranda; Gregory Joseph,0,29,40,40
1650839896802,CSE 11,A01,083080,Cao; Yingjun,0,96,40,40
1650839902824,CSE 12,A01,083652,Staff,0,21,100,100
1650839908853,CSE 15L,A01,083654,Staff,0,3,50,50
1650839908853,CSE 15L,A02,083655,Staff,0,2,50,50
1650839914882,CSE 20,A01,083657,Staff,49,0,80,31
1650839920903,CSE 30,A01,083084,Eldon; John,0,75,40,40
1650839926926,CSE 100,A01,083659,Cao; Yingjun,0,71,50,50
1650839932951,CSE 134B,A01,083661,Powell; Thomas Allan,0,38,65,65
1650839938974,CSE 140,A01,083663,Staff,0,11,75,75
1650839945012,CSE 140L,A01,083088,Eldon; John,0,20,75,75
1650839951034,CSE 175,A01,083665,Kumar; Rakesh,7,0,25,18
1650839957060,CSE 190,A00,092507,Dubnov; Shlomo,10,0,20,10
1650839963085,ECE 45,A01,083139,Staff,0,1,60,60
1650839969108,ECE 65,A50,083695,Staff,0,5,30,30
1650839975132,ECE 109,A01,091882,Touri; Behrouz,32,0,70,38
1650839981154,ECE 180,A00,083140,Abi Samra; Nicholas Camill,20,0,30,10
1650839981154,ECE 180,B00,083141,Abi Samra; Nicholas Camill,0,0,30,30
1650839987178,MATH 10A,A01,083735,Patchell; Gregory David,2,0,30,28
1650839987178,MATH 10A,A02,083736,Patchell; Gregory David,27,0,30,3
1650839987178,MATH 10A,A03,083737,Patchell; Gregory David,24,0,30,6
1650839993203,MATH 10B,A01,083207,Staff,0,9,30,30
1650839993203,MATH 10B,A02,083208,Staff,0,6,30,30
1650839993203,MATH 10B,B01,083739,Staff,11,0,30,19
1650839993203,MATH 10B,B02,083740,Staff,28,0,30,2
1650839999228,MATH 18,A01,083743,Staff,0,0,30,30
1650839999228,MATH 18,A02,083744,Staff,23,0,30,7
1650839999228,MATH 18,A03,083745,Staff,21,0,30,9
1650839999228,MATH 18,A04,083746,Staff,26,0,30,4
1650839999228,MATH 18,B01,083748,Staff,0,15,30,30
1650839999228,MATH 18,B02,083749,Staff,0,13,30,30
1650839999228,MATH 18,B03,083750,Staff,0,13,30,30
1650839999228,MATH 18,B04,083751,Staff,0,12,30,30
1650840005250,MATH 20A,A01,083754,Staff,19,0,40,21
1650840011272,MATH 20B,A01,083756,Staff,0,14,30,30
1650840011272,MATH 20B,A02,083757,Staff,0,12,30,30
1650840017299,MATH 20C,A01,083760,Staff,0,17,30,30
1650840017299,MATH 20C,A02,083761,Staff,0,16,30,30
1650840017299,MATH 20C,B01,083762,Staff,9,0,30,21
1650840017299,MATH 20C,B02,083763,Staff,28,0,30,2
1650840023324,MATH 20D,A01,083765,Staff,2,1,30,28
1650840023324,MATH 20D,A02,083766,Staff,6,0,30,24
1650840023324,MATH 20D,A03,083767,Staff,24,0,30,6
1650840029350,MATH 20E,A01,083771,Staff,2,0,30,28
1650840029350,MATH 20E,A02,083772,Staff,13,0,30,17
1650840029350,MATH 20E,B01,083773,Staff,0,0,30,30
1650840029350,MATH 20E,B02,083774,Staff,5,0,30,25
1650840035385,MATH 103A,A01,083777,Staff,0,16,30,30
1650840035385,MATH 103A,A02,083778,Staff,0,15,30,30
1650840035385,MATH 103A,B01,083779,Staff,0,15,30,30
1650840035385,MATH 103A,B02,083780,Staff,1,15,30,29
1650840041418,MATH 105,A01,085443,Staff,0,22,30,30
1650840047441,MATH 109,A01,083213,Anzaldo; Leesa B,0,7,30,30
1650840047441,MATH 109,A02,083214,Anzaldo; Leesa B,0,7,30,30
1650840047441,MATH 109,B01,083215,Anzaldo; Leesa B,0,8,30,30
1650840047441,MATH 109,B02,083216,Anzaldo; Leesa B,0,7,30,30
1650840053468,MATH 142A,A01,083219,Chow; Bennett,0,16,30,30
1650840053468,MATH 142A,A02,083220,Chow; Bennett,0,15,30,30
1650840053468,MATH 142A,B01,083221,Chow; Bennett,0,16,30,30
1650840053468,MATH 142A,B02,083222,Chow; Bennett,0,14,30,30
1650840059492,MATH 193A,A01,083224,Staff,0,6,30,30
1650840059492,MATH 193A,A02,083225,Staff,0,6,30,30
1650840059492,MATH 193A,A03,083781,Staff,0,6,30,30
1650840059492,MATH 193A,A04,083782,Staff,0,7,30,30
1650840065514,MATH 197,001,091859,McAuley; Julian John,9998,0,9999,1
1650840071580,COGS 9,A01,083615,Staff,0,17,60,60
1650840077609,COGS 11,A01,083617,Boyle; Mary E. T.,15,0,40,25
1650840083631,COGS 13,A01,083071,Staff,0,38,40,40
1650840089656,COGS 14A,A01,092681,Staff,0,36,100,100
1650840095683,COGS 14B,A01,083073,Cheng; Tzu-Han,0,12,50,50
1650840101706,COGS 17,A01,092677,Staff,12,0,75,63
1650840107729,COGS 100,A01,083619,Staff,0,29,60,60
1650840113750,COGS 101A,A01,083621,Davis; Joshua Daniel,0,28,60,60
1650840119781,COGS 101B,A01,091572,Staff,0,3,60,60
1650840125814,COGS 101C,A01,083625,Delgado; Tania,14,0,30,16
1650840131844,COGS 107A,A01,083627,Boyle; Mary E. T.,0,16,60,60
1650840137868,COGS 118A,A01,083075,Staff,0,8,60,60
1650840143891,CSE 3,A50,083646,Miranda; Gregory Joseph,18,0,38,20
1650840143891,CSE 3,A51,083647,Miranda; Gregory Joseph,36,0,37,1
1650840149916,CSE 8A,A50,083650,Miranda; Gregory Joseph,0,29,40,40
1650840155946,CSE 11,A01,083080,Cao; Yingjun,0,96,40,40
1650840161972,CSE 12,A01,083652,Staff,0,21,100,100
1650840167998,CSE 15L,A01,083654,Staff,0,3,50,50
1650840167998,CSE 15L,A02,083655,Staff,0,2,50,50
1650840174022,CSE 20,A01,083657,Staff,49,0,80,31
1650840180045,CSE 30,A01,083084,Eldon; John,0,75,40,40
1650840186079,CSE 100,A01,083659,Cao; Yingjun,0,71,50,50
1650840192102,CSE 134B,A01,083661,Powell; Thomas Allan,0,38,65,65
1650840198128,CSE 140,A01,083663,Staff,0,11,75,75
1650840204151,CSE 140L,A01,083088,Eldon; John,0,20,75,75
1650840210173,CSE 175,A01,083665,Kumar; Rakesh,7,0,25,18
1650840216198,CSE 190,A00,092507,Dubnov; Shlomo,10,0,20,10
1650840222219,ECE 45,A01,083139,Staff,0,1,60,60
1650840228241,ECE 65,A50,083695,Staff,0,5,30,30
1650840234265,ECE 109,A01,091882,Touri; Behrouz,32,0,70,38
1650840240288,ECE 180,A00,083140,Abi Samra; Nicholas Camill,20,0,30,10
1650840240288,ECE 180,B00,083141,Abi Samra; Nicholas Camill,0,0,30,30
1650840246311,MATH 10A,A01,083735,Patchell; Gregory David,2,0,30,28
1650840246311,MATH 10A,A02,083736,Patchell; Gregory David,27,0,30,3
1650840246311,MATH 10A,A03,083737,Patchell; Gregory David,24,0,30,6
1650840252342,MATH 10B,A01,083207,Staff,0,9,30,30
1650840252342,MATH 10B,A02,083208,Staff,0,6,30,30
1650840252342,MATH 10B,B01,083739,Staff,11,0,30,19
1650840252342,MATH 10B,B02,083740,Staff,28,0,30,2
1650840258384,MATH 18,A01,083743,Staff,0,0,30,30
1650840258384,MATH 18,A02,083744,Staff,23,0,30,7
1650840258384,MATH 18,A03,083745,Staff,21,0,30,9
1650840258384,MATH 18,A04,083746,Staff,26,0,30,4
1650840258384,MATH 18,B01,083748,Staff,0,15,30,30
1650840258384,MATH 18,B02,083749,Staff,0,13,30,30
1650840258384,MATH 18,B03,083750,Staff,0,13,30,30
1650840258384,MATH 18,B04,083751,Staff,0,12,30,30
1650840264410,MATH 20A,A01,083754,Staff,19,0,40,21
1650840270439,MATH 20B,A01,083756,Staff,0,14,30,30
1650840270439,MATH 20B,A02,083757,Staff,0,12,30,30
1650840276463,MATH 20C,A01,083760,Staff,0,17,30,30
1650840276463,MATH 20C,A02,083761,Staff,0,16,30,30
1650840276463,MATH 20C,B01,083762,Staff,9,0,30,21
1650840276463,MATH 20C,B02,083763,Staff,28,0,30,2
1650840282486,MATH 20D,A01,083765,Staff,2,1,30,28
1650840282486,MATH 20D,A02,083766,Staff,6,0,30,24
1650840282486,MATH 20D,A03,083767,Staff,24,0,30,6
1650840288509,MATH 20E,A01,083771,Staff,2,0,30,28
1650840288509,MATH 20E,A02,083772,Staff,13,0,30,17
1650840288509,MATH 20E,B01,083773,Staff,0,0,30,30
1650840288509,MATH 20E,B02,083774,Staff,5,0,30,25
1650840294532,MATH 103A,A01,083777,Staff,0,16,30,30
1650840294532,MATH 103A,A02,083778,Staff,0,15,30,30
1650840294532,MATH 103A,B01,083779,Staff,0,15,30,30
1650840294532,MATH 103A,B02,083780,Staff,1,15,30,29
1650840300560,MATH 105,A01,085443,Staff,0,22,30,30
1650840306584,MATH 109,A01,083213,Anzaldo; Leesa B,0,7,30,30
1650840306584,MATH 109,A02,083214,Anzaldo; Leesa B,0,7,30,30
1650840306584,MATH 109,B01,083215,Anzaldo; Leesa B,0,8,30,30
1650840306584,MATH 109,B02,083216,Anzaldo; Leesa B,0,7,30,30
1650840312612,MATH 142A,A01,083219,Chow; Bennett,0,16,30,30
1650840312612,MATH 142A,A02,083220,Chow; Bennett,0,15,30,30
1650840312612,MATH 142A,B01,083221,Chow; Bennett,0,16,30,30
1650840312612,MATH 142A,B02,083222,Chow; Bennett,0,14,30,30
1650840318635,MATH 193A,A01,083224,Staff,0,6,30,30
1650840318635,MATH 193A,A02,083225,Staff,0,6,30,30
1650840318635,MATH 193A,A03,083781,Staff,0,6,30,30
1650840318635,MATH 193A,A04,083782,Staff,0,7,30,30
1650840324658,MATH 197,001,091859,McAuley; Julian John,9998,0,9999,1
1650840330712,COGS 9,A01,083615,Staff,0,17,60,60
1650840336736,COGS 11,A01,083617,Boyle; Mary E. T.,15,0,40,25
1650840342762,COGS 13,A01,083071,Staff,0,38,40,40
1650840348785,COGS 14A,A01,092681,Staff,0,36,100,100
1650840354817,COGS 14B,A01,083073,Cheng; Tzu-Han,0,12,50,50
1650840360841,COGS 17,A01,092677,Staff,12,0,75,63
1650840366865,COGS 100,A01,083619,Staff,0,29,60,60
1650840372891,COGS 101A,A01,083621,Davis; Joshua Daniel,0,28,60,60
1650840378913,COGS 101B,A01,091572,Staff,0,3,60,60
1650840384944,COGS 101C,A01,083625,Delgado; Tania,14,0,30,16
1650840390967,COGS 107A,A01,083627,Boyle; Mary E. T.,0,16,60,60
1650840396994,COGS 118A,A01,083075,Staff,0,8,60,60
1650840403016,CSE 3,A50,083646,Miranda; Gregory Joseph,18,0,38,20
1650840403016,CSE 3,A51,083647,Miranda; Gregory Joseph,36,0,37,1
1650840409038,CSE 8A,A50,083650,Miranda; Gregory Joseph,0,29,40,40
1650840415060,CSE 11,A01,083080,Cao; Yingjun,0,96,40,40
1650840421083,CSE 12,A01,083652,Staff,0,21,100,100
1650840427108,CSE 15L,A01,083654,Staff,0,3,50,50
1650840427108,CSE 15L,A02,083655,Staff,0,2,50,50
1650840433151,CSE 20,A01,083657,Staff,49,0,80,31
1650840439173,CSE 30,A01,083084,Eldon; John,0,75,40,40
1650840445195,CSE 100,A01,083659,Cao; Yingjun,0,71,50,50
1650840451219,CSE 134B,A01,083661,Powell; Thomas Allan,0,38,65,65
1650840457248,CSE 140,A01,083663,Staff,0,11,75,75
1650840463269,CSE 140L,A01,083088,Eldon; John,0,20,75,75
1650840469294,CSE 175,A01,083665,Kumar; Rakesh,7,0,25,18
1650840475316,CSE 190,A00,092507,Dubnov; Shlomo,10,0,20,10
1650840481344,ECE 45,A01,083139,Staff,0,1,60,60
1650840487474,ECE 65,A50,083695,Staff,0,5,30,30
1650840493498,ECE 109,A01,091882,Touri; Behrouz,32,0,70,38
1650840499525,ECE 180,A00,083140,Abi Samra; Nicholas Camill,20,0,30,10
1650840499525,ECE 180,B00,083141,Abi Samra; Nicholas Camill,0,0,30,30
1650840505558,MATH 10A,A01,083735,Patchell; Gregory David,2,0,30,28
1650840505558,MATH 10A,A02,083736,Patchell; Gregory David,27,0,30,3
1650840505558,MATH 10A,A03,083737,Patchell; Gregory David,24,0,30,6
1650840511581,MATH 10B,A01,083207,Staff,0,9,30,30
1650840511581,MATH 10B,A02,083208,Staff,0,6,30,30
1650840511581,MATH 10B,B01,083739,Staff,11,0,30,19
1650840511581,MATH 10B,B02,083740,Staff,28,0,30,2
1650840517606,MATH 18,A01,083743,Staff,0,0,30,30
1650840517606,MATH 18,A02,083744,Staff,23,0,30,7
1650840517606,MATH 18,A03,083745,Staff,21,0,30,9
1650840517606,MATH 18,A04,083746,Staff,26,0,30,4
1650840517606,MATH 18,B01,083748,Staff,0,15,30,30
1650840517606,MATH 18,B02,083749,Staff,0,13,30,30
1650840517606,MATH 18,B03,083750,Staff,0,13,30,30
1650840517606,MATH 18,B04,083751,Staff,0,12,30,30
1650840523635,MATH 20A,A01,083754,Staff,19,0,40,21
1650840529662,MATH 20B,A01,083756,Staff,0,14,30,30
1650840529662,MATH 20B,A02,083757,Staff,0,12,30,30
1650840535686,MATH 20C,A01,083760,Staff,0,17,30,30
1650840535686,MATH 20C,A02,083761,Staff,0,16,30,30
1650840535686,MATH 20C,B01,083762,Staff,9,0,30,21
1650840535686,MATH 20C,B02,083763,Staff,28,0,30,2
1650840541715,MATH 20D,A01,083765,Staff,2,1,30,28
1650840541715,MATH 20D,A02,083766,Staff,6,0,30,24
1650840541715,MATH 20D,A03,083767,Staff,24,0,30,6
1650840547741,MATH 20E,A01,083771,Staff,2,0,30,28
1650840547741,MATH 20E,A02,083772,Staff,13,0,30,17
1650840547741,MATH 20E,B01,083773,Staff,0,0,30,30
1650840547741,MATH 20E,B02,083774,Staff,5,0,30,25
1650840553764,MATH 103A,A01,083777,Staff,0,16,30,30
1650840553764,MATH 103A,A02,083778,Staff,0,15,30,30
1650840553764,MATH 103A,B01,083779,Staff,0,15,30,30
1650840553764,MATH 103A,B02,083780,Staff,1,15,30,29
1650840559788,MATH 105,A01,085443,Staff,0,22,30,30
1650840565817,MATH 109,A01,083213,Anzaldo; Leesa B,0,7,30,30
1650840565817,MATH 109,A02,083214,Anzaldo; Leesa B,0,7,30,30
1650840565817,MATH 109,B01,083215,Anzaldo; Leesa B,0,8,30,30
1650840565817,MATH 109,B02,083216,Anzaldo; Leesa B,0,7,30,30
1650840571845,MATH 142A,A01,083219,Chow; Bennett,0,16,30,30
1650840571845,MATH 142A,A02,083220,Chow; Bennett,0,15,30,30
1650840571845,MATH 142A,B01,083221,Chow; Bennett,0,16,30,30
1650840571845,MATH 142A,B02,083222,Chow; Bennett,0,14,30,30
1650840577870,MATH 193A,A01,083224,Staff,0,6,30,30
1650840577870,MATH 193A,A02,083225,Staff,0,6,30,30
1650840577870,MATH 193A,A03,083781,Staff,0,6,30,30
1650840577870,MATH 193A,A04,083782,Staff,0,7,30,30
1650840583895,MATH 197,001,091859,McAuley; Julian John,9998,0,9999,1
1650840589952,COGS 9,A01,083615,Staff,0,17,60,60
1650840595974,COGS 11,A01,083617,Boyle; Mary E. T.,15,0,40,25
1650840601999,COGS 13,A01,083071,Staff,0,38,40,40
1650840608033,COGS 14A,A01,092681,Staff,0,36,100,100
1650840614058,COGS 14B,A01,083073,Cheng; Tzu-Han,0,12,50,50
1650840620082,COGS 17,A01,092677,Staff,12,0,75,63
1650840626106,COGS 100,A01,083619,Staff,0,29,60,60
1650840632129,COGS 101A,A01,083621,Davis; Joshua Daniel,0,28,60,60
1650840638153,COGS 101B,A01,091572,Staff,0,3,60,60
1650840644180,COGS 101C,A01,083625,Delgado; Tania,14,0,30,16
1650840650206,COGS 107A,A01,083627,Boyle; Mary E. T.,0,16,60,60
1650840656240,COGS 118A,A01,083075,Staff,0,8,60,60
1650840662278,CSE 3,A50,083646,Miranda; Gregory Joseph,18,0,38,20
1650840662278,CSE 3,A51,083647,Miranda; Gregory Joseph,36,0,37,1
1650840668303,CSE 8A,A50,083650,Miranda; Gregory Joseph,0,29,40,40
1650840674326,CSE 11,A01,083080,Cao; Yingjun,0,96,40,40
1650840680365,CSE 12,A01,083652,Staff,0,21,100,100
1650840686388,CSE 15L,A01,083654,Staff,0,3,50,50
1650840686388,CSE 15L,A02,083655,Staff,0,2,50,50
1650840692425,CSE 20,A01,083657,Staff,49,0,80,31
1650840698451,CSE 30,A01,083084,Eldon; John,0,75,40,40
1650840704478,CSE 100,A01,083659,Cao; Yingjun,0,71,50,50
1650840710500,CSE 134B,A01,083661,Powell; Thomas Allan,0,38,65,65
1650840716528,CSE 140,A01,083663,Staff,0,11,75,75
1650840722551,CSE 140L,A01,083088,Eldon; John,0,20,75,75
1650840728584,CSE 175,A01,083665,Kumar; Rakesh,7,0,25,18
1650840734612,CSE 190,A00,092507,Dubnov; Shlomo,10,0,20,10
1650840740643,ECE 45,A01,083139,Staff,0,1,60,60
1650840746666,ECE 65,A50,083695,Staff,0,5,30,30
1650840752692,ECE 109,A01,091882,Touri; Behrouz,32,0,70,38
1650840758715,ECE 180,A00,083140,Abi Samra; Nicholas Camill,20,0,30,10
1650840758715,ECE 180,B00,083141,Abi Samra; Nicholas Camill,0,0,30,30
1650840764751,MATH 10A,A01,083735,Patchell; Gregory David,2,0,30,28
1650840764751,MATH 10A,A02,083736,Patchell; Gregory David,27,0,30,3
1650840764751,MATH 10A,A03,083737,Patchell; Gregory David,24,0,30,6
1650840770776,MATH 10B,A01,083207,Staff,0,9,30,30
1650840770776,MATH 10B,A02,083208,Staff,0,6,30,30
1650840770776,MATH 10B,B01,083739,Staff,11,0,30,19
1650840770776,MATH 10B,B02,083740,Staff,28,0,30,2
1650840776802,MATH 18,A01,083743,Staff,0,0,30,30
1650840776802,MATH 18,A02,083744,Staff,23,0,30,7
1650840776802,MATH 18,A03,083745,Staff,21,0,30,9
1650840776802,MATH 18,A04,083746,Staff,26,0,30,4
1650840776802,MATH 18,B01,083748,Staff,0,15,30,30
1650840776802,MATH 18,B02,083749,Staff,0,13,30,30
1650840776802,MATH 18,B03,083750,Staff,0,13,30,30
1650840776802,MATH 18,B04,083751,Staff,0,12,30,30
1650840782827,MATH 20A,A01,083754,Staff,19,0,40,21
1650840788851,MATH 20B,A01,083756,Staff,0,14,30,30
1650840788851,MATH 20B,A02,083757,Staff,0,12,30,30
1650840794882,MATH 20C,A01,083760,Staff,0,17,30,30
1650840794882,MATH 20C,A02,083761,Staff,0,16,30,30
1650840794882,MATH 20C,B01,083762,Staff,9,0,30,21
1650840794882,MATH 20C,B02,083763,Staff,28,0,30,2
1650840800908,MATH 20D,A01,083765,Staff,2,1,30,28
1650840800908,MATH 20D,A02,083766,Staff,6,0,30,24
1650840800908,MATH 20D,A03,083767,Staff,24,0,30,6
1650840806942,MATH 20E,A01,083771,Staff,2,0,30,28
1650840806942,MATH 20E,A02,083772,Staff,13,0,30,17
1650840806942,MATH 20E,B01,083773,Staff,0,0,30,30
1650840806942,MATH 20E,B02,083774,Staff,5,0,30,25
1650840812972,MATH 103A,A01,083777,Staff,0,16,30,30
1650840812972,MATH 103A,A02,083778,Staff,0,15,30,30
1650840812972,MATH 103A,B01,083779,Staff,0,15,30,30
1650840812972,MATH 103A,B02,083780,Staff,1,15,30,29
1650840818999,MATH 105,A01,085443,Staff,0,22,30,30
1650840825022,MATH 109,A01,083213,Anzaldo; Leesa B,0,7,30,30
1650840825022,MATH 109,A02,083214,Anzaldo; Leesa B,0,7,30,30
1650840825022,MATH 109,B01,083215,Anzaldo; Leesa B,0,8,30,30
1650840825022,MATH 109,B02,083216,Anzaldo; Leesa B,0,7,30,30
1650840831050,MATH 142A,A01,083219,Chow; Bennett,0,16,30,30
1650840831050,MATH 142A,A02,083220,Chow; Bennett,0,15,30,30
1650840831050,MATH 142A,B01,083221,Chow; Bennett,0,16,30,30
1650840831050,MATH 142A,B02,083222,Chow; Bennett,0,14,30,30
1650840837073,MATH 193A,A01,083224,Staff,0,6,30,30
1650840837073,MATH 193A,A02,083225,Staff,0,6,30,30
1650840837073,MATH 193A,A03,083781,Staff,0,6,30,30
1650840837073,MATH 193A,A04,083782,Staff,0,7,30,30
1650840843094,MATH 197,001,091859,McAuley; Julian John,9998,0,9999,1
1650840849164,COGS 9,A01,083615,Staff,0,17,60,60
1650840855216,COGS 11,A01,083617,Boyle; Mary E. T.,15,0,40,25
1650840861240,COGS 13,A01,083071,Staff,0,38,40,40
1650840867268,COGS 14A,A01,092681,Staff,0,36,100,100
1650840873308,COGS 14B,A01,083073,Cheng; Tzu-Han,0,12,50,50
1650840879331,COGS 17,A01,092677,Staff,12,0,75,63
1650840885367,COGS 100,A01,083619,Staff,0,29,60,60
1650840891394,COGS 101A,A01,083621,Davis; Joshua Daniel,0,28,60,60
1650840897429,COGS 101B,A01,091572,Staff,0,3,60,60
1650840903453,COGS 101C,A01,083625,Delgado; Tania,14,0,30,16
1650840909482,COGS 107A,A01,083627,Boyle; Mary E. T.,0,16,60,60
1650840915511,COGS 118A,A01,083075,Staff,0,8,60,60
1650840921538,CSE 3,A50,083646,Miranda; Gregory Joseph,18,0,38,20
1650840921538,CSE 3,A51,083647,Miranda; Gregory Joseph,36,0,37,1
1650840927561,CSE 8A,A50,083650,Miranda; Gregory Joseph,0,29,40,40
1650840933589,CSE 11,A01,083080,Cao; Yingjun,0,96,40,40
1650840939613,CSE 12,A01,083652,Staff,0,21,100,100
1650840945635,CSE 15L,A01,083654,Staff,0,3,50,50
1650840945635,CSE 15L,A02,083655,Staff,0,2,50,50
1650840951658,CSE 20,A01,083657,Staff,49,0,80,31
1650840957681,CSE 30,A01,083084,Eldon; John,0,75,40,40
1650840963705,CSE 100,A01,083659,Cao; Yingjun,0,71,50,50
1650840969727,CSE 134B,A01,083661,Powell; Thomas Allan,0,38,65,65
1650840975751,CSE 140,A01,083663,Staff,0,11,75,75
1650840981787,CSE 140L,A01,083088,Eldon; John,0,20,75,75
1650840987810,CSE 175,A01,083665,Kumar; Rakesh,7,0,25,18
1650840993849,CSE 190,A00,092507,Dubnov; Shlomo,10,0,20,10
1650840999872,ECE 45,A01,083139,Staff,0,1,60,60
1650841005896,ECE 65,A50,083695,Staff,0,5,30,30
1650841011919,ECE 109,A01,091882,Touri; Behrouz,32,0,70,38
1650841017946,ECE 180,A00,083140,Abi Samra; Nicholas Camill,20,0,30,10
1650841017946,ECE 180,B00,083141,Abi Samra; Nicholas Camill,0,0,30,30
1650841023970,MATH 10A,A01,083735,Patchell; Gregory David,2,0,30,28
1650841023970,MATH 10A,A02,083736,Patchell; Gregory David,27,0,30,3
1650841023970,MATH 10A,A03,083737,Patchell; Gregory David,24,0,30,6
1650841029998,MATH 10B,A01,083207,Staff,0,9,30,30
1650841029998,MATH 10B,A02,083208,Staff,0,6,30,30
1650841029998,MATH 10B,B01,083739,Staff,11,0,30,19
1650841029998,MATH 10B,B02,083740,Staff,28,0,30,2
1650841036022,MATH 18,A01,083743,Staff,0,0,30,30
1650841036022,MATH 18,A02,083744,Staff,23,0,30,7
1650841036022,MATH 18,A03,083745,Staff,21,0,30,9
1650841036022,MATH 18,A04,083746,Staff,26,0,30,4
1650841036022,MATH 18,B01,083748,Staff,0,15,30,30
1650841036022,MATH 18,B02,083749,Staff,0,13,30,30
1650841036022,MATH 18,B03,083750,Staff,0,13,30,30
1650841036022,MATH 18,B04,083751,Staff,0,12,30,30
1650841042048,MATH 20A,A01,083754,Staff,19,0,40,21
1650841048085,MATH 20B,A01,083756,Staff,0,14,30,30
1650841048085,MATH 20B,A02,083757,Staff,0,12,30,30
1650841054112,MATH 20C,A01,083760,Staff,0,17,30,30
1650841054112,MATH 20C,A02,083761,Staff,0,16,30,30
1650841054112,MATH 20C,B01,083762,Staff,9,0,30,21
1650841054112,MATH 20C,B02,083763,Staff,28,0,30,2
1650841060139,MATH 20D,A01,083765,Staff,2,1,30,28
1650841060139,MATH 20D,A02,083766,Staff,6,0,30,24
1650841060139,MATH 20D,A03,083767,Staff,24,0,30,6
1650841066167,MATH 20E,A01,083771,Staff,2,0,30,28
1650841066167,MATH 20E,A02,083772,Staff,13,0,30,17
1650841066167,MATH 20E,B01,083773,Staff,0,0,30,30
1650841066167,MATH 20E,B02,083774,Staff,5,0,30,25
1650841072191,MATH 103A,A01,083777,Staff,0,16,30,30
1650841072191,MATH 103A,A02,083778,Staff,0,15,30,30
1650841072191,MATH 103A,B01,083779,Staff,0,15,30,30
1650841072191,MATH 103A,B02,083780,Staff,1,15,30,29
1650841078218,MATH 105,A01,085443,Staff,0,22,30,30
1650841084332,MATH 109,A01,083213,Anzaldo; Leesa B,0,7,30,30
1650841084332,MATH 109,A02,083214,Anzaldo; Leesa B,0,7,30,30
1650841084332,MATH 109,B01,083215,Anzaldo; Leesa B,0,8,30,30
1650841084332,MATH 109,B02,083216,Anzaldo; Leesa B,0,7,30,30
1650841090355,MATH 142A,A01,083219,Chow; Bennett,0,16,30,30
1650841090355,MATH 142A,A02,083220,Chow; Bennett,0,15,30,30
1650841090355,MATH 142A,B01,083221,Chow; Bennett,0,16,30,30
1650841090355,MATH 142A,B02,083222,Chow; Bennett,0,14,30,30
1650841096381,MATH 193A,A01,083224,Staff,0,6,30,30
1650841096381,MATH 193A,A02,083225,Staff,0,6,30,30
1650841096381,MATH 193A,A03,083781,Staff,0,6,30,30
1650841096381,MATH 193A,A04,083782,Staff,0,7,30,30
1650841102403,MATH 197,001,091859,McAuley; Julian John,9998,0,9999,1
1650841108458,COGS 9,A01,083615,Staff,0,17,60,60
1650841114489,COGS 11,A01,083617,Boyle; Mary E. T.,15,0,40,25
1650841120515,COGS 13,A01,083071,Staff,0,38,40,40
1650841126551,COGS 14A,A01,092681,Staff,0,36,100,100
1650841132575,COGS 14B,A01,083073,Cheng; Tzu-Han,0,12,50,50
1650841138603,COGS 17,A01,092677,Staff,12,0,75,63
1650841144627,COGS 100,A01,083619,Staff,0,29,60,60
1650841150666,COGS 101A,A01,083621,Davis; Joshua Daniel,0,28,60,60
1650841156692,COGS 101B,A01,091572,Staff,0,3,60,60
1650841162715,COGS 101C,A01,083625,Delgado; Tania,14,0,30,16
1650841168739,COGS 107A,A01,083627,Boyle; Mary E. T.,0,16,60,60
1650841174762,COGS 118A,A01,083075,Staff,0,8,60,60
1650841180785,CSE 3,A50,083646,Miranda; Gregory Joseph,18,0,38,20
1650841180785,CSE 3,A51,083647,Miranda; Gregory Joseph,36,0,37,1
1650841186809,CSE 8A,A50,083650,Miranda; Gregory Joseph,0,29,40,40
1650841192832,CSE 11,A01,083080,Cao; Yingjun,0,96,40,40
1650841198863,CSE 12,A01,083652,Staff,0,21,100,100
1650841204886,CSE 15L,A01,083654,Staff,0,3,50,50
1650841204886,CSE 15L,A02,083655,Staff,0,2,50,50
1650841210909,CSE 20,A01,083657,Staff,49,0,80,31
1650841216936,CSE 30,A01,083084,Eldon; John,0,76,40,40
1650841222965,CSE 100,A01,083659,Cao; Yingjun,0,71,50,50
1650841228987,CSE 134B,A01,083661,Powell; Thomas Allan,0,38,65,65
1650841235014,CSE 140,A01,083663,Staff,0,11,75,75
1650841241048,CSE 140L,A01,083088,Eldon; John,0,20,75,75
1650841247071,CSE 175,A01,083665,Kumar; Rakesh,7,0,25,18
1650841253095,CSE 190,A00,092507,Dubnov; Shlomo,10,0,20,10
1650841259125,ECE 45,A01,083139,Staff,0,1,60,60
1650841265153,ECE 65,A50,083695,Staff,0,5,30,30
1650841271177,ECE 109,A01,091882,Touri; Behrouz,32,0,70,38
1650841277211,ECE 180,A00,083140,Abi Samra; Nicholas Camill,20,0,30,10
1650841277211,ECE 180,B00,083141,Abi Samra; Nicholas Camill,0,0,30,30
1650841283238,MATH 10A,A01,083735,Patchell; Gregory David,2,0,30,28
1650841283238,MATH 10A,A02,083736,Patchell; Gregory David,27,0,30,3
1650841283238,MATH 10A,A03,083737,Patchell; Gregory David,24,0,30,6
1650841289261,MATH 10B,A01,083207,Staff,0,9,30,30
1650841289261,MATH 10B,A02,083208,Staff,0,6,30,30
1650841289261,MATH 10B,B01,083739,Staff,11,0,30,19
1650841289261,MATH 10B,B02,083740,Staff,28,0,30,2
1650841295287,MATH 18,A01,083743,Staff,0,0,30,30
1650841295287,MATH 18,A02,083744,Staff,23,0,30,7
1650841295287,MATH 18,A03,083745,Staff,21,0,30,9
1650841295287,MATH 18,A04,083746,Staff,26,0,30,4
1650841295287,MATH 18,B01,083748,Staff,0,15,30,30
1650841295287,MATH 18,B02,083749,Staff,0,13,30,30
1650841295287,MATH 18,B03,083750,Staff,0,13,30,30
1650841295287,MATH 18,B04,083751,Staff,0,12,30,30
1650841301310,MATH 20A,A01,083754,Staff,19,0,40,21
1650841307337,MATH 20B,A01,083756,Staff,0,14,30,30
1650841307337,MATH 20B,A02,083757,Staff,0,12,30,30
1650841313360,MATH 20C,A01,083760,Staff,0,17,30,30
1650841313360,MATH 20C,A02,083761,Staff,0,16,30,30
1650841313360,MATH 20C,B01,083762,Staff,9,0,30,21
1650841313360,MATH 20C,B02,083763,Staff,28,0,30,2
1650841319384,MATH 20D,A01,083765,Staff,2,1,30,28
1650841319384,MATH 20D,A02,083766,Staff,6,0,30,24
1650841319384,MATH 20D,A03,083767,Staff,24,0,30,6
1650841325412,MATH 20E,A01,083771,Staff,2,0,30,28
1650841325412,MATH 20E,A02,083772,Staff,13,0,30,17
1650841325412,MATH 20E,B01,083773,Staff,0,0,30,30
1650841325412,MATH 20E,B02,083774,Staff,5,0,30,25
1650841331451,MATH 103A,A01,083777,Staff,0,16,30,30
1650841331451,MATH 103A,A02,083778,Staff,0,15,30,30
1650841331451,MATH 103A,B01,083779,Staff,0,15,30,30
1650841331451,MATH 103A,B02,083780,Staff,1,15,30,29
1650841337473,MATH 105,A01,085443,Staff,0,22,30,30
1650841343496,MATH 109,A01,083213,Anzaldo; Leesa B,0,7,30,30
1650841343496,MATH 109,A02,083214,Anzaldo; Leesa B,0,7,30,30
1650841343496,MATH 109,B01,083215,Anzaldo; Leesa B,0,8,30,30
1650841343496,MATH 109,B02,083216,Anzaldo; Leesa B,0,7,30,30
1650841349523,MATH 142A,A01,083219,Chow; Bennett,0,16,30,30
1650841349523,MATH 142A,A02,083220,Chow; Bennett,0,15,30,30
1650841349523,MATH 142A,B01,083221,Chow; Bennett,0,16,30,30
1650841349523,MATH 142A,B02,083222,Chow; Bennett,0,14,30,30
1650841355547,MATH 193A,A01,083224,Staff,0,6,30,30
1650841355547,MATH 193A,A02,083225,Staff,0,6,30,30
1650841355547,MATH 193A,A03,083781,Staff,0,6,30,30
1650841355547,MATH 193A,A04,083782,Staff,0,7,30,30
1650841361572,MATH 197,001,091859,McAuley; Julian John,9998,0,9999,1
1650841367626,COGS 9,A01,083615,Staff,0,17,60,60
1650841373651,COGS 11,A01,083617,Boyle; Mary E. T.,15,0,40,25
1650841379676,COGS 13,A01,083071,Staff,0,38,40,40
1650841385702,COGS 14A,A01,092681,Staff,0,36,100,100
1650841391729,COGS 14B,A01,083073,Cheng; Tzu-Han,0,12,50,50
1650841397756,COGS 17,A01,092677,Staff,12,0,75,63
1650841403786,COGS 100,A01,083619,Staff,0,29,60,60
1650841409809,COGS 101A,A01,083621,Davis; Joshua Daniel,0,28,60,60
1650841415833,COGS 101B,A01,091572,Staff,0,3,60,60
1650841421857,COGS 101C,A01,083625,Delgado; Tania,14,0,30,16
1650841427885,COGS 107A,A01,083627,Boyle; Mary E. T.,0,16,60,60
1650841433911,COGS 118A,A01,083075,Staff,0,8,60,60
1650841439934,CSE 3,A50,083646,Miranda; Gregory Joseph,18,0,38,20
1650841439934,CSE 3,A51,083647,Miranda; Gregory Joseph,36,0,37,1
1650841445957,CSE 8A,A50,083650,Miranda; Gregory Joseph,0,29,40,40
1650841451983,CSE 11,A01,083080,Cao; Yingjun,0,96,40,40
1650841458014,CSE 12,A01,083652,Staff,0,21,100,100
1650841464041,CSE 15L,A01,083654,Staff,0,3,50,50
1650841464041,CSE 15L,A02,083655,Staff,0,2,50,50
1650841470067,CSE 20,A01,083657,Staff,49,0,80,31
1650841476094,CSE 30,A01,083084,Eldon; John,0,76,40,40
1650841482120,CSE 100,A01,083659,Cao; Yingjun,0,71,50,50
1650841488149,CSE 134B,A01,083661,Powell; Thomas Allan,0,38,65,65
1650841494172,CSE 140,A01,083663,Staff,0,11,75,75
1650841500196,CSE 140L,A01,083088,Eldon; John,0,20,75,75
1650841506222,CSE 175,A01,083665,Kumar; Rakesh,7,0,25,18
1650841512248,CSE 190,A00,092507,Dubnov; Shlomo,10,0,20,10
1650841518270,ECE 45,A01,083139,Staff,0,1,60,60
1650841524301,ECE 65,A50,083695,Staff,0,5,30,30
1650841530328,ECE 109,A01,091882,Touri; Behrouz,32,0,70,38
1650841536369,ECE 180,A00,083140,Abi Samra; Nicholas Camill,20,0,30,10
1650841536369,ECE 180,B00,083141,Abi Samra; Nicholas Camill,0,0,30,30
1650841542396,MATH 10A,A01,083735,Patchell; Gregory David,2,0,30,28
1650841542396,MATH 10A,A02,083736,Patchell; Gregory David,27,0,30,3
1650841542396,MATH 10A,A03,083737,Patchell; Gregory David,24,0,30,6
1650841548424,MATH 10B,A01,083207,Staff,0,9,30,30
1650841548424,MATH 10B,A02,083208,Staff,0,6,30,30
1650841548424,MATH 10B,B01,083739,Staff,10,0,30,20
1650841548424,MATH 10B,B02,083740,Staff,28,0,30,2
1650841554449,MATH 18,A01,083743,Staff,0,0,30,30
1650841554449,MATH 18,A02,083744,Staff,23,0,30,7
1650841554449,MATH 18,A03,083745,Staff,21,0,30,9
1650841554449,MATH 18,A04,083746,Staff,26,0,30,4
1650841554449,MATH 18,B01,083748,Staff,0,15,30,30
1650841554449,MATH 18,B02,083749,Staff,0,13,30,30
1650841554449,MATH 18,B03,083750,Staff,0,13,30,30
1650841554449,MATH 18,B04,083751,Staff,0,12,30,30
1650841560480,MATH 20A,A01,083754,Staff,19,0,40,21
1650841566507,MATH 20B,A01,083756,Staff,0,14,30,30
1650841566507,MATH 20B,A02,083757,Staff,0,12,30,30
1650841572534,MATH 20C,A01,083760,Staff,0,17,30,30
1650841572534,MATH 20C,A02,083761,Staff,0,16,30,30
1650841572534,MATH 20C,B01,083762,Staff,9,0,30,21
1650841572534,MATH 20C,B02,083763,Staff,28,0,30,2
1650841578563,MATH 20D,A01,083765,Staff,2,1,30,28
1650841578563,MATH 20D,A02,083766,Staff,6,0,30,24
1650841578563,MATH 20D,A03,083767,Staff,24,0,30,6
1650841584591,MATH 20E,A01,083771,Staff,2,0,30,28
1650841584591,MATH 20E,A02,083772,Staff,13,0,30,17
1650841584591,MATH 20E,B01,083773,Staff,0,0,30,30
1650841584591,MATH 20E,B02,083774,Staff,5,0,30,25
1650841590615,MATH 103A,A01,083777,Staff,0,16,30,30
1650841590615,MATH 103A,A02,083778,Staff,0,15,30,30
1650841590615,MATH 103A,B01,083779,Staff,0,15,30,30
1650841590615,MATH 103A,B02,083780,Staff,1,15,30,29
1650841596642,MATH 105,A01,085443,Staff,0,22,30,30
1650841602666,MATH 109,A01,083213,Anzaldo; Leesa B,0,7,30,30
1650841602666,MATH 109,A02,083214,Anzaldo; Leesa B,0,7,30,30
1650841602666,MATH 109,B01,083215,Anzaldo; Leesa B,0,8,30,30
1650841602666,MATH 109,B02,083216,Anzaldo; Leesa B,0,7,30,30
1650841608698,MATH 142A,A01,083219,Chow; Bennett,0,16,30,30
1650841608698,MATH 142A,A02,083220,Chow; Bennett,0,15,30,30
1650841608698,MATH 142A,B01,083221,Chow; Bennett,0,16,30,30
1650841608698,MATH 142A,B02,083222,Chow; Bennett,0,14,30,30
1650841614727,MATH 193A,A01,083224,Staff,0,6,30,30
1650841614727,MATH 193A,A02,083225,Staff,0,6,30,30
1650841614727,MATH 193A,A03,083781,Staff,0,6,30,30
1650841614727,MATH 193A,A04,083782,Staff,0,7,30,30
1650841620752,MATH 197,001,091859,McAuley; Julian John,9998,0,9999,1
1650841626804,COGS 9,A01,083615,Staff,0,17,60,60
1650841632831,COGS 11,A01,083617,Boyle; Mary E. T.,15,0,40,25
1650841638861,COGS 13,A01,083071,Staff,0,38,40,40
1650841644884,COGS 14A,A01,092681,Staff,0,36,100,100
1650841650907,COGS 14B,A01,083073,Cheng; Tzu-Han,0,12,50,50
1650841656930,COGS 17,A01,092677,Staff,12,0,75,63
1650841662955,COGS 100,A01,083619,Staff,0,30,60,60
1650841668981,COGS 101A,A01,083621,Davis; Joshua Daniel,0,28,60,60
1650841675095,COGS 101B,A01,091572,Staff,0,3,60,60
1650841681137,COGS 101C,A01,083625,Delgado; Tania,14,0,30,16
1650841687163,COGS 107A,A01,083627,Boyle; Mary E. T.,0,16,60,60
1650841693190,COGS 118A,A01,083075,Staff,0,8,60,60
1650841699218,CSE 3,A50,083646,Miranda; Gregory Joseph,18,0,38,20
1650841699218,CSE 3,A51,083647,Miranda; Gregory Joseph,36,0,37,1
1650841705245,CSE 8A,A50,083650,Miranda; Gregory Joseph,0,29,40,40
1650841711273,CSE 11,A01,083080,Cao; Yingjun,0,96,40,40
1650841717296,CSE 12,A01,083652,Staff,0,21,100,100
1650841723322,CSE 15L,A01,083654,Staff,0,3,50,50
1650841723322,CSE 15L,A02,083655,Staff,0,2,50,50
1650841729349,CSE 20,A01,083657,Staff,49,0,80,31
1650841735380,CSE 30,A01,083084,Eldon; John,0,76,40,40
1650841741408,CSE 100,A01,083659,Cao; Yingjun,0,71,50,50
1650841747432,CSE 134B,A01,083661,Powell; Thomas Allan,0,38,65,65
1650841753459,CSE 140,A01,083663,Staff,0,11,75,75
1650841759483,CSE 140L,A01,083088,Eldon; John,0,20,75,75
1650841765505,CSE 175,A01,083665,Kumar; Rakesh,7,0,25,18
1650841771530,CSE 190,A00,092507,Dubnov; Shlomo,10,0,20,10
1650841777556,ECE 45,A01,083139,Staff,0,1,60,60
1650841783590,ECE 65,A50,083695,Staff,0,5,30,30
1650841789613,ECE 109,A01,091882,Touri; Behrouz,32,0,70,38
1650841795636,ECE 180,A00,083140,Abi Samra; Nicholas Camill,20,0,30,10
1650841795636,ECE 180,B00,083141,Abi Samra; Nicholas Camill,0,0,30,30
1650841801660,MATH 10A,A01,083735,Patchell; Gregory David,2,0,30,28
1650841801660,MATH 10A,A02,083736,Patchell; Gregory David,27,0,30,3
1650841801660,MATH 10A,A03,083737,Patchell; Gregory David,24,0,30,6
1650841807684,MATH 10B,A01,083207,Staff,0,9,30,30
1650841807684,MATH 10B,A02,083208,Staff,0,6,30,30
1650841807684,MATH 10B,B01,083739,Staff,10,0,30,20
1650841807684,MATH 10B,B02,083740,Staff,28,0,30,2
1650841813708,MATH 18,A01,083743,Staff,0,0,30,30
1650841813708,MATH 18,A02,083744,Staff,23,0,30,7
1650841813708,MATH 18,A03,083745,Staff,21,0,30,9
1650841813708,MATH 18,A04,083746,Staff,26,0,30,4
1650841813708,MATH 18,B01,083748,Staff,0,15,30,30
1650841813708,MATH 18,B02,083749,Staff,0,13,30,30
1650841813708,MATH 18,B03,083750,Staff,0,13,30,30
1650841813708,MATH 18,B04,083751,Staff,0,12,30,30
1650841819733,MATH 20A,A01,083754,Staff,19,0,40,21
1650841825757,MATH 20B,A01,083756,Staff,0,14,30,30
1650841825757,MATH 20B,A02,083757,Staff,0,12,30,30
1650841831789,MATH 20C,A01,083760,Staff,0,17,30,30
1650841831789,MATH 20C,A02,083761,Staff,0,16,30,30
1650841831789,MATH 20C,B01,083762,Staff,9,0,30,21
1650841831789,MATH 20C,B02,083763,Staff,28,0,30,2
1650841837815,MATH 20D,A01,083765,Staff,2,1,30,28
1650841837815,MATH 20D,A02,083766,Staff,6,0,30,24
1650841837815,MATH 20D,A03,083767,Staff,24,0,30,6
1650841843848,MATH 20E,A01,083771,Staff,2,0,30,28
1650841843848,MATH 20E,A02,083772,Staff,13,0,30,17
1650841843848,MATH 20E,B01,083773,Staff,0,0,30,30
1650841843848,MATH 20E,B02,083774,Staff,5,0,30,25
1650841849871,MATH 103A,A01,083777,Staff,0,16,30,30
1650841849871,MATH 103A,A02,083778,Staff,0,15,30,30
1650841849871,MATH 103A,B01,083779,Staff,0,15,30,30
1650841849871,MATH 103A,B02,083780,Staff,1,15,30,29
1650841855897,MATH 105,A01,085443,Staff,0,22,30,30
1650841861921,MATH 109,A01,083213,Anzaldo; Leesa B,0,7,30,30
1650841861921,MATH 109,A02,083214,Anzaldo; Leesa B,0,7,30,30
1650841861921,MATH 109,B01,083215,Anzaldo; Leesa B,0,8,30,30
1650841861921,MATH 109,B02,083216,Anzaldo; Leesa B,0,7,30,30
1650841867945,MATH 142A,A01,083219,Chow; Bennett,0,16,30,30
1650841867945,MATH 142A,A02,083220,Chow; Bennett,0,15,30,30
1650841867945,MATH 142A,B01,083221,Chow; Bennett,0,16,30,30
1650841867945,MATH 142A,B02,083222,Chow; Bennett,0,14,30,30
1650841873970,MATH 193A,A01,083224,Staff,0,6,30,30
1650841873970,MATH 193A,A02,083225,Staff,0,6,30,30
1650841873970,MATH 193A,A03,083781,Staff,0,6,30,30
1650841873970,MATH 193A,A04,083782,Staff,0,7,30,30
1650841879995,MATH 197,001,091859,McAuley; Julian John,9998,0,9999,1
1650841886046,COGS 9,A01,083615,Staff,0,17,60,60
1650841892073,COGS 11,A01,083617,Boyle; Mary E. T.,15,0,40,25
1650841898103,COGS 13,A01,083071,Staff,0,38,40,40
1650841904125,COGS 14A,A01,092681,Staff,0,36,100,100
1650841910150,COGS 14B,A01,083073,Cheng; Tzu-Han,0,12,50,50
1650841916174,COGS 17,A01,092677,Staff,12,0,75,63
1650841922197,COGS 100,A01,083619,Staff,0,29,60,60
1650841928224,COGS 101A,A01,083621,Davis; Joshua Daniel,0,28,60,60
1650841934249,COGS 101B,A01,091572,Staff,0,3,60,60
1650841940272,COGS 101C,A01,083625,Delgado; Tania,14,0,30,16
1650841946296,COGS 107A,A01,083627,Boyle; Mary E. T.,0,16,60,60
1650841952323,COGS 118A,A01,083075,Staff,0,8,60,60
1650841958344,CSE 3,A50,083646,Miranda; Gregory Joseph,18,0,38,20
1650841958344,CSE 3,A51,083647,Miranda; Gregory Joseph,36,0,37,1
1650841964370,CSE 8A,A50,083650,Miranda; Gregory Joseph,0,29,40,40
1650841970392,CSE 11,A01,083080,Cao; Yingjun,0,96,40,40
1650841976420,CSE 12,A01,083652,Staff,0,21,100,100
1650841982447,CSE 15L,A01,083654,Staff,0,3,50,50
1650841982447,CSE 15L,A02,083655,Staff,0,2,50,50
1650841988473,CSE 20,A01,083657,Staff,49,0,80,31
1650841994499,CSE 30,A01,083084,Eldon; John,0,76,40,40
1650842000521,CSE 100,A01,083659,Cao; Yingjun,0,71,50,50
1650842006548,CSE 134B,A01,083661,Powell; Thomas Allan,0,38,65,65
1650842012570,CSE 140,A01,083663,Staff,0,11,75,75
1650842018595,CSE 140L,A01,083088,Eldon; John,0,20,75,75
1650842024621,CSE 175,A01,083665,Kumar; Rakesh,7,0,25,18
1650842030658,CSE 190,A00,092507,Dubnov; Shlomo,10,0,20,10
1650842036682,ECE 45,A01,083139,Staff,0,1,60,60
1650842042708,ECE 65,A50,083695,Staff,0,5,30,30
1650842048736,ECE 109,A01,091882,Touri; Behrouz,32,0,70,38
1650842054774,ECE 180,A00,083140,Abi Samra; Nicholas Camill,20,0,30,10
1650842054774,ECE 180,B00,083141,Abi Samra; Nicholas Camill,0,0,30,30
1650842060798,MATH 10A,A01,083735,Patchell; Gregory David,2,0,30,28
1650842060798,MATH 10A,A02,083736,Patchell; Gregory David,27,0,30,3
1650842060798,MATH 10A,A03,083737,Patchell; Gregory David,24,0,30,6
1650842066820,MATH 10B,A01,083207,Staff,0,9,30,30
1650842066820,MATH 10B,A02,083208,Staff,0,6,30,30
1650842066820,MATH 10B,B01,083739,Staff,10,0,30,20
1650842066820,MATH 10B,B02,083740,Staff,28,0,30,2
1650842072847,MATH 18,A01,083743,Staff,0,0,30,30
1650842072847,MATH 18,A02,083744,Staff,23,0,30,7
1650842072847,MATH 18,A03,083745,Staff,21,0,30,9
1650842072847,MATH 18,A04,083746,Staff,26,0,30,4
1650842072847,MATH 18,B01,083748,Staff,0,15,30,30
1650842072847,MATH 18,B02,083749,Staff,0,13,30,30
1650842072847,MATH 18,B03,083750,Staff,0,13,30,30
1650842072847,MATH 18,B04,083751,Staff,0,12,30,30
1650842078871,MATH 20A,A01,083754,Staff,19,0,40,21
1650842084899,MATH 20B,A01,083756,Staff,0,14,30,30
1650842084899,MATH 20B,A02,083757,Staff,0,12,30,30
1650842090927,MATH 20C,A01,083760,Staff,0,17,30,30
1650842090927,MATH 20C,A02,083761,Staff,0,16,30,30
1650842090927,MATH 20C,B01,083762,Staff,9,0,30,21
1650842090927,MATH 20C,B02,083763,Staff,28,0,30,2
1650842096955,MATH 20D,A01,083765,Staff,2,1,30,28
1650842096955,MATH 20D,A02,083766,Staff,6,0,30,24
1650842096955,MATH 20D,A03,083767,Staff,24,0,30,6
1650842102977,MATH 20E,A01,083771,Staff,2,0,30,28
1650842102977,MATH 20E,A02,083772,Staff,13,0,30,17
1650842102977,MATH 20E,B01,083773,Staff,0,0,30,30
1650842102977,MATH 20E,B02,083774,Staff,5,0,30,25
1650842109004,MATH 103A,A01,083777,Staff,0,16,30,30
1650842109004,MATH 103A,A02,083778,Staff,0,15,30,30
1650842109004,MATH 103A,B01,083779,Staff,0,15,30,30
1650842109004,MATH 103A,B02,083780,Staff,1,15,30,29
1650842115031,MATH 105,A01,085443,Staff,0,22,30,30
1650842121054,MATH 109,A01,083213,Anzaldo; Leesa B,0,7,30,30
1650842121054,MATH 109,A02,083214,Anzaldo; Leesa B,0,7,30,30
1650842121054,MATH 109,B01,083215,Anzaldo; Leesa B,0,8,30,30
1650842121054,MATH 109,B02,083216,Anzaldo; Leesa B,0,7,30,30
1650842127093,MATH 142A,A01,083219,Chow; Bennett,0,16,30,30
1650842127093,MATH 142A,A02,083220,Chow; Bennett,0,15,30,30
1650842127093,MATH 142A,B01,083221,Chow; Bennett,0,16,30,30
1650842127093,MATH 142A,B02,083222,Chow; Bennett,0,14,30,30
1650842133119,MATH 193A,A01,083224,Staff,0,6,30,30
1650842133119,MATH 193A,A02,083225,Staff,0,6,30,30
1650842133119,MATH 193A,A03,083781,Staff,0,6,30,30
1650842133119,MATH 193A,A04,083782,Staff,0,7,30,30
1650842139149,MATH 197,001,091859,McAuley; Julian John,9998,0,9999,1
1650842145209,COGS 9,A01,083615,Staff,0,17,60,60
1650842151233,COGS 11,A01,083617,Boyle; Mary E. T.,15,0,40,25
1650842157266,COGS 13,A01,083071,Staff,0,38,40,40
1650842163299,COGS 14A,A01,092681,Staff,0,36,100,100
1650842169321,COGS 14B,A01,083073,Cheng; Tzu-Han,0,12,50,50
1650842175348,COGS 17,A01,092677,Staff,12,0,75,63
1650842181379,COGS 100,A01,083619,Staff,0,30,60,60
1650842187407,COGS 101A,A01,083621,Davis; Joshua Daniel,0,29,60,60
1650842193430,COGS 101B,A01,091572,Staff,0,3,60,60
1650842199454,COGS 101C,A01,083625,Delgado; Tania,14,0,30,16
1650842205480,COGS 107A,A01,083627,Boyle; Mary E. T.,0,16,60,60
1650842211503,COGS 118A,A01,083075,Staff,0,8,60,60
1650842217532,CSE 3,A50,083646,Miranda; Gregory Joseph,18,0,38,20
1650842217532,CSE 3,A51,083647,Miranda; Gregory Joseph,36,0,37,1
1650842223562,CSE 8A,A50,083650,Miranda; Gregory Joseph,0,29,40,40
1650842229585,CSE 11,A01,083080,Cao; Yingjun,0,96,40,40
1650842235609,CSE 12,A01,083652,Staff,0,21,100,100
1650842241633,CSE 15L,A01,083654,Staff,0,3,50,50
1650842241633,CSE 15L,A02,083655,Staff,0,2,50,50
1650842247658,CSE 20,A01,083657,Staff,49,0,80,31
1650842253682,CSE 30,A01,083084,Eldon; John,0,76,40,40
1650842259706,CSE 100,A01,083659,Cao; Yingjun,0,71,50,50
1650842265731,CSE 134B,A01,083661,Powell; Thomas Allan,0,38,65,65
1650842271849,CSE 140,A01,083663,Staff,0,11,75,75
1650842277883,CSE 140L,A01,083088,Eldon; John,0,20,75,75
1650842283906,CSE 175,A01,083665,Kumar; Rakesh,7,0,25,18
1650842289934,CSE 190,A00,092507,Dubnov; Shlomo,10,0,20,10
1650842295960,ECE 45,A01,083139,Staff,0,1,60,60
1650842301987,ECE 65,A50,083695,Staff,0,5,30,30
1650842308012,ECE 109,A01,091882,Touri; Behrouz,32,0,70,38
1650842314052,ECE 180,A00,083140,Abi Samra; Nicholas Camill,20,0,30,10
1650842314052,ECE 180,B00,083141,Abi Samra; Nicholas Camill,0,0,30,30
1650842320084,MATH 10A,A01,083735,Patchell; Gregory David,2,0,30,28
1650842320084,MATH 10A,A02,083736,Patchell; Gregory David,27,0,30,3
1650842320084,MATH 10A,A03,083737,Patchell; Gregory David,24,0,30,6
1650842326121,MATH 10B,A01,083207,Staff,0,9,30,30
1650842326121,MATH 10B,A02,083208,Staff,0,6,30,30
1650842326121,MATH 10B,B01,083739,Staff,10,0,30,20
1650842326121,MATH 10B,B02,083740,Staff,28,0,30,2
1650842332151,MATH 18,A01,083743,Staff,0,0,30,30
1650842332151,MATH 18,A02,083744,Staff,23,0,30,7
1650842332151,MATH 18,A03,083745,Staff,21,0,30,9
1650842332151,MATH 18,A04,083746,Staff,26,0,30,4
1650842332151,MATH 18,B01,083748,Staff,0,15,30,30
1650842332151,MATH 18,B02,083749,Staff,0,13,30,30
1650842332151,MATH 18,B03,083750,Staff,0,13,30,30
1650842332151,MATH 18,B04,083751,Staff,0,12,30,30
1650842338177,MATH 20A,A01,083754,Staff,19,0,40,21
1650842344201,MATH 20B,A01,083756,Staff,0,14,30,30
1650842344201,MATH 20B,A02,083757,Staff,0,12,30,30
1650842350233,MATH 20C,A01,083760,Staff,0,17,30,30
1650842350233,MATH 20C,A02,083761,Staff,0,16,30,30
1650842350233,MATH 20C,B01,083762,Staff,9,0,30,21
1650842350233,MATH 20C,B02,083763,Staff,28,0,30,2
1650842356257,MATH 20D,A01,083765,Staff,2,1,30,28
1650842356257,MATH 20D,A02,083766,Staff,6,0,30,24
1650842356257,MATH 20D,A03,083767,Staff,24,0,30,6
1650842362281,MATH 20E,A01,083771,Staff,2,0,30,28
1650842362281,MATH 20E,A02,083772,Staff,13,0,30,17
1650842362281,MATH 20E,B01,083773,Staff,0,0,30,30
1650842362281,MATH 20E,B02,083774,Staff,5,0,30,25
1650842368307,MATH 103A,A01,083777,Staff,0,16,30,30
1650842368307,MATH 103A,A02,083778,Staff,0,15,30,30
1650842368307,MATH 103A,B01,083779,Staff,0,15,30,30
1650842368307,MATH 103A,B02,083780,Staff,1,15,30,29
1650842374332,MATH 105,A01,085443,Staff,0,22,30,30
1650842380356,MATH 109,A01,083213,Anzaldo; Leesa B,0,7,30,30
1650842380356,MATH 109,A02,083214,Anzaldo; Leesa B,0,7,30,30
1650842380356,MATH 109,B01,083215,Anzaldo; Leesa B,0,8,30,30
1650842380356,MATH 109,B02,083216,Anzaldo; Leesa B,0,7,30,30
1650842386388,MATH 142A,A01,083219,Chow; Bennett,0,16,30,30
1650842386388,MATH 142A,A02,083220,Chow; Bennett,0,15,30,30
1650842386388,MATH 142A,B01,083221,Chow; Bennett,0,16,30,30
1650842386388,MATH 142A,B02,083222,Chow; Bennett,0,14,30,30
1650842392414,MATH 193A,A01,083224,Staff,0,6,30,30
1650842392414,MATH 193A,A02,083225,Staff,0,6,30,30
1650842392414,MATH 193A,A03,083781,Staff,0,6,30,30
1650842392414,MATH 193A,A04,083782,Staff,0,7,30,30
1650842398440,MATH 197,001,091859,McAuley; Julian John,9998,0,9999,1
1650842404488,COGS 9,A01,083615,Staff,0,17,60,60
1650842410516,COGS 11,A01,083617,Boyle; Mary E. T.,15,0,40,25
1650842416542,COGS 13,A01,083071,Staff,0,38,40,40
1650842422570,COGS 14A,A01,092681,Staff,0,36,100,100
1650842428596,COGS 14B,A01,083073,Cheng; Tzu-Han,0,12,50,50
1650842434619,COGS 17,A01,092677,Staff,12,0,75,63
1650842440644,COGS 100,A01,083619,Staff,0,30,60,60
1650842446667,COGS 101A,A01,083621,Davis; Joshua Daniel,0,29,60,60
1650842452693,COGS 101B,A01,091572,Staff,0,3,60,60
1650842458719,COGS 101C,A01,083625,Delgado; Tania,14,0,30,16
1650842464746,COGS 107A,A01,083627,Boyle; Mary E. T.,0,16,60,60
1650842470770,COGS 118A,A01,083075,Staff,0,8,60,60
1650842476798,CSE 3,A50,083646,Miranda; Gregory Joseph,18,0,38,20
1650842476798,CSE 3,A51,083647,Miranda; Gregory Joseph,36,0,37,1
1650842482822,CSE 8A,A50,083650,Miranda; Gregory Joseph,0,29,40,40
1650842488846,CSE 11,A01,083080,Cao; Yingjun,0,96,40,40
1650842494872,CSE 12,A01,083652,Staff,0,21,100,100
1650842500897,CSE 15L,A01,083654,Staff,0,3,50,50
1650842500897,CSE 15L,A02,083655,Staff,0,2,50,50
1650842506924,CSE 20,A01,083657,Staff,49,0,80,31
1650842512948,CSE 30,A01,083084,Eldon; John,0,76,40,40
1650842518973,CSE 100,A01,083659,Cao; Yingjun,0,71,50,50
1650842525000,CSE 134B,A01,083661,Powell; Thomas Allan,0,38,65,65
1650842531027,CSE 140,A01,083663,Staff,0,11,75,75
1650842537051,CSE 140L,A01,083088,Eldon; John,0,20,75,75
1650842543074,CSE 175,A01,083665,Kumar; Rakesh,7,0,25,18
1650842549099,CSE 190,A00,092507,Dubnov; Shlomo,10,0,20,10
1650842555125,ECE 45,A01,083139,Staff,0,1,60,60
1650842561149,ECE 65,A50,083695,Staff,0,5,30,30
1650842567172,ECE 109,A01,091882,Touri; Behrouz,32,0,70,38
1650842573198,ECE 180,A00,083140,Abi Samra; Nicholas Camill,20,0,30,10
1650842573198,ECE 180,B00,083141,Abi Samra; Nicholas Camill,0,0,30,30
1650842579221,MATH 10A,A01,083735,Patchell; Gregory David,2,0,30,28
1650842579221,MATH 10A,A02,083736,Patchell; Gregory David,27,0,30,3
1650842579221,MATH 10A,A03,083737,Patchell; Gregory David,24,0,30,6
1650842585246,MATH 10B,A01,083207,Staff,0,9,30,30
1650842585246,MATH 10B,A02,083208,Staff,0,6,30,30
1650842585246,MATH 10B,B01,083739,Staff,10,0,30,20
1650842585246,MATH 10B,B02,083740,Staff,28,0,30,2
1650842591278,MATH 18,A01,083743,Staff,0,0,30,30
1650842591278,MATH 18,A02,083744,Staff,23,0,30,7
1650842591278,MATH 18,A03,083745,Staff,21,0,30,9
1650842591278,MATH 18,A04,083746,Staff,26,0,30,4
1650842591278,MATH 18,B01,083748,Staff,0,15,30,30
1650842591278,MATH 18,B02,083749,Staff,0,13,30,30
1650842591278,MATH 18,B03,083750,Staff,0,14,30,30
1650842591278,MATH 18,B04,083751,Staff,0,12,30,30
1650842597304,MATH 20A,A01,083754,Staff,19,0,40,21
1650842603329,MATH 20B,A01,083756,Staff,0,14,30,30
1650842603329,MATH 20B,A02,083757,Staff,0,12,30,30
1650842609354,MATH 20C,A01,083760,Staff,0,17,30,30
1650842609354,MATH 20C,A02,083761,Staff,0,16,30,30
1650842609354,MATH 20C,B01,083762,Staff,9,0,30,21
1650842609354,MATH 20C,B02,083763,Staff,28,0,30,2
1650842615382,MATH 20D,A01,083765,Staff,2,1,30,28
1650842615382,MATH 20D,A02,083766,Staff,6,0,30,24
1650842615382,MATH 20D,A03,083767,Staff,24,0,30,6
1650842621410,MATH 20E,A01,083771,Staff,2,0,30,28
1650842621410,MATH 20E,A02,083772,Staff,13,0,30,17
1650842621410,MATH 20E,B01,083773,Staff,0,0,30,30
1650842621410,MATH 20E,B02,083774,Staff,5,0,30,25
1650842627444,MATH 103A,A01,083777,Staff,0,16,30,30
1650842627444,MATH 103A,A02,083778,Staff,0,15,30,30
1650842627444,MATH 103A,B01,083779,Staff,0,15,30,30
1650842627444,MATH 103A,B02,083780,Staff,1,15,30,29
1650842633467,MATH 105,A01,085443,Staff,0,22,30,30
1650842639496,MATH 109,A01,083213,Anzaldo; Leesa B,0,7,30,30
1650842639496,MATH 109,A02,083214,Anzaldo; Leesa B,0,7,30,30
1650842639496,MATH 109,B01,083215,Anzaldo; Leesa B,0,8,30,30
1650842639496,MATH 109,B02,083216,Anzaldo; Leesa B,0,7,30,30
1650842645522,MATH 142A,A01,083219,Chow; Bennett,0,16,30,30
1650842645522,MATH 142A,A02,083220,Chow; Bennett,0,15,30,30
1650842645522,MATH 142A,B01,083221,Chow; Bennett,0,16,30,30
1650842645522,MATH 142A,B02,083222,Chow; Bennett,0,14,30,30
1650842651544,MATH 193A,A01,083224,Staff,0,6,30,30
1650842651544,MATH 193A,A02,083225,Staff,0,6,30,30
1650842651544,MATH 193A,A03,083781,Staff,0,6,30,30
1650842651544,MATH 193A,A04,083782,Staff,0,7,30,30
1650842657568,MATH 197,001,091859,McAuley; Julian John,9998,0,9999,1
1650842663619,COGS 9,A01,083615,Staff,0,17,60,60
1650842669643,COGS 11,A01,083617,Boyle; Mary E. T.,15,0,40,25
1650842675674,COGS 13,A01,083071,Staff,0,38,40,40
1650842681703,COGS 14A,A01,092681,Staff,0,36,100,100
1650842687730,COGS 14B,A01,083073,Cheng; Tzu-Han,0,12,50,50
1650842693751,COGS 17,A01,092677,Staff,12,0,75,63
1650842699777,COGS 100,A01,083619,Staff,0,30,60,60
1650842705802,COGS 101A,A01,083621,Davis; Joshua Daniel,0,29,60,60
1650842711828,COGS 101B,A01,091572,Staff,0,3,60,60
1650842717855,COGS 101C,A01,083625,Delgado; Tania,14,0,30,16
1650842723879,COGS 107A,A01,083627,Boyle; Mary E. T.,0,16,60,60
1650842729905,COGS 118A,A01,083075,Staff,0,8,60,60
1650842735930,CSE 3,A50,083646,Miranda; Gregory Joseph,18,0,38,20
1650842735930,CSE 3,A51,083647,Miranda; Gregory Joseph,36,0,37,1
1650842741954,CSE 8A,A50,083650,Miranda; Gregory Joseph,0,29,40,40
1650842747981,CSE 11,A01,083080,Cao; Yingjun,0,96,40,40
1650842754005,CSE 12,A01,083652,Staff,0,21,100,100
1650842760030,CSE 15L,A01,083654,Staff,0,3,50,50
1650842760030,CSE 15L,A02,083655,Staff,0,2,50,50
1650842766059,CSE 20,A01,083657,Staff,49,0,80,31
1650842772083,CSE 30,A01,083084,Eldon; John,0,76,40,40
1650842778111,CSE 100,A01,083659,Cao; Yingjun,0,71,50,50
1650842784138,CSE 134B,A01,083661,Powell; Thomas Allan,0,38,65,65
1650842790171,CSE 140,A01,083663,Staff,0,11,75,75
1650842796194,CSE 140L,A01,083088,Eldon; John,0,20,75,75
1650842802218,CSE 175,A01,083665,Kumar; Rakesh,7,0,25,18
1650842808242,CSE 190,A00,092507,Dubnov; Shlomo,10,0,20,10
1650842814269,ECE 45,A01,083139,Staff,0,1,60,60
1650842820299,ECE 65,A50,083695,Staff,0,5,30,30
1650842826323,ECE 109,A01,091882,Touri; Behrouz,32,0,70,38
1650842832350,ECE 180,A00,083140,Abi Samra; Nicholas Camill,20,0,30,10
1650842832350,ECE 180,B00,083141,Abi Samra; Nicholas Camill,0,0,30,30
1650842838373,MATH 10A,A01,083735,Patchell; Gregory David,2,0,30,28
1650842838373,MATH 10A,A02,083736,Patchell; Gregory David,27,0,30,3
1650842838373,MATH 10A,A03,083737,Patchell; Gregory David,24,0,30,6
1650842844396,MATH 10B,A01,083207,Staff,0,9,30,30
1650842844396,MATH 10B,A02,083208,Staff,0,6,30,30
1650842844396,MATH 10B,B01,083739,Staff,10,0,30,20
1650842844396,MATH 10B,B02,083740,Staff,28,0,30,2
1650842850422,MATH 18,A01,083743,Staff,0,0,30,30
1650842850422,MATH 18,A02,083744,Staff,23,0,30,7
1650842850422,MATH 18,A03,083745,Staff,21,0,30,9
1650842850422,MATH 18,A04,083746,Staff,26,0,30,4
1650842850422,MATH 18,B01,083748,Staff,0,15,30,30
1650842850422,MATH 18,B02,083749,Staff,0,13,30,30
1650842850422,MATH 18,B03,083750,Staff,0,13,30,30
1650842850422,MATH 18,B04,083751,Staff,0,13,30,30
1650842856446,MATH 20A,A01,083754,Staff,19,0,40,21
1650842862470,MATH 20B,A01,083756,Staff,0,14,30,30
1650842862470,MATH 20B,A02,083757,Staff,0,12,30,30
1650842868598,MATH 20C,A01,083760,Staff,0,17,30,30
1650842868598,MATH 20C,A02,083761,Staff,0,16,30,30
1650842868598,MATH 20C,B01,083762,Staff,9,0,30,21
1650842868598,MATH 20C,B02,083763,Staff,28,0,30,2
1650842874621,MATH 20D,A01,083765,Staff,2,1,30,28
1650842874621,MATH 20D,A02,083766,Staff,6,0,30,24
1650842874621,MATH 20D,A03,083767,Staff,24,0,30,6
1650842880647,MATH 20E,A01,083771,Staff,2,0,30,28
1650842880647,MATH 20E,A02,083772,Staff,13,0,30,17
1650842880647,MATH 20E,B01,083773,Staff,0,0,30,30
1650842880647,MATH 20E,B02,083774,Staff,5,0,30,25
1650842886672,MATH 103A,A01,083777,Staff,0,16,30,30
1650842886672,MATH 103A,A02,083778,Staff,0,15,30,30
1650842886672,MATH 103A,B01,083779,Staff,0,15,30,30
1650842886672,MATH 103A,B02,083780,Staff,1,15,30,29
1650842892698,MATH 105,A01,085443,Staff,0,22,30,30
1650842898720,MATH 109,A01,083213,Anzaldo; Leesa B,0,7,30,30
1650842898720,MATH 109,A02,083214,Anzaldo; Leesa B,0,7,30,30
1650842898720,MATH 109,B01,083215,Anzaldo; Leesa B,0,8,30,30
1650842898720,MATH 109,B02,083216,Anzaldo; Leesa B,0,7,30,30
1650842904745,MATH 142A,A01,083219,Chow; Bennett,0,16,30,30
1650842904745,MATH 142A,A02,083220,Chow; Bennett,0,15,30,30
1650842904745,MATH 142A,B01,083221,Chow; Bennett,0,16,30,30
1650842904745,MATH 142A,B02,083222,Chow; Bennett,0,14,30,30
1650842910775,MATH 193A,A01,083224,Staff,0,6,30,30
1650842910775,MATH 193A,A02,083225,Staff,0,6,30,30
1650842910775,MATH 193A,A03,083781,Staff,0,6,30,30
1650842910775,MATH 193A,A04,083782,Staff,0,7,30,30
1650842916801,MATH 197,001,091859,McAuley; Julian John,9998,0,9999,1
1650842922857,COGS 9,A01,083615,Staff,0,17,60,60
1650842928908,COGS 11,A01,083617,Boyle; Mary E. T.,15,0,40,25
1650842934943,COGS 13,A01,083071,Staff,0,38,40,40
1650842940971,COGS 14A,A01,092681,Staff,0,36,100,100
1650842946996,COGS 14B,A01,083073,Cheng; Tzu-Han,0,12,50,50
1650842953023,COGS 17,A01,092677,Staff,12,0,75,63
1650842959050,COGS 100,A01,083619,Staff,0,30,60,60
1650842965077,COGS 101A,A01,083621,Davis; Joshua Daniel,0,29,60,60
1650842971102,COGS 101B,A01,091572,Staff,0,3,60,60
1650842977131,COGS 101C,A01,083625,Delgado; Tania,14,0,30,16
1650842983162,COGS 107A,A01,083627,Boyle; Mary E. T.,0,16,60,60
1650842989191,COGS 118A,A01,083075,Staff,0,8,60,60
1650842995220,CSE 3,A50,083646,Miranda; Gregory Joseph,18,0,38,20
1650842995220,CSE 3,A51,083647,Miranda; Gregory Joseph,36,0,37,1
1650843001246,CSE 8A,A50,083650,Miranda; Gregory Joseph,0,29,40,40
1650843007279,CSE 11,A01,083080,Cao; Yingjun,0,96,40,40
1650843013302,CSE 12,A01,083652,Staff,0,21,100,100
1650843019329,CSE 15L,A01,083654,Staff,0,3,50,50
1650843019329,CSE 15L,A02,083655,Staff,0,2,50,50
1650843025354,CSE 20,A01,083657,Staff,49,0,80,31
1650843031377,CSE 30,A01,083084,Eldon; John,0,76,40,40
1650843037404,CSE 100,A01,083659,Cao; Yingjun,0,71,50,50
1650843043428,CSE 134B,A01,083661,Powell; Thomas Allan,0,38,65,65
1650843049453,CSE 140,A01,083663,Staff,0,11,75,75
1650843055482,CSE 140L,A01,083088,Eldon; John,0,20,75,75
1650843061506,CSE 175,A01,083665,Kumar; Rakesh,7,0,25,18
1650843067528,CSE 190,A00,092507,Dubnov; Shlomo,10,0,20,10
1650843073553,ECE 45,A01,083139,Staff,0,1,60,60
1650843079577,ECE 65,A50,083695,Staff,0,5,30,30
1650843085606,ECE 109,A01,091882,Touri; Behrouz,32,0,70,38
1650843091633,ECE 180,A00,083140,Abi Samra; Nicholas Camill,20,0,30,10
1650843091633,ECE 180,B00,083141,Abi Samra; Nicholas Camill,0,0,30,30
1650843097661,MATH 10A,A01,083735,Patchell; Gregory David,2,0,30,28
1650843097661,MATH 10A,A02,083736,Patchell; Gregory David,27,0,30,3
1650843097661,MATH 10A,A03,083737,Patchell; Gregory David,24,0,30,6
1650843103690,MATH 10B,A01,083207,Staff,0,9,30,30
1650843103690,MATH 10B,A02,083208,Staff,0,6,30,30
1650843103690,MATH 10B,B01,083739,Staff,10,0,30,20
1650843103690,MATH 10B,B02,083740,Staff,28,0,30,2
1650843109720,MATH 18,A01,083743,Staff,0,0,30,30
1650843109720,MATH 18,A02,083744,Staff,23,0,30,7
1650843109720,MATH 18,A03,083745,Staff,21,0,30,9
1650843109720,MATH 18,A04,083746,Staff,26,0,30,4
1650843109720,MATH 18,B01,083748,Staff,0,15,30,30
1650843109720,MATH 18,B02,083749,Staff,0,13,30,30
1650843109720,MATH 18,B03,083750,Staff,0,13,30,30
1650843109720,MATH 18,B04,083751,Staff,0,13,30,30
1650843115743,MATH 20A,A01,083754,Staff,19,0,40,21
1650843121775,MATH 20B,A01,083756,Staff,0,14,30,30
1650843121775,MATH 20B,A02,083757,Staff,0,12,30,30
1650843127799,MATH 20C,A01,083760,Staff,0,17,30,30
1650843127799,MATH 20C,A02,083761,Staff,0,16,30,30
1650843127799,MATH 20C,B01,083762,Staff,9,0,30,21
1650843127799,MATH 20C,B02,083763,Staff,28,0,30,2
1650843133823,MATH 20D,A01,083765,Staff,2,1,30,28
1650843133823,MATH 20D,A02,083766,Staff,6,0,30,24
1650843133823,MATH 20D,A03,083767,Staff,24,0,30,6
1650843139846,MATH 20E,A01,083771,Staff,2,0,30,28
1650843139846,MATH 20E,A02,083772,Staff,13,0,30,17
1650843139846,MATH 20E,B01,083773,Staff,0,0,30,30
1650843139846,MATH 20E,B02,083774,Staff,5,0,30,25
1650843145870,MATH 103A,A01,083777,Staff,0,16,30,30
1650843145870,MATH 103A,A02,083778,Staff,0,15,30,30
1650843145870,MATH 103A,B01,083779,Staff,0,15,30,30
1650843145870,MATH 103A,B02,083780,Staff,1,15,30,29
1650843151898,MATH 105,A01,085443,Staff,0,22,30,30
1650843157922,MATH 109,A01,083213,Anzaldo; Leesa B,0,7,30,30
1650843157922,MATH 109,A02,083214,Anzaldo; Leesa B,0,7,30,30
1650843157922,MATH 109,B01,083215,Anzaldo; Leesa B,0,8,30,30
1650843157922,MATH 109,B02,083216,Anzaldo; Leesa B,0,7,30,30
1650843163950,MATH 142A,A01,083219,Chow; Bennett,0,16,30,30
1650843163950,MATH 142A,A02,083220,Chow; Bennett,0,15,30,30
1650843163950,MATH 142A,B01,083221,Chow; Bennett,0,16,30,30
1650843163950,MATH 142A,B02,083222,Chow; Bennett,0,14,30,30
1650843169979,MATH 193A,A01,083224,Staff,0,6,30,30
1650843169979,MATH 193A,A02,083225,Staff,0,6,30,30
1650843169979,MATH 193A,A03,083781,Staff,0,6,30,30
1650843169979,MATH 193A,A04,083782,Staff,0,7,30,30
1650843176004,MATH 197,001,091859,McAuley; Julian John,9998,0,9999,1
1650843182059,COGS 9,A01,083615,Staff,0,17,60,60
1650843188086,COGS 11,A01,083617,Boyle; Mary E. T.,15,0,40,25
1650843194112,COGS 13,A01,083071,Staff,0,38,40,40
1650843200136,COGS 14A,A01,092681,Staff,0,36,100,100
1650843206163,COGS 14B,A01,083073,Cheng; Tzu-Han,0,12,50,50
1650843212189,COGS 17,A01,092677,Staff,12,0,75,63
1650843218214,COGS 100,A01,083619,Staff,0,30,60,60
1650843224242,COGS 101A,A01,083621,Davis; Joshua Daniel,0,29,60,60
1650843230265,COGS 101B,A01,091572,Staff,0,3,60,60
1650843236291,COGS 101C,A01,083625,Delgado; Tania,14,0,30,16
1650843242317,COGS 107A,A01,083627,Boyle; Mary E. T.,0,16,60,60
1650843248341,COGS 118A,A01,083075,Staff,0,8,60,60
1650843254365,CSE 3,A50,083646,Miranda; Gregory Joseph,18,0,38,20
1650843254365,CSE 3,A51,083647,Miranda; Gregory Joseph,36,0,37,1
1650843260392,CSE 8A,A50,083650,Miranda; Gregory Joseph,0,29,40,40
1650843266417,CSE 11,A01,083080,Cao; Yingjun,0,96,40,40
1650843272441,CSE 12,A01,083652,Staff,0,21,100,100
1650843278465,CSE 15L,A01,083654,Staff,0,3,50,50
1650843278465,CSE 15L,A02,083655,Staff,0,2,50,50
1650843284487,CSE 20,A01,083657,Staff,49,0,80,31
1650843290509,CSE 30,A01,083084,Eldon; John,0,76,40,40
1650843296531,CSE 100,A01,083659,Cao; Yingjun,0,71,50,50
1650843302557,CSE 134B,A01,083661,Powell; Thomas Allan,0,38,65,65
1650843308584,CSE 140,A01,083663,Staff,0,11,75,75
1650843314608,CSE 140L,A01,083088,Eldon; John,0,20,75,75
1650843320631,CSE 175,A01,083665,Kumar; Rakesh,7,0,25,18
1650843326665,CSE 190,A00,092507,Dubnov; Shlomo,10,0,20,10
1650843332689,ECE 45,A01,083139,Staff,0,1,60,60
1650843338713,ECE 65,A50,083695,Staff,0,5,30,30
1650843344740,ECE 109,A01,091882,Touri; Behrouz,32,0,70,38
1650843350775,ECE 180,A00,083140,Abi Samra; Nicholas Camill,20,0,30,10
1650843350775,ECE 180,B00,083141,Abi Samra; Nicholas Camill,0,0,30,30
1650843356799,MATH 10A,A01,083735,Patchell; Gregory David,2,0,30,28
1650843356799,MATH 10A,A02,083736,Patchell; Gregory David,27,0,30,3
1650843356799,MATH 10A,A03,083737,Patchell; Gregory David,24,0,30,6
1650843362822,MATH 10B,A01,083207,Staff,0,9,30,30
1650843362822,MATH 10B,A02,083208,Staff,0,6,30,30
1650843362822,MATH 10B,B01,083739,Staff,9,0,30,21
1650843362822,MATH 10B,B02,083740,Staff,28,0,30,2
1650843368856,MATH 18,A01,083743,Staff,0,0,30,30
1650843368856,MATH 18,A02,083744,Staff,23,0,30,7
1650843368856,MATH 18,A03,083745,Staff,21,0,30,9
1650843368856,MATH 18,A04,083746,Staff,26,0,30,4
1650843368856,MATH 18,B01,083748,Staff,0,15,30,30
1650843368856,MATH 18,B02,083749,Staff,0,13,30,30
1650843368856,MATH 18,B03,083750,Staff,0,13,30,30
1650843368856,MATH 18,B04,083751,Staff,0,13,30,30
1650843374883,MATH 20A,A01,083754,Staff,19,0,40,21
1650843380915,MATH 20B,A01,083756,Staff,0,14,30,30
1650843380915,MATH 20B,A02,083757,Staff,0,12,30,30
1650843386940,MATH 20C,A01,083760,Staff,0,17,30,30
1650843386940,MATH 20C,A02,083761,Staff,0,16,30,30
1650843386940,MATH 20C,B01,083762,Staff,9,0,30,21
1650843386940,MATH 20C,B02,083763,Staff,28,0,30,2
1650843392968,MATH 20D,A01,083765,Staff,2,1,30,28
1650843392968,MATH 20D,A02,083766,Staff,6,0,30,24
1650843392968,MATH 20D,A03,083767,Staff,23,0,30,7
1650843398994,MATH 20E,A01,083771,Staff,2,0,30,28
1650843398994,MATH 20E,A02,083772,Staff,13,0,30,17
1650843398994,MATH 20E,B01,083773,Staff,0,0,30,30
1650843398994,MATH 20E,B02,083774,Staff,5,0,30,25
1650843405018,MATH 103A,A01,083777,Staff,0,16,30,30
1650843405018,MATH 103A,A02,083778,Staff,0,15,30,30
1650843405018,MATH 103A,B01,083779,Staff,0,15,30,30
1650843405018,MATH 103A,B02,083780,Staff,1,15,30,29
1650843411042,MATH 105,A01,085443,Staff,0,22,30,30
1650843417066,MATH 109,A01,083213,Anzaldo; Leesa B,0,7,30,30
1650843417066,MATH 109,A02,083214,Anzaldo; Leesa B,0,7,30,30
1650843417066,MATH 109,B01,083215,Anzaldo; Leesa B,0,8,30,30
1650843417066,MATH 109,B02,083216,Anzaldo; Leesa B,0,7,30,30
1650843423095,MATH 142A,A01,083219,Chow; Bennett,0,16,30,30
1650843423095,MATH 142A,A02,083220,Chow; Bennett,0,15,30,30
1650843423095,MATH 142A,B01,083221,Chow; Bennett,0,16,30,30
1650843423095,MATH 142A,B02,083222,Chow; Bennett,0,14,30,30
1650843429127,MATH 193A,A01,083224,Staff,0,6,30,30
1650843429127,MATH 193A,A02,083225,Staff,0,6,30,30
1650843429127,MATH 193A,A03,083781,Staff,0,6,30,30
1650843429127,MATH 193A,A04,083782,Staff,0,7,30,30
1650843435159,MATH 197,001,091859,McAuley; Julian John,9998,0,9999,1
1650843441219,COGS 9,A01,083615,Staff,0,17,60,60
1650843447245,COGS 11,A01,083617,Boyle; Mary E. T.,15,0,40,25
1650843453268,COGS 13,A01,083071,Staff,0,38,40,40
1650843459400,COGS 14A,A01,092681,Staff,0,36,100,100
1650843465424,COGS 14B,A01,083073,Cheng; Tzu-Han,0,12,50,50
1650843471451,COGS 17,A01,092677,Staff,12,0,75,63
1650843477475,COGS 100,A01,083619,Staff,0,30,60,60
1650843483501,COGS 101A,A01,083621,Davis; Joshua Daniel,0,29,60,60
1650843489528,COGS 101B,A01,091572,Staff,0,3,60,60
1650843495554,COGS 101C,A01,083625,Delgado; Tania,14,0,30,16
1650843501576,COGS 107A,A01,083627,Boyle; Mary E. T.,0,16,60,60
1650843507600,COGS 118A,A01,083075,Staff,0,8,60,60
1650843513628,CSE 3,A50,083646,Miranda; Gregory Joseph,18,0,38,20
1650843513628,CSE 3,A51,083647,Miranda; Gregory Joseph,36,0,37,1
1650843519652,CSE 8A,A50,083650,Miranda; Gregory Joseph,0,29,40,40
1650843525685,CSE 11,A01,083080,Cao; Yingjun,0,96,40,40
1650843531712,CSE 12,A01,083652,Staff,0,21,100,100
1650843537735,CSE 15L,A01,083654,Staff,0,3,50,50
1650843537735,CSE 15L,A02,083655,Staff,0,2,50,50
1650843543760,CSE 20,A01,083657,Staff,49,0,80,31
1650843549782,CSE 30,A01,083084,Eldon; John,0,76,40,40
1650843555806,CSE 100,A01,083659,Cao; Yingjun,0,71,50,50
1650843561834,CSE 134B,A01,083661,Powell; Thomas Allan,0,38,65,65
1650843567861,CSE 140,A01,083663,Staff,0,11,75,75
1650843573886,CSE 140L,A01,083088,Eldon; John,0,20,75,75
1650843579911,CSE 175,A01,083665,Kumar; Rakesh,7,0,25,18
1650843585934,CSE 190,A00,092507,Dubnov; Shlomo,10,0,20,10
1650843591957,ECE 45,A01,083139,Staff,0,1,60,60
1650843597980,ECE 65,A50,083695,Staff,0,5,30,30
1650843604006,ECE 109,A01,091882,Touri; Behrouz,32,0,70,38
1650843610035,ECE 180,A00,083140,Abi Samra; Nicholas Camill,20,0,30,10
1650843610035,ECE 180,B00,083141,Abi Samra; Nicholas Camill,0,0,30,30
1650843616065,MATH 10A,A01,083735,Patchell; Gregory David,2,0,30,28
1650843616065,MATH 10A,A02,083736,Patchell; Gregory David,27,0,30,3
1650843616065,MATH 10A,A03,083737,Patchell; Gregory David,24,0,30,6
1650843622092,MATH 10B,A01,083207,Staff,0,9,30,30
1650843622092,MATH 10B,A02,083208,Staff,0,6,30,30
1650843622092,MATH 10B,B01,083739,Staff,10,0,30,20
1650843622092,MATH 10B,B02,083740,Staff,28,0,30,2
1650843628117,MATH 18,A01,083743,Staff,0,0,30,30
1650843628117,MATH 18,A02,083744,Staff,23,0,30,7
1650843628117,MATH 18,A03,083745,Staff,21,0,30,9
1650843628117,MATH 18,A04,083746,Staff,26,0,30,4
1650843628117,MATH 18,B01,083748,Staff,0,15,30,30
1650843628117,MATH 18,B02,083749,Staff,0,13,30,30
1650843628117,MATH 18,B03,083750,Staff,0,13,30,30
1650843628117,MATH 18,B04,083751,Staff,0,13,30,30
1650843634139,MATH 20A,A01,083754,Staff,19,0,40,21
1650843640163,MATH 20B,A01,083756,Staff,0,14,30,30
1650843640163,MATH 20B,A02,083757,Staff,0,12,30,30
1650843646187,MATH 20C,A01,083760,Staff,0,17,30,30
1650843646187,MATH 20C,A02,083761,Staff,0,16,30,30
1650843646187,MATH 20C,B01,083762,Staff,9,0,30,21
1650843646187,MATH 20C,B02,083763,Staff,28,0,30,2
1650843652211,MATH 20D,A01,083765,Staff,2,1,30,28
1650843652211,MATH 20D,A02,083766,Staff,6,0,30,24
1650843652211,MATH 20D,A03,083767,Staff,23,0,30,7
1650843658238,MATH 20E,A01,083771,Staff,2,0,30,28
1650843658238,MATH 20E,A02,083772,Staff,13,0,30,17
1650843658238,MATH 20E,B01,083773,Staff,0,0,30,30
1650843658238,MATH 20E,B02,083774,Staff,5,0,30,25
1650843664260,MATH 103A,A01,083777,Staff,0,16,30,30
1650843664260,MATH 103A,A02,083778,Staff,0,15,30,30
1650843664260,MATH 103A,B01,083779,Staff,0,15,30,30
1650843664260,MATH 103A,B02,083780,Staff,1,15,30,29
1650843670286,MATH 105,A01,085443,Staff,0,22,30,30
1650843676309,MATH 109,A01,083213,Anzaldo; Leesa B,0,7,30,30
1650843676309,MATH 109,A02,083214,Anzaldo; Leesa B,0,7,30,30
1650843676309,MATH 109,B01,083215,Anzaldo; Leesa B,0,8,30,30
1650843676309,MATH 109,B02,083216,Anzaldo; Leesa B,0,7,30,30
1650843682339,MATH 142A,A01,083219,Chow; Bennett,0,16,30,30
1650843682339,MATH 142A,A02,083220,Chow; Bennett,0,15,30,30
1650843682339,MATH 142A,B01,083221,Chow; Bennett,0,16,30,30
1650843682339,MATH 142A,B02,083222,Chow; Bennett,0,14,30,30
1650843688364,MATH 193A,A01,083224,Staff,0,6,30,30
1650843688364,MATH 193A,A02,083225,Staff,0,6,30,30
1650843688364,MATH 193A,A03,083781,Staff,0,6,30,30
1650843688364,MATH 193A,A04,083782,Staff,0,7,30,30
1650843694387,MATH 197,001,091859,McAuley; Julian John,9998,0,9999,1
1650843700447,COGS 9,A01,083615,Staff,0,17,60,60
1650843706475,COGS 11,A01,083617,Boyle; Mary E. T.,15,0,40,25
1650843712497,COGS 13,A01,083071,Staff,0,38,40,40
1650843718524,COGS 14A,A01,092681,Staff,0,36,100,100
1650843724547,COGS 14B,A01,083073,Cheng; Tzu-Han,0,12,50,50
1650843730575,COGS 17,A01,092677,Staff,12,0,75,63
1650843736596,COGS 100,A01,083619,Staff,0,30,60,60
1650843742623,COGS 101A,A01,083621,Davis; Joshua Daniel,0,29,60,60
1650843748650,COGS 101B,A01,091572,Staff,0,3,60,60
1650843754673,COGS 101C,A01,083625,Delgado; Tania,14,0,30,16
1650843760698,COGS 107A,A01,083627,Boyle; Mary E. T.,0,16,60,60
1650843766724,COGS 118A,A01,083075,Staff,0,8,60,60
1650843772746,CSE 3,A50,083646,Miranda; Gregory Joseph,18,0,38,20
1650843772746,CSE 3,A51,083647,Miranda; Gregory Joseph,36,0,37,1
1650843778772,CSE 8A,A50,083650,Miranda; Gregory Joseph,0,29,40,40
1650843784803,CSE 11,A01,083080,Cao; Yingjun,0,96,40,40
1650843790829,CSE 12,A01,083652,Staff,0,21,100,100
1650843796854,CSE 15L,A01,083654,Staff,0,3,50,50
1650843796854,CSE 15L,A02,083655,Staff,0,2,50,50
1650843802879,CSE 20,A01,083657,Staff,49,0,80,31
1650843808905,CSE 30,A01,083084,Eldon; John,0,76,40,40
1650843814927,CSE 100,A01,083659,Cao; Yingjun,0,71,50,50
1650843820950,CSE 134B,A01,083661,Powell; Thomas Allan,0,38,65,65
1650843826974,CSE 140,A01,083663,Staff,0,11,75,75
1650843833005,CSE 140L,A01,083088,Eldon; John,0,20,75,75
1650843839029,CSE 175,A01,083665,Kumar; Rakesh,7,0,25,18
1650843845053,CSE 190,A00,092507,Dubnov; Shlomo,10,0,20,10
1650843851079,ECE 45,A01,083139,Staff,0,1,60,60
1650843857104,ECE 65,A50,083695,Staff,0,5,30,30
1650843863129,ECE 109,A01,091882,Touri; Behrouz,32,0,70,38
1650843869153,ECE 180,A00,083140,Abi Samra; Nicholas Camill,20,0,30,10
1650843869153,ECE 180,B00,083141,Abi Samra; Nicholas Camill,0,0,30,30
1650843875177,MATH 10A,A01,083735,Patchell; Gregory David,2,0,30,28
1650843875177,MATH 10A,A02,083736,Patchell; Gregory David,27,0,30,3
1650843875177,MATH 10A,A03,083737,Patchell; Gregory David,24,0,30,6
1650843881201,MATH 10B,A01,083207,Staff,0,9,30,30
1650843881201,MATH 10B,A02,083208,Staff,0,6,30,30
1650843881201,MATH 10B,B01,083739,Staff,10,0,30,20
1650843881201,MATH 10B,B02,083740,Staff,28,0,30,2
1650843887230,MATH 18,A01,083743,Staff,0,0,30,30
1650843887230,MATH 18,A02,083744,Staff,23,0,30,7
1650843887230,MATH 18,A03,083745,Staff,21,0,30,9
1650843887230,MATH 18,A04,083746,Staff,26,0,30,4
1650843887230,MATH 18,B01,083748,Staff,0,15,30,30
1650843887230,MATH 18,B02,083749,Staff,0,13,30,30
1650843887230,MATH 18,B03,083750,Staff,0,13,30,30
1650843887230,MATH 18,B04,083751,Staff,0,13,30,30
1650843893253,MATH 20A,A01,083754,Staff,19,0,40,21
1650843899277,MATH 20B,A01,083756,Staff,0,14,30,30
1650843899277,MATH 20B,A02,083757,Staff,0,12,30,30
1650843905303,MATH 20C,A01,083760,Staff,0,17,30,30
1650843905303,MATH 20C,A02,083761,Staff,0,16,30,30
1650843905303,MATH 20C,B01,083762,Staff,9,0,30,21
1650843905303,MATH 20C,B02,083763,Staff,28,0,30,2
1650843911329,MATH 20D,A01,083765,Staff,2,1,30,28
1650843911329,MATH 20D,A02,083766,Staff,6,0,30,24
1650843911329,MATH 20D,A03,083767,Staff,23,0,30,7
1650843917355,MATH 20E,A01,083771,Staff,2,0,30,28
1650843917355,MATH 20E,A02,083772,Staff,13,0,30,17
1650843917355,MATH 20E,B01,083773,Staff,0,0,30,30
1650843917355,MATH 20E,B02,083774,Staff,5,0,30,25
1650843923378,MATH 103A,A01,083777,Staff,0,16,30,30
1650843923378,MATH 103A,A02,083778,Staff,0,15,30,30
1650843923378,MATH 103A,B01,083779,Staff,0,15,30,30
1650843923378,MATH 103A,B02,083780,Staff,1,15,30,29
1650843929400,MATH 105,A01,085443,Staff,0,22,30,30
1650843935421,MATH 109,A01,083213,Anzaldo; Leesa B,0,7,30,30
1650843935421,MATH 109,A02,083214,Anzaldo; Leesa B,0,7,30,30
1650843935421,MATH 109,B01,083215,Anzaldo; Leesa B,0,8,30,30
1650843935421,MATH 109,B02,083216,Anzaldo; Leesa B,0,7,30,30
1650843941446,MATH 142A,A01,083219,Chow; Bennett,0,16,30,30
1650843941446,MATH 142A,A02,083220,Chow; Bennett,0,15,30,30
1650843941446,MATH 142A,B01,083221,Chow; Bennett,0,16,30,30
1650843941446,MATH 142A,B02,083222,Chow; Bennett,0,14,30,30
1650843947470,MATH 193A,A01,083224,Staff,0,6,30,30
1650843947470,MATH 193A,A02,083225,Staff,0,6,30,30
1650843947470,MATH 193A,A03,083781,Staff,0,6,30,30
1650843947470,MATH 193A,A04,083782,Staff,0,7,30,30
1650843953493,MATH 197,001,091859,McAuley; Julian John,9998,0,9999,1
1650843959543,COGS 9,A01,083615,Staff,0,17,60,60
1650843965575,COGS 11,A01,083617,Boyle; Mary E. T.,15,0,40,25
1650843971598,COGS 13,A01,083071,Staff,0,38,40,40
1650843977622,COGS 14A,A01,092681,Staff,0,36,100,100
1650843983649,COGS 14B,A01,083073,Cheng; Tzu-Han,0,12,50,50
1650843989678,COGS 17,A01,092677,Staff,12,0,75,63
1650843995702,COGS 100,A01,083619,Staff,0,30,60,60
1650844001728,COGS 101A,A01,083621,Davis; Joshua Daniel,0,29,60,60
1650844007753,COGS 101B,A01,091572,Staff,0,3,60,60
1650844013781,COGS 101C,A01,083625,Delgado; Tania,14,0,30,16
1650844019805,COGS 107A,A01,083627,Boyle; Mary E. T.,0,16,60,60
1650844025832,COGS 118A,A01,083075,Staff,0,8,60,60
1650844031867,CSE 3,A50,083646,Miranda; Gregory Joseph,18,0,38,20
1650844031867,CSE 3,A51,083647,Miranda; Gregory Joseph,36,0,37,1
1650844037894,CSE 8A,A50,083650,Miranda; Gregory Joseph,0,29,40,40
1650844043925,CSE 11,A01,083080,Cao; Yingjun,0,96,40,40
1650844049951,CSE 12,A01,083652,Staff,0,21,100,100
1650844056074,CSE 15L,A01,083654,Staff,0,3,50,50
1650844056074,CSE 15L,A02,083655,Staff,0,2,50,50
1650844062098,CSE 20,A01,083657,Staff,49,0,80,31
1650844068121,CSE 30,A01,083084,Eldon; John,0,76,40,40
1650844074143,CSE 100,A01,083659,Cao; Yingjun,0,71,50,50
1650844080175,CSE 134B,A01,083661,Powell; Thomas Allan,0,38,65,65
1650844086202,CSE 140,A01,083663,Staff,0,11,75,75
1650844092226,CSE 140L,A01,083088,Eldon; John,0,20,75,75
1650844098248,CSE 175,A01,083665,Kumar; Rakesh,7,0,25,18
1650844104275,CSE 190,A00,092507,Dubnov; Shlomo,10,0,20,10
1650844110298,ECE 45,A01,083139,Staff,0,1,60,60
1650844116324,ECE 65,A50,083695,Staff,0,5,30,30
1650844122359,ECE 109,A01,091882,Touri; Behrouz,32,0,70,38
1650844128384,ECE 180,A00,083140,Abi Samra; Nicholas Camill,20,0,30,10
1650844128384,ECE 180,B00,083141,Abi Samra; Nicholas Camill,0,0,30,30
1650844134411,MATH 10A,A01,083735,Patchell; Gregory David,2,0,30,28
1650844134411,MATH 10A,A02,083736,Patchell; Gregory David,27,0,30,3
1650844134411,MATH 10A,A03,083737,Patchell; Gregory David,24,0,30,6
1650844140435,MATH 10B,A01,083207,Staff,0,9,30,30
1650844140435,MATH 10B,A02,083208,Staff,0,6,30,30
1650844140435,MATH 10B,B01,083739,Staff,10,0,30,20
1650844140435,MATH 10B,B02,083740,Staff,28,0,30,2
1650844146465,MATH 18,A01,083743,Staff,0,0,30,30
1650844146465,MATH 18,A02,083744,Staff,23,0,30,7
1650844146465,MATH 18,A03,083745,Staff,21,0,30,9
1650844146465,MATH 18,A04,083746,Staff,26,0,30,4
1650844146465,MATH 18,B01,083748,Staff,0,15,30,30
1650844146465,MATH 18,B02,083749,Staff,0,13,30,30
1650844146465,MATH 18,B03,083750,Staff,0,13,30,30
1650844146465,MATH 18,B04,083751,Staff,0,13,30,30
1650844152492,MATH 20A,A01,083754,Staff,19,0,40,21
1650844158526,MATH 20B,A01,083756,Staff,0,14,30,30
1650844158526,MATH 20B,A02,083757,Staff,0,12,30,30
1650844164550,MATH 20C,A01,083760,Staff,0,17,30,30
1650844164550,MATH 20C,A02,083761,Staff,0,16,30,30
1650844164550,MATH 20C,B01,083762,Staff,9,0,30,21
1650844164550,MATH 20C,B02,083763,Staff,28,0,30,2
1650844170580,MATH 20D,A01,083765,Staff,2,1,30,28
1650844170580,MATH 20D,A02,083766,Staff,6,0,30,24
1650844170580,MATH 20D,A03,083767,Staff,23,0,30,7
1650844176608,MATH 20E,A01,083771,Staff,2,0,30,28
1650844176608,MATH 20E,A02,083772,Staff,13,0,30,17
1650844176608,MATH 20E,B01,083773,Staff,0,0,30,30
1650844176608,MATH 20E,B02,083774,Staff,5,0,30,25
1650844182640,MATH 103A,A01,083777,Staff,0,16,30,30
1650844182640,MATH 103A,A02,083778,Staff,0,15,30,30
1650844182640,MATH 103A,B01,083779,Staff,0,15,30,30
1650844182640,MATH 103A,B02,083780,Staff,1,15,30,29
1650844188667,MATH 105,A01,085443,Staff,0,22,30,30
1650844194696,MATH 109,A01,083213,Anzaldo; Leesa B,0,7,30,30
1650844194696,MATH 109,A02,083214,Anzaldo; Leesa B,0,7,30,30
1650844194696,MATH 109,B01,083215,Anzaldo; Leesa B,0,8,30,30
1650844194696,MATH 109,B02,083216,Anzaldo; Leesa B,0,7,30,30
1650844200720,MATH 142A,A01,083219,Chow; Bennett,0,16,30,30
1650844200720,MATH 142A,A02,083220,Chow; Bennett,0,15,30,30
1650844200720,MATH 142A,B01,083221,Chow; Bennett,0,16,30,30
1650844200720,MATH 142A,B02,083222,Chow; Bennett,0,14,30,30
1650844206744,MATH 193A,A01,083224,Staff,0,6,30,30
1650844206744,MATH 193A,A02,083225,Staff,0,6,30,30
1650844206744,MATH 193A,A03,083781,Staff,0,6,30,30
1650844206744,MATH 193A,A04,083782,Staff,0,7,30,30
1650844212770,MATH 197,001,091859,McAuley; Julian John,9998,0,9999,1
1650844218822,COGS 9,A01,083615,Staff,0,17,60,60
1650844224850,COGS 11,A01,083617,Boyle; Mary E. T.,15,0,40,25
1650844230877,COGS 13,A01,083071,Staff,0,38,40,40
1650844236902,COGS 14A,A01,092681,Staff,0,36,100,100
1650844242928,COGS 14B,A01,083073,Cheng; Tzu-Han,0,12,50,50
1650844248952,COGS 17,A01,092677,Staff,12,0,75,63
1650844254978,COGS 100,A01,083619,Staff,0,30,60,60
1650844261005,COGS 101A,A01,083621,Davis; Joshua Daniel,0,29,60,60
1650844267036,COGS 101B,A01,091572,Staff,0,3,60,60
1650844273063,COGS 101C,A01,083625,Delgado; Tania,14,0,30,16
1650844279087,COGS 107A,A01,083627,Boyle; Mary E. T.,0,16,60,60
1650844285110,COGS 118A,A01,083075,Staff,0,8,60,60
1650844291135,CSE 3,A50,083646,Miranda; Gregory Joseph,18,0,38,20
1650844291135,CSE 3,A51,083647,Miranda; Gregory Joseph,36,0,37,1
1650844297169,CSE 8A,A50,083650,Miranda; Gregory Joseph,0,29,40,40
1650844303193,CSE 11,A01,083080,Cao; Yingjun,0,96,40,40
1650844309218,CSE 12,A01,083652,Staff,0,21,100,100
1650844315244,CSE 15L,A01,083654,Staff,0,3,50,50
1650844315244,CSE 15L,A02,083655,Staff,0,2,50,50
1650844321267,CSE 20,A01,083657,Staff,49,0,80,31
1650844327293,CSE 30,A01,083084,Eldon; John,0,76,40,40
1650844333316,CSE 100,A01,083659,Cao; Yingjun,0,71,50,50
1650844339340,CSE 134B,A01,083661,Powell; Thomas Allan,0,38,65,65
1650844345379,CSE 140,A01,083663,Staff,0,11,75,75
1650844351402,CSE 140L,A01,083088,Eldon; John,0,20,75,75
1650844357428,CSE 175,A01,083665,Kumar; Rakesh,7,0,25,18
1650844363452,CSE 190,A00,092507,Dubnov; Shlomo,10,0,20,10
1650844369489,ECE 45,A01,083139,Staff,0,1,60,60
1650844375515,ECE 65,A50,083695,Staff,0,5,30,30
1650844381539,ECE 109,A01,091882,Touri; Behrouz,32,0,70,38
1650844387562,ECE 180,A00,083140,Abi Samra; Nicholas Camill,20,0,30,10
1650844387562,ECE 180,B00,083141,Abi Samra; Nicholas Camill,0,0,30,30
1650844393587,MATH 10A,A01,083735,Patchell; Gregory David,2,0,30,28
1650844393587,MATH 10A,A02,083736,Patchell; Gregory David,27,0,30,3
1650844393587,MATH 10A,A03,083737,Patchell; Gregory David,24,0,30,6
1650844399611,MATH 10B,A01,083207,Staff,0,9,30,30
1650844399611,MATH 10B,A02,083208,Staff,0,6,30,30
1650844399611,MATH 10B,B01,083739,Staff,10,0,30,20
1650844399611,MATH 10B,B02,083740,Staff,28,0,30,2
1650844405640,MATH 18,A01,083743,Staff,0,0,30,30
1650844405640,MATH 18,A02,083744,Staff,23,0,30,7
1650844405640,MATH 18,A03,083745,Staff,21,0,30,9
1650844405640,MATH 18,A04,083746,Staff,26,0,30,4
1650844405640,MATH 18,B01,083748,Staff,0,15,30,30
1650844405640,MATH 18,B02,083749,Staff,0,13,30,30
1650844405640,MATH 18,B03,083750,Staff,0,13,30,30
1650844405640,MATH 18,B04,083751,Staff,0,13,30,30
1650844411666,MATH 20A,A01,083754,Staff,19,0,40,21
1650844417689,MATH 20B,A01,083756,Staff,0,14,30,30
1650844417689,MATH 20B,A02,083757,Staff,0,12,30,30
1650844423717,MATH 20C,A01,083760,Staff,0,17,30,30
1650844423717,MATH 20C,A02,083761,Staff,0,16,30,30
1650844423717,MATH 20C,B01,083762,Staff,9,0,30,21
1650844423717,MATH 20C,B02,083763,Staff,28,0,30,2
1650844429741,MATH 20D,A01,083765,Staff,2,1,30,28
1650844429741,MATH 20D,A02,083766,Staff,6,0,30,24
1650844429741,MATH 20D,A03,083767,Staff,23,0,30,7
1650844435795,MATH 20E,A01,083771,Staff,2,0,30,28
1650844435795,MATH 20E,A02,083772,Staff,13,0,30,17
1650844435795,MATH 20E,B01,083773,Staff,0,0,30,30
1650844435795,MATH 20E,B02,083774,Staff,5,0,30,25
1650844441819,MATH 103A,A01,083777,Staff,0,16,30,30
1650844441819,MATH 103A,A02,083778,Staff,0,15,30,30
1650844441819,MATH 103A,B01,083779,Staff,0,15,30,30
1650844441819,MATH 103A,B02,083780,Staff,1,15,30,29
1650844447846,MATH 105,A01,085443,Staff,0,22,30,30
1650844453869,MATH 109,A01,083213,Anzaldo; Leesa B,0,7,30,30
1650844453869,MATH 109,A02,083214,Anzaldo; Leesa B,0,7,30,30
1650844453869,MATH 109,B01,083215,Anzaldo; Leesa B,0,8,30,30
1650844453869,MATH 109,B02,083216,Anzaldo; Leesa B,0,7,30,30
1650844459893,MATH 142A,A01,083219,Chow; Bennett,0,16,30,30
1650844459893,MATH 142A,A02,083220,Chow; Bennett,0,15,30,30
1650844459893,MATH 142A,B01,083221,Chow; Bennett,0,16,30,30
1650844459893,MATH 142A,B02,083222,Chow; Bennett,0,14,30,30
1650844465917,MATH 193A,A01,083224,Staff,0,6,30,30
1650844465917,MATH 193A,A02,083225,Staff,0,6,30,30
1650844465917,MATH 193A,A03,083781,Staff,0,6,30,30
1650844465917,MATH 193A,A04,083782,Staff,0,7,30,30
1650844471941,MATH 197,001,091859,McAuley; Julian John,9998,0,9999,1
1650844478002,COGS 9,A01,083615,Staff,0,17,60,60
1650844484028,COGS 11,A01,083617,Boyle; Mary E. T.,15,0,40,25
1650844490051,COGS 13,A01,083071,Staff,0,38,40,40
1650844496074,COGS 14A,A01,092681,Staff,0,36,100,100
1650844502100,COGS 14B,A01,083073,Cheng; Tzu-Han,0,12,50,50
1650844508127,COGS 17,A01,092677,Staff,12,0,75,63
1650844514154,COGS 100,A01,083619,Staff,0,30,60,60
1650844520187,COGS 101A,A01,083621,Davis; Joshua Daniel,0,29,60,60
1650844526211,COGS 101B,A01,091572,Staff,0,3,60,60
1650844532248,COGS 101C,A01,083625,Delgado; Tania,14,0,30,16
1650844538286,COGS 107A,A01,083627,Boyle; Mary E. T.,0,16,60,60
1650844544307,COGS 118A,A01,083075,Staff,0,8,60,60
1650844550335,CSE 3,A50,083646,Miranda; Gregory Joseph,18,0,38,20
1650844550335,CSE 3,A51,083647,Miranda; Gregory Joseph,36,0,37,1
1650844556360,CSE 8A,A50,083650,Miranda; Gregory Joseph,0,29,40,40
1650844562383,CSE 11,A01,083080,Cao; Yingjun,0,96,40,40
1650844568409,CSE 12,A01,083652,Staff,0,21,100,100
1650844574430,CSE 15L,A01,083654,Staff,0,3,50,50
1650844574430,CSE 15L,A02,083655,Staff,0,2,50,50
1650844580454,CSE 20,A01,083657,Staff,49,0,80,31
1650844586479,CSE 30,A01,083084,Eldon; John,0,76,40,40
1650844592504,CSE 100,A01,083659,Cao; Yingjun,0,71,50,50
1650844598529,CSE 134B,A01,083661,Powell; Thomas Allan,0,38,65,65
1650844604551,CSE 140,A01,083663,Staff,0,11,75,75
1650844610577,CSE 140L,A01,083088,Eldon; John,0,20,75,75
1650844616610,CSE 175,A01,083665,Kumar; Rakesh,7,0,25,18
1650844622634,CSE 190,A00,092507,Dubnov; Shlomo,10,0,20,10
1650844628656,ECE 45,A01,083139,Staff,0,1,60,60
1650844634692,ECE 65,A50,083695,Staff,0,5,30,30
1650844640723,ECE 109,A01,091882,Touri; Behrouz,32,0,70,38
1650844646753,ECE 180,A00,083140,Abi Samra; Nicholas Camill,20,0,30,10
1650844646753,ECE 180,B00,083141,Abi Samra; Nicholas Camill,0,0,30,30
1650844652869,MATH 10A,A01,083735,Patchell; Gregory David,2,0,30,28
1650844652869,MATH 10A,A02,083736,Patchell; Gregory David,27,0,30,3
1650844652869,MATH 10A,A03,083737,Patchell; Gregory David,24,0,30,6
1650844658893,MATH 10B,A01,083207,Staff,0,9,30,30
1650844658893,MATH 10B,A02,083208,Staff,0,6,30,30
1650844658893,MATH 10B,B01,083739,Staff,10,0,30,20
1650844658893,MATH 10B,B02,083740,Staff,28,0,30,2
1650844664918,MATH 18,A01,083743,Staff,0,0,30,30
1650844664918,MATH 18,A02,083744,Staff,23,0,30,7
1650844664918,MATH 18,A03,083745,Staff,21,0,30,9
1650844664918,MATH 18,A04,083746,Staff,26,0,30,4
1650844664918,MATH 18,B01,083748,Staff,0,15,30,30
1650844664918,MATH 18,B02,083749,Staff,0,13,30,30
1650844664918,MATH 18,B03,083750,Staff,0,13,30,30
1650844664918,MATH 18,B04,083751,Staff,0,13,30,30
1650844670944,MATH 20A,A01,083754,Staff,19,0,40,21
1650844676970,MATH 20B,A01,083756,Staff,0,14,30,30
1650844676970,MATH 20B,A02,083757,Staff,0,12,30,30
1650844682993,MATH 20C,A01,083760,Staff,0,17,30,30
1650844682993,MATH 20C,A02,083761,Staff,0,16,30,30
1650844682993,MATH 20C,B01,083762,Staff,9,0,30,21
1650844682993,MATH 20C,B02,083763,Staff,28,0,30,2
1650844689017,MATH 20D,A01,083765,Staff,2,1,30,28
1650844689017,MATH 20D,A02,083766,Staff,6,0,30,24
1650844689017,MATH 20D,A03,083767,Staff,23,0,30,7
1650844695039,MATH 20E,A01,083771,Staff,2,0,30,28
1650844695039,MATH 20E,A02,083772,Staff,13,0,30,17
1650844695039,MATH 20E,B01,083773,Staff,0,0,30,30
1650844695039,MATH 20E,B02,083774,Staff,5,0,30,25
1650844701061,MATH 103A,A01,083777,Staff,0,16,30,30
1650844701061,MATH 103A,A02,083778,Staff,0,15,30,30
1650844701061,MATH 103A,B01,083779,Staff,0,15,30,30
1650844701061,MATH 103A,B02,083780,Staff,1,15,30,29
1650844707084,MATH 105,A01,085443,Staff,0,22,30,30
1650844713109,MATH 109,A01,083213,Anzaldo; Leesa B,0,7,30,30
1650844713109,MATH 109,A02,083214,Anzaldo; Leesa B,0,7,30,30
1650844713109,MATH 109,B01,083215,Anzaldo; Leesa B,0,8,30,30
1650844713109,MATH 109,B02,083216,Anzaldo; Leesa B,0,7,30,30
1650844719133,MATH 142A,A01,083219,Chow; Bennett,0,16,30,30
1650844719133,MATH 142A,A02,083220,Chow; Bennett,0,15,30,30
1650844719133,MATH 142A,B01,083221,Chow; Bennett,0,16,30,30
1650844719133,MATH 142A,B02,083222,Chow; Bennett,0,14,30,30
1650844725161,MATH 193A,A01,083224,Staff,0,6,30,30
1650844725161,MATH 193A,A02,083225,Staff,0,6,30,30
1650844725161,MATH 193A,A03,083781,Staff,0,6,30,30
1650844725161,MATH 193A,A04,083782,Staff,0,7,30,30
1650844731183,MATH 197,001,091859,McAuley; Julian John,9998,0,9999,1
1650844737264,COGS 9,A01,083615,Staff,0,17,60,60
1650844743293,COGS 11,A01,083617,Boyle; Mary E. T.,15,0,40,25
1650844749316,COGS 13,A01,083071,Staff,0,38,40,40
1650844755342,COGS 14A,A01,092681,Staff,0,36,100,100
1650844761366,COGS 14B,A01,083073,Cheng; Tzu-Han,0,12,50,50
1650844767392,COGS 17,A01,092677,Staff,12,0,75,63
1650844773415,COGS 100,A01,083619,Staff,0,30,60,60
1650844779442,COGS 101A,A01,083621,Davis; Joshua Daniel,0,29,60,60
1650844785466,COGS 101B,A01,091572,Staff,0,3,60,60
1650844791496,COGS 101C,A01,083625,Delgado; Tania,14,0,30,16
1650844797523,COGS 107A,A01,083627,Boyle; Mary E. T.,0,16,60,60
1650844803565,COGS 118A,A01,083075,Staff,0,8,60,60
1650844809601,CSE 3,A50,083646,Miranda; Gregory Joseph,18,0,38,20
1650844809601,CSE 3,A51,083647,Miranda; Gregory Joseph,36,0,37,1
1650844815623,CSE 8A,A50,083650,Miranda; Gregory Joseph,0,29,40,40
1650844821655,CSE 11,A01,083080,Cao; Yingjun,0,96,40,40
1650844827679,CSE 12,A01,083652,Staff,0,21,100,100
1650844833708,CSE 15L,A01,083654,Staff,0,3,50,50
1650844833708,CSE 15L,A02,083655,Staff,0,2,50,50
1650844839732,CSE 20,A01,083657,Staff,49,0,80,31
1650844845754,CSE 30,A01,083084,Eldon; John,0,76,40,40
1650844851789,CSE 100,A01,083659,Cao; Yingjun,0,71,50,50
1650844857814,CSE 134B,A01,083661,Powell; Thomas Allan,0,38,65,65
1650844863837,CSE 140,A01,083663,Staff,0,11,75,75
1650844869871,CSE 140L,A01,083088,Eldon; John,0,20,75,75
1650844875894,CSE 175,A01,083665,Kumar; Rakesh,7,0,25,18
1650844881919,CSE 190,A00,092507,Dubnov; Shlomo,10,0,20,10
1650844887945,ECE 45,A01,083139,Staff,0,1,60,60
1650844893974,ECE 65,A50,083695,Staff,0,5,30,30
1650844899997,ECE 109,A01,091882,Touri; Behrouz,32,0,70,38
1650844906023,ECE 180,A00,083140,Abi Samra; Nicholas Camill,20,0,30,10
1650844906023,ECE 180,B00,083141,Abi Samra; Nicholas Camill,0,0,30,30
1650844912046,MATH 10A,A01,083735,Patchell; Gregory David,2,0,30,28
1650844912046,MATH 10A,A02,083736,Patchell; Gregory David,27,0,30,3
1650844912046,MATH 10A,A03,083737,Patchell; Gregory David,24,0,30,6
1650844918073,MATH 10B,A01,083207,Staff,0,9,30,30
1650844918073,MATH 10B,A02,083208,Staff,0,6,30,30
1650844918073,MATH 10B,B01,083739,Staff,10,0,30,20
1650844918073,MATH 10B,B02,083740,Staff,28,0,30,2
1650844924097,MATH 18,A01,083743,Staff,0,0,30,30
1650844924097,MATH 18,A02,083744,Staff,23,0,30,7
1650844924097,MATH 18,A03,083745,Staff,21,0,30,9
1650844924097,MATH 18,A04,083746,Staff,26,0,30,4
1650844924097,MATH 18,B01,083748,Staff,0,15,30,30
1650844924097,MATH 18,B02,083749,Staff,0,13,30,30
1650844924097,MATH 18,B03,083750,Staff,0,13,30,30
1650844924097,MATH 18,B04,083751,Staff,0,13,30,30
1650844930121,MATH 20A,A01,083754,Staff,19,0,40,21
1650844936147,MATH 20B,A01,083756,Staff,0,14,30,30
1650844936147,MATH 20B,A02,083757,Staff,0,12,30,30
1650844942176,MATH 20C,A01,083760,Staff,0,17,30,30
1650844942176,MATH 20C,A02,083761,Staff,0,16,30,30
1650844942176,MATH 20C,B01,083762,Staff,9,0,30,21
1650844942176,MATH 20C,B02,083763,Staff,28,0,30,2
1650844948203,MATH 20D,A01,083765,Staff,2,1,30,28
1650844948203,MATH 20D,A02,083766,Staff,6,0,30,24
1650844948203,MATH 20D,A03,083767,Staff,23,0,30,7
1650844954243,MATH 20E,A01,083771,Staff,2,0,30,28
1650844954243,MATH 20E,A02,083772,Staff,13,0,30,17
1650844954243,MATH 20E,B01,083773,Staff,0,0,30,30
1650844954243,MATH 20E,B02,083774,Staff,5,0,30,25
1650844960268,MATH 103A,A01,083777,Staff,0,16,30,30
1650844960268,MATH 103A,A02,083778,Staff,0,15,30,30
1650844960268,MATH 103A,B01,083779,Staff,0,15,30,30
1650844960268,MATH 103A,B02,083780,Staff,1,15,30,29
1650844966290,MATH 105,A01,085443,Staff,0,22,30,30
1650844972319,MATH 109,A01,083213,Anzaldo; Leesa B,0,7,30,30
1650844972319,MATH 109,A02,083214,Anzaldo; Leesa B,0,7,30,30
1650844972319,MATH 109,B01,083215,Anzaldo; Leesa B,0,8,30,30
1650844972319,MATH 109,B02,083216,Anzaldo; Leesa B,0,7,30,30
1650844978342,MATH 142A,A01,083219,Chow; Bennett,0,16,30,30
1650844978342,MATH 142A,A02,083220,Chow; Bennett,0,15,30,30
1650844978342,MATH 142A,B01,083221,Chow; Bennett,0,16,30,30
1650844978342,MATH 142A,B02,083222,Chow; Bennett,0,14,30,30
1650844984365,MATH 193A,A01,083224,Staff,0,6,30,30
1650844984365,MATH 193A,A02,083225,Staff,0,6,30,30
1650844984365,MATH 193A,A03,083781,Staff,0,6,30,30
1650844984365,MATH 193A,A04,083782,Staff,0,7,30,30
1650844990402,MATH 197,001,091859,McAuley; Julian John,9998,0,9999,1
1650844996467,COGS 9,A01,083615,Staff,0,17,60,60
1650845002494,COGS 11,A01,083617,Boyle; Mary E. T.,15,0,40,25
1650845008526,COGS 13,A01,083071,Staff,0,38,40,40
1650845014550,COGS 14A,A01,092681,Staff,0,36,100,100
1650845020577,COGS 14B,A01,083073,Cheng; Tzu-Han,0,12,50,50
1650845026604,COGS 17,A01,092677,Staff,12,0,75,63
1650845032628,COGS 100,A01,083619,Staff,0,30,60,60
1650845038652,COGS 101A,A01,083621,Davis; Joshua Daniel,0,29,60,60
1650845044679,COGS 101B,A01,091572,Staff,0,3,60,60
1650845050702,COGS 101C,A01,083625,Delgado; Tania,14,0,30,16
1650845056725,COGS 107A,A01,083627,Boyle; Mary E. T.,0,16,60,60
1650845062749,COGS 118A,A01,083075,Staff,0,8,60,60
1650845068775,CSE 3,A50,083646,Miranda; Gregory Joseph,18,0,38,20
1650845068775,CSE 3,A51,083647,Miranda; Gregory Joseph,36,0,37,1
1650845074798,CSE 8A,A50,083650,Miranda; Gregory Joseph,0,29,40,40
1650845080821,CSE 11,A01,083080,Cao; Yingjun,0,96,40,40
1650845086852,CSE 12,A01,083652,Staff,0,21,100,100
1650845092876,CSE 15L,A01,083654,Staff,0,3,50,50
1650845092876,CSE 15L,A02,083655,Staff,0,2,50,50
1650845098900,CSE 20,A01,083657,Staff,49,0,80,31
1650845104923,CSE 30,A01,083084,Eldon; John,0,76,40,40
1650845110951,CSE 100,A01,083659,Cao; Yingjun,0,71,50,50
1650845116976,CSE 134B,A01,083661,Powell; Thomas Allan,0,38,65,65
1650845122999,CSE 140,A01,083663,Staff,0,11,75,75
1650845129033,CSE 140L,A01,083088,Eldon; John,0,20,75,75
1650845135059,CSE 175,A01,083665,Kumar; Rakesh,7,0,25,18
1650845141082,CSE 190,A00,092507,Dubnov; Shlomo,10,0,20,10
1650845147104,ECE 45,A01,083139,Staff,0,1,60,60
1650845153131,ECE 65,A50,083695,Staff,0,5,30,30
1650845159159,ECE 109,A01,091882,Touri; Behrouz,32,0,70,38
1650845165184,ECE 180,A00,083140,Abi Samra; Nicholas Camill,20,0,30,10
1650845165184,ECE 180,B00,083141,Abi Samra; Nicholas Camill,0,0,30,30
1650845171219,MATH 10A,A01,083735,Patchell; Gregory David,2,0,30,28
1650845171219,MATH 10A,A02,083736,Patchell; Gregory David,27,0,30,3
1650845171219,MATH 10A,A03,083737,Patchell; Gregory David,24,0,30,6
1650845177242,MATH 10B,A01,083207,Staff,0,9,30,30
1650845177242,MATH 10B,A02,083208,Staff,0,6,30,30
1650845177242,MATH 10B,B01,083739,Staff,10,0,30,20
1650845177242,MATH 10B,B02,083740,Staff,28,0,30,2
1650845183275,MATH 18,A01,083743,Staff,0,0,30,30
1650845183275,MATH 18,A02,083744,Staff,23,0,30,7
1650845183275,MATH 18,A03,083745,Staff,21,0,30,9
1650845183275,MATH 18,A04,083746,Staff,26,0,30,4
1650845183275,MATH 18,B01,083748,Staff,0,15,30,30
1650845183275,MATH 18,B02,083749,Staff,0,13,30,30
1650845183275,MATH 18,B03,083750,Staff,0,13,30,30
1650845183275,MATH 18,B04,083751,Staff,0,13,30,30
1650845189299,MATH 20A,A01,083754,Staff,19,0,40,21
1650845195340,MATH 20B,A01,083756,Staff,0,14,30,30
1650845195340,MATH 20B,A02,083757,Staff,0,12,30,30
1650845201370,MATH 20C,A01,083760,Staff,0,17,30,30
1650845201370,MATH 20C,A02,083761,Staff,0,16,30,30
1650845201370,MATH 20C,B01,083762,Staff,9,0,30,21
1650845201370,MATH 20C,B02,083763,Staff,28,0,30,2
1650845207408,MATH 20D,A01,083765,Staff,2,1,30,28
1650845207408,MATH 20D,A02,083766,Staff,6,0,30,24
1650845207408,MATH 20D,A03,083767,Staff,23,0,30,7
1650845213436,MATH 20E,A01,083771,Staff,2,0,30,28
1650845213436,MATH 20E,A02,083772,Staff,13,0,30,17
1650845213436,MATH 20E,B01,083773,Staff,0,0,30,30
1650845213436,MATH 20E,B02,083774,Staff,5,0,30,25
1650845219470,MATH 103A,A01,083777,Staff,0,16,30,30
1650845219470,MATH 103A,A02,083778,Staff,0,15,30,30
1650845219470,MATH 103A,B01,083779,Staff,0,15,30,30
1650845219470,MATH 103A,B02,083780,Staff,1,15,30,29
1650845225499,MATH 105,A01,085443,Staff,0,22,30,30
1650845231526,MATH 109,A01,083213,Anzaldo; Leesa B,0,7,30,30
1650845231526,MATH 109,A02,083214,Anzaldo; Leesa B,0,7,30,30
1650845231526,MATH 109,B01,083215,Anzaldo; Leesa B,0,8,30,30
1650845231526,MATH 109,B02,083216,Anzaldo; Leesa B,0,7,30,30
1650845237550,MATH 142A,A01,083219,Chow; Bennett,0,16,30,30
1650845237550,MATH 142A,A02,083220,Chow; Bennett,0,15,30,30
1650845237550,MATH 142A,B01,083221,Chow; Bennett,0,16,30,30
1650845237550,MATH 142A,B02,083222,Chow; Bennett,0,14,30,30
1650845243579,MATH 193A,A01,083224,Staff,0,6,30,30
1650845243579,MATH 193A,A02,083225,Staff,0,6,30,30
1650845243579,MATH 193A,A03,083781,Staff,0,6,30,30
1650845243579,MATH 193A,A04,083782,Staff,0,7,30,30
1650845249696,MATH 197,001,091859,McAuley; Julian John,9998,0,9999,1
1650845255752,COGS 9,A01,083615,Staff,0,17,60,60
1650845261776,COGS 11,A01,083617,Boyle; Mary E. T.,15,0,40,25
1650845267800,COGS 13,A01,083071,Staff,0,38,40,40
1650845273823,COGS 14A,A01,092681,Staff,0,36,100,100
1650845279847,COGS 14B,A01,083073,Cheng; Tzu-Han,0,12,50,50
1650845285881,COGS 17,A01,092677,Staff,12,0,75,63
1650845291911,COGS 100,A01,083619,Staff,0,30,60,60
1650845297934,COGS 101A,A01,083621,Davis; Joshua Daniel,0,29,60,60
1650845303959,COGS 101B,A01,091572,Staff,0,3,60,60
1650845309983,COGS 101C,A01,083625,Delgado; Tania,14,0,30,16
1650845316007,COGS 107A,A01,083627,Boyle; Mary E. T.,0,16,60,60
1650845322041,COGS 118A,A01,083075,Staff,0,8,60,60
1650845328068,CSE 3,A50,083646,Miranda; Gregory Joseph,18,0,38,20
1650845328068,CSE 3,A51,083647,Miranda; Gregory Joseph,36,0,37,1
1650845334097,CSE 8A,A50,083650,Miranda; Gregory Joseph,0,29,40,40
1650845340124,CSE 11,A01,083080,Cao; Yingjun,0,96,40,40
1650845346149,CSE 12,A01,083652,Staff,0,21,100,100
1650845352173,CSE 15L,A01,083654,Staff,0,3,50,50
1650845352173,CSE 15L,A02,083655,Staff,0,2,50,50
1650845358196,CSE 20,A01,083657,Staff,49,0,80,31
1650845364219,CSE 30,A01,083084,Eldon; John,0,76,40,40
1650845370245,CSE 100,A01,083659,Cao; Yingjun,0,71,50,50
1650845376269,CSE 134B,A01,083661,Powell; Thomas Allan,0,38,65,65
1650845382292,CSE 140,A01,083663,Staff,0,11,75,75
1650845388316,CSE 140L,A01,083088,Eldon; John,0,20,75,75
1650845394344,CSE 175,A01,083665,Kumar; Rakesh,7,0,25,18
1650845400369,CSE 190,A00,092507,Dubnov; Shlomo,10,0,20,10
1650845406396,ECE 45,A01,083139,Staff,0,1,60,60
1650845412424,ECE 65,A50,083695,Staff,0,5,30,30
1650845418457,ECE 109,A01,091882,Touri; Behrouz,32,0,70,38
1650845424483,ECE 180,A00,083140,Abi Samra; Nicholas Camill,20,0,30,10
1650845424483,ECE 180,B00,083141,Abi Samra; Nicholas Camill,0,0,30,30
1650845430520,MATH 10A,A01,083735,Patchell; Gregory David,2,0,30,28
1650845430520,MATH 10A,A02,083736,Patchell; Gregory David,27,0,30,3
1650845430520,MATH 10A,A03,083737,Patchell; Gregory David,24,0,30,6
1650845436544,MATH 10B,A01,083207,Staff,0,9,30,30
1650845436544,MATH 10B,A02,083208,Staff,0,6,30,30
1650845436544,MATH 10B,B01,083739,Staff,10,0,30,20
1650845436544,MATH 10B,B02,083740,Staff,28,0,30,2
1650845442583,MATH 18,A01,083743,Staff,0,0,30,30
1650845442583,MATH 18,A02,083744,Staff,23,0,30,7
1650845442583,MATH 18,A03,083745,Staff,21,0,30,9
1650845442583,MATH 18,A04,083746,Staff,26,0,30,4
1650845442583,MATH 18,B01,083748,Staff,0,15,30,30
1650845442583,MATH 18,B02,083749,Staff,0,13,30,30
1650845442583,MATH 18,B03,083750,Staff,0,13,30,30
1650845442583,MATH 18,B04,083751,Staff,0,13,30,30
1650845448605,MATH 20A,A01,083754,Staff,19,0,40,21
1650845454628,MATH 20B,A01,083756,Staff,0,14,30,30
1650845454628,MATH 20B,A02,083757,Staff,0,12,30,30
1650845460657,MATH 20C,A01,083760,Staff,0,17,30,30
1650845460657,MATH 20C,A02,083761,Staff,0,16,30,30
1650845460657,MATH 20C,B01,083762,Staff,9,0,30,21
1650845460657,MATH 20C,B02,083763,Staff,28,0,30,2
1650845466690,MATH 20D,A01,083765,Staff,2,1,30,28
1650845466690,MATH 20D,A02,083766,Staff,6,0,30,24
1650845466690,MATH 20D,A03,083767,Staff,23,0,30,7
1650845472714,MATH 20E,A01,083771,Staff,2,0,30,28
1650845472714,MATH 20E,A02,083772,Staff,13,0,30,17
1650845472714,MATH 20E,B01,083773,Staff,0,0,30,30
1650845472714,MATH 20E,B02,083774,Staff,5,0,30,25
1650845478737,MATH 103A,A01,083777,Staff,0,16,30,30
1650845478737,MATH 103A,A02,083778,Staff,0,15,30,30
1650845478737,MATH 103A,B01,083779,Staff,0,15,30,30
1650845478737,MATH 103A,B02,083780,Staff,1,15,30,29
1650845484766,MATH 105,A01,085443,Staff,0,22,30,30
1650845490789,MATH 109,A01,083213,Anzaldo; Leesa B,0,7,30,30
1650845490789,MATH 109,A02,083214,Anzaldo; Leesa B,0,7,30,30
1650845490789,MATH 109,B01,083215,Anzaldo; Leesa B,0,8,30,30
1650845490789,MATH 109,B02,083216,Anzaldo; Leesa B,0,7,30,30
1650845496821,MATH 142A,A01,083219,Chow; Bennett,0,16,30,30
1650845496821,MATH 142A,A02,083220,Chow; Bennett,0,15,30,30
1650845496821,MATH 142A,B01,083221,Chow; Bennett,0,16,30,30
1650845496821,MATH 142A,B02,083222,Chow; Bennett,0,14,30,30
1650845502843,MATH 193A,A01,083224,Staff,0,6,30,30
1650845502843,MATH 193A,A02,083225,Staff,0,6,30,30
1650845502843,MATH 193A,A03,083781,Staff,0,6,30,30
1650845502843,MATH 193A,A04,083782,Staff,0,7,30,30
1650845508866,MATH 197,001,091859,McAuley; Julian John,9998,0,9999,1
1650845514930,COGS 9,A01,083615,Staff,0,17,60,60
1650845520954,COGS 11,A01,083617,Boyle; Mary E. T.,15,0,40,25
1650845526980,COGS 13,A01,083071,Staff,0,38,40,40
1650845533010,COGS 14A,A01,092681,Staff,0,36,100,100
1650845539037,COGS 14B,A01,083073,Cheng; Tzu-Han,0,12,50,50
1650845545069,COGS 17,A01,092677,Staff,12,0,75,63
1650845551095,COGS 100,A01,083619,Staff,0,30,60,60
1650845557123,COGS 101A,A01,083621,Davis; Joshua Daniel,0,29,60,60
1650845563146,COGS 101B,A01,091572,Staff,0,3,60,60
1650845569183,COGS 101C,A01,083625,Delgado; Tania,14,0,30,16
1650845575208,COGS 107A,A01,083627,Boyle; Mary E. T.,0,16,60,60
1650845581231,COGS 118A,A01,083075,Staff,0,8,60,60
1650845587255,CSE 3,A50,083646,Miranda; Gregory Joseph,18,0,38,20
1650845587255,CSE 3,A51,083647,Miranda; Gregory Joseph,36,0,37,1
1650845593279,CSE 8A,A50,083650,Miranda; Gregory Joseph,0,29,40,40
1650845599305,CSE 11,A01,083080,Cao; Yingjun,0,96,40,40
1650845605332,CSE 12,A01,083652,Staff,0,21,100,100
1650845611364,CSE 15L,A01,083654,Staff,0,3,50,50
1650845611364,CSE 15L,A02,083655,Staff,0,2,50,50
1650845617387,CSE 20,A01,083657,Staff,49,0,80,31
1650845623420,CSE 30,A01,083084,Eldon; John,0,76,40,40
1650845629446,CSE 100,A01,083659,Cao; Yingjun,0,71,50,50
1650845635490,CSE 134B,A01,083661,Powell; Thomas Allan,0,38,65,65
1650845641516,CSE 140,A01,083663,Staff,0,11,75,75
1650845647540,CSE 140L,A01,083088,Eldon; John,0,20,75,75
1650845653567,CSE 175,A01,083665,Kumar; Rakesh,7,0,25,18
1650845659591,CSE 190,A00,092507,Dubnov; Shlomo,10,0,20,10
1650845665632,ECE 45,A01,083139,Staff,0,1,60,60
1650845671657,ECE 65,A50,083695,Staff,0,5,30,30
1650845677682,ECE 109,A01,091882,Touri; Behrouz,32,0,70,38
1650845683713,ECE 180,A00,083140,Abi Samra; Nicholas Camill,20,0,30,10
1650845683713,ECE 180,B00,083141,Abi Samra; Nicholas Camill,0,0,30,30
1650845689741,MATH 10A,A01,083735,Patchell; Gregory David,2,0,30,28
1650845689741,MATH 10A,A02,083736,Patchell; Gregory David,27,0,30,3
1650845689741,MATH 10A,A03,083737,Patchell; Gregory David,24,0,30,6
1650845695774,MATH 10B,A01,083207,Staff,0,9,30,30
1650845695774,MATH 10B,A02,083208,Staff,0,6,30,30
1650845695774,MATH 10B,B01,083739,Staff,10,0,30,20
1650845695774,MATH 10B,B02,083740,Staff,28,0,30,2
1650845701807,MATH 18,A01,083743,Staff,0,0,30,30
1650845701807,MATH 18,A02,083744,Staff,23,0,30,7
1650845701807,MATH 18,A03,083745,Staff,21,0,30,9
1650845701807,MATH 18,A04,083746,Staff,26,0,30,4
1650845701807,MATH 18,B01,083748,Staff,0,15,30,30
1650845701807,MATH 18,B02,083749,Staff,0,13,30,30
1650845701807,MATH 18,B03,083750,Staff,0,13,30,30
1650845701807,MATH 18,B04,083751,Staff,0,13,30,30
1650845707832,MATH 20A,A01,083754,Staff,19,0,40,21
1650845713854,MATH 20B,A01,083756,Staff,0,14,30,30
1650845713854,MATH 20B,A02,083757,Staff,0,12,30,30
1650845719882,MATH 20C,A01,083760,Staff,0,17,30,30
1650845719882,MATH 20C,A02,083761,Staff,0,16,30,30
1650845719882,MATH 20C,B01,083762,Staff,9,0,30,21
1650845719882,MATH 20C,B02,083763,Staff,28,0,30,2
1650845725909,MATH 20D,A01,083765,Staff,2,1,30,28
1650845725909,MATH 20D,A02,083766,Staff,6,0,30,24
1650845725909,MATH 20D,A03,083767,Staff,23,0,30,7
1650845731935,MATH 20E,A01,083771,Staff,2,0,30,28
1650845731935,MATH 20E,A02,083772,Staff,13,0,30,17
1650845731935,MATH 20E,B01,083773,Staff,0,0,30,30
1650845731935,MATH 20E,B02,083774,Staff,5,0,30,25
1650845737959,MATH 103A,A01,083777,Staff,0,16,30,30
1650845737959,MATH 103A,A02,083778,Staff,0,15,30,30
1650845737959,MATH 103A,B01,083779,Staff,0,15,30,30
1650845737959,MATH 103A,B02,083780,Staff,1,15,30,29
1650845743985,MATH 105,A01,085443,Staff,0,22,30,30
1650845750008,MATH 109,A01,083213,Anzaldo; Leesa B,0,7,30,30
1650845750008,MATH 109,A02,083214,Anzaldo; Leesa B,0,7,30,30
1650845750008,MATH 109,B01,083215,Anzaldo; Leesa B,0,8,30,30
1650845750008,MATH 109,B02,083216,Anzaldo; Leesa B,0,7,30,30
1650845756040,MATH 142A,A01,083219,Chow; Bennett,0,16,30,30
1650845756040,MATH 142A,A02,083220,Chow; Bennett,0,15,30,30
1650845756040,MATH 142A,B01,083221,Chow; Bennett,0,16,30,30
1650845756040,MATH 142A,B02,083222,Chow; Bennett,0,14,30,30
1650845762084,MATH 193A,A01,083224,Staff,0,6,30,30
1650845762084,MATH 193A,A02,083225,Staff,0,6,30,30
1650845762084,MATH 193A,A03,083781,Staff,0,6,30,30
1650845762084,MATH 193A,A04,083782,Staff,0,7,30,30
1650845768121,MATH 197,001,091859,McAuley; Julian John,9998,0,9999,1
1650845774167,COGS 9,A01,083615,Staff,0,17,60,60
1650845780198,COGS 11,A01,083617,Boyle; Mary E. T.,15,0,40,25
1650845786225,COGS 13,A01,083071,Staff,0,38,40,40
1650845792252,COGS 14A,A01,092681,Staff,0,36,100,100
1650845798273,COGS 14B,A01,083073,Cheng; Tzu-Han,0,12,50,50
1650845804296,COGS 17,A01,092677,Staff,12,0,75,63
1650845810318,COGS 100,A01,083619,Staff,0,30,60,60
1650845816367,COGS 101A,A01,083621,Davis; Joshua Daniel,0,29,60,60
1650845822395,COGS 101B,A01,091572,Staff,0,3,60,60
1650845828418,COGS 101C,A01,083625,Delgado; Tania,14,0,30,16
1650845834440,COGS 107A,A01,083627,Boyle; Mary E. T.,0,16,60,60
1650845840539,COGS 118A,A01,083075,Staff,0,8,60,60
1650845846566,CSE 3,A50,083646,Miranda; Gregory Joseph,18,0,38,20
1650845846566,CSE 3,A51,083647,Miranda; Gregory Joseph,36,0,37,1
1650845852589,CSE 8A,A50,083650,Miranda; Gregory Joseph,0,29,40,40
1650845858616,CSE 11,A01,083080,Cao; Yingjun,0,96,40,40
1650845864639,CSE 12,A01,083652,Staff,0,21,100,100
1650845870660,CSE 15L,A01,083654,Staff,0,3,50,50
1650845870660,CSE 15L,A02,083655,Staff,0,2,50,50
1650845876683,CSE 20,A01,083657,Staff,49,0,80,31
1650845882706,CSE 30,A01,083084,Eldon; John,0,76,40,40
1650845888731,CSE 100,A01,083659,Cao; Yingjun,0,71,50,50
1650845894754,CSE 134B,A01,083661,Powell; Thomas Allan,0,38,65,65
1650845900780,CSE 140,A01,083663,Staff,0,11,75,75
1650845906804,CSE 140L,A01,083088,Eldon; John,0,20,75,75
1650845912830,CSE 175,A01,083665,Kumar; Rakesh,7,0,25,18
1650845918862,CSE 190,A00,092507,Dubnov; Shlomo,10,0,20,10
1650845924886,ECE 45,A01,083139,Staff,0,1,60,60
1650845930909,ECE 65,A50,083695,Staff,0,5,30,30
1650845936934,ECE 109,A01,091882,Touri; Behrouz,32,0,70,38
1650845942961,ECE 180,A00,083140,Abi Samra; Nicholas Camill,20,0,30,10
1650845942961,ECE 180,B00,083141,Abi Samra; Nicholas Camill,0,0,30,30
1650845948993,MATH 10A,A01,083735,Patchell; Gregory David,2,0,30,28
1650845948993,MATH 10A,A02,083736,Patchell; Gregory David,27,0,30,3
1650845948993,MATH 10A,A03,083737,Patchell; Gregory David,24,0,30,6
1650845955018,MATH 10B,A01,083207,Staff,0,9,30,30
1650845955018,MATH 10B,A02,083208,Staff,0,6,30,30
1650845955018,MATH 10B,B01,083739,Staff,10,0,30,20
1650845955018,MATH 10B,B02,083740,Staff,28,0,30,2
1650845961047,MATH 18,A01,083743,Staff,0,0,30,30
1650845961047,MATH 18,A02,083744,Staff,23,0,30,7
1650845961047,MATH 18,A03,083745,Staff,21,0,30,9
1650845961047,MATH 18,A04,083746,Staff,26,0,30,4
1650845961047,MATH 18,B01,083748,Staff,0,15,30,30
1650845961047,MATH 18,B02,083749,Staff,0,13,30,30
1650845961047,MATH 18,B03,083750,Staff,0,13,30,30
1650845961047,MATH 18,B04,083751,Staff,0,13,30,30
1650845967073,MATH 20A,A01,083754,Staff,19,0,40,21
1650845973097,MATH 20B,A01,083756,Staff,0,14,30,30
1650845973097,MATH 20B,A02,083757,Staff,0,12,30,30
1650845979121,MATH 20C,A01,083760,Staff,0,17,30,30
1650845979121,MATH 20C,A02,083761,Staff,0,16,30,30
1650845979121,MATH 20C,B01,083762,Staff,9,0,30,21
1650845979121,MATH 20C,B02,083763,Staff,28,0,30,2
1650845985145,MATH 20D,A01,083765,Staff,2,1,30,28
1650845985145,MATH 20D,A02,083766,Staff,6,0,30,24
1650845985145,MATH 20D,A03,083767,Staff,23,0,30,7
1650845991169,MATH 20E,A01,083771,Staff,2,0,30,28
1650845991169,MATH 20E,A02,083772,Staff,13,0,30,17
1650845991169,MATH 20E,B01,083773,Staff,0,0,30,30
1650845991169,MATH 20E,B02,083774,Staff,5,0,30,25
1650845997191,MATH 103A,A01,083777,Staff,0,16,30,30
1650845997191,MATH 103A,A02,083778,Staff,0,15,30,30
1650845997191,MATH 103A,B01,083779,Staff,0,15,30,30
1650845997191,MATH 103A,B02,083780,Staff,1,15,30,29
1650846003214,MATH 105,A01,085443,Staff,0,22,30,30
1650846009239,MATH 109,A01,083213,Anzaldo; Leesa B,0,7,30,30
1650846009239,MATH 109,A02,083214,Anzaldo; Leesa B,0,7,30,30
1650846009239,MATH 109,B01,083215,Anzaldo; Leesa B,0,8,30,30
1650846009239,MATH 109,B02,083216,Anzaldo; Leesa B,0,7,30,30
1650846015269,MATH 142A,A01,083219,Chow; Bennett,0,16,30,30
1650846015269,MATH 142A,A02,083220,Chow; Bennett,0,15,30,30
1650846015269,MATH 142A,B01,083221,Chow; Bennett,0,16,30,30
1650846015269,MATH 142A,B02,083222,Chow; Bennett,0,14,30,30
1650846021294,MATH 193A,A01,083224,Staff,0,6,30,30
1650846021294,MATH 193A,A02,083225,Staff,0,6,30,30
1650846021294,MATH 193A,A03,083781,Staff,0,6,30,30
1650846021294,MATH 193A,A04,083782,Staff,0,7,30,30
1650846027318,MATH 197,001,091859,McAuley; Julian John,9998,0,9999,1
1650846033379,COGS 9,A01,083615,Staff,0,17,60,60
1650846039405,COGS 11,A01,083617,Boyle; Mary E. T.,15,0,40,25
1650846045429,COGS 13,A01,083071,Staff,0,38,40,40
1650846051451,COGS 14A,A01,092681,Staff,0,36,100,100
1650846057473,COGS 14B,A01,083073,Cheng; Tzu-Han,0,12,50,50
1650846063496,COGS 17,A01,092677,Staff,12,0,75,63
1650846069523,COGS 100,A01,083619,Staff,0,30,60,60
1650846075547,COGS 101A,A01,083621,Davis; Joshua Daniel,0,29,60,60
1650846081570,COGS 101B,A01,091572,Staff,0,3,60,60
1650846087598,COGS 101C,A01,083625,Delgado; Tania,14,0,30,16
1650846093621,COGS 107A,A01,083627,Boyle; Mary E. T.,0,16,60,60
1650846099648,COGS 118A,A01,083075,Staff,0,8,60,60
1650846105670,CSE 3,A50,083646,Miranda; Gregory Joseph,18,0,38,20
1650846105670,CSE 3,A51,083647,Miranda; Gregory Joseph,36,0,37,1
1650846111698,CSE 8A,A50,083650,Miranda; Gregory Joseph,0,29,40,40
1650846117723,CSE 11,A01,083080,Cao; Yingjun,0,96,40,40
1650846123747,CSE 12,A01,083652,Staff,0,21,100,100
1650846129773,CSE 15L,A01,083654,Staff,0,3,50,50
1650846129773,CSE 15L,A02,083655,Staff,0,2,50,50
1650846135797,CSE 20,A01,083657,Staff,49,0,80,31
1650846141820,CSE 30,A01,083084,Eldon; John,0,76,40,40
1650846147843,CSE 100,A01,083659,Cao; Yingjun,0,71,50,50
1650846153867,CSE 134B,A01,083661,Powell; Thomas Allan,0,38,65,65
1650846159893,CSE 140,A01,083663,Staff,0,11,75,75
1650846165919,CSE 140L,A01,083088,Eldon; John,0,20,75,75
1650846171943,CSE 175,A01,083665,Kumar; Rakesh,7,0,25,18
1650846177968,CSE 190,A00,092507,Dubnov; Shlomo,10,0,20,10
1650846183995,ECE 45,A01,083139,Staff,0,1,60,60
1650846190021,ECE 65,A50,083695,Staff,0,5,30,30
1650846196045,ECE 109,A01,091882,Touri; Behrouz,32,0,70,38
1650846202080,ECE 180,A00,083140,Abi Samra; Nicholas Camill,20,0,30,10
1650846202080,ECE 180,B00,083141,Abi Samra; Nicholas Camill,0,0,30,30
1650846208103,MATH 10A,A01,083735,Patchell; Gregory David,2,0,30,28
1650846208103,MATH 10A,A02,083736,Patchell; Gregory David,27,0,30,3
1650846208103,MATH 10A,A03,083737,Patchell; Gregory David,24,0,30,6
1650846214130,MATH 10B,A01,083207,Staff,0,9,30,30
1650846214130,MATH 10B,A02,083208,Staff,0,6,30,30
1650846214130,MATH 10B,B01,083739,Staff,10,0,30,20
1650846214130,MATH 10B,B02,083740,Staff,28,0,30,2
1650846220156,MATH 18,A01,083743,Staff,0,0,30,30
1650846220156,MATH 18,A02,083744,Staff,23,0,30,7
1650846220156,MATH 18,A03,083745,Staff,21,0,30,9
1650846220156,MATH 18,A04,083746,Staff,26,0,30,4
1650846220156,MATH 18,B01,083748,Staff,0,15,30,30
1650846220156,MATH 18,B02,083749,Staff,0,13,30,30
1650846220156,MATH 18,B03,083750,Staff,0,13,30,30
1650846220156,MATH 18,B04,083751,Staff,0,13,30,30
1650846226182,MATH 20A,A01,083754,Staff,19,0,40,21
1650846232208,MATH 20B,A01,083756,Staff,0,14,30,30
1650846232208,MATH 20B,A02,083757,Staff,0,12,30,30
1650846238236,MATH 20C,A01,083760,Staff,0,17,30,30
1650846238236,MATH 20C,A02,083761,Staff,0,16,30,30
1650846238236,MATH 20C,B01,083762,Staff,9,0,30,21
1650846238236,MATH 20C,B02,083763,Staff,28,0,30,2
1650846244264,MATH 20D,A01,083765,Staff,2,1,30,28
1650846244264,MATH 20D,A02,083766,Staff,6,0,30,24
1650846244264,MATH 20D,A03,083767,Staff,23,0,30,7
1650846250288,MATH 20E,A01,083771,Staff,2,0,30,28
1650846250288,MATH 20E,A02,083772,Staff,13,0,30,17
1650846250288,MATH 20E,B01,083773,Staff,0,0,30,30
1650846250288,MATH 20E,B02,083774,Staff,5,0,30,25
1650846256313,MATH 103A,A01,083777,Staff,0,16,30,30
1650846256313,MATH 103A,A02,083778,Staff,0,15,30,30
1650846256313,MATH 103A,B01,083779,Staff,0,15,30,30
1650846256313,MATH 103A,B02,083780,Staff,1,15,30,29
1650846262340,MATH 105,A01,085443,Staff,0,22,30,30
1650846268368,MATH 109,A01,083213,Anzaldo; Leesa B,0,7,30,30
1650846268368,MATH 109,A02,083214,Anzaldo; Leesa B,0,7,30,30
1650846268368,MATH 109,B01,083215,Anzaldo; Leesa B,0,8,30,30
1650846268368,MATH 109,B02,083216,Anzaldo; Leesa B,0,7,30,30
1650846274393,MATH 142A,A01,083219,Chow; Bennett,0,16,30,30
1650846274393,MATH 142A,A02,083220,Chow; Bennett,0,15,30,30
1650846274393,MATH 142A,B01,083221,Chow; Bennett,0,16,30,30
1650846274393,MATH 142A,B02,083222,Chow; Bennett,0,14,30,30
1650846280422,MATH 193A,A01,083224,Staff,0,6,30,30
1650846280422,MATH 193A,A02,083225,Staff,0,6,30,30
1650846280422,MATH 193A,A03,083781,Staff,0,6,30,30
1650846280422,MATH 193A,A04,083782,Staff,0,7,30,30
1650846286461,MATH 197,001,091859,McAuley; Julian John,9998,0,9999,1
1650846292518,COGS 9,A01,083615,Staff,0,17,60,60
1650846298545,COGS 11,A01,083617,Boyle; Mary E. T.,15,0,40,25
1650846304570,COGS 13,A01,083071,Staff,0,38,40,40
1650846310595,COGS 14A,A01,092681,Staff,0,36,100,100
1650846316619,COGS 14B,A01,083073,Cheng; Tzu-Han,0,12,50,50
1650846322644,COGS 17,A01,092677,Staff,12,0,75,63
1650846328668,COGS 100,A01,083619,Staff,0,30,60,60
1650846334690,COGS 101A,A01,083621,Davis; Joshua Daniel,0,29,60,60
1650846340713,COGS 101B,A01,091572,Staff,0,3,60,60
1650846346736,COGS 101C,A01,083625,Delgado; Tania,14,0,30,16
1650846352763,COGS 107A,A01,083627,Boyle; Mary E. T.,0,16,60,60
1650846358786,COGS 118A,A01,083075,Staff,0,8,60,60
1650846364812,CSE 3,A50,083646,Miranda; Gregory Joseph,18,0,38,20
1650846364812,CSE 3,A51,083647,Miranda; Gregory Joseph,36,0,37,1
1650846370836,CSE 8A,A50,083650,Miranda; Gregory Joseph,0,29,40,40
1650846391073,CSE 11,A01,083080,Cao; Yingjun,0,96,40,40
1650846397097,CSE 12,A01,083652,Staff,0,21,100,100
1650846403120,CSE 15L,A01,083654,Staff,0,3,50,50
1650846403120,CSE 15L,A02,083655,Staff,0,2,50,50
1650846409146,CSE 20,A01,083657,Staff,49,0,80,31
1650846415172,CSE 30,A01,083084,Eldon; John,0,76,40,40
1650846421200,CSE 100,A01,083659,Cao; Yingjun,0,71,50,50
1650846427224,CSE 134B,A01,083661,Powell; Thomas Allan,0,38,65,65
1650846433246,CSE 140,A01,083663,Staff,0,11,75,75
1650846439273,CSE 140L,A01,083088,Eldon; John,0,20,75,75
1650846445296,CSE 175,A01,083665,Kumar; Rakesh,7,0,25,18
1650846451423,CSE 190,A00,092507,Dubnov; Shlomo,10,0,20,10
1650846457451,ECE 45,A01,083139,Staff,0,1,60,60
1650846463477,ECE 65,A50,083695,Staff,0,5,30,30
1650846469501,ECE 109,A01,091882,Touri; Behrouz,32,0,70,38
1650846475525,ECE 180,A00,083140,Abi Samra; Nicholas Camill,20,0,30,10
1650846475525,ECE 180,B00,083141,Abi Samra; Nicholas Camill,0,0,30,30
1650846481553,MATH 10A,A01,083735,Patchell; Gregory David,2,0,30,28
1650846481553,MATH 10A,A02,083736,Patchell; Gregory David,27,0,30,3
1650846481553,MATH 10A,A03,083737,Patchell; Gregory David,24,0,30,6
1650846487577,MATH 10B,A01,083207,Staff,0,9,30,30
1650846487577,MATH 10B,A02,083208,Staff,0,6,30,30
1650846487577,MATH 10B,B01,083739,Staff,10,0,30,20
1650846487577,MATH 10B,B02,083740,Staff,28,0,30,2
1650846493608,MATH 18,A01,083743,Staff,0,0,30,30
1650846493608,MATH 18,A02,083744,Staff,23,0,30,7
1650846493608,MATH 18,A03,083745,Staff,21,0,30,9
1650846493608,MATH 18,A04,083746,Staff,26,0,30,4
1650846493608,MATH 18,B01,083748,Staff,0,15,30,30
1650846493608,MATH 18,B02,083749,Staff,0,13,30,30
1650846493608,MATH 18,B03,083750,Staff,0,13,30,30
1650846493608,MATH 18,B04,083751,Staff,0,13,30,30
1650846499633,MATH 20A,A01,083754,Staff,19,0,40,21
1650846505656,MATH 20B,A01,083756,Staff,0,14,30,30
1650846505656,MATH 20B,A02,083757,Staff,0,12,30,30
1650846511681,MATH 20C,A01,083760,Staff,0,17,30,30
1650846511681,MATH 20C,A02,083761,Staff,0,16,30,30
1650846511681,MATH 20C,B01,083762,Staff,9,0,30,21
1650846511681,MATH 20C,B02,083763,Staff,28,0,30,2
1650846517707,MATH 20D,A01,083765,Staff,2,1,30,28
1650846517707,MATH 20D,A02,083766,Staff,6,0,30,24
1650846517707,MATH 20D,A03,083767,Staff,23,0,30,7
1650846523730,MATH 20E,A01,083771,Staff,2,0,30,28
1650846523730,MATH 20E,A02,083772,Staff,13,0,30,17
1650846523730,MATH 20E,B01,083773,Staff,0,0,30,30
1650846523730,MATH 20E,B02,083774,Staff,5,0,30,25
1650846529760,MATH 103A,A01,083777,Staff,0,16,30,30
1650846529760,MATH 103A,A02,083778,Staff,0,15,30,30
1650846529760,MATH 103A,B01,083779,Staff,0,15,30,30
1650846529760,MATH 103A,B02,083780,Staff,1,15,30,29
1650846535784,MATH 105,A01,085443,Staff,0,22,30,30
1650846541813,MATH 109,A01,083213,Anzaldo; Leesa B,0,7,30,30
1650846541813,MATH 109,A02,083214,Anzaldo; Leesa B,0,7,30,30
1650846541813,MATH 109,B01,083215,Anzaldo; Leesa B,0,8,30,30
1650846541813,MATH 109,B02,083216,Anzaldo; Leesa B,0,7,30,30
1650846547846,MATH 142A,A01,083219,Chow; Bennett,0,16,30,30
1650846547846,MATH 142A,A02,083220,Chow; Bennett,0,15,30,30
1650846547846,MATH 142A,B01,083221,Chow; Bennett,0,16,30,30
1650846547846,MATH 142A,B02,083222,Chow; Bennett,0,14,30,30
1650846553868,MATH 193A,A01,083224,Staff,0,6,30,30
1650846553868,MATH 193A,A02,083225,Staff,0,6,30,30
1650846553868,MATH 193A,A03,083781,Staff,0,6,30,30
1650846553868,MATH 193A,A04,083782,Staff,0,7,30,30
1650846559891,MATH 197,001,091859,McAuley; Julian John,9998,0,9999,1
1650846565951,COGS 9,A01,083615,Staff,0,17,60,60
1650846571973,COGS 11,A01,083617,Boyle; Mary E. T.,15,0,40,25
1650846577999,COGS 13,A01,083071,Staff,0,38,40,40
1650846584023,COGS 14A,A01,092681,Staff,0,36,100,100
1650846590047,COGS 14B,A01,083073,Cheng; Tzu-Han,0,12,50,50
1650846596070,COGS 17,A01,092677,Staff,12,0,75,63
1650846602094,COGS 100,A01,083619,Staff,0,30,60,60
1650846608121,COGS 101A,A01,083621,Davis; Joshua Daniel,0,29,60,60
1650846614146,COGS 101B,A01,091572,Staff,0,3,60,60
1650846620169,COGS 101C,A01,083625,Delgado; Tania,14,0,30,16
1650846626192,COGS 107A,A01,083627,Boyle; Mary E. T.,0,16,60,60
1650846632214,COGS 118A,A01,083075,Staff,0,8,60,60
1650846638241,CSE 3,A50,083646,Miranda; Gregory Joseph,18,0,38,20
1650846638241,CSE 3,A51,083647,Miranda; Gregory Joseph,36,0,37,1
1650846644265,CSE 8A,A50,083650,Miranda; Gregory Joseph,0,29,40,40
1650846650289,CSE 11,A01,083080,Cao; Yingjun,0,96,40,40
1650846656314,CSE 12,A01,083652,Staff,0,21,100,100
1650846662355,CSE 15L,A01,083654,Staff,0,3,50,50
1650846662355,CSE 15L,A02,083655,Staff,0,2,50,50
1650846668385,CSE 20,A01,083657,Staff,49,0,80,31
1650846674412,CSE 30,A01,083084,Eldon; John,0,76,40,40
1650846680450,CSE 100,A01,083659,Cao; Yingjun,0,71,50,50
1650846686475,CSE 134B,A01,083661,Powell; Thomas Allan,0,38,65,65
1650846692497,CSE 140,A01,083663,Staff,0,11,75,75
1650846698519,CSE 140L,A01,083088,Eldon; John,0,20,75,75
1650846704543,CSE 175,A01,083665,Kumar; Rakesh,7,0,25,18
1650846710567,CSE 190,A00,092507,Dubnov; Shlomo,10,0,20,10
1650846716591,ECE 45,A01,083139,Staff,0,1,60,60
1650846722617,ECE 65,A50,083695,Staff,0,5,30,30
1650846728641,ECE 109,A01,091882,Touri; Behrouz,32,0,70,38
1650846734664,ECE 180,A00,083140,Abi Samra; Nicholas Camill,20,0,30,10
1650846734664,ECE 180,B00,083141,Abi Samra; Nicholas Camill,0,0,30,30
1650846740698,MATH 10A,A01,083735,Patchell; Gregory David,2,0,30,28
1650846740698,MATH 10A,A02,083736,Patchell; Gregory David,27,0,30,3
1650846740698,MATH 10A,A03,083737,Patchell; Gregory David,24,0,30,6
1650846746721,MATH 10B,A01,083207,Staff,0,9,30,30
1650846746721,MATH 10B,A02,083208,Staff,0,6,30,30
1650846746721,MATH 10B,B01,083739,Staff,10,0,30,20
1650846746721,MATH 10B,B02,083740,Staff,28,0,30,2
1650846752747,MATH 18,A01,083743,Staff,0,0,30,30
1650846752747,MATH 18,A02,083744,Staff,23,0,30,7
1650846752747,MATH 18,A03,083745,Staff,21,0,30,9
1650846752747,MATH 18,A04,083746,Staff,26,0,30,4
1650846752747,MATH 18,B01,083748,Staff,0,15,30,30
1650846752747,MATH 18,B02,083749,Staff,0,13,30,30
1650846752747,MATH 18,B03,083750,Staff,0,13,30,30
1650846752747,MATH 18,B04,083751,Staff,0,13,30,30
1650846758775,MATH 20A,A01,083754,Staff,19,0,40,21
1650846764803,MATH 20B,A01,083756,Staff,0,14,30,30
1650846764803,MATH 20B,A02,083757,Staff,0,12,30,30
1650846770830,MATH 20C,A01,083760,Staff,0,17,30,30
1650846770830,MATH 20C,A02,083761,Staff,0,16,30,30
1650846770830,MATH 20C,B01,083762,Staff,9,0,30,21
1650846770830,MATH 20C,B02,083763,Staff,28,0,30,2
1650846776853,MATH 20D,A01,083765,Staff,2,1,30,28
1650846776853,MATH 20D,A02,083766,Staff,6,0,30,24
1650846776853,MATH 20D,A03,083767,Staff,23,0,30,7
1650846782875,MATH 20E,A01,083771,Staff,2,0,30,28
1650846782875,MATH 20E,A02,083772,Staff,13,0,30,17
1650846782875,MATH 20E,B01,083773,Staff,0,0,30,30
1650846782875,MATH 20E,B02,083774,Staff,5,0,30,25
1650846788901,MATH 103A,A01,083777,Staff,0,16,30,30
1650846788901,MATH 103A,A02,083778,Staff,0,15,30,30
1650846788901,MATH 103A,B01,083779,Staff,0,15,30,30
1650846788901,MATH 103A,B02,083780,Staff,1,15,30,29
1650846794927,MATH 105,A01,085443,Staff,0,22,30,30
1650846800954,MATH 109,A01,083213,Anzaldo; Leesa B,0,7,30,30
1650846800954,MATH 109,A02,083214,Anzaldo; Leesa B,0,7,30,30
1650846800954,MATH 109,B01,083215,Anzaldo; Leesa B,0,8,30,30
1650846800954,MATH 109,B02,083216,Anzaldo; Leesa B,0,7,30,30
1650846806977,MATH 142A,A01,083219,Chow; Bennett,0,16,30,30
1650846806977,MATH 142A,A02,083220,Chow; Bennett,0,15,30,30
1650846806977,MATH 142A,B01,083221,Chow; Bennett,0,16,30,30
1650846806977,MATH 142A,B02,083222,Chow; Bennett,0,14,30,30
1650846813006,MATH 193A,A01,083224,Staff,0,6,30,30
1650846813006,MATH 193A,A02,083225,Staff,0,6,30,30
1650846813006,MATH 193A,A03,083781,Staff,0,6,30,30
1650846813006,MATH 193A,A04,083782,Staff,0,7,30,30
1650846819032,MATH 197,001,091859,McAuley; Julian John,9998,0,9999,1
1650846825087,COGS 9,A01,083615,Staff,0,17,60,60
1650846831112,COGS 11,A01,083617,Boyle; Mary E. T.,15,0,40,25
1650846837135,COGS 13,A01,083071,Staff,0,38,40,40
1650846843158,COGS 14A,A01,092681,Staff,0,36,100,100
1650846849184,COGS 14B,A01,083073,Cheng; Tzu-Han,0,12,50,50
1650846855207,COGS 17,A01,092677,Staff,12,0,75,63
1650846861229,COGS 100,A01,083619,Staff,0,30,60,60
1650846867255,COGS 101A,A01,083621,Davis; Joshua Daniel,0,29,60,60
1650846873279,COGS 101B,A01,091572,Staff,0,3,60,60
1650846879301,COGS 101C,A01,083625,Delgado; Tania,14,0,30,16
1650846885323,COGS 107A,A01,083627,Boyle; Mary E. T.,0,16,60,60
1650846891345,COGS 118A,A01,083075,Staff,0,8,60,60
1650846897378,CSE 3,A50,083646,Miranda; Gregory Joseph,18,0,38,20
1650846897378,CSE 3,A51,083647,Miranda; Gregory Joseph,36,0,37,1
1650846903406,CSE 8A,A50,083650,Miranda; Gregory Joseph,0,29,40,40
1650846909431,CSE 11,A01,083080,Cao; Yingjun,0,96,40,40
1650846915458,CSE 12,A01,083652,Staff,0,21,100,100
1650846921484,CSE 15L,A01,083654,Staff,0,3,50,50
1650846921484,CSE 15L,A02,083655,Staff,0,2,50,50
1650846927507,CSE 20,A01,083657,Staff,49,0,80,31
1650846933529,CSE 30,A01,083084,Eldon; John,0,76,40,40
1650846939552,CSE 100,A01,083659,Cao; Yingjun,0,71,50,50
1650846945576,CSE 134B,A01,083661,Powell; Thomas Allan,0,38,65,65
1650846951601,CSE 140,A01,083663,Staff,0,11,75,75
1650846957630,CSE 140L,A01,083088,Eldon; John,0,20,75,75
1650846963652,CSE 175,A01,083665,Kumar; Rakesh,7,0,25,18
1650846969680,CSE 190,A00,092507,Dubnov; Shlomo,10,0,20,10
1650846975702,ECE 45,A01,083139,Staff,0,1,60,60
1650846981728,ECE 65,A50,083695,Staff,0,5,30,30
1650846987752,ECE 109,A01,091882,Touri; Behrouz,32,0,70,38
1650846993781,ECE 180,A00,083140,Abi Samra; Nicholas Camill,20,0,30,10
1650846993781,ECE 180,B00,083141,Abi Samra; Nicholas Camill,0,0,30,30
1650846999815,MATH 10A,A01,083735,Patchell; Gregory David,2,0,30,28
1650846999815,MATH 10A,A02,083736,Patchell; Gregory David,27,0,30,3
1650846999815,MATH 10A,A03,083737,Patchell; Gregory David,24,0,30,6
1650847005839,MATH 10B,A01,083207,Staff,0,9,30,30
1650847005839,MATH 10B,A02,083208,Staff,0,6,30,30
1650847005839,MATH 10B,B01,083739,Staff,10,0,30,20
1650847005839,MATH 10B,B02,083740,Staff,28,0,30,2
1650847011868,MATH 18,A01,083743,Staff,0,0,30,30
1650847011868,MATH 18,A02,083744,Staff,23,0,30,7
1650847011868,MATH 18,A03,083745,Staff,21,0,30,9
1650847011868,MATH 18,A04,083746,Staff,26,0,30,4
1650847011868,MATH 18,B01,083748,Staff,0,15,30,30
1650847011868,MATH 18,B02,083749,Staff,0,13,30,30
1650847011868,MATH 18,B03,083750,Staff,0,13,30,30
1650847011868,MATH 18,B04,083751,Staff,0,13,30,30
1650847017891,MATH 20A,A01,083754,Staff,19,0,40,21
1650847023913,MATH 20B,A01,083756,Staff,0,14,30,30
1650847023913,MATH 20B,A02,083757,Staff,0,12,30,30
1650847029939,MATH 20C,A01,083760,Staff,0,17,30,30
1650847029939,MATH 20C,A02,083761,Staff,0,16,30,30
1650847029939,MATH 20C,B01,083762,Staff,9,0,30,21
1650847029939,MATH 20C,B02,083763,Staff,28,0,30,2
1650847035967,MATH 20D,A01,083765,Staff,2,1,30,28
1650847035967,MATH 20D,A02,083766,Staff,6,0,30,24
1650847035967,MATH 20D,A03,083767,Staff,23,0,30,7
1650847041995,MATH 20E,A01,083771,Staff,2,0,30,28
1650847041995,MATH 20E,A02,083772,Staff,13,0,30,17
1650847041995,MATH 20E,B01,083773,Staff,0,0,30,30
1650847041995,MATH 20E,B02,083774,Staff,5,0,30,25
1650847048112,MATH 103A,A01,083777,Staff,0,16,30,30
1650847048112,MATH 103A,A02,083778,Staff,0,15,30,30
1650847048112,MATH 103A,B01,083779,Staff,0,15,30,30
1650847048112,MATH 103A,B02,083780,Staff,1,15,30,29
1650847054136,MATH 105,A01,085443,Staff,0,22,30,30
1650847060160,MATH 109,A01,083213,Anzaldo; Leesa B,0,7,30,30
1650847060160,MATH 109,A02,083214,Anzaldo; Leesa B,0,7,30,30
1650847060160,MATH 109,B01,083215,Anzaldo; Leesa B,0,8,30,30
1650847060160,MATH 109,B02,083216,Anzaldo; Leesa B,0,7,30,30
1650847066187,MATH 142A,A01,083219,Chow; Bennett,0,16,30,30
1650847066187,MATH 142A,A02,083220,Chow; Bennett,0,15,30,30
1650847066187,MATH 142A,B01,083221,Chow; Bennett,0,16,30,30
1650847066187,MATH 142A,B02,083222,Chow; Bennett,0,14,30,30
1650847072211,MATH 193A,A01,083224,Staff,0,6,30,30
1650847072211,MATH 193A,A02,083225,Staff,0,6,30,30
1650847072211,MATH 193A,A03,083781,Staff,0,6,30,30
1650847072211,MATH 193A,A04,083782,Staff,0,7,30,30
1650847078235,MATH 197,001,091859,McAuley; Julian John,9998,0,9999,1
1650847084291,COGS 9,A01,083615,Staff,0,17,60,60
1650847090315,COGS 11,A01,083617,Boyle; Mary E. T.,15,0,40,25
1650847096342,COGS 13,A01,083071,Staff,0,38,40,40
1650847102366,COGS 14A,A01,092681,Staff,0,36,100,100
1650847108391,COGS 14B,A01,083073,Cheng; Tzu-Han,0,12,50,50
1650847114415,COGS 17,A01,092677,Staff,12,0,75,63
1650847120438,COGS 100,A01,083619,Staff,0,30,60,60
1650847126461,COGS 101A,A01,083621,Davis; Joshua Daniel,0,29,60,60
1650847132483,COGS 101B,A01,091572,Staff,0,3,60,60
1650847138507,COGS 101C,A01,083625,Delgado; Tania,14,0,30,16
1650847144530,COGS 107A,A01,083627,Boyle; Mary E. T.,0,16,60,60
1650847150562,COGS 118A,A01,083075,Staff,0,8,60,60
1650847156586,CSE 3,A50,083646,Miranda; Gregory Joseph,18,0,38,20
1650847156586,CSE 3,A51,083647,Miranda; Gregory Joseph,36,0,37,1
1650847162610,CSE 8A,A50,083650,Miranda; Gregory Joseph,0,29,40,40
1650847168636,CSE 11,A01,083080,Cao; Yingjun,0,96,40,40
1650847174660,CSE 12,A01,083652,Staff,0,21,100,100
1650847180682,CSE 15L,A01,083654,Staff,0,3,50,50
1650847180682,CSE 15L,A02,083655,Staff,0,2,50,50
1650847186705,CSE 20,A01,083657,Staff,49,0,80,31
1650847192731,CSE 30,A01,083084,Eldon; John,0,76,40,40
1650847198760,CSE 100,A01,083659,Cao; Yingjun,0,71,50,50
1650847204783,CSE 134B,A01,083661,Powell; Thomas Allan,0,38,65,65
1650847210809,CSE 140,A01,083663,Staff,0,11,75,75
1650847216831,CSE 140L,A01,083088,Eldon; John,0,20,75,75
1650847222853,CSE 175,A01,083665,Kumar; Rakesh,7,0,25,18
1650847228876,CSE 190,A00,092507,Dubnov; Shlomo,10,0,20,10
1650847234899,ECE 45,A01,083139,Staff,0,1,60,60
1650847240922,ECE 65,A50,083695,Staff,0,5,30,30
1650847246948,ECE 109,A01,091882,Touri; Behrouz,32,0,70,38
1650847252971,ECE 180,A00,083140,Abi Samra; Nicholas Camill,20,0,30,10
1650847252971,ECE 180,B00,083141,Abi Samra; Nicholas Camill,0,0,30,30
1650847258997,MATH 10A,A01,083735,Patchell; Gregory David,2,0,30,28
1650847258997,MATH 10A,A02,083736,Patchell; Gregory David,27,0,30,3
1650847258997,MATH 10A,A03,083737,Patchell; Gregory David,24,0,30,6
1650847265026,MATH 10B,A01,083207,Staff,0,9,30,30
1650847265026,MATH 10B,A02,083208,Staff,0,6,30,30
1650847265026,MATH 10B,B01,083739,Staff,10,0,30,20
1650847265026,MATH 10B,B02,083740,Staff,28,0,30,2
1650847271053,MATH 18,A01,083743,Staff,0,0,30,30
1650847271053,MATH 18,A02,083744,Staff,23,0,30,7
1650847271053,MATH 18,A03,083745,Staff,21,0,30,9
1650847271053,MATH 18,A04,083746,Staff,26,0,30,4
1650847271053,MATH 18,B01,083748,Staff,0,15,30,30
1650847271053,MATH 18,B02,083749,Staff,0,13,30,30
1650847271053,MATH 18,B03,083750,Staff,0,13,30,30
1650847271053,MATH 18,B04,083751,Staff,0,13,30,30
1650847277079,MATH 20A,A01,083754,Staff,19,0,40,21
1650847283102,MATH 20B,A01,083756,Staff,0,14,30,30
1650847283102,MATH 20B,A02,083757,Staff,0,12,30,30
1650847289137,MATH 20C,A01,083760,Staff,0,17,30,30
1650847289137,MATH 20C,A02,083761,Staff,0,16,30,30
1650847289137,MATH 20C,B01,083762,Staff,9,0,30,21
1650847289137,MATH 20C,B02,083763,Staff,28,0,30,2
1650847295159,MATH 20D,A01,083765,Staff,2,1,30,28
1650847295159,MATH 20D,A02,083766,Staff,6,0,30,24
1650847295159,MATH 20D,A03,083767,Staff,23,0,30,7
1650847301184,MATH 20E,A01,083771,Staff,2,0,30,28
1650847301184,MATH 20E,A02,083772,Staff,13,0,30,17
1650847301184,MATH 20E,B01,083773,Staff,0,0,30,30
1650847301184,MATH 20E,B02,083774,Staff,5,0,30,25
1650847307212,MATH 103A,A01,083777,Staff,0,16,30,30
1650847307212,MATH 103A,A02,083778,Staff,0,15,30,30
1650847307212,MATH 103A,B01,083779,Staff,0,15,30,30
1650847307212,MATH 103A,B02,083780,Staff,1,15,30,29
1650847313248,MATH 105,A01,085443,Staff,0,22,30,30
1650847319276,MATH 109,A01,083213,Anzaldo; Leesa B,0,7,30,30
1650847319276,MATH 109,A02,083214,Anzaldo; Leesa B,0,7,30,30
1650847319276,MATH 109,B01,083215,Anzaldo; Leesa B,0,8,30,30
1650847319276,MATH 109,B02,083216,Anzaldo; Leesa B,0,7,30,30
1650847325303,MATH 142A,A01,083219,Chow; Bennett,0,16,30,30
1650847325303,MATH 142A,A02,083220,Chow; Bennett,0,15,30,30
1650847325303,MATH 142A,B01,083221,Chow; Bennett,0,16,30,30
1650847325303,MATH 142A,B02,083222,Chow; Bennett,0,14,30,30
1650847331335,MATH 193A,A01,083224,Staff,0,6,30,30
1650847331335,MATH 193A,A02,083225,Staff,0,6,30,30
1650847331335,MATH 193A,A03,083781,Staff,0,6,30,30
1650847331335,MATH 193A,A04,083782,Staff,0,7,30,30
1650847337360,MATH 197,001,091859,McAuley; Julian John,9998,0,9999,1
1650847343411,COGS 9,A01,083615,Staff,0,17,60,60
1650847349434,COGS 11,A01,083617,Boyle; Mary E. T.,15,0,40,25
1650847355458,COGS 13,A01,083071,Staff,0,38,40,40
1650847361479,COGS 14A,A01,092681,Staff,0,36,100,100
1650847367501,COGS 14B,A01,083073,Cheng; Tzu-Han,0,12,50,50
1650847373524,COGS 17,A01,092677,Staff,12,0,75,63
1650847379549,COGS 100,A01,083619,Staff,0,30,60,60
1650847385572,COGS 101A,A01,083621,Davis; Joshua Daniel,0,29,60,60
1650847391608,COGS 101B,A01,091572,Staff,0,3,60,60
1650847397634,COGS 101C,A01,083625,Delgado; Tania,14,0,30,16
1650847403659,COGS 107A,A01,083627,Boyle; Mary E. T.,0,16,60,60
1650847409682,COGS 118A,A01,083075,Staff,0,8,60,60
1650847415706,CSE 3,A50,083646,Miranda; Gregory Joseph,18,0,38,20
1650847415706,CSE 3,A51,083647,Miranda; Gregory Joseph,36,0,37,1
1650847421736,CSE 8A,A50,083650,Miranda; Gregory Joseph,0,29,40,40
1650847427763,CSE 11,A01,083080,Cao; Yingjun,0,96,40,40
1650847433788,CSE 12,A01,083652,Staff,0,21,100,100
1650847439812,CSE 15L,A01,083654,Staff,0,3,50,50
1650847439812,CSE 15L,A02,083655,Staff,0,2,50,50
1650847445834,CSE 20,A01,083657,Staff,49,0,80,31
1650847451866,CSE 30,A01,083084,Eldon; John,0,76,40,40
1650847457893,CSE 100,A01,083659,Cao; Yingjun,0,71,50,50
1650847463926,CSE 134B,A01,083661,Powell; Thomas Allan,0,38,65,65
1650847469948,CSE 140,A01,083663,Staff,0,11,75,75
1650847475975,CSE 140L,A01,083088,Eldon; John,0,20,75,75
1650847482001,CSE 175,A01,083665,Kumar; Rakesh,7,0,25,18
1650847488027,CSE 190,A00,092507,Dubnov; Shlomo,10,0,20,10
1650847494049,ECE 45,A01,083139,Staff,0,1,60,60
1650847500074,ECE 65,A50,083695,Staff,0,5,30,30
1650847506100,ECE 109,A01,091882,Touri; Behrouz,32,0,70,38
1650847512128,ECE 180,A00,083140,Abi Samra; Nicholas Camill,20,0,30,10
1650847512128,ECE 180,B00,083141,Abi Samra; Nicholas Camill,0,0,30,30
1650847518159,MATH 10A,A01,083735,Patchell; Gregory David,2,0,30,28
1650847518159,MATH 10A,A02,083736,Patchell; Gregory David,27,0,30,3
1650847518159,MATH 10A,A03,083737,Patchell; Gregory David,24,0,30,6
1650847524184,MATH 10B,A01,083207,Staff,0,9,30,30
1650847524184,MATH 10B,A02,083208,Staff,0,6,30,30
1650847524184,MATH 10B,B01,083739,Staff,10,0,30,20
1650847524184,MATH 10B,B02,083740,Staff,28,0,30,2
1650847530213,MATH 18,A01,083743,Staff,0,0,30,30
1650847530213,MATH 18,A02,083744,Staff,23,0,30,7
1650847530213,MATH 18,A03,083745,Staff,21,0,30,9
1650847530213,MATH 18,A04,083746,Staff,26,0,30,4
1650847530213,MATH 18,B01,083748,Staff,0,15,30,30
1650847530213,MATH 18,B02,083749,Staff,0,13,30,30
1650847530213,MATH 18,B03,083750,Staff,0,13,30,30
1650847530213,MATH 18,B04,083751,Staff,0,13,30,30
1650847536238,MATH 20A,A01,083754,Staff,19,0,40,21
1650847542261,MATH 20B,A01,083756,Staff,0,14,30,30
1650847542261,MATH 20B,A02,083757,Staff,0,12,30,30
1650847548285,MATH 20C,A01,083760,Staff,0,17,30,30
1650847548285,MATH 20C,A02,083761,Staff,0,16,30,30
1650847548285,MATH 20C,B01,083762,Staff,9,0,30,21
1650847548285,MATH 20C,B02,083763,Staff,28,0,30,2
1650847554307,MATH 20D,A01,083765,Staff,2,1,30,28
1650847554307,MATH 20D,A02,083766,Staff,6,0,30,24
1650847554307,MATH 20D,A03,083767,Staff,23,0,30,7
1650847560332,MATH 20E,A01,083771,Staff,2,0,30,28
1650847560332,MATH 20E,A02,083772,Staff,13,0,30,17
1650847560332,MATH 20E,B01,083773,Staff,0,0,30,30
1650847560332,MATH 20E,B02,083774,Staff,5,0,30,25
1650847566360,MATH 103A,A01,083777,Staff,0,16,30,30
1650847566360,MATH 103A,A02,083778,Staff,0,15,30,30
1650847566360,MATH 103A,B01,083779,Staff,0,15,30,30
1650847566360,MATH 103A,B02,083780,Staff,1,15,30,29
1650847572389,MATH 105,A01,085443,Staff,0,22,30,30
1650847578417,MATH 109,A01,083213,Anzaldo; Leesa B,0,7,30,30
1650847578417,MATH 109,A02,083214,Anzaldo; Leesa B,0,7,30,30
1650847578417,MATH 109,B01,083215,Anzaldo; Leesa B,0,8,30,30
1650847578417,MATH 109,B02,083216,Anzaldo; Leesa B,0,7,30,30
1650847584439,MATH 142A,A01,083219,Chow; Bennett,0,16,30,30
1650847584439,MATH 142A,A02,083220,Chow; Bennett,0,15,30,30
1650847584439,MATH 142A,B01,083221,Chow; Bennett,0,16,30,30
1650847584439,MATH 142A,B02,083222,Chow; Bennett,0,14,30,30
1650847590466,MATH 193A,A01,083224,Staff,0,6,30,30
1650847590466,MATH 193A,A02,083225,Staff,0,6,30,30
1650847590466,MATH 193A,A03,083781,Staff,0,6,30,30
1650847590466,MATH 193A,A04,083782,Staff,0,7,30,30
1650847596489,MATH 197,001,091859,McAuley; Julian John,9998,0,9999,1
1650847602544,COGS 9,A01,083615,Staff,0,17,60,60
1650847608571,COGS 11,A01,083617,Boyle; Mary E. T.,15,0,40,25
1650847614596,COGS 13,A01,083071,Staff,0,38,40,40
1650847620620,COGS 14A,A01,092681,Staff,0,36,100,100
1650847626644,COGS 14B,A01,083073,Cheng; Tzu-Han,0,12,50,50
1650847632673,COGS 17,A01,092677,Staff,12,0,75,63
1650847638773,COGS 100,A01,083619,Staff,0,30,60,60
1650847644796,COGS 101A,A01,083621,Davis; Joshua Daniel,0,29,60,60
1650847650826,COGS 101B,A01,091572,Staff,0,3,60,60
1650847656852,COGS 101C,A01,083625,Delgado; Tania,14,0,30,16
1650847662876,COGS 107A,A01,083627,Boyle; Mary E. T.,0,16,60,60
1650847668901,COGS 118A,A01,083075,Staff,0,8,60,60
1650847674925,CSE 3,A50,083646,Miranda; Gregory Joseph,18,0,38,20
1650847674925,CSE 3,A51,083647,Miranda; Gregory Joseph,36,0,37,1
1650847680949,CSE 8A,A50,083650,Miranda; Gregory Joseph,0,29,40,40
1650847686973,CSE 11,A01,083080,Cao; Yingjun,0,96,40,40
1650847692996,CSE 12,A01,083652,Staff,0,21,100,100
1650847699023,CSE 15L,A01,083654,Staff,0,3,50,50
1650847699023,CSE 15L,A02,083655,Staff,0,3,50,50
1650847705049,CSE 20,A01,083657,Staff,49,0,80,31
1650847711073,CSE 30,A01,083084,Eldon; John,0,76,40,40
1650847717101,CSE 100,A01,083659,Cao; Yingjun,0,71,50,50
1650847723128,CSE 134B,A01,083661,Powell; Thomas Allan,0,38,65,65
1650847729149,CSE 140,A01,083663,Staff,0,11,75,75
1650847735187,CSE 140L,A01,083088,Eldon; John,0,20,75,75
1650847741208,CSE 175,A01,083665,Kumar; Rakesh,7,0,25,18
1650847747237,CSE 190,A00,092507,Dubnov; Shlomo,10,0,20,10
1650847753263,ECE 45,A01,083139,Staff,0,1,60,60
1650847759289,ECE 65,A50,083695,Staff,0,5,30,30
1650847765315,ECE 109,A01,091882,Touri; Behrouz,32,0,70,38
1650847771342,ECE 180,A00,083140,Abi Samra; Nicholas Camill,20,0,30,10
1650847771342,ECE 180,B00,083141,Abi Samra; Nicholas Camill,0,0,30,30
1650847777367,MATH 10A,A01,083735,Patchell; Gregory David,2,0,30,28
1650847777367,MATH 10A,A02,083736,Patchell; Gregory David,27,0,30,3
1650847777367,MATH 10A,A03,083737,Patchell; Gregory David,24,0,30,6
1650847783391,MATH 10B,A01,083207,Staff,0,9,30,30
1650847783391,MATH 10B,A02,083208,Staff,0,6,30,30
1650847783391,MATH 10B,B01,083739,Staff,10,0,30,20
1650847783391,MATH 10B,B02,083740,Staff,28,0,30,2
1650847789424,MATH 18,A01,083743,Staff,0,0,30,30
1650847789424,MATH 18,A02,083744,Staff,23,0,30,7
1650847789424,MATH 18,A03,083745,Staff,21,0,30,9
1650847789424,MATH 18,A04,083746,Staff,26,0,30,4
1650847789424,MATH 18,B01,083748,Staff,0,15,30,30
1650847789424,MATH 18,B02,083749,Staff,0,13,30,30
1650847789424,MATH 18,B03,083750,Staff,0,13,30,30
1650847789424,MATH 18,B04,083751,Staff,0,13,30,30
1650847795448,MATH 20A,A01,083754,Staff,19,0,40,21
1650847801474,MATH 20B,A01,083756,Staff,0,14,30,30
1650847801474,MATH 20B,A02,083757,Staff,0,12,30,30
1650847807498,MATH 20C,A01,083760,Staff,0,17,30,30
1650847807498,MATH 20C,A02,083761,Staff,0,16,30,30
1650847807498,MATH 20C,B01,083762,Staff,9,0,30,21
1650847807498,MATH 20C,B02,083763,Staff,28,0,30,2
1650847813523,MATH 20D,A01,083765,Staff,2,1,30,28
1650847813523,MATH 20D,A02,083766,Staff,6,0,30,24
1650847813523,MATH 20D,A03,083767,Staff,23,0,30,7
1650847819545,MATH 20E,A01,083771,Staff,2,0,30,28
1650847819545,MATH 20E,A02,083772,Staff,13,0,30,17
1650847819545,MATH 20E,B01,083773,Staff,0,0,30,30
1650847819545,MATH 20E,B02,083774,Staff,5,0,30,25
1650847825573,MATH 103A,A01,083777,Staff,0,16,30,30
1650847825573,MATH 103A,A02,083778,Staff,0,15,30,30
1650847825573,MATH 103A,B01,083779,Staff,0,15,30,30
1650847825573,MATH 103A,B02,083780,Staff,1,15,30,29
1650847831596,MATH 105,A01,085443,Staff,0,22,30,30
1650847837620,MATH 109,A01,083213,Anzaldo; Leesa B,0,7,30,30
1650847837620,MATH 109,A02,083214,Anzaldo; Leesa B,0,7,30,30
1650847837620,MATH 109,B01,083215,Anzaldo; Leesa B,0,8,30,30
1650847837620,MATH 109,B02,083216,Anzaldo; Leesa B,0,7,30,30
1650847843643,MATH 142A,A01,083219,Chow; Bennett,0,16,30,30
1650847843643,MATH 142A,A02,083220,Chow; Bennett,0,15,30,30
1650847843643,MATH 142A,B01,083221,Chow; Bennett,0,16,30,30
1650847843643,MATH 142A,B02,083222,Chow; Bennett,0,14,30,30
1650847849666,MATH 193A,A01,083224,Staff,0,6,30,30
1650847849666,MATH 193A,A02,083225,Staff,0,6,30,30
1650847849666,MATH 193A,A03,083781,Staff,0,6,30,30
1650847849666,MATH 193A,A04,083782,Staff,0,7,30,30
1650847855689,MATH 197,001,091859,McAuley; Julian John,9998,0,9999,1
1650847861750,COGS 9,A01,083615,Staff,0,17,60,60
1650847867775,COGS 11,A01,083617,Boyle; Mary E. T.,15,0,40,25
1650847873801,COGS 13,A01,083071,Staff,0,38,40,40
1650847879828,COGS 14A,A01,092681,Staff,0,36,100,100
1650847885850,COGS 14B,A01,083073,Cheng; Tzu-Han,0,12,50,50
1650847891872,COGS 17,A01,092677,Staff,12,0,75,63
1650847897896,COGS 100,A01,083619,Staff,0,30,60,60
1650847903921,COGS 101A,A01,083621,Davis; Joshua Daniel,0,29,60,60
1650847909946,COGS 101B,A01,091572,Staff,0,3,60,60
1650847915970,COGS 101C,A01,083625,Delgado; Tania,14,0,30,16
1650847921994,COGS 107A,A01,083627,Boyle; Mary E. T.,0,16,60,60
1650847928021,COGS 118A,A01,083075,Staff,0,8,60,60
1650847934044,CSE 3,A50,083646,Miranda; Gregory Joseph,18,0,38,20
1650847934044,CSE 3,A51,083647,Miranda; Gregory Joseph,36,0,37,1
1650847940068,CSE 8A,A50,083650,Miranda; Gregory Joseph,0,29,40,40
1650847946092,CSE 11,A01,083080,Cao; Yingjun,0,96,40,40
1650847952116,CSE 12,A01,083652,Staff,0,21,100,100
1650847958142,CSE 15L,A01,083654,Staff,0,3,50,50
1650847958142,CSE 15L,A02,083655,Staff,0,3,50,50
1650847964167,CSE 20,A01,083657,Staff,49,0,80,31
1650847970191,CSE 30,A01,083084,Eldon; John,0,76,40,40
1650847976220,CSE 100,A01,083659,Cao; Yingjun,0,71,50,50
1650847982246,CSE 134B,A01,083661,Powell; Thomas Allan,0,38,65,65
1650847988273,CSE 140,A01,083663,Staff,0,11,75,75
1650847994301,CSE 140L,A01,083088,Eldon; John,0,20,75,75
1650848000326,CSE 175,A01,083665,Kumar; Rakesh,7,0,25,18
1650848006348,CSE 190,A00,092507,Dubnov; Shlomo,10,0,20,10
1650848012374,ECE 45,A01,083139,Staff,0,1,60,60
1650848018402,ECE 65,A50,083695,Staff,0,5,30,30
1650848024428,ECE 109,A01,091882,Touri; Behrouz,32,0,70,38
1650848030451,ECE 180,A00,083140,Abi Samra; Nicholas Camill,20,0,30,10
1650848030451,ECE 180,B00,083141,Abi Samra; Nicholas Camill,0,0,30,30
1650848036475,MATH 10A,A01,083735,Patchell; Gregory David,2,0,30,28
1650848036475,MATH 10A,A02,083736,Patchell; Gregory David,27,0,30,3
1650848036475,MATH 10A,A03,083737,Patchell; Gregory David,24,0,30,6
1650848042499,MATH 10B,A01,083207,Staff,0,9,30,30
1650848042499,MATH 10B,A02,083208,Staff,0,6,30,30
1650848042499,MATH 10B,B01,083739,Staff,10,0,30,20
1650848042499,MATH 10B,B02,083740,Staff,28,0,30,2
1650848048532,MATH 18,A01,083743,Staff,0,0,30,30
1650848048532,MATH 18,A02,083744,Staff,23,0,30,7
1650848048532,MATH 18,A03,083745,Staff,21,0,30,9
1650848048532,MATH 18,A04,083746,Staff,26,0,30,4
1650848048532,MATH 18,B01,083748,Staff,0,15,30,30
1650848048532,MATH 18,B02,083749,Staff,0,13,30,30
1650848048532,MATH 18,B03,083750,Staff,0,13,30,30
1650848048532,MATH 18,B04,083751,Staff,0,13,30,30
1650848054558,MATH 20A,A01,083754,Staff,19,0,40,21
1650848060580,MATH 20B,A01,083756,Staff,0,14,30,30
1650848060580,MATH 20B,A02,083757,Staff,0,12,30,30
1650848066605,MATH 20C,A01,083760,Staff,0,17,30,30
1650848066605,MATH 20C,A02,083761,Staff,0,16,30,30
1650848066605,MATH 20C,B01,083762,Staff,9,0,30,21
1650848066605,MATH 20C,B02,083763,Staff,28,0,30,2
1650848072627,MATH 20D,A01,083765,Staff,2,1,30,28
1650848072627,MATH 20D,A02,083766,Staff,6,0,30,24
1650848072627,MATH 20D,A03,083767,Staff,23,0,30,7
1650848078652,MATH 20E,A01,083771,Staff,2,0,30,28
1650848078652,MATH 20E,A02,083772,Staff,13,0,30,17
1650848078652,MATH 20E,B01,083773,Staff,0,0,30,30
1650848078652,MATH 20E,B02,083774,Staff,5,0,30,25
1650848084676,MATH 103A,A01,083777,Staff,0,16,30,30
1650848084676,MATH 103A,A02,083778,Staff,0,15,30,30
1650848084676,MATH 103A,B01,083779,Staff,0,15,30,30
1650848084676,MATH 103A,B02,083780,Staff,1,15,30,29
1650848090701,MATH 105,A01,085443,Staff,0,22,30,30
1650848096732,MATH 109,A01,083213,Anzaldo; Leesa B,0,7,30,30
1650848096732,MATH 109,A02,083214,Anzaldo; Leesa B,0,7,30,30
1650848096732,MATH 109,B01,083215,Anzaldo; Leesa B,0,8,30,30
1650848096732,MATH 109,B02,083216,Anzaldo; Leesa B,0,7,30,30
1650848102760,MATH 142A,A01,083219,Chow; Bennett,0,16,30,30
1650848102760,MATH 142A,A02,083220,Chow; Bennett,0,15,30,30
1650848102760,MATH 142A,B01,083221,Chow; Bennett,0,16,30,30
1650848102760,MATH 142A,B02,083222,Chow; Bennett,0,14,30,30
1650848108783,MATH 193A,A01,083224,Staff,0,6,30,30
1650848108783,MATH 193A,A02,083225,Staff,0,6,30,30
1650848108783,MATH 193A,A03,083781,Staff,0,6,30,30
1650848108783,MATH 193A,A04,083782,Staff,0,7,30,30
1650848114806,MATH 197,001,091859,McAuley; Julian John,9998,0,9999,1
1650848120855,COGS 9,A01,083615,Staff,0,17,60,60
1650848126877,COGS 11,A01,083617,Boyle; Mary E. T.,15,0,40,25
1650848132900,COGS 13,A01,083071,Staff,0,38,40,40
1650848138922,COGS 14A,A01,092681,Staff,0,36,100,100
1650848144948,COGS 14B,A01,083073,Cheng; Tzu-Han,0,12,50,50
1650848150972,COGS 17,A01,092677,Staff,12,0,75,63
1650848157003,COGS 100,A01,083619,Staff,0,30,60,60
1650848163030,COGS 101A,A01,083621,Davis; Joshua Daniel,0,29,60,60
1650848169053,COGS 101B,A01,091572,Staff,0,3,60,60
1650848175080,COGS 101C,A01,083625,Delgado; Tania,14,0,30,16
1650848181114,COGS 107A,A01,083627,Boyle; Mary E. T.,0,16,60,60
1650848187141,COGS 118A,A01,083075,Staff,0,8,60,60
1650848193167,CSE 3,A50,083646,Miranda; Gregory Joseph,18,0,38,20
1650848193167,CSE 3,A51,083647,Miranda; Gregory Joseph,36,0,37,1
1650848199191,CSE 8A,A50,083650,Miranda; Gregory Joseph,0,29,40,40
1650848205216,CSE 11,A01,083080,Cao; Yingjun,0,96,40,40
1650848211240,CSE 12,A01,083652,Staff,0,21,100,100
1650848217272,CSE 15L,A01,083654,Staff,0,3,50,50
1650848217272,CSE 15L,A02,083655,Staff,0,3,50,50
1650848223299,CSE 20,A01,083657,Staff,49,0,80,31
1650848229323,CSE 30,A01,083084,Eldon; John,0,76,40,40
1650848235424,CSE 100,A01,083659,Cao; Yingjun,0,71,50,50
1650848241451,CSE 134B,A01,083661,Powell; Thomas Allan,0,38,65,65
1650848247475,CSE 140,A01,083663,Staff,0,11,75,75
1650848253497,CSE 140L,A01,083088,Eldon; John,0,20,75,75
1650848259523,CSE 175,A01,083665,Kumar; Rakesh,7,0,25,18
1650848265549,CSE 190,A00,092507,Dubnov; Shlomo,10,0,20,10
1650848271575,ECE 45,A01,083139,Staff,0,1,60,60
1650848277598,ECE 65,A50,083695,Staff,0,5,30,30
1650848283625,ECE 109,A01,091882,Touri; Behrouz,32,0,70,38
1650848289647,ECE 180,A00,083140,Abi Samra; Nicholas Camill,20,0,30,10
1650848289647,ECE 180,B00,083141,Abi Samra; Nicholas Camill,0,0,30,30
1650848295670,MATH 10A,A01,083735,Patchell; Gregory David,2,0,30,28
1650848295670,MATH 10A,A02,083736,Patchell; Gregory David,27,0,30,3
1650848295670,MATH 10A,A03,083737,Patchell; Gregory David,24,0,30,6
1650848301699,MATH 10B,A01,083207,Staff,0,9,30,30
1650848301699,MATH 10B,A02,083208,Staff,0,6,30,30
1650848301699,MATH 10B,B01,083739,Staff,10,0,30,20
1650848301699,MATH 10B,B02,083740,Staff,28,0,30,2
1650848307730,MATH 18,A01,083743,Staff,0,0,30,30
1650848307730,MATH 18,A02,083744,Staff,23,0,30,7
1650848307730,MATH 18,A03,083745,Staff,21,0,30,9
1650848307730,MATH 18,A04,083746,Staff,26,0,30,4
1650848307730,MATH 18,B01,083748,Staff,0,15,30,30
1650848307730,MATH 18,B02,083749,Staff,0,13,30,30
1650848307730,MATH 18,B03,083750,Staff,0,13,30,30
1650848307730,MATH 18,B04,083751,Staff,0,13,30,30
1650848313756,MATH 20A,A01,083754,Staff,19,0,40,21
1650848319784,MATH 20B,A01,083756,Staff,0,14,30,30
1650848319784,MATH 20B,A02,083757,Staff,0,12,30,30
1650848325815,MATH 20C,A01,083760,Staff,0,17,30,30
1650848325815,MATH 20C,A02,083761,Staff,0,16,30,30
1650848325815,MATH 20C,B01,083762,Staff,9,0,30,21
1650848325815,MATH 20C,B02,083763,Staff,28,0,30,2
1650848331845,MATH 20D,A01,083765,Staff,2,1,30,28
1650848331845,MATH 20D,A02,083766,Staff,6,0,30,24
1650848331845,MATH 20D,A03,083767,Staff,23,0,30,7
1650848337874,MATH 20E,A01,083771,Staff,2,0,30,28
1650848337874,MATH 20E,A02,083772,Staff,13,0,30,17
1650848337874,MATH 20E,B01,083773,Staff,0,0,30,30
1650848337874,MATH 20E,B02,083774,Staff,5,0,30,25
1650848343897,MATH 103A,A01,083777,Staff,0,16,30,30
1650848343897,MATH 103A,A02,083778,Staff,0,15,30,30
1650848343897,MATH 103A,B01,083779,Staff,0,15,30,30
1650848343897,MATH 103A,B02,083780,Staff,1,15,30,29
1650848349920,MATH 105,A01,085443,Staff,0,22,30,30
1650848355946,MATH 109,A01,083213,Anzaldo; Leesa B,0,7,30,30
1650848355946,MATH 109,A02,083214,Anzaldo; Leesa B,0,7,30,30
1650848355946,MATH 109,B01,083215,Anzaldo; Leesa B,0,8,30,30
1650848355946,MATH 109,B02,083216,Anzaldo; Leesa B,0,7,30,30
1650848361974,MATH 142A,A01,083219,Chow; Bennett,0,16,30,30
1650848361974,MATH 142A,A02,083220,Chow; Bennett,0,15,30,30
1650848361974,MATH 142A,B01,083221,Chow; Bennett,0,16,30,30
1650848361974,MATH 142A,B02,083222,Chow; Bennett,0,14,30,30
1650848368001,MATH 193A,A01,083224,Staff,0,6,30,30
1650848368001,MATH 193A,A02,083225,Staff,0,6,30,30
1650848368001,MATH 193A,A03,083781,Staff,0,6,30,30
1650848368001,MATH 193A,A04,083782,Staff,0,7,30,30
1650848374024,MATH 197,001,091859,McAuley; Julian John,9998,0,9999,1
1650848380092,COGS 9,A01,083615,Staff,0,17,60,60
1650848386118,COGS 11,A01,083617,Boyle; Mary E. T.,15,0,40,25
1650848392140,COGS 13,A01,083071,Staff,0,38,40,40
1650848398164,COGS 14A,A01,092681,Staff,0,36,100,100
1650848404186,COGS 14B,A01,083073,Cheng; Tzu-Han,0,12,50,50
1650848410210,COGS 17,A01,092677,Staff,12,0,75,63
1650848416234,COGS 100,A01,083619,Staff,0,30,60,60
1650848422261,COGS 101A,A01,083621,Davis; Joshua Daniel,0,29,60,60
1650848428284,COGS 101B,A01,091572,Staff,0,3,60,60
1650848434309,COGS 101C,A01,083625,Delgado; Tania,14,0,30,16
1650848440342,COGS 107A,A01,083627,Boyle; Mary E. T.,0,16,60,60
1650848446368,COGS 118A,A01,083075,Staff,0,8,60,60
1650848452392,CSE 3,A50,083646,Miranda; Gregory Joseph,18,0,38,20
1650848452392,CSE 3,A51,083647,Miranda; Gregory Joseph,36,0,37,1
1650848458420,CSE 8A,A50,083650,Miranda; Gregory Joseph,0,29,40,40
1650848464452,CSE 11,A01,083080,Cao; Yingjun,0,96,40,40
1650848470476,CSE 12,A01,083652,Staff,0,21,100,100
1650848476500,CSE 15L,A01,083654,Staff,0,3,50,50
1650848476500,CSE 15L,A02,083655,Staff,0,3,50,50
1650848482523,CSE 20,A01,083657,Staff,49,0,80,31
1650848488555,CSE 30,A01,083084,Eldon; John,0,76,40,40
1650848494578,CSE 100,A01,083659,Cao; Yingjun,0,71,50,50
1650848500602,CSE 134B,A01,083661,Powell; Thomas Allan,0,38,65,65
1650848506636,CSE 140,A01,083663,Staff,0,11,75,75
1650848512660,CSE 140L,A01,083088,Eldon; John,0,20,75,75
1650848518686,CSE 175,A01,083665,Kumar; Rakesh,7,0,25,18
1650848524722,CSE 190,A00,092507,Dubnov; Shlomo,10,0,20,10
1650848530748,ECE 45,A01,083139,Staff,0,1,60,60
1650848536774,ECE 65,A50,083695,Staff,0,5,30,30
1650848542799,ECE 109,A01,091882,Touri; Behrouz,32,0,70,38
1650848548826,ECE 180,A00,083140,Abi Samra; Nicholas Camill,20,0,30,10
1650848548826,ECE 180,B00,083141,Abi Samra; Nicholas Camill,0,0,30,30
1650848554853,MATH 10A,A01,083735,Patchell; Gregory David,2,0,30,28
1650848554853,MATH 10A,A02,083736,Patchell; Gregory David,27,0,30,3
1650848554853,MATH 10A,A03,083737,Patchell; Gregory David,24,0,30,6
1650848560877,MATH 10B,A01,083207,Staff,0,9,30,30
1650848560877,MATH 10B,A02,083208,Staff,0,6,30,30
1650848560877,MATH 10B,B01,083739,Staff,10,0,30,20
1650848560877,MATH 10B,B02,083740,Staff,28,0,30,2
1650848566901,MATH 18,A01,083743,Staff,0,0,30,30
1650848566901,MATH 18,A02,083744,Staff,23,0,30,7
1650848566901,MATH 18,A03,083745,Staff,21,0,30,9
1650848566901,MATH 18,A04,083746,Staff,26,0,30,4
1650848566901,MATH 18,B01,083748,Staff,0,15,30,30
1650848566901,MATH 18,B02,083749,Staff,0,13,30,30
1650848566901,MATH 18,B03,083750,Staff,0,13,30,30
1650848566901,MATH 18,B04,083751,Staff,0,13,30,30
1650848572924,MATH 20A,A01,083754,Staff,19,0,40,21
1650848578951,MATH 20B,A01,083756,Staff,0,14,30,30
1650848578951,MATH 20B,A02,083757,Staff,0,12,30,30
1650848584980,MATH 20C,A01,083760,Staff,0,17,30,30
1650848584980,MATH 20C,A02,083761,Staff,0,16,30,30
1650848584980,MATH 20C,B01,083762,Staff,9,0,30,21
1650848584980,MATH 20C,B02,083763,Staff,28,0,30,2
1650848591006,MATH 20D,A01,083765,Staff,2,1,30,28
1650848591006,MATH 20D,A02,083766,Staff,6,0,30,24
1650848591006,MATH 20D,A03,083767,Staff,23,0,30,7
1650848597032,MATH 20E,A01,083771,Staff,2,0,30,28
1650848597032,MATH 20E,A02,083772,Staff,13,0,30,17
1650848597032,MATH 20E,B01,083773,Staff,0,0,30,30
1650848597032,MATH 20E,B02,083774,Staff,5,0,30,25
1650848603054,MATH 103A,A01,083777,Staff,0,16,30,30
1650848603054,MATH 103A,A02,083778,Staff,0,15,30,30
1650848603054,MATH 103A,B01,083779,Staff,0,15,30,30
1650848603054,MATH 103A,B02,083780,Staff,1,15,30,29
1650848609080,MATH 105,A01,085443,Staff,0,22,30,30
1650848615105,MATH 109,A01,083213,Anzaldo; Leesa B,0,7,30,30
1650848615105,MATH 109,A02,083214,Anzaldo; Leesa B,0,7,30,30
1650848615105,MATH 109,B01,083215,Anzaldo; Leesa B,0,8,30,30
1650848615105,MATH 109,B02,083216,Anzaldo; Leesa B,0,7,30,30
1650848621136,MATH 142A,A01,083219,Chow; Bennett,0,16,30,30
1650848621136,MATH 142A,A02,083220,Chow; Bennett,0,15,30,30
1650848621136,MATH 142A,B01,083221,Chow; Bennett,0,16,30,30
1650848621136,MATH 142A,B02,083222,Chow; Bennett,0,14,30,30
1650848627162,MATH 193A,A01,083224,Staff,0,6,30,30
1650848627162,MATH 193A,A02,083225,Staff,0,6,30,30
1650848627162,MATH 193A,A03,083781,Staff,0,6,30,30
1650848627162,MATH 193A,A04,083782,Staff,0,7,30,30
1650848633189,MATH 197,001,091859,McAuley; Julian John,9998,0,9999,1
1650848639240,COGS 9,A01,083615,Staff,0,17,60,60
1650848645270,COGS 11,A01,083617,Boyle; Mary E. T.,15,0,40,25
1650848651292,COGS 13,A01,083071,Staff,0,38,40,40
1650848657318,COGS 14A,A01,092681,Staff,0,36,100,100
1650848663340,COGS 14B,A01,083073,Cheng; Tzu-Han,0,12,50,50
1650848669364,COGS 17,A01,092677,Staff,12,0,75,63
1650848675392,COGS 100,A01,083619,Staff,0,30,60,60
1650848681415,COGS 101A,A01,083621,Davis; Joshua Daniel,0,29,60,60
1650848687445,COGS 101B,A01,091572,Staff,0,3,60,60
1650848693470,COGS 101C,A01,083625,Delgado; Tania,14,0,30,16
1650848699495,COGS 107A,A01,083627,Boyle; Mary E. T.,0,16,60,60
1650848705525,COGS 118A,A01,083075,Staff,0,8,60,60
1650848711548,CSE 3,A50,083646,Miranda; Gregory Joseph,18,0,38,20
1650848711548,CSE 3,A51,083647,Miranda; Gregory Joseph,36,0,37,1
1650848717572,CSE 8A,A50,083650,Miranda; Gregory Joseph,0,29,40,40
1650848723598,CSE 11,A01,083080,Cao; Yingjun,0,96,40,40
1650848729621,CSE 12,A01,083652,Staff,0,21,100,100
1650848735644,CSE 15L,A01,083654,Staff,0,3,50,50
1650848735644,CSE 15L,A02,083655,Staff,0,3,50,50
1650848741670,CSE 20,A01,083657,Staff,49,0,80,31
1650848747693,CSE 30,A01,083084,Eldon; John,0,76,40,40
1650848753717,CSE 100,A01,083659,Cao; Yingjun,0,71,50,50
1650848759740,CSE 134B,A01,083661,Powell; Thomas Allan,0,38,65,65
1650848765762,CSE 140,A01,083663,Staff,0,11,75,75
1650848771786,CSE 140L,A01,083088,Eldon; John,0,20,75,75
1650848777813,CSE 175,A01,083665,Kumar; Rakesh,7,0,25,18
1650848783839,CSE 190,A00,092507,Dubnov; Shlomo,10,0,20,10
1650848789867,ECE 45,A01,083139,Staff,0,1,60,60
1650848795892,ECE 65,A50,083695,Staff,0,5,30,30
1650848801914,ECE 109,A01,091882,Touri; Behrouz,32,0,70,38
1650848807942,ECE 180,A00,083140,Abi Samra; Nicholas Camill,20,0,30,10
1650848807942,ECE 180,B00,083141,Abi Samra; Nicholas Camill,0,0,30,30
1650848813970,MATH 10A,A01,083735,Patchell; Gregory David,2,0,30,28
1650848813970,MATH 10A,A02,083736,Patchell; Gregory David,27,0,30,3
1650848813970,MATH 10A,A03,083737,Patchell; Gregory David,24,0,30,6
1650848819997,MATH 10B,A01,083207,Staff,0,9,30,30
1650848819997,MATH 10B,A02,083208,Staff,0,6,30,30
1650848819997,MATH 10B,B01,083739,Staff,10,0,30,20
1650848819997,MATH 10B,B02,083740,Staff,28,0,30,2
1650848826023,MATH 18,A01,083743,Staff,0,0,30,30
1650848826023,MATH 18,A02,083744,Staff,23,0,30,7
1650848826023,MATH 18,A03,083745,Staff,21,0,30,9
1650848826023,MATH 18,A04,083746,Staff,26,0,30,4
1650848826023,MATH 18,B01,083748,Staff,0,15,30,30
1650848826023,MATH 18,B02,083749,Staff,0,13,30,30
1650848826023,MATH 18,B03,083750,Staff,0,13,30,30
1650848826023,MATH 18,B04,083751,Staff,0,13,30,30
1650848832140,MATH 20A,A01,083754,Staff,19,0,40,21
1650848838166,MATH 20B,A01,083756,Staff,0,14,30,30
1650848838166,MATH 20B,A02,083757,Staff,0,12,30,30
1650848844194,MATH 20C,A01,083760,Staff,0,17,30,30
1650848844194,MATH 20C,A02,083761,Staff,0,16,30,30
1650848844194,MATH 20C,B01,083762,Staff,9,0,30,21
1650848844194,MATH 20C,B02,083763,Staff,28,0,30,2
1650848850217,MATH 20D,A01,083765,Staff,2,1,30,28
1650848850217,MATH 20D,A02,083766,Staff,6,0,30,24
1650848850217,MATH 20D,A03,083767,Staff,23,0,30,7
1650848856239,MATH 20E,A01,083771,Staff,2,0,30,28
1650848856239,MATH 20E,A02,083772,Staff,13,0,30,17
1650848856239,MATH 20E,B01,083773,Staff,0,0,30,30
1650848856239,MATH 20E,B02,083774,Staff,5,0,30,25
1650848862265,MATH 103A,A01,083777,Staff,0,16,30,30
1650848862265,MATH 103A,A02,083778,Staff,0,15,30,30
1650848862265,MATH 103A,B01,083779,Staff,0,15,30,30
1650848862265,MATH 103A,B02,083780,Staff,1,15,30,29
1650848868289,MATH 105,A01,085443,Staff,0,22,30,30
1650848874317,MATH 109,A01,083213,Anzaldo; Leesa B,0,7,30,30
1650848874317,MATH 109,A02,083214,Anzaldo; Leesa B,0,7,30,30
1650848874317,MATH 109,B01,083215,Anzaldo; Leesa B,0,8,30,30
1650848874317,MATH 109,B02,083216,Anzaldo; Leesa B,0,7,30,30
1650848880343,MATH 142A,A01,083219,Chow; Bennett,0,15,30,30
1650848880343,MATH 142A,A02,083220,Chow; Bennett,0,15,30,30
1650848880343,MATH 142A,B01,083221,Chow; Bennett,0,16,30,30
1650848880343,MATH 142A,B02,083222,Chow; Bennett,0,14,30,30
1650848886369,MATH 193A,A01,083224,Staff,0,6,30,30
1650848886369,MATH 193A,A02,083225,Staff,0,6,30,30
1650848886369,MATH 193A,A03,083781,Staff,0,6,30,30
1650848886369,MATH 193A,A04,083782,Staff,0,7,30,30
1650848892397,MATH 197,001,091859,McAuley; Julian John,9998,0,9999,1
1650848898452,COGS 9,A01,083615,Staff,0,17,60,60
1650848904475,COGS 11,A01,083617,Boyle; Mary E. T.,15,0,40,25
1650848910498,COGS 13,A01,083071,Staff,0,38,40,40
1650848916525,COGS 14A,A01,092681,Staff,0,36,100,100
1650848922550,COGS 14B,A01,083073,Cheng; Tzu-Han,0,12,50,50
1650848928575,COGS 17,A01,092677,Staff,12,0,75,63
1650848934598,COGS 100,A01,083619,Staff,0,30,60,60
1650848940621,COGS 101A,A01,083621,Davis; Joshua Daniel,0,29,60,60
1650848946648,COGS 101B,A01,091572,Staff,0,3,60,60
1650848952676,COGS 101C,A01,083625,Delgado; Tania,14,0,30,16
1650848958702,COGS 107A,A01,083627,Boyle; Mary E. T.,0,16,60,60
1650848964724,COGS 118A,A01,083075,Staff,0,8,60,60
1650848970754,CSE 3,A50,083646,Miranda; Gregory Joseph,18,0,38,20
1650848970754,CSE 3,A51,083647,Miranda; Gregory Joseph,36,0,37,1
1650848976782,CSE 8A,A50,083650,Miranda; Gregory Joseph,0,29,40,40
1650848982812,CSE 11,A01,083080,Cao; Yingjun,0,96,40,40
1650848988835,CSE 12,A01,083652,Staff,0,21,100,100
1650848994861,CSE 15L,A01,083654,Staff,0,3,50,50
1650848994861,CSE 15L,A02,083655,Staff,0,3,50,50
1650849000883,CSE 20,A01,083657,Staff,49,0,80,31
1650849006906,CSE 30,A01,083084,Eldon; John,0,76,40,40
1650849012934,CSE 100,A01,083659,Cao; Yingjun,0,71,50,50
1650849018956,CSE 134B,A01,083661,Powell; Thomas Allan,0,38,65,65
1650849024981,CSE 140,A01,083663,Staff,0,11,75,75
1650849031005,CSE 140L,A01,083088,Eldon; John,0,20,75,75
1650849037029,CSE 175,A01,083665,Kumar; Rakesh,7,0,25,18
1650849043052,CSE 190,A00,092507,Dubnov; Shlomo,10,0,20,10
1650849049076,ECE 45,A01,083139,Staff,0,1,60,60
1650849055103,ECE 65,A50,083695,Staff,0,5,30,30
1650849061127,ECE 109,A01,091882,Touri; Behrouz,32,0,70,38
1650849067157,ECE 180,A00,083140,Abi Samra; Nicholas Camill,20,0,30,10
1650849067157,ECE 180,B00,083141,Abi Samra; Nicholas Camill,0,0,30,30
1650849073184,MATH 10A,A01,083735,Patchell; Gregory David,2,0,30,28
1650849073184,MATH 10A,A02,083736,Patchell; Gregory David,27,0,30,3
1650849073184,MATH 10A,A03,083737,Patchell; Gregory David,24,0,30,6
1650849079207,MATH 10B,A01,083207,Staff,0,9,30,30
1650849079207,MATH 10B,A02,083208,Staff,0,6,30,30
1650849079207,MATH 10B,B01,083739,Staff,10,0,30,20
1650849079207,MATH 10B,B02,083740,Staff,28,0,30,2
1650849085232,MATH 18,A01,083743,Staff,0,0,30,30
1650849085232,MATH 18,A02,083744,Staff,23,0,30,7
1650849085232,MATH 18,A03,083745,Staff,21,0,30,9
1650849085232,MATH 18,A04,083746,Staff,26,0,30,4
1650849085232,MATH 18,B01,083748,Staff,0,15,30,30
1650849085232,MATH 18,B02,083749,Staff,0,13,30,30
1650849085232,MATH 18,B03,083750,Staff,0,13,30,30
1650849085232,MATH 18,B04,083751,Staff,0,13,30,30
1650849091257,MATH 20A,A01,083754,Staff,19,0,40,21
1650849097284,MATH 20B,A01,083756,Staff,0,14,30,30
1650849097284,MATH 20B,A02,083757,Staff,0,12,30,30
1650849103312,MATH 20C,A01,083760,Staff,0,17,30,30
1650849103312,MATH 20C,A02,083761,Staff,0,16,30,30
1650849103312,MATH 20C,B01,083762,Staff,9,0,30,21
1650849103312,MATH 20C,B02,083763,Staff,28,0,30,2
1650849109339,MATH 20D,A01,083765,Staff,2,1,30,28
1650849109339,MATH 20D,A02,083766,Staff,6,0,30,24
1650849109339,MATH 20D,A03,083767,Staff,23,0,30,7
1650849115364,MATH 20E,A01,083771,Staff,2,0,30,28
1650849115364,MATH 20E,A02,083772,Staff,13,0,30,17
1650849115364,MATH 20E,B01,083773,Staff,0,0,30,30
1650849115364,MATH 20E,B02,083774,Staff,5,0,30,25
1650849121393,MATH 103A,A01,083777,Staff,0,16,30,30
1650849121393,MATH 103A,A02,083778,Staff,0,15,30,30
1650849121393,MATH 103A,B01,083779,Staff,0,15,30,30
1650849121393,MATH 103A,B02,083780,Staff,1,15,30,29
1650849127417,MATH 105,A01,085443,Staff,0,22,30,30
1650849133450,MATH 109,A01,083213,Anzaldo; Leesa B,0,7,30,30
1650849133450,MATH 109,A02,083214,Anzaldo; Leesa B,0,7,30,30
1650849133450,MATH 109,B01,083215,Anzaldo; Leesa B,0,8,30,30
1650849133450,MATH 109,B02,083216,Anzaldo; Leesa B,0,7,30,30
1650849139480,MATH 142A,A01,083219,Chow; Bennett,0,15,30,30
1650849139480,MATH 142A,A02,083220,Chow; Bennett,0,15,30,30
1650849139480,MATH 142A,B01,083221,Chow; Bennett,0,16,30,30
1650849139480,MATH 142A,B02,083222,Chow; Bennett,0,14,30,30
1650849145503,MATH 193A,A01,083224,Staff,0,6,30,30
1650849145503,MATH 193A,A02,083225,Staff,0,7,30,30
1650849145503,MATH 193A,A03,083781,Staff,0,6,30,30
1650849145503,MATH 193A,A04,083782,Staff,0,7,30,30
1650849151527,MATH 197,001,091859,McAuley; Julian John,9998,0,9999,1
1650849157576,COGS 9,A01,083615,Staff,0,17,60,60
1650849163603,COGS 11,A01,083617,Boyle; Mary E. T.,15,0,40,25
1650849169625,COGS 13,A01,083071,Staff,0,38,40,40
1650849175650,COGS 14A,A01,092681,Staff,0,36,100,100
1650849181676,COGS 14B,A01,083073,Cheng; Tzu-Han,0,12,50,50
1650849187700,COGS 17,A01,092677,Staff,12,0,75,63
1650849193724,COGS 100,A01,083619,Staff,0,30,60,60
1650849199747,COGS 101A,A01,083621,Davis; Joshua Daniel,0,29,60,60
1650849205773,COGS 101B,A01,091572,Staff,0,3,60,60
1650849211801,COGS 101C,A01,083625,Delgado; Tania,14,0,30,16
1650849217824,COGS 107A,A01,083627,Boyle; Mary E. T.,0,16,60,60
1650849223851,COGS 118A,A01,083075,Staff,0,8,60,60
1650849229877,CSE 3,A50,083646,Miranda; Gregory Joseph,18,0,38,20
1650849229877,CSE 3,A51,083647,Miranda; Gregory Joseph,36,0,37,1
1650849235909,CSE 8A,A50,083650,Miranda; Gregory Joseph,0,29,40,40
1650849241934,CSE 11,A01,083080,Cao; Yingjun,0,96,40,40
1650849247962,CSE 12,A01,083652,Staff,0,21,100,100
1650849253990,CSE 15L,A01,083654,Staff,0,3,50,50
1650849253990,CSE 15L,A02,083655,Staff,0,3,50,50
1650849260020,CSE 20,A01,083657,Staff,49,0,80,31
1650849266045,CSE 30,A01,083084,Eldon; John,0,76,40,40
1650849272079,CSE 100,A01,083659,Cao; Yingjun,0,71,50,50
1650849278104,CSE 134B,A01,083661,Powell; Thomas Allan,0,38,65,65
1650849284131,CSE 140,A01,083663,Staff,0,11,75,75
1650849290156,CSE 140L,A01,083088,Eldon; John,0,20,75,75
1650849296184,CSE 175,A01,083665,Kumar; Rakesh,7,0,25,18
1650849302212,CSE 190,A00,092507,Dubnov; Shlomo,10,0,20,10
1650849308238,ECE 45,A01,083139,Staff,0,1,60,60
1650849314264,ECE 65,A50,083695,Staff,0,5,30,30
1650849320301,ECE 109,A01,091882,Touri; Behrouz,32,0,70,38
1650849326325,ECE 180,A00,083140,Abi Samra; Nicholas Camill,20,0,30,10
1650849326325,ECE 180,B00,083141,Abi Samra; Nicholas Camill,0,0,30,30
1650849332355,MATH 10A,A01,083735,Patchell; Gregory David,2,0,30,28
1650849332355,MATH 10A,A02,083736,Patchell; Gregory David,27,0,30,3
1650849332355,MATH 10A,A03,083737,Patchell; Gregory David,24,0,30,6
1650849338388,MATH 10B,A01,083207,Staff,0,9,30,30
1650849338388,MATH 10B,A02,083208,Staff,0,6,30,30
1650849338388,MATH 10B,B01,083739,Staff,10,0,30,20
1650849338388,MATH 10B,B02,083740,Staff,28,0,30,2
1650849344409,MATH 18,A01,083743,Staff,0,0,30,30
1650849344409,MATH 18,A02,083744,Staff,23,0,30,7
1650849344409,MATH 18,A03,083745,Staff,21,0,30,9
1650849344409,MATH 18,A04,083746,Staff,26,0,30,4
1650849344409,MATH 18,B01,083748,Staff,0,15,30,30
1650849344409,MATH 18,B02,083749,Staff,0,13,30,30
1650849344409,MATH 18,B03,083750,Staff,0,13,30,30
1650849344409,MATH 18,B04,083751,Staff,0,13,30,30
1650849350433,MATH 20A,A01,083754,Staff,19,0,40,21
1650849356456,MATH 20B,A01,083756,Staff,0,14,30,30
1650849356456,MATH 20B,A02,083757,Staff,0,12,30,30
1650849362482,MATH 20C,A01,083760,Staff,0,17,30,30
1650849362482,MATH 20C,A02,083761,Staff,0,16,30,30
1650849362482,MATH 20C,B01,083762,Staff,9,0,30,21
1650849362482,MATH 20C,B02,083763,Staff,28,0,30,2
1650849368506,MATH 20D,A01,083765,Staff,2,1,30,28
1650849368506,MATH 20D,A02,083766,Staff,6,0,30,24
1650849368506,MATH 20D,A03,083767,Staff,23,0,30,7
1650849374528,MATH 20E,A01,083771,Staff,2,0,30,28
1650849374528,MATH 20E,A02,083772,Staff,13,0,30,17
1650849374528,MATH 20E,B01,083773,Staff,0,0,30,30
1650849374528,MATH 20E,B02,083774,Staff,5,0,30,25
1650849380551,MATH 103A,A01,083777,Staff,0,16,30,30
1650849380551,MATH 103A,A02,083778,Staff,0,15,30,30
1650849380551,MATH 103A,B01,083779,Staff,0,15,30,30
1650849380551,MATH 103A,B02,083780,Staff,1,15,30,29
1650849386576,MATH 105,A01,085443,Staff,0,22,30,30
1650849392598,MATH 109,A01,083213,Anzaldo; Leesa B,0,7,30,30
1650849392598,MATH 109,A02,083214,Anzaldo; Leesa B,0,7,30,30
1650849392598,MATH 109,B01,083215,Anzaldo; Leesa B,0,8,30,30
1650849392598,MATH 109,B02,083216,Anzaldo; Leesa B,0,7,30,30
1650849398626,MATH 142A,A01,083219,Chow; Bennett,0,15,30,30
1650849398626,MATH 142A,A02,083220,Chow; Bennett,0,15,30,30
1650849398626,MATH 142A,B01,083221,Chow; Bennett,0,16,30,30
1650849398626,MATH 142A,B02,083222,Chow; Bennett,0,14,30,30
1650849404650,MATH 193A,A01,083224,Staff,0,6,30,30
1650849404650,MATH 193A,A02,083225,Staff,0,7,30,30
1650849404650,MATH 193A,A03,083781,Staff,0,6,30,30
1650849404650,MATH 193A,A04,083782,Staff,0,7,30,30
1650849410674,MATH 197,001,091859,McAuley; Julian John,9998,0,9999,1
1650849416740,COGS 9,A01,083615,Staff,0,17,60,60
1650849422848,COGS 11,A01,083617,Boyle; Mary E. T.,15,0,40,25
1650849428872,COGS 13,A01,083071,Staff,0,38,40,40
1650849434898,COGS 14A,A01,092681,Staff,0,36,100,100
1650849440921,COGS 14B,A01,083073,Cheng; Tzu-Han,0,12,50,50
1650849446945,COGS 17,A01,092677,Staff,12,0,75,63
1650849452972,COGS 100,A01,083619,Staff,0,30,60,60
1650849458996,COGS 101A,A01,083621,Davis; Joshua Daniel,0,29,60,60
1650849465030,COGS 101B,A01,091572,Staff,0,3,60,60
1650849471057,COGS 101C,A01,083625,Delgado; Tania,14,0,30,16
1650849477081,COGS 107A,A01,083627,Boyle; Mary E. T.,0,16,60,60
1650849483105,COGS 118A,A01,083075,Staff,0,8,60,60
1650849489133,CSE 3,A50,083646,Miranda; Gregory Joseph,18,0,38,20
1650849489133,CSE 3,A51,083647,Miranda; Gregory Joseph,36,0,37,1
1650849495158,CSE 8A,A50,083650,Miranda; Gregory Joseph,0,29,40,40
1650849501184,CSE 11,A01,083080,Cao; Yingjun,0,96,40,40
1650849507207,CSE 12,A01,083652,Staff,0,21,100,100
1650849513241,CSE 15L,A01,083654,Staff,0,3,50,50
1650849513241,CSE 15L,A02,083655,Staff,0,3,50,50
1650849519270,CSE 20,A01,083657,Staff,49,0,80,31
1650849525293,CSE 30,A01,083084,Eldon; John,0,76,40,40
1650849531319,CSE 100,A01,083659,Cao; Yingjun,0,71,50,50
1650849537360,CSE 134B,A01,083661,Powell; Thomas Allan,0,38,65,65
1650849543385,CSE 140,A01,083663,Staff,0,11,75,75
1650849549410,CSE 140L,A01,083088,Eldon; John,0,20,75,75
1650849555433,CSE 175,A01,083665,Kumar; Rakesh,7,0,25,18
1650849561458,CSE 190,A00,092507,Dubnov; Shlomo,10,0,20,10
1650849567487,ECE 45,A01,083139,Staff,0,1,60,60
1650849573514,ECE 65,A50,083695,Staff,0,5,30,30
1650849579539,ECE 109,A01,091882,Touri; Behrouz,32,0,70,38
1650849585563,ECE 180,A00,083140,Abi Samra; Nicholas Camill,20,0,30,10
1650849585563,ECE 180,B00,083141,Abi Samra; Nicholas Camill,0,0,30,30
1650849591589,MATH 10A,A01,083735,Patchell; Gregory David,2,0,30,28
1650849591589,MATH 10A,A02,083736,Patchell; Gregory David,27,0,30,3
1650849591589,MATH 10A,A03,083737,Patchell; Gregory David,24,0,30,6
1650849597613,MATH 10B,A01,083207,Staff,0,9,30,30
1650849597613,MATH 10B,A02,083208,Staff,0,6,30,30
1650849597613,MATH 10B,B01,083739,Staff,10,0,30,20
1650849597613,MATH 10B,B02,083740,Staff,28,0,30,2
1650849603639,MATH 18,A01,083743,Staff,0,0,30,30
1650849603639,MATH 18,A02,083744,Staff,23,0,30,7
1650849603639,MATH 18,A03,083745,Staff,21,0,30,9
1650849603639,MATH 18,A04,083746,Staff,26,0,30,4
1650849603639,MATH 18,B01,083748,Staff,0,15,30,30
1650849603639,MATH 18,B02,083749,Staff,0,13,30,30
1650849603639,MATH 18,B03,083750,Staff,0,13,30,30
1650849603639,MATH 18,B04,083751,Staff,0,13,30,30
1650849609666,MATH 20A,A01,083754,Staff,19,0,40,21
1650849615691,MATH 20B,A01,083756,Staff,0,14,30,30
1650849615691,MATH 20B,A02,083757,Staff,0,12,30,30
1650849621714,MATH 20C,A01,083760,Staff,0,17,30,30
1650849621714,MATH 20C,A02,083761,Staff,0,16,30,30
1650849621714,MATH 20C,B01,083762,Staff,9,0,30,21
1650849621714,MATH 20C,B02,083763,Staff,28,0,30,2
1650849627737,MATH 20D,A01,083765,Staff,2,1,30,28
1650849627737,MATH 20D,A02,083766,Staff,6,0,30,24
1650849627737,MATH 20D,A03,083767,Staff,23,0,30,7
1650849633768,MATH 20E,A01,083771,Staff,2,0,30,28
1650849633768,MATH 20E,A02,083772,Staff,13,0,30,17
1650849633768,MATH 20E,B01,083773,Staff,0,0,30,30
1650849633768,MATH 20E,B02,083774,Staff,5,0,30,25
1650849639792,MATH 103A,A01,083777,Staff,0,16,30,30
1650849639792,MATH 103A,A02,083778,Staff,0,15,30,30
1650849639792,MATH 103A,B01,083779,Staff,0,15,30,30
1650849639792,MATH 103A,B02,083780,Staff,1,15,30,29
1650849645814,MATH 105,A01,085443,Staff,0,22,30,30
1650849651837,MATH 109,A01,083213,Anzaldo; Leesa B,0,7,30,30
1650849651837,MATH 109,A02,083214,Anzaldo; Leesa B,0,7,30,30
1650849651837,MATH 109,B01,083215,Anzaldo; Leesa B,0,8,30,30
1650849651837,MATH 109,B02,083216,Anzaldo; Leesa B,0,7,30,30
1650849657861,MATH 142A,A01,083219,Chow; Bennett,0,15,30,30
1650849657861,MATH 142A,A02,083220,Chow; Bennett,0,15,30,30
1650849657861,MATH 142A,B01,083221,Chow; Bennett,0,16,30,30
1650849657861,MATH 142A,B02,083222,Chow; Bennett,0,14,30,30
1650849663887,MATH 193A,A01,083224,Staff,0,6,30,30
1650849663887,MATH 193A,A02,083225,Staff,0,7,30,30
1650849663887,MATH 193A,A03,083781,Staff,0,6,30,30
1650849663887,MATH 193A,A04,083782,Staff,0,7,30,30
1650849669910,MATH 197,001,091859,McAuley; Julian John,9998,0,9999,1
1650849675962,COGS 9,A01,083615,Staff,0,17,60,60
1650849681988,COGS 11,A01,083617,Boyle; Mary E. T.,15,0,40,25
1650849688012,COGS 13,A01,083071,Staff,0,38,40,40
1650849694036,COGS 14A,A01,092681,Staff,0,36,100,100
1650849700062,COGS 14B,A01,083073,Cheng; Tzu-Han,0,12,50,50
1650849706098,COGS 17,A01,092677,Staff,12,0,75,63
1650849712122,COGS 100,A01,083619,Staff,0,30,60,60
1650849718157,COGS 101A,A01,083621,Davis; Joshua Daniel,0,29,60,60
1650849724186,COGS 101B,A01,091572,Staff,0,3,60,60
1650849730212,COGS 101C,A01,083625,Delgado; Tania,14,0,30,16
1650849736234,COGS 107A,A01,083627,Boyle; Mary E. T.,0,16,60,60
1650849742266,COGS 118A,A01,083075,Staff,0,8,60,60
1650849748300,CSE 3,A50,083646,Miranda; Gregory Joseph,18,0,38,20
1650849748300,CSE 3,A51,083647,Miranda; Gregory Joseph,36,0,37,1
1650849754325,CSE 8A,A50,083650,Miranda; Gregory Joseph,0,29,40,40
1650849760358,CSE 11,A01,083080,Cao; Yingjun,0,96,40,40
1650849766381,CSE 12,A01,083652,Staff,0,21,100,100
1650849772409,CSE 15L,A01,083654,Staff,0,3,50,50
1650849772409,CSE 15L,A02,083655,Staff,0,3,50,50
1650849778433,CSE 20,A01,083657,Staff,49,0,80,31
1650849784460,CSE 30,A01,083084,Eldon; John,0,76,40,40
1650849790486,CSE 100,A01,083659,Cao; Yingjun,0,71,50,50
1650849796512,CSE 134B,A01,083661,Powell; Thomas Allan,0,38,65,65
1650849802536,CSE 140,A01,083663,Staff,0,11,75,75
1650849808563,CSE 140L,A01,083088,Eldon; John,0,20,75,75
1650849814590,CSE 175,A01,083665,Kumar; Rakesh,7,0,25,18
1650849820616,CSE 190,A00,092507,Dubnov; Shlomo,10,0,20,10
1650849826640,ECE 45,A01,083139,Staff,0,1,60,60
1650849832664,ECE 65,A50,083695,Staff,0,5,30,30
1650849838688,ECE 109,A01,091882,Touri; Behrouz,32,0,70,38
1650849844711,ECE 180,A00,083140,Abi Samra; Nicholas Camill,20,0,30,10
1650849844711,ECE 180,B00,083141,Abi Samra; Nicholas Camill,0,0,30,30
1650849850738,MATH 10A,A01,083735,Patchell; Gregory David,2,0,30,28
1650849850738,MATH 10A,A02,083736,Patchell; Gregory David,27,0,30,3
1650849850738,MATH 10A,A03,083737,Patchell; Gregory David,24,0,30,6
1650849856765,MATH 10B,A01,083207,Staff,0,9,30,30
1650849856765,MATH 10B,A02,083208,Staff,0,6,30,30
1650849856765,MATH 10B,B01,083739,Staff,10,0,30,20
1650849856765,MATH 10B,B02,083740,Staff,28,0,30,2
1650849862797,MATH 18,A01,083743,Staff,0,0,30,30
1650849862797,MATH 18,A02,083744,Staff,23,0,30,7
1650849862797,MATH 18,A03,083745,Staff,21,0,30,9
1650849862797,MATH 18,A04,083746,Staff,26,0,30,4
1650849862797,MATH 18,B01,083748,Staff,0,15,30,30
1650849862797,MATH 18,B02,083749,Staff,0,13,30,30
1650849862797,MATH 18,B03,083750,Staff,0,13,30,30
1650849862797,MATH 18,B04,083751,Staff,0,13,30,30
1650849868821,MATH 20A,A01,083754,Staff,19,0,40,21
1650849874845,MATH 20B,A01,083756,Staff,0,14,30,30
1650849874845,MATH 20B,A02,083757,Staff,0,12,30,30
1650849880869,MATH 20C,A01,083760,Staff,0,17,30,30
1650849880869,MATH 20C,A02,083761,Staff,0,16,30,30
1650849880869,MATH 20C,B01,083762,Staff,9,0,30,21
1650849880869,MATH 20C,B02,083763,Staff,28,0,30,2
1650849886895,MATH 20D,A01,083765,Staff,2,1,30,28
1650849886895,MATH 20D,A02,083766,Staff,6,0,30,24
1650849886895,MATH 20D,A03,083767,Staff,23,0,30,7
1650849892922,MATH 20E,A01,083771,Staff,2,0,30,28
1650849892922,MATH 20E,A02,083772,Staff,13,0,30,17
1650849892922,MATH 20E,B01,083773,Staff,0,0,30,30
1650849892922,MATH 20E,B02,083774,Staff,5,0,30,25
1650849898950,MATH 103A,A01,083777,Staff,0,16,30,30
1650849898950,MATH 103A,A02,083778,Staff,0,15,30,30
1650849898950,MATH 103A,B01,083779,Staff,0,15,30,30
1650849898950,MATH 103A,B02,083780,Staff,1,15,30,29
1650849904972,MATH 105,A01,085443,Staff,0,22,30,30
1650849910995,MATH 109,A01,083213,Anzaldo; Leesa B,0,7,30,30
1650849910995,MATH 109,A02,083214,Anzaldo; Leesa B,0,7,30,30
1650849910995,MATH 109,B01,083215,Anzaldo; Leesa B,0,8,30,30
1650849910995,MATH 109,B02,083216,Anzaldo; Leesa B,0,7,30,30
1650849917030,MATH 142A,A01,083219,Chow; Bennett,0,15,30,30
1650849917030,MATH 142A,A02,083220,Chow; Bennett,0,15,30,30
1650849917030,MATH 142A,B01,083221,Chow; Bennett,0,16,30,30
1650849917030,MATH 142A,B02,083222,Chow; Bennett,0,14,30,30
1650849923055,MATH 193A,A01,083224,Staff,0,6,30,30
1650849923055,MATH 193A,A02,083225,Staff,0,7,30,30
1650849923055,MATH 193A,A03,083781,Staff,0,6,30,30
1650849923055,MATH 193A,A04,083782,Staff,0,7,30,30
1650849929080,MATH 197,001,091859,McAuley; Julian John,9998,0,9999,1
1650849935162,COGS 9,A01,083615,Staff,0,17,60,60
1650849941185,COGS 11,A01,083617,Boyle; Mary E. T.,15,0,40,25
1650849947210,COGS 13,A01,083071,Staff,0,38,40,40
1650849953244,COGS 14A,A01,092681,Staff,0,36,100,100
1650849959271,COGS 14B,A01,083073,Cheng; Tzu-Han,0,12,50,50
1650849965293,COGS 17,A01,092677,Staff,12,0,75,63
1650849971316,COGS 100,A01,083619,Staff,0,30,60,60
1650849977349,COGS 101A,A01,083621,Davis; Joshua Daniel,0,29,60,60
1650849983371,COGS 101B,A01,091572,Staff,0,3,60,60
1650849989393,COGS 101C,A01,083625,Delgado; Tania,14,0,30,16
1650849995419,COGS 107A,A01,083627,Boyle; Mary E. T.,0,16,60,60
1650850001445,COGS 118A,A01,083075,Staff,0,8,60,60
1650850007467,CSE 3,A50,083646,Miranda; Gregory Joseph,18,0,38,20
1650850007467,CSE 3,A51,083647,Miranda; Gregory Joseph,36,0,37,1
1650850013490,CSE 8A,A50,083650,Miranda; Gregory Joseph,0,29,40,40
1650850019587,CSE 11,A01,083080,Cao; Yingjun,0,96,40,40
1650850025614,CSE 12,A01,083652,Staff,0,21,100,100
1650850031644,CSE 15L,A01,083654,Staff,0,3,50,50
1650850031644,CSE 15L,A02,083655,Staff,0,3,50,50
1650850037672,CSE 20,A01,083657,Staff,49,0,80,31
1650850043698,CSE 30,A01,083084,Eldon; John,0,76,40,40
1650850049724,CSE 100,A01,083659,Cao; Yingjun,0,71,50,50
1650850055746,CSE 134B,A01,083661,Powell; Thomas Allan,0,38,65,65
1650850061768,CSE 140,A01,083663,Staff,0,11,75,75
1650850067796,CSE 140L,A01,083088,Eldon; John,0,20,75,75
1650850073819,CSE 175,A01,083665,Kumar; Rakesh,7,0,25,18
1650850079850,CSE 190,A00,092507,Dubnov; Shlomo,10,0,20,10
1650850085885,ECE 45,A01,083139,Staff,0,1,60,60
1650850091908,ECE 65,A50,083695,Staff,0,5,30,30
1650850097933,ECE 109,A01,091882,Touri; Behrouz,32,0,70,38
1650850103959,ECE 180,A00,083140,Abi Samra; Nicholas Camill,20,0,30,10
1650850103959,ECE 180,B00,083141,Abi Samra; Nicholas Camill,0,0,30,30
1650850109987,MATH 10A,A01,083735,Patchell; Gregory David,2,0,30,28
1650850109987,MATH 10A,A02,083736,Patchell; Gregory David,27,0,30,3
1650850109987,MATH 10A,A03,083737,Patchell; Gregory David,24,0,30,6
1650850116015,MATH 10B,A01,083207,Staff,0,9,30,30
1650850116015,MATH 10B,A02,083208,Staff,0,6,30,30
1650850116015,MATH 10B,B01,083739,Staff,10,0,30,20
1650850116015,MATH 10B,B02,083740,Staff,28,0,30,2
1650850122047,MATH 18,A01,083743,Staff,0,0,30,30
1650850122047,MATH 18,A02,083744,Staff,23,0,30,7
1650850122047,MATH 18,A03,083745,Staff,21,0,30,9
1650850122047,MATH 18,A04,083746,Staff,26,0,30,4
1650850122047,MATH 18,B01,083748,Staff,0,15,30,30
1650850122047,MATH 18,B02,083749,Staff,0,13,30,30
1650850122047,MATH 18,B03,083750,Staff,0,13,30,30
1650850122047,MATH 18,B04,083751,Staff,0,13,30,30
1650850128077,MATH 20A,A01,083754,Staff,19,0,40,21
1650850134103,MATH 20B,A01,083756,Staff,0,14,30,30
1650850134103,MATH 20B,A02,083757,Staff,0,12,30,30
1650850140126,MATH 20C,A01,083760,Staff,0,17,30,30
1650850140126,MATH 20C,A02,083761,Staff,0,16,30,30
1650850140126,MATH 20C,B01,083762,Staff,9,0,30,21
1650850140126,MATH 20C,B02,083763,Staff,28,0,30,2
1650850146153,MATH 20D,A01,083765,Staff,2,1,30,28
1650850146153,MATH 20D,A02,083766,Staff,6,0,30,24
1650850146153,MATH 20D,A03,083767,Staff,23,0,30,7
1650850152177,MATH 20E,A01,083771,Staff,2,0,30,28
1650850152177,MATH 20E,A02,083772,Staff,13,0,30,17
1650850152177,MATH 20E,B01,083773,Staff,0,0,30,30
1650850152177,MATH 20E,B02,083774,Staff,5,0,30,25
1650850158200,MATH 103A,A01,083777,Staff,0,16,30,30
1650850158200,MATH 103A,A02,083778,Staff,0,15,30,30
1650850158200,MATH 103A,B01,083779,Staff,0,15,30,30
1650850158200,MATH 103A,B02,083780,Staff,1,15,30,29
1650850164230,MATH 105,A01,085443,Staff,0,22,30,30
1650850170253,MATH 109,A01,083213,Anzaldo; Leesa B,0,7,30,30
1650850170253,MATH 109,A02,083214,Anzaldo; Leesa B,0,7,30,30
1650850170253,MATH 109,B01,083215,Anzaldo; Leesa B,0,8,30,30
1650850170253,MATH 109,B02,083216,Anzaldo; Leesa B,0,7,30,30
1650850176281,MATH 142A,A01,083219,Chow; Bennett,0,15,30,30
1650850176281,MATH 142A,A02,083220,Chow; Bennett,0,15,30,30
1650850176281,MATH 142A,B01,083221,Chow; Bennett,0,16,30,30
1650850176281,MATH 142A,B02,083222,Chow; Bennett,0,14,30,30
1650850182303,MATH 193A,A01,083224,Staff,0,6,30,30
1650850182303,MATH 193A,A02,083225,Staff,0,7,30,30
1650850182303,MATH 193A,A03,083781,Staff,0,6,30,30
1650850182303,MATH 193A,A04,083782,Staff,0,7,30,30
1650850188328,MATH 197,001,091859,McAuley; Julian John,9998,0,9999,1
1650850194376,COGS 9,A01,083615,Staff,0,17,60,60
1650850200400,COGS 11,A01,083617,Boyle; Mary E. T.,15,0,40,25
1650850206425,COGS 13,A01,083071,Staff,0,38,40,40
1650850212450,COGS 14A,A01,092681,Staff,0,36,100,100
1650850218475,COGS 14B,A01,083073,Cheng; Tzu-Han,0,12,50,50
1650850224498,COGS 17,A01,092677,Staff,12,0,75,63
1650850230521,COGS 100,A01,083619,Staff,0,30,60,60
1650850236548,COGS 101A,A01,083621,Davis; Joshua Daniel,0,29,60,60
1650850242574,COGS 101B,A01,091572,Staff,0,3,60,60
1650850248598,COGS 101C,A01,083625,Delgado; Tania,14,0,30,16
1650850254621,COGS 107A,A01,083627,Boyle; Mary E. T.,0,16,60,60
1650850260655,COGS 118A,A01,083075,Staff,0,8,60,60
1650850266679,CSE 3,A50,083646,Miranda; Gregory Joseph,18,0,38,20
1650850266679,CSE 3,A51,083647,Miranda; Gregory Joseph,36,0,37,1
1650850272703,CSE 8A,A50,083650,Miranda; Gregory Joseph,0,29,40,40
1650850278726,CSE 11,A01,083080,Cao; Yingjun,0,96,40,40
1650850284749,CSE 12,A01,083652,Staff,0,21,100,100
1650850290773,CSE 15L,A01,083654,Staff,0,3,50,50
1650850290773,CSE 15L,A02,083655,Staff,0,3,50,50
1650850296799,CSE 20,A01,083657,Staff,49,0,80,31
1650850302822,CSE 30,A01,083084,Eldon; John,0,76,40,40
1650850308846,CSE 100,A01,083659,Cao; Yingjun,0,71,50,50
1650850314870,CSE 134B,A01,083661,Powell; Thomas Allan,0,38,65,65
1650850320896,CSE 140,A01,083663,Staff,0,11,75,75
1650850326919,CSE 140L,A01,083088,Eldon; John,0,20,75,75
1650850332943,CSE 175,A01,083665,Kumar; Rakesh,7,0,25,18
1650850338966,CSE 190,A00,092507,Dubnov; Shlomo,10,0,20,10
1650850344993,ECE 45,A01,083139,Staff,0,1,60,60
1650850351017,ECE 65,A50,083695,Staff,0,5,30,30
1650850357041,ECE 109,A01,091882,Touri; Behrouz,32,0,70,38
1650850363082,ECE 180,A00,083140,Abi Samra; Nicholas Camill,20,0,30,10
1650850363082,ECE 180,B00,083141,Abi Samra; Nicholas Camill,0,0,30,30
1650850369109,MATH 10A,A01,083735,Patchell; Gregory David,2,0,30,28
1650850369109,MATH 10A,A02,083736,Patchell; Gregory David,27,0,30,3
1650850369109,MATH 10A,A03,083737,Patchell; Gregory David,24,0,30,6
1650850375132,MATH 10B,A01,083207,Staff,0,9,30,30
1650850375132,MATH 10B,A02,083208,Staff,0,6,30,30
1650850375132,MATH 10B,B01,083739,Staff,10,0,30,20
1650850375132,MATH 10B,B02,083740,Staff,28,0,30,2
1650850381158,MATH 18,A01,083743,Staff,0,0,30,30
1650850381158,MATH 18,A02,083744,Staff,23,0,30,7
1650850381158,MATH 18,A03,083745,Staff,21,0,30,9
1650850381158,MATH 18,A04,083746,Staff,26,0,30,4
1650850381158,MATH 18,B01,083748,Staff,0,15,30,30
1650850381158,MATH 18,B02,083749,Staff,0,13,30,30
1650850381158,MATH 18,B03,083750,Staff,0,13,30,30
1650850381158,MATH 18,B04,083751,Staff,0,13,30,30
1650850387183,MATH 20A,A01,083754,Staff,19,0,40,21
1650850393214,MATH 20B,A01,083756,Staff,0,14,30,30
1650850393214,MATH 20B,A02,083757,Staff,0,12,30,30
1650850399238,MATH 20C,A01,083760,Staff,0,17,30,30
1650850399238,MATH 20C,A02,083761,Staff,0,16,30,30
1650850399238,MATH 20C,B01,083762,Staff,9,0,30,21
1650850399238,MATH 20C,B02,083763,Staff,28,0,30,2
1650850405270,MATH 20D,A01,083765,Staff,2,1,30,28
1650850405270,MATH 20D,A02,083766,Staff,6,0,30,24
1650850405270,MATH 20D,A03,083767,Staff,23,0,30,7
1650850411302,MATH 20E,A01,083771,Staff,2,0,30,28
1650850411302,MATH 20E,A02,083772,Staff,13,0,30,17
1650850411302,MATH 20E,B01,083773,Staff,0,0,30,30
1650850411302,MATH 20E,B02,083774,Staff,5,0,30,25
1650850417333,MATH 103A,A01,083777,Staff,0,16,30,30
1650850417333,MATH 103A,A02,083778,Staff,0,15,30,30
1650850417333,MATH 103A,B01,083779,Staff,0,15,30,30
1650850417333,MATH 103A,B02,083780,Staff,1,15,30,29
1650850423356,MATH 105,A01,085443,Staff,0,22,30,30
1650850429400,MATH 109,A01,083213,Anzaldo; Leesa B,0,7,30,30
1650850429400,MATH 109,A02,083214,Anzaldo; Leesa B,0,7,30,30
1650850429400,MATH 109,B01,083215,Anzaldo; Leesa B,0,8,30,30
1650850429400,MATH 109,B02,083216,Anzaldo; Leesa B,0,7,30,30
1650850435424,MATH 142A,A01,083219,Chow; Bennett,0,14,30,30
1650850435424,MATH 142A,A02,083220,Chow; Bennett,0,15,30,30
1650850435424,MATH 142A,B01,083221,Chow; Bennett,0,16,30,30
1650850435424,MATH 142A,B02,083222,Chow; Bennett,0,14,30,30
1650850441446,MATH 193A,A01,083224,Staff,0,6,30,30
1650850441446,MATH 193A,A02,083225,Staff,0,7,30,30
1650850441446,MATH 193A,A03,083781,Staff,0,6,30,30
1650850441446,MATH 193A,A04,083782,Staff,0,7,30,30
1650850447473,MATH 197,001,091859,McAuley; Julian John,9998,0,9999,1
1650850453535,COGS 9,A01,083615,Staff,0,17,60,60
1650850459563,COGS 11,A01,083617,Boyle; Mary E. T.,15,0,40,25
1650850465587,COGS 13,A01,083071,Staff,0,38,40,40
1650850471609,COGS 14A,A01,092681,Staff,0,36,100,100
1650850477632,COGS 14B,A01,083073,Cheng; Tzu-Han,0,12,50,50
1650850483653,COGS 17,A01,092677,Staff,12,0,75,63
1650850489676,COGS 100,A01,083619,Staff,0,30,60,60
1650850495702,COGS 101A,A01,083621,Davis; Joshua Daniel,0,29,60,60
1650850501727,COGS 101B,A01,091572,Staff,0,3,60,60
1650850507755,COGS 101C,A01,083625,Delgado; Tania,14,0,30,16
1650850513781,COGS 107A,A01,083627,Boyle; Mary E. T.,0,16,60,60
1650850519807,COGS 118A,A01,083075,Staff,0,8,60,60
1650850525835,CSE 3,A50,083646,Miranda; Gregory Joseph,18,0,38,20
1650850525835,CSE 3,A51,083647,Miranda; Gregory Joseph,36,0,37,1
1650850531866,CSE 8A,A50,083650,Miranda; Gregory Joseph,0,29,40,40
1650850537888,CSE 11,A01,083080,Cao; Yingjun,0,96,40,40
1650850543910,CSE 12,A01,083652,Staff,0,21,100,100
1650850549935,CSE 15L,A01,083654,Staff,0,3,50,50
1650850549935,CSE 15L,A02,083655,Staff,0,3,50,50
1650850555958,CSE 20,A01,083657,Staff,49,0,80,31
1650850561984,CSE 30,A01,083084,Eldon; John,0,76,40,40
1650850568008,CSE 100,A01,083659,Cao; Yingjun,0,71,50,50
1650850574033,CSE 134B,A01,083661,Powell; Thomas Allan,0,38,65,65
1650850580059,CSE 140,A01,083663,Staff,0,11,75,75
1650850586081,CSE 140L,A01,083088,Eldon; John,0,20,75,75
1650850592104,CSE 175,A01,083665,Kumar; Rakesh,7,0,25,18
1650850598131,CSE 190,A00,092507,Dubnov; Shlomo,10,0,20,10
1650850604165,ECE 45,A01,083139,Staff,0,1,60,60
1650850610189,ECE 65,A50,083695,Staff,0,5,30,30
1650850616290,ECE 109,A01,091882,Touri; Behrouz,32,0,70,38
1650850622313,ECE 180,A00,083140,Abi Samra; Nicholas Camill,20,0,30,10
1650850622313,ECE 180,B00,083141,Abi Samra; Nicholas Camill,0,0,30,30
1650850628339,MATH 10A,A01,083735,Patchell; Gregory David,2,0,30,28
1650850628339,MATH 10A,A02,083736,Patchell; Gregory David,27,0,30,3
1650850628339,MATH 10A,A03,083737,Patchell; Gregory David,24,0,30,6
1650850634361,MATH 10B,A01,083207,Staff,0,9,30,30
1650850634361,MATH 10B,A02,083208,Staff,0,6,30,30
1650850634361,MATH 10B,B01,083739,Staff,10,0,30,20
1650850634361,MATH 10B,B02,083740,Staff,28,0,30,2
1650850640390,MATH 18,A01,083743,Staff,0,0,30,30
1650850640390,MATH 18,A02,083744,Staff,23,0,30,7
1650850640390,MATH 18,A03,083745,Staff,21,0,30,9
1650850640390,MATH 18,A04,083746,Staff,26,0,30,4
1650850640390,MATH 18,B01,083748,Staff,0,15,30,30
1650850640390,MATH 18,B02,083749,Staff,0,13,30,30
1650850640390,MATH 18,B03,083750,Staff,0,13,30,30
1650850640390,MATH 18,B04,083751,Staff,0,13,30,30
1650850646413,MATH 20A,A01,083754,Staff,19,0,40,21
1650850652435,MATH 20B,A01,083756,Staff,0,14,30,30
1650850652435,MATH 20B,A02,083757,Staff,0,12,30,30
1650850658462,MATH 20C,A01,083760,Staff,0,17,30,30
1650850658462,MATH 20C,A02,083761,Staff,0,16,30,30
1650850658462,MATH 20C,B01,083762,Staff,9,0,30,21
1650850658462,MATH 20C,B02,083763,Staff,28,0,30,2
1650850664490,MATH 20D,A01,083765,Staff,2,1,30,28
1650850664490,MATH 20D,A02,083766,Staff,6,0,30,24
1650850664490,MATH 20D,A03,083767,Staff,23,0,30,7
1650850670515,MATH 20E,A01,083771,Staff,2,0,30,28
1650850670515,MATH 20E,A02,083772,Staff,13,0,30,17
1650850670515,MATH 20E,B01,083773,Staff,0,0,30,30
1650850670515,MATH 20E,B02,083774,Staff,5,0,30,25
1650850676542,MATH 103A,A01,083777,Staff,0,16,30,30
1650850676542,MATH 103A,A02,083778,Staff,0,15,30,30
1650850676542,MATH 103A,B01,083779,Staff,0,15,30,30
1650850676542,MATH 103A,B02,083780,Staff,1,15,30,29
1650850682568,MATH 105,A01,085443,Staff,0,22,30,30
1650850688593,MATH 109,A01,083213,Anzaldo; Leesa B,0,7,30,30
1650850688593,MATH 109,A02,083214,Anzaldo; Leesa B,0,7,30,30
1650850688593,MATH 109,B01,083215,Anzaldo; Leesa B,0,8,30,30
1650850688593,MATH 109,B02,083216,Anzaldo; Leesa B,0,7,30,30
1650850694615,MATH 142A,A01,083219,Chow; Bennett,0,14,30,30
1650850694615,MATH 142A,A02,083220,Chow; Bennett,0,15,30,30
1650850694615,MATH 142A,B01,083221,Chow; Bennett,0,16,30,30
1650850694615,MATH 142A,B02,083222,Chow; Bennett,0,14,30,30
1650850700645,MATH 193A,A01,083224,Staff,0,6,30,30
1650850700645,MATH 193A,A02,083225,Staff,0,7,30,30
1650850700645,MATH 193A,A03,083781,Staff,0,6,30,30
1650850700645,MATH 193A,A04,083782,Staff,0,7,30,30
1650850706669,MATH 197,001,091859,McAuley; Julian John,9998,0,9999,1
1650850712735,COGS 9,A01,083615,Staff,0,17,60,60
1650850718759,COGS 11,A01,083617,Boyle; Mary E. T.,15,0,40,25
1650850724782,COGS 13,A01,083071,Staff,0,38,40,40
1650850730804,COGS 14A,A01,092681,Staff,0,36,100,100
1650850736831,COGS 14B,A01,083073,Cheng; Tzu-Han,0,12,50,50
1650850742856,COGS 17,A01,092677,Staff,12,0,75,63
1650850748881,COGS 100,A01,083619,Staff,0,30,60,60
1650850754908,COGS 101A,A01,083621,Davis; Joshua Daniel,0,29,60,60
1650850760934,COGS 101B,A01,091572,Staff,0,3,60,60
1650850766958,COGS 101C,A01,083625,Delgado; Tania,14,0,30,16
1650850772992,COGS 107A,A01,083627,Boyle; Mary E. T.,0,16,60,60
1650850779015,COGS 118A,A01,083075,Staff,0,8,60,60
1650850785048,CSE 3,A50,083646,Miranda; Gregory Joseph,18,0,38,20
1650850785048,CSE 3,A51,083647,Miranda; Gregory Joseph,36,0,37,1
1650850791073,CSE 8A,A50,083650,Miranda; Gregory Joseph,0,29,40,40
1650850797097,CSE 11,A01,083080,Cao; Yingjun,0,96,40,40
1650850803120,CSE 12,A01,083652,Staff,0,21,100,100
1650850809147,CSE 15L,A01,083654,Staff,0,3,50,50
1650850809147,CSE 15L,A02,083655,Staff,0,3,50,50
1650850815172,CSE 20,A01,083657,Staff,49,0,80,31
1650850821195,CSE 30,A01,083084,Eldon; John,0,76,40,40
1650850827219,CSE 100,A01,083659,Cao; Yingjun,0,71,50,50
1650850833241,CSE 134B,A01,083661,Powell; Thomas Allan,0,38,65,65
1650850839266,CSE 140,A01,083663,Staff,0,11,75,75
1650850845293,CSE 140L,A01,083088,Eldon; John,0,20,75,75
1650850851317,CSE 175,A01,083665,Kumar; Rakesh,7,0,25,18
1650850857346,CSE 190,A00,092507,Dubnov; Shlomo,10,0,20,10
1650850863376,ECE 45,A01,083139,Staff,0,1,60,60
1650850869399,ECE 65,A50,083695,Staff,0,5,30,30
1650850875425,ECE 109,A01,091882,Touri; Behrouz,32,0,70,38
1650850881449,ECE 180,A00,083140,Abi Samra; Nicholas Camill,20,0,30,10
1650850881449,ECE 180,B00,083141,Abi Samra; Nicholas Camill,0,0,30,30
1650850887473,MATH 10A,A01,083735,Patchell; Gregory David,2,0,30,28
1650850887473,MATH 10A,A02,083736,Patchell; Gregory David,27,0,30,3
1650850887473,MATH 10A,A03,083737,Patchell; Gregory David,24,0,30,6
1650850893497,MATH 10B,A01,083207,Staff,0,9,30,30
1650850893497,MATH 10B,A02,083208,Staff,0,6,30,30
1650850893497,MATH 10B,B01,083739,Staff,10,0,30,20
1650850893497,MATH 10B,B02,083740,Staff,28,0,30,2
1650850899528,MATH 18,A01,083743,Staff,0,0,30,30
1650850899528,MATH 18,A02,083744,Staff,23,0,30,7
1650850899528,MATH 18,A03,083745,Staff,21,0,30,9
1650850899528,MATH 18,A04,083746,Staff,26,0,30,4
1650850899528,MATH 18,B01,083748,Staff,0,15,30,30
1650850899528,MATH 18,B02,083749,Staff,0,13,30,30
1650850899528,MATH 18,B03,083750,Staff,0,13,30,30
1650850899528,MATH 18,B04,083751,Staff,0,13,30,30
1650850905553,MATH 20A,A01,083754,Staff,19,0,40,21
1650850911579,MATH 20B,A01,083756,Staff,0,14,30,30
1650850911579,MATH 20B,A02,083757,Staff,0,12,30,30
1650850917604,MATH 20C,A01,083760,Staff,0,17,30,30
1650850917604,MATH 20C,A02,083761,Staff,0,16,30,30
1650850917604,MATH 20C,B01,083762,Staff,9,0,30,21
1650850917604,MATH 20C,B02,083763,Staff,28,0,30,2
1650850923628,MATH 20D,A01,083765,Staff,2,1,30,28
1650850923628,MATH 20D,A02,083766,Staff,6,0,30,24
1650850923628,MATH 20D,A03,083767,Staff,23,0,30,7
1650850929655,MATH 20E,A01,083771,Staff,2,0,30,28
1650850929655,MATH 20E,A02,083772,Staff,13,0,30,17
1650850929655,MATH 20E,B01,083773,Staff,0,0,30,30
1650850929655,MATH 20E,B02,083774,Staff,5,0,30,25
1650850935682,MATH 103A,A01,083777,Staff,0,16,30,30
1650850935682,MATH 103A,A02,083778,Staff,0,15,30,30
1650850935682,MATH 103A,B01,083779,Staff,0,15,30,30
1650850935682,MATH 103A,B02,083780,Staff,1,15,30,29
1650850941707,MATH 105,A01,085443,Staff,0,22,30,30
1650850947734,MATH 109,A01,083213,Anzaldo; Leesa B,0,7,30,30
1650850947734,MATH 109,A02,083214,Anzaldo; Leesa B,0,7,30,30
1650850947734,MATH 109,B01,083215,Anzaldo; Leesa B,0,8,30,30
1650850947734,MATH 109,B02,083216,Anzaldo; Leesa B,0,7,30,30
1650850953763,MATH 142A,A01,083219,Chow; Bennett,0,14,30,30
1650850953763,MATH 142A,A02,083220,Chow; Bennett,0,15,30,30
1650850953763,MATH 142A,B01,083221,Chow; Bennett,0,16,30,30
1650850953763,MATH 142A,B02,083222,Chow; Bennett,0,14,30,30
1650850959791,MATH 193A,A01,083224,Staff,0,6,30,30
1650850959791,MATH 193A,A02,083225,Staff,0,7,30,30
1650850959791,MATH 193A,A03,083781,Staff,0,6,30,30
1650850959791,MATH 193A,A04,083782,Staff,0,7,30,30
1650850965823,MATH 197,001,091859,McAuley; Julian John,9998,0,9999,1
1650850971871,COGS 9,A01,083615,Staff,0,17,60,60
1650850977894,COGS 11,A01,083617,Boyle; Mary E. T.,15,0,40,25
1650850983916,COGS 13,A01,083071,Staff,0,38,40,40
1650850989940,COGS 14A,A01,092681,Staff,0,36,100,100
1650850995963,COGS 14B,A01,083073,Cheng; Tzu-Han,0,12,50,50
1650851001989,COGS 17,A01,092677,Staff,12,0,75,63
1650851008012,COGS 100,A01,083619,Staff,0,30,60,60
1650851014039,COGS 101A,A01,083621,Davis; Joshua Daniel,0,29,60,60
1650851020063,COGS 101B,A01,091572,Staff,0,3,60,60
1650851026092,COGS 101C,A01,083625,Delgado; Tania,14,0,30,16
1650851032121,COGS 107A,A01,083627,Boyle; Mary E. T.,0,16,60,60
1650851038146,COGS 118A,A01,083075,Staff,0,8,60,60
1650851044171,CSE 3,A50,083646,Miranda; Gregory Joseph,18,0,38,20
1650851044171,CSE 3,A51,083647,Miranda; Gregory Joseph,36,0,37,1
1650851050197,CSE 8A,A50,083650,Miranda; Gregory Joseph,0,29,40,40
1650851056231,CSE 11,A01,083080,Cao; Yingjun,0,96,40,40
1650851062259,CSE 12,A01,083652,Staff,0,21,100,100
1650851068280,CSE 15L,A01,083654,Staff,0,3,50,50
1650851068280,CSE 15L,A02,083655,Staff,0,3,50,50
1650851074311,CSE 20,A01,083657,Staff,49,0,80,31
1650851080334,CSE 30,A01,083084,Eldon; John,0,76,40,40
1650851086364,CSE 100,A01,083659,Cao; Yingjun,0,71,50,50
1650851092391,CSE 134B,A01,083661,Powell; Thomas Allan,0,38,65,65
1650851098420,CSE 140,A01,083663,Staff,0,12,75,75
1650851104444,CSE 140L,A01,083088,Eldon; John,0,20,75,75
1650851110468,CSE 175,A01,083665,Kumar; Rakesh,7,0,25,18
1650851116492,CSE 190,A00,092507,Dubnov; Shlomo,10,0,20,10
1650851122516,ECE 45,A01,083139,Staff,0,1,60,60
1650851128539,ECE 65,A50,083695,Staff,0,5,30,30
1650851134563,ECE 109,A01,091882,Touri; Behrouz,32,0,70,38
1650851140587,ECE 180,A00,083140,Abi Samra; Nicholas Camill,20,0,30,10
1650851140587,ECE 180,B00,083141,Abi Samra; Nicholas Camill,0,0,30,30
1650851146612,MATH 10A,A01,083735,Patchell; Gregory David,2,0,30,28
1650851146612,MATH 10A,A02,083736,Patchell; Gregory David,27,0,30,3
1650851146612,MATH 10A,A03,083737,Patchell; Gregory David,24,0,30,6
1650851152636,MATH 10B,A01,083207,Staff,0,9,30,30
1650851152636,MATH 10B,A02,083208,Staff,0,6,30,30
1650851152636,MATH 10B,B01,083739,Staff,10,0,30,20
1650851152636,MATH 10B,B02,083740,Staff,28,0,30,2
1650851158666,MATH 18,A01,083743,Staff,0,0,30,30
1650851158666,MATH 18,A02,083744,Staff,23,0,30,7
1650851158666,MATH 18,A03,083745,Staff,21,0,30,9
1650851158666,MATH 18,A04,083746,Staff,26,0,30,4
1650851158666,MATH 18,B01,083748,Staff,0,15,30,30
1650851158666,MATH 18,B02,083749,Staff,0,13,30,30
1650851158666,MATH 18,B03,083750,Staff,0,13,30,30
1650851158666,MATH 18,B04,083751,Staff,0,13,30,30
1650851164689,MATH 20A,A01,083754,Staff,19,0,40,21
1650851170717,MATH 20B,A01,083756,Staff,0,14,30,30
1650851170717,MATH 20B,A02,083757,Staff,0,12,30,30
1650851176742,MATH 20C,A01,083760,Staff,0,17,30,30
1650851176742,MATH 20C,A02,083761,Staff,0,16,30,30
1650851176742,MATH 20C,B01,083762,Staff,9,0,30,21
1650851176742,MATH 20C,B02,083763,Staff,28,0,30,2
1650851182768,MATH 20D,A01,083765,Staff,2,1,30,28
1650851182768,MATH 20D,A02,083766,Staff,6,0,30,24
1650851182768,MATH 20D,A03,083767,Staff,23,0,30,7
1650851188794,MATH 20E,A01,083771,Staff,2,0,30,28
1650851188794,MATH 20E,A02,083772,Staff,13,0,30,17
1650851188794,MATH 20E,B01,083773,Staff,0,0,30,30
1650851188794,MATH 20E,B02,083774,Staff,5,0,30,25
1650851194818,MATH 103A,A01,083777,Staff,0,16,30,30
1650851194818,MATH 103A,A02,083778,Staff,0,15,30,30
1650851194818,MATH 103A,B01,083779,Staff,0,15,30,30
1650851194818,MATH 103A,B02,083780,Staff,1,15,30,29
1650851200841,MATH 105,A01,085443,Staff,0,22,30,30
1650851206865,MATH 109,A01,083213,Anzaldo; Leesa B,0,7,30,30
1650851206865,MATH 109,A02,083214,Anzaldo; Leesa B,0,7,30,30
1650851206865,MATH 109,B01,083215,Anzaldo; Leesa B,0,8,30,30
1650851206865,MATH 109,B02,083216,Anzaldo; Leesa B,0,7,30,30
1650851212984,MATH 142A,A01,083219,Chow; Bennett,0,14,30,30
1650851212984,MATH 142A,A02,083220,Chow; Bennett,0,15,30,30
1650851212984,MATH 142A,B01,083221,Chow; Bennett,0,16,30,30
1650851212984,MATH 142A,B02,083222,Chow; Bennett,0,14,30,30
1650851219008,MATH 193A,A01,083224,Staff,0,6,30,30
1650851219008,MATH 193A,A02,083225,Staff,0,7,30,30
1650851219008,MATH 193A,A03,083781,Staff,0,6,30,30
1650851219008,MATH 193A,A04,083782,Staff,0,7,30,30
1650851225034,MATH 197,001,091859,McAuley; Julian John,9998,0,9999,1
1650851231110,COGS 9,A01,083615,Staff,0,17,60,60
1650851237134,COGS 11,A01,083617,Boyle; Mary E. T.,15,0,40,25
1650851243166,COGS 13,A01,083071,Staff,0,38,40,40
1650851249191,COGS 14A,A01,092681,Staff,0,36,100,100
1650851255216,COGS 14B,A01,083073,Cheng; Tzu-Han,0,12,50,50
1650851261241,COGS 17,A01,092677,Staff,12,0,75,63
1650851267268,COGS 100,A01,083619,Staff,0,30,60,60
1650851273292,COGS 101A,A01,083621,Davis; Joshua Daniel,0,29,60,60
1650851279317,COGS 101B,A01,091572,Staff,0,3,60,60
1650851285349,COGS 101C,A01,083625,Delgado; Tania,14,0,30,16
1650851291376,COGS 107A,A01,083627,Boyle; Mary E. T.,0,16,60,60
1650851297398,COGS 118A,A01,083075,Staff,0,8,60,60
1650851303433,CSE 3,A50,083646,Miranda; Gregory Joseph,18,0,38,20
1650851303433,CSE 3,A51,083647,Miranda; Gregory Joseph,36,0,37,1
1650851309455,CSE 8A,A50,083650,Miranda; Gregory Joseph,0,29,40,40
1650851315478,CSE 11,A01,083080,Cao; Yingjun,0,96,40,40
1650851321500,CSE 12,A01,083652,Staff,0,21,100,100
1650851327528,CSE 15L,A01,083654,Staff,0,3,50,50
1650851327528,CSE 15L,A02,083655,Staff,0,3,50,50
1650851333553,CSE 20,A01,083657,Staff,49,0,80,31
1650851339575,CSE 30,A01,083084,Eldon; John,0,76,40,40
1650851345599,CSE 100,A01,083659,Cao; Yingjun,0,71,50,50
1650851351620,CSE 134B,A01,083661,Powell; Thomas Allan,0,38,65,65
1650851357644,CSE 140,A01,083663,Staff,0,12,75,75
1650851363671,CSE 140L,A01,083088,Eldon; John,0,20,75,75
1650851369694,CSE 175,A01,083665,Kumar; Rakesh,7,0,25,18
1650851375723,CSE 190,A00,092507,Dubnov; Shlomo,10,0,20,10
1650851381747,ECE 45,A01,083139,Staff,0,2,60,60
1650851387775,ECE 65,A50,083695,Staff,0,5,30,30
1650851393802,ECE 109,A01,091882,Touri; Behrouz,32,0,70,38
1650851399827,ECE 180,A00,083140,Abi Samra; Nicholas Camill,20,0,30,10
1650851399827,ECE 180,B00,083141,Abi Samra; Nicholas Camill,0,0,30,30
1650851405851,MATH 10A,A01,083735,Patchell; Gregory David,2,0,30,28
1650851405851,MATH 10A,A02,083736,Patchell; Gregory David,27,0,30,3
1650851405851,MATH 10A,A03,083737,Patchell; Gregory David,24,0,30,6
1650851411880,MATH 10B,A01,083207,Staff,0,9,30,30
1650851411880,MATH 10B,A02,083208,Staff,0,6,30,30
1650851411880,MATH 10B,B01,083739,Staff,10,0,30,20
1650851411880,MATH 10B,B02,083740,Staff,28,0,30,2
1650851417906,MATH 18,A01,083743,Staff,0,0,30,30
1650851417906,MATH 18,A02,083744,Staff,23,0,30,7
1650851417906,MATH 18,A03,083745,Staff,21,0,30,9
1650851417906,MATH 18,A04,083746,Staff,26,0,30,4
1650851417906,MATH 18,B01,083748,Staff,0,15,30,30
1650851417906,MATH 18,B02,083749,Staff,0,13,30,30
1650851417906,MATH 18,B03,083750,Staff,0,13,30,30
1650851417906,MATH 18,B04,083751,Staff,0,13,30,30
1650851423930,MATH 20A,A01,083754,Staff,19,0,40,21
1650851429954,MATH 20B,A01,083756,Staff,0,14,30,30
1650851429954,MATH 20B,A02,083757,Staff,0,12,30,30
1650851435982,MATH 20C,A01,083760,Staff,0,17,30,30
1650851435982,MATH 20C,A02,083761,Staff,0,16,30,30
1650851435982,MATH 20C,B01,083762,Staff,9,0,30,21
1650851435982,MATH 20C,B02,083763,Staff,28,0,30,2
1650851442011,MATH 20D,A01,083765,Staff,2,1,30,28
1650851442011,MATH 20D,A02,083766,Staff,6,0,30,24
1650851442011,MATH 20D,A03,083767,Staff,23,0,30,7
1650851448036,MATH 20E,A01,083771,Staff,2,0,30,28
1650851448036,MATH 20E,A02,083772,Staff,13,0,30,17
1650851448036,MATH 20E,B01,083773,Staff,0,0,30,30
1650851448036,MATH 20E,B02,083774,Staff,5,0,30,25
1650851454065,MATH 103A,A01,083777,Staff,0,16,30,30
1650851454065,MATH 103A,A02,083778,Staff,0,15,30,30
1650851454065,MATH 103A,B01,083779,Staff,0,15,30,30
1650851454065,MATH 103A,B02,083780,Staff,1,15,30,29
1650851460090,MATH 105,A01,085443,Staff,0,22,30,30
1650851466124,MATH 109,A01,083213,Anzaldo; Leesa B,0,7,30,30
1650851466124,MATH 109,A02,083214,Anzaldo; Leesa B,0,7,30,30
1650851466124,MATH 109,B01,083215,Anzaldo; Leesa B,0,8,30,30
1650851466124,MATH 109,B02,083216,Anzaldo; Leesa B,0,7,30,30
1650851472147,MATH 142A,A01,083219,Chow; Bennett,0,14,30,30
1650851472147,MATH 142A,A02,083220,Chow; Bennett,0,15,30,30
1650851472147,MATH 142A,B01,083221,Chow; Bennett,0,16,30,30
1650851472147,MATH 142A,B02,083222,Chow; Bennett,0,14,30,30
1650851478172,MATH 193A,A01,083224,Staff,0,6,30,30
1650851478172,MATH 193A,A02,083225,Staff,0,7,30,30
1650851478172,MATH 193A,A03,083781,Staff,0,6,30,30
1650851478172,MATH 193A,A04,083782,Staff,0,7,30,30
1650851484200,MATH 197,001,091859,McAuley; Julian John,9998,0,9999,1
1650851490259,COGS 9,A01,083615,Staff,0,17,60,60
1650851496286,COGS 11,A01,083617,Boyle; Mary E. T.,15,0,40,25
1650851502310,COGS 13,A01,083071,Staff,0,38,40,40
1650851508333,COGS 14A,A01,092681,Staff,0,36,100,100
1650851514358,COGS 14B,A01,083073,Cheng; Tzu-Han,0,12,50,50
1650851520382,COGS 17,A01,092677,Staff,12,0,75,63
1650851526408,COGS 100,A01,083619,Staff,0,30,60,60
1650851532436,COGS 101A,A01,083621,Davis; Joshua Daniel,0,29,60,60
1650851538461,COGS 101B,A01,091572,Staff,0,3,60,60
1650851544488,COGS 101C,A01,083625,Delgado; Tania,14,0,30,16
1650851550514,COGS 107A,A01,083627,Boyle; Mary E. T.,0,16,60,60
1650851556536,COGS 118A,A01,083075,Staff,0,8,60,60
1650851562559,CSE 3,A50,083646,Miranda; Gregory Joseph,18,0,38,20
1650851562559,CSE 3,A51,083647,Miranda; Gregory Joseph,36,0,37,1
1650851568586,CSE 8A,A50,083650,Miranda; Gregory Joseph,0,29,40,40
1650851574616,CSE 11,A01,083080,Cao; Yingjun,0,96,40,40
1650851580639,CSE 12,A01,083652,Staff,0,21,100,100
1650851586668,CSE 15L,A01,083654,Staff,0,3,50,50
1650851586668,CSE 15L,A02,083655,Staff,0,3,50,50
1650851592694,CSE 20,A01,083657,Staff,49,0,80,31
1650851598718,CSE 30,A01,083084,Eldon; John,0,76,40,40
1650851604742,CSE 100,A01,083659,Cao; Yingjun,0,71,50,50
1650851610769,CSE 134B,A01,083661,Powell; Thomas Allan,0,38,65,65
1650851616791,CSE 140,A01,083663,Staff,0,12,75,75
1650851622815,CSE 140L,A01,083088,Eldon; John,0,20,75,75
1650851628839,CSE 175,A01,083665,Kumar; Rakesh,7,0,25,18
1650851634862,CSE 190,A00,092507,Dubnov; Shlomo,10,0,20,10
1650851640890,ECE 45,A01,083139,Staff,0,3,60,60
1650851646914,ECE 65,A50,083695,Staff,0,5,30,30
1650851652942,ECE 109,A01,091882,Touri; Behrouz,32,0,70,38
1650851658969,ECE 180,A00,083140,Abi Samra; Nicholas Camill,20,0,30,10
1650851658969,ECE 180,B00,083141,Abi Samra; Nicholas Camill,0,0,30,30
1650851664993,MATH 10A,A01,083735,Patchell; Gregory David,2,0,30,28
1650851664993,MATH 10A,A02,083736,Patchell; Gregory David,27,0,30,3
1650851664993,MATH 10A,A03,083737,Patchell; Gregory David,24,0,30,6
1650851671016,MATH 10B,A01,083207,Staff,0,9,30,30
1650851671016,MATH 10B,A02,083208,Staff,0,6,30,30
1650851671016,MATH 10B,B01,083739,Staff,10,0,30,20
1650851671016,MATH 10B,B02,083740,Staff,28,0,30,2
1650851677041,MATH 18,A01,083743,Staff,0,0,30,30
1650851677041,MATH 18,A02,083744,Staff,23,0,30,7
1650851677041,MATH 18,A03,083745,Staff,21,0,30,9
1650851677041,MATH 18,A04,083746,Staff,26,0,30,4
1650851677041,MATH 18,B01,083748,Staff,0,15,30,30
1650851677041,MATH 18,B02,083749,Staff,0,13,30,30
1650851677041,MATH 18,B03,083750,Staff,0,13,30,30
1650851677041,MATH 18,B04,083751,Staff,0,13,30,30
1650851683064,MATH 20A,A01,083754,Staff,19,0,40,21
1650851689091,MATH 20B,A01,083756,Staff,0,14,30,30
1650851689091,MATH 20B,A02,083757,Staff,0,12,30,30
1650851695118,MATH 20C,A01,083760,Staff,0,17,30,30
1650851695118,MATH 20C,A02,083761,Staff,0,16,30,30
1650851695118,MATH 20C,B01,083762,Staff,9,0,30,21
1650851695118,MATH 20C,B02,083763,Staff,28,0,30,2
1650851701145,MATH 20D,A01,083765,Staff,2,1,30,28
1650851701145,MATH 20D,A02,083766,Staff,6,0,30,24
1650851701145,MATH 20D,A03,083767,Staff,23,0,30,7
1650851707168,MATH 20E,A01,083771,Staff,2,0,30,28
1650851707168,MATH 20E,A02,083772,Staff,13,0,30,17
1650851707168,MATH 20E,B01,083773,Staff,0,0,30,30
1650851707168,MATH 20E,B02,083774,Staff,5,0,30,25
1650851713191,MATH 103A,A01,083777,Staff,0,16,30,30
1650851713191,MATH 103A,A02,083778,Staff,0,15,30,30
1650851713191,MATH 103A,B01,083779,Staff,0,15,30,30
1650851713191,MATH 103A,B02,083780,Staff,1,15,30,29
1650851719215,MATH 105,A01,085443,Staff,0,22,30,30
1650851725240,MATH 109,A01,083213,Anzaldo; Leesa B,0,7,30,30
1650851725240,MATH 109,A02,083214,Anzaldo; Leesa B,0,7,30,30
1650851725240,MATH 109,B01,083215,Anzaldo; Leesa B,0,8,30,30
1650851725240,MATH 109,B02,083216,Anzaldo; Leesa B,0,7,30,30
1650851731265,MATH 142A,A01,083219,Chow; Bennett,0,14,30,30
1650851731265,MATH 142A,A02,083220,Chow; Bennett,0,15,30,30
1650851731265,MATH 142A,B01,083221,Chow; Bennett,0,16,30,30
1650851731265,MATH 142A,B02,083222,Chow; Bennett,0,14,30,30
1650851737297,MATH 193A,A01,083224,Staff,0,6,30,30
1650851737297,MATH 193A,A02,083225,Staff,0,7,30,30
1650851737297,MATH 193A,A03,083781,Staff,0,6,30,30
1650851737297,MATH 193A,A04,083782,Staff,0,7,30,30
1650851743320,MATH 197,001,091859,McAuley; Julian John,9998,0,9999,1
1650851749378,COGS 9,A01,083615,Staff,0,17,60,60
1650851755412,COGS 11,A01,083617,Boyle; Mary E. T.,15,0,40,25
1650851761442,COGS 13,A01,083071,Staff,0,38,40,40
1650851767466,COGS 14A,A01,092681,Staff,0,36,100,100
1650851773491,COGS 14B,A01,083073,Cheng; Tzu-Han,0,12,50,50
1650851779514,COGS 17,A01,092677,Staff,12,0,75,63
1650851785540,COGS 100,A01,083619,Staff,0,30,60,60
1650851791564,COGS 101A,A01,083621,Davis; Joshua Daniel,0,29,60,60
1650851797587,COGS 101B,A01,091572,Staff,0,3,60,60
1650851803703,COGS 101C,A01,083625,Delgado; Tania,14,0,30,16
1650851809731,COGS 107A,A01,083627,Boyle; Mary E. T.,0,16,60,60
1650851815754,COGS 118A,A01,083075,Staff,0,8,60,60
1650851821778,CSE 3,A50,083646,Miranda; Gregory Joseph,18,0,38,20
1650851821778,CSE 3,A51,083647,Miranda; Gregory Joseph,36,0,37,1
1650851827803,CSE 8A,A50,083650,Miranda; Gregory Joseph,0,29,40,40
1650851833830,CSE 11,A01,083080,Cao; Yingjun,0,96,40,40
1650851839856,CSE 12,A01,083652,Staff,0,21,100,100
1650851845883,CSE 15L,A01,083654,Staff,0,3,50,50
1650851845883,CSE 15L,A02,083655,Staff,0,3,50,50
1650851851906,CSE 20,A01,083657,Staff,49,0,80,31
1650851857930,CSE 30,A01,083084,Eldon; John,0,76,40,40
1650851863957,CSE 100,A01,083659,Cao; Yingjun,0,71,50,50
1650851869980,CSE 134B,A01,083661,Powell; Thomas Allan,0,38,65,65
1650851876003,CSE 140,A01,083663,Staff,0,12,75,75
1650851882027,CSE 140L,A01,083088,Eldon; John,0,20,75,75
1650851888055,CSE 175,A01,083665,Kumar; Rakesh,7,0,25,18
1650851894081,CSE 190,A00,092507,Dubnov; Shlomo,10,0,20,10
1650851900113,ECE 45,A01,083139,Staff,0,3,60,60
1650851906135,ECE 65,A50,083695,Staff,0,5,30,30
1650851912158,ECE 109,A01,091882,Touri; Behrouz,32,0,70,38
1650851918180,ECE 180,A00,083140,Abi Samra; Nicholas Camill,20,0,30,10
1650851918180,ECE 180,B00,083141,Abi Samra; Nicholas Camill,0,0,30,30
1650851924207,MATH 10A,A01,083735,Patchell; Gregory David,2,0,30,28
1650851924207,MATH 10A,A02,083736,Patchell; Gregory David,27,0,30,3
1650851924207,MATH 10A,A03,083737,Patchell; Gregory David,24,0,30,6
1650851930231,MATH 10B,A01,083207,Staff,0,9,30,30
1650851930231,MATH 10B,A02,083208,Staff,0,6,30,30
1650851930231,MATH 10B,B01,083739,Staff,10,0,30,20
1650851930231,MATH 10B,B02,083740,Staff,28,0,30,2
1650851936259,MATH 18,A01,083743,Staff,0,0,30,30
1650851936259,MATH 18,A02,083744,Staff,23,0,30,7
1650851936259,MATH 18,A03,083745,Staff,21,0,30,9
1650851936259,MATH 18,A04,083746,Staff,26,0,30,4
1650851936259,MATH 18,B01,083748,Staff,0,15,30,30
1650851936259,MATH 18,B02,083749,Staff,0,13,30,30
1650851936259,MATH 18,B03,083750,Staff,0,13,30,30
1650851936259,MATH 18,B04,083751,Staff,0,13,30,30
1650851942283,MATH 20A,A01,083754,Staff,19,0,40,21
1650851948307,MATH 20B,A01,083756,Staff,0,14,30,30
1650851948307,MATH 20B,A02,083757,Staff,0,12,30,30
1650851954338,MATH 20C,A01,083760,Staff,0,17,30,30
1650851954338,MATH 20C,A02,083761,Staff,0,16,30,30
1650851954338,MATH 20C,B01,083762,Staff,9,0,30,21
1650851954338,MATH 20C,B02,083763,Staff,28,0,30,2
1650851960359,MATH 20D,A01,083765,Staff,2,1,30,28
1650851960359,MATH 20D,A02,083766,Staff,6,0,30,24
1650851960359,MATH 20D,A03,083767,Staff,23,0,30,7
1650851966387,MATH 20E,A01,083771,Staff,2,0,30,28
1650851966387,MATH 20E,A02,083772,Staff,13,0,30,17
1650851966387,MATH 20E,B01,083773,Staff,0,0,30,30
1650851966387,MATH 20E,B02,083774,Staff,5,0,30,25
1650851972421,MATH 103A,A01,083777,Staff,0,16,30,30
1650851972421,MATH 103A,A02,083778,Staff,0,15,30,30
1650851972421,MATH 103A,B01,083779,Staff,0,15,30,30
1650851972421,MATH 103A,B02,083780,Staff,1,15,30,29
1650851978458,MATH 105,A01,085443,Staff,0,22,30,30
1650851984482,MATH 109,A01,083213,Anzaldo; Leesa B,0,7,30,30
1650851984482,MATH 109,A02,083214,Anzaldo; Leesa B,0,7,30,30
1650851984482,MATH 109,B01,083215,Anzaldo; Leesa B,0,8,30,30
1650851984482,MATH 109,B02,083216,Anzaldo; Leesa B,0,7,30,30
1650851990508,MATH 142A,A01,083219,Chow; Bennett,0,14,30,30
1650851990508,MATH 142A,A02,083220,Chow; Bennett,0,15,30,30
1650851990508,MATH 142A,B01,083221,Chow; Bennett,0,16,30,30
1650851990508,MATH 142A,B02,083222,Chow; Bennett,0,14,30,30
1650851996534,MATH 193A,A01,083224,Staff,0,6,30,30
1650851996534,MATH 193A,A02,083225,Staff,0,7,30,30
1650851996534,MATH 193A,A03,083781,Staff,0,6,30,30
1650851996534,MATH 193A,A04,083782,Staff,0,7,30,30
1650852002556,MATH 197,001,091859,McAuley; Julian John,9998,0,9999,1
1650852008612,COGS 9,A01,083615,Staff,0,17,60,60
1650852014637,COGS 11,A01,083617,Boyle; Mary E. T.,15,0,40,25
1650852020660,COGS 13,A01,083071,Staff,0,38,40,40
1650852026686,COGS 14A,A01,092681,Staff,0,36,100,100
1650852032710,COGS 14B,A01,083073,Cheng; Tzu-Han,0,12,50,50
1650852038736,COGS 17,A01,092677,Staff,12,0,75,63
1650852044763,COGS 100,A01,083619,Staff,0,30,60,60
1650852050795,COGS 101A,A01,083621,Davis; Joshua Daniel,0,29,60,60
1650852056819,COGS 101B,A01,091572,Staff,0,3,60,60
1650852062849,COGS 101C,A01,083625,Delgado; Tania,14,0,30,16
1650852068872,COGS 107A,A01,083627,Boyle; Mary E. T.,0,16,60,60
1650852074894,COGS 118A,A01,083075,Staff,0,8,60,60
1650852080918,CSE 3,A50,083646,Miranda; Gregory Joseph,18,0,38,20
1650852080918,CSE 3,A51,083647,Miranda; Gregory Joseph,36,0,37,1
1650852086942,CSE 8A,A50,083650,Miranda; Gregory Joseph,0,29,40,40
1650852092970,CSE 11,A01,083080,Cao; Yingjun,0,96,40,40
1650852098993,CSE 12,A01,083652,Staff,0,21,100,100
1650852105017,CSE 15L,A01,083654,Staff,0,3,50,50
1650852105017,CSE 15L,A02,083655,Staff,0,3,50,50
1650852111041,CSE 20,A01,083657,Staff,49,0,80,31
1650852117069,CSE 30,A01,083084,Eldon; John,0,76,40,40
1650852123095,CSE 100,A01,083659,Cao; Yingjun,0,71,50,50
1650852129119,CSE 134B,A01,083661,Powell; Thomas Allan,0,38,65,65
1650852135144,CSE 140,A01,083663,Staff,0,12,75,75
1650852141168,CSE 140L,A01,083088,Eldon; John,0,20,75,75
1650852147190,CSE 175,A01,083665,Kumar; Rakesh,7,0,25,18
1650852153216,CSE 190,A00,092507,Dubnov; Shlomo,10,0,20,10
1650852159239,ECE 45,A01,083139,Staff,0,3,60,60
1650852165271,ECE 65,A50,083695,Staff,0,5,30,30
1650852171294,ECE 109,A01,091882,Touri; Behrouz,32,0,70,38
1650852177319,ECE 180,A00,083140,Abi Samra; Nicholas Camill,20,0,30,10
1650852177319,ECE 180,B00,083141,Abi Samra; Nicholas Camill,0,0,30,30
1650852183343,MATH 10A,A01,083735,Patchell; Gregory David,2,0,30,28
1650852183343,MATH 10A,A02,083736,Patchell; Gregory David,27,0,30,3
1650852183343,MATH 10A,A03,083737,Patchell; Gregory David,24,0,30,6
1650852189370,MATH 10B,A01,083207,Staff,0,9,30,30
1650852189370,MATH 10B,A02,083208,Staff,0,6,30,30
1650852189370,MATH 10B,B01,083739,Staff,10,0,30,20
1650852189370,MATH 10B,B02,083740,Staff,28,0,30,2
1650852195399,MATH 18,A01,083743,Staff,0,0,30,30
1650852195399,MATH 18,A02,083744,Staff,23,0,30,7
1650852195399,MATH 18,A03,083745,Staff,21,0,30,9
1650852195399,MATH 18,A04,083746,Staff,26,0,30,4
1650852195399,MATH 18,B01,083748,Staff,0,15,30,30
1650852195399,MATH 18,B02,083749,Staff,0,13,30,30
1650852195399,MATH 18,B03,083750,Staff,0,13,30,30
1650852195399,MATH 18,B04,083751,Staff,0,13,30,30
1650852201421,MATH 20A,A01,083754,Staff,19,0,40,21
1650852207448,MATH 20B,A01,083756,Staff,0,14,30,30
1650852207448,MATH 20B,A02,083757,Staff,0,12,30,30
1650852213473,MATH 20C,A01,083760,Staff,0,17,30,30
1650852213473,MATH 20C,A02,083761,Staff,0,16,30,30
1650852213473,MATH 20C,B01,083762,Staff,9,0,30,21
1650852213473,MATH 20C,B02,083763,Staff,28,0,30,2
1650852219495,MATH 20D,A01,083765,Staff,2,1,30,28
1650852219495,MATH 20D,A02,083766,Staff,6,0,30,24
1650852219495,MATH 20D,A03,083767,Staff,23,0,30,7
1650852225525,MATH 20E,A01,083771,Staff,2,0,30,28
1650852225525,MATH 20E,A02,083772,Staff,13,0,30,17
1650852225525,MATH 20E,B01,083773,Staff,0,0,30,30
1650852225525,MATH 20E,B02,083774,Staff,5,0,30,25
1650852231548,MATH 103A,A01,083777,Staff,0,16,30,30
1650852231548,MATH 103A,A02,083778,Staff,0,15,30,30
1650852231548,MATH 103A,B01,083779,Staff,0,15,30,30
1650852231548,MATH 103A,B02,083780,Staff,1,15,30,29
1650852237576,MATH 105,A01,085443,Staff,0,22,30,30
1650852243605,MATH 109,A01,083213,Anzaldo; Leesa B,0,7,30,30
1650852243605,MATH 109,A02,083214,Anzaldo; Leesa B,0,7,30,30
1650852243605,MATH 109,B01,083215,Anzaldo; Leesa B,0,8,30,30
1650852243605,MATH 109,B02,083216,Anzaldo; Leesa B,0,7,30,30
1650852249630,MATH 142A,A01,083219,Chow; Bennett,0,14,30,30
1650852249630,MATH 142A,A02,083220,Chow; Bennett,0,15,30,30
1650852249630,MATH 142A,B01,083221,Chow; Bennett,0,16,30,30
1650852249630,MATH 142A,B02,083222,Chow; Bennett,0,14,30,30
1650852255668,MATH 193A,A01,083224,Staff,0,6,30,30
1650852255668,MATH 193A,A02,083225,Staff,0,7,30,30
1650852255668,MATH 193A,A03,083781,Staff,0,6,30,30
1650852255668,MATH 193A,A04,083782,Staff,0,7,30,30
1650852261691,MATH 197,001,091859,McAuley; Julian John,9998,0,9999,1
1650852267741,COGS 9,A01,083615,Staff,0,17,60,60
1650852274380,COGS 11,A01,083617,Boyle; Mary E. T.,15,0,40,25
1650852280406,COGS 13,A01,083071,Staff,0,38,40,40
1650852286432,COGS 14A,A01,092681,Staff,0,36,100,100
1650852292459,COGS 14B,A01,083073,Cheng; Tzu-Han,0,12,50,50
1650852298482,COGS 17,A01,092677,Staff,12,0,75,63
1650852304505,COGS 100,A01,083619,Staff,0,30,60,60
1650852310532,COGS 101A,A01,083621,Davis; Joshua Daniel,0,29,60,60
1650852316554,COGS 101B,A01,091572,Staff,0,3,60,60
1650852322580,COGS 101C,A01,083625,Delgado; Tania,14,0,30,16
1650852328603,COGS 107A,A01,083627,Boyle; Mary E. T.,0,16,60,60
1650852334629,COGS 118A,A01,083075,Staff,0,8,60,60
1650852340656,CSE 3,A50,083646,Miranda; Gregory Joseph,18,0,38,20
1650852340656,CSE 3,A51,083647,Miranda; Gregory Joseph,36,0,37,1
1650852346680,CSE 8A,A50,083650,Miranda; Gregory Joseph,0,29,40,40
1650852352704,CSE 11,A01,083080,Cao; Yingjun,0,96,40,40
1650852358731,CSE 12,A01,083652,Staff,0,21,100,100
1650852364756,CSE 15L,A01,083654,Staff,0,3,50,50
1650852364756,CSE 15L,A02,083655,Staff,0,3,50,50
1650852370783,CSE 20,A01,083657,Staff,49,0,80,31
1650852376815,CSE 30,A01,083084,Eldon; John,0,76,40,40
1650852382840,CSE 100,A01,083659,Cao; Yingjun,0,71,50,50
1650852388878,CSE 134B,A01,083661,Powell; Thomas Allan,0,38,65,65
1650852394902,CSE 140,A01,083663,Staff,0,12,75,75
1650852401024,CSE 140L,A01,083088,Eldon; John,0,20,75,75
1650852407051,CSE 175,A01,083665,Kumar; Rakesh,7,0,25,18
1650852413076,CSE 190,A00,092507,Dubnov; Shlomo,10,0,20,10
1650852419101,ECE 45,A01,083139,Staff,0,3,60,60
1650852425138,ECE 65,A50,083695,Staff,0,5,30,30
1650852431167,ECE 109,A01,091882,Touri; Behrouz,32,0,70,38
1650852437192,ECE 180,A00,083140,Abi Samra; Nicholas Camill,20,0,30,10
1650852437192,ECE 180,B00,083141,Abi Samra; Nicholas Camill,0,0,30,30
1650852443215,MATH 10A,A01,083735,Patchell; Gregory David,2,0,30,28
1650852443215,MATH 10A,A02,083736,Patchell; Gregory David,27,0,30,3
1650852443215,MATH 10A,A03,083737,Patchell; Gregory David,24,0,30,6
1650852449240,MATH 10B,A01,083207,Staff,0,9,30,30
1650852449240,MATH 10B,A02,083208,Staff,0,6,30,30
1650852449240,MATH 10B,B01,083739,Staff,10,0,30,20
1650852449240,MATH 10B,B02,083740,Staff,28,0,30,2
1650852455267,MATH 18,A01,083743,Staff,0,0,30,30
1650852455267,MATH 18,A02,083744,Staff,23,0,30,7
1650852455267,MATH 18,A03,083745,Staff,21,0,30,9
1650852455267,MATH 18,A04,083746,Staff,26,0,30,4
1650852455267,MATH 18,B01,083748,Staff,0,15,30,30
1650852455267,MATH 18,B02,083749,Staff,0,13,30,30
1650852455267,MATH 18,B03,083750,Staff,0,13,30,30
1650852455267,MATH 18,B04,083751,Staff,0,13,30,30
1650852461291,MATH 20A,A01,083754,Staff,19,0,40,21
1650852467318,MATH 20B,A01,083756,Staff,0,14,30,30
1650852467318,MATH 20B,A02,083757,Staff,0,12,30,30
1650852473351,MATH 20C,A01,083760,Staff,0,17,30,30
1650852473351,MATH 20C,A02,083761,Staff,0,16,30,30
1650852473351,MATH 20C,B01,083762,Staff,9,0,30,21
1650852473351,MATH 20C,B02,083763,Staff,28,0,30,2
1650852479375,MATH 20D,A01,083765,Staff,2,1,30,28
1650852479375,MATH 20D,A02,083766,Staff,6,0,30,24
1650852479375,MATH 20D,A03,083767,Staff,23,0,30,7
1650852485401,MATH 20E,A01,083771,Staff,2,0,30,28
1650852485401,MATH 20E,A02,083772,Staff,13,0,30,17
1650852485401,MATH 20E,B01,083773,Staff,0,0,30,30
1650852485401,MATH 20E,B02,083774,Staff,5,0,30,25
1650852491433,MATH 103A,A01,083777,Staff,0,16,30,30
1650852491433,MATH 103A,A02,083778,Staff,0,15,30,30
1650852491433,MATH 103A,B01,083779,Staff,0,15,30,30
1650852491433,MATH 103A,B02,083780,Staff,1,15,30,29
1650852497461,MATH 105,A01,085443,Staff,0,22,30,30
1650852503485,MATH 109,A01,083213,Anzaldo; Leesa B,0,7,30,30
1650852503485,MATH 109,A02,083214,Anzaldo; Leesa B,0,7,30,30
1650852503485,MATH 109,B01,083215,Anzaldo; Leesa B,0,8,30,30
1650852503485,MATH 109,B02,083216,Anzaldo; Leesa B,0,7,30,30
1650852509511,MATH 142A,A01,083219,Chow; Bennett,0,14,30,30
1650852509511,MATH 142A,A02,083220,Chow; Bennett,0,15,30,30
1650852509511,MATH 142A,B01,083221,Chow; Bennett,0,16,30,30
1650852509511,MATH 142A,B02,083222,Chow; Bennett,0,14,30,30
1650852515534,MATH 193A,A01,083224,Staff,0,6,30,30
1650852515534,MATH 193A,A02,083225,Staff,0,7,30,30
1650852515534,MATH 193A,A03,083781,Staff,0,6,30,30
1650852515534,MATH 193A,A04,083782,Staff,0,7,30,30
1650852521560,MATH 197,001,091859,McAuley; Julian John,9998,0,9999,1
1650852527614,COGS 9,A01,083615,Staff,0,17,60,60
1650852533641,COGS 11,A01,083617,Boyle; Mary E. T.,15,0,40,25
1650852539667,COGS 13,A01,083071,Staff,0,38,40,40
1650852545689,COGS 14A,A01,092681,Staff,0,36,100,100
1650852551726,COGS 14B,A01,083073,Cheng; Tzu-Han,0,12,50,50
1650852557751,COGS 17,A01,092677,Staff,12,0,75,63
1650852563783,COGS 100,A01,083619,Staff,0,30,60,60
1650852569808,COGS 101A,A01,083621,Davis; Joshua Daniel,0,29,60,60
1650852575837,COGS 101B,A01,091572,Staff,0,3,60,60
1650852581860,COGS 101C,A01,083625,Delgado; Tania,14,0,30,16
1650852587894,COGS 107A,A01,083627,Boyle; Mary E. T.,0,16,60,60
1650852593920,COGS 118A,A01,083075,Staff,0,8,60,60
1650852599968,CSE 3,A50,083646,Miranda; Gregory Joseph,18,0,38,20
1650852599968,CSE 3,A51,083647,Miranda; Gregory Joseph,36,0,37,1
1650852605991,CSE 8A,A50,083650,Miranda; Gregory Joseph,0,29,40,40
1650852612018,CSE 11,A01,083080,Cao; Yingjun,0,96,40,40
1650852618040,CSE 12,A01,083652,Staff,0,21,100,100
1650852624064,CSE 15L,A01,083654,Staff,0,3,50,50
1650852624064,CSE 15L,A02,083655,Staff,0,3,50,50
1650852630100,CSE 20,A01,083657,Staff,49,0,80,31
1650852636122,CSE 30,A01,083084,Eldon; John,0,76,40,40
1650852642150,CSE 100,A01,083659,Cao; Yingjun,0,71,50,50
1650852648175,CSE 134B,A01,083661,Powell; Thomas Allan,0,38,65,65
1650852654198,CSE 140,A01,083663,Staff,0,12,75,75
1650852660232,CSE 140L,A01,083088,Eldon; John,0,20,75,75
1650852666258,CSE 175,A01,083665,Kumar; Rakesh,7,0,25,18
1650852672279,CSE 190,A00,092507,Dubnov; Shlomo,10,0,20,10
1650852678303,ECE 45,A01,083139,Staff,0,3,60,60
1650852684331,ECE 65,A50,083695,Staff,0,5,30,30
1650852690358,ECE 109,A01,091882,Touri; Behrouz,32,0,70,38
1650852696383,ECE 180,A00,083140,Abi Samra; Nicholas Camill,20,0,30,10
1650852696383,ECE 180,B00,083141,Abi Samra; Nicholas Camill,0,0,30,30
1650852702413,MATH 10A,A01,083735,Patchell; Gregory David,2,0,30,28
1650852702413,MATH 10A,A02,083736,Patchell; Gregory David,27,0,30,3
1650852702413,MATH 10A,A03,083737,Patchell; Gregory David,24,0,30,6
1650852708442,MATH 10B,A01,083207,Staff,0,9,30,30
1650852708442,MATH 10B,A02,083208,Staff,0,6,30,30
1650852708442,MATH 10B,B01,083739,Staff,10,0,30,20
1650852708442,MATH 10B,B02,083740,Staff,28,0,30,2
1650852714467,MATH 18,A01,083743,Staff,0,0,30,30
1650852714467,MATH 18,A02,083744,Staff,23,0,30,7
1650852714467,MATH 18,A03,083745,Staff,21,0,30,9
1650852714467,MATH 18,A04,083746,Staff,26,0,30,4
1650852714467,MATH 18,B01,083748,Staff,0,15,30,30
1650852714467,MATH 18,B02,083749,Staff,0,13,30,30
1650852714467,MATH 18,B03,083750,Staff,0,13,30,30
1650852714467,MATH 18,B04,083751,Staff,0,13,30,30
1650852720493,MATH 20A,A01,083754,Staff,19,0,40,21
1650852726520,MATH 20B,A01,083756,Staff,0,14,30,30
1650852726520,MATH 20B,A02,083757,Staff,0,12,30,30
1650852732547,MATH 20C,A01,083760,Staff,0,17,30,30
1650852732547,MATH 20C,A02,083761,Staff,0,16,30,30
1650852732547,MATH 20C,B01,083762,Staff,9,0,30,21
1650852732547,MATH 20C,B02,083763,Staff,28,0,30,2
1650852738574,MATH 20D,A01,083765,Staff,2,1,30,28
1650852738574,MATH 20D,A02,083766,Staff,6,0,30,24
1650852738574,MATH 20D,A03,083767,Staff,23,0,30,7
1650852744599,MATH 20E,A01,083771,Staff,2,0,30,28
1650852744599,MATH 20E,A02,083772,Staff,13,0,30,17
1650852744599,MATH 20E,B01,083773,Staff,0,0,30,30
1650852744599,MATH 20E,B02,083774,Staff,5,0,30,25
1650852750623,MATH 103A,A01,083777,Staff,0,16,30,30
1650852750623,MATH 103A,A02,083778,Staff,0,15,30,30
1650852750623,MATH 103A,B01,083779,Staff,0,15,30,30
1650852750623,MATH 103A,B02,083780,Staff,1,15,30,29
1650852756647,MATH 105,A01,085443,Staff,0,22,30,30
1650852762674,MATH 109,A01,083213,Anzaldo; Leesa B,0,7,30,30
1650852762674,MATH 109,A02,083214,Anzaldo; Leesa B,0,7,30,30
1650852762674,MATH 109,B01,083215,Anzaldo; Leesa B,0,8,30,30
1650852762674,MATH 109,B02,083216,Anzaldo; Leesa B,0,7,30,30
1650852768699,MATH 142A,A01,083219,Chow; Bennett,0,14,30,30
1650852768699,MATH 142A,A02,083220,Chow; Bennett,0,15,30,30
1650852768699,MATH 142A,B01,083221,Chow; Bennett,0,16,30,30
1650852768699,MATH 142A,B02,083222,Chow; Bennett,0,14,30,30
1650852774727,MATH 193A,A01,083224,Staff,0,6,30,30
1650852774727,MATH 193A,A02,083225,Staff,0,7,30,30
1650852774727,MATH 193A,A03,083781,Staff,0,6,30,30
1650852774727,MATH 193A,A04,083782,Staff,0,7,30,30
1650852780754,MATH 197,001,091859,McAuley; Julian John,9998,0,9999,1
1650852786804,COGS 9,A01,083615,Staff,0,17,60,60
1650852792827,COGS 11,A01,083617,Boyle; Mary E. T.,15,0,40,25
1650852798850,COGS 13,A01,083071,Staff,0,38,40,40
1650852804874,COGS 14A,A01,092681,Staff,0,36,100,100
1650852810915,COGS 14B,A01,083073,Cheng; Tzu-Han,0,12,50,50
1650852816939,COGS 17,A01,092677,Staff,12,0,75,63
1650852822972,COGS 100,A01,083619,Staff,0,30,60,60
1650852829011,COGS 101A,A01,083621,Davis; Joshua Daniel,0,29,60,60
1650852835035,COGS 101B,A01,091572,Staff,0,3,60,60
1650852841061,COGS 101C,A01,083625,Delgado; Tania,14,0,30,16
1650852847086,COGS 107A,A01,083627,Boyle; Mary E. T.,0,16,60,60
1650852853115,COGS 118A,A01,083075,Staff,0,8,60,60
1650852859139,CSE 3,A50,083646,Miranda; Gregory Joseph,18,0,38,20
1650852859139,CSE 3,A51,083647,Miranda; Gregory Joseph,36,0,37,1
1650852865164,CSE 8A,A50,083650,Miranda; Gregory Joseph,0,29,40,40
1650852871189,CSE 11,A01,083080,Cao; Yingjun,0,96,40,40
1650852877214,CSE 12,A01,083652,Staff,0,21,100,100
1650852883238,CSE 15L,A01,083654,Staff,0,3,50,50
1650852883238,CSE 15L,A02,083655,Staff,0,3,50,50
1650852889269,CSE 20,A01,083657,Staff,49,0,80,31
1650852895292,CSE 30,A01,083084,Eldon; John,0,76,40,40
1650852901320,CSE 100,A01,083659,Cao; Yingjun,0,71,50,50
1650852907343,CSE 134B,A01,083661,Powell; Thomas Allan,0,38,65,65
1650852913367,CSE 140,A01,083663,Staff,0,12,75,75
1650852919392,CSE 140L,A01,083088,Eldon; John,0,20,75,75
1650852925415,CSE 175,A01,083665,Kumar; Rakesh,7,0,25,18
1650852931441,CSE 190,A00,092507,Dubnov; Shlomo,10,0,20,10
1650852937467,ECE 45,A01,083139,Staff,0,3,60,60
1650852943491,ECE 65,A50,083695,Staff,0,5,30,30
1650852949515,ECE 109,A01,091882,Touri; Behrouz,32,0,70,38
1650852955539,ECE 180,A00,083140,Abi Samra; Nicholas Camill,20,0,30,10
1650852955539,ECE 180,B00,083141,Abi Samra; Nicholas Camill,0,0,30,30
1650852961564,MATH 10A,A01,083735,Patchell; Gregory David,2,0,30,28
1650852961564,MATH 10A,A02,083736,Patchell; Gregory David,27,0,30,3
1650852961564,MATH 10A,A03,083737,Patchell; Gregory David,24,0,30,6
1650852967589,MATH 10B,A01,083207,Staff,0,9,30,30
1650852967589,MATH 10B,A02,083208,Staff,0,6,30,30
1650852967589,MATH 10B,B01,083739,Staff,10,0,30,20
1650852967589,MATH 10B,B02,083740,Staff,28,0,30,2
1650852973615,MATH 18,A01,083743,Staff,0,0,30,30
1650852973615,MATH 18,A02,083744,Staff,23,0,30,7
1650852973615,MATH 18,A03,083745,Staff,21,0,30,9
1650852973615,MATH 18,A04,083746,Staff,26,0,30,4
1650852973615,MATH 18,B01,083748,Staff,0,15,30,30
1650852973615,MATH 18,B02,083749,Staff,0,13,30,30
1650852973615,MATH 18,B03,083750,Staff,0,13,30,30
1650852973615,MATH 18,B04,083751,Staff,0,13,30,30
1650852979642,MATH 20A,A01,083754,Staff,19,0,40,21
1650852985666,MATH 20B,A01,083756,Staff,0,14,30,30
1650852985666,MATH 20B,A02,083757,Staff,0,12,30,30
1650852991694,MATH 20C,A01,083760,Staff,0,17,30,30
1650852991694,MATH 20C,A02,083761,Staff,0,16,30,30
1650852991694,MATH 20C,B01,083762,Staff,9,0,30,21
1650852991694,MATH 20C,B02,083763,Staff,28,0,30,2
1650852997799,MATH 20D,A01,083765,Staff,2,1,30,28
1650852997799,MATH 20D,A02,083766,Staff,6,0,30,24
1650852997799,MATH 20D,A03,083767,Staff,23,0,30,7
1650853003827,MATH 20E,A01,083771,Staff,2,0,30,28
1650853003827,MATH 20E,A02,083772,Staff,13,0,30,17
1650853003827,MATH 20E,B01,083773,Staff,0,0,30,30
1650853003827,MATH 20E,B02,083774,Staff,5,0,30,25
1650853009852,MATH 103A,A01,083777,Staff,0,16,30,30
1650853009852,MATH 103A,A02,083778,Staff,0,15,30,30
1650853009852,MATH 103A,B01,083779,Staff,0,15,30,30
1650853009852,MATH 103A,B02,083780,Staff,1,15,30,29
1650853015878,MATH 105,A01,085443,Staff,0,22,30,30
1650853021901,MATH 109,A01,083213,Anzaldo; Leesa B,0,7,30,30
1650853021901,MATH 109,A02,083214,Anzaldo; Leesa B,0,7,30,30
1650853021901,MATH 109,B01,083215,Anzaldo; Leesa B,0,8,30,30
1650853021901,MATH 109,B02,083216,Anzaldo; Leesa B,0,7,30,30
1650853027930,MATH 142A,A01,083219,Chow; Bennett,0,14,30,30
1650853027930,MATH 142A,A02,083220,Chow; Bennett,0,15,30,30
1650853027930,MATH 142A,B01,083221,Chow; Bennett,0,16,30,30
1650853027930,MATH 142A,B02,083222,Chow; Bennett,0,14,30,30
1650853033954,MATH 193A,A01,083224,Staff,0,6,30,30
1650853033954,MATH 193A,A02,083225,Staff,0,7,30,30
1650853033954,MATH 193A,A03,083781,Staff,0,6,30,30
1650853033954,MATH 193A,A04,083782,Staff,0,7,30,30
1650853039979,MATH 197,001,091859,McAuley; Julian John,9998,0,9999,1
1650853046045,COGS 9,A01,083615,Staff,0,17,60,60
1650853052072,COGS 11,A01,083617,Boyle; Mary E. T.,15,0,40,25
1650853058094,COGS 13,A01,083071,Staff,0,38,40,40
1650853064118,COGS 14A,A01,092681,Staff,0,36,100,100
1650853070140,COGS 14B,A01,083073,Cheng; Tzu-Han,0,12,50,50
1650853076167,COGS 17,A01,092677,Staff,12,0,75,63
1650853082195,COGS 100,A01,083619,Staff,0,30,60,60
1650853088217,COGS 101A,A01,083621,Davis; Joshua Daniel,0,29,60,60
1650853094242,COGS 101B,A01,091572,Staff,0,3,60,60
1650853100277,COGS 101C,A01,083625,Delgado; Tania,14,0,30,16
1650853106307,COGS 107A,A01,083627,Boyle; Mary E. T.,0,16,60,60
1650853112330,COGS 118A,A01,083075,Staff,0,8,60,60
1650853118358,CSE 3,A50,083646,Miranda; Gregory Joseph,18,0,38,20
1650853118358,CSE 3,A51,083647,Miranda; Gregory Joseph,36,0,37,1
1650853124386,CSE 8A,A50,083650,Miranda; Gregory Joseph,0,29,40,40
1650853130411,CSE 11,A01,083080,Cao; Yingjun,0,96,40,40
1650853136436,CSE 12,A01,083652,Staff,0,21,100,100
1650853142460,CSE 15L,A01,083654,Staff,0,3,50,50
1650853142460,CSE 15L,A02,083655,Staff,0,3,50,50
1650853148487,CSE 20,A01,083657,Staff,49,0,80,31
1650853154509,CSE 30,A01,083084,Eldon; John,0,76,40,40
1650853160534,CSE 100,A01,083659,Cao; Yingjun,0,71,50,50
1650853166559,CSE 134B,A01,083661,Powell; Thomas Allan,0,38,65,65
1650853172587,CSE 140,A01,083663,Staff,0,12,75,75
1650853178613,CSE 140L,A01,083088,Eldon; John,0,20,75,75
1650853184640,CSE 175,A01,083665,Kumar; Rakesh,7,0,25,18
1650853190669,CSE 190,A00,092507,Dubnov; Shlomo,10,0,20,10
1650853196701,ECE 45,A01,083139,Staff,0,3,60,60
1650853202743,ECE 65,A50,083695,Staff,0,5,30,30
1650853208768,ECE 109,A01,091882,Touri; Behrouz,32,0,70,38
1650853214791,ECE 180,A00,083140,Abi Samra; Nicholas Camill,20,0,30,10
1650853214791,ECE 180,B00,083141,Abi Samra; Nicholas Camill,0,0,30,30
1650853220816,MATH 10A,A01,083735,Patchell; Gregory David,2,0,30,28
1650853220816,MATH 10A,A02,083736,Patchell; Gregory David,27,0,30,3
1650853220816,MATH 10A,A03,083737,Patchell; Gregory David,24,0,30,6
1650853226845,MATH 10B,A01,083207,Staff,0,9,30,30
1650853226845,MATH 10B,A02,083208,Staff,0,6,30,30
1650853226845,MATH 10B,B01,083739,Staff,10,0,30,20
1650853226845,MATH 10B,B02,083740,Staff,28,0,30,2
1650853232868,MATH 18,A01,083743,Staff,0,0,30,30
1650853232868,MATH 18,A02,083744,Staff,23,0,30,7
1650853232868,MATH 18,A03,083745,Staff,21,0,30,9
1650853232868,MATH 18,A04,083746,Staff,26,0,30,4
1650853232868,MATH 18,B01,083748,Staff,0,15,30,30
1650853232868,MATH 18,B02,083749,Staff,0,13,30,30
1650853232868,MATH 18,B03,083750,Staff,0,13,30,30
1650853232868,MATH 18,B04,083751,Staff,0,13,30,30
1650853238891,MATH 20A,A01,083754,Staff,19,0,40,21
1650853244915,MATH 20B,A01,083756,Staff,0,14,30,30
1650853244915,MATH 20B,A02,083757,Staff,0,12,30,30
1650853250940,MATH 20C,A01,083760,Staff,0,17,30,30
1650853250940,MATH 20C,A02,083761,Staff,0,16,30,30
1650853250940,MATH 20C,B01,083762,Staff,9,0,30,21
1650853250940,MATH 20C,B02,083763,Staff,28,0,30,2
1650853256965,MATH 20D,A01,083765,Staff,2,1,30,28
1650853256965,MATH 20D,A02,083766,Staff,6,0,30,24
1650853256965,MATH 20D,A03,083767,Staff,23,0,30,7
1650853262990,MATH 20E,A01,083771,Staff,2,0,30,28
1650853262990,MATH 20E,A02,083772,Staff,13,0,30,17
1650853262990,MATH 20E,B01,083773,Staff,0,0,30,30
1650853262990,MATH 20E,B02,083774,Staff,5,0,30,25
1650853269020,MATH 103A,A01,083777,Staff,0,16,30,30
1650853269020,MATH 103A,A02,083778,Staff,0,15,30,30
1650853269020,MATH 103A,B01,083779,Staff,0,15,30,30
1650853269020,MATH 103A,B02,083780,Staff,1,15,30,29
1650853275044,MATH 105,A01,085443,Staff,0,22,30,30
1650853281069,MATH 109,A01,083213,Anzaldo; Leesa B,0,7,30,30
1650853281069,MATH 109,A02,083214,Anzaldo; Leesa B,0,7,30,30
1650853281069,MATH 109,B01,083215,Anzaldo; Leesa B,0,8,30,30
1650853281069,MATH 109,B02,083216,Anzaldo; Leesa B,0,7,30,30
1650853287098,MATH 142A,A01,083219,Chow; Bennett,0,14,30,30
1650853287098,MATH 142A,A02,083220,Chow; Bennett,0,15,30,30
1650853287098,MATH 142A,B01,083221,Chow; Bennett,0,16,30,30
1650853287098,MATH 142A,B02,083222,Chow; Bennett,0,14,30,30
1650853293131,MATH 193A,A01,083224,Staff,0,6,30,30
1650853293131,MATH 193A,A02,083225,Staff,0,7,30,30
1650853293131,MATH 193A,A03,083781,Staff,0,6,30,30
1650853293131,MATH 193A,A04,083782,Staff,0,7,30,30
1650853299157,MATH 197,001,091859,McAuley; Julian John,9998,0,9999,1
1650853305211,COGS 9,A01,083615,Staff,0,17,60,60
1650853311246,COGS 11,A01,083617,Boyle; Mary E. T.,15,0,40,25
1650853317271,COGS 13,A01,083071,Staff,0,38,40,40
1650853323296,COGS 14A,A01,092681,Staff,0,36,100,100
1650853329321,COGS 14B,A01,083073,Cheng; Tzu-Han,0,12,50,50
1650853335344,COGS 17,A01,092677,Staff,12,0,75,63
1650853341372,COGS 100,A01,083619,Staff,0,30,60,60
1650853347398,COGS 101A,A01,083621,Davis; Joshua Daniel,0,29,60,60
1650853353420,COGS 101B,A01,091572,Staff,0,3,60,60
1650853359454,COGS 101C,A01,083625,Delgado; Tania,14,0,30,16
1650853365479,COGS 107A,A01,083627,Boyle; Mary E. T.,0,16,60,60
1650853371507,COGS 118A,A01,083075,Staff,0,8,60,60
1650853377531,CSE 3,A50,083646,Miranda; Gregory Joseph,18,0,38,20
1650853377531,CSE 3,A51,083647,Miranda; Gregory Joseph,36,0,37,1
1650853383554,CSE 8A,A50,083650,Miranda; Gregory Joseph,0,29,40,40
1650853389580,CSE 11,A01,083080,Cao; Yingjun,0,96,40,40
1650853395604,CSE 12,A01,083652,Staff,0,21,100,100
1650853401626,CSE 15L,A01,083654,Staff,0,3,50,50
1650853401626,CSE 15L,A02,083655,Staff,0,3,50,50
1650853407657,CSE 20,A01,083657,Staff,49,0,80,31
1650853413683,CSE 30,A01,083084,Eldon; John,0,76,40,40
1650853419706,CSE 100,A01,083659,Cao; Yingjun,0,71,50,50
1650853425741,CSE 134B,A01,083661,Powell; Thomas Allan,0,38,65,65
1650853431765,CSE 140,A01,083663,Staff,0,12,75,75
1650853437792,CSE 140L,A01,083088,Eldon; John,0,20,75,75
1650853443818,CSE 175,A01,083665,Kumar; Rakesh,7,0,25,18
1650853449842,CSE 190,A00,092507,Dubnov; Shlomo,10,0,20,10
1650853455877,ECE 45,A01,083139,Staff,0,3,60,60
1650853461902,ECE 65,A50,083695,Staff,0,5,30,30
1650853467927,ECE 109,A01,091882,Touri; Behrouz,32,0,70,38
1650853473951,ECE 180,A00,083140,Abi Samra; Nicholas Camill,20,0,30,10
1650853473951,ECE 180,B00,083141,Abi Samra; Nicholas Camill,0,0,30,30
1650853479978,MATH 10A,A01,083735,Patchell; Gregory David,2,0,30,28
1650853479978,MATH 10A,A02,083736,Patchell; Gregory David,27,0,30,3
1650853479978,MATH 10A,A03,083737,Patchell; Gregory David,24,0,30,6
1650853486003,MATH 10B,A01,083207,Staff,0,9,30,30
1650853486003,MATH 10B,A02,083208,Staff,0,6,30,30
1650853486003,MATH 10B,B01,083739,Staff,10,0,30,20
1650853486003,MATH 10B,B02,083740,Staff,28,0,30,2
1650853492033,MATH 18,A01,083743,Staff,0,0,30,30
1650853492033,MATH 18,A02,083744,Staff,23,0,30,7
1650853492033,MATH 18,A03,083745,Staff,21,0,30,9
1650853492033,MATH 18,A04,083746,Staff,26,0,30,4
1650853492033,MATH 18,B01,083748,Staff,0,15,30,30
1650853492033,MATH 18,B02,083749,Staff,0,13,30,30
1650853492033,MATH 18,B03,083750,Staff,0,13,30,30
1650853492033,MATH 18,B04,083751,Staff,0,13,30,30
1650853498057,MATH 20A,A01,083754,Staff,19,0,40,21
1650853504079,MATH 20B,A01,083756,Staff,0,14,30,30
1650853504079,MATH 20B,A02,083757,Staff,0,12,30,30
1650853510103,MATH 20C,A01,083760,Staff,0,17,30,30
1650853510103,MATH 20C,A02,083761,Staff,0,16,30,30
1650853510103,MATH 20C,B01,083762,Staff,9,0,30,21
1650853510103,MATH 20C,B02,083763,Staff,28,0,30,2
1650853516127,MATH 20D,A01,083765,Staff,2,1,30,28
1650853516127,MATH 20D,A02,083766,Staff,6,0,30,24
1650853516127,MATH 20D,A03,083767,Staff,23,0,30,7
1650853522171,MATH 20E,A01,083771,Staff,2,0,30,28
1650853522171,MATH 20E,A02,083772,Staff,13,0,30,17
1650853522171,MATH 20E,B01,083773,Staff,0,0,30,30
1650853522171,MATH 20E,B02,083774,Staff,5,0,30,25
1650853528196,MATH 103A,A01,083777,Staff,0,16,30,30
1650853528196,MATH 103A,A02,083778,Staff,0,15,30,30
1650853528196,MATH 103A,B01,083779,Staff,0,15,30,30
1650853528196,MATH 103A,B02,083780,Staff,1,15,30,29
1650853534219,MATH 105,A01,085443,Staff,0,22,30,30
1650853540244,MATH 109,A01,083213,Anzaldo; Leesa B,0,7,30,30
1650853540244,MATH 109,A02,083214,Anzaldo; Leesa B,0,7,30,30
1650853540244,MATH 109,B01,083215,Anzaldo; Leesa B,0,8,30,30
1650853540244,MATH 109,B02,083216,Anzaldo; Leesa B,0,7,30,30
1650853546272,MATH 142A,A01,083219,Chow; Bennett,0,14,30,30
1650853546272,MATH 142A,A02,083220,Chow; Bennett,0,15,30,30
1650853546272,MATH 142A,B01,083221,Chow; Bennett,0,16,30,30
1650853546272,MATH 142A,B02,083222,Chow; Bennett,0,14,30,30
1650853552302,MATH 193A,A01,083224,Staff,0,6,30,30
1650853552302,MATH 193A,A02,083225,Staff,0,7,30,30
1650853552302,MATH 193A,A03,083781,Staff,0,6,30,30
1650853552302,MATH 193A,A04,083782,Staff,0,7,30,30
1650853558332,MATH 197,001,091859,McAuley; Julian John,9998,0,9999,1
1650853564381,COGS 9,A01,083615,Staff,0,17,60,60
1650853570405,COGS 11,A01,083617,Boyle; Mary E. T.,15,0,40,25
1650853576432,COGS 13,A01,083071,Staff,0,38,40,40
1650853582456,COGS 14A,A01,092681,Staff,0,36,100,100
1650853588578,COGS 14B,A01,083073,Cheng; Tzu-Han,0,12,50,50
1650853594601,COGS 17,A01,092677,Staff,12,0,75,63
1650853600626,COGS 100,A01,083619,Staff,0,30,60,60
1650853606654,COGS 101A,A01,083621,Davis; Joshua Daniel,0,29,60,60
1650853612676,COGS 101B,A01,091572,Staff,0,3,60,60
1650853618700,COGS 101C,A01,083625,Delgado; Tania,14,0,30,16
1650853624727,COGS 107A,A01,083627,Boyle; Mary E. T.,0,16,60,60
1650853630754,COGS 118A,A01,083075,Staff,0,8,60,60
1650853636778,CSE 3,A50,083646,Miranda; Gregory Joseph,18,0,38,20
1650853636778,CSE 3,A51,083647,Miranda; Gregory Joseph,36,0,37,1
1650853642801,CSE 8A,A50,083650,Miranda; Gregory Joseph,0,29,40,40
1650853648825,CSE 11,A01,083080,Cao; Yingjun,0,96,40,40
1650853654848,CSE 12,A01,083652,Staff,0,21,100,100
1650853660870,CSE 15L,A01,083654,Staff,0,3,50,50
1650853660870,CSE 15L,A02,083655,Staff,0,3,50,50
1650853666896,CSE 20,A01,083657,Staff,49,0,80,31
1650853672919,CSE 30,A01,083084,Eldon; John,0,76,40,40
1650853678941,CSE 100,A01,083659,Cao; Yingjun,0,71,50,50
1650853684965,CSE 134B,A01,083661,Powell; Thomas Allan,0,38,65,65
1650853690990,CSE 140,A01,083663,Staff,0,12,75,75
1650853697016,CSE 140L,A01,083088,Eldon; John,0,20,75,75
1650853703046,CSE 175,A01,083665,Kumar; Rakesh,7,0,25,18
1650853709073,CSE 190,A00,092507,Dubnov; Shlomo,10,0,20,10
1650853715096,ECE 45,A01,083139,Staff,0,3,60,60
1650853721122,ECE 65,A50,083695,Staff,0,5,30,30
1650853727147,ECE 109,A01,091882,Touri; Behrouz,32,0,70,38
1650853733170,ECE 180,A00,083140,Abi Samra; Nicholas Camill,20,0,30,10
1650853733170,ECE 180,B00,083141,Abi Samra; Nicholas Camill,0,0,30,30
1650853739197,MATH 10A,A01,083735,Patchell; Gregory David,2,0,30,28
1650853739197,MATH 10A,A02,083736,Patchell; Gregory David,27,0,30,3
1650853739197,MATH 10A,A03,083737,Patchell; Gregory David,24,0,30,6
1650853745222,MATH 10B,A01,083207,Staff,0,9,30,30
1650853745222,MATH 10B,A02,083208,Staff,0,6,30,30
1650853745222,MATH 10B,B01,083739,Staff,10,0,30,20
1650853745222,MATH 10B,B02,083740,Staff,28,0,30,2
1650853751252,MATH 18,A01,083743,Staff,0,0,30,30
1650853751252,MATH 18,A02,083744,Staff,23,0,30,7
1650853751252,MATH 18,A03,083745,Staff,21,0,30,9
1650853751252,MATH 18,A04,083746,Staff,26,0,30,4
1650853751252,MATH 18,B01,083748,Staff,0,15,30,30
1650853751252,MATH 18,B02,083749,Staff,0,13,30,30
1650853751252,MATH 18,B03,083750,Staff,0,13,30,30
1650853751252,MATH 18,B04,083751,Staff,0,13,30,30
1650853757288,MATH 20A,A01,083754,Staff,19,0,40,21
1650853763313,MATH 20B,A01,083756,Staff,0,14,30,30
1650853763313,MATH 20B,A02,083757,Staff,0,12,30,30
1650853769338,MATH 20C,A01,083760,Staff,0,17,30,30
1650853769338,MATH 20C,A02,083761,Staff,0,16,30,30
1650853769338,MATH 20C,B01,083762,Staff,9,0,30,21
1650853769338,MATH 20C,B02,083763,Staff,28,0,30,2
1650853775361,MATH 20D,A01,083765,Staff,2,1,30,28
1650853775361,MATH 20D,A02,083766,Staff,6,0,30,24
1650853775361,MATH 20D,A03,083767,Staff,23,0,30,7
1650853781385,MATH 20E,A01,083771,Staff,2,0,30,28
1650853781385,MATH 20E,A02,083772,Staff,13,0,30,17
1650853781385,MATH 20E,B01,083773,Staff,0,0,30,30
1650853781385,MATH 20E,B02,083774,Staff,5,0,30,25
1650853787408,MATH 103A,A01,083777,Staff,0,16,30,30
1650853787408,MATH 103A,A02,083778,Staff,0,15,30,30
1650853787408,MATH 103A,B01,083779,Staff,0,15,30,30
1650853787408,MATH 103A,B02,083780,Staff,1,15,30,29
1650853793433,MATH 105,A01,085443,Staff,0,22,30,30
1650853799455,MATH 109,A01,083213,Anzaldo; Leesa B,0,7,30,30
1650853799455,MATH 109,A02,083214,Anzaldo; Leesa B,0,7,30,30
1650853799455,MATH 109,B01,083215,Anzaldo; Leesa B,0,8,30,30
1650853799455,MATH 109,B02,083216,Anzaldo; Leesa B,0,7,30,30
1650853805480,MATH 142A,A01,083219,Chow; Bennett,0,14,30,30
1650853805480,MATH 142A,A02,083220,Chow; Bennett,0,15,30,30
1650853805480,MATH 142A,B01,083221,Chow; Bennett,0,16,30,30
1650853805480,MATH 142A,B02,083222,Chow; Bennett,0,14,30,30
1650853811506,MATH 193A,A01,083224,Staff,0,6,30,30
1650853811506,MATH 193A,A02,083225,Staff,0,7,30,30
1650853811506,MATH 193A,A03,083781,Staff,0,6,30,30
1650853811506,MATH 193A,A04,083782,Staff,0,7,30,30
1650853817532,MATH 197,001,091859,McAuley; Julian John,9998,0,9999,1
1650853823588,COGS 9,A01,083615,Staff,0,17,60,60
1650853829611,COGS 11,A01,083617,Boyle; Mary E. T.,15,0,40,25
1650853835638,COGS 13,A01,083071,Staff,0,38,40,40
1650853841662,COGS 14A,A01,092681,Staff,0,36,100,100
1650853847691,COGS 14B,A01,083073,Cheng; Tzu-Han,0,12,50,50
1650853853715,COGS 17,A01,092677,Staff,12,0,75,63
1650853859742,COGS 100,A01,083619,Staff,0,30,60,60
1650853865772,COGS 101A,A01,083621,Davis; Joshua Daniel,0,29,60,60
1650853871795,COGS 101B,A01,091572,Staff,0,3,60,60
1650853877819,COGS 101C,A01,083625,Delgado; Tania,14,0,30,16
1650853883841,COGS 107A,A01,083627,Boyle; Mary E. T.,0,16,60,60
1650853889863,COGS 118A,A01,083075,Staff,0,8,60,60
1650853895893,CSE 3,A50,083646,Miranda; Gregory Joseph,18,0,38,20
1650853895893,CSE 3,A51,083647,Miranda; Gregory Joseph,36,0,37,1
1650853901918,CSE 8A,A50,083650,Miranda; Gregory Joseph,0,29,40,40
1650853907947,CSE 11,A01,083080,Cao; Yingjun,0,96,40,40
1650853913973,CSE 12,A01,083652,Staff,0,21,100,100
1650853920009,CSE 15L,A01,083654,Staff,0,3,50,50
1650853920009,CSE 15L,A02,083655,Staff,0,3,50,50
1650853926035,CSE 20,A01,083657,Staff,49,0,80,31
1650853932060,CSE 30,A01,083084,Eldon; John,0,76,40,40
1650853938082,CSE 100,A01,083659,Cao; Yingjun,0,71,50,50
1650853944106,CSE 134B,A01,083661,Powell; Thomas Allan,0,38,65,65
1650853950129,CSE 140,A01,083663,Staff,0,12,75,75
1650853956155,CSE 140L,A01,083088,Eldon; John,0,20,75,75
1650853962179,CSE 175,A01,083665,Kumar; Rakesh,7,0,25,18
1650853968203,CSE 190,A00,092507,Dubnov; Shlomo,10,0,20,10
1650853974227,ECE 45,A01,083139,Staff,0,3,60,60
1650853980262,ECE 65,A50,083695,Staff,0,5,30,30
1650853986300,ECE 109,A01,091882,Touri; Behrouz,32,0,70,38
1650853992324,ECE 180,A00,083140,Abi Samra; Nicholas Camill,20,0,30,10
1650853992324,ECE 180,B00,083141,Abi Samra; Nicholas Camill,0,0,30,30
1650853998347,MATH 10A,A01,083735,Patchell; Gregory David,2,0,30,28
1650853998347,MATH 10A,A02,083736,Patchell; Gregory David,27,0,30,3
1650853998347,MATH 10A,A03,083737,Patchell; Gregory David,24,0,30,6
1650854004371,MATH 10B,A01,083207,Staff,0,9,30,30
1650854004371,MATH 10B,A02,083208,Staff,0,6,30,30
1650854004371,MATH 10B,B01,083739,Staff,10,0,30,20
1650854004371,MATH 10B,B02,083740,Staff,28,0,30,2
1650854010412,MATH 18,A01,083743,Staff,0,0,30,30
1650854010412,MATH 18,A02,083744,Staff,23,0,30,7
1650854010412,MATH 18,A03,083745,Staff,21,0,30,9
1650854010412,MATH 18,A04,083746,Staff,26,0,30,4
1650854010412,MATH 18,B01,083748,Staff,0,15,30,30
1650854010412,MATH 18,B02,083749,Staff,0,13,30,30
1650854010412,MATH 18,B03,083750,Staff,0,13,30,30
1650854010412,MATH 18,B04,083751,Staff,0,13,30,30
1650854016444,MATH 20A,A01,083754,Staff,19,0,40,21
1650854022467,MATH 20B,A01,083756,Staff,0,14,30,30
1650854022467,MATH 20B,A02,083757,Staff,0,12,30,30
1650854028492,MATH 20C,A01,083760,Staff,0,17,30,30
1650854028492,MATH 20C,A02,083761,Staff,0,16,30,30
1650854028492,MATH 20C,B01,083762,Staff,9,0,30,21
1650854028492,MATH 20C,B02,083763,Staff,28,0,30,2
1650854034519,MATH 20D,A01,083765,Staff,2,1,30,28
1650854034519,MATH 20D,A02,083766,Staff,6,0,30,24
1650854034519,MATH 20D,A03,083767,Staff,23,0,30,7
1650854040551,MATH 20E,A01,083771,Staff,2,0,30,28
1650854040551,MATH 20E,A02,083772,Staff,13,0,30,17
1650854040551,MATH 20E,B01,083773,Staff,0,0,30,30
1650854040551,MATH 20E,B02,083774,Staff,4,0,30,26
1650854046574,MATH 103A,A01,083777,Staff,0,16,30,30
1650854046574,MATH 103A,A02,083778,Staff,0,15,30,30
1650854046574,MATH 103A,B01,083779,Staff,0,15,30,30
1650854046574,MATH 103A,B02,083780,Staff,1,15,30,29
1650854052598,MATH 105,A01,085443,Staff,0,22,30,30
1650854058622,MATH 109,A01,083213,Anzaldo; Leesa B,0,7,30,30
1650854058622,MATH 109,A02,083214,Anzaldo; Leesa B,0,7,30,30
1650854058622,MATH 109,B01,083215,Anzaldo; Leesa B,0,8,30,30
1650854058622,MATH 109,B02,083216,Anzaldo; Leesa B,0,7,30,30
1650854064646,MATH 142A,A01,083219,Chow; Bennett,0,14,30,30
1650854064646,MATH 142A,A02,083220,Chow; Bennett,0,15,30,30
1650854064646,MATH 142A,B01,083221,Chow; Bennett,0,16,30,30
1650854064646,MATH 142A,B02,083222,Chow; Bennett,0,14,30,30
1650854070672,MATH 193A,A01,083224,Staff,0,6,30,30
1650854070672,MATH 193A,A02,083225,Staff,0,7,30,30
1650854070672,MATH 193A,A03,083781,Staff,0,6,30,30
1650854070672,MATH 193A,A04,083782,Staff,0,7,30,30
1650854076709,MATH 197,001,091859,McAuley; Julian John,9998,0,9999,1
1650854082765,COGS 9,A01,083615,Staff,0,17,60,60
1650854088786,COGS 11,A01,083617,Boyle; Mary E. T.,15,0,40,25
1650854094809,COGS 13,A01,083071,Staff,0,38,40,40
1650854100834,COGS 14A,A01,092681,Staff,0,36,100,100
1650854106861,COGS 14B,A01,083073,Cheng; Tzu-Han,0,12,50,50
1650854112884,COGS 17,A01,092677,Staff,12,0,75,63
1650854118925,COGS 100,A01,083619,Staff,0,30,60,60
1650854124948,COGS 101A,A01,083621,Davis; Joshua Daniel,0,29,60,60
1650854130974,COGS 101B,A01,091572,Staff,0,3,60,60
1650854137002,COGS 101C,A01,083625,Delgado; Tania,14,0,30,16
1650854143029,COGS 107A,A01,083627,Boyle; Mary E. T.,0,16,60,60
1650854149053,COGS 118A,A01,083075,Staff,0,8,60,60
1650854155076,CSE 3,A50,083646,Miranda; Gregory Joseph,18,0,38,20
1650854155076,CSE 3,A51,083647,Miranda; Gregory Joseph,36,0,37,1
1650854161113,CSE 8A,A50,083650,Miranda; Gregory Joseph,0,29,40,40
1650854167139,CSE 11,A01,083080,Cao; Yingjun,0,96,40,40
1650854173172,CSE 12,A01,083652,Staff,0,21,100,100
1650854179199,CSE 15L,A01,083654,Staff,0,3,50,50
1650854179199,CSE 15L,A02,083655,Staff,0,3,50,50
1650854185309,CSE 20,A01,083657,Staff,49,0,80,31
1650854191333,CSE 30,A01,083084,Eldon; John,0,76,40,40
1650854197357,CSE 100,A01,083659,Cao; Yingjun,0,71,50,50
1650854203380,CSE 134B,A01,083661,Powell; Thomas Allan,0,38,65,65
1650854209403,CSE 140,A01,083663,Staff,0,12,75,75
1650854215429,CSE 140L,A01,083088,Eldon; John,0,20,75,75
1650854221457,CSE 175,A01,083665,Kumar; Rakesh,7,0,25,18
1650854227480,CSE 190,A00,092507,Dubnov; Shlomo,10,0,20,10
1650854233503,ECE 45,A01,083139,Staff,0,3,60,60
1650854239530,ECE 65,A50,083695,Staff,0,5,30,30
1650854245558,ECE 109,A01,091882,Touri; Behrouz,32,0,70,38
1650854251582,ECE 180,A00,083140,Abi Samra; Nicholas Camill,20,0,30,10
1650854251582,ECE 180,B00,083141,Abi Samra; Nicholas Camill,0,0,30,30
1650854257603,MATH 10A,A01,083735,Patchell; Gregory David,2,0,30,28
1650854257603,MATH 10A,A02,083736,Patchell; Gregory David,27,0,30,3
1650854257603,MATH 10A,A03,083737,Patchell; Gregory David,24,0,30,6
1650854263630,MATH 10B,A01,083207,Staff,0,9,30,30
1650854263630,MATH 10B,A02,083208,Staff,0,6,30,30
1650854263630,MATH 10B,B01,083739,Staff,10,0,30,20
1650854263630,MATH 10B,B02,083740,Staff,28,0,30,2
1650854269664,MATH 18,A01,083743,Staff,0,0,30,30
1650854269664,MATH 18,A02,083744,Staff,23,0,30,7
1650854269664,MATH 18,A03,083745,Staff,21,0,30,9
1650854269664,MATH 18,A04,083746,Staff,26,0,30,4
1650854269664,MATH 18,B01,083748,Staff,0,15,30,30
1650854269664,MATH 18,B02,083749,Staff,0,13,30,30
1650854269664,MATH 18,B03,083750,Staff,0,13,30,30
1650854269664,MATH 18,B04,083751,Staff,0,13,30,30
1650854275707,MATH 20A,A01,083754,Staff,19,0,40,21
1650854281731,MATH 20B,A01,083756,Staff,0,14,30,30
1650854281731,MATH 20B,A02,083757,Staff,0,12,30,30
1650854287754,MATH 20C,A01,083760,Staff,0,17,30,30
1650854287754,MATH 20C,A02,083761,Staff,0,16,30,30
1650854287754,MATH 20C,B01,083762,Staff,9,0,30,21
1650854287754,MATH 20C,B02,083763,Staff,28,0,30,2
1650854293780,MATH 20D,A01,083765,Staff,2,1,30,28
1650854293780,MATH 20D,A02,083766,Staff,6,0,30,24
1650854293780,MATH 20D,A03,083767,Staff,23,0,30,7
1650854299810,MATH 20E,A01,083771,Staff,2,0,30,28
1650854299810,MATH 20E,A02,083772,Staff,13,0,30,17
1650854299810,MATH 20E,B01,083773,Staff,0,0,30,30
1650854299810,MATH 20E,B02,083774,Staff,4,0,30,26
1650854305835,MATH 103A,A01,083777,Staff,0,16,30,30
1650854305835,MATH 103A,A02,083778,Staff,0,15,30,30
1650854305835,MATH 103A,B01,083779,Staff,0,15,30,30
1650854305835,MATH 103A,B02,083780,Staff,1,15,30,29
1650854311858,MATH 105,A01,085443,Staff,0,22,30,30
1650854317884,MATH 109,A01,083213,Anzaldo; Leesa B,0,7,30,30
1650854317884,MATH 109,A02,083214,Anzaldo; Leesa B,0,7,30,30
1650854317884,MATH 109,B01,083215,Anzaldo; Leesa B,0,8,30,30
1650854317884,MATH 109,B02,083216,Anzaldo; Leesa B,0,7,30,30
1650854323913,MATH 142A,A01,083219,Chow; Bennett,0,14,30,30
1650854323913,MATH 142A,A02,083220,Chow; Bennett,0,15,30,30
1650854323913,MATH 142A,B01,083221,Chow; Bennett,0,16,30,30
1650854323913,MATH 142A,B02,083222,Chow; Bennett,0,14,30,30
1650854329936,MATH 193A,A01,083224,Staff,0,6,30,30
1650854329936,MATH 193A,A02,083225,Staff,0,7,30,30
1650854329936,MATH 193A,A03,083781,Staff,0,6,30,30
1650854329936,MATH 193A,A04,083782,Staff,0,7,30,30
1650854335960,MATH 197,001,091859,McAuley; Julian John,9998,0,9999,1
1650854342022,COGS 9,A01,083615,Staff,0,17,60,60
1650854348050,COGS 11,A01,083617,Boyle; Mary E. T.,15,0,40,25
1650854354074,COGS 13,A01,083071,Staff,0,38,40,40
1650854360097,COGS 14A,A01,092681,Staff,0,36,100,100
1650854366120,COGS 14B,A01,083073,Cheng; Tzu-Han,0,12,50,50
1650854372154,COGS 17,A01,092677,Staff,12,0,75,63
1650854378178,COGS 100,A01,083619,Staff,0,30,60,60
1650854384201,COGS 101A,A01,083621,Davis; Joshua Daniel,0,29,60,60
1650854390227,COGS 101B,A01,091572,Staff,0,3,60,60
1650854396252,COGS 101C,A01,083625,Delgado; Tania,14,0,30,16
1650854402284,COGS 107A,A01,083627,Boyle; Mary E. T.,0,16,60,60
1650854408311,COGS 118A,A01,083075,Staff,0,8,60,60
1650854414339,CSE 3,A50,083646,Miranda; Gregory Joseph,18,0,38,20
1650854414339,CSE 3,A51,083647,Miranda; Gregory Joseph,36,0,37,1
1650854420362,CSE 8A,A50,083650,Miranda; Gregory Joseph,0,29,40,40
1650854426388,CSE 11,A01,083080,Cao; Yingjun,0,96,40,40
1650854432414,CSE 12,A01,083652,Staff,0,21,100,100
1650854438442,CSE 15L,A01,083654,Staff,0,3,50,50
1650854438442,CSE 15L,A02,083655,Staff,0,3,50,50
1650854444465,CSE 20,A01,083657,Staff,49,0,80,31
1650854450488,CSE 30,A01,083084,Eldon; John,0,76,40,40
1650854456514,CSE 100,A01,083659,Cao; Yingjun,0,71,50,50
1650854462538,CSE 134B,A01,083661,Powell; Thomas Allan,0,38,65,65
1650854468561,CSE 140,A01,083663,Staff,0,12,75,75
1650854474587,CSE 140L,A01,083088,Eldon; John,0,20,75,75
1650854480613,CSE 175,A01,083665,Kumar; Rakesh,7,0,25,18
1650854486646,CSE 190,A00,092507,Dubnov; Shlomo,10,0,20,10
1650854492672,ECE 45,A01,083139,Staff,0,3,60,60
1650854498695,ECE 65,A50,083695,Staff,0,5,30,30
1650854504719,ECE 109,A01,091882,Touri; Behrouz,32,0,70,38
1650854510745,ECE 180,A00,083140,Abi Samra; Nicholas Camill,20,0,30,10
1650854510745,ECE 180,B00,083141,Abi Samra; Nicholas Camill,0,0,30,30
1650854516769,MATH 10A,A01,083735,Patchell; Gregory David,2,0,30,28
1650854516769,MATH 10A,A02,083736,Patchell; Gregory David,27,0,30,3
1650854516769,MATH 10A,A03,083737,Patchell; Gregory David,24,0,30,6
1650854522797,MATH 10B,A01,083207,Staff,0,9,30,30
1650854522797,MATH 10B,A02,083208,Staff,0,6,30,30
1650854522797,MATH 10B,B01,083739,Staff,10,0,30,20
1650854522797,MATH 10B,B02,083740,Staff,28,0,30,2
1650854528823,MATH 18,A01,083743,Staff,0,0,30,30
1650854528823,MATH 18,A02,083744,Staff,23,0,30,7
1650854528823,MATH 18,A03,083745,Staff,21,0,30,9
1650854528823,MATH 18,A04,083746,Staff,26,0,30,4
1650854528823,MATH 18,B01,083748,Staff,0,15,30,30
1650854528823,MATH 18,B02,083749,Staff,0,13,30,30
1650854528823,MATH 18,B03,083750,Staff,0,13,30,30
1650854528823,MATH 18,B04,083751,Staff,0,13,30,30
1650854534847,MATH 20A,A01,083754,Staff,19,0,40,21
1650854540873,MATH 20B,A01,083756,Staff,0,14,30,30
1650854540873,MATH 20B,A02,083757,Staff,0,12,30,30
1650854546900,MATH 20C,A01,083760,Staff,0,17,30,30
1650854546900,MATH 20C,A02,083761,Staff,0,16,30,30
1650854546900,MATH 20C,B01,083762,Staff,9,0,30,21
1650854546900,MATH 20C,B02,083763,Staff,28,0,30,2
1650854552927,MATH 20D,A01,083765,Staff,2,1,30,28
1650854552927,MATH 20D,A02,083766,Staff,6,0,30,24
1650854552927,MATH 20D,A03,083767,Staff,23,0,30,7
1650854558959,MATH 20E,A01,083771,Staff,2,0,30,28
1650854558959,MATH 20E,A02,083772,Staff,13,0,30,17
1650854558959,MATH 20E,B01,083773,Staff,0,0,30,30
1650854558959,MATH 20E,B02,083774,Staff,4,0,30,26
1650854564994,MATH 103A,A01,083777,Staff,0,16,30,30
1650854564994,MATH 103A,A02,083778,Staff,0,15,30,30
1650854564994,MATH 103A,B01,083779,Staff,0,15,30,30
1650854564994,MATH 103A,B02,083780,Staff,1,15,30,29
1650854571019,MATH 105,A01,085443,Staff,0,22,30,30
1650854577046,MATH 109,A01,083213,Anzaldo; Leesa B,0,7,30,30
1650854577046,MATH 109,A02,083214,Anzaldo; Leesa B,0,7,30,30
1650854577046,MATH 109,B01,083215,Anzaldo; Leesa B,0,8,30,30
1650854577046,MATH 109,B02,083216,Anzaldo; Leesa B,0,7,30,30
1650854583071,MATH 142A,A01,083219,Chow; Bennett,0,14,30,30
1650854583071,MATH 142A,A02,083220,Chow; Bennett,0,15,30,30
1650854583071,MATH 142A,B01,083221,Chow; Bennett,0,16,30,30
1650854583071,MATH 142A,B02,083222,Chow; Bennett,0,14,30,30
1650854589098,MATH 193A,A01,083224,Staff,0,6,30,30
1650854589098,MATH 193A,A02,083225,Staff,0,7,30,30
1650854589098,MATH 193A,A03,083781,Staff,0,6,30,30
1650854589098,MATH 193A,A04,083782,Staff,0,7,30,30
1650854595121,MATH 197,001,091859,McAuley; Julian John,9998,0,9999,1
1650854601181,COGS 9,A01,083615,Staff,0,17,60,60
1650854607207,COGS 11,A01,083617,Boyle; Mary E. T.,15,0,40,25
1650854613233,COGS 13,A01,083071,Staff,0,38,40,40
1650854619257,COGS 14A,A01,092681,Staff,0,36,100,100
1650854625283,COGS 14B,A01,083073,Cheng; Tzu-Han,0,12,50,50
1650854631317,COGS 17,A01,092677,Staff,12,0,75,63
1650854637341,COGS 100,A01,083619,Staff,0,30,60,60
1650854643365,COGS 101A,A01,083621,Davis; Joshua Daniel,0,29,60,60
1650854649388,COGS 101B,A01,091572,Staff,0,3,60,60
1650854655413,COGS 101C,A01,083625,Delgado; Tania,14,0,30,16
1650854661442,COGS 107A,A01,083627,Boyle; Mary E. T.,0,16,60,60
1650854667468,COGS 118A,A01,083075,Staff,0,8,60,60
1650854673495,CSE 3,A50,083646,Miranda; Gregory Joseph,18,0,38,20
1650854673495,CSE 3,A51,083647,Miranda; Gregory Joseph,36,0,37,1
1650854679519,CSE 8A,A50,083650,Miranda; Gregory Joseph,0,29,40,40
1650854685546,CSE 11,A01,083080,Cao; Yingjun,0,96,40,40
1650854691567,CSE 12,A01,083652,Staff,0,21,100,100
1650854697589,CSE 15L,A01,083654,Staff,0,3,50,50
1650854697589,CSE 15L,A02,083655,Staff,0,3,50,50
1650854703613,CSE 20,A01,083657,Staff,49,0,80,31
1650854709637,CSE 30,A01,083084,Eldon; John,0,76,40,40
1650854715660,CSE 100,A01,083659,Cao; Yingjun,0,71,50,50
1650854721687,CSE 134B,A01,083661,Powell; Thomas Allan,0,38,65,65
1650854727710,CSE 140,A01,083663,Staff,0,12,75,75
1650854733743,CSE 140L,A01,083088,Eldon; John,0,20,75,75
1650854739767,CSE 175,A01,083665,Kumar; Rakesh,7,0,25,18
1650854745796,CSE 190,A00,092507,Dubnov; Shlomo,10,0,20,10
1650854751818,ECE 45,A01,083139,Staff,0,3,60,60
1650854757843,ECE 65,A50,083695,Staff,0,5,30,30
1650854763869,ECE 109,A01,091882,Touri; Behrouz,32,0,70,38
1650854769895,ECE 180,A00,083140,Abi Samra; Nicholas Camill,20,0,30,10
1650854769895,ECE 180,B00,083141,Abi Samra; Nicholas Camill,0,0,30,30
1650854775918,MATH 10A,A01,083735,Patchell; Gregory David,2,0,30,28
1650854775918,MATH 10A,A02,083736,Patchell; Gregory David,27,0,30,3
1650854775918,MATH 10A,A03,083737,Patchell; Gregory David,24,0,30,6
1650854782032,MATH 10B,A01,083207,Staff,0,9,30,30
1650854782032,MATH 10B,A02,083208,Staff,0,6,30,30
1650854782032,MATH 10B,B01,083739,Staff,10,0,30,20
1650854782032,MATH 10B,B02,083740,Staff,28,0,30,2
1650854788059,MATH 18,A01,083743,Staff,0,0,30,30
1650854788059,MATH 18,A02,083744,Staff,23,0,30,7
1650854788059,MATH 18,A03,083745,Staff,21,0,30,9
1650854788059,MATH 18,A04,083746,Staff,26,0,30,4
1650854788059,MATH 18,B01,083748,Staff,0,15,30,30
1650854788059,MATH 18,B02,083749,Staff,0,13,30,30
1650854788059,MATH 18,B03,083750,Staff,0,13,30,30
1650854788059,MATH 18,B04,083751,Staff,0,13,30,30
1650854794095,MATH 20A,A01,083754,Staff,19,0,40,21
1650854800118,MATH 20B,A01,083756,Staff,0,14,30,30
1650854800118,MATH 20B,A02,083757,Staff,0,12,30,30
1650854806146,MATH 20C,A01,083760,Staff,0,17,30,30
1650854806146,MATH 20C,A02,083761,Staff,0,16,30,30
1650854806146,MATH 20C,B01,083762,Staff,9,0,30,21
1650854806146,MATH 20C,B02,083763,Staff,28,0,30,2
1650854812168,MATH 20D,A01,083765,Staff,2,1,30,28
1650854812168,MATH 20D,A02,083766,Staff,6,0,30,24
1650854812168,MATH 20D,A03,083767,Staff,23,0,30,7
1650854818205,MATH 20E,A01,083771,Staff,2,0,30,28
1650854818205,MATH 20E,A02,083772,Staff,13,0,30,17
1650854818205,MATH 20E,B01,083773,Staff,0,0,30,30
1650854818205,MATH 20E,B02,083774,Staff,4,0,30,26
1650854824232,MATH 103A,A01,083777,Staff,0,16,30,30
1650854824232,MATH 103A,A02,083778,Staff,0,15,30,30
1650854824232,MATH 103A,B01,083779,Staff,0,15,30,30
1650854824232,MATH 103A,B02,083780,Staff,1,15,30,29
1650854830256,MATH 105,A01,085443,Staff,0,22,30,30
1650854836284,MATH 109,A01,083213,Anzaldo; Leesa B,0,7,30,30
1650854836284,MATH 109,A02,083214,Anzaldo; Leesa B,0,7,30,30
1650854836284,MATH 109,B01,083215,Anzaldo; Leesa B,0,8,30,30
1650854836284,MATH 109,B02,083216,Anzaldo; Leesa B,0,7,30,30
1650854842312,MATH 142A,A01,083219,Chow; Bennett,0,14,30,30
1650854842312,MATH 142A,A02,083220,Chow; Bennett,0,15,30,30
1650854842312,MATH 142A,B01,083221,Chow; Bennett,0,16,30,30
1650854842312,MATH 142A,B02,083222,Chow; Bennett,0,14,30,30
1650854848335,MATH 193A,A01,083224,Staff,0,6,30,30
1650854848335,MATH 193A,A02,083225,Staff,0,7,30,30
1650854848335,MATH 193A,A03,083781,Staff,0,6,30,30
1650854848335,MATH 193A,A04,083782,Staff,0,7,30,30
1650854854360,MATH 197,001,091859,McAuley; Julian John,9998,0,9999,1
1650854860411,COGS 9,A01,083615,Staff,0,17,60,60
1650854866434,COGS 11,A01,083617,Boyle; Mary E. T.,15,0,40,25
1650854872470,COGS 13,A01,083071,Staff,0,38,40,40
1650854878493,COGS 14A,A01,092681,Staff,0,36,100,100
1650854884517,COGS 14B,A01,083073,Cheng; Tzu-Han,0,12,50,50
1650854890540,COGS 17,A01,092677,Staff,12,0,75,63
1650854896563,COGS 100,A01,083619,Staff,0,30,60,60
1650854902586,COGS 101A,A01,083621,Davis; Joshua Daniel,0,29,60,60
1650854908609,COGS 101B,A01,091572,Staff,0,3,60,60
1650854914635,COGS 101C,A01,083625,Delgado; Tania,14,0,30,16
1650854920692,COGS 107A,A01,083627,Boyle; Mary E. T.,0,16,60,60
1650854926720,COGS 118A,A01,083075,Staff,0,8,60,60
1650854932743,CSE 3,A50,083646,Miranda; Gregory Joseph,18,0,38,20
1650854932743,CSE 3,A51,083647,Miranda; Gregory Joseph,36,0,37,1
1650854938771,CSE 8A,A50,083650,Miranda; Gregory Joseph,0,29,40,40
1650854944795,CSE 11,A01,083080,Cao; Yingjun,0,96,40,40
1650854950818,CSE 12,A01,083652,Staff,0,21,100,100
1650854956843,CSE 15L,A01,083654,Staff,0,3,50,50
1650854956843,CSE 15L,A02,083655,Staff,0,3,50,50
1650854962867,CSE 20,A01,083657,Staff,49,0,80,31
1650854968893,CSE 30,A01,083084,Eldon; John,0,76,40,40
1650854974920,CSE 100,A01,083659,Cao; Yingjun,0,71,50,50
1650854980944,CSE 134B,A01,083661,Powell; Thomas Allan,0,38,65,65
1650854986970,CSE 140,A01,083663,Staff,0,12,75,75
1650854992997,CSE 140L,A01,083088,Eldon; John,0,20,75,75
1650854999020,CSE 175,A01,083665,Kumar; Rakesh,7,0,25,18
1650855005046,CSE 190,A00,092507,Dubnov; Shlomo,10,0,20,10
1650855011072,ECE 45,A01,083139,Staff,0,3,60,60
1650855017098,ECE 65,A50,083695,Staff,0,5,30,30
1650855023128,ECE 109,A01,091882,Touri; Behrouz,32,0,70,38
1650855029159,ECE 180,A00,083140,Abi Samra; Nicholas Camill,20,0,30,10
1650855029159,ECE 180,B00,083141,Abi Samra; Nicholas Camill,0,0,30,30
1650855035186,MATH 10A,A01,083735,Patchell; Gregory David,2,0,30,28
1650855035186,MATH 10A,A02,083736,Patchell; Gregory David,27,0,30,3
1650855035186,MATH 10A,A03,083737,Patchell; Gregory David,24,0,30,6
1650855041211,MATH 10B,A01,083207,Staff,0,9,30,30
1650855041211,MATH 10B,A02,083208,Staff,0,6,30,30
1650855041211,MATH 10B,B01,083739,Staff,10,0,30,20
1650855041211,MATH 10B,B02,083740,Staff,28,0,30,2
1650855047236,MATH 18,A01,083743,Staff,0,0,30,30
1650855047236,MATH 18,A02,083744,Staff,23,0,30,7
1650855047236,MATH 18,A03,083745,Staff,21,0,30,9
1650855047236,MATH 18,A04,083746,Staff,26,0,30,4
1650855047236,MATH 18,B01,083748,Staff,0,15,30,30
1650855047236,MATH 18,B02,083749,Staff,0,13,30,30
1650855047236,MATH 18,B03,083750,Staff,0,13,30,30
1650855047236,MATH 18,B04,083751,Staff,0,13,30,30
1650855053263,MATH 20A,A01,083754,Staff,19,0,40,21
1650855059286,MATH 20B,A01,083756,Staff,0,14,30,30
1650855059286,MATH 20B,A02,083757,Staff,0,12,30,30
1650855065319,MATH 20C,A01,083760,Staff,0,17,30,30
1650855065319,MATH 20C,A02,083761,Staff,0,16,30,30
1650855065319,MATH 20C,B01,083762,Staff,9,0,30,21
1650855065319,MATH 20C,B02,083763,Staff,28,0,30,2
1650855071346,MATH 20D,A01,083765,Staff,2,1,30,28
1650855071346,MATH 20D,A02,083766,Staff,6,0,30,24
1650855071346,MATH 20D,A03,083767,Staff,23,0,30,7
1650855077372,MATH 20E,A01,083771,Staff,2,0,30,28
1650855077372,MATH 20E,A02,083772,Staff,13,0,30,17
1650855077372,MATH 20E,B01,083773,Staff,0,0,30,30
1650855077372,MATH 20E,B02,083774,Staff,4,0,30,26
1650855083396,MATH 103A,A01,083777,Staff,0,16,30,30
1650855083396,MATH 103A,A02,083778,Staff,0,15,30,30
1650855083396,MATH 103A,B01,083779,Staff,0,15,30,30
1650855083396,MATH 103A,B02,083780,Staff,1,15,30,29
1650855089420,MATH 105,A01,085443,Staff,0,22,30,30
1650855095443,MATH 109,A01,083213,Anzaldo; Leesa B,0,7,30,30
1650855095443,MATH 109,A02,083214,Anzaldo; Leesa B,0,7,30,30
1650855095443,MATH 109,B01,083215,Anzaldo; Leesa B,0,8,30,30
1650855095443,MATH 109,B02,083216,Anzaldo; Leesa B,0,7,30,30
1650855101465,MATH 142A,A01,083219,Chow; Bennett,0,14,30,30
1650855101465,MATH 142A,A02,083220,Chow; Bennett,0,15,30,30
1650855101465,MATH 142A,B01,083221,Chow; Bennett,0,16,30,30
1650855101465,MATH 142A,B02,083222,Chow; Bennett,0,14,30,30
1650855107494,MATH 193A,A01,083224,Staff,0,6,30,30
1650855107494,MATH 193A,A02,083225,Staff,0,7,30,30
1650855107494,MATH 193A,A03,083781,Staff,0,6,30,30
1650855107494,MATH 193A,A04,083782,Staff,0,7,30,30
1650855113524,MATH 197,001,091859,McAuley; Julian John,9998,0,9999,1
1650855119582,COGS 9,A01,083615,Staff,0,17,60,60
1650855125610,COGS 11,A01,083617,Boyle; Mary E. T.,15,0,40,25
1650855131632,COGS 13,A01,083071,Staff,0,38,40,40
1650855137654,COGS 14A,A01,092681,Staff,0,36,100,100
1650855143678,COGS 14B,A01,083073,Cheng; Tzu-Han,0,12,50,50
1650855149718,COGS 17,A01,092677,Staff,12,0,75,63
1650855155744,COGS 100,A01,083619,Staff,0,30,60,60
1650855161768,COGS 101A,A01,083621,Davis; Joshua Daniel,0,29,60,60
1650855167790,COGS 101B,A01,091572,Staff,0,3,60,60
1650855173814,COGS 101C,A01,083625,Delgado; Tania,14,0,30,16
1650855179841,COGS 107A,A01,083627,Boyle; Mary E. T.,0,16,60,60
1650855185864,COGS 118A,A01,083075,Staff,0,8,60,60
1650855191893,CSE 3,A50,083646,Miranda; Gregory Joseph,18,0,38,20
1650855191893,CSE 3,A51,083647,Miranda; Gregory Joseph,36,0,37,1
1650855197915,CSE 8A,A50,083650,Miranda; Gregory Joseph,0,29,40,40
1650855203942,CSE 11,A01,083080,Cao; Yingjun,0,96,40,40
1650855209965,CSE 12,A01,083652,Staff,0,21,100,100
1650855215988,CSE 15L,A01,083654,Staff,0,3,50,50
1650855215988,CSE 15L,A02,083655,Staff,0,3,50,50
1650855222019,CSE 20,A01,083657,Staff,49,0,80,31
1650855228044,CSE 30,A01,083084,Eldon; John,0,76,40,40
1650855234067,CSE 100,A01,083659,Cao; Yingjun,0,71,50,50
1650855240094,CSE 134B,A01,083661,Powell; Thomas Allan,0,38,65,65
1650855246120,CSE 140,A01,083663,Staff,0,12,75,75
1650855252143,CSE 140L,A01,083088,Eldon; John,0,20,75,75
1650855258173,CSE 175,A01,083665,Kumar; Rakesh,7,0,25,18
1650855264200,CSE 190,A00,092507,Dubnov; Shlomo,10,0,20,10
1650855270224,ECE 45,A01,083139,Staff,0,3,60,60
1650855276249,ECE 65,A50,083695,Staff,0,5,30,30
1650855282272,ECE 109,A01,091882,Touri; Behrouz,32,0,70,38
1650855288296,ECE 180,A00,083140,Abi Samra; Nicholas Camill,20,0,30,10
1650855288296,ECE 180,B00,083141,Abi Samra; Nicholas Camill,0,0,30,30
1650855294318,MATH 10A,A01,083735,Patchell; Gregory David,2,0,30,28
1650855294318,MATH 10A,A02,083736,Patchell; Gregory David,27,0,30,3
1650855294318,MATH 10A,A03,083737,Patchell; Gregory David,24,0,30,6
1650855300342,MATH 10B,A01,083207,Staff,0,9,30,30
1650855300342,MATH 10B,A02,083208,Staff,0,6,30,30
1650855300342,MATH 10B,B01,083739,Staff,10,0,30,20
1650855300342,MATH 10B,B02,083740,Staff,28,0,30,2
1650855306375,MATH 18,A01,083743,Staff,0,0,30,30
1650855306375,MATH 18,A02,083744,Staff,23,0,30,7
1650855306375,MATH 18,A03,083745,Staff,21,0,30,9
1650855306375,MATH 18,A04,083746,Staff,26,0,30,4
1650855306375,MATH 18,B01,083748,Staff,0,15,30,30
1650855306375,MATH 18,B02,083749,Staff,0,13,30,30
1650855306375,MATH 18,B03,083750,Staff,0,13,30,30
1650855306375,MATH 18,B04,083751,Staff,0,13,30,30
1650855312402,MATH 20A,A01,083754,Staff,19,0,40,21
1650855318427,MATH 20B,A01,083756,Staff,0,14,30,30
1650855318427,MATH 20B,A02,083757,Staff,0,12,30,30
1650855324452,MATH 20C,A01,083760,Staff,0,17,30,30
1650855324452,MATH 20C,A02,083761,Staff,0,16,30,30
1650855324452,MATH 20C,B01,083762,Staff,9,0,30,21
1650855324452,MATH 20C,B02,083763,Staff,28,0,30,2
1650855330487,MATH 20D,A01,083765,Staff,2,1,30,28
1650855330487,MATH 20D,A02,083766,Staff,6,0,30,24
1650855330487,MATH 20D,A03,083767,Staff,23,0,30,7
1650855336514,MATH 20E,A01,083771,Staff,2,0,30,28
1650855336514,MATH 20E,A02,083772,Staff,13,0,30,17
1650855336514,MATH 20E,B01,083773,Staff,0,0,30,30
1650855336514,MATH 20E,B02,083774,Staff,4,0,30,26
1650855342539,MATH 103A,A01,083777,Staff,0,16,30,30
1650855342539,MATH 103A,A02,083778,Staff,0,15,30,30
1650855342539,MATH 103A,B01,083779,Staff,0,15,30,30
1650855342539,MATH 103A,B02,083780,Staff,1,15,30,29
1650855348563,MATH 105,A01,085443,Staff,0,22,30,30
1650855354599,MATH 109,A01,083213,Anzaldo; Leesa B,0,7,30,30
1650855354599,MATH 109,A02,083214,Anzaldo; Leesa B,0,7,30,30
1650855354599,MATH 109,B01,083215,Anzaldo; Leesa B,0,8,30,30
1650855354599,MATH 109,B02,083216,Anzaldo; Leesa B,0,7,30,30
1650855360624,MATH 142A,A01,083219,Chow; Bennett,0,14,30,30
1650855360624,MATH 142A,A02,083220,Chow; Bennett,0,15,30,30
1650855360624,MATH 142A,B01,083221,Chow; Bennett,0,16,30,30
1650855360624,MATH 142A,B02,083222,Chow; Bennett,0,14,30,30
1650855366662,MATH 193A,A01,083224,Staff,0,6,30,30
1650855366662,MATH 193A,A02,083225,Staff,0,7,30,30
1650855366662,MATH 193A,A03,083781,Staff,0,6,30,30
1650855366662,MATH 193A,A04,083782,Staff,0,7,30,30
1650855372688,MATH 197,001,091859,McAuley; Julian John,9998,0,9999,1
1650855378836,COGS 9,A01,083615,Staff,0,17,60,60
1650855384863,COGS 11,A01,083617,Boyle; Mary E. T.,15,0,40,25
1650855393979,COGS 13,A01,083071,Staff,0,38,40,40
1650855400005,COGS 14A,A01,092681,Staff,0,36,100,100
1650855406031,COGS 14B,A01,083073,Cheng; Tzu-Han,0,12,50,50
1650855412057,COGS 17,A01,092677,Staff,12,0,75,63
1650855418084,COGS 100,A01,083619,Staff,0,30,60,60
1650855424118,COGS 101A,A01,083621,Davis; Joshua Daniel,0,29,60,60
1650855430149,COGS 101B,A01,091572,Staff,0,3,60,60
1650855436174,COGS 101C,A01,083625,Delgado; Tania,14,0,30,16
1650855442199,COGS 107A,A01,083627,Boyle; Mary E. T.,0,16,60,60
1650855448223,COGS 118A,A01,083075,Staff,0,8,60,60
1650855454246,CSE 3,A50,083646,Miranda; Gregory Joseph,18,0,38,20
1650855454246,CSE 3,A51,083647,Miranda; Gregory Joseph,36,0,37,1
1650855460274,CSE 8A,A50,083650,Miranda; Gregory Joseph,0,29,40,40
1650855466298,CSE 11,A01,083080,Cao; Yingjun,0,96,40,40
1650855472320,CSE 12,A01,083652,Staff,0,21,100,100
1650855478343,CSE 15L,A01,083654,Staff,0,3,50,50
1650855478343,CSE 15L,A02,083655,Staff,0,3,50,50
1650855484366,CSE 20,A01,083657,Staff,49,0,80,31
1650855490392,CSE 30,A01,083084,Eldon; John,0,76,40,40
1650855496423,CSE 100,A01,083659,Cao; Yingjun,0,71,50,50
1650855502446,CSE 134B,A01,083661,Powell; Thomas Allan,0,38,65,65
1650855508471,CSE 140,A01,083663,Staff,0,12,75,75
1650855514494,CSE 140L,A01,083088,Eldon; John,0,20,75,75
1650855520520,CSE 175,A01,083665,Kumar; Rakesh,7,0,25,18
1650855526545,CSE 190,A00,092507,Dubnov; Shlomo,10,0,20,10
1650855532575,ECE 45,A01,083139,Staff,0,3,60,60
1650855538602,ECE 65,A50,083695,Staff,0,5,30,30
1650855544629,ECE 109,A01,091882,Touri; Behrouz,32,0,70,38
1650855550656,ECE 180,A00,083140,Abi Samra; Nicholas Camill,20,0,30,10
1650855550656,ECE 180,B00,083141,Abi Samra; Nicholas Camill,0,0,30,30
1650855556681,MATH 10A,A01,083735,Patchell; Gregory David,2,0,30,28
1650855556681,MATH 10A,A02,083736,Patchell; Gregory David,27,0,30,3
1650855556681,MATH 10A,A03,083737,Patchell; Gregory David,24,0,30,6
1650855562705,MATH 10B,A01,083207,Staff,0,9,30,30
1650855562705,MATH 10B,A02,083208,Staff,0,6,30,30
1650855562705,MATH 10B,B01,083739,Staff,10,0,30,20
1650855562705,MATH 10B,B02,083740,Staff,28,0,30,2
1650855568736,MATH 18,A01,083743,Staff,0,0,30,30
1650855568736,MATH 18,A02,083744,Staff,23,0,30,7
1650855568736,MATH 18,A03,083745,Staff,21,0,30,9
1650855568736,MATH 18,A04,083746,Staff,26,0,30,4
1650855568736,MATH 18,B01,083748,Staff,0,15,30,30
1650855568736,MATH 18,B02,083749,Staff,0,13,30,30
1650855568736,MATH 18,B03,083750,Staff,0,13,30,30
1650855568736,MATH 18,B04,083751,Staff,0,13,30,30
1650855574760,MATH 20A,A01,083754,Staff,19,0,40,21
1650855580782,MATH 20B,A01,083756,Staff,0,14,30,30
1650855580782,MATH 20B,A02,083757,Staff,0,12,30,30
1650855586808,MATH 20C,A01,083760,Staff,0,17,30,30
1650855586808,MATH 20C,A02,083761,Staff,0,16,30,30
1650855586808,MATH 20C,B01,083762,Staff,9,0,30,21
1650855586808,MATH 20C,B02,083763,Staff,28,0,30,2
1650855592831,MATH 20D,A01,083765,Staff,2,1,30,28
1650855592831,MATH 20D,A02,083766,Staff,6,0,30,24
1650855592831,MATH 20D,A03,083767,Staff,23,0,30,7
1650855598854,MATH 20E,A01,083771,Staff,2,0,30,28
1650855598854,MATH 20E,A02,083772,Staff,13,0,30,17
1650855598854,MATH 20E,B01,083773,Staff,0,0,30,30
1650855598854,MATH 20E,B02,083774,Staff,4,0,30,26
1650855604881,MATH 103A,A01,083777,Staff,0,16,30,30
1650855604881,MATH 103A,A02,083778,Staff,0,15,30,30
1650855604881,MATH 103A,B01,083779,Staff,0,15,30,30
1650855604881,MATH 103A,B02,083780,Staff,1,15,30,29
1650855610907,MATH 105,A01,085443,Staff,0,22,30,30
1650855616933,MATH 109,A01,083213,Anzaldo; Leesa B,0,7,30,30
1650855616933,MATH 109,A02,083214,Anzaldo; Leesa B,0,7,30,30
1650855616933,MATH 109,B01,083215,Anzaldo; Leesa B,0,8,30,30
1650855616933,MATH 109,B02,083216,Anzaldo; Leesa B,0,7,30,30
1650855622961,MATH 142A,A01,083219,Chow; Bennett,0,14,30,30
1650855622961,MATH 142A,A02,083220,Chow; Bennett,0,15,30,30
1650855622961,MATH 142A,B01,083221,Chow; Bennett,0,16,30,30
1650855622961,MATH 142A,B02,083222,Chow; Bennett,0,14,30,30
1650855628988,MATH 193A,A01,083224,Staff,0,6,30,30
1650855628988,MATH 193A,A02,083225,Staff,0,7,30,30
1650855628988,MATH 193A,A03,083781,Staff,0,6,30,30
1650855628988,MATH 193A,A04,083782,Staff,0,7,30,30
1650855635012,MATH 197,001,091859,McAuley; Julian John,9998,0,9999,1
1650855641069,COGS 9,A01,083615,Staff,0,17,60,60
1650855647095,COGS 11,A01,083617,Boyle; Mary E. T.,15,0,40,25
1650855653119,COGS 13,A01,083071,Staff,0,38,40,40
1650855659144,COGS 14A,A01,092681,Staff,0,36,100,100
1650855665171,COGS 14B,A01,083073,Cheng; Tzu-Han,0,12,50,50
1650855671199,COGS 17,A01,092677,Staff,12,0,75,63
1650855677225,COGS 100,A01,083619,Staff,0,30,60,60
1650855683248,COGS 101A,A01,083621,Davis; Joshua Daniel,0,29,60,60
1650855689278,COGS 101B,A01,091572,Staff,0,3,60,60
1650855695301,COGS 101C,A01,083625,Delgado; Tania,14,0,30,16
1650855701325,COGS 107A,A01,083627,Boyle; Mary E. T.,0,16,60,60
1650855707347,COGS 118A,A01,083075,Staff,0,8,60,60
1650855713386,CSE 3,A50,083646,Miranda; Gregory Joseph,18,0,38,20
1650855713386,CSE 3,A51,083647,Miranda; Gregory Joseph,36,0,37,1
1650855719410,CSE 8A,A50,083650,Miranda; Gregory Joseph,0,29,40,40
1650855725435,CSE 11,A01,083080,Cao; Yingjun,0,96,40,40
1650855731458,CSE 12,A01,083652,Staff,0,21,100,100
1650855737482,CSE 15L,A01,083654,Staff,0,3,50,50
1650855737482,CSE 15L,A02,083655,Staff,0,3,50,50
1650855743512,CSE 20,A01,083657,Staff,49,0,80,31
1650855749536,CSE 30,A01,083084,Eldon; John,0,76,40,40
1650855755558,CSE 100,A01,083659,Cao; Yingjun,0,71,50,50
1650855761580,CSE 134B,A01,083661,Powell; Thomas Allan,0,38,65,65
1650855767604,CSE 140,A01,083663,Staff,0,12,75,75
1650855773627,CSE 140L,A01,083088,Eldon; John,0,20,75,75
1650855779651,CSE 175,A01,083665,Kumar; Rakesh,7,0,25,18
1650855785673,CSE 190,A00,092507,Dubnov; Shlomo,10,0,20,10
1650855791702,ECE 45,A01,083139,Staff,0,3,60,60
1650855797725,ECE 65,A50,083695,Staff,0,5,30,30
1650855803751,ECE 109,A01,091882,Touri; Behrouz,32,0,70,38
1650855809776,ECE 180,A00,083140,Abi Samra; Nicholas Camill,20,0,30,10
1650855809776,ECE 180,B00,083141,Abi Samra; Nicholas Camill,0,0,30,30
1650855815802,MATH 10A,A01,083735,Patchell; Gregory David,2,0,30,28
1650855815802,MATH 10A,A02,083736,Patchell; Gregory David,27,0,30,3
1650855815802,MATH 10A,A03,083737,Patchell; Gregory David,24,0,30,6
1650855821825,MATH 10B,A01,083207,Staff,0,9,30,30
1650855821825,MATH 10B,A02,083208,Staff,0,6,30,30
1650855821825,MATH 10B,B01,083739,Staff,10,0,30,20
1650855821825,MATH 10B,B02,083740,Staff,28,0,30,2
1650855827854,MATH 18,A01,083743,Staff,0,0,30,30
1650855827854,MATH 18,A02,083744,Staff,23,0,30,7
1650855827854,MATH 18,A03,083745,Staff,21,0,30,9
1650855827854,MATH 18,A04,083746,Staff,26,0,30,4
1650855827854,MATH 18,B01,083748,Staff,0,15,30,30
1650855827854,MATH 18,B02,083749,Staff,0,13,30,30
1650855827854,MATH 18,B03,083750,Staff,0,13,30,30
1650855827854,MATH 18,B04,083751,Staff,0,13,30,30
1650855833883,MATH 20A,A01,083754,Staff,19,0,40,21
1650855839908,MATH 20B,A01,083756,Staff,0,14,30,30
1650855839908,MATH 20B,A02,083757,Staff,0,12,30,30
1650855845936,MATH 20C,A01,083760,Staff,0,17,30,30
1650855845936,MATH 20C,A02,083761,Staff,0,16,30,30
1650855845936,MATH 20C,B01,083762,Staff,9,0,30,21
1650855845936,MATH 20C,B02,083763,Staff,28,0,30,2
1650855851960,MATH 20D,A01,083765,Staff,2,1,30,28
1650855851960,MATH 20D,A02,083766,Staff,6,0,30,24
1650855851960,MATH 20D,A03,083767,Staff,23,0,30,7
1650855857983,MATH 20E,A01,083771,Staff,2,0,30,28
1650855857983,MATH 20E,A02,083772,Staff,13,0,30,17
1650855857983,MATH 20E,B01,083773,Staff,0,0,30,30
1650855857983,MATH 20E,B02,083774,Staff,4,0,30,26
1650855864007,MATH 103A,A01,083777,Staff,0,16,30,30
1650855864007,MATH 103A,A02,083778,Staff,0,15,30,30
1650855864007,MATH 103A,B01,083779,Staff,0,15,30,30
1650855864007,MATH 103A,B02,083780,Staff,1,15,30,29
1650855870030,MATH 105,A01,085443,Staff,0,22,30,30
1650855876054,MATH 109,A01,083213,Anzaldo; Leesa B,0,7,30,30
1650855876054,MATH 109,A02,083214,Anzaldo; Leesa B,0,7,30,30
1650855876054,MATH 109,B01,083215,Anzaldo; Leesa B,0,8,30,30
1650855876054,MATH 109,B02,083216,Anzaldo; Leesa B,0,7,30,30
1650855882078,MATH 142A,A01,083219,Chow; Bennett,0,14,30,30
1650855882078,MATH 142A,A02,083220,Chow; Bennett,0,15,30,30
1650855882078,MATH 142A,B01,083221,Chow; Bennett,0,16,30,30
1650855882078,MATH 142A,B02,083222,Chow; Bennett,0,14,30,30
1650855888105,MATH 193A,A01,083224,Staff,0,6,30,30
1650855888105,MATH 193A,A02,083225,Staff,0,7,30,30
1650855888105,MATH 193A,A03,083781,Staff,0,6,30,30
1650855888105,MATH 193A,A04,083782,Staff,0,7,30,30
1650855894130,MATH 197,001,091859,McAuley; Julian John,9998,0,9999,1
1650855900179,COGS 9,A01,083615,Staff,0,17,60,60
1650855906203,COGS 11,A01,083617,Boyle; Mary E. T.,15,0,40,25
1650855912233,COGS 13,A01,083071,Staff,0,38,40,40
1650855918258,COGS 14A,A01,092681,Staff,0,36,100,100
1650855924285,COGS 14B,A01,083073,Cheng; Tzu-Han,0,12,50,50
1650855930309,COGS 17,A01,092677,Staff,12,0,75,63
1650855936333,COGS 100,A01,083619,Staff,0,30,60,60
1650855942372,COGS 101A,A01,083621,Davis; Joshua Daniel,0,29,60,60
1650855948395,COGS 101B,A01,091572,Staff,0,3,60,60
1650855954418,COGS 101C,A01,083625,Delgado; Tania,14,0,30,16
1650855960445,COGS 107A,A01,083627,Boyle; Mary E. T.,0,16,60,60
1650855966468,COGS 118A,A01,083075,Staff,0,8,60,60
1650855972596,CSE 3,A50,083646,Miranda; Gregory Joseph,18,0,38,20
1650855972596,CSE 3,A51,083647,Miranda; Gregory Joseph,36,0,37,1
1650855978620,CSE 8A,A50,083650,Miranda; Gregory Joseph,0,29,40,40
1650855984643,CSE 11,A01,083080,Cao; Yingjun,0,96,40,40
1650855990668,CSE 12,A01,083652,Staff,0,21,100,100
1650855996693,CSE 15L,A01,083654,Staff,0,3,50,50
1650855996693,CSE 15L,A02,083655,Staff,0,3,50,50
1650856002716,CSE 20,A01,083657,Staff,49,0,80,31
1650856008740,CSE 30,A01,083084,Eldon; John,0,76,40,40
1650856014762,CSE 100,A01,083659,Cao; Yingjun,0,71,50,50
1650856020794,CSE 134B,A01,083661,Powell; Thomas Allan,0,38,65,65
1650856026825,CSE 140,A01,083663,Staff,0,12,75,75
1650856032852,CSE 140L,A01,083088,Eldon; John,0,20,75,75
1650856038878,CSE 175,A01,083665,Kumar; Rakesh,7,0,25,18
1650856044917,CSE 190,A00,092507,Dubnov; Shlomo,10,0,20,10
1650856050943,ECE 45,A01,083139,Staff,0,3,60,60
1650856056966,ECE 65,A50,083695,Staff,0,5,30,30
1650856062990,ECE 109,A01,091882,Touri; Behrouz,32,0,70,38
1650856069015,ECE 180,A00,083140,Abi Samra; Nicholas Camill,20,0,30,10
1650856069015,ECE 180,B00,083141,Abi Samra; Nicholas Camill,0,0,30,30
1650856075045,MATH 10A,A01,083735,Patchell; Gregory David,2,0,30,28
1650856075045,MATH 10A,A02,083736,Patchell; Gregory David,27,0,30,3
1650856075045,MATH 10A,A03,083737,Patchell; Gregory David,24,0,30,6
1650856081073,MATH 10B,A01,083207,Staff,0,9,30,30
1650856081073,MATH 10B,A02,083208,Staff,0,6,30,30
1650856081073,MATH 10B,B01,083739,Staff,10,0,30,20
1650856081073,MATH 10B,B02,083740,Staff,28,0,30,2
1650856087098,MATH 18,A01,083743,Staff,0,0,30,30
1650856087098,MATH 18,A02,083744,Staff,23,0,30,7
1650856087098,MATH 18,A03,083745,Staff,21,0,30,9
1650856087098,MATH 18,A04,083746,Staff,26,0,30,4
1650856087098,MATH 18,B01,083748,Staff,0,15,30,30
1650856087098,MATH 18,B02,083749,Staff,0,13,30,30
1650856087098,MATH 18,B03,083750,Staff,0,13,30,30
1650856087098,MATH 18,B04,083751,Staff,0,13,30,30
1650856093122,MATH 20A,A01,083754,Staff,19,0,40,21
1650856099146,MATH 20B,A01,083756,Staff,0,14,30,30
1650856099146,MATH 20B,A02,083757,Staff,0,12,30,30
1650856105173,MATH 20C,A01,083760,Staff,0,17,30,30
1650856105173,MATH 20C,A02,083761,Staff,0,16,30,30
1650856105173,MATH 20C,B01,083762,Staff,9,0,30,21
1650856105173,MATH 20C,B02,083763,Staff,28,0,30,2
1650856111197,MATH 20D,A01,083765,Staff,2,1,30,28
1650856111197,MATH 20D,A02,083766,Staff,6,0,30,24
1650856111197,MATH 20D,A03,083767,Staff,23,0,30,7
1650856117220,MATH 20E,A01,083771,Staff,2,0,30,28
1650856117220,MATH 20E,A02,083772,Staff,13,0,30,17
1650856117220,MATH 20E,B01,083773,Staff,0,0,30,30
1650856117220,MATH 20E,B02,083774,Staff,4,0,30,26
1650856123245,MATH 103A,A01,083777,Staff,0,16,30,30
1650856123245,MATH 103A,A02,083778,Staff,0,15,30,30
1650856123245,MATH 103A,B01,083779,Staff,0,15,30,30
1650856123245,MATH 103A,B02,083780,Staff,1,15,30,29
1650856129267,MATH 105,A01,085443,Staff,0,22,30,30
1650856135295,MATH 109,A01,083213,Anzaldo; Leesa B,0,7,30,30
1650856135295,MATH 109,A02,083214,Anzaldo; Leesa B,0,7,30,30
1650856135295,MATH 109,B01,083215,Anzaldo; Leesa B,0,8,30,30
1650856135295,MATH 109,B02,083216,Anzaldo; Leesa B,0,7,30,30
1650856141319,MATH 142A,A01,083219,Chow; Bennett,0,14,30,30
1650856141319,MATH 142A,A02,083220,Chow; Bennett,0,15,30,30
1650856141319,MATH 142A,B01,083221,Chow; Bennett,0,16,30,30
1650856141319,MATH 142A,B02,083222,Chow; Bennett,0,14,30,30
1650856147346,MATH 193A,A01,083224,Staff,0,6,30,30
1650856147346,MATH 193A,A02,083225,Staff,0,7,30,30
1650856147346,MATH 193A,A03,083781,Staff,0,6,30,30
1650856147346,MATH 193A,A04,083782,Staff,0,7,30,30
1650856153370,MATH 197,001,091859,McAuley; Julian John,9998,0,9999,1
1650856159428,COGS 9,A01,083615,Staff,0,17,60,60
1650856165454,COGS 11,A01,083617,Boyle; Mary E. T.,15,0,40,25
1650856171477,COGS 13,A01,083071,Staff,0,38,40,40
1650856177503,COGS 14A,A01,092681,Staff,0,36,100,100
1650856183527,COGS 14B,A01,083073,Cheng; Tzu-Han,0,12,50,50
1650856189551,COGS 17,A01,092677,Staff,12,0,75,63
1650856195577,COGS 100,A01,083619,Staff,0,30,60,60
1650856201600,COGS 101A,A01,083621,Davis; Joshua Daniel,0,29,60,60
1650856207628,COGS 101B,A01,091572,Staff,0,3,60,60
1650856213655,COGS 101C,A01,083625,Delgado; Tania,14,0,30,16
1650856219679,COGS 107A,A01,083627,Boyle; Mary E. T.,0,16,60,60
1650856225703,COGS 118A,A01,083075,Staff,0,8,60,60
1650856231727,CSE 3,A50,083646,Miranda; Gregory Joseph,18,0,38,20
1650856231727,CSE 3,A51,083647,Miranda; Gregory Joseph,36,0,37,1
1650856237750,CSE 8A,A50,083650,Miranda; Gregory Joseph,0,29,40,40
1650856243777,CSE 11,A01,083080,Cao; Yingjun,0,96,40,40
1650856249800,CSE 12,A01,083652,Staff,0,21,100,100
1650856255826,CSE 15L,A01,083654,Staff,0,3,50,50
1650856255826,CSE 15L,A02,083655,Staff,0,3,50,50
1650856261851,CSE 20,A01,083657,Staff,49,0,80,31
1650856267876,CSE 30,A01,083084,Eldon; John,0,76,40,40
1650856273899,CSE 100,A01,083659,Cao; Yingjun,0,71,50,50
1650856279923,CSE 134B,A01,083661,Powell; Thomas Allan,0,38,65,65
1650856285944,CSE 140,A01,083663,Staff,0,12,75,75
1650856291971,CSE 140L,A01,083088,Eldon; John,0,20,75,75
1650856297993,CSE 175,A01,083665,Kumar; Rakesh,7,0,25,18
1650856304018,CSE 190,A00,092507,Dubnov; Shlomo,10,0,20,10
1650856310042,ECE 45,A01,083139,Staff,0,3,60,60
1650856316077,ECE 65,A50,083695,Staff,0,5,30,30
1650856322104,ECE 109,A01,091882,Touri; Behrouz,32,0,70,38
1650856328131,ECE 180,A00,083140,Abi Samra; Nicholas Camill,20,0,30,10
1650856328131,ECE 180,B00,083141,Abi Samra; Nicholas Camill,0,0,30,30
1650856334157,MATH 10A,A01,083735,Patchell; Gregory David,2,0,30,28
1650856334157,MATH 10A,A02,083736,Patchell; Gregory David,27,0,30,3
1650856334157,MATH 10A,A03,083737,Patchell; Gregory David,24,0,30,6
1650856340181,MATH 10B,A01,083207,Staff,0,9,30,30
1650856340181,MATH 10B,A02,083208,Staff,0,6,30,30
1650856340181,MATH 10B,B01,083739,Staff,10,0,30,20
1650856340181,MATH 10B,B02,083740,Staff,28,0,30,2
1650856346203,MATH 18,A01,083743,Staff,0,0,30,30
1650856346203,MATH 18,A02,083744,Staff,23,0,30,7
1650856346203,MATH 18,A03,083745,Staff,21,0,30,9
1650856346203,MATH 18,A04,083746,Staff,26,0,30,4
1650856346203,MATH 18,B01,083748,Staff,0,15,30,30
1650856346203,MATH 18,B02,083749,Staff,0,13,30,30
1650856346203,MATH 18,B03,083750,Staff,0,13,30,30
1650856346203,MATH 18,B04,083751,Staff,0,13,30,30
1650856352226,MATH 20A,A01,083754,Staff,19,0,40,21
1650856358249,MATH 20B,A01,083756,Staff,0,14,30,30
1650856358249,MATH 20B,A02,083757,Staff,0,12,30,30
1650856364276,MATH 20C,A01,083760,Staff,0,17,30,30
1650856364276,MATH 20C,A02,083761,Staff,0,16,30,30
1650856364276,MATH 20C,B01,083762,Staff,9,0,30,21
1650856364276,MATH 20C,B02,083763,Staff,28,0,30,2
1650856370300,MATH 20D,A01,083765,Staff,2,1,30,28
1650856370300,MATH 20D,A02,083766,Staff,6,0,30,24
1650856370300,MATH 20D,A03,083767,Staff,23,0,30,7
1650856376325,MATH 20E,A01,083771,Staff,2,0,30,28
1650856376325,MATH 20E,A02,083772,Staff,13,0,30,17
1650856376325,MATH 20E,B01,083773,Staff,0,0,30,30
1650856376325,MATH 20E,B02,083774,Staff,4,0,30,26
1650856382355,MATH 103A,A01,083777,Staff,0,16,30,30
1650856382355,MATH 103A,A02,083778,Staff,0,15,30,30
1650856382355,MATH 103A,B01,083779,Staff,0,15,30,30
1650856382355,MATH 103A,B02,083780,Staff,1,15,30,29
1650856388379,MATH 105,A01,085443,Staff,0,22,30,30
1650856394407,MATH 109,A01,083213,Anzaldo; Leesa B,0,7,30,30
1650856394407,MATH 109,A02,083214,Anzaldo; Leesa B,0,7,30,30
1650856394407,MATH 109,B01,083215,Anzaldo; Leesa B,0,8,30,30
1650856394407,MATH 109,B02,083216,Anzaldo; Leesa B,0,7,30,30
1650856400436,MATH 142A,A01,083219,Chow; Bennett,0,14,30,30
1650856400436,MATH 142A,A02,083220,Chow; Bennett,0,15,30,30
1650856400436,MATH 142A,B01,083221,Chow; Bennett,0,16,30,30
1650856400436,MATH 142A,B02,083222,Chow; Bennett,0,14,30,30
1650856406460,MATH 193A,A01,083224,Staff,0,6,30,30
1650856406460,MATH 193A,A02,083225,Staff,0,7,30,30
1650856406460,MATH 193A,A03,083781,Staff,0,6,30,30
1650856406460,MATH 193A,A04,083782,Staff,0,7,30,30
1650856412482,MATH 197,001,091859,McAuley; Julian John,9998,0,9999,1
1650856418540,COGS 9,A01,083615,Staff,0,17,60,60
1650856424562,COGS 11,A01,083617,Boyle; Mary E. T.,15,0,40,25
1650856430586,COGS 13,A01,083071,Staff,0,38,40,40
1650856436610,COGS 14A,A01,092681,Staff,0,36,100,100
1650856442633,COGS 14B,A01,083073,Cheng; Tzu-Han,0,12,50,50
1650856448665,COGS 17,A01,092677,Staff,12,0,75,63
1650856454689,COGS 100,A01,083619,Staff,0,30,60,60
1650856460715,COGS 101A,A01,083621,Davis; Joshua Daniel,0,29,60,60
1650856466738,COGS 101B,A01,091572,Staff,0,3,60,60
1650856472761,COGS 101C,A01,083625,Delgado; Tania,14,0,30,16
1650856478796,COGS 107A,A01,083627,Boyle; Mary E. T.,0,16,60,60
1650856484835,COGS 118A,A01,083075,Staff,0,8,60,60
1650856490863,CSE 3,A50,083646,Miranda; Gregory Joseph,18,0,38,20
1650856490863,CSE 3,A51,083647,Miranda; Gregory Joseph,36,0,37,1
1650856496886,CSE 8A,A50,083650,Miranda; Gregory Joseph,0,29,40,40
1650856502914,CSE 11,A01,083080,Cao; Yingjun,0,96,40,40
1650856508938,CSE 12,A01,083652,Staff,0,21,100,100
1650856514965,CSE 15L,A01,083654,Staff,0,3,50,50
1650856514965,CSE 15L,A02,083655,Staff,0,3,50,50
1650856520989,CSE 20,A01,083657,Staff,49,0,80,31
1650856527013,CSE 30,A01,083084,Eldon; John,0,76,40,40
1650856533041,CSE 100,A01,083659,Cao; Yingjun,0,71,50,50
1650856539066,CSE 134B,A01,083661,Powell; Thomas Allan,0,38,65,65
1650856545089,CSE 140,A01,083663,Staff,0,12,75,75
1650856551112,CSE 140L,A01,083088,Eldon; John,0,20,75,75
1650856557138,CSE 175,A01,083665,Kumar; Rakesh,7,0,25,18
1650856563160,CSE 190,A00,092507,Dubnov; Shlomo,10,0,20,10
1650856569257,ECE 45,A01,083139,Staff,0,3,60,60
1650856575288,ECE 65,A50,083695,Staff,0,5,30,30
1650856581312,ECE 109,A01,091882,Touri; Behrouz,32,0,70,38
1650856587352,ECE 180,A00,083140,Abi Samra; Nicholas Camill,20,0,30,10
1650856587352,ECE 180,B00,083141,Abi Samra; Nicholas Camill,0,0,30,30
1650856593379,MATH 10A,A01,083735,Patchell; Gregory David,2,0,30,28
1650856593379,MATH 10A,A02,083736,Patchell; Gregory David,27,0,30,3
1650856593379,MATH 10A,A03,083737,Patchell; Gregory David,24,0,30,6
1650856599410,MATH 10B,A01,083207,Staff,0,9,30,30
1650856599410,MATH 10B,A02,083208,Staff,0,6,30,30
1650856599410,MATH 10B,B01,083739,Staff,10,0,30,20
1650856599410,MATH 10B,B02,083740,Staff,28,0,30,2
1650856605435,MATH 18,A01,083743,Staff,0,0,30,30
1650856605435,MATH 18,A02,083744,Staff,23,0,30,7
1650856605435,MATH 18,A03,083745,Staff,21,0,30,9
1650856605435,MATH 18,A04,083746,Staff,26,0,30,4
1650856605435,MATH 18,B01,083748,Staff,0,15,30,30
1650856605435,MATH 18,B02,083749,Staff,0,13,30,30
1650856605435,MATH 18,B03,083750,Staff,0,13,30,30
1650856605435,MATH 18,B04,083751,Staff,0,13,30,30
1650856611458,MATH 20A,A01,083754,Staff,19,0,40,21
1650856617492,MATH 20B,A01,083756,Staff,0,14,30,30
1650856617492,MATH 20B,A02,083757,Staff,0,12,30,30
1650856623515,MATH 20C,A01,083760,Staff,0,17,30,30
1650856623515,MATH 20C,A02,083761,Staff,0,16,30,30
1650856623515,MATH 20C,B01,083762,Staff,9,0,30,21
1650856623515,MATH 20C,B02,083763,Staff,28,0,30,2
1650856629542,MATH 20D,A01,083765,Staff,2,1,30,28
1650856629542,MATH 20D,A02,083766,Staff,6,0,30,24
1650856629542,MATH 20D,A03,083767,Staff,23,0,30,7
1650856635570,MATH 20E,A01,083771,Staff,2,0,30,28
1650856635570,MATH 20E,A02,083772,Staff,13,0,30,17
1650856635570,MATH 20E,B01,083773,Staff,0,0,30,30
1650856635570,MATH 20E,B02,083774,Staff,4,0,30,26
1650856641591,MATH 103A,A01,083777,Staff,0,16,30,30
1650856641591,MATH 103A,A02,083778,Staff,0,15,30,30
1650856641591,MATH 103A,B01,083779,Staff,0,15,30,30
1650856641591,MATH 103A,B02,083780,Staff,1,15,30,29
1650856647615,MATH 105,A01,085443,Staff,0,22,30,30
1650856653639,MATH 109,A01,083213,Anzaldo; Leesa B,0,7,30,30
1650856653639,MATH 109,A02,083214,Anzaldo; Leesa B,0,7,30,30
1650856653639,MATH 109,B01,083215,Anzaldo; Leesa B,0,8,30,30
1650856653639,MATH 109,B02,083216,Anzaldo; Leesa B,0,7,30,30
1650856659663,MATH 142A,A01,083219,Chow; Bennett,0,14,30,30
1650856659663,MATH 142A,A02,083220,Chow; Bennett,0,15,30,30
1650856659663,MATH 142A,B01,083221,Chow; Bennett,0,16,30,30
1650856659663,MATH 142A,B02,083222,Chow; Bennett,0,14,30,30
1650856665686,MATH 193A,A01,083224,Staff,0,6,30,30
1650856665686,MATH 193A,A02,083225,Staff,0,7,30,30
1650856665686,MATH 193A,A03,083781,Staff,0,6,30,30
1650856665686,MATH 193A,A04,083782,Staff,0,7,30,30
1650856671708,MATH 197,001,091859,McAuley; Julian John,9998,0,9999,1
1650856677767,COGS 9,A01,083615,Staff,0,17,60,60
1650856683789,COGS 11,A01,083617,Boyle; Mary E. T.,15,0,40,25
1650856689816,COGS 13,A01,083071,Staff,0,38,40,40
1650856695838,COGS 14A,A01,092681,Staff,0,36,100,100
1650856701864,COGS 14B,A01,083073,Cheng; Tzu-Han,0,12,50,50
1650856707888,COGS 17,A01,092677,Staff,12,0,75,63
1650856713913,COGS 100,A01,083619,Staff,0,30,60,60
1650856719950,COGS 101A,A01,083621,Davis; Joshua Daniel,0,29,60,60
1650856725974,COGS 101B,A01,091572,Staff,0,3,60,60
1650856731996,COGS 101C,A01,083625,Delgado; Tania,14,0,30,16
1650856738019,COGS 107A,A01,083627,Boyle; Mary E. T.,0,16,60,60
1650856744048,COGS 118A,A01,083075,Staff,0,8,60,60
1650856750093,CSE 3,A50,083646,Miranda; Gregory Joseph,18,0,38,20
1650856750093,CSE 3,A51,083647,Miranda; Gregory Joseph,36,0,37,1
1650856756118,CSE 8A,A50,083650,Miranda; Gregory Joseph,0,29,40,40
1650856762148,CSE 11,A01,083080,Cao; Yingjun,0,96,40,40
1650856768173,CSE 12,A01,083652,Staff,0,21,100,100
1650856774195,CSE 15L,A01,083654,Staff,0,3,50,50
1650856774195,CSE 15L,A02,083655,Staff,0,3,50,50
1650856780226,CSE 20,A01,083657,Staff,49,0,80,31
1650856786258,CSE 30,A01,083084,Eldon; John,0,76,40,40
1650856792283,CSE 100,A01,083659,Cao; Yingjun,0,71,50,50
1650856798314,CSE 134B,A01,083661,Powell; Thomas Allan,0,38,65,65
1650856804336,CSE 140,A01,083663,Staff,0,12,75,75
1650856810359,CSE 140L,A01,083088,Eldon; John,0,20,75,75
1650856816380,CSE 175,A01,083665,Kumar; Rakesh,7,0,25,18
1650856822406,CSE 190,A00,092507,Dubnov; Shlomo,10,0,20,10
1650856828434,ECE 45,A01,083139,Staff,0,4,60,60
1650856834460,ECE 65,A50,083695,Staff,0,5,30,30
1650856840486,ECE 109,A01,091882,Touri; Behrouz,32,0,70,38
1650856846508,ECE 180,A00,083140,Abi Samra; Nicholas Camill,20,0,30,10
1650856846508,ECE 180,B00,083141,Abi Samra; Nicholas Camill,0,0,30,30
1650856852532,MATH 10A,A01,083735,Patchell; Gregory David,2,0,30,28
1650856852532,MATH 10A,A02,083736,Patchell; Gregory David,27,0,30,3
1650856852532,MATH 10A,A03,083737,Patchell; Gregory David,24,0,30,6
1650856858554,MATH 10B,A01,083207,Staff,0,9,30,30
1650856858554,MATH 10B,A02,083208,Staff,0,6,30,30
1650856858554,MATH 10B,B01,083739,Staff,10,0,30,20
1650856858554,MATH 10B,B02,083740,Staff,28,0,30,2
1650856864589,MATH 18,A01,083743,Staff,0,0,30,30
1650856864589,MATH 18,A02,083744,Staff,23,0,30,7
1650856864589,MATH 18,A03,083745,Staff,21,0,30,9
1650856864589,MATH 18,A04,083746,Staff,26,0,30,4
1650856864589,MATH 18,B01,083748,Staff,0,15,30,30
1650856864589,MATH 18,B02,083749,Staff,0,13,30,30
1650856864589,MATH 18,B03,083750,Staff,0,13,30,30
1650856864589,MATH 18,B04,083751,Staff,0,13,30,30
1650856870613,MATH 20A,A01,083754,Staff,19,0,40,21
1650856876639,MATH 20B,A01,083756,Staff,0,14,30,30
1650856876639,MATH 20B,A02,083757,Staff,0,12,30,30
1650856882664,MATH 20C,A01,083760,Staff,0,17,30,30
1650856882664,MATH 20C,A02,083761,Staff,0,16,30,30
1650856882664,MATH 20C,B01,083762,Staff,9,0,30,21
1650856882664,MATH 20C,B02,083763,Staff,28,0,30,2
1650856888689,MATH 20D,A01,083765,Staff,2,1,30,28
1650856888689,MATH 20D,A02,083766,Staff,6,0,30,24
1650856888689,MATH 20D,A03,083767,Staff,23,0,30,7
1650856894716,MATH 20E,A01,083771,Staff,2,0,30,28
1650856894716,MATH 20E,A02,083772,Staff,13,0,30,17
1650856894716,MATH 20E,B01,083773,Staff,0,0,30,30
1650856894716,MATH 20E,B02,083774,Staff,4,0,30,26
1650856900750,MATH 103A,A01,083777,Staff,0,16,30,30
1650856900750,MATH 103A,A02,083778,Staff,0,15,30,30
1650856900750,MATH 103A,B01,083779,Staff,0,15,30,30
1650856900750,MATH 103A,B02,083780,Staff,1,15,30,29
1650856906773,MATH 105,A01,085443,Staff,0,22,30,30
1650856912803,MATH 109,A01,083213,Anzaldo; Leesa B,0,7,30,30
1650856912803,MATH 109,A02,083214,Anzaldo; Leesa B,0,7,30,30
1650856912803,MATH 109,B01,083215,Anzaldo; Leesa B,0,8,30,30
1650856912803,MATH 109,B02,083216,Anzaldo; Leesa B,0,7,30,30
1650856918828,MATH 142A,A01,083219,Chow; Bennett,0,14,30,30
1650856918828,MATH 142A,A02,083220,Chow; Bennett,0,15,30,30
1650856918828,MATH 142A,B01,083221,Chow; Bennett,0,16,30,30
1650856918828,MATH 142A,B02,083222,Chow; Bennett,0,14,30,30
1650856924854,MATH 193A,A01,083224,Staff,0,6,30,30
1650856924854,MATH 193A,A02,083225,Staff,0,7,30,30
1650856924854,MATH 193A,A03,083781,Staff,0,6,30,30
1650856924854,MATH 193A,A04,083782,Staff,0,7,30,30
1650856930882,MATH 197,001,091859,McAuley; Julian John,9998,0,9999,1
1650856936932,COGS 9,A01,083615,Staff,0,17,60,60
1650856942954,COGS 11,A01,083617,Boyle; Mary E. T.,15,0,40,25
1650856948978,COGS 13,A01,083071,Staff,0,38,40,40
1650856955003,COGS 14A,A01,092681,Staff,0,36,100,100
1650856961026,COGS 14B,A01,083073,Cheng; Tzu-Han,0,12,50,50
1650856967049,COGS 17,A01,092677,Staff,12,0,75,63
1650856973075,COGS 100,A01,083619,Staff,0,30,60,60
1650856979109,COGS 101A,A01,083621,Davis; Joshua Daniel,0,29,60,60
1650856985133,COGS 101B,A01,091572,Staff,0,3,60,60
1650856991157,COGS 101C,A01,083625,Delgado; Tania,14,0,30,16
1650856997181,COGS 107A,A01,083627,Boyle; Mary E. T.,0,16,60,60
1650857003207,COGS 118A,A01,083075,Staff,0,8,60,60
1650857009238,CSE 3,A50,083646,Miranda; Gregory Joseph,18,0,38,20
1650857009238,CSE 3,A51,083647,Miranda; Gregory Joseph,36,0,37,1
1650857015260,CSE 8A,A50,083650,Miranda; Gregory Joseph,0,29,40,40
1650857021287,CSE 11,A01,083080,Cao; Yingjun,0,96,40,40
1650857027309,CSE 12,A01,083652,Staff,0,21,100,100
1650857033331,CSE 15L,A01,083654,Staff,0,3,50,50
1650857033331,CSE 15L,A02,083655,Staff,0,3,50,50
1650857039354,CSE 20,A01,083657,Staff,49,0,80,31
1650857045378,CSE 30,A01,083084,Eldon; John,0,76,40,40
1650857051401,CSE 100,A01,083659,Cao; Yingjun,0,71,50,50
1650857057432,CSE 134B,A01,083661,Powell; Thomas Allan,0,38,65,65
1650857063455,CSE 140,A01,083663,Staff,0,12,75,75
1650857069482,CSE 140L,A01,083088,Eldon; John,0,20,75,75
1650857075507,CSE 175,A01,083665,Kumar; Rakesh,7,0,25,18
1650857081528,CSE 190,A00,092507,Dubnov; Shlomo,10,0,20,10
1650857087558,ECE 45,A01,083139,Staff,0,4,60,60
1650857093583,ECE 65,A50,083695,Staff,0,5,30,30
1650857099608,ECE 109,A01,091882,Touri; Behrouz,32,0,70,38
1650857105640,ECE 180,A00,083140,Abi Samra; Nicholas Camill,20,0,30,10
1650857105640,ECE 180,B00,083141,Abi Samra; Nicholas Camill,0,0,30,30
1650857111666,MATH 10A,A01,083735,Patchell; Gregory David,2,0,30,28
1650857111666,MATH 10A,A02,083736,Patchell; Gregory David,27,0,30,3
1650857111666,MATH 10A,A03,083737,Patchell; Gregory David,24,0,30,6
1650857117690,MATH 10B,A01,083207,Staff,0,9,30,30
1650857117690,MATH 10B,A02,083208,Staff,0,6,30,30
1650857117690,MATH 10B,B01,083739,Staff,10,0,30,20
1650857117690,MATH 10B,B02,083740,Staff,28,0,30,2
1650857123718,MATH 18,A01,083743,Staff,0,0,30,30
1650857123718,MATH 18,A02,083744,Staff,23,0,30,7
1650857123718,MATH 18,A03,083745,Staff,21,0,30,9
1650857123718,MATH 18,A04,083746,Staff,26,0,30,4
1650857123718,MATH 18,B01,083748,Staff,0,15,30,30
1650857123718,MATH 18,B02,083749,Staff,0,13,30,30
1650857123718,MATH 18,B03,083750,Staff,0,13,30,30
1650857123718,MATH 18,B04,083751,Staff,0,13,30,30
1650857129742,MATH 20A,A01,083754,Staff,19,0,40,21
1650857135766,MATH 20B,A01,083756,Staff,0,14,30,30
1650857135766,MATH 20B,A02,083757,Staff,0,12,30,30
1650857141789,MATH 20C,A01,083760,Staff,0,17,30,30
1650857141789,MATH 20C,A02,083761,Staff,0,16,30,30
1650857141789,MATH 20C,B01,083762,Staff,9,0,30,21
1650857141789,MATH 20C,B02,083763,Staff,28,0,30,2
1650857147812,MATH 20D,A01,083765,Staff,2,1,30,28
1650857147812,MATH 20D,A02,083766,Staff,6,0,30,24
1650857147812,MATH 20D,A03,083767,Staff,23,0,30,7
1650857153846,MATH 20E,A01,083771,Staff,2,0,30,28
1650857153846,MATH 20E,A02,083772,Staff,13,0,30,17
1650857153846,MATH 20E,B01,083773,Staff,0,0,30,30
1650857153846,MATH 20E,B02,083774,Staff,4,0,30,26
1650857159871,MATH 103A,A01,083777,Staff,0,16,30,30
1650857159871,MATH 103A,A02,083778,Staff,0,15,30,30
1650857159871,MATH 103A,B01,083779,Staff,0,15,30,30
1650857159871,MATH 103A,B02,083780,Staff,1,15,30,29
1650857166023,MATH 105,A01,085443,Staff,0,22,30,30
1650857172048,MATH 109,A01,083213,Anzaldo; Leesa B,0,7,30,30
1650857172048,MATH 109,A02,083214,Anzaldo; Leesa B,0,7,30,30
1650857172048,MATH 109,B01,083215,Anzaldo; Leesa B,0,8,30,30
1650857172048,MATH 109,B02,083216,Anzaldo; Leesa B,0,7,30,30
1650857178081,MATH 142A,A01,083219,Chow; Bennett,0,14,30,30
1650857178081,MATH 142A,A02,083220,Chow; Bennett,0,15,30,30
1650857178081,MATH 142A,B01,083221,Chow; Bennett,0,16,30,30
1650857178081,MATH 142A,B02,083222,Chow; Bennett,0,14,30,30
1650857184108,MATH 193A,A01,083224,Staff,0,6,30,30
1650857184108,MATH 193A,A02,083225,Staff,0,7,30,30
1650857184108,MATH 193A,A03,083781,Staff,0,6,30,30
1650857184108,MATH 193A,A04,083782,Staff,0,7,30,30
1650857190134,MATH 197,001,091859,McAuley; Julian John,9998,0,9999,1
1650857196185,COGS 9,A01,083615,Staff,0,17,60,60
1650857202209,COGS 11,A01,083617,Boyle; Mary E. T.,15,0,40,25
1650857208244,COGS 13,A01,083071,Staff,0,38,40,40
1650857214275,COGS 14A,A01,092681,Staff,0,36,100,100
1650857220316,COGS 14B,A01,083073,Cheng; Tzu-Han,0,12,50,50
1650857226346,COGS 17,A01,092677,Staff,12,0,75,63
1650857232375,COGS 100,A01,083619,Staff,0,30,60,60
1650857238414,COGS 101A,A01,083621,Davis; Joshua Daniel,0,29,60,60
1650857244441,COGS 101B,A01,091572,Staff,0,3,60,60
1650857250470,COGS 101C,A01,083625,Delgado; Tania,14,0,30,16
1650857256504,COGS 107A,A01,083627,Boyle; Mary E. T.,0,16,60,60
1650857262535,COGS 118A,A01,083075,Staff,0,8,60,60
1650857268558,CSE 3,A50,083646,Miranda; Gregory Joseph,18,0,38,20
1650857268558,CSE 3,A51,083647,Miranda; Gregory Joseph,36,0,37,1
1650857274586,CSE 8A,A50,083650,Miranda; Gregory Joseph,0,29,40,40
1650857280611,CSE 11,A01,083080,Cao; Yingjun,0,96,40,40
1650857286634,CSE 12,A01,083652,Staff,0,21,100,100
1650857292657,CSE 15L,A01,083654,Staff,0,3,50,50
1650857292657,CSE 15L,A02,083655,Staff,0,3,50,50
1650857298680,CSE 20,A01,083657,Staff,49,0,80,31
1650857304707,CSE 30,A01,083084,Eldon; John,0,76,40,40
1650857310732,CSE 100,A01,083659,Cao; Yingjun,0,71,50,50
1650857316756,CSE 134B,A01,083661,Powell; Thomas Allan,0,38,65,65
1650857322782,CSE 140,A01,083663,Staff,0,12,75,75
1650857328809,CSE 140L,A01,083088,Eldon; John,0,20,75,75
1650857334835,CSE 175,A01,083665,Kumar; Rakesh,7,0,25,18
1650857340860,CSE 190,A00,092507,Dubnov; Shlomo,10,0,20,10
1650857346884,ECE 45,A01,083139,Staff,0,4,60,60
1650857352911,ECE 65,A50,083695,Staff,0,5,30,30
1650857358954,ECE 109,A01,091882,Touri; Behrouz,32,0,70,38
1650857364978,ECE 180,A00,083140,Abi Samra; Nicholas Camill,20,0,30,10
1650857364978,ECE 180,B00,083141,Abi Samra; Nicholas Camill,0,0,30,30
1650857371002,MATH 10A,A01,083735,Patchell; Gregory David,2,0,30,28
1650857371002,MATH 10A,A02,083736,Patchell; Gregory David,27,0,30,3
1650857371002,MATH 10A,A03,083737,Patchell; Gregory David,24,0,30,6
1650857377026,MATH 10B,A01,083207,Staff,0,9,30,30
1650857377026,MATH 10B,A02,083208,Staff,0,6,30,30
1650857377026,MATH 10B,B01,083739,Staff,10,0,30,20
1650857377026,MATH 10B,B02,083740,Staff,28,0,30,2
1650857383051,MATH 18,A01,083743,Staff,0,0,30,30
1650857383051,MATH 18,A02,083744,Staff,23,0,30,7
1650857383051,MATH 18,A03,083745,Staff,21,0,30,9
1650857383051,MATH 18,A04,083746,Staff,26,0,30,4
1650857383051,MATH 18,B01,083748,Staff,0,15,30,30
1650857383051,MATH 18,B02,083749,Staff,0,13,30,30
1650857383051,MATH 18,B03,083750,Staff,0,13,30,30
1650857383051,MATH 18,B04,083751,Staff,0,13,30,30
1650857389075,MATH 20A,A01,083754,Staff,19,0,40,21
1650857395098,MATH 20B,A01,083756,Staff,0,14,30,30
1650857395098,MATH 20B,A02,083757,Staff,0,12,30,30
1650857401126,MATH 20C,A01,083760,Staff,0,17,30,30
1650857401126,MATH 20C,A02,083761,Staff,0,16,30,30
1650857401126,MATH 20C,B01,083762,Staff,9,0,30,21
1650857401126,MATH 20C,B02,083763,Staff,28,0,30,2
1650857407153,MATH 20D,A01,083765,Staff,2,1,30,28
1650857407153,MATH 20D,A02,083766,Staff,6,0,30,24
1650857407153,MATH 20D,A03,083767,Staff,23,0,30,7
1650857413178,MATH 20E,A01,083771,Staff,2,0,30,28
1650857413178,MATH 20E,A02,083772,Staff,13,0,30,17
1650857413178,MATH 20E,B01,083773,Staff,0,0,30,30
1650857413178,MATH 20E,B02,083774,Staff,4,0,30,26
1650857419223,MATH 103A,A01,083777,Staff,0,16,30,30
1650857419223,MATH 103A,A02,083778,Staff,0,15,30,30
1650857419223,MATH 103A,B01,083779,Staff,0,15,30,30
1650857419223,MATH 103A,B02,083780,Staff,1,15,30,29
1650857425246,MATH 105,A01,085443,Staff,0,22,30,30
1650857431283,MATH 109,A01,083213,Anzaldo; Leesa B,0,7,30,30
1650857431283,MATH 109,A02,083214,Anzaldo; Leesa B,0,7,30,30
1650857431283,MATH 109,B01,083215,Anzaldo; Leesa B,0,8,30,30
1650857431283,MATH 109,B02,083216,Anzaldo; Leesa B,0,7,30,30
1650857437310,MATH 142A,A01,083219,Chow; Bennett,0,14,30,30
1650857437310,MATH 142A,A02,083220,Chow; Bennett,0,15,30,30
1650857437310,MATH 142A,B01,083221,Chow; Bennett,0,16,30,30
1650857437310,MATH 142A,B02,083222,Chow; Bennett,0,14,30,30
1650857443333,MATH 193A,A01,083224,Staff,0,6,30,30
1650857443333,MATH 193A,A02,083225,Staff,0,7,30,30
1650857443333,MATH 193A,A03,083781,Staff,0,6,30,30
1650857443333,MATH 193A,A04,083782,Staff,0,7,30,30
1650857449359,MATH 197,001,091859,McAuley; Julian John,9998,0,9999,1
1650857455417,COGS 9,A01,083615,Staff,0,17,60,60
1650857461446,COGS 11,A01,083617,Boyle; Mary E. T.,15,0,40,25
1650857467473,COGS 13,A01,083071,Staff,0,38,40,40
1650857473512,COGS 14A,A01,092681,Staff,0,36,100,100
1650857479541,COGS 14B,A01,083073,Cheng; Tzu-Han,0,12,50,50
1650857485571,COGS 17,A01,092677,Staff,12,0,75,63
1650857491598,COGS 100,A01,083619,Staff,0,30,60,60
1650857497625,COGS 101A,A01,083621,Davis; Joshua Daniel,0,29,60,60
1650857503649,COGS 101B,A01,091572,Staff,0,3,60,60
1650857509685,COGS 101C,A01,083625,Delgado; Tania,14,0,30,16
1650857515709,COGS 107A,A01,083627,Boyle; Mary E. T.,0,16,60,60
1650857521732,COGS 118A,A01,083075,Staff,0,8,60,60
1650857527759,CSE 3,A50,083646,Miranda; Gregory Joseph,18,0,38,20
1650857527759,CSE 3,A51,083647,Miranda; Gregory Joseph,36,0,37,1
1650857533788,CSE 8A,A50,083650,Miranda; Gregory Joseph,0,29,40,40
1650857539814,CSE 11,A01,083080,Cao; Yingjun,0,96,40,40
1650857545837,CSE 12,A01,083652,Staff,0,21,100,100
1650857551862,CSE 15L,A01,083654,Staff,0,3,50,50
1650857551862,CSE 15L,A02,083655,Staff,0,3,50,50
1650857557885,CSE 20,A01,083657,Staff,49,0,80,31
1650857563909,CSE 30,A01,083084,Eldon; John,0,76,40,40
1650857569932,CSE 100,A01,083659,Cao; Yingjun,0,71,50,50
1650857575956,CSE 134B,A01,083661,Powell; Thomas Allan,0,38,65,65
1650857581989,CSE 140,A01,083663,Staff,0,12,75,75
1650857588013,CSE 140L,A01,083088,Eldon; John,0,20,75,75
1650857594038,CSE 175,A01,083665,Kumar; Rakesh,7,0,25,18
1650857600064,CSE 190,A00,092507,Dubnov; Shlomo,10,0,20,10
1650857606091,ECE 45,A01,083139,Staff,0,4,60,60
1650857612114,ECE 65,A50,083695,Staff,0,5,30,30
1650857618145,ECE 109,A01,091882,Touri; Behrouz,32,0,70,38
1650857624173,ECE 180,A00,083140,Abi Samra; Nicholas Camill,20,0,30,10
1650857624173,ECE 180,B00,083141,Abi Samra; Nicholas Camill,0,0,30,30
1650857630200,MATH 10A,A01,083735,Patchell; Gregory David,2,0,30,28
1650857630200,MATH 10A,A02,083736,Patchell; Gregory David,27,0,30,3
1650857630200,MATH 10A,A03,083737,Patchell; Gregory David,24,0,30,6
1650857636223,MATH 10B,A01,083207,Staff,0,9,30,30
1650857636223,MATH 10B,A02,083208,Staff,0,6,30,30
1650857636223,MATH 10B,B01,083739,Staff,10,0,30,20
1650857636223,MATH 10B,B02,083740,Staff,28,0,30,2
1650857642249,MATH 18,A01,083743,Staff,0,0,30,30
1650857642249,MATH 18,A02,083744,Staff,23,0,30,7
1650857642249,MATH 18,A03,083745,Staff,21,0,30,9
1650857642249,MATH 18,A04,083746,Staff,26,0,30,4
1650857642249,MATH 18,B01,083748,Staff,0,15,30,30
1650857642249,MATH 18,B02,083749,Staff,0,13,30,30
1650857642249,MATH 18,B03,083750,Staff,0,13,30,30
1650857642249,MATH 18,B04,083751,Staff,0,13,30,30
1650857648272,MATH 20A,A01,083754,Staff,19,0,40,21
1650857654301,MATH 20B,A01,083756,Staff,0,14,30,30
1650857654301,MATH 20B,A02,083757,Staff,0,12,30,30
1650857660329,MATH 20C,A01,083760,Staff,0,17,30,30
1650857660329,MATH 20C,A02,083761,Staff,0,16,30,30
1650857660329,MATH 20C,B01,083762,Staff,9,0,30,21
1650857660329,MATH 20C,B02,083763,Staff,28,0,30,2
1650857666357,MATH 20D,A01,083765,Staff,2,1,30,28
1650857666357,MATH 20D,A02,083766,Staff,6,0,30,24
1650857666357,MATH 20D,A03,083767,Staff,23,0,30,7
1650857672383,MATH 20E,A01,083771,Staff,2,0,30,28
1650857672383,MATH 20E,A02,083772,Staff,13,0,30,17
1650857672383,MATH 20E,B01,083773,Staff,0,0,30,30
1650857672383,MATH 20E,B02,083774,Staff,4,0,30,26
1650857678408,MATH 103A,A01,083777,Staff,0,16,30,30
1650857678408,MATH 103A,A02,083778,Staff,0,15,30,30
1650857678408,MATH 103A,B01,083779,Staff,0,15,30,30
1650857678408,MATH 103A,B02,083780,Staff,1,15,30,29
1650857684439,MATH 105,A01,085443,Staff,0,22,30,30
1650857690463,MATH 109,A01,083213,Anzaldo; Leesa B,0,7,30,30
1650857690463,MATH 109,A02,083214,Anzaldo; Leesa B,0,7,30,30
1650857690463,MATH 109,B01,083215,Anzaldo; Leesa B,0,8,30,30
1650857690463,MATH 109,B02,083216,Anzaldo; Leesa B,0,7,30,30
1650857696490,MATH 142A,A01,083219,Chow; Bennett,0,14,30,30
1650857696490,MATH 142A,A02,083220,Chow; Bennett,0,15,30,30
1650857696490,MATH 142A,B01,083221,Chow; Bennett,0,16,30,30
1650857696490,MATH 142A,B02,083222,Chow; Bennett,0,14,30,30
1650857702515,MATH 193A,A01,083224,Staff,0,6,30,30
1650857702515,MATH 193A,A02,083225,Staff,0,7,30,30
1650857702515,MATH 193A,A03,083781,Staff,0,6,30,30
1650857702515,MATH 193A,A04,083782,Staff,0,7,30,30
1650857708536,MATH 197,001,091859,McAuley; Julian John,9998,0,9999,1
1650857714594,COGS 9,A01,083615,Staff,0,17,60,60
1650857720617,COGS 11,A01,083617,Boyle; Mary E. T.,15,0,40,25
1650857726641,COGS 13,A01,083071,Staff,0,38,40,40
1650857732663,COGS 14A,A01,092681,Staff,0,36,100,100
1650857738686,COGS 14B,A01,083073,Cheng; Tzu-Han,0,12,50,50
1650857744711,COGS 17,A01,092677,Staff,12,0,75,63
1650857750739,COGS 100,A01,083619,Staff,0,30,60,60
1650857756875,COGS 101A,A01,083621,Davis; Joshua Daniel,0,29,60,60
1650857762899,COGS 101B,A01,091572,Staff,0,3,60,60
1650857768923,COGS 101C,A01,083625,Delgado; Tania,14,0,30,16
1650857774947,COGS 107A,A01,083627,Boyle; Mary E. T.,0,16,60,60
1650857780970,COGS 118A,A01,083075,Staff,0,8,60,60
1650857786994,CSE 3,A50,083646,Miranda; Gregory Joseph,18,0,38,20
1650857786994,CSE 3,A51,083647,Miranda; Gregory Joseph,36,0,37,1
1650857793018,CSE 8A,A50,083650,Miranda; Gregory Joseph,0,29,40,40
1650857799046,CSE 11,A01,083080,Cao; Yingjun,0,96,40,40
1650857805069,CSE 12,A01,083652,Staff,0,21,100,100
1650857811091,CSE 15L,A01,083654,Staff,0,3,50,50
1650857811091,CSE 15L,A02,083655,Staff,0,3,50,50
1650857817117,CSE 20,A01,083657,Staff,49,0,80,31
1650857823142,CSE 30,A01,083084,Eldon; John,0,76,40,40
1650857829168,CSE 100,A01,083659,Cao; Yingjun,0,71,50,50
1650857835198,CSE 134B,A01,083661,Powell; Thomas Allan,0,38,65,65
1650857841227,CSE 140,A01,083663,Staff,0,12,75,75
1650857847248,CSE 140L,A01,083088,Eldon; John,0,20,75,75
1650857853274,CSE 175,A01,083665,Kumar; Rakesh,7,0,25,18
1650857859313,CSE 190,A00,092507,Dubnov; Shlomo,10,0,20,10
1650857865336,ECE 45,A01,083139,Staff,0,4,60,60
1650857871361,ECE 65,A50,083695,Staff,0,5,30,30
1650857877397,ECE 109,A01,091882,Touri; Behrouz,32,0,70,38
1650857883428,ECE 180,A00,083140,Abi Samra; Nicholas Camill,20,0,30,10
1650857883428,ECE 180,B00,083141,Abi Samra; Nicholas Camill,0,0,30,30
1650857889453,MATH 10A,A01,083735,Patchell; Gregory David,2,0,30,28
1650857889453,MATH 10A,A02,083736,Patchell; Gregory David,27,0,30,3
1650857889453,MATH 10A,A03,083737,Patchell; Gregory David,24,0,30,6
1650857895483,MATH 10B,A01,083207,Staff,0,9,30,30
1650857895483,MATH 10B,A02,083208,Staff,0,6,30,30
1650857895483,MATH 10B,B01,083739,Staff,10,0,30,20
1650857895483,MATH 10B,B02,083740,Staff,28,0,30,2
1650857901514,MATH 18,A01,083743,Staff,0,0,30,30
1650857901514,MATH 18,A02,083744,Staff,23,0,30,7
1650857901514,MATH 18,A03,083745,Staff,21,0,30,9
1650857901514,MATH 18,A04,083746,Staff,26,0,30,4
1650857901514,MATH 18,B01,083748,Staff,0,15,30,30
1650857901514,MATH 18,B02,083749,Staff,0,13,30,30
1650857901514,MATH 18,B03,083750,Staff,0,13,30,30
1650857901514,MATH 18,B04,083751,Staff,0,13,30,30
1650857907539,MATH 20A,A01,083754,Staff,19,0,40,21
1650857913562,MATH 20B,A01,083756,Staff,0,14,30,30
1650857913562,MATH 20B,A02,083757,Staff,0,12,30,30
1650857919586,MATH 20C,A01,083760,Staff,0,17,30,30
1650857919586,MATH 20C,A02,083761,Staff,0,16,30,30
1650857919586,MATH 20C,B01,083762,Staff,9,0,30,21
1650857919586,MATH 20C,B02,083763,Staff,28,0,30,2
1650857925621,MATH 20D,A01,083765,Staff,2,1,30,28
1650857925621,MATH 20D,A02,083766,Staff,6,0,30,24
1650857925621,MATH 20D,A03,083767,Staff,23,0,30,7
1650857931645,MATH 20E,A01,083771,Staff,2,0,30,28
1650857931645,MATH 20E,A02,083772,Staff,13,0,30,17
1650857931645,MATH 20E,B01,083773,Staff,0,0,30,30
1650857931645,MATH 20E,B02,083774,Staff,4,0,30,26
1650857937673,MATH 103A,A01,083777,Staff,0,16,30,30
1650857937673,MATH 103A,A02,083778,Staff,0,15,30,30
1650857937673,MATH 103A,B01,083779,Staff,0,15,30,30
1650857937673,MATH 103A,B02,083780,Staff,1,15,30,29
1650857943697,MATH 105,A01,085443,Staff,0,22,30,30
1650857949721,MATH 109,A01,083213,Anzaldo; Leesa B,0,7,30,30
1650857949721,MATH 109,A02,083214,Anzaldo; Leesa B,0,7,30,30
1650857949721,MATH 109,B01,083215,Anzaldo; Leesa B,0,8,30,30
1650857949721,MATH 109,B02,083216,Anzaldo; Leesa B,0,7,30,30
1650857955747,MATH 142A,A01,083219,Chow; Bennett,0,14,30,30
1650857955747,MATH 142A,A02,083220,Chow; Bennett,0,15,30,30
1650857955747,MATH 142A,B01,083221,Chow; Bennett,0,16,30,30
1650857955747,MATH 142A,B02,083222,Chow; Bennett,0,14,30,30
1650857961785,MATH 193A,A01,083224,Staff,0,6,30,30
1650857961785,MATH 193A,A02,083225,Staff,0,7,30,30
1650857961785,MATH 193A,A03,083781,Staff,0,6,30,30
1650857961785,MATH 193A,A04,083782,Staff,0,7,30,30
1650857967807,MATH 197,001,091859,McAuley; Julian John,9998,0,9999,1
1650857973865,COGS 9,A01,083615,Staff,0,17,60,60
1650857979888,COGS 11,A01,083617,Boyle; Mary E. T.,15,0,40,25
1650857985916,COGS 13,A01,083071,Staff,0,38,40,40
1650857991945,COGS 14A,A01,092681,Staff,0,36,100,100
1650857997969,COGS 14B,A01,083073,Cheng; Tzu-Han,0,12,50,50
1650858003992,COGS 17,A01,092677,Staff,12,0,75,63
1650858010017,COGS 100,A01,083619,Staff,0,30,60,60
1650858016047,COGS 101A,A01,083621,Davis; Joshua Daniel,0,29,60,60
1650858022069,COGS 101B,A01,091572,Staff,0,3,60,60
1650858028096,COGS 101C,A01,083625,Delgado; Tania,14,0,30,16
1650858034118,COGS 107A,A01,083627,Boyle; Mary E. T.,0,16,60,60
1650858040145,COGS 118A,A01,083075,Staff,0,8,60,60
1650858046168,CSE 3,A50,083646,Miranda; Gregory Joseph,18,0,38,20
1650858046168,CSE 3,A51,083647,Miranda; Gregory Joseph,36,0,37,1
1650858052195,CSE 8A,A50,083650,Miranda; Gregory Joseph,0,29,40,40
1650858058219,CSE 11,A01,083080,Cao; Yingjun,0,96,40,40
1650858064247,CSE 12,A01,083652,Staff,0,21,100,100
1650858070274,CSE 15L,A01,083654,Staff,0,3,50,50
1650858070274,CSE 15L,A02,083655,Staff,0,3,50,50
1650858076298,CSE 20,A01,083657,Staff,49,0,80,31
1650858082323,CSE 30,A01,083084,Eldon; John,0,76,40,40
1650858088379,CSE 100,A01,083659,Cao; Yingjun,0,71,50,50
1650858094403,CSE 134B,A01,083661,Powell; Thomas Allan,0,38,65,65
1650858100429,CSE 140,A01,083663,Staff,0,12,75,75
1650858106467,CSE 140L,A01,083088,Eldon; John,0,20,75,75
1650858112490,CSE 175,A01,083665,Kumar; Rakesh,7,0,25,18
1650858118514,CSE 190,A00,092507,Dubnov; Shlomo,10,0,20,10
1650858124540,ECE 45,A01,083139,Staff,0,4,60,60
1650858130570,ECE 65,A50,083695,Staff,0,5,30,30
1650858136599,ECE 109,A01,091882,Touri; Behrouz,32,0,70,38
1650858142625,ECE 180,A00,083140,Abi Samra; Nicholas Camill,20,0,30,10
1650858142625,ECE 180,B00,083141,Abi Samra; Nicholas Camill,0,0,30,30
1650858148648,MATH 10A,A01,083735,Patchell; Gregory David,2,0,30,28
1650858148648,MATH 10A,A02,083736,Patchell; Gregory David,27,0,30,3
1650858148648,MATH 10A,A03,083737,Patchell; Gregory David,24,0,30,6
1650858154675,MATH 10B,A01,083207,Staff,0,9,30,30
1650858154675,MATH 10B,A02,083208,Staff,0,6,30,30
1650858154675,MATH 10B,B01,083739,Staff,10,0,30,20
1650858154675,MATH 10B,B02,083740,Staff,28,0,30,2
1650858160710,MATH 18,A01,083743,Staff,0,0,30,30
1650858160710,MATH 18,A02,083744,Staff,23,0,30,7
1650858160710,MATH 18,A03,083745,Staff,21,0,30,9
1650858160710,MATH 18,A04,083746,Staff,26,0,30,4
1650858160710,MATH 18,B01,083748,Staff,0,15,30,30
1650858160710,MATH 18,B02,083749,Staff,0,13,30,30
1650858160710,MATH 18,B03,083750,Staff,0,13,30,30
1650858160710,MATH 18,B04,083751,Staff,0,13,30,30
1650858166734,MATH 20A,A01,083754,Staff,19,0,40,21
1650858172757,MATH 20B,A01,083756,Staff,0,14,30,30
1650858172757,MATH 20B,A02,083757,Staff,0,12,30,30
1650858178780,MATH 20C,A01,083760,Staff,0,17,30,30
1650858178780,MATH 20C,A02,083761,Staff,0,16,30,30
1650858178780,MATH 20C,B01,083762,Staff,9,0,30,21
1650858178780,MATH 20C,B02,083763,Staff,28,0,30,2
1650858184815,MATH 20D,A01,083765,Staff,2,1,30,28
1650858184815,MATH 20D,A02,083766,Staff,6,0,30,24
1650858184815,MATH 20D,A03,083767,Staff,23,0,30,7
1650858190841,MATH 20E,A01,083771,Staff,2,0,30,28
1650858190841,MATH 20E,A02,083772,Staff,13,0,30,17
1650858190841,MATH 20E,B01,083773,Staff,0,0,30,30
1650858190841,MATH 20E,B02,083774,Staff,4,0,30,26
1650858196869,MATH 103A,A01,083777,Staff,0,16,30,30
1650858196869,MATH 103A,A02,083778,Staff,0,15,30,30
1650858196869,MATH 103A,B01,083779,Staff,0,15,30,30
1650858196869,MATH 103A,B02,083780,Staff,1,15,30,29
1650858202891,MATH 105,A01,085443,Staff,0,22,30,30
1650858208914,MATH 109,A01,083213,Anzaldo; Leesa B,0,7,30,30
1650858208914,MATH 109,A02,083214,Anzaldo; Leesa B,0,7,30,30
1650858208914,MATH 109,B01,083215,Anzaldo; Leesa B,0,8,30,30
1650858208914,MATH 109,B02,083216,Anzaldo; Leesa B,0,7,30,30
1650858214938,MATH 142A,A01,083219,Chow; Bennett,0,14,30,30
1650858214938,MATH 142A,A02,083220,Chow; Bennett,0,15,30,30
1650858214938,MATH 142A,B01,083221,Chow; Bennett,0,16,30,30
1650858214938,MATH 142A,B02,083222,Chow; Bennett,0,14,30,30
1650858220971,MATH 193A,A01,083224,Staff,0,6,30,30
1650858220971,MATH 193A,A02,083225,Staff,0,7,30,30
1650858220971,MATH 193A,A03,083781,Staff,0,6,30,30
1650858220971,MATH 193A,A04,083782,Staff,0,7,30,30
1650858227005,MATH 197,001,091859,McAuley; Julian John,9998,0,9999,1
1650858233061,COGS 9,A01,083615,Staff,0,17,60,60
1650858239088,COGS 11,A01,083617,Boyle; Mary E. T.,15,0,40,25
1650858245113,COGS 13,A01,083071,Staff,0,38,40,40
1650858251139,COGS 14A,A01,092681,Staff,0,36,100,100
1650858257166,COGS 14B,A01,083073,Cheng; Tzu-Han,0,12,50,50
1650858263190,COGS 17,A01,092677,Staff,12,0,75,63
1650858269214,COGS 100,A01,083619,Staff,0,30,60,60
1650858275241,COGS 101A,A01,083621,Davis; Joshua Daniel,0,29,60,60
1650858281267,COGS 101B,A01,091572,Staff,0,3,60,60
1650858287293,COGS 101C,A01,083625,Delgado; Tania,14,0,30,16
1650858293318,COGS 107A,A01,083627,Boyle; Mary E. T.,0,16,60,60
1650858299341,COGS 118A,A01,083075,Staff,0,8,60,60
1650858305364,CSE 3,A50,083646,Miranda; Gregory Joseph,18,0,38,20
1650858305364,CSE 3,A51,083647,Miranda; Gregory Joseph,36,0,37,1
1650858311385,CSE 8A,A50,083650,Miranda; Gregory Joseph,0,29,40,40
1650858317415,CSE 11,A01,083080,Cao; Yingjun,0,96,40,40
1650858323437,CSE 12,A01,083652,Staff,0,21,100,100
1650858329460,CSE 15L,A01,083654,Staff,0,3,50,50
1650858329460,CSE 15L,A02,083655,Staff,0,3,50,50
1650858335483,CSE 20,A01,083657,Staff,49,0,80,31
1650858341504,CSE 30,A01,083084,Eldon; John,0,76,40,40
1650858347528,CSE 100,A01,083659,Cao; Yingjun,0,71,50,50
1650858353655,CSE 134B,A01,083661,Powell; Thomas Allan,0,38,65,65
1650858359678,CSE 140,A01,083663,Staff,0,12,75,75
1650858365701,CSE 140L,A01,083088,Eldon; John,0,20,75,75
1650858371724,CSE 175,A01,083665,Kumar; Rakesh,7,0,25,18
1650858377746,CSE 190,A00,092507,Dubnov; Shlomo,10,0,20,10
1650858383773,ECE 45,A01,083139,Staff,0,4,60,60
1650858389812,ECE 65,A50,083695,Staff,0,5,30,30
1650858395836,ECE 109,A01,091882,Touri; Behrouz,32,0,70,38
1650858401859,ECE 180,A00,083140,Abi Samra; Nicholas Camill,20,0,30,10
1650858401859,ECE 180,B00,083141,Abi Samra; Nicholas Camill,0,0,30,30
1650858407891,MATH 10A,A01,083735,Patchell; Gregory David,2,0,30,28
1650858407891,MATH 10A,A02,083736,Patchell; Gregory David,27,0,30,3
1650858407891,MATH 10A,A03,083737,Patchell; Gregory David,24,0,30,6
1650858413918,MATH 10B,A01,083207,Staff,0,9,30,30
1650858413918,MATH 10B,A02,083208,Staff,0,6,30,30
1650858413918,MATH 10B,B01,083739,Staff,10,0,30,20
1650858413918,MATH 10B,B02,083740,Staff,28,0,30,2
1650858419942,MATH 18,A01,083743,Staff,0,0,30,30
1650858419942,MATH 18,A02,083744,Staff,23,0,30,7
1650858419942,MATH 18,A03,083745,Staff,21,0,30,9
1650858419942,MATH 18,A04,083746,Staff,26,0,30,4
1650858419942,MATH 18,B01,083748,Staff,0,15,30,30
1650858419942,MATH 18,B02,083749,Staff,0,13,30,30
1650858419942,MATH 18,B03,083750,Staff,0,13,30,30
1650858419942,MATH 18,B04,083751,Staff,0,13,30,30
1650858425966,MATH 20A,A01,083754,Staff,19,0,40,21
1650858431988,MATH 20B,A01,083756,Staff,0,14,30,30
1650858431988,MATH 20B,A02,083757,Staff,0,12,30,30
1650858438012,MATH 20C,A01,083760,Staff,0,17,30,30
1650858438012,MATH 20C,A02,083761,Staff,0,16,30,30
1650858438012,MATH 20C,B01,083762,Staff,9,0,30,21
1650858438012,MATH 20C,B02,083763,Staff,28,0,30,2
1650858444037,MATH 20D,A01,083765,Staff,2,1,30,28
1650858444037,MATH 20D,A02,083766,Staff,6,0,30,24
1650858444037,MATH 20D,A03,083767,Staff,23,0,30,7
1650858450062,MATH 20E,A01,083771,Staff,2,0,30,28
1650858450062,MATH 20E,A02,083772,Staff,13,0,30,17
1650858450062,MATH 20E,B01,083773,Staff,0,0,30,30
1650858450062,MATH 20E,B02,083774,Staff,4,0,30,26
1650858456087,MATH 103A,A01,083777,Staff,0,16,30,30
1650858456087,MATH 103A,A02,083778,Staff,0,15,30,30
1650858456087,MATH 103A,B01,083779,Staff,0,15,30,30
1650858456087,MATH 103A,B02,083780,Staff,1,15,30,29
1650858462116,MATH 105,A01,085443,Staff,0,22,30,30
1650858468139,MATH 109,A01,083213,Anzaldo; Leesa B,0,7,30,30
1650858468139,MATH 109,A02,083214,Anzaldo; Leesa B,0,7,30,30
1650858468139,MATH 109,B01,083215,Anzaldo; Leesa B,0,8,30,30
1650858468139,MATH 109,B02,083216,Anzaldo; Leesa B,0,7,30,30
1650858474163,MATH 142A,A01,083219,Chow; Bennett,0,14,30,30
1650858474163,MATH 142A,A02,083220,Chow; Bennett,0,15,30,30
1650858474163,MATH 142A,B01,083221,Chow; Bennett,0,16,30,30
1650858474163,MATH 142A,B02,083222,Chow; Bennett,0,14,30,30
1650858480192,MATH 193A,A01,083224,Staff,0,6,30,30
1650858480192,MATH 193A,A02,083225,Staff,0,7,30,30
1650858480192,MATH 193A,A03,083781,Staff,0,6,30,30
1650858480192,MATH 193A,A04,083782,Staff,0,7,30,30
1650858486215,MATH 197,001,091859,McAuley; Julian John,9998,0,9999,1
1650858492265,COGS 9,A01,083615,Staff,0,17,60,60
1650858498301,COGS 11,A01,083617,Boyle; Mary E. T.,15,0,40,25
1650858504328,COGS 13,A01,083071,Staff,0,38,40,40
1650858510352,COGS 14A,A01,092681,Staff,0,36,100,100
1650858516375,COGS 14B,A01,083073,Cheng; Tzu-Han,0,12,50,50
1650858522398,COGS 17,A01,092677,Staff,12,0,75,63
1650858528422,COGS 100,A01,083619,Staff,0,30,60,60
1650858534444,COGS 101A,A01,083621,Davis; Joshua Daniel,0,29,60,60
1650858540469,COGS 101B,A01,091572,Staff,0,3,60,60
1650858546491,COGS 101C,A01,083625,Delgado; Tania,14,0,30,16
1650858552516,COGS 107A,A01,083627,Boyle; Mary E. T.,0,16,60,60
1650858558543,COGS 118A,A01,083075,Staff,0,8,60,60
1650858564569,CSE 3,A50,083646,Miranda; Gregory Joseph,18,0,38,20
1650858564569,CSE 3,A51,083647,Miranda; Gregory Joseph,36,0,37,1
1650858570592,CSE 8A,A50,083650,Miranda; Gregory Joseph,0,29,40,40
1650858576626,CSE 11,A01,083080,Cao; Yingjun,0,96,40,40
1650858582659,CSE 12,A01,083652,Staff,0,21,100,100
1650858588698,CSE 15L,A01,083654,Staff,0,3,50,50
1650858588698,CSE 15L,A02,083655,Staff,0,3,50,50
1650858594725,CSE 20,A01,083657,Staff,49,0,80,31
1650858600758,CSE 30,A01,083084,Eldon; John,0,76,40,40
1650858606792,CSE 100,A01,083659,Cao; Yingjun,0,71,50,50
1650858612820,CSE 134B,A01,083661,Powell; Thomas Allan,0,38,65,65
1650858618853,CSE 140,A01,083663,Staff,0,12,75,75
1650858624877,CSE 140L,A01,083088,Eldon; John,0,20,75,75
1650858630903,CSE 175,A01,083665,Kumar; Rakesh,7,0,25,18
1650858636926,CSE 190,A00,092507,Dubnov; Shlomo,10,0,20,10
1650858642949,ECE 45,A01,083139,Staff,0,4,60,60
1650858648971,ECE 65,A50,083695,Staff,0,5,30,30
1650858654993,ECE 109,A01,091882,Touri; Behrouz,32,0,70,38
1650858661016,ECE 180,A00,083140,Abi Samra; Nicholas Camill,20,0,30,10
1650858661016,ECE 180,B00,083141,Abi Samra; Nicholas Camill,0,0,30,30
1650858667039,MATH 10A,A01,083735,Patchell; Gregory David,2,0,30,28
1650858667039,MATH 10A,A02,083736,Patchell; Gregory David,27,0,30,3
1650858667039,MATH 10A,A03,083737,Patchell; Gregory David,24,0,30,6
1650858673063,MATH 10B,A01,083207,Staff,0,9,30,30
1650858673063,MATH 10B,A02,083208,Staff,0,6,30,30
1650858673063,MATH 10B,B01,083739,Staff,10,0,30,20
1650858673063,MATH 10B,B02,083740,Staff,28,0,30,2
1650858679087,MATH 18,A01,083743,Staff,0,0,30,30
1650858679087,MATH 18,A02,083744,Staff,23,0,30,7
1650858679087,MATH 18,A03,083745,Staff,21,0,30,9
1650858679087,MATH 18,A04,083746,Staff,26,0,30,4
1650858679087,MATH 18,B01,083748,Staff,0,15,30,30
1650858679087,MATH 18,B02,083749,Staff,0,13,30,30
1650858679087,MATH 18,B03,083750,Staff,0,13,30,30
1650858679087,MATH 18,B04,083751,Staff,0,13,30,30
1650858685115,MATH 20A,A01,083754,Staff,19,0,40,21
1650858691137,MATH 20B,A01,083756,Staff,0,14,30,30
1650858691137,MATH 20B,A02,083757,Staff,0,12,30,30
1650858697160,MATH 20C,A01,083760,Staff,0,17,30,30
1650858697160,MATH 20C,A02,083761,Staff,0,16,30,30
1650858697160,MATH 20C,B01,083762,Staff,9,0,30,21
1650858697160,MATH 20C,B02,083763,Staff,28,0,30,2
1650858703187,MATH 20D,A01,083765,Staff,2,1,30,28
1650858703187,MATH 20D,A02,083766,Staff,6,0,30,24
1650858703187,MATH 20D,A03,083767,Staff,23,0,30,7
1650858709210,MATH 20E,A01,083771,Staff,2,0,30,28
1650858709210,MATH 20E,A02,083772,Staff,13,0,30,17
1650858709210,MATH 20E,B01,083773,Staff,0,0,30,30
1650858709210,MATH 20E,B02,083774,Staff,4,0,30,26
1650858715239,MATH 103A,A01,083777,Staff,0,16,30,30
1650858715239,MATH 103A,A02,083778,Staff,0,15,30,30
1650858715239,MATH 103A,B01,083779,Staff,0,15,30,30
1650858715239,MATH 103A,B02,083780,Staff,1,15,30,29
1650858721269,MATH 105,A01,085443,Staff,0,22,30,30
1650858727306,MATH 109,A01,083213,Anzaldo; Leesa B,0,7,30,30
1650858727306,MATH 109,A02,083214,Anzaldo; Leesa B,0,7,30,30
1650858727306,MATH 109,B01,083215,Anzaldo; Leesa B,0,8,30,30
1650858727306,MATH 109,B02,083216,Anzaldo; Leesa B,0,7,30,30
1650858733331,MATH 142A,A01,083219,Chow; Bennett,0,14,30,30
1650858733331,MATH 142A,A02,083220,Chow; Bennett,0,15,30,30
1650858733331,MATH 142A,B01,083221,Chow; Bennett,0,16,30,30
1650858733331,MATH 142A,B02,083222,Chow; Bennett,0,14,30,30
1650858739355,MATH 193A,A01,083224,Staff,0,6,30,30
1650858739355,MATH 193A,A02,083225,Staff,0,7,30,30
1650858739355,MATH 193A,A03,083781,Staff,0,6,30,30
1650858739355,MATH 193A,A04,083782,Staff,0,7,30,30
1650858745381,MATH 197,001,091859,McAuley; Julian John,9998,0,9999,1
1650858751451,COGS 9,A01,083615,Staff,0,17,60,60
1650858757477,COGS 11,A01,083617,Boyle; Mary E. T.,15,0,40,25
1650858763512,COGS 13,A01,083071,Staff,0,38,40,40
1650858769536,COGS 14A,A01,092681,Staff,0,36,100,100
1650858775565,COGS 14B,A01,083073,Cheng; Tzu-Han,0,12,50,50
1650858781592,COGS 17,A01,092677,Staff,12,0,75,63
1650858787619,COGS 100,A01,083619,Staff,0,30,60,60
1650858793652,COGS 101A,A01,083621,Davis; Joshua Daniel,0,29,60,60
1650858799674,COGS 101B,A01,091572,Staff,0,3,60,60
1650858805702,COGS 101C,A01,083625,Delgado; Tania,14,0,30,16
1650858811726,COGS 107A,A01,083627,Boyle; Mary E. T.,0,16,60,60
1650858817756,COGS 118A,A01,083075,Staff,0,8,60,60
1650858823787,CSE 3,A50,083646,Miranda; Gregory Joseph,18,0,38,20
1650858823787,CSE 3,A51,083647,Miranda; Gregory Joseph,36,0,37,1
1650858829829,CSE 8A,A50,083650,Miranda; Gregory Joseph,0,29,40,40
1650858835864,CSE 11,A01,083080,Cao; Yingjun,0,96,40,40
1650858841888,CSE 12,A01,083652,Staff,0,21,100,100
1650858847918,CSE 15L,A01,083654,Staff,0,3,50,50
1650858847918,CSE 15L,A02,083655,Staff,0,3,50,50
1650858853941,CSE 20,A01,083657,Staff,49,0,80,31
1650858859963,CSE 30,A01,083084,Eldon; John,0,76,40,40
1650858865992,CSE 100,A01,083659,Cao; Yingjun,0,71,50,50
1650858872036,CSE 134B,A01,083661,Powell; Thomas Allan,0,38,65,65
1650858878057,CSE 140,A01,083663,Staff,0,12,75,75
1650858884081,CSE 140L,A01,083088,Eldon; John,0,20,75,75
1650858890119,CSE 175,A01,083665,Kumar; Rakesh,7,0,25,18
1650858896143,CSE 190,A00,092507,Dubnov; Shlomo,10,0,20,10
1650858902168,ECE 45,A01,083139,Staff,0,4,60,60
1650858908192,ECE 65,A50,083695,Staff,0,5,30,30
1650858914223,ECE 109,A01,091882,Touri; Behrouz,32,0,70,38
1650858920247,ECE 180,A00,083140,Abi Samra; Nicholas Camill,20,0,30,10
1650858920247,ECE 180,B00,083141,Abi Samra; Nicholas Camill,0,0,30,30
1650858926292,MATH 10A,A01,083735,Patchell; Gregory David,2,0,30,28
1650858926292,MATH 10A,A02,083736,Patchell; Gregory David,27,0,30,3
1650858926292,MATH 10A,A03,083737,Patchell; Gregory David,24,0,30,6
1650858932328,MATH 10B,A01,083207,Staff,0,9,30,30
1650858932328,MATH 10B,A02,083208,Staff,0,6,30,30
1650858932328,MATH 10B,B01,083739,Staff,10,0,30,20
1650858932328,MATH 10B,B02,083740,Staff,28,0,30,2
1650858938359,MATH 18,A01,083743,Staff,0,0,30,30
1650858938359,MATH 18,A02,083744,Staff,23,0,30,7
1650858938359,MATH 18,A03,083745,Staff,21,0,30,9
1650858938359,MATH 18,A04,083746,Staff,26,0,30,4
1650858938359,MATH 18,B01,083748,Staff,0,15,30,30
1650858938359,MATH 18,B02,083749,Staff,0,13,30,30
1650858938359,MATH 18,B03,083750,Staff,0,13,30,30
1650858938359,MATH 18,B04,083751,Staff,0,13,30,30
1650858944383,MATH 20A,A01,083754,Staff,19,0,40,21
1650858950498,MATH 20B,A01,083756,Staff,0,14,30,30
1650858950498,MATH 20B,A02,083757,Staff,0,12,30,30
1650858956524,MATH 20C,A01,083760,Staff,0,17,30,30
1650858956524,MATH 20C,A02,083761,Staff,0,16,30,30
1650858956524,MATH 20C,B01,083762,Staff,9,0,30,21
1650858956524,MATH 20C,B02,083763,Staff,28,0,30,2
1650858962545,MATH 20D,A01,083765,Staff,2,1,30,28
1650858962545,MATH 20D,A02,083766,Staff,6,0,30,24
1650858962545,MATH 20D,A03,083767,Staff,23,0,30,7
1650858968572,MATH 20E,A01,083771,Staff,2,0,30,28
1650858968572,MATH 20E,A02,083772,Staff,13,0,30,17
1650858968572,MATH 20E,B01,083773,Staff,0,0,30,30
1650858968572,MATH 20E,B02,083774,Staff,4,0,30,26
1650858974599,MATH 103A,A01,083777,Staff,0,16,30,30
1650858974599,MATH 103A,A02,083778,Staff,0,15,30,30
1650858974599,MATH 103A,B01,083779,Staff,0,15,30,30
1650858974599,MATH 103A,B02,083780,Staff,1,15,30,29
1650858980625,MATH 105,A01,085443,Staff,0,22,30,30
1650858986649,MATH 109,A01,083213,Anzaldo; Leesa B,0,7,30,30
1650858986649,MATH 109,A02,083214,Anzaldo; Leesa B,0,7,30,30
1650858986649,MATH 109,B01,083215,Anzaldo; Leesa B,0,8,30,30
1650858986649,MATH 109,B02,083216,Anzaldo; Leesa B,0,7,30,30
1650858992674,MATH 142A,A01,083219,Chow; Bennett,0,14,30,30
1650858992674,MATH 142A,A02,083220,Chow; Bennett,0,15,30,30
1650858992674,MATH 142A,B01,083221,Chow; Bennett,0,16,30,30
1650858992674,MATH 142A,B02,083222,Chow; Bennett,0,14,30,30
1650858998699,MATH 193A,A01,083224,Staff,0,6,30,30
1650858998699,MATH 193A,A02,083225,Staff,0,7,30,30
1650858998699,MATH 193A,A03,083781,Staff,0,6,30,30
1650858998699,MATH 193A,A04,083782,Staff,0,7,30,30
1650859004719,MATH 197,001,091859,McAuley; Julian John,9998,0,9999,1
1650859010780,COGS 9,A01,083615,Staff,0,17,60,60
1650859016804,COGS 11,A01,083617,Boyle; Mary E. T.,15,0,40,25
1650859022837,COGS 13,A01,083071,Staff,0,38,40,40
1650859028860,COGS 14A,A01,092681,Staff,0,36,100,100
1650859034882,COGS 14B,A01,083073,Cheng; Tzu-Han,0,12,50,50
1650859040914,COGS 17,A01,092677,Staff,12,0,75,63
1650859046936,COGS 100,A01,083619,Staff,0,30,60,60
1650859052960,COGS 101A,A01,083621,Davis; Joshua Daniel,0,29,60,60
1650859058988,COGS 101B,A01,091572,Staff,0,3,60,60
1650859065008,COGS 101C,A01,083625,Delgado; Tania,14,0,30,16
1650859071031,COGS 107A,A01,083627,Boyle; Mary E. T.,0,16,60,60
1650859077056,COGS 118A,A01,083075,Staff,0,8,60,60
1650859083082,CSE 3,A50,083646,Miranda; Gregory Joseph,18,0,38,20
1650859083082,CSE 3,A51,083647,Miranda; Gregory Joseph,36,0,37,1
1650859089114,CSE 8A,A50,083650,Miranda; Gregory Joseph,0,29,40,40
1650859095152,CSE 11,A01,083080,Cao; Yingjun,0,96,40,40
1650859101175,CSE 12,A01,083652,Staff,0,21,100,100
1650859107199,CSE 15L,A01,083654,Staff,0,3,50,50
1650859107199,CSE 15L,A02,083655,Staff,0,3,50,50
1650859113222,CSE 20,A01,083657,Staff,49,0,80,31
1650859119246,CSE 30,A01,083084,Eldon; John,0,76,40,40
1650859125276,CSE 100,A01,083659,Cao; Yingjun,0,71,50,50
1650859131302,CSE 134B,A01,083661,Powell; Thomas Allan,0,38,65,65
1650859137325,CSE 140,A01,083663,Staff,0,12,75,75
1650859143357,CSE 140L,A01,083088,Eldon; John,0,20,75,75
1650859149380,CSE 175,A01,083665,Kumar; Rakesh,7,0,25,18
1650859155414,CSE 190,A00,092507,Dubnov; Shlomo,10,0,20,10
1650859161446,ECE 45,A01,083139,Staff,0,4,60,60
1650859167470,ECE 65,A50,083695,Staff,0,5,30,30
1650859173496,ECE 109,A01,091882,Touri; Behrouz,32,0,70,38
1650859179520,ECE 180,A00,083140,Abi Samra; Nicholas Camill,20,0,30,10
1650859179520,ECE 180,B00,083141,Abi Samra; Nicholas Camill,0,0,30,30
1650859185547,MATH 10A,A01,083735,Patchell; Gregory David,2,0,30,28
1650859185547,MATH 10A,A02,083736,Patchell; Gregory David,27,0,30,3
1650859185547,MATH 10A,A03,083737,Patchell; Gregory David,24,0,30,6
1650859191575,MATH 10B,A01,083207,Staff,0,9,30,30
1650859191575,MATH 10B,A02,083208,Staff,0,6,30,30
1650859191575,MATH 10B,B01,083739,Staff,10,0,30,20
1650859191575,MATH 10B,B02,083740,Staff,28,0,30,2
1650859197602,MATH 18,A01,083743,Staff,0,0,30,30
1650859197602,MATH 18,A02,083744,Staff,23,0,30,7
1650859197602,MATH 18,A03,083745,Staff,21,0,30,9
1650859197602,MATH 18,A04,083746,Staff,26,0,30,4
1650859197602,MATH 18,B01,083748,Staff,0,15,30,30
1650859197602,MATH 18,B02,083749,Staff,0,13,30,30
1650859197602,MATH 18,B03,083750,Staff,0,13,30,30
1650859197602,MATH 18,B04,083751,Staff,0,13,30,30
1650859203631,MATH 20A,A01,083754,Staff,19,0,40,21
1650859209654,MATH 20B,A01,083756,Staff,0,14,30,30
1650859209654,MATH 20B,A02,083757,Staff,0,12,30,30
1650859215679,MATH 20C,A01,083760,Staff,0,17,30,30
1650859215679,MATH 20C,A02,083761,Staff,0,16,30,30
1650859215679,MATH 20C,B01,083762,Staff,9,0,30,21
1650859215679,MATH 20C,B02,083763,Staff,28,0,30,2
1650859221708,MATH 20D,A01,083765,Staff,2,1,30,28
1650859221708,MATH 20D,A02,083766,Staff,6,0,30,24
1650859221708,MATH 20D,A03,083767,Staff,23,0,30,7
1650859227740,MATH 20E,A01,083771,Staff,2,0,30,28
1650859227740,MATH 20E,A02,083772,Staff,13,0,30,17
1650859227740,MATH 20E,B01,083773,Staff,0,0,30,30
1650859227740,MATH 20E,B02,083774,Staff,4,0,30,26
1650859233769,MATH 103A,A01,083777,Staff,0,17,30,30
1650859233769,MATH 103A,A02,083778,Staff,0,15,30,30
1650859233769,MATH 103A,B01,083779,Staff,0,15,30,30
1650859233769,MATH 103A,B02,083780,Staff,1,15,30,29
1650859239792,MATH 105,A01,085443,Staff,0,22,30,30
1650859245836,MATH 109,A01,083213,Anzaldo; Leesa B,0,7,30,30
1650859245836,MATH 109,A02,083214,Anzaldo; Leesa B,0,7,30,30
1650859245836,MATH 109,B01,083215,Anzaldo; Leesa B,0,8,30,30
1650859245836,MATH 109,B02,083216,Anzaldo; Leesa B,0,7,30,30
1650859251860,MATH 142A,A01,083219,Chow; Bennett,0,14,30,30
1650859251860,MATH 142A,A02,083220,Chow; Bennett,0,15,30,30
1650859251860,MATH 142A,B01,083221,Chow; Bennett,0,16,30,30
1650859251860,MATH 142A,B02,083222,Chow; Bennett,0,14,30,30
1650859257893,MATH 193A,A01,083224,Staff,0,6,30,30
1650859257893,MATH 193A,A02,083225,Staff,0,7,30,30
1650859257893,MATH 193A,A03,083781,Staff,0,6,30,30
1650859257893,MATH 193A,A04,083782,Staff,0,7,30,30
1650859263917,MATH 197,001,091859,McAuley; Julian John,9998,0,9999,1
1650859269984,COGS 9,A01,083615,Staff,0,17,60,60
1650859276010,COGS 11,A01,083617,Boyle; Mary E. T.,15,0,40,25
1650859282034,COGS 13,A01,083071,Staff,0,38,40,40
1650859288071,COGS 14A,A01,092681,Staff,0,36,100,100
1650859294095,COGS 14B,A01,083073,Cheng; Tzu-Han,0,12,50,50
1650859300119,COGS 17,A01,092677,Staff,12,0,75,63
1650859306140,COGS 100,A01,083619,Staff,0,30,60,60
1650859312176,COGS 101A,A01,083621,Davis; Joshua Daniel,0,29,60,60
1650859318208,COGS 101B,A01,091572,Staff,0,3,60,60
1650859324236,COGS 101C,A01,083625,Delgado; Tania,14,0,30,16
1650859330261,COGS 107A,A01,083627,Boyle; Mary E. T.,0,16,60,60
1650859336288,COGS 118A,A01,083075,Staff,0,8,60,60
1650859342313,CSE 3,A50,083646,Miranda; Gregory Joseph,18,0,38,20
1650859342313,CSE 3,A51,083647,Miranda; Gregory Joseph,36,0,37,1
1650859348337,CSE 8A,A50,083650,Miranda; Gregory Joseph,0,29,40,40
1650859354362,CSE 11,A01,083080,Cao; Yingjun,0,96,40,40
1650859360384,CSE 12,A01,083652,Staff,0,21,100,100
1650859366412,CSE 15L,A01,083654,Staff,0,3,50,50
1650859366412,CSE 15L,A02,083655,Staff,0,3,50,50
1650859372438,CSE 20,A01,083657,Staff,49,0,80,31
1650859378466,CSE 30,A01,083084,Eldon; John,0,76,40,40
1650859384490,CSE 100,A01,083659,Cao; Yingjun,0,71,50,50
1650859390517,CSE 134B,A01,083661,Powell; Thomas Allan,0,38,65,65
1650859396540,CSE 140,A01,083663,Staff,0,12,75,75
1650859402566,CSE 140L,A01,083088,Eldon; John,0,20,75,75
1650859408588,CSE 175,A01,083665,Kumar; Rakesh,7,0,25,18
1650859414619,CSE 190,A00,092507,Dubnov; Shlomo,10,0,20,10
1650859420641,ECE 45,A01,083139,Staff,0,4,60,60
1650859426665,ECE 65,A50,083695,Staff,0,5,30,30
1650859432691,ECE 109,A01,091882,Touri; Behrouz,32,0,70,38
1650859438719,ECE 180,A00,083140,Abi Samra; Nicholas Camill,20,0,30,10
1650859438719,ECE 180,B00,083141,Abi Samra; Nicholas Camill,0,0,30,30
1650859444746,MATH 10A,A01,083735,Patchell; Gregory David,2,0,30,28
1650859444746,MATH 10A,A02,083736,Patchell; Gregory David,27,0,30,3
1650859444746,MATH 10A,A03,083737,Patchell; Gregory David,24,0,30,6
1650859450779,MATH 10B,A01,083207,Staff,0,9,30,30
1650859450779,MATH 10B,A02,083208,Staff,0,6,30,30
1650859450779,MATH 10B,B01,083739,Staff,10,0,30,20
1650859450779,MATH 10B,B02,083740,Staff,28,0,30,2
1650859456809,MATH 18,A01,083743,Staff,0,0,30,30
1650859456809,MATH 18,A02,083744,Staff,23,0,30,7
1650859456809,MATH 18,A03,083745,Staff,21,0,30,9
1650859456809,MATH 18,A04,083746,Staff,26,0,30,4
1650859456809,MATH 18,B01,083748,Staff,0,15,30,30
1650859456809,MATH 18,B02,083749,Staff,0,13,30,30
1650859456809,MATH 18,B03,083750,Staff,0,13,30,30
1650859456809,MATH 18,B04,083751,Staff,0,13,30,30
1650859462832,MATH 20A,A01,083754,Staff,19,0,40,21
1650859468855,MATH 20B,A01,083756,Staff,0,14,30,30
1650859468855,MATH 20B,A02,083757,Staff,0,12,30,30
1650859474885,MATH 20C,A01,083760,Staff,0,17,30,30
1650859474885,MATH 20C,A02,083761,Staff,0,16,30,30
1650859474885,MATH 20C,B01,083762,Staff,9,0,30,21
1650859474885,MATH 20C,B02,083763,Staff,28,0,30,2
1650859480909,MATH 20D,A01,083765,Staff,2,1,30,28
1650859480909,MATH 20D,A02,083766,Staff,6,0,30,24
1650859480909,MATH 20D,A03,083767,Staff,23,0,30,7
1650859486937,MATH 20E,A01,083771,Staff,2,0,30,28
1650859486937,MATH 20E,A02,083772,Staff,13,0,30,17
1650859486937,MATH 20E,B01,083773,Staff,0,0,30,30
1650859486937,MATH 20E,B02,083774,Staff,4,0,30,26
1650859492961,MATH 103A,A01,083777,Staff,0,17,30,30
1650859492961,MATH 103A,A02,083778,Staff,0,15,30,30
1650859492961,MATH 103A,B01,083779,Staff,0,15,30,30
1650859492961,MATH 103A,B02,083780,Staff,1,15,30,29
1650859498990,MATH 105,A01,085443,Staff,0,22,30,30
1650859505019,MATH 109,A01,083213,Anzaldo; Leesa B,0,7,30,30
1650859505019,MATH 109,A02,083214,Anzaldo; Leesa B,0,7,30,30
1650859505019,MATH 109,B01,083215,Anzaldo; Leesa B,0,8,30,30
1650859505019,MATH 109,B02,083216,Anzaldo; Leesa B,0,7,30,30
1650859511044,MATH 142A,A01,083219,Chow; Bennett,0,14,30,30
1650859511044,MATH 142A,A02,083220,Chow; Bennett,0,15,30,30
1650859511044,MATH 142A,B01,083221,Chow; Bennett,0,16,30,30
1650859511044,MATH 142A,B02,083222,Chow; Bennett,0,14,30,30
1650859517072,MATH 193A,A01,083224,Staff,0,6,30,30
1650859517072,MATH 193A,A02,083225,Staff,0,7,30,30
1650859517072,MATH 193A,A03,083781,Staff,0,6,30,30
1650859517072,MATH 193A,A04,083782,Staff,0,7,30,30
1650859523098,MATH 197,001,091859,McAuley; Julian John,9998,0,9999,1
1650859529158,COGS 9,A01,083615,Staff,0,17,60,60
1650859535200,COGS 11,A01,083617,Boyle; Mary E. T.,15,0,40,25
1650859541318,COGS 13,A01,083071,Staff,0,38,40,40
1650859547341,COGS 14A,A01,092681,Staff,0,36,100,100
1650859553364,COGS 14B,A01,083073,Cheng; Tzu-Han,0,12,50,50
1650859559386,COGS 17,A01,092677,Staff,12,0,75,63
1650859565409,COGS 100,A01,083619,Staff,0,30,60,60
1650859571430,COGS 101A,A01,083621,Davis; Joshua Daniel,0,29,60,60
1650859577453,COGS 101B,A01,091572,Staff,0,3,60,60
1650859583475,COGS 101C,A01,083625,Delgado; Tania,14,0,30,16
1650859589501,COGS 107A,A01,083627,Boyle; Mary E. T.,0,16,60,60
1650859595524,COGS 118A,A01,083075,Staff,0,8,60,60
1650859601556,CSE 3,A50,083646,Miranda; Gregory Joseph,18,0,38,20
1650859601556,CSE 3,A51,083647,Miranda; Gregory Joseph,36,0,37,1
1650859607583,CSE 8A,A50,083650,Miranda; Gregory Joseph,0,29,40,40
1650859613606,CSE 11,A01,083080,Cao; Yingjun,0,96,40,40
1650859619640,CSE 12,A01,083652,Staff,0,21,100,100
1650859625661,CSE 15L,A01,083654,Staff,0,3,50,50
1650859625661,CSE 15L,A02,083655,Staff,0,3,50,50
1650859631690,CSE 20,A01,083657,Staff,49,0,80,31
1650859637717,CSE 30,A01,083084,Eldon; John,0,76,40,40
1650859643748,CSE 100,A01,083659,Cao; Yingjun,0,71,50,50
1650859649771,CSE 134B,A01,083661,Powell; Thomas Allan,0,38,65,65
1650859655795,CSE 140,A01,083663,Staff,0,12,75,75
1650859661820,CSE 140L,A01,083088,Eldon; John,0,20,75,75
1650859667846,CSE 175,A01,083665,Kumar; Rakesh,7,0,25,18
1650859673868,CSE 190,A00,092507,Dubnov; Shlomo,10,0,20,10
1650859679894,ECE 45,A01,083139,Staff,0,4,60,60
1650859685918,ECE 65,A50,083695,Staff,0,5,30,30
1650859691945,ECE 109,A01,091882,Touri; Behrouz,32,0,70,38
1650859697972,ECE 180,A00,083140,Abi Samra; Nicholas Camill,20,0,30,10
1650859697972,ECE 180,B00,083141,Abi Samra; Nicholas Camill,0,0,30,30
1650859704014,MATH 10A,A01,083735,Patchell; Gregory David,2,0,30,28
1650859704014,MATH 10A,A02,083736,Patchell; Gregory David,27,0,30,3
1650859704014,MATH 10A,A03,083737,Patchell; Gregory David,24,0,30,6
1650859710046,MATH 10B,A01,083207,Staff,0,9,30,30
1650859710046,MATH 10B,A02,083208,Staff,0,6,30,30
1650859710046,MATH 10B,B01,083739,Staff,10,0,30,20
1650859710046,MATH 10B,B02,083740,Staff,28,0,30,2
1650859716077,MATH 18,A01,083743,Staff,0,0,30,30
1650859716077,MATH 18,A02,083744,Staff,23,0,30,7
1650859716077,MATH 18,A03,083745,Staff,21,0,30,9
1650859716077,MATH 18,A04,083746,Staff,26,0,30,4
1650859716077,MATH 18,B01,083748,Staff,0,15,30,30
1650859716077,MATH 18,B02,083749,Staff,0,13,30,30
1650859716077,MATH 18,B03,083750,Staff,0,13,30,30
1650859716077,MATH 18,B04,083751,Staff,0,13,30,30
1650859722100,MATH 20A,A01,083754,Staff,19,0,40,21
1650859728130,MATH 20B,A01,083756,Staff,0,14,30,30
1650859728130,MATH 20B,A02,083757,Staff,0,12,30,30
1650859734157,MATH 20C,A01,083760,Staff,0,17,30,30
1650859734157,MATH 20C,A02,083761,Staff,0,16,30,30
1650859734157,MATH 20C,B01,083762,Staff,9,0,30,21
1650859734157,MATH 20C,B02,083763,Staff,28,0,30,2
1650859740184,MATH 20D,A01,083765,Staff,2,1,30,28
1650859740184,MATH 20D,A02,083766,Staff,6,0,30,24
1650859740184,MATH 20D,A03,083767,Staff,23,0,30,7
1650859746207,MATH 20E,A01,083771,Staff,2,0,30,28
1650859746207,MATH 20E,A02,083772,Staff,13,0,30,17
1650859746207,MATH 20E,B01,083773,Staff,0,0,30,30
1650859746207,MATH 20E,B02,083774,Staff,4,0,30,26
1650859752238,MATH 103A,A01,083777,Staff,0,17,30,30
1650859752238,MATH 103A,A02,083778,Staff,0,15,30,30
1650859752238,MATH 103A,B01,083779,Staff,0,15,30,30
1650859752238,MATH 103A,B02,083780,Staff,1,15,30,29
1650859758260,MATH 105,A01,085443,Staff,0,22,30,30
1650859764287,MATH 109,A01,083213,Anzaldo; Leesa B,0,7,30,30
1650859764287,MATH 109,A02,083214,Anzaldo; Leesa B,0,7,30,30
1650859764287,MATH 109,B01,083215,Anzaldo; Leesa B,0,8,30,30
1650859764287,MATH 109,B02,083216,Anzaldo; Leesa B,0,7,30,30
1650859770316,MATH 142A,A01,083219,Chow; Bennett,0,14,30,30
1650859770316,MATH 142A,A02,083220,Chow; Bennett,0,15,30,30
1650859770316,MATH 142A,B01,083221,Chow; Bennett,0,16,30,30
1650859770316,MATH 142A,B02,083222,Chow; Bennett,0,14,30,30
1650859776342,MATH 193A,A01,083224,Staff,0,6,30,30
1650859776342,MATH 193A,A02,083225,Staff,0,7,30,30
1650859776342,MATH 193A,A03,083781,Staff,0,6,30,30
1650859776342,MATH 193A,A04,083782,Staff,0,7,30,30
1650859782365,MATH 197,001,091859,McAuley; Julian John,9998,0,9999,1
1650859788414,COGS 9,A01,083615,Staff,0,17,60,60
1650859794442,COGS 11,A01,083617,Boyle; Mary E. T.,15,0,40,25
1650859800472,COGS 13,A01,083071,Staff,0,38,40,40
1650859806520,COGS 14A,A01,092681,Staff,0,36,100,100
1650859812546,COGS 14B,A01,083073,Cheng; Tzu-Han,0,12,50,50
1650859818569,COGS 17,A01,092677,Staff,12,0,75,63
1650859824594,COGS 100,A01,083619,Staff,0,30,60,60
1650859830621,COGS 101A,A01,083621,Davis; Joshua Daniel,0,29,60,60
1650859836645,COGS 101B,A01,091572,Staff,0,3,60,60
1650859842669,COGS 101C,A01,083625,Delgado; Tania,14,0,30,16
1650859848693,COGS 107A,A01,083627,Boyle; Mary E. T.,0,16,60,60
1650859854715,COGS 118A,A01,083075,Staff,0,8,60,60
1650859860739,CSE 3,A50,083646,Miranda; Gregory Joseph,18,0,38,20
1650859860739,CSE 3,A51,083647,Miranda; Gregory Joseph,36,0,37,1
1650859866768,CSE 8A,A50,083650,Miranda; Gregory Joseph,0,29,40,40
1650859872790,CSE 11,A01,083080,Cao; Yingjun,0,96,40,40
1650859878816,CSE 12,A01,083652,Staff,0,21,100,100
1650859884842,CSE 15L,A01,083654,Staff,0,3,50,50
1650859884842,CSE 15L,A02,083655,Staff,0,3,50,50
1650859890867,CSE 20,A01,083657,Staff,49,0,80,31
1650859896893,CSE 30,A01,083084,Eldon; John,0,76,40,40
1650859902917,CSE 100,A01,083659,Cao; Yingjun,0,71,50,50
1650859908944,CSE 134B,A01,083661,Powell; Thomas Allan,0,38,65,65
1650859914969,CSE 140,A01,083663,Staff,0,12,75,75
1650859920994,CSE 140L,A01,083088,Eldon; John,0,20,75,75
1650859927023,CSE 175,A01,083665,Kumar; Rakesh,7,0,25,18
1650859933046,CSE 190,A00,092507,Dubnov; Shlomo,10,0,20,10
1650859939073,ECE 45,A01,083139,Staff,0,4,60,60
1650859945113,ECE 65,A50,083695,Staff,0,5,30,30
1650859951135,ECE 109,A01,091882,Touri; Behrouz,32,0,70,38
1650859957159,ECE 180,A00,083140,Abi Samra; Nicholas Camill,20,0,30,10
1650859957159,ECE 180,B00,083141,Abi Samra; Nicholas Camill,0,0,30,30
1650859963181,MATH 10A,A01,083735,Patchell; Gregory David,2,0,30,28
1650859963181,MATH 10A,A02,083736,Patchell; Gregory David,27,0,30,3
1650859963181,MATH 10A,A03,083737,Patchell; Gregory David,24,0,30,6
1650859969208,MATH 10B,A01,083207,Staff,0,9,30,30
1650859969208,MATH 10B,A02,083208,Staff,0,6,30,30
1650859969208,MATH 10B,B01,083739,Staff,10,0,30,20
1650859969208,MATH 10B,B02,083740,Staff,28,0,30,2
1650859975242,MATH 18,A01,083743,Staff,0,0,30,30
1650859975242,MATH 18,A02,083744,Staff,23,0,30,7
1650859975242,MATH 18,A03,083745,Staff,21,0,30,9
1650859975242,MATH 18,A04,083746,Staff,26,0,30,4
1650859975242,MATH 18,B01,083748,Staff,0,15,30,30
1650859975242,MATH 18,B02,083749,Staff,0,13,30,30
1650859975242,MATH 18,B03,083750,Staff,0,13,30,30
1650859975242,MATH 18,B04,083751,Staff,0,13,30,30
1650859981265,MATH 20A,A01,083754,Staff,19,0,40,21
1650859987292,MATH 20B,A01,083756,Staff,0,14,30,30
1650859987292,MATH 20B,A02,083757,Staff,0,12,30,30
1650859993320,MATH 20C,A01,083760,Staff,0,17,30,30
1650859993320,MATH 20C,A02,083761,Staff,0,16,30,30
1650859993320,MATH 20C,B01,083762,Staff,9,0,30,21
1650859993320,MATH 20C,B02,083763,Staff,28,0,30,2
1650859999347,MATH 20D,A01,083765,Staff,2,1,30,28
1650859999347,MATH 20D,A02,083766,Staff,6,0,30,24
1650859999347,MATH 20D,A03,083767,Staff,23,0,30,7
1650860005374,MATH 20E,A01,083771,Staff,2,0,30,28
1650860005374,MATH 20E,A02,083772,Staff,13,0,30,17
1650860005374,MATH 20E,B01,083773,Staff,0,0,30,30
1650860005374,MATH 20E,B02,083774,Staff,4,0,30,26
1650860011398,MATH 103A,A01,083777,Staff,0,17,30,30
1650860011398,MATH 103A,A02,083778,Staff,0,15,30,30
1650860011398,MATH 103A,B01,083779,Staff,0,15,30,30
1650860011398,MATH 103A,B02,083780,Staff,1,15,30,29
1650860017425,MATH 105,A01,085443,Staff,0,22,30,30
1650860023461,MATH 109,A01,083213,Anzaldo; Leesa B,0,7,30,30
1650860023461,MATH 109,A02,083214,Anzaldo; Leesa B,0,7,30,30
1650860023461,MATH 109,B01,083215,Anzaldo; Leesa B,0,8,30,30
1650860023461,MATH 109,B02,083216,Anzaldo; Leesa B,0,7,30,30
1650860029486,MATH 142A,A01,083219,Chow; Bennett,0,14,30,30
1650860029486,MATH 142A,A02,083220,Chow; Bennett,0,15,30,30
1650860029486,MATH 142A,B01,083221,Chow; Bennett,0,16,30,30
1650860029486,MATH 142A,B02,083222,Chow; Bennett,0,14,30,30
1650860035515,MATH 193A,A01,083224,Staff,0,6,30,30
1650860035515,MATH 193A,A02,083225,Staff,0,7,30,30
1650860035515,MATH 193A,A03,083781,Staff,0,6,30,30
1650860035515,MATH 193A,A04,083782,Staff,0,7,30,30
1650860041542,MATH 197,001,091859,McAuley; Julian John,9998,0,9999,1
1650860047626,COGS 9,A01,083615,Staff,0,17,60,60
1650860053649,COGS 11,A01,083617,Boyle; Mary E. T.,15,0,40,25
1650860059681,COGS 13,A01,083071,Staff,0,38,40,40
1650860065705,COGS 14A,A01,092681,Staff,0,36,100,100
1650860071729,COGS 14B,A01,083073,Cheng; Tzu-Han,0,12,50,50
1650860077755,COGS 17,A01,092677,Staff,12,0,75,63
1650860083783,COGS 100,A01,083619,Staff,0,30,60,60
1650860089812,COGS 101A,A01,083621,Davis; Joshua Daniel,0,29,60,60
1650860095838,COGS 101B,A01,091572,Staff,0,3,60,60
1650860101863,COGS 101C,A01,083625,Delgado; Tania,14,0,30,16
1650860107889,COGS 107A,A01,083627,Boyle; Mary E. T.,0,16,60,60
1650860113912,COGS 118A,A01,083075,Staff,0,8,60,60
1650860119939,CSE 3,A50,083646,Miranda; Gregory Joseph,18,0,38,20
1650860119939,CSE 3,A51,083647,Miranda; Gregory Joseph,36,0,37,1
1650860125964,CSE 8A,A50,083650,Miranda; Gregory Joseph,0,29,40,40
1650860131996,CSE 11,A01,083080,Cao; Yingjun,0,96,40,40
1650860138098,CSE 12,A01,083652,Staff,0,21,100,100
1650860144123,CSE 15L,A01,083654,Staff,0,3,50,50
1650860144123,CSE 15L,A02,083655,Staff,0,3,50,50
1650860150152,CSE 20,A01,083657,Staff,49,0,80,31
1650860156178,CSE 30,A01,083084,Eldon; John,0,76,40,40
1650860162203,CSE 100,A01,083659,Cao; Yingjun,0,71,50,50
1650860168226,CSE 134B,A01,083661,Powell; Thomas Allan,0,38,65,65
1650860174252,CSE 140,A01,083663,Staff,0,12,75,75
1650860180281,CSE 140L,A01,083088,Eldon; John,0,20,75,75
1650860186305,CSE 175,A01,083665,Kumar; Rakesh,7,0,25,18
1650860192338,CSE 190,A00,092507,Dubnov; Shlomo,10,0,20,10
1650860198362,ECE 45,A01,083139,Staff,0,4,60,60
1650860204387,ECE 65,A50,083695,Staff,0,5,30,30
1650860210413,ECE 109,A01,091882,Touri; Behrouz,32,0,70,38
1650860216441,ECE 180,A00,083140,Abi Samra; Nicholas Camill,20,0,30,10
1650860216441,ECE 180,B00,083141,Abi Samra; Nicholas Camill,0,0,30,30
1650860222463,MATH 10A,A01,083735,Patchell; Gregory David,2,0,30,28
1650860222463,MATH 10A,A02,083736,Patchell; Gregory David,27,0,30,3
1650860222463,MATH 10A,A03,083737,Patchell; Gregory David,24,0,30,6
1650860228486,MATH 10B,A01,083207,Staff,0,9,30,30
1650860228486,MATH 10B,A02,083208,Staff,0,6,30,30
1650860228486,MATH 10B,B01,083739,Staff,10,0,30,20
1650860228486,MATH 10B,B02,083740,Staff,28,0,30,2
1650860234512,MATH 18,A01,083743,Staff,0,0,30,30
1650860234512,MATH 18,A02,083744,Staff,23,0,30,7
1650860234512,MATH 18,A03,083745,Staff,21,0,30,9
1650860234512,MATH 18,A04,083746,Staff,26,0,30,4
1650860234512,MATH 18,B01,083748,Staff,0,15,30,30
1650860234512,MATH 18,B02,083749,Staff,0,13,30,30
1650860234512,MATH 18,B03,083750,Staff,0,13,30,30
1650860234512,MATH 18,B04,083751,Staff,0,13,30,30
1650860240540,MATH 20A,A01,083754,Staff,19,0,40,21
1650860246563,MATH 20B,A01,083756,Staff,0,14,30,30
1650860246563,MATH 20B,A02,083757,Staff,0,12,30,30
1650860252586,MATH 20C,A01,083760,Staff,0,17,30,30
1650860252586,MATH 20C,A02,083761,Staff,0,16,30,30
1650860252586,MATH 20C,B01,083762,Staff,9,0,30,21
1650860252586,MATH 20C,B02,083763,Staff,28,0,30,2
1650860258612,MATH 20D,A01,083765,Staff,2,1,30,28
1650860258612,MATH 20D,A02,083766,Staff,6,0,30,24
1650860258612,MATH 20D,A03,083767,Staff,23,0,30,7
1650860264638,MATH 20E,A01,083771,Staff,2,0,30,28
1650860264638,MATH 20E,A02,083772,Staff,13,0,30,17
1650860264638,MATH 20E,B01,083773,Staff,0,0,30,30
1650860264638,MATH 20E,B02,083774,Staff,4,0,30,26
1650860270666,MATH 103A,A01,083777,Staff,0,17,30,30
1650860270666,MATH 103A,A02,083778,Staff,0,15,30,30
1650860270666,MATH 103A,B01,083779,Staff,0,15,30,30
1650860270666,MATH 103A,B02,083780,Staff,1,15,30,29
1650860276691,MATH 105,A01,085443,Staff,0,22,30,30
1650860282715,MATH 109,A01,083213,Anzaldo; Leesa B,0,7,30,30
1650860282715,MATH 109,A02,083214,Anzaldo; Leesa B,0,7,30,30
1650860282715,MATH 109,B01,083215,Anzaldo; Leesa B,0,8,30,30
1650860282715,MATH 109,B02,083216,Anzaldo; Leesa B,0,7,30,30
1650860288739,MATH 142A,A01,083219,Chow; Bennett,0,14,30,30
1650860288739,MATH 142A,A02,083220,Chow; Bennett,0,15,30,30
1650860288739,MATH 142A,B01,083221,Chow; Bennett,0,16,30,30
1650860288739,MATH 142A,B02,083222,Chow; Bennett,0,14,30,30
1650860294764,MATH 193A,A01,083224,Staff,0,6,30,30
1650860294764,MATH 193A,A02,083225,Staff,0,7,30,30
1650860294764,MATH 193A,A03,083781,Staff,0,6,30,30
1650860294764,MATH 193A,A04,083782,Staff,0,7,30,30
1650860300786,MATH 197,001,091859,McAuley; Julian John,9998,0,9999,1
1650860306843,COGS 9,A01,083615,Staff,0,17,60,60
1650860312866,COGS 11,A01,083617,Boyle; Mary E. T.,15,0,40,25
1650860318893,COGS 13,A01,083071,Staff,0,38,40,40
1650860324919,COGS 14A,A01,092681,Staff,0,36,100,100
1650860330945,COGS 14B,A01,083073,Cheng; Tzu-Han,0,12,50,50
1650860336967,COGS 17,A01,092677,Staff,12,0,75,63
1650860342991,COGS 100,A01,083619,Staff,0,30,60,60
1650860349026,COGS 101A,A01,083621,Davis; Joshua Daniel,0,29,60,60
1650860355049,COGS 101B,A01,091572,Staff,0,3,60,60
1650860361078,COGS 101C,A01,083625,Delgado; Tania,14,0,30,16
1650860367105,COGS 107A,A01,083627,Boyle; Mary E. T.,0,16,60,60
1650860373128,COGS 118A,A01,083075,Staff,0,8,60,60
1650860379156,CSE 3,A50,083646,Miranda; Gregory Joseph,18,0,38,20
1650860379156,CSE 3,A51,083647,Miranda; Gregory Joseph,36,0,37,1
1650860385186,CSE 8A,A50,083650,Miranda; Gregory Joseph,0,29,40,40
1650860391213,CSE 11,A01,083080,Cao; Yingjun,0,96,40,40
1650860397240,CSE 12,A01,083652,Staff,0,21,100,100
1650860403265,CSE 15L,A01,083654,Staff,0,3,50,50
1650860403265,CSE 15L,A02,083655,Staff,0,3,50,50
1650860409291,CSE 20,A01,083657,Staff,49,0,80,31
1650860415315,CSE 30,A01,083084,Eldon; John,0,76,40,40
1650860421353,CSE 100,A01,083659,Cao; Yingjun,0,71,50,50
1650860427376,CSE 134B,A01,083661,Powell; Thomas Allan,0,38,65,65
1650860433399,CSE 140,A01,083663,Staff,0,12,75,75
1650860439423,CSE 140L,A01,083088,Eldon; John,0,20,75,75
1650860445455,CSE 175,A01,083665,Kumar; Rakesh,7,0,25,18
1650860451481,CSE 190,A00,092507,Dubnov; Shlomo,10,0,20,10
1650860457518,ECE 45,A01,083139,Staff,0,4,60,60
1650860463541,ECE 65,A50,083695,Staff,0,5,30,30
1650860469565,ECE 109,A01,091882,Touri; Behrouz,32,0,70,38
1650860475590,ECE 180,A00,083140,Abi Samra; Nicholas Camill,20,0,30,10
1650860475590,ECE 180,B00,083141,Abi Samra; Nicholas Camill,0,0,30,30
1650860481617,MATH 10A,A01,083735,Patchell; Gregory David,2,0,30,28
1650860481617,MATH 10A,A02,083736,Patchell; Gregory David,27,0,30,3
1650860481617,MATH 10A,A03,083737,Patchell; Gregory David,24,0,30,6
1650860487642,MATH 10B,A01,083207,Staff,0,9,30,30
1650860487642,MATH 10B,A02,083208,Staff,0,6,30,30
1650860487642,MATH 10B,B01,083739,Staff,10,0,30,20
1650860487642,MATH 10B,B02,083740,Staff,28,0,30,2
1650860493670,MATH 18,A01,083743,Staff,0,0,30,30
1650860493670,MATH 18,A02,083744,Staff,23,0,30,7
1650860493670,MATH 18,A03,083745,Staff,21,0,30,9
1650860493670,MATH 18,A04,083746,Staff,26,0,30,4
1650860493670,MATH 18,B01,083748,Staff,0,15,30,30
1650860493670,MATH 18,B02,083749,Staff,0,13,30,30
1650860493670,MATH 18,B03,083750,Staff,0,13,30,30
1650860493670,MATH 18,B04,083751,Staff,0,13,30,30
1650860499693,MATH 20A,A01,083754,Staff,19,0,40,21
1650860505716,MATH 20B,A01,083756,Staff,0,14,30,30
1650860505716,MATH 20B,A02,083757,Staff,0,12,30,30
1650860511740,MATH 20C,A01,083760,Staff,0,17,30,30
1650860511740,MATH 20C,A02,083761,Staff,0,16,30,30
1650860511740,MATH 20C,B01,083762,Staff,9,0,30,21
1650860511740,MATH 20C,B02,083763,Staff,28,0,30,2
1650860517767,MATH 20D,A01,083765,Staff,2,1,30,28
1650860517767,MATH 20D,A02,083766,Staff,6,0,30,24
1650860517767,MATH 20D,A03,083767,Staff,23,0,30,7
1650860523796,MATH 20E,A01,083771,Staff,2,0,30,28
1650860523796,MATH 20E,A02,083772,Staff,13,0,30,17
1650860523796,MATH 20E,B01,083773,Staff,0,0,30,30
1650860523796,MATH 20E,B02,083774,Staff,4,0,30,26
1650860529820,MATH 103A,A01,083777,Staff,0,17,30,30
1650860529820,MATH 103A,A02,083778,Staff,0,15,30,30
1650860529820,MATH 103A,B01,083779,Staff,0,15,30,30
1650860529820,MATH 103A,B02,083780,Staff,1,15,30,29
1650860535844,MATH 105,A01,085443,Staff,0,22,30,30
1650860541872,MATH 109,A01,083213,Anzaldo; Leesa B,0,7,30,30
1650860541872,MATH 109,A02,083214,Anzaldo; Leesa B,0,7,30,30
1650860541872,MATH 109,B01,083215,Anzaldo; Leesa B,0,8,30,30
1650860541872,MATH 109,B02,083216,Anzaldo; Leesa B,0,7,30,30
1650860547896,MATH 142A,A01,083219,Chow; Bennett,0,14,30,30
1650860547896,MATH 142A,A02,083220,Chow; Bennett,0,15,30,30
1650860547896,MATH 142A,B01,083221,Chow; Bennett,0,16,30,30
1650860547896,MATH 142A,B02,083222,Chow; Bennett,0,14,30,30
1650860553919,MATH 193A,A01,083224,Staff,0,6,30,30
1650860553919,MATH 193A,A02,083225,Staff,0,7,30,30
1650860553919,MATH 193A,A03,083781,Staff,0,6,30,30
1650860553919,MATH 193A,A04,083782,Staff,0,7,30,30
1650860559947,MATH 197,001,091859,McAuley; Julian John,9998,0,9999,1
1650860566001,COGS 9,A01,083615,Staff,0,17,60,60
1650860572022,COGS 11,A01,083617,Boyle; Mary E. T.,15,0,40,25
1650860578047,COGS 13,A01,083071,Staff,0,38,40,40
1650860584072,COGS 14A,A01,092681,Staff,0,36,100,100
1650860590096,COGS 14B,A01,083073,Cheng; Tzu-Han,0,12,50,50
1650860596123,COGS 17,A01,092677,Staff,12,0,75,63
1650860602149,COGS 100,A01,083619,Staff,0,30,60,60
1650860608173,COGS 101A,A01,083621,Davis; Joshua Daniel,0,29,60,60
1650860614197,COGS 101B,A01,091572,Staff,0,3,60,60
1650860620219,COGS 101C,A01,083625,Delgado; Tania,14,0,30,16
1650860626241,COGS 107A,A01,083627,Boyle; Mary E. T.,0,16,60,60
1650860632267,COGS 118A,A01,083075,Staff,0,8,60,60
1650860638294,CSE 3,A50,083646,Miranda; Gregory Joseph,18,0,38,20
1650860638294,CSE 3,A51,083647,Miranda; Gregory Joseph,36,0,37,1
1650860644322,CSE 8A,A50,083650,Miranda; Gregory Joseph,0,29,40,40
1650860650350,CSE 11,A01,083080,Cao; Yingjun,0,96,40,40
1650860656378,CSE 12,A01,083652,Staff,0,21,100,100
1650860662403,CSE 15L,A01,083654,Staff,0,3,50,50
1650860662403,CSE 15L,A02,083655,Staff,0,3,50,50
1650860668434,CSE 20,A01,083657,Staff,49,0,80,31
1650860674458,CSE 30,A01,083084,Eldon; John,0,76,40,40
1650860680486,CSE 100,A01,083659,Cao; Yingjun,0,71,50,50
1650860686510,CSE 134B,A01,083661,Powell; Thomas Allan,0,38,65,65
1650860692535,CSE 140,A01,083663,Staff,0,12,75,75
1650860698559,CSE 140L,A01,083088,Eldon; John,0,20,75,75
1650860704582,CSE 175,A01,083665,Kumar; Rakesh,7,0,25,18
1650860710618,CSE 190,A00,092507,Dubnov; Shlomo,10,0,20,10
1650860716641,ECE 45,A01,083139,Staff,0,4,60,60
1650860722666,ECE 65,A50,083695,Staff,0,5,30,30
1650860728692,ECE 109,A01,091882,Touri; Behrouz,32,0,70,38
1650860734819,ECE 180,A00,083140,Abi Samra; Nicholas Camill,20,0,30,10
1650860734819,ECE 180,B00,083141,Abi Samra; Nicholas Camill,0,0,30,30
1650860740850,MATH 10A,A01,083735,Patchell; Gregory David,2,0,30,28
1650860740850,MATH 10A,A02,083736,Patchell; Gregory David,27,0,30,3
1650860740850,MATH 10A,A03,083737,Patchell; Gregory David,23,0,30,7
1650860746876,MATH 10B,A01,083207,Staff,0,9,30,30
1650860746876,MATH 10B,A02,083208,Staff,0,6,30,30
1650860746876,MATH 10B,B01,083739,Staff,10,0,30,20
1650860746876,MATH 10B,B02,083740,Staff,28,0,30,2
1650860752902,MATH 18,A01,083743,Staff,0,0,30,30
1650860752902,MATH 18,A02,083744,Staff,23,0,30,7
1650860752902,MATH 18,A03,083745,Staff,21,0,30,9
1650860752902,MATH 18,A04,083746,Staff,26,0,30,4
1650860752902,MATH 18,B01,083748,Staff,0,15,30,30
1650860752902,MATH 18,B02,083749,Staff,0,13,30,30
1650860752902,MATH 18,B03,083750,Staff,0,13,30,30
1650860752902,MATH 18,B04,083751,Staff,0,13,30,30
1650860758924,MATH 20A,A01,083754,Staff,19,0,40,21
1650860764952,MATH 20B,A01,083756,Staff,0,14,30,30
1650860764952,MATH 20B,A02,083757,Staff,0,12,30,30
1650860770980,MATH 20C,A01,083760,Staff,0,17,30,30
1650860770980,MATH 20C,A02,083761,Staff,0,16,30,30
1650860770980,MATH 20C,B01,083762,Staff,9,0,30,21
1650860770980,MATH 20C,B02,083763,Staff,28,0,30,2
1650860777002,MATH 20D,A01,083765,Staff,2,1,30,28
1650860777002,MATH 20D,A02,083766,Staff,6,0,30,24
1650860777002,MATH 20D,A03,083767,Staff,23,0,30,7
1650860783031,MATH 20E,A01,083771,Staff,2,0,30,28
1650860783031,MATH 20E,A02,083772,Staff,13,0,30,17
1650860783031,MATH 20E,B01,083773,Staff,0,0,30,30
1650860783031,MATH 20E,B02,083774,Staff,4,0,30,26
1650860789054,MATH 103A,A01,083777,Staff,0,17,30,30
1650860789054,MATH 103A,A02,083778,Staff,0,15,30,30
1650860789054,MATH 103A,B01,083779,Staff,0,15,30,30
1650860789054,MATH 103A,B02,083780,Staff,1,15,30,29
1650860795080,MATH 105,A01,085443,Staff,0,22,30,30
1650860801109,MATH 109,A01,083213,Anzaldo; Leesa B,0,7,30,30
1650860801109,MATH 109,A02,083214,Anzaldo; Leesa B,0,7,30,30
1650860801109,MATH 109,B01,083215,Anzaldo; Leesa B,0,8,30,30
1650860801109,MATH 109,B02,083216,Anzaldo; Leesa B,0,7,30,30
1650860807131,MATH 142A,A01,083219,Chow; Bennett,0,14,30,30
1650860807131,MATH 142A,A02,083220,Chow; Bennett,0,15,30,30
1650860807131,MATH 142A,B01,083221,Chow; Bennett,0,16,30,30
1650860807131,MATH 142A,B02,083222,Chow; Bennett,0,14,30,30
1650860813158,MATH 193A,A01,083224,Staff,0,6,30,30
1650860813158,MATH 193A,A02,083225,Staff,0,7,30,30
1650860813158,MATH 193A,A03,083781,Staff,0,6,30,30
1650860813158,MATH 193A,A04,083782,Staff,0,7,30,30
1650860819183,MATH 197,001,091859,McAuley; Julian John,9998,0,9999,1
1650860825241,COGS 9,A01,083615,Staff,0,17,60,60
1650860831268,COGS 11,A01,083617,Boyle; Mary E. T.,15,0,40,25
1650860837291,COGS 13,A01,083071,Staff,0,38,40,40
1650860843314,COGS 14A,A01,092681,Staff,0,36,100,100
1650860849336,COGS 14B,A01,083073,Cheng; Tzu-Han,0,12,50,50
1650860855358,COGS 17,A01,092677,Staff,12,0,75,63
1650860861382,COGS 100,A01,083619,Staff,0,30,60,60
1650860867404,COGS 101A,A01,083621,Davis; Joshua Daniel,0,29,60,60
1650860873425,COGS 101B,A01,091572,Staff,0,3,60,60
1650860879448,COGS 101C,A01,083625,Delgado; Tania,14,0,30,16
1650860885475,COGS 107A,A01,083627,Boyle; Mary E. T.,0,16,60,60
1650860891500,COGS 118A,A01,083075,Staff,0,8,60,60
1650860897523,CSE 3,A50,083646,Miranda; Gregory Joseph,18,0,38,20
1650860897523,CSE 3,A51,083647,Miranda; Gregory Joseph,36,0,37,1
1650860903544,CSE 8A,A50,083650,Miranda; Gregory Joseph,0,29,40,40
1650860909569,CSE 11,A01,083080,Cao; Yingjun,0,96,40,40
1650860915595,CSE 12,A01,083652,Staff,0,21,100,100
1650860921618,CSE 15L,A01,083654,Staff,0,3,50,50
1650860921618,CSE 15L,A02,083655,Staff,0,3,50,50
1650860927645,CSE 20,A01,083657,Staff,49,0,80,31
1650860933668,CSE 30,A01,083084,Eldon; John,0,76,40,40
1650860939701,CSE 100,A01,083659,Cao; Yingjun,0,71,50,50
1650860945726,CSE 134B,A01,083661,Powell; Thomas Allan,0,38,65,65
1650860951751,CSE 140,A01,083663,Staff,0,12,75,75
1650860957775,CSE 140L,A01,083088,Eldon; John,0,20,75,75
1650860963797,CSE 175,A01,083665,Kumar; Rakesh,7,0,25,18
1650860969823,CSE 190,A00,092507,Dubnov; Shlomo,10,0,20,10
1650860975847,ECE 45,A01,083139,Staff,0,4,60,60
1650860981872,ECE 65,A50,083695,Staff,0,5,30,30
1650860987896,ECE 109,A01,091882,Touri; Behrouz,32,0,70,38
1650860993931,ECE 180,A00,083140,Abi Samra; Nicholas Camill,20,0,30,10
1650860993931,ECE 180,B00,083141,Abi Samra; Nicholas Camill,0,0,30,30
1650860999955,MATH 10A,A01,083735,Patchell; Gregory David,2,0,30,28
1650860999955,MATH 10A,A02,083736,Patchell; Gregory David,27,0,30,3
1650860999955,MATH 10A,A03,083737,Patchell; Gregory David,24,0,30,6
1650861005978,MATH 10B,A01,083207,Staff,0,9,30,30
1650861005978,MATH 10B,A02,083208,Staff,0,6,30,30
1650861005978,MATH 10B,B01,083739,Staff,10,0,30,20
1650861005978,MATH 10B,B02,083740,Staff,28,0,30,2
1650861012003,MATH 18,A01,083743,Staff,0,0,30,30
1650861012003,MATH 18,A02,083744,Staff,23,0,30,7
1650861012003,MATH 18,A03,083745,Staff,21,0,30,9
1650861012003,MATH 18,A04,083746,Staff,26,0,30,4
1650861012003,MATH 18,B01,083748,Staff,0,15,30,30
1650861012003,MATH 18,B02,083749,Staff,0,13,30,30
1650861012003,MATH 18,B03,083750,Staff,0,13,30,30
1650861012003,MATH 18,B04,083751,Staff,0,13,30,30
1650861018026,MATH 20A,A01,083754,Staff,19,0,40,21
1650861024062,MATH 20B,A01,083756,Staff,0,14,30,30
1650861024062,MATH 20B,A02,083757,Staff,0,12,30,30
1650861030087,MATH 20C,A01,083760,Staff,0,17,30,30
1650861030087,MATH 20C,A02,083761,Staff,0,16,30,30
1650861030087,MATH 20C,B01,083762,Staff,9,0,30,21
1650861030087,MATH 20C,B02,083763,Staff,28,0,30,2
1650861036129,MATH 20D,A01,083765,Staff,2,1,30,28
1650861036129,MATH 20D,A02,083766,Staff,6,0,30,24
1650861036129,MATH 20D,A03,083767,Staff,23,0,30,7
1650861042155,MATH 20E,A01,083771,Staff,2,0,30,28
1650861042155,MATH 20E,A02,083772,Staff,13,0,30,17
1650861042155,MATH 20E,B01,083773,Staff,0,0,30,30
1650861042155,MATH 20E,B02,083774,Staff,4,0,30,26
1650861048179,MATH 103A,A01,083777,Staff,0,17,30,30
1650861048179,MATH 103A,A02,083778,Staff,0,15,30,30
1650861048179,MATH 103A,B01,083779,Staff,0,15,30,30
1650861048179,MATH 103A,B02,083780,Staff,1,15,30,29
1650861054201,MATH 105,A01,085443,Staff,0,22,30,30
1650861060231,MATH 109,A01,083213,Anzaldo; Leesa B,0,7,30,30
1650861060231,MATH 109,A02,083214,Anzaldo; Leesa B,0,7,30,30
1650861060231,MATH 109,B01,083215,Anzaldo; Leesa B,0,8,30,30
1650861060231,MATH 109,B02,083216,Anzaldo; Leesa B,0,7,30,30
1650861066256,MATH 142A,A01,083219,Chow; Bennett,0,14,30,30
1650861066256,MATH 142A,A02,083220,Chow; Bennett,0,15,30,30
1650861066256,MATH 142A,B01,083221,Chow; Bennett,0,16,30,30
1650861066256,MATH 142A,B02,083222,Chow; Bennett,0,14,30,30
1650861072279,MATH 193A,A01,083224,Staff,0,6,30,30
1650861072279,MATH 193A,A02,083225,Staff,0,7,30,30
1650861072279,MATH 193A,A03,083781,Staff,0,6,30,30
1650861072279,MATH 193A,A04,083782,Staff,0,7,30,30
1650861078302,MATH 197,001,091859,McAuley; Julian John,9998,0,9999,1
1650861084367,COGS 9,A01,083615,Staff,0,17,60,60
1650861090393,COGS 11,A01,083617,Boyle; Mary E. T.,15,0,40,25
1650861096417,COGS 13,A01,083071,Staff,0,38,40,40
1650861102444,COGS 14A,A01,092681,Staff,0,36,100,100
1650861108467,COGS 14B,A01,083073,Cheng; Tzu-Han,0,12,50,50
1650861114493,COGS 17,A01,092677,Staff,12,0,75,63
1650861120518,COGS 100,A01,083619,Staff,0,30,60,60
1650861126545,COGS 101A,A01,083621,Davis; Joshua Daniel,0,29,60,60
1650861132570,COGS 101B,A01,091572,Staff,0,3,60,60
1650861138593,COGS 101C,A01,083625,Delgado; Tania,14,0,30,16
1650861144618,COGS 107A,A01,083627,Boyle; Mary E. T.,0,16,60,60
1650861150641,COGS 118A,A01,083075,Staff,0,8,60,60
1650861156676,CSE 3,A50,083646,Miranda; Gregory Joseph,18,0,38,20
1650861156676,CSE 3,A51,083647,Miranda; Gregory Joseph,36,0,37,1
1650861162707,CSE 8A,A50,083650,Miranda; Gregory Joseph,0,29,40,40
1650861168730,CSE 11,A01,083080,Cao; Yingjun,0,96,40,40
1650861174754,CSE 12,A01,083652,Staff,0,21,100,100
1650861180777,CSE 15L,A01,083654,Staff,0,3,50,50
1650861180777,CSE 15L,A02,083655,Staff,0,3,50,50
1650861186800,CSE 20,A01,083657,Staff,49,0,80,31
1650861192827,CSE 30,A01,083084,Eldon; John,0,76,40,40
1650861198850,CSE 100,A01,083659,Cao; Yingjun,0,71,50,50
1650861204872,CSE 134B,A01,083661,Powell; Thomas Allan,0,38,65,65
1650861210896,CSE 140,A01,083663,Staff,0,12,75,75
1650861216919,CSE 140L,A01,083088,Eldon; John,0,20,75,75
1650861222945,CSE 175,A01,083665,Kumar; Rakesh,7,0,25,18
1650861228980,CSE 190,A00,092507,Dubnov; Shlomo,10,0,20,10
1650861235007,ECE 45,A01,083139,Staff,0,4,60,60
1650861241031,ECE 65,A50,083695,Staff,0,5,30,30
1650861247055,ECE 109,A01,091882,Touri; Behrouz,32,0,70,38
1650861253079,ECE 180,A00,083140,Abi Samra; Nicholas Camill,20,0,30,10
1650861253079,ECE 180,B00,083141,Abi Samra; Nicholas Camill,0,0,30,30
1650861259106,MATH 10A,A01,083735,Patchell; Gregory David,2,0,30,28
1650861259106,MATH 10A,A02,083736,Patchell; Gregory David,27,0,30,3
1650861259106,MATH 10A,A03,083737,Patchell; Gregory David,24,0,30,6
1650861265133,MATH 10B,A01,083207,Staff,0,9,30,30
1650861265133,MATH 10B,A02,083208,Staff,0,6,30,30
1650861265133,MATH 10B,B01,083739,Staff,10,0,30,20
1650861265133,MATH 10B,B02,083740,Staff,28,0,30,2
1650861271163,MATH 18,A01,083743,Staff,0,0,30,30
1650861271163,MATH 18,A02,083744,Staff,23,0,30,7
1650861271163,MATH 18,A03,083745,Staff,21,0,30,9
1650861271163,MATH 18,A04,083746,Staff,26,0,30,4
1650861271163,MATH 18,B01,083748,Staff,0,15,30,30
1650861271163,MATH 18,B02,083749,Staff,0,13,30,30
1650861271163,MATH 18,B03,083750,Staff,0,13,30,30
1650861271163,MATH 18,B04,083751,Staff,0,13,30,30
1650861277193,MATH 20A,A01,083754,Staff,19,0,40,21
1650861283217,MATH 20B,A01,083756,Staff,0,14,30,30
1650861283217,MATH 20B,A02,083757,Staff,0,12,30,30
1650861289244,MATH 20C,A01,083760,Staff,0,17,30,30
1650861289244,MATH 20C,A02,083761,Staff,0,16,30,30
1650861289244,MATH 20C,B01,083762,Staff,9,0,30,21
1650861289244,MATH 20C,B02,083763,Staff,28,0,30,2
1650861295269,MATH 20D,A01,083765,Staff,2,1,30,28
1650861295269,MATH 20D,A02,083766,Staff,6,0,30,24
1650861295269,MATH 20D,A03,083767,Staff,23,0,30,7
1650861301307,MATH 20E,A01,083771,Staff,2,0,30,28
1650861301307,MATH 20E,A02,083772,Staff,13,0,30,17
1650861301307,MATH 20E,B01,083773,Staff,0,0,30,30
1650861301307,MATH 20E,B02,083774,Staff,4,0,30,26
1650861307331,MATH 103A,A01,083777,Staff,0,17,30,30
1650861307331,MATH 103A,A02,083778,Staff,0,15,30,30
1650861307331,MATH 103A,B01,083779,Staff,0,15,30,30
1650861307331,MATH 103A,B02,083780,Staff,1,15,30,29
1650861313362,MATH 105,A01,085443,Staff,0,22,30,30
1650861319386,MATH 109,A01,083213,Anzaldo; Leesa B,0,7,30,30
1650861319386,MATH 109,A02,083214,Anzaldo; Leesa B,0,7,30,30
1650861319386,MATH 109,B01,083215,Anzaldo; Leesa B,0,8,30,30
1650861319386,MATH 109,B02,083216,Anzaldo; Leesa B,0,7,30,30
1650861325413,MATH 142A,A01,083219,Chow; Bennett,0,14,30,30
1650861325413,MATH 142A,A02,083220,Chow; Bennett,0,15,30,30
1650861325413,MATH 142A,B01,083221,Chow; Bennett,0,16,30,30
1650861325413,MATH 142A,B02,083222,Chow; Bennett,0,14,30,30
1650861331536,MATH 193A,A01,083224,Staff,0,6,30,30
1650861331536,MATH 193A,A02,083225,Staff,0,7,30,30
1650861331536,MATH 193A,A03,083781,Staff,0,6,30,30
1650861331536,MATH 193A,A04,083782,Staff,0,7,30,30
1650861337569,MATH 197,001,091859,McAuley; Julian John,9998,0,9999,1
1650861343634,COGS 9,A01,083615,Staff,0,17,60,60
1650861349657,COGS 11,A01,083617,Boyle; Mary E. T.,15,0,40,25
1650861355681,COGS 13,A01,083071,Staff,0,38,40,40
1650861361707,COGS 14A,A01,092681,Staff,0,36,100,100
1650861367738,COGS 14B,A01,083073,Cheng; Tzu-Han,0,12,50,50
1650861373764,COGS 17,A01,092677,Staff,12,0,75,63
1650861379786,COGS 100,A01,083619,Staff,0,30,60,60
1650861385813,COGS 101A,A01,083621,Davis; Joshua Daniel,0,29,60,60
1650861391841,COGS 101B,A01,091572,Staff,0,3,60,60
1650861397866,COGS 101C,A01,083625,Delgado; Tania,14,0,30,16
1650861403892,COGS 107A,A01,083627,Boyle; Mary E. T.,0,16,60,60
1650861409916,COGS 118A,A01,083075,Staff,0,8,60,60
1650861415940,CSE 3,A50,083646,Miranda; Gregory Joseph,18,0,38,20
1650861415940,CSE 3,A51,083647,Miranda; Gregory Joseph,36,0,37,1
1650861421965,CSE 8A,A50,083650,Miranda; Gregory Joseph,0,29,40,40
1650861427989,CSE 11,A01,083080,Cao; Yingjun,0,96,40,40
1650861434016,CSE 12,A01,083652,Staff,0,21,100,100
1650861440038,CSE 15L,A01,083654,Staff,0,3,50,50
1650861440038,CSE 15L,A02,083655,Staff,0,3,50,50
1650861446065,CSE 20,A01,083657,Staff,49,0,80,31
1650861452089,CSE 30,A01,083084,Eldon; John,0,76,40,40
1650861458113,CSE 100,A01,083659,Cao; Yingjun,0,71,50,50
1650861464137,CSE 134B,A01,083661,Powell; Thomas Allan,0,38,65,65
1650861470160,CSE 140,A01,083663,Staff,0,12,75,75
1650861476187,CSE 140L,A01,083088,Eldon; John,0,20,75,75
1650861482214,CSE 175,A01,083665,Kumar; Rakesh,7,0,25,18
1650861488239,CSE 190,A00,092507,Dubnov; Shlomo,10,0,20,10
1650861494262,ECE 45,A01,083139,Staff,0,4,60,60
1650861500288,ECE 65,A50,083695,Staff,0,5,30,30
1650861506316,ECE 109,A01,091882,Touri; Behrouz,32,0,70,38
1650861512337,ECE 180,A00,083140,Abi Samra; Nicholas Camill,20,0,30,10
1650861512337,ECE 180,B00,083141,Abi Samra; Nicholas Camill,0,0,30,30
1650861518364,MATH 10A,A01,083735,Patchell; Gregory David,2,0,30,28
1650861518364,MATH 10A,A02,083736,Patchell; Gregory David,27,0,30,3
1650861518364,MATH 10A,A03,083737,Patchell; Gregory David,24,0,30,6
1650861524393,MATH 10B,A01,083207,Staff,0,9,30,30
1650861524393,MATH 10B,A02,083208,Staff,0,6,30,30
1650861524393,MATH 10B,B01,083739,Staff,10,0,30,20
1650861524393,MATH 10B,B02,083740,Staff,28,0,30,2
1650861530418,MATH 18,A01,083743,Staff,0,0,30,30
1650861530418,MATH 18,A02,083744,Staff,23,0,30,7
1650861530418,MATH 18,A03,083745,Staff,21,0,30,9
1650861530418,MATH 18,A04,083746,Staff,26,0,30,4
1650861530418,MATH 18,B01,083748,Staff,0,15,30,30
1650861530418,MATH 18,B02,083749,Staff,0,13,30,30
1650861530418,MATH 18,B03,083750,Staff,0,13,30,30
1650861530418,MATH 18,B04,083751,Staff,0,13,30,30
1650861536451,MATH 20A,A01,083754,Staff,19,0,40,21
1650861542475,MATH 20B,A01,083756,Staff,0,14,30,30
1650861542475,MATH 20B,A02,083757,Staff,0,12,30,30
1650861548505,MATH 20C,A01,083760,Staff,0,17,30,30
1650861548505,MATH 20C,A02,083761,Staff,0,16,30,30
1650861548505,MATH 20C,B01,083762,Staff,9,0,30,21
1650861548505,MATH 20C,B02,083763,Staff,28,0,30,2
1650861554542,MATH 20D,A01,083765,Staff,2,1,30,28
1650861554542,MATH 20D,A02,083766,Staff,6,0,30,24
1650861554542,MATH 20D,A03,083767,Staff,23,0,30,7
1650861560565,MATH 20E,A01,083771,Staff,2,0,30,28
1650861560565,MATH 20E,A02,083772,Staff,13,0,30,17
1650861560565,MATH 20E,B01,083773,Staff,0,0,30,30
1650861560565,MATH 20E,B02,083774,Staff,4,0,30,26
1650861566593,MATH 103A,A01,083777,Staff,0,17,30,30
1650861566593,MATH 103A,A02,083778,Staff,0,15,30,30
1650861566593,MATH 103A,B01,083779,Staff,0,15,30,30
1650861566593,MATH 103A,B02,083780,Staff,1,15,30,29
1650861572615,MATH 105,A01,085443,Staff,0,22,30,30
1650861578642,MATH 109,A01,083213,Anzaldo; Leesa B,0,7,30,30
1650861578642,MATH 109,A02,083214,Anzaldo; Leesa B,0,7,30,30
1650861578642,MATH 109,B01,083215,Anzaldo; Leesa B,0,8,30,30
1650861578642,MATH 109,B02,083216,Anzaldo; Leesa B,0,7,30,30
1650861584666,MATH 142A,A01,083219,Chow; Bennett,0,14,30,30
1650861584666,MATH 142A,A02,083220,Chow; Bennett,0,15,30,30
1650861584666,MATH 142A,B01,083221,Chow; Bennett,0,16,30,30
1650861584666,MATH 142A,B02,083222,Chow; Bennett,0,14,30,30
1650861590693,MATH 193A,A01,083224,Staff,0,6,30,30
1650861590693,MATH 193A,A02,083225,Staff,0,7,30,30
1650861590693,MATH 193A,A03,083781,Staff,0,6,30,30
1650861590693,MATH 193A,A04,083782,Staff,0,7,30,30
1650861596725,MATH 197,001,091859,McAuley; Julian John,9998,0,9999,1
1650861602786,COGS 9,A01,083615,Staff,0,17,60,60
1650861608809,COGS 11,A01,083617,Boyle; Mary E. T.,15,0,40,25
1650861614832,COGS 13,A01,083071,Staff,0,38,40,40
1650861620855,COGS 14A,A01,092681,Staff,0,36,100,100
1650861626878,COGS 14B,A01,083073,Cheng; Tzu-Han,0,12,50,50
1650861632903,COGS 17,A01,092677,Staff,12,0,75,63
1650861638931,COGS 100,A01,083619,Staff,0,30,60,60
1650861644955,COGS 101A,A01,083621,Davis; Joshua Daniel,0,29,60,60
1650861650977,COGS 101B,A01,091572,Staff,0,3,60,60
1650861657000,COGS 101C,A01,083625,Delgado; Tania,14,0,30,16
1650861663029,COGS 107A,A01,083627,Boyle; Mary E. T.,0,16,60,60
1650861669053,COGS 118A,A01,083075,Staff,0,8,60,60
1650861675076,CSE 3,A50,083646,Miranda; Gregory Joseph,18,0,38,20
1650861675076,CSE 3,A51,083647,Miranda; Gregory Joseph,36,0,37,1
1650861681101,CSE 8A,A50,083650,Miranda; Gregory Joseph,0,29,40,40
1650861687125,CSE 11,A01,083080,Cao; Yingjun,0,96,40,40
1650861693148,CSE 12,A01,083652,Staff,0,21,100,100
1650861699176,CSE 15L,A01,083654,Staff,0,3,50,50
1650861699176,CSE 15L,A02,083655,Staff,0,3,50,50
1650861705199,CSE 20,A01,083657,Staff,49,0,80,31
1650861711231,CSE 30,A01,083084,Eldon; John,0,76,40,40
1650861717255,CSE 100,A01,083659,Cao; Yingjun,0,71,50,50
1650861723280,CSE 134B,A01,083661,Powell; Thomas Allan,0,38,65,65
1650861729311,CSE 140,A01,083663,Staff,0,12,75,75
1650861735337,CSE 140L,A01,083088,Eldon; John,0,20,75,75
1650861741368,CSE 175,A01,083665,Kumar; Rakesh,7,0,25,18
1650861747391,CSE 190,A00,092507,Dubnov; Shlomo,10,0,20,10
1650861753414,ECE 45,A01,083139,Staff,0,4,60,60
1650861759440,ECE 65,A50,083695,Staff,0,5,30,30
1650861765466,ECE 109,A01,091882,Touri; Behrouz,32,0,70,38
1650861771495,ECE 180,A00,083140,Abi Samra; Nicholas Camill,20,0,30,10
1650861771495,ECE 180,B00,083141,Abi Samra; Nicholas Camill,0,0,30,30
1650861777517,MATH 10A,A01,083735,Patchell; Gregory David,2,0,30,28
1650861777517,MATH 10A,A02,083736,Patchell; Gregory David,27,0,30,3
1650861777517,MATH 10A,A03,083737,Patchell; Gregory David,23,0,30,7
1650861783544,MATH 10B,A01,083207,Staff,0,9,30,30
1650861783544,MATH 10B,A02,083208,Staff,0,6,30,30
1650861783544,MATH 10B,B01,083739,Staff,10,0,30,20
1650861783544,MATH 10B,B02,083740,Staff,28,0,30,2
1650861789569,MATH 18,A01,083743,Staff,0,0,30,30
1650861789569,MATH 18,A02,083744,Staff,23,0,30,7
1650861789569,MATH 18,A03,083745,Staff,21,0,30,9
1650861789569,MATH 18,A04,083746,Staff,26,0,30,4
1650861789569,MATH 18,B01,083748,Staff,0,15,30,30
1650861789569,MATH 18,B02,083749,Staff,0,13,30,30
1650861789569,MATH 18,B03,083750,Staff,0,13,30,30
1650861789569,MATH 18,B04,083751,Staff,0,13,30,30
1650861795593,MATH 20A,A01,083754,Staff,19,0,40,21
1650861801617,MATH 20B,A01,083756,Staff,0,14,30,30
1650861801617,MATH 20B,A02,083757,Staff,0,12,30,30
1650861807647,MATH 20C,A01,083760,Staff,0,17,30,30
1650861807647,MATH 20C,A02,083761,Staff,0,16,30,30
1650861807647,MATH 20C,B01,083762,Staff,9,0,30,21
1650861807647,MATH 20C,B02,083763,Staff,28,0,30,2
1650861813670,MATH 20D,A01,083765,Staff,2,1,30,28
1650861813670,MATH 20D,A02,083766,Staff,6,0,30,24
1650861813670,MATH 20D,A03,083767,Staff,23,0,30,7
1650861819695,MATH 20E,A01,083771,Staff,2,0,30,28
1650861819695,MATH 20E,A02,083772,Staff,13,0,30,17
1650861819695,MATH 20E,B01,083773,Staff,0,0,30,30
1650861819695,MATH 20E,B02,083774,Staff,4,0,30,26
1650861825730,MATH 103A,A01,083777,Staff,0,17,30,30
1650861825730,MATH 103A,A02,083778,Staff,0,15,30,30
1650861825730,MATH 103A,B01,083779,Staff,0,15,30,30
1650861825730,MATH 103A,B02,083780,Staff,1,15,30,29
1650861831757,MATH 105,A01,085443,Staff,0,22,30,30
1650861837781,MATH 109,A01,083213,Anzaldo; Leesa B,0,7,30,30
1650861837781,MATH 109,A02,083214,Anzaldo; Leesa B,0,7,30,30
1650861837781,MATH 109,B01,083215,Anzaldo; Leesa B,0,8,30,30
1650861837781,MATH 109,B02,083216,Anzaldo; Leesa B,0,7,30,30
1650861843810,MATH 142A,A01,083219,Chow; Bennett,0,14,30,30
1650861843810,MATH 142A,A02,083220,Chow; Bennett,0,15,30,30
1650861843810,MATH 142A,B01,083221,Chow; Bennett,0,16,30,30
1650861843810,MATH 142A,B02,083222,Chow; Bennett,0,14,30,30
1650861849834,MATH 193A,A01,083224,Staff,0,6,30,30
1650861849834,MATH 193A,A02,083225,Staff,0,7,30,30
1650861849834,MATH 193A,A03,083781,Staff,0,6,30,30
1650861849834,MATH 193A,A04,083782,Staff,0,7,30,30
1650861855856,MATH 197,001,091859,McAuley; Julian John,9998,0,9999,1
1650861861913,COGS 9,A01,083615,Staff,0,17,60,60
1650861867935,COGS 11,A01,083617,Boyle; Mary E. T.,15,0,40,25
1650861873962,COGS 13,A01,083071,Staff,0,38,40,40
1650861879985,COGS 14A,A01,092681,Staff,0,36,100,100
1650861886009,COGS 14B,A01,083073,Cheng; Tzu-Han,0,12,50,50
1650861892035,COGS 17,A01,092677,Staff,12,0,75,63
1650861898059,COGS 100,A01,083619,Staff,0,30,60,60
1650861904083,COGS 101A,A01,083621,Davis; Joshua Daniel,0,29,60,60
1650861910109,COGS 101B,A01,091572,Staff,0,3,60,60
1650861916141,COGS 101C,A01,083625,Delgado; Tania,14,0,30,16
1650861922254,COGS 107A,A01,083627,Boyle; Mary E. T.,0,16,60,60
1650861928281,COGS 118A,A01,083075,Staff,0,8,60,60
1650861934307,CSE 3,A50,083646,Miranda; Gregory Joseph,18,0,38,20
1650861934307,CSE 3,A51,083647,Miranda; Gregory Joseph,36,0,37,1
1650861940336,CSE 8A,A50,083650,Miranda; Gregory Joseph,0,29,40,40
1650861946362,CSE 11,A01,083080,Cao; Yingjun,0,96,40,40
1650861952385,CSE 12,A01,083652,Staff,0,21,100,100
1650861958409,CSE 15L,A01,083654,Staff,0,3,50,50
1650861958409,CSE 15L,A02,083655,Staff,0,3,50,50
1650861964432,CSE 20,A01,083657,Staff,49,0,80,31
1650861970460,CSE 30,A01,083084,Eldon; John,0,76,40,40
1650861976483,CSE 100,A01,083659,Cao; Yingjun,0,71,50,50
1650861982507,CSE 134B,A01,083661,Powell; Thomas Allan,0,38,65,65
1650861988532,CSE 140,A01,083663,Staff,0,12,75,75
1650861994566,CSE 140L,A01,083088,Eldon; John,0,20,75,75
1650862000596,CSE 175,A01,083665,Kumar; Rakesh,7,0,25,18
1650862006622,CSE 190,A00,092507,Dubnov; Shlomo,10,0,20,10
1650862012646,ECE 45,A01,083139,Staff,0,4,60,60
1650862018669,ECE 65,A50,083695,Staff,0,5,30,30
1650862024693,ECE 109,A01,091882,Touri; Behrouz,32,0,70,38
1650862030720,ECE 180,A00,083140,Abi Samra; Nicholas Camill,20,0,30,10
1650862030720,ECE 180,B00,083141,Abi Samra; Nicholas Camill,0,0,30,30
1650862036747,MATH 10A,A01,083735,Patchell; Gregory David,2,0,30,28
1650862036747,MATH 10A,A02,083736,Patchell; Gregory David,27,0,30,3
1650862036747,MATH 10A,A03,083737,Patchell; Gregory David,23,0,30,7
1650862042772,MATH 10B,A01,083207,Staff,0,9,30,30
1650862042772,MATH 10B,A02,083208,Staff,0,6,30,30
1650862042772,MATH 10B,B01,083739,Staff,10,0,30,20
1650862042772,MATH 10B,B02,083740,Staff,28,0,30,2
1650862048802,MATH 18,A01,083743,Staff,0,0,30,30
1650862048802,MATH 18,A02,083744,Staff,23,0,30,7
1650862048802,MATH 18,A03,083745,Staff,21,0,30,9
1650862048802,MATH 18,A04,083746,Staff,26,0,30,4
1650862048802,MATH 18,B01,083748,Staff,0,15,30,30
1650862048802,MATH 18,B02,083749,Staff,0,13,30,30
1650862048802,MATH 18,B03,083750,Staff,0,13,30,30
1650862048802,MATH 18,B04,083751,Staff,0,13,30,30
1650862054825,MATH 20A,A01,083754,Staff,19,0,40,21
1650862060851,MATH 20B,A01,083756,Staff,0,14,30,30
1650862060851,MATH 20B,A02,083757,Staff,0,12,30,30
1650862066875,MATH 20C,A01,083760,Staff,0,17,30,30
1650862066875,MATH 20C,A02,083761,Staff,0,16,30,30
1650862066875,MATH 20C,B01,083762,Staff,9,0,30,21
1650862066875,MATH 20C,B02,083763,Staff,28,0,30,2
1650862072902,MATH 20D,A01,083765,Staff,2,1,30,28
1650862072902,MATH 20D,A02,083766,Staff,6,0,30,24
1650862072902,MATH 20D,A03,083767,Staff,23,0,30,7
1650862078926,MATH 20E,A01,083771,Staff,2,0,30,28
1650862078926,MATH 20E,A02,083772,Staff,13,0,30,17
1650862078926,MATH 20E,B01,083773,Staff,0,0,30,30
1650862078926,MATH 20E,B02,083774,Staff,4,0,30,26
1650862084951,MATH 103A,A01,083777,Staff,0,17,30,30
1650862084951,MATH 103A,A02,083778,Staff,0,15,30,30
1650862084951,MATH 103A,B01,083779,Staff,0,15,30,30
1650862084951,MATH 103A,B02,083780,Staff,1,15,30,29
1650862090979,MATH 105,A01,085443,Staff,0,22,30,30
1650862097004,MATH 109,A01,083213,Anzaldo; Leesa B,0,7,30,30
1650862097004,MATH 109,A02,083214,Anzaldo; Leesa B,0,7,30,30
1650862097004,MATH 109,B01,083215,Anzaldo; Leesa B,0,8,30,30
1650862097004,MATH 109,B02,083216,Anzaldo; Leesa B,0,7,30,30
1650862103027,MATH 142A,A01,083219,Chow; Bennett,0,14,30,30
1650862103027,MATH 142A,A02,083220,Chow; Bennett,0,15,30,30
1650862103027,MATH 142A,B01,083221,Chow; Bennett,0,16,30,30
1650862103027,MATH 142A,B02,083222,Chow; Bennett,0,14,30,30
1650862109050,MATH 193A,A01,083224,Staff,0,6,30,30
1650862109050,MATH 193A,A02,083225,Staff,0,7,30,30
1650862109050,MATH 193A,A03,083781,Staff,0,6,30,30
1650862109050,MATH 193A,A04,083782,Staff,0,7,30,30
1650862115072,MATH 197,001,091859,McAuley; Julian John,9998,0,9999,1
1650862121133,COGS 9,A01,083615,Staff,0,17,60,60
1650862127157,COGS 11,A01,083617,Boyle; Mary E. T.,15,0,40,25
1650862133181,COGS 13,A01,083071,Staff,0,38,40,40
1650862139204,COGS 14A,A01,092681,Staff,0,36,100,100
1650862145226,COGS 14B,A01,083073,Cheng; Tzu-Han,0,12,50,50
1650862151250,COGS 17,A01,092677,Staff,12,0,75,63
1650862157272,COGS 100,A01,083619,Staff,0,30,60,60
1650862163299,COGS 101A,A01,083621,Davis; Joshua Daniel,0,29,60,60
1650862169321,COGS 101B,A01,091572,Staff,0,3,60,60
1650862175348,COGS 101C,A01,083625,Delgado; Tania,14,0,30,16
1650862181372,COGS 107A,A01,083627,Boyle; Mary E. T.,0,16,60,60
1650862187394,COGS 118A,A01,083075,Staff,0,8,60,60
1650862193417,CSE 3,A50,083646,Miranda; Gregory Joseph,18,0,38,20
1650862193417,CSE 3,A51,083647,Miranda; Gregory Joseph,36,0,37,1
1650862199444,CSE 8A,A50,083650,Miranda; Gregory Joseph,0,29,40,40
1650862205466,CSE 11,A01,083080,Cao; Yingjun,0,96,40,40
1650862211489,CSE 12,A01,083652,Staff,0,21,100,100
1650862217511,CSE 15L,A01,083654,Staff,0,3,50,50
1650862217511,CSE 15L,A02,083655,Staff,0,3,50,50
1650862223532,CSE 20,A01,083657,Staff,49,0,80,31
1650862229557,CSE 30,A01,083084,Eldon; John,0,76,40,40
1650862235584,CSE 100,A01,083659,Cao; Yingjun,0,71,50,50
1650862241609,CSE 134B,A01,083661,Powell; Thomas Allan,0,38,65,65
1650862247633,CSE 140,A01,083663,Staff,0,12,75,75
1650862253656,CSE 140L,A01,083088,Eldon; John,0,20,75,75
1650862259681,CSE 175,A01,083665,Kumar; Rakesh,7,0,25,18
1650862265704,CSE 190,A00,092507,Dubnov; Shlomo,10,0,20,10
1650862271726,ECE 45,A01,083139,Staff,0,4,60,60
1650862277749,ECE 65,A50,083695,Staff,0,5,30,30
1650862283773,ECE 109,A01,091882,Touri; Behrouz,32,0,70,38
1650862289797,ECE 180,A00,083140,Abi Samra; Nicholas Camill,20,0,30,10
1650862289797,ECE 180,B00,083141,Abi Samra; Nicholas Camill,0,0,30,30
1650862295820,MATH 10A,A01,083735,Patchell; Gregory David,2,0,30,28
1650862295820,MATH 10A,A02,083736,Patchell; Gregory David,27,0,30,3
1650862295820,MATH 10A,A03,083737,Patchell; Gregory David,23,0,30,7
1650862301850,MATH 10B,A01,083207,Staff,0,9,30,30
1650862301850,MATH 10B,A02,083208,Staff,0,6,30,30
1650862301850,MATH 10B,B01,083739,Staff,10,0,30,20
1650862301850,MATH 10B,B02,083740,Staff,28,0,30,2
1650862307876,MATH 18,A01,083743,Staff,0,0,30,30
1650862307876,MATH 18,A02,083744,Staff,23,0,30,7
1650862307876,MATH 18,A03,083745,Staff,21,0,30,9
1650862307876,MATH 18,A04,083746,Staff,26,0,30,4
1650862307876,MATH 18,B01,083748,Staff,0,15,30,30
1650862307876,MATH 18,B02,083749,Staff,0,13,30,30
1650862307876,MATH 18,B03,083750,Staff,0,13,30,30
1650862307876,MATH 18,B04,083751,Staff,0,13,30,30
1650862313902,MATH 20A,A01,083754,Staff,19,0,40,21
1650862319929,MATH 20B,A01,083756,Staff,0,14,30,30
1650862319929,MATH 20B,A02,083757,Staff,0,12,30,30
1650862325953,MATH 20C,A01,083760,Staff,0,17,30,30
1650862325953,MATH 20C,A02,083761,Staff,0,16,30,30
1650862325953,MATH 20C,B01,083762,Staff,9,0,30,21
1650862325953,MATH 20C,B02,083763,Staff,28,0,30,2
1650862331987,MATH 20D,A01,083765,Staff,2,1,30,28
1650862331987,MATH 20D,A02,083766,Staff,6,0,30,24
1650862331987,MATH 20D,A03,083767,Staff,23,0,30,7
1650862338010,MATH 20E,A01,083771,Staff,2,0,30,28
1650862338010,MATH 20E,A02,083772,Staff,13,0,30,17
1650862338010,MATH 20E,B01,083773,Staff,0,0,30,30
1650862338010,MATH 20E,B02,083774,Staff,4,0,30,26
1650862344034,MATH 103A,A01,083777,Staff,0,17,30,30
1650862344034,MATH 103A,A02,083778,Staff,0,15,30,30
1650862344034,MATH 103A,B01,083779,Staff,0,15,30,30
1650862344034,MATH 103A,B02,083780,Staff,1,15,30,29
1650862350061,MATH 105,A01,085443,Staff,0,22,30,30
1650862356088,MATH 109,A01,083213,Anzaldo; Leesa B,0,7,30,30
1650862356088,MATH 109,A02,083214,Anzaldo; Leesa B,0,7,30,30
1650862356088,MATH 109,B01,083215,Anzaldo; Leesa B,0,8,30,30
1650862356088,MATH 109,B02,083216,Anzaldo; Leesa B,0,7,30,30
1650862362116,MATH 142A,A01,083219,Chow; Bennett,0,14,30,30
1650862362116,MATH 142A,A02,083220,Chow; Bennett,0,15,30,30
1650862362116,MATH 142A,B01,083221,Chow; Bennett,0,16,30,30
1650862362116,MATH 142A,B02,083222,Chow; Bennett,0,14,30,30
1650862368143,MATH 193A,A01,083224,Staff,0,6,30,30
1650862368143,MATH 193A,A02,083225,Staff,0,7,30,30
1650862368143,MATH 193A,A03,083781,Staff,0,6,30,30
1650862368143,MATH 193A,A04,083782,Staff,0,7,30,30
1650862374169,MATH 197,001,091859,McAuley; Julian John,9998,0,9999,1
1650862380235,COGS 9,A01,083615,Staff,0,17,60,60
1650862386258,COGS 11,A01,083617,Boyle; Mary E. T.,15,0,40,25
1650862392284,COGS 13,A01,083071,Staff,0,38,40,40
1650862398305,COGS 14A,A01,092681,Staff,0,36,100,100
1650862404344,COGS 14B,A01,083073,Cheng; Tzu-Han,0,12,50,50
1650862410374,COGS 17,A01,092677,Staff,12,0,75,63
1650862416400,COGS 100,A01,083619,Staff,0,30,60,60
1650862422428,COGS 101A,A01,083621,Davis; Joshua Daniel,0,29,60,60
1650862428455,COGS 101B,A01,091572,Staff,0,3,60,60
1650862434493,COGS 101C,A01,083625,Delgado; Tania,14,0,30,16
1650862440516,COGS 107A,A01,083627,Boyle; Mary E. T.,0,16,60,60
1650862446538,COGS 118A,A01,083075,Staff,0,8,60,60
1650862452567,CSE 3,A50,083646,Miranda; Gregory Joseph,18,0,38,20
1650862452567,CSE 3,A51,083647,Miranda; Gregory Joseph,36,0,37,1
1650862458593,CSE 8A,A50,083650,Miranda; Gregory Joseph,0,29,40,40
1650862464617,CSE 11,A01,083080,Cao; Yingjun,0,96,40,40
1650862470641,CSE 12,A01,083652,Staff,0,21,100,100
1650862476668,CSE 15L,A01,083654,Staff,0,3,50,50
1650862476668,CSE 15L,A02,083655,Staff,0,3,50,50
1650862482695,CSE 20,A01,083657,Staff,49,0,80,31
1650862488719,CSE 30,A01,083084,Eldon; John,0,76,40,40
1650862494743,CSE 100,A01,083659,Cao; Yingjun,0,71,50,50
1650862500768,CSE 134B,A01,083661,Powell; Thomas Allan,0,38,65,65
1650862506794,CSE 140,A01,083663,Staff,0,12,75,75
1650862512819,CSE 140L,A01,083088,Eldon; John,0,20,75,75
1650862518933,CSE 175,A01,083665,Kumar; Rakesh,7,0,25,18
1650862524957,CSE 190,A00,092507,Dubnov; Shlomo,10,0,20,10
1650862530980,ECE 45,A01,083139,Staff,0,4,60,60
1650862537007,ECE 65,A50,083695,Staff,0,5,30,30
1650862543034,ECE 109,A01,091882,Touri; Behrouz,32,0,70,38
1650862549057,ECE 180,A00,083140,Abi Samra; Nicholas Camill,20,0,30,10
1650862549057,ECE 180,B00,083141,Abi Samra; Nicholas Camill,0,0,30,30
1650862555079,MATH 10A,A01,083735,Patchell; Gregory David,2,0,30,28
1650862555079,MATH 10A,A02,083736,Patchell; Gregory David,27,0,30,3
1650862555079,MATH 10A,A03,083737,Patchell; Gregory David,23,0,30,7
1650862561103,MATH 10B,A01,083207,Staff,0,9,30,30
1650862561103,MATH 10B,A02,083208,Staff,0,6,30,30
1650862561103,MATH 10B,B01,083739,Staff,10,0,30,20
1650862561103,MATH 10B,B02,083740,Staff,28,0,30,2
1650862567136,MATH 18,A01,083743,Staff,0,0,30,30
1650862567136,MATH 18,A02,083744,Staff,23,0,30,7
1650862567136,MATH 18,A03,083745,Staff,21,0,30,9
1650862567136,MATH 18,A04,083746,Staff,26,0,30,4
1650862567136,MATH 18,B01,083748,Staff,0,15,30,30
1650862567136,MATH 18,B02,083749,Staff,0,13,30,30
1650862567136,MATH 18,B03,083750,Staff,0,13,30,30
1650862567136,MATH 18,B04,083751,Staff,0,13,30,30
1650862573159,MATH 20A,A01,083754,Staff,19,0,40,21
1650862579185,MATH 20B,A01,083756,Staff,0,14,30,30
1650862579185,MATH 20B,A02,083757,Staff,0,12,30,30
1650862585212,MATH 20C,A01,083760,Staff,0,17,30,30
1650862585212,MATH 20C,A02,083761,Staff,0,16,30,30
1650862585212,MATH 20C,B01,083762,Staff,9,0,30,21
1650862585212,MATH 20C,B02,083763,Staff,28,0,30,2
1650862591238,MATH 20D,A01,083765,Staff,2,1,30,28
1650862591238,MATH 20D,A02,083766,Staff,6,0,30,24
1650862591238,MATH 20D,A03,083767,Staff,23,0,30,7
1650862597262,MATH 20E,A01,083771,Staff,2,0,30,28
1650862597262,MATH 20E,A02,083772,Staff,13,0,30,17
1650862597262,MATH 20E,B01,083773,Staff,0,0,30,30
1650862597262,MATH 20E,B02,083774,Staff,4,0,30,26
1650862603285,MATH 103A,A01,083777,Staff,0,17,30,30
1650862603285,MATH 103A,A02,083778,Staff,0,15,30,30
1650862603285,MATH 103A,B01,083779,Staff,0,15,30,30
1650862603285,MATH 103A,B02,083780,Staff,1,15,30,29
1650862609311,MATH 105,A01,085443,Staff,0,22,30,30
1650862615338,MATH 109,A01,083213,Anzaldo; Leesa B,0,7,30,30
1650862615338,MATH 109,A02,083214,Anzaldo; Leesa B,0,7,30,30
1650862615338,MATH 109,B01,083215,Anzaldo; Leesa B,0,8,30,30
1650862615338,MATH 109,B02,083216,Anzaldo; Leesa B,0,7,30,30
1650862621366,MATH 142A,A01,083219,Chow; Bennett,0,14,30,30
1650862621366,MATH 142A,A02,083220,Chow; Bennett,0,15,30,30
1650862621366,MATH 142A,B01,083221,Chow; Bennett,0,16,30,30
1650862621366,MATH 142A,B02,083222,Chow; Bennett,0,14,30,30
1650862627390,MATH 193A,A01,083224,Staff,0,6,30,30
1650862627390,MATH 193A,A02,083225,Staff,0,7,30,30
1650862627390,MATH 193A,A03,083781,Staff,0,6,30,30
1650862627390,MATH 193A,A04,083782,Staff,0,7,30,30
1650862633413,MATH 197,001,091859,McAuley; Julian John,9998,0,9999,1
1650862639469,COGS 9,A01,083615,Staff,0,17,60,60
1650862645492,COGS 11,A01,083617,Boyle; Mary E. T.,15,0,40,25
1650862651516,COGS 13,A01,083071,Staff,0,38,40,40
1650862657539,COGS 14A,A01,092681,Staff,0,36,100,100
1650862663562,COGS 14B,A01,083073,Cheng; Tzu-Han,0,12,50,50
1650862669585,COGS 17,A01,092677,Staff,12,0,75,63
1650862675609,COGS 100,A01,083619,Staff,0,30,60,60
1650862681639,COGS 101A,A01,083621,Davis; Joshua Daniel,0,29,60,60
1650862687664,COGS 101B,A01,091572,Staff,0,3,60,60
1650862693687,COGS 101C,A01,083625,Delgado; Tania,14,0,30,16
1650862699712,COGS 107A,A01,083627,Boyle; Mary E. T.,0,16,60,60
1650862705735,COGS 118A,A01,083075,Staff,0,8,60,60
1650862711759,CSE 3,A50,083646,Miranda; Gregory Joseph,18,0,38,20
1650862711759,CSE 3,A51,083647,Miranda; Gregory Joseph,36,0,37,1
1650862729887,CSE 8A,A50,083650,Miranda; Gregory Joseph,0,29,40,40
1650862735916,CSE 11,A01,083080,Cao; Yingjun,0,96,40,40
1650862741939,CSE 12,A01,083652,Staff,0,21,100,100
1650862747967,CSE 15L,A01,083654,Staff,0,3,50,50
1650862747967,CSE 15L,A02,083655,Staff,0,3,50,50
1650862753989,CSE 20,A01,083657,Staff,49,0,80,31
1650862760016,CSE 30,A01,083084,Eldon; John,0,76,40,40
1650862766039,CSE 100,A01,083659,Cao; Yingjun,0,71,50,50
1650862772061,CSE 134B,A01,083661,Powell; Thomas Allan,0,38,65,65
1650862778085,CSE 140,A01,083663,Staff,0,12,75,75
1650862784110,CSE 140L,A01,083088,Eldon; John,0,20,75,75
1650862790133,CSE 175,A01,083665,Kumar; Rakesh,7,0,25,18
1650862796156,CSE 190,A00,092507,Dubnov; Shlomo,10,0,20,10
1650862802185,ECE 45,A01,083139,Staff,0,4,60,60
1650862808213,ECE 65,A50,083695,Staff,0,5,30,30
1650862814240,ECE 109,A01,091882,Touri; Behrouz,32,0,70,38
1650862820266,ECE 180,A00,083140,Abi Samra; Nicholas Camill,20,0,30,10
1650862820266,ECE 180,B00,083141,Abi Samra; Nicholas Camill,0,0,30,30
1650862826294,MATH 10A,A01,083735,Patchell; Gregory David,2,0,30,28
1650862826294,MATH 10A,A02,083736,Patchell; Gregory David,27,0,30,3
1650862826294,MATH 10A,A03,083737,Patchell; Gregory David,23,0,30,7
1650862832317,MATH 10B,A01,083207,Staff,0,9,30,30
1650862832317,MATH 10B,A02,083208,Staff,0,6,30,30
1650862832317,MATH 10B,B01,083739,Staff,10,0,30,20
1650862832317,MATH 10B,B02,083740,Staff,28,0,30,2
1650862838346,MATH 18,A01,083743,Staff,0,0,30,30
1650862838346,MATH 18,A02,083744,Staff,23,0,30,7
1650862838346,MATH 18,A03,083745,Staff,21,0,30,9
1650862838346,MATH 18,A04,083746,Staff,26,0,30,4
1650862838346,MATH 18,B01,083748,Staff,0,15,30,30
1650862838346,MATH 18,B02,083749,Staff,0,13,30,30
1650862838346,MATH 18,B03,083750,Staff,0,13,30,30
1650862838346,MATH 18,B04,083751,Staff,0,13,30,30
1650862844370,MATH 20A,A01,083754,Staff,19,0,40,21
1650862850394,MATH 20B,A01,083756,Staff,0,14,30,30
1650862850394,MATH 20B,A02,083757,Staff,0,12,30,30
1650862856417,MATH 20C,A01,083760,Staff,0,17,30,30
1650862856417,MATH 20C,A02,083761,Staff,0,16,30,30
1650862856417,MATH 20C,B01,083762,Staff,9,0,30,21
1650862856417,MATH 20C,B02,083763,Staff,28,0,30,2
1650862862439,MATH 20D,A01,083765,Staff,2,1,30,28
1650862862439,MATH 20D,A02,083766,Staff,6,0,30,24
1650862862439,MATH 20D,A03,083767,Staff,23,0,30,7
1650862868487,MATH 20E,A01,083771,Staff,2,0,30,28
1650862868487,MATH 20E,A02,083772,Staff,13,0,30,17
1650862868487,MATH 20E,B01,083773,Staff,0,0,30,30
1650862868487,MATH 20E,B02,083774,Staff,4,0,30,26
1650862874514,MATH 103A,A01,083777,Staff,0,17,30,30
1650862874514,MATH 103A,A02,083778,Staff,0,15,30,30
1650862874514,MATH 103A,B01,083779,Staff,0,15,30,30
1650862874514,MATH 103A,B02,083780,Staff,1,15,30,29
1650862880544,MATH 105,A01,085443,Staff,0,22,30,30
1650862886567,MATH 109,A01,083213,Anzaldo; Leesa B,0,7,30,30
1650862886567,MATH 109,A02,083214,Anzaldo; Leesa B,0,7,30,30
1650862886567,MATH 109,B01,083215,Anzaldo; Leesa B,0,8,30,30
1650862886567,MATH 109,B02,083216,Anzaldo; Leesa B,0,7,30,30
1650862892588,MATH 142A,A01,083219,Chow; Bennett,0,14,30,30
1650862892588,MATH 142A,A02,083220,Chow; Bennett,0,15,30,30
1650862892588,MATH 142A,B01,083221,Chow; Bennett,0,16,30,30
1650862892588,MATH 142A,B02,083222,Chow; Bennett,0,14,30,30
1650862898616,MATH 193A,A01,083224,Staff,0,6,30,30
1650862898616,MATH 193A,A02,083225,Staff,0,7,30,30
1650862898616,MATH 193A,A03,083781,Staff,0,6,30,30
1650862898616,MATH 193A,A04,083782,Staff,0,7,30,30
1650862904639,MATH 197,001,091859,McAuley; Julian John,9998,0,9999,1
1650862910697,COGS 9,A01,083615,Staff,0,17,60,60
1650862916736,COGS 11,A01,083617,Boyle; Mary E. T.,15,0,40,25
1650862922761,COGS 13,A01,083071,Staff,0,38,40,40
1650862928783,COGS 14A,A01,092681,Staff,0,36,100,100
1650862934810,COGS 14B,A01,083073,Cheng; Tzu-Han,0,12,50,50
1650862940842,COGS 17,A01,092677,Staff,12,0,75,63
1650862946865,COGS 100,A01,083619,Staff,0,30,60,60
1650862952897,COGS 101A,A01,083621,Davis; Joshua Daniel,0,29,60,60
1650862958925,COGS 101B,A01,091572,Staff,0,3,60,60
1650862964950,COGS 101C,A01,083625,Delgado; Tania,14,0,30,16
1650862970983,COGS 107A,A01,083627,Boyle; Mary E. T.,0,16,60,60
1650862977009,COGS 118A,A01,083075,Staff,0,8,60,60
1650862983032,CSE 3,A50,083646,Miranda; Gregory Joseph,18,0,38,20
1650862983032,CSE 3,A51,083647,Miranda; Gregory Joseph,36,0,37,1
1650862989062,CSE 8A,A50,083650,Miranda; Gregory Joseph,0,29,40,40
1650862995084,CSE 11,A01,083080,Cao; Yingjun,0,96,40,40
1650863001108,CSE 12,A01,083652,Staff,0,21,100,100
1650863007132,CSE 15L,A01,083654,Staff,0,3,50,50
1650863007132,CSE 15L,A02,083655,Staff,0,3,50,50
1650863013159,CSE 20,A01,083657,Staff,49,0,80,31
1650863019187,CSE 30,A01,083084,Eldon; John,0,76,40,40
1650863025217,CSE 100,A01,083659,Cao; Yingjun,0,71,50,50
1650863031242,CSE 134B,A01,083661,Powell; Thomas Allan,0,38,65,65
1650863037263,CSE 140,A01,083663,Staff,0,12,75,75
1650863043291,CSE 140L,A01,083088,Eldon; John,0,20,75,75
1650863049314,CSE 175,A01,083665,Kumar; Rakesh,7,0,25,18
1650863055337,CSE 190,A00,092507,Dubnov; Shlomo,10,0,20,10
1650863061361,ECE 45,A01,083139,Staff,0,4,60,60
1650863067384,ECE 65,A50,083695,Staff,0,5,30,30
1650863073407,ECE 109,A01,091882,Touri; Behrouz,32,0,70,38
1650863079432,ECE 180,A00,083140,Abi Samra; Nicholas Camill,20,0,30,10
1650863079432,ECE 180,B00,083141,Abi Samra; Nicholas Camill,0,0,30,30
1650863085455,MATH 10A,A01,083735,Patchell; Gregory David,2,0,30,28
1650863085455,MATH 10A,A02,083736,Patchell; Gregory David,27,0,30,3
1650863085455,MATH 10A,A03,083737,Patchell; Gregory David,23,0,30,7
1650863091479,MATH 10B,A01,083207,Staff,0,9,30,30
1650863091479,MATH 10B,A02,083208,Staff,0,6,30,30
1650863091479,MATH 10B,B01,083739,Staff,10,0,30,20
1650863091479,MATH 10B,B02,083740,Staff,28,0,30,2
1650863097509,MATH 18,A01,083743,Staff,0,0,30,30
1650863097509,MATH 18,A02,083744,Staff,23,0,30,7
1650863097509,MATH 18,A03,083745,Staff,21,0,30,9
1650863097509,MATH 18,A04,083746,Staff,26,0,30,4
1650863097509,MATH 18,B01,083748,Staff,0,15,30,30
1650863097509,MATH 18,B02,083749,Staff,0,13,30,30
1650863097509,MATH 18,B03,083750,Staff,0,13,30,30
1650863097509,MATH 18,B04,083751,Staff,0,13,30,30
1650863103532,MATH 20A,A01,083754,Staff,19,0,40,21
1650863109556,MATH 20B,A01,083756,Staff,0,14,30,30
1650863109556,MATH 20B,A02,083757,Staff,0,12,30,30
1650863115584,MATH 20C,A01,083760,Staff,0,17,30,30
1650863115584,MATH 20C,A02,083761,Staff,0,16,30,30
1650863115584,MATH 20C,B01,083762,Staff,9,0,30,21
1650863115584,MATH 20C,B02,083763,Staff,28,0,30,2
1650863121610,MATH 20D,A01,083765,Staff,2,1,30,28
1650863121610,MATH 20D,A02,083766,Staff,6,0,30,24
1650863121610,MATH 20D,A03,083767,Staff,23,0,30,7
1650863127727,MATH 20E,A01,083771,Staff,2,0,30,28
1650863127727,MATH 20E,A02,083772,Staff,13,0,30,17
1650863127727,MATH 20E,B01,083773,Staff,0,0,30,30
1650863127727,MATH 20E,B02,083774,Staff,4,0,30,26
1650863133764,MATH 103A,A01,083777,Staff,0,17,30,30
1650863133764,MATH 103A,A02,083778,Staff,0,15,30,30
1650863133764,MATH 103A,B01,083779,Staff,0,15,30,30
1650863133764,MATH 103A,B02,083780,Staff,1,15,30,29
1650863139787,MATH 105,A01,085443,Staff,0,22,30,30
1650863145816,MATH 109,A01,083213,Anzaldo; Leesa B,0,7,30,30
1650863145816,MATH 109,A02,083214,Anzaldo; Leesa B,0,7,30,30
1650863145816,MATH 109,B01,083215,Anzaldo; Leesa B,0,8,30,30
1650863145816,MATH 109,B02,083216,Anzaldo; Leesa B,0,7,30,30
1650863151841,MATH 142A,A01,083219,Chow; Bennett,0,14,30,30
1650863151841,MATH 142A,A02,083220,Chow; Bennett,0,15,30,30
1650863151841,MATH 142A,B01,083221,Chow; Bennett,0,16,30,30
1650863151841,MATH 142A,B02,083222,Chow; Bennett,0,14,30,30
1650863157877,MATH 193A,A01,083224,Staff,0,6,30,30
1650863157877,MATH 193A,A02,083225,Staff,0,7,30,30
1650863157877,MATH 193A,A03,083781,Staff,0,6,30,30
1650863157877,MATH 193A,A04,083782,Staff,0,7,30,30
1650863163901,MATH 197,001,091859,McAuley; Julian John,9998,0,9999,1
1650863169975,COGS 9,A01,083615,Staff,0,17,60,60
1650863175998,COGS 11,A01,083617,Boyle; Mary E. T.,15,0,40,25
1650863182020,COGS 13,A01,083071,Staff,0,38,40,40
1650863188045,COGS 14A,A01,092681,Staff,0,36,100,100
1650863194073,COGS 14B,A01,083073,Cheng; Tzu-Han,0,12,50,50
1650863200096,COGS 17,A01,092677,Staff,12,0,75,63
1650863206120,COGS 100,A01,083619,Staff,0,30,60,60
1650863212144,COGS 101A,A01,083621,Davis; Joshua Daniel,0,29,60,60
1650863218167,COGS 101B,A01,091572,Staff,0,3,60,60
1650863224190,COGS 101C,A01,083625,Delgado; Tania,14,0,30,16
1650863230218,COGS 107A,A01,083627,Boyle; Mary E. T.,0,16,60,60
1650863236252,COGS 118A,A01,083075,Staff,0,8,60,60
1650863242275,CSE 3,A50,083646,Miranda; Gregory Joseph,18,0,38,20
1650863242275,CSE 3,A51,083647,Miranda; Gregory Joseph,36,0,37,1
1650863248303,CSE 8A,A50,083650,Miranda; Gregory Joseph,0,29,40,40
1650863254328,CSE 11,A01,083080,Cao; Yingjun,0,96,40,40
1650863260358,CSE 12,A01,083652,Staff,0,21,100,100
1650863266381,CSE 15L,A01,083654,Staff,0,3,50,50
1650863266381,CSE 15L,A02,083655,Staff,0,3,50,50
1650863272405,CSE 20,A01,083657,Staff,49,0,80,31
1650863278430,CSE 30,A01,083084,Eldon; John,0,76,40,40
1650863284460,CSE 100,A01,083659,Cao; Yingjun,0,71,50,50
1650863290483,CSE 134B,A01,083661,Powell; Thomas Allan,0,38,65,65
1650863296506,CSE 140,A01,083663,Staff,0,12,75,75
1650863302529,CSE 140L,A01,083088,Eldon; John,0,20,75,75
1650863308552,CSE 175,A01,083665,Kumar; Rakesh,7,0,25,18
1650863314577,CSE 190,A00,092507,Dubnov; Shlomo,10,0,20,10
1650863320600,ECE 45,A01,083139,Staff,0,4,60,60
1650863326622,ECE 65,A50,083695,Staff,0,5,30,30
1650863332652,ECE 109,A01,091882,Touri; Behrouz,32,0,70,38
1650863338676,ECE 180,A00,083140,Abi Samra; Nicholas Camill,20,0,30,10
1650863338676,ECE 180,B00,083141,Abi Samra; Nicholas Camill,0,0,30,30
1650863344705,MATH 10A,A01,083735,Patchell; Gregory David,2,0,30,28
1650863344705,MATH 10A,A02,083736,Patchell; Gregory David,27,0,30,3
1650863344705,MATH 10A,A03,083737,Patchell; Gregory David,23,0,30,7
1650863350729,MATH 10B,A01,083207,Staff,0,9,30,30
1650863350729,MATH 10B,A02,083208,Staff,0,6,30,30
1650863350729,MATH 10B,B01,083739,Staff,10,0,30,20
1650863350729,MATH 10B,B02,083740,Staff,28,0,30,2
1650863356753,MATH 18,A01,083743,Staff,0,0,30,30
1650863356753,MATH 18,A02,083744,Staff,23,0,30,7
1650863356753,MATH 18,A03,083745,Staff,21,0,30,9
1650863356753,MATH 18,A04,083746,Staff,26,0,30,4
1650863356753,MATH 18,B01,083748,Staff,0,15,30,30
1650863356753,MATH 18,B02,083749,Staff,0,13,30,30
1650863356753,MATH 18,B03,083750,Staff,0,13,30,30
1650863356753,MATH 18,B04,083751,Staff,0,13,30,30
1650863362777,MATH 20A,A01,083754,Staff,19,0,40,21
1650863368801,MATH 20B,A01,083756,Staff,0,14,30,30
1650863368801,MATH 20B,A02,083757,Staff,0,12,30,30
1650863374829,MATH 20C,A01,083760,Staff,0,17,30,30
1650863374829,MATH 20C,A02,083761,Staff,0,16,30,30
1650863374829,MATH 20C,B01,083762,Staff,9,0,30,21
1650863374829,MATH 20C,B02,083763,Staff,28,0,30,2
1650863380855,MATH 20D,A01,083765,Staff,2,1,30,28
1650863380855,MATH 20D,A02,083766,Staff,6,0,30,24
1650863380855,MATH 20D,A03,083767,Staff,23,0,30,7
1650863386882,MATH 20E,A01,083771,Staff,2,0,30,28
1650863386882,MATH 20E,A02,083772,Staff,13,0,30,17
1650863386882,MATH 20E,B01,083773,Staff,0,0,30,30
1650863386882,MATH 20E,B02,083774,Staff,4,0,30,26
1650863392906,MATH 103A,A01,083777,Staff,0,17,30,30
1650863392906,MATH 103A,A02,083778,Staff,0,15,30,30
1650863392906,MATH 103A,B01,083779,Staff,0,15,30,30
1650863392906,MATH 103A,B02,083780,Staff,1,15,30,29
1650863398929,MATH 105,A01,085443,Staff,0,22,30,30
1650863404952,MATH 109,A01,083213,Anzaldo; Leesa B,0,7,30,30
1650863404952,MATH 109,A02,083214,Anzaldo; Leesa B,0,7,30,30
1650863404952,MATH 109,B01,083215,Anzaldo; Leesa B,0,8,30,30
1650863404952,MATH 109,B02,083216,Anzaldo; Leesa B,0,7,30,30
1650863410981,MATH 142A,A01,083219,Chow; Bennett,0,14,30,30
1650863410981,MATH 142A,A02,083220,Chow; Bennett,0,15,30,30
1650863410981,MATH 142A,B01,083221,Chow; Bennett,0,16,30,30
1650863410981,MATH 142A,B02,083222,Chow; Bennett,0,14,30,30
1650863417013,MATH 193A,A01,083224,Staff,0,6,30,30
1650863417013,MATH 193A,A02,083225,Staff,0,7,30,30
1650863417013,MATH 193A,A03,083781,Staff,0,6,30,30
1650863417013,MATH 193A,A04,083782,Staff,0,7,30,30
1650863423045,MATH 197,001,091859,McAuley; Julian John,9998,0,9999,1
1650863429090,COGS 9,A01,083615,Staff,0,17,60,60
1650863435114,COGS 11,A01,083617,Boyle; Mary E. T.,15,0,40,25
1650863441140,COGS 13,A01,083071,Staff,0,38,40,40
1650863447163,COGS 14A,A01,092681,Staff,0,37,100,100
1650863453190,COGS 14B,A01,083073,Cheng; Tzu-Han,0,12,50,50
1650863459212,COGS 17,A01,092677,Staff,12,0,75,63
1650863465236,COGS 100,A01,083619,Staff,0,30,60,60
1650863471262,COGS 101A,A01,083621,Davis; Joshua Daniel,0,29,60,60
1650863477287,COGS 101B,A01,091572,Staff,0,3,60,60
1650863483311,COGS 101C,A01,083625,Delgado; Tania,14,0,30,16
1650863489338,COGS 107A,A01,083627,Boyle; Mary E. T.,0,16,60,60
1650863495365,COGS 118A,A01,083075,Staff,0,8,60,60
1650863501400,CSE 3,A50,083646,Miranda; Gregory Joseph,18,0,38,20
1650863501400,CSE 3,A51,083647,Miranda; Gregory Joseph,36,0,37,1
1650863507428,CSE 8A,A50,083650,Miranda; Gregory Joseph,0,29,40,40
1650863513462,CSE 11,A01,083080,Cao; Yingjun,0,97,40,40
1650863519484,CSE 12,A01,083652,Staff,0,21,100,100
1650863525508,CSE 15L,A01,083654,Staff,0,3,50,50
1650863525508,CSE 15L,A02,083655,Staff,0,3,50,50
1650863531530,CSE 20,A01,083657,Staff,49,0,80,31
1650863537555,CSE 30,A01,083084,Eldon; John,0,76,40,40
1650863543578,CSE 100,A01,083659,Cao; Yingjun,0,71,50,50
1650863549602,CSE 134B,A01,083661,Powell; Thomas Allan,0,38,65,65
1650863555628,CSE 140,A01,083663,Staff,0,12,75,75
1650863561649,CSE 140L,A01,083088,Eldon; John,0,20,75,75
1650863567673,CSE 175,A01,083665,Kumar; Rakesh,7,0,25,18
1650863573695,CSE 190,A00,092507,Dubnov; Shlomo,10,0,20,10
1650863579719,ECE 45,A01,083139,Staff,0,4,60,60
1650863585743,ECE 65,A50,083695,Staff,0,5,30,30
1650863591771,ECE 109,A01,091882,Touri; Behrouz,32,0,70,38
1650863597797,ECE 180,A00,083140,Abi Samra; Nicholas Camill,20,0,30,10
1650863597797,ECE 180,B00,083141,Abi Samra; Nicholas Camill,0,0,30,30
1650863603821,MATH 10A,A01,083735,Patchell; Gregory David,2,0,30,28
1650863603821,MATH 10A,A02,083736,Patchell; Gregory David,27,0,30,3
1650863603821,MATH 10A,A03,083737,Patchell; Gregory David,23,0,30,7
1650863609848,MATH 10B,A01,083207,Staff,0,9,30,30
1650863609848,MATH 10B,A02,083208,Staff,0,6,30,30
1650863609848,MATH 10B,B01,083739,Staff,10,0,30,20
1650863609848,MATH 10B,B02,083740,Staff,28,0,30,2
1650863615873,MATH 18,A01,083743,Staff,0,0,30,30
1650863615873,MATH 18,A02,083744,Staff,23,0,30,7
1650863615873,MATH 18,A03,083745,Staff,21,0,30,9
1650863615873,MATH 18,A04,083746,Staff,26,0,30,4
1650863615873,MATH 18,B01,083748,Staff,0,15,30,30
1650863615873,MATH 18,B02,083749,Staff,0,13,30,30
1650863615873,MATH 18,B03,083750,Staff,0,13,30,30
1650863615873,MATH 18,B04,083751,Staff,0,13,30,30
1650863621897,MATH 20A,A01,083754,Staff,19,0,40,21
1650863627925,MATH 20B,A01,083756,Staff,0,14,30,30
1650863627925,MATH 20B,A02,083757,Staff,0,12,30,30
1650863633953,MATH 20C,A01,083760,Staff,0,17,30,30
1650863633953,MATH 20C,A02,083761,Staff,0,16,30,30
1650863633953,MATH 20C,B01,083762,Staff,9,0,30,21
1650863633953,MATH 20C,B02,083763,Staff,28,0,30,2
1650863639976,MATH 20D,A01,083765,Staff,2,1,30,28
1650863639976,MATH 20D,A02,083766,Staff,6,0,30,24
1650863639976,MATH 20D,A03,083767,Staff,23,0,30,7
1650863646004,MATH 20E,A01,083771,Staff,2,0,30,28
1650863646004,MATH 20E,A02,083772,Staff,13,0,30,17
1650863646004,MATH 20E,B01,083773,Staff,0,0,30,30
1650863646004,MATH 20E,B02,083774,Staff,4,0,30,26
1650863652027,MATH 103A,A01,083777,Staff,0,17,30,30
1650863652027,MATH 103A,A02,083778,Staff,0,15,30,30
1650863652027,MATH 103A,B01,083779,Staff,0,15,30,30
1650863652027,MATH 103A,B02,083780,Staff,1,15,30,29
1650863658054,MATH 105,A01,085443,Staff,0,23,30,30
1650863664078,MATH 109,A01,083213,Anzaldo; Leesa B,0,7,30,30
1650863664078,MATH 109,A02,083214,Anzaldo; Leesa B,0,7,30,30
1650863664078,MATH 109,B01,083215,Anzaldo; Leesa B,0,8,30,30
1650863664078,MATH 109,B02,083216,Anzaldo; Leesa B,0,7,30,30
1650863670106,MATH 142A,A01,083219,Chow; Bennett,0,14,30,30
1650863670106,MATH 142A,A02,083220,Chow; Bennett,0,15,30,30
1650863670106,MATH 142A,B01,083221,Chow; Bennett,0,16,30,30
1650863670106,MATH 142A,B02,083222,Chow; Bennett,0,14,30,30
1650863676133,MATH 193A,A01,083224,Staff,0,6,30,30
1650863676133,MATH 193A,A02,083225,Staff,0,7,30,30
1650863676133,MATH 193A,A03,083781,Staff,0,6,30,30
1650863676133,MATH 193A,A04,083782,Staff,0,7,30,30
1650863682157,MATH 197,001,091859,McAuley; Julian John,9998,0,9999,1
1650863688210,COGS 9,A01,083615,Staff,0,17,60,60
1650863694239,COGS 11,A01,083617,Boyle; Mary E. T.,15,0,40,25
1650863700265,COGS 13,A01,083071,Staff,0,38,40,40
1650863706290,COGS 14A,A01,092681,Staff,0,37,100,100
1650863712322,COGS 14B,A01,083073,Cheng; Tzu-Han,0,12,50,50
1650863718444,COGS 17,A01,092677,Staff,12,0,75,63
1650863724466,COGS 100,A01,083619,Staff,0,30,60,60
1650863730494,COGS 101A,A01,083621,Davis; Joshua Daniel,0,29,60,60
1650863736521,COGS 101B,A01,091572,Staff,0,3,60,60
1650863742545,COGS 101C,A01,083625,Delgado; Tania,14,0,30,16
1650863748574,COGS 107A,A01,083627,Boyle; Mary E. T.,0,16,60,60
1650863754608,COGS 118A,A01,083075,Staff,0,8,60,60
1650863760632,CSE 3,A50,083646,Miranda; Gregory Joseph,18,0,38,20
1650863760632,CSE 3,A51,083647,Miranda; Gregory Joseph,36,0,37,1
1650863766655,CSE 8A,A50,083650,Miranda; Gregory Joseph,0,29,40,40
1650863772682,CSE 11,A01,083080,Cao; Yingjun,0,97,40,40
1650863778704,CSE 12,A01,083652,Staff,0,21,100,100
1650863784731,CSE 15L,A01,083654,Staff,0,3,50,50
1650863784731,CSE 15L,A02,083655,Staff,0,3,50,50
1650863790757,CSE 20,A01,083657,Staff,49,0,80,31
1650863796781,CSE 30,A01,083084,Eldon; John,0,76,40,40
1650863802805,CSE 100,A01,083659,Cao; Yingjun,0,71,50,50
1650863808829,CSE 134B,A01,083661,Powell; Thomas Allan,0,38,65,65
1650863814854,CSE 140,A01,083663,Staff,0,12,75,75
1650863820878,CSE 140L,A01,083088,Eldon; John,0,20,75,75
1650863826902,CSE 175,A01,083665,Kumar; Rakesh,7,0,25,18
1650863832929,CSE 190,A00,092507,Dubnov; Shlomo,10,0,20,10
1650863838955,ECE 45,A01,083139,Staff,0,4,60,60
1650863844981,ECE 65,A50,083695,Staff,0,5,30,30
1650863851004,ECE 109,A01,091882,Touri; Behrouz,32,0,70,38
1650863857031,ECE 180,A00,083140,Abi Samra; Nicholas Camill,20,0,30,10
1650863857031,ECE 180,B00,083141,Abi Samra; Nicholas Camill,0,0,30,30
1650863863059,MATH 10A,A01,083735,Patchell; Gregory David,2,0,30,28
1650863863059,MATH 10A,A02,083736,Patchell; Gregory David,27,0,30,3
1650863863059,MATH 10A,A03,083737,Patchell; Gregory David,23,0,30,7
1650863869083,MATH 10B,A01,083207,Staff,0,9,30,30
1650863869083,MATH 10B,A02,083208,Staff,0,6,30,30
1650863869083,MATH 10B,B01,083739,Staff,10,0,30,20
1650863869083,MATH 10B,B02,083740,Staff,28,0,30,2
1650863875109,MATH 18,A01,083743,Staff,0,0,30,30
1650863875109,MATH 18,A02,083744,Staff,23,0,30,7
1650863875109,MATH 18,A03,083745,Staff,21,0,30,9
1650863875109,MATH 18,A04,083746,Staff,26,0,30,4
1650863875109,MATH 18,B01,083748,Staff,0,15,30,30
1650863875109,MATH 18,B02,083749,Staff,0,13,30,30
1650863875109,MATH 18,B03,083750,Staff,0,13,30,30
1650863875109,MATH 18,B04,083751,Staff,0,13,30,30
1650863881134,MATH 20A,A01,083754,Staff,19,0,40,21
1650863887157,MATH 20B,A01,083756,Staff,0,14,30,30
1650863887157,MATH 20B,A02,083757,Staff,0,12,30,30
1650863893184,MATH 20C,A01,083760,Staff,0,17,30,30
1650863893184,MATH 20C,A02,083761,Staff,0,16,30,30
1650863893184,MATH 20C,B01,083762,Staff,9,0,30,21
1650863893184,MATH 20C,B02,083763,Staff,28,0,30,2
1650863899207,MATH 20D,A01,083765,Staff,2,1,30,28
1650863899207,MATH 20D,A02,083766,Staff,6,0,30,24
1650863899207,MATH 20D,A03,083767,Staff,23,0,30,7
1650863905239,MATH 20E,A01,083771,Staff,2,0,30,28
1650863905239,MATH 20E,A02,083772,Staff,13,0,30,17
1650863905239,MATH 20E,B01,083773,Staff,0,0,30,30
1650863905239,MATH 20E,B02,083774,Staff,4,0,30,26
1650863911266,MATH 103A,A01,083777,Staff,0,17,30,30
1650863911266,MATH 103A,A02,083778,Staff,0,15,30,30
1650863911266,MATH 103A,B01,083779,Staff,0,15,30,30
1650863911266,MATH 103A,B02,083780,Staff,1,15,30,29
1650863917290,MATH 105,A01,085443,Staff,0,23,30,30
1650863923316,MATH 109,A01,083213,Anzaldo; Leesa B,0,7,30,30
1650863923316,MATH 109,A02,083214,Anzaldo; Leesa B,0,7,30,30
1650863923316,MATH 109,B01,083215,Anzaldo; Leesa B,0,8,30,30
1650863923316,MATH 109,B02,083216,Anzaldo; Leesa B,0,7,30,30
1650863929339,MATH 142A,A01,083219,Chow; Bennett,0,14,30,30
1650863929339,MATH 142A,A02,083220,Chow; Bennett,0,15,30,30
1650863929339,MATH 142A,B01,083221,Chow; Bennett,0,16,30,30
1650863929339,MATH 142A,B02,083222,Chow; Bennett,0,14,30,30
1650863935362,MATH 193A,A01,083224,Staff,0,6,30,30
1650863935362,MATH 193A,A02,083225,Staff,0,7,30,30
1650863935362,MATH 193A,A03,083781,Staff,0,6,30,30
1650863935362,MATH 193A,A04,083782,Staff,0,7,30,30
1650863941387,MATH 197,001,091859,McAuley; Julian John,9998,0,9999,1
1650863947445,COGS 9,A01,083615,Staff,0,17,60,60
1650863953467,COGS 11,A01,083617,Boyle; Mary E. T.,15,0,40,25
1650863959494,COGS 13,A01,083071,Staff,0,38,40,40
1650863965520,COGS 14A,A01,092681,Staff,0,37,100,100
1650863971543,COGS 14B,A01,083073,Cheng; Tzu-Han,0,12,50,50
1650863977566,COGS 17,A01,092677,Staff,12,0,75,63
1650863983593,COGS 100,A01,083619,Staff,0,30,60,60
1650863989617,COGS 101A,A01,083621,Davis; Joshua Daniel,0,29,60,60
1650863995639,COGS 101B,A01,091572,Staff,0,3,60,60
1650864001666,COGS 101C,A01,083625,Delgado; Tania,14,0,30,16
1650864007688,COGS 107A,A01,083627,Boyle; Mary E. T.,0,16,60,60
1650864013714,COGS 118A,A01,083075,Staff,0,8,60,60
1650864019739,CSE 3,A50,083646,Miranda; Gregory Joseph,18,0,38,20
1650864019739,CSE 3,A51,083647,Miranda; Gregory Joseph,36,0,37,1
1650864025765,CSE 8A,A50,083650,Miranda; Gregory Joseph,0,29,40,40
1650864031789,CSE 11,A01,083080,Cao; Yingjun,0,97,40,40
1650864037812,CSE 12,A01,083652,Staff,0,21,100,100
1650864043836,CSE 15L,A01,083654,Staff,0,3,50,50
1650864043836,CSE 15L,A02,083655,Staff,0,3,50,50
1650864049860,CSE 20,A01,083657,Staff,49,0,80,31
1650864055892,CSE 30,A01,083084,Eldon; John,0,76,40,40
1650864061919,CSE 100,A01,083659,Cao; Yingjun,0,71,50,50
1650864067953,CSE 134B,A01,083661,Powell; Thomas Allan,0,38,65,65
1650864073980,CSE 140,A01,083663,Staff,0,12,75,75
1650864080013,CSE 140L,A01,083088,Eldon; John,0,20,75,75
1650864086039,CSE 175,A01,083665,Kumar; Rakesh,7,0,25,18
1650864092062,CSE 190,A00,092507,Dubnov; Shlomo,10,0,20,10
1650864098087,ECE 45,A01,083139,Staff,0,4,60,60
1650864104114,ECE 65,A50,083695,Staff,0,5,30,30
1650864110145,ECE 109,A01,091882,Touri; Behrouz,32,0,70,38
1650864116168,ECE 180,A00,083140,Abi Samra; Nicholas Camill,20,0,30,10
1650864116168,ECE 180,B00,083141,Abi Samra; Nicholas Camill,0,0,30,30
1650864122192,MATH 10A,A01,083735,Patchell; Gregory David,2,0,30,28
1650864122192,MATH 10A,A02,083736,Patchell; Gregory David,27,0,30,3
1650864122192,MATH 10A,A03,083737,Patchell; Gregory David,23,0,30,7
1650864128220,MATH 10B,A01,083207,Staff,0,9,30,30
1650864128220,MATH 10B,A02,083208,Staff,0,6,30,30
1650864128220,MATH 10B,B01,083739,Staff,10,0,30,20
1650864128220,MATH 10B,B02,083740,Staff,28,0,30,2
1650864134244,MATH 18,A01,083743,Staff,0,0,30,30
1650864134244,MATH 18,A02,083744,Staff,23,0,30,7
1650864134244,MATH 18,A03,083745,Staff,21,0,30,9
1650864134244,MATH 18,A04,083746,Staff,26,0,30,4
1650864134244,MATH 18,B01,083748,Staff,0,15,30,30
1650864134244,MATH 18,B02,083749,Staff,0,13,30,30
1650864134244,MATH 18,B03,083750,Staff,0,13,30,30
1650864134244,MATH 18,B04,083751,Staff,0,13,30,30
1650864140270,MATH 20A,A01,083754,Staff,19,0,40,21
1650864146301,MATH 20B,A01,083756,Staff,0,14,30,30
1650864146301,MATH 20B,A02,083757,Staff,0,12,30,30
1650864152329,MATH 20C,A01,083760,Staff,0,17,30,30
1650864152329,MATH 20C,A02,083761,Staff,0,16,30,30
1650864152329,MATH 20C,B01,083762,Staff,9,0,30,21
1650864152329,MATH 20C,B02,083763,Staff,28,0,30,2
1650864158362,MATH 20D,A01,083765,Staff,2,1,30,28
1650864158362,MATH 20D,A02,083766,Staff,6,0,30,24
1650864158362,MATH 20D,A03,083767,Staff,23,0,30,7
1650864164387,MATH 20E,A01,083771,Staff,2,0,30,28
1650864164387,MATH 20E,A02,083772,Staff,13,0,30,17
1650864164387,MATH 20E,B01,083773,Staff,0,0,30,30
1650864164387,MATH 20E,B02,083774,Staff,4,0,30,26
1650864170410,MATH 103A,A01,083777,Staff,0,17,30,30
1650864170410,MATH 103A,A02,083778,Staff,0,15,30,30
1650864170410,MATH 103A,B01,083779,Staff,0,15,30,30
1650864170410,MATH 103A,B02,083780,Staff,1,15,30,29
1650864176437,MATH 105,A01,085443,Staff,0,23,30,30
1650864182464,MATH 109,A01,083213,Anzaldo; Leesa B,0,7,30,30
1650864182464,MATH 109,A02,083214,Anzaldo; Leesa B,0,7,30,30
1650864182464,MATH 109,B01,083215,Anzaldo; Leesa B,0,8,30,30
1650864182464,MATH 109,B02,083216,Anzaldo; Leesa B,0,7,30,30
1650864188486,MATH 142A,A01,083219,Chow; Bennett,0,14,30,30
1650864188486,MATH 142A,A02,083220,Chow; Bennett,0,15,30,30
1650864188486,MATH 142A,B01,083221,Chow; Bennett,0,16,30,30
1650864188486,MATH 142A,B02,083222,Chow; Bennett,0,14,30,30
1650864194509,MATH 193A,A01,083224,Staff,0,6,30,30
1650864194509,MATH 193A,A02,083225,Staff,0,7,30,30
1650864194509,MATH 193A,A03,083781,Staff,0,6,30,30
1650864194509,MATH 193A,A04,083782,Staff,0,7,30,30
1650864200531,MATH 197,001,091859,McAuley; Julian John,9998,0,9999,1
1650864206591,COGS 9,A01,083615,Staff,0,17,60,60
1650864212615,COGS 11,A01,083617,Boyle; Mary E. T.,15,0,40,25
1650864218644,COGS 13,A01,083071,Staff,0,38,40,40
1650864224675,COGS 14A,A01,092681,Staff,0,37,100,100
1650864230701,COGS 14B,A01,083073,Cheng; Tzu-Han,0,12,50,50
1650864236728,COGS 17,A01,092677,Staff,12,0,75,63
1650864242759,COGS 100,A01,083619,Staff,0,30,60,60
1650864248789,COGS 101A,A01,083621,Davis; Joshua Daniel,0,29,60,60
1650864254812,COGS 101B,A01,091572,Staff,0,3,60,60
1650864260841,COGS 101C,A01,083625,Delgado; Tania,14,0,30,16
1650864266865,COGS 107A,A01,083627,Boyle; Mary E. T.,0,16,60,60
1650864272892,COGS 118A,A01,083075,Staff,0,8,60,60
1650864278920,CSE 3,A50,083646,Miranda; Gregory Joseph,18,0,38,20
1650864278920,CSE 3,A51,083647,Miranda; Gregory Joseph,36,0,37,1
1650864284943,CSE 8A,A50,083650,Miranda; Gregory Joseph,0,29,40,40
1650864290969,CSE 11,A01,083080,Cao; Yingjun,0,97,40,40
1650864296994,CSE 12,A01,083652,Staff,0,21,100,100
1650864303021,CSE 15L,A01,083654,Staff,0,3,50,50
1650864303021,CSE 15L,A02,083655,Staff,0,3,50,50
1650864309047,CSE 20,A01,083657,Staff,49,0,80,31
1650864315160,CSE 30,A01,083084,Eldon; John,0,76,40,40
1650864321183,CSE 100,A01,083659,Cao; Yingjun,0,71,50,50
1650864327206,CSE 134B,A01,083661,Powell; Thomas Allan,0,38,65,65
1650864333232,CSE 140,A01,083663,Staff,0,12,75,75
1650864339254,CSE 140L,A01,083088,Eldon; John,0,20,75,75
1650864345278,CSE 175,A01,083665,Kumar; Rakesh,7,0,25,18
1650864351300,CSE 190,A00,092507,Dubnov; Shlomo,10,0,20,10
1650864357332,ECE 45,A01,083139,Staff,0,4,60,60
1650864363356,ECE 65,A50,083695,Staff,0,5,30,30
1650864369378,ECE 109,A01,091882,Touri; Behrouz,32,0,70,38
1650864375404,ECE 180,A00,083140,Abi Samra; Nicholas Camill,20,0,30,10
1650864375404,ECE 180,B00,083141,Abi Samra; Nicholas Camill,0,0,30,30
1650864381432,MATH 10A,A01,083735,Patchell; Gregory David,2,0,30,28
1650864381432,MATH 10A,A02,083736,Patchell; Gregory David,27,0,30,3
1650864381432,MATH 10A,A03,083737,Patchell; Gregory David,23,0,30,7
1650864387460,MATH 10B,A01,083207,Staff,0,9,30,30
1650864387460,MATH 10B,A02,083208,Staff,0,6,30,30
1650864387460,MATH 10B,B01,083739,Staff,10,0,30,20
1650864387460,MATH 10B,B02,083740,Staff,28,0,30,2
1650864393487,MATH 18,A01,083743,Staff,0,0,30,30
1650864393487,MATH 18,A02,083744,Staff,23,0,30,7
1650864393487,MATH 18,A03,083745,Staff,21,0,30,9
1650864393487,MATH 18,A04,083746,Staff,26,0,30,4
1650864393487,MATH 18,B01,083748,Staff,0,15,30,30
1650864393487,MATH 18,B02,083749,Staff,0,13,30,30
1650864393487,MATH 18,B03,083750,Staff,0,13,30,30
1650864393487,MATH 18,B04,083751,Staff,0,13,30,30
1650864399520,MATH 20A,A01,083754,Staff,19,0,40,21
1650864405543,MATH 20B,A01,083756,Staff,0,14,30,30
1650864405543,MATH 20B,A02,083757,Staff,0,12,30,30
1650864411565,MATH 20C,A01,083760,Staff,0,17,30,30
1650864411565,MATH 20C,A02,083761,Staff,0,16,30,30
1650864411565,MATH 20C,B01,083762,Staff,9,0,30,21
1650864411565,MATH 20C,B02,083763,Staff,28,0,30,2
1650864417602,MATH 20D,A01,083765,Staff,2,1,30,28
1650864417602,MATH 20D,A02,083766,Staff,6,0,30,24
1650864417602,MATH 20D,A03,083767,Staff,23,0,30,7
1650864423625,MATH 20E,A01,083771,Staff,2,0,30,28
1650864423625,MATH 20E,A02,083772,Staff,13,0,30,17
1650864423625,MATH 20E,B01,083773,Staff,0,0,30,30
1650864423625,MATH 20E,B02,083774,Staff,4,0,30,26
1650864429648,MATH 103A,A01,083777,Staff,0,17,30,30
1650864429648,MATH 103A,A02,083778,Staff,0,15,30,30
1650864429648,MATH 103A,B01,083779,Staff,0,15,30,30
1650864429648,MATH 103A,B02,083780,Staff,0,14,30,30
1650864435672,MATH 105,A01,085443,Staff,0,23,30,30
1650864441700,MATH 109,A01,083213,Anzaldo; Leesa B,0,7,30,30
1650864441700,MATH 109,A02,083214,Anzaldo; Leesa B,0,7,30,30
1650864441700,MATH 109,B01,083215,Anzaldo; Leesa B,0,8,30,30
1650864441700,MATH 109,B02,083216,Anzaldo; Leesa B,0,7,30,30
1650864447727,MATH 142A,A01,083219,Chow; Bennett,0,14,30,30
1650864447727,MATH 142A,A02,083220,Chow; Bennett,0,15,30,30
1650864447727,MATH 142A,B01,083221,Chow; Bennett,0,16,30,30
1650864447727,MATH 142A,B02,083222,Chow; Bennett,0,14,30,30
1650864453750,MATH 193A,A01,083224,Staff,0,6,30,30
1650864453750,MATH 193A,A02,083225,Staff,0,7,30,30
1650864453750,MATH 193A,A03,083781,Staff,0,6,30,30
1650864453750,MATH 193A,A04,083782,Staff,0,7,30,30
1650864459778,MATH 197,001,091859,McAuley; Julian John,9998,0,9999,1
1650864465836,COGS 9,A01,083615,Staff,0,17,60,60
1650864471859,COGS 11,A01,083617,Boyle; Mary E. T.,15,0,40,25
1650864477882,COGS 13,A01,083071,Staff,0,38,40,40
1650864483906,COGS 14A,A01,092681,Staff,0,37,100,100
1650864489933,COGS 14B,A01,083073,Cheng; Tzu-Han,0,12,50,50
1650864495957,COGS 17,A01,092677,Staff,12,0,75,63
1650864501988,COGS 100,A01,083619,Staff,0,30,60,60
1650864508010,COGS 101A,A01,083621,Davis; Joshua Daniel,0,29,60,60
1650864514041,COGS 101B,A01,091572,Staff,0,3,60,60
1650864520066,COGS 101C,A01,083625,Delgado; Tania,14,0,30,16
1650864526099,COGS 107A,A01,083627,Boyle; Mary E. T.,0,16,60,60
1650864532129,COGS 118A,A01,083075,Staff,0,8,60,60
1650864538156,CSE 3,A50,083646,Miranda; Gregory Joseph,18,0,38,20
1650864538156,CSE 3,A51,083647,Miranda; Gregory Joseph,36,0,37,1
1650864544180,CSE 8A,A50,083650,Miranda; Gregory Joseph,0,29,40,40
1650864550207,CSE 11,A01,083080,Cao; Yingjun,0,97,40,40
1650864556236,CSE 12,A01,083652,Staff,0,21,100,100
1650864562261,CSE 15L,A01,083654,Staff,0,3,50,50
1650864562261,CSE 15L,A02,083655,Staff,0,3,50,50
1650864568289,CSE 20,A01,083657,Staff,49,0,80,31
1650864574315,CSE 30,A01,083084,Eldon; John,0,76,40,40
1650864580348,CSE 100,A01,083659,Cao; Yingjun,0,71,50,50
1650864586374,CSE 134B,A01,083661,Powell; Thomas Allan,0,38,65,65
1650864592398,CSE 140,A01,083663,Staff,0,12,75,75
1650864598422,CSE 140L,A01,083088,Eldon; John,0,20,75,75
1650864604445,CSE 175,A01,083665,Kumar; Rakesh,7,0,25,18
1650864610467,CSE 190,A00,092507,Dubnov; Shlomo,10,0,20,10
1650864616489,ECE 45,A01,083139,Staff,0,4,60,60
1650864622522,ECE 65,A50,083695,Staff,0,5,30,30
1650864628545,ECE 109,A01,091882,Touri; Behrouz,32,0,70,38
1650864634572,ECE 180,A00,083140,Abi Samra; Nicholas Camill,20,0,30,10
1650864634572,ECE 180,B00,083141,Abi Samra; Nicholas Camill,0,0,30,30
1650864640600,MATH 10A,A01,083735,Patchell; Gregory David,2,0,30,28
1650864640600,MATH 10A,A02,083736,Patchell; Gregory David,27,0,30,3
1650864640600,MATH 10A,A03,083737,Patchell; Gregory David,23,0,30,7
1650864646623,MATH 10B,A01,083207,Staff,0,9,30,30
1650864646623,MATH 10B,A02,083208,Staff,0,6,30,30
1650864646623,MATH 10B,B01,083739,Staff,10,0,30,20
1650864646623,MATH 10B,B02,083740,Staff,28,0,30,2
1650864652649,MATH 18,A01,083743,Staff,0,0,30,30
1650864652649,MATH 18,A02,083744,Staff,23,0,30,7
1650864652649,MATH 18,A03,083745,Staff,21,0,30,9
1650864652649,MATH 18,A04,083746,Staff,26,0,30,4
1650864652649,MATH 18,B01,083748,Staff,0,15,30,30
1650864652649,MATH 18,B02,083749,Staff,0,13,30,30
1650864652649,MATH 18,B03,083750,Staff,0,13,30,30
1650864652649,MATH 18,B04,083751,Staff,0,13,30,30
1650864658676,MATH 20A,A01,083754,Staff,19,0,40,21
1650864664706,MATH 20B,A01,083756,Staff,0,14,30,30
1650864664706,MATH 20B,A02,083757,Staff,0,12,30,30
1650864670753,MATH 20C,A01,083760,Staff,0,17,30,30
1650864670753,MATH 20C,A02,083761,Staff,0,16,30,30
1650864670753,MATH 20C,B01,083762,Staff,9,0,30,21
1650864670753,MATH 20C,B02,083763,Staff,28,0,30,2
1650864676776,MATH 20D,A01,083765,Staff,2,1,30,28
1650864676776,MATH 20D,A02,083766,Staff,6,0,30,24
1650864676776,MATH 20D,A03,083767,Staff,23,0,30,7
1650864682801,MATH 20E,A01,083771,Staff,2,0,30,28
1650864682801,MATH 20E,A02,083772,Staff,13,0,30,17
1650864682801,MATH 20E,B01,083773,Staff,0,0,30,30
1650864682801,MATH 20E,B02,083774,Staff,4,0,30,26
1650864688829,MATH 103A,A01,083777,Staff,0,17,30,30
1650864688829,MATH 103A,A02,083778,Staff,0,15,30,30
1650864688829,MATH 103A,B01,083779,Staff,0,15,30,30
1650864688829,MATH 103A,B02,083780,Staff,0,14,30,30
1650864694859,MATH 105,A01,085443,Staff,0,23,30,30
1650864700883,MATH 109,A01,083213,Anzaldo; Leesa B,0,7,30,30
1650864700883,MATH 109,A02,083214,Anzaldo; Leesa B,0,7,30,30
1650864700883,MATH 109,B01,083215,Anzaldo; Leesa B,0,8,30,30
1650864700883,MATH 109,B02,083216,Anzaldo; Leesa B,0,7,30,30
1650864706912,MATH 142A,A01,083219,Chow; Bennett,0,14,30,30
1650864706912,MATH 142A,A02,083220,Chow; Bennett,0,15,30,30
1650864706912,MATH 142A,B01,083221,Chow; Bennett,0,16,30,30
1650864706912,MATH 142A,B02,083222,Chow; Bennett,0,14,30,30
1650864712936,MATH 193A,A01,083224,Staff,0,6,30,30
1650864712936,MATH 193A,A02,083225,Staff,0,7,30,30
1650864712936,MATH 193A,A03,083781,Staff,0,6,30,30
1650864712936,MATH 193A,A04,083782,Staff,0,7,30,30
1650864718958,MATH 197,001,091859,McAuley; Julian John,9998,0,9999,1
1650864725008,COGS 9,A01,083615,Staff,0,17,60,60
1650864731032,COGS 11,A01,083617,Boyle; Mary E. T.,15,0,40,25
1650864737059,COGS 13,A01,083071,Staff,0,38,40,40
1650864743084,COGS 14A,A01,092681,Staff,0,37,100,100
1650864749120,COGS 14B,A01,083073,Cheng; Tzu-Han,0,12,50,50
1650864755143,COGS 17,A01,092677,Staff,12,0,75,63
1650864761165,COGS 100,A01,083619,Staff,0,30,60,60
1650864767199,COGS 101A,A01,083621,Davis; Joshua Daniel,0,29,60,60
1650864773226,COGS 101B,A01,091572,Staff,0,3,60,60
1650864779257,COGS 101C,A01,083625,Delgado; Tania,14,0,30,16
1650864785282,COGS 107A,A01,083627,Boyle; Mary E. T.,0,16,60,60
1650864791307,COGS 118A,A01,083075,Staff,0,8,60,60
1650864797331,CSE 3,A50,083646,Miranda; Gregory Joseph,18,0,38,20
1650864797331,CSE 3,A51,083647,Miranda; Gregory Joseph,36,0,37,1
1650864803355,CSE 8A,A50,083650,Miranda; Gregory Joseph,0,29,40,40
1650864809380,CSE 11,A01,083080,Cao; Yingjun,0,97,40,40
1650864815402,CSE 12,A01,083652,Staff,0,21,100,100
1650864821431,CSE 15L,A01,083654,Staff,0,3,50,50
1650864821431,CSE 15L,A02,083655,Staff,0,3,50,50
1650864827454,CSE 20,A01,083657,Staff,49,0,80,31
1650864833479,CSE 30,A01,083084,Eldon; John,0,76,40,40
1650864839507,CSE 100,A01,083659,Cao; Yingjun,0,71,50,50
1650864845533,CSE 134B,A01,083661,Powell; Thomas Allan,0,38,65,65
1650864851570,CSE 140,A01,083663,Staff,0,12,75,75
1650864857596,CSE 140L,A01,083088,Eldon; John,0,20,75,75
1650864863618,CSE 175,A01,083665,Kumar; Rakesh,7,0,25,18
1650864869641,CSE 190,A00,092507,Dubnov; Shlomo,10,0,20,10
1650864875665,ECE 45,A01,083139,Staff,0,4,60,60
1650864881688,ECE 65,A50,083695,Staff,0,5,30,30
1650864887711,ECE 109,A01,091882,Touri; Behrouz,32,0,70,38
1650864893739,ECE 180,A00,083140,Abi Samra; Nicholas Camill,20,0,30,10
1650864893739,ECE 180,B00,083141,Abi Samra; Nicholas Camill,0,0,30,30
1650864899767,MATH 10A,A01,083735,Patchell; Gregory David,2,0,30,28
1650864899767,MATH 10A,A02,083736,Patchell; Gregory David,27,0,30,3
1650864899767,MATH 10A,A03,083737,Patchell; Gregory David,23,0,30,7
1650864905794,MATH 10B,A01,083207,Staff,0,9,30,30
1650864905794,MATH 10B,A02,083208,Staff,0,6,30,30
1650864905794,MATH 10B,B01,083739,Staff,10,0,30,20
1650864905794,MATH 10B,B02,083740,Staff,28,0,30,2
1650864911908,MATH 18,A01,083743,Staff,0,0,30,30
1650864911908,MATH 18,A02,083744,Staff,23,0,30,7
1650864911908,MATH 18,A03,083745,Staff,21,0,30,9
1650864911908,MATH 18,A04,083746,Staff,26,0,30,4
1650864911908,MATH 18,B01,083748,Staff,0,15,30,30
1650864911908,MATH 18,B02,083749,Staff,0,13,30,30
1650864911908,MATH 18,B03,083750,Staff,0,13,30,30
1650864911908,MATH 18,B04,083751,Staff,0,13,30,30
1650864917935,MATH 20A,A01,083754,Staff,19,0,40,21
1650864923961,MATH 20B,A01,083756,Staff,0,14,30,30
1650864923961,MATH 20B,A02,083757,Staff,0,12,30,30
1650864929987,MATH 20C,A01,083760,Staff,0,17,30,30
1650864929987,MATH 20C,A02,083761,Staff,0,16,30,30
1650864929987,MATH 20C,B01,083762,Staff,9,0,30,21
1650864929987,MATH 20C,B02,083763,Staff,28,0,30,2
1650864936015,MATH 20D,A01,083765,Staff,2,1,30,28
1650864936015,MATH 20D,A02,083766,Staff,6,0,30,24
1650864936015,MATH 20D,A03,083767,Staff,23,0,30,7
1650864942039,MATH 20E,A01,083771,Staff,2,0,30,28
1650864942039,MATH 20E,A02,083772,Staff,13,0,30,17
1650864942039,MATH 20E,B01,083773,Staff,0,0,30,30
1650864942039,MATH 20E,B02,083774,Staff,4,0,30,26
1650864948064,MATH 103A,A01,083777,Staff,0,17,30,30
1650864948064,MATH 103A,A02,083778,Staff,0,15,30,30
1650864948064,MATH 103A,B01,083779,Staff,0,15,30,30
1650864948064,MATH 103A,B02,083780,Staff,0,14,30,30
1650864954088,MATH 105,A01,085443,Staff,0,23,30,30
1650864960113,MATH 109,A01,083213,Anzaldo; Leesa B,0,7,30,30
1650864960113,MATH 109,A02,083214,Anzaldo; Leesa B,0,7,30,30
1650864960113,MATH 109,B01,083215,Anzaldo; Leesa B,0,8,30,30
1650864960113,MATH 109,B02,083216,Anzaldo; Leesa B,0,7,30,30
1650864966141,MATH 142A,A01,083219,Chow; Bennett,0,14,30,30
1650864966141,MATH 142A,A02,083220,Chow; Bennett,0,15,30,30
1650864966141,MATH 142A,B01,083221,Chow; Bennett,0,16,30,30
1650864966141,MATH 142A,B02,083222,Chow; Bennett,0,14,30,30
1650864972163,MATH 193A,A01,083224,Staff,0,6,30,30
1650864972163,MATH 193A,A02,083225,Staff,0,7,30,30
1650864972163,MATH 193A,A03,083781,Staff,0,6,30,30
1650864972163,MATH 193A,A04,083782,Staff,0,7,30,30
1650864978186,MATH 197,001,091859,McAuley; Julian John,9998,0,9999,1
1650864984239,COGS 9,A01,083615,Staff,0,17,60,60
1650864990264,COGS 11,A01,083617,Boyle; Mary E. T.,15,0,40,25
1650864996288,COGS 13,A01,083071,Staff,0,38,40,40
1650865002313,COGS 14A,A01,092681,Staff,0,37,100,100
1650865008336,COGS 14B,A01,083073,Cheng; Tzu-Han,0,12,50,50
1650865014361,COGS 17,A01,092677,Staff,12,0,75,63
1650865020385,COGS 100,A01,083619,Staff,0,30,60,60
1650865026413,COGS 101A,A01,083621,Davis; Joshua Daniel,0,29,60,60
1650865032437,COGS 101B,A01,091572,Staff,0,3,60,60
1650865038460,COGS 101C,A01,083625,Delgado; Tania,14,0,30,16
1650865044487,COGS 107A,A01,083627,Boyle; Mary E. T.,0,16,60,60
1650865050518,COGS 118A,A01,083075,Staff,0,8,60,60
1650865056545,CSE 3,A50,083646,Miranda; Gregory Joseph,18,0,38,20
1650865056545,CSE 3,A51,083647,Miranda; Gregory Joseph,36,0,37,1
1650865062569,CSE 8A,A50,083650,Miranda; Gregory Joseph,0,29,40,40
1650865068591,CSE 11,A01,083080,Cao; Yingjun,0,97,40,40
1650865074618,CSE 12,A01,083652,Staff,0,21,100,100
1650865080644,CSE 15L,A01,083654,Staff,0,3,50,50
1650865080644,CSE 15L,A02,083655,Staff,0,3,50,50
1650865086667,CSE 20,A01,083657,Staff,49,0,80,31
1650865092690,CSE 30,A01,083084,Eldon; John,0,76,40,40
1650865098717,CSE 100,A01,083659,Cao; Yingjun,0,71,50,50
1650865104744,CSE 134B,A01,083661,Powell; Thomas Allan,0,38,65,65
1650865110768,CSE 140,A01,083663,Staff,0,12,75,75
1650865116799,CSE 140L,A01,083088,Eldon; John,0,20,75,75
1650865122822,CSE 175,A01,083665,Kumar; Rakesh,7,0,25,18
1650865128848,CSE 190,A00,092507,Dubnov; Shlomo,10,0,20,10
1650865134873,ECE 45,A01,083139,Staff,0,4,60,60
1650865140897,ECE 65,A50,083695,Staff,0,5,30,30
1650865146920,ECE 109,A01,091882,Touri; Behrouz,32,0,70,38
1650865152946,ECE 180,A00,083140,Abi Samra; Nicholas Camill,20,0,30,10
1650865152946,ECE 180,B00,083141,Abi Samra; Nicholas Camill,0,0,30,30
1650865158970,MATH 10A,A01,083735,Patchell; Gregory David,2,0,30,28
1650865158970,MATH 10A,A02,083736,Patchell; Gregory David,27,0,30,3
1650865158970,MATH 10A,A03,083737,Patchell; Gregory David,23,0,30,7
1650865164993,MATH 10B,A01,083207,Staff,0,9,30,30
1650865164993,MATH 10B,A02,083208,Staff,0,6,30,30
1650865164993,MATH 10B,B01,083739,Staff,10,0,30,20
1650865164993,MATH 10B,B02,083740,Staff,28,0,30,2
1650865171019,MATH 18,A01,083743,Staff,0,0,30,30
1650865171019,MATH 18,A02,083744,Staff,23,0,30,7
1650865171019,MATH 18,A03,083745,Staff,21,0,30,9
1650865171019,MATH 18,A04,083746,Staff,26,0,30,4
1650865171019,MATH 18,B01,083748,Staff,0,15,30,30
1650865171019,MATH 18,B02,083749,Staff,0,13,30,30
1650865171019,MATH 18,B03,083750,Staff,0,13,30,30
1650865171019,MATH 18,B04,083751,Staff,0,13,30,30
1650865177041,MATH 20A,A01,083754,Staff,19,0,40,21
1650865183071,MATH 20B,A01,083756,Staff,0,14,30,30
1650865183071,MATH 20B,A02,083757,Staff,0,12,30,30
1650865189096,MATH 20C,A01,083760,Staff,0,17,30,30
1650865189096,MATH 20C,A02,083761,Staff,0,16,30,30
1650865189096,MATH 20C,B01,083762,Staff,9,0,30,21
1650865189096,MATH 20C,B02,083763,Staff,28,0,30,2
1650865195120,MATH 20D,A01,083765,Staff,2,1,30,28
1650865195120,MATH 20D,A02,083766,Staff,6,0,30,24
1650865195120,MATH 20D,A03,083767,Staff,23,0,30,7
1650865201148,MATH 20E,A01,083771,Staff,2,0,30,28
1650865201148,MATH 20E,A02,083772,Staff,13,0,30,17
1650865201148,MATH 20E,B01,083773,Staff,0,0,30,30
1650865201148,MATH 20E,B02,083774,Staff,4,0,30,26
1650865207179,MATH 103A,A01,083777,Staff,0,17,30,30
1650865207179,MATH 103A,A02,083778,Staff,0,15,30,30
1650865207179,MATH 103A,B01,083779,Staff,0,15,30,30
1650865207179,MATH 103A,B02,083780,Staff,0,14,30,30
1650865213214,MATH 105,A01,085443,Staff,0,23,30,30
1650865219257,MATH 109,A01,083213,Anzaldo; Leesa B,0,7,30,30
1650865219257,MATH 109,A02,083214,Anzaldo; Leesa B,0,7,30,30
1650865219257,MATH 109,B01,083215,Anzaldo; Leesa B,0,8,30,30
1650865219257,MATH 109,B02,083216,Anzaldo; Leesa B,0,7,30,30
1650865225283,MATH 142A,A01,083219,Chow; Bennett,0,14,30,30
1650865225283,MATH 142A,A02,083220,Chow; Bennett,0,15,30,30
1650865225283,MATH 142A,B01,083221,Chow; Bennett,0,16,30,30
1650865225283,MATH 142A,B02,083222,Chow; Bennett,0,14,30,30
1650865231306,MATH 193A,A01,083224,Staff,0,6,30,30
1650865231306,MATH 193A,A02,083225,Staff,0,7,30,30
1650865231306,MATH 193A,A03,083781,Staff,0,6,30,30
1650865231306,MATH 193A,A04,083782,Staff,0,7,30,30
1650865237332,MATH 197,001,091859,McAuley; Julian John,9998,0,9999,1
1650865243383,COGS 9,A01,083615,Staff,0,17,60,60
1650865249406,COGS 11,A01,083617,Boyle; Mary E. T.,15,0,40,25
1650865255430,COGS 13,A01,083071,Staff,0,38,40,40
1650865261455,COGS 14A,A01,092681,Staff,0,37,100,100
1650865267479,COGS 14B,A01,083073,Cheng; Tzu-Han,0,12,50,50
1650865273503,COGS 17,A01,092677,Staff,12,0,75,63
1650865279529,COGS 100,A01,083619,Staff,0,30,60,60
1650865285552,COGS 101A,A01,083621,Davis; Joshua Daniel,0,29,60,60
1650865291577,COGS 101B,A01,091572,Staff,0,3,60,60
1650865297600,COGS 101C,A01,083625,Delgado; Tania,14,0,30,16
1650865303624,COGS 107A,A01,083627,Boyle; Mary E. T.,0,16,60,60
1650865309649,COGS 118A,A01,083075,Staff,0,8,60,60
1650865315676,CSE 3,A50,083646,Miranda; Gregory Joseph,18,0,38,20
1650865315676,CSE 3,A51,083647,Miranda; Gregory Joseph,36,0,37,1
1650865321703,CSE 8A,A50,083650,Miranda; Gregory Joseph,0,29,40,40
1650865327726,CSE 11,A01,083080,Cao; Yingjun,0,97,40,40
1650865333760,CSE 12,A01,083652,Staff,0,21,100,100
1650865339783,CSE 15L,A01,083654,Staff,0,3,50,50
1650865339783,CSE 15L,A02,083655,Staff,0,3,50,50
1650865345810,CSE 20,A01,083657,Staff,49,0,80,31
1650865351843,CSE 30,A01,083084,Eldon; John,0,76,40,40
1650865357868,CSE 100,A01,083659,Cao; Yingjun,0,71,50,50
1650865363895,CSE 134B,A01,083661,Powell; Thomas Allan,0,38,65,65
1650865369922,CSE 140,A01,083663,Staff,0,12,75,75
1650865375952,CSE 140L,A01,083088,Eldon; John,0,20,75,75
1650865381981,CSE 175,A01,083665,Kumar; Rakesh,7,0,25,18
1650865388006,CSE 190,A00,092507,Dubnov; Shlomo,10,0,20,10
1650865394033,ECE 45,A01,083139,Staff,0,4,60,60
1650865400060,ECE 65,A50,083695,Staff,0,5,30,30
1650865406102,ECE 109,A01,091882,Touri; Behrouz,32,0,70,38
1650865412126,ECE 180,A00,083140,Abi Samra; Nicholas Camill,20,0,30,10
1650865412126,ECE 180,B00,083141,Abi Samra; Nicholas Camill,0,0,30,30
1650865418153,MATH 10A,A01,083735,Patchell; Gregory David,2,0,30,28
1650865418153,MATH 10A,A02,083736,Patchell; Gregory David,27,0,30,3
1650865418153,MATH 10A,A03,083737,Patchell; Gregory David,23,0,30,7
1650865424179,MATH 10B,A01,083207,Staff,0,9,30,30
1650865424179,MATH 10B,A02,083208,Staff,0,6,30,30
1650865424179,MATH 10B,B01,083739,Staff,10,0,30,20
1650865424179,MATH 10B,B02,083740,Staff,28,0,30,2
1650865430204,MATH 18,A01,083743,Staff,0,0,30,30
1650865430204,MATH 18,A02,083744,Staff,23,0,30,7
1650865430204,MATH 18,A03,083745,Staff,21,0,30,9
1650865430204,MATH 18,A04,083746,Staff,26,0,30,4
1650865430204,MATH 18,B01,083748,Staff,0,15,30,30
1650865430204,MATH 18,B02,083749,Staff,0,13,30,30
1650865430204,MATH 18,B03,083750,Staff,0,13,30,30
1650865430204,MATH 18,B04,083751,Staff,0,13,30,30
1650865436229,MATH 20A,A01,083754,Staff,19,0,40,21
1650865442255,MATH 20B,A01,083756,Staff,0,14,30,30
1650865442255,MATH 20B,A02,083757,Staff,0,12,30,30
1650865448279,MATH 20C,A01,083760,Staff,0,17,30,30
1650865448279,MATH 20C,A02,083761,Staff,0,16,30,30
1650865448279,MATH 20C,B01,083762,Staff,9,0,30,21
1650865448279,MATH 20C,B02,083763,Staff,28,0,30,2
1650865454303,MATH 20D,A01,083765,Staff,2,1,30,28
1650865454303,MATH 20D,A02,083766,Staff,6,0,30,24
1650865454303,MATH 20D,A03,083767,Staff,23,0,30,7
1650865460329,MATH 20E,A01,083771,Staff,2,0,30,28
1650865460329,MATH 20E,A02,083772,Staff,13,0,30,17
1650865460329,MATH 20E,B01,083773,Staff,0,0,30,30
1650865460329,MATH 20E,B02,083774,Staff,4,0,30,26
1650865466358,MATH 103A,A01,083777,Staff,0,17,30,30
1650865466358,MATH 103A,A02,083778,Staff,0,15,30,30
1650865466358,MATH 103A,B01,083779,Staff,0,15,30,30
1650865466358,MATH 103A,B02,083780,Staff,0,14,30,30
1650865472382,MATH 105,A01,085443,Staff,0,23,30,30
1650865478406,MATH 109,A01,083213,Anzaldo; Leesa B,0,7,30,30
1650865478406,MATH 109,A02,083214,Anzaldo; Leesa B,0,7,30,30
1650865478406,MATH 109,B01,083215,Anzaldo; Leesa B,0,8,30,30
1650865478406,MATH 109,B02,083216,Anzaldo; Leesa B,0,7,30,30
1650865484434,MATH 142A,A01,083219,Chow; Bennett,0,14,30,30
1650865484434,MATH 142A,A02,083220,Chow; Bennett,0,15,30,30
1650865484434,MATH 142A,B01,083221,Chow; Bennett,0,16,30,30
1650865484434,MATH 142A,B02,083222,Chow; Bennett,0,14,30,30
1650865490457,MATH 193A,A01,083224,Staff,0,6,30,30
1650865490457,MATH 193A,A02,083225,Staff,0,7,30,30
1650865490457,MATH 193A,A03,083781,Staff,0,6,30,30
1650865490457,MATH 193A,A04,083782,Staff,0,7,30,30
1650865496480,MATH 197,001,091859,McAuley; Julian John,9998,0,9999,1
1650865502627,COGS 9,A01,083615,Staff,0,17,60,60
1650865508648,COGS 11,A01,083617,Boyle; Mary E. T.,15,0,40,25
1650865514671,COGS 13,A01,083071,Staff,0,38,40,40
1650865520710,COGS 14A,A01,092681,Staff,0,37,100,100
1650865526733,COGS 14B,A01,083073,Cheng; Tzu-Han,0,12,50,50
1650865532759,COGS 17,A01,092677,Staff,12,0,75,63
1650865538781,COGS 100,A01,083619,Staff,0,30,60,60
1650865544807,COGS 101A,A01,083621,Davis; Joshua Daniel,0,29,60,60
1650865550829,COGS 101B,A01,091572,Staff,0,3,60,60
1650865556852,COGS 101C,A01,083625,Delgado; Tania,14,0,30,16
1650865562879,COGS 107A,A01,083627,Boyle; Mary E. T.,0,16,60,60
1650865568906,COGS 118A,A01,083075,Staff,0,8,60,60
1650865574930,CSE 3,A50,083646,Miranda; Gregory Joseph,18,0,38,20
1650865574930,CSE 3,A51,083647,Miranda; Gregory Joseph,36,0,37,1
1650865580953,CSE 8A,A50,083650,Miranda; Gregory Joseph,0,29,40,40
1650865586980,CSE 11,A01,083080,Cao; Yingjun,0,97,40,40
1650865593011,CSE 12,A01,083652,Staff,0,21,100,100
1650865599034,CSE 15L,A01,083654,Staff,0,3,50,50
1650865599034,CSE 15L,A02,083655,Staff,0,3,50,50
1650865605062,CSE 20,A01,083657,Staff,49,0,80,31
1650865611086,CSE 30,A01,083084,Eldon; John,0,76,40,40
1650865617127,CSE 100,A01,083659,Cao; Yingjun,0,71,50,50
1650865623154,CSE 134B,A01,083661,Powell; Thomas Allan,0,38,65,65
1650865629177,CSE 140,A01,083663,Staff,0,12,75,75
1650865635200,CSE 140L,A01,083088,Eldon; John,0,20,75,75
1650865641232,CSE 175,A01,083665,Kumar; Rakesh,7,0,25,18
1650865647255,CSE 190,A00,092507,Dubnov; Shlomo,10,0,20,10
1650865653279,ECE 45,A01,083139,Staff,0,4,60,60
1650865659304,ECE 65,A50,083695,Staff,0,5,30,30
1650865665329,ECE 109,A01,091882,Touri; Behrouz,32,0,70,38
1650865671363,ECE 180,A00,083140,Abi Samra; Nicholas Camill,20,0,30,10
1650865671363,ECE 180,B00,083141,Abi Samra; Nicholas Camill,0,0,30,30
1650865677387,MATH 10A,A01,083735,Patchell; Gregory David,2,0,30,28
1650865677387,MATH 10A,A02,083736,Patchell; Gregory David,27,0,30,3
1650865677387,MATH 10A,A03,083737,Patchell; Gregory David,23,0,30,7
1650865683413,MATH 10B,A01,083207,Staff,0,9,30,30
1650865683413,MATH 10B,A02,083208,Staff,0,6,30,30
1650865683413,MATH 10B,B01,083739,Staff,10,0,30,20
1650865683413,MATH 10B,B02,083740,Staff,28,0,30,2
1650865689436,MATH 18,A01,083743,Staff,0,0,30,30
1650865689436,MATH 18,A02,083744,Staff,23,0,30,7
1650865689436,MATH 18,A03,083745,Staff,21,0,30,9
1650865689436,MATH 18,A04,083746,Staff,26,0,30,4
1650865689436,MATH 18,B01,083748,Staff,0,15,30,30
1650865689436,MATH 18,B02,083749,Staff,0,13,30,30
1650865689436,MATH 18,B03,083750,Staff,0,13,30,30
1650865689436,MATH 18,B04,083751,Staff,0,13,30,30
1650865695461,MATH 20A,A01,083754,Staff,19,0,40,21
1650865701487,MATH 20B,A01,083756,Staff,0,14,30,30
1650865701487,MATH 20B,A02,083757,Staff,0,12,30,30
1650865707511,MATH 20C,A01,083760,Staff,0,17,30,30
1650865707511,MATH 20C,A02,083761,Staff,0,16,30,30
1650865707511,MATH 20C,B01,083762,Staff,9,0,30,21
1650865707511,MATH 20C,B02,083763,Staff,28,0,30,2
1650865713536,MATH 20D,A01,083765,Staff,2,1,30,28
1650865713536,MATH 20D,A02,083766,Staff,6,0,30,24
1650865713536,MATH 20D,A03,083767,Staff,23,0,30,7
1650865719562,MATH 20E,A01,083771,Staff,2,0,30,28
1650865719562,MATH 20E,A02,083772,Staff,13,0,30,17
1650865719562,MATH 20E,B01,083773,Staff,0,0,30,30
1650865719562,MATH 20E,B02,083774,Staff,4,0,30,26
1650865725586,MATH 103A,A01,083777,Staff,0,17,30,30
1650865725586,MATH 103A,A02,083778,Staff,0,15,30,30
1650865725586,MATH 103A,B01,083779,Staff,0,15,30,30
1650865725586,MATH 103A,B02,083780,Staff,0,14,30,30
1650865731612,MATH 105,A01,085443,Staff,0,23,30,30
1650865737635,MATH 109,A01,083213,Anzaldo; Leesa B,0,7,30,30
1650865737635,MATH 109,A02,083214,Anzaldo; Leesa B,0,7,30,30
1650865737635,MATH 109,B01,083215,Anzaldo; Leesa B,0,8,30,30
1650865737635,MATH 109,B02,083216,Anzaldo; Leesa B,0,7,30,30
1650865743663,MATH 142A,A01,083219,Chow; Bennett,0,14,30,30
1650865743663,MATH 142A,A02,083220,Chow; Bennett,0,15,30,30
1650865743663,MATH 142A,B01,083221,Chow; Bennett,0,16,30,30
1650865743663,MATH 142A,B02,083222,Chow; Bennett,0,14,30,30
1650865749686,MATH 193A,A01,083224,Staff,0,6,30,30
1650865749686,MATH 193A,A02,083225,Staff,0,7,30,30
1650865749686,MATH 193A,A03,083781,Staff,0,6,30,30
1650865749686,MATH 193A,A04,083782,Staff,0,7,30,30
1650865755715,MATH 197,001,091859,McAuley; Julian John,9998,0,9999,1
1650865761774,COGS 9,A01,083615,Staff,0,17,60,60
1650865767801,COGS 11,A01,083617,Boyle; Mary E. T.,15,0,40,25
1650865773829,COGS 13,A01,083071,Staff,0,38,40,40
1650865779855,COGS 14A,A01,092681,Staff,0,37,100,100
1650865785879,COGS 14B,A01,083073,Cheng; Tzu-Han,0,12,50,50
1650865791906,COGS 17,A01,092677,Staff,12,0,75,63
1650865797929,COGS 100,A01,083619,Staff,0,30,60,60
1650865803951,COGS 101A,A01,083621,Davis; Joshua Daniel,0,29,60,60
1650865809974,COGS 101B,A01,091572,Staff,0,3,60,60
1650865815998,COGS 101C,A01,083625,Delgado; Tania,14,0,30,16
1650865822024,COGS 107A,A01,083627,Boyle; Mary E. T.,0,16,60,60
1650865828064,COGS 118A,A01,083075,Staff,0,8,60,60
1650865834096,CSE 3,A50,083646,Miranda; Gregory Joseph,18,0,38,20
1650865834096,CSE 3,A51,083647,Miranda; Gregory Joseph,36,0,37,1
1650865840118,CSE 8A,A50,083650,Miranda; Gregory Joseph,0,29,40,40
1650865846141,CSE 11,A01,083080,Cao; Yingjun,0,97,40,40
1650865852167,CSE 12,A01,083652,Staff,0,21,100,100
1650865858190,CSE 15L,A01,083654,Staff,0,3,50,50
1650865858190,CSE 15L,A02,083655,Staff,0,3,50,50
1650865864213,CSE 20,A01,083657,Staff,49,0,80,31
1650865870238,CSE 30,A01,083084,Eldon; John,0,76,40,40
1650865876263,CSE 100,A01,083659,Cao; Yingjun,0,71,50,50
1650865882301,CSE 134B,A01,083661,Powell; Thomas Allan,0,38,65,65
1650865888324,CSE 140,A01,083663,Staff,0,12,75,75
1650865894348,CSE 140L,A01,083088,Eldon; John,0,20,75,75
1650865900374,CSE 175,A01,083665,Kumar; Rakesh,7,0,25,18
1650865906404,CSE 190,A00,092507,Dubnov; Shlomo,10,0,20,10
1650865912431,ECE 45,A01,083139,Staff,0,4,60,60
1650865918455,ECE 65,A50,083695,Staff,0,5,30,30
1650865924477,ECE 109,A01,091882,Touri; Behrouz,32,0,70,38
1650865930500,ECE 180,A00,083140,Abi Samra; Nicholas Camill,20,0,30,10
1650865930500,ECE 180,B00,083141,Abi Samra; Nicholas Camill,0,0,30,30
1650865936529,MATH 10A,A01,083735,Patchell; Gregory David,2,0,30,28
1650865936529,MATH 10A,A02,083736,Patchell; Gregory David,27,0,30,3
1650865936529,MATH 10A,A03,083737,Patchell; Gregory David,23,0,30,7
1650865942564,MATH 10B,A01,083207,Staff,0,9,30,30
1650865942564,MATH 10B,A02,083208,Staff,0,6,30,30
1650865942564,MATH 10B,B01,083739,Staff,10,0,30,20
1650865942564,MATH 10B,B02,083740,Staff,28,0,30,2
1650865948590,MATH 18,A01,083743,Staff,0,0,30,30
1650865948590,MATH 18,A02,083744,Staff,23,0,30,7
1650865948590,MATH 18,A03,083745,Staff,21,0,30,9
1650865948590,MATH 18,A04,083746,Staff,26,0,30,4
1650865948590,MATH 18,B01,083748,Staff,0,15,30,30
1650865948590,MATH 18,B02,083749,Staff,0,13,30,30
1650865948590,MATH 18,B03,083750,Staff,0,13,30,30
1650865948590,MATH 18,B04,083751,Staff,0,13,30,30
1650865954612,MATH 20A,A01,083754,Staff,19,0,40,21
1650865960636,MATH 20B,A01,083756,Staff,0,14,30,30
1650865960636,MATH 20B,A02,083757,Staff,0,12,30,30
1650865966666,MATH 20C,A01,083760,Staff,0,17,30,30
1650865966666,MATH 20C,A02,083761,Staff,0,16,30,30
1650865966666,MATH 20C,B01,083762,Staff,9,0,30,21
1650865966666,MATH 20C,B02,083763,Staff,28,0,30,2
1650865972690,MATH 20D,A01,083765,Staff,2,1,30,28
1650865972690,MATH 20D,A02,083766,Staff,6,0,30,24
1650865972690,MATH 20D,A03,083767,Staff,23,0,30,7
1650865978715,MATH 20E,A01,083771,Staff,2,0,30,28
1650865978715,MATH 20E,A02,083772,Staff,13,0,30,17
1650865978715,MATH 20E,B01,083773,Staff,0,0,30,30
1650865978715,MATH 20E,B02,083774,Staff,4,0,30,26
1650865984752,MATH 103A,A01,083777,Staff,0,17,30,30
1650865984752,MATH 103A,A02,083778,Staff,0,15,30,30
1650865984752,MATH 103A,B01,083779,Staff,0,15,30,30
1650865984752,MATH 103A,B02,083780,Staff,0,14,30,30
1650865990774,MATH 105,A01,085443,Staff,0,23,30,30
1650865996798,MATH 109,A01,083213,Anzaldo; Leesa B,0,7,30,30
1650865996798,MATH 109,A02,083214,Anzaldo; Leesa B,0,7,30,30
1650865996798,MATH 109,B01,083215,Anzaldo; Leesa B,0,8,30,30
1650865996798,MATH 109,B02,083216,Anzaldo; Leesa B,0,7,30,30
1650866002825,MATH 142A,A01,083219,Chow; Bennett,0,14,30,30
1650866002825,MATH 142A,A02,083220,Chow; Bennett,0,15,30,30
1650866002825,MATH 142A,B01,083221,Chow; Bennett,0,16,30,30
1650866002825,MATH 142A,B02,083222,Chow; Bennett,0,14,30,30
1650866008849,MATH 193A,A01,083224,Staff,0,6,30,30
1650866008849,MATH 193A,A02,083225,Staff,0,7,30,30
1650866008849,MATH 193A,A03,083781,Staff,0,6,30,30
1650866008849,MATH 193A,A04,083782,Staff,0,7,30,30
1650866014872,MATH 197,001,091859,McAuley; Julian John,9998,0,9999,1
1650866020934,COGS 9,A01,083615,Staff,0,17,60,60
1650866026963,COGS 11,A01,083617,Boyle; Mary E. T.,15,0,40,25
1650866032999,COGS 13,A01,083071,Staff,0,38,40,40
1650866039038,COGS 14A,A01,092681,Staff,0,37,100,100
1650866045062,COGS 14B,A01,083073,Cheng; Tzu-Han,0,12,50,50
1650866051090,COGS 17,A01,092677,Staff,12,0,75,63
1650866057115,COGS 100,A01,083619,Staff,0,30,60,60
1650866063141,COGS 101A,A01,083621,Davis; Joshua Daniel,0,29,60,60
1650866069165,COGS 101B,A01,091572,Staff,0,3,60,60
1650866075188,COGS 101C,A01,083625,Delgado; Tania,14,0,30,16
1650866081229,COGS 107A,A01,083627,Boyle; Mary E. T.,0,16,60,60
1650866087273,COGS 118A,A01,083075,Staff,0,8,60,60
1650866093298,CSE 3,A50,083646,Miranda; Gregory Joseph,18,0,38,20
1650866093298,CSE 3,A51,083647,Miranda; Gregory Joseph,36,0,37,1
1650866099412,CSE 8A,A50,083650,Miranda; Gregory Joseph,0,29,40,40
1650866105442,CSE 11,A01,083080,Cao; Yingjun,0,97,40,40
1650866111467,CSE 12,A01,083652,Staff,0,21,100,100
1650866117490,CSE 15L,A01,083654,Staff,0,3,50,50
1650866117490,CSE 15L,A02,083655,Staff,0,3,50,50
1650866123512,CSE 20,A01,083657,Staff,49,0,80,31
1650866129541,CSE 30,A01,083084,Eldon; John,0,76,40,40
1650866135573,CSE 100,A01,083659,Cao; Yingjun,0,71,50,50
1650866141598,CSE 134B,A01,083661,Powell; Thomas Allan,0,38,65,65
1650866147623,CSE 140,A01,083663,Staff,0,12,75,75
1650866153646,CSE 140L,A01,083088,Eldon; John,0,20,75,75
1650866159671,CSE 175,A01,083665,Kumar; Rakesh,7,0,25,18
1650866165701,CSE 190,A00,092507,Dubnov; Shlomo,10,0,20,10
1650866171728,ECE 45,A01,083139,Staff,0,4,60,60
1650866177754,ECE 65,A50,083695,Staff,0,5,30,30
1650866183780,ECE 109,A01,091882,Touri; Behrouz,32,0,70,38
1650866189806,ECE 180,A00,083140,Abi Samra; Nicholas Camill,20,0,30,10
1650866189806,ECE 180,B00,083141,Abi Samra; Nicholas Camill,0,0,30,30
1650866195831,MATH 10A,A01,083735,Patchell; Gregory David,2,0,30,28
1650866195831,MATH 10A,A02,083736,Patchell; Gregory David,27,0,30,3
1650866195831,MATH 10A,A03,083737,Patchell; Gregory David,23,0,30,7
1650866201855,MATH 10B,A01,083207,Staff,0,9,30,30
1650866201855,MATH 10B,A02,083208,Staff,0,6,30,30
1650866201855,MATH 10B,B01,083739,Staff,10,0,30,20
1650866201855,MATH 10B,B02,083740,Staff,28,0,30,2
1650866207883,MATH 18,A01,083743,Staff,0,0,30,30
1650866207883,MATH 18,A02,083744,Staff,23,0,30,7
1650866207883,MATH 18,A03,083745,Staff,21,0,30,9
1650866207883,MATH 18,A04,083746,Staff,26,0,30,4
1650866207883,MATH 18,B01,083748,Staff,0,15,30,30
1650866207883,MATH 18,B02,083749,Staff,0,13,30,30
1650866207883,MATH 18,B03,083750,Staff,0,13,30,30
1650866207883,MATH 18,B04,083751,Staff,0,13,30,30
1650866213905,MATH 20A,A01,083754,Staff,19,0,40,21
1650866219955,MATH 20B,A01,083756,Staff,0,14,30,30
1650866219955,MATH 20B,A02,083757,Staff,0,12,30,30
1650866225980,MATH 20C,A01,083760,Staff,0,17,30,30
1650866225980,MATH 20C,A02,083761,Staff,0,16,30,30
1650866225980,MATH 20C,B01,083762,Staff,9,0,30,21
1650866225980,MATH 20C,B02,083763,Staff,28,0,30,2
1650866232003,MATH 20D,A01,083765,Staff,2,1,30,28
1650866232003,MATH 20D,A02,083766,Staff,6,0,30,24
1650866232003,MATH 20D,A03,083767,Staff,23,0,30,7
1650866238030,MATH 20E,A01,083771,Staff,2,0,30,28
1650866238030,MATH 20E,A02,083772,Staff,13,0,30,17
1650866238030,MATH 20E,B01,083773,Staff,0,0,30,30
1650866238030,MATH 20E,B02,083774,Staff,4,0,30,26
1650866244052,MATH 103A,A01,083777,Staff,0,17,30,30
1650866244052,MATH 103A,A02,083778,Staff,0,15,30,30
1650866244052,MATH 103A,B01,083779,Staff,0,15,30,30
1650866244052,MATH 103A,B02,083780,Staff,0,14,30,30
1650866250081,MATH 105,A01,085443,Staff,0,23,30,30
1650866256109,MATH 109,A01,083213,Anzaldo; Leesa B,0,7,30,30
1650866256109,MATH 109,A02,083214,Anzaldo; Leesa B,0,7,30,30
1650866256109,MATH 109,B01,083215,Anzaldo; Leesa B,0,8,30,30
1650866256109,MATH 109,B02,083216,Anzaldo; Leesa B,0,7,30,30
1650866262134,MATH 142A,A01,083219,Chow; Bennett,0,14,30,30
1650866262134,MATH 142A,A02,083220,Chow; Bennett,0,15,30,30
1650866262134,MATH 142A,B01,083221,Chow; Bennett,0,16,30,30
1650866262134,MATH 142A,B02,083222,Chow; Bennett,0,14,30,30
1650866268161,MATH 193A,A01,083224,Staff,0,6,30,30
1650866268161,MATH 193A,A02,083225,Staff,0,7,30,30
1650866268161,MATH 193A,A03,083781,Staff,0,6,30,30
1650866268161,MATH 193A,A04,083782,Staff,0,7,30,30
1650866274186,MATH 197,001,091859,McAuley; Julian John,9998,0,9999,1
1650866280269,COGS 9,A01,083615,Staff,0,17,60,60
1650866286292,COGS 11,A01,083617,Boyle; Mary E. T.,15,0,40,25
1650866292319,COGS 13,A01,083071,Staff,0,38,40,40
1650866298346,COGS 14A,A01,092681,Staff,0,37,100,100
1650866304379,COGS 14B,A01,083073,Cheng; Tzu-Han,0,12,50,50
1650866310406,COGS 17,A01,092677,Staff,12,0,75,63
1650866316433,COGS 100,A01,083619,Staff,0,30,60,60
1650866322460,COGS 101A,A01,083621,Davis; Joshua Daniel,0,29,60,60
1650866328486,COGS 101B,A01,091572,Staff,0,3,60,60
1650866334519,COGS 101C,A01,083625,Delgado; Tania,14,0,30,16
1650866340548,COGS 107A,A01,083627,Boyle; Mary E. T.,0,16,60,60
1650866346592,COGS 118A,A01,083075,Staff,0,8,60,60
1650866352617,CSE 3,A50,083646,Miranda; Gregory Joseph,18,0,38,20
1650866352617,CSE 3,A51,083647,Miranda; Gregory Joseph,36,0,37,1
1650866358641,CSE 8A,A50,083650,Miranda; Gregory Joseph,0,29,40,40
1650866364673,CSE 11,A01,083080,Cao; Yingjun,0,97,40,40
1650866370697,CSE 12,A01,083652,Staff,0,21,100,100
1650866376719,CSE 15L,A01,083654,Staff,0,3,50,50
1650866376719,CSE 15L,A02,083655,Staff,0,3,50,50
1650866382745,CSE 20,A01,083657,Staff,49,0,80,31
1650866388768,CSE 30,A01,083084,Eldon; John,0,76,40,40
1650866394794,CSE 100,A01,083659,Cao; Yingjun,0,70,50,50
1650866400817,CSE 134B,A01,083661,Powell; Thomas Allan,0,38,65,65
1650866406838,CSE 140,A01,083663,Staff,0,12,75,75
1650866412861,CSE 140L,A01,083088,Eldon; John,0,20,75,75
1650866418889,CSE 175,A01,083665,Kumar; Rakesh,7,0,25,18
1650866424915,CSE 190,A00,092507,Dubnov; Shlomo,9,0,20,11
1650866430936,ECE 45,A01,083139,Staff,0,4,60,60
1650866436959,ECE 65,A50,083695,Staff,0,5,30,30
1650866442987,ECE 109,A01,091882,Touri; Behrouz,32,0,70,38
1650866449037,ECE 180,A00,083140,Abi Samra; Nicholas Camill,20,0,30,10
1650866449037,ECE 180,B00,083141,Abi Samra; Nicholas Camill,0,0,30,30
1650866455082,MATH 10A,A01,083735,Patchell; Gregory David,2,0,30,28
1650866455082,MATH 10A,A02,083736,Patchell; Gregory David,27,0,30,3
1650866455082,MATH 10A,A03,083737,Patchell; Gregory David,23,0,30,7
1650866461111,MATH 10B,A01,083207,Staff,0,9,30,30
1650866461111,MATH 10B,A02,083208,Staff,0,6,30,30
1650866461111,MATH 10B,B01,083739,Staff,10,0,30,20
1650866461111,MATH 10B,B02,083740,Staff,28,0,30,2
1650866467145,MATH 18,A01,083743,Staff,0,0,30,30
1650866467145,MATH 18,A02,083744,Staff,23,0,30,7
1650866467145,MATH 18,A03,083745,Staff,21,0,30,9
1650866467145,MATH 18,A04,083746,Staff,26,0,30,4
1650866467145,MATH 18,B01,083748,Staff,0,15,30,30
1650866467145,MATH 18,B02,083749,Staff,0,13,30,30
1650866467145,MATH 18,B03,083750,Staff,0,13,30,30
1650866467145,MATH 18,B04,083751,Staff,0,13,30,30
1650866473175,MATH 20A,A01,083754,Staff,19,0,40,21
1650866479207,MATH 20B,A01,083756,Staff,0,14,30,30
1650866479207,MATH 20B,A02,083757,Staff,0,12,30,30
1650866485244,MATH 20C,A01,083760,Staff,0,17,30,30
1650866485244,MATH 20C,A02,083761,Staff,0,16,30,30
1650866485244,MATH 20C,B01,083762,Staff,9,0,30,21
1650866485244,MATH 20C,B02,083763,Staff,28,0,30,2
1650866491298,MATH 20D,A01,083765,Staff,2,1,30,28
1650866491298,MATH 20D,A02,083766,Staff,6,0,30,24
1650866491298,MATH 20D,A03,083767,Staff,23,0,30,7
1650866497325,MATH 20E,A01,083771,Staff,2,0,30,28
1650866497325,MATH 20E,A02,083772,Staff,13,0,30,17
1650866497325,MATH 20E,B01,083773,Staff,0,0,30,30
1650866497325,MATH 20E,B02,083774,Staff,4,0,30,26
1650866503355,MATH 103A,A01,083777,Staff,0,17,30,30
1650866503355,MATH 103A,A02,083778,Staff,0,15,30,30
1650866503355,MATH 103A,B01,083779,Staff,0,15,30,30
1650866503355,MATH 103A,B02,083780,Staff,0,14,30,30
1650866509379,MATH 105,A01,085443,Staff,0,23,30,30
1650866515411,MATH 109,A01,083213,Anzaldo; Leesa B,0,7,30,30
1650866515411,MATH 109,A02,083214,Anzaldo; Leesa B,0,7,30,30
1650866515411,MATH 109,B01,083215,Anzaldo; Leesa B,0,8,30,30
1650866515411,MATH 109,B02,083216,Anzaldo; Leesa B,0,7,30,30
1650866521444,MATH 142A,A01,083219,Chow; Bennett,0,14,30,30
1650866521444,MATH 142A,A02,083220,Chow; Bennett,0,15,30,30
1650866521444,MATH 142A,B01,083221,Chow; Bennett,0,16,30,30
1650866521444,MATH 142A,B02,083222,Chow; Bennett,0,14,30,30
1650866527476,MATH 193A,A01,083224,Staff,0,6,30,30
1650866527476,MATH 193A,A02,083225,Staff,0,7,30,30
1650866527476,MATH 193A,A03,083781,Staff,0,6,30,30
1650866527476,MATH 193A,A04,083782,Staff,0,7,30,30
1650866533507,MATH 197,001,091859,McAuley; Julian John,9998,0,9999,1
1650866539559,COGS 9,A01,083615,Staff,0,17,60,60
1650866545583,COGS 11,A01,083617,Boyle; Mary E. T.,15,0,40,25
1650866551605,COGS 13,A01,083071,Staff,0,38,40,40
1650866557628,COGS 14A,A01,092681,Staff,0,37,100,100
1650866563652,COGS 14B,A01,083073,Cheng; Tzu-Han,0,12,50,50
1650866569675,COGS 17,A01,092677,Staff,12,0,75,63
1650866575699,COGS 100,A01,083619,Staff,0,30,60,60
1650866581736,COGS 101A,A01,083621,Davis; Joshua Daniel,0,29,60,60
1650866587764,COGS 101B,A01,091572,Staff,0,3,60,60
1650866593787,COGS 101C,A01,083625,Delgado; Tania,14,0,30,16
1650866599814,COGS 107A,A01,083627,Boyle; Mary E. T.,0,16,60,60
1650866605858,COGS 118A,A01,083075,Staff,0,8,60,60
1650866611881,CSE 3,A50,083646,Miranda; Gregory Joseph,18,0,38,20
1650866611881,CSE 3,A51,083647,Miranda; Gregory Joseph,36,0,37,1
1650866617914,CSE 8A,A50,083650,Miranda; Gregory Joseph,0,29,40,40
1650866623948,CSE 11,A01,083080,Cao; Yingjun,0,97,40,40
1650866629978,CSE 12,A01,083652,Staff,0,21,100,100
1650866636008,CSE 15L,A01,083654,Staff,0,3,50,50
1650866636008,CSE 15L,A02,083655,Staff,0,3,50,50
1650866642033,CSE 20,A01,083657,Staff,49,0,80,31
1650866648060,CSE 30,A01,083084,Eldon; John,0,76,40,40
1650866654087,CSE 100,A01,083659,Cao; Yingjun,0,70,50,50
1650866660112,CSE 134B,A01,083661,Powell; Thomas Allan,0,38,65,65
1650866666135,CSE 140,A01,083663,Staff,0,12,75,75
1650866672168,CSE 140L,A01,083088,Eldon; John,0,20,75,75
1650866678199,CSE 175,A01,083665,Kumar; Rakesh,7,0,25,18
1650866684222,CSE 190,A00,092507,Dubnov; Shlomo,9,0,20,11
1650866690247,ECE 45,A01,083139,Staff,0,4,60,60
1650866696339,ECE 65,A50,083695,Staff,0,5,30,30
1650866702367,ECE 109,A01,091882,Touri; Behrouz,32,0,70,38
1650866708396,ECE 180,A00,083140,Abi Samra; Nicholas Camill,20,0,30,10
1650866708396,ECE 180,B00,083141,Abi Samra; Nicholas Camill,0,0,30,30
1650866714427,MATH 10A,A01,083735,Patchell; Gregory David,2,0,30,28
1650866714427,MATH 10A,A02,083736,Patchell; Gregory David,27,0,30,3
1650866714427,MATH 10A,A03,083737,Patchell; Gregory David,23,0,30,7
1650866720460,MATH 10B,A01,083207,Staff,0,9,30,30
1650866720460,MATH 10B,A02,083208,Staff,0,6,30,30
1650866720460,MATH 10B,B01,083739,Staff,10,0,30,20
1650866720460,MATH 10B,B02,083740,Staff,28,0,30,2
1650866726483,MATH 18,A01,083743,Staff,0,0,30,30
1650866726483,MATH 18,A02,083744,Staff,23,0,30,7
1650866726483,MATH 18,A03,083745,Staff,21,0,30,9
1650866726483,MATH 18,A04,083746,Staff,26,0,30,4
1650866726483,MATH 18,B01,083748,Staff,0,15,30,30
1650866726483,MATH 18,B02,083749,Staff,0,13,30,30
1650866726483,MATH 18,B03,083750,Staff,0,13,30,30
1650866726483,MATH 18,B04,083751,Staff,0,13,30,30
1650866732507,MATH 20A,A01,083754,Staff,19,0,40,21
1650866738534,MATH 20B,A01,083756,Staff,0,14,30,30
1650866738534,MATH 20B,A02,083757,Staff,0,12,30,30
1650866744561,MATH 20C,A01,083760,Staff,0,17,30,30
1650866744561,MATH 20C,A02,083761,Staff,0,16,30,30
1650866744561,MATH 20C,B01,083762,Staff,9,0,30,21
1650866744561,MATH 20C,B02,083763,Staff,28,0,30,2
1650866750583,MATH 20D,A01,083765,Staff,2,1,30,28
1650866750583,MATH 20D,A02,083766,Staff,6,0,30,24
1650866750583,MATH 20D,A03,083767,Staff,23,0,30,7
1650866756616,MATH 20E,A01,083771,Staff,2,0,30,28
1650866756616,MATH 20E,A02,083772,Staff,13,0,30,17
1650866756616,MATH 20E,B01,083773,Staff,0,0,30,30
1650866756616,MATH 20E,B02,083774,Staff,4,0,30,26
1650866762644,MATH 103A,A01,083777,Staff,0,17,30,30
1650866762644,MATH 103A,A02,083778,Staff,0,15,30,30
1650866762644,MATH 103A,B01,083779,Staff,0,15,30,30
1650866762644,MATH 103A,B02,083780,Staff,0,14,30,30
1650866768671,MATH 105,A01,085443,Staff,0,23,30,30
1650866774700,MATH 109,A01,083213,Anzaldo; Leesa B,0,7,30,30
1650866774700,MATH 109,A02,083214,Anzaldo; Leesa B,0,7,30,30
1650866774700,MATH 109,B01,083215,Anzaldo; Leesa B,0,8,30,30
1650866774700,MATH 109,B02,083216,Anzaldo; Leesa B,0,7,30,30
1650866780723,MATH 142A,A01,083219,Chow; Bennett,0,14,30,30
1650866780723,MATH 142A,A02,083220,Chow; Bennett,0,15,30,30
1650866780723,MATH 142A,B01,083221,Chow; Bennett,0,16,30,30
1650866780723,MATH 142A,B02,083222,Chow; Bennett,0,14,30,30
1650866786757,MATH 193A,A01,083224,Staff,0,6,30,30
1650866786757,MATH 193A,A02,083225,Staff,0,7,30,30
1650866786757,MATH 193A,A03,083781,Staff,0,6,30,30
1650866786757,MATH 193A,A04,083782,Staff,0,7,30,30
1650866792780,MATH 197,001,091859,McAuley; Julian John,9998,0,9999,1
1650866798848,COGS 9,A01,083615,Staff,0,18,60,60
1650866804870,COGS 11,A01,083617,Boyle; Mary E. T.,15,0,40,25
1650866810894,COGS 13,A01,083071,Staff,0,38,40,40
1650866816920,COGS 14A,A01,092681,Staff,0,37,100,100
1650866822943,COGS 14B,A01,083073,Cheng; Tzu-Han,0,12,50,50
1650866828968,COGS 17,A01,092677,Staff,12,0,75,63
1650866834994,COGS 100,A01,083619,Staff,0,30,60,60
1650866841022,COGS 101A,A01,083621,Davis; Joshua Daniel,0,29,60,60
1650866847046,COGS 101B,A01,091572,Staff,0,3,60,60
1650866853073,COGS 101C,A01,083625,Delgado; Tania,14,0,30,16
1650866859101,COGS 107A,A01,083627,Boyle; Mary E. T.,0,16,60,60
1650866865137,COGS 118A,A01,083075,Staff,0,8,60,60
1650866871161,CSE 3,A50,083646,Miranda; Gregory Joseph,18,0,38,20
1650866871161,CSE 3,A51,083647,Miranda; Gregory Joseph,36,0,37,1
1650866877188,CSE 8A,A50,083650,Miranda; Gregory Joseph,0,30,40,40
1650866883221,CSE 11,A01,083080,Cao; Yingjun,0,97,40,40
1650866889248,CSE 12,A01,083652,Staff,0,21,100,100
1650866895279,CSE 15L,A01,083654,Staff,0,3,50,50
1650866895279,CSE 15L,A02,083655,Staff,0,3,50,50
1650866901306,CSE 20,A01,083657,Staff,49,0,80,31
1650866907337,CSE 30,A01,083084,Eldon; John,0,76,40,40
1650866913360,CSE 100,A01,083659,Cao; Yingjun,0,70,50,50
1650866919386,CSE 134B,A01,083661,Powell; Thomas Allan,0,38,65,65
1650866925413,CSE 140,A01,083663,Staff,0,12,75,75
1650866931436,CSE 140L,A01,083088,Eldon; John,0,20,75,75
1650866937461,CSE 175,A01,083665,Kumar; Rakesh,7,0,25,18
1650866943482,CSE 190,A00,092507,Dubnov; Shlomo,9,0,20,11
1650866949509,ECE 45,A01,083139,Staff,0,4,60,60
1650866955541,ECE 65,A50,083695,Staff,0,5,30,30
1650866961569,ECE 109,A01,091882,Touri; Behrouz,32,0,70,38
1650866967592,ECE 180,A00,083140,Abi Samra; Nicholas Camill,20,0,30,10
1650866967592,ECE 180,B00,083141,Abi Samra; Nicholas Camill,0,0,30,30
1650866973617,MATH 10A,A01,083735,Patchell; Gregory David,2,0,30,28
1650866973617,MATH 10A,A02,083736,Patchell; Gregory David,27,0,30,3
1650866973617,MATH 10A,A03,083737,Patchell; Gregory David,23,0,30,7
1650866979640,MATH 10B,A01,083207,Staff,0,9,30,30
1650866979640,MATH 10B,A02,083208,Staff,0,6,30,30
1650866979640,MATH 10B,B01,083739,Staff,10,0,30,20
1650866979640,MATH 10B,B02,083740,Staff,28,0,30,2
1650866985665,MATH 18,A01,083743,Staff,0,0,30,30
1650866985665,MATH 18,A02,083744,Staff,23,0,30,7
1650866985665,MATH 18,A03,083745,Staff,21,0,30,9
1650866985665,MATH 18,A04,083746,Staff,26,0,30,4
1650866985665,MATH 18,B01,083748,Staff,0,15,30,30
1650866985665,MATH 18,B02,083749,Staff,0,13,30,30
1650866985665,MATH 18,B03,083750,Staff,0,13,30,30
1650866985665,MATH 18,B04,083751,Staff,0,13,30,30
1650866991700,MATH 20A,A01,083754,Staff,19,0,40,21
1650866997723,MATH 20B,A01,083756,Staff,0,14,30,30
1650866997723,MATH 20B,A02,083757,Staff,0,11,30,30
1650867003751,MATH 20C,A01,083760,Staff,0,17,30,30
1650867003751,MATH 20C,A02,083761,Staff,0,16,30,30
1650867003751,MATH 20C,B01,083762,Staff,9,0,30,21
1650867003751,MATH 20C,B02,083763,Staff,28,0,30,2
1650867009776,MATH 20D,A01,083765,Staff,2,1,30,28
1650867009776,MATH 20D,A02,083766,Staff,6,0,30,24
1650867009776,MATH 20D,A03,083767,Staff,23,0,30,7
1650867015804,MATH 20E,A01,083771,Staff,2,0,30,28
1650867015804,MATH 20E,A02,083772,Staff,13,0,30,17
1650867015804,MATH 20E,B01,083773,Staff,0,0,30,30
1650867015804,MATH 20E,B02,083774,Staff,4,0,30,26
1650867021827,MATH 103A,A01,083777,Staff,0,17,30,30
1650867021827,MATH 103A,A02,083778,Staff,0,15,30,30
1650867021827,MATH 103A,B01,083779,Staff,0,15,30,30
1650867021827,MATH 103A,B02,083780,Staff,0,14,30,30
1650867027855,MATH 105,A01,085443,Staff,0,23,30,30
1650867033881,MATH 109,A01,083213,Anzaldo; Leesa B,0,7,30,30
1650867033881,MATH 109,A02,083214,Anzaldo; Leesa B,0,7,30,30
1650867033881,MATH 109,B01,083215,Anzaldo; Leesa B,0,8,30,30
1650867033881,MATH 109,B02,083216,Anzaldo; Leesa B,0,7,30,30
1650867039905,MATH 142A,A01,083219,Chow; Bennett,0,14,30,30
1650867039905,MATH 142A,A02,083220,Chow; Bennett,0,15,30,30
1650867039905,MATH 142A,B01,083221,Chow; Bennett,0,16,30,30
1650867039905,MATH 142A,B02,083222,Chow; Bennett,0,14,30,30
1650867045929,MATH 193A,A01,083224,Staff,0,6,30,30
1650867045929,MATH 193A,A02,083225,Staff,0,7,30,30
1650867045929,MATH 193A,A03,083781,Staff,0,6,30,30
1650867045929,MATH 193A,A04,083782,Staff,0,7,30,30
1650867051952,MATH 197,001,091859,McAuley; Julian John,9998,0,9999,1
1650867058013,COGS 9,A01,083615,Staff,0,17,60,60
1650867064036,COGS 11,A01,083617,Boyle; Mary E. T.,15,0,40,25
1650867070062,COGS 13,A01,083071,Staff,0,38,40,40
1650867076090,COGS 14A,A01,092681,Staff,0,37,100,100
1650867082115,COGS 14B,A01,083073,Cheng; Tzu-Han,0,12,50,50
1650867088140,COGS 17,A01,092677,Staff,12,0,75,63
1650867094164,COGS 100,A01,083619,Staff,0,30,60,60
1650867100191,COGS 101A,A01,083621,Davis; Joshua Daniel,0,29,60,60
1650867106218,COGS 101B,A01,091572,Staff,0,3,60,60
1650867112242,COGS 101C,A01,083625,Delgado; Tania,14,0,30,16
1650867118264,COGS 107A,A01,083627,Boyle; Mary E. T.,0,16,60,60
1650867124292,COGS 118A,A01,083075,Staff,0,8,60,60
1650867130320,CSE 3,A50,083646,Miranda; Gregory Joseph,18,0,38,20
1650867130320,CSE 3,A51,083647,Miranda; Gregory Joseph,36,0,37,1
1650867136363,CSE 8A,A50,083650,Miranda; Gregory Joseph,0,29,40,40
1650867142387,CSE 11,A01,083080,Cao; Yingjun,0,97,40,40
1650867148411,CSE 12,A01,083652,Staff,0,21,100,100
1650867154442,CSE 15L,A01,083654,Staff,0,3,50,50
1650867154442,CSE 15L,A02,083655,Staff,0,3,50,50
1650867160466,CSE 20,A01,083657,Staff,49,0,80,31
1650867166488,CSE 30,A01,083084,Eldon; John,0,76,40,40
1650867172516,CSE 100,A01,083659,Cao; Yingjun,0,70,50,50
1650867178540,CSE 134B,A01,083661,Powell; Thomas Allan,0,38,65,65
1650867184565,CSE 140,A01,083663,Staff,0,12,75,75
1650867190600,CSE 140L,A01,083088,Eldon; John,0,20,75,75
1650867196625,CSE 175,A01,083665,Kumar; Rakesh,7,0,25,18
1650867202650,CSE 190,A00,092507,Dubnov; Shlomo,9,0,20,11
1650867208674,ECE 45,A01,083139,Staff,0,4,60,60
1650867214700,ECE 65,A50,083695,Staff,0,5,30,30
1650867220734,ECE 109,A01,091882,Touri; Behrouz,32,0,70,38
1650867226758,ECE 180,A00,083140,Abi Samra; Nicholas Camill,20,0,30,10
1650867226758,ECE 180,B00,083141,Abi Samra; Nicholas Camill,0,0,30,30
1650867232786,MATH 10A,A01,083735,Patchell; Gregory David,2,0,30,28
1650867232786,MATH 10A,A02,083736,Patchell; Gregory David,27,0,30,3
1650867232786,MATH 10A,A03,083737,Patchell; Gregory David,23,0,30,7
1650867238809,MATH 10B,A01,083207,Staff,0,9,30,30
1650867238809,MATH 10B,A02,083208,Staff,0,6,30,30
1650867238809,MATH 10B,B01,083739,Staff,10,0,30,20
1650867238809,MATH 10B,B02,083740,Staff,28,0,30,2
1650867244832,MATH 18,A01,083743,Staff,0,0,30,30
1650867244832,MATH 18,A02,083744,Staff,23,0,30,7
1650867244832,MATH 18,A03,083745,Staff,21,0,30,9
1650867244832,MATH 18,A04,083746,Staff,26,0,30,4
1650867244832,MATH 18,B01,083748,Staff,0,15,30,30
1650867244832,MATH 18,B02,083749,Staff,0,13,30,30
1650867244832,MATH 18,B03,083750,Staff,0,13,30,30
1650867244832,MATH 18,B04,083751,Staff,0,13,30,30
1650867250855,MATH 20A,A01,083754,Staff,19,0,40,21
1650867256880,MATH 20B,A01,083756,Staff,0,14,30,30
1650867256880,MATH 20B,A02,083757,Staff,0,11,30,30
1650867262903,MATH 20C,A01,083760,Staff,0,17,30,30
1650867262903,MATH 20C,A02,083761,Staff,0,16,30,30
1650867262903,MATH 20C,B01,083762,Staff,9,0,30,21
1650867262903,MATH 20C,B02,083763,Staff,28,0,30,2
1650867268930,MATH 20D,A01,083765,Staff,2,1,30,28
1650867268930,MATH 20D,A02,083766,Staff,6,0,30,24
1650867268930,MATH 20D,A03,083767,Staff,23,0,30,7
1650867274956,MATH 20E,A01,083771,Staff,2,0,30,28
1650867274956,MATH 20E,A02,083772,Staff,13,0,30,17
1650867274956,MATH 20E,B01,083773,Staff,0,0,30,30
1650867274956,MATH 20E,B02,083774,Staff,4,0,30,26
1650867280989,MATH 103A,A01,083777,Staff,0,17,30,30
1650867280989,MATH 103A,A02,083778,Staff,0,15,30,30
1650867280989,MATH 103A,B01,083779,Staff,0,15,30,30
1650867280989,MATH 103A,B02,083780,Staff,0,14,30,30
1650867287011,MATH 105,A01,085443,Staff,0,23,30,30
1650867293135,MATH 109,A01,083213,Anzaldo; Leesa B,0,7,30,30
1650867293135,MATH 109,A02,083214,Anzaldo; Leesa B,0,7,30,30
1650867293135,MATH 109,B01,083215,Anzaldo; Leesa B,0,8,30,30
1650867293135,MATH 109,B02,083216,Anzaldo; Leesa B,0,7,30,30
1650867299161,MATH 142A,A01,083219,Chow; Bennett,0,14,30,30
1650867299161,MATH 142A,A02,083220,Chow; Bennett,0,15,30,30
1650867299161,MATH 142A,B01,083221,Chow; Bennett,0,16,30,30
1650867299161,MATH 142A,B02,083222,Chow; Bennett,0,14,30,30
1650867305185,MATH 193A,A01,083224,Staff,0,6,30,30
1650867305185,MATH 193A,A02,083225,Staff,0,7,30,30
1650867305185,MATH 193A,A03,083781,Staff,0,6,30,30
1650867305185,MATH 193A,A04,083782,Staff,0,7,30,30
1650867311211,MATH 197,001,091859,McAuley; Julian John,9998,0,9999,1
1650867317272,COGS 9,A01,083615,Staff,0,17,60,60
1650867323298,COGS 11,A01,083617,Boyle; Mary E. T.,15,0,40,25
1650867329325,COGS 13,A01,083071,Staff,0,38,40,40
1650867335350,COGS 14A,A01,092681,Staff,0,37,100,100
1650867341373,COGS 14B,A01,083073,Cheng; Tzu-Han,0,12,50,50
1650867347396,COGS 17,A01,092677,Staff,12,0,75,63
1650867353423,COGS 100,A01,083619,Staff,0,30,60,60
1650867359445,COGS 101A,A01,083621,Davis; Joshua Daniel,0,29,60,60
1650867365469,COGS 101B,A01,091572,Staff,0,3,60,60
1650867371495,COGS 101C,A01,083625,Delgado; Tania,14,0,30,16
1650867377518,COGS 107A,A01,083627,Boyle; Mary E. T.,0,16,60,60
1650867383542,COGS 118A,A01,083075,Staff,0,8,60,60
1650867389565,CSE 3,A50,083646,Miranda; Gregory Joseph,18,0,38,20
1650867389565,CSE 3,A51,083647,Miranda; Gregory Joseph,36,0,37,1
1650867395590,CSE 8A,A50,083650,Miranda; Gregory Joseph,0,29,40,40
1650867401612,CSE 11,A01,083080,Cao; Yingjun,0,97,40,40
1650867407635,CSE 12,A01,083652,Staff,0,21,100,100
1650867413660,CSE 15L,A01,083654,Staff,0,3,50,50
1650867413660,CSE 15L,A02,083655,Staff,0,3,50,50
1650867419690,CSE 20,A01,083657,Staff,49,0,80,31
1650867425720,CSE 30,A01,083084,Eldon; John,0,76,40,40
1650867431743,CSE 100,A01,083659,Cao; Yingjun,0,70,50,50
1650867437766,CSE 134B,A01,083661,Powell; Thomas Allan,0,38,65,65
1650867443792,CSE 140,A01,083663,Staff,0,12,75,75
1650867449817,CSE 140L,A01,083088,Eldon; John,0,20,75,75
1650867455840,CSE 175,A01,083665,Kumar; Rakesh,7,0,25,18
1650867461872,CSE 190,A00,092507,Dubnov; Shlomo,9,0,20,11
1650867467896,ECE 45,A01,083139,Staff,0,4,60,60
1650867473923,ECE 65,A50,083695,Staff,0,5,30,30
1650867479952,ECE 109,A01,091882,Touri; Behrouz,32,0,70,38
1650867485978,ECE 180,A00,083140,Abi Samra; Nicholas Camill,20,0,30,10
1650867485978,ECE 180,B00,083141,Abi Samra; Nicholas Camill,0,0,30,30
1650867492005,MATH 10A,A01,083735,Patchell; Gregory David,2,0,30,28
1650867492005,MATH 10A,A02,083736,Patchell; Gregory David,27,0,30,3
1650867492005,MATH 10A,A03,083737,Patchell; Gregory David,23,0,30,7
1650867498027,MATH 10B,A01,083207,Staff,0,9,30,30
1650867498027,MATH 10B,A02,083208,Staff,0,6,30,30
1650867498027,MATH 10B,B01,083739,Staff,10,0,30,20
1650867498027,MATH 10B,B02,083740,Staff,28,0,30,2
1650867504054,MATH 18,A01,083743,Staff,0,0,30,30
1650867504054,MATH 18,A02,083744,Staff,23,0,30,7
1650867504054,MATH 18,A03,083745,Staff,21,0,30,9
1650867504054,MATH 18,A04,083746,Staff,26,0,30,4
1650867504054,MATH 18,B01,083748,Staff,0,15,30,30
1650867504054,MATH 18,B02,083749,Staff,0,13,30,30
1650867504054,MATH 18,B03,083750,Staff,0,13,30,30
1650867504054,MATH 18,B04,083751,Staff,0,13,30,30
1650867510083,MATH 20A,A01,083754,Staff,19,0,40,21
1650867516110,MATH 20B,A01,083756,Staff,0,14,30,30
1650867516110,MATH 20B,A02,083757,Staff,0,11,30,30
1650867522139,MATH 20C,A01,083760,Staff,0,17,30,30
1650867522139,MATH 20C,A02,083761,Staff,0,16,30,30
1650867522139,MATH 20C,B01,083762,Staff,9,0,30,21
1650867522139,MATH 20C,B02,083763,Staff,28,0,30,2
1650867528168,MATH 20D,A01,083765,Staff,2,1,30,28
1650867528168,MATH 20D,A02,083766,Staff,6,0,30,24
1650867528168,MATH 20D,A03,083767,Staff,23,0,30,7
1650867534193,MATH 20E,A01,083771,Staff,2,0,30,28
1650867534193,MATH 20E,A02,083772,Staff,13,0,30,17
1650867534193,MATH 20E,B01,083773,Staff,0,0,30,30
1650867534193,MATH 20E,B02,083774,Staff,4,0,30,26
1650867540218,MATH 103A,A01,083777,Staff,0,17,30,30
1650867540218,MATH 103A,A02,083778,Staff,0,15,30,30
1650867540218,MATH 103A,B01,083779,Staff,0,15,30,30
1650867540218,MATH 103A,B02,083780,Staff,0,14,30,30
1650867546254,MATH 105,A01,085443,Staff,0,23,30,30
1650867552279,MATH 109,A01,083213,Anzaldo; Leesa B,0,7,30,30
1650867552279,MATH 109,A02,083214,Anzaldo; Leesa B,0,7,30,30
1650867552279,MATH 109,B01,083215,Anzaldo; Leesa B,0,8,30,30
1650867552279,MATH 109,B02,083216,Anzaldo; Leesa B,0,7,30,30
1650867558318,MATH 142A,A01,083219,Chow; Bennett,0,14,30,30
1650867558318,MATH 142A,A02,083220,Chow; Bennett,0,15,30,30
1650867558318,MATH 142A,B01,083221,Chow; Bennett,0,16,30,30
1650867558318,MATH 142A,B02,083222,Chow; Bennett,0,14,30,30
1650867564342,MATH 193A,A01,083224,Staff,0,6,30,30
1650867564342,MATH 193A,A02,083225,Staff,0,7,30,30
1650867564342,MATH 193A,A03,083781,Staff,0,6,30,30
1650867564342,MATH 193A,A04,083782,Staff,0,7,30,30
1650867570371,MATH 197,001,091859,McAuley; Julian John,9998,0,9999,1
1650867576452,COGS 9,A01,083615,Staff,0,17,60,60
1650867582474,COGS 11,A01,083617,Boyle; Mary E. T.,15,0,40,25
1650867588497,COGS 13,A01,083071,Staff,0,38,40,40
1650867594523,COGS 14A,A01,092681,Staff,0,37,100,100
1650867600551,COGS 14B,A01,083073,Cheng; Tzu-Han,0,12,50,50
1650867606575,COGS 17,A01,092677,Staff,12,0,75,63
1650867612600,COGS 100,A01,083619,Staff,0,30,60,60
1650867618636,COGS 101A,A01,083621,Davis; Joshua Daniel,0,29,60,60
1650867624660,COGS 101B,A01,091572,Staff,0,3,60,60
1650867630683,COGS 101C,A01,083625,Delgado; Tania,14,0,30,16
1650867636709,COGS 107A,A01,083627,Boyle; Mary E. T.,0,16,60,60
1650867642740,COGS 118A,A01,083075,Staff,0,8,60,60
1650867648773,CSE 3,A50,083646,Miranda; Gregory Joseph,18,0,38,20
1650867648773,CSE 3,A51,083647,Miranda; Gregory Joseph,36,0,37,1
1650867654797,CSE 8A,A50,083650,Miranda; Gregory Joseph,0,29,40,40
1650867660823,CSE 11,A01,083080,Cao; Yingjun,0,97,40,40
1650867666848,CSE 12,A01,083652,Staff,0,21,100,100
1650867672876,CSE 15L,A01,083654,Staff,0,3,50,50
1650867672876,CSE 15L,A02,083655,Staff,0,3,50,50
1650867678899,CSE 20,A01,083657,Staff,49,0,80,31
1650867684926,CSE 30,A01,083084,Eldon; John,0,76,40,40
1650867690960,CSE 100,A01,083659,Cao; Yingjun,0,70,50,50
1650867696997,CSE 134B,A01,083661,Powell; Thomas Allan,0,38,65,65
1650867703023,CSE 140,A01,083663,Staff,0,12,75,75
1650867709045,CSE 140L,A01,083088,Eldon; John,0,20,75,75
1650867715075,CSE 175,A01,083665,Kumar; Rakesh,7,0,25,18
1650867721101,CSE 190,A00,092507,Dubnov; Shlomo,9,0,20,11
1650867727128,ECE 45,A01,083139,Staff,0,4,60,60
1650867733162,ECE 65,A50,083695,Staff,0,5,30,30
1650867739190,ECE 109,A01,091882,Touri; Behrouz,32,0,70,38
1650867745217,ECE 180,A00,083140,Abi Samra; Nicholas Camill,20,0,30,10
1650867745217,ECE 180,B00,083141,Abi Samra; Nicholas Camill,0,0,30,30
1650867751241,MATH 10A,A01,083735,Patchell; Gregory David,2,0,30,28
1650867751241,MATH 10A,A02,083736,Patchell; Gregory David,27,0,30,3
1650867751241,MATH 10A,A03,083737,Patchell; Gregory David,23,0,30,7
1650867757274,MATH 10B,A01,083207,Staff,0,9,30,30
1650867757274,MATH 10B,A02,083208,Staff,0,6,30,30
1650867757274,MATH 10B,B01,083739,Staff,10,0,30,20
1650867757274,MATH 10B,B02,083740,Staff,28,0,30,2
1650867763299,MATH 18,A01,083743,Staff,0,0,30,30
1650867763299,MATH 18,A02,083744,Staff,23,0,30,7
1650867763299,MATH 18,A03,083745,Staff,21,0,30,9
1650867763299,MATH 18,A04,083746,Staff,26,0,30,4
1650867763299,MATH 18,B01,083748,Staff,0,15,30,30
1650867763299,MATH 18,B02,083749,Staff,0,13,30,30
1650867763299,MATH 18,B03,083750,Staff,0,13,30,30
1650867763299,MATH 18,B04,083751,Staff,0,13,30,30
1650867769332,MATH 20A,A01,083754,Staff,19,0,40,21
1650867775355,MATH 20B,A01,083756,Staff,0,14,30,30
1650867775355,MATH 20B,A02,083757,Staff,0,11,30,30
1650867781379,MATH 20C,A01,083760,Staff,0,17,30,30
1650867781379,MATH 20C,A02,083761,Staff,0,16,30,30
1650867781379,MATH 20C,B01,083762,Staff,9,0,30,21
1650867781379,MATH 20C,B02,083763,Staff,28,0,30,2
1650867787422,MATH 20D,A01,083765,Staff,2,1,30,28
1650867787422,MATH 20D,A02,083766,Staff,6,0,30,24
1650867787422,MATH 20D,A03,083767,Staff,23,0,30,7
1650867793452,MATH 20E,A01,083771,Staff,2,0,30,28
1650867793452,MATH 20E,A02,083772,Staff,13,0,30,17
1650867793452,MATH 20E,B01,083773,Staff,0,0,30,30
1650867793452,MATH 20E,B02,083774,Staff,4,0,30,26
1650867799478,MATH 103A,A01,083777,Staff,0,17,30,30
1650867799478,MATH 103A,A02,083778,Staff,0,15,30,30
1650867799478,MATH 103A,B01,083779,Staff,0,15,30,30
1650867799478,MATH 103A,B02,083780,Staff,0,14,30,30
1650867805508,MATH 105,A01,085443,Staff,0,23,30,30
1650867811532,MATH 109,A01,083213,Anzaldo; Leesa B,0,7,30,30
1650867811532,MATH 109,A02,083214,Anzaldo; Leesa B,0,7,30,30
1650867811532,MATH 109,B01,083215,Anzaldo; Leesa B,0,8,30,30
1650867811532,MATH 109,B02,083216,Anzaldo; Leesa B,0,7,30,30
1650867817563,MATH 142A,A01,083219,Chow; Bennett,0,14,30,30
1650867817563,MATH 142A,A02,083220,Chow; Bennett,0,15,30,30
1650867817563,MATH 142A,B01,083221,Chow; Bennett,0,16,30,30
1650867817563,MATH 142A,B02,083222,Chow; Bennett,0,14,30,30
1650867823602,MATH 193A,A01,083224,Staff,0,6,30,30
1650867823602,MATH 193A,A02,083225,Staff,0,7,30,30
1650867823602,MATH 193A,A03,083781,Staff,0,6,30,30
1650867823602,MATH 193A,A04,083782,Staff,0,7,30,30
1650867829637,MATH 197,001,091859,McAuley; Julian John,9998,0,9999,1
1650867835703,COGS 9,A01,083615,Staff,0,17,60,60
1650867841731,COGS 11,A01,083617,Boyle; Mary E. T.,15,0,40,25
1650867847762,COGS 13,A01,083071,Staff,0,38,40,40
1650867853790,COGS 14A,A01,092681,Staff,0,37,100,100
1650867859817,COGS 14B,A01,083073,Cheng; Tzu-Han,0,12,50,50
1650867865841,COGS 17,A01,092677,Staff,12,0,75,63
1650867871865,COGS 100,A01,083619,Staff,0,30,60,60
1650867877890,COGS 101A,A01,083621,Davis; Joshua Daniel,0,29,60,60
1650867884013,COGS 101B,A01,091572,Staff,0,3,60,60
1650867890038,COGS 101C,A01,083625,Delgado; Tania,14,0,30,16
1650867896067,COGS 107A,A01,083627,Boyle; Mary E. T.,0,16,60,60
1650867902094,COGS 118A,A01,083075,Staff,0,8,60,60
1650867908126,CSE 3,A50,083646,Miranda; Gregory Joseph,18,0,38,20
1650867908126,CSE 3,A51,083647,Miranda; Gregory Joseph,36,0,37,1
1650867914154,CSE 8A,A50,083650,Miranda; Gregory Joseph,0,29,40,40
1650867920191,CSE 11,A01,083080,Cao; Yingjun,0,97,40,40
1650867926216,CSE 12,A01,083652,Staff,0,21,100,100
1650867932239,CSE 15L,A01,083654,Staff,0,3,50,50
1650867932239,CSE 15L,A02,083655,Staff,0,3,50,50
1650867938266,CSE 20,A01,083657,Staff,49,0,80,31
1650867944303,CSE 30,A01,083084,Eldon; John,0,76,40,40
1650867950332,CSE 100,A01,083659,Cao; Yingjun,0,70,50,50
1650867956359,CSE 134B,A01,083661,Powell; Thomas Allan,0,38,65,65
1650867962387,CSE 140,A01,083663,Staff,0,12,75,75
1650867968412,CSE 140L,A01,083088,Eldon; John,0,20,75,75
1650867974443,CSE 175,A01,083665,Kumar; Rakesh,7,0,25,18
1650867980465,CSE 190,A00,092507,Dubnov; Shlomo,9,0,20,11
1650867986491,ECE 45,A01,083139,Staff,0,4,60,60
1650867992514,ECE 65,A50,083695,Staff,0,5,30,30
1650867998535,ECE 109,A01,091882,Touri; Behrouz,32,0,70,38
1650868004562,ECE 180,A00,083140,Abi Samra; Nicholas Camill,20,0,30,10
1650868004562,ECE 180,B00,083141,Abi Samra; Nicholas Camill,0,0,30,30
1650868010585,MATH 10A,A01,083735,Patchell; Gregory David,2,0,30,28
1650868010585,MATH 10A,A02,083736,Patchell; Gregory David,27,0,30,3
1650868010585,MATH 10A,A03,083737,Patchell; Gregory David,23,0,30,7
1650868016609,MATH 10B,A01,083207,Staff,0,9,30,30
1650868016609,MATH 10B,A02,083208,Staff,0,6,30,30
1650868016609,MATH 10B,B01,083739,Staff,10,0,30,20
1650868016609,MATH 10B,B02,083740,Staff,28,0,30,2
1650868022639,MATH 18,A01,083743,Staff,0,0,30,30
1650868022639,MATH 18,A02,083744,Staff,23,0,30,7
1650868022639,MATH 18,A03,083745,Staff,21,0,30,9
1650868022639,MATH 18,A04,083746,Staff,26,0,30,4
1650868022639,MATH 18,B01,083748,Staff,0,15,30,30
1650868022639,MATH 18,B02,083749,Staff,0,13,30,30
1650868022639,MATH 18,B03,083750,Staff,0,13,30,30
1650868022639,MATH 18,B04,083751,Staff,0,13,30,30
1650868028662,MATH 20A,A01,083754,Staff,19,0,40,21
1650868034686,MATH 20B,A01,083756,Staff,0,14,30,30
1650868034686,MATH 20B,A02,083757,Staff,0,11,30,30
1650868040709,MATH 20C,A01,083760,Staff,0,17,30,30
1650868040709,MATH 20C,A02,083761,Staff,0,16,30,30
1650868040709,MATH 20C,B01,083762,Staff,9,0,30,21
1650868040709,MATH 20C,B02,083763,Staff,28,0,30,2
1650868046733,MATH 20D,A01,083765,Staff,2,1,30,28
1650868046733,MATH 20D,A02,083766,Staff,6,0,30,24
1650868046733,MATH 20D,A03,083767,Staff,23,0,30,7
1650868052756,MATH 20E,A01,083771,Staff,2,0,30,28
1650868052756,MATH 20E,A02,083772,Staff,13,0,30,17
1650868052756,MATH 20E,B01,083773,Staff,0,0,30,30
1650868052756,MATH 20E,B02,083774,Staff,4,0,30,26
1650868058783,MATH 103A,A01,083777,Staff,0,17,30,30
1650868058783,MATH 103A,A02,083778,Staff,0,15,30,30
1650868058783,MATH 103A,B01,083779,Staff,0,15,30,30
1650868058783,MATH 103A,B02,083780,Staff,0,14,30,30
1650868064813,MATH 105,A01,085443,Staff,0,23,30,30
1650868070847,MATH 109,A01,083213,Anzaldo; Leesa B,0,7,30,30
1650868070847,MATH 109,A02,083214,Anzaldo; Leesa B,0,7,30,30
1650868070847,MATH 109,B01,083215,Anzaldo; Leesa B,0,8,30,30
1650868070847,MATH 109,B02,083216,Anzaldo; Leesa B,0,7,30,30
1650868076870,MATH 142A,A01,083219,Chow; Bennett,0,14,30,30
1650868076870,MATH 142A,A02,083220,Chow; Bennett,0,15,30,30
1650868076870,MATH 142A,B01,083221,Chow; Bennett,0,16,30,30
1650868076870,MATH 142A,B02,083222,Chow; Bennett,0,14,30,30
1650868082895,MATH 193A,A01,083224,Staff,0,6,30,30
1650868082895,MATH 193A,A02,083225,Staff,0,7,30,30
1650868082895,MATH 193A,A03,083781,Staff,0,6,30,30
1650868082895,MATH 193A,A04,083782,Staff,0,7,30,30
1650868088919,MATH 197,001,091859,McAuley; Julian John,9998,0,9999,1
1650868094979,COGS 9,A01,083615,Staff,0,17,60,60
1650868101007,COGS 11,A01,083617,Boyle; Mary E. T.,15,0,40,25
1650868107034,COGS 13,A01,083071,Staff,0,38,40,40
1650868113066,COGS 14A,A01,092681,Staff,0,37,100,100
1650868119091,COGS 14B,A01,083073,Cheng; Tzu-Han,0,12,50,50
1650868125114,COGS 17,A01,092677,Staff,12,0,75,63
1650868131152,COGS 100,A01,083619,Staff,0,30,60,60
1650868137184,COGS 101A,A01,083621,Davis; Joshua Daniel,0,29,60,60
1650868143209,COGS 101B,A01,091572,Staff,0,3,60,60
1650868149236,COGS 101C,A01,083625,Delgado; Tania,14,0,30,16
1650868155261,COGS 107A,A01,083627,Boyle; Mary E. T.,0,16,60,60
1650868161330,COGS 118A,A01,083075,Staff,0,8,60,60
1650868167351,CSE 3,A50,083646,Miranda; Gregory Joseph,18,0,38,20
1650868167351,CSE 3,A51,083647,Miranda; Gregory Joseph,36,0,37,1
1650868173374,CSE 8A,A50,083650,Miranda; Gregory Joseph,0,29,40,40
1650868179398,CSE 11,A01,083080,Cao; Yingjun,0,97,40,40
1650868185424,CSE 12,A01,083652,Staff,0,21,100,100
1650868191448,CSE 15L,A01,083654,Staff,0,3,50,50
1650868191448,CSE 15L,A02,083655,Staff,0,3,50,50
1650868197469,CSE 20,A01,083657,Staff,49,0,80,31
1650868203490,CSE 30,A01,083084,Eldon; John,0,76,40,40
1650868209516,CSE 100,A01,083659,Cao; Yingjun,0,70,50,50
1650868215542,CSE 134B,A01,083661,Powell; Thomas Allan,0,38,65,65
1650868221566,CSE 140,A01,083663,Staff,0,12,75,75
1650868227587,CSE 140L,A01,083088,Eldon; John,0,20,75,75
1650868233610,CSE 175,A01,083665,Kumar; Rakesh,7,0,25,18
1650868239632,CSE 190,A00,092507,Dubnov; Shlomo,9,0,20,11
1650868245655,ECE 45,A01,083139,Staff,0,4,60,60
1650868251686,ECE 65,A50,083695,Staff,0,5,30,30
1650868257708,ECE 109,A01,091882,Touri; Behrouz,32,0,70,38
1650868263735,ECE 180,A00,083140,Abi Samra; Nicholas Camill,20,0,30,10
1650868263735,ECE 180,B00,083141,Abi Samra; Nicholas Camill,0,0,30,30
1650868269757,MATH 10A,A01,083735,Patchell; Gregory David,2,0,30,28
1650868269757,MATH 10A,A02,083736,Patchell; Gregory David,27,0,30,3
1650868269757,MATH 10A,A03,083737,Patchell; Gregory David,23,0,30,7
1650868275784,MATH 10B,A01,083207,Staff,0,9,30,30
1650868275784,MATH 10B,A02,083208,Staff,0,6,30,30
1650868275784,MATH 10B,B01,083739,Staff,10,0,30,20
1650868275784,MATH 10B,B02,083740,Staff,28,0,30,2
1650868281810,MATH 18,A01,083743,Staff,0,0,30,30
1650868281810,MATH 18,A02,083744,Staff,23,0,30,7
1650868281810,MATH 18,A03,083745,Staff,21,0,30,9
1650868281810,MATH 18,A04,083746,Staff,26,0,30,4
1650868281810,MATH 18,B01,083748,Staff,0,15,30,30
1650868281810,MATH 18,B02,083749,Staff,0,13,30,30
1650868281810,MATH 18,B03,083750,Staff,0,13,30,30
1650868281810,MATH 18,B04,083751,Staff,0,13,30,30
1650868287834,MATH 20A,A01,083754,Staff,19,0,40,21
1650868293859,MATH 20B,A01,083756,Staff,0,14,30,30
1650868293859,MATH 20B,A02,083757,Staff,0,11,30,30
1650868299886,MATH 20C,A01,083760,Staff,0,17,30,30
1650868299886,MATH 20C,A02,083761,Staff,0,16,30,30
1650868299886,MATH 20C,B01,083762,Staff,9,0,30,21
1650868299886,MATH 20C,B02,083763,Staff,28,0,30,2
1650868305910,MATH 20D,A01,083765,Staff,2,1,30,28
1650868305910,MATH 20D,A02,083766,Staff,6,0,30,24
1650868305910,MATH 20D,A03,083767,Staff,23,0,30,7
1650868311938,MATH 20E,A01,083771,Staff,2,0,30,28
1650868311938,MATH 20E,A02,083772,Staff,13,0,30,17
1650868311938,MATH 20E,B01,083773,Staff,0,0,30,30
1650868311938,MATH 20E,B02,083774,Staff,4,0,30,26
1650868317961,MATH 103A,A01,083777,Staff,0,17,30,30
1650868317961,MATH 103A,A02,083778,Staff,0,15,30,30
1650868317961,MATH 103A,B01,083779,Staff,0,15,30,30
1650868317961,MATH 103A,B02,083780,Staff,0,14,30,30
1650868323995,MATH 105,A01,085443,Staff,0,23,30,30
1650868330020,MATH 109,A01,083213,Anzaldo; Leesa B,0,7,30,30
1650868330020,MATH 109,A02,083214,Anzaldo; Leesa B,0,7,30,30
1650868330020,MATH 109,B01,083215,Anzaldo; Leesa B,0,8,30,30
1650868330020,MATH 109,B02,083216,Anzaldo; Leesa B,0,7,30,30
1650868336042,MATH 142A,A01,083219,Chow; Bennett,0,14,30,30
1650868336042,MATH 142A,A02,083220,Chow; Bennett,0,15,30,30
1650868336042,MATH 142A,B01,083221,Chow; Bennett,0,16,30,30
1650868336042,MATH 142A,B02,083222,Chow; Bennett,0,14,30,30
1650868342069,MATH 193A,A01,083224,Staff,0,6,30,30
1650868342069,MATH 193A,A02,083225,Staff,0,7,30,30
1650868342069,MATH 193A,A03,083781,Staff,0,6,30,30
1650868342069,MATH 193A,A04,083782,Staff,0,7,30,30
1650868348093,MATH 197,001,091859,McAuley; Julian John,9998,0,9999,1
1650868354144,COGS 9,A01,083615,Staff,0,17,60,60
1650868360170,COGS 11,A01,083617,Boyle; Mary E. T.,15,0,40,25
1650868366193,COGS 13,A01,083071,Staff,0,38,40,40
1650868372216,COGS 14A,A01,092681,Staff,0,37,100,100
1650868378239,COGS 14B,A01,083073,Cheng; Tzu-Han,0,12,50,50
1650868384264,COGS 17,A01,092677,Staff,12,0,75,63
1650868390291,COGS 100,A01,083619,Staff,0,30,60,60
1650868396314,COGS 101A,A01,083621,Davis; Joshua Daniel,0,29,60,60
1650868402339,COGS 101B,A01,091572,Staff,0,3,60,60
1650868408362,COGS 101C,A01,083625,Delgado; Tania,14,0,30,16
1650868414388,COGS 107A,A01,083627,Boyle; Mary E. T.,0,16,60,60
1650868420411,COGS 118A,A01,083075,Staff,0,8,60,60
1650868426435,CSE 3,A50,083646,Miranda; Gregory Joseph,18,0,38,20
1650868426435,CSE 3,A51,083647,Miranda; Gregory Joseph,36,0,37,1
1650868432458,CSE 8A,A50,083650,Miranda; Gregory Joseph,0,29,40,40
1650868438481,CSE 11,A01,083080,Cao; Yingjun,0,97,40,40
1650868444503,CSE 12,A01,083652,Staff,0,21,100,100
1650868450530,CSE 15L,A01,083654,Staff,0,3,50,50
1650868450530,CSE 15L,A02,083655,Staff,0,3,50,50
1650868456556,CSE 20,A01,083657,Staff,49,0,80,31
1650868462581,CSE 30,A01,083084,Eldon; John,0,76,40,40
1650868468605,CSE 100,A01,083659,Cao; Yingjun,0,70,50,50
1650868474627,CSE 134B,A01,083661,Powell; Thomas Allan,0,38,65,65
1650868480744,CSE 140,A01,083663,Staff,0,12,75,75
1650868486804,CSE 140L,A01,083088,Eldon; John,0,20,75,75
1650868492825,CSE 175,A01,083665,Kumar; Rakesh,7,0,25,18
1650868498851,CSE 190,A00,092507,Dubnov; Shlomo,9,0,20,11
1650868504873,ECE 45,A01,083139,Staff,0,4,60,60
1650868510895,ECE 65,A50,083695,Staff,0,5,30,30
1650868516918,ECE 109,A01,091882,Touri; Behrouz,32,0,70,38
1650868522944,ECE 180,A00,083140,Abi Samra; Nicholas Camill,20,0,30,10
1650868522944,ECE 180,B00,083141,Abi Samra; Nicholas Camill,0,0,30,30
1650868528973,MATH 10A,A01,083735,Patchell; Gregory David,2,0,30,28
1650868528973,MATH 10A,A02,083736,Patchell; Gregory David,27,0,30,3
1650868528973,MATH 10A,A03,083737,Patchell; Gregory David,23,0,30,7
1650868534998,MATH 10B,A01,083207,Staff,0,9,30,30
1650868534998,MATH 10B,A02,083208,Staff,0,6,30,30
1650868534998,MATH 10B,B01,083739,Staff,10,0,30,20
1650868534998,MATH 10B,B02,083740,Staff,28,0,30,2
1650868541021,MATH 18,A01,083743,Staff,0,0,30,30
1650868541021,MATH 18,A02,083744,Staff,23,0,30,7
1650868541021,MATH 18,A03,083745,Staff,21,0,30,9
1650868541021,MATH 18,A04,083746,Staff,26,0,30,4
1650868541021,MATH 18,B01,083748,Staff,0,15,30,30
1650868541021,MATH 18,B02,083749,Staff,0,13,30,30
1650868541021,MATH 18,B03,083750,Staff,0,13,30,30
1650868541021,MATH 18,B04,083751,Staff,0,13,30,30
1650868547043,MATH 20A,A01,083754,Staff,19,0,40,21
1650868553068,MATH 20B,A01,083756,Staff,0,14,30,30
1650868553068,MATH 20B,A02,083757,Staff,0,11,30,30
1650868559110,MATH 20C,A01,083760,Staff,0,17,30,30
1650868559110,MATH 20C,A02,083761,Staff,0,16,30,30
1650868559110,MATH 20C,B01,083762,Staff,9,0,30,21
1650868559110,MATH 20C,B02,083763,Staff,28,0,30,2
1650868565135,MATH 20D,A01,083765,Staff,2,1,30,28
1650868565135,MATH 20D,A02,083766,Staff,6,0,30,24
1650868565135,MATH 20D,A03,083767,Staff,23,0,30,7
1650868571164,MATH 20E,A01,083771,Staff,2,0,30,28
1650868571164,MATH 20E,A02,083772,Staff,13,0,30,17
1650868571164,MATH 20E,B01,083773,Staff,0,0,30,30
1650868571164,MATH 20E,B02,083774,Staff,4,0,30,26
1650868577187,MATH 103A,A01,083777,Staff,0,17,30,30
1650868577187,MATH 103A,A02,083778,Staff,0,15,30,30
1650868577187,MATH 103A,B01,083779,Staff,0,15,30,30
1650868577187,MATH 103A,B02,083780,Staff,0,14,30,30
1650868583211,MATH 105,A01,085443,Staff,0,23,30,30
1650868589239,MATH 109,A01,083213,Anzaldo; Leesa B,0,7,30,30
1650868589239,MATH 109,A02,083214,Anzaldo; Leesa B,0,7,30,30
1650868589239,MATH 109,B01,083215,Anzaldo; Leesa B,0,8,30,30
1650868589239,MATH 109,B02,083216,Anzaldo; Leesa B,0,7,30,30
1650868595263,MATH 142A,A01,083219,Chow; Bennett,0,14,30,30
1650868595263,MATH 142A,A02,083220,Chow; Bennett,0,15,30,30
1650868595263,MATH 142A,B01,083221,Chow; Bennett,0,16,30,30
1650868595263,MATH 142A,B02,083222,Chow; Bennett,0,14,30,30
1650868601287,MATH 193A,A01,083224,Staff,0,6,30,30
1650868601287,MATH 193A,A02,083225,Staff,0,7,30,30
1650868601287,MATH 193A,A03,083781,Staff,0,6,30,30
1650868601287,MATH 193A,A04,083782,Staff,0,7,30,30
1650868607308,MATH 197,001,091859,McAuley; Julian John,9998,0,9999,1
1650868613369,COGS 9,A01,083615,Staff,0,17,60,60
1650868619396,COGS 11,A01,083617,Boyle; Mary E. T.,15,0,40,25
1650868625423,COGS 13,A01,083071,Staff,0,38,40,40
1650868631444,COGS 14A,A01,092681,Staff,0,37,100,100
1650868637469,COGS 14B,A01,083073,Cheng; Tzu-Han,0,12,50,50
1650868643493,COGS 17,A01,092677,Staff,12,0,75,63
1650868649516,COGS 100,A01,083619,Staff,0,30,60,60
1650868655540,COGS 101A,A01,083621,Davis; Joshua Daniel,0,29,60,60
1650868661566,COGS 101B,A01,091572,Staff,0,3,60,60
1650868667603,COGS 101C,A01,083625,Delgado; Tania,14,0,30,16
1650868673630,COGS 107A,A01,083627,Boyle; Mary E. T.,0,16,60,60
1650868679653,COGS 118A,A01,083075,Staff,0,8,60,60
1650868685676,CSE 3,A50,083646,Miranda; Gregory Joseph,18,0,38,20
1650868685676,CSE 3,A51,083647,Miranda; Gregory Joseph,36,0,37,1
1650868691710,CSE 8A,A50,083650,Miranda; Gregory Joseph,0,29,40,40
1650868697742,CSE 11,A01,083080,Cao; Yingjun,0,97,40,40
1650868703766,CSE 12,A01,083652,Staff,0,21,100,100
1650868709807,CSE 15L,A01,083654,Staff,0,3,50,50
1650868709807,CSE 15L,A02,083655,Staff,0,3,50,50
1650868715833,CSE 20,A01,083657,Staff,48,0,80,32
1650868721858,CSE 30,A01,083084,Eldon; John,0,76,40,40
1650868727880,CSE 100,A01,083659,Cao; Yingjun,0,70,50,50
1650868733903,CSE 134B,A01,083661,Powell; Thomas Allan,0,38,65,65
1650868739926,CSE 140,A01,083663,Staff,0,12,75,75
1650868745950,CSE 140L,A01,083088,Eldon; John,0,20,75,75
1650868751975,CSE 175,A01,083665,Kumar; Rakesh,7,0,25,18
1650868757996,CSE 190,A00,092507,Dubnov; Shlomo,9,0,20,11
1650868764021,ECE 45,A01,083139,Staff,0,4,60,60
1650868770048,ECE 65,A50,083695,Staff,0,5,30,30
1650868776076,ECE 109,A01,091882,Touri; Behrouz,32,0,70,38
1650868782106,ECE 180,A00,083140,Abi Samra; Nicholas Camill,20,0,30,10
1650868782106,ECE 180,B00,083141,Abi Samra; Nicholas Camill,0,0,30,30
1650868788130,MATH 10A,A01,083735,Patchell; Gregory David,2,0,30,28
1650868788130,MATH 10A,A02,083736,Patchell; Gregory David,27,0,30,3
1650868788130,MATH 10A,A03,083737,Patchell; Gregory David,23,0,30,7
1650868794155,MATH 10B,A01,083207,Staff,0,9,30,30
1650868794155,MATH 10B,A02,083208,Staff,0,6,30,30
1650868794155,MATH 10B,B01,083739,Staff,10,0,30,20
1650868794155,MATH 10B,B02,083740,Staff,28,0,30,2
1650868800182,MATH 18,A01,083743,Staff,0,0,30,30
1650868800182,MATH 18,A02,083744,Staff,23,0,30,7
1650868800182,MATH 18,A03,083745,Staff,21,0,30,9
1650868800182,MATH 18,A04,083746,Staff,26,0,30,4
1650868800182,MATH 18,B01,083748,Staff,0,15,30,30
1650868800182,MATH 18,B02,083749,Staff,0,13,30,30
1650868800182,MATH 18,B03,083750,Staff,0,13,30,30
1650868800182,MATH 18,B04,083751,Staff,0,13,30,30
1650868806208,MATH 20A,A01,083754,Staff,19,0,40,21
1650868812238,MATH 20B,A01,083756,Staff,0,14,30,30
1650868812238,MATH 20B,A02,083757,Staff,0,11,30,30
1650868818265,MATH 20C,A01,083760,Staff,0,17,30,30
1650868818265,MATH 20C,A02,083761,Staff,0,16,30,30
1650868818265,MATH 20C,B01,083762,Staff,9,0,30,21
1650868818265,MATH 20C,B02,083763,Staff,28,0,30,2
1650868824287,MATH 20D,A01,083765,Staff,2,1,30,28
1650868824287,MATH 20D,A02,083766,Staff,6,0,30,24
1650868824287,MATH 20D,A03,083767,Staff,23,0,30,7
1650868830311,MATH 20E,A01,083771,Staff,2,0,30,28
1650868830311,MATH 20E,A02,083772,Staff,13,0,30,17
1650868830311,MATH 20E,B01,083773,Staff,0,0,30,30
1650868830311,MATH 20E,B02,083774,Staff,4,0,30,26
1650868836335,MATH 103A,A01,083777,Staff,0,17,30,30
1650868836335,MATH 103A,A02,083778,Staff,0,15,30,30
1650868836335,MATH 103A,B01,083779,Staff,0,15,30,30
1650868836335,MATH 103A,B02,083780,Staff,0,14,30,30
1650868842358,MATH 105,A01,085443,Staff,0,23,30,30
1650868848383,MATH 109,A01,083213,Anzaldo; Leesa B,0,7,30,30
1650868848383,MATH 109,A02,083214,Anzaldo; Leesa B,0,7,30,30
1650868848383,MATH 109,B01,083215,Anzaldo; Leesa B,0,8,30,30
1650868848383,MATH 109,B02,083216,Anzaldo; Leesa B,0,7,30,30
1650868854411,MATH 142A,A01,083219,Chow; Bennett,0,14,30,30
1650868854411,MATH 142A,A02,083220,Chow; Bennett,0,15,30,30
1650868854411,MATH 142A,B01,083221,Chow; Bennett,0,16,30,30
1650868854411,MATH 142A,B02,083222,Chow; Bennett,0,14,30,30
1650868860435,MATH 193A,A01,083224,Staff,0,6,30,30
1650868860435,MATH 193A,A02,083225,Staff,0,7,30,30
1650868860435,MATH 193A,A03,083781,Staff,0,6,30,30
1650868860435,MATH 193A,A04,083782,Staff,0,7,30,30
1650868866458,MATH 197,001,091859,McAuley; Julian John,9998,0,9999,1
1650868872506,COGS 9,A01,083615,Staff,0,17,60,60
1650868878534,COGS 11,A01,083617,Boyle; Mary E. T.,15,0,40,25
1650868884558,COGS 13,A01,083071,Staff,0,38,40,40
1650868890596,COGS 14A,A01,092681,Staff,0,37,100,100
1650868896618,COGS 14B,A01,083073,Cheng; Tzu-Han,0,12,50,50
1650868902644,COGS 17,A01,092677,Staff,12,0,75,63
1650868908667,COGS 100,A01,083619,Staff,0,30,60,60
1650868914690,COGS 101A,A01,083621,Davis; Joshua Daniel,0,29,60,60
1650868920721,COGS 101B,A01,091572,Staff,0,3,60,60
1650868926743,COGS 101C,A01,083625,Delgado; Tania,14,0,30,16
1650868932770,COGS 107A,A01,083627,Boyle; Mary E. T.,0,16,60,60
1650868938794,COGS 118A,A01,083075,Staff,0,8,60,60
1650868944834,CSE 3,A50,083646,Miranda; Gregory Joseph,18,0,38,20
1650868944834,CSE 3,A51,083647,Miranda; Gregory Joseph,36,0,37,1
1650868950861,CSE 8A,A50,083650,Miranda; Gregory Joseph,0,29,40,40
1650868956885,CSE 11,A01,083080,Cao; Yingjun,0,97,40,40
1650868962912,CSE 12,A01,083652,Staff,0,21,100,100
1650868968935,CSE 15L,A01,083654,Staff,0,3,50,50
1650868968935,CSE 15L,A02,083655,Staff,0,3,50,50
1650868974959,CSE 20,A01,083657,Staff,48,0,80,32
1650868980982,CSE 30,A01,083084,Eldon; John,0,76,40,40
1650868987007,CSE 100,A01,083659,Cao; Yingjun,0,70,50,50
1650868993032,CSE 134B,A01,083661,Powell; Thomas Allan,0,38,65,65
1650868999055,CSE 140,A01,083663,Staff,0,12,75,75
1650869005078,CSE 140L,A01,083088,Eldon; John,0,20,75,75
1650869011104,CSE 175,A01,083665,Kumar; Rakesh,7,0,25,18
1650869017127,CSE 190,A00,092507,Dubnov; Shlomo,9,0,20,11
1650869023153,ECE 45,A01,083139,Staff,0,4,60,60
1650869029177,ECE 65,A50,083695,Staff,0,5,30,30
1650869035206,ECE 109,A01,091882,Touri; Behrouz,32,0,70,38
1650869041231,ECE 180,A00,083140,Abi Samra; Nicholas Camill,20,0,30,10
1650869041231,ECE 180,B00,083141,Abi Samra; Nicholas Camill,0,0,30,30
1650869047252,MATH 10A,A01,083735,Patchell; Gregory David,2,0,30,28
1650869047252,MATH 10A,A02,083736,Patchell; Gregory David,27,0,30,3
1650869047252,MATH 10A,A03,083737,Patchell; Gregory David,23,0,30,7
1650869053273,MATH 10B,A01,083207,Staff,0,9,30,30
1650869053273,MATH 10B,A02,083208,Staff,0,6,30,30
1650869053273,MATH 10B,B01,083739,Staff,10,0,30,20
1650869053273,MATH 10B,B02,083740,Staff,28,0,30,2
1650869059299,MATH 18,A01,083743,Staff,0,0,30,30
1650869059299,MATH 18,A02,083744,Staff,23,0,30,7
1650869059299,MATH 18,A03,083745,Staff,21,0,30,9
1650869059299,MATH 18,A04,083746,Staff,26,0,30,4
1650869059299,MATH 18,B01,083748,Staff,0,15,30,30
1650869059299,MATH 18,B02,083749,Staff,0,13,30,30
1650869059299,MATH 18,B03,083750,Staff,0,13,30,30
1650869059299,MATH 18,B04,083751,Staff,0,13,30,30
1650869065325,MATH 20A,A01,083754,Staff,19,0,40,21
1650869071347,MATH 20B,A01,083756,Staff,0,14,30,30
1650869071347,MATH 20B,A02,083757,Staff,0,11,30,30
1650869077474,MATH 20C,A01,083760,Staff,0,17,30,30
1650869077474,MATH 20C,A02,083761,Staff,0,16,30,30
1650869077474,MATH 20C,B01,083762,Staff,9,0,30,21
1650869077474,MATH 20C,B02,083763,Staff,28,0,30,2
1650869083496,MATH 20D,A01,083765,Staff,2,1,30,28
1650869083496,MATH 20D,A02,083766,Staff,6,0,30,24
1650869083496,MATH 20D,A03,083767,Staff,23,0,30,7
1650869089533,MATH 20E,A01,083771,Staff,2,0,30,28
1650869089533,MATH 20E,A02,083772,Staff,13,0,30,17
1650869089533,MATH 20E,B01,083773,Staff,0,0,30,30
1650869089533,MATH 20E,B02,083774,Staff,4,0,30,26
1650869095558,MATH 103A,A01,083777,Staff,0,17,30,30
1650869095558,MATH 103A,A02,083778,Staff,0,15,30,30
1650869095558,MATH 103A,B01,083779,Staff,0,15,30,30
1650869095558,MATH 103A,B02,083780,Staff,0,14,30,30
1650869101585,MATH 105,A01,085443,Staff,0,23,30,30
1650869107607,MATH 109,A01,083213,Anzaldo; Leesa B,0,7,30,30
1650869107607,MATH 109,A02,083214,Anzaldo; Leesa B,0,7,30,30
1650869107607,MATH 109,B01,083215,Anzaldo; Leesa B,0,8,30,30
1650869107607,MATH 109,B02,083216,Anzaldo; Leesa B,0,7,30,30
1650869113633,MATH 142A,A01,083219,Chow; Bennett,0,14,30,30
1650869113633,MATH 142A,A02,083220,Chow; Bennett,0,15,30,30
1650869113633,MATH 142A,B01,083221,Chow; Bennett,0,16,30,30
1650869113633,MATH 142A,B02,083222,Chow; Bennett,0,14,30,30
1650869119667,MATH 193A,A01,083224,Staff,0,6,30,30
1650869119667,MATH 193A,A02,083225,Staff,0,7,30,30
1650869119667,MATH 193A,A03,083781,Staff,0,6,30,30
1650869119667,MATH 193A,A04,083782,Staff,0,7,30,30
1650869125690,MATH 197,001,091859,McAuley; Julian John,9998,0,9999,1
1650869131746,COGS 9,A01,083615,Staff,0,17,60,60
1650869137770,COGS 11,A01,083617,Boyle; Mary E. T.,15,0,40,25
1650869143792,COGS 13,A01,083071,Staff,0,38,40,40
1650869149814,COGS 14A,A01,092681,Staff,0,37,100,100
1650869155839,COGS 14B,A01,083073,Cheng; Tzu-Han,0,12,50,50
1650869161865,COGS 17,A01,092677,Staff,12,0,75,63
1650869167890,COGS 100,A01,083619,Staff,0,30,60,60
1650869173911,COGS 101A,A01,083621,Davis; Joshua Daniel,0,29,60,60
1650869179937,COGS 101B,A01,091572,Staff,0,3,60,60
1650869185961,COGS 101C,A01,083625,Delgado; Tania,14,0,30,16
1650869191984,COGS 107A,A01,083627,Boyle; Mary E. T.,0,16,60,60
1650869198007,COGS 118A,A01,083075,Staff,0,8,60,60
1650869204033,CSE 3,A50,083646,Miranda; Gregory Joseph,18,0,38,20
1650869204033,CSE 3,A51,083647,Miranda; Gregory Joseph,36,0,37,1
1650869210062,CSE 8A,A50,083650,Miranda; Gregory Joseph,0,29,40,40
1650869216084,CSE 11,A01,083080,Cao; Yingjun,0,97,40,40
1650869222107,CSE 12,A01,083652,Staff,0,21,100,100
1650869228153,CSE 15L,A01,083654,Staff,0,3,50,50
1650869228153,CSE 15L,A02,083655,Staff,0,3,50,50
1650869234175,CSE 20,A01,083657,Staff,48,0,80,32
1650869240204,CSE 30,A01,083084,Eldon; John,0,76,40,40
1650869246225,CSE 100,A01,083659,Cao; Yingjun,0,70,50,50
1650869252251,CSE 134B,A01,083661,Powell; Thomas Allan,0,38,65,65
1650869258273,CSE 140,A01,083663,Staff,0,12,75,75
1650869264303,CSE 140L,A01,083088,Eldon; John,0,20,75,75
1650869270330,CSE 175,A01,083665,Kumar; Rakesh,7,0,25,18
1650869276371,CSE 190,A00,092507,Dubnov; Shlomo,9,0,20,11
1650869282394,ECE 45,A01,083139,Staff,0,4,60,60
1650869288425,ECE 65,A50,083695,Staff,0,5,30,30
1650869294448,ECE 109,A01,091882,Touri; Behrouz,32,0,70,38
1650869300470,ECE 180,A00,083140,Abi Samra; Nicholas Camill,20,0,30,10
1650869300470,ECE 180,B00,083141,Abi Samra; Nicholas Camill,0,0,30,30
1650869306493,MATH 10A,A01,083735,Patchell; Gregory David,2,0,30,28
1650869306493,MATH 10A,A02,083736,Patchell; Gregory David,27,0,30,3
1650869306493,MATH 10A,A03,083737,Patchell; Gregory David,23,0,30,7
1650869312519,MATH 10B,A01,083207,Staff,0,9,30,30
1650869312519,MATH 10B,A02,083208,Staff,0,6,30,30
1650869312519,MATH 10B,B01,083739,Staff,10,0,30,20
1650869312519,MATH 10B,B02,083740,Staff,28,0,30,2
1650869318548,MATH 18,A01,083743,Staff,0,0,30,30
1650869318548,MATH 18,A02,083744,Staff,23,0,30,7
1650869318548,MATH 18,A03,083745,Staff,21,0,30,9
1650869318548,MATH 18,A04,083746,Staff,26,0,30,4
1650869318548,MATH 18,B01,083748,Staff,0,15,30,30
1650869318548,MATH 18,B02,083749,Staff,0,13,30,30
1650869318548,MATH 18,B03,083750,Staff,0,13,30,30
1650869318548,MATH 18,B04,083751,Staff,0,13,30,30
1650869324570,MATH 20A,A01,083754,Staff,19,0,40,21
1650869330601,MATH 20B,A01,083756,Staff,0,14,30,30
1650869330601,MATH 20B,A02,083757,Staff,0,11,30,30
1650869336631,MATH 20C,A01,083760,Staff,0,17,30,30
1650869336631,MATH 20C,A02,083761,Staff,0,16,30,30
1650869336631,MATH 20C,B01,083762,Staff,9,0,30,21
1650869336631,MATH 20C,B02,083763,Staff,28,0,30,2
1650869342658,MATH 20D,A01,083765,Staff,2,1,30,28
1650869342658,MATH 20D,A02,083766,Staff,6,0,30,24
1650869342658,MATH 20D,A03,083767,Staff,23,0,30,7
1650869348689,MATH 20E,A01,083771,Staff,2,0,30,28
1650869348689,MATH 20E,A02,083772,Staff,13,0,30,17
1650869348689,MATH 20E,B01,083773,Staff,0,0,30,30
1650869348689,MATH 20E,B02,083774,Staff,4,0,30,26
1650869354715,MATH 103A,A01,083777,Staff,0,17,30,30
1650869354715,MATH 103A,A02,083778,Staff,0,15,30,30
1650869354715,MATH 103A,B01,083779,Staff,0,15,30,30
1650869354715,MATH 103A,B02,083780,Staff,0,14,30,30
1650869360744,MATH 105,A01,085443,Staff,0,23,30,30
1650869366768,MATH 109,A01,083213,Anzaldo; Leesa B,0,7,30,30
1650869366768,MATH 109,A02,083214,Anzaldo; Leesa B,0,7,30,30
1650869366768,MATH 109,B01,083215,Anzaldo; Leesa B,0,8,30,30
1650869366768,MATH 109,B02,083216,Anzaldo; Leesa B,0,7,30,30
1650869372794,MATH 142A,A01,083219,Chow; Bennett,0,14,30,30
1650869372794,MATH 142A,A02,083220,Chow; Bennett,0,15,30,30
1650869372794,MATH 142A,B01,083221,Chow; Bennett,0,16,30,30
1650869372794,MATH 142A,B02,083222,Chow; Bennett,0,14,30,30
1650869378824,MATH 193A,A01,083224,Staff,0,6,30,30
1650869378824,MATH 193A,A02,083225,Staff,0,7,30,30
1650869378824,MATH 193A,A03,083781,Staff,0,6,30,30
1650869378824,MATH 193A,A04,083782,Staff,0,7,30,30
1650869384846,MATH 197,001,091859,McAuley; Julian John,9998,0,9999,1
1650869390895,COGS 9,A01,083615,Staff,0,17,60,60
1650869396919,COGS 11,A01,083617,Boyle; Mary E. T.,15,0,40,25
1650869403006,COGS 13,A01,083071,Staff,0,38,40,40
1650869409029,COGS 14A,A01,092681,Staff,0,37,100,100
1650869415057,COGS 14B,A01,083073,Cheng; Tzu-Han,0,12,50,50
1650869421089,COGS 17,A01,092677,Staff,12,0,75,63
1650869427114,COGS 100,A01,083619,Staff,0,30,60,60
1650869433153,COGS 101A,A01,083621,Davis; Joshua Daniel,0,29,60,60
1650869439176,COGS 101B,A01,091572,Staff,0,3,60,60
1650869445200,COGS 101C,A01,083625,Delgado; Tania,14,0,30,16
1650869451223,COGS 107A,A01,083627,Boyle; Mary E. T.,0,16,60,60
1650869457252,COGS 118A,A01,083075,Staff,0,8,60,60
1650869463280,CSE 3,A50,083646,Miranda; Gregory Joseph,18,0,38,20
1650869463280,CSE 3,A51,083647,Miranda; Gregory Joseph,36,0,37,1
1650869469308,CSE 8A,A50,083650,Miranda; Gregory Joseph,0,29,40,40
1650869475335,CSE 11,A01,083080,Cao; Yingjun,0,97,40,40
1650869481358,CSE 12,A01,083652,Staff,0,21,100,100
1650869487383,CSE 15L,A01,083654,Staff,0,3,50,50
1650869487383,CSE 15L,A02,083655,Staff,0,3,50,50
1650869493405,CSE 20,A01,083657,Staff,48,0,80,32
1650869499427,CSE 30,A01,083084,Eldon; John,0,76,40,40
1650869505453,CSE 100,A01,083659,Cao; Yingjun,0,70,50,50
1650869511476,CSE 134B,A01,083661,Powell; Thomas Allan,0,38,65,65
1650869517500,CSE 140,A01,083663,Staff,0,12,75,75
1650869523522,CSE 140L,A01,083088,Eldon; John,0,20,75,75
1650869529551,CSE 175,A01,083665,Kumar; Rakesh,7,0,25,18
1650869535572,CSE 190,A00,092507,Dubnov; Shlomo,9,0,20,11
1650869541594,ECE 45,A01,083139,Staff,0,4,60,60
1650869547616,ECE 65,A50,083695,Staff,0,5,30,30
1650869553642,ECE 109,A01,091882,Touri; Behrouz,32,0,70,38
1650869559668,ECE 180,A00,083140,Abi Samra; Nicholas Camill,20,0,30,10
1650869559668,ECE 180,B00,083141,Abi Samra; Nicholas Camill,0,0,30,30
1650869565692,MATH 10A,A01,083735,Patchell; Gregory David,2,0,30,28
1650869565692,MATH 10A,A02,083736,Patchell; Gregory David,27,0,30,3
1650869565692,MATH 10A,A03,083737,Patchell; Gregory David,23,0,30,7
1650869571715,MATH 10B,A01,083207,Staff,0,9,30,30
1650869571715,MATH 10B,A02,083208,Staff,0,6,30,30
1650869571715,MATH 10B,B01,083739,Staff,10,0,30,20
1650869571715,MATH 10B,B02,083740,Staff,28,0,30,2
1650869577744,MATH 18,A01,083743,Staff,0,0,30,30
1650869577744,MATH 18,A02,083744,Staff,23,0,30,7
1650869577744,MATH 18,A03,083745,Staff,21,0,30,9
1650869577744,MATH 18,A04,083746,Staff,26,0,30,4
1650869577744,MATH 18,B01,083748,Staff,0,15,30,30
1650869577744,MATH 18,B02,083749,Staff,0,13,30,30
1650869577744,MATH 18,B03,083750,Staff,0,13,30,30
1650869577744,MATH 18,B04,083751,Staff,0,13,30,30
1650869583773,MATH 20A,A01,083754,Staff,19,0,40,21
1650869589798,MATH 20B,A01,083756,Staff,0,14,30,30
1650869589798,MATH 20B,A02,083757,Staff,0,11,30,30
1650869595825,MATH 20C,A01,083760,Staff,0,17,30,30
1650869595825,MATH 20C,A02,083761,Staff,0,16,30,30
1650869595825,MATH 20C,B01,083762,Staff,9,0,30,21
1650869595825,MATH 20C,B02,083763,Staff,28,0,30,2
1650869601851,MATH 20D,A01,083765,Staff,2,1,30,28
1650869601851,MATH 20D,A02,083766,Staff,6,0,30,24
1650869601851,MATH 20D,A03,083767,Staff,23,0,30,7
1650869607873,MATH 20E,A01,083771,Staff,2,0,30,28
1650869607873,MATH 20E,A02,083772,Staff,13,0,30,17
1650869607873,MATH 20E,B01,083773,Staff,0,0,30,30
1650869607873,MATH 20E,B02,083774,Staff,4,0,30,26
1650869613896,MATH 103A,A01,083777,Staff,0,17,30,30
1650869613896,MATH 103A,A02,083778,Staff,0,15,30,30
1650869613896,MATH 103A,B01,083779,Staff,0,15,30,30
1650869613896,MATH 103A,B02,083780,Staff,0,14,30,30
1650869619940,MATH 105,A01,085443,Staff,0,23,30,30
1650869625973,MATH 109,A01,083213,Anzaldo; Leesa B,0,7,30,30
1650869625973,MATH 109,A02,083214,Anzaldo; Leesa B,0,7,30,30
1650869625973,MATH 109,B01,083215,Anzaldo; Leesa B,0,8,30,30
1650869625973,MATH 109,B02,083216,Anzaldo; Leesa B,0,7,30,30
1650869631996,MATH 142A,A01,083219,Chow; Bennett,0,14,30,30
1650869631996,MATH 142A,A02,083220,Chow; Bennett,0,15,30,30
1650869631996,MATH 142A,B01,083221,Chow; Bennett,0,16,30,30
1650869631996,MATH 142A,B02,083222,Chow; Bennett,0,14,30,30
1650869638028,MATH 193A,A01,083224,Staff,0,6,30,30
1650869638028,MATH 193A,A02,083225,Staff,0,7,30,30
1650869638028,MATH 193A,A03,083781,Staff,0,6,30,30
1650869638028,MATH 193A,A04,083782,Staff,0,7,30,30
1650869644051,MATH 197,001,091859,McAuley; Julian John,9998,0,9999,1
1650869650101,COGS 9,A01,083615,Staff,0,17,60,60
1650869656124,COGS 11,A01,083617,Boyle; Mary E. T.,15,0,40,25
1650869662151,COGS 13,A01,083071,Staff,0,38,40,40
1650869668278,COGS 14A,A01,092681,Staff,0,37,100,100
1650869674308,COGS 14B,A01,083073,Cheng; Tzu-Han,0,12,50,50
1650869680334,COGS 17,A01,092677,Staff,12,0,75,63
1650869686363,COGS 100,A01,083619,Staff,0,30,60,60
1650869692386,COGS 101A,A01,083621,Davis; Joshua Daniel,0,29,60,60
1650869698410,COGS 101B,A01,091572,Staff,0,3,60,60
1650869704438,COGS 101C,A01,083625,Delgado; Tania,14,0,30,16
1650869710478,COGS 107A,A01,083627,Boyle; Mary E. T.,0,16,60,60
1650869716502,COGS 118A,A01,083075,Staff,0,8,60,60
1650869722530,CSE 3,A50,083646,Miranda; Gregory Joseph,18,0,38,20
1650869722530,CSE 3,A51,083647,Miranda; Gregory Joseph,36,0,37,1
1650869728553,CSE 8A,A50,083650,Miranda; Gregory Joseph,0,29,40,40
1650869734579,CSE 11,A01,083080,Cao; Yingjun,0,97,40,40
1650869740605,CSE 12,A01,083652,Staff,0,21,100,100
1650869746632,CSE 15L,A01,083654,Staff,0,3,50,50
1650869746632,CSE 15L,A02,083655,Staff,0,3,50,50
1650869767577,CSE 20,A01,083657,Staff,48,0,80,32
1650869773599,CSE 30,A01,083084,Eldon; John,0,76,40,40
1650869779622,CSE 100,A01,083659,Cao; Yingjun,0,70,50,50
1650869785646,CSE 134B,A01,083661,Powell; Thomas Allan,0,38,65,65
1650869791667,CSE 140,A01,083663,Staff,0,12,75,75
1650869797689,CSE 140L,A01,083088,Eldon; John,0,20,75,75
1650869803716,CSE 175,A01,083665,Kumar; Rakesh,7,0,25,18
1650869809751,CSE 190,A00,092507,Dubnov; Shlomo,9,0,20,11
1650869815773,ECE 45,A01,083139,Staff,0,4,60,60
1650869821802,ECE 65,A50,083695,Staff,0,5,30,30
1650869827828,ECE 109,A01,091882,Touri; Behrouz,32,0,70,38
1650869833857,ECE 180,A00,083140,Abi Samra; Nicholas Camill,20,0,30,10
1650869833857,ECE 180,B00,083141,Abi Samra; Nicholas Camill,0,0,30,30
1650869839883,MATH 10A,A01,083735,Patchell; Gregory David,2,0,30,28
1650869839883,MATH 10A,A02,083736,Patchell; Gregory David,27,0,30,3
1650869839883,MATH 10A,A03,083737,Patchell; Gregory David,23,0,30,7
1650869845907,MATH 10B,A01,083207,Staff,0,9,30,30
1650869845907,MATH 10B,A02,083208,Staff,0,6,30,30
1650869845907,MATH 10B,B01,083739,Staff,10,0,30,20
1650869845907,MATH 10B,B02,083740,Staff,28,0,30,2
1650869851947,MATH 18,A01,083743,Staff,0,0,30,30
1650869851947,MATH 18,A02,083744,Staff,23,0,30,7
1650869851947,MATH 18,A03,083745,Staff,21,0,30,9
1650869851947,MATH 18,A04,083746,Staff,26,0,30,4
1650869851947,MATH 18,B01,083748,Staff,0,15,30,30
1650869851947,MATH 18,B02,083749,Staff,0,13,30,30
1650869851947,MATH 18,B03,083750,Staff,0,13,30,30
1650869851947,MATH 18,B04,083751,Staff,0,13,30,30
1650869857970,MATH 20A,A01,083754,Staff,19,0,40,21
1650869863997,MATH 20B,A01,083756,Staff,0,14,30,30
1650869863997,MATH 20B,A02,083757,Staff,0,11,30,30
1650869870021,MATH 20C,A01,083760,Staff,0,17,30,30
1650869870021,MATH 20C,A02,083761,Staff,0,16,30,30
1650869870021,MATH 20C,B01,083762,Staff,9,0,30,21
1650869870021,MATH 20C,B02,083763,Staff,28,0,30,2
1650869876059,MATH 20D,A01,083765,Staff,2,1,30,28
1650869876059,MATH 20D,A02,083766,Staff,6,0,30,24
1650869876059,MATH 20D,A03,083767,Staff,23,0,30,7
1650869882087,MATH 20E,A01,083771,Staff,2,0,30,28
1650869882087,MATH 20E,A02,083772,Staff,13,0,30,17
1650869882087,MATH 20E,B01,083773,Staff,0,0,30,30
1650869882087,MATH 20E,B02,083774,Staff,4,0,30,26
1650869888129,MATH 103A,A01,083777,Staff,0,17,30,30
1650869888129,MATH 103A,A02,083778,Staff,0,15,30,30
1650869888129,MATH 103A,B01,083779,Staff,0,15,30,30
1650869888129,MATH 103A,B02,083780,Staff,0,14,30,30
1650869894155,MATH 105,A01,085443,Staff,0,23,30,30
1650869900194,MATH 109,A01,083213,Anzaldo; Leesa B,0,7,30,30
1650869900194,MATH 109,A02,083214,Anzaldo; Leesa B,0,7,30,30
1650869900194,MATH 109,B01,083215,Anzaldo; Leesa B,0,8,30,30
1650869900194,MATH 109,B02,083216,Anzaldo; Leesa B,0,7,30,30
1650869906220,MATH 142A,A01,083219,Chow; Bennett,0,14,30,30
1650869906220,MATH 142A,A02,083220,Chow; Bennett,0,15,30,30
1650869906220,MATH 142A,B01,083221,Chow; Bennett,0,16,30,30
1650869906220,MATH 142A,B02,083222,Chow; Bennett,0,14,30,30
1650869912245,MATH 193A,A01,083224,Staff,0,6,30,30
1650869912245,MATH 193A,A02,083225,Staff,0,7,30,30
1650869912245,MATH 193A,A03,083781,Staff,0,6,30,30
1650869912245,MATH 193A,A04,083782,Staff,0,7,30,30
1650869918284,MATH 197,001,091859,McAuley; Julian John,9998,0,9999,1
1650869924334,COGS 9,A01,083615,Staff,0,17,60,60
1650869930360,COGS 11,A01,083617,Boyle; Mary E. T.,15,0,40,25
1650869936384,COGS 13,A01,083071,Staff,0,38,40,40
1650869942409,COGS 14A,A01,092681,Staff,0,37,100,100
1650869948441,COGS 14B,A01,083073,Cheng; Tzu-Han,0,12,50,50
1650869954463,COGS 17,A01,092677,Staff,12,0,75,63
1650869960501,COGS 100,A01,083619,Staff,0,30,60,60
1650869966525,COGS 101A,A01,083621,Davis; Joshua Daniel,0,29,60,60
1650869972546,COGS 101B,A01,091572,Staff,0,3,60,60
1650869978572,COGS 101C,A01,083625,Delgado; Tania,14,0,30,16
1650869984600,COGS 107A,A01,083627,Boyle; Mary E. T.,0,16,60,60
1650869990631,COGS 118A,A01,083075,Staff,0,8,60,60
1650869996672,CSE 3,A50,083646,Miranda; Gregory Joseph,18,0,38,20
1650869996672,CSE 3,A51,083647,Miranda; Gregory Joseph,36,0,37,1
1650870002696,CSE 8A,A50,083650,Miranda; Gregory Joseph,0,29,40,40
1650870008724,CSE 11,A01,083080,Cao; Yingjun,0,97,40,40
1650870014757,CSE 12,A01,083652,Staff,0,21,100,100
1650870020793,CSE 15L,A01,083654,Staff,0,3,50,50
1650870020793,CSE 15L,A02,083655,Staff,0,3,50,50
1650870026815,CSE 20,A01,083657,Staff,48,0,80,32
1650870032838,CSE 30,A01,083084,Eldon; John,0,76,40,40
1650870038862,CSE 100,A01,083659,Cao; Yingjun,0,70,50,50
1650870044893,CSE 134B,A01,083661,Powell; Thomas Allan,0,38,65,65
1650870050918,CSE 140,A01,083663,Staff,0,12,75,75
1650870056943,CSE 140L,A01,083088,Eldon; John,0,20,75,75
1650870062967,CSE 175,A01,083665,Kumar; Rakesh,7,0,25,18
1650870068991,CSE 190,A00,092507,Dubnov; Shlomo,9,0,20,11
1650870075015,ECE 45,A01,083139,Staff,0,4,60,60
1650870081053,ECE 65,A50,083695,Staff,0,5,30,30
1650870087088,ECE 109,A01,091882,Touri; Behrouz,32,0,70,38
1650870093112,ECE 180,A00,083140,Abi Samra; Nicholas Camill,20,0,30,10
1650870093112,ECE 180,B00,083141,Abi Samra; Nicholas Camill,0,0,30,30
1650870099143,MATH 10A,A01,083735,Patchell; Gregory David,2,0,30,28
1650870099143,MATH 10A,A02,083736,Patchell; Gregory David,27,0,30,3
1650870099143,MATH 10A,A03,083737,Patchell; Gregory David,23,0,30,7
1650870105167,MATH 10B,A01,083207,Staff,0,9,30,30
1650870105167,MATH 10B,A02,083208,Staff,0,6,30,30
1650870105167,MATH 10B,B01,083739,Staff,10,0,30,20
1650870105167,MATH 10B,B02,083740,Staff,28,0,30,2
1650870111206,MATH 18,A01,083743,Staff,0,0,30,30
1650870111206,MATH 18,A02,083744,Staff,23,0,30,7
1650870111206,MATH 18,A03,083745,Staff,21,0,30,9
1650870111206,MATH 18,A04,083746,Staff,26,0,30,4
1650870111206,MATH 18,B01,083748,Staff,0,15,30,30
1650870111206,MATH 18,B02,083749,Staff,0,13,30,30
1650870111206,MATH 18,B03,083750,Staff,0,13,30,30
1650870111206,MATH 18,B04,083751,Staff,0,13,30,30
1650870117236,MATH 20A,A01,083754,Staff,19,0,40,21
1650870123260,MATH 20B,A01,083756,Staff,0,14,30,30
1650870123260,MATH 20B,A02,083757,Staff,0,11,30,30
1650870129285,MATH 20C,A01,083760,Staff,0,17,30,30
1650870129285,MATH 20C,A02,083761,Staff,0,16,30,30
1650870129285,MATH 20C,B01,083762,Staff,9,0,30,21
1650870129285,MATH 20C,B02,083763,Staff,28,0,30,2
1650870135307,MATH 20D,A01,083765,Staff,2,1,30,28
1650870135307,MATH 20D,A02,083766,Staff,6,0,30,24
1650870135307,MATH 20D,A03,083767,Staff,23,0,30,7
1650870141335,MATH 20E,A01,083771,Staff,2,0,30,28
1650870141335,MATH 20E,A02,083772,Staff,13,0,30,17
1650870141335,MATH 20E,B01,083773,Staff,0,0,30,30
1650870141335,MATH 20E,B02,083774,Staff,4,0,30,26
1650870147359,MATH 103A,A01,083777,Staff,0,17,30,30
1650870147359,MATH 103A,A02,083778,Staff,0,15,30,30
1650870147359,MATH 103A,B01,083779,Staff,0,15,30,30
1650870147359,MATH 103A,B02,083780,Staff,0,14,30,30
1650870153388,MATH 105,A01,085443,Staff,0,23,30,30
1650870159419,MATH 109,A01,083213,Anzaldo; Leesa B,0,7,30,30
1650870159419,MATH 109,A02,083214,Anzaldo; Leesa B,0,7,30,30
1650870159419,MATH 109,B01,083215,Anzaldo; Leesa B,0,8,30,30
1650870159419,MATH 109,B02,083216,Anzaldo; Leesa B,0,7,30,30
1650870165448,MATH 142A,A01,083219,Chow; Bennett,0,14,30,30
1650870165448,MATH 142A,A02,083220,Chow; Bennett,0,15,30,30
1650870165448,MATH 142A,B01,083221,Chow; Bennett,0,16,30,30
1650870165448,MATH 142A,B02,083222,Chow; Bennett,0,14,30,30
1650870171485,MATH 193A,A01,083224,Staff,0,6,30,30
1650870171485,MATH 193A,A02,083225,Staff,0,7,30,30
1650870171485,MATH 193A,A03,083781,Staff,0,6,30,30
1650870171485,MATH 193A,A04,083782,Staff,0,7,30,30
1650870177509,MATH 197,001,091859,McAuley; Julian John,9998,0,9999,1
1650870183568,COGS 9,A01,083615,Staff,0,17,60,60
1650870189595,COGS 11,A01,083617,Boyle; Mary E. T.,15,0,40,25
1650870195622,COGS 13,A01,083071,Staff,0,38,40,40
1650870201647,COGS 14A,A01,092681,Staff,0,37,100,100
1650870207671,COGS 14B,A01,083073,Cheng; Tzu-Han,0,12,50,50
1650870213694,COGS 17,A01,092677,Staff,12,0,75,63
1650870219718,COGS 100,A01,083619,Staff,0,30,60,60
1650870225747,COGS 101A,A01,083621,Davis; Joshua Daniel,0,29,60,60
1650870231771,COGS 101B,A01,091572,Staff,0,3,60,60
1650870237801,COGS 101C,A01,083625,Delgado; Tania,14,0,30,16
1650870243824,COGS 107A,A01,083627,Boyle; Mary E. T.,0,16,60,60
1650870249847,COGS 118A,A01,083075,Staff,0,8,60,60
1650870255883,CSE 3,A50,083646,Miranda; Gregory Joseph,18,0,38,20
1650870255883,CSE 3,A51,083647,Miranda; Gregory Joseph,36,0,37,1
1650870261908,CSE 8A,A50,083650,Miranda; Gregory Joseph,0,29,40,40
1650870267932,CSE 11,A01,083080,Cao; Yingjun,0,97,40,40
1650870273961,CSE 12,A01,083652,Staff,0,21,100,100
1650870280058,CSE 15L,A01,083654,Staff,0,3,50,50
1650870280058,CSE 15L,A02,083655,Staff,0,3,50,50
1650870286082,CSE 20,A01,083657,Staff,48,0,80,32
1650870292107,CSE 30,A01,083084,Eldon; John,0,76,40,40
1650870298138,CSE 100,A01,083659,Cao; Yingjun,0,70,50,50
1650870304166,CSE 134B,A01,083661,Powell; Thomas Allan,0,38,65,65
1650870310199,CSE 140,A01,083663,Staff,0,12,75,75
1650870316226,CSE 140L,A01,083088,Eldon; John,0,20,75,75
1650870322248,CSE 175,A01,083665,Kumar; Rakesh,7,0,25,18
1650870328272,CSE 190,A00,092507,Dubnov; Shlomo,9,0,20,11
1650870334295,ECE 45,A01,083139,Staff,0,4,60,60
1650870340319,ECE 65,A50,083695,Staff,0,5,30,30
1650870346344,ECE 109,A01,091882,Touri; Behrouz,32,0,70,38
1650870352371,ECE 180,A00,083140,Abi Samra; Nicholas Camill,20,0,30,10
1650870352371,ECE 180,B00,083141,Abi Samra; Nicholas Camill,0,0,30,30
1650870358396,MATH 10A,A01,083735,Patchell; Gregory David,2,0,30,28
1650870358396,MATH 10A,A02,083736,Patchell; Gregory David,27,0,30,3
1650870358396,MATH 10A,A03,083737,Patchell; Gregory David,23,0,30,7
1650870364426,MATH 10B,A01,083207,Staff,0,9,30,30
1650870364426,MATH 10B,A02,083208,Staff,0,6,30,30
1650870364426,MATH 10B,B01,083739,Staff,10,0,30,20
1650870364426,MATH 10B,B02,083740,Staff,28,0,30,2
1650870370451,MATH 18,A01,083743,Staff,0,0,30,30
1650870370451,MATH 18,A02,083744,Staff,24,0,30,6
1650870370451,MATH 18,A03,083745,Staff,21,0,30,9
1650870370451,MATH 18,A04,083746,Staff,26,0,30,4
1650870370451,MATH 18,B01,083748,Staff,0,15,30,30
1650870370451,MATH 18,B02,083749,Staff,0,13,30,30
1650870370451,MATH 18,B03,083750,Staff,0,13,30,30
1650870370451,MATH 18,B04,083751,Staff,0,13,30,30
1650870376475,MATH 20A,A01,083754,Staff,19,0,40,21
1650870382499,MATH 20B,A01,083756,Staff,0,14,30,30
1650870382499,MATH 20B,A02,083757,Staff,0,11,30,30
1650870388522,MATH 20C,A01,083760,Staff,0,17,30,30
1650870388522,MATH 20C,A02,083761,Staff,1,16,30,29
1650870388522,MATH 20C,B01,083762,Staff,9,0,30,21
1650870388522,MATH 20C,B02,083763,Staff,28,0,30,2
1650870394549,MATH 20D,A01,083765,Staff,2,1,30,28
1650870394549,MATH 20D,A02,083766,Staff,6,0,30,24
1650870394549,MATH 20D,A03,083767,Staff,23,0,30,7
1650870400572,MATH 20E,A01,083771,Staff,2,0,30,28
1650870400572,MATH 20E,A02,083772,Staff,13,0,30,17
1650870400572,MATH 20E,B01,083773,Staff,0,0,30,30
1650870400572,MATH 20E,B02,083774,Staff,4,0,30,26
1650870406597,MATH 103A,A01,083777,Staff,0,17,30,30
1650870406597,MATH 103A,A02,083778,Staff,0,15,30,30
1650870406597,MATH 103A,B01,083779,Staff,0,15,30,30
1650870406597,MATH 103A,B02,083780,Staff,0,14,30,30
1650870412624,MATH 105,A01,085443,Staff,0,23,30,30
1650870418654,MATH 109,A01,083213,Anzaldo; Leesa B,0,7,30,30
1650870418654,MATH 109,A02,083214,Anzaldo; Leesa B,0,7,30,30
1650870418654,MATH 109,B01,083215,Anzaldo; Leesa B,0,8,30,30
1650870418654,MATH 109,B02,083216,Anzaldo; Leesa B,0,7,30,30
1650870424679,MATH 142A,A01,083219,Chow; Bennett,0,14,30,30
1650870424679,MATH 142A,A02,083220,Chow; Bennett,0,15,30,30
1650870424679,MATH 142A,B01,083221,Chow; Bennett,0,16,30,30
1650870424679,MATH 142A,B02,083222,Chow; Bennett,0,14,30,30
1650870430708,MATH 193A,A01,083224,Staff,0,6,30,30
1650870430708,MATH 193A,A02,083225,Staff,0,7,30,30
1650870430708,MATH 193A,A03,083781,Staff,0,6,30,30
1650870430708,MATH 193A,A04,083782,Staff,0,7,30,30
1650870436731,MATH 197,001,091859,McAuley; Julian John,9998,0,9999,1
1650870442787,COGS 9,A01,083615,Staff,0,17,60,60
1650870448811,COGS 11,A01,083617,Boyle; Mary E. T.,15,0,40,25
1650870454835,COGS 13,A01,083071,Staff,0,38,40,40
1650870460859,COGS 14A,A01,092681,Staff,0,37,100,100
1650870466884,COGS 14B,A01,083073,Cheng; Tzu-Han,0,12,50,50
1650870472910,COGS 17,A01,092677,Staff,12,0,75,63
1650870478933,COGS 100,A01,083619,Staff,0,30,60,60
1650870484956,COGS 101A,A01,083621,Davis; Joshua Daniel,0,29,60,60
1650870490979,COGS 101B,A01,091572,Staff,0,3,60,60
1650870497016,COGS 101C,A01,083625,Delgado; Tania,14,0,30,16
1650870503048,COGS 107A,A01,083627,Boyle; Mary E. T.,0,16,60,60
1650870509076,COGS 118A,A01,083075,Staff,0,8,60,60
1650870515105,CSE 3,A50,083646,Miranda; Gregory Joseph,18,0,38,20
1650870515105,CSE 3,A51,083647,Miranda; Gregory Joseph,36,0,37,1
1650870521133,CSE 8A,A50,083650,Miranda; Gregory Joseph,0,29,40,40
1650870527158,CSE 11,A01,083080,Cao; Yingjun,0,97,40,40
1650870533190,CSE 12,A01,083652,Staff,0,21,100,100
1650870539218,CSE 15L,A01,083654,Staff,0,3,50,50
1650870539218,CSE 15L,A02,083655,Staff,0,3,50,50
1650870545245,CSE 20,A01,083657,Staff,48,0,80,32
1650870551285,CSE 30,A01,083084,Eldon; John,0,76,40,40
1650870557308,CSE 100,A01,083659,Cao; Yingjun,0,70,50,50
1650870563331,CSE 134B,A01,083661,Powell; Thomas Allan,0,38,65,65
1650870569358,CSE 140,A01,083663,Staff,0,12,75,75
1650870575397,CSE 140L,A01,083088,Eldon; John,0,20,75,75
1650870581421,CSE 175,A01,083665,Kumar; Rakesh,7,0,25,18
1650870587442,CSE 190,A00,092507,Dubnov; Shlomo,9,0,20,11
1650870593469,ECE 45,A01,083139,Staff,0,4,60,60
1650870599493,ECE 65,A50,083695,Staff,0,5,30,30
1650870605517,ECE 109,A01,091882,Touri; Behrouz,32,0,70,38
1650870611544,ECE 180,A00,083140,Abi Samra; Nicholas Camill,20,0,30,10
1650870611544,ECE 180,B00,083141,Abi Samra; Nicholas Camill,0,0,30,30
1650870617571,MATH 10A,A01,083735,Patchell; Gregory David,2,0,30,28
1650870617571,MATH 10A,A02,083736,Patchell; Gregory David,27,0,30,3
1650870617571,MATH 10A,A03,083737,Patchell; Gregory David,23,0,30,7
1650870623600,MATH 10B,A01,083207,Staff,0,9,30,30
1650870623600,MATH 10B,A02,083208,Staff,0,6,30,30
1650870623600,MATH 10B,B01,083739,Staff,10,0,30,20
1650870623600,MATH 10B,B02,083740,Staff,28,0,30,2
1650870629624,MATH 18,A01,083743,Staff,0,0,30,30
1650870629624,MATH 18,A02,083744,Staff,24,0,30,6
1650870629624,MATH 18,A03,083745,Staff,21,0,30,9
1650870629624,MATH 18,A04,083746,Staff,26,0,30,4
1650870629624,MATH 18,B01,083748,Staff,0,15,30,30
1650870629624,MATH 18,B02,083749,Staff,0,13,30,30
1650870629624,MATH 18,B03,083750,Staff,0,13,30,30
1650870629624,MATH 18,B04,083751,Staff,0,13,30,30
1650870635647,MATH 20A,A01,083754,Staff,19,0,40,21
1650870641675,MATH 20B,A01,083756,Staff,0,14,30,30
1650870641675,MATH 20B,A02,083757,Staff,0,11,30,30
1650870647698,MATH 20C,A01,083760,Staff,0,17,30,30
1650870647698,MATH 20C,A02,083761,Staff,1,16,30,29
1650870647698,MATH 20C,B01,083762,Staff,9,0,30,21
1650870647698,MATH 20C,B02,083763,Staff,28,0,30,2
1650870653732,MATH 20D,A01,083765,Staff,2,1,30,28
1650870653732,MATH 20D,A02,083766,Staff,6,0,30,24
1650870653732,MATH 20D,A03,083767,Staff,23,0,30,7
1650870659757,MATH 20E,A01,083771,Staff,2,0,30,28
1650870659757,MATH 20E,A02,083772,Staff,13,0,30,17
1650870659757,MATH 20E,B01,083773,Staff,0,0,30,30
1650870659757,MATH 20E,B02,083774,Staff,4,0,30,26
1650870665782,MATH 103A,A01,083777,Staff,0,17,30,30
1650870665782,MATH 103A,A02,083778,Staff,0,15,30,30
1650870665782,MATH 103A,B01,083779,Staff,0,15,30,30
1650870665782,MATH 103A,B02,083780,Staff,0,14,30,30
1650870671806,MATH 105,A01,085443,Staff,0,23,30,30
1650870677834,MATH 109,A01,083213,Anzaldo; Leesa B,0,7,30,30
1650870677834,MATH 109,A02,083214,Anzaldo; Leesa B,0,7,30,30
1650870677834,MATH 109,B01,083215,Anzaldo; Leesa B,0,8,30,30
1650870677834,MATH 109,B02,083216,Anzaldo; Leesa B,0,7,30,30
1650870683861,MATH 142A,A01,083219,Chow; Bennett,0,14,30,30
1650870683861,MATH 142A,A02,083220,Chow; Bennett,0,15,30,30
1650870683861,MATH 142A,B01,083221,Chow; Bennett,0,16,30,30
1650870683861,MATH 142A,B02,083222,Chow; Bennett,0,14,30,30
1650870689905,MATH 193A,A01,083224,Staff,0,6,30,30
1650870689905,MATH 193A,A02,083225,Staff,0,7,30,30
1650870689905,MATH 193A,A03,083781,Staff,0,6,30,30
1650870689905,MATH 193A,A04,083782,Staff,0,7,30,30
1650870695928,MATH 197,001,091859,McAuley; Julian John,9998,0,9999,1
1650870701996,COGS 9,A01,083615,Staff,0,17,60,60
1650870708020,COGS 11,A01,083617,Boyle; Mary E. T.,15,0,40,25
1650870714049,COGS 13,A01,083071,Staff,0,38,40,40
1650870720077,COGS 14A,A01,092681,Staff,0,37,100,100
1650870726100,COGS 14B,A01,083073,Cheng; Tzu-Han,0,12,50,50
1650870732124,COGS 17,A01,092677,Staff,12,0,75,63
1650870738150,COGS 100,A01,083619,Staff,0,30,60,60
1650870744178,COGS 101A,A01,083621,Davis; Joshua Daniel,0,29,60,60
1650870750205,COGS 101B,A01,091572,Staff,0,3,60,60
1650870756229,COGS 101C,A01,083625,Delgado; Tania,14,0,30,16
1650870762257,COGS 107A,A01,083627,Boyle; Mary E. T.,0,16,60,60
1650870768283,COGS 118A,A01,083075,Staff,0,8,60,60
1650870774311,CSE 3,A50,083646,Miranda; Gregory Joseph,18,0,38,20
1650870774311,CSE 3,A51,083647,Miranda; Gregory Joseph,36,0,37,1
1650870780334,CSE 8A,A50,083650,Miranda; Gregory Joseph,0,29,40,40
1650870786362,CSE 11,A01,083080,Cao; Yingjun,0,97,40,40
1650870792386,CSE 12,A01,083652,Staff,0,21,100,100
1650870798409,CSE 15L,A01,083654,Staff,0,3,50,50
1650870798409,CSE 15L,A02,083655,Staff,0,3,50,50
1650870804433,CSE 20,A01,083657,Staff,48,0,80,32
1650870810457,CSE 30,A01,083084,Eldon; John,0,76,40,40
1650870816481,CSE 100,A01,083659,Cao; Yingjun,0,70,50,50
1650870822508,CSE 134B,A01,083661,Powell; Thomas Allan,0,38,65,65
1650870828531,CSE 140,A01,083663,Staff,0,12,75,75
1650870834565,CSE 140L,A01,083088,Eldon; John,0,20,75,75
1650870840588,CSE 175,A01,083665,Kumar; Rakesh,7,0,25,18
1650870846615,CSE 190,A00,092507,Dubnov; Shlomo,9,0,20,11
1650870852639,ECE 45,A01,083139,Staff,0,4,60,60
1650870858666,ECE 65,A50,083695,Staff,0,5,30,30
1650870864691,ECE 109,A01,091882,Touri; Behrouz,32,0,70,38
1650870870724,ECE 180,A00,083140,Abi Samra; Nicholas Camill,20,0,30,10
1650870870724,ECE 180,B00,083141,Abi Samra; Nicholas Camill,0,0,30,30
1650870876845,MATH 10A,A01,083735,Patchell; Gregory David,2,0,30,28
1650870876845,MATH 10A,A02,083736,Patchell; Gregory David,27,0,30,3
1650870876845,MATH 10A,A03,083737,Patchell; Gregory David,23,0,30,7
1650870882868,MATH 10B,A01,083207,Staff,0,9,30,30
1650870882868,MATH 10B,A02,083208,Staff,0,6,30,30
1650870882868,MATH 10B,B01,083739,Staff,10,0,30,20
1650870882868,MATH 10B,B02,083740,Staff,28,0,30,2
1650870888899,MATH 18,A01,083743,Staff,0,0,30,30
1650870888899,MATH 18,A02,083744,Staff,24,0,30,6
1650870888899,MATH 18,A03,083745,Staff,21,0,30,9
1650870888899,MATH 18,A04,083746,Staff,26,0,30,4
1650870888899,MATH 18,B01,083748,Staff,0,15,30,30
1650870888899,MATH 18,B02,083749,Staff,0,13,30,30
1650870888899,MATH 18,B03,083750,Staff,0,13,30,30
1650870888899,MATH 18,B04,083751,Staff,0,13,30,30
1650870894923,MATH 20A,A01,083754,Staff,19,0,40,21
1650870900946,MATH 20B,A01,083756,Staff,0,14,30,30
1650870900946,MATH 20B,A02,083757,Staff,0,11,30,30
1650870906971,MATH 20C,A01,083760,Staff,0,17,30,30
1650870906971,MATH 20C,A02,083761,Staff,1,16,30,29
1650870906971,MATH 20C,B01,083762,Staff,9,0,30,21
1650870906971,MATH 20C,B02,083763,Staff,28,0,30,2
1650870912992,MATH 20D,A01,083765,Staff,2,1,30,28
1650870912992,MATH 20D,A02,083766,Staff,6,0,30,24
1650870912992,MATH 20D,A03,083767,Staff,23,0,30,7
1650870919015,MATH 20E,A01,083771,Staff,2,0,30,28
1650870919015,MATH 20E,A02,083772,Staff,13,0,30,17
1650870919015,MATH 20E,B01,083773,Staff,0,0,30,30
1650870919015,MATH 20E,B02,083774,Staff,4,0,30,26
1650870925041,MATH 103A,A01,083777,Staff,0,17,30,30
1650870925041,MATH 103A,A02,083778,Staff,0,15,30,30
1650870925041,MATH 103A,B01,083779,Staff,0,15,30,30
1650870925041,MATH 103A,B02,083780,Staff,0,14,30,30
1650870931064,MATH 105,A01,085443,Staff,0,23,30,30
1650870937088,MATH 109,A01,083213,Anzaldo; Leesa B,0,7,30,30
1650870937088,MATH 109,A02,083214,Anzaldo; Leesa B,0,7,30,30
1650870937088,MATH 109,B01,083215,Anzaldo; Leesa B,0,8,30,30
1650870937088,MATH 109,B02,083216,Anzaldo; Leesa B,0,7,30,30
1650870943115,MATH 142A,A01,083219,Chow; Bennett,0,14,30,30
1650870943115,MATH 142A,A02,083220,Chow; Bennett,0,15,30,30
1650870943115,MATH 142A,B01,083221,Chow; Bennett,0,16,30,30
1650870943115,MATH 142A,B02,083222,Chow; Bennett,0,14,30,30
1650870949138,MATH 193A,A01,083224,Staff,0,6,30,30
1650870949138,MATH 193A,A02,083225,Staff,0,7,30,30
1650870949138,MATH 193A,A03,083781,Staff,0,6,30,30
1650870949138,MATH 193A,A04,083782,Staff,0,7,30,30
1650870955163,MATH 197,001,091859,McAuley; Julian John,9998,0,9999,1
1650870961215,COGS 9,A01,083615,Staff,0,17,60,60
1650870967238,COGS 11,A01,083617,Boyle; Mary E. T.,15,0,40,25
1650870973259,COGS 13,A01,083071,Staff,0,38,40,40
1650870979281,COGS 14A,A01,092681,Staff,0,37,100,100
1650870985309,COGS 14B,A01,083073,Cheng; Tzu-Han,0,12,50,50
1650870991346,COGS 17,A01,092677,Staff,12,0,75,63
1650870997371,COGS 100,A01,083619,Staff,0,30,60,60
1650871003410,COGS 101A,A01,083621,Davis; Joshua Daniel,0,29,60,60
1650871009432,COGS 101B,A01,091572,Staff,0,3,60,60
1650871015457,COGS 101C,A01,083625,Delgado; Tania,14,0,30,16
1650871021484,COGS 107A,A01,083627,Boyle; Mary E. T.,0,16,60,60
1650871027511,COGS 118A,A01,083075,Staff,0,8,60,60
1650871033536,CSE 3,A50,083646,Miranda; Gregory Joseph,18,0,38,20
1650871033536,CSE 3,A51,083647,Miranda; Gregory Joseph,36,0,37,1
1650871039564,CSE 8A,A50,083650,Miranda; Gregory Joseph,0,29,40,40
1650871045588,CSE 11,A01,083080,Cao; Yingjun,0,97,40,40
1650871051616,CSE 12,A01,083652,Staff,0,21,100,100
1650871057644,CSE 15L,A01,083654,Staff,0,3,50,50
1650871057644,CSE 15L,A02,083655,Staff,0,3,50,50
1650871063671,CSE 20,A01,083657,Staff,48,0,80,32
1650871069701,CSE 30,A01,083084,Eldon; John,0,76,40,40
1650871075725,CSE 100,A01,083659,Cao; Yingjun,0,70,50,50
1650871081749,CSE 134B,A01,083661,Powell; Thomas Allan,0,38,65,65
1650871087778,CSE 140,A01,083663,Staff,0,12,75,75
1650871093801,CSE 140L,A01,083088,Eldon; John,0,20,75,75
1650871099825,CSE 175,A01,083665,Kumar; Rakesh,7,0,25,18
1650871105856,CSE 190,A00,092507,Dubnov; Shlomo,9,0,20,11
1650871111882,ECE 45,A01,083139,Staff,0,4,60,60
1650871117908,ECE 65,A50,083695,Staff,0,5,30,30
1650871123932,ECE 109,A01,091882,Touri; Behrouz,32,0,70,38
1650871129958,ECE 180,A00,083140,Abi Samra; Nicholas Camill,20,0,30,10
1650871129958,ECE 180,B00,083141,Abi Samra; Nicholas Camill,0,0,30,30
1650871135982,MATH 10A,A01,083735,Patchell; Gregory David,2,0,30,28
1650871135982,MATH 10A,A02,083736,Patchell; Gregory David,27,0,30,3
1650871135982,MATH 10A,A03,083737,Patchell; Gregory David,23,0,30,7
1650871142008,MATH 10B,A01,083207,Staff,0,9,30,30
1650871142008,MATH 10B,A02,083208,Staff,0,6,30,30
1650871142008,MATH 10B,B01,083739,Staff,10,0,30,20
1650871142008,MATH 10B,B02,083740,Staff,28,0,30,2
1650871148044,MATH 18,A01,083743,Staff,0,0,30,30
1650871148044,MATH 18,A02,083744,Staff,24,0,30,6
1650871148044,MATH 18,A03,083745,Staff,21,0,30,9
1650871148044,MATH 18,A04,083746,Staff,26,0,30,4
1650871148044,MATH 18,B01,083748,Staff,0,15,30,30
1650871148044,MATH 18,B02,083749,Staff,0,13,30,30
1650871148044,MATH 18,B03,083750,Staff,0,13,30,30
1650871148044,MATH 18,B04,083751,Staff,0,13,30,30
1650871154067,MATH 20A,A01,083754,Staff,19,0,40,21
1650871160088,MATH 20B,A01,083756,Staff,0,14,30,30
1650871160088,MATH 20B,A02,083757,Staff,0,11,30,30
1650871166110,MATH 20C,A01,083760,Staff,0,17,30,30
1650871166110,MATH 20C,A02,083761,Staff,1,16,30,29
1650871166110,MATH 20C,B01,083762,Staff,9,0,30,21
1650871166110,MATH 20C,B02,083763,Staff,28,0,30,2
1650871172133,MATH 20D,A01,083765,Staff,2,1,30,28
1650871172133,MATH 20D,A02,083766,Staff,6,0,30,24
1650871172133,MATH 20D,A03,083767,Staff,23,0,30,7
1650871178157,MATH 20E,A01,083771,Staff,2,0,30,28
1650871178157,MATH 20E,A02,083772,Staff,13,0,30,17
1650871178157,MATH 20E,B01,083773,Staff,0,0,30,30
1650871178157,MATH 20E,B02,083774,Staff,4,0,30,26
1650871184185,MATH 103A,A01,083777,Staff,0,17,30,30
1650871184185,MATH 103A,A02,083778,Staff,0,15,30,30
1650871184185,MATH 103A,B01,083779,Staff,0,15,30,30
1650871184185,MATH 103A,B02,083780,Staff,0,14,30,30
1650871190209,MATH 105,A01,085443,Staff,0,23,30,30
1650871196231,MATH 109,A01,083213,Anzaldo; Leesa B,0,7,30,30
1650871196231,MATH 109,A02,083214,Anzaldo; Leesa B,0,7,30,30
1650871196231,MATH 109,B01,083215,Anzaldo; Leesa B,0,8,30,30
1650871196231,MATH 109,B02,083216,Anzaldo; Leesa B,0,7,30,30
1650871202262,MATH 142A,A01,083219,Chow; Bennett,0,14,30,30
1650871202262,MATH 142A,A02,083220,Chow; Bennett,0,15,30,30
1650871202262,MATH 142A,B01,083221,Chow; Bennett,0,16,30,30
1650871202262,MATH 142A,B02,083222,Chow; Bennett,0,14,30,30
1650871208285,MATH 193A,A01,083224,Staff,0,6,30,30
1650871208285,MATH 193A,A02,083225,Staff,0,7,30,30
1650871208285,MATH 193A,A03,083781,Staff,0,6,30,30
1650871208285,MATH 193A,A04,083782,Staff,0,7,30,30
1650871214308,MATH 197,001,091859,McAuley; Julian John,9998,0,9999,1
1650871220370,COGS 9,A01,083615,Staff,0,17,60,60
1650871226393,COGS 11,A01,083617,Boyle; Mary E. T.,15,0,40,25
1650871232419,COGS 13,A01,083071,Staff,0,38,40,40
1650871238441,COGS 14A,A01,092681,Staff,0,37,100,100
1650871244472,COGS 14B,A01,083073,Cheng; Tzu-Han,0,12,50,50
1650871250496,COGS 17,A01,092677,Staff,12,0,75,63
1650871256542,COGS 100,A01,083619,Staff,0,30,60,60
1650871262570,COGS 101A,A01,083621,Davis; Joshua Daniel,0,29,60,60
1650871268597,COGS 101B,A01,091572,Staff,0,3,60,60
1650871274620,COGS 101C,A01,083625,Delgado; Tania,14,0,30,16
1650871280644,COGS 107A,A01,083627,Boyle; Mary E. T.,0,16,60,60
1650871286668,COGS 118A,A01,083075,Staff,0,8,60,60
1650871292691,CSE 3,A50,083646,Miranda; Gregory Joseph,18,0,38,20
1650871292691,CSE 3,A51,083647,Miranda; Gregory Joseph,36,0,37,1
1650871298715,CSE 8A,A50,083650,Miranda; Gregory Joseph,0,29,40,40
1650871304737,CSE 11,A01,083080,Cao; Yingjun,0,97,40,40
1650871310763,CSE 12,A01,083652,Staff,0,21,100,100
1650871316785,CSE 15L,A01,083654,Staff,0,3,50,50
1650871316785,CSE 15L,A02,083655,Staff,0,3,50,50
1650871322812,CSE 20,A01,083657,Staff,48,0,80,32
1650871328838,CSE 30,A01,083084,Eldon; John,0,76,40,40
1650871334866,CSE 100,A01,083659,Cao; Yingjun,0,70,50,50
1650871340904,CSE 134B,A01,083661,Powell; Thomas Allan,0,38,65,65
1650871346930,CSE 140,A01,083663,Staff,0,12,75,75
1650871352953,CSE 140L,A01,083088,Eldon; John,0,20,75,75
1650871358977,CSE 175,A01,083665,Kumar; Rakesh,7,0,25,18
1650871365002,CSE 190,A00,092507,Dubnov; Shlomo,9,0,20,11
1650871371025,ECE 45,A01,083139,Staff,0,4,60,60
1650871377053,ECE 65,A50,083695,Staff,0,5,30,30
1650871383077,ECE 109,A01,091882,Touri; Behrouz,32,0,70,38
1650871389099,ECE 180,A00,083140,Abi Samra; Nicholas Camill,20,0,30,10
1650871389099,ECE 180,B00,083141,Abi Samra; Nicholas Camill,0,0,30,30
1650871395122,MATH 10A,A01,083735,Patchell; Gregory David,2,0,30,28
1650871395122,MATH 10A,A02,083736,Patchell; Gregory David,27,0,30,3
1650871395122,MATH 10A,A03,083737,Patchell; Gregory David,23,0,30,7
1650871401145,MATH 10B,A01,083207,Staff,0,9,30,30
1650871401145,MATH 10B,A02,083208,Staff,0,6,30,30
1650871401145,MATH 10B,B01,083739,Staff,10,0,30,20
1650871401145,MATH 10B,B02,083740,Staff,28,0,30,2
1650871407170,MATH 18,A01,083743,Staff,0,0,30,30
1650871407170,MATH 18,A02,083744,Staff,24,0,30,6
1650871407170,MATH 18,A03,083745,Staff,21,0,30,9
1650871407170,MATH 18,A04,083746,Staff,26,0,30,4
1650871407170,MATH 18,B01,083748,Staff,0,15,30,30
1650871407170,MATH 18,B02,083749,Staff,0,13,30,30
1650871407170,MATH 18,B03,083750,Staff,0,13,30,30
1650871407170,MATH 18,B04,083751,Staff,0,13,30,30
1650871413198,MATH 20A,A01,083754,Staff,19,0,40,21
1650871419225,MATH 20B,A01,083756,Staff,0,14,30,30
1650871419225,MATH 20B,A02,083757,Staff,0,11,30,30
1650871425251,MATH 20C,A01,083760,Staff,0,17,30,30
1650871425251,MATH 20C,A02,083761,Staff,1,16,30,29
1650871425251,MATH 20C,B01,083762,Staff,9,0,30,21
1650871425251,MATH 20C,B02,083763,Staff,28,0,30,2
1650871431277,MATH 20D,A01,083765,Staff,2,1,30,28
1650871431277,MATH 20D,A02,083766,Staff,6,0,30,24
1650871431277,MATH 20D,A03,083767,Staff,23,0,30,7
1650871437310,MATH 20E,A01,083771,Staff,2,0,30,28
1650871437310,MATH 20E,A02,083772,Staff,13,0,30,17
1650871437310,MATH 20E,B01,083773,Staff,0,0,30,30
1650871437310,MATH 20E,B02,083774,Staff,4,0,30,26
1650871443334,MATH 103A,A01,083777,Staff,0,17,30,30
1650871443334,MATH 103A,A02,083778,Staff,0,15,30,30
1650871443334,MATH 103A,B01,083779,Staff,0,15,30,30
1650871443334,MATH 103A,B02,083780,Staff,0,14,30,30
1650871449356,MATH 105,A01,085443,Staff,0,23,30,30
1650871455379,MATH 109,A01,083213,Anzaldo; Leesa B,0,7,30,30
1650871455379,MATH 109,A02,083214,Anzaldo; Leesa B,0,7,30,30
1650871455379,MATH 109,B01,083215,Anzaldo; Leesa B,0,8,30,30
1650871455379,MATH 109,B02,083216,Anzaldo; Leesa B,0,7,30,30
1650871461403,MATH 142A,A01,083219,Chow; Bennett,0,14,30,30
1650871461403,MATH 142A,A02,083220,Chow; Bennett,0,15,30,30
1650871461403,MATH 142A,B01,083221,Chow; Bennett,0,16,30,30
1650871461403,MATH 142A,B02,083222,Chow; Bennett,0,14,30,30
1650871467428,MATH 193A,A01,083224,Staff,0,6,30,30
1650871467428,MATH 193A,A02,083225,Staff,0,7,30,30
1650871467428,MATH 193A,A03,083781,Staff,0,6,30,30
1650871467428,MATH 193A,A04,083782,Staff,0,7,30,30
1650871473545,MATH 197,001,091859,McAuley; Julian John,9998,0,9999,1
1650871479605,COGS 9,A01,083615,Staff,0,17,60,60
1650871485628,COGS 11,A01,083617,Boyle; Mary E. T.,15,0,40,25
1650871491652,COGS 13,A01,083071,Staff,0,38,40,40
1650871497679,COGS 14A,A01,092681,Staff,0,37,100,100
1650871503701,COGS 14B,A01,083073,Cheng; Tzu-Han,0,12,50,50
1650871509726,COGS 17,A01,092677,Staff,12,0,75,63
1650871515750,COGS 100,A01,083619,Staff,0,30,60,60
1650871521773,COGS 101A,A01,083621,Davis; Joshua Daniel,0,29,60,60
1650871527797,COGS 101B,A01,091572,Staff,0,3,60,60
1650871533820,COGS 101C,A01,083625,Delgado; Tania,14,0,30,16
1650871539843,COGS 107A,A01,083627,Boyle; Mary E. T.,0,16,60,60
1650871545870,COGS 118A,A01,083075,Staff,0,8,60,60
1650871551897,CSE 3,A50,083646,Miranda; Gregory Joseph,18,0,38,20
1650871551897,CSE 3,A51,083647,Miranda; Gregory Joseph,36,0,37,1
1650871557920,CSE 8A,A50,083650,Miranda; Gregory Joseph,0,29,40,40
1650871563948,CSE 11,A01,083080,Cao; Yingjun,0,97,40,40
1650871569972,CSE 12,A01,083652,Staff,0,21,100,100
1650871575996,CSE 15L,A01,083654,Staff,0,3,50,50
1650871575996,CSE 15L,A02,083655,Staff,0,3,50,50
1650871582023,CSE 20,A01,083657,Staff,48,0,80,32
1650871588049,CSE 30,A01,083084,Eldon; John,0,76,40,40
1650871594074,CSE 100,A01,083659,Cao; Yingjun,0,70,50,50
1650871600100,CSE 134B,A01,083661,Powell; Thomas Allan,0,38,65,65
1650871606126,CSE 140,A01,083663,Staff,0,12,75,75
1650871612151,CSE 140L,A01,083088,Eldon; John,0,20,75,75
1650871618180,CSE 175,A01,083665,Kumar; Rakesh,7,0,25,18
1650871624207,CSE 190,A00,092507,Dubnov; Shlomo,9,0,20,11
1650871630230,ECE 45,A01,083139,Staff,0,4,60,60
1650871636260,ECE 65,A50,083695,Staff,0,5,30,30
1650871642283,ECE 109,A01,091882,Touri; Behrouz,32,0,70,38
1650871648307,ECE 180,A00,083140,Abi Samra; Nicholas Camill,20,0,30,10
1650871648307,ECE 180,B00,083141,Abi Samra; Nicholas Camill,0,0,30,30
1650871654331,MATH 10A,A01,083735,Patchell; Gregory David,2,0,30,28
1650871654331,MATH 10A,A02,083736,Patchell; Gregory David,27,0,30,3
1650871654331,MATH 10A,A03,083737,Patchell; Gregory David,23,0,30,7
1650871660355,MATH 10B,A01,083207,Staff,0,9,30,30
1650871660355,MATH 10B,A02,083208,Staff,0,6,30,30
1650871660355,MATH 10B,B01,083739,Staff,10,0,30,20
1650871660355,MATH 10B,B02,083740,Staff,28,0,30,2
1650871666382,MATH 18,A01,083743,Staff,0,0,30,30
1650871666382,MATH 18,A02,083744,Staff,24,0,30,6
1650871666382,MATH 18,A03,083745,Staff,21,0,30,9
1650871666382,MATH 18,A04,083746,Staff,26,0,30,4
1650871666382,MATH 18,B01,083748,Staff,0,15,30,30
1650871666382,MATH 18,B02,083749,Staff,0,13,30,30
1650871666382,MATH 18,B03,083750,Staff,0,13,30,30
1650871666382,MATH 18,B04,083751,Staff,0,13,30,30
1650871672411,MATH 20A,A01,083754,Staff,19,0,40,21
1650871678437,MATH 20B,A01,083756,Staff,0,14,30,30
1650871678437,MATH 20B,A02,083757,Staff,0,11,30,30
1650871684464,MATH 20C,A01,083760,Staff,0,17,30,30
1650871684464,MATH 20C,A02,083761,Staff,1,16,30,29
1650871684464,MATH 20C,B01,083762,Staff,9,0,30,21
1650871684464,MATH 20C,B02,083763,Staff,28,0,30,2
1650871690490,MATH 20D,A01,083765,Staff,2,1,30,28
1650871690490,MATH 20D,A02,083766,Staff,6,0,30,24
1650871690490,MATH 20D,A03,083767,Staff,23,0,30,7
1650871696516,MATH 20E,A01,083771,Staff,2,0,30,28
1650871696516,MATH 20E,A02,083772,Staff,13,0,30,17
1650871696516,MATH 20E,B01,083773,Staff,0,0,30,30
1650871696516,MATH 20E,B02,083774,Staff,4,0,30,26
1650871702542,MATH 103A,A01,083777,Staff,0,17,30,30
1650871702542,MATH 103A,A02,083778,Staff,0,15,30,30
1650871702542,MATH 103A,B01,083779,Staff,0,15,30,30
1650871702542,MATH 103A,B02,083780,Staff,0,14,30,30
1650871708566,MATH 105,A01,085443,Staff,0,23,30,30
1650871714589,MATH 109,A01,083213,Anzaldo; Leesa B,0,7,30,30
1650871714589,MATH 109,A02,083214,Anzaldo; Leesa B,0,7,30,30
1650871714589,MATH 109,B01,083215,Anzaldo; Leesa B,0,8,30,30
1650871714589,MATH 109,B02,083216,Anzaldo; Leesa B,0,7,30,30
1650871720612,MATH 142A,A01,083219,Chow; Bennett,0,14,30,30
1650871720612,MATH 142A,A02,083220,Chow; Bennett,0,15,30,30
1650871720612,MATH 142A,B01,083221,Chow; Bennett,0,16,30,30
1650871720612,MATH 142A,B02,083222,Chow; Bennett,0,14,30,30
1650871726636,MATH 193A,A01,083224,Staff,0,6,30,30
1650871726636,MATH 193A,A02,083225,Staff,0,7,30,30
1650871726636,MATH 193A,A03,083781,Staff,0,6,30,30
1650871726636,MATH 193A,A04,083782,Staff,0,7,30,30
1650871732659,MATH 197,001,091859,McAuley; Julian John,9998,0,9999,1
1650871738715,COGS 9,A01,083615,Staff,0,17,60,60
1650871744738,COGS 11,A01,083617,Boyle; Mary E. T.,15,0,40,25
1650871750761,COGS 13,A01,083071,Staff,0,38,40,40
1650871756783,COGS 14A,A01,092681,Staff,0,37,100,100
1650871762810,COGS 14B,A01,083073,Cheng; Tzu-Han,0,12,50,50
1650871768833,COGS 17,A01,092677,Staff,12,0,75,63
1650871774854,COGS 100,A01,083619,Staff,0,30,60,60
1650871780876,COGS 101A,A01,083621,Davis; Joshua Daniel,0,29,60,60
1650871786915,COGS 101B,A01,091572,Staff,0,3,60,60
1650871792938,COGS 101C,A01,083625,Delgado; Tania,14,0,30,16
1650871798965,COGS 107A,A01,083627,Boyle; Mary E. T.,0,16,60,60
1650871804988,COGS 118A,A01,083075,Staff,0,8,60,60
1650871811014,CSE 3,A50,083646,Miranda; Gregory Joseph,18,0,38,20
1650871811014,CSE 3,A51,083647,Miranda; Gregory Joseph,36,0,37,1
1650871817040,CSE 8A,A50,083650,Miranda; Gregory Joseph,0,29,40,40
1650871823065,CSE 11,A01,083080,Cao; Yingjun,0,97,40,40
1650871829091,CSE 12,A01,083652,Staff,0,21,100,100
1650871835112,CSE 15L,A01,083654,Staff,0,3,50,50
1650871835112,CSE 15L,A02,083655,Staff,0,3,50,50
1650871841141,CSE 20,A01,083657,Staff,48,0,80,32
1650871847165,CSE 30,A01,083084,Eldon; John,0,76,40,40
1650871853193,CSE 100,A01,083659,Cao; Yingjun,0,70,50,50
1650871859216,CSE 134B,A01,083661,Powell; Thomas Allan,0,38,65,65
1650871865241,CSE 140,A01,083663,Staff,0,12,75,75
1650871871265,CSE 140L,A01,083088,Eldon; John,0,20,75,75
1650871877287,CSE 175,A01,083665,Kumar; Rakesh,7,0,25,18
1650871883309,CSE 190,A00,092507,Dubnov; Shlomo,9,0,20,11
1650871889331,ECE 45,A01,083139,Staff,0,4,60,60
1650871895355,ECE 65,A50,083695,Staff,0,5,30,30
1650871901377,ECE 109,A01,091882,Touri; Behrouz,32,0,70,38
1650871907401,ECE 180,A00,083140,Abi Samra; Nicholas Camill,20,0,30,10
1650871907401,ECE 180,B00,083141,Abi Samra; Nicholas Camill,0,0,30,30
1650871913423,MATH 10A,A01,083735,Patchell; Gregory David,2,0,30,28
1650871913423,MATH 10A,A02,083736,Patchell; Gregory David,27,0,30,3
1650871913423,MATH 10A,A03,083737,Patchell; Gregory David,23,0,30,7
1650871919452,MATH 10B,A01,083207,Staff,0,9,30,30
1650871919452,MATH 10B,A02,083208,Staff,0,6,30,30
1650871919452,MATH 10B,B01,083739,Staff,10,0,30,20
1650871919452,MATH 10B,B02,083740,Staff,28,0,30,2
1650871925479,MATH 18,A01,083743,Staff,0,0,30,30
1650871925479,MATH 18,A02,083744,Staff,24,0,30,6
1650871925479,MATH 18,A03,083745,Staff,21,0,30,9
1650871925479,MATH 18,A04,083746,Staff,26,0,30,4
1650871925479,MATH 18,B01,083748,Staff,0,15,30,30
1650871925479,MATH 18,B02,083749,Staff,0,13,30,30
1650871925479,MATH 18,B03,083750,Staff,0,13,30,30
1650871925479,MATH 18,B04,083751,Staff,0,13,30,30
1650871931501,MATH 20A,A01,083754,Staff,19,0,40,21
1650871937525,MATH 20B,A01,083756,Staff,0,14,30,30
1650871937525,MATH 20B,A02,083757,Staff,0,11,30,30
1650871943550,MATH 20C,A01,083760,Staff,0,17,30,30
1650871943550,MATH 20C,A02,083761,Staff,1,16,30,29
1650871943550,MATH 20C,B01,083762,Staff,9,0,30,21
1650871943550,MATH 20C,B02,083763,Staff,28,0,30,2
1650871949573,MATH 20D,A01,083765,Staff,2,1,30,28
1650871949573,MATH 20D,A02,083766,Staff,6,0,30,24
1650871949573,MATH 20D,A03,083767,Staff,23,0,30,7
1650871955599,MATH 20E,A01,083771,Staff,2,0,30,28
1650871955599,MATH 20E,A02,083772,Staff,13,0,30,17
1650871955599,MATH 20E,B01,083773,Staff,0,0,30,30
1650871955599,MATH 20E,B02,083774,Staff,4,0,30,26
1650871961626,MATH 103A,A01,083777,Staff,0,17,30,30
1650871961626,MATH 103A,A02,083778,Staff,0,15,30,30
1650871961626,MATH 103A,B01,083779,Staff,0,15,30,30
1650871961626,MATH 103A,B02,083780,Staff,0,14,30,30
1650871967650,MATH 105,A01,085443,Staff,0,23,30,30
1650871973674,MATH 109,A01,083213,Anzaldo; Leesa B,0,7,30,30
1650871973674,MATH 109,A02,083214,Anzaldo; Leesa B,0,7,30,30
1650871973674,MATH 109,B01,083215,Anzaldo; Leesa B,0,8,30,30
1650871973674,MATH 109,B02,083216,Anzaldo; Leesa B,0,7,30,30
1650871979701,MATH 142A,A01,083219,Chow; Bennett,0,14,30,30
1650871979701,MATH 142A,A02,083220,Chow; Bennett,0,15,30,30
1650871979701,MATH 142A,B01,083221,Chow; Bennett,0,16,30,30
1650871979701,MATH 142A,B02,083222,Chow; Bennett,0,14,30,30
1650871985725,MATH 193A,A01,083224,Staff,0,6,30,30
1650871985725,MATH 193A,A02,083225,Staff,0,7,30,30
1650871985725,MATH 193A,A03,083781,Staff,0,6,30,30
1650871985725,MATH 193A,A04,083782,Staff,0,7,30,30
1650871991747,MATH 197,001,091859,McAuley; Julian John,9998,0,9999,1
1650871997805,COGS 9,A01,083615,Staff,0,17,60,60
1650872003827,COGS 11,A01,083617,Boyle; Mary E. T.,15,0,40,25
1650872009850,COGS 13,A01,083071,Staff,0,38,40,40
1650872015875,COGS 14A,A01,092681,Staff,0,37,100,100
1650872021898,COGS 14B,A01,083073,Cheng; Tzu-Han,0,12,50,50
1650872027921,COGS 17,A01,092677,Staff,12,0,75,63
1650872033947,COGS 100,A01,083619,Staff,0,30,60,60
1650872039970,COGS 101A,A01,083621,Davis; Joshua Daniel,0,29,60,60
1650872045993,COGS 101B,A01,091572,Staff,0,3,60,60
1650872052018,COGS 101C,A01,083625,Delgado; Tania,14,0,30,16
1650872058041,COGS 107A,A01,083627,Boyle; Mary E. T.,0,16,60,60
1650872064183,COGS 118A,A01,083075,Staff,0,8,60,60
1650872070206,CSE 3,A50,083646,Miranda; Gregory Joseph,18,0,38,20
1650872070206,CSE 3,A51,083647,Miranda; Gregory Joseph,36,0,37,1
1650872076235,CSE 8A,A50,083650,Miranda; Gregory Joseph,0,29,40,40
1650872082260,CSE 11,A01,083080,Cao; Yingjun,0,97,40,40
1650872088282,CSE 12,A01,083652,Staff,0,21,100,100
1650872094307,CSE 15L,A01,083654,Staff,0,3,50,50
1650872094307,CSE 15L,A02,083655,Staff,0,3,50,50
1650872100337,CSE 20,A01,083657,Staff,48,0,80,32
1650872106360,CSE 30,A01,083084,Eldon; John,0,76,40,40
1650872112386,CSE 100,A01,083659,Cao; Yingjun,0,70,50,50
1650872118408,CSE 134B,A01,083661,Powell; Thomas Allan,0,38,65,65
1650872124429,CSE 140,A01,083663,Staff,0,12,75,75
1650872130460,CSE 140L,A01,083088,Eldon; John,0,20,75,75
1650872136490,CSE 175,A01,083665,Kumar; Rakesh,7,0,25,18
1650872142511,CSE 190,A00,092507,Dubnov; Shlomo,9,0,20,11
1650872148535,ECE 45,A01,083139,Staff,0,4,60,60
1650872154560,ECE 65,A50,083695,Staff,0,5,30,30
1650872160592,ECE 109,A01,091882,Touri; Behrouz,32,0,70,38
1650872166618,ECE 180,A00,083140,Abi Samra; Nicholas Camill,20,0,30,10
1650872166618,ECE 180,B00,083141,Abi Samra; Nicholas Camill,0,0,30,30
1650872172645,MATH 10A,A01,083735,Patchell; Gregory David,2,0,30,28
1650872172645,MATH 10A,A02,083736,Patchell; Gregory David,27,0,30,3
1650872172645,MATH 10A,A03,083737,Patchell; Gregory David,23,0,30,7
1650872178669,MATH 10B,A01,083207,Staff,0,9,30,30
1650872178669,MATH 10B,A02,083208,Staff,0,6,30,30
1650872178669,MATH 10B,B01,083739,Staff,10,0,30,20
1650872178669,MATH 10B,B02,083740,Staff,28,0,30,2
1650872184694,MATH 18,A01,083743,Staff,0,0,30,30
1650872184694,MATH 18,A02,083744,Staff,24,0,30,6
1650872184694,MATH 18,A03,083745,Staff,21,0,30,9
1650872184694,MATH 18,A04,083746,Staff,26,0,30,4
1650872184694,MATH 18,B01,083748,Staff,0,15,30,30
1650872184694,MATH 18,B02,083749,Staff,0,13,30,30
1650872184694,MATH 18,B03,083750,Staff,0,13,30,30
1650872184694,MATH 18,B04,083751,Staff,0,13,30,30
1650872190718,MATH 20A,A01,083754,Staff,19,0,40,21
1650872196745,MATH 20B,A01,083756,Staff,0,14,30,30
1650872196745,MATH 20B,A02,083757,Staff,0,11,30,30
1650872202773,MATH 20C,A01,083760,Staff,0,17,30,30
1650872202773,MATH 20C,A02,083761,Staff,1,16,30,29
1650872202773,MATH 20C,B01,083762,Staff,9,0,30,21
1650872202773,MATH 20C,B02,083763,Staff,28,0,30,2
1650872208797,MATH 20D,A01,083765,Staff,2,1,30,28
1650872208797,MATH 20D,A02,083766,Staff,6,0,30,24
1650872208797,MATH 20D,A03,083767,Staff,23,0,30,7
1650872214820,MATH 20E,A01,083771,Staff,2,0,30,28
1650872214820,MATH 20E,A02,083772,Staff,13,0,30,17
1650872214820,MATH 20E,B01,083773,Staff,0,0,30,30
1650872214820,MATH 20E,B02,083774,Staff,4,0,30,26
1650872220845,MATH 103A,A01,083777,Staff,0,17,30,30
1650872220845,MATH 103A,A02,083778,Staff,0,15,30,30
1650872220845,MATH 103A,B01,083779,Staff,0,15,30,30
1650872220845,MATH 103A,B02,083780,Staff,0,14,30,30
1650872226868,MATH 105,A01,085443,Staff,0,23,30,30
1650872232893,MATH 109,A01,083213,Anzaldo; Leesa B,0,7,30,30
1650872232893,MATH 109,A02,083214,Anzaldo; Leesa B,0,7,30,30
1650872232893,MATH 109,B01,083215,Anzaldo; Leesa B,0,8,30,30
1650872232893,MATH 109,B02,083216,Anzaldo; Leesa B,0,7,30,30
1650872238921,MATH 142A,A01,083219,Chow; Bennett,0,14,30,30
1650872238921,MATH 142A,A02,083220,Chow; Bennett,0,15,30,30
1650872238921,MATH 142A,B01,083221,Chow; Bennett,0,16,30,30
1650872238921,MATH 142A,B02,083222,Chow; Bennett,0,14,30,30
1650872244945,MATH 193A,A01,083224,Staff,0,6,30,30
1650872244945,MATH 193A,A02,083225,Staff,0,7,30,30
1650872244945,MATH 193A,A03,083781,Staff,0,6,30,30
1650872244945,MATH 193A,A04,083782,Staff,0,7,30,30
1650872250969,MATH 197,001,091859,McAuley; Julian John,9998,0,9999,1
1650872257027,COGS 9,A01,083615,Staff,0,17,60,60
1650872263050,COGS 11,A01,083617,Boyle; Mary E. T.,15,0,40,25
1650872269076,COGS 13,A01,083071,Staff,0,38,40,40
1650872275100,COGS 14A,A01,092681,Staff,0,37,100,100
1650872281128,COGS 14B,A01,083073,Cheng; Tzu-Han,0,12,50,50
1650872287151,COGS 17,A01,092677,Staff,12,0,75,63
1650872293178,COGS 100,A01,083619,Staff,0,30,60,60
1650872299201,COGS 101A,A01,083621,Davis; Joshua Daniel,0,29,60,60
1650872305224,COGS 101B,A01,091572,Staff,0,3,60,60
1650872311247,COGS 101C,A01,083625,Delgado; Tania,14,0,30,16
1650872317274,COGS 107A,A01,083627,Boyle; Mary E. T.,0,16,60,60
1650872323301,COGS 118A,A01,083075,Staff,0,8,60,60
1650872329326,CSE 3,A50,083646,Miranda; Gregory Joseph,18,0,38,20
1650872329326,CSE 3,A51,083647,Miranda; Gregory Joseph,36,0,37,1
1650872335350,CSE 8A,A50,083650,Miranda; Gregory Joseph,0,29,40,40
1650872341374,CSE 11,A01,083080,Cao; Yingjun,0,97,40,40
1650872347398,CSE 12,A01,083652,Staff,0,21,100,100
1650872353421,CSE 15L,A01,083654,Staff,0,3,50,50
1650872353421,CSE 15L,A02,083655,Staff,0,3,50,50
1650872359448,CSE 20,A01,083657,Staff,48,0,80,32
1650872365474,CSE 30,A01,083084,Eldon; John,0,76,40,40
1650872371506,CSE 100,A01,083659,Cao; Yingjun,0,70,50,50
1650872377531,CSE 134B,A01,083661,Powell; Thomas Allan,0,38,65,65
1650872383553,CSE 140,A01,083663,Staff,0,12,75,75
1650872389577,CSE 140L,A01,083088,Eldon; John,0,20,75,75
1650872395602,CSE 175,A01,083665,Kumar; Rakesh,7,0,25,18
1650872401626,CSE 190,A00,092507,Dubnov; Shlomo,9,0,20,11
1650872407652,ECE 45,A01,083139,Staff,0,4,60,60
1650872413685,ECE 65,A50,083695,Staff,0,5,30,30
1650872419717,ECE 109,A01,091882,Touri; Behrouz,32,0,70,38
1650872425740,ECE 180,A00,083140,Abi Samra; Nicholas Camill,20,0,30,10
1650872425740,ECE 180,B00,083141,Abi Samra; Nicholas Camill,0,0,30,30
1650872431764,MATH 10A,A01,083735,Patchell; Gregory David,2,0,30,28
1650872431764,MATH 10A,A02,083736,Patchell; Gregory David,27,0,30,3
1650872431764,MATH 10A,A03,083737,Patchell; Gregory David,23,0,30,7
1650872437790,MATH 10B,A01,083207,Staff,0,9,30,30
1650872437790,MATH 10B,A02,083208,Staff,0,6,30,30
1650872437790,MATH 10B,B01,083739,Staff,10,0,30,20
1650872437790,MATH 10B,B02,083740,Staff,28,0,30,2
1650872443815,MATH 18,A01,083743,Staff,0,0,30,30
1650872443815,MATH 18,A02,083744,Staff,24,0,30,6
1650872443815,MATH 18,A03,083745,Staff,21,0,30,9
1650872443815,MATH 18,A04,083746,Staff,26,0,30,4
1650872443815,MATH 18,B01,083748,Staff,0,15,30,30
1650872443815,MATH 18,B02,083749,Staff,0,13,30,30
1650872443815,MATH 18,B03,083750,Staff,0,13,30,30
1650872443815,MATH 18,B04,083751,Staff,0,13,30,30
1650872449846,MATH 20A,A01,083754,Staff,19,0,40,21
1650872455873,MATH 20B,A01,083756,Staff,0,14,30,30
1650872455873,MATH 20B,A02,083757,Staff,0,11,30,30
1650872461901,MATH 20C,A01,083760,Staff,0,17,30,30
1650872461901,MATH 20C,A02,083761,Staff,1,16,30,29
1650872461901,MATH 20C,B01,083762,Staff,9,0,30,21
1650872461901,MATH 20C,B02,083763,Staff,28,0,30,2
1650872467927,MATH 20D,A01,083765,Staff,2,1,30,28
1650872467927,MATH 20D,A02,083766,Staff,6,0,30,24
1650872467927,MATH 20D,A03,083767,Staff,23,0,30,7
1650872473955,MATH 20E,A01,083771,Staff,2,0,30,28
1650872473955,MATH 20E,A02,083772,Staff,13,0,30,17
1650872473955,MATH 20E,B01,083773,Staff,0,0,30,30
1650872473955,MATH 20E,B02,083774,Staff,4,0,30,26
1650872479983,MATH 103A,A01,083777,Staff,0,17,30,30
1650872479983,MATH 103A,A02,083778,Staff,0,15,30,30
1650872479983,MATH 103A,B01,083779,Staff,0,15,30,30
1650872479983,MATH 103A,B02,083780,Staff,0,14,30,30
1650872486006,MATH 105,A01,085443,Staff,0,23,30,30
1650872492032,MATH 109,A01,083213,Anzaldo; Leesa B,0,7,30,30
1650872492032,MATH 109,A02,083214,Anzaldo; Leesa B,0,7,30,30
1650872492032,MATH 109,B01,083215,Anzaldo; Leesa B,0,8,30,30
1650872492032,MATH 109,B02,083216,Anzaldo; Leesa B,0,7,30,30
1650872498061,MATH 142A,A01,083219,Chow; Bennett,0,14,30,30
1650872498061,MATH 142A,A02,083220,Chow; Bennett,0,15,30,30
1650872498061,MATH 142A,B01,083221,Chow; Bennett,0,16,30,30
1650872498061,MATH 142A,B02,083222,Chow; Bennett,0,14,30,30
1650872504085,MATH 193A,A01,083224,Staff,0,6,30,30
1650872504085,MATH 193A,A02,083225,Staff,0,7,30,30
1650872504085,MATH 193A,A03,083781,Staff,0,6,30,30
1650872504085,MATH 193A,A04,083782,Staff,0,7,30,30
1650872510109,MATH 197,001,091859,McAuley; Julian John,9998,0,9999,1
1650872516159,COGS 9,A01,083615,Staff,0,17,60,60
1650872522186,COGS 11,A01,083617,Boyle; Mary E. T.,15,0,40,25
1650872528212,COGS 13,A01,083071,Staff,0,38,40,40
1650872534239,COGS 14A,A01,092681,Staff,0,37,100,100
1650872540268,COGS 14B,A01,083073,Cheng; Tzu-Han,0,12,50,50
1650872546293,COGS 17,A01,092677,Staff,12,0,75,63
1650872552318,COGS 100,A01,083619,Staff,0,30,60,60
1650872558346,COGS 101A,A01,083621,Davis; Joshua Daniel,0,29,60,60
1650872564370,COGS 101B,A01,091572,Staff,0,3,60,60
1650872570406,COGS 101C,A01,083625,Delgado; Tania,14,0,30,16
1650872576431,COGS 107A,A01,083627,Boyle; Mary E. T.,0,16,60,60
1650872582457,COGS 118A,A01,083075,Staff,0,8,60,60
1650872588485,CSE 3,A50,083646,Miranda; Gregory Joseph,17,0,38,21
1650872588485,CSE 3,A51,083647,Miranda; Gregory Joseph,36,0,37,1
1650872594509,CSE 8A,A50,083650,Miranda; Gregory Joseph,0,29,40,40
1650872600537,CSE 11,A01,083080,Cao; Yingjun,0,97,40,40
1650872606561,CSE 12,A01,083652,Staff,0,21,100,100
1650872612585,CSE 15L,A01,083654,Staff,0,3,50,50
1650872612585,CSE 15L,A02,083655,Staff,0,3,50,50
1650872618608,CSE 20,A01,083657,Staff,48,0,80,32
1650872624634,CSE 30,A01,083084,Eldon; John,0,76,40,40
1650872630660,CSE 100,A01,083659,Cao; Yingjun,0,70,50,50
1650872636683,CSE 134B,A01,083661,Powell; Thomas Allan,0,38,65,65
1650872642706,CSE 140,A01,083663,Staff,0,12,75,75
1650872648730,CSE 140L,A01,083088,Eldon; John,0,20,75,75
1650872654752,CSE 175,A01,083665,Kumar; Rakesh,7,0,25,18
1650872660868,CSE 190,A00,092507,Dubnov; Shlomo,9,0,20,11
1650872666892,ECE 45,A01,083139,Staff,0,4,60,60
1650872672916,ECE 65,A50,083695,Staff,0,5,30,30
1650872678940,ECE 109,A01,091882,Touri; Behrouz,32,0,70,38
1650872684964,ECE 180,A00,083140,Abi Samra; Nicholas Camill,20,0,30,10
1650872684964,ECE 180,B00,083141,Abi Samra; Nicholas Camill,0,0,30,30
1650872690989,MATH 10A,A01,083735,Patchell; Gregory David,2,0,30,28
1650872690989,MATH 10A,A02,083736,Patchell; Gregory David,27,0,30,3
1650872690989,MATH 10A,A03,083737,Patchell; Gregory David,23,0,30,7
1650872697017,MATH 10B,A01,083207,Staff,0,9,30,30
1650872697017,MATH 10B,A02,083208,Staff,0,6,30,30
1650872697017,MATH 10B,B01,083739,Staff,10,0,30,20
1650872697017,MATH 10B,B02,083740,Staff,28,0,30,2
1650872703044,MATH 18,A01,083743,Staff,0,0,30,30
1650872703044,MATH 18,A02,083744,Staff,24,0,30,6
1650872703044,MATH 18,A03,083745,Staff,21,0,30,9
1650872703044,MATH 18,A04,083746,Staff,26,0,30,4
1650872703044,MATH 18,B01,083748,Staff,0,15,30,30
1650872703044,MATH 18,B02,083749,Staff,0,13,30,30
1650872703044,MATH 18,B03,083750,Staff,0,13,30,30
1650872703044,MATH 18,B04,083751,Staff,0,13,30,30
1650872709070,MATH 20A,A01,083754,Staff,19,0,40,21
1650872715098,MATH 20B,A01,083756,Staff,0,14,30,30
1650872715098,MATH 20B,A02,083757,Staff,0,11,30,30
1650872721120,MATH 20C,A01,083760,Staff,0,17,30,30
1650872721120,MATH 20C,A02,083761,Staff,1,16,30,29
1650872721120,MATH 20C,B01,083762,Staff,9,0,30,21
1650872721120,MATH 20C,B02,083763,Staff,28,0,30,2
1650872727143,MATH 20D,A01,083765,Staff,2,1,30,28
1650872727143,MATH 20D,A02,083766,Staff,6,0,30,24
1650872727143,MATH 20D,A03,083767,Staff,23,0,30,7
1650872733171,MATH 20E,A01,083771,Staff,2,0,30,28
1650872733171,MATH 20E,A02,083772,Staff,13,0,30,17
1650872733171,MATH 20E,B01,083773,Staff,0,0,30,30
1650872733171,MATH 20E,B02,083774,Staff,4,0,30,26
1650872739199,MATH 103A,A01,083777,Staff,0,17,30,30
1650872739199,MATH 103A,A02,083778,Staff,0,15,30,30
1650872739199,MATH 103A,B01,083779,Staff,0,15,30,30
1650872739199,MATH 103A,B02,083780,Staff,0,14,30,30
1650872745223,MATH 105,A01,085443,Staff,0,23,30,30
1650872751249,MATH 109,A01,083213,Anzaldo; Leesa B,0,7,30,30
1650872751249,MATH 109,A02,083214,Anzaldo; Leesa B,0,7,30,30
1650872751249,MATH 109,B01,083215,Anzaldo; Leesa B,0,8,30,30
1650872751249,MATH 109,B02,083216,Anzaldo; Leesa B,0,7,30,30
1650872757277,MATH 142A,A01,083219,Chow; Bennett,0,14,30,30
1650872757277,MATH 142A,A02,083220,Chow; Bennett,0,15,30,30
1650872757277,MATH 142A,B01,083221,Chow; Bennett,0,16,30,30
1650872757277,MATH 142A,B02,083222,Chow; Bennett,0,14,30,30
1650872763317,MATH 193A,A01,083224,Staff,0,6,30,30
1650872763317,MATH 193A,A02,083225,Staff,0,7,30,30
1650872763317,MATH 193A,A03,083781,Staff,0,6,30,30
1650872763317,MATH 193A,A04,083782,Staff,0,7,30,30
1650872769342,MATH 197,001,091859,McAuley; Julian John,9998,0,9999,1
1650872775399,COGS 9,A01,083615,Staff,0,17,60,60
1650872781426,COGS 11,A01,083617,Boyle; Mary E. T.,15,0,40,25
1650872787452,COGS 13,A01,083071,Staff,0,38,40,40
1650872793480,COGS 14A,A01,092681,Staff,0,37,100,100
1650872799504,COGS 14B,A01,083073,Cheng; Tzu-Han,0,12,50,50
1650872805530,COGS 17,A01,092677,Staff,12,0,75,63
1650872811554,COGS 100,A01,083619,Staff,0,30,60,60
1650872817580,COGS 101A,A01,083621,Davis; Joshua Daniel,0,29,60,60
1650872823609,COGS 101B,A01,091572,Staff,0,3,60,60
1650872829636,COGS 101C,A01,083625,Delgado; Tania,14,0,30,16
1650872835663,COGS 107A,A01,083627,Boyle; Mary E. T.,0,16,60,60
1650872841686,COGS 118A,A01,083075,Staff,0,8,60,60
1650872847725,CSE 3,A50,083646,Miranda; Gregory Joseph,17,0,38,21
1650872847725,CSE 3,A51,083647,Miranda; Gregory Joseph,36,0,37,1
1650872853753,CSE 8A,A50,083650,Miranda; Gregory Joseph,0,29,40,40
1650872859785,CSE 11,A01,083080,Cao; Yingjun,0,97,40,40
1650872865811,CSE 12,A01,083652,Staff,0,21,100,100
1650872871838,CSE 15L,A01,083654,Staff,0,3,50,50
1650872871838,CSE 15L,A02,083655,Staff,0,3,50,50
1650872877860,CSE 20,A01,083657,Staff,48,0,80,32
1650872883883,CSE 30,A01,083084,Eldon; John,0,76,40,40
1650872889909,CSE 100,A01,083659,Cao; Yingjun,0,70,50,50
1650872895940,CSE 134B,A01,083661,Powell; Thomas Allan,0,38,65,65
1650872901965,CSE 140,A01,083663,Staff,0,12,75,75
1650872907989,CSE 140L,A01,083088,Eldon; John,0,20,75,75
1650872914015,CSE 175,A01,083665,Kumar; Rakesh,7,0,25,18
1650872920040,CSE 190,A00,092507,Dubnov; Shlomo,9,0,20,11
1650872926064,ECE 45,A01,083139,Staff,0,4,60,60
1650872932088,ECE 65,A50,083695,Staff,0,5,30,30
1650872938111,ECE 109,A01,091882,Touri; Behrouz,32,0,70,38
1650872944139,ECE 180,A00,083140,Abi Samra; Nicholas Camill,20,0,30,10
1650872944139,ECE 180,B00,083141,Abi Samra; Nicholas Camill,0,0,30,30
1650872950164,MATH 10A,A01,083735,Patchell; Gregory David,2,0,30,28
1650872950164,MATH 10A,A02,083736,Patchell; Gregory David,27,0,30,3
1650872950164,MATH 10A,A03,083737,Patchell; Gregory David,23,0,30,7
1650872956187,MATH 10B,A01,083207,Staff,0,9,30,30
1650872956187,MATH 10B,A02,083208,Staff,0,6,30,30
1650872956187,MATH 10B,B01,083739,Staff,10,0,30,20
1650872956187,MATH 10B,B02,083740,Staff,28,0,30,2
1650872962210,MATH 18,A01,083743,Staff,0,0,30,30
1650872962210,MATH 18,A02,083744,Staff,24,0,30,6
1650872962210,MATH 18,A03,083745,Staff,21,0,30,9
1650872962210,MATH 18,A04,083746,Staff,26,0,30,4
1650872962210,MATH 18,B01,083748,Staff,0,15,30,30
1650872962210,MATH 18,B02,083749,Staff,0,13,30,30
1650872962210,MATH 18,B03,083750,Staff,0,13,30,30
1650872962210,MATH 18,B04,083751,Staff,0,13,30,30
1650872968240,MATH 20A,A01,083754,Staff,19,0,40,21
1650872974266,MATH 20B,A01,083756,Staff,0,14,30,30
1650872974266,MATH 20B,A02,083757,Staff,0,11,30,30
1650872980296,MATH 20C,A01,083760,Staff,0,17,30,30
1650872980296,MATH 20C,A02,083761,Staff,1,16,30,29
1650872980296,MATH 20C,B01,083762,Staff,9,0,30,21
1650872980296,MATH 20C,B02,083763,Staff,28,0,30,2
1650872986322,MATH 20D,A01,083765,Staff,2,1,30,28
1650872986322,MATH 20D,A02,083766,Staff,6,0,30,24
1650872986322,MATH 20D,A03,083767,Staff,23,0,30,7
1650872992352,MATH 20E,A01,083771,Staff,2,0,30,28
1650872992352,MATH 20E,A02,083772,Staff,13,0,30,17
1650872992352,MATH 20E,B01,083773,Staff,0,0,30,30
1650872992352,MATH 20E,B02,083774,Staff,4,0,30,26
1650872998380,MATH 103A,A01,083777,Staff,0,17,30,30
1650872998380,MATH 103A,A02,083778,Staff,0,15,30,30
1650872998380,MATH 103A,B01,083779,Staff,0,15,30,30
1650872998380,MATH 103A,B02,083780,Staff,0,14,30,30
1650873004404,MATH 105,A01,085443,Staff,0,23,30,30
1650873010427,MATH 109,A01,083213,Anzaldo; Leesa B,0,7,30,30
1650873010427,MATH 109,A02,083214,Anzaldo; Leesa B,0,7,30,30
1650873010427,MATH 109,B01,083215,Anzaldo; Leesa B,0,8,30,30
1650873010427,MATH 109,B02,083216,Anzaldo; Leesa B,0,7,30,30
1650873016460,MATH 142A,A01,083219,Chow; Bennett,0,14,30,30
1650873016460,MATH 142A,A02,083220,Chow; Bennett,0,15,30,30
1650873016460,MATH 142A,B01,083221,Chow; Bennett,0,16,30,30
1650873016460,MATH 142A,B02,083222,Chow; Bennett,0,14,30,30
1650873022481,MATH 193A,A01,083224,Staff,0,6,30,30
1650873022481,MATH 193A,A02,083225,Staff,0,7,30,30
1650873022481,MATH 193A,A03,083781,Staff,0,6,30,30
1650873022481,MATH 193A,A04,083782,Staff,0,7,30,30
1650873028505,MATH 197,001,091859,McAuley; Julian John,9998,0,9999,1
1650873034569,COGS 9,A01,083615,Staff,0,17,60,60
1650873040593,COGS 11,A01,083617,Boyle; Mary E. T.,15,0,40,25
1650873046619,COGS 13,A01,083071,Staff,0,38,40,40
1650873052654,COGS 14A,A01,092681,Staff,0,37,100,100
1650873058687,COGS 14B,A01,083073,Cheng; Tzu-Han,0,12,50,50
1650873064714,COGS 17,A01,092677,Staff,12,0,75,63
1650873070739,COGS 100,A01,083619,Staff,0,30,60,60
1650873076762,COGS 101A,A01,083621,Davis; Joshua Daniel,0,29,60,60
1650873082786,COGS 101B,A01,091572,Staff,0,3,60,60
1650873088811,COGS 101C,A01,083625,Delgado; Tania,14,0,30,16
1650873094839,COGS 107A,A01,083627,Boyle; Mary E. T.,0,16,60,60
1650873100863,COGS 118A,A01,083075,Staff,0,8,60,60
1650873106887,CSE 3,A50,083646,Miranda; Gregory Joseph,17,0,38,21
1650873106887,CSE 3,A51,083647,Miranda; Gregory Joseph,36,0,37,1
1650873112916,CSE 8A,A50,083650,Miranda; Gregory Joseph,0,29,40,40
1650873118942,CSE 11,A01,083080,Cao; Yingjun,0,97,40,40
1650873124965,CSE 12,A01,083652,Staff,0,21,100,100
1650873130991,CSE 15L,A01,083654,Staff,0,3,50,50
1650873130991,CSE 15L,A02,083655,Staff,0,3,50,50
1650873137015,CSE 20,A01,083657,Staff,48,0,80,32
1650873143038,CSE 30,A01,083084,Eldon; John,0,76,40,40
1650873149062,CSE 100,A01,083659,Cao; Yingjun,0,70,50,50
1650873155086,CSE 134B,A01,083661,Powell; Thomas Allan,0,38,65,65
1650873161109,CSE 140,A01,083663,Staff,0,12,75,75
1650873167134,CSE 140L,A01,083088,Eldon; John,0,20,75,75
1650873173160,CSE 175,A01,083665,Kumar; Rakesh,7,0,25,18
1650873179182,CSE 190,A00,092507,Dubnov; Shlomo,9,0,20,11
1650873185206,ECE 45,A01,083139,Staff,0,4,60,60
1650873191236,ECE 65,A50,083695,Staff,0,5,30,30
1650873197262,ECE 109,A01,091882,Touri; Behrouz,32,0,70,38
1650873203288,ECE 180,A00,083140,Abi Samra; Nicholas Camill,20,0,30,10
1650873203288,ECE 180,B00,083141,Abi Samra; Nicholas Camill,0,0,30,30
1650873209317,MATH 10A,A01,083735,Patchell; Gregory David,2,0,30,28
1650873209317,MATH 10A,A02,083736,Patchell; Gregory David,27,0,30,3
1650873209317,MATH 10A,A03,083737,Patchell; Gregory David,23,0,30,7
1650873215341,MATH 10B,A01,083207,Staff,0,9,30,30
1650873215341,MATH 10B,A02,083208,Staff,0,6,30,30
1650873215341,MATH 10B,B01,083739,Staff,10,0,30,20
1650873215341,MATH 10B,B02,083740,Staff,28,0,30,2
1650873221365,MATH 18,A01,083743,Staff,0,0,30,30
1650873221365,MATH 18,A02,083744,Staff,24,0,30,6
1650873221365,MATH 18,A03,083745,Staff,21,0,30,9
1650873221365,MATH 18,A04,083746,Staff,26,0,30,4
1650873221365,MATH 18,B01,083748,Staff,0,15,30,30
1650873221365,MATH 18,B02,083749,Staff,0,13,30,30
1650873221365,MATH 18,B03,083750,Staff,0,13,30,30
1650873221365,MATH 18,B04,083751,Staff,0,13,30,30
1650873227391,MATH 20A,A01,083754,Staff,19,0,40,21
1650873233418,MATH 20B,A01,083756,Staff,0,14,30,30
1650873233418,MATH 20B,A02,083757,Staff,0,11,30,30
1650873239446,MATH 20C,A01,083760,Staff,0,17,30,30
1650873239446,MATH 20C,A02,083761,Staff,1,16,30,29
1650873239446,MATH 20C,B01,083762,Staff,9,0,30,21
1650873239446,MATH 20C,B02,083763,Staff,28,0,30,2
1650873245472,MATH 20D,A01,083765,Staff,2,1,30,28
1650873245472,MATH 20D,A02,083766,Staff,6,0,30,24
1650873245472,MATH 20D,A03,083767,Staff,23,0,30,7
1650873251499,MATH 20E,A01,083771,Staff,2,0,30,28
1650873251499,MATH 20E,A02,083772,Staff,13,0,30,17
1650873251499,MATH 20E,B01,083773,Staff,0,0,30,30
1650873251499,MATH 20E,B02,083774,Staff,4,0,30,26
1650873257638,MATH 103A,A01,083777,Staff,0,17,30,30
1650873257638,MATH 103A,A02,083778,Staff,0,15,30,30
1650873257638,MATH 103A,B01,083779,Staff,0,15,30,30
1650873257638,MATH 103A,B02,083780,Staff,0,14,30,30
1650873263661,MATH 105,A01,085443,Staff,0,23,30,30
1650873269693,MATH 109,A01,083213,Anzaldo; Leesa B,0,7,30,30
1650873269693,MATH 109,A02,083214,Anzaldo; Leesa B,0,7,30,30
1650873269693,MATH 109,B01,083215,Anzaldo; Leesa B,0,8,30,30
1650873269693,MATH 109,B02,083216,Anzaldo; Leesa B,0,7,30,30
1650873275717,MATH 142A,A01,083219,Chow; Bennett,0,14,30,30
1650873275717,MATH 142A,A02,083220,Chow; Bennett,0,15,30,30
1650873275717,MATH 142A,B01,083221,Chow; Bennett,0,16,30,30
1650873275717,MATH 142A,B02,083222,Chow; Bennett,0,14,30,30
1650873281741,MATH 193A,A01,083224,Staff,0,6,30,30
1650873281741,MATH 193A,A02,083225,Staff,0,7,30,30
1650873281741,MATH 193A,A03,083781,Staff,0,6,30,30
1650873281741,MATH 193A,A04,083782,Staff,0,7,30,30
1650873287767,MATH 197,001,091859,McAuley; Julian John,9998,0,9999,1
1650873293820,COGS 9,A01,083615,Staff,0,17,60,60
1650873299847,COGS 11,A01,083617,Boyle; Mary E. T.,15,0,40,25
1650873305872,COGS 13,A01,083071,Staff,0,38,40,40
1650873311905,COGS 14A,A01,092681,Staff,0,37,100,100
1650873317933,COGS 14B,A01,083073,Cheng; Tzu-Han,0,12,50,50
1650873323958,COGS 17,A01,092677,Staff,12,0,75,63
1650873329985,COGS 100,A01,083619,Staff,0,30,60,60
1650873336011,COGS 101A,A01,083621,Davis; Joshua Daniel,0,29,60,60
1650873342035,COGS 101B,A01,091572,Staff,0,3,60,60
1650873348058,COGS 101C,A01,083625,Delgado; Tania,14,0,30,16
1650873354085,COGS 107A,A01,083627,Boyle; Mary E. T.,0,16,60,60
1650873360109,COGS 118A,A01,083075,Staff,0,8,60,60
1650873366133,CSE 3,A50,083646,Miranda; Gregory Joseph,17,0,38,21
1650873366133,CSE 3,A51,083647,Miranda; Gregory Joseph,36,0,37,1
1650873372172,CSE 8A,A50,083650,Miranda; Gregory Joseph,0,29,40,40
1650873378196,CSE 11,A01,083080,Cao; Yingjun,0,97,40,40
1650873384220,CSE 12,A01,083652,Staff,0,21,100,100
1650873390247,CSE 15L,A01,083654,Staff,0,3,50,50
1650873390247,CSE 15L,A02,083655,Staff,0,3,50,50
1650873396275,CSE 20,A01,083657,Staff,48,0,80,32
1650873402298,CSE 30,A01,083084,Eldon; John,0,76,40,40
1650873408325,CSE 100,A01,083659,Cao; Yingjun,0,70,50,50
1650873414348,CSE 134B,A01,083661,Powell; Thomas Allan,0,38,65,65
1650873420374,CSE 140,A01,083663,Staff,0,12,75,75
1650873426402,CSE 140L,A01,083088,Eldon; John,0,20,75,75
1650873432425,CSE 175,A01,083665,Kumar; Rakesh,7,0,25,18
1650873438452,CSE 190,A00,092507,Dubnov; Shlomo,9,0,20,11
1650873444475,ECE 45,A01,083139,Staff,0,4,60,60
1650873450499,ECE 65,A50,083695,Staff,0,5,30,30
1650873456524,ECE 109,A01,091882,Touri; Behrouz,32,0,70,38
1650873462545,ECE 180,A00,083140,Abi Samra; Nicholas Camill,20,0,30,10
1650873462545,ECE 180,B00,083141,Abi Samra; Nicholas Camill,0,0,30,30
1650873468568,MATH 10A,A01,083735,Patchell; Gregory David,2,0,30,28
1650873468568,MATH 10A,A02,083736,Patchell; Gregory David,27,0,30,3
1650873468568,MATH 10A,A03,083737,Patchell; Gregory David,23,0,30,7
1650873474596,MATH 10B,A01,083207,Staff,0,9,30,30
1650873474596,MATH 10B,A02,083208,Staff,0,6,30,30
1650873474596,MATH 10B,B01,083739,Staff,10,0,30,20
1650873474596,MATH 10B,B02,083740,Staff,28,0,30,2
1650873480622,MATH 18,A01,083743,Staff,0,0,30,30
1650873480622,MATH 18,A02,083744,Staff,24,0,30,6
1650873480622,MATH 18,A03,083745,Staff,21,0,30,9
1650873480622,MATH 18,A04,083746,Staff,26,0,30,4
1650873480622,MATH 18,B01,083748,Staff,0,15,30,30
1650873480622,MATH 18,B02,083749,Staff,0,13,30,30
1650873480622,MATH 18,B03,083750,Staff,0,13,30,30
1650873480622,MATH 18,B04,083751,Staff,0,13,30,30
1650873486644,MATH 20A,A01,083754,Staff,19,0,40,21
1650873492669,MATH 20B,A01,083756,Staff,0,14,30,30
1650873492669,MATH 20B,A02,083757,Staff,0,11,30,30
1650873498693,MATH 20C,A01,083760,Staff,0,17,30,30
1650873498693,MATH 20C,A02,083761,Staff,1,16,30,29
1650873498693,MATH 20C,B01,083762,Staff,9,0,30,21
1650873498693,MATH 20C,B02,083763,Staff,28,0,30,2
1650873504722,MATH 20D,A01,083765,Staff,2,1,30,28
1650873504722,MATH 20D,A02,083766,Staff,6,0,30,24
1650873504722,MATH 20D,A03,083767,Staff,23,0,30,7
1650873510766,MATH 20E,A01,083771,Staff,2,0,30,28
1650873510766,MATH 20E,A02,083772,Staff,13,0,30,17
1650873510766,MATH 20E,B01,083773,Staff,0,0,30,30
1650873510766,MATH 20E,B02,083774,Staff,4,0,30,26
1650873516794,MATH 103A,A01,083777,Staff,0,17,30,30
1650873516794,MATH 103A,A02,083778,Staff,0,15,30,30
1650873516794,MATH 103A,B01,083779,Staff,0,15,30,30
1650873516794,MATH 103A,B02,083780,Staff,0,14,30,30
1650873522822,MATH 105,A01,085443,Staff,0,23,30,30
1650873528846,MATH 109,A01,083213,Anzaldo; Leesa B,0,7,30,30
1650873528846,MATH 109,A02,083214,Anzaldo; Leesa B,0,7,30,30
1650873528846,MATH 109,B01,083215,Anzaldo; Leesa B,0,8,30,30
1650873528846,MATH 109,B02,083216,Anzaldo; Leesa B,0,7,30,30
1650873534869,MATH 142A,A01,083219,Chow; Bennett,0,14,30,30
1650873534869,MATH 142A,A02,083220,Chow; Bennett,0,15,30,30
1650873534869,MATH 142A,B01,083221,Chow; Bennett,0,16,30,30
1650873534869,MATH 142A,B02,083222,Chow; Bennett,0,14,30,30
1650873540893,MATH 193A,A01,083224,Staff,0,6,30,30
1650873540893,MATH 193A,A02,083225,Staff,0,7,30,30
1650873540893,MATH 193A,A03,083781,Staff,0,6,30,30
1650873540893,MATH 193A,A04,083782,Staff,0,7,30,30
1650873546917,MATH 197,001,091859,McAuley; Julian John,9998,0,9999,1
1650873552986,COGS 9,A01,083615,Staff,0,17,60,60
1650873559013,COGS 11,A01,083617,Boyle; Mary E. T.,15,0,40,25
1650873565037,COGS 13,A01,083071,Staff,0,38,40,40
1650873571059,COGS 14A,A01,092681,Staff,0,37,100,100
1650873577082,COGS 14B,A01,083073,Cheng; Tzu-Han,0,12,50,50
1650873583105,COGS 17,A01,092677,Staff,12,0,75,63
1650873589127,COGS 100,A01,083619,Staff,0,30,60,60
1650873595153,COGS 101A,A01,083621,Davis; Joshua Daniel,0,29,60,60
1650873601180,COGS 101B,A01,091572,Staff,0,3,60,60
1650873607212,COGS 101C,A01,083625,Delgado; Tania,14,0,30,16
1650873613237,COGS 107A,A01,083627,Boyle; Mary E. T.,0,16,60,60
1650873619259,COGS 118A,A01,083075,Staff,0,8,60,60
1650873625287,CSE 3,A50,083646,Miranda; Gregory Joseph,17,0,38,21
1650873625287,CSE 3,A51,083647,Miranda; Gregory Joseph,36,0,37,1
1650873631316,CSE 8A,A50,083650,Miranda; Gregory Joseph,0,29,40,40
1650873637344,CSE 11,A01,083080,Cao; Yingjun,0,97,40,40
1650873643368,CSE 12,A01,083652,Staff,0,21,100,100
1650873649393,CSE 15L,A01,083654,Staff,0,3,50,50
1650873649393,CSE 15L,A02,083655,Staff,0,3,50,50
1650873655416,CSE 20,A01,083657,Staff,48,0,80,32
1650873661446,CSE 30,A01,083084,Eldon; John,0,76,40,40
1650873667472,CSE 100,A01,083659,Cao; Yingjun,0,70,50,50
1650873673499,CSE 134B,A01,083661,Powell; Thomas Allan,0,38,65,65
1650873679522,CSE 140,A01,083663,Staff,0,12,75,75
1650873685550,CSE 140L,A01,083088,Eldon; John,0,20,75,75
1650873691574,CSE 175,A01,083665,Kumar; Rakesh,7,0,25,18
1650873697605,CSE 190,A00,092507,Dubnov; Shlomo,9,0,20,11
1650873703626,ECE 45,A01,083139,Staff,0,4,60,60
1650873709654,ECE 65,A50,083695,Staff,0,5,30,30
1650873715677,ECE 109,A01,091882,Touri; Behrouz,32,0,70,38
1650873721701,ECE 180,A00,083140,Abi Samra; Nicholas Camill,20,0,30,10
1650873721701,ECE 180,B00,083141,Abi Samra; Nicholas Camill,0,0,30,30
1650873727730,MATH 10A,A01,083735,Patchell; Gregory David,2,0,30,28
1650873727730,MATH 10A,A02,083736,Patchell; Gregory David,27,0,30,3
1650873727730,MATH 10A,A03,083737,Patchell; Gregory David,23,0,30,7
1650873733754,MATH 10B,A01,083207,Staff,0,9,30,30
1650873733754,MATH 10B,A02,083208,Staff,0,6,30,30
1650873733754,MATH 10B,B01,083739,Staff,10,0,30,20
1650873733754,MATH 10B,B02,083740,Staff,28,0,30,2
1650873739786,MATH 18,A01,083743,Staff,0,0,30,30
1650873739786,MATH 18,A02,083744,Staff,24,0,30,6
1650873739786,MATH 18,A03,083745,Staff,21,0,30,9
1650873739786,MATH 18,A04,083746,Staff,26,0,30,4
1650873739786,MATH 18,B01,083748,Staff,0,15,30,30
1650873739786,MATH 18,B02,083749,Staff,0,13,30,30
1650873739786,MATH 18,B03,083750,Staff,0,13,30,30
1650873739786,MATH 18,B04,083751,Staff,0,13,30,30
1650873745811,MATH 20A,A01,083754,Staff,19,0,40,21
1650873751837,MATH 20B,A01,083756,Staff,0,14,30,30
1650873751837,MATH 20B,A02,083757,Staff,0,11,30,30
1650873757863,MATH 20C,A01,083760,Staff,0,17,30,30
1650873757863,MATH 20C,A02,083761,Staff,1,16,30,29
1650873757863,MATH 20C,B01,083762,Staff,9,0,30,21
1650873757863,MATH 20C,B02,083763,Staff,28,0,30,2
1650873763887,MATH 20D,A01,083765,Staff,2,1,30,28
1650873763887,MATH 20D,A02,083766,Staff,6,0,30,24
1650873763887,MATH 20D,A03,083767,Staff,23,0,30,7
1650873769911,MATH 20E,A01,083771,Staff,2,0,30,28
1650873769911,MATH 20E,A02,083772,Staff,13,0,30,17
1650873769911,MATH 20E,B01,083773,Staff,0,0,30,30
1650873769911,MATH 20E,B02,083774,Staff,4,0,30,26
1650873775947,MATH 103A,A01,083777,Staff,0,17,30,30
1650873775947,MATH 103A,A02,083778,Staff,0,15,30,30
1650873775947,MATH 103A,B01,083779,Staff,0,15,30,30
1650873775947,MATH 103A,B02,083780,Staff,0,14,30,30
1650873781975,MATH 105,A01,085443,Staff,0,23,30,30
1650873787998,MATH 109,A01,083213,Anzaldo; Leesa B,0,7,30,30
1650873787998,MATH 109,A02,083214,Anzaldo; Leesa B,0,7,30,30
1650873787998,MATH 109,B01,083215,Anzaldo; Leesa B,0,8,30,30
1650873787998,MATH 109,B02,083216,Anzaldo; Leesa B,0,7,30,30
1650873794025,MATH 142A,A01,083219,Chow; Bennett,0,14,30,30
1650873794025,MATH 142A,A02,083220,Chow; Bennett,0,15,30,30
1650873794025,MATH 142A,B01,083221,Chow; Bennett,0,16,30,30
1650873794025,MATH 142A,B02,083222,Chow; Bennett,0,14,30,30
1650873800048,MATH 193A,A01,083224,Staff,0,6,30,30
1650873800048,MATH 193A,A02,083225,Staff,0,7,30,30
1650873800048,MATH 193A,A03,083781,Staff,0,6,30,30
1650873800048,MATH 193A,A04,083782,Staff,0,7,30,30
1650873806072,MATH 197,001,091859,McAuley; Julian John,9998,0,9999,1
1650873812123,COGS 9,A01,083615,Staff,0,17,60,60
1650873818152,COGS 11,A01,083617,Boyle; Mary E. T.,15,0,40,25
1650873824176,COGS 13,A01,083071,Staff,0,38,40,40
1650873830201,COGS 14A,A01,092681,Staff,0,37,100,100
1650873836225,COGS 14B,A01,083073,Cheng; Tzu-Han,0,12,50,50
1650873842251,COGS 17,A01,092677,Staff,12,0,75,63
1650873848362,COGS 100,A01,083619,Staff,0,30,60,60
1650873854386,COGS 101A,A01,083621,Davis; Joshua Daniel,0,29,60,60
1650873860409,COGS 101B,A01,091572,Staff,0,3,60,60
1650873866432,COGS 101C,A01,083625,Delgado; Tania,14,0,30,16
1650873872467,COGS 107A,A01,083627,Boyle; Mary E. T.,0,16,60,60
1650873878493,COGS 118A,A01,083075,Staff,0,8,60,60
1650873884519,CSE 3,A50,083646,Miranda; Gregory Joseph,17,0,38,21
1650873884519,CSE 3,A51,083647,Miranda; Gregory Joseph,36,0,37,1
1650873890546,CSE 8A,A50,083650,Miranda; Gregory Joseph,0,29,40,40
1650873896573,CSE 11,A01,083080,Cao; Yingjun,0,97,40,40
1650873902600,CSE 12,A01,083652,Staff,0,21,100,100
1650873908627,CSE 15L,A01,083654,Staff,0,3,50,50
1650873908627,CSE 15L,A02,083655,Staff,0,3,50,50
1650873914650,CSE 20,A01,083657,Staff,48,0,80,32
1650873920674,CSE 30,A01,083084,Eldon; John,0,76,40,40
1650873926698,CSE 100,A01,083659,Cao; Yingjun,0,70,50,50
1650873932740,CSE 134B,A01,083661,Powell; Thomas Allan,0,38,65,65
1650873938762,CSE 140,A01,083663,Staff,0,12,75,75
1650873944791,CSE 140L,A01,083088,Eldon; John,0,20,75,75
1650873950817,CSE 175,A01,083665,Kumar; Rakesh,7,0,25,18
1650873956844,CSE 190,A00,092507,Dubnov; Shlomo,9,0,20,11
1650873962867,ECE 45,A01,083139,Staff,0,4,60,60
1650873968895,ECE 65,A50,083695,Staff,0,5,30,30
1650873974924,ECE 109,A01,091882,Touri; Behrouz,32,0,70,38
1650873980950,ECE 180,A00,083140,Abi Samra; Nicholas Camill,20,0,30,10
1650873980950,ECE 180,B00,083141,Abi Samra; Nicholas Camill,0,0,30,30
1650873986978,MATH 10A,A01,083735,Patchell; Gregory David,2,0,30,28
1650873986978,MATH 10A,A02,083736,Patchell; Gregory David,27,0,30,3
1650873986978,MATH 10A,A03,083737,Patchell; Gregory David,23,0,30,7
1650873993001,MATH 10B,A01,083207,Staff,0,9,30,30
1650873993001,MATH 10B,A02,083208,Staff,0,6,30,30
1650873993001,MATH 10B,B01,083739,Staff,10,0,30,20
1650873993001,MATH 10B,B02,083740,Staff,28,0,30,2
1650873999025,MATH 18,A01,083743,Staff,0,0,30,30
1650873999025,MATH 18,A02,083744,Staff,24,0,30,6
1650873999025,MATH 18,A03,083745,Staff,21,0,30,9
1650873999025,MATH 18,A04,083746,Staff,26,0,30,4
1650873999025,MATH 18,B01,083748,Staff,0,15,30,30
1650873999025,MATH 18,B02,083749,Staff,0,13,30,30
1650873999025,MATH 18,B03,083750,Staff,0,13,30,30
1650873999025,MATH 18,B04,083751,Staff,0,13,30,30
1650874005051,MATH 20A,A01,083754,Staff,19,0,40,21
1650874011078,MATH 20B,A01,083756,Staff,0,14,30,30
1650874011078,MATH 20B,A02,083757,Staff,0,11,30,30
1650874017101,MATH 20C,A01,083760,Staff,0,17,30,30
1650874017101,MATH 20C,A02,083761,Staff,1,16,30,29
1650874017101,MATH 20C,B01,083762,Staff,9,0,30,21
1650874017101,MATH 20C,B02,083763,Staff,28,0,30,2
1650874023129,MATH 20D,A01,083765,Staff,2,1,30,28
1650874023129,MATH 20D,A02,083766,Staff,6,0,30,24
1650874023129,MATH 20D,A03,083767,Staff,23,0,30,7
1650874029151,MATH 20E,A01,083771,Staff,2,0,30,28
1650874029151,MATH 20E,A02,083772,Staff,13,0,30,17
1650874029151,MATH 20E,B01,083773,Staff,0,0,30,30
1650874029151,MATH 20E,B02,083774,Staff,4,0,30,26
1650874035182,MATH 103A,A01,083777,Staff,0,17,30,30
1650874035182,MATH 103A,A02,083778,Staff,0,15,30,30
1650874035182,MATH 103A,B01,083779,Staff,0,15,30,30
1650874035182,MATH 103A,B02,083780,Staff,0,14,30,30
1650874041209,MATH 105,A01,085443,Staff,0,23,30,30
1650874047236,MATH 109,A01,083213,Anzaldo; Leesa B,0,7,30,30
1650874047236,MATH 109,A02,083214,Anzaldo; Leesa B,0,7,30,30
1650874047236,MATH 109,B01,083215,Anzaldo; Leesa B,0,8,30,30
1650874047236,MATH 109,B02,083216,Anzaldo; Leesa B,0,7,30,30
1650874053260,MATH 142A,A01,083219,Chow; Bennett,0,14,30,30
1650874053260,MATH 142A,A02,083220,Chow; Bennett,0,15,30,30
1650874053260,MATH 142A,B01,083221,Chow; Bennett,0,16,30,30
1650874053260,MATH 142A,B02,083222,Chow; Bennett,0,14,30,30
1650874059281,MATH 193A,A01,083224,Staff,0,6,30,30
1650874059281,MATH 193A,A02,083225,Staff,0,7,30,30
1650874059281,MATH 193A,A03,083781,Staff,0,6,30,30
1650874059281,MATH 193A,A04,083782,Staff,0,7,30,30
1650874065303,MATH 197,001,091859,McAuley; Julian John,9998,0,9999,1
1650874071367,COGS 9,A01,083615,Staff,0,17,60,60
1650874077398,COGS 11,A01,083617,Boyle; Mary E. T.,15,0,40,25
1650874083427,COGS 13,A01,083071,Staff,0,38,40,40
1650874089450,COGS 14A,A01,092681,Staff,0,37,100,100
1650874095477,COGS 14B,A01,083073,Cheng; Tzu-Han,0,12,50,50
1650874101506,COGS 17,A01,092677,Staff,12,0,75,63
1650874107530,COGS 100,A01,083619,Staff,0,30,60,60
1650874113557,COGS 101A,A01,083621,Davis; Joshua Daniel,0,29,60,60
1650874119583,COGS 101B,A01,091572,Staff,0,3,60,60
1650874125608,COGS 101C,A01,083625,Delgado; Tania,14,0,30,16
1650874131638,COGS 107A,A01,083627,Boyle; Mary E. T.,0,16,60,60
1650874137665,COGS 118A,A01,083075,Staff,0,8,60,60
1650874143693,CSE 3,A50,083646,Miranda; Gregory Joseph,17,0,38,21
1650874143693,CSE 3,A51,083647,Miranda; Gregory Joseph,36,0,37,1
1650874149720,CSE 8A,A50,083650,Miranda; Gregory Joseph,0,29,40,40
1650874155753,CSE 11,A01,083080,Cao; Yingjun,0,97,40,40
1650874161780,CSE 12,A01,083652,Staff,0,21,100,100
1650874167804,CSE 15L,A01,083654,Staff,0,3,50,50
1650874167804,CSE 15L,A02,083655,Staff,0,3,50,50
1650874173830,CSE 20,A01,083657,Staff,48,0,80,32
1650874179852,CSE 30,A01,083084,Eldon; John,0,76,40,40
1650874185876,CSE 100,A01,083659,Cao; Yingjun,0,70,50,50
1650874191901,CSE 134B,A01,083661,Powell; Thomas Allan,0,38,65,65
1650874197927,CSE 140,A01,083663,Staff,0,12,75,75
1650874203953,CSE 140L,A01,083088,Eldon; John,0,20,75,75
1650874209976,CSE 175,A01,083665,Kumar; Rakesh,7,0,25,18
1650874216002,CSE 190,A00,092507,Dubnov; Shlomo,9,0,20,11
1650874222029,ECE 45,A01,083139,Staff,0,4,60,60
1650874228054,ECE 65,A50,083695,Staff,0,5,30,30
1650874234077,ECE 109,A01,091882,Touri; Behrouz,32,0,70,38
1650874240104,ECE 180,A00,083140,Abi Samra; Nicholas Camill,20,0,30,10
1650874240104,ECE 180,B00,083141,Abi Samra; Nicholas Camill,0,0,30,30
1650874246128,MATH 10A,A01,083735,Patchell; Gregory David,2,0,30,28
1650874246128,MATH 10A,A02,083736,Patchell; Gregory David,27,0,30,3
1650874246128,MATH 10A,A03,083737,Patchell; Gregory David,23,0,30,7
1650874252156,MATH 10B,A01,083207,Staff,0,9,30,30
1650874252156,MATH 10B,A02,083208,Staff,0,6,30,30
1650874252156,MATH 10B,B01,083739,Staff,10,0,30,20
1650874252156,MATH 10B,B02,083740,Staff,28,0,30,2
1650874258181,MATH 18,A01,083743,Staff,0,0,30,30
1650874258181,MATH 18,A02,083744,Staff,24,0,30,6
1650874258181,MATH 18,A03,083745,Staff,21,0,30,9
1650874258181,MATH 18,A04,083746,Staff,26,0,30,4
1650874258181,MATH 18,B01,083748,Staff,0,15,30,30
1650874258181,MATH 18,B02,083749,Staff,0,13,30,30
1650874258181,MATH 18,B03,083750,Staff,0,13,30,30
1650874258181,MATH 18,B04,083751,Staff,0,13,30,30
1650874264212,MATH 20A,A01,083754,Staff,19,0,40,21
1650874270239,MATH 20B,A01,083756,Staff,0,14,30,30
1650874270239,MATH 20B,A02,083757,Staff,0,11,30,30
1650874276273,MATH 20C,A01,083760,Staff,0,17,30,30
1650874276273,MATH 20C,A02,083761,Staff,1,16,30,29
1650874276273,MATH 20C,B01,083762,Staff,9,0,30,21
1650874276273,MATH 20C,B02,083763,Staff,28,0,30,2
1650874282302,MATH 20D,A01,083765,Staff,2,1,30,28
1650874282302,MATH 20D,A02,083766,Staff,6,0,30,24
1650874282302,MATH 20D,A03,083767,Staff,23,0,30,7
1650874288328,MATH 20E,A01,083771,Staff,2,0,30,28
1650874288328,MATH 20E,A02,083772,Staff,13,0,30,17
1650874288328,MATH 20E,B01,083773,Staff,0,0,30,30
1650874288328,MATH 20E,B02,083774,Staff,4,0,30,26
1650874294360,MATH 103A,A01,083777,Staff,0,17,30,30
1650874294360,MATH 103A,A02,083778,Staff,0,15,30,30
1650874294360,MATH 103A,B01,083779,Staff,0,15,30,30
1650874294360,MATH 103A,B02,083780,Staff,0,14,30,30
1650874300385,MATH 105,A01,085443,Staff,0,23,30,30
1650874306414,MATH 109,A01,083213,Anzaldo; Leesa B,0,7,30,30
1650874306414,MATH 109,A02,083214,Anzaldo; Leesa B,0,7,30,30
1650874306414,MATH 109,B01,083215,Anzaldo; Leesa B,0,8,30,30
1650874306414,MATH 109,B02,083216,Anzaldo; Leesa B,0,7,30,30
1650874312442,MATH 142A,A01,083219,Chow; Bennett,0,14,30,30
1650874312442,MATH 142A,A02,083220,Chow; Bennett,0,15,30,30
1650874312442,MATH 142A,B01,083221,Chow; Bennett,0,16,30,30
1650874312442,MATH 142A,B02,083222,Chow; Bennett,0,14,30,30
1650874318466,MATH 193A,A01,083224,Staff,0,6,30,30
1650874318466,MATH 193A,A02,083225,Staff,0,7,30,30
1650874318466,MATH 193A,A03,083781,Staff,0,6,30,30
1650874318466,MATH 193A,A04,083782,Staff,0,7,30,30
1650874324490,MATH 197,001,091859,McAuley; Julian John,9998,0,9999,1
1650874330550,COGS 9,A01,083615,Staff,0,17,60,60
1650874336575,COGS 11,A01,083617,Boyle; Mary E. T.,15,0,40,25
1650874342602,COGS 13,A01,083071,Staff,0,38,40,40
1650874348635,COGS 14A,A01,092681,Staff,0,37,100,100
1650874354660,COGS 14B,A01,083073,Cheng; Tzu-Han,0,12,50,50
1650874360695,COGS 17,A01,092677,Staff,12,0,75,63
1650874366719,COGS 100,A01,083619,Staff,0,30,60,60
1650874372743,COGS 101A,A01,083621,Davis; Joshua Daniel,0,29,60,60
1650874378769,COGS 101B,A01,091572,Staff,0,3,60,60
1650874384800,COGS 101C,A01,083625,Delgado; Tania,14,0,30,16
1650874390831,COGS 107A,A01,083627,Boyle; Mary E. T.,0,16,60,60
1650874396856,COGS 118A,A01,083075,Staff,0,8,60,60
1650874402883,CSE 3,A50,083646,Miranda; Gregory Joseph,17,0,38,21
1650874402883,CSE 3,A51,083647,Miranda; Gregory Joseph,36,0,37,1
1650874408920,CSE 8A,A50,083650,Miranda; Gregory Joseph,0,29,40,40
1650874414943,CSE 11,A01,083080,Cao; Yingjun,0,97,40,40
1650874420969,CSE 12,A01,083652,Staff,0,21,100,100
1650874427000,CSE 15L,A01,083654,Staff,0,3,50,50
1650874427000,CSE 15L,A02,083655,Staff,0,3,50,50
1650874433028,CSE 20,A01,083657,Staff,48,0,80,32
1650874439050,CSE 30,A01,083084,Eldon; John,0,76,40,40
1650874445169,CSE 100,A01,083659,Cao; Yingjun,0,70,50,50
1650874451195,CSE 134B,A01,083661,Powell; Thomas Allan,0,38,65,65
1650874457218,CSE 140,A01,083663,Staff,0,12,75,75
1650874463242,CSE 140L,A01,083088,Eldon; John,0,20,75,75
1650874469266,CSE 175,A01,083665,Kumar; Rakesh,7,0,25,18
1650874475290,CSE 190,A00,092507,Dubnov; Shlomo,9,0,20,11
1650874481318,ECE 45,A01,083139,Staff,0,4,60,60
1650874487346,ECE 65,A50,083695,Staff,0,5,30,30
1650874493371,ECE 109,A01,091882,Touri; Behrouz,32,0,70,38
1650874499397,ECE 180,A00,083140,Abi Samra; Nicholas Camill,20,0,30,10
1650874499397,ECE 180,B00,083141,Abi Samra; Nicholas Camill,0,0,30,30
1650874505424,MATH 10A,A01,083735,Patchell; Gregory David,2,0,30,28
1650874505424,MATH 10A,A02,083736,Patchell; Gregory David,27,0,30,3
1650874505424,MATH 10A,A03,083737,Patchell; Gregory David,23,0,30,7
1650874511451,MATH 10B,A01,083207,Staff,0,9,30,30
1650874511451,MATH 10B,A02,083208,Staff,0,6,30,30
1650874511451,MATH 10B,B01,083739,Staff,10,0,30,20
1650874511451,MATH 10B,B02,083740,Staff,28,0,30,2
1650874517479,MATH 18,A01,083743,Staff,0,0,30,30
1650874517479,MATH 18,A02,083744,Staff,24,0,30,6
1650874517479,MATH 18,A03,083745,Staff,21,0,30,9
1650874517479,MATH 18,A04,083746,Staff,26,0,30,4
1650874517479,MATH 18,B01,083748,Staff,0,15,30,30
1650874517479,MATH 18,B02,083749,Staff,0,13,30,30
1650874517479,MATH 18,B03,083750,Staff,0,13,30,30
1650874517479,MATH 18,B04,083751,Staff,0,13,30,30
1650874523508,MATH 20A,A01,083754,Staff,19,0,40,21
1650874529534,MATH 20B,A01,083756,Staff,0,14,30,30
1650874529534,MATH 20B,A02,083757,Staff,0,11,30,30
1650874535560,MATH 20C,A01,083760,Staff,0,17,30,30
1650874535560,MATH 20C,A02,083761,Staff,1,16,30,29
1650874535560,MATH 20C,B01,083762,Staff,9,0,30,21
1650874535560,MATH 20C,B02,083763,Staff,28,0,30,2
1650874541587,MATH 20D,A01,083765,Staff,2,1,30,28
1650874541587,MATH 20D,A02,083766,Staff,6,0,30,24
1650874541587,MATH 20D,A03,083767,Staff,23,0,30,7
1650874547611,MATH 20E,A01,083771,Staff,2,0,30,28
1650874547611,MATH 20E,A02,083772,Staff,13,0,30,17
1650874547611,MATH 20E,B01,083773,Staff,0,0,30,30
1650874547611,MATH 20E,B02,083774,Staff,4,0,30,26
1650874553645,MATH 103A,A01,083777,Staff,0,17,30,30
1650874553645,MATH 103A,A02,083778,Staff,0,15,30,30
1650874553645,MATH 103A,B01,083779,Staff,0,15,30,30
1650874553645,MATH 103A,B02,083780,Staff,0,14,30,30
1650874559668,MATH 105,A01,085443,Staff,0,23,30,30
1650874565691,MATH 109,A01,083213,Anzaldo; Leesa B,0,7,30,30
1650874565691,MATH 109,A02,083214,Anzaldo; Leesa B,0,7,30,30
1650874565691,MATH 109,B01,083215,Anzaldo; Leesa B,0,8,30,30
1650874565691,MATH 109,B02,083216,Anzaldo; Leesa B,0,7,30,30
1650874571721,MATH 142A,A01,083219,Chow; Bennett,0,14,30,30
1650874571721,MATH 142A,A02,083220,Chow; Bennett,0,15,30,30
1650874571721,MATH 142A,B01,083221,Chow; Bennett,0,16,30,30
1650874571721,MATH 142A,B02,083222,Chow; Bennett,0,14,30,30
1650874577755,MATH 193A,A01,083224,Staff,0,6,30,30
1650874577755,MATH 193A,A02,083225,Staff,0,7,30,30
1650874577755,MATH 193A,A03,083781,Staff,0,6,30,30
1650874577755,MATH 193A,A04,083782,Staff,0,7,30,30
1650874583780,MATH 197,001,091859,McAuley; Julian John,9998,0,9999,1
1650874589832,COGS 9,A01,083615,Staff,0,17,60,60
1650874595855,COGS 11,A01,083617,Boyle; Mary E. T.,15,0,40,25
1650874601882,COGS 13,A01,083071,Staff,0,38,40,40
1650874607909,COGS 14A,A01,092681,Staff,0,37,100,100
1650874613935,COGS 14B,A01,083073,Cheng; Tzu-Han,0,12,50,50
1650874619959,COGS 17,A01,092677,Staff,12,0,75,63
1650874625983,COGS 100,A01,083619,Staff,0,30,60,60
1650874632011,COGS 101A,A01,083621,Davis; Joshua Daniel,0,29,60,60
1650874638038,COGS 101B,A01,091572,Staff,0,3,60,60
1650874644060,COGS 101C,A01,083625,Delgado; Tania,14,0,30,16
1650874650085,COGS 107A,A01,083627,Boyle; Mary E. T.,0,16,60,60
1650874656109,COGS 118A,A01,083075,Staff,0,8,60,60
1650874662138,CSE 3,A50,083646,Miranda; Gregory Joseph,16,0,38,22
1650874662138,CSE 3,A51,083647,Miranda; Gregory Joseph,36,0,37,1
1650874668166,CSE 8A,A50,083650,Miranda; Gregory Joseph,0,29,40,40
1650874674190,CSE 11,A01,083080,Cao; Yingjun,0,97,40,40
1650874680213,CSE 12,A01,083652,Staff,0,21,100,100
1650874686240,CSE 15L,A01,083654,Staff,0,3,50,50
1650874686240,CSE 15L,A02,083655,Staff,0,3,50,50
1650874692266,CSE 20,A01,083657,Staff,48,0,80,32
1650874698289,CSE 30,A01,083084,Eldon; John,0,76,40,40
1650874704313,CSE 100,A01,083659,Cao; Yingjun,0,70,50,50
1650874710340,CSE 134B,A01,083661,Powell; Thomas Allan,0,38,65,65
1650874716365,CSE 140,A01,083663,Staff,0,12,75,75
1650874722389,CSE 140L,A01,083088,Eldon; John,0,20,75,75
1650874728413,CSE 175,A01,083665,Kumar; Rakesh,7,0,25,18
1650874734438,CSE 190,A00,092507,Dubnov; Shlomo,9,0,20,11
1650874740466,ECE 45,A01,083139,Staff,0,4,60,60
1650874746493,ECE 65,A50,083695,Staff,0,5,30,30
1650874752517,ECE 109,A01,091882,Touri; Behrouz,32,0,70,38
1650874758553,ECE 180,A00,083140,Abi Samra; Nicholas Camill,20,0,30,10
1650874758553,ECE 180,B00,083141,Abi Samra; Nicholas Camill,0,0,30,30
1650874764580,MATH 10A,A01,083735,Patchell; Gregory David,2,0,30,28
1650874764580,MATH 10A,A02,083736,Patchell; Gregory David,27,0,30,3
1650874764580,MATH 10A,A03,083737,Patchell; Gregory David,23,0,30,7
1650874770608,MATH 10B,A01,083207,Staff,0,9,30,30
1650874770608,MATH 10B,A02,083208,Staff,0,6,30,30
1650874770608,MATH 10B,B01,083739,Staff,10,0,30,20
1650874770608,MATH 10B,B02,083740,Staff,28,0,30,2
1650874776636,MATH 18,A01,083743,Staff,0,0,30,30
1650874776636,MATH 18,A02,083744,Staff,24,0,30,6
1650874776636,MATH 18,A03,083745,Staff,21,0,30,9
1650874776636,MATH 18,A04,083746,Staff,26,0,30,4
1650874776636,MATH 18,B01,083748,Staff,0,15,30,30
1650874776636,MATH 18,B02,083749,Staff,0,13,30,30
1650874776636,MATH 18,B03,083750,Staff,0,13,30,30
1650874776636,MATH 18,B04,083751,Staff,0,13,30,30
1650874782660,MATH 20A,A01,083754,Staff,19,0,40,21
1650874788685,MATH 20B,A01,083756,Staff,0,14,30,30
1650874788685,MATH 20B,A02,083757,Staff,0,11,30,30
1650874794712,MATH 20C,A01,083760,Staff,0,17,30,30
1650874794712,MATH 20C,A02,083761,Staff,1,16,30,29
1650874794712,MATH 20C,B01,083762,Staff,9,0,30,21
1650874794712,MATH 20C,B02,083763,Staff,28,0,30,2
1650874800737,MATH 20D,A01,083765,Staff,2,1,30,28
1650874800737,MATH 20D,A02,083766,Staff,6,0,30,24
1650874800737,MATH 20D,A03,083767,Staff,23,0,30,7
1650874806766,MATH 20E,A01,083771,Staff,2,0,30,28
1650874806766,MATH 20E,A02,083772,Staff,13,0,30,17
1650874806766,MATH 20E,B01,083773,Staff,0,0,30,30
1650874806766,MATH 20E,B02,083774,Staff,4,0,30,26
1650874812794,MATH 103A,A01,083777,Staff,0,17,30,30
1650874812794,MATH 103A,A02,083778,Staff,0,15,30,30
1650874812794,MATH 103A,B01,083779,Staff,0,15,30,30
1650874812794,MATH 103A,B02,083780,Staff,0,14,30,30
1650874818819,MATH 105,A01,085443,Staff,0,23,30,30
1650874824847,MATH 109,A01,083213,Anzaldo; Leesa B,0,7,30,30
1650874824847,MATH 109,A02,083214,Anzaldo; Leesa B,0,7,30,30
1650874824847,MATH 109,B01,083215,Anzaldo; Leesa B,0,8,30,30
1650874824847,MATH 109,B02,083216,Anzaldo; Leesa B,0,7,30,30
1650874830876,MATH 142A,A01,083219,Chow; Bennett,0,14,30,30
1650874830876,MATH 142A,A02,083220,Chow; Bennett,0,15,30,30
1650874830876,MATH 142A,B01,083221,Chow; Bennett,0,16,30,30
1650874830876,MATH 142A,B02,083222,Chow; Bennett,0,14,30,30
1650874836903,MATH 193A,A01,083224,Staff,0,6,30,30
1650874836903,MATH 193A,A02,083225,Staff,0,7,30,30
1650874836903,MATH 193A,A03,083781,Staff,0,6,30,30
1650874836903,MATH 193A,A04,083782,Staff,0,7,30,30
1650874842926,MATH 197,001,091859,McAuley; Julian John,9998,0,9999,1
1650874848988,COGS 9,A01,083615,Staff,0,17,60,60
1650874855024,COGS 11,A01,083617,Boyle; Mary E. T.,15,0,40,25
1650874861048,COGS 13,A01,083071,Staff,0,38,40,40
1650874867075,COGS 14A,A01,092681,Staff,0,37,100,100
1650874873099,COGS 14B,A01,083073,Cheng; Tzu-Han,0,12,50,50
1650874879124,COGS 17,A01,092677,Staff,12,0,75,63
1650874885154,COGS 100,A01,083619,Staff,0,30,60,60
1650874891182,COGS 101A,A01,083621,Davis; Joshua Daniel,0,29,60,60
1650874897214,COGS 101B,A01,091572,Staff,0,3,60,60
1650874903244,COGS 101C,A01,083625,Delgado; Tania,14,0,30,16
1650874909273,COGS 107A,A01,083627,Boyle; Mary E. T.,0,16,60,60
1650874915304,COGS 118A,A01,083075,Staff,0,8,60,60
1650874921338,CSE 3,A50,083646,Miranda; Gregory Joseph,16,0,38,22
1650874921338,CSE 3,A51,083647,Miranda; Gregory Joseph,36,0,37,1
1650874927363,CSE 8A,A50,083650,Miranda; Gregory Joseph,0,29,40,40
1650874933390,CSE 11,A01,083080,Cao; Yingjun,0,97,40,40
1650874939414,CSE 12,A01,083652,Staff,0,21,100,100
1650874945446,CSE 15L,A01,083654,Staff,0,3,50,50
1650874945446,CSE 15L,A02,083655,Staff,0,3,50,50
1650874951473,CSE 20,A01,083657,Staff,48,0,80,32
1650874957499,CSE 30,A01,083084,Eldon; John,0,76,40,40
1650874963526,CSE 100,A01,083659,Cao; Yingjun,0,70,50,50
1650874969552,CSE 134B,A01,083661,Powell; Thomas Allan,0,38,65,65
1650874975580,CSE 140,A01,083663,Staff,0,12,75,75
1650874981617,CSE 140L,A01,083088,Eldon; John,0,20,75,75
1650874987642,CSE 175,A01,083665,Kumar; Rakesh,7,0,25,18
1650874993675,CSE 190,A00,092507,Dubnov; Shlomo,9,0,20,11
1650874999703,ECE 45,A01,083139,Staff,0,4,60,60
1650875005734,ECE 65,A50,083695,Staff,0,5,30,30
1650875011758,ECE 109,A01,091882,Touri; Behrouz,32,0,70,38
1650875017782,ECE 180,A00,083140,Abi Samra; Nicholas Camill,20,0,30,10
1650875017782,ECE 180,B00,083141,Abi Samra; Nicholas Camill,0,0,30,30
1650875023810,MATH 10A,A01,083735,Patchell; Gregory David,2,0,30,28
1650875023810,MATH 10A,A02,083736,Patchell; Gregory David,27,0,30,3
1650875023810,MATH 10A,A03,083737,Patchell; Gregory David,23,0,30,7
1650875029858,MATH 10B,A01,083207,Staff,0,9,30,30
1650875029858,MATH 10B,A02,083208,Staff,0,6,30,30
1650875029858,MATH 10B,B01,083739,Staff,10,0,30,20
1650875029858,MATH 10B,B02,083740,Staff,28,0,30,2
1650875035890,MATH 18,A01,083743,Staff,0,0,30,30
1650875035890,MATH 18,A02,083744,Staff,24,0,30,6
1650875035890,MATH 18,A03,083745,Staff,21,0,30,9
1650875035890,MATH 18,A04,083746,Staff,26,0,30,4
1650875035890,MATH 18,B01,083748,Staff,0,15,30,30
1650875035890,MATH 18,B02,083749,Staff,0,13,30,30
1650875035890,MATH 18,B03,083750,Staff,0,13,30,30
1650875035890,MATH 18,B04,083751,Staff,0,13,30,30
1650875042016,MATH 20A,A01,083754,Staff,19,0,40,21
1650875048045,MATH 20B,A01,083756,Staff,0,14,30,30
1650875048045,MATH 20B,A02,083757,Staff,0,11,30,30
1650875054078,MATH 20C,A01,083760,Staff,0,17,30,30
1650875054078,MATH 20C,A02,083761,Staff,1,16,30,29
1650875054078,MATH 20C,B01,083762,Staff,9,0,30,21
1650875054078,MATH 20C,B02,083763,Staff,28,0,30,2
1650875060106,MATH 20D,A01,083765,Staff,2,1,30,28
1650875060106,MATH 20D,A02,083766,Staff,6,0,30,24
1650875060106,MATH 20D,A03,083767,Staff,23,0,30,7
1650875066134,MATH 20E,A01,083771,Staff,2,0,30,28
1650875066134,MATH 20E,A02,083772,Staff,13,0,30,17
1650875066134,MATH 20E,B01,083773,Staff,0,0,30,30
1650875066134,MATH 20E,B02,083774,Staff,4,0,30,26
1650875072157,MATH 103A,A01,083777,Staff,0,17,30,30
1650875072157,MATH 103A,A02,083778,Staff,0,15,30,30
1650875072157,MATH 103A,B01,083779,Staff,0,15,30,30
1650875072157,MATH 103A,B02,083780,Staff,0,14,30,30
1650875078184,MATH 105,A01,085443,Staff,0,23,30,30
1650875084213,MATH 109,A01,083213,Anzaldo; Leesa B,0,7,30,30
1650875084213,MATH 109,A02,083214,Anzaldo; Leesa B,0,7,30,30
1650875084213,MATH 109,B01,083215,Anzaldo; Leesa B,0,8,30,30
1650875084213,MATH 109,B02,083216,Anzaldo; Leesa B,0,7,30,30
1650875090244,MATH 142A,A01,083219,Chow; Bennett,0,14,30,30
1650875090244,MATH 142A,A02,083220,Chow; Bennett,0,15,30,30
1650875090244,MATH 142A,B01,083221,Chow; Bennett,0,16,30,30
1650875090244,MATH 142A,B02,083222,Chow; Bennett,0,14,30,30
1650875096274,MATH 193A,A01,083224,Staff,0,6,30,30
1650875096274,MATH 193A,A02,083225,Staff,0,7,30,30
1650875096274,MATH 193A,A03,083781,Staff,0,6,30,30
1650875096274,MATH 193A,A04,083782,Staff,0,7,30,30
1650875102304,MATH 197,001,091859,McAuley; Julian John,9998,0,9999,1
1650875108361,COGS 9,A01,083615,Staff,0,17,60,60
1650875114388,COGS 11,A01,083617,Boyle; Mary E. T.,15,0,40,25
1650875120412,COGS 13,A01,083071,Staff,0,38,40,40
1650875126444,COGS 14A,A01,092681,Staff,0,37,100,100
1650875132470,COGS 14B,A01,083073,Cheng; Tzu-Han,0,12,50,50
1650875138492,COGS 17,A01,092677,Staff,12,0,75,63
1650875144522,COGS 100,A01,083619,Staff,0,30,60,60
1650875150545,COGS 101A,A01,083621,Davis; Joshua Daniel,0,29,60,60
1650875156566,COGS 101B,A01,091572,Staff,0,3,60,60
1650875162589,COGS 101C,A01,083625,Delgado; Tania,14,0,30,16
1650875168612,COGS 107A,A01,083627,Boyle; Mary E. T.,0,16,60,60
1650875174636,COGS 118A,A01,083075,Staff,0,8,60,60
1650875180673,CSE 3,A50,083646,Miranda; Gregory Joseph,16,0,38,22
1650875180673,CSE 3,A51,083647,Miranda; Gregory Joseph,36,0,37,1
1650875186700,CSE 8A,A50,083650,Miranda; Gregory Joseph,0,29,40,40
1650875192726,CSE 11,A01,083080,Cao; Yingjun,0,97,40,40
1650875198750,CSE 12,A01,083652,Staff,0,21,100,100
1650875204774,CSE 15L,A01,083654,Staff,0,3,50,50
1650875204774,CSE 15L,A02,083655,Staff,0,3,50,50
1650875210801,CSE 20,A01,083657,Staff,48,0,80,32
1650875216828,CSE 30,A01,083084,Eldon; John,0,76,40,40
1650875222853,CSE 100,A01,083659,Cao; Yingjun,0,70,50,50
1650875228879,CSE 134B,A01,083661,Powell; Thomas Allan,0,38,65,65
1650875234905,CSE 140,A01,083663,Staff,0,12,75,75
1650875240929,CSE 140L,A01,083088,Eldon; John,0,20,75,75
1650875246954,CSE 175,A01,083665,Kumar; Rakesh,7,0,25,18
1650875252983,CSE 190,A00,092507,Dubnov; Shlomo,9,0,20,11
1650875259010,ECE 45,A01,083139,Staff,0,4,60,60
1650875265035,ECE 65,A50,083695,Staff,0,5,30,30
1650875271058,ECE 109,A01,091882,Touri; Behrouz,32,0,70,38
1650875277083,ECE 180,A00,083140,Abi Samra; Nicholas Camill,20,0,30,10
1650875277083,ECE 180,B00,083141,Abi Samra; Nicholas Camill,0,0,30,30
1650875283111,MATH 10A,A01,083735,Patchell; Gregory David,2,0,30,28
1650875283111,MATH 10A,A02,083736,Patchell; Gregory David,27,0,30,3
1650875283111,MATH 10A,A03,083737,Patchell; Gregory David,23,0,30,7
1650875289134,MATH 10B,A01,083207,Staff,0,9,30,30
1650875289134,MATH 10B,A02,083208,Staff,0,6,30,30
1650875289134,MATH 10B,B01,083739,Staff,10,0,30,20
1650875289134,MATH 10B,B02,083740,Staff,28,0,30,2
1650875295159,MATH 18,A01,083743,Staff,0,0,30,30
1650875295159,MATH 18,A02,083744,Staff,24,0,30,6
1650875295159,MATH 18,A03,083745,Staff,21,0,30,9
1650875295159,MATH 18,A04,083746,Staff,26,0,30,4
1650875295159,MATH 18,B01,083748,Staff,0,15,30,30
1650875295159,MATH 18,B02,083749,Staff,0,13,30,30
1650875295159,MATH 18,B03,083750,Staff,0,13,30,30
1650875295159,MATH 18,B04,083751,Staff,0,13,30,30
1650875301183,MATH 20A,A01,083754,Staff,19,0,40,21
1650875307217,MATH 20B,A01,083756,Staff,0,14,30,30
1650875307217,MATH 20B,A02,083757,Staff,0,11,30,30
1650875313242,MATH 20C,A01,083760,Staff,0,17,30,30
1650875313242,MATH 20C,A02,083761,Staff,1,16,30,29
1650875313242,MATH 20C,B01,083762,Staff,9,0,30,21
1650875313242,MATH 20C,B02,083763,Staff,28,0,30,2
1650875319271,MATH 20D,A01,083765,Staff,2,1,30,28
1650875319271,MATH 20D,A02,083766,Staff,6,0,30,24
1650875319271,MATH 20D,A03,083767,Staff,23,0,30,7
1650875325300,MATH 20E,A01,083771,Staff,2,0,30,28
1650875325300,MATH 20E,A02,083772,Staff,13,0,30,17
1650875325300,MATH 20E,B01,083773,Staff,0,0,30,30
1650875325300,MATH 20E,B02,083774,Staff,4,0,30,26
1650875331331,MATH 103A,A01,083777,Staff,0,17,30,30
1650875331331,MATH 103A,A02,083778,Staff,0,15,30,30
1650875331331,MATH 103A,B01,083779,Staff,0,15,30,30
1650875331331,MATH 103A,B02,083780,Staff,0,14,30,30
1650875337358,MATH 105,A01,085443,Staff,0,23,30,30
1650875343381,MATH 109,A01,083213,Anzaldo; Leesa B,0,7,30,30
1650875343381,MATH 109,A02,083214,Anzaldo; Leesa B,0,7,30,30
1650875343381,MATH 109,B01,083215,Anzaldo; Leesa B,0,8,30,30
1650875343381,MATH 109,B02,083216,Anzaldo; Leesa B,0,7,30,30
1650875349404,MATH 142A,A01,083219,Chow; Bennett,0,14,30,30
1650875349404,MATH 142A,A02,083220,Chow; Bennett,0,15,30,30
1650875349404,MATH 142A,B01,083221,Chow; Bennett,0,16,30,30
1650875349404,MATH 142A,B02,083222,Chow; Bennett,0,14,30,30
1650875355428,MATH 193A,A01,083224,Staff,0,6,30,30
1650875355428,MATH 193A,A02,083225,Staff,0,7,30,30
1650875355428,MATH 193A,A03,083781,Staff,0,6,30,30
1650875355428,MATH 193A,A04,083782,Staff,0,7,30,30
1650875361453,MATH 197,001,091859,McAuley; Julian John,9998,0,9999,1
1650875367513,COGS 9,A01,083615,Staff,0,17,60,60
1650875373537,COGS 11,A01,083617,Boyle; Mary E. T.,15,0,40,25
1650875379559,COGS 13,A01,083071,Staff,0,38,40,40
1650875385581,COGS 14A,A01,092681,Staff,0,37,100,100
1650875391604,COGS 14B,A01,083073,Cheng; Tzu-Han,0,12,50,50
1650875397626,COGS 17,A01,092677,Staff,12,0,75,63
1650875403652,COGS 100,A01,083619,Staff,0,30,60,60
1650875409674,COGS 101A,A01,083621,Davis; Joshua Daniel,0,29,60,60
1650875415705,COGS 101B,A01,091572,Staff,0,3,60,60
1650875421732,COGS 101C,A01,083625,Delgado; Tania,14,0,30,16
1650875427760,COGS 107A,A01,083627,Boyle; Mary E. T.,0,16,60,60
1650875433782,COGS 118A,A01,083075,Staff,0,8,60,60
1650875439809,CSE 3,A50,083646,Miranda; Gregory Joseph,16,0,38,22
1650875439809,CSE 3,A51,083647,Miranda; Gregory Joseph,36,0,37,1
1650875445844,CSE 8A,A50,083650,Miranda; Gregory Joseph,0,29,40,40
1650875451884,CSE 11,A01,083080,Cao; Yingjun,0,97,40,40
1650875457909,CSE 12,A01,083652,Staff,0,21,100,100
1650875463935,CSE 15L,A01,083654,Staff,0,3,50,50
1650875463935,CSE 15L,A02,083655,Staff,0,3,50,50
1650875469964,CSE 20,A01,083657,Staff,48,0,80,32
1650875475994,CSE 30,A01,083084,Eldon; John,0,76,40,40
1650875482022,CSE 100,A01,083659,Cao; Yingjun,0,70,50,50
1650875488046,CSE 134B,A01,083661,Powell; Thomas Allan,0,38,65,65
1650875494077,CSE 140,A01,083663,Staff,0,12,75,75
1650875500117,CSE 140L,A01,083088,Eldon; John,0,20,75,75
1650875506140,CSE 175,A01,083665,Kumar; Rakesh,7,0,25,18
1650875512174,CSE 190,A00,092507,Dubnov; Shlomo,9,0,20,11
1650875518200,ECE 45,A01,083139,Staff,0,4,60,60
1650875524234,ECE 65,A50,083695,Staff,0,5,30,30
1650875530258,ECE 109,A01,091882,Touri; Behrouz,32,0,70,38
1650875536282,ECE 180,A00,083140,Abi Samra; Nicholas Camill,20,0,30,10
1650875536282,ECE 180,B00,083141,Abi Samra; Nicholas Camill,0,0,30,30
1650875542306,MATH 10A,A01,083735,Patchell; Gregory David,2,0,30,28
1650875542306,MATH 10A,A02,083736,Patchell; Gregory David,27,0,30,3
1650875542306,MATH 10A,A03,083737,Patchell; Gregory David,23,0,30,7
1650875548339,MATH 10B,A01,083207,Staff,0,9,30,30
1650875548339,MATH 10B,A02,083208,Staff,0,6,30,30
1650875548339,MATH 10B,B01,083739,Staff,10,0,30,20
1650875548339,MATH 10B,B02,083740,Staff,28,0,30,2
1650875554368,MATH 18,A01,083743,Staff,0,0,30,30
1650875554368,MATH 18,A02,083744,Staff,24,0,30,6
1650875554368,MATH 18,A03,083745,Staff,21,0,30,9
1650875554368,MATH 18,A04,083746,Staff,26,0,30,4
1650875554368,MATH 18,B01,083748,Staff,0,15,30,30
1650875554368,MATH 18,B02,083749,Staff,0,13,30,30
1650875554368,MATH 18,B03,083750,Staff,0,13,30,30
1650875554368,MATH 18,B04,083751,Staff,0,13,30,30
1650875560390,MATH 20A,A01,083754,Staff,19,0,40,21
1650875566416,MATH 20B,A01,083756,Staff,0,14,30,30
1650875566416,MATH 20B,A02,083757,Staff,0,11,30,30
1650875572442,MATH 20C,A01,083760,Staff,0,17,30,30
1650875572442,MATH 20C,A02,083761,Staff,1,16,30,29
1650875572442,MATH 20C,B01,083762,Staff,9,0,30,21
1650875572442,MATH 20C,B02,083763,Staff,28,0,30,2
1650875578466,MATH 20D,A01,083765,Staff,2,1,30,28
1650875578466,MATH 20D,A02,083766,Staff,6,0,30,24
1650875578466,MATH 20D,A03,083767,Staff,23,0,30,7
1650875584492,MATH 20E,A01,083771,Staff,2,0,30,28
1650875584492,MATH 20E,A02,083772,Staff,13,0,30,17
1650875584492,MATH 20E,B01,083773,Staff,0,0,30,30
1650875584492,MATH 20E,B02,083774,Staff,4,0,30,26
1650875590522,MATH 103A,A01,083777,Staff,0,17,30,30
1650875590522,MATH 103A,A02,083778,Staff,0,15,30,30
1650875590522,MATH 103A,B01,083779,Staff,0,15,30,30
1650875590522,MATH 103A,B02,083780,Staff,0,14,30,30
1650875596548,MATH 105,A01,085443,Staff,0,23,30,30
1650875602576,MATH 109,A01,083213,Anzaldo; Leesa B,0,7,30,30
1650875602576,MATH 109,A02,083214,Anzaldo; Leesa B,0,7,30,30
1650875602576,MATH 109,B01,083215,Anzaldo; Leesa B,0,8,30,30
1650875602576,MATH 109,B02,083216,Anzaldo; Leesa B,0,7,30,30
1650875608602,MATH 142A,A01,083219,Chow; Bennett,0,14,30,30
1650875608602,MATH 142A,A02,083220,Chow; Bennett,0,15,30,30
1650875608602,MATH 142A,B01,083221,Chow; Bennett,0,16,30,30
1650875608602,MATH 142A,B02,083222,Chow; Bennett,0,14,30,30
1650875614624,MATH 193A,A01,083224,Staff,0,6,30,30
1650875614624,MATH 193A,A02,083225,Staff,0,7,30,30
1650875614624,MATH 193A,A03,083781,Staff,0,6,30,30
1650875614624,MATH 193A,A04,083782,Staff,0,7,30,30
1650875620649,MATH 197,001,091859,McAuley; Julian John,9998,0,9999,1
1650875626698,COGS 9,A01,083615,Staff,0,17,60,60
1650875632819,COGS 11,A01,083617,Boyle; Mary E. T.,15,0,40,25
1650875638842,COGS 13,A01,083071,Staff,0,38,40,40
1650875644869,COGS 14A,A01,092681,Staff,0,37,100,100
1650875650895,COGS 14B,A01,083073,Cheng; Tzu-Han,0,12,50,50
1650875656916,COGS 17,A01,092677,Staff,12,0,75,63
1650875662942,COGS 100,A01,083619,Staff,0,30,60,60
1650875668973,COGS 101A,A01,083621,Davis; Joshua Daniel,0,29,60,60
1650875675000,COGS 101B,A01,091572,Staff,0,3,60,60
1650875681023,COGS 101C,A01,083625,Delgado; Tania,14,0,30,16
1650875687046,COGS 107A,A01,083627,Boyle; Mary E. T.,0,16,60,60
1650875693070,COGS 118A,A01,083075,Staff,0,8,60,60
1650875699093,CSE 3,A50,083646,Miranda; Gregory Joseph,16,0,38,22
1650875699093,CSE 3,A51,083647,Miranda; Gregory Joseph,36,0,37,1
1650875705117,CSE 8A,A50,083650,Miranda; Gregory Joseph,0,29,40,40
1650875711148,CSE 11,A01,083080,Cao; Yingjun,0,97,40,40
1650875717173,CSE 12,A01,083652,Staff,0,21,100,100
1650875723196,CSE 15L,A01,083654,Staff,0,3,50,50
1650875723196,CSE 15L,A02,083655,Staff,0,3,50,50
1650875729219,CSE 20,A01,083657,Staff,48,0,80,32
1650875735244,CSE 30,A01,083084,Eldon; John,0,76,40,40
1650875741267,CSE 100,A01,083659,Cao; Yingjun,0,70,50,50
1650875747292,CSE 134B,A01,083661,Powell; Thomas Allan,0,38,65,65
1650875753318,CSE 140,A01,083663,Staff,0,12,75,75
1650875759339,CSE 140L,A01,083088,Eldon; John,0,20,75,75
1650875765361,CSE 175,A01,083665,Kumar; Rakesh,7,0,25,18
1650875771386,CSE 190,A00,092507,Dubnov; Shlomo,9,0,20,11
1650875777408,ECE 45,A01,083139,Staff,0,4,60,60
1650875783430,ECE 65,A50,083695,Staff,0,5,30,30
1650875789454,ECE 109,A01,091882,Touri; Behrouz,32,0,70,38
1650875795479,ECE 180,A00,083140,Abi Samra; Nicholas Camill,20,0,30,10
1650875795479,ECE 180,B00,083141,Abi Samra; Nicholas Camill,0,0,30,30
1650875801501,MATH 10A,A01,083735,Patchell; Gregory David,2,0,30,28
1650875801501,MATH 10A,A02,083736,Patchell; Gregory David,27,0,30,3
1650875801501,MATH 10A,A03,083737,Patchell; Gregory David,23,0,30,7
1650875807528,MATH 10B,A01,083207,Staff,0,9,30,30
1650875807528,MATH 10B,A02,083208,Staff,0,6,30,30
1650875807528,MATH 10B,B01,083739,Staff,10,0,30,20
1650875807528,MATH 10B,B02,083740,Staff,28,0,30,2
1650875813553,MATH 18,A01,083743,Staff,0,0,30,30
1650875813553,MATH 18,A02,083744,Staff,24,0,30,6
1650875813553,MATH 18,A03,083745,Staff,21,0,30,9
1650875813553,MATH 18,A04,083746,Staff,26,0,30,4
1650875813553,MATH 18,B01,083748,Staff,0,15,30,30
1650875813553,MATH 18,B02,083749,Staff,0,13,30,30
1650875813553,MATH 18,B03,083750,Staff,0,13,30,30
1650875813553,MATH 18,B04,083751,Staff,0,13,30,30
1650875819575,MATH 20A,A01,083754,Staff,19,0,40,21
1650875825599,MATH 20B,A01,083756,Staff,0,14,30,30
1650875825599,MATH 20B,A02,083757,Staff,0,11,30,30
1650875831629,MATH 20C,A01,083760,Staff,0,17,30,30
1650875831629,MATH 20C,A02,083761,Staff,1,16,30,29
1650875831629,MATH 20C,B01,083762,Staff,9,0,30,21
1650875831629,MATH 20C,B02,083763,Staff,28,0,30,2
1650875837654,MATH 20D,A01,083765,Staff,2,1,30,28
1650875837654,MATH 20D,A02,083766,Staff,6,0,30,24
1650875837654,MATH 20D,A03,083767,Staff,23,0,30,7
1650875843682,MATH 20E,A01,083771,Staff,2,0,30,28
1650875843682,MATH 20E,A02,083772,Staff,13,0,30,17
1650875843682,MATH 20E,B01,083773,Staff,0,0,30,30
1650875843682,MATH 20E,B02,083774,Staff,4,0,30,26
1650875849707,MATH 103A,A01,083777,Staff,0,17,30,30
1650875849707,MATH 103A,A02,083778,Staff,0,15,30,30
1650875849707,MATH 103A,B01,083779,Staff,0,15,30,30
1650875849707,MATH 103A,B02,083780,Staff,0,14,30,30
1650875855734,MATH 105,A01,085443,Staff,0,23,30,30
1650875861757,MATH 109,A01,083213,Anzaldo; Leesa B,0,7,30,30
1650875861757,MATH 109,A02,083214,Anzaldo; Leesa B,0,7,30,30
1650875861757,MATH 109,B01,083215,Anzaldo; Leesa B,0,8,30,30
1650875861757,MATH 109,B02,083216,Anzaldo; Leesa B,0,7,30,30
1650875867787,MATH 142A,A01,083219,Chow; Bennett,0,14,30,30
1650875867787,MATH 142A,A02,083220,Chow; Bennett,0,15,30,30
1650875867787,MATH 142A,B01,083221,Chow; Bennett,0,16,30,30
1650875867787,MATH 142A,B02,083222,Chow; Bennett,0,14,30,30
1650875873810,MATH 193A,A01,083224,Staff,0,6,30,30
1650875873810,MATH 193A,A02,083225,Staff,0,7,30,30
1650875873810,MATH 193A,A03,083781,Staff,0,6,30,30
1650875873810,MATH 193A,A04,083782,Staff,0,7,30,30
1650875879834,MATH 197,001,091859,McAuley; Julian John,9998,0,9999,1
1650875885899,COGS 9,A01,083615,Staff,0,17,60,60
1650875891924,COGS 11,A01,083617,Boyle; Mary E. T.,15,0,40,25
1650875897947,COGS 13,A01,083071,Staff,0,38,40,40
1650875903970,COGS 14A,A01,092681,Staff,0,37,100,100
1650875909994,COGS 14B,A01,083073,Cheng; Tzu-Han,0,12,50,50
1650875916018,COGS 17,A01,092677,Staff,12,0,75,63
1650875922048,COGS 100,A01,083619,Staff,0,30,60,60
1650875928078,COGS 101A,A01,083621,Davis; Joshua Daniel,0,29,60,60
1650875934105,COGS 101B,A01,091572,Staff,0,3,60,60
1650875940139,COGS 101C,A01,083625,Delgado; Tania,14,0,30,16
1650875946166,COGS 107A,A01,083627,Boyle; Mary E. T.,0,16,60,60
1650875952215,COGS 118A,A01,083075,Staff,0,8,60,60
1650875958418,CSE 3,A50,083646,Miranda; Gregory Joseph,16,0,38,22
1650875958418,CSE 3,A51,083647,Miranda; Gregory Joseph,36,0,37,1
1650875964442,CSE 8A,A50,083650,Miranda; Gregory Joseph,0,29,40,40
1650875970466,CSE 11,A01,083080,Cao; Yingjun,0,97,40,40
1650875976493,CSE 12,A01,083652,Staff,0,21,100,100
1650875982529,CSE 15L,A01,083654,Staff,0,3,50,50
1650875982529,CSE 15L,A02,083655,Staff,0,3,50,50
1650875988557,CSE 20,A01,083657,Staff,48,0,80,32
1650875994589,CSE 30,A01,083084,Eldon; John,0,76,40,40
1650876000616,CSE 100,A01,083659,Cao; Yingjun,0,70,50,50
1650876006645,CSE 134B,A01,083661,Powell; Thomas Allan,0,38,65,65
1650876012669,CSE 140,A01,083663,Staff,0,12,75,75
1650876018730,CSE 140L,A01,083088,Eldon; John,0,20,75,75
1650876024762,CSE 175,A01,083665,Kumar; Rakesh,7,0,25,18
1650876030796,CSE 190,A00,092507,Dubnov; Shlomo,9,0,20,11
1650876036839,ECE 45,A01,083139,Staff,0,4,60,60
1650876042866,ECE 65,A50,083695,Staff,0,5,30,30
1650876048891,ECE 109,A01,091882,Touri; Behrouz,32,0,70,38
1650876054922,ECE 180,A00,083140,Abi Samra; Nicholas Camill,20,0,30,10
1650876054922,ECE 180,B00,083141,Abi Samra; Nicholas Camill,0,0,30,30
1650876060957,MATH 10A,A01,083735,Patchell; Gregory David,2,0,30,28
1650876060957,MATH 10A,A02,083736,Patchell; Gregory David,27,0,30,3
1650876060957,MATH 10A,A03,083737,Patchell; Gregory David,23,0,30,7
1650876066982,MATH 10B,A01,083207,Staff,0,9,30,30
1650876066982,MATH 10B,A02,083208,Staff,0,6,30,30
1650876066982,MATH 10B,B01,083739,Staff,10,0,30,20
1650876066982,MATH 10B,B02,083740,Staff,28,0,30,2
1650876073026,MATH 18,A01,083743,Staff,0,0,30,30
1650876073026,MATH 18,A02,083744,Staff,24,0,30,6
1650876073026,MATH 18,A03,083745,Staff,21,0,30,9
1650876073026,MATH 18,A04,083746,Staff,26,0,30,4
1650876073026,MATH 18,B01,083748,Staff,0,15,30,30
1650876073026,MATH 18,B02,083749,Staff,0,13,30,30
1650876073026,MATH 18,B03,083750,Staff,0,13,30,30
1650876073026,MATH 18,B04,083751,Staff,0,13,30,30
1650876079055,MATH 20A,A01,083754,Staff,19,0,40,21
1650876085079,MATH 20B,A01,083756,Staff,0,14,30,30
1650876085079,MATH 20B,A02,083757,Staff,0,11,30,30
1650876091107,MATH 20C,A01,083760,Staff,0,17,30,30
1650876091107,MATH 20C,A02,083761,Staff,1,16,30,29
1650876091107,MATH 20C,B01,083762,Staff,9,0,30,21
1650876091107,MATH 20C,B02,083763,Staff,28,0,30,2
1650876097136,MATH 20D,A01,083765,Staff,2,1,30,28
1650876097136,MATH 20D,A02,083766,Staff,6,0,30,24
1650876097136,MATH 20D,A03,083767,Staff,23,0,30,7
1650876103161,MATH 20E,A01,083771,Staff,2,0,30,28
1650876103161,MATH 20E,A02,083772,Staff,13,0,30,17
1650876103161,MATH 20E,B01,083773,Staff,0,0,30,30
1650876103161,MATH 20E,B02,083774,Staff,4,0,30,26
1650876109191,MATH 103A,A01,083777,Staff,0,17,30,30
1650876109191,MATH 103A,A02,083778,Staff,0,15,30,30
1650876109191,MATH 103A,B01,083779,Staff,0,15,30,30
1650876109191,MATH 103A,B02,083780,Staff,0,14,30,30
1650876115215,MATH 105,A01,085443,Staff,0,23,30,30
1650876121240,MATH 109,A01,083213,Anzaldo; Leesa B,0,7,30,30
1650876121240,MATH 109,A02,083214,Anzaldo; Leesa B,0,7,30,30
1650876121240,MATH 109,B01,083215,Anzaldo; Leesa B,0,8,30,30
1650876121240,MATH 109,B02,083216,Anzaldo; Leesa B,0,7,30,30
1650876127271,MATH 142A,A01,083219,Chow; Bennett,0,14,30,30
1650876127271,MATH 142A,A02,083220,Chow; Bennett,0,15,30,30
1650876127271,MATH 142A,B01,083221,Chow; Bennett,0,16,30,30
1650876127271,MATH 142A,B02,083222,Chow; Bennett,0,14,30,30
1650876133300,MATH 193A,A01,083224,Staff,0,6,30,30
1650876133300,MATH 193A,A02,083225,Staff,0,7,30,30
1650876133300,MATH 193A,A03,083781,Staff,0,6,30,30
1650876133300,MATH 193A,A04,083782,Staff,0,7,30,30
1650876139327,MATH 197,001,091859,McAuley; Julian John,9998,0,9999,1
1650876145390,COGS 9,A01,083615,Staff,0,17,60,60
1650876151413,COGS 11,A01,083617,Boyle; Mary E. T.,15,0,40,25
1650876157438,COGS 13,A01,083071,Staff,0,38,40,40
1650876163464,COGS 14A,A01,092681,Staff,0,37,100,100
1650876169489,COGS 14B,A01,083073,Cheng; Tzu-Han,0,12,50,50
1650876175512,COGS 17,A01,092677,Staff,12,0,75,63
1650876181548,COGS 100,A01,083619,Staff,0,30,60,60
1650876187574,COGS 101A,A01,083621,Davis; Joshua Daniel,0,29,60,60
1650876193607,COGS 101B,A01,091572,Staff,0,3,60,60
1650876199630,COGS 101C,A01,083625,Delgado; Tania,14,0,30,16
1650876205652,COGS 107A,A01,083627,Boyle; Mary E. T.,0,16,60,60
1650876211683,COGS 118A,A01,083075,Staff,0,8,60,60
1650876217713,CSE 3,A50,083646,Miranda; Gregory Joseph,16,0,38,22
1650876217713,CSE 3,A51,083647,Miranda; Gregory Joseph,36,0,37,1
1650876223738,CSE 8A,A50,083650,Miranda; Gregory Joseph,0,29,40,40
1650876229863,CSE 11,A01,083080,Cao; Yingjun,0,97,40,40
1650876235887,CSE 12,A01,083652,Staff,0,21,100,100
1650876241916,CSE 15L,A01,083654,Staff,0,3,50,50
1650876241916,CSE 15L,A02,083655,Staff,0,3,50,50
1650876247942,CSE 20,A01,083657,Staff,48,0,80,32
1650876253966,CSE 30,A01,083084,Eldon; John,0,76,40,40
1650876259994,CSE 100,A01,083659,Cao; Yingjun,0,70,50,50
1650876266019,CSE 134B,A01,083661,Powell; Thomas Allan,0,38,65,65
1650876272047,CSE 140,A01,083663,Staff,0,12,75,75
1650876278104,CSE 140L,A01,083088,Eldon; John,0,20,75,75
1650876284136,CSE 175,A01,083665,Kumar; Rakesh,7,0,25,18
1650876290163,CSE 190,A00,092507,Dubnov; Shlomo,9,0,20,11
1650876296188,ECE 45,A01,083139,Staff,0,4,60,60
1650876302214,ECE 65,A50,083695,Staff,0,5,30,30
1650876308238,ECE 109,A01,091882,Touri; Behrouz,32,0,70,38
1650876314272,ECE 180,A00,083140,Abi Samra; Nicholas Camill,20,0,30,10
1650876314272,ECE 180,B00,083141,Abi Samra; Nicholas Camill,0,0,30,30
1650876320308,MATH 10A,A01,083735,Patchell; Gregory David,2,0,30,28
1650876320308,MATH 10A,A02,083736,Patchell; Gregory David,27,0,30,3
1650876320308,MATH 10A,A03,083737,Patchell; Gregory David,23,0,30,7
1650876326344,MATH 10B,A01,083207,Staff,0,9,30,30
1650876326344,MATH 10B,A02,083208,Staff,0,6,30,30
1650876326344,MATH 10B,B01,083739,Staff,10,0,30,20
1650876326344,MATH 10B,B02,083740,Staff,28,0,30,2
1650876332380,MATH 18,A01,083743,Staff,0,0,30,30
1650876332380,MATH 18,A02,083744,Staff,24,0,30,6
1650876332380,MATH 18,A03,083745,Staff,21,0,30,9
1650876332380,MATH 18,A04,083746,Staff,26,0,30,4
1650876332380,MATH 18,B01,083748,Staff,0,15,30,30
1650876332380,MATH 18,B02,083749,Staff,0,13,30,30
1650876332380,MATH 18,B03,083750,Staff,0,13,30,30
1650876332380,MATH 18,B04,083751,Staff,0,13,30,30
1650876338405,MATH 20A,A01,083754,Staff,19,0,40,21
1650876344429,MATH 20B,A01,083756,Staff,0,14,30,30
1650876344429,MATH 20B,A02,083757,Staff,0,11,30,30
1650876350454,MATH 20C,A01,083760,Staff,0,17,30,30
1650876350454,MATH 20C,A02,083761,Staff,1,16,30,29
1650876350454,MATH 20C,B01,083762,Staff,9,0,30,21
1650876350454,MATH 20C,B02,083763,Staff,28,0,30,2
1650876356489,MATH 20D,A01,083765,Staff,2,1,30,28
1650876356489,MATH 20D,A02,083766,Staff,6,0,30,24
1650876356489,MATH 20D,A03,083767,Staff,23,0,30,7
1650876362515,MATH 20E,A01,083771,Staff,2,0,30,28
1650876362515,MATH 20E,A02,083772,Staff,13,0,30,17
1650876362515,MATH 20E,B01,083773,Staff,0,0,30,30
1650876362515,MATH 20E,B02,083774,Staff,4,0,30,26
1650876368554,MATH 103A,A01,083777,Staff,0,17,30,30
1650876368554,MATH 103A,A02,083778,Staff,0,15,30,30
1650876368554,MATH 103A,B01,083779,Staff,0,15,30,30
1650876368554,MATH 103A,B02,083780,Staff,0,14,30,30
1650876374578,MATH 105,A01,085443,Staff,0,23,30,30
1650876380603,MATH 109,A01,083213,Anzaldo; Leesa B,0,7,30,30
1650876380603,MATH 109,A02,083214,Anzaldo; Leesa B,0,7,30,30
1650876380603,MATH 109,B01,083215,Anzaldo; Leesa B,0,8,30,30
1650876380603,MATH 109,B02,083216,Anzaldo; Leesa B,0,7,30,30
1650876386627,MATH 142A,A01,083219,Chow; Bennett,0,14,30,30
1650876386627,MATH 142A,A02,083220,Chow; Bennett,0,15,30,30
1650876386627,MATH 142A,B01,083221,Chow; Bennett,0,16,30,30
1650876386627,MATH 142A,B02,083222,Chow; Bennett,0,14,30,30
1650876392653,MATH 193A,A01,083224,Staff,0,6,30,30
1650876392653,MATH 193A,A02,083225,Staff,0,7,30,30
1650876392653,MATH 193A,A03,083781,Staff,0,6,30,30
1650876392653,MATH 193A,A04,083782,Staff,0,7,30,30
1650876398678,MATH 197,001,091859,McAuley; Julian John,9998,0,9999,1
1650876404747,COGS 9,A01,083615,Staff,0,17,60,60
1650876410776,COGS 11,A01,083617,Boyle; Mary E. T.,15,0,40,25
1650876416809,COGS 13,A01,083071,Staff,0,38,40,40
1650876422843,COGS 14A,A01,092681,Staff,0,37,100,100
1650876428873,COGS 14B,A01,083073,Cheng; Tzu-Han,0,12,50,50
1650876434898,COGS 17,A01,092677,Staff,12,0,75,63
1650876440924,COGS 100,A01,083619,Staff,0,30,60,60
1650876446951,COGS 101A,A01,083621,Davis; Joshua Daniel,0,29,60,60
1650876452976,COGS 101B,A01,091572,Staff,0,3,60,60
1650876459000,COGS 101C,A01,083625,Delgado; Tania,14,0,30,16
1650876465030,COGS 107A,A01,083627,Boyle; Mary E. T.,0,16,60,60
1650876471052,COGS 118A,A01,083075,Staff,0,8,60,60
1650876477078,CSE 3,A50,083646,Miranda; Gregory Joseph,16,0,38,22
1650876477078,CSE 3,A51,083647,Miranda; Gregory Joseph,36,0,37,1
1650876483109,CSE 8A,A50,083650,Miranda; Gregory Joseph,0,29,40,40
1650876489138,CSE 11,A01,083080,Cao; Yingjun,0,97,40,40
1650876495162,CSE 12,A01,083652,Staff,0,21,100,100
1650876501187,CSE 15L,A01,083654,Staff,0,3,50,50
1650876501187,CSE 15L,A02,083655,Staff,0,3,50,50
1650876507216,CSE 20,A01,083657,Staff,48,0,80,32
1650876513244,CSE 30,A01,083084,Eldon; John,0,76,40,40
1650876519270,CSE 100,A01,083659,Cao; Yingjun,0,70,50,50
1650876525295,CSE 134B,A01,083661,Powell; Thomas Allan,0,38,65,65
1650876531320,CSE 140,A01,083663,Staff,0,12,75,75
1650876537344,CSE 140L,A01,083088,Eldon; John,0,20,75,75
1650876543369,CSE 175,A01,083665,Kumar; Rakesh,7,0,25,18
1650876549398,CSE 190,A00,092507,Dubnov; Shlomo,9,0,20,11
1650876555428,ECE 45,A01,083139,Staff,0,4,60,60
1650876561454,ECE 65,A50,083695,Staff,0,5,30,30
1650876567486,ECE 109,A01,091882,Touri; Behrouz,32,0,70,38
1650876573518,ECE 180,A00,083140,Abi Samra; Nicholas Camill,20,0,30,10
1650876573518,ECE 180,B00,083141,Abi Samra; Nicholas Camill,0,0,30,30
1650876579547,MATH 10A,A01,083735,Patchell; Gregory David,2,0,30,28
1650876579547,MATH 10A,A02,083736,Patchell; Gregory David,27,0,30,3
1650876579547,MATH 10A,A03,083737,Patchell; Gregory David,23,0,30,7
1650876585574,MATH 10B,A01,083207,Staff,0,9,30,30
1650876585574,MATH 10B,A02,083208,Staff,0,6,30,30
1650876585574,MATH 10B,B01,083739,Staff,10,0,30,20
1650876585574,MATH 10B,B02,083740,Staff,28,0,30,2
1650876591602,MATH 18,A01,083743,Staff,0,0,30,30
1650876591602,MATH 18,A02,083744,Staff,24,0,30,6
1650876591602,MATH 18,A03,083745,Staff,21,0,30,9
1650876591602,MATH 18,A04,083746,Staff,26,0,30,4
1650876591602,MATH 18,B01,083748,Staff,0,15,30,30
1650876591602,MATH 18,B02,083749,Staff,0,13,30,30
1650876591602,MATH 18,B03,083750,Staff,0,13,30,30
1650876591602,MATH 18,B04,083751,Staff,0,13,30,30
1650876597626,MATH 20A,A01,083754,Staff,19,0,40,21
1650876603657,MATH 20B,A01,083756,Staff,0,14,30,30
1650876603657,MATH 20B,A02,083757,Staff,0,11,30,30
1650876609684,MATH 20C,A01,083760,Staff,0,17,30,30
1650876609684,MATH 20C,A02,083761,Staff,1,16,30,29
1650876609684,MATH 20C,B01,083762,Staff,9,0,30,21
1650876609684,MATH 20C,B02,083763,Staff,28,0,30,2
1650876615709,MATH 20D,A01,083765,Staff,2,1,30,28
1650876615709,MATH 20D,A02,083766,Staff,6,0,30,24
1650876615709,MATH 20D,A03,083767,Staff,23,0,30,7
1650876621738,MATH 20E,A01,083771,Staff,2,0,30,28
1650876621738,MATH 20E,A02,083772,Staff,13,0,30,17
1650876621738,MATH 20E,B01,083773,Staff,0,0,30,30
1650876621738,MATH 20E,B02,083774,Staff,4,0,30,26
1650876627766,MATH 103A,A01,083777,Staff,0,17,30,30
1650876627766,MATH 103A,A02,083778,Staff,0,15,30,30
1650876627766,MATH 103A,B01,083779,Staff,0,15,30,30
1650876627766,MATH 103A,B02,083780,Staff,0,14,30,30
1650876633794,MATH 105,A01,085443,Staff,0,23,30,30
1650876639819,MATH 109,A01,083213,Anzaldo; Leesa B,0,7,30,30
1650876639819,MATH 109,A02,083214,Anzaldo; Leesa B,0,7,30,30
1650876639819,MATH 109,B01,083215,Anzaldo; Leesa B,0,8,30,30
1650876639819,MATH 109,B02,083216,Anzaldo; Leesa B,0,7,30,30
1650876645851,MATH 142A,A01,083219,Chow; Bennett,0,14,30,30
1650876645851,MATH 142A,A02,083220,Chow; Bennett,0,15,30,30
1650876645851,MATH 142A,B01,083221,Chow; Bennett,0,16,30,30
1650876645851,MATH 142A,B02,083222,Chow; Bennett,0,14,30,30
1650876651877,MATH 193A,A01,083224,Staff,0,6,30,30
1650876651877,MATH 193A,A02,083225,Staff,0,7,30,30
1650876651877,MATH 193A,A03,083781,Staff,0,6,30,30
1650876651877,MATH 193A,A04,083782,Staff,0,7,30,30
1650876657910,MATH 197,001,091859,McAuley; Julian John,9998,0,9999,1
1650876663975,COGS 9,A01,083615,Staff,0,17,60,60
1650876670001,COGS 11,A01,083617,Boyle; Mary E. T.,15,0,40,25
1650876676029,COGS 13,A01,083071,Staff,0,38,40,40
1650876682056,COGS 14A,A01,092681,Staff,0,37,100,100
1650876688083,COGS 14B,A01,083073,Cheng; Tzu-Han,0,12,50,50
1650876694107,COGS 17,A01,092677,Staff,12,0,75,63
1650876700137,COGS 100,A01,083619,Staff,0,30,60,60
1650876706163,COGS 101A,A01,083621,Davis; Joshua Daniel,0,29,60,60
1650876712188,COGS 101B,A01,091572,Staff,0,3,60,60
1650876718220,COGS 101C,A01,083625,Delgado; Tania,14,0,30,16
1650876724249,COGS 107A,A01,083627,Boyle; Mary E. T.,0,16,60,60
1650876730275,COGS 118A,A01,083075,Staff,0,8,60,60
1650876736307,CSE 3,A50,083646,Miranda; Gregory Joseph,16,0,38,22
1650876736307,CSE 3,A51,083647,Miranda; Gregory Joseph,36,0,37,1
1650876742332,CSE 8A,A50,083650,Miranda; Gregory Joseph,0,29,40,40
1650876748356,CSE 11,A01,083080,Cao; Yingjun,0,97,40,40
1650876754380,CSE 12,A01,083652,Staff,0,21,100,100
1650876760410,CSE 15L,A01,083654,Staff,0,3,50,50
1650876760410,CSE 15L,A02,083655,Staff,0,3,50,50
1650876766436,CSE 20,A01,083657,Staff,48,0,80,32
1650876772462,CSE 30,A01,083084,Eldon; John,0,76,40,40
1650876778487,CSE 100,A01,083659,Cao; Yingjun,0,70,50,50
1650876784520,CSE 134B,A01,083661,Powell; Thomas Allan,0,38,65,65
1650876790544,CSE 140,A01,083663,Staff,0,12,75,75
1650876796578,CSE 140L,A01,083088,Eldon; John,0,20,75,75
1650876802607,CSE 175,A01,083665,Kumar; Rakesh,7,0,25,18
1650876808634,CSE 190,A00,092507,Dubnov; Shlomo,9,0,20,11
1650876814660,ECE 45,A01,083139,Staff,0,4,60,60
1650876820689,ECE 65,A50,083695,Staff,0,5,30,30
1650876826801,ECE 109,A01,091882,Touri; Behrouz,32,0,70,38
1650876832855,ECE 180,A00,083140,Abi Samra; Nicholas Camill,20,0,30,10
1650876832855,ECE 180,B00,083141,Abi Samra; Nicholas Camill,0,0,30,30
1650876838882,MATH 10A,A01,083735,Patchell; Gregory David,2,0,30,28
1650876838882,MATH 10A,A02,083736,Patchell; Gregory David,27,0,30,3
1650876838882,MATH 10A,A03,083737,Patchell; Gregory David,23,0,30,7
1650876844909,MATH 10B,A01,083207,Staff,0,9,30,30
1650876844909,MATH 10B,A02,083208,Staff,0,6,30,30
1650876844909,MATH 10B,B01,083739,Staff,10,0,30,20
1650876844909,MATH 10B,B02,083740,Staff,28,0,30,2
1650876850947,MATH 18,A01,083743,Staff,0,0,30,30
1650876850947,MATH 18,A02,083744,Staff,24,0,30,6
1650876850947,MATH 18,A03,083745,Staff,21,0,30,9
1650876850947,MATH 18,A04,083746,Staff,26,0,30,4
1650876850947,MATH 18,B01,083748,Staff,0,15,30,30
1650876850947,MATH 18,B02,083749,Staff,0,13,30,30
1650876850947,MATH 18,B03,083750,Staff,0,13,30,30
1650876850947,MATH 18,B04,083751,Staff,0,13,30,30
1650876856985,MATH 20A,A01,083754,Staff,19,0,40,21
1650876863010,MATH 20B,A01,083756,Staff,0,14,30,30
1650876863010,MATH 20B,A02,083757,Staff,0,11,30,30
1650876869038,MATH 20C,A01,083760,Staff,0,17,30,30
1650876869038,MATH 20C,A02,083761,Staff,1,16,30,29
1650876869038,MATH 20C,B01,083762,Staff,9,0,30,21
1650876869038,MATH 20C,B02,083763,Staff,28,0,30,2
1650876875067,MATH 20D,A01,083765,Staff,2,1,30,28
1650876875067,MATH 20D,A02,083766,Staff,6,0,30,24
1650876875067,MATH 20D,A03,083767,Staff,23,0,30,7
1650876881098,MATH 20E,A01,083771,Staff,2,0,30,28
1650876881098,MATH 20E,A02,083772,Staff,13,0,30,17
1650876881098,MATH 20E,B01,083773,Staff,0,0,30,30
1650876881098,MATH 20E,B02,083774,Staff,4,0,30,26
1650876887124,MATH 103A,A01,083777,Staff,0,17,30,30
1650876887124,MATH 103A,A02,083778,Staff,0,15,30,30
1650876887124,MATH 103A,B01,083779,Staff,0,15,30,30
1650876887124,MATH 103A,B02,083780,Staff,0,14,30,30
1650876893154,MATH 105,A01,085443,Staff,0,23,30,30
1650876899180,MATH 109,A01,083213,Anzaldo; Leesa B,0,7,30,30
1650876899180,MATH 109,A02,083214,Anzaldo; Leesa B,0,7,30,30
1650876899180,MATH 109,B01,083215,Anzaldo; Leesa B,0,8,30,30
1650876899180,MATH 109,B02,083216,Anzaldo; Leesa B,0,7,30,30
1650876905212,MATH 142A,A01,083219,Chow; Bennett,0,14,30,30
1650876905212,MATH 142A,A02,083220,Chow; Bennett,0,15,30,30
1650876905212,MATH 142A,B01,083221,Chow; Bennett,0,16,30,30
1650876905212,MATH 142A,B02,083222,Chow; Bennett,0,14,30,30
1650876911237,MATH 193A,A01,083224,Staff,0,6,30,30
1650876911237,MATH 193A,A02,083225,Staff,0,7,30,30
1650876911237,MATH 193A,A03,083781,Staff,0,6,30,30
1650876911237,MATH 193A,A04,083782,Staff,0,7,30,30
1650876917262,MATH 197,001,091859,McAuley; Julian John,9998,0,9999,1
1650876923345,COGS 9,A01,083615,Staff,0,17,60,60
1650876929369,COGS 11,A01,083617,Boyle; Mary E. T.,15,0,40,25
1650876935393,COGS 13,A01,083071,Staff,0,38,40,40
1650876941420,COGS 14A,A01,092681,Staff,0,37,100,100
1650876947462,COGS 14B,A01,083073,Cheng; Tzu-Han,0,12,50,50
1650876953490,COGS 17,A01,092677,Staff,11,0,75,64
1650876959511,COGS 100,A01,083619,Staff,0,30,60,60
1650876965540,COGS 101A,A01,083621,Davis; Joshua Daniel,0,29,60,60
1650876971567,COGS 101B,A01,091572,Staff,0,3,60,60
1650876977598,COGS 101C,A01,083625,Delgado; Tania,14,0,30,16
1650876983630,COGS 107A,A01,083627,Boyle; Mary E. T.,0,16,60,60
1650876989655,COGS 118A,A01,083075,Staff,0,8,60,60
1650876995690,CSE 3,A50,083646,Miranda; Gregory Joseph,16,0,38,22
1650876995690,CSE 3,A51,083647,Miranda; Gregory Joseph,36,0,37,1
1650877001714,CSE 8A,A50,083650,Miranda; Gregory Joseph,0,29,40,40
1650877007744,CSE 11,A01,083080,Cao; Yingjun,0,97,40,40
1650877013770,CSE 12,A01,083652,Staff,0,21,100,100
1650877019798,CSE 15L,A01,083654,Staff,0,3,50,50
1650877019798,CSE 15L,A02,083655,Staff,0,3,50,50
1650877025824,CSE 20,A01,083657,Staff,48,0,80,32
1650877031852,CSE 30,A01,083084,Eldon; John,0,76,40,40
1650877037879,CSE 100,A01,083659,Cao; Yingjun,0,70,50,50
1650877043917,CSE 134B,A01,083661,Powell; Thomas Allan,0,38,65,65
1650877049945,CSE 140,A01,083663,Staff,0,12,75,75
1650877055976,CSE 140L,A01,083088,Eldon; John,0,20,75,75
1650877062007,CSE 175,A01,083665,Kumar; Rakesh,7,0,25,18
1650877068058,CSE 190,A00,092507,Dubnov; Shlomo,9,0,20,11
1650877074088,ECE 45,A01,083139,Staff,0,4,60,60
1650877080117,ECE 65,A50,083695,Staff,0,5,30,30
1650877086149,ECE 109,A01,091882,Touri; Behrouz,32,0,70,38
1650877092175,ECE 180,A00,083140,Abi Samra; Nicholas Camill,20,0,30,10
1650877092175,ECE 180,B00,083141,Abi Samra; Nicholas Camill,0,0,30,30
1650877098207,MATH 10A,A01,083735,Patchell; Gregory David,2,0,30,28
1650877098207,MATH 10A,A02,083736,Patchell; Gregory David,27,0,30,3
1650877098207,MATH 10A,A03,083737,Patchell; Gregory David,23,0,30,7
1650877104240,MATH 10B,A01,083207,Staff,0,9,30,30
1650877104240,MATH 10B,A02,083208,Staff,0,6,30,30
1650877104240,MATH 10B,B01,083739,Staff,10,0,30,20
1650877104240,MATH 10B,B02,083740,Staff,28,0,30,2
1650877110269,MATH 18,A01,083743,Staff,0,0,30,30
1650877110269,MATH 18,A02,083744,Staff,24,0,30,6
1650877110269,MATH 18,A03,083745,Staff,21,0,30,9
1650877110269,MATH 18,A04,083746,Staff,26,0,30,4
1650877110269,MATH 18,B01,083748,Staff,0,15,30,30
1650877110269,MATH 18,B02,083749,Staff,0,13,30,30
1650877110269,MATH 18,B03,083750,Staff,0,13,30,30
1650877110269,MATH 18,B04,083751,Staff,0,13,30,30
1650877116296,MATH 20A,A01,083754,Staff,19,0,40,21
1650877122332,MATH 20B,A01,083756,Staff,0,14,30,30
1650877122332,MATH 20B,A02,083757,Staff,0,11,30,30
1650877128355,MATH 20C,A01,083760,Staff,0,17,30,30
1650877128355,MATH 20C,A02,083761,Staff,1,16,30,29
1650877128355,MATH 20C,B01,083762,Staff,9,0,30,21
1650877128355,MATH 20C,B02,083763,Staff,28,0,30,2
1650877134383,MATH 20D,A01,083765,Staff,2,1,30,28
1650877134383,MATH 20D,A02,083766,Staff,6,0,30,24
1650877134383,MATH 20D,A03,083767,Staff,23,0,30,7
1650877140410,MATH 20E,A01,083771,Staff,2,0,30,28
1650877140410,MATH 20E,A02,083772,Staff,13,0,30,17
1650877140410,MATH 20E,B01,083773,Staff,0,0,30,30
1650877140410,MATH 20E,B02,083774,Staff,4,0,30,26
1650877146441,MATH 103A,A01,083777,Staff,0,17,30,30
1650877146441,MATH 103A,A02,083778,Staff,0,15,30,30
1650877146441,MATH 103A,B01,083779,Staff,0,15,30,30
1650877146441,MATH 103A,B02,083780,Staff,0,14,30,30
1650877152467,MATH 105,A01,085443,Staff,0,23,30,30
1650877158499,MATH 109,A01,083213,Anzaldo; Leesa B,0,7,30,30
1650877158499,MATH 109,A02,083214,Anzaldo; Leesa B,0,7,30,30
1650877158499,MATH 109,B01,083215,Anzaldo; Leesa B,0,8,30,30
1650877158499,MATH 109,B02,083216,Anzaldo; Leesa B,0,7,30,30
1650877164530,MATH 142A,A01,083219,Chow; Bennett,0,14,30,30
1650877164530,MATH 142A,A02,083220,Chow; Bennett,0,15,30,30
1650877164530,MATH 142A,B01,083221,Chow; Bennett,0,16,30,30
1650877164530,MATH 142A,B02,083222,Chow; Bennett,0,14,30,30
1650877170560,MATH 193A,A01,083224,Staff,0,6,30,30
1650877170560,MATH 193A,A02,083225,Staff,0,7,30,30
1650877170560,MATH 193A,A03,083781,Staff,0,6,30,30
1650877170560,MATH 193A,A04,083782,Staff,0,7,30,30
1650877176585,MATH 197,001,091859,McAuley; Julian John,9998,0,9999,1
1650877182649,COGS 9,A01,083615,Staff,0,17,60,60
1650877188677,COGS 11,A01,083617,Boyle; Mary E. T.,15,0,40,25
1650877194702,COGS 13,A01,083071,Staff,0,38,40,40
1650877200732,COGS 14A,A01,092681,Staff,0,37,100,100
1650877206768,COGS 14B,A01,083073,Cheng; Tzu-Han,0,12,50,50
1650877212793,COGS 17,A01,092677,Staff,11,0,75,64
1650877218828,COGS 100,A01,083619,Staff,0,30,60,60
1650877224852,COGS 101A,A01,083621,Davis; Joshua Daniel,0,29,60,60
1650877230878,COGS 101B,A01,091572,Staff,0,3,60,60
1650877236914,COGS 101C,A01,083625,Delgado; Tania,14,0,30,16
1650877242942,COGS 107A,A01,083627,Boyle; Mary E. T.,0,16,60,60
1650877248970,COGS 118A,A01,083075,Staff,0,8,60,60
1650877254998,CSE 3,A50,083646,Miranda; Gregory Joseph,16,0,38,22
1650877254998,CSE 3,A51,083647,Miranda; Gregory Joseph,36,0,37,1
1650877261031,CSE 8A,A50,083650,Miranda; Gregory Joseph,0,29,40,40
1650877267057,CSE 11,A01,083080,Cao; Yingjun,0,97,40,40
1650877273083,CSE 12,A01,083652,Staff,0,21,100,100
1650877279108,CSE 15L,A01,083654,Staff,0,3,50,50
1650877279108,CSE 15L,A02,083655,Staff,0,3,50,50
1650877285135,CSE 20,A01,083657,Staff,48,0,80,32
1650877291160,CSE 30,A01,083084,Eldon; John,0,76,40,40
1650877297185,CSE 100,A01,083659,Cao; Yingjun,0,70,50,50
1650877303225,CSE 134B,A01,083661,Powell; Thomas Allan,0,38,65,65
1650877309251,CSE 140,A01,083663,Staff,0,12,75,75
1650877315279,CSE 140L,A01,083088,Eldon; John,0,20,75,75
1650877321317,CSE 175,A01,083665,Kumar; Rakesh,7,0,25,18
1650877327351,CSE 190,A00,092507,Dubnov; Shlomo,9,0,20,11
1650877333380,ECE 45,A01,083139,Staff,0,4,60,60
1650877339423,ECE 65,A50,083695,Staff,0,5,30,30
1650877345456,ECE 109,A01,091882,Touri; Behrouz,32,0,70,38
1650877351482,ECE 180,A00,083140,Abi Samra; Nicholas Camill,20,0,30,10
1650877351482,ECE 180,B00,083141,Abi Samra; Nicholas Camill,0,0,30,30
1650877357509,MATH 10A,A01,083735,Patchell; Gregory David,2,0,30,28
1650877357509,MATH 10A,A02,083736,Patchell; Gregory David,27,0,30,3
1650877357509,MATH 10A,A03,083737,Patchell; Gregory David,23,0,30,7
1650877363541,MATH 10B,A01,083207,Staff,0,9,30,30
1650877363541,MATH 10B,A02,083208,Staff,0,6,30,30
1650877363541,MATH 10B,B01,083739,Staff,10,0,30,20
1650877363541,MATH 10B,B02,083740,Staff,28,0,30,2
1650877369570,MATH 18,A01,083743,Staff,0,0,30,30
1650877369570,MATH 18,A02,083744,Staff,24,0,30,6
1650877369570,MATH 18,A03,083745,Staff,21,0,30,9
1650877369570,MATH 18,A04,083746,Staff,26,0,30,4
1650877369570,MATH 18,B01,083748,Staff,0,15,30,30
1650877369570,MATH 18,B02,083749,Staff,0,13,30,30
1650877369570,MATH 18,B03,083750,Staff,0,13,30,30
1650877369570,MATH 18,B04,083751,Staff,0,13,30,30
1650877375600,MATH 20A,A01,083754,Staff,19,0,40,21
1650877381630,MATH 20B,A01,083756,Staff,0,14,30,30
1650877381630,MATH 20B,A02,083757,Staff,0,11,30,30
1650877387662,MATH 20C,A01,083760,Staff,0,17,30,30
1650877387662,MATH 20C,A02,083761,Staff,1,16,30,29
1650877387662,MATH 20C,B01,083762,Staff,9,0,30,21
1650877387662,MATH 20C,B02,083763,Staff,28,0,30,2
1650877393688,MATH 20D,A01,083765,Staff,2,1,30,28
1650877393688,MATH 20D,A02,083766,Staff,6,0,30,24
1650877393688,MATH 20D,A03,083767,Staff,23,0,30,7
1650877399720,MATH 20E,A01,083771,Staff,2,0,30,28
1650877399720,MATH 20E,A02,083772,Staff,13,0,30,17
1650877399720,MATH 20E,B01,083773,Staff,0,0,30,30
1650877399720,MATH 20E,B02,083774,Staff,4,0,30,26
1650877405766,MATH 103A,A01,083777,Staff,0,17,30,30
1650877405766,MATH 103A,A02,083778,Staff,0,15,30,30
1650877405766,MATH 103A,B01,083779,Staff,0,15,30,30
1650877405766,MATH 103A,B02,083780,Staff,0,14,30,30
1650877411874,MATH 105,A01,085443,Staff,0,23,30,30
1650877417906,MATH 109,A01,083213,Anzaldo; Leesa B,0,7,30,30
1650877417906,MATH 109,A02,083214,Anzaldo; Leesa B,0,7,30,30
1650877417906,MATH 109,B01,083215,Anzaldo; Leesa B,0,8,30,30
1650877417906,MATH 109,B02,083216,Anzaldo; Leesa B,0,7,30,30
1650877423930,MATH 142A,A01,083219,Chow; Bennett,0,14,30,30
1650877423930,MATH 142A,A02,083220,Chow; Bennett,0,15,30,30
1650877423930,MATH 142A,B01,083221,Chow; Bennett,0,16,30,30
1650877423930,MATH 142A,B02,083222,Chow; Bennett,0,14,30,30
1650877429956,MATH 193A,A01,083224,Staff,0,6,30,30
1650877429956,MATH 193A,A02,083225,Staff,0,7,30,30
1650877429956,MATH 193A,A03,083781,Staff,0,6,30,30
1650877429956,MATH 193A,A04,083782,Staff,0,7,30,30
1650877435983,MATH 197,001,091859,McAuley; Julian John,9998,0,9999,1
1650877442059,COGS 9,A01,083615,Staff,0,17,60,60
1650877448084,COGS 11,A01,083617,Boyle; Mary E. T.,15,0,40,25
1650877454109,COGS 13,A01,083071,Staff,0,38,40,40
1650877460134,COGS 14A,A01,092681,Staff,0,37,100,100
1650877466160,COGS 14B,A01,083073,Cheng; Tzu-Han,0,12,50,50
1650877472185,COGS 17,A01,092677,Staff,11,0,75,64
1650877478210,COGS 100,A01,083619,Staff,0,30,60,60
1650877484234,COGS 101A,A01,083621,Davis; Joshua Daniel,0,29,60,60
1650877490265,COGS 101B,A01,091572,Staff,0,3,60,60
1650877496290,COGS 101C,A01,083625,Delgado; Tania,14,0,30,16
1650877502315,COGS 107A,A01,083627,Boyle; Mary E. T.,0,16,60,60
1650877508341,COGS 118A,A01,083075,Staff,0,8,60,60
1650877514371,CSE 3,A50,083646,Miranda; Gregory Joseph,16,0,38,22
1650877514371,CSE 3,A51,083647,Miranda; Gregory Joseph,36,0,37,1
1650877520395,CSE 8A,A50,083650,Miranda; Gregory Joseph,0,29,40,40
1650877526420,CSE 11,A01,083080,Cao; Yingjun,0,97,40,40
1650877532444,CSE 12,A01,083652,Staff,0,21,100,100
1650877538472,CSE 15L,A01,083654,Staff,0,3,50,50
1650877538472,CSE 15L,A02,083655,Staff,0,3,50,50
1650877544494,CSE 20,A01,083657,Staff,48,0,80,32
1650877550520,CSE 30,A01,083084,Eldon; John,0,76,40,40
1650877556545,CSE 100,A01,083659,Cao; Yingjun,0,70,50,50
1650877562568,CSE 134B,A01,083661,Powell; Thomas Allan,0,38,65,65
1650877568594,CSE 140,A01,083663,Staff,0,12,75,75
1650877574621,CSE 140L,A01,083088,Eldon; John,0,20,75,75
1650877580646,CSE 175,A01,083665,Kumar; Rakesh,7,0,25,18
1650877586674,CSE 190,A00,092507,Dubnov; Shlomo,9,0,20,11
1650877592704,ECE 45,A01,083139,Staff,0,4,60,60
1650877598730,ECE 65,A50,083695,Staff,0,5,30,30
1650877604758,ECE 109,A01,091882,Touri; Behrouz,32,0,70,38
1650877610789,ECE 180,A00,083140,Abi Samra; Nicholas Camill,20,0,30,10
1650877610789,ECE 180,B00,083141,Abi Samra; Nicholas Camill,0,0,30,30
1650877616815,MATH 10A,A01,083735,Patchell; Gregory David,2,0,30,28
1650877616815,MATH 10A,A02,083736,Patchell; Gregory David,27,0,30,3
1650877616815,MATH 10A,A03,083737,Patchell; Gregory David,23,0,30,7
1650877622847,MATH 10B,A01,083207,Staff,0,9,30,30
1650877622847,MATH 10B,A02,083208,Staff,0,6,30,30
1650877622847,MATH 10B,B01,083739,Staff,10,0,30,20
1650877622847,MATH 10B,B02,083740,Staff,28,0,30,2
1650877628882,MATH 18,A01,083743,Staff,0,0,30,30
1650877628882,MATH 18,A02,083744,Staff,24,0,30,6
1650877628882,MATH 18,A03,083745,Staff,21,0,30,9
1650877628882,MATH 18,A04,083746,Staff,26,0,30,4
1650877628882,MATH 18,B01,083748,Staff,0,15,30,30
1650877628882,MATH 18,B02,083749,Staff,0,13,30,30
1650877628882,MATH 18,B03,083750,Staff,0,13,30,30
1650877628882,MATH 18,B04,083751,Staff,0,13,30,30
1650877634907,MATH 20A,A01,083754,Staff,19,0,40,21
1650877640941,MATH 20B,A01,083756,Staff,0,14,30,30
1650877640941,MATH 20B,A02,083757,Staff,0,11,30,30
1650877646966,MATH 20C,A01,083760,Staff,0,17,30,30
1650877646966,MATH 20C,A02,083761,Staff,1,16,30,29
1650877646966,MATH 20C,B01,083762,Staff,9,0,30,21
1650877646966,MATH 20C,B02,083763,Staff,28,0,30,2
1650877652991,MATH 20D,A01,083765,Staff,2,1,30,28
1650877652991,MATH 20D,A02,083766,Staff,6,0,30,24
1650877652991,MATH 20D,A03,083767,Staff,23,0,30,7
1650877659018,MATH 20E,A01,083771,Staff,2,0,30,28
1650877659018,MATH 20E,A02,083772,Staff,13,0,30,17
1650877659018,MATH 20E,B01,083773,Staff,0,0,30,30
1650877659018,MATH 20E,B02,083774,Staff,4,0,30,26
1650877665049,MATH 103A,A01,083777,Staff,0,17,30,30
1650877665049,MATH 103A,A02,083778,Staff,0,15,30,30
1650877665049,MATH 103A,B01,083779,Staff,0,15,30,30
1650877665049,MATH 103A,B02,083780,Staff,0,14,30,30
1650877671074,MATH 105,A01,085443,Staff,0,23,30,30
1650877677106,MATH 109,A01,083213,Anzaldo; Leesa B,0,7,30,30
1650877677106,MATH 109,A02,083214,Anzaldo; Leesa B,0,7,30,30
1650877677106,MATH 109,B01,083215,Anzaldo; Leesa B,0,8,30,30
1650877677106,MATH 109,B02,083216,Anzaldo; Leesa B,0,7,30,30
1650877683132,MATH 142A,A01,083219,Chow; Bennett,0,14,30,30
1650877683132,MATH 142A,A02,083220,Chow; Bennett,0,15,30,30
1650877683132,MATH 142A,B01,083221,Chow; Bennett,0,16,30,30
1650877683132,MATH 142A,B02,083222,Chow; Bennett,0,14,30,30
1650877689157,MATH 193A,A01,083224,Staff,0,6,30,30
1650877689157,MATH 193A,A02,083225,Staff,0,7,30,30
1650877689157,MATH 193A,A03,083781,Staff,0,6,30,30
1650877689157,MATH 193A,A04,083782,Staff,0,7,30,30
1650877695182,MATH 197,001,091859,McAuley; Julian John,9998,0,9999,1
1650877701256,COGS 9,A01,083615,Staff,0,17,60,60
1650877707284,COGS 11,A01,083617,Boyle; Mary E. T.,15,0,40,25
1650877713309,COGS 13,A01,083071,Staff,0,38,40,40
1650877719336,COGS 14A,A01,092681,Staff,0,37,100,100
1650877725366,COGS 14B,A01,083073,Cheng; Tzu-Han,0,12,50,50
1650877731396,COGS 17,A01,092677,Staff,11,0,75,64
1650877737426,COGS 100,A01,083619,Staff,0,30,60,60
1650877743458,COGS 101A,A01,083621,Davis; Joshua Daniel,0,29,60,60
1650877749485,COGS 101B,A01,091572,Staff,0,3,60,60
1650877755510,COGS 101C,A01,083625,Delgado; Tania,14,0,30,16
1650877761535,COGS 107A,A01,083627,Boyle; Mary E. T.,0,16,60,60
1650877767559,COGS 118A,A01,083075,Staff,0,8,60,60
1650877773584,CSE 3,A50,083646,Miranda; Gregory Joseph,16,0,38,22
1650877773584,CSE 3,A51,083647,Miranda; Gregory Joseph,36,0,37,1
1650877779608,CSE 8A,A50,083650,Miranda; Gregory Joseph,0,29,40,40
1650877785633,CSE 11,A01,083080,Cao; Yingjun,0,97,40,40
1650877791662,CSE 12,A01,083652,Staff,0,21,100,100
1650877797684,CSE 15L,A01,083654,Staff,0,3,50,50
1650877797684,CSE 15L,A02,083655,Staff,0,3,50,50
1650877803715,CSE 20,A01,083657,Staff,48,0,80,32
1650877809742,CSE 30,A01,083084,Eldon; John,0,76,40,40
1650877815770,CSE 100,A01,083659,Cao; Yingjun,0,70,50,50
1650877821800,CSE 134B,A01,083661,Powell; Thomas Allan,0,38,65,65
1650877827825,CSE 140,A01,083663,Staff,0,12,75,75
1650877833866,CSE 140L,A01,083088,Eldon; John,0,20,75,75
1650877839892,CSE 175,A01,083665,Kumar; Rakesh,7,0,25,18
1650877845916,CSE 190,A00,092507,Dubnov; Shlomo,9,0,20,11
1650877851942,ECE 45,A01,083139,Staff,0,4,60,60
1650877857987,ECE 65,A50,083695,Staff,0,5,30,30
1650877864014,ECE 109,A01,091882,Touri; Behrouz,32,0,70,38
1650877870040,ECE 180,A00,083140,Abi Samra; Nicholas Camill,20,0,30,10
1650877870040,ECE 180,B00,083141,Abi Samra; Nicholas Camill,0,0,30,30
1650877876073,MATH 10A,A01,083735,Patchell; Gregory David,2,0,30,28
1650877876073,MATH 10A,A02,083736,Patchell; Gregory David,27,0,30,3
1650877876073,MATH 10A,A03,083737,Patchell; Gregory David,23,0,30,7
1650877882104,MATH 10B,A01,083207,Staff,0,9,30,30
1650877882104,MATH 10B,A02,083208,Staff,0,6,30,30
1650877882104,MATH 10B,B01,083739,Staff,10,0,30,20
1650877882104,MATH 10B,B02,083740,Staff,28,0,30,2
1650877888141,MATH 18,A01,083743,Staff,0,0,30,30
1650877888141,MATH 18,A02,083744,Staff,24,0,30,6
1650877888141,MATH 18,A03,083745,Staff,21,0,30,9
1650877888141,MATH 18,A04,083746,Staff,26,0,30,4
1650877888141,MATH 18,B01,083748,Staff,0,15,30,30
1650877888141,MATH 18,B02,083749,Staff,0,13,30,30
1650877888141,MATH 18,B03,083750,Staff,0,13,30,30
1650877888141,MATH 18,B04,083751,Staff,0,13,30,30
1650877894167,MATH 20A,A01,083754,Staff,19,0,40,21
1650877900197,MATH 20B,A01,083756,Staff,0,14,30,30
1650877900197,MATH 20B,A02,083757,Staff,0,11,30,30
1650877906259,MATH 20C,A01,083760,Staff,0,17,30,30
1650877906259,MATH 20C,A02,083761,Staff,1,16,30,29
1650877906259,MATH 20C,B01,083762,Staff,9,0,30,21
1650877906259,MATH 20C,B02,083763,Staff,28,0,30,2
1650877912284,MATH 20D,A01,083765,Staff,2,1,30,28
1650877912284,MATH 20D,A02,083766,Staff,6,0,30,24
1650877912284,MATH 20D,A03,083767,Staff,23,0,30,7
1650877918316,MATH 20E,A01,083771,Staff,2,0,30,28
1650877918316,MATH 20E,A02,083772,Staff,13,0,30,17
1650877918316,MATH 20E,B01,083773,Staff,0,0,30,30
1650877918316,MATH 20E,B02,083774,Staff,4,0,30,26
1650877924350,MATH 103A,A01,083777,Staff,0,17,30,30
1650877924350,MATH 103A,A02,083778,Staff,0,15,30,30
1650877924350,MATH 103A,B01,083779,Staff,0,15,30,30
1650877924350,MATH 103A,B02,083780,Staff,0,14,30,30
1650877930376,MATH 105,A01,085443,Staff,0,23,30,30
1650877936408,MATH 109,A01,083213,Anzaldo; Leesa B,0,7,30,30
1650877936408,MATH 109,A02,083214,Anzaldo; Leesa B,0,7,30,30
1650877936408,MATH 109,B01,083215,Anzaldo; Leesa B,0,8,30,30
1650877936408,MATH 109,B02,083216,Anzaldo; Leesa B,0,7,30,30
1650877942435,MATH 142A,A01,083219,Chow; Bennett,0,14,30,30
1650877942435,MATH 142A,A02,083220,Chow; Bennett,0,15,30,30
1650877942435,MATH 142A,B01,083221,Chow; Bennett,0,16,30,30
1650877942435,MATH 142A,B02,083222,Chow; Bennett,0,14,30,30
1650877948463,MATH 193A,A01,083224,Staff,0,6,30,30
1650877948463,MATH 193A,A02,083225,Staff,0,7,30,30
1650877948463,MATH 193A,A03,083781,Staff,0,6,30,30
1650877948463,MATH 193A,A04,083782,Staff,0,7,30,30
1650877954494,MATH 197,001,091859,McAuley; Julian John,9998,0,9999,1
1650877960560,COGS 9,A01,083615,Staff,0,17,60,60
1650877966597,COGS 11,A01,083617,Boyle; Mary E. T.,15,0,40,25
1650877972627,COGS 13,A01,083071,Staff,0,38,40,40
1650877978655,COGS 14A,A01,092681,Staff,0,37,100,100
1650877984682,COGS 14B,A01,083073,Cheng; Tzu-Han,0,12,50,50
1650877990710,COGS 17,A01,092677,Staff,11,0,75,64
1650877996746,COGS 100,A01,083619,Staff,0,30,60,60
1650878002872,COGS 101A,A01,083621,Davis; Joshua Daniel,0,29,60,60
1650878008899,COGS 101B,A01,091572,Staff,0,3,60,60
1650878014930,COGS 101C,A01,083625,Delgado; Tania,14,0,30,16
1650878020964,COGS 107A,A01,083627,Boyle; Mary E. T.,0,16,60,60
1650878026988,COGS 118A,A01,083075,Staff,0,8,60,60
1650878033017,CSE 3,A50,083646,Miranda; Gregory Joseph,16,0,38,22
1650878033017,CSE 3,A51,083647,Miranda; Gregory Joseph,36,0,37,1
1650878039042,CSE 8A,A50,083650,Miranda; Gregory Joseph,0,29,40,40
1650878045076,CSE 11,A01,083080,Cao; Yingjun,0,97,40,40
1650878051111,CSE 12,A01,083652,Staff,0,21,100,100
1650878057140,CSE 15L,A01,083654,Staff,0,3,50,50
1650878057140,CSE 15L,A02,083655,Staff,0,3,50,50
1650878063165,CSE 20,A01,083657,Staff,48,0,80,32
1650878069191,CSE 30,A01,083084,Eldon; John,0,76,40,40
1650878075219,CSE 100,A01,083659,Cao; Yingjun,0,70,50,50
1650878081244,CSE 134B,A01,083661,Powell; Thomas Allan,0,38,65,65
1650878087273,CSE 140,A01,083663,Staff,0,12,75,75
1650878093306,CSE 140L,A01,083088,Eldon; John,0,20,75,75
1650878099338,CSE 175,A01,083665,Kumar; Rakesh,7,0,25,18
1650878105363,CSE 190,A00,092507,Dubnov; Shlomo,9,0,20,11
1650878111391,ECE 45,A01,083139,Staff,0,4,60,60
1650878117430,ECE 65,A50,083695,Staff,0,5,30,30
1650878123455,ECE 109,A01,091882,Touri; Behrouz,32,0,70,38
1650878129479,ECE 180,A00,083140,Abi Samra; Nicholas Camill,20,0,30,10
1650878129479,ECE 180,B00,083141,Abi Samra; Nicholas Camill,0,0,30,30
1650878135507,MATH 10A,A01,083735,Patchell; Gregory David,2,0,30,28
1650878135507,MATH 10A,A02,083736,Patchell; Gregory David,27,0,30,3
1650878135507,MATH 10A,A03,083737,Patchell; Gregory David,23,0,30,7
1650878141532,MATH 10B,A01,083207,Staff,0,9,30,30
1650878141532,MATH 10B,A02,083208,Staff,0,6,30,30
1650878141532,MATH 10B,B01,083739,Staff,10,0,30,20
1650878141532,MATH 10B,B02,083740,Staff,28,0,30,2
1650878147566,MATH 18,A01,083743,Staff,0,0,30,30
1650878147566,MATH 18,A02,083744,Staff,24,0,30,6
1650878147566,MATH 18,A03,083745,Staff,21,0,30,9
1650878147566,MATH 18,A04,083746,Staff,26,0,30,4
1650878147566,MATH 18,B01,083748,Staff,0,15,30,30
1650878147566,MATH 18,B02,083749,Staff,0,13,30,30
1650878147566,MATH 18,B03,083750,Staff,0,13,30,30
1650878147566,MATH 18,B04,083751,Staff,0,13,30,30
1650878153591,MATH 20A,A01,083754,Staff,19,0,40,21
1650878159617,MATH 20B,A01,083756,Staff,0,14,30,30
1650878159617,MATH 20B,A02,083757,Staff,0,11,30,30
1650878165647,MATH 20C,A01,083760,Staff,0,17,30,30
1650878165647,MATH 20C,A02,083761,Staff,1,16,30,29
1650878165647,MATH 20C,B01,083762,Staff,9,0,30,21
1650878165647,MATH 20C,B02,083763,Staff,28,0,30,2
1650878171674,MATH 20D,A01,083765,Staff,2,1,30,28
1650878171674,MATH 20D,A02,083766,Staff,6,0,30,24
1650878171674,MATH 20D,A03,083767,Staff,23,0,30,7
1650878177697,MATH 20E,A01,083771,Staff,2,0,30,28
1650878177697,MATH 20E,A02,083772,Staff,13,0,30,17
1650878177697,MATH 20E,B01,083773,Staff,0,0,30,30
1650878177697,MATH 20E,B02,083774,Staff,4,0,30,26
1650878183723,MATH 103A,A01,083777,Staff,0,17,30,30
1650878183723,MATH 103A,A02,083778,Staff,0,15,30,30
1650878183723,MATH 103A,B01,083779,Staff,0,15,30,30
1650878183723,MATH 103A,B02,083780,Staff,0,14,30,30
1650878189767,MATH 105,A01,085443,Staff,0,23,30,30
1650878195792,MATH 109,A01,083213,Anzaldo; Leesa B,0,7,30,30
1650878195792,MATH 109,A02,083214,Anzaldo; Leesa B,0,7,30,30
1650878195792,MATH 109,B01,083215,Anzaldo; Leesa B,0,8,30,30
1650878195792,MATH 109,B02,083216,Anzaldo; Leesa B,0,7,30,30
1650878201818,MATH 142A,A01,083219,Chow; Bennett,0,14,30,30
1650878201818,MATH 142A,A02,083220,Chow; Bennett,0,15,30,30
1650878201818,MATH 142A,B01,083221,Chow; Bennett,0,16,30,30
1650878201818,MATH 142A,B02,083222,Chow; Bennett,0,14,30,30
1650878207843,MATH 193A,A01,083224,Staff,0,6,30,30
1650878207843,MATH 193A,A02,083225,Staff,0,7,30,30
1650878207843,MATH 193A,A03,083781,Staff,0,6,30,30
1650878207843,MATH 193A,A04,083782,Staff,0,7,30,30
1650878213867,MATH 197,001,091859,McAuley; Julian John,9998,0,9999,1
1650878219959,COGS 9,A01,083615,Staff,0,17,60,60
1650878225984,COGS 11,A01,083617,Boyle; Mary E. T.,15,0,40,25
1650878232013,COGS 13,A01,083071,Staff,0,38,40,40
1650878238039,COGS 14A,A01,092681,Staff,0,37,100,100
1650878244063,COGS 14B,A01,083073,Cheng; Tzu-Han,0,12,50,50
1650878250091,COGS 17,A01,092677,Staff,11,0,75,64
1650878256116,COGS 100,A01,083619,Staff,0,30,60,60
1650878262142,COGS 101A,A01,083621,Davis; Joshua Daniel,0,29,60,60
1650878268167,COGS 101B,A01,091572,Staff,0,3,60,60
1650878274196,COGS 101C,A01,083625,Delgado; Tania,14,0,30,16
1650878280220,COGS 107A,A01,083627,Boyle; Mary E. T.,0,16,60,60
1650878286248,COGS 118A,A01,083075,Staff,0,8,60,60
1650878292284,CSE 3,A50,083646,Miranda; Gregory Joseph,16,0,38,22
1650878292284,CSE 3,A51,083647,Miranda; Gregory Joseph,36,0,37,1
1650878298309,CSE 8A,A50,083650,Miranda; Gregory Joseph,0,29,40,40
1650878304338,CSE 11,A01,083080,Cao; Yingjun,0,97,40,40
1650878310361,CSE 12,A01,083652,Staff,0,21,100,100
1650878316385,CSE 15L,A01,083654,Staff,0,3,50,50
1650878316385,CSE 15L,A02,083655,Staff,0,3,50,50
1650878322409,CSE 20,A01,083657,Staff,48,0,80,32
1650878328437,CSE 30,A01,083084,Eldon; John,0,76,40,40
1650878334462,CSE 100,A01,083659,Cao; Yingjun,0,70,50,50
1650878340491,CSE 134B,A01,083661,Powell; Thomas Allan,0,38,65,65
1650878346514,CSE 140,A01,083663,Staff,0,12,75,75
1650878352539,CSE 140L,A01,083088,Eldon; John,0,20,75,75
1650878358568,CSE 175,A01,083665,Kumar; Rakesh,7,0,25,18
1650878364593,CSE 190,A00,092507,Dubnov; Shlomo,9,0,20,11
1650878370619,ECE 45,A01,083139,Staff,0,4,60,60
1650878376645,ECE 65,A50,083695,Staff,0,5,30,30
1650878382670,ECE 109,A01,091882,Touri; Behrouz,32,0,70,38
1650878388696,ECE 180,A00,083140,Abi Samra; Nicholas Camill,20,0,30,10
1650878388696,ECE 180,B00,083141,Abi Samra; Nicholas Camill,0,0,30,30
1650878394722,MATH 10A,A01,083735,Patchell; Gregory David,2,0,30,28
1650878394722,MATH 10A,A02,083736,Patchell; Gregory David,27,0,30,3
1650878394722,MATH 10A,A03,083737,Patchell; Gregory David,23,0,30,7
1650878400750,MATH 10B,A01,083207,Staff,0,9,30,30
1650878400750,MATH 10B,A02,083208,Staff,0,6,30,30
1650878400750,MATH 10B,B01,083739,Staff,10,0,30,20
1650878400750,MATH 10B,B02,083740,Staff,28,0,30,2
1650878406795,MATH 18,A01,083743,Staff,0,0,30,30
1650878406795,MATH 18,A02,083744,Staff,24,0,30,6
1650878406795,MATH 18,A03,083745,Staff,21,0,30,9
1650878406795,MATH 18,A04,083746,Staff,26,0,30,4
1650878406795,MATH 18,B01,083748,Staff,0,15,30,30
1650878406795,MATH 18,B02,083749,Staff,0,13,30,30
1650878406795,MATH 18,B03,083750,Staff,0,13,30,30
1650878406795,MATH 18,B04,083751,Staff,0,13,30,30
1650878412823,MATH 20A,A01,083754,Staff,19,0,40,21
1650878418853,MATH 20B,A01,083756,Staff,0,14,30,30
1650878418853,MATH 20B,A02,083757,Staff,0,11,30,30
1650878424898,MATH 20C,A01,083760,Staff,0,17,30,30
1650878424898,MATH 20C,A02,083761,Staff,1,16,30,29
1650878424898,MATH 20C,B01,083762,Staff,9,0,30,21
1650878424898,MATH 20C,B02,083763,Staff,28,0,30,2
1650878430923,MATH 20D,A01,083765,Staff,2,1,30,28
1650878430923,MATH 20D,A02,083766,Staff,6,0,30,24
1650878430923,MATH 20D,A03,083767,Staff,23,0,30,7
1650878436948,MATH 20E,A01,083771,Staff,2,0,30,28
1650878436948,MATH 20E,A02,083772,Staff,13,0,30,17
1650878436948,MATH 20E,B01,083773,Staff,0,0,30,30
1650878436948,MATH 20E,B02,083774,Staff,4,0,30,26
1650878442981,MATH 103A,A01,083777,Staff,0,17,30,30
1650878442981,MATH 103A,A02,083778,Staff,0,15,30,30
1650878442981,MATH 103A,B01,083779,Staff,0,15,30,30
1650878442981,MATH 103A,B02,083780,Staff,0,14,30,30
1650878449011,MATH 105,A01,085443,Staff,0,23,30,30
1650878455035,MATH 109,A01,083213,Anzaldo; Leesa B,0,7,30,30
1650878455035,MATH 109,A02,083214,Anzaldo; Leesa B,0,7,30,30
1650878455035,MATH 109,B01,083215,Anzaldo; Leesa B,0,8,30,30
1650878455035,MATH 109,B02,083216,Anzaldo; Leesa B,0,7,30,30
1650878461061,MATH 142A,A01,083219,Chow; Bennett,0,14,30,30
1650878461061,MATH 142A,A02,083220,Chow; Bennett,0,15,30,30
1650878461061,MATH 142A,B01,083221,Chow; Bennett,0,16,30,30
1650878461061,MATH 142A,B02,083222,Chow; Bennett,0,14,30,30
1650878467085,MATH 193A,A01,083224,Staff,0,6,30,30
1650878467085,MATH 193A,A02,083225,Staff,0,7,30,30
1650878467085,MATH 193A,A03,083781,Staff,0,6,30,30
1650878467085,MATH 193A,A04,083782,Staff,0,7,30,30
1650878473112,MATH 197,001,091859,McAuley; Julian John,9998,0,9999,1
1650878479172,COGS 9,A01,083615,Staff,0,17,60,60
1650878485201,COGS 11,A01,083617,Boyle; Mary E. T.,15,0,40,25
1650878491239,COGS 13,A01,083071,Staff,0,38,40,40
1650878497281,COGS 14A,A01,092681,Staff,0,37,100,100
1650878503321,COGS 14B,A01,083073,Cheng; Tzu-Han,0,12,50,50
1650878509346,COGS 17,A01,092677,Staff,11,0,75,64
1650878515374,COGS 100,A01,083619,Staff,0,30,60,60
1650878521410,COGS 101A,A01,083621,Davis; Joshua Daniel,0,29,60,60
1650878527436,COGS 101B,A01,091572,Staff,0,3,60,60
1650878533462,COGS 101C,A01,083625,Delgado; Tania,14,0,30,16
1650878539486,COGS 107A,A01,083627,Boyle; Mary E. T.,0,16,60,60
1650878545509,COGS 118A,A01,083075,Staff,0,8,60,60
1650878551538,CSE 3,A50,083646,Miranda; Gregory Joseph,16,0,38,22
1650878551538,CSE 3,A51,083647,Miranda; Gregory Joseph,36,0,37,1
1650878557569,CSE 8A,A50,083650,Miranda; Gregory Joseph,0,29,40,40
1650878563594,CSE 11,A01,083080,Cao; Yingjun,0,97,40,40
1650878569625,CSE 12,A01,083652,Staff,0,21,100,100
1650878575653,CSE 15L,A01,083654,Staff,0,3,50,50
1650878575653,CSE 15L,A02,083655,Staff,0,3,50,50
1650878581681,CSE 20,A01,083657,Staff,48,0,80,32
1650878587710,CSE 30,A01,083084,Eldon; John,0,76,40,40
1650878593735,CSE 100,A01,083659,Cao; Yingjun,0,70,50,50
1650878599859,CSE 134B,A01,083661,Powell; Thomas Allan,0,38,65,65
1650878605887,CSE 140,A01,083663,Staff,0,12,75,75
1650878611917,CSE 140L,A01,083088,Eldon; John,0,20,75,75
1650878617947,CSE 175,A01,083665,Kumar; Rakesh,7,0,25,18
1650878623978,CSE 190,A00,092507,Dubnov; Shlomo,9,0,20,11
1650878630010,ECE 45,A01,083139,Staff,0,4,60,60
1650878636049,ECE 65,A50,083695,Staff,0,5,30,30
1650878642075,ECE 109,A01,091882,Touri; Behrouz,32,0,70,38
1650878648102,ECE 180,A00,083140,Abi Samra; Nicholas Camill,20,0,30,10
1650878648102,ECE 180,B00,083141,Abi Samra; Nicholas Camill,0,0,30,30
1650878654128,MATH 10A,A01,083735,Patchell; Gregory David,2,0,30,28
1650878654128,MATH 10A,A02,083736,Patchell; Gregory David,27,0,30,3
1650878654128,MATH 10A,A03,083737,Patchell; Gregory David,23,0,30,7
1650878660161,MATH 10B,A01,083207,Staff,0,9,30,30
1650878660161,MATH 10B,A02,083208,Staff,0,6,30,30
1650878660161,MATH 10B,B01,083739,Staff,10,0,30,20
1650878660161,MATH 10B,B02,083740,Staff,28,0,30,2
1650878666203,MATH 18,A01,083743,Staff,0,0,30,30
1650878666203,MATH 18,A02,083744,Staff,24,0,30,6
1650878666203,MATH 18,A03,083745,Staff,21,0,30,9
1650878666203,MATH 18,A04,083746,Staff,26,0,30,4
1650878666203,MATH 18,B01,083748,Staff,0,15,30,30
1650878666203,MATH 18,B02,083749,Staff,0,13,30,30
1650878666203,MATH 18,B03,083750,Staff,0,13,30,30
1650878666203,MATH 18,B04,083751,Staff,0,13,30,30
1650878672228,MATH 20A,A01,083754,Staff,19,0,40,21
1650878678263,MATH 20B,A01,083756,Staff,0,14,30,30
1650878678263,MATH 20B,A02,083757,Staff,0,11,30,30
1650878684289,MATH 20C,A01,083760,Staff,0,17,30,30
1650878684289,MATH 20C,A02,083761,Staff,1,16,30,29
1650878684289,MATH 20C,B01,083762,Staff,9,0,30,21
1650878684289,MATH 20C,B02,083763,Staff,28,0,30,2
1650878690314,MATH 20D,A01,083765,Staff,2,1,30,28
1650878690314,MATH 20D,A02,083766,Staff,6,0,30,24
1650878690314,MATH 20D,A03,083767,Staff,23,0,30,7
1650878696339,MATH 20E,A01,083771,Staff,2,0,30,28
1650878696339,MATH 20E,A02,083772,Staff,13,0,30,17
1650878696339,MATH 20E,B01,083773,Staff,0,0,30,30
1650878696339,MATH 20E,B02,083774,Staff,4,0,30,26
1650878702372,MATH 103A,A01,083777,Staff,0,17,30,30
1650878702372,MATH 103A,A02,083778,Staff,0,15,30,30
1650878702372,MATH 103A,B01,083779,Staff,0,15,30,30
1650878702372,MATH 103A,B02,083780,Staff,0,14,30,30
1650878708399,MATH 105,A01,085443,Staff,0,23,30,30
1650878714430,MATH 109,A01,083213,Anzaldo; Leesa B,0,7,30,30
1650878714430,MATH 109,A02,083214,Anzaldo; Leesa B,0,7,30,30
1650878714430,MATH 109,B01,083215,Anzaldo; Leesa B,0,8,30,30
1650878714430,MATH 109,B02,083216,Anzaldo; Leesa B,0,7,30,30
1650878720459,MATH 142A,A01,083219,Chow; Bennett,0,14,30,30
1650878720459,MATH 142A,A02,083220,Chow; Bennett,0,15,30,30
1650878720459,MATH 142A,B01,083221,Chow; Bennett,0,16,30,30
1650878720459,MATH 142A,B02,083222,Chow; Bennett,0,14,30,30
1650878726488,MATH 193A,A01,083224,Staff,0,6,30,30
1650878726488,MATH 193A,A02,083225,Staff,0,7,30,30
1650878726488,MATH 193A,A03,083781,Staff,0,6,30,30
1650878726488,MATH 193A,A04,083782,Staff,0,7,30,30
1650878732514,MATH 197,001,091859,McAuley; Julian John,9998,0,9999,1
1650878738588,COGS 9,A01,083615,Staff,0,17,60,60
1650878744616,COGS 11,A01,083617,Boyle; Mary E. T.,15,0,40,25
1650878750639,COGS 13,A01,083071,Staff,0,38,40,40
1650878756665,COGS 14A,A01,092681,Staff,0,37,100,100
1650878762696,COGS 14B,A01,083073,Cheng; Tzu-Han,0,12,50,50
1650878773561,COGS 17,A01,092677,Staff,11,0,75,64
1650878779589,COGS 100,A01,083619,Staff,0,30,60,60
1650878785618,COGS 101A,A01,083621,Davis; Joshua Daniel,0,29,60,60
1650878791647,COGS 101B,A01,091572,Staff,0,3,60,60
1650878797679,COGS 101C,A01,083625,Delgado; Tania,14,0,30,16
1650878803708,COGS 107A,A01,083627,Boyle; Mary E. T.,0,16,60,60
1650878809734,COGS 118A,A01,083075,Staff,0,8,60,60
1650878815760,CSE 3,A50,083646,Miranda; Gregory Joseph,16,0,38,22
1650878815760,CSE 3,A51,083647,Miranda; Gregory Joseph,36,0,37,1
1650878821787,CSE 8A,A50,083650,Miranda; Gregory Joseph,0,29,40,40
1650878827816,CSE 11,A01,083080,Cao; Yingjun,0,97,40,40
1650878833840,CSE 12,A01,083652,Staff,0,21,100,100
1650878839864,CSE 15L,A01,083654,Staff,0,3,50,50
1650878839864,CSE 15L,A02,083655,Staff,0,3,50,50
1650878845889,CSE 20,A01,083657,Staff,48,0,80,32
1650878851915,CSE 30,A01,083084,Eldon; John,0,76,40,40
1650878857940,CSE 100,A01,083659,Cao; Yingjun,0,70,50,50
1650878863966,CSE 134B,A01,083661,Powell; Thomas Allan,0,38,65,65
1650878869993,CSE 140,A01,083663,Staff,0,12,75,75
1650878876018,CSE 140L,A01,083088,Eldon; John,0,20,75,75
1650878882048,CSE 175,A01,083665,Kumar; Rakesh,7,0,25,18
1650878888074,CSE 190,A00,092507,Dubnov; Shlomo,9,0,20,11
1650878894103,ECE 45,A01,083139,Staff,0,4,60,60
1650878900129,ECE 65,A50,083695,Staff,0,5,30,30
1650878906158,ECE 109,A01,091882,Touri; Behrouz,32,0,70,38
1650878912183,ECE 180,A00,083140,Abi Samra; Nicholas Camill,20,0,30,10
1650878912183,ECE 180,B00,083141,Abi Samra; Nicholas Camill,0,0,30,30
1650878918210,MATH 10A,A01,083735,Patchell; Gregory David,2,0,30,28
1650878918210,MATH 10A,A02,083736,Patchell; Gregory David,27,0,30,3
1650878918210,MATH 10A,A03,083737,Patchell; Gregory David,23,0,30,7
1650878924234,MATH 10B,A01,083207,Staff,0,9,30,30
1650878924234,MATH 10B,A02,083208,Staff,0,6,30,30
1650878924234,MATH 10B,B01,083739,Staff,10,0,30,20
1650878924234,MATH 10B,B02,083740,Staff,28,0,30,2
1650878930268,MATH 18,A01,083743,Staff,0,0,30,30
1650878930268,MATH 18,A02,083744,Staff,24,0,30,6
1650878930268,MATH 18,A03,083745,Staff,21,0,30,9
1650878930268,MATH 18,A04,083746,Staff,26,0,30,4
1650878930268,MATH 18,B01,083748,Staff,0,15,30,30
1650878930268,MATH 18,B02,083749,Staff,0,13,30,30
1650878930268,MATH 18,B03,083750,Staff,0,13,30,30
1650878930268,MATH 18,B04,083751,Staff,0,13,30,30
1650878936302,MATH 20A,A01,083754,Staff,19,0,40,21
1650878942331,MATH 20B,A01,083756,Staff,0,14,30,30
1650878942331,MATH 20B,A02,083757,Staff,0,11,30,30
1650878948360,MATH 20C,A01,083760,Staff,0,17,30,30
1650878948360,MATH 20C,A02,083761,Staff,1,16,30,29
1650878948360,MATH 20C,B01,083762,Staff,9,0,30,21
1650878948360,MATH 20C,B02,083763,Staff,28,0,30,2
1650878954387,MATH 20D,A01,083765,Staff,2,1,30,28
1650878954387,MATH 20D,A02,083766,Staff,6,0,30,24
1650878954387,MATH 20D,A03,083767,Staff,23,0,30,7
1650878960408,MATH 20E,A01,083771,Staff,2,0,30,28
1650878960408,MATH 20E,A02,083772,Staff,13,0,30,17
1650878960408,MATH 20E,B01,083773,Staff,0,0,30,30
1650878960408,MATH 20E,B02,083774,Staff,4,0,30,26
1650878966434,MATH 103A,A01,083777,Staff,0,17,30,30
1650878966434,MATH 103A,A02,083778,Staff,0,15,30,30
1650878966434,MATH 103A,B01,083779,Staff,0,15,30,30
1650878966434,MATH 103A,B02,083780,Staff,0,14,30,30
1650878972456,MATH 105,A01,085443,Staff,0,23,30,30
1650878978484,MATH 109,A01,083213,Anzaldo; Leesa B,0,7,30,30
1650878978484,MATH 109,A02,083214,Anzaldo; Leesa B,0,7,30,30
1650878978484,MATH 109,B01,083215,Anzaldo; Leesa B,0,8,30,30
1650878978484,MATH 109,B02,083216,Anzaldo; Leesa B,0,7,30,30
1650878984509,MATH 142A,A01,083219,Chow; Bennett,0,14,30,30
1650878984509,MATH 142A,A02,083220,Chow; Bennett,0,15,30,30
1650878984509,MATH 142A,B01,083221,Chow; Bennett,0,16,30,30
1650878984509,MATH 142A,B02,083222,Chow; Bennett,0,14,30,30
1650878990532,MATH 193A,A01,083224,Staff,0,6,30,30
1650878990532,MATH 193A,A02,083225,Staff,0,7,30,30
1650878990532,MATH 193A,A03,083781,Staff,0,6,30,30
1650878990532,MATH 193A,A04,083782,Staff,0,7,30,30
1650878996558,MATH 197,001,091859,McAuley; Julian John,9998,0,9999,1
1650879002630,COGS 9,A01,083615,Staff,0,17,60,60
1650879008657,COGS 11,A01,083617,Boyle; Mary E. T.,15,0,40,25
1650879014693,COGS 13,A01,083071,Staff,0,38,40,40
1650879020722,COGS 14A,A01,092681,Staff,0,37,100,100
1650879026746,COGS 14B,A01,083073,Cheng; Tzu-Han,0,12,50,50
1650879032771,COGS 17,A01,092677,Staff,11,0,75,64
1650879038798,COGS 100,A01,083619,Staff,0,30,60,60
1650879044835,COGS 101A,A01,083621,Davis; Joshua Daniel,0,29,60,60
1650879050858,COGS 101B,A01,091572,Staff,0,3,60,60
1650879056883,COGS 101C,A01,083625,Delgado; Tania,14,0,30,16
1650879062906,COGS 107A,A01,083627,Boyle; Mary E. T.,0,16,60,60
1650879068933,COGS 118A,A01,083075,Staff,0,8,60,60
1650879074960,CSE 3,A50,083646,Miranda; Gregory Joseph,16,0,38,22
1650879074960,CSE 3,A51,083647,Miranda; Gregory Joseph,36,0,37,1
1650879080985,CSE 8A,A50,083650,Miranda; Gregory Joseph,0,29,40,40
1650879087013,CSE 11,A01,083080,Cao; Yingjun,0,97,40,40
1650879093038,CSE 12,A01,083652,Staff,0,21,100,100
1650879099062,CSE 15L,A01,083654,Staff,0,3,50,50
1650879099062,CSE 15L,A02,083655,Staff,0,3,50,50
1650879105086,CSE 20,A01,083657,Staff,48,0,80,32
1650879111111,CSE 30,A01,083084,Eldon; John,0,76,40,40
1650879117136,CSE 100,A01,083659,Cao; Yingjun,0,70,50,50
1650879123167,CSE 134B,A01,083661,Powell; Thomas Allan,0,38,65,65
1650879129197,CSE 140,A01,083663,Staff,0,12,75,75
1650879135223,CSE 140L,A01,083088,Eldon; John,0,20,75,75
1650879141246,CSE 175,A01,083665,Kumar; Rakesh,7,0,25,18
1650879147278,CSE 190,A00,092507,Dubnov; Shlomo,9,0,20,11
1650879153310,ECE 45,A01,083139,Staff,0,4,60,60
1650879159345,ECE 65,A50,083695,Staff,0,5,30,30
1650879165374,ECE 109,A01,091882,Touri; Behrouz,32,0,70,38
1650879171398,ECE 180,A00,083140,Abi Samra; Nicholas Camill,20,0,30,10
1650879171398,ECE 180,B00,083141,Abi Samra; Nicholas Camill,0,0,30,30
1650879177427,MATH 10A,A01,083735,Patchell; Gregory David,2,0,30,28
1650879177427,MATH 10A,A02,083736,Patchell; Gregory David,27,0,30,3
1650879177427,MATH 10A,A03,083737,Patchell; Gregory David,23,0,30,7
1650879183453,MATH 10B,A01,083207,Staff,0,9,30,30
1650879183453,MATH 10B,A02,083208,Staff,0,6,30,30
1650879183453,MATH 10B,B01,083739,Staff,10,0,30,20
1650879183453,MATH 10B,B02,083740,Staff,28,0,30,2
1650879189482,MATH 18,A01,083743,Staff,0,0,30,30
1650879189482,MATH 18,A02,083744,Staff,24,0,30,6
1650879189482,MATH 18,A03,083745,Staff,21,0,30,9
1650879189482,MATH 18,A04,083746,Staff,26,0,30,4
1650879189482,MATH 18,B01,083748,Staff,0,15,30,30
1650879189482,MATH 18,B02,083749,Staff,0,13,30,30
1650879189482,MATH 18,B03,083750,Staff,0,13,30,30
1650879189482,MATH 18,B04,083751,Staff,0,13,30,30
1650879195507,MATH 20A,A01,083754,Staff,19,0,40,21
1650879201624,MATH 20B,A01,083756,Staff,0,14,30,30
1650879201624,MATH 20B,A02,083757,Staff,0,11,30,30
1650879207646,MATH 20C,A01,083760,Staff,0,17,30,30
1650879207646,MATH 20C,A02,083761,Staff,1,16,30,29
1650879207646,MATH 20C,B01,083762,Staff,9,0,30,21
1650879207646,MATH 20C,B02,083763,Staff,28,0,30,2
1650879213672,MATH 20D,A01,083765,Staff,2,1,30,28
1650879213672,MATH 20D,A02,083766,Staff,6,0,30,24
1650879213672,MATH 20D,A03,083767,Staff,23,0,30,7
1650879219704,MATH 20E,A01,083771,Staff,2,0,30,28
1650879219704,MATH 20E,A02,083772,Staff,13,0,30,17
1650879219704,MATH 20E,B01,083773,Staff,0,0,30,30
1650879219704,MATH 20E,B02,083774,Staff,4,0,30,26
1650879225744,MATH 103A,A01,083777,Staff,0,17,30,30
1650879225744,MATH 103A,A02,083778,Staff,0,15,30,30
1650879225744,MATH 103A,B01,083779,Staff,0,15,30,30
1650879225744,MATH 103A,B02,083780,Staff,0,14,30,30
1650879231771,MATH 105,A01,085443,Staff,0,23,30,30
1650879237799,MATH 109,A01,083213,Anzaldo; Leesa B,0,7,30,30
1650879237799,MATH 109,A02,083214,Anzaldo; Leesa B,0,7,30,30
1650879237799,MATH 109,B01,083215,Anzaldo; Leesa B,0,8,30,30
1650879237799,MATH 109,B02,083216,Anzaldo; Leesa B,0,7,30,30
1650879243825,MATH 142A,A01,083219,Chow; Bennett,0,14,30,30
1650879243825,MATH 142A,A02,083220,Chow; Bennett,0,15,30,30
1650879243825,MATH 142A,B01,083221,Chow; Bennett,0,16,30,30
1650879243825,MATH 142A,B02,083222,Chow; Bennett,0,14,30,30
1650879249847,MATH 193A,A01,083224,Staff,0,6,30,30
1650879249847,MATH 193A,A02,083225,Staff,0,7,30,30
1650879249847,MATH 193A,A03,083781,Staff,0,6,30,30
1650879249847,MATH 193A,A04,083782,Staff,0,7,30,30
1650879255873,MATH 197,001,091859,McAuley; Julian John,9998,0,9999,1
1650879261927,COGS 9,A01,083615,Staff,0,17,60,60
1650879267955,COGS 11,A01,083617,Boyle; Mary E. T.,15,0,40,25
1650879273984,COGS 13,A01,083071,Staff,0,38,40,40
1650879280011,COGS 14A,A01,092681,Staff,0,37,100,100
1650879286038,COGS 14B,A01,083073,Cheng; Tzu-Han,0,12,50,50
1650879292074,COGS 17,A01,092677,Staff,11,0,75,64
1650879298096,COGS 100,A01,083619,Staff,0,30,60,60
1650879304119,COGS 101A,A01,083621,Davis; Joshua Daniel,0,29,60,60
1650879310146,COGS 101B,A01,091572,Staff,0,3,60,60
1650879316173,COGS 101C,A01,083625,Delgado; Tania,14,0,30,16
1650879322199,COGS 107A,A01,083627,Boyle; Mary E. T.,0,16,60,60
1650879328224,COGS 118A,A01,083075,Staff,0,8,60,60
1650879334268,CSE 3,A50,083646,Miranda; Gregory Joseph,16,0,38,22
1650879334268,CSE 3,A51,083647,Miranda; Gregory Joseph,36,0,37,1
1650879340291,CSE 8A,A50,083650,Miranda; Gregory Joseph,0,29,40,40
1650879346316,CSE 11,A01,083080,Cao; Yingjun,0,97,40,40
1650879352347,CSE 12,A01,083652,Staff,0,21,100,100
1650879358370,CSE 15L,A01,083654,Staff,0,3,50,50
1650879358370,CSE 15L,A02,083655,Staff,0,3,50,50
1650879364395,CSE 20,A01,083657,Staff,48,0,80,32
1650879370425,CSE 30,A01,083084,Eldon; John,0,76,40,40
1650879376448,CSE 100,A01,083659,Cao; Yingjun,0,70,50,50
1650879382472,CSE 134B,A01,083661,Powell; Thomas Allan,0,38,65,65
1650879388500,CSE 140,A01,083663,Staff,0,12,75,75
1650879394524,CSE 140L,A01,083088,Eldon; John,0,20,75,75
1650879400548,CSE 175,A01,083665,Kumar; Rakesh,7,0,25,18
1650879406577,CSE 190,A00,092507,Dubnov; Shlomo,9,0,20,11
1650879412601,ECE 45,A01,083139,Staff,0,4,60,60
1650879418635,ECE 65,A50,083695,Staff,0,5,30,30
1650879424657,ECE 109,A01,091882,Touri; Behrouz,32,0,70,38
1650879430688,ECE 180,A00,083140,Abi Samra; Nicholas Camill,20,0,30,10
1650879430688,ECE 180,B00,083141,Abi Samra; Nicholas Camill,0,0,30,30
1650879436714,MATH 10A,A01,083735,Patchell; Gregory David,2,0,30,28
1650879436714,MATH 10A,A02,083736,Patchell; Gregory David,27,0,30,3
1650879436714,MATH 10A,A03,083737,Patchell; Gregory David,23,0,30,7
1650879443062,MATH 10B,A01,083207,Staff,0,9,30,30
1650879443062,MATH 10B,A02,083208,Staff,0,6,30,30
1650879443062,MATH 10B,B01,083739,Staff,10,0,30,20
1650879443062,MATH 10B,B02,083740,Staff,28,0,30,2
1650879449095,MATH 18,A01,083743,Staff,0,0,30,30
1650879449095,MATH 18,A02,083744,Staff,24,0,30,6
1650879449095,MATH 18,A03,083745,Staff,21,0,30,9
1650879449095,MATH 18,A04,083746,Staff,26,0,30,4
1650879449095,MATH 18,B01,083748,Staff,0,15,30,30
1650879449095,MATH 18,B02,083749,Staff,0,13,30,30
1650879449095,MATH 18,B03,083750,Staff,0,13,30,30
1650879449095,MATH 18,B04,083751,Staff,0,13,30,30
1650879455131,MATH 20A,A01,083754,Staff,19,0,40,21
1650879461156,MATH 20B,A01,083756,Staff,0,14,30,30
1650879461156,MATH 20B,A02,083757,Staff,0,11,30,30
1650879467183,MATH 20C,A01,083760,Staff,0,17,30,30
1650879467183,MATH 20C,A02,083761,Staff,1,16,30,29
1650879467183,MATH 20C,B01,083762,Staff,9,0,30,21
1650879467183,MATH 20C,B02,083763,Staff,28,0,30,2
1650879473226,MATH 20D,A01,083765,Staff,2,1,30,28
1650879473226,MATH 20D,A02,083766,Staff,6,0,30,24
1650879473226,MATH 20D,A03,083767,Staff,23,0,30,7
1650879479253,MATH 20E,A01,083771,Staff,2,0,30,28
1650879479253,MATH 20E,A02,083772,Staff,13,0,30,17
1650879479253,MATH 20E,B01,083773,Staff,0,0,30,30
1650879479253,MATH 20E,B02,083774,Staff,4,0,30,26
1650879485282,MATH 103A,A01,083777,Staff,0,17,30,30
1650879485282,MATH 103A,A02,083778,Staff,0,15,30,30
1650879485282,MATH 103A,B01,083779,Staff,0,15,30,30
1650879485282,MATH 103A,B02,083780,Staff,0,14,30,30
1650879491311,MATH 105,A01,085443,Staff,0,23,30,30
1650879497335,MATH 109,A01,083213,Anzaldo; Leesa B,0,7,30,30
1650879497335,MATH 109,A02,083214,Anzaldo; Leesa B,0,7,30,30
1650879497335,MATH 109,B01,083215,Anzaldo; Leesa B,0,8,30,30
1650879497335,MATH 109,B02,083216,Anzaldo; Leesa B,0,7,30,30
1650879503369,MATH 142A,A01,083219,Chow; Bennett,0,14,30,30
1650879503369,MATH 142A,A02,083220,Chow; Bennett,0,15,30,30
1650879503369,MATH 142A,B01,083221,Chow; Bennett,0,16,30,30
1650879503369,MATH 142A,B02,083222,Chow; Bennett,0,14,30,30
1650879509398,MATH 193A,A01,083224,Staff,0,6,30,30
1650879509398,MATH 193A,A02,083225,Staff,0,7,30,30
1650879509398,MATH 193A,A03,083781,Staff,0,6,30,30
1650879509398,MATH 193A,A04,083782,Staff,0,7,30,30
1650879515426,MATH 197,001,091859,McAuley; Julian John,9998,0,9999,1
1650879521503,COGS 9,A01,083615,Staff,0,17,60,60
1650879527540,COGS 11,A01,083617,Boyle; Mary E. T.,15,0,40,25
1650879533577,COGS 13,A01,083071,Staff,0,38,40,40
1650879539614,COGS 14A,A01,092681,Staff,0,37,100,100
1650879545641,COGS 14B,A01,083073,Cheng; Tzu-Han,0,12,50,50
1650879551665,COGS 17,A01,092677,Staff,11,0,75,64
1650879557694,COGS 100,A01,083619,Staff,0,30,60,60
1650879563718,COGS 101A,A01,083621,Davis; Joshua Daniel,0,29,60,60
1650879569745,COGS 101B,A01,091572,Staff,0,3,60,60
1650879575771,COGS 101C,A01,083625,Delgado; Tania,14,0,30,16
1650879581796,COGS 107A,A01,083627,Boyle; Mary E. T.,0,16,60,60
1650879587820,COGS 118A,A01,083075,Staff,0,8,60,60
1650879593846,CSE 3,A50,083646,Miranda; Gregory Joseph,16,0,38,22
1650879593846,CSE 3,A51,083647,Miranda; Gregory Joseph,36,0,37,1
1650879599874,CSE 8A,A50,083650,Miranda; Gregory Joseph,0,29,40,40
1650879605907,CSE 11,A01,083080,Cao; Yingjun,0,97,40,40
1650879611930,CSE 12,A01,083652,Staff,0,21,100,100
1650879617955,CSE 15L,A01,083654,Staff,0,3,50,50
1650879617955,CSE 15L,A02,083655,Staff,0,3,50,50
1650879623981,CSE 20,A01,083657,Staff,48,0,80,32
1650879630006,CSE 30,A01,083084,Eldon; John,0,76,40,40
1650879636033,CSE 100,A01,083659,Cao; Yingjun,0,70,50,50
1650879642058,CSE 134B,A01,083661,Powell; Thomas Allan,0,38,65,65
1650879648085,CSE 140,A01,083663,Staff,0,12,75,75
1650879654110,CSE 140L,A01,083088,Eldon; John,0,20,75,75
1650879660143,CSE 175,A01,083665,Kumar; Rakesh,7,0,25,18
1650879666172,CSE 190,A00,092507,Dubnov; Shlomo,9,0,20,11
1650879672199,ECE 45,A01,083139,Staff,0,4,60,60
1650879678229,ECE 65,A50,083695,Staff,0,5,30,30
1650879684254,ECE 109,A01,091882,Touri; Behrouz,32,0,70,38
1650879690282,ECE 180,A00,083140,Abi Samra; Nicholas Camill,20,0,30,10
1650879690282,ECE 180,B00,083141,Abi Samra; Nicholas Camill,0,0,30,30
1650879696313,MATH 10A,A01,083735,Patchell; Gregory David,2,0,30,28
1650879696313,MATH 10A,A02,083736,Patchell; Gregory David,27,0,30,3
1650879696313,MATH 10A,A03,083737,Patchell; Gregory David,23,0,30,7
1650879702338,MATH 10B,A01,083207,Staff,0,9,30,30
1650879702338,MATH 10B,A02,083208,Staff,0,6,30,30
1650879702338,MATH 10B,B01,083739,Staff,10,0,30,20
1650879702338,MATH 10B,B02,083740,Staff,28,0,30,2
1650879708365,MATH 18,A01,083743,Staff,0,0,30,30
1650879708365,MATH 18,A02,083744,Staff,24,0,30,6
1650879708365,MATH 18,A03,083745,Staff,21,0,30,9
1650879708365,MATH 18,A04,083746,Staff,26,0,30,4
1650879708365,MATH 18,B01,083748,Staff,0,15,30,30
1650879708365,MATH 18,B02,083749,Staff,0,13,30,30
1650879708365,MATH 18,B03,083750,Staff,0,13,30,30
1650879708365,MATH 18,B04,083751,Staff,0,13,30,30
1650879714389,MATH 20A,A01,083754,Staff,19,0,40,21
1650879720414,MATH 20B,A01,083756,Staff,0,14,30,30
1650879720414,MATH 20B,A02,083757,Staff,0,11,30,30
1650879726448,MATH 20C,A01,083760,Staff,0,17,30,30
1650879726448,MATH 20C,A02,083761,Staff,1,16,30,29
1650879726448,MATH 20C,B01,083762,Staff,9,0,30,21
1650879726448,MATH 20C,B02,083763,Staff,28,0,30,2
1650879732476,MATH 20D,A01,083765,Staff,2,1,30,28
1650879732476,MATH 20D,A02,083766,Staff,6,0,30,24
1650879732476,MATH 20D,A03,083767,Staff,23,0,30,7
1650879738505,MATH 20E,A01,083771,Staff,2,0,30,28
1650879738505,MATH 20E,A02,083772,Staff,13,0,30,17
1650879738505,MATH 20E,B01,083773,Staff,0,0,30,30
1650879738505,MATH 20E,B02,083774,Staff,4,0,30,26
1650879744532,MATH 103A,A01,083777,Staff,0,17,30,30
1650879744532,MATH 103A,A02,083778,Staff,0,15,30,30
1650879744532,MATH 103A,B01,083779,Staff,0,15,30,30
1650879744532,MATH 103A,B02,083780,Staff,0,14,30,30
1650879750558,MATH 105,A01,085443,Staff,0,23,30,30
1650879756584,MATH 109,A01,083213,Anzaldo; Leesa B,0,7,30,30
1650879756584,MATH 109,A02,083214,Anzaldo; Leesa B,0,7,30,30
1650879756584,MATH 109,B01,083215,Anzaldo; Leesa B,0,8,30,30
1650879756584,MATH 109,B02,083216,Anzaldo; Leesa B,0,7,30,30
1650879762605,MATH 142A,A01,083219,Chow; Bennett,0,14,30,30
1650879762605,MATH 142A,A02,083220,Chow; Bennett,0,15,30,30
1650879762605,MATH 142A,B01,083221,Chow; Bennett,0,16,30,30
1650879762605,MATH 142A,B02,083222,Chow; Bennett,0,14,30,30
1650879768629,MATH 193A,A01,083224,Staff,0,6,30,30
1650879768629,MATH 193A,A02,083225,Staff,0,7,30,30
1650879768629,MATH 193A,A03,083781,Staff,0,6,30,30
1650879768629,MATH 193A,A04,083782,Staff,0,7,30,30
1650879774653,MATH 197,001,091859,McAuley; Julian John,9998,0,9999,1
1650879780712,COGS 9,A01,083615,Staff,0,17,60,60
1650879786735,COGS 11,A01,083617,Boyle; Mary E. T.,15,0,40,25
1650879792849,COGS 13,A01,083071,Staff,0,38,40,40
1650879798874,COGS 14A,A01,092681,Staff,0,37,100,100
1650879804902,COGS 14B,A01,083073,Cheng; Tzu-Han,0,12,50,50
1650879810926,COGS 17,A01,092677,Staff,11,0,75,64
1650879816952,COGS 100,A01,083619,Staff,0,30,60,60
1650879822979,COGS 101A,A01,083621,Davis; Joshua Daniel,0,29,60,60
1650879829011,COGS 101B,A01,091572,Staff,0,3,60,60
1650879835035,COGS 101C,A01,083625,Delgado; Tania,14,0,30,16
1650879841059,COGS 107A,A01,083627,Boyle; Mary E. T.,0,16,60,60
1650879847084,COGS 118A,A01,083075,Staff,0,8,60,60
1650879853108,CSE 3,A50,083646,Miranda; Gregory Joseph,16,0,38,22
1650879853108,CSE 3,A51,083647,Miranda; Gregory Joseph,36,0,37,1
1650879859136,CSE 8A,A50,083650,Miranda; Gregory Joseph,0,29,40,40
1650879865160,CSE 11,A01,083080,Cao; Yingjun,0,97,40,40
1650879871186,CSE 12,A01,083652,Staff,0,21,100,100
1650879877213,CSE 15L,A01,083654,Staff,0,3,50,50
1650879877213,CSE 15L,A02,083655,Staff,0,3,50,50
1650879883240,CSE 20,A01,083657,Staff,48,0,80,32
1650879889268,CSE 30,A01,083084,Eldon; John,0,76,40,40
1650879895296,CSE 100,A01,083659,Cao; Yingjun,0,70,50,50
1650879901320,CSE 134B,A01,083661,Powell; Thomas Allan,0,38,65,65
1650879907348,CSE 140,A01,083663,Staff,0,12,75,75
1650879913375,CSE 140L,A01,083088,Eldon; John,0,20,75,75
1650879919400,CSE 175,A01,083665,Kumar; Rakesh,7,0,25,18
1650879925427,CSE 190,A00,092507,Dubnov; Shlomo,9,0,20,11
1650879931452,ECE 45,A01,083139,Staff,0,4,60,60
1650879937477,ECE 65,A50,083695,Staff,0,5,30,30
1650879943500,ECE 109,A01,091882,Touri; Behrouz,32,0,70,38
1650879949528,ECE 180,A00,083140,Abi Samra; Nicholas Camill,20,0,30,10
1650879949528,ECE 180,B00,083141,Abi Samra; Nicholas Camill,0,0,30,30
1650879955552,MATH 10A,A01,083735,Patchell; Gregory David,2,0,30,28
1650879955552,MATH 10A,A02,083736,Patchell; Gregory David,27,0,30,3
1650879955552,MATH 10A,A03,083737,Patchell; Gregory David,23,0,30,7
1650879961575,MATH 10B,A01,083207,Staff,0,9,30,30
1650879961575,MATH 10B,A02,083208,Staff,0,6,30,30
1650879961575,MATH 10B,B01,083739,Staff,10,0,30,20
1650879961575,MATH 10B,B02,083740,Staff,28,0,30,2
1650879967602,MATH 18,A01,083743,Staff,0,0,30,30
1650879967602,MATH 18,A02,083744,Staff,24,0,30,6
1650879967602,MATH 18,A03,083745,Staff,21,0,30,9
1650879967602,MATH 18,A04,083746,Staff,26,0,30,4
1650879967602,MATH 18,B01,083748,Staff,0,15,30,30
1650879967602,MATH 18,B02,083749,Staff,0,13,30,30
1650879967602,MATH 18,B03,083750,Staff,0,13,30,30
1650879967602,MATH 18,B04,083751,Staff,0,13,30,30
1650879973626,MATH 20A,A01,083754,Staff,19,0,40,21
1650879979649,MATH 20B,A01,083756,Staff,0,14,30,30
1650879979649,MATH 20B,A02,083757,Staff,0,11,30,30
1650879985673,MATH 20C,A01,083760,Staff,0,17,30,30
1650879985673,MATH 20C,A02,083761,Staff,1,16,30,29
1650879985673,MATH 20C,B01,083762,Staff,9,0,30,21
1650879985673,MATH 20C,B02,083763,Staff,28,0,30,2
1650879991696,MATH 20D,A01,083765,Staff,2,1,30,28
1650879991696,MATH 20D,A02,083766,Staff,6,0,30,24
1650879991696,MATH 20D,A03,083767,Staff,23,0,30,7
1650879997722,MATH 20E,A01,083771,Staff,2,0,30,28
1650879997722,MATH 20E,A02,083772,Staff,13,0,30,17
1650879997722,MATH 20E,B01,083773,Staff,0,0,30,30
1650879997722,MATH 20E,B02,083774,Staff,4,0,30,26
1650880003745,MATH 103A,A01,083777,Staff,0,17,30,30
1650880003745,MATH 103A,A02,083778,Staff,0,15,30,30
1650880003745,MATH 103A,B01,083779,Staff,0,15,30,30
1650880003745,MATH 103A,B02,083780,Staff,0,14,30,30
1650880009769,MATH 105,A01,085443,Staff,0,23,30,30
1650880015804,MATH 109,A01,083213,Anzaldo; Leesa B,0,7,30,30
1650880015804,MATH 109,A02,083214,Anzaldo; Leesa B,0,7,30,30
1650880015804,MATH 109,B01,083215,Anzaldo; Leesa B,0,8,30,30
1650880015804,MATH 109,B02,083216,Anzaldo; Leesa B,0,7,30,30
1650880021834,MATH 142A,A01,083219,Chow; Bennett,0,14,30,30
1650880021834,MATH 142A,A02,083220,Chow; Bennett,0,15,30,30
1650880021834,MATH 142A,B01,083221,Chow; Bennett,0,16,30,30
1650880021834,MATH 142A,B02,083222,Chow; Bennett,0,14,30,30
1650880027859,MATH 193A,A01,083224,Staff,0,6,30,30
1650880027859,MATH 193A,A02,083225,Staff,0,7,30,30
1650880027859,MATH 193A,A03,083781,Staff,0,6,30,30
1650880027859,MATH 193A,A04,083782,Staff,0,7,30,30
1650880033887,MATH 197,001,091859,McAuley; Julian John,9998,0,9999,1
1650880039950,COGS 9,A01,083615,Staff,0,17,60,60
1650880045986,COGS 11,A01,083617,Boyle; Mary E. T.,15,0,40,25
1650880052009,COGS 13,A01,083071,Staff,0,38,40,40
1650880058046,COGS 14A,A01,092681,Staff,0,37,100,100
1650880064070,COGS 14B,A01,083073,Cheng; Tzu-Han,0,12,50,50
1650880070105,COGS 17,A01,092677,Staff,11,0,75,64
1650880076132,COGS 100,A01,083619,Staff,0,30,60,60
1650880082156,COGS 101A,A01,083621,Davis; Joshua Daniel,0,29,60,60
1650880088180,COGS 101B,A01,091572,Staff,0,3,60,60
1650880094205,COGS 101C,A01,083625,Delgado; Tania,14,0,30,16
1650880100228,COGS 107A,A01,083627,Boyle; Mary E. T.,0,16,60,60
1650880106252,COGS 118A,A01,083075,Staff,0,8,60,60
1650880112277,CSE 3,A50,083646,Miranda; Gregory Joseph,16,0,38,22
1650880112277,CSE 3,A51,083647,Miranda; Gregory Joseph,36,0,37,1
1650880118306,CSE 8A,A50,083650,Miranda; Gregory Joseph,0,29,40,40
1650880124332,CSE 11,A01,083080,Cao; Yingjun,0,97,40,40
1650880130355,CSE 12,A01,083652,Staff,0,21,100,100
1650880136380,CSE 15L,A01,083654,Staff,0,3,50,50
1650880136380,CSE 15L,A02,083655,Staff,0,3,50,50
1650880142405,CSE 20,A01,083657,Staff,48,0,80,32
1650880148427,CSE 30,A01,083084,Eldon; John,0,76,40,40
1650880154450,CSE 100,A01,083659,Cao; Yingjun,0,70,50,50
1650880160474,CSE 134B,A01,083661,Powell; Thomas Allan,0,38,65,65
1650880166500,CSE 140,A01,083663,Staff,0,12,75,75
1650880172522,CSE 140L,A01,083088,Eldon; John,0,20,75,75
1650880178557,CSE 175,A01,083665,Kumar; Rakesh,7,0,25,18
1650880184586,CSE 190,A00,092507,Dubnov; Shlomo,9,0,20,11
1650880190609,ECE 45,A01,083139,Staff,0,4,60,60
1650880196636,ECE 65,A50,083695,Staff,0,5,30,30
1650880202658,ECE 109,A01,091882,Touri; Behrouz,32,0,70,38
1650880208682,ECE 180,A00,083140,Abi Samra; Nicholas Camill,20,0,30,10
1650880208682,ECE 180,B00,083141,Abi Samra; Nicholas Camill,0,0,30,30
1650880214705,MATH 10A,A01,083735,Patchell; Gregory David,2,0,30,28
1650880214705,MATH 10A,A02,083736,Patchell; Gregory David,27,0,30,3
1650880214705,MATH 10A,A03,083737,Patchell; Gregory David,23,0,30,7
1650880220730,MATH 10B,A01,083207,Staff,0,9,30,30
1650880220730,MATH 10B,A02,083208,Staff,0,6,30,30
1650880220730,MATH 10B,B01,083739,Staff,10,0,30,20
1650880220730,MATH 10B,B02,083740,Staff,28,0,30,2
1650880226755,MATH 18,A01,083743,Staff,0,0,30,30
1650880226755,MATH 18,A02,083744,Staff,24,0,30,6
1650880226755,MATH 18,A03,083745,Staff,21,0,30,9
1650880226755,MATH 18,A04,083746,Staff,26,0,30,4
1650880226755,MATH 18,B01,083748,Staff,0,15,30,30
1650880226755,MATH 18,B02,083749,Staff,0,13,30,30
1650880226755,MATH 18,B03,083750,Staff,0,13,30,30
1650880226755,MATH 18,B04,083751,Staff,0,13,30,30
1650880232779,MATH 20A,A01,083754,Staff,19,0,40,21
1650880238807,MATH 20B,A01,083756,Staff,0,14,30,30
1650880238807,MATH 20B,A02,083757,Staff,0,11,30,30
1650880244834,MATH 20C,A01,083760,Staff,0,17,30,30
1650880244834,MATH 20C,A02,083761,Staff,1,16,30,29
1650880244834,MATH 20C,B01,083762,Staff,9,0,30,21
1650880244834,MATH 20C,B02,083763,Staff,28,0,30,2
1650880250868,MATH 20D,A01,083765,Staff,2,1,30,28
1650880250868,MATH 20D,A02,083766,Staff,6,0,30,24
1650880250868,MATH 20D,A03,083767,Staff,23,0,30,7
1650880256895,MATH 20E,A01,083771,Staff,2,0,30,28
1650880256895,MATH 20E,A02,083772,Staff,13,0,30,17
1650880256895,MATH 20E,B01,083773,Staff,0,0,30,30
1650880256895,MATH 20E,B02,083774,Staff,4,0,30,26
1650880262921,MATH 103A,A01,083777,Staff,0,17,30,30
1650880262921,MATH 103A,A02,083778,Staff,0,15,30,30
1650880262921,MATH 103A,B01,083779,Staff,0,15,30,30
1650880262921,MATH 103A,B02,083780,Staff,0,14,30,30
1650880268945,MATH 105,A01,085443,Staff,0,23,30,30
1650880274972,MATH 109,A01,083213,Anzaldo; Leesa B,0,7,30,30
1650880274972,MATH 109,A02,083214,Anzaldo; Leesa B,0,7,30,30
1650880274972,MATH 109,B01,083215,Anzaldo; Leesa B,0,8,30,30
1650880274972,MATH 109,B02,083216,Anzaldo; Leesa B,0,7,30,30
1650880280997,MATH 142A,A01,083219,Chow; Bennett,0,14,30,30
1650880280997,MATH 142A,A02,083220,Chow; Bennett,0,15,30,30
1650880280997,MATH 142A,B01,083221,Chow; Bennett,0,16,30,30
1650880280997,MATH 142A,B02,083222,Chow; Bennett,0,14,30,30
1650880287022,MATH 193A,A01,083224,Staff,0,6,30,30
1650880287022,MATH 193A,A02,083225,Staff,0,7,30,30
1650880287022,MATH 193A,A03,083781,Staff,0,6,30,30
1650880287022,MATH 193A,A04,083782,Staff,0,7,30,30
1650880293046,MATH 197,001,091859,McAuley; Julian John,9998,0,9999,1
1650880299117,COGS 9,A01,083615,Staff,0,17,60,60
1650880305141,COGS 11,A01,083617,Boyle; Mary E. T.,15,0,40,25
1650880311167,COGS 13,A01,083071,Staff,0,38,40,40
1650880317196,COGS 14A,A01,092681,Staff,0,37,100,100
1650880323225,COGS 14B,A01,083073,Cheng; Tzu-Han,0,12,50,50
1650880329248,COGS 17,A01,092677,Staff,11,0,75,64
1650880335274,COGS 100,A01,083619,Staff,0,30,60,60
1650880341298,COGS 101A,A01,083621,Davis; Joshua Daniel,0,29,60,60
1650880347322,COGS 101B,A01,091572,Staff,0,3,60,60
1650880353352,COGS 101C,A01,083625,Delgado; Tania,14,0,30,16
1650880359378,COGS 107A,A01,083627,Boyle; Mary E. T.,0,16,60,60
1650880365403,COGS 118A,A01,083075,Staff,0,8,60,60
1650880371425,CSE 3,A50,083646,Miranda; Gregory Joseph,16,0,38,22
1650880371425,CSE 3,A51,083647,Miranda; Gregory Joseph,36,0,37,1
1650880377453,CSE 8A,A50,083650,Miranda; Gregory Joseph,0,29,40,40
1650880383482,CSE 11,A01,083080,Cao; Yingjun,0,97,40,40
1650880389606,CSE 12,A01,083652,Staff,0,21,100,100
1650880395627,CSE 15L,A01,083654,Staff,0,3,50,50
1650880395627,CSE 15L,A02,083655,Staff,0,3,50,50
1650880401651,CSE 20,A01,083657,Staff,48,0,80,32
1650880407679,CSE 30,A01,083084,Eldon; John,0,76,40,40
1650880413707,CSE 100,A01,083659,Cao; Yingjun,0,70,50,50
1650880419732,CSE 134B,A01,083661,Powell; Thomas Allan,0,38,65,65
1650880425755,CSE 140,A01,083663,Staff,0,12,75,75
1650880431780,CSE 140L,A01,083088,Eldon; John,0,20,75,75
1650880437803,CSE 175,A01,083665,Kumar; Rakesh,7,0,25,18
1650880443828,CSE 190,A00,092507,Dubnov; Shlomo,9,0,20,11
1650880449853,ECE 45,A01,083139,Staff,0,4,60,60
1650880455882,ECE 65,A50,083695,Staff,0,5,30,30
1650880461914,ECE 109,A01,091882,Touri; Behrouz,32,0,70,38
1650880467939,ECE 180,A00,083140,Abi Samra; Nicholas Camill,20,0,30,10
1650880467939,ECE 180,B00,083141,Abi Samra; Nicholas Camill,0,0,30,30
1650880473972,MATH 10A,A01,083735,Patchell; Gregory David,2,0,30,28
1650880473972,MATH 10A,A02,083736,Patchell; Gregory David,27,0,30,3
1650880473972,MATH 10A,A03,083737,Patchell; Gregory David,23,0,30,7
1650880480005,MATH 10B,A01,083207,Staff,0,9,30,30
1650880480005,MATH 10B,A02,083208,Staff,0,6,30,30
1650880480005,MATH 10B,B01,083739,Staff,10,0,30,20
1650880480005,MATH 10B,B02,083740,Staff,28,0,30,2
1650880486031,MATH 18,A01,083743,Staff,0,0,30,30
1650880486031,MATH 18,A02,083744,Staff,24,0,30,6
1650880486031,MATH 18,A03,083745,Staff,21,0,30,9
1650880486031,MATH 18,A04,083746,Staff,26,0,30,4
1650880486031,MATH 18,B01,083748,Staff,0,15,30,30
1650880486031,MATH 18,B02,083749,Staff,0,13,30,30
1650880486031,MATH 18,B03,083750,Staff,0,13,30,30
1650880486031,MATH 18,B04,083751,Staff,0,13,30,30
1650880492058,MATH 20A,A01,083754,Staff,19,0,40,21
1650880498091,MATH 20B,A01,083756,Staff,0,14,30,30
1650880498091,MATH 20B,A02,083757,Staff,0,11,30,30
1650880504116,MATH 20C,A01,083760,Staff,0,17,30,30
1650880504116,MATH 20C,A02,083761,Staff,1,16,30,29
1650880504116,MATH 20C,B01,083762,Staff,9,0,30,21
1650880504116,MATH 20C,B02,083763,Staff,28,0,30,2
1650880510143,MATH 20D,A01,083765,Staff,2,1,30,28
1650880510143,MATH 20D,A02,083766,Staff,6,0,30,24
1650880510143,MATH 20D,A03,083767,Staff,23,0,30,7
1650880516171,MATH 20E,A01,083771,Staff,2,0,30,28
1650880516171,MATH 20E,A02,083772,Staff,13,0,30,17
1650880516171,MATH 20E,B01,083773,Staff,0,0,30,30
1650880516171,MATH 20E,B02,083774,Staff,4,0,30,26
1650880522196,MATH 103A,A01,083777,Staff,0,17,30,30
1650880522196,MATH 103A,A02,083778,Staff,0,15,30,30
1650880522196,MATH 103A,B01,083779,Staff,0,15,30,30
1650880522196,MATH 103A,B02,083780,Staff,0,14,30,30
1650880528224,MATH 105,A01,085443,Staff,0,23,30,30
1650880534253,MATH 109,A01,083213,Anzaldo; Leesa B,0,7,30,30
1650880534253,MATH 109,A02,083214,Anzaldo; Leesa B,0,7,30,30
1650880534253,MATH 109,B01,083215,Anzaldo; Leesa B,0,8,30,30
1650880534253,MATH 109,B02,083216,Anzaldo; Leesa B,0,7,30,30
1650880540282,MATH 142A,A01,083219,Chow; Bennett,0,14,30,30
1650880540282,MATH 142A,A02,083220,Chow; Bennett,0,15,30,30
1650880540282,MATH 142A,B01,083221,Chow; Bennett,0,16,30,30
1650880540282,MATH 142A,B02,083222,Chow; Bennett,0,14,30,30
1650880546307,MATH 193A,A01,083224,Staff,0,6,30,30
1650880546307,MATH 193A,A02,083225,Staff,0,7,30,30
1650880546307,MATH 193A,A03,083781,Staff,0,6,30,30
1650880546307,MATH 193A,A04,083782,Staff,0,7,30,30
1650880552331,MATH 197,001,091859,McAuley; Julian John,9998,0,9999,1
1650880558386,COGS 9,A01,083615,Staff,0,17,60,60
1650880564408,COGS 11,A01,083617,Boyle; Mary E. T.,15,0,40,25
1650880570433,COGS 13,A01,083071,Staff,0,38,40,40
1650880576457,COGS 14A,A01,092681,Staff,0,37,100,100
1650880582483,COGS 14B,A01,083073,Cheng; Tzu-Han,0,12,50,50
1650880588506,COGS 17,A01,092677,Staff,11,0,75,64
1650880594530,COGS 100,A01,083619,Staff,0,30,60,60
1650880600563,COGS 101A,A01,083621,Davis; Joshua Daniel,0,29,60,60
1650880606590,COGS 101B,A01,091572,Staff,0,3,60,60
1650880612613,COGS 101C,A01,083625,Delgado; Tania,14,0,30,16
1650880618637,COGS 107A,A01,083627,Boyle; Mary E. T.,0,16,60,60
1650880624661,COGS 118A,A01,083075,Staff,0,8,60,60
1650880630686,CSE 3,A50,083646,Miranda; Gregory Joseph,16,0,38,22
1650880630686,CSE 3,A51,083647,Miranda; Gregory Joseph,36,0,37,1
1650880636713,CSE 8A,A50,083650,Miranda; Gregory Joseph,0,29,40,40
1650880642742,CSE 11,A01,083080,Cao; Yingjun,0,97,40,40
1650880648766,CSE 12,A01,083652,Staff,0,21,100,100
1650880654789,CSE 15L,A01,083654,Staff,0,3,50,50
1650880654789,CSE 15L,A02,083655,Staff,0,3,50,50
1650880660813,CSE 20,A01,083657,Staff,48,0,80,32
1650880666842,CSE 30,A01,083084,Eldon; John,0,76,40,40
1650880672870,CSE 100,A01,083659,Cao; Yingjun,0,70,50,50
1650880678898,CSE 134B,A01,083661,Powell; Thomas Allan,0,38,65,65
1650880684922,CSE 140,A01,083663,Staff,0,12,75,75
1650880690961,CSE 140L,A01,083088,Eldon; John,0,20,75,75
1650880696988,CSE 175,A01,083665,Kumar; Rakesh,7,0,25,18
1650880703012,CSE 190,A00,092507,Dubnov; Shlomo,9,0,20,11
1650880709038,ECE 45,A01,083139,Staff,0,4,60,60
1650880715062,ECE 65,A50,083695,Staff,0,5,30,30
1650880721091,ECE 109,A01,091882,Touri; Behrouz,32,0,70,38
1650880727120,ECE 180,A00,083140,Abi Samra; Nicholas Camill,20,0,30,10
1650880727120,ECE 180,B00,083141,Abi Samra; Nicholas Camill,0,0,30,30
1650880733145,MATH 10A,A01,083735,Patchell; Gregory David,2,0,30,28
1650880733145,MATH 10A,A02,083736,Patchell; Gregory David,27,0,30,3
1650880733145,MATH 10A,A03,083737,Patchell; Gregory David,23,0,30,7
1650880739169,MATH 10B,A01,083207,Staff,0,9,30,30
1650880739169,MATH 10B,A02,083208,Staff,0,6,30,30
1650880739169,MATH 10B,B01,083739,Staff,10,0,30,20
1650880739169,MATH 10B,B02,083740,Staff,28,0,30,2
1650880745201,MATH 18,A01,083743,Staff,0,0,30,30
1650880745201,MATH 18,A02,083744,Staff,24,0,30,6
1650880745201,MATH 18,A03,083745,Staff,21,0,30,9
1650880745201,MATH 18,A04,083746,Staff,26,0,30,4
1650880745201,MATH 18,B01,083748,Staff,0,15,30,30
1650880745201,MATH 18,B02,083749,Staff,0,13,30,30
1650880745201,MATH 18,B03,083750,Staff,0,13,30,30
1650880745201,MATH 18,B04,083751,Staff,0,13,30,30
1650880751224,MATH 20A,A01,083754,Staff,19,0,40,21
1650880757250,MATH 20B,A01,083756,Staff,0,14,30,30
1650880757250,MATH 20B,A02,083757,Staff,0,11,30,30
1650880763273,MATH 20C,A01,083760,Staff,0,17,30,30
1650880763273,MATH 20C,A02,083761,Staff,1,16,30,29
1650880763273,MATH 20C,B01,083762,Staff,9,0,30,21
1650880763273,MATH 20C,B02,083763,Staff,28,0,30,2
1650880769302,MATH 20D,A01,083765,Staff,2,1,30,28
1650880769302,MATH 20D,A02,083766,Staff,6,0,30,24
1650880769302,MATH 20D,A03,083767,Staff,23,0,30,7
1650880775331,MATH 20E,A01,083771,Staff,2,0,30,28
1650880775331,MATH 20E,A02,083772,Staff,13,0,30,17
1650880775331,MATH 20E,B01,083773,Staff,0,0,30,30
1650880775331,MATH 20E,B02,083774,Staff,4,0,30,26
1650880781358,MATH 103A,A01,083777,Staff,0,17,30,30
1650880781358,MATH 103A,A02,083778,Staff,0,15,30,30
1650880781358,MATH 103A,B01,083779,Staff,0,15,30,30
1650880781358,MATH 103A,B02,083780,Staff,0,14,30,30
1650880787381,MATH 105,A01,085443,Staff,0,23,30,30
1650880793407,MATH 109,A01,083213,Anzaldo; Leesa B,0,7,30,30
1650880793407,MATH 109,A02,083214,Anzaldo; Leesa B,0,7,30,30
1650880793407,MATH 109,B01,083215,Anzaldo; Leesa B,0,8,30,30
1650880793407,MATH 109,B02,083216,Anzaldo; Leesa B,0,7,30,30
1650880799432,MATH 142A,A01,083219,Chow; Bennett,0,14,30,30
1650880799432,MATH 142A,A02,083220,Chow; Bennett,0,15,30,30
1650880799432,MATH 142A,B01,083221,Chow; Bennett,0,16,30,30
1650880799432,MATH 142A,B02,083222,Chow; Bennett,0,14,30,30
1650880805460,MATH 193A,A01,083224,Staff,0,6,30,30
1650880805460,MATH 193A,A02,083225,Staff,0,7,30,30
1650880805460,MATH 193A,A03,083781,Staff,0,6,30,30
1650880805460,MATH 193A,A04,083782,Staff,0,7,30,30
1650880811482,MATH 197,001,091859,McAuley; Julian John,9998,0,9999,1
1650880817539,COGS 9,A01,083615,Staff,0,17,60,60
1650880823570,COGS 11,A01,083617,Boyle; Mary E. T.,15,0,40,25
1650880829592,COGS 13,A01,083071,Staff,0,38,40,40
1650880835618,COGS 14A,A01,092681,Staff,0,37,100,100
1650880841650,COGS 14B,A01,083073,Cheng; Tzu-Han,0,12,50,50
1650880847673,COGS 17,A01,092677,Staff,11,0,75,64
1650880853697,COGS 100,A01,083619,Staff,0,30,60,60
1650880859723,COGS 101A,A01,083621,Davis; Joshua Daniel,0,29,60,60
1650880865748,COGS 101B,A01,091572,Staff,0,3,60,60
1650880871774,COGS 101C,A01,083625,Delgado; Tania,14,0,30,16
1650880877813,COGS 107A,A01,083627,Boyle; Mary E. T.,0,16,60,60
1650880883852,COGS 118A,A01,083075,Staff,0,8,60,60
1650880889877,CSE 3,A50,083646,Miranda; Gregory Joseph,16,0,38,22
1650880889877,CSE 3,A51,083647,Miranda; Gregory Joseph,36,0,37,1
1650880895907,CSE 8A,A50,083650,Miranda; Gregory Joseph,0,29,40,40
1650880901931,CSE 11,A01,083080,Cao; Yingjun,0,97,40,40
1650880907961,CSE 12,A01,083652,Staff,0,21,100,100
1650880913985,CSE 15L,A01,083654,Staff,0,3,50,50
1650880913985,CSE 15L,A02,083655,Staff,0,3,50,50
1650880920014,CSE 20,A01,083657,Staff,48,0,80,32
1650880926037,CSE 30,A01,083084,Eldon; John,0,76,40,40
1650880932066,CSE 100,A01,083659,Cao; Yingjun,0,70,50,50
1650880938092,CSE 134B,A01,083661,Powell; Thomas Allan,0,38,65,65
1650880944118,CSE 140,A01,083663,Staff,0,12,75,75
1650880950142,CSE 140L,A01,083088,Eldon; John,0,20,75,75
1650880956166,CSE 175,A01,083665,Kumar; Rakesh,7,0,25,18
1650880962190,CSE 190,A00,092507,Dubnov; Shlomo,9,0,20,11
1650880968213,ECE 45,A01,083139,Staff,0,4,60,60
1650880974237,ECE 65,A50,083695,Staff,0,5,30,30
1650880980261,ECE 109,A01,091882,Touri; Behrouz,32,0,70,38
1650880986378,ECE 180,A00,083140,Abi Samra; Nicholas Camill,20,0,30,10
1650880986378,ECE 180,B00,083141,Abi Samra; Nicholas Camill,0,0,30,30
1650880992403,MATH 10A,A01,083735,Patchell; Gregory David,2,0,30,28
1650880992403,MATH 10A,A02,083736,Patchell; Gregory David,27,0,30,3
1650880992403,MATH 10A,A03,083737,Patchell; Gregory David,23,0,30,7
1650880998428,MATH 10B,A01,083207,Staff,0,9,30,30
1650880998428,MATH 10B,A02,083208,Staff,0,6,30,30
1650880998428,MATH 10B,B01,083739,Staff,10,0,30,20
1650880998428,MATH 10B,B02,083740,Staff,28,0,30,2
1650881004458,MATH 18,A01,083743,Staff,0,0,30,30
1650881004458,MATH 18,A02,083744,Staff,24,0,30,6
1650881004458,MATH 18,A03,083745,Staff,21,0,30,9
1650881004458,MATH 18,A04,083746,Staff,26,0,30,4
1650881004458,MATH 18,B01,083748,Staff,0,15,30,30
1650881004458,MATH 18,B02,083749,Staff,0,13,30,30
1650881004458,MATH 18,B03,083750,Staff,0,13,30,30
1650881004458,MATH 18,B04,083751,Staff,0,13,30,30
1650881010482,MATH 20A,A01,083754,Staff,19,0,40,21
1650881016510,MATH 20B,A01,083756,Staff,0,14,30,30
1650881016510,MATH 20B,A02,083757,Staff,0,11,30,30
1650881022533,MATH 20C,A01,083760,Staff,0,17,30,30
1650881022533,MATH 20C,A02,083761,Staff,1,16,30,29
1650881022533,MATH 20C,B01,083762,Staff,9,0,30,21
1650881022533,MATH 20C,B02,083763,Staff,28,0,30,2
1650881028571,MATH 20D,A01,083765,Staff,2,1,30,28
1650881028571,MATH 20D,A02,083766,Staff,6,0,30,24
1650881028571,MATH 20D,A03,083767,Staff,23,0,30,7
1650881034596,MATH 20E,A01,083771,Staff,2,0,30,28
1650881034596,MATH 20E,A02,083772,Staff,13,0,30,17
1650881034596,MATH 20E,B01,083773,Staff,0,0,30,30
1650881034596,MATH 20E,B02,083774,Staff,4,0,30,26
1650881040627,MATH 103A,A01,083777,Staff,0,17,30,30
1650881040627,MATH 103A,A02,083778,Staff,0,15,30,30
1650881040627,MATH 103A,B01,083779,Staff,0,15,30,30
1650881040627,MATH 103A,B02,083780,Staff,0,14,30,30
1650881046656,MATH 105,A01,085443,Staff,0,23,30,30
1650881052682,MATH 109,A01,083213,Anzaldo; Leesa B,0,7,30,30
1650881052682,MATH 109,A02,083214,Anzaldo; Leesa B,0,7,30,30
1650881052682,MATH 109,B01,083215,Anzaldo; Leesa B,0,8,30,30
1650881052682,MATH 109,B02,083216,Anzaldo; Leesa B,0,7,30,30
1650881058711,MATH 142A,A01,083219,Chow; Bennett,0,14,30,30
1650881058711,MATH 142A,A02,083220,Chow; Bennett,0,15,30,30
1650881058711,MATH 142A,B01,083221,Chow; Bennett,0,16,30,30
1650881058711,MATH 142A,B02,083222,Chow; Bennett,0,14,30,30
1650881064734,MATH 193A,A01,083224,Staff,0,6,30,30
1650881064734,MATH 193A,A02,083225,Staff,0,7,30,30
1650881064734,MATH 193A,A03,083781,Staff,0,6,30,30
1650881064734,MATH 193A,A04,083782,Staff,0,7,30,30
1650881070758,MATH 197,001,091859,McAuley; Julian John,9998,0,9999,1
1650881076811,COGS 9,A01,083615,Staff,0,17,60,60
1650881082838,COGS 11,A01,083617,Boyle; Mary E. T.,15,0,40,25
1650881088863,COGS 13,A01,083071,Staff,0,38,40,40
1650881094891,COGS 14A,A01,092681,Staff,0,37,100,100
1650881100919,COGS 14B,A01,083073,Cheng; Tzu-Han,0,12,50,50
1650881106946,COGS 17,A01,092677,Staff,11,0,75,64
1650881112970,COGS 100,A01,083619,Staff,0,30,60,60
1650881118995,COGS 101A,A01,083621,Davis; Joshua Daniel,0,29,60,60
1650881125022,COGS 101B,A01,091572,Staff,0,3,60,60
1650881131046,COGS 101C,A01,083625,Delgado; Tania,14,0,30,16
1650881137078,COGS 107A,A01,083627,Boyle; Mary E. T.,0,16,60,60
1650881143105,COGS 118A,A01,083075,Staff,0,8,60,60
1650881149130,CSE 3,A50,083646,Miranda; Gregory Joseph,16,0,38,22
1650881149130,CSE 3,A51,083647,Miranda; Gregory Joseph,36,0,37,1
1650881155155,CSE 8A,A50,083650,Miranda; Gregory Joseph,0,29,40,40
1650881161192,CSE 11,A01,083080,Cao; Yingjun,0,97,40,40
1650881167220,CSE 12,A01,083652,Staff,0,21,100,100
1650881173244,CSE 15L,A01,083654,Staff,0,3,50,50
1650881173244,CSE 15L,A02,083655,Staff,0,3,50,50
1650881179266,CSE 20,A01,083657,Staff,48,0,80,32
1650881185290,CSE 30,A01,083084,Eldon; John,0,76,40,40
1650881191317,CSE 100,A01,083659,Cao; Yingjun,0,70,50,50
1650881197339,CSE 134B,A01,083661,Powell; Thomas Allan,0,38,65,65
1650881203365,CSE 140,A01,083663,Staff,0,12,75,75
1650881209407,CSE 140L,A01,083088,Eldon; John,0,20,75,75
1650881215431,CSE 175,A01,083665,Kumar; Rakesh,7,0,25,18
1650881221454,CSE 190,A00,092507,Dubnov; Shlomo,9,0,20,11
1650881227478,ECE 45,A01,083139,Staff,0,4,60,60
1650881233504,ECE 65,A50,083695,Staff,0,5,30,30
1650881239528,ECE 109,A01,091882,Touri; Behrouz,32,0,70,38
1650881245553,ECE 180,A00,083140,Abi Samra; Nicholas Camill,20,0,30,10
1650881245553,ECE 180,B00,083141,Abi Samra; Nicholas Camill,0,0,30,30
1650881251578,MATH 10A,A01,083735,Patchell; Gregory David,2,0,30,28
1650881251578,MATH 10A,A02,083736,Patchell; Gregory David,27,0,30,3
1650881251578,MATH 10A,A03,083737,Patchell; Gregory David,23,0,30,7
1650881257602,MATH 10B,A01,083207,Staff,0,9,30,30
1650881257602,MATH 10B,A02,083208,Staff,0,6,30,30
1650881257602,MATH 10B,B01,083739,Staff,10,0,30,20
1650881257602,MATH 10B,B02,083740,Staff,28,0,30,2
1650881263633,MATH 18,A01,083743,Staff,0,0,30,30
1650881263633,MATH 18,A02,083744,Staff,24,0,30,6
1650881263633,MATH 18,A03,083745,Staff,21,0,30,9
1650881263633,MATH 18,A04,083746,Staff,26,0,30,4
1650881263633,MATH 18,B01,083748,Staff,0,15,30,30
1650881263633,MATH 18,B02,083749,Staff,0,13,30,30
1650881263633,MATH 18,B03,083750,Staff,0,13,30,30
1650881263633,MATH 18,B04,083751,Staff,0,13,30,30
1650881269656,MATH 20A,A01,083754,Staff,19,0,40,21
1650881275686,MATH 20B,A01,083756,Staff,0,14,30,30
1650881275686,MATH 20B,A02,083757,Staff,0,11,30,30
1650881281710,MATH 20C,A01,083760,Staff,0,17,30,30
1650881281710,MATH 20C,A02,083761,Staff,1,16,30,29
1650881281710,MATH 20C,B01,083762,Staff,9,0,30,21
1650881281710,MATH 20C,B02,083763,Staff,28,0,30,2
1650881287739,MATH 20D,A01,083765,Staff,2,1,30,28
1650881287739,MATH 20D,A02,083766,Staff,6,0,30,24
1650881287739,MATH 20D,A03,083767,Staff,23,0,30,7
1650881293766,MATH 20E,A01,083771,Staff,2,0,30,28
1650881293766,MATH 20E,A02,083772,Staff,13,0,30,17
1650881293766,MATH 20E,B01,083773,Staff,0,0,30,30
1650881293766,MATH 20E,B02,083774,Staff,4,0,30,26
1650881299789,MATH 103A,A01,083777,Staff,0,17,30,30
1650881299789,MATH 103A,A02,083778,Staff,0,15,30,30
1650881299789,MATH 103A,B01,083779,Staff,0,15,30,30
1650881299789,MATH 103A,B02,083780,Staff,0,14,30,30
1650881305817,MATH 105,A01,085443,Staff,0,23,30,30
1650881311842,MATH 109,A01,083213,Anzaldo; Leesa B,0,7,30,30
1650881311842,MATH 109,A02,083214,Anzaldo; Leesa B,0,7,30,30
1650881311842,MATH 109,B01,083215,Anzaldo; Leesa B,0,8,30,30
1650881311842,MATH 109,B02,083216,Anzaldo; Leesa B,0,7,30,30
1650881317873,MATH 142A,A01,083219,Chow; Bennett,0,14,30,30
1650881317873,MATH 142A,A02,083220,Chow; Bennett,0,15,30,30
1650881317873,MATH 142A,B01,083221,Chow; Bennett,0,16,30,30
1650881317873,MATH 142A,B02,083222,Chow; Bennett,0,14,30,30
1650881323897,MATH 193A,A01,083224,Staff,0,6,30,30
1650881323897,MATH 193A,A02,083225,Staff,0,7,30,30
1650881323897,MATH 193A,A03,083781,Staff,0,6,30,30
1650881323897,MATH 193A,A04,083782,Staff,0,7,30,30
1650881329929,MATH 197,001,091859,McAuley; Julian John,9998,0,9999,1
1650881335982,COGS 9,A01,083615,Staff,0,17,60,60
1650881342010,COGS 11,A01,083617,Boyle; Mary E. T.,15,0,40,25
1650881348038,COGS 13,A01,083071,Staff,0,38,40,40
1650881354066,COGS 14A,A01,092681,Staff,0,37,100,100
1650881360095,COGS 14B,A01,083073,Cheng; Tzu-Han,0,12,50,50
1650881366118,COGS 17,A01,092677,Staff,11,0,75,64
1650881372145,COGS 100,A01,083619,Staff,0,30,60,60
1650881378169,COGS 101A,A01,083621,Davis; Joshua Daniel,0,29,60,60
1650881384196,COGS 101B,A01,091572,Staff,0,3,60,60
1650881390225,COGS 101C,A01,083625,Delgado; Tania,14,0,30,16
1650881396248,COGS 107A,A01,083627,Boyle; Mary E. T.,0,16,60,60
1650881402277,COGS 118A,A01,083075,Staff,0,8,60,60
1650881408299,CSE 3,A50,083646,Miranda; Gregory Joseph,16,0,38,22
1650881408299,CSE 3,A51,083647,Miranda; Gregory Joseph,36,0,37,1
1650881414323,CSE 8A,A50,083650,Miranda; Gregory Joseph,0,29,40,40
1650881420350,CSE 11,A01,083080,Cao; Yingjun,0,97,40,40
1650881426383,CSE 12,A01,083652,Staff,0,21,100,100
1650881432407,CSE 15L,A01,083654,Staff,0,3,50,50
1650881432407,CSE 15L,A02,083655,Staff,0,3,50,50
1650881438431,CSE 20,A01,083657,Staff,48,0,80,32
1650881444458,CSE 30,A01,083084,Eldon; John,0,76,40,40
1650881450485,CSE 100,A01,083659,Cao; Yingjun,0,70,50,50
1650881456508,CSE 134B,A01,083661,Powell; Thomas Allan,0,38,65,65
1650881462533,CSE 140,A01,083663,Staff,0,12,75,75
1650881468559,CSE 140L,A01,083088,Eldon; John,0,20,75,75
1650881474587,CSE 175,A01,083665,Kumar; Rakesh,7,0,25,18
1650881480612,CSE 190,A00,092507,Dubnov; Shlomo,9,0,20,11
1650881486645,ECE 45,A01,083139,Staff,0,4,60,60
1650881492669,ECE 65,A50,083695,Staff,0,5,30,30
1650881498693,ECE 109,A01,091882,Touri; Behrouz,32,0,70,38
1650881504721,ECE 180,A00,083140,Abi Samra; Nicholas Camill,20,0,30,10
1650881504721,ECE 180,B00,083141,Abi Samra; Nicholas Camill,0,0,30,30
1650881510749,MATH 10A,A01,083735,Patchell; Gregory David,2,0,30,28
1650881510749,MATH 10A,A02,083736,Patchell; Gregory David,27,0,30,3
1650881510749,MATH 10A,A03,083737,Patchell; Gregory David,23,0,30,7
1650881516778,MATH 10B,A01,083207,Staff,0,9,30,30
1650881516778,MATH 10B,A02,083208,Staff,0,6,30,30
1650881516778,MATH 10B,B01,083739,Staff,10,0,30,20
1650881516778,MATH 10B,B02,083740,Staff,28,0,30,2
1650881522803,MATH 18,A01,083743,Staff,0,0,30,30
1650881522803,MATH 18,A02,083744,Staff,24,0,30,6
1650881522803,MATH 18,A03,083745,Staff,21,0,30,9
1650881522803,MATH 18,A04,083746,Staff,26,0,30,4
1650881522803,MATH 18,B01,083748,Staff,0,15,30,30
1650881522803,MATH 18,B02,083749,Staff,0,13,30,30
1650881522803,MATH 18,B03,083750,Staff,0,13,30,30
1650881522803,MATH 18,B04,083751,Staff,0,13,30,30
1650881528833,MATH 20A,A01,083754,Staff,19,0,40,21
1650881534859,MATH 20B,A01,083756,Staff,0,14,30,30
1650881534859,MATH 20B,A02,083757,Staff,0,11,30,30
1650881540884,MATH 20C,A01,083760,Staff,0,17,30,30
1650881540884,MATH 20C,A02,083761,Staff,1,16,30,29
1650881540884,MATH 20C,B01,083762,Staff,9,0,30,21
1650881540884,MATH 20C,B02,083763,Staff,28,0,30,2
1650881546908,MATH 20D,A01,083765,Staff,2,1,30,28
1650881546908,MATH 20D,A02,083766,Staff,6,0,30,24
1650881546908,MATH 20D,A03,083767,Staff,23,0,30,7
1650881552933,MATH 20E,A01,083771,Staff,2,0,30,28
1650881552933,MATH 20E,A02,083772,Staff,13,0,30,17
1650881552933,MATH 20E,B01,083773,Staff,0,0,30,30
1650881552933,MATH 20E,B02,083774,Staff,4,0,30,26
1650881558955,MATH 103A,A01,083777,Staff,0,17,30,30
1650881558955,MATH 103A,A02,083778,Staff,0,15,30,30
1650881558955,MATH 103A,B01,083779,Staff,0,15,30,30
1650881558955,MATH 103A,B02,083780,Staff,0,14,30,30
1650881564990,MATH 105,A01,085443,Staff,0,23,30,30
1650881571012,MATH 109,A01,083213,Anzaldo; Leesa B,0,7,30,30
1650881571012,MATH 109,A02,083214,Anzaldo; Leesa B,0,7,30,30
1650881571012,MATH 109,B01,083215,Anzaldo; Leesa B,0,8,30,30
1650881571012,MATH 109,B02,083216,Anzaldo; Leesa B,0,7,30,30
1650881577041,MATH 142A,A01,083219,Chow; Bennett,0,14,30,30
1650881577041,MATH 142A,A02,083220,Chow; Bennett,0,15,30,30
1650881577041,MATH 142A,B01,083221,Chow; Bennett,0,16,30,30
1650881577041,MATH 142A,B02,083222,Chow; Bennett,0,14,30,30
1650881583152,MATH 193A,A01,083224,Staff,0,6,30,30
1650881583152,MATH 193A,A02,083225,Staff,0,7,30,30
1650881583152,MATH 193A,A03,083781,Staff,0,6,30,30
1650881583152,MATH 193A,A04,083782,Staff,0,7,30,30
1650881589175,MATH 197,001,091859,McAuley; Julian John,9998,0,9999,1
1650881595238,COGS 9,A01,083615,Staff,0,17,60,60
1650881601262,COGS 11,A01,083617,Boyle; Mary E. T.,15,0,40,25
1650881607284,COGS 13,A01,083071,Staff,0,38,40,40
1650881613308,COGS 14A,A01,092681,Staff,0,37,100,100
1650881619332,COGS 14B,A01,083073,Cheng; Tzu-Han,0,12,50,50
1650881625359,COGS 17,A01,092677,Staff,11,0,75,64
1650881631385,COGS 100,A01,083619,Staff,0,30,60,60
1650881637419,COGS 101A,A01,083621,Davis; Joshua Daniel,0,29,60,60
1650881643458,COGS 101B,A01,091572,Staff,0,3,60,60
1650881649485,COGS 101C,A01,083625,Delgado; Tania,14,0,30,16
1650881655508,COGS 107A,A01,083627,Boyle; Mary E. T.,0,16,60,60
1650881661532,COGS 118A,A01,083075,Staff,0,8,60,60
1650881667557,CSE 3,A50,083646,Miranda; Gregory Joseph,16,0,38,22
1650881667557,CSE 3,A51,083647,Miranda; Gregory Joseph,36,0,37,1
1650881673595,CSE 8A,A50,083650,Miranda; Gregory Joseph,0,29,40,40
1650881679634,CSE 11,A01,083080,Cao; Yingjun,0,97,40,40
1650881685656,CSE 12,A01,083652,Staff,0,21,100,100
1650881691681,CSE 15L,A01,083654,Staff,0,3,50,50
1650881691681,CSE 15L,A02,083655,Staff,0,3,50,50
1650881697706,CSE 20,A01,083657,Staff,48,0,80,32
1650881703737,CSE 30,A01,083084,Eldon; John,0,76,40,40
1650881709772,CSE 100,A01,083659,Cao; Yingjun,0,70,50,50
1650881715798,CSE 134B,A01,083661,Powell; Thomas Allan,0,38,65,65
1650881721822,CSE 140,A01,083663,Staff,0,12,75,75
1650881727844,CSE 140L,A01,083088,Eldon; John,0,20,75,75
1650881733875,CSE 175,A01,083665,Kumar; Rakesh,7,0,25,18
1650881739912,CSE 190,A00,092507,Dubnov; Shlomo,9,0,20,11
1650881745940,ECE 45,A01,083139,Staff,0,4,60,60
1650881751972,ECE 65,A50,083695,Staff,0,5,30,30
1650881758007,ECE 109,A01,091882,Touri; Behrouz,32,0,70,38
1650881764033,ECE 180,A00,083140,Abi Samra; Nicholas Camill,20,0,30,10
1650881764033,ECE 180,B00,083141,Abi Samra; Nicholas Camill,0,0,30,30
1650881770079,MATH 10A,A01,083735,Patchell; Gregory David,2,0,30,28
1650881770079,MATH 10A,A02,083736,Patchell; Gregory David,27,0,30,3
1650881770079,MATH 10A,A03,083737,Patchell; Gregory David,23,0,30,7
1650881776122,MATH 10B,A01,083207,Staff,0,9,30,30
1650881776122,MATH 10B,A02,083208,Staff,0,6,30,30
1650881776122,MATH 10B,B01,083739,Staff,10,0,30,20
1650881776122,MATH 10B,B02,083740,Staff,28,0,30,2
1650881782157,MATH 18,A01,083743,Staff,0,0,30,30
1650881782157,MATH 18,A02,083744,Staff,24,0,30,6
1650881782157,MATH 18,A03,083745,Staff,21,0,30,9
1650881782157,MATH 18,A04,083746,Staff,26,0,30,4
1650881782157,MATH 18,B01,083748,Staff,0,15,30,30
1650881782157,MATH 18,B02,083749,Staff,0,13,30,30
1650881782157,MATH 18,B03,083750,Staff,0,13,30,30
1650881782157,MATH 18,B04,083751,Staff,0,13,30,30
1650881788185,MATH 20A,A01,083754,Staff,19,0,40,21
1650881794211,MATH 20B,A01,083756,Staff,0,14,30,30
1650881794211,MATH 20B,A02,083757,Staff,0,11,30,30
1650881800237,MATH 20C,A01,083760,Staff,0,17,30,30
1650881800237,MATH 20C,A02,083761,Staff,1,16,30,29
1650881800237,MATH 20C,B01,083762,Staff,9,0,30,21
1650881800237,MATH 20C,B02,083763,Staff,28,0,30,2
1650881806267,MATH 20D,A01,083765,Staff,2,1,30,28
1650881806267,MATH 20D,A02,083766,Staff,6,0,30,24
1650881806267,MATH 20D,A03,083767,Staff,23,0,30,7
1650881812298,MATH 20E,A01,083771,Staff,2,0,30,28
1650881812298,MATH 20E,A02,083772,Staff,13,0,30,17
1650881812298,MATH 20E,B01,083773,Staff,0,0,30,30
1650881812298,MATH 20E,B02,083774,Staff,4,0,30,26
1650881818331,MATH 103A,A01,083777,Staff,0,17,30,30
1650881818331,MATH 103A,A02,083778,Staff,0,15,30,30
1650881818331,MATH 103A,B01,083779,Staff,0,15,30,30
1650881818331,MATH 103A,B02,083780,Staff,0,14,30,30
1650881824364,MATH 105,A01,085443,Staff,0,23,30,30
1650881830392,MATH 109,A01,083213,Anzaldo; Leesa B,0,7,30,30
1650881830392,MATH 109,A02,083214,Anzaldo; Leesa B,0,7,30,30
1650881830392,MATH 109,B01,083215,Anzaldo; Leesa B,0,8,30,30
1650881830392,MATH 109,B02,083216,Anzaldo; Leesa B,0,7,30,30
1650881836445,MATH 142A,A01,083219,Chow; Bennett,0,14,30,30
1650881836445,MATH 142A,A02,083220,Chow; Bennett,0,15,30,30
1650881836445,MATH 142A,B01,083221,Chow; Bennett,0,16,30,30
1650881836445,MATH 142A,B02,083222,Chow; Bennett,0,14,30,30
1650881842468,MATH 193A,A01,083224,Staff,0,6,30,30
1650881842468,MATH 193A,A02,083225,Staff,0,7,30,30
1650881842468,MATH 193A,A03,083781,Staff,0,6,30,30
1650881842468,MATH 193A,A04,083782,Staff,0,7,30,30
1650881848493,MATH 197,001,091859,McAuley; Julian John,9998,0,9999,1
1650881854571,COGS 9,A01,083615,Staff,0,17,60,60
1650881860600,COGS 11,A01,083617,Boyle; Mary E. T.,15,0,40,25
1650881866629,COGS 13,A01,083071,Staff,0,38,40,40
1650881872654,COGS 14A,A01,092681,Staff,0,37,100,100
1650881878679,COGS 14B,A01,083073,Cheng; Tzu-Han,0,12,50,50
1650881884701,COGS 17,A01,092677,Staff,11,0,75,64
1650881890727,COGS 100,A01,083619,Staff,0,30,60,60
1650881896755,COGS 101A,A01,083621,Davis; Joshua Daniel,0,29,60,60
1650881902782,COGS 101B,A01,091572,Staff,0,3,60,60
1650881908810,COGS 101C,A01,083625,Delgado; Tania,14,0,30,16
1650881914834,COGS 107A,A01,083627,Boyle; Mary E. T.,0,16,60,60
1650881920864,COGS 118A,A01,083075,Staff,0,8,60,60
1650881926895,CSE 3,A50,083646,Miranda; Gregory Joseph,16,0,38,22
1650881926895,CSE 3,A51,083647,Miranda; Gregory Joseph,36,0,37,1
1650881932928,CSE 8A,A50,083650,Miranda; Gregory Joseph,0,29,40,40
1650881938955,CSE 11,A01,083080,Cao; Yingjun,0,97,40,40
1650881944983,CSE 12,A01,083652,Staff,0,21,100,100
1650881951016,CSE 15L,A01,083654,Staff,0,3,50,50
1650881951016,CSE 15L,A02,083655,Staff,0,3,50,50
1650881957048,CSE 20,A01,083657,Staff,48,0,80,32
1650881963072,CSE 30,A01,083084,Eldon; John,0,76,40,40
1650881969097,CSE 100,A01,083659,Cao; Yingjun,0,70,50,50
1650881975123,CSE 134B,A01,083661,Powell; Thomas Allan,0,38,65,65
1650881981149,CSE 140,A01,083663,Staff,0,12,75,75
1650881987174,CSE 140L,A01,083088,Eldon; John,0,20,75,75
1650881993199,CSE 175,A01,083665,Kumar; Rakesh,7,0,25,18
1650881999225,CSE 190,A00,092507,Dubnov; Shlomo,9,0,20,11
1650882005253,ECE 45,A01,083139,Staff,0,4,60,60
1650882011279,ECE 65,A50,083695,Staff,0,5,30,30
1650882017305,ECE 109,A01,091882,Touri; Behrouz,32,0,70,38
1650882023337,ECE 180,A00,083140,Abi Samra; Nicholas Camill,20,0,30,10
1650882023337,ECE 180,B00,083141,Abi Samra; Nicholas Camill,0,0,30,30
1650882029369,MATH 10A,A01,083735,Patchell; Gregory David,2,0,30,28
1650882029369,MATH 10A,A02,083736,Patchell; Gregory David,27,0,30,3
1650882029369,MATH 10A,A03,083737,Patchell; Gregory David,23,0,30,7
1650882035400,MATH 10B,A01,083207,Staff,0,9,30,30
1650882035400,MATH 10B,A02,083208,Staff,0,6,30,30
1650882035400,MATH 10B,B01,083739,Staff,10,0,30,20
1650882035400,MATH 10B,B02,083740,Staff,28,0,30,2
1650882041430,MATH 18,A01,083743,Staff,0,0,30,30
1650882041430,MATH 18,A02,083744,Staff,24,0,30,6
1650882041430,MATH 18,A03,083745,Staff,21,0,30,9
1650882041430,MATH 18,A04,083746,Staff,26,0,30,4
1650882041430,MATH 18,B01,083748,Staff,0,15,30,30
1650882041430,MATH 18,B02,083749,Staff,0,13,30,30
1650882041430,MATH 18,B03,083750,Staff,0,13,30,30
1650882041430,MATH 18,B04,083751,Staff,0,13,30,30
1650882047458,MATH 20A,A01,083754,Staff,19,0,40,21
1650882053482,MATH 20B,A01,083756,Staff,0,14,30,30
1650882053482,MATH 20B,A02,083757,Staff,0,11,30,30
1650882059506,MATH 20C,A01,083760,Staff,0,17,30,30
1650882059506,MATH 20C,A02,083761,Staff,1,16,30,29
1650882059506,MATH 20C,B01,083762,Staff,9,0,30,21
1650882059506,MATH 20C,B02,083763,Staff,28,0,30,2
1650882065529,MATH 20D,A01,083765,Staff,2,1,30,28
1650882065529,MATH 20D,A02,083766,Staff,6,0,30,24
1650882065529,MATH 20D,A03,083767,Staff,23,0,30,7
1650882071554,MATH 20E,A01,083771,Staff,2,0,30,28
1650882071554,MATH 20E,A02,083772,Staff,13,0,30,17
1650882071554,MATH 20E,B01,083773,Staff,0,0,30,30
1650882071554,MATH 20E,B02,083774,Staff,4,0,30,26
1650882077586,MATH 103A,A01,083777,Staff,0,17,30,30
1650882077586,MATH 103A,A02,083778,Staff,0,15,30,30
1650882077586,MATH 103A,B01,083779,Staff,0,15,30,30
1650882077586,MATH 103A,B02,083780,Staff,0,14,30,30
1650882083621,MATH 105,A01,085443,Staff,0,23,30,30
1650882089651,MATH 109,A01,083213,Anzaldo; Leesa B,0,7,30,30
1650882089651,MATH 109,A02,083214,Anzaldo; Leesa B,0,7,30,30
1650882089651,MATH 109,B01,083215,Anzaldo; Leesa B,0,8,30,30
1650882089651,MATH 109,B02,083216,Anzaldo; Leesa B,0,7,30,30
1650882095676,MATH 142A,A01,083219,Chow; Bennett,0,14,30,30
1650882095676,MATH 142A,A02,083220,Chow; Bennett,0,15,30,30
1650882095676,MATH 142A,B01,083221,Chow; Bennett,0,16,30,30
1650882095676,MATH 142A,B02,083222,Chow; Bennett,0,14,30,30
1650882101703,MATH 193A,A01,083224,Staff,0,6,30,30
1650882101703,MATH 193A,A02,083225,Staff,0,7,30,30
1650882101703,MATH 193A,A03,083781,Staff,0,6,30,30
1650882101703,MATH 193A,A04,083782,Staff,0,7,30,30
1650882107730,MATH 197,001,091859,McAuley; Julian John,9998,0,9999,1
1650882113804,COGS 9,A01,083615,Staff,0,17,60,60
1650882119827,COGS 11,A01,083617,Boyle; Mary E. T.,15,0,40,25
1650882125850,COGS 13,A01,083071,Staff,0,38,40,40
1650882131876,COGS 14A,A01,092681,Staff,0,37,100,100
1650882137901,COGS 14B,A01,083073,Cheng; Tzu-Han,0,12,50,50
1650882143925,COGS 17,A01,092677,Staff,11,0,75,64
1650882149952,COGS 100,A01,083619,Staff,0,30,60,60
1650882155977,COGS 101A,A01,083621,Davis; Joshua Daniel,0,29,60,60
1650882162003,COGS 101B,A01,091572,Staff,0,3,60,60
1650882168029,COGS 101C,A01,083625,Delgado; Tania,14,0,30,16
1650882174125,COGS 107A,A01,083627,Boyle; Mary E. T.,0,16,60,60
1650882180150,COGS 118A,A01,083075,Staff,0,8,60,60
1650882186178,CSE 3,A50,083646,Miranda; Gregory Joseph,16,0,38,22
1650882186178,CSE 3,A51,083647,Miranda; Gregory Joseph,36,0,37,1
1650882192226,CSE 8A,A50,083650,Miranda; Gregory Joseph,0,29,40,40
1650882198253,CSE 11,A01,083080,Cao; Yingjun,0,97,40,40
1650882204280,CSE 12,A01,083652,Staff,0,21,100,100
1650882210307,CSE 15L,A01,083654,Staff,0,3,50,50
1650882210307,CSE 15L,A02,083655,Staff,0,3,50,50
1650882216330,CSE 20,A01,083657,Staff,48,0,80,32
1650882222360,CSE 30,A01,083084,Eldon; John,0,76,40,40
1650882228391,CSE 100,A01,083659,Cao; Yingjun,0,70,50,50
1650882234421,CSE 134B,A01,083661,Powell; Thomas Allan,0,38,65,65
1650882240455,CSE 140,A01,083663,Staff,0,12,75,75
1650882246480,CSE 140L,A01,083088,Eldon; John,0,20,75,75
1650882252508,CSE 175,A01,083665,Kumar; Rakesh,7,0,25,18
1650882258533,CSE 190,A00,092507,Dubnov; Shlomo,9,0,20,11
1650882264558,ECE 45,A01,083139,Staff,0,4,60,60
1650882270587,ECE 65,A50,083695,Staff,0,5,30,30
1650882276612,ECE 109,A01,091882,Touri; Behrouz,32,0,70,38
1650882282637,ECE 180,A00,083140,Abi Samra; Nicholas Camill,20,0,30,10
1650882282637,ECE 180,B00,083141,Abi Samra; Nicholas Camill,0,0,30,30
1650882288663,MATH 10A,A01,083735,Patchell; Gregory David,2,0,30,28
1650882288663,MATH 10A,A02,083736,Patchell; Gregory David,27,0,30,3
1650882288663,MATH 10A,A03,083737,Patchell; Gregory David,23,0,30,7
1650882294689,MATH 10B,A01,083207,Staff,0,9,30,30
1650882294689,MATH 10B,A02,083208,Staff,0,6,30,30
1650882294689,MATH 10B,B01,083739,Staff,10,0,30,20
1650882294689,MATH 10B,B02,083740,Staff,28,0,30,2
1650882300722,MATH 18,A01,083743,Staff,0,0,30,30
1650882300722,MATH 18,A02,083744,Staff,24,0,30,6
1650882300722,MATH 18,A03,083745,Staff,21,0,30,9
1650882300722,MATH 18,A04,083746,Staff,26,0,30,4
1650882300722,MATH 18,B01,083748,Staff,0,15,30,30
1650882300722,MATH 18,B02,083749,Staff,0,13,30,30
1650882300722,MATH 18,B03,083750,Staff,0,13,30,30
1650882300722,MATH 18,B04,083751,Staff,0,13,30,30
1650882306750,MATH 20A,A01,083754,Staff,19,0,40,21
1650882312779,MATH 20B,A01,083756,Staff,0,14,30,30
1650882312779,MATH 20B,A02,083757,Staff,0,11,30,30
1650882318804,MATH 20C,A01,083760,Staff,0,17,30,30
1650882318804,MATH 20C,A02,083761,Staff,1,16,30,29
1650882318804,MATH 20C,B01,083762,Staff,9,0,30,21
1650882318804,MATH 20C,B02,083763,Staff,28,0,30,2
1650882324832,MATH 20D,A01,083765,Staff,2,1,30,28
1650882324832,MATH 20D,A02,083766,Staff,6,0,30,24
1650882324832,MATH 20D,A03,083767,Staff,23,0,30,7
1650882330863,MATH 20E,A01,083771,Staff,2,0,30,28
1650882330863,MATH 20E,A02,083772,Staff,13,0,30,17
1650882330863,MATH 20E,B01,083773,Staff,0,0,30,30
1650882330863,MATH 20E,B02,083774,Staff,4,0,30,26
1650882336899,MATH 103A,A01,083777,Staff,0,17,30,30
1650882336899,MATH 103A,A02,083778,Staff,0,15,30,30
1650882336899,MATH 103A,B01,083779,Staff,0,15,30,30
1650882336899,MATH 103A,B02,083780,Staff,0,14,30,30
1650882342934,MATH 105,A01,085443,Staff,0,23,30,30
1650882348960,MATH 109,A01,083213,Anzaldo; Leesa B,0,7,30,30
1650882348960,MATH 109,A02,083214,Anzaldo; Leesa B,0,7,30,30
1650882348960,MATH 109,B01,083215,Anzaldo; Leesa B,0,8,30,30
1650882348960,MATH 109,B02,083216,Anzaldo; Leesa B,0,7,30,30
1650882354984,MATH 142A,A01,083219,Chow; Bennett,0,14,30,30
1650882354984,MATH 142A,A02,083220,Chow; Bennett,0,15,30,30
1650882354984,MATH 142A,B01,083221,Chow; Bennett,0,16,30,30
1650882354984,MATH 142A,B02,083222,Chow; Bennett,0,14,30,30
1650882361008,MATH 193A,A01,083224,Staff,0,6,30,30
1650882361008,MATH 193A,A02,083225,Staff,0,7,30,30
1650882361008,MATH 193A,A03,083781,Staff,0,6,30,30
1650882361008,MATH 193A,A04,083782,Staff,0,7,30,30
1650882367032,MATH 197,001,091859,McAuley; Julian John,9998,0,9999,1
1650882373098,COGS 9,A01,083615,Staff,0,17,60,60
1650882379123,COGS 11,A01,083617,Boyle; Mary E. T.,15,0,40,25
1650882385146,COGS 13,A01,083071,Staff,0,38,40,40
1650882391171,COGS 14A,A01,092681,Staff,0,37,100,100
1650882397198,COGS 14B,A01,083073,Cheng; Tzu-Han,0,12,50,50
1650882403225,COGS 17,A01,092677,Staff,11,0,75,64
1650882409252,COGS 100,A01,083619,Staff,0,30,60,60
1650882415278,COGS 101A,A01,083621,Davis; Joshua Daniel,0,29,60,60
1650882421301,COGS 101B,A01,091572,Staff,0,3,60,60
1650882427330,COGS 101C,A01,083625,Delgado; Tania,14,0,30,16
1650882433372,COGS 107A,A01,083627,Boyle; Mary E. T.,0,16,60,60
1650882439395,COGS 118A,A01,083075,Staff,0,8,60,60
1650882445423,CSE 3,A50,083646,Miranda; Gregory Joseph,16,0,38,22
1650882445423,CSE 3,A51,083647,Miranda; Gregory Joseph,36,0,37,1
1650882451452,CSE 8A,A50,083650,Miranda; Gregory Joseph,0,29,40,40
1650882457476,CSE 11,A01,083080,Cao; Yingjun,0,97,40,40
1650882463504,CSE 12,A01,083652,Staff,0,21,100,100
1650882469530,CSE 15L,A01,083654,Staff,0,3,50,50
1650882469530,CSE 15L,A02,083655,Staff,0,3,50,50
1650882475556,CSE 20,A01,083657,Staff,48,0,80,32
1650882481580,CSE 30,A01,083084,Eldon; John,0,76,40,40
1650882487608,CSE 100,A01,083659,Cao; Yingjun,0,70,50,50
1650882493632,CSE 134B,A01,083661,Powell; Thomas Allan,0,38,65,65
1650882499656,CSE 140,A01,083663,Staff,0,12,75,75
1650882505680,CSE 140L,A01,083088,Eldon; John,0,20,75,75
1650882511711,CSE 175,A01,083665,Kumar; Rakesh,7,0,25,18
1650882517737,CSE 190,A00,092507,Dubnov; Shlomo,9,0,20,11
1650882523764,ECE 45,A01,083139,Staff,0,4,60,60
1650882529790,ECE 65,A50,083695,Staff,0,5,30,30
1650882535816,ECE 109,A01,091882,Touri; Behrouz,32,0,70,38
1650882541845,ECE 180,A00,083140,Abi Samra; Nicholas Camill,20,0,30,10
1650882541845,ECE 180,B00,083141,Abi Samra; Nicholas Camill,0,0,30,30
1650882547871,MATH 10A,A01,083735,Patchell; Gregory David,2,0,30,28
1650882547871,MATH 10A,A02,083736,Patchell; Gregory David,27,0,30,3
1650882547871,MATH 10A,A03,083737,Patchell; Gregory David,23,0,30,7
1650882553895,MATH 10B,A01,083207,Staff,0,9,30,30
1650882553895,MATH 10B,A02,083208,Staff,0,6,30,30
1650882553895,MATH 10B,B01,083739,Staff,10,0,30,20
1650882553895,MATH 10B,B02,083740,Staff,28,0,30,2
1650882559945,MATH 18,A01,083743,Staff,0,0,30,30
1650882559945,MATH 18,A02,083744,Staff,24,0,30,6
1650882559945,MATH 18,A03,083745,Staff,21,0,30,9
1650882559945,MATH 18,A04,083746,Staff,26,0,30,4
1650882559945,MATH 18,B01,083748,Staff,0,15,30,30
1650882559945,MATH 18,B02,083749,Staff,0,13,30,30
1650882559945,MATH 18,B03,083750,Staff,0,13,30,30
1650882559945,MATH 18,B04,083751,Staff,0,13,30,30
1650882565969,MATH 20A,A01,083754,Staff,19,0,40,21
1650882571998,MATH 20B,A01,083756,Staff,0,14,30,30
1650882571998,MATH 20B,A02,083757,Staff,0,11,30,30
1650882578025,MATH 20C,A01,083760,Staff,0,17,30,30
1650882578025,MATH 20C,A02,083761,Staff,1,16,30,29
1650882578025,MATH 20C,B01,083762,Staff,9,0,30,21
1650882578025,MATH 20C,B02,083763,Staff,28,0,30,2
1650882584047,MATH 20D,A01,083765,Staff,2,1,30,28
1650882584047,MATH 20D,A02,083766,Staff,6,0,30,24
1650882584047,MATH 20D,A03,083767,Staff,23,0,30,7
1650882590077,MATH 20E,A01,083771,Staff,2,0,30,28
1650882590077,MATH 20E,A02,083772,Staff,13,0,30,17
1650882590077,MATH 20E,B01,083773,Staff,0,0,30,30
1650882590077,MATH 20E,B02,083774,Staff,4,0,30,26
1650882596108,MATH 103A,A01,083777,Staff,0,17,30,30
1650882596108,MATH 103A,A02,083778,Staff,0,15,30,30
1650882596108,MATH 103A,B01,083779,Staff,0,15,30,30
1650882596108,MATH 103A,B02,083780,Staff,0,14,30,30
1650882602135,MATH 105,A01,085443,Staff,0,23,30,30
1650882608158,MATH 109,A01,083213,Anzaldo; Leesa B,0,7,30,30
1650882608158,MATH 109,A02,083214,Anzaldo; Leesa B,0,7,30,30
1650882608158,MATH 109,B01,083215,Anzaldo; Leesa B,0,8,30,30
1650882608158,MATH 109,B02,083216,Anzaldo; Leesa B,0,7,30,30
1650882614184,MATH 142A,A01,083219,Chow; Bennett,0,14,30,30
1650882614184,MATH 142A,A02,083220,Chow; Bennett,0,15,30,30
1650882614184,MATH 142A,B01,083221,Chow; Bennett,0,16,30,30
1650882614184,MATH 142A,B02,083222,Chow; Bennett,0,14,30,30
1650882620208,MATH 193A,A01,083224,Staff,0,6,30,30
1650882620208,MATH 193A,A02,083225,Staff,0,7,30,30
1650882620208,MATH 193A,A03,083781,Staff,0,6,30,30
1650882620208,MATH 193A,A04,083782,Staff,0,7,30,30
1650882626230,MATH 197,001,091859,McAuley; Julian John,9998,0,9999,1
1650882632288,COGS 9,A01,083615,Staff,0,17,60,60
1650882638313,COGS 11,A01,083617,Boyle; Mary E. T.,15,0,40,25
1650882644336,COGS 13,A01,083071,Staff,0,38,40,40
1650882650359,COGS 14A,A01,092681,Staff,0,37,100,100
1650882656387,COGS 14B,A01,083073,Cheng; Tzu-Han,0,12,50,50
1650882662412,COGS 17,A01,092677,Staff,11,0,75,64
1650882668437,COGS 100,A01,083619,Staff,0,30,60,60
1650882674462,COGS 101A,A01,083621,Davis; Joshua Daniel,0,29,60,60
1650882680493,COGS 101B,A01,091572,Staff,0,3,60,60
1650882686516,COGS 101C,A01,083625,Delgado; Tania,14,0,30,16
1650882692547,COGS 107A,A01,083627,Boyle; Mary E. T.,0,16,60,60
1650882698569,COGS 118A,A01,083075,Staff,0,8,60,60
1650882704601,CSE 3,A50,083646,Miranda; Gregory Joseph,16,0,38,22
1650882704601,CSE 3,A51,083647,Miranda; Gregory Joseph,36,0,37,1
1650882710628,CSE 8A,A50,083650,Miranda; Gregory Joseph,0,29,40,40
1650882716656,CSE 11,A01,083080,Cao; Yingjun,0,97,40,40
1650882722680,CSE 12,A01,083652,Staff,0,21,100,100
1650882728702,CSE 15L,A01,083654,Staff,0,3,50,50
1650882728702,CSE 15L,A02,083655,Staff,0,3,50,50
1650882734729,CSE 20,A01,083657,Staff,48,0,80,32
1650882740757,CSE 30,A01,083084,Eldon; John,0,76,40,40
1650882746782,CSE 100,A01,083659,Cao; Yingjun,0,70,50,50
1650882752808,CSE 134B,A01,083661,Powell; Thomas Allan,0,38,65,65
1650882758835,CSE 140,A01,083663,Staff,0,12,75,75
1650882764858,CSE 140L,A01,083088,Eldon; John,0,20,75,75
1650882770961,CSE 175,A01,083665,Kumar; Rakesh,7,0,25,18
1650882776999,CSE 190,A00,092507,Dubnov; Shlomo,9,0,20,11
1650882783030,ECE 45,A01,083139,Staff,0,4,60,60
1650882789053,ECE 65,A50,083695,Staff,0,5,30,30
1650882795079,ECE 109,A01,091882,Touri; Behrouz,32,0,70,38
1650882801108,ECE 180,A00,083140,Abi Samra; Nicholas Camill,20,0,30,10
1650882801108,ECE 180,B00,083141,Abi Samra; Nicholas Camill,0,0,30,30
1650882807140,MATH 10A,A01,083735,Patchell; Gregory David,2,0,30,28
1650882807140,MATH 10A,A02,083736,Patchell; Gregory David,27,0,30,3
1650882807140,MATH 10A,A03,083737,Patchell; Gregory David,23,0,30,7
1650882813170,MATH 10B,A01,083207,Staff,0,9,30,30
1650882813170,MATH 10B,A02,083208,Staff,0,6,30,30
1650882813170,MATH 10B,B01,083739,Staff,10,0,30,20
1650882813170,MATH 10B,B02,083740,Staff,28,0,30,2
1650882819197,MATH 18,A01,083743,Staff,0,0,30,30
1650882819197,MATH 18,A02,083744,Staff,24,0,30,6
1650882819197,MATH 18,A03,083745,Staff,21,0,30,9
1650882819197,MATH 18,A04,083746,Staff,26,0,30,4
1650882819197,MATH 18,B01,083748,Staff,0,15,30,30
1650882819197,MATH 18,B02,083749,Staff,0,13,30,30
1650882819197,MATH 18,B03,083750,Staff,0,13,30,30
1650882819197,MATH 18,B04,083751,Staff,0,13,30,30
1650882825242,MATH 20A,A01,083754,Staff,19,0,40,21
1650882831272,MATH 20B,A01,083756,Staff,0,14,30,30
1650882831272,MATH 20B,A02,083757,Staff,0,11,30,30
1650882837297,MATH 20C,A01,083760,Staff,0,17,30,30
1650882837297,MATH 20C,A02,083761,Staff,1,16,30,29
1650882837297,MATH 20C,B01,083762,Staff,9,0,30,21
1650882837297,MATH 20C,B02,083763,Staff,28,0,30,2
1650882843326,MATH 20D,A01,083765,Staff,2,1,30,28
1650882843326,MATH 20D,A02,083766,Staff,6,0,30,24
1650882843326,MATH 20D,A03,083767,Staff,23,0,30,7
1650882849356,MATH 20E,A01,083771,Staff,2,0,30,28
1650882849356,MATH 20E,A02,083772,Staff,13,0,30,17
1650882849356,MATH 20E,B01,083773,Staff,0,0,30,30
1650882849356,MATH 20E,B02,083774,Staff,4,0,30,26
1650882855380,MATH 103A,A01,083777,Staff,0,17,30,30
1650882855380,MATH 103A,A02,083778,Staff,0,15,30,30
1650882855380,MATH 103A,B01,083779,Staff,0,15,30,30
1650882855380,MATH 103A,B02,083780,Staff,0,14,30,30
1650882861408,MATH 105,A01,085443,Staff,0,23,30,30
1650882867436,MATH 109,A01,083213,Anzaldo; Leesa B,0,7,30,30
1650882867436,MATH 109,A02,083214,Anzaldo; Leesa B,0,7,30,30
1650882867436,MATH 109,B01,083215,Anzaldo; Leesa B,0,8,30,30
1650882867436,MATH 109,B02,083216,Anzaldo; Leesa B,0,7,30,30
1650882873464,MATH 142A,A01,083219,Chow; Bennett,0,14,30,30
1650882873464,MATH 142A,A02,083220,Chow; Bennett,0,15,30,30
1650882873464,MATH 142A,B01,083221,Chow; Bennett,0,16,30,30
1650882873464,MATH 142A,B02,083222,Chow; Bennett,0,14,30,30
1650882879491,MATH 193A,A01,083224,Staff,0,6,30,30
1650882879491,MATH 193A,A02,083225,Staff,0,7,30,30
1650882879491,MATH 193A,A03,083781,Staff,0,6,30,30
1650882879491,MATH 193A,A04,083782,Staff,0,7,30,30
1650882885514,MATH 197,001,091859,McAuley; Julian John,9998,0,9999,1
1650882891596,COGS 9,A01,083615,Staff,0,17,60,60
1650882897621,COGS 11,A01,083617,Boyle; Mary E. T.,15,0,40,25
1650882903644,COGS 13,A01,083071,Staff,0,38,40,40
1650882909671,COGS 14A,A01,092681,Staff,0,37,100,100
1650882915696,COGS 14B,A01,083073,Cheng; Tzu-Han,0,12,50,50
1650882921719,COGS 17,A01,092677,Staff,11,0,75,64
1650882927742,COGS 100,A01,083619,Staff,0,30,60,60
1650882933767,COGS 101A,A01,083621,Davis; Joshua Daniel,0,29,60,60
1650882939791,COGS 101B,A01,091572,Staff,0,3,60,60
1650882945828,COGS 101C,A01,083625,Delgado; Tania,14,0,30,16
1650882951852,COGS 107A,A01,083627,Boyle; Mary E. T.,0,16,60,60
1650882957881,COGS 118A,A01,083075,Staff,0,8,60,60
1650882963907,CSE 3,A50,083646,Miranda; Gregory Joseph,16,0,38,22
1650882963907,CSE 3,A51,083647,Miranda; Gregory Joseph,36,0,37,1
1650882969934,CSE 8A,A50,083650,Miranda; Gregory Joseph,0,29,40,40
1650882975959,CSE 11,A01,083080,Cao; Yingjun,0,97,40,40
1650882981984,CSE 12,A01,083652,Staff,0,21,100,100
1650882988010,CSE 15L,A01,083654,Staff,0,3,50,50
1650882988010,CSE 15L,A02,083655,Staff,0,3,50,50
1650882994037,CSE 20,A01,083657,Staff,48,0,80,32
1650883000065,CSE 30,A01,083084,Eldon; John,0,76,40,40
1650883006098,CSE 100,A01,083659,Cao; Yingjun,0,70,50,50
1650883012122,CSE 134B,A01,083661,Powell; Thomas Allan,0,38,65,65
1650883018150,CSE 140,A01,083663,Staff,0,12,75,75
1650883024174,CSE 140L,A01,083088,Eldon; John,0,20,75,75
1650883030202,CSE 175,A01,083665,Kumar; Rakesh,7,0,25,18
1650883036235,CSE 190,A00,092507,Dubnov; Shlomo,9,0,20,11
1650883042264,ECE 45,A01,083139,Staff,0,4,60,60
1650883048293,ECE 65,A50,083695,Staff,0,5,30,30
1650883054321,ECE 109,A01,091882,Touri; Behrouz,32,0,70,38
1650883060346,ECE 180,A00,083140,Abi Samra; Nicholas Camill,20,0,30,10
1650883060346,ECE 180,B00,083141,Abi Samra; Nicholas Camill,0,0,30,30
1650883066378,MATH 10A,A01,083735,Patchell; Gregory David,2,0,30,28
1650883066378,MATH 10A,A02,083736,Patchell; Gregory David,27,0,30,3
1650883066378,MATH 10A,A03,083737,Patchell; Gregory David,23,0,30,7
1650883072417,MATH 10B,A01,083207,Staff,0,9,30,30
1650883072417,MATH 10B,A02,083208,Staff,0,6,30,30
1650883072417,MATH 10B,B01,083739,Staff,10,0,30,20
1650883072417,MATH 10B,B02,083740,Staff,28,0,30,2
1650883078444,MATH 18,A01,083743,Staff,0,0,30,30
1650883078444,MATH 18,A02,083744,Staff,24,0,30,6
1650883078444,MATH 18,A03,083745,Staff,21,0,30,9
1650883078444,MATH 18,A04,083746,Staff,26,0,30,4
1650883078444,MATH 18,B01,083748,Staff,0,15,30,30
1650883078444,MATH 18,B02,083749,Staff,0,13,30,30
1650883078444,MATH 18,B03,083750,Staff,0,13,30,30
1650883078444,MATH 18,B04,083751,Staff,0,13,30,30
1650883084472,MATH 20A,A01,083754,Staff,19,0,40,21
1650883090497,MATH 20B,A01,083756,Staff,0,14,30,30
1650883090497,MATH 20B,A02,083757,Staff,0,11,30,30
1650883096523,MATH 20C,A01,083760,Staff,0,17,30,30
1650883096523,MATH 20C,A02,083761,Staff,1,16,30,29
1650883096523,MATH 20C,B01,083762,Staff,9,0,30,21
1650883096523,MATH 20C,B02,083763,Staff,28,0,30,2
1650883102547,MATH 20D,A01,083765,Staff,2,1,30,28
1650883102547,MATH 20D,A02,083766,Staff,6,0,30,24
1650883102547,MATH 20D,A03,083767,Staff,23,0,30,7
1650883108573,MATH 20E,A01,083771,Staff,2,0,30,28
1650883108573,MATH 20E,A02,083772,Staff,13,0,30,17
1650883108573,MATH 20E,B01,083773,Staff,0,0,30,30
1650883108573,MATH 20E,B02,083774,Staff,4,0,30,26
1650883114599,MATH 103A,A01,083777,Staff,0,17,30,30
1650883114599,MATH 103A,A02,083778,Staff,0,15,30,30
1650883114599,MATH 103A,B01,083779,Staff,0,15,30,30
1650883114599,MATH 103A,B02,083780,Staff,0,14,30,30
1650883120624,MATH 105,A01,085443,Staff,0,23,30,30
1650883126653,MATH 109,A01,083213,Anzaldo; Leesa B,0,7,30,30
1650883126653,MATH 109,A02,083214,Anzaldo; Leesa B,0,7,30,30
1650883126653,MATH 109,B01,083215,Anzaldo; Leesa B,0,8,30,30
1650883126653,MATH 109,B02,083216,Anzaldo; Leesa B,0,7,30,30
1650883132679,MATH 142A,A01,083219,Chow; Bennett,0,14,30,30
1650883132679,MATH 142A,A02,083220,Chow; Bennett,0,15,30,30
1650883132679,MATH 142A,B01,083221,Chow; Bennett,0,16,30,30
1650883132679,MATH 142A,B02,083222,Chow; Bennett,0,14,30,30
1650883138707,MATH 193A,A01,083224,Staff,0,6,30,30
1650883138707,MATH 193A,A02,083225,Staff,0,7,30,30
1650883138707,MATH 193A,A03,083781,Staff,0,6,30,30
1650883138707,MATH 193A,A04,083782,Staff,0,7,30,30
1650883144731,MATH 197,001,091859,McAuley; Julian John,9998,0,9999,1
1650883150796,COGS 9,A01,083615,Staff,0,17,60,60
1650883156821,COGS 11,A01,083617,Boyle; Mary E. T.,15,0,40,25
1650883162845,COGS 13,A01,083071,Staff,0,38,40,40
1650883168870,COGS 14A,A01,092681,Staff,0,37,100,100
1650883174903,COGS 14B,A01,083073,Cheng; Tzu-Han,0,12,50,50
1650883180930,COGS 17,A01,092677,Staff,11,0,75,64
1650883186959,COGS 100,A01,083619,Staff,0,30,60,60
1650883192989,COGS 101A,A01,083621,Davis; Joshua Daniel,0,29,60,60
1650883199023,COGS 101B,A01,091572,Staff,0,3,60,60
1650883205048,COGS 101C,A01,083625,Delgado; Tania,14,0,30,16
1650883211073,COGS 107A,A01,083627,Boyle; Mary E. T.,0,16,60,60
1650883217098,COGS 118A,A01,083075,Staff,0,8,60,60
1650883223125,CSE 3,A50,083646,Miranda; Gregory Joseph,16,0,38,22
1650883223125,CSE 3,A51,083647,Miranda; Gregory Joseph,36,0,37,1
1650883229150,CSE 8A,A50,083650,Miranda; Gregory Joseph,0,29,40,40
1650883235174,CSE 11,A01,083080,Cao; Yingjun,0,97,40,40
1650883241198,CSE 12,A01,083652,Staff,0,21,100,100
1650883247222,CSE 15L,A01,083654,Staff,0,3,50,50
1650883247222,CSE 15L,A02,083655,Staff,0,3,50,50
1650883253247,CSE 20,A01,083657,Staff,48,0,80,32
1650883259276,CSE 30,A01,083084,Eldon; John,0,76,40,40
1650883265309,CSE 100,A01,083659,Cao; Yingjun,0,70,50,50
1650883271340,CSE 134B,A01,083661,Powell; Thomas Allan,0,38,65,65
1650883277363,CSE 140,A01,083663,Staff,0,12,75,75
1650883283393,CSE 140L,A01,083088,Eldon; John,0,20,75,75
1650883289422,CSE 175,A01,083665,Kumar; Rakesh,7,0,25,18
1650883295452,CSE 190,A00,092507,Dubnov; Shlomo,9,0,20,11
1650883301476,ECE 45,A01,083139,Staff,0,4,60,60
1650883307503,ECE 65,A50,083695,Staff,0,5,30,30
1650883313527,ECE 109,A01,091882,Touri; Behrouz,32,0,70,38
1650883319560,ECE 180,A00,083140,Abi Samra; Nicholas Camill,20,0,30,10
1650883319560,ECE 180,B00,083141,Abi Samra; Nicholas Camill,0,0,30,30
1650883325597,MATH 10A,A01,083735,Patchell; Gregory David,2,0,30,28
1650883325597,MATH 10A,A02,083736,Patchell; Gregory David,27,0,30,3
1650883325597,MATH 10A,A03,083737,Patchell; Gregory David,23,0,30,7
1650883331619,MATH 10B,A01,083207,Staff,0,9,30,30
1650883331619,MATH 10B,A02,083208,Staff,0,6,30,30
1650883331619,MATH 10B,B01,083739,Staff,10,0,30,20
1650883331619,MATH 10B,B02,083740,Staff,28,0,30,2
1650883337657,MATH 18,A01,083743,Staff,0,0,30,30
1650883337657,MATH 18,A02,083744,Staff,24,0,30,6
1650883337657,MATH 18,A03,083745,Staff,21,0,30,9
1650883337657,MATH 18,A04,083746,Staff,26,0,30,4
1650883337657,MATH 18,B01,083748,Staff,0,15,30,30
1650883337657,MATH 18,B02,083749,Staff,0,13,30,30
1650883337657,MATH 18,B03,083750,Staff,0,13,30,30
1650883337657,MATH 18,B04,083751,Staff,0,13,30,30
1650883343680,MATH 20A,A01,083754,Staff,19,0,40,21
1650883349707,MATH 20B,A01,083756,Staff,0,14,30,30
1650883349707,MATH 20B,A02,083757,Staff,0,11,30,30
1650883355732,MATH 20C,A01,083760,Staff,0,17,30,30
1650883355732,MATH 20C,A02,083761,Staff,1,16,30,29
1650883355732,MATH 20C,B01,083762,Staff,9,0,30,21
1650883355732,MATH 20C,B02,083763,Staff,28,0,30,2
1650883361757,MATH 20D,A01,083765,Staff,2,1,30,28
1650883361757,MATH 20D,A02,083766,Staff,6,0,30,24
1650883361757,MATH 20D,A03,083767,Staff,23,0,30,7
1650883367871,MATH 20E,A01,083771,Staff,2,0,30,28
1650883367871,MATH 20E,A02,083772,Staff,13,0,30,17
1650883367871,MATH 20E,B01,083773,Staff,0,0,30,30
1650883367871,MATH 20E,B02,083774,Staff,4,0,30,26
1650883373902,MATH 103A,A01,083777,Staff,0,17,30,30
1650883373902,MATH 103A,A02,083778,Staff,0,15,30,30
1650883373902,MATH 103A,B01,083779,Staff,0,15,30,30
1650883373902,MATH 103A,B02,083780,Staff,0,14,30,30
1650883379932,MATH 105,A01,085443,Staff,0,23,30,30
1650883385961,MATH 109,A01,083213,Anzaldo; Leesa B,0,7,30,30
1650883385961,MATH 109,A02,083214,Anzaldo; Leesa B,0,7,30,30
1650883385961,MATH 109,B01,083215,Anzaldo; Leesa B,0,8,30,30
1650883385961,MATH 109,B02,083216,Anzaldo; Leesa B,0,7,30,30
1650883391988,MATH 142A,A01,083219,Chow; Bennett,0,14,30,30
1650883391988,MATH 142A,A02,083220,Chow; Bennett,0,15,30,30
1650883391988,MATH 142A,B01,083221,Chow; Bennett,0,16,30,30
1650883391988,MATH 142A,B02,083222,Chow; Bennett,0,14,30,30
1650883398017,MATH 193A,A01,083224,Staff,0,6,30,30
1650883398017,MATH 193A,A02,083225,Staff,0,7,30,30
1650883398017,MATH 193A,A03,083781,Staff,0,6,30,30
1650883398017,MATH 193A,A04,083782,Staff,0,7,30,30
1650883404040,MATH 197,001,091859,McAuley; Julian John,9998,0,9999,1
1650883410109,COGS 9,A01,083615,Staff,0,17,60,60
1650883416133,COGS 11,A01,083617,Boyle; Mary E. T.,15,0,40,25
1650883422156,COGS 13,A01,083071,Staff,0,38,40,40
1650883428184,COGS 14A,A01,092681,Staff,0,37,100,100
1650883434217,COGS 14B,A01,083073,Cheng; Tzu-Han,0,12,50,50
1650883440248,COGS 17,A01,092677,Staff,11,0,75,64
1650883446278,COGS 100,A01,083619,Staff,0,30,60,60
1650883452312,COGS 101A,A01,083621,Davis; Joshua Daniel,0,29,60,60
1650883458337,COGS 101B,A01,091572,Staff,0,3,60,60
1650883464366,COGS 101C,A01,083625,Delgado; Tania,14,0,30,16
1650883470411,COGS 107A,A01,083627,Boyle; Mary E. T.,0,16,60,60
1650883476435,COGS 118A,A01,083075,Staff,0,8,60,60
1650883482461,CSE 3,A50,083646,Miranda; Gregory Joseph,16,0,38,22
1650883482461,CSE 3,A51,083647,Miranda; Gregory Joseph,36,0,37,1
1650883488485,CSE 8A,A50,083650,Miranda; Gregory Joseph,0,29,40,40
1650883494509,CSE 11,A01,083080,Cao; Yingjun,0,97,40,40
1650883500547,CSE 12,A01,083652,Staff,0,21,100,100
1650883506573,CSE 15L,A01,083654,Staff,0,3,50,50
1650883506573,CSE 15L,A02,083655,Staff,0,3,50,50
1650883512597,CSE 20,A01,083657,Staff,48,0,80,32
1650883518627,CSE 30,A01,083084,Eldon; John,0,76,40,40
1650883524652,CSE 100,A01,083659,Cao; Yingjun,0,70,50,50
1650883530677,CSE 134B,A01,083661,Powell; Thomas Allan,0,38,65,65
1650883536701,CSE 140,A01,083663,Staff,0,12,75,75
1650883542726,CSE 140L,A01,083088,Eldon; John,0,20,75,75
1650883548751,CSE 175,A01,083665,Kumar; Rakesh,7,0,25,18
1650883554777,CSE 190,A00,092507,Dubnov; Shlomo,9,0,20,11
1650883560803,ECE 45,A01,083139,Staff,0,4,60,60
1650883566829,ECE 65,A50,083695,Staff,0,5,30,30
1650883572865,ECE 109,A01,091882,Touri; Behrouz,32,0,70,38
1650883578891,ECE 180,A00,083140,Abi Samra; Nicholas Camill,20,0,30,10
1650883578891,ECE 180,B00,083141,Abi Samra; Nicholas Camill,0,0,30,30
1650883584918,MATH 10A,A01,083735,Patchell; Gregory David,2,0,30,28
1650883584918,MATH 10A,A02,083736,Patchell; Gregory David,27,0,30,3
1650883584918,MATH 10A,A03,083737,Patchell; Gregory David,23,0,30,7
1650883590949,MATH 10B,A01,083207,Staff,0,9,30,30
1650883590949,MATH 10B,A02,083208,Staff,0,6,30,30
1650883590949,MATH 10B,B01,083739,Staff,10,0,30,20
1650883590949,MATH 10B,B02,083740,Staff,28,0,30,2
1650883596983,MATH 18,A01,083743,Staff,0,0,30,30
1650883596983,MATH 18,A02,083744,Staff,24,0,30,6
1650883596983,MATH 18,A03,083745,Staff,21,0,30,9
1650883596983,MATH 18,A04,083746,Staff,26,0,30,4
1650883596983,MATH 18,B01,083748,Staff,0,15,30,30
1650883596983,MATH 18,B02,083749,Staff,0,13,30,30
1650883596983,MATH 18,B03,083750,Staff,0,13,30,30
1650883596983,MATH 18,B04,083751,Staff,0,13,30,30
1650883603011,MATH 20A,A01,083754,Staff,19,0,40,21
1650883609047,MATH 20B,A01,083756,Staff,0,14,30,30
1650883609047,MATH 20B,A02,083757,Staff,0,11,30,30
1650883615078,MATH 20C,A01,083760,Staff,0,17,30,30
1650883615078,MATH 20C,A02,083761,Staff,1,16,30,29
1650883615078,MATH 20C,B01,083762,Staff,9,0,30,21
1650883615078,MATH 20C,B02,083763,Staff,28,0,30,2
1650883621103,MATH 20D,A01,083765,Staff,2,1,30,28
1650883621103,MATH 20D,A02,083766,Staff,6,0,30,24
1650883621103,MATH 20D,A03,083767,Staff,23,0,30,7
1650883627134,MATH 20E,A01,083771,Staff,2,0,30,28
1650883627134,MATH 20E,A02,083772,Staff,13,0,30,17
1650883627134,MATH 20E,B01,083773,Staff,0,0,30,30
1650883627134,MATH 20E,B02,083774,Staff,4,0,30,26
1650883633160,MATH 103A,A01,083777,Staff,0,17,30,30
1650883633160,MATH 103A,A02,083778,Staff,0,15,30,30
1650883633160,MATH 103A,B01,083779,Staff,0,15,30,30
1650883633160,MATH 103A,B02,083780,Staff,0,14,30,30
1650883639187,MATH 105,A01,085443,Staff,0,23,30,30
1650883645215,MATH 109,A01,083213,Anzaldo; Leesa B,0,7,30,30
1650883645215,MATH 109,A02,083214,Anzaldo; Leesa B,0,7,30,30
1650883645215,MATH 109,B01,083215,Anzaldo; Leesa B,0,8,30,30
1650883645215,MATH 109,B02,083216,Anzaldo; Leesa B,0,7,30,30
1650883651247,MATH 142A,A01,083219,Chow; Bennett,0,14,30,30
1650883651247,MATH 142A,A02,083220,Chow; Bennett,0,15,30,30
1650883651247,MATH 142A,B01,083221,Chow; Bennett,0,16,30,30
1650883651247,MATH 142A,B02,083222,Chow; Bennett,0,14,30,30
1650883657280,MATH 193A,A01,083224,Staff,0,6,30,30
1650883657280,MATH 193A,A02,083225,Staff,0,7,30,30
1650883657280,MATH 193A,A03,083781,Staff,0,6,30,30
1650883657280,MATH 193A,A04,083782,Staff,0,7,30,30
1650883663305,MATH 197,001,091859,McAuley; Julian John,9998,0,9999,1
1650883669376,COGS 9,A01,083615,Staff,0,17,60,60
1650883675404,COGS 11,A01,083617,Boyle; Mary E. T.,15,0,40,25
1650883681436,COGS 13,A01,083071,Staff,0,38,40,40
1650883687465,COGS 14A,A01,092681,Staff,0,37,100,100
1650883693492,COGS 14B,A01,083073,Cheng; Tzu-Han,0,12,50,50
1650883699515,COGS 17,A01,092677,Staff,11,0,75,64
1650883705545,COGS 100,A01,083619,Staff,0,30,60,60
1650883711575,COGS 101A,A01,083621,Davis; Joshua Daniel,0,29,60,60
1650883717603,COGS 101B,A01,091572,Staff,0,3,60,60
1650883723853,COGS 101C,A01,083625,Delgado; Tania,14,0,30,16
1650883729880,COGS 107A,A01,083627,Boyle; Mary E. T.,0,16,60,60
1650883735904,COGS 118A,A01,083075,Staff,0,8,60,60
1650883741936,CSE 3,A50,083646,Miranda; Gregory Joseph,16,0,38,22
1650883741936,CSE 3,A51,083647,Miranda; Gregory Joseph,36,0,37,1
1650883747959,CSE 8A,A50,083650,Miranda; Gregory Joseph,0,29,40,40
1650883753983,CSE 11,A01,083080,Cao; Yingjun,0,97,40,40
1650883760007,CSE 12,A01,083652,Staff,0,21,100,100
1650883766031,CSE 15L,A01,083654,Staff,0,3,50,50
1650883766031,CSE 15L,A02,083655,Staff,0,3,50,50
1650883772055,CSE 20,A01,083657,Staff,48,0,80,32
1650883778085,CSE 30,A01,083084,Eldon; John,0,76,40,40
1650883784110,CSE 100,A01,083659,Cao; Yingjun,0,70,50,50
1650883790141,CSE 134B,A01,083661,Powell; Thomas Allan,0,38,65,65
1650883796164,CSE 140,A01,083663,Staff,0,12,75,75
1650883802188,CSE 140L,A01,083088,Eldon; John,0,20,75,75
1650883808226,CSE 175,A01,083665,Kumar; Rakesh,7,0,25,18
1650883814251,CSE 190,A00,092507,Dubnov; Shlomo,9,0,20,11
1650883820274,ECE 45,A01,083139,Staff,0,4,60,60
1650883826296,ECE 65,A50,083695,Staff,0,5,30,30
1650883832321,ECE 109,A01,091882,Touri; Behrouz,32,0,70,38
1650883838345,ECE 180,A00,083140,Abi Samra; Nicholas Camill,20,0,30,10
1650883838345,ECE 180,B00,083141,Abi Samra; Nicholas Camill,0,0,30,30
1650883844371,MATH 10A,A01,083735,Patchell; Gregory David,2,0,30,28
1650883844371,MATH 10A,A02,083736,Patchell; Gregory David,27,0,30,3
1650883844371,MATH 10A,A03,083737,Patchell; Gregory David,23,0,30,7
1650883850402,MATH 10B,A01,083207,Staff,0,9,30,30
1650883850402,MATH 10B,A02,083208,Staff,0,6,30,30
1650883850402,MATH 10B,B01,083739,Staff,10,0,30,20
1650883850402,MATH 10B,B02,083740,Staff,28,0,30,2
1650883856436,MATH 18,A01,083743,Staff,0,0,30,30
1650883856436,MATH 18,A02,083744,Staff,24,0,30,6
1650883856436,MATH 18,A03,083745,Staff,21,0,30,9
1650883856436,MATH 18,A04,083746,Staff,26,0,30,4
1650883856436,MATH 18,B01,083748,Staff,0,15,30,30
1650883856436,MATH 18,B02,083749,Staff,0,13,30,30
1650883856436,MATH 18,B03,083750,Staff,0,13,30,30
1650883856436,MATH 18,B04,083751,Staff,0,13,30,30
1650883862462,MATH 20A,A01,083754,Staff,19,0,40,21
1650883868486,MATH 20B,A01,083756,Staff,0,14,30,30
1650883868486,MATH 20B,A02,083757,Staff,0,11,30,30
1650883874516,MATH 20C,A01,083760,Staff,0,17,30,30
1650883874516,MATH 20C,A02,083761,Staff,1,16,30,29
1650883874516,MATH 20C,B01,083762,Staff,9,0,30,21
1650883874516,MATH 20C,B02,083763,Staff,28,0,30,2
1650883880544,MATH 20D,A01,083765,Staff,2,1,30,28
1650883880544,MATH 20D,A02,083766,Staff,6,0,30,24
1650883880544,MATH 20D,A03,083767,Staff,23,0,30,7
1650883886575,MATH 20E,A01,083771,Staff,2,0,30,28
1650883886575,MATH 20E,A02,083772,Staff,13,0,30,17
1650883886575,MATH 20E,B01,083773,Staff,0,0,30,30
1650883886575,MATH 20E,B02,083774,Staff,4,0,30,26
1650883892601,MATH 103A,A01,083777,Staff,0,17,30,30
1650883892601,MATH 103A,A02,083778,Staff,0,15,30,30
1650883892601,MATH 103A,B01,083779,Staff,0,15,30,30
1650883892601,MATH 103A,B02,083780,Staff,0,14,30,30
1650883898626,MATH 105,A01,085443,Staff,0,23,30,30
1650883904650,MATH 109,A01,083213,Anzaldo; Leesa B,0,7,30,30
1650883904650,MATH 109,A02,083214,Anzaldo; Leesa B,0,7,30,30
1650883904650,MATH 109,B01,083215,Anzaldo; Leesa B,0,8,30,30
1650883904650,MATH 109,B02,083216,Anzaldo; Leesa B,0,7,30,30
1650883910675,MATH 142A,A01,083219,Chow; Bennett,0,14,30,30
1650883910675,MATH 142A,A02,083220,Chow; Bennett,0,15,30,30
1650883910675,MATH 142A,B01,083221,Chow; Bennett,0,16,30,30
1650883910675,MATH 142A,B02,083222,Chow; Bennett,0,14,30,30
1650883916704,MATH 193A,A01,083224,Staff,0,6,30,30
1650883916704,MATH 193A,A02,083225,Staff,0,7,30,30
1650883916704,MATH 193A,A03,083781,Staff,0,6,30,30
1650883916704,MATH 193A,A04,083782,Staff,0,7,30,30
1650883922729,MATH 197,001,091859,McAuley; Julian John,9998,0,9999,1
1650883928807,COGS 9,A01,083615,Staff,0,17,60,60
1650883934832,COGS 11,A01,083617,Boyle; Mary E. T.,15,0,40,25
1650883940873,COGS 13,A01,083071,Staff,0,38,40,40
1650883946898,COGS 14A,A01,092681,Staff,0,37,100,100
1650883952951,COGS 14B,A01,083073,Cheng; Tzu-Han,0,12,50,50
1650883959054,COGS 17,A01,092677,Staff,11,0,75,64
1650883965078,COGS 100,A01,083619,Staff,0,30,60,60
1650883971102,COGS 101A,A01,083621,Davis; Joshua Daniel,0,29,60,60
1650883977131,COGS 101B,A01,091572,Staff,0,3,60,60
1650883983155,COGS 101C,A01,083625,Delgado; Tania,14,0,30,16
1650883989179,COGS 107A,A01,083627,Boyle; Mary E. T.,0,16,60,60
1650883995203,COGS 118A,A01,083075,Staff,0,8,60,60
1650884001229,CSE 3,A50,083646,Miranda; Gregory Joseph,16,0,38,22
1650884001229,CSE 3,A51,083647,Miranda; Gregory Joseph,36,0,37,1
1650884007257,CSE 8A,A50,083650,Miranda; Gregory Joseph,0,29,40,40
1650884013291,CSE 11,A01,083080,Cao; Yingjun,0,97,40,40
1650884019318,CSE 12,A01,083652,Staff,0,21,100,100
1650884025342,CSE 15L,A01,083654,Staff,0,3,50,50
1650884025342,CSE 15L,A02,083655,Staff,0,3,50,50
1650884031366,CSE 20,A01,083657,Staff,48,0,80,32
1650884037392,CSE 30,A01,083084,Eldon; John,0,76,40,40
1650884043429,CSE 100,A01,083659,Cao; Yingjun,0,70,50,50
1650884049459,CSE 134B,A01,083661,Powell; Thomas Allan,0,38,65,65
1650884055491,CSE 140,A01,083663,Staff,0,12,75,75
1650884061516,CSE 140L,A01,083088,Eldon; John,0,20,75,75
1650884067543,CSE 175,A01,083665,Kumar; Rakesh,7,0,25,18
1650884073571,CSE 190,A00,092507,Dubnov; Shlomo,9,0,20,11
1650884079594,ECE 45,A01,083139,Staff,0,4,60,60
1650884085618,ECE 65,A50,083695,Staff,0,5,30,30
1650884091643,ECE 109,A01,091882,Touri; Behrouz,32,0,70,38
1650884097668,ECE 180,A00,083140,Abi Samra; Nicholas Camill,20,0,30,10
1650884097668,ECE 180,B00,083141,Abi Samra; Nicholas Camill,0,0,30,30
1650884103700,MATH 10A,A01,083735,Patchell; Gregory David,2,0,30,28
1650884103700,MATH 10A,A02,083736,Patchell; Gregory David,27,0,30,3
1650884103700,MATH 10A,A03,083737,Patchell; Gregory David,23,0,30,7
1650884109725,MATH 10B,A01,083207,Staff,0,9,30,30
1650884109725,MATH 10B,A02,083208,Staff,0,6,30,30
1650884109725,MATH 10B,B01,083739,Staff,10,0,30,20
1650884109725,MATH 10B,B02,083740,Staff,28,0,30,2
1650884115760,MATH 18,A01,083743,Staff,0,0,30,30
1650884115760,MATH 18,A02,083744,Staff,24,0,30,6
1650884115760,MATH 18,A03,083745,Staff,21,0,30,9
1650884115760,MATH 18,A04,083746,Staff,26,0,30,4
1650884115760,MATH 18,B01,083748,Staff,0,15,30,30
1650884115760,MATH 18,B02,083749,Staff,0,13,30,30
1650884115760,MATH 18,B03,083750,Staff,0,13,30,30
1650884115760,MATH 18,B04,083751,Staff,0,13,30,30
1650884121783,MATH 20A,A01,083754,Staff,19,0,40,21
1650884127815,MATH 20B,A01,083756,Staff,0,14,30,30
1650884127815,MATH 20B,A02,083757,Staff,0,11,30,30
1650884133843,MATH 20C,A01,083760,Staff,0,17,30,30
1650884133843,MATH 20C,A02,083761,Staff,1,16,30,29
1650884133843,MATH 20C,B01,083762,Staff,9,0,30,21
1650884133843,MATH 20C,B02,083763,Staff,28,0,30,2
1650884139872,MATH 20D,A01,083765,Staff,2,1,30,28
1650884139872,MATH 20D,A02,083766,Staff,6,0,30,24
1650884139872,MATH 20D,A03,083767,Staff,23,0,30,7
1650884145901,MATH 20E,A01,083771,Staff,2,0,30,28
1650884145901,MATH 20E,A02,083772,Staff,13,0,30,17
1650884145901,MATH 20E,B01,083773,Staff,0,0,30,30
1650884145901,MATH 20E,B02,083774,Staff,4,0,30,26
1650884151927,MATH 103A,A01,083777,Staff,0,17,30,30
1650884151927,MATH 103A,A02,083778,Staff,0,15,30,30
1650884151927,MATH 103A,B01,083779,Staff,0,15,30,30
1650884151927,MATH 103A,B02,083780,Staff,0,14,30,30
1650884157950,MATH 105,A01,085443,Staff,0,23,30,30
1650884163980,MATH 109,A01,083213,Anzaldo; Leesa B,0,7,30,30
1650884163980,MATH 109,A02,083214,Anzaldo; Leesa B,0,7,30,30
1650884163980,MATH 109,B01,083215,Anzaldo; Leesa B,0,8,30,30
1650884163980,MATH 109,B02,083216,Anzaldo; Leesa B,0,7,30,30
1650884170009,MATH 142A,A01,083219,Chow; Bennett,0,14,30,30
1650884170009,MATH 142A,A02,083220,Chow; Bennett,0,15,30,30
1650884170009,MATH 142A,B01,083221,Chow; Bennett,0,16,30,30
1650884170009,MATH 142A,B02,083222,Chow; Bennett,0,14,30,30
1650884176040,MATH 193A,A01,083224,Staff,0,6,30,30
1650884176040,MATH 193A,A02,083225,Staff,0,7,30,30
1650884176040,MATH 193A,A03,083781,Staff,0,6,30,30
1650884176040,MATH 193A,A04,083782,Staff,0,7,30,30
1650884182063,MATH 197,001,091859,McAuley; Julian John,9998,0,9999,1
1650884188136,COGS 9,A01,083615,Staff,0,17,60,60
1650884194165,COGS 11,A01,083617,Boyle; Mary E. T.,15,0,40,25
1650884200201,COGS 13,A01,083071,Staff,0,38,40,40
1650884206226,COGS 14A,A01,092681,Staff,0,37,100,100
1650884212251,COGS 14B,A01,083073,Cheng; Tzu-Han,0,12,50,50
1650884218276,COGS 17,A01,092677,Staff,11,0,75,64
1650884224300,COGS 100,A01,083619,Staff,0,30,60,60
1650884230325,COGS 101A,A01,083621,Davis; Joshua Daniel,0,29,60,60
1650884236354,COGS 101B,A01,091572,Staff,0,3,60,60
1650884242382,COGS 101C,A01,083625,Delgado; Tania,14,0,30,16
1650884248415,COGS 107A,A01,083627,Boyle; Mary E. T.,0,16,60,60
1650884254457,COGS 118A,A01,083075,Staff,0,8,60,60
1650884260482,CSE 3,A50,083646,Miranda; Gregory Joseph,16,0,38,22
1650884260482,CSE 3,A51,083647,Miranda; Gregory Joseph,36,0,37,1
1650884266505,CSE 8A,A50,083650,Miranda; Gregory Joseph,0,29,40,40
1650884272537,CSE 11,A01,083080,Cao; Yingjun,0,97,40,40
1650884278568,CSE 12,A01,083652,Staff,0,21,100,100
1650884284610,CSE 15L,A01,083654,Staff,0,3,50,50
1650884284610,CSE 15L,A02,083655,Staff,0,3,50,50
1650884290636,CSE 20,A01,083657,Staff,48,0,80,32
1650884296660,CSE 30,A01,083084,Eldon; John,0,76,40,40
1650884302691,CSE 100,A01,083659,Cao; Yingjun,0,70,50,50
1650884308715,CSE 134B,A01,083661,Powell; Thomas Allan,0,38,65,65
1650884314738,CSE 140,A01,083663,Staff,0,12,75,75
1650884320762,CSE 140L,A01,083088,Eldon; John,0,20,75,75
1650884326786,CSE 175,A01,083665,Kumar; Rakesh,7,0,25,18
1650884332811,CSE 190,A00,092507,Dubnov; Shlomo,9,0,20,11
1650884338836,ECE 45,A01,083139,Staff,0,4,60,60
1650884344864,ECE 65,A50,083695,Staff,0,5,30,30
1650884350889,ECE 109,A01,091882,Touri; Behrouz,32,0,70,38
1650884356920,ECE 180,A00,083140,Abi Samra; Nicholas Camill,20,0,30,10
1650884356920,ECE 180,B00,083141,Abi Samra; Nicholas Camill,0,0,30,30
1650884362954,MATH 10A,A01,083735,Patchell; Gregory David,2,0,30,28
1650884362954,MATH 10A,A02,083736,Patchell; Gregory David,27,0,30,3
1650884362954,MATH 10A,A03,083737,Patchell; Gregory David,23,0,30,7
1650884368981,MATH 10B,A01,083207,Staff,0,9,30,30
1650884368981,MATH 10B,A02,083208,Staff,0,6,30,30
1650884368981,MATH 10B,B01,083739,Staff,10,0,30,20
1650884368981,MATH 10B,B02,083740,Staff,28,0,30,2
1650884375008,MATH 18,A01,083743,Staff,0,0,30,30
1650884375008,MATH 18,A02,083744,Staff,24,0,30,6
1650884375008,MATH 18,A03,083745,Staff,21,0,30,9
1650884375008,MATH 18,A04,083746,Staff,26,0,30,4
1650884375008,MATH 18,B01,083748,Staff,0,15,30,30
1650884375008,MATH 18,B02,083749,Staff,0,13,30,30
1650884375008,MATH 18,B03,083750,Staff,0,13,30,30
1650884375008,MATH 18,B04,083751,Staff,0,13,30,30
1650884381032,MATH 20A,A01,083754,Staff,19,0,40,21
1650884387057,MATH 20B,A01,083756,Staff,0,14,30,30
1650884387057,MATH 20B,A02,083757,Staff,0,11,30,30
1650884393087,MATH 20C,A01,083760,Staff,0,17,30,30
1650884393087,MATH 20C,A02,083761,Staff,1,16,30,29
1650884393087,MATH 20C,B01,083762,Staff,9,0,30,21
1650884393087,MATH 20C,B02,083763,Staff,28,0,30,2
1650884399115,MATH 20D,A01,083765,Staff,2,1,30,28
1650884399115,MATH 20D,A02,083766,Staff,6,0,30,24
1650884399115,MATH 20D,A03,083767,Staff,23,0,30,7
1650884405153,MATH 20E,A01,083771,Staff,2,0,30,28
1650884405153,MATH 20E,A02,083772,Staff,13,0,30,17
1650884405153,MATH 20E,B01,083773,Staff,0,0,30,30
1650884405153,MATH 20E,B02,083774,Staff,4,0,30,26
1650884411179,MATH 103A,A01,083777,Staff,0,17,30,30
1650884411179,MATH 103A,A02,083778,Staff,0,15,30,30
1650884411179,MATH 103A,B01,083779,Staff,0,15,30,30
1650884411179,MATH 103A,B02,083780,Staff,0,14,30,30
1650884417209,MATH 105,A01,085443,Staff,0,23,30,30
1650884423240,MATH 109,A01,083213,Anzaldo; Leesa B,0,7,30,30
1650884423240,MATH 109,A02,083214,Anzaldo; Leesa B,0,7,30,30
1650884423240,MATH 109,B01,083215,Anzaldo; Leesa B,0,8,30,30
1650884423240,MATH 109,B02,083216,Anzaldo; Leesa B,0,7,30,30
1650884429265,MATH 142A,A01,083219,Chow; Bennett,0,14,30,30
1650884429265,MATH 142A,A02,083220,Chow; Bennett,0,15,30,30
1650884429265,MATH 142A,B01,083221,Chow; Bennett,0,16,30,30
1650884429265,MATH 142A,B02,083222,Chow; Bennett,0,14,30,30
1650884435290,MATH 193A,A01,083224,Staff,0,6,30,30
1650884435290,MATH 193A,A02,083225,Staff,0,7,30,30
1650884435290,MATH 193A,A03,083781,Staff,0,6,30,30
1650884435290,MATH 193A,A04,083782,Staff,0,7,30,30
1650884441314,MATH 197,001,091859,McAuley; Julian John,9998,0,9999,1
1650884447385,COGS 9,A01,083615,Staff,0,17,60,60
1650884453408,COGS 11,A01,083617,Boyle; Mary E. T.,15,0,40,25
1650884459432,COGS 13,A01,083071,Staff,0,38,40,40
1650884465456,COGS 14A,A01,092681,Staff,0,37,100,100
1650884471477,COGS 14B,A01,083073,Cheng; Tzu-Han,0,12,50,50
1650884477500,COGS 17,A01,092677,Staff,11,0,75,64
1650884483536,COGS 100,A01,083619,Staff,0,30,60,60
1650884489561,COGS 101A,A01,083621,Davis; Joshua Daniel,0,29,60,60
1650884495588,COGS 101B,A01,091572,Staff,0,3,60,60
1650884501619,COGS 101C,A01,083625,Delgado; Tania,14,0,30,16
1650884507646,COGS 107A,A01,083627,Boyle; Mary E. T.,0,16,60,60
1650884513670,COGS 118A,A01,083075,Staff,0,8,60,60
1650884519697,CSE 3,A50,083646,Miranda; Gregory Joseph,16,0,38,22
1650884519697,CSE 3,A51,083647,Miranda; Gregory Joseph,36,0,37,1
1650884525725,CSE 8A,A50,083650,Miranda; Gregory Joseph,0,29,40,40
1650884531762,CSE 11,A01,083080,Cao; Yingjun,0,97,40,40
1650884537786,CSE 12,A01,083652,Staff,0,21,100,100
1650884543813,CSE 15L,A01,083654,Staff,0,3,50,50
1650884543813,CSE 15L,A02,083655,Staff,0,3,50,50
1650884549841,CSE 20,A01,083657,Staff,48,0,80,32
1650884555960,CSE 30,A01,083084,Eldon; John,0,76,40,40
1650884561988,CSE 100,A01,083659,Cao; Yingjun,0,70,50,50
1650884568013,CSE 134B,A01,083661,Powell; Thomas Allan,0,38,65,65
1650884574036,CSE 140,A01,083663,Staff,0,12,75,75
1650884580058,CSE 140L,A01,083088,Eldon; John,0,20,75,75
1650884586169,CSE 175,A01,083665,Kumar; Rakesh,7,0,25,18
1650884592200,CSE 190,A00,092507,Dubnov; Shlomo,9,0,20,11
1650884598225,ECE 45,A01,083139,Staff,0,4,60,60
1650884604255,ECE 65,A50,083695,Staff,0,5,30,30
1650884610287,ECE 109,A01,091882,Touri; Behrouz,32,0,70,38
1650884616318,ECE 180,A00,083140,Abi Samra; Nicholas Camill,20,0,30,10
1650884616318,ECE 180,B00,083141,Abi Samra; Nicholas Camill,0,0,30,30
1650884622344,MATH 10A,A01,083735,Patchell; Gregory David,2,0,30,28
1650884622344,MATH 10A,A02,083736,Patchell; Gregory David,27,0,30,3
1650884622344,MATH 10A,A03,083737,Patchell; Gregory David,23,0,30,7
1650884628366,MATH 10B,A01,083207,Staff,0,9,30,30
1650884628366,MATH 10B,A02,083208,Staff,0,6,30,30
1650884628366,MATH 10B,B01,083739,Staff,10,0,30,20
1650884628366,MATH 10B,B02,083740,Staff,28,0,30,2
1650884634393,MATH 18,A01,083743,Staff,0,0,30,30
1650884634393,MATH 18,A02,083744,Staff,24,0,30,6
1650884634393,MATH 18,A03,083745,Staff,21,0,30,9
1650884634393,MATH 18,A04,083746,Staff,26,0,30,4
1650884634393,MATH 18,B01,083748,Staff,0,15,30,30
1650884634393,MATH 18,B02,083749,Staff,0,13,30,30
1650884634393,MATH 18,B03,083750,Staff,0,13,30,30
1650884634393,MATH 18,B04,083751,Staff,0,13,30,30
1650884640426,MATH 20A,A01,083754,Staff,19,0,40,21
1650884646452,MATH 20B,A01,083756,Staff,0,14,30,30
1650884646452,MATH 20B,A02,083757,Staff,0,11,30,30
1650884652477,MATH 20C,A01,083760,Staff,0,17,30,30
1650884652477,MATH 20C,A02,083761,Staff,1,16,30,29
1650884652477,MATH 20C,B01,083762,Staff,9,0,30,21
1650884652477,MATH 20C,B02,083763,Staff,28,0,30,2
1650884658505,MATH 20D,A01,083765,Staff,2,1,30,28
1650884658505,MATH 20D,A02,083766,Staff,6,0,30,24
1650884658505,MATH 20D,A03,083767,Staff,23,0,30,7
1650884664537,MATH 20E,A01,083771,Staff,2,0,30,28
1650884664537,MATH 20E,A02,083772,Staff,13,0,30,17
1650884664537,MATH 20E,B01,083773,Staff,0,0,30,30
1650884664537,MATH 20E,B02,083774,Staff,4,0,30,26
1650884670567,MATH 103A,A01,083777,Staff,0,17,30,30
1650884670567,MATH 103A,A02,083778,Staff,0,15,30,30
1650884670567,MATH 103A,B01,083779,Staff,0,15,30,30
1650884670567,MATH 103A,B02,083780,Staff,0,14,30,30
1650884676596,MATH 105,A01,085443,Staff,0,23,30,30
1650884682626,MATH 109,A01,083213,Anzaldo; Leesa B,0,7,30,30
1650884682626,MATH 109,A02,083214,Anzaldo; Leesa B,0,7,30,30
1650884682626,MATH 109,B01,083215,Anzaldo; Leesa B,0,8,30,30
1650884682626,MATH 109,B02,083216,Anzaldo; Leesa B,0,7,30,30
1650884688656,MATH 142A,A01,083219,Chow; Bennett,0,14,30,30
1650884688656,MATH 142A,A02,083220,Chow; Bennett,0,15,30,30
1650884688656,MATH 142A,B01,083221,Chow; Bennett,0,16,30,30
1650884688656,MATH 142A,B02,083222,Chow; Bennett,0,14,30,30
1650884694680,MATH 193A,A01,083224,Staff,0,6,30,30
1650884694680,MATH 193A,A02,083225,Staff,0,7,30,30
1650884694680,MATH 193A,A03,083781,Staff,0,6,30,30
1650884694680,MATH 193A,A04,083782,Staff,0,7,30,30
1650884700704,MATH 197,001,091859,McAuley; Julian John,9998,0,9999,1
1650884706769,COGS 9,A01,083615,Staff,0,17,60,60
1650884712794,COGS 11,A01,083617,Boyle; Mary E. T.,15,0,40,25
1650884718819,COGS 13,A01,083071,Staff,0,38,40,40
1650884724842,COGS 14A,A01,092681,Staff,0,37,100,100
1650884730866,COGS 14B,A01,083073,Cheng; Tzu-Han,0,12,50,50
1650884736892,COGS 17,A01,092677,Staff,11,0,75,64
