time,subj_course_id,sec_code,sec_id,prof,available,waitlist,total,enrolled_ct
1650453600060,COGS 9,A01,083615,Staff,0,14,60,60
1650453606094,COGS 11,A01,083617,Boyle; Mary E. T.,21,0,40,19
1650453612127,COGS 13,A01,083071,Staff,0,34,40,40
1650453618161,COGS 14A,A01,092681,Staff,1,25,100,99
1650453624195,COGS 14B,A01,083073,Cheng; Tzu-Han,0,11,50,50
1650453630229,COGS 17,A01,092677,Staff,22,0,75,53
1650453636264,COGS 100,A01,083619,Staff,0,26,60,60
1650453642299,COGS 101A,A01,083621,Davis; Joshua Daniel,0,21,60,60
1650453648332,COGS 101B,A01,091572,Staff,0,4,60,60
1650453654363,COGS 101C,A01,083625,Delgado; Tania,16,0,30,14
1650453660397,COGS 107A,A01,083627,Boyle; Mary E. T.,0,11,60,60
1650453666429,COGS 118A,A01,083075,Staff,2,0,60,58
1650453672459,CSE 3,A50,083646,Miranda; Gregory Joseph,20,0,38,18
1650453672459,CSE 3,A51,083647,Miranda; Gregory Joseph,36,0,37,1
1650453678487,CSE 8A,A50,083650,Miranda; Gregory Joseph,0,28,40,40
1650453684516,CSE 11,A01,083080,Cao; Yingjun,0,92,40,40
1650453690562,CSE 12,A01,083652,Staff,0,16,100,100
1650453696597,CSE 15L,A01,083654,Staff,0,1,50,50
1650453696597,CSE 15L,A02,083655,Staff,1,0,50,49
1650453702635,CSE 20,A01,083657,Staff,51,0,80,29
1650453708664,CSE 30,A01,083084,Eldon; John,0,76,40,40
1650453714709,CSE 100,A01,083659,Cao; Yingjun,0,66,50,50
1650453720741,CSE 134B,A01,083661,Powell; Thomas Allan,0,32,65,65
1650453726766,CSE 140,A01,083663,Staff,0,2,75,75
1650453732794,CSE 140L,A01,083088,Eldon; John,0,8,75,75
1650453738827,CSE 175,A01,083665,Kumar; Rakesh,7,0,25,18
1650453744865,CSE 190,A00,092507,Dubnov; Shlomo,14,0,20,6
1650453750904,ECE 45,A01,083139,Staff,0,18,40,40
1650453756939,ECE 65,A50,083695,Staff,0,6,30,30
1650453762972,ECE 109,A01,091882,Touri; Behrouz,38,0,70,32
1650453769025,ECE 180,A00,083140,Abi Samra; Nicholas Camill,23,0,30,7
1650453769025,ECE 180,B00,083141,Abi Samra; Nicholas Camill,0,0,30,30
1650453775064,MATH 10A,A01,083735,Patchell; Gregory David,7,0,30,23
1650453775064,MATH 10A,A02,083736,Patchell; Gregory David,28,0,30,2
1650453775064,MATH 10A,A03,083737,Patchell; Gregory David,25,0,30,5
1650453781096,MATH 10B,A01,083207,Staff,0,7,30,30
1650453781096,MATH 10B,A02,083208,Staff,0,7,30,30
1650453781096,MATH 10B,B01,083739,Staff,13,0,30,17
1650453781096,MATH 10B,B02,083740,Staff,28,0,30,2
1650453787187,MATH 18,A01,083743,Staff,1,0,30,29
1650453787187,MATH 18,A02,083744,Staff,27,0,30,3
1650453787187,MATH 18,A03,083745,Staff,22,0,30,8
1650453787187,MATH 18,A04,083746,Staff,26,0,30,4
1650453787187,MATH 18,B01,083748,Staff,0,11,30,30
1650453787187,MATH 18,B02,083749,Staff,0,12,30,30
1650453787187,MATH 18,B03,083750,Staff,0,11,30,30
1650453787187,MATH 18,B04,083751,Staff,0,12,30,30
1650453793218,MATH 20A,A01,083754,Staff,25,0,40,15
1650453799262,MATH 20B,A01,083756,Staff,0,10,30,30
1650453799262,MATH 20B,A02,083757,Staff,0,10,30,30
1650453805292,MATH 20C,A01,083760,Staff,0,15,30,30
1650453805292,MATH 20C,A02,083761,Staff,1,14,30,29
1650453805292,MATH 20C,B01,083762,Staff,13,0,30,17
1650453805292,MATH 20C,B02,083763,Staff,28,0,30,2
1650453811324,MATH 20D,A01,083765,Staff,0,1,30,30
1650453811324,MATH 20D,A02,083766,Staff,9,0,30,21
1650453811324,MATH 20D,A03,083767,Staff,25,0,30,5
1650453817354,MATH 20E,A01,083771,Staff,6,0,30,24
1650453817354,MATH 20E,A02,083772,Staff,18,0,30,12
1650453817354,MATH 20E,B01,083773,Staff,0,0,30,30
1650453817354,MATH 20E,B02,083774,Staff,10,0,30,20
1650453823387,MATH 103A,A01,083777,Staff,0,12,30,30
1650453823387,MATH 103A,A02,083778,Staff,0,12,30,30
1650453823387,MATH 103A,B01,083779,Staff,0,13,30,30
1650453823387,MATH 103A,B02,083780,Staff,0,12,30,30
1650453829422,MATH 105,A01,085443,Staff,0,23,30,30
1650453835452,MATH 109,A01,083213,Anzaldo; Leesa B,0,7,30,30
1650453835452,MATH 109,A02,083214,Anzaldo; Leesa B,0,7,30,30
1650453835452,MATH 109,B01,083215,Anzaldo; Leesa B,0,5,30,30
1650453835452,MATH 109,B02,083216,Anzaldo; Leesa B,0,6,30,30
1650453841481,MATH 142A,A01,083219,Chow; Bennett,0,14,30,30
1650453841481,MATH 142A,A02,083220,Chow; Bennett,0,13,30,30
1650453841481,MATH 142A,B01,083221,Chow; Bennett,0,12,30,30
1650453841481,MATH 142A,B02,083222,Chow; Bennett,0,13,30,30
1650453847510,MATH 193A,A01,083224,Staff,0,5,30,30
1650453847510,MATH 193A,A02,083225,Staff,0,5,30,30
1650453847510,MATH 193A,A03,083781,Staff,0,4,30,30
1650453847510,MATH 193A,A04,083782,Staff,0,5,30,30
1650453853539,MATH 197,001,091859,McAuley; Julian John,9998,0,9999,1
1650453859634,COGS 9,A01,083615,Staff,0,14,60,60
1650453865667,COGS 11,A01,083617,Boyle; Mary E. T.,21,0,40,19
1650453871699,COGS 13,A01,083071,Staff,0,34,40,40
1650453877734,COGS 14A,A01,092681,Staff,1,25,100,99
1650453883763,COGS 14B,A01,083073,Cheng; Tzu-Han,0,11,50,50
1650453889793,COGS 17,A01,092677,Staff,22,0,75,53
1650453895823,COGS 100,A01,083619,Staff,0,26,60,60
1650453901858,COGS 101A,A01,083621,Davis; Joshua Daniel,0,21,60,60
1650453907888,COGS 101B,A01,091572,Staff,0,4,60,60
1650453913919,COGS 101C,A01,083625,Delgado; Tania,16,0,30,14
1650453919951,COGS 107A,A01,083627,Boyle; Mary E. T.,0,11,60,60
1650453925975,COGS 118A,A01,083075,Staff,2,0,60,58
1650453932007,CSE 3,A50,083646,Miranda; Gregory Joseph,20,0,38,18
1650453932007,CSE 3,A51,083647,Miranda; Gregory Joseph,36,0,37,1
1650453938036,CSE 8A,A50,083650,Miranda; Gregory Joseph,0,28,40,40
1650453944065,CSE 11,A01,083080,Cao; Yingjun,0,92,40,40
1650453950099,CSE 12,A01,083652,Staff,0,16,100,100
1650453956130,CSE 15L,A01,083654,Staff,0,1,50,50
1650453956130,CSE 15L,A02,083655,Staff,1,0,50,49
1650453962162,CSE 20,A01,083657,Staff,51,0,80,29
1650453968191,CSE 30,A01,083084,Eldon; John,0,76,40,40
1650453974233,CSE 100,A01,083659,Cao; Yingjun,0,66,50,50
1650453980266,CSE 134B,A01,083661,Powell; Thomas Allan,0,32,65,65
1650453986297,CSE 140,A01,083663,Staff,0,2,75,75
1650453992332,CSE 140L,A01,083088,Eldon; John,0,8,75,75
1650453998360,CSE 175,A01,083665,Kumar; Rakesh,7,0,25,18
1650454004421,CSE 190,A00,092507,Dubnov; Shlomo,14,0,20,6
1650454010454,ECE 45,A01,083139,Staff,0,18,40,40
1650454016489,ECE 65,A50,083695,Staff,0,6,30,30
1650454030452,ECE 109,A01,091882,Touri; Behrouz,38,0,70,32
1650454036582,ECE 180,A00,083140,Abi Samra; Nicholas Camill,23,0,30,7
1650454036582,ECE 180,B00,083141,Abi Samra; Nicholas Camill,0,0,30,30
1650454051699,MATH 10A,A01,083735,Patchell; Gregory David,7,0,30,23
1650454051699,MATH 10A,A02,083736,Patchell; Gregory David,28,0,30,2
1650454051699,MATH 10A,A03,083737,Patchell; Gregory David,25,0,30,5
1650454057731,MATH 10B,A01,083207,Staff,0,7,30,30
1650454057731,MATH 10B,A02,083208,Staff,0,7,30,30
1650454057731,MATH 10B,B01,083739,Staff,13,0,30,17
1650454057731,MATH 10B,B02,083740,Staff,28,0,30,2
1650454073030,MATH 18,A01,083743,Staff,1,0,30,29
1650454073030,MATH 18,A02,083744,Staff,27,0,30,3
1650454073030,MATH 18,A03,083745,Staff,22,0,30,8
1650454073030,MATH 18,A04,083746,Staff,26,0,30,4
1650454073030,MATH 18,B01,083748,Staff,0,11,30,30
1650454073030,MATH 18,B02,083749,Staff,0,12,30,30
1650454073030,MATH 18,B03,083750,Staff,0,11,30,30
1650454073030,MATH 18,B04,083751,Staff,0,12,30,30
1650454079064,MATH 20A,A01,083754,Staff,25,0,40,15
1650454094531,MATH 20B,A01,083756,Staff,0,10,30,30
1650454094531,MATH 20B,A02,083757,Staff,0,10,30,30
1650454100569,MATH 20C,A01,083760,Staff,0,15,30,30
1650454100569,MATH 20C,A02,083761,Staff,1,14,30,29
1650454100569,MATH 20C,B01,083762,Staff,13,0,30,17
1650454100569,MATH 20C,B02,083763,Staff,28,0,30,2
1650454115973,MATH 20D,A01,083765,Staff,0,1,30,30
1650454115973,MATH 20D,A02,083766,Staff,9,0,30,21
1650454115973,MATH 20D,A03,083767,Staff,25,0,30,5
1650454122010,MATH 20E,A01,083771,Staff,6,0,30,24
1650454122010,MATH 20E,A02,083772,Staff,18,0,30,12
1650454122010,MATH 20E,B01,083773,Staff,0,0,30,30
1650454122010,MATH 20E,B02,083774,Staff,10,0,30,20
1650454137621,MATH 103A,A01,083777,Staff,0,12,30,30
1650454137621,MATH 103A,A02,083778,Staff,0,12,30,30
1650454137621,MATH 103A,B01,083779,Staff,0,13,30,30
1650454137621,MATH 103A,B02,083780,Staff,0,12,30,30
1650454143659,MATH 105,A01,085443,Staff,0,23,30,30
1650454151979,MATH 109,A01,083213,Anzaldo; Leesa B,0,7,30,30
1650454151979,MATH 109,A02,083214,Anzaldo; Leesa B,0,7,30,30
1650454151979,MATH 109,B01,083215,Anzaldo; Leesa B,0,5,30,30
1650454151979,MATH 109,B02,083216,Anzaldo; Leesa B,0,6,30,30
1650454158016,MATH 142A,A01,083219,Chow; Bennett,0,14,30,30
1650454158016,MATH 142A,A02,083220,Chow; Bennett,0,13,30,30
1650454158016,MATH 142A,B01,083221,Chow; Bennett,0,12,30,30
1650454158016,MATH 142A,B02,083222,Chow; Bennett,0,13,30,30
1650454164046,MATH 193A,A01,083224,Staff,0,5,30,30
1650454164046,MATH 193A,A02,083225,Staff,0,5,30,30
1650454164046,MATH 193A,A03,083781,Staff,0,4,30,30
1650454164046,MATH 193A,A04,083782,Staff,0,5,30,30
1650454170091,MATH 197,001,091859,McAuley; Julian John,9998,0,9999,1
1650454176169,COGS 9,A01,083615,Staff,0,14,60,60
1650454182201,COGS 11,A01,083617,Boyle; Mary E. T.,21,0,40,19
1650454188237,COGS 13,A01,083071,Staff,0,34,40,40
1650454194270,COGS 14A,A01,092681,Staff,1,25,100,99
1650454200300,COGS 14B,A01,083073,Cheng; Tzu-Han,0,11,50,50
1650454206332,COGS 17,A01,092677,Staff,22,0,75,53
1650454212374,COGS 100,A01,083619,Staff,0,26,60,60
1650454218405,COGS 101A,A01,083621,Davis; Joshua Daniel,0,21,60,60
1650454224435,COGS 101B,A01,091572,Staff,0,4,60,60
1650454230536,COGS 101C,A01,083625,Delgado; Tania,16,0,30,14
1650454236565,COGS 107A,A01,083627,Boyle; Mary E. T.,0,11,60,60
1650454242642,COGS 118A,A01,083075,Staff,2,0,60,58
1650454248681,CSE 3,A50,083646,Miranda; Gregory Joseph,20,0,38,18
1650454248681,CSE 3,A51,083647,Miranda; Gregory Joseph,36,0,37,1
1650454254710,CSE 8A,A50,083650,Miranda; Gregory Joseph,0,28,40,40
1650454260759,CSE 11,A01,083080,Cao; Yingjun,0,92,40,40
1650454266784,CSE 12,A01,083652,Staff,0,16,100,100
1650454272815,CSE 15L,A01,083654,Staff,0,1,50,50
1650454272815,CSE 15L,A02,083655,Staff,1,0,50,49
1650454278845,CSE 20,A01,083657,Staff,51,0,80,29
1650454284872,CSE 30,A01,083084,Eldon; John,0,76,40,40
1650454290901,CSE 100,A01,083659,Cao; Yingjun,0,66,50,50
1650454296932,CSE 134B,A01,083661,Powell; Thomas Allan,0,32,65,65
1650454302961,CSE 140,A01,083663,Staff,0,2,75,75
1650454308992,CSE 140L,A01,083088,Eldon; John,0,8,75,75
1650454315022,CSE 175,A01,083665,Kumar; Rakesh,7,0,25,18
1650454321057,CSE 190,A00,092507,Dubnov; Shlomo,14,0,20,6
1650454327091,ECE 45,A01,083139,Staff,0,18,40,40
1650454333121,ECE 65,A50,083695,Staff,0,6,30,30
1650454339154,ECE 109,A01,091882,Touri; Behrouz,38,0,70,32
1650454345184,ECE 180,A00,083140,Abi Samra; Nicholas Camill,23,0,30,7
1650454345184,ECE 180,B00,083141,Abi Samra; Nicholas Camill,0,0,30,30
1650454351220,MATH 10A,A01,083735,Patchell; Gregory David,7,0,30,23
1650454351220,MATH 10A,A02,083736,Patchell; Gregory David,28,0,30,2
1650454351220,MATH 10A,A03,083737,Patchell; Gregory David,25,0,30,5
1650454357251,MATH 10B,A01,083207,Staff,0,7,30,30
1650454357251,MATH 10B,A02,083208,Staff,0,7,30,30
1650454357251,MATH 10B,B01,083739,Staff,13,0,30,17
1650454357251,MATH 10B,B02,083740,Staff,28,0,30,2
1650454363288,MATH 18,A01,083743,Staff,1,0,30,29
1650454363288,MATH 18,A02,083744,Staff,27,0,30,3
1650454363288,MATH 18,A03,083745,Staff,22,0,30,8
1650454363288,MATH 18,A04,083746,Staff,26,0,30,4
1650454363288,MATH 18,B01,083748,Staff,0,11,30,30
1650454363288,MATH 18,B02,083749,Staff,0,12,30,30
1650454363288,MATH 18,B03,083750,Staff,0,11,30,30
1650454363288,MATH 18,B04,083751,Staff,0,12,30,30
1650454369321,MATH 20A,A01,083754,Staff,25,0,40,15
1650454375350,MATH 20B,A01,083756,Staff,0,10,30,30
1650454375350,MATH 20B,A02,083757,Staff,0,10,30,30
1650454381380,MATH 20C,A01,083760,Staff,0,15,30,30
1650454381380,MATH 20C,A02,083761,Staff,1,14,30,29
1650454381380,MATH 20C,B01,083762,Staff,13,0,30,17
1650454381380,MATH 20C,B02,083763,Staff,28,0,30,2
1650454387414,MATH 20D,A01,083765,Staff,0,1,30,30
1650454387414,MATH 20D,A02,083766,Staff,9,0,30,21
1650454387414,MATH 20D,A03,083767,Staff,25,0,30,5
1650454393446,MATH 20E,A01,083771,Staff,6,0,30,24
1650454393446,MATH 20E,A02,083772,Staff,18,0,30,12
1650454393446,MATH 20E,B01,083773,Staff,0,0,30,30
1650454393446,MATH 20E,B02,083774,Staff,10,0,30,20
1650454399482,MATH 103A,A01,083777,Staff,0,12,30,30
1650454399482,MATH 103A,A02,083778,Staff,0,12,30,30
1650454399482,MATH 103A,B01,083779,Staff,0,13,30,30
1650454399482,MATH 103A,B02,083780,Staff,0,12,30,30
1650454405511,MATH 105,A01,085443,Staff,0,23,30,30
1650454411546,MATH 109,A01,083213,Anzaldo; Leesa B,0,7,30,30
1650454411546,MATH 109,A02,083214,Anzaldo; Leesa B,0,7,30,30
1650454411546,MATH 109,B01,083215,Anzaldo; Leesa B,0,5,30,30
1650454411546,MATH 109,B02,083216,Anzaldo; Leesa B,0,6,30,30
1650454417594,MATH 142A,A01,083219,Chow; Bennett,0,14,30,30
1650454417594,MATH 142A,A02,083220,Chow; Bennett,0,13,30,30
1650454417594,MATH 142A,B01,083221,Chow; Bennett,0,12,30,30
1650454417594,MATH 142A,B02,083222,Chow; Bennett,0,13,30,30
1650454423622,MATH 193A,A01,083224,Staff,0,5,30,30
1650454423622,MATH 193A,A02,083225,Staff,0,5,30,30
1650454423622,MATH 193A,A03,083781,Staff,0,4,30,30
1650454423622,MATH 193A,A04,083782,Staff,0,5,30,30
1650454429651,MATH 197,001,091859,McAuley; Julian John,9998,0,9999,1
1650454435730,COGS 9,A01,083615,Staff,0,14,60,60
1650454441766,COGS 11,A01,083617,Boyle; Mary E. T.,21,0,40,19
1650454447799,COGS 13,A01,083071,Staff,0,34,40,40
1650454453830,COGS 14A,A01,092681,Staff,1,25,100,99
1650454459859,COGS 14B,A01,083073,Cheng; Tzu-Han,0,11,50,50
1650454465890,COGS 17,A01,092677,Staff,22,0,75,53
1650454471919,COGS 100,A01,083619,Staff,0,26,60,60
1650454477948,COGS 101A,A01,083621,Davis; Joshua Daniel,0,21,60,60
1650454483973,COGS 101B,A01,091572,Staff,0,4,60,60
1650454490006,COGS 101C,A01,083625,Delgado; Tania,16,0,30,14
1650454496032,COGS 107A,A01,083627,Boyle; Mary E. T.,0,11,60,60
1650454508788,COGS 118A,A01,083075,Staff,2,0,60,58
1650454514820,CSE 3,A50,083646,Miranda; Gregory Joseph,20,0,38,18
1650454514820,CSE 3,A51,083647,Miranda; Gregory Joseph,36,0,37,1
1650454524752,CSE 8A,A50,083650,Miranda; Gregory Joseph,0,28,40,40
1650454530785,CSE 11,A01,083080,Cao; Yingjun,0,92,40,40
1650454536819,CSE 12,A01,083652,Staff,0,16,100,100
1650454542895,CSE 15L,A01,083654,Staff,0,1,50,50
1650454542895,CSE 15L,A02,083655,Staff,1,0,50,49
1650454548922,CSE 20,A01,083657,Staff,51,0,80,29
1650454554957,CSE 30,A01,083084,Eldon; John,0,76,40,40
1650454560986,CSE 100,A01,083659,Cao; Yingjun,0,66,50,50
1650454567014,CSE 134B,A01,083661,Powell; Thomas Allan,0,32,65,65
1650454573042,CSE 140,A01,083663,Staff,0,2,75,75
1650454579069,CSE 140L,A01,083088,Eldon; John,0,8,75,75
1650454585097,CSE 175,A01,083665,Kumar; Rakesh,7,0,25,18
1650454591131,CSE 190,A00,092507,Dubnov; Shlomo,14,0,20,6
1650454597164,ECE 45,A01,083139,Staff,0,18,40,40
1650454603195,ECE 65,A50,083695,Staff,0,6,30,30
1650454609222,ECE 109,A01,091882,Touri; Behrouz,38,0,70,32
1650454615251,ECE 180,A00,083140,Abi Samra; Nicholas Camill,23,0,30,7
1650454615251,ECE 180,B00,083141,Abi Samra; Nicholas Camill,0,0,30,30
1650454621283,MATH 10A,A01,083735,Patchell; Gregory David,7,0,30,23
1650454621283,MATH 10A,A02,083736,Patchell; Gregory David,28,0,30,2
1650454621283,MATH 10A,A03,083737,Patchell; Gregory David,25,0,30,5
1650454627313,MATH 10B,A01,083207,Staff,0,7,30,30
1650454627313,MATH 10B,A02,083208,Staff,0,7,30,30
1650454627313,MATH 10B,B01,083739,Staff,13,0,30,17
1650454627313,MATH 10B,B02,083740,Staff,28,0,30,2
1650454633342,MATH 18,A01,083743,Staff,1,0,30,29
1650454633342,MATH 18,A02,083744,Staff,27,0,30,3
1650454633342,MATH 18,A03,083745,Staff,22,0,30,8
1650454633342,MATH 18,A04,083746,Staff,26,0,30,4
1650454633342,MATH 18,B01,083748,Staff,0,11,30,30
1650454633342,MATH 18,B02,083749,Staff,0,12,30,30
1650454633342,MATH 18,B03,083750,Staff,0,11,30,30
1650454633342,MATH 18,B04,083751,Staff,0,12,30,30
1650454639371,MATH 20A,A01,083754,Staff,25,0,40,15
1650454645410,MATH 20B,A01,083756,Staff,0,10,30,30
1650454645410,MATH 20B,A02,083757,Staff,0,10,30,30
1650454651446,MATH 20C,A01,083760,Staff,0,15,30,30
1650454651446,MATH 20C,A02,083761,Staff,1,14,30,29
1650454651446,MATH 20C,B01,083762,Staff,13,0,30,17
1650454651446,MATH 20C,B02,083763,Staff,28,0,30,2
1650454657476,MATH 20D,A01,083765,Staff,0,1,30,30
1650454657476,MATH 20D,A02,083766,Staff,9,0,30,21
1650454657476,MATH 20D,A03,083767,Staff,25,0,30,5
1650454663512,MATH 20E,A01,083771,Staff,6,0,30,24
1650454663512,MATH 20E,A02,083772,Staff,18,0,30,12
1650454663512,MATH 20E,B01,083773,Staff,0,0,30,30
1650454663512,MATH 20E,B02,083774,Staff,10,0,30,20
1650454669539,MATH 103A,A01,083777,Staff,0,12,30,30
1650454669539,MATH 103A,A02,083778,Staff,0,12,30,30
1650454669539,MATH 103A,B01,083779,Staff,0,13,30,30
1650454669539,MATH 103A,B02,083780,Staff,0,12,30,30
1650454675570,MATH 105,A01,085443,Staff,0,23,30,30
1650454681599,MATH 109,A01,083213,Anzaldo; Leesa B,0,7,30,30
1650454681599,MATH 109,A02,083214,Anzaldo; Leesa B,0,7,30,30
1650454681599,MATH 109,B01,083215,Anzaldo; Leesa B,0,5,30,30
1650454681599,MATH 109,B02,083216,Anzaldo; Leesa B,0,6,30,30
1650454687628,MATH 142A,A01,083219,Chow; Bennett,0,14,30,30
1650454687628,MATH 142A,A02,083220,Chow; Bennett,0,13,30,30
1650454687628,MATH 142A,B01,083221,Chow; Bennett,0,12,30,30
1650454687628,MATH 142A,B02,083222,Chow; Bennett,0,13,30,30
1650454693667,MATH 193A,A01,083224,Staff,0,5,30,30
1650454693667,MATH 193A,A02,083225,Staff,0,5,30,30
1650454693667,MATH 193A,A03,083781,Staff,0,4,30,30
1650454693667,MATH 193A,A04,083782,Staff,0,5,30,30
1650454699701,MATH 197,001,091859,McAuley; Julian John,9998,0,9999,1
1650454705772,COGS 9,A01,083615,Staff,0,14,60,60
1650454711806,COGS 11,A01,083617,Boyle; Mary E. T.,21,0,40,19
1650454717839,COGS 13,A01,083071,Staff,0,34,40,40
1650454723872,COGS 14A,A01,092681,Staff,1,25,100,99
1650454729906,COGS 14B,A01,083073,Cheng; Tzu-Han,0,11,50,50
1650454735938,COGS 17,A01,092677,Staff,22,0,75,53
1650454741970,COGS 100,A01,083619,Staff,0,26,60,60
1650454748002,COGS 101A,A01,083621,Davis; Joshua Daniel,0,21,60,60
1650454754030,COGS 101B,A01,091572,Staff,0,4,60,60
1650454760059,COGS 101C,A01,083625,Delgado; Tania,16,0,30,14
1650454766088,COGS 107A,A01,083627,Boyle; Mary E. T.,0,11,60,60
1650454772118,COGS 118A,A01,083075,Staff,2,0,60,58
1650454778149,CSE 3,A50,083646,Miranda; Gregory Joseph,20,0,38,18
1650454778149,CSE 3,A51,083647,Miranda; Gregory Joseph,36,0,37,1
1650454784180,CSE 8A,A50,083650,Miranda; Gregory Joseph,0,28,40,40
1650454790217,CSE 11,A01,083080,Cao; Yingjun,0,92,40,40
1650454796245,CSE 12,A01,083652,Staff,0,16,100,100
1650454802273,CSE 15L,A01,083654,Staff,0,1,50,50
1650454802273,CSE 15L,A02,083655,Staff,1,0,50,49
1650454808300,CSE 20,A01,083657,Staff,51,0,80,29
1650454814335,CSE 30,A01,083084,Eldon; John,0,76,40,40
1650454820364,CSE 100,A01,083659,Cao; Yingjun,0,66,50,50
1650454826396,CSE 134B,A01,083661,Powell; Thomas Allan,0,32,65,65
1650454832426,CSE 140,A01,083663,Staff,0,2,75,75
1650454838526,CSE 140L,A01,083088,Eldon; John,0,8,75,75
1650454844561,CSE 175,A01,083665,Kumar; Rakesh,7,0,25,18
1650454850588,CSE 190,A00,092507,Dubnov; Shlomo,14,0,20,6
1650454856617,ECE 45,A01,083139,Staff,0,18,40,40
1650454862648,ECE 65,A50,083695,Staff,0,6,30,30
1650454868680,ECE 109,A01,091882,Touri; Behrouz,38,0,70,32
1650454874711,ECE 180,A00,083140,Abi Samra; Nicholas Camill,23,0,30,7
1650454874711,ECE 180,B00,083141,Abi Samra; Nicholas Camill,0,0,30,30
1650454880743,MATH 10A,A01,083735,Patchell; Gregory David,7,0,30,23
1650454880743,MATH 10A,A02,083736,Patchell; Gregory David,28,0,30,2
1650454880743,MATH 10A,A03,083737,Patchell; Gregory David,25,0,30,5
1650454886773,MATH 10B,A01,083207,Staff,0,7,30,30
1650454886773,MATH 10B,A02,083208,Staff,0,7,30,30
1650454886773,MATH 10B,B01,083739,Staff,13,0,30,17
1650454886773,MATH 10B,B02,083740,Staff,28,0,30,2
1650454892815,MATH 18,A01,083743,Staff,1,0,30,29
1650454892815,MATH 18,A02,083744,Staff,27,0,30,3
1650454892815,MATH 18,A03,083745,Staff,22,0,30,8
1650454892815,MATH 18,A04,083746,Staff,26,0,30,4
1650454892815,MATH 18,B01,083748,Staff,0,11,30,30
1650454892815,MATH 18,B02,083749,Staff,0,12,30,30
1650454892815,MATH 18,B03,083750,Staff,0,11,30,30
1650454892815,MATH 18,B04,083751,Staff,0,12,30,30
1650454898844,MATH 20A,A01,083754,Staff,25,0,40,15
1650454904873,MATH 20B,A01,083756,Staff,0,10,30,30
1650454904873,MATH 20B,A02,083757,Staff,0,10,30,30
1650454910903,MATH 20C,A01,083760,Staff,0,15,30,30
1650454910903,MATH 20C,A02,083761,Staff,1,14,30,29
1650454910903,MATH 20C,B01,083762,Staff,13,0,30,17
1650454910903,MATH 20C,B02,083763,Staff,28,0,30,2
1650454916929,MATH 20D,A01,083765,Staff,0,1,30,30
1650454916929,MATH 20D,A02,083766,Staff,9,0,30,21
1650454916929,MATH 20D,A03,083767,Staff,25,0,30,5
1650454922960,MATH 20E,A01,083771,Staff,6,0,30,24
1650454922960,MATH 20E,A02,083772,Staff,18,0,30,12
1650454922960,MATH 20E,B01,083773,Staff,0,0,30,30
1650454922960,MATH 20E,B02,083774,Staff,10,0,30,20
1650454928994,MATH 103A,A01,083777,Staff,0,12,30,30
1650454928994,MATH 103A,A02,083778,Staff,0,12,30,30
1650454928994,MATH 103A,B01,083779,Staff,0,13,30,30
1650454928994,MATH 103A,B02,083780,Staff,0,12,30,30
1650454935022,MATH 105,A01,085443,Staff,0,23,30,30
1650454941056,MATH 109,A01,083213,Anzaldo; Leesa B,0,7,30,30
1650454941056,MATH 109,A02,083214,Anzaldo; Leesa B,0,7,30,30
1650454941056,MATH 109,B01,083215,Anzaldo; Leesa B,0,5,30,30
1650454941056,MATH 109,B02,083216,Anzaldo; Leesa B,0,6,30,30
1650454947085,MATH 142A,A01,083219,Chow; Bennett,0,14,30,30
1650454947085,MATH 142A,A02,083220,Chow; Bennett,0,13,30,30
1650454947085,MATH 142A,B01,083221,Chow; Bennett,0,12,30,30
1650454947085,MATH 142A,B02,083222,Chow; Bennett,0,13,30,30
1650454953119,MATH 193A,A01,083224,Staff,0,5,30,30
1650454953119,MATH 193A,A02,083225,Staff,0,5,30,30
1650454953119,MATH 193A,A03,083781,Staff,0,4,30,30
1650454953119,MATH 193A,A04,083782,Staff,0,5,30,30
1650454959153,MATH 197,001,091859,McAuley; Julian John,9998,0,9999,1
1650454965235,COGS 9,A01,083615,Staff,0,14,60,60
1650454971264,COGS 11,A01,083617,Boyle; Mary E. T.,21,0,40,19
1650454977291,COGS 13,A01,083071,Staff,0,34,40,40
1650454983323,COGS 14A,A01,092681,Staff,1,25,100,99
1650454989357,COGS 14B,A01,083073,Cheng; Tzu-Han,0,11,50,50
1650454995388,COGS 17,A01,092677,Staff,22,0,75,53
1650455001420,COGS 100,A01,083619,Staff,0,26,60,60
1650455007451,COGS 101A,A01,083621,Davis; Joshua Daniel,0,21,60,60
1650455013486,COGS 101B,A01,091572,Staff,0,4,60,60
1650455019511,COGS 101C,A01,083625,Delgado; Tania,16,0,30,14
1650455025540,COGS 107A,A01,083627,Boyle; Mary E. T.,0,11,60,60
1650455031568,COGS 118A,A01,083075,Staff,2,0,60,58
1650455037597,CSE 3,A50,083646,Miranda; Gregory Joseph,20,0,38,18
1650455037597,CSE 3,A51,083647,Miranda; Gregory Joseph,36,0,37,1
1650455043621,CSE 8A,A50,083650,Miranda; Gregory Joseph,0,28,40,40
1650455049645,CSE 11,A01,083080,Cao; Yingjun,0,92,40,40
1650455055671,CSE 12,A01,083652,Staff,0,16,100,100
1650455061703,CSE 15L,A01,083654,Staff,0,1,50,50
1650455061703,CSE 15L,A02,083655,Staff,1,0,50,49
1650455067734,CSE 20,A01,083657,Staff,51,0,80,29
1650455073760,CSE 30,A01,083084,Eldon; John,0,76,40,40
1650455079790,CSE 100,A01,083659,Cao; Yingjun,0,66,50,50
1650455085817,CSE 134B,A01,083661,Powell; Thomas Allan,0,32,65,65
1650455091839,CSE 140,A01,083663,Staff,0,2,75,75
1650455097865,CSE 140L,A01,083088,Eldon; John,0,8,75,75
1650455103896,CSE 175,A01,083665,Kumar; Rakesh,7,0,25,18
1650455109923,CSE 190,A00,092507,Dubnov; Shlomo,14,0,20,6
1650455115957,ECE 45,A01,083139,Staff,0,18,40,40
1650455121988,ECE 65,A50,083695,Staff,0,6,30,30
1650455128017,ECE 109,A01,091882,Touri; Behrouz,38,0,70,32
1650455134048,ECE 180,A00,083140,Abi Samra; Nicholas Camill,23,0,30,7
1650455134048,ECE 180,B00,083141,Abi Samra; Nicholas Camill,0,0,30,30
1650455140074,MATH 10A,A01,083735,Patchell; Gregory David,7,0,30,23
1650455140074,MATH 10A,A02,083736,Patchell; Gregory David,28,0,30,2
1650455140074,MATH 10A,A03,083737,Patchell; Gregory David,25,0,30,5
1650455146101,MATH 10B,A01,083207,Staff,0,7,30,30
1650455146101,MATH 10B,A02,083208,Staff,0,7,30,30
1650455146101,MATH 10B,B01,083739,Staff,13,0,30,17
1650455146101,MATH 10B,B02,083740,Staff,28,0,30,2
1650455152134,MATH 18,A01,083743,Staff,1,0,30,29
1650455152134,MATH 18,A02,083744,Staff,27,0,30,3
1650455152134,MATH 18,A03,083745,Staff,22,0,30,8
1650455152134,MATH 18,A04,083746,Staff,26,0,30,4
1650455152134,MATH 18,B01,083748,Staff,0,11,30,30
1650455152134,MATH 18,B02,083749,Staff,0,12,30,30
1650455152134,MATH 18,B03,083750,Staff,0,11,30,30
1650455152134,MATH 18,B04,083751,Staff,0,12,30,30
1650455158163,MATH 20A,A01,083754,Staff,25,0,40,15
1650455164203,MATH 20B,A01,083756,Staff,0,10,30,30
1650455164203,MATH 20B,A02,083757,Staff,0,10,30,30
1650455170237,MATH 20C,A01,083760,Staff,0,15,30,30
1650455170237,MATH 20C,A02,083761,Staff,1,14,30,29
1650455170237,MATH 20C,B01,083762,Staff,13,0,30,17
1650455170237,MATH 20C,B02,083763,Staff,28,0,30,2
1650455176264,MATH 20D,A01,083765,Staff,0,1,30,30
1650455176264,MATH 20D,A02,083766,Staff,9,0,30,21
1650455176264,MATH 20D,A03,083767,Staff,25,0,30,5
1650455182303,MATH 20E,A01,083771,Staff,6,0,30,24
1650455182303,MATH 20E,A02,083772,Staff,18,0,30,12
1650455182303,MATH 20E,B01,083773,Staff,0,0,30,30
1650455182303,MATH 20E,B02,083774,Staff,10,0,30,20
1650455188330,MATH 103A,A01,083777,Staff,0,12,30,30
1650455188330,MATH 103A,A02,083778,Staff,0,12,30,30
1650455188330,MATH 103A,B01,083779,Staff,0,13,30,30
1650455188330,MATH 103A,B02,083780,Staff,0,12,30,30
1650455194357,MATH 105,A01,085443,Staff,0,23,30,30
1650455200386,MATH 109,A01,083213,Anzaldo; Leesa B,0,7,30,30
1650455200386,MATH 109,A02,083214,Anzaldo; Leesa B,0,7,30,30
1650455200386,MATH 109,B01,083215,Anzaldo; Leesa B,0,5,30,30
1650455200386,MATH 109,B02,083216,Anzaldo; Leesa B,0,6,30,30
1650455206416,MATH 142A,A01,083219,Chow; Bennett,0,14,30,30
1650455206416,MATH 142A,A02,083220,Chow; Bennett,0,13,30,30
1650455206416,MATH 142A,B01,083221,Chow; Bennett,0,12,30,30
1650455206416,MATH 142A,B02,083222,Chow; Bennett,0,13,30,30
1650455212445,MATH 193A,A01,083224,Staff,0,5,30,30
1650455212445,MATH 193A,A02,083225,Staff,0,5,30,30
1650455212445,MATH 193A,A03,083781,Staff,0,4,30,30
1650455212445,MATH 193A,A04,083782,Staff,0,5,30,30
1650455218476,MATH 197,001,091859,McAuley; Julian John,9998,0,9999,1
1650455224549,COGS 9,A01,083615,Staff,0,14,60,60
1650455230576,COGS 11,A01,083617,Boyle; Mary E. T.,21,0,40,19
1650455236608,COGS 13,A01,083071,Staff,0,34,40,40
1650455242634,COGS 14A,A01,092681,Staff,1,25,100,99
1650455248665,COGS 14B,A01,083073,Cheng; Tzu-Han,0,11,50,50
1650455254692,COGS 17,A01,092677,Staff,22,0,75,53
1650455260717,COGS 100,A01,083619,Staff,0,26,60,60
1650455266744,COGS 101A,A01,083621,Davis; Joshua Daniel,0,21,60,60
1650455272769,COGS 101B,A01,091572,Staff,0,4,60,60
1650455278795,COGS 101C,A01,083625,Delgado; Tania,16,0,30,14
1650455284821,COGS 107A,A01,083627,Boyle; Mary E. T.,0,11,60,60
1650455290845,COGS 118A,A01,083075,Staff,2,0,60,58
1650455296871,CSE 3,A50,083646,Miranda; Gregory Joseph,20,0,38,18
1650455296871,CSE 3,A51,083647,Miranda; Gregory Joseph,36,0,37,1
1650455302900,CSE 8A,A50,083650,Miranda; Gregory Joseph,0,28,40,40
1650455308930,CSE 11,A01,083080,Cao; Yingjun,0,92,40,40
1650455314970,CSE 12,A01,083652,Staff,0,16,100,100
1650455320994,CSE 15L,A01,083654,Staff,0,1,50,50
1650455320994,CSE 15L,A02,083655,Staff,1,0,50,49
1650455327020,CSE 20,A01,083657,Staff,51,0,80,29
1650455333047,CSE 30,A01,083084,Eldon; John,0,76,40,40
1650455339074,CSE 100,A01,083659,Cao; Yingjun,0,66,50,50
1650455345114,CSE 134B,A01,083661,Powell; Thomas Allan,0,32,65,65
1650455351141,CSE 140,A01,083663,Staff,0,2,75,75
1650455357165,CSE 140L,A01,083088,Eldon; John,0,8,75,75
1650455363192,CSE 175,A01,083665,Kumar; Rakesh,7,0,25,18
1650455369225,CSE 190,A00,092507,Dubnov; Shlomo,14,0,20,6
1650455375252,ECE 45,A01,083139,Staff,0,18,40,40
1650455381278,ECE 65,A50,083695,Staff,0,6,30,30
1650455387303,ECE 109,A01,091882,Touri; Behrouz,38,0,70,32
1650455393335,ECE 180,A00,083140,Abi Samra; Nicholas Camill,23,0,30,7
1650455393335,ECE 180,B00,083141,Abi Samra; Nicholas Camill,0,0,30,30
1650455399373,MATH 10A,A01,083735,Patchell; Gregory David,7,0,30,23
1650455399373,MATH 10A,A02,083736,Patchell; Gregory David,28,0,30,2
1650455399373,MATH 10A,A03,083737,Patchell; Gregory David,25,0,30,5
1650455405400,MATH 10B,A01,083207,Staff,0,7,30,30
1650455405400,MATH 10B,A02,083208,Staff,0,7,30,30
1650455405400,MATH 10B,B01,083739,Staff,13,0,30,17
1650455405400,MATH 10B,B02,083740,Staff,28,0,30,2
1650455411434,MATH 18,A01,083743,Staff,1,0,30,29
1650455411434,MATH 18,A02,083744,Staff,27,0,30,3
1650455411434,MATH 18,A03,083745,Staff,22,0,30,8
1650455411434,MATH 18,A04,083746,Staff,26,0,30,4
1650455411434,MATH 18,B01,083748,Staff,0,11,30,30
1650455411434,MATH 18,B02,083749,Staff,0,12,30,30
1650455411434,MATH 18,B03,083750,Staff,0,11,30,30
1650455411434,MATH 18,B04,083751,Staff,0,12,30,30
1650455417460,MATH 20A,A01,083754,Staff,25,0,40,15
1650455423488,MATH 20B,A01,083756,Staff,0,10,30,30
1650455423488,MATH 20B,A02,083757,Staff,0,10,30,30
1650455429517,MATH 20C,A01,083760,Staff,0,15,30,30
1650455429517,MATH 20C,A02,083761,Staff,1,14,30,29
1650455429517,MATH 20C,B01,083762,Staff,13,0,30,17
1650455429517,MATH 20C,B02,083763,Staff,28,0,30,2
1650455435619,MATH 20D,A01,083765,Staff,0,1,30,30
1650455435619,MATH 20D,A02,083766,Staff,9,0,30,21
1650455435619,MATH 20D,A03,083767,Staff,25,0,30,5
1650455441645,MATH 20E,A01,083771,Staff,6,0,30,24
1650455441645,MATH 20E,A02,083772,Staff,18,0,30,12
1650455441645,MATH 20E,B01,083773,Staff,0,0,30,30
1650455441645,MATH 20E,B02,083774,Staff,10,0,30,20
1650455447683,MATH 103A,A01,083777,Staff,0,12,30,30
1650455447683,MATH 103A,A02,083778,Staff,0,12,30,30
1650455447683,MATH 103A,B01,083779,Staff,0,13,30,30
1650455447683,MATH 103A,B02,083780,Staff,0,12,30,30
1650455453721,MATH 105,A01,085443,Staff,0,23,30,30
1650455459760,MATH 109,A01,083213,Anzaldo; Leesa B,0,7,30,30
1650455459760,MATH 109,A02,083214,Anzaldo; Leesa B,0,7,30,30
1650455459760,MATH 109,B01,083215,Anzaldo; Leesa B,0,5,30,30
1650455459760,MATH 109,B02,083216,Anzaldo; Leesa B,0,6,30,30
1650455465788,MATH 142A,A01,083219,Chow; Bennett,0,14,30,30
1650455465788,MATH 142A,A02,083220,Chow; Bennett,0,13,30,30
1650455465788,MATH 142A,B01,083221,Chow; Bennett,0,12,30,30
1650455465788,MATH 142A,B02,083222,Chow; Bennett,0,13,30,30
1650455471817,MATH 193A,A01,083224,Staff,0,5,30,30
1650455471817,MATH 193A,A02,083225,Staff,0,5,30,30
1650455471817,MATH 193A,A03,083781,Staff,0,4,30,30
1650455471817,MATH 193A,A04,083782,Staff,0,5,30,30
1650455477845,MATH 197,001,091859,McAuley; Julian John,9998,0,9999,1
1650455483935,COGS 9,A01,083615,Staff,0,14,60,60
1650455489982,COGS 11,A01,083617,Boyle; Mary E. T.,21,0,40,19
1650455496009,COGS 13,A01,083071,Staff,0,34,40,40
1650455502040,COGS 14A,A01,092681,Staff,1,25,100,99
1650455508069,COGS 14B,A01,083073,Cheng; Tzu-Han,0,11,50,50
1650455514094,COGS 17,A01,092677,Staff,22,0,75,53
1650455520119,COGS 100,A01,083619,Staff,0,26,60,60
1650455526147,COGS 101A,A01,083621,Davis; Joshua Daniel,0,21,60,60
1650455532179,COGS 101B,A01,091572,Staff,0,4,60,60
1650455538207,COGS 101C,A01,083625,Delgado; Tania,16,0,30,14
1650455544237,COGS 107A,A01,083627,Boyle; Mary E. T.,0,11,60,60
1650455550271,COGS 118A,A01,083075,Staff,2,0,60,58
1650455556304,CSE 3,A50,083646,Miranda; Gregory Joseph,20,0,38,18
1650455556304,CSE 3,A51,083647,Miranda; Gregory Joseph,36,0,37,1
1650455562331,CSE 8A,A50,083650,Miranda; Gregory Joseph,0,28,40,40
1650455568358,CSE 11,A01,083080,Cao; Yingjun,0,92,40,40
1650455574387,CSE 12,A01,083652,Staff,0,16,100,100
1650455580416,CSE 15L,A01,083654,Staff,0,1,50,50
1650455580416,CSE 15L,A02,083655,Staff,1,0,50,49
1650455586446,CSE 20,A01,083657,Staff,51,0,80,29
1650455592474,CSE 30,A01,083084,Eldon; John,0,76,40,40
1650455598502,CSE 100,A01,083659,Cao; Yingjun,0,66,50,50
1650455604536,CSE 134B,A01,083661,Powell; Thomas Allan,0,32,65,65
1650455610561,CSE 140,A01,083663,Staff,0,2,75,75
1650455616585,CSE 140L,A01,083088,Eldon; John,0,8,75,75
1650455622611,CSE 175,A01,083665,Kumar; Rakesh,7,0,25,18
1650455628642,CSE 190,A00,092507,Dubnov; Shlomo,14,0,20,6
1650455634670,ECE 45,A01,083139,Staff,0,18,40,40
1650455640694,ECE 65,A50,083695,Staff,0,6,30,30
1650455646726,ECE 109,A01,091882,Touri; Behrouz,38,0,70,32
1650455652753,ECE 180,A00,083140,Abi Samra; Nicholas Camill,23,0,30,7
1650455652753,ECE 180,B00,083141,Abi Samra; Nicholas Camill,0,0,30,30
1650455658780,MATH 10A,A01,083735,Patchell; Gregory David,7,0,30,23
1650455658780,MATH 10A,A02,083736,Patchell; Gregory David,28,0,30,2
1650455658780,MATH 10A,A03,083737,Patchell; Gregory David,25,0,30,5
1650455664807,MATH 10B,A01,083207,Staff,0,7,30,30
1650455664807,MATH 10B,A02,083208,Staff,0,7,30,30
1650455664807,MATH 10B,B01,083739,Staff,13,0,30,17
1650455664807,MATH 10B,B02,083740,Staff,28,0,30,2
1650455670839,MATH 18,A01,083743,Staff,1,0,30,29
1650455670839,MATH 18,A02,083744,Staff,27,0,30,3
1650455670839,MATH 18,A03,083745,Staff,22,0,30,8
1650455670839,MATH 18,A04,083746,Staff,26,0,30,4
1650455670839,MATH 18,B01,083748,Staff,0,11,30,30
1650455670839,MATH 18,B02,083749,Staff,0,12,30,30
1650455670839,MATH 18,B03,083750,Staff,0,11,30,30
1650455670839,MATH 18,B04,083751,Staff,0,12,30,30
1650455676867,MATH 20A,A01,083754,Staff,25,0,40,15
1650455682893,MATH 20B,A01,083756,Staff,0,10,30,30
1650455682893,MATH 20B,A02,083757,Staff,0,10,30,30
1650455688927,MATH 20C,A01,083760,Staff,0,15,30,30
1650455688927,MATH 20C,A02,083761,Staff,1,14,30,29
1650455688927,MATH 20C,B01,083762,Staff,13,0,30,17
1650455688927,MATH 20C,B02,083763,Staff,28,0,30,2
1650455694953,MATH 20D,A01,083765,Staff,0,1,30,30
1650455694953,MATH 20D,A02,083766,Staff,9,0,30,21
1650455694953,MATH 20D,A03,083767,Staff,25,0,30,5
1650455700987,MATH 20E,A01,083771,Staff,6,0,30,24
1650455700987,MATH 20E,A02,083772,Staff,18,0,30,12
1650455700987,MATH 20E,B01,083773,Staff,0,0,30,30
1650455700987,MATH 20E,B02,083774,Staff,10,0,30,20
1650455707018,MATH 103A,A01,083777,Staff,0,12,30,30
1650455707018,MATH 103A,A02,083778,Staff,0,12,30,30
1650455707018,MATH 103A,B01,083779,Staff,0,13,30,30
1650455707018,MATH 103A,B02,083780,Staff,0,12,30,30
1650455713050,MATH 105,A01,085443,Staff,0,23,30,30
1650455719079,MATH 109,A01,083213,Anzaldo; Leesa B,0,7,30,30
1650455719079,MATH 109,A02,083214,Anzaldo; Leesa B,0,7,30,30
1650455719079,MATH 109,B01,083215,Anzaldo; Leesa B,0,5,30,30
1650455719079,MATH 109,B02,083216,Anzaldo; Leesa B,0,6,30,30
1650455725145,MATH 142A,A01,083219,Chow; Bennett,0,14,30,30
1650455725145,MATH 142A,A02,083220,Chow; Bennett,0,13,30,30
1650455725145,MATH 142A,B01,083221,Chow; Bennett,0,12,30,30
1650455725145,MATH 142A,B02,083222,Chow; Bennett,0,13,30,30
1650455731176,MATH 193A,A01,083224,Staff,0,5,30,30
1650455731176,MATH 193A,A02,083225,Staff,0,5,30,30
1650455731176,MATH 193A,A03,083781,Staff,0,4,30,30
1650455731176,MATH 193A,A04,083782,Staff,0,5,30,30
1650455737205,MATH 197,001,091859,McAuley; Julian John,9998,0,9999,1
1650455743298,COGS 9,A01,083615,Staff,0,14,60,60
1650455749324,COGS 11,A01,083617,Boyle; Mary E. T.,21,0,40,19
1650455755356,COGS 13,A01,083071,Staff,0,34,40,40
1650455761399,COGS 14A,A01,092681,Staff,1,25,100,99
1650455767428,COGS 14B,A01,083073,Cheng; Tzu-Han,0,11,50,50
1650455773461,COGS 17,A01,092677,Staff,22,0,75,53
1650455779491,COGS 100,A01,083619,Staff,0,26,60,60
1650455785518,COGS 101A,A01,083621,Davis; Joshua Daniel,0,21,60,60
1650455791546,COGS 101B,A01,091572,Staff,0,4,60,60
1650455797575,COGS 101C,A01,083625,Delgado; Tania,16,0,30,14
1650455803609,COGS 107A,A01,083627,Boyle; Mary E. T.,0,11,60,60
1650455809636,COGS 118A,A01,083075,Staff,2,0,60,58
1650455815663,CSE 3,A50,083646,Miranda; Gregory Joseph,20,0,38,18
1650455815663,CSE 3,A51,083647,Miranda; Gregory Joseph,36,0,37,1
1650455821689,CSE 8A,A50,083650,Miranda; Gregory Joseph,0,28,40,40
1650455827719,CSE 11,A01,083080,Cao; Yingjun,0,92,40,40
1650455833745,CSE 12,A01,083652,Staff,0,16,100,100
1650455839769,CSE 15L,A01,083654,Staff,0,1,50,50
1650455839769,CSE 15L,A02,083655,Staff,1,0,50,49
1650455845796,CSE 20,A01,083657,Staff,51,0,80,29
1650455851823,CSE 30,A01,083084,Eldon; John,0,76,40,40
1650455857853,CSE 100,A01,083659,Cao; Yingjun,0,66,50,50
1650455863885,CSE 134B,A01,083661,Powell; Thomas Allan,0,32,65,65
1650455869912,CSE 140,A01,083663,Staff,0,2,75,75
1650455875942,CSE 140L,A01,083088,Eldon; John,0,8,75,75
1650455881970,CSE 175,A01,083665,Kumar; Rakesh,7,0,25,18
1650455887996,CSE 190,A00,092507,Dubnov; Shlomo,14,0,20,6
1650455894023,ECE 45,A01,083139,Staff,0,18,40,40
1650455900053,ECE 65,A50,083695,Staff,0,6,30,30
1650455906083,ECE 109,A01,091882,Touri; Behrouz,38,0,70,32
1650455912113,ECE 180,A00,083140,Abi Samra; Nicholas Camill,23,0,30,7
1650455912113,ECE 180,B00,083141,Abi Samra; Nicholas Camill,0,0,30,30
1650455918162,MATH 10A,A01,083735,Patchell; Gregory David,7,0,30,23
1650455918162,MATH 10A,A02,083736,Patchell; Gregory David,28,0,30,2
1650455918162,MATH 10A,A03,083737,Patchell; Gregory David,25,0,30,5
1650455924196,MATH 10B,A01,083207,Staff,0,7,30,30
1650455924196,MATH 10B,A02,083208,Staff,0,7,30,30
1650455924196,MATH 10B,B01,083739,Staff,13,0,30,17
1650455924196,MATH 10B,B02,083740,Staff,28,0,30,2
1650455930232,MATH 18,A01,083743,Staff,1,0,30,29
1650455930232,MATH 18,A02,083744,Staff,27,0,30,3
1650455930232,MATH 18,A03,083745,Staff,22,0,30,8
1650455930232,MATH 18,A04,083746,Staff,26,0,30,4
1650455930232,MATH 18,B01,083748,Staff,0,11,30,30
1650455930232,MATH 18,B02,083749,Staff,0,12,30,30
1650455930232,MATH 18,B03,083750,Staff,0,11,30,30
1650455930232,MATH 18,B04,083751,Staff,0,12,30,30
1650455936259,MATH 20A,A01,083754,Staff,25,0,40,15
1650455942290,MATH 20B,A01,083756,Staff,0,10,30,30
1650455942290,MATH 20B,A02,083757,Staff,0,10,30,30
1650455948323,MATH 20C,A01,083760,Staff,0,15,30,30
1650455948323,MATH 20C,A02,083761,Staff,1,14,30,29
1650455948323,MATH 20C,B01,083762,Staff,13,0,30,17
1650455948323,MATH 20C,B02,083763,Staff,28,0,30,2
1650455954352,MATH 20D,A01,083765,Staff,0,1,30,30
1650455954352,MATH 20D,A02,083766,Staff,9,0,30,21
1650455954352,MATH 20D,A03,083767,Staff,25,0,30,5
1650455960388,MATH 20E,A01,083771,Staff,6,0,30,24
1650455960388,MATH 20E,A02,083772,Staff,18,0,30,12
1650455960388,MATH 20E,B01,083773,Staff,0,0,30,30
1650455960388,MATH 20E,B02,083774,Staff,10,0,30,20
1650455966416,MATH 103A,A01,083777,Staff,0,12,30,30
1650455966416,MATH 103A,A02,083778,Staff,0,12,30,30
1650455966416,MATH 103A,B01,083779,Staff,0,13,30,30
1650455966416,MATH 103A,B02,083780,Staff,0,12,30,30
1650455972447,MATH 105,A01,085443,Staff,0,23,30,30
1650455978474,MATH 109,A01,083213,Anzaldo; Leesa B,0,7,30,30
1650455978474,MATH 109,A02,083214,Anzaldo; Leesa B,0,7,30,30
1650455978474,MATH 109,B01,083215,Anzaldo; Leesa B,0,5,30,30
1650455978474,MATH 109,B02,083216,Anzaldo; Leesa B,0,6,30,30
1650455984506,MATH 142A,A01,083219,Chow; Bennett,0,14,30,30
1650455984506,MATH 142A,A02,083220,Chow; Bennett,0,13,30,30
1650455984506,MATH 142A,B01,083221,Chow; Bennett,0,12,30,30
1650455984506,MATH 142A,B02,083222,Chow; Bennett,0,13,30,30
1650455990533,MATH 193A,A01,083224,Staff,0,5,30,30
1650455990533,MATH 193A,A02,083225,Staff,0,5,30,30
1650455990533,MATH 193A,A03,083781,Staff,0,4,30,30
1650455990533,MATH 193A,A04,083782,Staff,0,5,30,30
1650455996558,MATH 197,001,091859,McAuley; Julian John,9998,0,9999,1
1650456002627,COGS 9,A01,083615,Staff,0,14,60,60
1650456008656,COGS 11,A01,083617,Boyle; Mary E. T.,21,0,40,19
1650456014683,COGS 13,A01,083071,Staff,0,34,40,40
1650456020710,COGS 14A,A01,092681,Staff,1,25,100,99
1650456026819,COGS 14B,A01,083073,Cheng; Tzu-Han,0,11,50,50
1650456032843,COGS 17,A01,092677,Staff,22,0,75,53
1650456038868,COGS 100,A01,083619,Staff,0,26,60,60
1650456044895,COGS 101A,A01,083621,Davis; Joshua Daniel,0,21,60,60
1650456050922,COGS 101B,A01,091572,Staff,0,4,60,60
1650456056949,COGS 101C,A01,083625,Delgado; Tania,16,0,30,14
1650456062975,COGS 107A,A01,083627,Boyle; Mary E. T.,0,11,60,60
1650456069001,COGS 118A,A01,083075,Staff,2,0,60,58
1650456075031,CSE 3,A50,083646,Miranda; Gregory Joseph,20,0,38,18
1650456075031,CSE 3,A51,083647,Miranda; Gregory Joseph,36,0,37,1
1650456081060,CSE 8A,A50,083650,Miranda; Gregory Joseph,0,28,40,40
1650456087085,CSE 11,A01,083080,Cao; Yingjun,0,92,40,40
1650456093109,CSE 12,A01,083652,Staff,0,16,100,100
1650456099136,CSE 15L,A01,083654,Staff,0,1,50,50
1650456099136,CSE 15L,A02,083655,Staff,1,0,50,49
1650456105163,CSE 20,A01,083657,Staff,51,0,80,29
1650456111189,CSE 30,A01,083084,Eldon; John,0,76,40,40
1650456117217,CSE 100,A01,083659,Cao; Yingjun,0,66,50,50
1650456123243,CSE 134B,A01,083661,Powell; Thomas Allan,0,32,65,65
1650456129268,CSE 140,A01,083663,Staff,0,2,75,75
1650456135305,CSE 140L,A01,083088,Eldon; John,0,8,75,75
1650456141331,CSE 175,A01,083665,Kumar; Rakesh,7,0,25,18
1650456147357,CSE 190,A00,092507,Dubnov; Shlomo,14,0,20,6
1650456153381,ECE 45,A01,083139,Staff,0,18,40,40
1650456159407,ECE 65,A50,083695,Staff,0,6,30,30
1650456165434,ECE 109,A01,091882,Touri; Behrouz,38,0,70,32
1650456171466,ECE 180,A00,083140,Abi Samra; Nicholas Camill,23,0,30,7
1650456171466,ECE 180,B00,083141,Abi Samra; Nicholas Camill,0,0,30,30
1650456177492,MATH 10A,A01,083735,Patchell; Gregory David,7,0,30,23
1650456177492,MATH 10A,A02,083736,Patchell; Gregory David,28,0,30,2
1650456177492,MATH 10A,A03,083737,Patchell; Gregory David,25,0,30,5
1650456183524,MATH 10B,A01,083207,Staff,0,7,30,30
1650456183524,MATH 10B,A02,083208,Staff,0,7,30,30
1650456183524,MATH 10B,B01,083739,Staff,13,0,30,17
1650456183524,MATH 10B,B02,083740,Staff,28,0,30,2
1650456189552,MATH 18,A01,083743,Staff,1,0,30,29
1650456189552,MATH 18,A02,083744,Staff,27,0,30,3
1650456189552,MATH 18,A03,083745,Staff,22,0,30,8
1650456189552,MATH 18,A04,083746,Staff,26,0,30,4
1650456189552,MATH 18,B01,083748,Staff,0,11,30,30
1650456189552,MATH 18,B02,083749,Staff,0,12,30,30
1650456189552,MATH 18,B03,083750,Staff,0,11,30,30
1650456189552,MATH 18,B04,083751,Staff,0,12,30,30
1650456195576,MATH 20A,A01,083754,Staff,25,0,40,15
1650456201603,MATH 20B,A01,083756,Staff,0,10,30,30
1650456201603,MATH 20B,A02,083757,Staff,0,10,30,30
1650456207629,MATH 20C,A01,083760,Staff,0,15,30,30
1650456207629,MATH 20C,A02,083761,Staff,1,14,30,29
1650456207629,MATH 20C,B01,083762,Staff,13,0,30,17
1650456207629,MATH 20C,B02,083763,Staff,28,0,30,2
1650456213656,MATH 20D,A01,083765,Staff,0,1,30,30
1650456213656,MATH 20D,A02,083766,Staff,9,0,30,21
1650456213656,MATH 20D,A03,083767,Staff,25,0,30,5
1650456219684,MATH 20E,A01,083771,Staff,6,0,30,24
1650456219684,MATH 20E,A02,083772,Staff,18,0,30,12
1650456219684,MATH 20E,B01,083773,Staff,0,0,30,30
1650456219684,MATH 20E,B02,083774,Staff,10,0,30,20
1650456225712,MATH 103A,A01,083777,Staff,0,12,30,30
1650456225712,MATH 103A,A02,083778,Staff,0,12,30,30
1650456225712,MATH 103A,B01,083779,Staff,0,13,30,30
1650456225712,MATH 103A,B02,083780,Staff,0,12,30,30
1650456231738,MATH 105,A01,085443,Staff,0,23,30,30
1650456237772,MATH 109,A01,083213,Anzaldo; Leesa B,0,7,30,30
1650456237772,MATH 109,A02,083214,Anzaldo; Leesa B,0,7,30,30
1650456237772,MATH 109,B01,083215,Anzaldo; Leesa B,0,5,30,30
1650456237772,MATH 109,B02,083216,Anzaldo; Leesa B,0,6,30,30
1650456243800,MATH 142A,A01,083219,Chow; Bennett,0,14,30,30
1650456243800,MATH 142A,A02,083220,Chow; Bennett,0,13,30,30
1650456243800,MATH 142A,B01,083221,Chow; Bennett,0,12,30,30
1650456243800,MATH 142A,B02,083222,Chow; Bennett,0,13,30,30
1650456249828,MATH 193A,A01,083224,Staff,0,5,30,30
1650456249828,MATH 193A,A02,083225,Staff,0,5,30,30
1650456249828,MATH 193A,A03,083781,Staff,0,4,30,30
1650456249828,MATH 193A,A04,083782,Staff,0,5,30,30
1650456255858,MATH 197,001,091859,McAuley; Julian John,9998,0,9999,1
1650456261939,COGS 9,A01,083615,Staff,0,14,60,60
1650456267967,COGS 11,A01,083617,Boyle; Mary E. T.,21,0,40,19
1650456273998,COGS 13,A01,083071,Staff,0,34,40,40
1650456280025,COGS 14A,A01,092681,Staff,1,25,100,99
1650456286051,COGS 14B,A01,083073,Cheng; Tzu-Han,0,11,50,50
1650456292077,COGS 17,A01,092677,Staff,22,0,75,53
1650456298104,COGS 100,A01,083619,Staff,0,26,60,60
1650456304140,COGS 101A,A01,083621,Davis; Joshua Daniel,0,21,60,60
1650456310173,COGS 101B,A01,091572,Staff,0,4,60,60
1650456316206,COGS 101C,A01,083625,Delgado; Tania,16,0,30,14
1650456322237,COGS 107A,A01,083627,Boyle; Mary E. T.,0,11,60,60
1650456328264,COGS 118A,A01,083075,Staff,2,0,60,58
1650456334299,CSE 3,A50,083646,Miranda; Gregory Joseph,20,0,38,18
1650456334299,CSE 3,A51,083647,Miranda; Gregory Joseph,36,0,37,1
1650456340327,CSE 8A,A50,083650,Miranda; Gregory Joseph,0,28,40,40
1650456346361,CSE 11,A01,083080,Cao; Yingjun,0,92,40,40
1650456352385,CSE 12,A01,083652,Staff,0,16,100,100
1650456358435,CSE 15L,A01,083654,Staff,0,1,50,50
1650456358435,CSE 15L,A02,083655,Staff,1,0,50,49
1650456364462,CSE 20,A01,083657,Staff,51,0,80,29
1650456370495,CSE 30,A01,083084,Eldon; John,0,76,40,40
1650456376533,CSE 100,A01,083659,Cao; Yingjun,0,66,50,50
1650456382564,CSE 134B,A01,083661,Powell; Thomas Allan,0,32,65,65
1650456388593,CSE 140,A01,083663,Staff,0,2,75,75
1650456394627,CSE 140L,A01,083088,Eldon; John,0,8,75,75
1650456400655,CSE 175,A01,083665,Kumar; Rakesh,7,0,25,18
1650456406682,CSE 190,A00,092507,Dubnov; Shlomo,14,0,20,6
1650456412712,ECE 45,A01,083139,Staff,0,18,40,40
1650456418743,ECE 65,A50,083695,Staff,0,6,30,30
1650456424768,ECE 109,A01,091882,Touri; Behrouz,38,0,70,32
1650456430817,ECE 180,A00,083140,Abi Samra; Nicholas Camill,23,0,30,7
1650456430817,ECE 180,B00,083141,Abi Samra; Nicholas Camill,0,0,30,30
1650456436844,MATH 10A,A01,083735,Patchell; Gregory David,7,0,30,23
1650456436844,MATH 10A,A02,083736,Patchell; Gregory David,28,0,30,2
1650456436844,MATH 10A,A03,083737,Patchell; Gregory David,25,0,30,5
1650456442881,MATH 10B,A01,083207,Staff,0,7,30,30
1650456442881,MATH 10B,A02,083208,Staff,0,7,30,30
1650456442881,MATH 10B,B01,083739,Staff,13,0,30,17
1650456442881,MATH 10B,B02,083740,Staff,28,0,30,2
1650456448921,MATH 18,A01,083743,Staff,1,0,30,29
1650456448921,MATH 18,A02,083744,Staff,27,0,30,3
1650456448921,MATH 18,A03,083745,Staff,22,0,30,8
1650456448921,MATH 18,A04,083746,Staff,26,0,30,4
1650456448921,MATH 18,B01,083748,Staff,0,11,30,30
1650456448921,MATH 18,B02,083749,Staff,0,12,30,30
1650456448921,MATH 18,B03,083750,Staff,0,11,30,30
1650456448921,MATH 18,B04,083751,Staff,0,12,30,30
1650456454947,MATH 20A,A01,083754,Staff,25,0,40,15
1650456460978,MATH 20B,A01,083756,Staff,0,10,30,30
1650456460978,MATH 20B,A02,083757,Staff,0,10,30,30
1650456467014,MATH 20C,A01,083760,Staff,0,15,30,30
1650456467014,MATH 20C,A02,083761,Staff,1,14,30,29
1650456467014,MATH 20C,B01,083762,Staff,13,0,30,17
1650456467014,MATH 20C,B02,083763,Staff,28,0,30,2
1650456473042,MATH 20D,A01,083765,Staff,0,1,30,30
1650456473042,MATH 20D,A02,083766,Staff,9,0,30,21
1650456473042,MATH 20D,A03,083767,Staff,25,0,30,5
1650456479074,MATH 20E,A01,083771,Staff,6,0,30,24
1650456479074,MATH 20E,A02,083772,Staff,18,0,30,12
1650456479074,MATH 20E,B01,083773,Staff,0,0,30,30
1650456479074,MATH 20E,B02,083774,Staff,10,0,30,20
1650456485107,MATH 103A,A01,083777,Staff,0,12,30,30
1650456485107,MATH 103A,A02,083778,Staff,0,12,30,30
1650456485107,MATH 103A,B01,083779,Staff,0,13,30,30
1650456485107,MATH 103A,B02,083780,Staff,0,12,30,30
1650456491135,MATH 105,A01,085443,Staff,0,23,30,30
1650456497173,MATH 109,A01,083213,Anzaldo; Leesa B,0,7,30,30
1650456497173,MATH 109,A02,083214,Anzaldo; Leesa B,0,7,30,30
1650456497173,MATH 109,B01,083215,Anzaldo; Leesa B,0,5,30,30
1650456497173,MATH 109,B02,083216,Anzaldo; Leesa B,0,6,30,30
1650456503197,MATH 142A,A01,083219,Chow; Bennett,0,14,30,30
1650456503197,MATH 142A,A02,083220,Chow; Bennett,0,13,30,30
1650456503197,MATH 142A,B01,083221,Chow; Bennett,0,12,30,30
1650456503197,MATH 142A,B02,083222,Chow; Bennett,0,13,30,30
1650456509233,MATH 193A,A01,083224,Staff,0,5,30,30
1650456509233,MATH 193A,A02,083225,Staff,0,5,30,30
1650456509233,MATH 193A,A03,083781,Staff,0,4,30,30
1650456509233,MATH 193A,A04,083782,Staff,0,5,30,30
1650456515267,MATH 197,001,091859,McAuley; Julian John,9998,0,9999,1
1650456521367,COGS 9,A01,083615,Staff,0,14,60,60
1650456527396,COGS 11,A01,083617,Boyle; Mary E. T.,21,0,40,19
1650456533423,COGS 13,A01,083071,Staff,0,34,40,40
1650456539449,COGS 14A,A01,092681,Staff,1,25,100,99
1650456545477,COGS 14B,A01,083073,Cheng; Tzu-Han,0,11,50,50
1650456551503,COGS 17,A01,092677,Staff,22,0,75,53
1650456557530,COGS 100,A01,083619,Staff,0,26,60,60
1650456563557,COGS 101A,A01,083621,Davis; Joshua Daniel,0,21,60,60
1650456569589,COGS 101B,A01,091572,Staff,0,4,60,60
1650456575615,COGS 101C,A01,083625,Delgado; Tania,16,0,30,14
1650456581654,COGS 107A,A01,083627,Boyle; Mary E. T.,0,11,60,60
1650456587679,COGS 118A,A01,083075,Staff,2,0,60,58
1650456593713,CSE 3,A50,083646,Miranda; Gregory Joseph,20,0,38,18
1650456593713,CSE 3,A51,083647,Miranda; Gregory Joseph,36,0,37,1
1650456599746,CSE 8A,A50,083650,Miranda; Gregory Joseph,0,28,40,40
1650456605770,CSE 11,A01,083080,Cao; Yingjun,0,92,40,40
1650456611803,CSE 12,A01,083652,Staff,0,16,100,100
1650456617832,CSE 15L,A01,083654,Staff,0,1,50,50
1650456617832,CSE 15L,A02,083655,Staff,1,0,50,49
1650456623929,CSE 20,A01,083657,Staff,51,0,80,29
1650456629961,CSE 30,A01,083084,Eldon; John,0,76,40,40
1650456635988,CSE 100,A01,083659,Cao; Yingjun,0,66,50,50
1650456642018,CSE 134B,A01,083661,Powell; Thomas Allan,0,32,65,65
1650456648045,CSE 140,A01,083663,Staff,0,2,75,75
1650456654081,CSE 140L,A01,083088,Eldon; John,0,8,75,75
1650456660106,CSE 175,A01,083665,Kumar; Rakesh,7,0,25,18
1650456666137,CSE 190,A00,092507,Dubnov; Shlomo,14,0,20,6
1650456672164,ECE 45,A01,083139,Staff,0,18,40,40
1650456678196,ECE 65,A50,083695,Staff,0,6,30,30
1650456684223,ECE 109,A01,091882,Touri; Behrouz,38,0,70,32
1650456690248,ECE 180,A00,083140,Abi Samra; Nicholas Camill,23,0,30,7
1650456690248,ECE 180,B00,083141,Abi Samra; Nicholas Camill,0,0,30,30
1650456696275,MATH 10A,A01,083735,Patchell; Gregory David,7,0,30,23
1650456696275,MATH 10A,A02,083736,Patchell; Gregory David,28,0,30,2
1650456696275,MATH 10A,A03,083737,Patchell; Gregory David,25,0,30,5
1650456702304,MATH 10B,A01,083207,Staff,0,7,30,30
1650456702304,MATH 10B,A02,083208,Staff,0,7,30,30
1650456702304,MATH 10B,B01,083739,Staff,13,0,30,17
1650456702304,MATH 10B,B02,083740,Staff,28,0,30,2
1650456708339,MATH 18,A01,083743,Staff,1,0,30,29
1650456708339,MATH 18,A02,083744,Staff,27,0,30,3
1650456708339,MATH 18,A03,083745,Staff,22,0,30,8
1650456708339,MATH 18,A04,083746,Staff,26,0,30,4
1650456708339,MATH 18,B01,083748,Staff,0,11,30,30
1650456708339,MATH 18,B02,083749,Staff,0,12,30,30
1650456708339,MATH 18,B03,083750,Staff,0,11,30,30
1650456708339,MATH 18,B04,083751,Staff,0,12,30,30
1650456714364,MATH 20A,A01,083754,Staff,25,0,40,15
1650456720390,MATH 20B,A01,083756,Staff,0,10,30,30
1650456720390,MATH 20B,A02,083757,Staff,0,10,30,30
1650456726413,MATH 20C,A01,083760,Staff,0,15,30,30
1650456726413,MATH 20C,A02,083761,Staff,1,14,30,29
1650456726413,MATH 20C,B01,083762,Staff,13,0,30,17
1650456726413,MATH 20C,B02,083763,Staff,28,0,30,2
1650456732436,MATH 20D,A01,083765,Staff,0,1,30,30
1650456732436,MATH 20D,A02,083766,Staff,9,0,30,21
1650456732436,MATH 20D,A03,083767,Staff,25,0,30,5
1650456738463,MATH 20E,A01,083771,Staff,6,0,30,24
1650456738463,MATH 20E,A02,083772,Staff,18,0,30,12
1650456738463,MATH 20E,B01,083773,Staff,0,0,30,30
1650456738463,MATH 20E,B02,083774,Staff,10,0,30,20
1650456744504,MATH 103A,A01,083777,Staff,0,12,30,30
1650456744504,MATH 103A,A02,083778,Staff,0,12,30,30
1650456744504,MATH 103A,B01,083779,Staff,0,13,30,30
1650456744504,MATH 103A,B02,083780,Staff,0,12,30,30
1650456750535,MATH 105,A01,085443,Staff,0,23,30,30
1650456756566,MATH 109,A01,083213,Anzaldo; Leesa B,0,7,30,30
1650456756566,MATH 109,A02,083214,Anzaldo; Leesa B,0,7,30,30
1650456756566,MATH 109,B01,083215,Anzaldo; Leesa B,0,5,30,30
1650456756566,MATH 109,B02,083216,Anzaldo; Leesa B,0,6,30,30
1650456762590,MATH 142A,A01,083219,Chow; Bennett,0,14,30,30
1650456762590,MATH 142A,A02,083220,Chow; Bennett,0,13,30,30
1650456762590,MATH 142A,B01,083221,Chow; Bennett,0,12,30,30
1650456762590,MATH 142A,B02,083222,Chow; Bennett,0,13,30,30
1650456768615,MATH 193A,A01,083224,Staff,0,5,30,30
1650456768615,MATH 193A,A02,083225,Staff,0,5,30,30
1650456768615,MATH 193A,A03,083781,Staff,0,4,30,30
1650456768615,MATH 193A,A04,083782,Staff,0,5,30,30
1650456774641,MATH 197,001,091859,McAuley; Julian John,9998,0,9999,1
1650456780699,COGS 9,A01,083615,Staff,0,14,60,60
1650456786724,COGS 11,A01,083617,Boyle; Mary E. T.,21,0,40,19
1650456792754,COGS 13,A01,083071,Staff,0,34,40,40
1650456798783,COGS 14A,A01,092681,Staff,1,25,100,99
1650456804809,COGS 14B,A01,083073,Cheng; Tzu-Han,0,11,50,50
1650456810839,COGS 17,A01,092677,Staff,22,0,75,53
1650456816866,COGS 100,A01,083619,Staff,0,26,60,60
1650456822892,COGS 101A,A01,083621,Davis; Joshua Daniel,0,21,60,60
1650456828922,COGS 101B,A01,091572,Staff,0,4,60,60
1650456834952,COGS 101C,A01,083625,Delgado; Tania,16,0,30,14
1650456840985,COGS 107A,A01,083627,Boyle; Mary E. T.,0,11,60,60
1650456847014,COGS 118A,A01,083075,Staff,2,0,60,58
1650456853046,CSE 3,A50,083646,Miranda; Gregory Joseph,20,0,38,18
1650456853046,CSE 3,A51,083647,Miranda; Gregory Joseph,36,0,37,1
1650456859076,CSE 8A,A50,083650,Miranda; Gregory Joseph,0,28,40,40
1650456865114,CSE 11,A01,083080,Cao; Yingjun,0,92,40,40
1650456871139,CSE 12,A01,083652,Staff,0,16,100,100
1650456877162,CSE 15L,A01,083654,Staff,0,1,50,50
1650456877162,CSE 15L,A02,083655,Staff,1,0,50,49
1650456883190,CSE 20,A01,083657,Staff,51,0,80,29
1650456889216,CSE 30,A01,083084,Eldon; John,0,76,40,40
1650456895247,CSE 100,A01,083659,Cao; Yingjun,0,66,50,50
1650456901273,CSE 134B,A01,083661,Powell; Thomas Allan,0,32,65,65
1650456907312,CSE 140,A01,083663,Staff,0,2,75,75
1650456913340,CSE 140L,A01,083088,Eldon; John,0,8,75,75
1650456919364,CSE 175,A01,083665,Kumar; Rakesh,7,0,25,18
1650456925389,CSE 190,A00,092507,Dubnov; Shlomo,14,0,20,6
1650456931421,ECE 45,A01,083139,Staff,0,18,40,40
1650456937458,ECE 65,A50,083695,Staff,0,6,30,30
1650456943484,ECE 109,A01,091882,Touri; Behrouz,38,0,70,32
1650456949509,ECE 180,A00,083140,Abi Samra; Nicholas Camill,23,0,30,7
1650456949509,ECE 180,B00,083141,Abi Samra; Nicholas Camill,0,0,30,30
1650456955537,MATH 10A,A01,083735,Patchell; Gregory David,7,0,30,23
1650456955537,MATH 10A,A02,083736,Patchell; Gregory David,28,0,30,2
1650456955537,MATH 10A,A03,083737,Patchell; Gregory David,25,0,30,5
1650456961567,MATH 10B,A01,083207,Staff,0,7,30,30
1650456961567,MATH 10B,A02,083208,Staff,0,7,30,30
1650456961567,MATH 10B,B01,083739,Staff,13,0,30,17
1650456961567,MATH 10B,B02,083740,Staff,28,0,30,2
1650456967595,MATH 18,A01,083743,Staff,1,0,30,29
1650456967595,MATH 18,A02,083744,Staff,27,0,30,3
1650456967595,MATH 18,A03,083745,Staff,22,0,30,8
1650456967595,MATH 18,A04,083746,Staff,26,0,30,4
1650456967595,MATH 18,B01,083748,Staff,0,11,30,30
1650456967595,MATH 18,B02,083749,Staff,0,12,30,30
1650456967595,MATH 18,B03,083750,Staff,0,11,30,30
1650456967595,MATH 18,B04,083751,Staff,0,12,30,30
1650456973621,MATH 20A,A01,083754,Staff,25,0,40,15
1650456979648,MATH 20B,A01,083756,Staff,0,10,30,30
1650456979648,MATH 20B,A02,083757,Staff,0,10,30,30
1650456985674,MATH 20C,A01,083760,Staff,0,15,30,30
1650456985674,MATH 20C,A02,083761,Staff,1,14,30,29
1650456985674,MATH 20C,B01,083762,Staff,13,0,30,17
1650456985674,MATH 20C,B02,083763,Staff,28,0,30,2
1650456991699,MATH 20D,A01,083765,Staff,0,1,30,30
1650456991699,MATH 20D,A02,083766,Staff,9,0,30,21
1650456991699,MATH 20D,A03,083767,Staff,25,0,30,5
1650456997731,MATH 20E,A01,083771,Staff,6,0,30,24
1650456997731,MATH 20E,A02,083772,Staff,18,0,30,12
1650456997731,MATH 20E,B01,083773,Staff,0,0,30,30
1650456997731,MATH 20E,B02,083774,Staff,10,0,30,20
1650457003758,MATH 103A,A01,083777,Staff,0,12,30,30
1650457003758,MATH 103A,A02,083778,Staff,0,12,30,30
1650457003758,MATH 103A,B01,083779,Staff,0,13,30,30
1650457003758,MATH 103A,B02,083780,Staff,0,12,30,30
1650457009790,MATH 105,A01,085443,Staff,0,23,30,30
1650457015820,MATH 109,A01,083213,Anzaldo; Leesa B,0,7,30,30
1650457015820,MATH 109,A02,083214,Anzaldo; Leesa B,0,7,30,30
1650457015820,MATH 109,B01,083215,Anzaldo; Leesa B,0,5,30,30
1650457015820,MATH 109,B02,083216,Anzaldo; Leesa B,0,6,30,30
1650457021847,MATH 142A,A01,083219,Chow; Bennett,0,14,30,30
1650457021847,MATH 142A,A02,083220,Chow; Bennett,0,13,30,30
1650457021847,MATH 142A,B01,083221,Chow; Bennett,0,12,30,30
1650457021847,MATH 142A,B02,083222,Chow; Bennett,0,13,30,30
1650457027877,MATH 193A,A01,083224,Staff,0,5,30,30
1650457027877,MATH 193A,A02,083225,Staff,0,5,30,30
1650457027877,MATH 193A,A03,083781,Staff,0,4,30,30
1650457027877,MATH 193A,A04,083782,Staff,0,5,30,30
1650457033907,MATH 197,001,091859,McAuley; Julian John,9998,0,9999,1
1650457039970,COGS 9,A01,083615,Staff,0,14,60,60
1650457045995,COGS 11,A01,083617,Boyle; Mary E. T.,21,0,40,19
1650457052020,COGS 13,A01,083071,Staff,0,34,40,40
1650457058048,COGS 14A,A01,092681,Staff,1,25,100,99
1650457064078,COGS 14B,A01,083073,Cheng; Tzu-Han,0,11,50,50
1650457070102,COGS 17,A01,092677,Staff,22,0,75,53
1650457076130,COGS 100,A01,083619,Staff,0,26,60,60
1650457082158,COGS 101A,A01,083621,Davis; Joshua Daniel,0,21,60,60
1650457088184,COGS 101B,A01,091572,Staff,0,4,60,60
1650457094213,COGS 101C,A01,083625,Delgado; Tania,16,0,30,14
1650457100238,COGS 107A,A01,083627,Boyle; Mary E. T.,0,11,60,60
1650457106263,COGS 118A,A01,083075,Staff,2,0,60,58
1650457112289,CSE 3,A50,083646,Miranda; Gregory Joseph,20,0,38,18
1650457112289,CSE 3,A51,083647,Miranda; Gregory Joseph,36,0,37,1
1650457118323,CSE 8A,A50,083650,Miranda; Gregory Joseph,0,28,40,40
1650457124351,CSE 11,A01,083080,Cao; Yingjun,0,92,40,40
1650457130377,CSE 12,A01,083652,Staff,0,16,100,100
1650457136405,CSE 15L,A01,083654,Staff,0,1,50,50
1650457136405,CSE 15L,A02,083655,Staff,1,0,50,49
1650457142430,CSE 20,A01,083657,Staff,51,0,80,29
1650457148459,CSE 30,A01,083084,Eldon; John,0,76,40,40
1650457154485,CSE 100,A01,083659,Cao; Yingjun,0,66,50,50
1650457160518,CSE 134B,A01,083661,Powell; Thomas Allan,0,32,65,65
1650457166540,CSE 140,A01,083663,Staff,0,2,75,75
1650457172565,CSE 140L,A01,083088,Eldon; John,0,8,75,75
1650457178594,CSE 175,A01,083665,Kumar; Rakesh,7,0,25,18
1650457184622,CSE 190,A00,092507,Dubnov; Shlomo,14,0,20,6
1650457190647,ECE 45,A01,083139,Staff,0,18,40,40
1650457196680,ECE 65,A50,083695,Staff,0,6,30,30
1650457202708,ECE 109,A01,091882,Touri; Behrouz,38,0,70,32
1650457208735,ECE 180,A00,083140,Abi Samra; Nicholas Camill,23,0,30,7
1650457208735,ECE 180,B00,083141,Abi Samra; Nicholas Camill,0,0,30,30
1650457214763,MATH 10A,A01,083735,Patchell; Gregory David,7,0,30,23
1650457214763,MATH 10A,A02,083736,Patchell; Gregory David,28,0,30,2
1650457214763,MATH 10A,A03,083737,Patchell; Gregory David,25,0,30,5
1650457220862,MATH 10B,A01,083207,Staff,0,7,30,30
1650457220862,MATH 10B,A02,083208,Staff,0,7,30,30
1650457220862,MATH 10B,B01,083739,Staff,13,0,30,17
1650457220862,MATH 10B,B02,083740,Staff,28,0,30,2
1650457226890,MATH 18,A01,083743,Staff,1,0,30,29
1650457226890,MATH 18,A02,083744,Staff,27,0,30,3
1650457226890,MATH 18,A03,083745,Staff,22,0,30,8
1650457226890,MATH 18,A04,083746,Staff,26,0,30,4
1650457226890,MATH 18,B01,083748,Staff,0,11,30,30
1650457226890,MATH 18,B02,083749,Staff,0,12,30,30
1650457226890,MATH 18,B03,083750,Staff,0,11,30,30
1650457226890,MATH 18,B04,083751,Staff,0,12,30,30
1650457232916,MATH 20A,A01,083754,Staff,25,0,40,15
1650457238941,MATH 20B,A01,083756,Staff,0,10,30,30
1650457238941,MATH 20B,A02,083757,Staff,0,10,30,30
1650457244973,MATH 20C,A01,083760,Staff,0,15,30,30
1650457244973,MATH 20C,A02,083761,Staff,1,14,30,29
1650457244973,MATH 20C,B01,083762,Staff,13,0,30,17
1650457244973,MATH 20C,B02,083763,Staff,28,0,30,2
1650457250998,MATH 20D,A01,083765,Staff,0,1,30,30
1650457250998,MATH 20D,A02,083766,Staff,9,0,30,21
1650457250998,MATH 20D,A03,083767,Staff,25,0,30,5
1650457257029,MATH 20E,A01,083771,Staff,6,0,30,24
1650457257029,MATH 20E,A02,083772,Staff,18,0,30,12
1650457257029,MATH 20E,B01,083773,Staff,0,0,30,30
1650457257029,MATH 20E,B02,083774,Staff,10,0,30,20
1650457263055,MATH 103A,A01,083777,Staff,0,12,30,30
1650457263055,MATH 103A,A02,083778,Staff,0,12,30,30
1650457263055,MATH 103A,B01,083779,Staff,0,13,30,30
1650457263055,MATH 103A,B02,083780,Staff,0,12,30,30
1650457269080,MATH 105,A01,085443,Staff,0,23,30,30
1650457275116,MATH 109,A01,083213,Anzaldo; Leesa B,0,7,30,30
1650457275116,MATH 109,A02,083214,Anzaldo; Leesa B,0,7,30,30
1650457275116,MATH 109,B01,083215,Anzaldo; Leesa B,0,5,30,30
1650457275116,MATH 109,B02,083216,Anzaldo; Leesa B,0,6,30,30
1650457281143,MATH 142A,A01,083219,Chow; Bennett,0,14,30,30
1650457281143,MATH 142A,A02,083220,Chow; Bennett,0,13,30,30
1650457281143,MATH 142A,B01,083221,Chow; Bennett,0,12,30,30
1650457281143,MATH 142A,B02,083222,Chow; Bennett,0,13,30,30
1650457287174,MATH 193A,A01,083224,Staff,0,5,30,30
1650457287174,MATH 193A,A02,083225,Staff,0,5,30,30
1650457287174,MATH 193A,A03,083781,Staff,0,4,30,30
1650457287174,MATH 193A,A04,083782,Staff,0,5,30,30
1650457293203,MATH 197,001,091859,McAuley; Julian John,9998,0,9999,1
1650457299271,COGS 9,A01,083615,Staff,0,14,60,60
1650457305298,COGS 11,A01,083617,Boyle; Mary E. T.,21,0,40,19
1650457311334,COGS 13,A01,083071,Staff,0,34,40,40
1650457317362,COGS 14A,A01,092681,Staff,1,25,100,99
1650457323389,COGS 14B,A01,083073,Cheng; Tzu-Han,0,11,50,50
1650457329426,COGS 17,A01,092677,Staff,22,0,75,53
1650457335451,COGS 100,A01,083619,Staff,0,26,60,60
1650457341478,COGS 101A,A01,083621,Davis; Joshua Daniel,0,21,60,60
1650457347508,COGS 101B,A01,091572,Staff,0,4,60,60
1650457353534,COGS 101C,A01,083625,Delgado; Tania,16,0,30,14
1650457359565,COGS 107A,A01,083627,Boyle; Mary E. T.,0,11,60,60
1650457365596,COGS 118A,A01,083075,Staff,2,0,60,58
1650457371630,CSE 3,A50,083646,Miranda; Gregory Joseph,20,0,38,18
1650457371630,CSE 3,A51,083647,Miranda; Gregory Joseph,36,0,37,1
1650457377654,CSE 8A,A50,083650,Miranda; Gregory Joseph,0,28,40,40
1650457383679,CSE 11,A01,083080,Cao; Yingjun,0,92,40,40
1650457389703,CSE 12,A01,083652,Staff,0,16,100,100
1650457395740,CSE 15L,A01,083654,Staff,0,1,50,50
1650457395740,CSE 15L,A02,083655,Staff,1,0,50,49
1650457401767,CSE 20,A01,083657,Staff,51,0,80,29
1650457407797,CSE 30,A01,083084,Eldon; John,0,76,40,40
1650457413824,CSE 100,A01,083659,Cao; Yingjun,0,66,50,50
1650457419856,CSE 134B,A01,083661,Powell; Thomas Allan,0,32,65,65
1650457425884,CSE 140,A01,083663,Staff,0,2,75,75
1650457431909,CSE 140L,A01,083088,Eldon; John,0,8,75,75
1650457437934,CSE 175,A01,083665,Kumar; Rakesh,7,0,25,18
1650457443963,CSE 190,A00,092507,Dubnov; Shlomo,14,0,20,6
1650457449990,ECE 45,A01,083139,Staff,0,18,40,40
1650457456021,ECE 65,A50,083695,Staff,0,6,30,30
1650457462047,ECE 109,A01,091882,Touri; Behrouz,38,0,70,32
1650457468074,ECE 180,A00,083140,Abi Samra; Nicholas Camill,23,0,30,7
1650457468074,ECE 180,B00,083141,Abi Samra; Nicholas Camill,0,0,30,30
1650457474100,MATH 10A,A01,083735,Patchell; Gregory David,7,0,30,23
1650457474100,MATH 10A,A02,083736,Patchell; Gregory David,28,0,30,2
1650457474100,MATH 10A,A03,083737,Patchell; Gregory David,25,0,30,5
1650457480132,MATH 10B,A01,083207,Staff,0,7,30,30
1650457480132,MATH 10B,A02,083208,Staff,0,7,30,30
1650457480132,MATH 10B,B01,083739,Staff,13,0,30,17
1650457480132,MATH 10B,B02,083740,Staff,28,0,30,2
1650457486160,MATH 18,A01,083743,Staff,1,0,30,29
1650457486160,MATH 18,A02,083744,Staff,27,0,30,3
1650457486160,MATH 18,A03,083745,Staff,22,0,30,8
1650457486160,MATH 18,A04,083746,Staff,26,0,30,4
1650457486160,MATH 18,B01,083748,Staff,0,11,30,30
1650457486160,MATH 18,B02,083749,Staff,0,12,30,30
1650457486160,MATH 18,B03,083750,Staff,0,11,30,30
1650457486160,MATH 18,B04,083751,Staff,0,12,30,30
1650457492194,MATH 20A,A01,083754,Staff,25,0,40,15
1650457498222,MATH 20B,A01,083756,Staff,0,10,30,30
1650457498222,MATH 20B,A02,083757,Staff,0,10,30,30
1650457504250,MATH 20C,A01,083760,Staff,0,15,30,30
1650457504250,MATH 20C,A02,083761,Staff,1,14,30,29
1650457504250,MATH 20C,B01,083762,Staff,13,0,30,17
1650457504250,MATH 20C,B02,083763,Staff,28,0,30,2
1650457510272,MATH 20D,A01,083765,Staff,0,1,30,30
1650457510272,MATH 20D,A02,083766,Staff,9,0,30,21
1650457510272,MATH 20D,A03,083767,Staff,25,0,30,5
1650457516308,MATH 20E,A01,083771,Staff,6,0,30,24
1650457516308,MATH 20E,A02,083772,Staff,18,0,30,12
1650457516308,MATH 20E,B01,083773,Staff,0,0,30,30
1650457516308,MATH 20E,B02,083774,Staff,10,0,30,20
1650457522333,MATH 103A,A01,083777,Staff,0,12,30,30
1650457522333,MATH 103A,A02,083778,Staff,0,12,30,30
1650457522333,MATH 103A,B01,083779,Staff,0,13,30,30
1650457522333,MATH 103A,B02,083780,Staff,0,12,30,30
1650457528357,MATH 105,A01,085443,Staff,0,23,30,30
1650457534386,MATH 109,A01,083213,Anzaldo; Leesa B,0,7,30,30
1650457534386,MATH 109,A02,083214,Anzaldo; Leesa B,0,7,30,30
1650457534386,MATH 109,B01,083215,Anzaldo; Leesa B,0,5,30,30
1650457534386,MATH 109,B02,083216,Anzaldo; Leesa B,0,6,30,30
1650457540412,MATH 142A,A01,083219,Chow; Bennett,0,14,30,30
1650457540412,MATH 142A,A02,083220,Chow; Bennett,0,13,30,30
1650457540412,MATH 142A,B01,083221,Chow; Bennett,0,12,30,30
1650457540412,MATH 142A,B02,083222,Chow; Bennett,0,13,30,30
1650457546438,MATH 193A,A01,083224,Staff,0,5,30,30
1650457546438,MATH 193A,A02,083225,Staff,0,5,30,30
1650457546438,MATH 193A,A03,083781,Staff,0,4,30,30
1650457546438,MATH 193A,A04,083782,Staff,0,5,30,30
1650457552463,MATH 197,001,091859,McAuley; Julian John,9998,0,9999,1
1650457558536,COGS 9,A01,083615,Staff,0,14,60,60
1650457564567,COGS 11,A01,083617,Boyle; Mary E. T.,21,0,40,19
1650457570596,COGS 13,A01,083071,Staff,0,34,40,40
1650457576626,COGS 14A,A01,092681,Staff,1,25,100,99
1650457582652,COGS 14B,A01,083073,Cheng; Tzu-Han,0,11,50,50
1650457588677,COGS 17,A01,092677,Staff,22,0,75,53
1650457594705,COGS 100,A01,083619,Staff,0,26,60,60
1650457600733,COGS 101A,A01,083621,Davis; Joshua Daniel,0,21,60,60
1650457606757,COGS 101B,A01,091572,Staff,0,4,60,60
1650457612782,COGS 101C,A01,083625,Delgado; Tania,16,0,30,14
1650457618816,COGS 107A,A01,083627,Boyle; Mary E. T.,0,11,60,60
1650457624844,COGS 118A,A01,083075,Staff,2,0,60,58
1650457630878,CSE 3,A50,083646,Miranda; Gregory Joseph,20,0,38,18
1650457630878,CSE 3,A51,083647,Miranda; Gregory Joseph,36,0,37,1
1650457636903,CSE 8A,A50,083650,Miranda; Gregory Joseph,0,28,40,40
1650457642933,CSE 11,A01,083080,Cao; Yingjun,0,92,40,40
1650457648958,CSE 12,A01,083652,Staff,0,16,100,100
1650457654983,CSE 15L,A01,083654,Staff,0,1,50,50
1650457654983,CSE 15L,A02,083655,Staff,1,0,50,49
1650457661017,CSE 20,A01,083657,Staff,51,0,80,29
1650457667049,CSE 30,A01,083084,Eldon; John,0,76,40,40
1650457673074,CSE 100,A01,083659,Cao; Yingjun,0,66,50,50
1650457679097,CSE 134B,A01,083661,Powell; Thomas Allan,0,32,65,65
1650457685126,CSE 140,A01,083663,Staff,0,2,75,75
1650457691149,CSE 140L,A01,083088,Eldon; John,0,8,75,75
1650457697174,CSE 175,A01,083665,Kumar; Rakesh,7,0,25,18
1650457703218,CSE 190,A00,092507,Dubnov; Shlomo,14,0,20,6
1650457709244,ECE 45,A01,083139,Staff,0,18,40,40
1650457715275,ECE 65,A50,083695,Staff,0,6,30,30
1650457721304,ECE 109,A01,091882,Touri; Behrouz,38,0,70,32
1650457727334,ECE 180,A00,083140,Abi Samra; Nicholas Camill,23,0,30,7
1650457727334,ECE 180,B00,083141,Abi Samra; Nicholas Camill,0,0,30,30
1650457733366,MATH 10A,A01,083735,Patchell; Gregory David,7,0,30,23
1650457733366,MATH 10A,A02,083736,Patchell; Gregory David,28,0,30,2
1650457733366,MATH 10A,A03,083737,Patchell; Gregory David,25,0,30,5
1650457739397,MATH 10B,A01,083207,Staff,0,7,30,30
1650457739397,MATH 10B,A02,083208,Staff,0,7,30,30
1650457739397,MATH 10B,B01,083739,Staff,13,0,30,17
1650457739397,MATH 10B,B02,083740,Staff,28,0,30,2
1650457745426,MATH 18,A01,083743,Staff,1,0,30,29
1650457745426,MATH 18,A02,083744,Staff,27,0,30,3
1650457745426,MATH 18,A03,083745,Staff,22,0,30,8
1650457745426,MATH 18,A04,083746,Staff,26,0,30,4
1650457745426,MATH 18,B01,083748,Staff,0,11,30,30
1650457745426,MATH 18,B02,083749,Staff,0,12,30,30
1650457745426,MATH 18,B03,083750,Staff,0,11,30,30
1650457745426,MATH 18,B04,083751,Staff,0,12,30,30
1650457751454,MATH 20A,A01,083754,Staff,25,0,40,15
1650457757481,MATH 20B,A01,083756,Staff,0,10,30,30
1650457757481,MATH 20B,A02,083757,Staff,0,10,30,30
1650457763520,MATH 20C,A01,083760,Staff,0,15,30,30
1650457763520,MATH 20C,A02,083761,Staff,1,14,30,29
1650457763520,MATH 20C,B01,083762,Staff,13,0,30,17
1650457763520,MATH 20C,B02,083763,Staff,28,0,30,2
1650457769549,MATH 20D,A01,083765,Staff,0,1,30,30
1650457769549,MATH 20D,A02,083766,Staff,9,0,30,21
1650457769549,MATH 20D,A03,083767,Staff,25,0,30,5
1650457775583,MATH 20E,A01,083771,Staff,6,0,30,24
1650457775583,MATH 20E,A02,083772,Staff,18,0,30,12
1650457775583,MATH 20E,B01,083773,Staff,0,0,30,30
1650457775583,MATH 20E,B02,083774,Staff,10,0,30,20
1650457781614,MATH 103A,A01,083777,Staff,0,12,30,30
1650457781614,MATH 103A,A02,083778,Staff,0,12,30,30
1650457781614,MATH 103A,B01,083779,Staff,0,13,30,30
1650457781614,MATH 103A,B02,083780,Staff,0,12,30,30
1650457787641,MATH 105,A01,085443,Staff,0,23,30,30
1650457793666,MATH 109,A01,083213,Anzaldo; Leesa B,0,7,30,30
1650457793666,MATH 109,A02,083214,Anzaldo; Leesa B,0,7,30,30
1650457793666,MATH 109,B01,083215,Anzaldo; Leesa B,0,5,30,30
1650457793666,MATH 109,B02,083216,Anzaldo; Leesa B,0,6,30,30
1650457799708,MATH 142A,A01,083219,Chow; Bennett,0,14,30,30
1650457799708,MATH 142A,A02,083220,Chow; Bennett,0,13,30,30
1650457799708,MATH 142A,B01,083221,Chow; Bennett,0,12,30,30
1650457799708,MATH 142A,B02,083222,Chow; Bennett,0,13,30,30
1650457805732,MATH 193A,A01,083224,Staff,0,5,30,30
1650457805732,MATH 193A,A02,083225,Staff,0,5,30,30
1650457805732,MATH 193A,A03,083781,Staff,0,4,30,30
1650457805732,MATH 193A,A04,083782,Staff,0,5,30,30
1650457811760,MATH 197,001,091859,McAuley; Julian John,9998,0,9999,1
1650457817896,COGS 9,A01,083615,Staff,0,14,60,60
1650457823930,COGS 11,A01,083617,Boyle; Mary E. T.,21,0,40,19
1650457829954,COGS 13,A01,083071,Staff,0,34,40,40
1650457835993,COGS 14A,A01,092681,Staff,1,25,100,99
1650457842027,COGS 14B,A01,083073,Cheng; Tzu-Han,0,11,50,50
1650457848058,COGS 17,A01,092677,Staff,22,0,75,53
1650457854082,COGS 100,A01,083619,Staff,0,26,60,60
1650457860112,COGS 101A,A01,083621,Davis; Joshua Daniel,0,21,60,60
1650457866141,COGS 101B,A01,091572,Staff,0,4,60,60
1650457872170,COGS 101C,A01,083625,Delgado; Tania,16,0,30,14
1650457878197,COGS 107A,A01,083627,Boyle; Mary E. T.,0,11,60,60
1650457884221,COGS 118A,A01,083075,Staff,2,0,60,58
1650457890247,CSE 3,A50,083646,Miranda; Gregory Joseph,20,0,38,18
1650457890247,CSE 3,A51,083647,Miranda; Gregory Joseph,36,0,37,1
1650457896286,CSE 8A,A50,083650,Miranda; Gregory Joseph,0,28,40,40
1650457902314,CSE 11,A01,083080,Cao; Yingjun,0,92,40,40
1650457908339,CSE 12,A01,083652,Staff,0,16,100,100
1650457914364,CSE 15L,A01,083654,Staff,0,1,50,50
1650457914364,CSE 15L,A02,083655,Staff,1,0,50,49
1650457920389,CSE 20,A01,083657,Staff,51,0,80,29
1650457926419,CSE 30,A01,083084,Eldon; John,0,76,40,40
1650457932441,CSE 100,A01,083659,Cao; Yingjun,0,66,50,50
1650457938465,CSE 134B,A01,083661,Powell; Thomas Allan,0,32,65,65
1650457944491,CSE 140,A01,083663,Staff,0,2,75,75
1650457950520,CSE 140L,A01,083088,Eldon; John,0,8,75,75
1650457956546,CSE 175,A01,083665,Kumar; Rakesh,7,0,25,18
1650457962575,CSE 190,A00,092507,Dubnov; Shlomo,14,0,20,6
1650457968605,ECE 45,A01,083139,Staff,0,18,40,40
1650457974629,ECE 65,A50,083695,Staff,0,6,30,30
1650457980656,ECE 109,A01,091882,Touri; Behrouz,38,0,70,32
1650457986680,ECE 180,A00,083140,Abi Samra; Nicholas Camill,23,0,30,7
1650457986680,ECE 180,B00,083141,Abi Samra; Nicholas Camill,0,0,30,30
1650457992710,MATH 10A,A01,083735,Patchell; Gregory David,7,0,30,23
1650457992710,MATH 10A,A02,083736,Patchell; Gregory David,28,0,30,2
1650457992710,MATH 10A,A03,083737,Patchell; Gregory David,25,0,30,5
1650457998740,MATH 10B,A01,083207,Staff,0,7,30,30
1650457998740,MATH 10B,A02,083208,Staff,0,7,30,30
1650457998740,MATH 10B,B01,083739,Staff,13,0,30,17
1650457998740,MATH 10B,B02,083740,Staff,28,0,30,2
1650458004769,MATH 18,A01,083743,Staff,1,0,30,29
1650458004769,MATH 18,A02,083744,Staff,27,0,30,3
1650458004769,MATH 18,A03,083745,Staff,22,0,30,8
1650458004769,MATH 18,A04,083746,Staff,26,0,30,4
1650458004769,MATH 18,B01,083748,Staff,0,11,30,30
1650458004769,MATH 18,B02,083749,Staff,0,12,30,30
1650458004769,MATH 18,B03,083750,Staff,0,11,30,30
1650458004769,MATH 18,B04,083751,Staff,0,12,30,30
1650458010794,MATH 20A,A01,083754,Staff,25,0,40,15
1650458016822,MATH 20B,A01,083756,Staff,0,10,30,30
1650458016822,MATH 20B,A02,083757,Staff,0,10,30,30
1650458022852,MATH 20C,A01,083760,Staff,0,15,30,30
1650458022852,MATH 20C,A02,083761,Staff,1,14,30,29
1650458022852,MATH 20C,B01,083762,Staff,13,0,30,17
1650458022852,MATH 20C,B02,083763,Staff,28,0,30,2
1650458028878,MATH 20D,A01,083765,Staff,0,1,30,30
1650458028878,MATH 20D,A02,083766,Staff,9,0,30,21
1650458028878,MATH 20D,A03,083767,Staff,25,0,30,5
1650458034905,MATH 20E,A01,083771,Staff,6,0,30,24
1650458034905,MATH 20E,A02,083772,Staff,18,0,30,12
1650458034905,MATH 20E,B01,083773,Staff,0,0,30,30
1650458034905,MATH 20E,B02,083774,Staff,10,0,30,20
1650458040943,MATH 103A,A01,083777,Staff,0,12,30,30
1650458040943,MATH 103A,A02,083778,Staff,0,12,30,30
1650458040943,MATH 103A,B01,083779,Staff,0,13,30,30
1650458040943,MATH 103A,B02,083780,Staff,0,12,30,30
1650458046968,MATH 105,A01,085443,Staff,0,23,30,30
1650458052995,MATH 109,A01,083213,Anzaldo; Leesa B,0,7,30,30
1650458052995,MATH 109,A02,083214,Anzaldo; Leesa B,0,7,30,30
1650458052995,MATH 109,B01,083215,Anzaldo; Leesa B,0,5,30,30
1650458052995,MATH 109,B02,083216,Anzaldo; Leesa B,0,6,30,30
1650458059020,MATH 142A,A01,083219,Chow; Bennett,0,14,30,30
1650458059020,MATH 142A,A02,083220,Chow; Bennett,0,13,30,30
1650458059020,MATH 142A,B01,083221,Chow; Bennett,0,12,30,30
1650458059020,MATH 142A,B02,083222,Chow; Bennett,0,13,30,30
1650458065047,MATH 193A,A01,083224,Staff,0,5,30,30
1650458065047,MATH 193A,A02,083225,Staff,0,5,30,30
1650458065047,MATH 193A,A03,083781,Staff,0,4,30,30
1650458065047,MATH 193A,A04,083782,Staff,0,5,30,30
1650458071073,MATH 197,001,091859,McAuley; Julian John,9998,0,9999,1
1650458077153,COGS 9,A01,083615,Staff,0,14,60,60
1650458083185,COGS 11,A01,083617,Boyle; Mary E. T.,21,0,40,19
1650458089212,COGS 13,A01,083071,Staff,0,34,40,40
1650458098443,COGS 14A,A01,092681,Staff,1,25,100,99
1650458104469,COGS 14B,A01,083073,Cheng; Tzu-Han,0,11,50,50
1650458110500,COGS 17,A01,092677,Staff,22,0,75,53
1650458116526,COGS 100,A01,083619,Staff,0,26,60,60
1650458122555,COGS 101A,A01,083621,Davis; Joshua Daniel,0,21,60,60
1650458128579,COGS 101B,A01,091572,Staff,0,4,60,60
1650458134606,COGS 101C,A01,083625,Delgado; Tania,16,0,30,14
1650458140632,COGS 107A,A01,083627,Boyle; Mary E. T.,0,11,60,60
1650458146659,COGS 118A,A01,083075,Staff,2,0,60,58
1650458152686,CSE 3,A50,083646,Miranda; Gregory Joseph,20,0,38,18
1650458152686,CSE 3,A51,083647,Miranda; Gregory Joseph,36,0,37,1
1650458158714,CSE 8A,A50,083650,Miranda; Gregory Joseph,0,28,40,40
1650458164738,CSE 11,A01,083080,Cao; Yingjun,0,92,40,40
1650458170767,CSE 12,A01,083652,Staff,0,16,100,100
1650458176794,CSE 15L,A01,083654,Staff,0,1,50,50
1650458176794,CSE 15L,A02,083655,Staff,1,0,50,49
1650458182819,CSE 20,A01,083657,Staff,51,0,80,29
1650458188843,CSE 30,A01,083084,Eldon; John,0,76,40,40
1650458194869,CSE 100,A01,083659,Cao; Yingjun,0,66,50,50
1650458200893,CSE 134B,A01,083661,Powell; Thomas Allan,0,32,65,65
1650458206921,CSE 140,A01,083663,Staff,0,2,75,75
1650458212945,CSE 140L,A01,083088,Eldon; John,0,8,75,75
1650458218971,CSE 175,A01,083665,Kumar; Rakesh,7,0,25,18
1650458225010,CSE 190,A00,092507,Dubnov; Shlomo,14,0,20,6
1650458231040,ECE 45,A01,083139,Staff,0,18,40,40
1650458237069,ECE 65,A50,083695,Staff,0,6,30,30
1650458243100,ECE 109,A01,091882,Touri; Behrouz,38,0,70,32
1650458249129,ECE 180,A00,083140,Abi Samra; Nicholas Camill,23,0,30,7
1650458249129,ECE 180,B00,083141,Abi Samra; Nicholas Camill,0,0,30,30
1650458255168,MATH 10A,A01,083735,Patchell; Gregory David,7,0,30,23
1650458255168,MATH 10A,A02,083736,Patchell; Gregory David,28,0,30,2
1650458255168,MATH 10A,A03,083737,Patchell; Gregory David,25,0,30,5
1650458261199,MATH 10B,A01,083207,Staff,0,7,30,30
1650458261199,MATH 10B,A02,083208,Staff,0,7,30,30
1650458261199,MATH 10B,B01,083739,Staff,13,0,30,17
1650458261199,MATH 10B,B02,083740,Staff,28,0,30,2
1650458267226,MATH 18,A01,083743,Staff,1,0,30,29
1650458267226,MATH 18,A02,083744,Staff,27,0,30,3
1650458267226,MATH 18,A03,083745,Staff,22,0,30,8
1650458267226,MATH 18,A04,083746,Staff,26,0,30,4
1650458267226,MATH 18,B01,083748,Staff,0,11,30,30
1650458267226,MATH 18,B02,083749,Staff,0,12,30,30
1650458267226,MATH 18,B03,083750,Staff,0,11,30,30
1650458267226,MATH 18,B04,083751,Staff,0,12,30,30
1650458273252,MATH 20A,A01,083754,Staff,25,0,40,15
1650458279277,MATH 20B,A01,083756,Staff,0,10,30,30
1650458279277,MATH 20B,A02,083757,Staff,0,10,30,30
1650458285305,MATH 20C,A01,083760,Staff,0,15,30,30
1650458285305,MATH 20C,A02,083761,Staff,1,14,30,29
1650458285305,MATH 20C,B01,083762,Staff,13,0,30,17
1650458285305,MATH 20C,B02,083763,Staff,28,0,30,2
1650458291337,MATH 20D,A01,083765,Staff,0,1,30,30
1650458291337,MATH 20D,A02,083766,Staff,9,0,30,21
1650458291337,MATH 20D,A03,083767,Staff,25,0,30,5
1650458297363,MATH 20E,A01,083771,Staff,6,0,30,24
1650458297363,MATH 20E,A02,083772,Staff,18,0,30,12
1650458297363,MATH 20E,B01,083773,Staff,0,0,30,30
1650458297363,MATH 20E,B02,083774,Staff,10,0,30,20
1650458303386,MATH 103A,A01,083777,Staff,0,12,30,30
1650458303386,MATH 103A,A02,083778,Staff,0,12,30,30
1650458303386,MATH 103A,B01,083779,Staff,0,13,30,30
1650458303386,MATH 103A,B02,083780,Staff,0,12,30,30
1650458309421,MATH 105,A01,085443,Staff,0,23,30,30
1650458315452,MATH 109,A01,083213,Anzaldo; Leesa B,0,7,30,30
1650458315452,MATH 109,A02,083214,Anzaldo; Leesa B,0,7,30,30
1650458315452,MATH 109,B01,083215,Anzaldo; Leesa B,0,5,30,30
1650458315452,MATH 109,B02,083216,Anzaldo; Leesa B,0,6,30,30
1650458321476,MATH 142A,A01,083219,Chow; Bennett,0,14,30,30
1650458321476,MATH 142A,A02,083220,Chow; Bennett,0,13,30,30
1650458321476,MATH 142A,B01,083221,Chow; Bennett,0,12,30,30
1650458321476,MATH 142A,B02,083222,Chow; Bennett,0,13,30,30
1650458327518,MATH 193A,A01,083224,Staff,0,5,30,30
1650458327518,MATH 193A,A02,083225,Staff,0,5,30,30
1650458327518,MATH 193A,A03,083781,Staff,0,4,30,30
1650458327518,MATH 193A,A04,083782,Staff,0,5,30,30
1650458333544,MATH 197,001,091859,McAuley; Julian John,9998,0,9999,1
1650458339611,COGS 9,A01,083615,Staff,0,14,60,60
1650458345641,COGS 11,A01,083617,Boyle; Mary E. T.,21,0,40,19
1650458351672,COGS 13,A01,083071,Staff,0,34,40,40
1650458357697,COGS 14A,A01,092681,Staff,1,25,100,99
1650458363727,COGS 14B,A01,083073,Cheng; Tzu-Han,0,11,50,50
1650458369753,COGS 17,A01,092677,Staff,22,0,75,53
1650458375777,COGS 100,A01,083619,Staff,0,26,60,60
1650458381802,COGS 101A,A01,083621,Davis; Joshua Daniel,0,21,60,60
1650458387828,COGS 101B,A01,091572,Staff,0,4,60,60
1650458393855,COGS 101C,A01,083625,Delgado; Tania,16,0,30,14
1650458399884,COGS 107A,A01,083627,Boyle; Mary E. T.,0,11,60,60
1650458405922,COGS 118A,A01,083075,Staff,2,0,60,58
1650458412021,CSE 3,A50,083646,Miranda; Gregory Joseph,20,0,38,18
1650458412021,CSE 3,A51,083647,Miranda; Gregory Joseph,36,0,37,1
1650458418051,CSE 8A,A50,083650,Miranda; Gregory Joseph,0,28,40,40
1650458424077,CSE 11,A01,083080,Cao; Yingjun,0,92,40,40
1650458430102,CSE 12,A01,083652,Staff,0,16,100,100
1650458436130,CSE 15L,A01,083654,Staff,0,1,50,50
1650458436130,CSE 15L,A02,083655,Staff,1,0,50,49
1650458442158,CSE 20,A01,083657,Staff,51,0,80,29
1650458448187,CSE 30,A01,083084,Eldon; John,0,76,40,40
1650458454215,CSE 100,A01,083659,Cao; Yingjun,0,66,50,50
1650458460271,CSE 134B,A01,083661,Powell; Thomas Allan,0,32,65,65
1650458466297,CSE 140,A01,083663,Staff,0,2,75,75
1650458472323,CSE 140L,A01,083088,Eldon; John,0,8,75,75
1650458478354,CSE 175,A01,083665,Kumar; Rakesh,7,0,25,18
1650458484380,CSE 190,A00,092507,Dubnov; Shlomo,14,0,20,6
1650458490407,ECE 45,A01,083139,Staff,0,18,40,40
1650458496434,ECE 65,A50,083695,Staff,0,6,30,30
1650458502457,ECE 109,A01,091882,Touri; Behrouz,38,0,70,32
1650458508481,ECE 180,A00,083140,Abi Samra; Nicholas Camill,23,0,30,7
1650458508481,ECE 180,B00,083141,Abi Samra; Nicholas Camill,0,0,30,30
1650458514504,MATH 10A,A01,083735,Patchell; Gregory David,7,0,30,23
1650458514504,MATH 10A,A02,083736,Patchell; Gregory David,28,0,30,2
1650458514504,MATH 10A,A03,083737,Patchell; Gregory David,25,0,30,5
1650458520537,MATH 10B,A01,083207,Staff,0,7,30,30
1650458520537,MATH 10B,A02,083208,Staff,0,7,30,30
1650458520537,MATH 10B,B01,083739,Staff,13,0,30,17
1650458520537,MATH 10B,B02,083740,Staff,28,0,30,2
1650458526576,MATH 18,A01,083743,Staff,1,0,30,29
1650458526576,MATH 18,A02,083744,Staff,27,0,30,3
1650458526576,MATH 18,A03,083745,Staff,22,0,30,8
1650458526576,MATH 18,A04,083746,Staff,26,0,30,4
1650458526576,MATH 18,B01,083748,Staff,0,11,30,30
1650458526576,MATH 18,B02,083749,Staff,0,12,30,30
1650458526576,MATH 18,B03,083750,Staff,0,11,30,30
1650458526576,MATH 18,B04,083751,Staff,0,12,30,30
1650458532602,MATH 20A,A01,083754,Staff,25,0,40,15
1650458538631,MATH 20B,A01,083756,Staff,0,10,30,30
1650458538631,MATH 20B,A02,083757,Staff,0,10,30,30
1650458544657,MATH 20C,A01,083760,Staff,0,15,30,30
1650458544657,MATH 20C,A02,083761,Staff,1,14,30,29
1650458544657,MATH 20C,B01,083762,Staff,13,0,30,17
1650458544657,MATH 20C,B02,083763,Staff,28,0,30,2
1650458550682,MATH 20D,A01,083765,Staff,0,1,30,30
1650458550682,MATH 20D,A02,083766,Staff,9,0,30,21
1650458550682,MATH 20D,A03,083767,Staff,25,0,30,5
1650458556709,MATH 20E,A01,083771,Staff,6,0,30,24
1650458556709,MATH 20E,A02,083772,Staff,18,0,30,12
1650458556709,MATH 20E,B01,083773,Staff,0,0,30,30
1650458556709,MATH 20E,B02,083774,Staff,10,0,30,20
1650458562739,MATH 103A,A01,083777,Staff,0,12,30,30
1650458562739,MATH 103A,A02,083778,Staff,0,12,30,30
1650458562739,MATH 103A,B01,083779,Staff,0,13,30,30
1650458562739,MATH 103A,B02,083780,Staff,0,12,30,30
1650458568766,MATH 105,A01,085443,Staff,0,23,30,30
1650458574797,MATH 109,A01,083213,Anzaldo; Leesa B,0,7,30,30
1650458574797,MATH 109,A02,083214,Anzaldo; Leesa B,0,7,30,30
1650458574797,MATH 109,B01,083215,Anzaldo; Leesa B,0,5,30,30
1650458574797,MATH 109,B02,083216,Anzaldo; Leesa B,0,6,30,30
1650458580821,MATH 142A,A01,083219,Chow; Bennett,0,14,30,30
1650458580821,MATH 142A,A02,083220,Chow; Bennett,0,13,30,30
1650458580821,MATH 142A,B01,083221,Chow; Bennett,0,12,30,30
1650458580821,MATH 142A,B02,083222,Chow; Bennett,0,13,30,30
1650458586851,MATH 193A,A01,083224,Staff,0,5,30,30
1650458586851,MATH 193A,A02,083225,Staff,0,5,30,30
1650458586851,MATH 193A,A03,083781,Staff,0,4,30,30
1650458586851,MATH 193A,A04,083782,Staff,0,5,30,30
1650458592877,MATH 197,001,091859,McAuley; Julian John,9998,0,9999,1
1650458598939,COGS 9,A01,083615,Staff,0,14,60,60
1650458604967,COGS 11,A01,083617,Boyle; Mary E. T.,21,0,40,19
1650458610999,COGS 13,A01,083071,Staff,0,34,40,40
1650458617023,COGS 14A,A01,092681,Staff,1,25,100,99
1650458623051,COGS 14B,A01,083073,Cheng; Tzu-Han,0,11,50,50
1650458629079,COGS 17,A01,092677,Staff,22,0,75,53
1650458635105,COGS 100,A01,083619,Staff,0,26,60,60
1650458641129,COGS 101A,A01,083621,Davis; Joshua Daniel,0,21,60,60
1650458647159,COGS 101B,A01,091572,Staff,0,4,60,60
1650458653189,COGS 101C,A01,083625,Delgado; Tania,16,0,30,14
1650458659213,COGS 107A,A01,083627,Boyle; Mary E. T.,0,11,60,60
1650458665243,COGS 118A,A01,083075,Staff,2,0,60,58
1650458671273,CSE 3,A50,083646,Miranda; Gregory Joseph,20,0,38,18
1650458671273,CSE 3,A51,083647,Miranda; Gregory Joseph,36,0,37,1
1650458677318,CSE 8A,A50,083650,Miranda; Gregory Joseph,0,28,40,40
1650458683352,CSE 11,A01,083080,Cao; Yingjun,0,92,40,40
1650458689379,CSE 12,A01,083652,Staff,0,16,100,100
1650458695407,CSE 15L,A01,083654,Staff,0,1,50,50
1650458695407,CSE 15L,A02,083655,Staff,1,0,50,49
1650458701436,CSE 20,A01,083657,Staff,51,0,80,29
1650458707468,CSE 30,A01,083084,Eldon; John,0,76,40,40
1650458713496,CSE 100,A01,083659,Cao; Yingjun,0,66,50,50
1650458719521,CSE 134B,A01,083661,Powell; Thomas Allan,0,32,65,65
1650458725549,CSE 140,A01,083663,Staff,0,2,75,75
1650458731573,CSE 140L,A01,083088,Eldon; John,0,8,75,75
1650458737603,CSE 175,A01,083665,Kumar; Rakesh,7,0,25,18
1650458743631,CSE 190,A00,092507,Dubnov; Shlomo,14,0,20,6
1650458749658,ECE 45,A01,083139,Staff,0,18,40,40
1650458755684,ECE 65,A50,083695,Staff,0,6,30,30
1650458761715,ECE 109,A01,091882,Touri; Behrouz,38,0,70,32
1650458767743,ECE 180,A00,083140,Abi Samra; Nicholas Camill,23,0,30,7
1650458767743,ECE 180,B00,083141,Abi Samra; Nicholas Camill,0,0,30,30
1650458773774,MATH 10A,A01,083735,Patchell; Gregory David,7,0,30,23
1650458773774,MATH 10A,A02,083736,Patchell; Gregory David,28,0,30,2
1650458773774,MATH 10A,A03,083737,Patchell; Gregory David,25,0,30,5
1650458779811,MATH 10B,A01,083207,Staff,0,7,30,30
1650458779811,MATH 10B,A02,083208,Staff,0,7,30,30
1650458779811,MATH 10B,B01,083739,Staff,13,0,30,17
1650458779811,MATH 10B,B02,083740,Staff,28,0,30,2
1650458785850,MATH 18,A01,083743,Staff,1,0,30,29
1650458785850,MATH 18,A02,083744,Staff,27,0,30,3
1650458785850,MATH 18,A03,083745,Staff,22,0,30,8
1650458785850,MATH 18,A04,083746,Staff,26,0,30,4
1650458785850,MATH 18,B01,083748,Staff,0,11,30,30
1650458785850,MATH 18,B02,083749,Staff,0,12,30,30
1650458785850,MATH 18,B03,083750,Staff,0,11,30,30
1650458785850,MATH 18,B04,083751,Staff,0,12,30,30
1650458791878,MATH 20A,A01,083754,Staff,25,0,40,15
1650458797906,MATH 20B,A01,083756,Staff,0,10,30,30
1650458797906,MATH 20B,A02,083757,Staff,0,10,30,30
1650458803932,MATH 20C,A01,083760,Staff,0,15,30,30
1650458803932,MATH 20C,A02,083761,Staff,1,14,30,29
1650458803932,MATH 20C,B01,083762,Staff,13,0,30,17
1650458803932,MATH 20C,B02,083763,Staff,28,0,30,2
1650458809962,MATH 20D,A01,083765,Staff,0,1,30,30
1650458809962,MATH 20D,A02,083766,Staff,9,0,30,21
1650458809962,MATH 20D,A03,083767,Staff,25,0,30,5
1650458815989,MATH 20E,A01,083771,Staff,6,0,30,24
1650458815989,MATH 20E,A02,083772,Staff,18,0,30,12
1650458815989,MATH 20E,B01,083773,Staff,0,0,30,30
1650458815989,MATH 20E,B02,083774,Staff,10,0,30,20
1650458822022,MATH 103A,A01,083777,Staff,0,12,30,30
1650458822022,MATH 103A,A02,083778,Staff,0,12,30,30
1650458822022,MATH 103A,B01,083779,Staff,0,13,30,30
1650458822022,MATH 103A,B02,083780,Staff,0,12,30,30
1650458828054,MATH 105,A01,085443,Staff,0,23,30,30
1650458834081,MATH 109,A01,083213,Anzaldo; Leesa B,0,7,30,30
1650458834081,MATH 109,A02,083214,Anzaldo; Leesa B,0,7,30,30
1650458834081,MATH 109,B01,083215,Anzaldo; Leesa B,0,5,30,30
1650458834081,MATH 109,B02,083216,Anzaldo; Leesa B,0,6,30,30
1650458840108,MATH 142A,A01,083219,Chow; Bennett,0,14,30,30
1650458840108,MATH 142A,A02,083220,Chow; Bennett,0,13,30,30
1650458840108,MATH 142A,B01,083221,Chow; Bennett,0,12,30,30
1650458840108,MATH 142A,B02,083222,Chow; Bennett,0,13,30,30
1650458846135,MATH 193A,A01,083224,Staff,0,5,30,30
1650458846135,MATH 193A,A02,083225,Staff,0,5,30,30
1650458846135,MATH 193A,A03,083781,Staff,0,4,30,30
1650458846135,MATH 193A,A04,083782,Staff,0,5,30,30
1650458852163,MATH 197,001,091859,McAuley; Julian John,9998,0,9999,1
1650458858247,COGS 9,A01,083615,Staff,0,14,60,60
1650458864274,COGS 11,A01,083617,Boyle; Mary E. T.,21,0,40,19
1650458870306,COGS 13,A01,083071,Staff,0,34,40,40
1650458876333,COGS 14A,A01,092681,Staff,1,25,100,99
1650458882364,COGS 14B,A01,083073,Cheng; Tzu-Han,0,11,50,50
1650458888394,COGS 17,A01,092677,Staff,22,0,75,53
1650458894419,COGS 100,A01,083619,Staff,0,26,60,60
1650458900453,COGS 101A,A01,083621,Davis; Joshua Daniel,0,21,60,60
1650458906479,COGS 101B,A01,091572,Staff,0,4,60,60
1650458912510,COGS 101C,A01,083625,Delgado; Tania,16,0,30,14
1650458918539,COGS 107A,A01,083627,Boyle; Mary E. T.,0,11,60,60
1650458924568,COGS 118A,A01,083075,Staff,2,0,60,58
1650458930595,CSE 3,A50,083646,Miranda; Gregory Joseph,20,0,38,18
1650458930595,CSE 3,A51,083647,Miranda; Gregory Joseph,36,0,37,1
1650458936621,CSE 8A,A50,083650,Miranda; Gregory Joseph,0,28,40,40
1650458942650,CSE 11,A01,083080,Cao; Yingjun,0,92,40,40
1650458948684,CSE 12,A01,083652,Staff,0,16,100,100
1650458954710,CSE 15L,A01,083654,Staff,0,1,50,50
1650458954710,CSE 15L,A02,083655,Staff,1,0,50,49
1650458960739,CSE 20,A01,083657,Staff,51,0,80,29
1650458966768,CSE 30,A01,083084,Eldon; John,0,76,40,40
1650458972794,CSE 100,A01,083659,Cao; Yingjun,0,66,50,50
1650458978821,CSE 134B,A01,083661,Powell; Thomas Allan,0,32,65,65
1650458984851,CSE 140,A01,083663,Staff,0,2,75,75
1650458990877,CSE 140L,A01,083088,Eldon; John,0,8,75,75
1650458996912,CSE 175,A01,083665,Kumar; Rakesh,7,0,25,18
1650459002944,CSE 190,A00,092507,Dubnov; Shlomo,14,0,20,6
1650459009046,ECE 45,A01,083139,Staff,0,18,40,40
1650459015090,ECE 65,A50,083695,Staff,0,6,30,30
1650459021117,ECE 109,A01,091882,Touri; Behrouz,38,0,70,32
1650459027146,ECE 180,A00,083140,Abi Samra; Nicholas Camill,23,0,30,7
1650459027146,ECE 180,B00,083141,Abi Samra; Nicholas Camill,0,0,30,30
1650459033174,MATH 10A,A01,083735,Patchell; Gregory David,7,0,30,23
1650459033174,MATH 10A,A02,083736,Patchell; Gregory David,28,0,30,2
1650459033174,MATH 10A,A03,083737,Patchell; Gregory David,25,0,30,5
1650459039201,MATH 10B,A01,083207,Staff,0,7,30,30
1650459039201,MATH 10B,A02,083208,Staff,0,7,30,30
1650459039201,MATH 10B,B01,083739,Staff,13,0,30,17
1650459039201,MATH 10B,B02,083740,Staff,28,0,30,2
1650459045229,MATH 18,A01,083743,Staff,1,0,30,29
1650459045229,MATH 18,A02,083744,Staff,27,0,30,3
1650459045229,MATH 18,A03,083745,Staff,22,0,30,8
1650459045229,MATH 18,A04,083746,Staff,26,0,30,4
1650459045229,MATH 18,B01,083748,Staff,0,11,30,30
1650459045229,MATH 18,B02,083749,Staff,0,12,30,30
1650459045229,MATH 18,B03,083750,Staff,0,11,30,30
1650459045229,MATH 18,B04,083751,Staff,0,12,30,30
1650459051263,MATH 20A,A01,083754,Staff,25,0,40,15
1650459057289,MATH 20B,A01,083756,Staff,0,10,30,30
1650459057289,MATH 20B,A02,083757,Staff,0,10,30,30
1650459063318,MATH 20C,A01,083760,Staff,0,15,30,30
1650459063318,MATH 20C,A02,083761,Staff,1,14,30,29
1650459063318,MATH 20C,B01,083762,Staff,13,0,30,17
1650459063318,MATH 20C,B02,083763,Staff,28,0,30,2
1650459069344,MATH 20D,A01,083765,Staff,0,1,30,30
1650459069344,MATH 20D,A02,083766,Staff,9,0,30,21
1650459069344,MATH 20D,A03,083767,Staff,25,0,30,5
1650459075370,MATH 20E,A01,083771,Staff,6,0,30,24
1650459075370,MATH 20E,A02,083772,Staff,18,0,30,12
1650459075370,MATH 20E,B01,083773,Staff,0,0,30,30
1650459075370,MATH 20E,B02,083774,Staff,10,0,30,20
1650459081399,MATH 103A,A01,083777,Staff,0,12,30,30
1650459081399,MATH 103A,A02,083778,Staff,0,12,30,30
1650459081399,MATH 103A,B01,083779,Staff,0,13,30,30
1650459081399,MATH 103A,B02,083780,Staff,0,12,30,30
1650459087425,MATH 105,A01,085443,Staff,0,23,30,30
1650459093454,MATH 109,A01,083213,Anzaldo; Leesa B,0,7,30,30
1650459093454,MATH 109,A02,083214,Anzaldo; Leesa B,0,7,30,30
1650459093454,MATH 109,B01,083215,Anzaldo; Leesa B,0,5,30,30
1650459093454,MATH 109,B02,083216,Anzaldo; Leesa B,0,6,30,30
1650459099488,MATH 142A,A01,083219,Chow; Bennett,0,14,30,30
1650459099488,MATH 142A,A02,083220,Chow; Bennett,0,13,30,30
1650459099488,MATH 142A,B01,083221,Chow; Bennett,0,12,30,30
1650459099488,MATH 142A,B02,083222,Chow; Bennett,0,13,30,30
1650459105516,MATH 193A,A01,083224,Staff,0,5,30,30
1650459105516,MATH 193A,A02,083225,Staff,0,5,30,30
1650459105516,MATH 193A,A03,083781,Staff,0,4,30,30
1650459105516,MATH 193A,A04,083782,Staff,0,5,30,30
1650459111541,MATH 197,001,091859,McAuley; Julian John,9998,0,9999,1
1650459117630,COGS 9,A01,083615,Staff,0,14,60,60
1650459123659,COGS 11,A01,083617,Boyle; Mary E. T.,21,0,40,19
1650459129690,COGS 13,A01,083071,Staff,0,34,40,40
1650459135715,COGS 14A,A01,092681,Staff,1,25,100,99
1650459141741,COGS 14B,A01,083073,Cheng; Tzu-Han,0,11,50,50
1650459147766,COGS 17,A01,092677,Staff,22,0,75,53
1650459153790,COGS 100,A01,083619,Staff,0,26,60,60
1650459159824,COGS 101A,A01,083621,Davis; Joshua Daniel,0,21,60,60
1650459165851,COGS 101B,A01,091572,Staff,0,4,60,60
1650459171877,COGS 101C,A01,083625,Delgado; Tania,16,0,30,14
1650459177903,COGS 107A,A01,083627,Boyle; Mary E. T.,0,11,60,60
1650459183933,COGS 118A,A01,083075,Staff,2,0,60,58
1650459189960,CSE 3,A50,083646,Miranda; Gregory Joseph,20,0,38,18
1650459189960,CSE 3,A51,083647,Miranda; Gregory Joseph,36,0,37,1
1650459195992,CSE 8A,A50,083650,Miranda; Gregory Joseph,0,28,40,40
1650459202026,CSE 11,A01,083080,Cao; Yingjun,0,92,40,40
1650459208056,CSE 12,A01,083652,Staff,0,16,100,100
1650459214081,CSE 15L,A01,083654,Staff,0,1,50,50
1650459214081,CSE 15L,A02,083655,Staff,1,0,50,49
1650459220109,CSE 20,A01,083657,Staff,51,0,80,29
1650459226145,CSE 30,A01,083084,Eldon; John,0,76,40,40
1650459232177,CSE 100,A01,083659,Cao; Yingjun,0,66,50,50
1650459238210,CSE 134B,A01,083661,Powell; Thomas Allan,0,32,65,65
1650459244236,CSE 140,A01,083663,Staff,0,2,75,75
1650459250265,CSE 140L,A01,083088,Eldon; John,0,8,75,75
1650459256295,CSE 175,A01,083665,Kumar; Rakesh,7,0,25,18
1650459262323,CSE 190,A00,092507,Dubnov; Shlomo,14,0,20,6
1650459268351,ECE 45,A01,083139,Staff,0,18,40,40
1650459274384,ECE 65,A50,083695,Staff,0,6,30,30
1650459280417,ECE 109,A01,091882,Touri; Behrouz,38,0,70,32
1650459286452,ECE 180,A00,083140,Abi Samra; Nicholas Camill,23,0,30,7
1650459286452,ECE 180,B00,083141,Abi Samra; Nicholas Camill,0,0,30,30
1650459292480,MATH 10A,A01,083735,Patchell; Gregory David,7,0,30,23
1650459292480,MATH 10A,A02,083736,Patchell; Gregory David,28,0,30,2
1650459292480,MATH 10A,A03,083737,Patchell; Gregory David,25,0,30,5
1650459298508,MATH 10B,A01,083207,Staff,0,7,30,30
1650459298508,MATH 10B,A02,083208,Staff,0,7,30,30
1650459298508,MATH 10B,B01,083739,Staff,13,0,30,17
1650459298508,MATH 10B,B02,083740,Staff,28,0,30,2
1650459304535,MATH 18,A01,083743,Staff,1,0,30,29
1650459304535,MATH 18,A02,083744,Staff,27,0,30,3
1650459304535,MATH 18,A03,083745,Staff,22,0,30,8
1650459304535,MATH 18,A04,083746,Staff,26,0,30,4
1650459304535,MATH 18,B01,083748,Staff,0,11,30,30
1650459304535,MATH 18,B02,083749,Staff,0,12,30,30
1650459304535,MATH 18,B03,083750,Staff,0,11,30,30
1650459304535,MATH 18,B04,083751,Staff,0,12,30,30
1650459310563,MATH 20A,A01,083754,Staff,25,0,40,15
1650459316591,MATH 20B,A01,083756,Staff,0,10,30,30
1650459316591,MATH 20B,A02,083757,Staff,0,10,30,30
1650459322618,MATH 20C,A01,083760,Staff,0,15,30,30
1650459322618,MATH 20C,A02,083761,Staff,1,14,30,29
1650459322618,MATH 20C,B01,083762,Staff,13,0,30,17
1650459322618,MATH 20C,B02,083763,Staff,28,0,30,2
1650459328644,MATH 20D,A01,083765,Staff,0,1,30,30
1650459328644,MATH 20D,A02,083766,Staff,9,0,30,21
1650459328644,MATH 20D,A03,083767,Staff,25,0,30,5
1650459334675,MATH 20E,A01,083771,Staff,6,0,30,24
1650459334675,MATH 20E,A02,083772,Staff,18,0,30,12
1650459334675,MATH 20E,B01,083773,Staff,0,0,30,30
1650459334675,MATH 20E,B02,083774,Staff,10,0,30,20
1650459340708,MATH 103A,A01,083777,Staff,0,12,30,30
1650459340708,MATH 103A,A02,083778,Staff,0,12,30,30
1650459340708,MATH 103A,B01,083779,Staff,0,13,30,30
1650459340708,MATH 103A,B02,083780,Staff,0,12,30,30
1650459346734,MATH 105,A01,085443,Staff,0,23,30,30
1650459352768,MATH 109,A01,083213,Anzaldo; Leesa B,0,7,30,30
1650459352768,MATH 109,A02,083214,Anzaldo; Leesa B,0,7,30,30
1650459352768,MATH 109,B01,083215,Anzaldo; Leesa B,0,5,30,30
1650459352768,MATH 109,B02,083216,Anzaldo; Leesa B,0,6,30,30
1650459358794,MATH 142A,A01,083219,Chow; Bennett,0,14,30,30
1650459358794,MATH 142A,A02,083220,Chow; Bennett,0,13,30,30
1650459358794,MATH 142A,B01,083221,Chow; Bennett,0,12,30,30
1650459358794,MATH 142A,B02,083222,Chow; Bennett,0,13,30,30
1650459364824,MATH 193A,A01,083224,Staff,0,5,30,30
1650459364824,MATH 193A,A02,083225,Staff,0,5,30,30
1650459364824,MATH 193A,A03,083781,Staff,0,4,30,30
1650459364824,MATH 193A,A04,083782,Staff,0,5,30,30
1650459370850,MATH 197,001,091859,McAuley; Julian John,9998,0,9999,1
1650459376926,COGS 9,A01,083615,Staff,0,14,60,60
1650459382959,COGS 11,A01,083617,Boyle; Mary E. T.,21,0,40,19
1650459388988,COGS 13,A01,083071,Staff,0,34,40,40
1650459395017,COGS 14A,A01,092681,Staff,1,25,100,99
1650459401042,COGS 14B,A01,083073,Cheng; Tzu-Han,0,11,50,50
1650459407072,COGS 17,A01,092677,Staff,22,0,75,53
1650459413097,COGS 100,A01,083619,Staff,0,26,60,60
1650459419137,COGS 101A,A01,083621,Davis; Joshua Daniel,0,21,60,60
1650459425165,COGS 101B,A01,091572,Staff,0,4,60,60
1650459431196,COGS 101C,A01,083625,Delgado; Tania,16,0,30,14
1650459437223,COGS 107A,A01,083627,Boyle; Mary E. T.,0,11,60,60
1650459443253,COGS 118A,A01,083075,Staff,2,0,60,58
1650459449281,CSE 3,A50,083646,Miranda; Gregory Joseph,20,0,38,18
1650459449281,CSE 3,A51,083647,Miranda; Gregory Joseph,36,0,37,1
1650459455305,CSE 8A,A50,083650,Miranda; Gregory Joseph,0,28,40,40
1650459461335,CSE 11,A01,083080,Cao; Yingjun,0,92,40,40
1650459467361,CSE 12,A01,083652,Staff,0,16,100,100
1650459473387,CSE 15L,A01,083654,Staff,0,1,50,50
1650459473387,CSE 15L,A02,083655,Staff,1,0,50,49
1650459479413,CSE 20,A01,083657,Staff,51,0,80,29
1650459485440,CSE 30,A01,083084,Eldon; John,0,76,40,40
1650459491471,CSE 100,A01,083659,Cao; Yingjun,0,66,50,50
1650459497498,CSE 134B,A01,083661,Powell; Thomas Allan,0,32,65,65
1650459503523,CSE 140,A01,083663,Staff,0,2,75,75
1650459509552,CSE 140L,A01,083088,Eldon; John,0,8,75,75
1650459515579,CSE 175,A01,083665,Kumar; Rakesh,7,0,25,18
1650459521610,CSE 190,A00,092507,Dubnov; Shlomo,14,0,20,6
1650459527636,ECE 45,A01,083139,Staff,0,18,40,40
1650459533667,ECE 65,A50,083695,Staff,0,6,30,30
1650459539693,ECE 109,A01,091882,Touri; Behrouz,38,0,70,32
1650459545719,ECE 180,A00,083140,Abi Samra; Nicholas Camill,23,0,30,7
1650459545719,ECE 180,B00,083141,Abi Samra; Nicholas Camill,0,0,30,30
1650459551751,MATH 10A,A01,083735,Patchell; Gregory David,7,0,30,23
1650459551751,MATH 10A,A02,083736,Patchell; Gregory David,28,0,30,2
1650459551751,MATH 10A,A03,083737,Patchell; Gregory David,25,0,30,5
1650459557778,MATH 10B,A01,083207,Staff,0,7,30,30
1650459557778,MATH 10B,A02,083208,Staff,0,7,30,30
1650459557778,MATH 10B,B01,083739,Staff,13,0,30,17
1650459557778,MATH 10B,B02,083740,Staff,28,0,30,2
1650459563807,MATH 18,A01,083743,Staff,1,0,30,29
1650459563807,MATH 18,A02,083744,Staff,27,0,30,3
1650459563807,MATH 18,A03,083745,Staff,22,0,30,8
1650459563807,MATH 18,A04,083746,Staff,26,0,30,4
1650459563807,MATH 18,B01,083748,Staff,0,11,30,30
1650459563807,MATH 18,B02,083749,Staff,0,12,30,30
1650459563807,MATH 18,B03,083750,Staff,0,11,30,30
1650459563807,MATH 18,B04,083751,Staff,0,12,30,30
1650459569836,MATH 20A,A01,083754,Staff,25,0,40,15
1650459575865,MATH 20B,A01,083756,Staff,0,10,30,30
1650459575865,MATH 20B,A02,083757,Staff,0,10,30,30
1650459581890,MATH 20C,A01,083760,Staff,0,15,30,30
1650459581890,MATH 20C,A02,083761,Staff,1,14,30,29
1650459581890,MATH 20C,B01,083762,Staff,13,0,30,17
1650459581890,MATH 20C,B02,083763,Staff,28,0,30,2
1650459587919,MATH 20D,A01,083765,Staff,0,1,30,30
1650459587919,MATH 20D,A02,083766,Staff,9,0,30,21
1650459587919,MATH 20D,A03,083767,Staff,25,0,30,5
1650459593952,MATH 20E,A01,083771,Staff,6,0,30,24
1650459593952,MATH 20E,A02,083772,Staff,18,0,30,12
1650459593952,MATH 20E,B01,083773,Staff,0,0,30,30
1650459593952,MATH 20E,B02,083774,Staff,10,0,30,20
1650459599978,MATH 103A,A01,083777,Staff,0,12,30,30
1650459599978,MATH 103A,A02,083778,Staff,0,12,30,30
1650459599978,MATH 103A,B01,083779,Staff,0,13,30,30
1650459599978,MATH 103A,B02,083780,Staff,0,12,30,30
1650459606079,MATH 105,A01,085443,Staff,0,23,30,30
1650459612111,MATH 109,A01,083213,Anzaldo; Leesa B,0,7,30,30
1650459612111,MATH 109,A02,083214,Anzaldo; Leesa B,0,7,30,30
1650459612111,MATH 109,B01,083215,Anzaldo; Leesa B,0,5,30,30
1650459612111,MATH 109,B02,083216,Anzaldo; Leesa B,0,6,30,30
1650459618137,MATH 142A,A01,083219,Chow; Bennett,0,14,30,30
1650459618137,MATH 142A,A02,083220,Chow; Bennett,0,13,30,30
1650459618137,MATH 142A,B01,083221,Chow; Bennett,0,12,30,30
1650459618137,MATH 142A,B02,083222,Chow; Bennett,0,13,30,30
1650459624165,MATH 193A,A01,083224,Staff,0,5,30,30
1650459624165,MATH 193A,A02,083225,Staff,0,5,30,30
1650459624165,MATH 193A,A03,083781,Staff,0,4,30,30
1650459624165,MATH 193A,A04,083782,Staff,0,5,30,30
1650459630190,MATH 197,001,091859,McAuley; Julian John,9998,0,9999,1
1650459636255,COGS 9,A01,083615,Staff,0,14,60,60
1650459642281,COGS 11,A01,083617,Boyle; Mary E. T.,21,0,40,19
1650459648310,COGS 13,A01,083071,Staff,0,34,40,40
1650459654340,COGS 14A,A01,092681,Staff,1,25,100,99
1650459660365,COGS 14B,A01,083073,Cheng; Tzu-Han,0,11,50,50
1650459666394,COGS 17,A01,092677,Staff,22,0,75,53
1650459672422,COGS 100,A01,083619,Staff,0,26,60,60
1650459678452,COGS 101A,A01,083621,Davis; Joshua Daniel,0,21,60,60
1650459684477,COGS 101B,A01,091572,Staff,0,4,60,60
1650459690507,COGS 101C,A01,083625,Delgado; Tania,16,0,30,14
1650459696538,COGS 107A,A01,083627,Boyle; Mary E. T.,0,11,60,60
1650459702562,COGS 118A,A01,083075,Staff,2,0,60,58
1650459708589,CSE 3,A50,083646,Miranda; Gregory Joseph,20,0,38,18
1650459708589,CSE 3,A51,083647,Miranda; Gregory Joseph,36,0,37,1
1650459714613,CSE 8A,A50,083650,Miranda; Gregory Joseph,0,28,40,40
1650459720643,CSE 11,A01,083080,Cao; Yingjun,0,92,40,40
1650459726670,CSE 12,A01,083652,Staff,0,16,100,100
1650459732694,CSE 15L,A01,083654,Staff,0,1,50,50
1650459732694,CSE 15L,A02,083655,Staff,1,0,50,49
1650459738719,CSE 20,A01,083657,Staff,51,0,80,29
1650459744748,CSE 30,A01,083084,Eldon; John,0,76,40,40
1650459750778,CSE 100,A01,083659,Cao; Yingjun,0,66,50,50
1650459756809,CSE 134B,A01,083661,Powell; Thomas Allan,0,32,65,65
1650459762833,CSE 140,A01,083663,Staff,0,2,75,75
1650459768858,CSE 140L,A01,083088,Eldon; John,0,8,75,75
1650459774890,CSE 175,A01,083665,Kumar; Rakesh,7,0,25,18
1650459780925,CSE 190,A00,092507,Dubnov; Shlomo,14,0,20,6
1650459786959,ECE 45,A01,083139,Staff,0,18,40,40
1650459792996,ECE 65,A50,083695,Staff,0,6,30,30
1650459799023,ECE 109,A01,091882,Touri; Behrouz,38,0,70,32
1650459805049,ECE 180,A00,083140,Abi Samra; Nicholas Camill,23,0,30,7
1650459805049,ECE 180,B00,083141,Abi Samra; Nicholas Camill,0,0,30,30
1650459811078,MATH 10A,A01,083735,Patchell; Gregory David,7,0,30,23
1650459811078,MATH 10A,A02,083736,Patchell; Gregory David,28,0,30,2
1650459811078,MATH 10A,A03,083737,Patchell; Gregory David,25,0,30,5
1650459817103,MATH 10B,A01,083207,Staff,0,7,30,30
1650459817103,MATH 10B,A02,083208,Staff,0,7,30,30
1650459817103,MATH 10B,B01,083739,Staff,13,0,30,17
1650459817103,MATH 10B,B02,083740,Staff,28,0,30,2
1650459823130,MATH 18,A01,083743,Staff,1,0,30,29
1650459823130,MATH 18,A02,083744,Staff,27,0,30,3
1650459823130,MATH 18,A03,083745,Staff,22,0,30,8
1650459823130,MATH 18,A04,083746,Staff,26,0,30,4
1650459823130,MATH 18,B01,083748,Staff,0,11,30,30
1650459823130,MATH 18,B02,083749,Staff,0,12,30,30
1650459823130,MATH 18,B03,083750,Staff,0,11,30,30
1650459823130,MATH 18,B04,083751,Staff,0,12,30,30
1650459829159,MATH 20A,A01,083754,Staff,25,0,40,15
1650459835184,MATH 20B,A01,083756,Staff,0,10,30,30
1650459835184,MATH 20B,A02,083757,Staff,0,10,30,30
1650459841217,MATH 20C,A01,083760,Staff,0,15,30,30
1650459841217,MATH 20C,A02,083761,Staff,1,14,30,29
1650459841217,MATH 20C,B01,083762,Staff,13,0,30,17
1650459841217,MATH 20C,B02,083763,Staff,28,0,30,2
1650459847243,MATH 20D,A01,083765,Staff,0,1,30,30
1650459847243,MATH 20D,A02,083766,Staff,9,0,30,21
1650459847243,MATH 20D,A03,083767,Staff,25,0,30,5
1650459853269,MATH 20E,A01,083771,Staff,6,0,30,24
1650459853269,MATH 20E,A02,083772,Staff,18,0,30,12
1650459853269,MATH 20E,B01,083773,Staff,0,0,30,30
1650459853269,MATH 20E,B02,083774,Staff,10,0,30,20
1650459859309,MATH 103A,A01,083777,Staff,0,12,30,30
1650459859309,MATH 103A,A02,083778,Staff,0,12,30,30
1650459859309,MATH 103A,B01,083779,Staff,0,13,30,30
1650459859309,MATH 103A,B02,083780,Staff,0,12,30,30
1650459865338,MATH 105,A01,085443,Staff,0,23,30,30
1650459871363,MATH 109,A01,083213,Anzaldo; Leesa B,0,7,30,30
1650459871363,MATH 109,A02,083214,Anzaldo; Leesa B,0,7,30,30
1650459871363,MATH 109,B01,083215,Anzaldo; Leesa B,0,5,30,30
1650459871363,MATH 109,B02,083216,Anzaldo; Leesa B,0,6,30,30
1650459877389,MATH 142A,A01,083219,Chow; Bennett,0,14,30,30
1650459877389,MATH 142A,A02,083220,Chow; Bennett,0,13,30,30
1650459877389,MATH 142A,B01,083221,Chow; Bennett,0,12,30,30
1650459877389,MATH 142A,B02,083222,Chow; Bennett,0,13,30,30
1650459883420,MATH 193A,A01,083224,Staff,0,5,30,30
1650459883420,MATH 193A,A02,083225,Staff,0,5,30,30
1650459883420,MATH 193A,A03,083781,Staff,0,4,30,30
1650459883420,MATH 193A,A04,083782,Staff,0,5,30,30
1650459889445,MATH 197,001,091859,McAuley; Julian John,9998,0,9999,1
1650459895524,COGS 9,A01,083615,Staff,0,14,60,60
1650459901552,COGS 11,A01,083617,Boyle; Mary E. T.,21,0,40,19
1650459907583,COGS 13,A01,083071,Staff,0,34,40,40
1650459913607,COGS 14A,A01,092681,Staff,1,25,100,99
1650459919633,COGS 14B,A01,083073,Cheng; Tzu-Han,0,11,50,50
1650459925675,COGS 17,A01,092677,Staff,22,0,75,53
1650459931702,COGS 100,A01,083619,Staff,0,26,60,60
1650459937733,COGS 101A,A01,083621,Davis; Joshua Daniel,0,21,60,60
1650459943764,COGS 101B,A01,091572,Staff,0,4,60,60
1650459949791,COGS 101C,A01,083625,Delgado; Tania,16,0,30,14
1650459955815,COGS 107A,A01,083627,Boyle; Mary E. T.,0,11,60,60
1650459961838,COGS 118A,A01,083075,Staff,2,0,60,58
1650459967869,CSE 3,A50,083646,Miranda; Gregory Joseph,20,0,38,18
1650459967869,CSE 3,A51,083647,Miranda; Gregory Joseph,36,0,37,1
1650459973900,CSE 8A,A50,083650,Miranda; Gregory Joseph,0,28,40,40
1650459979931,CSE 11,A01,083080,Cao; Yingjun,0,92,40,40
1650459985961,CSE 12,A01,083652,Staff,0,16,100,100
1650459991987,CSE 15L,A01,083654,Staff,0,1,50,50
1650459991987,CSE 15L,A02,083655,Staff,1,0,50,49
1650459998013,CSE 20,A01,083657,Staff,51,0,80,29
1650460004038,CSE 30,A01,083084,Eldon; John,0,76,40,40
1650460010068,CSE 100,A01,083659,Cao; Yingjun,0,66,50,50
1650460016094,CSE 134B,A01,083661,Powell; Thomas Allan,0,32,65,65
1650460022119,CSE 140,A01,083663,Staff,0,2,75,75
1650460028152,CSE 140L,A01,083088,Eldon; John,0,8,75,75
1650460034180,CSE 175,A01,083665,Kumar; Rakesh,7,0,25,18
1650460040210,CSE 190,A00,092507,Dubnov; Shlomo,14,0,20,6
1650460046237,ECE 45,A01,083139,Staff,0,18,40,40
1650460052265,ECE 65,A50,083695,Staff,0,6,30,30
1650460058291,ECE 109,A01,091882,Touri; Behrouz,38,0,70,32
1650460064316,ECE 180,A00,083140,Abi Samra; Nicholas Camill,23,0,30,7
1650460064316,ECE 180,B00,083141,Abi Samra; Nicholas Camill,0,0,30,30
1650460070343,MATH 10A,A01,083735,Patchell; Gregory David,7,0,30,23
1650460070343,MATH 10A,A02,083736,Patchell; Gregory David,28,0,30,2
1650460070343,MATH 10A,A03,083737,Patchell; Gregory David,25,0,30,5
1650460076370,MATH 10B,A01,083207,Staff,0,7,30,30
1650460076370,MATH 10B,A02,083208,Staff,0,7,30,30
1650460076370,MATH 10B,B01,083739,Staff,13,0,30,17
1650460076370,MATH 10B,B02,083740,Staff,28,0,30,2
1650460082404,MATH 18,A01,083743,Staff,1,0,30,29
1650460082404,MATH 18,A02,083744,Staff,27,0,30,3
1650460082404,MATH 18,A03,083745,Staff,22,0,30,8
1650460082404,MATH 18,A04,083746,Staff,26,0,30,4
1650460082404,MATH 18,B01,083748,Staff,0,11,30,30
1650460082404,MATH 18,B02,083749,Staff,0,12,30,30
1650460082404,MATH 18,B03,083750,Staff,0,11,30,30
1650460082404,MATH 18,B04,083751,Staff,0,12,30,30
1650460088436,MATH 20A,A01,083754,Staff,25,0,40,15
1650460094468,MATH 20B,A01,083756,Staff,0,10,30,30
1650460094468,MATH 20B,A02,083757,Staff,0,10,30,30
1650460100500,MATH 20C,A01,083760,Staff,0,15,30,30
1650460100500,MATH 20C,A02,083761,Staff,1,14,30,29
1650460100500,MATH 20C,B01,083762,Staff,13,0,30,17
1650460100500,MATH 20C,B02,083763,Staff,28,0,30,2
1650460106526,MATH 20D,A01,083765,Staff,0,1,30,30
1650460106526,MATH 20D,A02,083766,Staff,9,0,30,21
1650460106526,MATH 20D,A03,083767,Staff,25,0,30,5
1650460112561,MATH 20E,A01,083771,Staff,6,0,30,24
1650460112561,MATH 20E,A02,083772,Staff,18,0,30,12
1650460112561,MATH 20E,B01,083773,Staff,0,0,30,30
1650460112561,MATH 20E,B02,083774,Staff,10,0,30,20
1650460118588,MATH 103A,A01,083777,Staff,0,12,30,30
1650460118588,MATH 103A,A02,083778,Staff,0,12,30,30
1650460118588,MATH 103A,B01,083779,Staff,0,13,30,30
1650460118588,MATH 103A,B02,083780,Staff,0,12,30,30
1650460124614,MATH 105,A01,085443,Staff,0,23,30,30
1650460130646,MATH 109,A01,083213,Anzaldo; Leesa B,0,7,30,30
1650460130646,MATH 109,A02,083214,Anzaldo; Leesa B,0,7,30,30
1650460130646,MATH 109,B01,083215,Anzaldo; Leesa B,0,5,30,30
1650460130646,MATH 109,B02,083216,Anzaldo; Leesa B,0,6,30,30
1650460136678,MATH 142A,A01,083219,Chow; Bennett,0,14,30,30
1650460136678,MATH 142A,A02,083220,Chow; Bennett,0,13,30,30
1650460136678,MATH 142A,B01,083221,Chow; Bennett,0,12,30,30
1650460136678,MATH 142A,B02,083222,Chow; Bennett,0,13,30,30
1650460142703,MATH 193A,A01,083224,Staff,0,5,30,30
1650460142703,MATH 193A,A02,083225,Staff,0,5,30,30
1650460142703,MATH 193A,A03,083781,Staff,0,4,30,30
1650460142703,MATH 193A,A04,083782,Staff,0,5,30,30
1650460148736,MATH 197,001,091859,McAuley; Julian John,9998,0,9999,1
1650460154807,COGS 9,A01,083615,Staff,0,14,60,60
1650460160846,COGS 11,A01,083617,Boyle; Mary E. T.,21,0,40,19
1650460166871,COGS 13,A01,083071,Staff,0,34,40,40
1650460172897,COGS 14A,A01,092681,Staff,1,25,100,99
1650460178931,COGS 14B,A01,083073,Cheng; Tzu-Han,0,11,50,50
1650460184956,COGS 17,A01,092677,Staff,22,0,75,53
1650460190987,COGS 100,A01,083619,Staff,0,26,60,60
1650460197086,COGS 101A,A01,083621,Davis; Joshua Daniel,0,21,60,60
1650460203117,COGS 101B,A01,091572,Staff,0,4,60,60
1650460209144,COGS 101C,A01,083625,Delgado; Tania,16,0,30,14
1650460215173,COGS 107A,A01,083627,Boyle; Mary E. T.,0,11,60,60
1650460221199,COGS 118A,A01,083075,Staff,2,0,60,58
1650460227225,CSE 3,A50,083646,Miranda; Gregory Joseph,20,0,38,18
1650460227225,CSE 3,A51,083647,Miranda; Gregory Joseph,36,0,37,1
1650460233251,CSE 8A,A50,083650,Miranda; Gregory Joseph,0,28,40,40
1650460239276,CSE 11,A01,083080,Cao; Yingjun,0,92,40,40
1650460245302,CSE 12,A01,083652,Staff,0,16,100,100
1650460251329,CSE 15L,A01,083654,Staff,0,1,50,50
1650460251329,CSE 15L,A02,083655,Staff,1,0,50,49
1650460257354,CSE 20,A01,083657,Staff,51,0,80,29
1650460263382,CSE 30,A01,083084,Eldon; John,0,76,40,40
1650460269418,CSE 100,A01,083659,Cao; Yingjun,0,66,50,50
1650460275443,CSE 134B,A01,083661,Powell; Thomas Allan,0,32,65,65
1650460281467,CSE 140,A01,083663,Staff,0,2,75,75
1650460287497,CSE 140L,A01,083088,Eldon; John,0,8,75,75
1650460293523,CSE 175,A01,083665,Kumar; Rakesh,7,0,25,18
1650460299548,CSE 190,A00,092507,Dubnov; Shlomo,14,0,20,6
1650460305574,ECE 45,A01,083139,Staff,0,18,40,40
1650460311598,ECE 65,A50,083695,Staff,0,6,30,30
1650460317632,ECE 109,A01,091882,Touri; Behrouz,38,0,70,32
1650460323658,ECE 180,A00,083140,Abi Samra; Nicholas Camill,23,0,30,7
1650460323658,ECE 180,B00,083141,Abi Samra; Nicholas Camill,0,0,30,30
1650460329692,MATH 10A,A01,083735,Patchell; Gregory David,7,0,30,23
1650460329692,MATH 10A,A02,083736,Patchell; Gregory David,28,0,30,2
1650460329692,MATH 10A,A03,083737,Patchell; Gregory David,25,0,30,5
1650460335722,MATH 10B,A01,083207,Staff,0,7,30,30
1650460335722,MATH 10B,A02,083208,Staff,0,7,30,30
1650460335722,MATH 10B,B01,083739,Staff,13,0,30,17
1650460335722,MATH 10B,B02,083740,Staff,28,0,30,2
1650460341752,MATH 18,A01,083743,Staff,1,0,30,29
1650460341752,MATH 18,A02,083744,Staff,27,0,30,3
1650460341752,MATH 18,A03,083745,Staff,22,0,30,8
1650460341752,MATH 18,A04,083746,Staff,26,0,30,4
1650460341752,MATH 18,B01,083748,Staff,0,11,30,30
1650460341752,MATH 18,B02,083749,Staff,0,12,30,30
1650460341752,MATH 18,B03,083750,Staff,0,11,30,30
1650460341752,MATH 18,B04,083751,Staff,0,12,30,30
1650460347775,MATH 20A,A01,083754,Staff,25,0,40,15
1650460353800,MATH 20B,A01,083756,Staff,0,10,30,30
1650460353800,MATH 20B,A02,083757,Staff,0,10,30,30
1650460359824,MATH 20C,A01,083760,Staff,0,15,30,30
1650460359824,MATH 20C,A02,083761,Staff,1,14,30,29
1650460359824,MATH 20C,B01,083762,Staff,13,0,30,17
1650460359824,MATH 20C,B02,083763,Staff,28,0,30,2
1650460365848,MATH 20D,A01,083765,Staff,0,1,30,30
1650460365848,MATH 20D,A02,083766,Staff,9,0,30,21
1650460365848,MATH 20D,A03,083767,Staff,25,0,30,5
1650460371880,MATH 20E,A01,083771,Staff,6,0,30,24
1650460371880,MATH 20E,A02,083772,Staff,18,0,30,12
1650460371880,MATH 20E,B01,083773,Staff,0,0,30,30
1650460371880,MATH 20E,B02,083774,Staff,10,0,30,20
1650460377913,MATH 103A,A01,083777,Staff,0,12,30,30
1650460377913,MATH 103A,A02,083778,Staff,0,12,30,30
1650460377913,MATH 103A,B01,083779,Staff,0,13,30,30
1650460377913,MATH 103A,B02,083780,Staff,0,12,30,30
1650460383944,MATH 105,A01,085443,Staff,0,23,30,30
1650460389994,MATH 109,A01,083213,Anzaldo; Leesa B,0,7,30,30
1650460389994,MATH 109,A02,083214,Anzaldo; Leesa B,0,7,30,30
1650460389994,MATH 109,B01,083215,Anzaldo; Leesa B,0,5,30,30
1650460389994,MATH 109,B02,083216,Anzaldo; Leesa B,0,6,30,30
1650460396021,MATH 142A,A01,083219,Chow; Bennett,0,14,30,30
1650460396021,MATH 142A,A02,083220,Chow; Bennett,0,13,30,30
1650460396021,MATH 142A,B01,083221,Chow; Bennett,0,12,30,30
1650460396021,MATH 142A,B02,083222,Chow; Bennett,0,13,30,30
1650460402058,MATH 193A,A01,083224,Staff,0,5,30,30
1650460402058,MATH 193A,A02,083225,Staff,0,5,30,30
1650460402058,MATH 193A,A03,083781,Staff,0,4,30,30
1650460402058,MATH 193A,A04,083782,Staff,0,5,30,30
1650460408087,MATH 197,001,091859,McAuley; Julian John,9998,0,9999,1
1650460414156,COGS 9,A01,083615,Staff,0,14,60,60
1650460420185,COGS 11,A01,083617,Boyle; Mary E. T.,21,0,40,19
1650460426214,COGS 13,A01,083071,Staff,0,34,40,40
1650460432243,COGS 14A,A01,092681,Staff,1,25,100,99
1650460438267,COGS 14B,A01,083073,Cheng; Tzu-Han,0,11,50,50
1650460444297,COGS 17,A01,092677,Staff,22,0,75,53
1650460450328,COGS 100,A01,083619,Staff,0,26,60,60
1650460456356,COGS 101A,A01,083621,Davis; Joshua Daniel,0,21,60,60
1650460462386,COGS 101B,A01,091572,Staff,0,4,60,60
1650460468411,COGS 101C,A01,083625,Delgado; Tania,16,0,30,14
1650460474439,COGS 107A,A01,083627,Boyle; Mary E. T.,0,11,60,60
1650460480466,COGS 118A,A01,083075,Staff,2,0,60,58
1650460486492,CSE 3,A50,083646,Miranda; Gregory Joseph,20,0,38,18
1650460486492,CSE 3,A51,083647,Miranda; Gregory Joseph,36,0,37,1
1650460492518,CSE 8A,A50,083650,Miranda; Gregory Joseph,0,28,40,40
1650460498544,CSE 11,A01,083080,Cao; Yingjun,0,92,40,40
1650460504576,CSE 12,A01,083652,Staff,0,16,100,100
1650460510600,CSE 15L,A01,083654,Staff,0,1,50,50
1650460510600,CSE 15L,A02,083655,Staff,1,0,50,49
1650460516630,CSE 20,A01,083657,Staff,51,0,80,29
1650460522656,CSE 30,A01,083084,Eldon; John,0,76,40,40
1650460528699,CSE 100,A01,083659,Cao; Yingjun,0,66,50,50
1650460534723,CSE 134B,A01,083661,Powell; Thomas Allan,0,32,65,65
1650460540748,CSE 140,A01,083663,Staff,0,2,75,75
1650460546779,CSE 140L,A01,083088,Eldon; John,0,8,75,75
1650460552804,CSE 175,A01,083665,Kumar; Rakesh,7,0,25,18
1650460558830,CSE 190,A00,092507,Dubnov; Shlomo,14,0,20,6
1650460564867,ECE 45,A01,083139,Staff,0,18,40,40
1650460570896,ECE 65,A50,083695,Staff,0,6,30,30
1650460576922,ECE 109,A01,091882,Touri; Behrouz,38,0,70,32
1650460582950,ECE 180,A00,083140,Abi Samra; Nicholas Camill,23,0,30,7
1650460582950,ECE 180,B00,083141,Abi Samra; Nicholas Camill,0,0,30,30
1650460588991,MATH 10A,A01,083735,Patchell; Gregory David,7,0,30,23
1650460588991,MATH 10A,A02,083736,Patchell; Gregory David,28,0,30,2
1650460588991,MATH 10A,A03,083737,Patchell; Gregory David,25,0,30,5
1650460595020,MATH 10B,A01,083207,Staff,0,7,30,30
1650460595020,MATH 10B,A02,083208,Staff,0,7,30,30
1650460595020,MATH 10B,B01,083739,Staff,13,0,30,17
1650460595020,MATH 10B,B02,083740,Staff,28,0,30,2
1650460601055,MATH 18,A01,083743,Staff,1,0,30,29
1650460601055,MATH 18,A02,083744,Staff,27,0,30,3
1650460601055,MATH 18,A03,083745,Staff,22,0,30,8
1650460601055,MATH 18,A04,083746,Staff,26,0,30,4
1650460601055,MATH 18,B01,083748,Staff,0,11,30,30
1650460601055,MATH 18,B02,083749,Staff,0,12,30,30
1650460601055,MATH 18,B03,083750,Staff,0,11,30,30
1650460601055,MATH 18,B04,083751,Staff,0,12,30,30
1650460607080,MATH 20A,A01,083754,Staff,25,0,40,15
1650460613110,MATH 20B,A01,083756,Staff,0,10,30,30
1650460613110,MATH 20B,A02,083757,Staff,0,10,30,30
1650460619137,MATH 20C,A01,083760,Staff,0,15,30,30
1650460619137,MATH 20C,A02,083761,Staff,1,14,30,29
1650460619137,MATH 20C,B01,083762,Staff,13,0,30,17
1650460619137,MATH 20C,B02,083763,Staff,28,0,30,2
1650460625162,MATH 20D,A01,083765,Staff,0,1,30,30
1650460625162,MATH 20D,A02,083766,Staff,9,0,30,21
1650460625162,MATH 20D,A03,083767,Staff,25,0,30,5
1650460631195,MATH 20E,A01,083771,Staff,6,0,30,24
1650460631195,MATH 20E,A02,083772,Staff,18,0,30,12
1650460631195,MATH 20E,B01,083773,Staff,0,0,30,30
1650460631195,MATH 20E,B02,083774,Staff,10,0,30,20
1650460637220,MATH 103A,A01,083777,Staff,0,12,30,30
1650460637220,MATH 103A,A02,083778,Staff,0,12,30,30
1650460637220,MATH 103A,B01,083779,Staff,0,13,30,30
1650460637220,MATH 103A,B02,083780,Staff,0,12,30,30
1650460643251,MATH 105,A01,085443,Staff,0,23,30,30
1650460649282,MATH 109,A01,083213,Anzaldo; Leesa B,0,7,30,30
1650460649282,MATH 109,A02,083214,Anzaldo; Leesa B,0,7,30,30
1650460649282,MATH 109,B01,083215,Anzaldo; Leesa B,0,5,30,30
1650460649282,MATH 109,B02,083216,Anzaldo; Leesa B,0,6,30,30
1650460655314,MATH 142A,A01,083219,Chow; Bennett,0,14,30,30
1650460655314,MATH 142A,A02,083220,Chow; Bennett,0,13,30,30
1650460655314,MATH 142A,B01,083221,Chow; Bennett,0,12,30,30
1650460655314,MATH 142A,B02,083222,Chow; Bennett,0,13,30,30
1650460661857,MATH 193A,A01,083224,Staff,0,5,30,30
1650460661857,MATH 193A,A02,083225,Staff,0,5,30,30
1650460661857,MATH 193A,A03,083781,Staff,0,4,30,30
1650460661857,MATH 193A,A04,083782,Staff,0,5,30,30
1650460667884,MATH 197,001,091859,McAuley; Julian John,9998,0,9999,1
1650460673942,COGS 9,A01,083615,Staff,0,14,60,60
1650460679972,COGS 11,A01,083617,Boyle; Mary E. T.,21,0,40,19
1650460685997,COGS 13,A01,083071,Staff,0,34,40,40
1650460692025,COGS 14A,A01,092681,Staff,1,25,100,99
1650460698050,COGS 14B,A01,083073,Cheng; Tzu-Han,0,11,50,50
1650460704075,COGS 17,A01,092677,Staff,22,0,75,53
1650460710099,COGS 100,A01,083619,Staff,0,26,60,60
1650460716126,COGS 101A,A01,083621,Davis; Joshua Daniel,0,21,60,60
1650460722154,COGS 101B,A01,091572,Staff,0,4,60,60
1650460728181,COGS 101C,A01,083625,Delgado; Tania,16,0,30,14
1650460734205,COGS 107A,A01,083627,Boyle; Mary E. T.,0,11,60,60
1650460740234,COGS 118A,A01,083075,Staff,2,0,60,58
1650460746261,CSE 3,A50,083646,Miranda; Gregory Joseph,20,0,38,18
1650460746261,CSE 3,A51,083647,Miranda; Gregory Joseph,36,0,37,1
1650460752292,CSE 8A,A50,083650,Miranda; Gregory Joseph,0,28,40,40
1650460758319,CSE 11,A01,083080,Cao; Yingjun,0,92,40,40
1650460764350,CSE 12,A01,083652,Staff,0,16,100,100
1650460770378,CSE 15L,A01,083654,Staff,0,1,50,50
1650460770378,CSE 15L,A02,083655,Staff,1,0,50,49
1650460776405,CSE 20,A01,083657,Staff,51,0,80,29
1650460782435,CSE 30,A01,083084,Eldon; John,0,76,40,40
1650460788462,CSE 100,A01,083659,Cao; Yingjun,0,66,50,50
1650460794561,CSE 134B,A01,083661,Powell; Thomas Allan,0,32,65,65
1650460800590,CSE 140,A01,083663,Staff,0,2,75,75
1650460806616,CSE 140L,A01,083088,Eldon; John,0,8,75,75
1650460812640,CSE 175,A01,083665,Kumar; Rakesh,7,0,25,18
1650460818670,CSE 190,A00,092507,Dubnov; Shlomo,14,0,20,6
1650460824696,ECE 45,A01,083139,Staff,0,18,40,40
1650460830722,ECE 65,A50,083695,Staff,0,6,30,30
1650460836753,ECE 109,A01,091882,Touri; Behrouz,38,0,70,32
1650460842776,ECE 180,A00,083140,Abi Samra; Nicholas Camill,23,0,30,7
1650460842776,ECE 180,B00,083141,Abi Samra; Nicholas Camill,0,0,30,30
1650460848806,MATH 10A,A01,083735,Patchell; Gregory David,7,0,30,23
1650460848806,MATH 10A,A02,083736,Patchell; Gregory David,28,0,30,2
1650460848806,MATH 10A,A03,083737,Patchell; Gregory David,25,0,30,5
1650460854833,MATH 10B,A01,083207,Staff,0,7,30,30
1650460854833,MATH 10B,A02,083208,Staff,0,7,30,30
1650460854833,MATH 10B,B01,083739,Staff,13,0,30,17
1650460854833,MATH 10B,B02,083740,Staff,28,0,30,2
1650460860871,MATH 18,A01,083743,Staff,1,0,30,29
1650460860871,MATH 18,A02,083744,Staff,27,0,30,3
1650460860871,MATH 18,A03,083745,Staff,22,0,30,8
1650460860871,MATH 18,A04,083746,Staff,26,0,30,4
1650460860871,MATH 18,B01,083748,Staff,0,11,30,30
1650460860871,MATH 18,B02,083749,Staff,0,12,30,30
1650460860871,MATH 18,B03,083750,Staff,0,11,30,30
1650460860871,MATH 18,B04,083751,Staff,0,12,30,30
1650460866903,MATH 20A,A01,083754,Staff,25,0,40,15
1650460872935,MATH 20B,A01,083756,Staff,0,10,30,30
1650460872935,MATH 20B,A02,083757,Staff,0,10,30,30
1650460878971,MATH 20C,A01,083760,Staff,0,15,30,30
1650460878971,MATH 20C,A02,083761,Staff,1,14,30,29
1650460878971,MATH 20C,B01,083762,Staff,13,0,30,17
1650460878971,MATH 20C,B02,083763,Staff,28,0,30,2
1650460884996,MATH 20D,A01,083765,Staff,0,1,30,30
1650460884996,MATH 20D,A02,083766,Staff,9,0,30,21
1650460884996,MATH 20D,A03,083767,Staff,25,0,30,5
1650460891024,MATH 20E,A01,083771,Staff,6,0,30,24
1650460891024,MATH 20E,A02,083772,Staff,18,0,30,12
1650460891024,MATH 20E,B01,083773,Staff,0,0,30,30
1650460891024,MATH 20E,B02,083774,Staff,10,0,30,20
1650460897053,MATH 103A,A01,083777,Staff,0,12,30,30
1650460897053,MATH 103A,A02,083778,Staff,0,12,30,30
1650460897053,MATH 103A,B01,083779,Staff,0,13,30,30
1650460897053,MATH 103A,B02,083780,Staff,0,12,30,30
1650460903083,MATH 105,A01,085443,Staff,0,23,30,30
1650460909115,MATH 109,A01,083213,Anzaldo; Leesa B,0,7,30,30
1650460909115,MATH 109,A02,083214,Anzaldo; Leesa B,0,7,30,30
1650460909115,MATH 109,B01,083215,Anzaldo; Leesa B,0,5,30,30
1650460909115,MATH 109,B02,083216,Anzaldo; Leesa B,0,6,30,30
1650460915152,MATH 142A,A01,083219,Chow; Bennett,0,14,30,30
1650460915152,MATH 142A,A02,083220,Chow; Bennett,0,13,30,30
1650460915152,MATH 142A,B01,083221,Chow; Bennett,0,12,30,30
1650460915152,MATH 142A,B02,083222,Chow; Bennett,0,13,30,30
1650460921184,MATH 193A,A01,083224,Staff,0,5,30,30
1650460921184,MATH 193A,A02,083225,Staff,0,5,30,30
1650460921184,MATH 193A,A03,083781,Staff,0,4,30,30
1650460921184,MATH 193A,A04,083782,Staff,0,5,30,30
1650460927210,MATH 197,001,091859,McAuley; Julian John,9998,0,9999,1
1650460933272,COGS 9,A01,083615,Staff,0,14,60,60
1650460939297,COGS 11,A01,083617,Boyle; Mary E. T.,21,0,40,19
1650460945329,COGS 13,A01,083071,Staff,0,34,40,40
1650460951358,COGS 14A,A01,092681,Staff,1,25,100,99
1650460957384,COGS 14B,A01,083073,Cheng; Tzu-Han,0,11,50,50
1650460963408,COGS 17,A01,092677,Staff,22,0,75,53
1650460969439,COGS 100,A01,083619,Staff,0,26,60,60
1650460975470,COGS 101A,A01,083621,Davis; Joshua Daniel,0,21,60,60
1650460981501,COGS 101B,A01,091572,Staff,0,4,60,60
1650460987528,COGS 101C,A01,083625,Delgado; Tania,16,0,30,14
1650460993552,COGS 107A,A01,083627,Boyle; Mary E. T.,0,11,60,60
1650460999578,COGS 118A,A01,083075,Staff,2,0,60,58
1650461005605,CSE 3,A50,083646,Miranda; Gregory Joseph,20,0,38,18
1650461005605,CSE 3,A51,083647,Miranda; Gregory Joseph,36,0,37,1
1650461011635,CSE 8A,A50,083650,Miranda; Gregory Joseph,0,28,40,40
1650461017660,CSE 11,A01,083080,Cao; Yingjun,0,92,40,40
1650461023692,CSE 12,A01,083652,Staff,0,16,100,100
1650461029725,CSE 15L,A01,083654,Staff,0,1,50,50
1650461029725,CSE 15L,A02,083655,Staff,1,0,50,49
1650461035753,CSE 20,A01,083657,Staff,51,0,80,29
1650461041781,CSE 30,A01,083084,Eldon; John,0,76,40,40
1650461047806,CSE 100,A01,083659,Cao; Yingjun,0,66,50,50
1650461053838,CSE 134B,A01,083661,Powell; Thomas Allan,0,32,65,65
1650461059866,CSE 140,A01,083663,Staff,0,2,75,75
1650461065897,CSE 140L,A01,083088,Eldon; John,0,8,75,75
1650461071921,CSE 175,A01,083665,Kumar; Rakesh,7,0,25,18
1650461077946,CSE 190,A00,092507,Dubnov; Shlomo,14,0,20,6
1650461083975,ECE 45,A01,083139,Staff,0,18,40,40
1650461090004,ECE 65,A50,083695,Staff,0,6,30,30
1650461096031,ECE 109,A01,091882,Touri; Behrouz,38,0,70,32
1650461102057,ECE 180,A00,083140,Abi Samra; Nicholas Camill,23,0,30,7
1650461102057,ECE 180,B00,083141,Abi Samra; Nicholas Camill,0,0,30,30
1650461108083,MATH 10A,A01,083735,Patchell; Gregory David,7,0,30,23
1650461108083,MATH 10A,A02,083736,Patchell; Gregory David,28,0,30,2
1650461108083,MATH 10A,A03,083737,Patchell; Gregory David,25,0,30,5
1650461114109,MATH 10B,A01,083207,Staff,0,7,30,30
1650461114109,MATH 10B,A02,083208,Staff,0,7,30,30
1650461114109,MATH 10B,B01,083739,Staff,13,0,30,17
1650461114109,MATH 10B,B02,083740,Staff,28,0,30,2
1650461120135,MATH 18,A01,083743,Staff,1,0,30,29
1650461120135,MATH 18,A02,083744,Staff,27,0,30,3
1650461120135,MATH 18,A03,083745,Staff,22,0,30,8
1650461120135,MATH 18,A04,083746,Staff,26,0,30,4
1650461120135,MATH 18,B01,083748,Staff,0,11,30,30
1650461120135,MATH 18,B02,083749,Staff,0,12,30,30
1650461120135,MATH 18,B03,083750,Staff,0,11,30,30
1650461120135,MATH 18,B04,083751,Staff,0,12,30,30
1650461126158,MATH 20A,A01,083754,Staff,25,0,40,15
1650461132183,MATH 20B,A01,083756,Staff,0,10,30,30
1650461132183,MATH 20B,A02,083757,Staff,0,10,30,30
1650461138213,MATH 20C,A01,083760,Staff,0,15,30,30
1650461138213,MATH 20C,A02,083761,Staff,1,14,30,29
1650461138213,MATH 20C,B01,083762,Staff,13,0,30,17
1650461138213,MATH 20C,B02,083763,Staff,28,0,30,2
1650461144240,MATH 20D,A01,083765,Staff,0,1,30,30
1650461144240,MATH 20D,A02,083766,Staff,9,0,30,21
1650461144240,MATH 20D,A03,083767,Staff,25,0,30,5
1650461150266,MATH 20E,A01,083771,Staff,6,0,30,24
1650461150266,MATH 20E,A02,083772,Staff,18,0,30,12
1650461150266,MATH 20E,B01,083773,Staff,0,0,30,30
1650461150266,MATH 20E,B02,083774,Staff,10,0,30,20
1650461156291,MATH 103A,A01,083777,Staff,0,12,30,30
1650461156291,MATH 103A,A02,083778,Staff,0,12,30,30
1650461156291,MATH 103A,B01,083779,Staff,0,13,30,30
1650461156291,MATH 103A,B02,083780,Staff,0,12,30,30
1650461162317,MATH 105,A01,085443,Staff,0,23,30,30
1650461168348,MATH 109,A01,083213,Anzaldo; Leesa B,0,7,30,30
1650461168348,MATH 109,A02,083214,Anzaldo; Leesa B,0,7,30,30
1650461168348,MATH 109,B01,083215,Anzaldo; Leesa B,0,5,30,30
1650461168348,MATH 109,B02,083216,Anzaldo; Leesa B,0,6,30,30
1650461174375,MATH 142A,A01,083219,Chow; Bennett,0,14,30,30
1650461174375,MATH 142A,A02,083220,Chow; Bennett,0,13,30,30
1650461174375,MATH 142A,B01,083221,Chow; Bennett,0,12,30,30
1650461174375,MATH 142A,B02,083222,Chow; Bennett,0,13,30,30
1650461184884,MATH 193A,A01,083224,Staff,0,5,30,30
1650461184884,MATH 193A,A02,083225,Staff,0,5,30,30
1650461184884,MATH 193A,A03,083781,Staff,0,4,30,30
1650461184884,MATH 193A,A04,083782,Staff,0,5,30,30
1650461190909,MATH 197,001,091859,McAuley; Julian John,9998,0,9999,1
1650461196960,COGS 9,A01,083615,Staff,0,14,60,60
1650461202985,COGS 11,A01,083617,Boyle; Mary E. T.,21,0,40,19
1650461209012,COGS 13,A01,083071,Staff,0,34,40,40
1650461215041,COGS 14A,A01,092681,Staff,1,25,100,99
1650461221071,COGS 14B,A01,083073,Cheng; Tzu-Han,0,11,50,50
1650461227097,COGS 17,A01,092677,Staff,22,0,75,53
1650461233121,COGS 100,A01,083619,Staff,0,26,60,60
1650461239149,COGS 101A,A01,083621,Davis; Joshua Daniel,0,21,60,60
1650461245177,COGS 101B,A01,091572,Staff,0,4,60,60
1650461251206,COGS 101C,A01,083625,Delgado; Tania,16,0,30,14
1650461257230,COGS 107A,A01,083627,Boyle; Mary E. T.,0,11,60,60
1650461263255,COGS 118A,A01,083075,Staff,2,0,60,58
1650461269285,CSE 3,A50,083646,Miranda; Gregory Joseph,20,0,38,18
1650461269285,CSE 3,A51,083647,Miranda; Gregory Joseph,36,0,37,1
1650461275318,CSE 8A,A50,083650,Miranda; Gregory Joseph,0,28,40,40
1650461281348,CSE 11,A01,083080,Cao; Yingjun,0,92,40,40
1650461287372,CSE 12,A01,083652,Staff,0,16,100,100
1650461293396,CSE 15L,A01,083654,Staff,0,1,50,50
1650461293396,CSE 15L,A02,083655,Staff,1,0,50,49
1650461299425,CSE 20,A01,083657,Staff,51,0,80,29
1650461305450,CSE 30,A01,083084,Eldon; John,0,76,40,40
1650461311478,CSE 100,A01,083659,Cao; Yingjun,0,66,50,50
1650461317504,CSE 134B,A01,083661,Powell; Thomas Allan,0,32,65,65
1650461323527,CSE 140,A01,083663,Staff,0,2,75,75
1650461329552,CSE 140L,A01,083088,Eldon; John,0,8,75,75
1650461335576,CSE 175,A01,083665,Kumar; Rakesh,7,0,25,18
1650461341600,CSE 190,A00,092507,Dubnov; Shlomo,14,0,20,6
1650461347634,ECE 45,A01,083139,Staff,0,18,40,40
1650461353663,ECE 65,A50,083695,Staff,0,6,30,30
1650461359691,ECE 109,A01,091882,Touri; Behrouz,38,0,70,32
1650461365727,ECE 180,A00,083140,Abi Samra; Nicholas Camill,23,0,30,7
1650461365727,ECE 180,B00,083141,Abi Samra; Nicholas Camill,0,0,30,30
1650461371753,MATH 10A,A01,083735,Patchell; Gregory David,7,0,30,23
1650461371753,MATH 10A,A02,083736,Patchell; Gregory David,28,0,30,2
1650461371753,MATH 10A,A03,083737,Patchell; Gregory David,25,0,30,5
1650461377783,MATH 10B,A01,083207,Staff,0,7,30,30
1650461377783,MATH 10B,A02,083208,Staff,0,7,30,30
1650461377783,MATH 10B,B01,083739,Staff,13,0,30,17
1650461377783,MATH 10B,B02,083740,Staff,28,0,30,2
1650461383809,MATH 18,A01,083743,Staff,1,0,30,29
1650461383809,MATH 18,A02,083744,Staff,27,0,30,3
1650461383809,MATH 18,A03,083745,Staff,22,0,30,8
1650461383809,MATH 18,A04,083746,Staff,26,0,30,4
1650461383809,MATH 18,B01,083748,Staff,0,11,30,30
1650461383809,MATH 18,B02,083749,Staff,0,12,30,30
1650461383809,MATH 18,B03,083750,Staff,0,11,30,30
1650461383809,MATH 18,B04,083751,Staff,0,12,30,30
1650461389837,MATH 20A,A01,083754,Staff,25,0,40,15
1650461395934,MATH 20B,A01,083756,Staff,0,10,30,30
1650461395934,MATH 20B,A02,083757,Staff,0,10,30,30
1650461401963,MATH 20C,A01,083760,Staff,0,15,30,30
1650461401963,MATH 20C,A02,083761,Staff,1,14,30,29
1650461401963,MATH 20C,B01,083762,Staff,13,0,30,17
1650461401963,MATH 20C,B02,083763,Staff,28,0,30,2
1650461407991,MATH 20D,A01,083765,Staff,0,1,30,30
1650461407991,MATH 20D,A02,083766,Staff,9,0,30,21
1650461407991,MATH 20D,A03,083767,Staff,25,0,30,5
1650461414021,MATH 20E,A01,083771,Staff,6,0,30,24
1650461414021,MATH 20E,A02,083772,Staff,18,0,30,12
1650461414021,MATH 20E,B01,083773,Staff,0,0,30,30
1650461414021,MATH 20E,B02,083774,Staff,10,0,30,20
1650461420050,MATH 103A,A01,083777,Staff,0,12,30,30
1650461420050,MATH 103A,A02,083778,Staff,0,12,30,30
1650461420050,MATH 103A,B01,083779,Staff,0,13,30,30
1650461420050,MATH 103A,B02,083780,Staff,0,12,30,30
1650461426075,MATH 105,A01,085443,Staff,0,23,30,30
1650461432149,MATH 109,A01,083213,Anzaldo; Leesa B,0,7,30,30
1650461432149,MATH 109,A02,083214,Anzaldo; Leesa B,0,7,30,30
1650461432149,MATH 109,B01,083215,Anzaldo; Leesa B,0,5,30,30
1650461432149,MATH 109,B02,083216,Anzaldo; Leesa B,0,6,30,30
1650461438177,MATH 142A,A01,083219,Chow; Bennett,0,14,30,30
1650461438177,MATH 142A,A02,083220,Chow; Bennett,0,13,30,30
1650461438177,MATH 142A,B01,083221,Chow; Bennett,0,12,30,30
1650461438177,MATH 142A,B02,083222,Chow; Bennett,0,13,30,30
1650461444206,MATH 193A,A01,083224,Staff,0,5,30,30
1650461444206,MATH 193A,A02,083225,Staff,0,5,30,30
1650461444206,MATH 193A,A03,083781,Staff,0,4,30,30
1650461444206,MATH 193A,A04,083782,Staff,0,5,30,30
1650461450230,MATH 197,001,091859,McAuley; Julian John,9998,0,9999,1
1650461456284,COGS 9,A01,083615,Staff,0,14,60,60
1650461462312,COGS 11,A01,083617,Boyle; Mary E. T.,21,0,40,19
1650461468344,COGS 13,A01,083071,Staff,0,34,40,40
1650461474373,COGS 14A,A01,092681,Staff,1,25,100,99
1650461480398,COGS 14B,A01,083073,Cheng; Tzu-Han,0,11,50,50
1650461486421,COGS 17,A01,092677,Staff,22,0,75,53
1650461492449,COGS 100,A01,083619,Staff,0,26,60,60
1650461498477,COGS 101A,A01,083621,Davis; Joshua Daniel,0,21,60,60
1650461504502,COGS 101B,A01,091572,Staff,0,4,60,60
1650461510525,COGS 101C,A01,083625,Delgado; Tania,16,0,30,14
1650461516550,COGS 107A,A01,083627,Boyle; Mary E. T.,0,11,60,60
1650461522582,COGS 118A,A01,083075,Staff,2,0,60,58
1650461528606,CSE 3,A50,083646,Miranda; Gregory Joseph,20,0,38,18
1650461528606,CSE 3,A51,083647,Miranda; Gregory Joseph,36,0,37,1
1650461534635,CSE 8A,A50,083650,Miranda; Gregory Joseph,0,28,40,40
1650461540660,CSE 11,A01,083080,Cao; Yingjun,0,92,40,40
1650461546687,CSE 12,A01,083652,Staff,0,16,100,100
1650461552711,CSE 15L,A01,083654,Staff,0,1,50,50
1650461552711,CSE 15L,A02,083655,Staff,1,0,50,49
1650461558734,CSE 20,A01,083657,Staff,51,0,80,29
1650461564761,CSE 30,A01,083084,Eldon; John,0,76,40,40
1650461570789,CSE 100,A01,083659,Cao; Yingjun,0,66,50,50
1650461576817,CSE 134B,A01,083661,Powell; Thomas Allan,0,32,65,65
1650461582844,CSE 140,A01,083663,Staff,0,2,75,75
1650461588871,CSE 140L,A01,083088,Eldon; John,0,8,75,75
1650461594894,CSE 175,A01,083665,Kumar; Rakesh,7,0,25,18
1650461600920,CSE 190,A00,092507,Dubnov; Shlomo,14,0,20,6
1650461606943,ECE 45,A01,083139,Staff,0,18,40,40
1650461612966,ECE 65,A50,083695,Staff,0,6,30,30
1650461618991,ECE 109,A01,091882,Touri; Behrouz,38,0,70,32
1650461625015,ECE 180,A00,083140,Abi Samra; Nicholas Camill,23,0,30,7
1650461625015,ECE 180,B00,083141,Abi Samra; Nicholas Camill,0,0,30,30
1650461631044,MATH 10A,A01,083735,Patchell; Gregory David,7,0,30,23
1650461631044,MATH 10A,A02,083736,Patchell; Gregory David,28,0,30,2
1650461631044,MATH 10A,A03,083737,Patchell; Gregory David,25,0,30,5
1650461637070,MATH 10B,A01,083207,Staff,0,7,30,30
1650461637070,MATH 10B,A02,083208,Staff,0,7,30,30
1650461637070,MATH 10B,B01,083739,Staff,13,0,30,17
1650461637070,MATH 10B,B02,083740,Staff,28,0,30,2
1650461643104,MATH 18,A01,083743,Staff,1,0,30,29
1650461643104,MATH 18,A02,083744,Staff,27,0,30,3
1650461643104,MATH 18,A03,083745,Staff,22,0,30,8
1650461643104,MATH 18,A04,083746,Staff,26,0,30,4
1650461643104,MATH 18,B01,083748,Staff,0,11,30,30
1650461643104,MATH 18,B02,083749,Staff,0,12,30,30
1650461643104,MATH 18,B03,083750,Staff,0,11,30,30
1650461643104,MATH 18,B04,083751,Staff,0,12,30,30
1650461649126,MATH 20A,A01,083754,Staff,25,0,40,15
1650461655155,MATH 20B,A01,083756,Staff,0,10,30,30
1650461655155,MATH 20B,A02,083757,Staff,0,10,30,30
1650461661187,MATH 20C,A01,083760,Staff,0,15,30,30
1650461661187,MATH 20C,A02,083761,Staff,1,14,30,29
1650461661187,MATH 20C,B01,083762,Staff,13,0,30,17
1650461661187,MATH 20C,B02,083763,Staff,28,0,30,2
1650461667215,MATH 20D,A01,083765,Staff,0,1,30,30
1650461667215,MATH 20D,A02,083766,Staff,9,0,30,21
1650461667215,MATH 20D,A03,083767,Staff,25,0,30,5
1650461673238,MATH 20E,A01,083771,Staff,6,0,30,24
1650461673238,MATH 20E,A02,083772,Staff,18,0,30,12
1650461673238,MATH 20E,B01,083773,Staff,0,0,30,30
1650461673238,MATH 20E,B02,083774,Staff,10,0,30,20
1650461679279,MATH 103A,A01,083777,Staff,0,12,30,30
1650461679279,MATH 103A,A02,083778,Staff,0,12,30,30
1650461679279,MATH 103A,B01,083779,Staff,0,13,30,30
1650461679279,MATH 103A,B02,083780,Staff,0,12,30,30
1650461685302,MATH 105,A01,085443,Staff,0,23,30,30
1650461691337,MATH 109,A01,083213,Anzaldo; Leesa B,0,7,30,30
1650461691337,MATH 109,A02,083214,Anzaldo; Leesa B,0,7,30,30
1650461691337,MATH 109,B01,083215,Anzaldo; Leesa B,0,5,30,30
1650461691337,MATH 109,B02,083216,Anzaldo; Leesa B,0,6,30,30
1650461697366,MATH 142A,A01,083219,Chow; Bennett,0,14,30,30
1650461697366,MATH 142A,A02,083220,Chow; Bennett,0,13,30,30
1650461697366,MATH 142A,B01,083221,Chow; Bennett,0,12,30,30
1650461697366,MATH 142A,B02,083222,Chow; Bennett,0,13,30,30
1650461703390,MATH 193A,A01,083224,Staff,0,5,30,30
1650461703390,MATH 193A,A02,083225,Staff,0,5,30,30
1650461703390,MATH 193A,A03,083781,Staff,0,4,30,30
1650461703390,MATH 193A,A04,083782,Staff,0,5,30,30
1650461709425,MATH 197,001,091859,McAuley; Julian John,9998,0,9999,1
1650461715494,COGS 9,A01,083615,Staff,0,14,60,60
1650461721524,COGS 11,A01,083617,Boyle; Mary E. T.,21,0,40,19
1650461727567,COGS 13,A01,083071,Staff,0,34,40,40
1650461733593,COGS 14A,A01,092681,Staff,1,25,100,99
1650461739616,COGS 14B,A01,083073,Cheng; Tzu-Han,0,11,50,50
1650461745646,COGS 17,A01,092677,Staff,22,0,75,53
1650461751671,COGS 100,A01,083619,Staff,0,26,60,60
1650461757701,COGS 101A,A01,083621,Davis; Joshua Daniel,0,21,60,60
1650461763732,COGS 101B,A01,091572,Staff,0,4,60,60
1650461769754,COGS 101C,A01,083625,Delgado; Tania,16,0,30,14
1650461775782,COGS 107A,A01,083627,Boyle; Mary E. T.,0,11,60,60
1650461781804,COGS 118A,A01,083075,Staff,2,0,60,58
1650461787874,CSE 3,A50,083646,Miranda; Gregory Joseph,20,0,38,18
1650461787874,CSE 3,A51,083647,Miranda; Gregory Joseph,36,0,37,1
1650461793900,CSE 8A,A50,083650,Miranda; Gregory Joseph,0,28,40,40
1650461799923,CSE 11,A01,083080,Cao; Yingjun,0,92,40,40
1650461805947,CSE 12,A01,083652,Staff,0,16,100,100
1650461811976,CSE 15L,A01,083654,Staff,0,1,50,50
1650461811976,CSE 15L,A02,083655,Staff,1,0,50,49
1650461818002,CSE 20,A01,083657,Staff,51,0,80,29
1650461824028,CSE 30,A01,083084,Eldon; John,0,76,40,40
1650461830054,CSE 100,A01,083659,Cao; Yingjun,0,66,50,50
1650461836086,CSE 134B,A01,083661,Powell; Thomas Allan,0,32,65,65
1650461842112,CSE 140,A01,083663,Staff,0,2,75,75
1650461848138,CSE 140L,A01,083088,Eldon; John,0,8,75,75
1650461854165,CSE 175,A01,083665,Kumar; Rakesh,7,0,25,18
1650461860201,CSE 190,A00,092507,Dubnov; Shlomo,14,0,20,6
1650461866225,ECE 45,A01,083139,Staff,0,18,40,40
1650461872250,ECE 65,A50,083695,Staff,0,6,30,30
1650461878273,ECE 109,A01,091882,Touri; Behrouz,38,0,70,32
1650461884297,ECE 180,A00,083140,Abi Samra; Nicholas Camill,23,0,30,7
1650461884297,ECE 180,B00,083141,Abi Samra; Nicholas Camill,0,0,30,30
1650461890327,MATH 10A,A01,083735,Patchell; Gregory David,7,0,30,23
1650461890327,MATH 10A,A02,083736,Patchell; Gregory David,28,0,30,2
1650461890327,MATH 10A,A03,083737,Patchell; Gregory David,25,0,30,5
1650461896355,MATH 10B,A01,083207,Staff,0,7,30,30
1650461896355,MATH 10B,A02,083208,Staff,0,7,30,30
1650461896355,MATH 10B,B01,083739,Staff,13,0,30,17
1650461896355,MATH 10B,B02,083740,Staff,28,0,30,2
1650461902383,MATH 18,A01,083743,Staff,1,0,30,29
1650461902383,MATH 18,A02,083744,Staff,27,0,30,3
1650461902383,MATH 18,A03,083745,Staff,22,0,30,8
1650461902383,MATH 18,A04,083746,Staff,26,0,30,4
1650461902383,MATH 18,B01,083748,Staff,0,11,30,30
1650461902383,MATH 18,B02,083749,Staff,0,12,30,30
1650461902383,MATH 18,B03,083750,Staff,0,11,30,30
1650461902383,MATH 18,B04,083751,Staff,0,12,30,30
1650461908409,MATH 20A,A01,083754,Staff,25,0,40,15
1650461914434,MATH 20B,A01,083756,Staff,0,10,30,30
1650461914434,MATH 20B,A02,083757,Staff,0,10,30,30
1650461920467,MATH 20C,A01,083760,Staff,0,15,30,30
1650461920467,MATH 20C,A02,083761,Staff,1,14,30,29
1650461920467,MATH 20C,B01,083762,Staff,13,0,30,17
1650461920467,MATH 20C,B02,083763,Staff,28,0,30,2
1650461926493,MATH 20D,A01,083765,Staff,0,1,30,30
1650461926493,MATH 20D,A02,083766,Staff,9,0,30,21
1650461926493,MATH 20D,A03,083767,Staff,25,0,30,5
1650461932518,MATH 20E,A01,083771,Staff,6,0,30,24
1650461932518,MATH 20E,A02,083772,Staff,18,0,30,12
1650461932518,MATH 20E,B01,083773,Staff,0,0,30,30
1650461932518,MATH 20E,B02,083774,Staff,10,0,30,20
1650461938543,MATH 103A,A01,083777,Staff,0,12,30,30
1650461938543,MATH 103A,A02,083778,Staff,0,12,30,30
1650461938543,MATH 103A,B01,083779,Staff,0,13,30,30
1650461938543,MATH 103A,B02,083780,Staff,0,12,30,30
1650461944573,MATH 105,A01,085443,Staff,0,23,30,30
1650461950597,MATH 109,A01,083213,Anzaldo; Leesa B,0,7,30,30
1650461950597,MATH 109,A02,083214,Anzaldo; Leesa B,0,7,30,30
1650461950597,MATH 109,B01,083215,Anzaldo; Leesa B,0,5,30,30
1650461950597,MATH 109,B02,083216,Anzaldo; Leesa B,0,6,30,30
1650461956621,MATH 142A,A01,083219,Chow; Bennett,0,14,30,30
1650461956621,MATH 142A,A02,083220,Chow; Bennett,0,13,30,30
1650461956621,MATH 142A,B01,083221,Chow; Bennett,0,12,30,30
1650461956621,MATH 142A,B02,083222,Chow; Bennett,0,13,30,30
1650461962656,MATH 193A,A01,083224,Staff,0,5,30,30
1650461962656,MATH 193A,A02,083225,Staff,0,5,30,30
1650461962656,MATH 193A,A03,083781,Staff,0,4,30,30
1650461962656,MATH 193A,A04,083782,Staff,0,5,30,30
1650461968680,MATH 197,001,091859,McAuley; Julian John,9998,0,9999,1
1650461974734,COGS 9,A01,083615,Staff,0,14,60,60
1650461980758,COGS 11,A01,083617,Boyle; Mary E. T.,21,0,40,19
1650461986855,COGS 13,A01,083071,Staff,0,34,40,40
1650461992883,COGS 14A,A01,092681,Staff,1,25,100,99
1650461998908,COGS 14B,A01,083073,Cheng; Tzu-Han,0,11,50,50
1650462004936,COGS 17,A01,092677,Staff,22,0,75,53
1650462010969,COGS 100,A01,083619,Staff,0,26,60,60
1650462016996,COGS 101A,A01,083621,Davis; Joshua Daniel,0,21,60,60
1650462023021,COGS 101B,A01,091572,Staff,0,4,60,60
1650462029047,COGS 101C,A01,083625,Delgado; Tania,16,0,30,14
1650462035071,COGS 107A,A01,083627,Boyle; Mary E. T.,0,11,60,60
1650462041096,COGS 118A,A01,083075,Staff,2,0,60,58
1650462047120,CSE 3,A50,083646,Miranda; Gregory Joseph,20,0,38,18
1650462047120,CSE 3,A51,083647,Miranda; Gregory Joseph,36,0,37,1
1650462053148,CSE 8A,A50,083650,Miranda; Gregory Joseph,0,28,40,40
1650462059174,CSE 11,A01,083080,Cao; Yingjun,0,92,40,40
1650462065201,CSE 12,A01,083652,Staff,0,16,100,100
1650462071227,CSE 15L,A01,083654,Staff,0,1,50,50
1650462071227,CSE 15L,A02,083655,Staff,1,0,50,49
1650462077252,CSE 20,A01,083657,Staff,51,0,80,29
1650462083280,CSE 30,A01,083084,Eldon; John,0,76,40,40
1650462089308,CSE 100,A01,083659,Cao; Yingjun,0,66,50,50
1650462095333,CSE 134B,A01,083661,Powell; Thomas Allan,0,32,65,65
1650462101359,CSE 140,A01,083663,Staff,0,2,75,75
1650462107382,CSE 140L,A01,083088,Eldon; John,0,8,75,75
1650462113409,CSE 175,A01,083665,Kumar; Rakesh,7,0,25,18
1650462119433,CSE 190,A00,092507,Dubnov; Shlomo,14,0,20,6
1650462125459,ECE 45,A01,083139,Staff,0,18,40,40
1650462131487,ECE 65,A50,083695,Staff,0,6,30,30
1650462137510,ECE 109,A01,091882,Touri; Behrouz,38,0,70,32
1650462143533,ECE 180,A00,083140,Abi Samra; Nicholas Camill,23,0,30,7
1650462143533,ECE 180,B00,083141,Abi Samra; Nicholas Camill,0,0,30,30
1650462149556,MATH 10A,A01,083735,Patchell; Gregory David,7,0,30,23
1650462149556,MATH 10A,A02,083736,Patchell; Gregory David,28,0,30,2
1650462149556,MATH 10A,A03,083737,Patchell; Gregory David,25,0,30,5
1650462155611,MATH 10B,A01,083207,Staff,0,7,30,30
1650462155611,MATH 10B,A02,083208,Staff,0,7,30,30
1650462155611,MATH 10B,B01,083739,Staff,13,0,30,17
1650462155611,MATH 10B,B02,083740,Staff,28,0,30,2
1650462161634,MATH 18,A01,083743,Staff,1,0,30,29
1650462161634,MATH 18,A02,083744,Staff,27,0,30,3
1650462161634,MATH 18,A03,083745,Staff,22,0,30,8
1650462161634,MATH 18,A04,083746,Staff,26,0,30,4
1650462161634,MATH 18,B01,083748,Staff,0,11,30,30
1650462161634,MATH 18,B02,083749,Staff,0,12,30,30
1650462161634,MATH 18,B03,083750,Staff,0,11,30,30
1650462161634,MATH 18,B04,083751,Staff,0,12,30,30
1650462167658,MATH 20A,A01,083754,Staff,25,0,40,15
1650462173682,MATH 20B,A01,083756,Staff,0,10,30,30
1650462173682,MATH 20B,A02,083757,Staff,0,10,30,30
1650462179706,MATH 20C,A01,083760,Staff,0,15,30,30
1650462179706,MATH 20C,A02,083761,Staff,1,14,30,29
1650462179706,MATH 20C,B01,083762,Staff,13,0,30,17
1650462179706,MATH 20C,B02,083763,Staff,28,0,30,2
1650462185738,MATH 20D,A01,083765,Staff,0,1,30,30
1650462185738,MATH 20D,A02,083766,Staff,9,0,30,21
1650462185738,MATH 20D,A03,083767,Staff,25,0,30,5
1650462191764,MATH 20E,A01,083771,Staff,6,0,30,24
1650462191764,MATH 20E,A02,083772,Staff,18,0,30,12
1650462191764,MATH 20E,B01,083773,Staff,0,0,30,30
1650462191764,MATH 20E,B02,083774,Staff,10,0,30,20
1650462197793,MATH 103A,A01,083777,Staff,0,12,30,30
1650462197793,MATH 103A,A02,083778,Staff,0,12,30,30
1650462197793,MATH 103A,B01,083779,Staff,0,13,30,30
1650462197793,MATH 103A,B02,083780,Staff,0,12,30,30
1650462203817,MATH 105,A01,085443,Staff,0,23,30,30
1650462209842,MATH 109,A01,083213,Anzaldo; Leesa B,0,7,30,30
1650462209842,MATH 109,A02,083214,Anzaldo; Leesa B,0,7,30,30
1650462209842,MATH 109,B01,083215,Anzaldo; Leesa B,0,5,30,30
1650462209842,MATH 109,B02,083216,Anzaldo; Leesa B,0,6,30,30
1650462215866,MATH 142A,A01,083219,Chow; Bennett,0,14,30,30
1650462215866,MATH 142A,A02,083220,Chow; Bennett,0,13,30,30
1650462215866,MATH 142A,B01,083221,Chow; Bennett,0,12,30,30
1650462215866,MATH 142A,B02,083222,Chow; Bennett,0,13,30,30
1650462221891,MATH 193A,A01,083224,Staff,0,5,30,30
1650462221891,MATH 193A,A02,083225,Staff,0,5,30,30
1650462221891,MATH 193A,A03,083781,Staff,0,4,30,30
1650462221891,MATH 193A,A04,083782,Staff,0,5,30,30
1650462227927,MATH 197,001,091859,McAuley; Julian John,9998,0,9999,1
1650462233991,COGS 9,A01,083615,Staff,0,14,60,60
1650462240015,COGS 11,A01,083617,Boyle; Mary E. T.,21,0,40,19
1650462246038,COGS 13,A01,083071,Staff,0,34,40,40
1650462252060,COGS 14A,A01,092681,Staff,1,25,100,99
1650462258084,COGS 14B,A01,083073,Cheng; Tzu-Han,0,11,50,50
1650462264108,COGS 17,A01,092677,Staff,22,0,75,53
1650462270133,COGS 100,A01,083619,Staff,0,26,60,60
1650462276156,COGS 101A,A01,083621,Davis; Joshua Daniel,0,21,60,60
1650462282183,COGS 101B,A01,091572,Staff,0,4,60,60
1650462288216,COGS 101C,A01,083625,Delgado; Tania,16,0,30,14
1650462294242,COGS 107A,A01,083627,Boyle; Mary E. T.,0,11,60,60
1650462300268,COGS 118A,A01,083075,Staff,2,0,60,58
1650462306296,CSE 3,A50,083646,Miranda; Gregory Joseph,20,0,38,18
1650462306296,CSE 3,A51,083647,Miranda; Gregory Joseph,36,0,37,1
1650462312321,CSE 8A,A50,083650,Miranda; Gregory Joseph,0,28,40,40
1650462318346,CSE 11,A01,083080,Cao; Yingjun,0,92,40,40
1650462324370,CSE 12,A01,083652,Staff,0,16,100,100
1650462330397,CSE 15L,A01,083654,Staff,0,1,50,50
1650462330397,CSE 15L,A02,083655,Staff,1,0,50,49
1650462336423,CSE 20,A01,083657,Staff,51,0,80,29
1650462342447,CSE 30,A01,083084,Eldon; John,0,76,40,40
1650462348470,CSE 100,A01,083659,Cao; Yingjun,0,66,50,50
1650462354492,CSE 134B,A01,083661,Powell; Thomas Allan,0,32,65,65
1650462360525,CSE 140,A01,083663,Staff,0,2,75,75
1650462366549,CSE 140L,A01,083088,Eldon; John,0,8,75,75
1650462372573,CSE 175,A01,083665,Kumar; Rakesh,7,0,25,18
1650462378611,CSE 190,A00,092507,Dubnov; Shlomo,14,0,20,6
1650462384634,ECE 45,A01,083139,Staff,0,18,40,40
1650462390657,ECE 65,A50,083695,Staff,0,6,30,30
1650462396690,ECE 109,A01,091882,Touri; Behrouz,38,0,70,32
1650462402713,ECE 180,A00,083140,Abi Samra; Nicholas Camill,23,0,30,7
1650462402713,ECE 180,B00,083141,Abi Samra; Nicholas Camill,0,0,30,30
1650462408736,MATH 10A,A01,083735,Patchell; Gregory David,7,0,30,23
1650462408736,MATH 10A,A02,083736,Patchell; Gregory David,28,0,30,2
1650462408736,MATH 10A,A03,083737,Patchell; Gregory David,25,0,30,5
1650462414760,MATH 10B,A01,083207,Staff,0,7,30,30
1650462414760,MATH 10B,A02,083208,Staff,0,7,30,30
1650462414760,MATH 10B,B01,083739,Staff,13,0,30,17
1650462414760,MATH 10B,B02,083740,Staff,28,0,30,2
1650462420790,MATH 18,A01,083743,Staff,1,0,30,29
1650462420790,MATH 18,A02,083744,Staff,27,0,30,3
1650462420790,MATH 18,A03,083745,Staff,22,0,30,8
1650462420790,MATH 18,A04,083746,Staff,26,0,30,4
1650462420790,MATH 18,B01,083748,Staff,0,11,30,30
1650462420790,MATH 18,B02,083749,Staff,0,12,30,30
1650462420790,MATH 18,B03,083750,Staff,0,11,30,30
1650462420790,MATH 18,B04,083751,Staff,0,12,30,30
1650462426814,MATH 20A,A01,083754,Staff,25,0,40,15
1650462432838,MATH 20B,A01,083756,Staff,0,10,30,30
1650462432838,MATH 20B,A02,083757,Staff,0,10,30,30
1650462438872,MATH 20C,A01,083760,Staff,0,15,30,30
1650462438872,MATH 20C,A02,083761,Staff,1,14,30,29
1650462438872,MATH 20C,B01,083762,Staff,13,0,30,17
1650462438872,MATH 20C,B02,083763,Staff,28,0,30,2
1650462444899,MATH 20D,A01,083765,Staff,0,1,30,30
1650462444899,MATH 20D,A02,083766,Staff,9,0,30,21
1650462444899,MATH 20D,A03,083767,Staff,25,0,30,5
1650462450924,MATH 20E,A01,083771,Staff,6,0,30,24
1650462450924,MATH 20E,A02,083772,Staff,18,0,30,12
1650462450924,MATH 20E,B01,083773,Staff,0,0,30,30
1650462450924,MATH 20E,B02,083774,Staff,10,0,30,20
1650462456952,MATH 103A,A01,083777,Staff,0,12,30,30
1650462456952,MATH 103A,A02,083778,Staff,0,12,30,30
1650462456952,MATH 103A,B01,083779,Staff,0,13,30,30
1650462456952,MATH 103A,B02,083780,Staff,0,12,30,30
1650462462975,MATH 105,A01,085443,Staff,0,23,30,30
1650462468997,MATH 109,A01,083213,Anzaldo; Leesa B,0,7,30,30
1650462468997,MATH 109,A02,083214,Anzaldo; Leesa B,0,7,30,30
1650462468997,MATH 109,B01,083215,Anzaldo; Leesa B,0,5,30,30
1650462468997,MATH 109,B02,083216,Anzaldo; Leesa B,0,6,30,30
1650462475025,MATH 142A,A01,083219,Chow; Bennett,0,14,30,30
1650462475025,MATH 142A,A02,083220,Chow; Bennett,0,13,30,30
1650462475025,MATH 142A,B01,083221,Chow; Bennett,0,12,30,30
1650462475025,MATH 142A,B02,083222,Chow; Bennett,0,13,30,30
1650462481050,MATH 193A,A01,083224,Staff,0,5,30,30
1650462481050,MATH 193A,A02,083225,Staff,0,5,30,30
1650462481050,MATH 193A,A03,083781,Staff,0,4,30,30
1650462481050,MATH 193A,A04,083782,Staff,0,5,30,30
1650462487076,MATH 197,001,091859,McAuley; Julian John,9998,0,9999,1
1650462493138,COGS 9,A01,083615,Staff,0,14,60,60
1650462499164,COGS 11,A01,083617,Boyle; Mary E. T.,21,0,40,19
1650462505191,COGS 13,A01,083071,Staff,0,34,40,40
1650462511218,COGS 14A,A01,092681,Staff,1,25,100,99
1650462517241,COGS 14B,A01,083073,Cheng; Tzu-Han,0,11,50,50
1650462523264,COGS 17,A01,092677,Staff,22,0,75,53
1650462529289,COGS 100,A01,083619,Staff,0,26,60,60
1650462535312,COGS 101A,A01,083621,Davis; Joshua Daniel,0,21,60,60
1650462541340,COGS 101B,A01,091572,Staff,0,4,60,60
1650462547363,COGS 101C,A01,083625,Delgado; Tania,16,0,30,14
1650462553385,COGS 107A,A01,083627,Boyle; Mary E. T.,0,11,60,60
1650462559413,COGS 118A,A01,083075,Staff,2,0,60,58
1650462565440,CSE 3,A50,083646,Miranda; Gregory Joseph,20,0,38,18
1650462565440,CSE 3,A51,083647,Miranda; Gregory Joseph,36,0,37,1
1650462571471,CSE 8A,A50,083650,Miranda; Gregory Joseph,0,28,40,40
1650462577495,CSE 11,A01,083080,Cao; Yingjun,0,92,40,40
1650462583595,CSE 12,A01,083652,Staff,0,16,100,100
1650462589637,CSE 15L,A01,083654,Staff,0,1,50,50
1650462589637,CSE 15L,A02,083655,Staff,1,0,50,49
1650462595662,CSE 20,A01,083657,Staff,51,0,80,29
1650462601688,CSE 30,A01,083084,Eldon; John,0,76,40,40
1650462607711,CSE 100,A01,083659,Cao; Yingjun,0,66,50,50
1650462613741,CSE 134B,A01,083661,Powell; Thomas Allan,0,32,65,65
1650462619773,CSE 140,A01,083663,Staff,0,2,75,75
1650462625800,CSE 140L,A01,083088,Eldon; John,0,8,75,75
1650462631827,CSE 175,A01,083665,Kumar; Rakesh,7,0,25,18
1650462637854,CSE 190,A00,092507,Dubnov; Shlomo,14,0,20,6
1650462643880,ECE 45,A01,083139,Staff,0,18,40,40
1650462649903,ECE 65,A50,083695,Staff,0,6,30,30
1650462655926,ECE 109,A01,091882,Touri; Behrouz,38,0,70,32
1650462661954,ECE 180,A00,083140,Abi Samra; Nicholas Camill,23,0,30,7
1650462661954,ECE 180,B00,083141,Abi Samra; Nicholas Camill,0,0,30,30
1650462667979,MATH 10A,A01,083735,Patchell; Gregory David,7,0,30,23
1650462667979,MATH 10A,A02,083736,Patchell; Gregory David,28,0,30,2
1650462667979,MATH 10A,A03,083737,Patchell; Gregory David,25,0,30,5
1650462674005,MATH 10B,A01,083207,Staff,0,7,30,30
1650462674005,MATH 10B,A02,083208,Staff,0,7,30,30
1650462674005,MATH 10B,B01,083739,Staff,13,0,30,17
1650462674005,MATH 10B,B02,083740,Staff,28,0,30,2
1650462680041,MATH 18,A01,083743,Staff,1,0,30,29
1650462680041,MATH 18,A02,083744,Staff,27,0,30,3
1650462680041,MATH 18,A03,083745,Staff,22,0,30,8
1650462680041,MATH 18,A04,083746,Staff,26,0,30,4
1650462680041,MATH 18,B01,083748,Staff,0,11,30,30
1650462680041,MATH 18,B02,083749,Staff,0,12,30,30
1650462680041,MATH 18,B03,083750,Staff,0,11,30,30
1650462680041,MATH 18,B04,083751,Staff,0,12,30,30
1650462686064,MATH 20A,A01,083754,Staff,25,0,40,15
1650462692092,MATH 20B,A01,083756,Staff,0,10,30,30
1650462692092,MATH 20B,A02,083757,Staff,0,10,30,30
1650462698121,MATH 20C,A01,083760,Staff,0,15,30,30
1650462698121,MATH 20C,A02,083761,Staff,1,14,30,29
1650462698121,MATH 20C,B01,083762,Staff,13,0,30,17
1650462698121,MATH 20C,B02,083763,Staff,28,0,30,2
1650462704150,MATH 20D,A01,083765,Staff,0,1,30,30
1650462704150,MATH 20D,A02,083766,Staff,9,0,30,21
1650462704150,MATH 20D,A03,083767,Staff,25,0,30,5
1650462710177,MATH 20E,A01,083771,Staff,6,0,30,24
1650462710177,MATH 20E,A02,083772,Staff,18,0,30,12
1650462710177,MATH 20E,B01,083773,Staff,0,0,30,30
1650462710177,MATH 20E,B02,083774,Staff,10,0,30,20
1650462716206,MATH 103A,A01,083777,Staff,0,12,30,30
1650462716206,MATH 103A,A02,083778,Staff,0,12,30,30
1650462716206,MATH 103A,B01,083779,Staff,0,13,30,30
1650462716206,MATH 103A,B02,083780,Staff,0,12,30,30
1650462722234,MATH 105,A01,085443,Staff,0,23,30,30
1650462728259,MATH 109,A01,083213,Anzaldo; Leesa B,0,7,30,30
1650462728259,MATH 109,A02,083214,Anzaldo; Leesa B,0,7,30,30
1650462728259,MATH 109,B01,083215,Anzaldo; Leesa B,0,5,30,30
1650462728259,MATH 109,B02,083216,Anzaldo; Leesa B,0,6,30,30
1650462734284,MATH 142A,A01,083219,Chow; Bennett,0,14,30,30
1650462734284,MATH 142A,A02,083220,Chow; Bennett,0,13,30,30
1650462734284,MATH 142A,B01,083221,Chow; Bennett,0,12,30,30
1650462734284,MATH 142A,B02,083222,Chow; Bennett,0,13,30,30
1650462740309,MATH 193A,A01,083224,Staff,0,5,30,30
1650462740309,MATH 193A,A02,083225,Staff,0,5,30,30
1650462740309,MATH 193A,A03,083781,Staff,0,4,30,30
1650462740309,MATH 193A,A04,083782,Staff,0,5,30,30
1650462746332,MATH 197,001,091859,McAuley; Julian John,9998,0,9999,1
1650462752398,COGS 9,A01,083615,Staff,0,14,60,60
1650462758426,COGS 11,A01,083617,Boyle; Mary E. T.,21,0,40,19
1650462764453,COGS 13,A01,083071,Staff,0,34,40,40
1650462770481,COGS 14A,A01,092681,Staff,1,25,100,99
1650462776506,COGS 14B,A01,083073,Cheng; Tzu-Han,0,11,50,50
1650462782531,COGS 17,A01,092677,Staff,22,0,75,53
1650462788554,COGS 100,A01,083619,Staff,0,26,60,60
1650462794577,COGS 101A,A01,083621,Davis; Joshua Daniel,0,21,60,60
1650462800603,COGS 101B,A01,091572,Staff,0,4,60,60
1650462806631,COGS 101C,A01,083625,Delgado; Tania,16,0,30,14
1650462812656,COGS 107A,A01,083627,Boyle; Mary E. T.,0,11,60,60
1650462818681,COGS 118A,A01,083075,Staff,2,0,60,58
1650462824705,CSE 3,A50,083646,Miranda; Gregory Joseph,20,0,38,18
1650462824705,CSE 3,A51,083647,Miranda; Gregory Joseph,36,0,37,1
1650462830736,CSE 8A,A50,083650,Miranda; Gregory Joseph,0,28,40,40
1650462836761,CSE 11,A01,083080,Cao; Yingjun,0,92,40,40
1650462842793,CSE 12,A01,083652,Staff,0,16,100,100
1650462848818,CSE 15L,A01,083654,Staff,0,1,50,50
1650462848818,CSE 15L,A02,083655,Staff,1,0,50,49
1650462854844,CSE 20,A01,083657,Staff,51,0,80,29
1650462860869,CSE 30,A01,083084,Eldon; John,0,76,40,40
1650462866894,CSE 100,A01,083659,Cao; Yingjun,0,66,50,50
1650462872929,CSE 134B,A01,083661,Powell; Thomas Allan,0,32,65,65
1650462878954,CSE 140,A01,083663,Staff,0,2,75,75
1650462884979,CSE 140L,A01,083088,Eldon; John,0,8,75,75
1650462891002,CSE 175,A01,083665,Kumar; Rakesh,7,0,25,18
1650462897039,CSE 190,A00,092507,Dubnov; Shlomo,14,0,20,6
1650462903075,ECE 45,A01,083139,Staff,0,18,40,40
1650462909099,ECE 65,A50,083695,Staff,0,6,30,30
1650462915129,ECE 109,A01,091882,Touri; Behrouz,38,0,70,32
1650462921156,ECE 180,A00,083140,Abi Samra; Nicholas Camill,23,0,30,7
1650462921156,ECE 180,B00,083141,Abi Samra; Nicholas Camill,0,0,30,30
1650462927185,MATH 10A,A01,083735,Patchell; Gregory David,7,0,30,23
1650462927185,MATH 10A,A02,083736,Patchell; Gregory David,28,0,30,2
1650462927185,MATH 10A,A03,083737,Patchell; Gregory David,25,0,30,5
1650462933208,MATH 10B,A01,083207,Staff,0,7,30,30
1650462933208,MATH 10B,A02,083208,Staff,0,7,30,30
1650462933208,MATH 10B,B01,083739,Staff,13,0,30,17
1650462933208,MATH 10B,B02,083740,Staff,28,0,30,2
1650462939236,MATH 18,A01,083743,Staff,1,0,30,29
1650462939236,MATH 18,A02,083744,Staff,27,0,30,3
1650462939236,MATH 18,A03,083745,Staff,22,0,30,8
1650462939236,MATH 18,A04,083746,Staff,26,0,30,4
1650462939236,MATH 18,B01,083748,Staff,0,11,30,30
1650462939236,MATH 18,B02,083749,Staff,0,12,30,30
1650462939236,MATH 18,B03,083750,Staff,0,11,30,30
1650462939236,MATH 18,B04,083751,Staff,0,12,30,30
1650462945263,MATH 20A,A01,083754,Staff,25,0,40,15
1650462951288,MATH 20B,A01,083756,Staff,0,10,30,30
1650462951288,MATH 20B,A02,083757,Staff,0,10,30,30
1650462957313,MATH 20C,A01,083760,Staff,0,15,30,30
1650462957313,MATH 20C,A02,083761,Staff,1,14,30,29
1650462957313,MATH 20C,B01,083762,Staff,13,0,30,17
1650462957313,MATH 20C,B02,083763,Staff,28,0,30,2
1650462963338,MATH 20D,A01,083765,Staff,0,1,30,30
1650462963338,MATH 20D,A02,083766,Staff,9,0,30,21
1650462963338,MATH 20D,A03,083767,Staff,25,0,30,5
1650462969362,MATH 20E,A01,083771,Staff,6,0,30,24
1650462969362,MATH 20E,A02,083772,Staff,18,0,30,12
1650462969362,MATH 20E,B01,083773,Staff,0,0,30,30
1650462969362,MATH 20E,B02,083774,Staff,10,0,30,20
1650462975393,MATH 103A,A01,083777,Staff,0,12,30,30
1650462975393,MATH 103A,A02,083778,Staff,0,12,30,30
1650462975393,MATH 103A,B01,083779,Staff,0,13,30,30
1650462975393,MATH 103A,B02,083780,Staff,0,12,30,30
1650462981421,MATH 105,A01,085443,Staff,0,23,30,30
1650462987450,MATH 109,A01,083213,Anzaldo; Leesa B,0,7,30,30
1650462987450,MATH 109,A02,083214,Anzaldo; Leesa B,0,7,30,30
1650462987450,MATH 109,B01,083215,Anzaldo; Leesa B,0,5,30,30
1650462987450,MATH 109,B02,083216,Anzaldo; Leesa B,0,6,30,30
1650462993480,MATH 142A,A01,083219,Chow; Bennett,0,14,30,30
1650462993480,MATH 142A,A02,083220,Chow; Bennett,0,13,30,30
1650462993480,MATH 142A,B01,083221,Chow; Bennett,0,12,30,30
1650462993480,MATH 142A,B02,083222,Chow; Bennett,0,13,30,30
1650462999508,MATH 193A,A01,083224,Staff,0,5,30,30
1650462999508,MATH 193A,A02,083225,Staff,0,5,30,30
1650462999508,MATH 193A,A03,083781,Staff,0,4,30,30
1650462999508,MATH 193A,A04,083782,Staff,0,5,30,30
1650463005532,MATH 197,001,091859,McAuley; Julian John,9998,0,9999,1
1650463011593,COGS 9,A01,083615,Staff,0,14,60,60
1650463017615,COGS 11,A01,083617,Boyle; Mary E. T.,21,0,40,19
1650463023640,COGS 13,A01,083071,Staff,0,34,40,40
1650463029667,COGS 14A,A01,092681,Staff,1,25,100,99
1650463035694,COGS 14B,A01,083073,Cheng; Tzu-Han,0,11,50,50
1650463041717,COGS 17,A01,092677,Staff,22,0,75,53
1650463047740,COGS 100,A01,083619,Staff,0,26,60,60
1650463053764,COGS 101A,A01,083621,Davis; Joshua Daniel,0,21,60,60
1650463059786,COGS 101B,A01,091572,Staff,0,4,60,60
1650463065831,COGS 101C,A01,083625,Delgado; Tania,16,0,30,14
1650463071861,COGS 107A,A01,083627,Boyle; Mary E. T.,0,11,60,60
1650463077904,COGS 118A,A01,083075,Staff,2,0,60,58
1650463083937,CSE 3,A50,083646,Miranda; Gregory Joseph,20,0,38,18
1650463083937,CSE 3,A51,083647,Miranda; Gregory Joseph,36,0,37,1
1650463089960,CSE 8A,A50,083650,Miranda; Gregory Joseph,0,28,40,40
1650463095984,CSE 11,A01,083080,Cao; Yingjun,0,92,40,40
1650463102010,CSE 12,A01,083652,Staff,0,16,100,100
1650463108038,CSE 15L,A01,083654,Staff,0,1,50,50
1650463108038,CSE 15L,A02,083655,Staff,1,0,50,49
1650463114063,CSE 20,A01,083657,Staff,51,0,80,29
1650463120088,CSE 30,A01,083084,Eldon; John,0,76,40,40
1650463126115,CSE 100,A01,083659,Cao; Yingjun,0,66,50,50
1650463132139,CSE 134B,A01,083661,Powell; Thomas Allan,0,32,65,65
1650463138162,CSE 140,A01,083663,Staff,0,2,75,75
1650463144185,CSE 140L,A01,083088,Eldon; John,0,8,75,75
1650463150211,CSE 175,A01,083665,Kumar; Rakesh,7,0,25,18
1650463156234,CSE 190,A00,092507,Dubnov; Shlomo,14,0,20,6
1650463162259,ECE 45,A01,083139,Staff,20,18,60,40
1650463168287,ECE 65,A50,083695,Staff,0,6,30,30
1650463174315,ECE 109,A01,091882,Touri; Behrouz,38,0,70,32
1650463180414,ECE 180,A00,083140,Abi Samra; Nicholas Camill,23,0,30,7
1650463180414,ECE 180,B00,083141,Abi Samra; Nicholas Camill,0,0,30,30
1650463186437,MATH 10A,A01,083735,Patchell; Gregory David,7,0,30,23
1650463186437,MATH 10A,A02,083736,Patchell; Gregory David,28,0,30,2
1650463186437,MATH 10A,A03,083737,Patchell; Gregory David,25,0,30,5
1650463192467,MATH 10B,A01,083207,Staff,0,7,30,30
1650463192467,MATH 10B,A02,083208,Staff,0,7,30,30
1650463192467,MATH 10B,B01,083739,Staff,13,0,30,17
1650463192467,MATH 10B,B02,083740,Staff,28,0,30,2
1650463198507,MATH 18,A01,083743,Staff,1,0,30,29
1650463198507,MATH 18,A02,083744,Staff,27,0,30,3
1650463198507,MATH 18,A03,083745,Staff,22,0,30,8
1650463198507,MATH 18,A04,083746,Staff,26,0,30,4
1650463198507,MATH 18,B01,083748,Staff,0,11,30,30
1650463198507,MATH 18,B02,083749,Staff,0,12,30,30
1650463198507,MATH 18,B03,083750,Staff,0,11,30,30
1650463198507,MATH 18,B04,083751,Staff,0,12,30,30
1650463204532,MATH 20A,A01,083754,Staff,25,0,40,15
1650463210557,MATH 20B,A01,083756,Staff,0,10,30,30
1650463210557,MATH 20B,A02,083757,Staff,0,10,30,30
1650463216582,MATH 20C,A01,083760,Staff,0,15,30,30
1650463216582,MATH 20C,A02,083761,Staff,1,14,30,29
1650463216582,MATH 20C,B01,083762,Staff,13,0,30,17
1650463216582,MATH 20C,B02,083763,Staff,28,0,30,2
1650463222609,MATH 20D,A01,083765,Staff,0,1,30,30
1650463222609,MATH 20D,A02,083766,Staff,9,0,30,21
1650463222609,MATH 20D,A03,083767,Staff,25,0,30,5
1650463228634,MATH 20E,A01,083771,Staff,6,0,30,24
1650463228634,MATH 20E,A02,083772,Staff,18,0,30,12
1650463228634,MATH 20E,B01,083773,Staff,0,0,30,30
1650463228634,MATH 20E,B02,083774,Staff,10,0,30,20
1650463234663,MATH 103A,A01,083777,Staff,0,12,30,30
1650463234663,MATH 103A,A02,083778,Staff,0,12,30,30
1650463234663,MATH 103A,B01,083779,Staff,0,13,30,30
1650463234663,MATH 103A,B02,083780,Staff,0,12,30,30
1650463240695,MATH 105,A01,085443,Staff,0,23,30,30
1650463246721,MATH 109,A01,083213,Anzaldo; Leesa B,0,7,30,30
1650463246721,MATH 109,A02,083214,Anzaldo; Leesa B,0,7,30,30
1650463246721,MATH 109,B01,083215,Anzaldo; Leesa B,0,5,30,30
1650463246721,MATH 109,B02,083216,Anzaldo; Leesa B,0,6,30,30
1650463252746,MATH 142A,A01,083219,Chow; Bennett,0,14,30,30
1650463252746,MATH 142A,A02,083220,Chow; Bennett,0,13,30,30
1650463252746,MATH 142A,B01,083221,Chow; Bennett,0,12,30,30
1650463252746,MATH 142A,B02,083222,Chow; Bennett,0,13,30,30
1650463258772,MATH 193A,A01,083224,Staff,0,5,30,30
1650463258772,MATH 193A,A02,083225,Staff,0,5,30,30
1650463258772,MATH 193A,A03,083781,Staff,0,4,30,30
1650463258772,MATH 193A,A04,083782,Staff,0,5,30,30
1650463264802,MATH 197,001,091859,McAuley; Julian John,9998,0,9999,1
1650463270864,COGS 9,A01,083615,Staff,0,14,60,60
1650463276889,COGS 11,A01,083617,Boyle; Mary E. T.,21,0,40,19
1650463282916,COGS 13,A01,083071,Staff,0,34,40,40
1650463288942,COGS 14A,A01,092681,Staff,1,25,100,99
1650463294971,COGS 14B,A01,083073,Cheng; Tzu-Han,0,11,50,50
1650463301004,COGS 17,A01,092677,Staff,22,0,75,53
1650463307030,COGS 100,A01,083619,Staff,0,26,60,60
1650463313062,COGS 101A,A01,083621,Davis; Joshua Daniel,0,21,60,60
1650463319088,COGS 101B,A01,091572,Staff,0,4,60,60
1650463325121,COGS 101C,A01,083625,Delgado; Tania,16,0,30,14
1650463331157,COGS 107A,A01,083627,Boyle; Mary E. T.,0,11,60,60
1650463337188,COGS 118A,A01,083075,Staff,2,0,60,58
1650463343214,CSE 3,A50,083646,Miranda; Gregory Joseph,20,0,38,18
1650463343214,CSE 3,A51,083647,Miranda; Gregory Joseph,36,0,37,1
1650463349244,CSE 8A,A50,083650,Miranda; Gregory Joseph,0,28,40,40
1650463355275,CSE 11,A01,083080,Cao; Yingjun,0,92,40,40
1650463361304,CSE 12,A01,083652,Staff,0,16,100,100
1650463367334,CSE 15L,A01,083654,Staff,0,1,50,50
1650463367334,CSE 15L,A02,083655,Staff,1,0,50,49
1650463373362,CSE 20,A01,083657,Staff,51,0,80,29
1650463379389,CSE 30,A01,083084,Eldon; John,0,76,40,40
1650463385417,CSE 100,A01,083659,Cao; Yingjun,0,66,50,50
1650463391445,CSE 134B,A01,083661,Powell; Thomas Allan,0,32,65,65
1650463397477,CSE 140,A01,083663,Staff,0,2,75,75
1650463403516,CSE 140L,A01,083088,Eldon; John,0,8,75,75
1650463409561,CSE 175,A01,083665,Kumar; Rakesh,7,0,25,18
1650463415586,CSE 190,A00,092507,Dubnov; Shlomo,14,0,20,6
1650463421613,ECE 45,A01,083139,Staff,20,18,60,40
1650463427643,ECE 65,A50,083695,Staff,0,6,30,30
1650463433680,ECE 109,A01,091882,Touri; Behrouz,38,0,70,32
1650463439719,ECE 180,A00,083140,Abi Samra; Nicholas Camill,23,0,30,7
1650463439719,ECE 180,B00,083141,Abi Samra; Nicholas Camill,0,0,30,30
1650463445751,MATH 10A,A01,083735,Patchell; Gregory David,7,0,30,23
1650463445751,MATH 10A,A02,083736,Patchell; Gregory David,28,0,30,2
1650463445751,MATH 10A,A03,083737,Patchell; Gregory David,25,0,30,5
1650463451790,MATH 10B,A01,083207,Staff,0,7,30,30
1650463451790,MATH 10B,A02,083208,Staff,0,7,30,30
1650463451790,MATH 10B,B01,083739,Staff,13,0,30,17
1650463451790,MATH 10B,B02,083740,Staff,28,0,30,2
1650463457824,MATH 18,A01,083743,Staff,1,0,30,29
1650463457824,MATH 18,A02,083744,Staff,27,0,30,3
1650463457824,MATH 18,A03,083745,Staff,22,0,30,8
1650463457824,MATH 18,A04,083746,Staff,26,0,30,4
1650463457824,MATH 18,B01,083748,Staff,0,11,30,30
1650463457824,MATH 18,B02,083749,Staff,0,12,30,30
1650463457824,MATH 18,B03,083750,Staff,0,11,30,30
1650463457824,MATH 18,B04,083751,Staff,0,12,30,30
1650463463853,MATH 20A,A01,083754,Staff,25,0,40,15
1650463469880,MATH 20B,A01,083756,Staff,0,10,30,30
1650463469880,MATH 20B,A02,083757,Staff,0,10,30,30
1650463475906,MATH 20C,A01,083760,Staff,0,15,30,30
1650463475906,MATH 20C,A02,083761,Staff,1,14,30,29
1650463475906,MATH 20C,B01,083762,Staff,13,0,30,17
1650463475906,MATH 20C,B02,083763,Staff,28,0,30,2
1650463481931,MATH 20D,A01,083765,Staff,0,1,30,30
1650463481931,MATH 20D,A02,083766,Staff,9,0,30,21
1650463481931,MATH 20D,A03,083767,Staff,25,0,30,5
1650463487957,MATH 20E,A01,083771,Staff,6,0,30,24
1650463487957,MATH 20E,A02,083772,Staff,18,0,30,12
1650463487957,MATH 20E,B01,083773,Staff,0,0,30,30
1650463487957,MATH 20E,B02,083774,Staff,10,0,30,20
1650463493983,MATH 103A,A01,083777,Staff,0,12,30,30
1650463493983,MATH 103A,A02,083778,Staff,0,12,30,30
1650463493983,MATH 103A,B01,083779,Staff,0,13,30,30
1650463493983,MATH 103A,B02,083780,Staff,0,12,30,30
1650463500010,MATH 105,A01,085443,Staff,0,23,30,30
1650463506038,MATH 109,A01,083213,Anzaldo; Leesa B,0,7,30,30
1650463506038,MATH 109,A02,083214,Anzaldo; Leesa B,0,7,30,30
1650463506038,MATH 109,B01,083215,Anzaldo; Leesa B,0,5,30,30
1650463506038,MATH 109,B02,083216,Anzaldo; Leesa B,0,6,30,30
1650463512063,MATH 142A,A01,083219,Chow; Bennett,0,14,30,30
1650463512063,MATH 142A,A02,083220,Chow; Bennett,0,13,30,30
1650463512063,MATH 142A,B01,083221,Chow; Bennett,0,12,30,30
1650463512063,MATH 142A,B02,083222,Chow; Bennett,0,13,30,30
1650463518094,MATH 193A,A01,083224,Staff,0,5,30,30
1650463518094,MATH 193A,A02,083225,Staff,0,5,30,30
1650463518094,MATH 193A,A03,083781,Staff,0,4,30,30
1650463518094,MATH 193A,A04,083782,Staff,0,5,30,30
1650463524122,MATH 197,001,091859,McAuley; Julian John,9998,0,9999,1
1650463530204,COGS 9,A01,083615,Staff,0,14,60,60
1650463536230,COGS 11,A01,083617,Boyle; Mary E. T.,21,0,40,19
1650463542260,COGS 13,A01,083071,Staff,0,34,40,40
1650463548285,COGS 14A,A01,092681,Staff,1,25,100,99
1650463554314,COGS 14B,A01,083073,Cheng; Tzu-Han,0,11,50,50
1650463560338,COGS 17,A01,092677,Staff,22,0,75,53
1650463566366,COGS 100,A01,083619,Staff,0,26,60,60
1650463572393,COGS 101A,A01,083621,Davis; Joshua Daniel,0,21,60,60
1650463578421,COGS 101B,A01,091572,Staff,0,4,60,60
1650463584447,COGS 101C,A01,083625,Delgado; Tania,16,0,30,14
1650463590475,COGS 107A,A01,083627,Boyle; Mary E. T.,0,11,60,60
1650463596500,COGS 118A,A01,083075,Staff,2,0,60,58
1650463602523,CSE 3,A50,083646,Miranda; Gregory Joseph,20,0,38,18
1650463602523,CSE 3,A51,083647,Miranda; Gregory Joseph,36,0,37,1
1650463608562,CSE 8A,A50,083650,Miranda; Gregory Joseph,0,28,40,40
1650463614586,CSE 11,A01,083080,Cao; Yingjun,0,92,40,40
1650463620610,CSE 12,A01,083652,Staff,0,16,100,100
1650463626639,CSE 15L,A01,083654,Staff,0,1,50,50
1650463626639,CSE 15L,A02,083655,Staff,1,0,50,49
1650463632661,CSE 20,A01,083657,Staff,51,0,80,29
1650463638688,CSE 30,A01,083084,Eldon; John,0,76,40,40
1650463644716,CSE 100,A01,083659,Cao; Yingjun,0,66,50,50
1650463650740,CSE 134B,A01,083661,Powell; Thomas Allan,0,32,65,65
1650463656762,CSE 140,A01,083663,Staff,0,2,75,75
1650463662787,CSE 140L,A01,083088,Eldon; John,0,8,75,75
1650463668809,CSE 175,A01,083665,Kumar; Rakesh,7,0,25,18
1650463674831,CSE 190,A00,092507,Dubnov; Shlomo,14,0,20,6
1650463680856,ECE 45,A01,083139,Staff,20,18,60,40
1650463686881,ECE 65,A50,083695,Staff,0,6,30,30
1650463692906,ECE 109,A01,091882,Touri; Behrouz,38,0,70,32
1650463698937,ECE 180,A00,083140,Abi Samra; Nicholas Camill,23,0,30,7
1650463698937,ECE 180,B00,083141,Abi Samra; Nicholas Camill,0,0,30,30
1650463704963,MATH 10A,A01,083735,Patchell; Gregory David,7,0,30,23
1650463704963,MATH 10A,A02,083736,Patchell; Gregory David,28,0,30,2
1650463704963,MATH 10A,A03,083737,Patchell; Gregory David,25,0,30,5
1650463710987,MATH 10B,A01,083207,Staff,0,7,30,30
1650463710987,MATH 10B,A02,083208,Staff,0,7,30,30
1650463710987,MATH 10B,B01,083739,Staff,13,0,30,17
1650463710987,MATH 10B,B02,083740,Staff,28,0,30,2
1650463717019,MATH 18,A01,083743,Staff,1,0,30,29
1650463717019,MATH 18,A02,083744,Staff,27,0,30,3
1650463717019,MATH 18,A03,083745,Staff,22,0,30,8
1650463717019,MATH 18,A04,083746,Staff,26,0,30,4
1650463717019,MATH 18,B01,083748,Staff,0,11,30,30
1650463717019,MATH 18,B02,083749,Staff,0,12,30,30
1650463717019,MATH 18,B03,083750,Staff,0,11,30,30
1650463717019,MATH 18,B04,083751,Staff,0,12,30,30
1650463723047,MATH 20A,A01,083754,Staff,25,0,40,15
1650463729072,MATH 20B,A01,083756,Staff,0,10,30,30
1650463729072,MATH 20B,A02,083757,Staff,0,10,30,30
1650463735101,MATH 20C,A01,083760,Staff,0,15,30,30
1650463735101,MATH 20C,A02,083761,Staff,1,14,30,29
1650463735101,MATH 20C,B01,083762,Staff,13,0,30,17
1650463735101,MATH 20C,B02,083763,Staff,28,0,30,2
1650463741125,MATH 20D,A01,083765,Staff,0,1,30,30
1650463741125,MATH 20D,A02,083766,Staff,9,0,30,21
1650463741125,MATH 20D,A03,083767,Staff,25,0,30,5
1650463747151,MATH 20E,A01,083771,Staff,6,0,30,24
1650463747151,MATH 20E,A02,083772,Staff,18,0,30,12
1650463747151,MATH 20E,B01,083773,Staff,0,0,30,30
1650463747151,MATH 20E,B02,083774,Staff,10,0,30,20
1650463753176,MATH 103A,A01,083777,Staff,0,12,30,30
1650463753176,MATH 103A,A02,083778,Staff,0,12,30,30
1650463753176,MATH 103A,B01,083779,Staff,0,13,30,30
1650463753176,MATH 103A,B02,083780,Staff,0,12,30,30
1650463759204,MATH 105,A01,085443,Staff,0,23,30,30
1650463765237,MATH 109,A01,083213,Anzaldo; Leesa B,0,7,30,30
1650463765237,MATH 109,A02,083214,Anzaldo; Leesa B,0,7,30,30
1650463765237,MATH 109,B01,083215,Anzaldo; Leesa B,0,5,30,30
1650463765237,MATH 109,B02,083216,Anzaldo; Leesa B,0,6,30,30
1650463771265,MATH 142A,A01,083219,Chow; Bennett,0,14,30,30
1650463771265,MATH 142A,A02,083220,Chow; Bennett,0,13,30,30
1650463771265,MATH 142A,B01,083221,Chow; Bennett,0,12,30,30
1650463771265,MATH 142A,B02,083222,Chow; Bennett,0,13,30,30
1650463777363,MATH 193A,A01,083224,Staff,0,5,30,30
1650463777363,MATH 193A,A02,083225,Staff,0,5,30,30
1650463777363,MATH 193A,A03,083781,Staff,0,4,30,30
1650463777363,MATH 193A,A04,083782,Staff,0,5,30,30
1650463783388,MATH 197,001,091859,McAuley; Julian John,9998,0,9999,1
1650463789445,COGS 9,A01,083615,Staff,0,14,60,60
1650463795469,COGS 11,A01,083617,Boyle; Mary E. T.,21,0,40,19
1650463801496,COGS 13,A01,083071,Staff,0,34,40,40
1650463807530,COGS 14A,A01,092681,Staff,1,25,100,99
1650463813554,COGS 14B,A01,083073,Cheng; Tzu-Han,0,11,50,50
1650463819577,COGS 17,A01,092677,Staff,22,0,75,53
1650463825603,COGS 100,A01,083619,Staff,0,26,60,60
1650463831627,COGS 101A,A01,083621,Davis; Joshua Daniel,0,21,60,60
1650463837652,COGS 101B,A01,091572,Staff,0,4,60,60
1650463843688,COGS 101C,A01,083625,Delgado; Tania,16,0,30,14
1650463849712,COGS 107A,A01,083627,Boyle; Mary E. T.,0,11,60,60
1650463855742,COGS 118A,A01,083075,Staff,2,0,60,58
1650463861768,CSE 3,A50,083646,Miranda; Gregory Joseph,20,0,38,18
1650463861768,CSE 3,A51,083647,Miranda; Gregory Joseph,36,0,37,1
1650463867795,CSE 8A,A50,083650,Miranda; Gregory Joseph,0,28,40,40
1650463873823,CSE 11,A01,083080,Cao; Yingjun,0,92,40,40
1650463879857,CSE 12,A01,083652,Staff,0,16,100,100
1650463885886,CSE 15L,A01,083654,Staff,0,1,50,50
1650463885886,CSE 15L,A02,083655,Staff,1,0,50,49
1650463891912,CSE 20,A01,083657,Staff,51,0,80,29
1650463897940,CSE 30,A01,083084,Eldon; John,0,76,40,40
1650463903963,CSE 100,A01,083659,Cao; Yingjun,0,66,50,50
1650463909992,CSE 134B,A01,083661,Powell; Thomas Allan,0,32,65,65
1650463916019,CSE 140,A01,083663,Staff,0,2,75,75
1650463922043,CSE 140L,A01,083088,Eldon; John,0,8,75,75
1650463928071,CSE 175,A01,083665,Kumar; Rakesh,7,0,25,18
1650463934105,CSE 190,A00,092507,Dubnov; Shlomo,14,0,20,6
1650463940138,ECE 45,A01,083139,Staff,20,18,60,40
1650463946163,ECE 65,A50,083695,Staff,0,6,30,30
1650463952188,ECE 109,A01,091882,Touri; Behrouz,38,0,70,32
1650463958212,ECE 180,A00,083140,Abi Samra; Nicholas Camill,23,0,30,7
1650463958212,ECE 180,B00,083141,Abi Samra; Nicholas Camill,0,0,30,30
1650463964239,MATH 10A,A01,083735,Patchell; Gregory David,7,0,30,23
1650463964239,MATH 10A,A02,083736,Patchell; Gregory David,28,0,30,2
1650463964239,MATH 10A,A03,083737,Patchell; Gregory David,25,0,30,5
1650463970265,MATH 10B,A01,083207,Staff,0,7,30,30
1650463970265,MATH 10B,A02,083208,Staff,0,7,30,30
1650463970265,MATH 10B,B01,083739,Staff,13,0,30,17
1650463970265,MATH 10B,B02,083740,Staff,28,0,30,2
1650463976297,MATH 18,A01,083743,Staff,1,0,30,29
1650463976297,MATH 18,A02,083744,Staff,27,0,30,3
1650463976297,MATH 18,A03,083745,Staff,22,0,30,8
1650463976297,MATH 18,A04,083746,Staff,26,0,30,4
1650463976297,MATH 18,B01,083748,Staff,0,11,30,30
1650463976297,MATH 18,B02,083749,Staff,0,12,30,30
1650463976297,MATH 18,B03,083750,Staff,0,11,30,30
1650463976297,MATH 18,B04,083751,Staff,0,12,30,30
1650463982322,MATH 20A,A01,083754,Staff,25,0,40,15
1650463988348,MATH 20B,A01,083756,Staff,0,10,30,30
1650463988348,MATH 20B,A02,083757,Staff,0,10,30,30
1650463994373,MATH 20C,A01,083760,Staff,0,15,30,30
1650463994373,MATH 20C,A02,083761,Staff,1,14,30,29
1650463994373,MATH 20C,B01,083762,Staff,13,0,30,17
1650463994373,MATH 20C,B02,083763,Staff,28,0,30,2
1650464000398,MATH 20D,A01,083765,Staff,0,1,30,30
1650464000398,MATH 20D,A02,083766,Staff,9,0,30,21
1650464000398,MATH 20D,A03,083767,Staff,25,0,30,5
1650464006424,MATH 20E,A01,083771,Staff,6,0,30,24
1650464006424,MATH 20E,A02,083772,Staff,18,0,30,12
1650464006424,MATH 20E,B01,083773,Staff,0,0,30,30
1650464006424,MATH 20E,B02,083774,Staff,10,0,30,20
1650464012455,MATH 103A,A01,083777,Staff,0,12,30,30
1650464012455,MATH 103A,A02,083778,Staff,0,12,30,30
1650464012455,MATH 103A,B01,083779,Staff,0,13,30,30
1650464012455,MATH 103A,B02,083780,Staff,0,12,30,30
1650464018486,MATH 105,A01,085443,Staff,0,23,30,30
1650464024510,MATH 109,A01,083213,Anzaldo; Leesa B,0,7,30,30
1650464024510,MATH 109,A02,083214,Anzaldo; Leesa B,0,7,30,30
1650464024510,MATH 109,B01,083215,Anzaldo; Leesa B,0,5,30,30
1650464024510,MATH 109,B02,083216,Anzaldo; Leesa B,0,6,30,30
1650464030535,MATH 142A,A01,083219,Chow; Bennett,0,14,30,30
1650464030535,MATH 142A,A02,083220,Chow; Bennett,0,13,30,30
1650464030535,MATH 142A,B01,083221,Chow; Bennett,0,12,30,30
1650464030535,MATH 142A,B02,083222,Chow; Bennett,0,13,30,30
1650464036560,MATH 193A,A01,083224,Staff,0,5,30,30
1650464036560,MATH 193A,A02,083225,Staff,0,5,30,30
1650464036560,MATH 193A,A03,083781,Staff,0,4,30,30
1650464036560,MATH 193A,A04,083782,Staff,0,5,30,30
1650464042584,MATH 197,001,091859,McAuley; Julian John,9998,0,9999,1
1650464048638,COGS 9,A01,083615,Staff,0,14,60,60
1650464054662,COGS 11,A01,083617,Boyle; Mary E. T.,21,0,40,19
1650464060696,COGS 13,A01,083071,Staff,0,34,40,40
1650464066724,COGS 14A,A01,092681,Staff,1,25,100,99
1650464072754,COGS 14B,A01,083073,Cheng; Tzu-Han,0,11,50,50
1650464078784,COGS 17,A01,092677,Staff,22,0,75,53
1650464084811,COGS 100,A01,083619,Staff,0,26,60,60
1650464090840,COGS 101A,A01,083621,Davis; Joshua Daniel,0,21,60,60
1650464096864,COGS 101B,A01,091572,Staff,0,4,60,60
1650464102890,COGS 101C,A01,083625,Delgado; Tania,16,0,30,14
1650464108916,COGS 107A,A01,083627,Boyle; Mary E. T.,0,11,60,60
1650464114945,COGS 118A,A01,083075,Staff,2,0,60,58
1650464120968,CSE 3,A50,083646,Miranda; Gregory Joseph,20,0,38,18
1650464120968,CSE 3,A51,083647,Miranda; Gregory Joseph,36,0,37,1
1650464126996,CSE 8A,A50,083650,Miranda; Gregory Joseph,0,28,40,40
1650464133020,CSE 11,A01,083080,Cao; Yingjun,0,92,40,40
1650464139045,CSE 12,A01,083652,Staff,0,16,100,100
1650464145069,CSE 15L,A01,083654,Staff,0,1,50,50
1650464145069,CSE 15L,A02,083655,Staff,1,0,50,49
1650464151096,CSE 20,A01,083657,Staff,51,0,80,29
1650464157121,CSE 30,A01,083084,Eldon; John,0,76,40,40
1650464163146,CSE 100,A01,083659,Cao; Yingjun,0,66,50,50
1650464169173,CSE 134B,A01,083661,Powell; Thomas Allan,0,32,65,65
1650464175200,CSE 140,A01,083663,Staff,0,2,75,75
1650464181225,CSE 140L,A01,083088,Eldon; John,0,8,75,75
1650464187251,CSE 175,A01,083665,Kumar; Rakesh,7,0,25,18
1650464193277,CSE 190,A00,092507,Dubnov; Shlomo,14,0,20,6
1650464199303,ECE 45,A01,083139,Staff,20,18,60,40
1650464205330,ECE 65,A50,083695,Staff,0,6,30,30
1650464211357,ECE 109,A01,091882,Touri; Behrouz,38,0,70,32
1650464217397,ECE 180,A00,083140,Abi Samra; Nicholas Camill,23,0,30,7
1650464217397,ECE 180,B00,083141,Abi Samra; Nicholas Camill,0,0,30,30
1650464223422,MATH 10A,A01,083735,Patchell; Gregory David,7,0,30,23
1650464223422,MATH 10A,A02,083736,Patchell; Gregory David,28,0,30,2
1650464223422,MATH 10A,A03,083737,Patchell; Gregory David,25,0,30,5
1650464229446,MATH 10B,A01,083207,Staff,0,7,30,30
1650464229446,MATH 10B,A02,083208,Staff,0,7,30,30
1650464229446,MATH 10B,B01,083739,Staff,13,0,30,17
1650464229446,MATH 10B,B02,083740,Staff,28,0,30,2
1650464235478,MATH 18,A01,083743,Staff,1,0,30,29
1650464235478,MATH 18,A02,083744,Staff,27,0,30,3
1650464235478,MATH 18,A03,083745,Staff,22,0,30,8
1650464235478,MATH 18,A04,083746,Staff,26,0,30,4
1650464235478,MATH 18,B01,083748,Staff,0,11,30,30
1650464235478,MATH 18,B02,083749,Staff,0,12,30,30
1650464235478,MATH 18,B03,083750,Staff,0,11,30,30
1650464235478,MATH 18,B04,083751,Staff,0,12,30,30
1650464241505,MATH 20A,A01,083754,Staff,25,0,40,15
1650464247529,MATH 20B,A01,083756,Staff,0,10,30,30
1650464247529,MATH 20B,A02,083757,Staff,0,10,30,30
1650464253556,MATH 20C,A01,083760,Staff,0,15,30,30
1650464253556,MATH 20C,A02,083761,Staff,1,14,30,29
1650464253556,MATH 20C,B01,083762,Staff,13,0,30,17
1650464253556,MATH 20C,B02,083763,Staff,28,0,30,2
1650464259579,MATH 20D,A01,083765,Staff,0,1,30,30
1650464259579,MATH 20D,A02,083766,Staff,9,0,30,21
1650464259579,MATH 20D,A03,083767,Staff,25,0,30,5
1650464265603,MATH 20E,A01,083771,Staff,6,0,30,24
1650464265603,MATH 20E,A02,083772,Staff,18,0,30,12
1650464265603,MATH 20E,B01,083773,Staff,0,0,30,30
1650464265603,MATH 20E,B02,083774,Staff,10,0,30,20
1650464271635,MATH 103A,A01,083777,Staff,0,12,30,30
1650464271635,MATH 103A,A02,083778,Staff,0,12,30,30
1650464271635,MATH 103A,B01,083779,Staff,0,13,30,30
1650464271635,MATH 103A,B02,083780,Staff,0,12,30,30
1650464277662,MATH 105,A01,085443,Staff,0,23,30,30
1650464283701,MATH 109,A01,083213,Anzaldo; Leesa B,0,7,30,30
1650464283701,MATH 109,A02,083214,Anzaldo; Leesa B,0,7,30,30
1650464283701,MATH 109,B01,083215,Anzaldo; Leesa B,0,5,30,30
1650464283701,MATH 109,B02,083216,Anzaldo; Leesa B,0,6,30,30
1650464289731,MATH 142A,A01,083219,Chow; Bennett,0,14,30,30
1650464289731,MATH 142A,A02,083220,Chow; Bennett,0,13,30,30
1650464289731,MATH 142A,B01,083221,Chow; Bennett,0,12,30,30
1650464289731,MATH 142A,B02,083222,Chow; Bennett,0,13,30,30
1650464295763,MATH 193A,A01,083224,Staff,0,5,30,30
1650464295763,MATH 193A,A02,083225,Staff,0,5,30,30
1650464295763,MATH 193A,A03,083781,Staff,0,4,30,30
1650464295763,MATH 193A,A04,083782,Staff,0,5,30,30
1650464301798,MATH 197,001,091859,McAuley; Julian John,9998,0,9999,1
1650464307852,COGS 9,A01,083615,Staff,0,14,60,60
1650464313883,COGS 11,A01,083617,Boyle; Mary E. T.,21,0,40,19
1650464319910,COGS 13,A01,083071,Staff,0,34,40,40
1650464325935,COGS 14A,A01,092681,Staff,1,25,100,99
1650464331959,COGS 14B,A01,083073,Cheng; Tzu-Han,0,11,50,50
1650464337983,COGS 17,A01,092677,Staff,22,0,75,53
1650464344011,COGS 100,A01,083619,Staff,0,26,60,60
1650464350038,COGS 101A,A01,083621,Davis; Joshua Daniel,0,21,60,60
1650464356063,COGS 101B,A01,091572,Staff,0,4,60,60
1650464362089,COGS 101C,A01,083625,Delgado; Tania,16,0,30,14
1650464368191,COGS 107A,A01,083627,Boyle; Mary E. T.,0,11,60,60
1650464374226,COGS 118A,A01,083075,Staff,2,0,60,58
1650464380253,CSE 3,A50,083646,Miranda; Gregory Joseph,20,0,38,18
1650464380253,CSE 3,A51,083647,Miranda; Gregory Joseph,36,0,37,1
1650464386284,CSE 8A,A50,083650,Miranda; Gregory Joseph,0,28,40,40
1650464392309,CSE 11,A01,083080,Cao; Yingjun,0,92,40,40
1650464398341,CSE 12,A01,083652,Staff,0,16,100,100
1650464404366,CSE 15L,A01,083654,Staff,0,1,50,50
1650464404366,CSE 15L,A02,083655,Staff,1,0,50,49
1650464410394,CSE 20,A01,083657,Staff,51,0,80,29
1650464416421,CSE 30,A01,083084,Eldon; John,0,76,40,40
1650464422449,CSE 100,A01,083659,Cao; Yingjun,0,66,50,50
1650464428478,CSE 134B,A01,083661,Powell; Thomas Allan,0,32,65,65
1650464434503,CSE 140,A01,083663,Staff,0,2,75,75
1650464440531,CSE 140L,A01,083088,Eldon; John,0,8,75,75
1650464446562,CSE 175,A01,083665,Kumar; Rakesh,7,0,25,18
1650464452590,CSE 190,A00,092507,Dubnov; Shlomo,14,0,20,6
1650464458615,ECE 45,A01,083139,Staff,20,18,60,40
1650464464640,ECE 65,A50,083695,Staff,0,6,30,30
1650464470664,ECE 109,A01,091882,Touri; Behrouz,38,0,70,32
1650464476688,ECE 180,A00,083140,Abi Samra; Nicholas Camill,23,0,30,7
1650464476688,ECE 180,B00,083141,Abi Samra; Nicholas Camill,0,0,30,30
1650464482716,MATH 10A,A01,083735,Patchell; Gregory David,7,0,30,23
1650464482716,MATH 10A,A02,083736,Patchell; Gregory David,28,0,30,2
1650464482716,MATH 10A,A03,083737,Patchell; Gregory David,25,0,30,5
1650464488747,MATH 10B,A01,083207,Staff,0,7,30,30
1650464488747,MATH 10B,A02,083208,Staff,0,7,30,30
1650464488747,MATH 10B,B01,083739,Staff,13,0,30,17
1650464488747,MATH 10B,B02,083740,Staff,28,0,30,2
1650464494773,MATH 18,A01,083743,Staff,1,0,30,29
1650464494773,MATH 18,A02,083744,Staff,27,0,30,3
1650464494773,MATH 18,A03,083745,Staff,22,0,30,8
1650464494773,MATH 18,A04,083746,Staff,26,0,30,4
1650464494773,MATH 18,B01,083748,Staff,0,11,30,30
1650464494773,MATH 18,B02,083749,Staff,0,12,30,30
1650464494773,MATH 18,B03,083750,Staff,0,11,30,30
1650464494773,MATH 18,B04,083751,Staff,0,12,30,30
1650464500797,MATH 20A,A01,083754,Staff,25,0,40,15
1650464506821,MATH 20B,A01,083756,Staff,0,10,30,30
1650464506821,MATH 20B,A02,083757,Staff,0,10,30,30
1650464512858,MATH 20C,A01,083760,Staff,0,15,30,30
1650464512858,MATH 20C,A02,083761,Staff,1,14,30,29
1650464512858,MATH 20C,B01,083762,Staff,13,0,30,17
1650464512858,MATH 20C,B02,083763,Staff,28,0,30,2
1650464518882,MATH 20D,A01,083765,Staff,0,1,30,30
1650464518882,MATH 20D,A02,083766,Staff,9,0,30,21
1650464518882,MATH 20D,A03,083767,Staff,25,0,30,5
1650464524907,MATH 20E,A01,083771,Staff,6,0,30,24
1650464524907,MATH 20E,A02,083772,Staff,18,0,30,12
1650464524907,MATH 20E,B01,083773,Staff,0,0,30,30
1650464524907,MATH 20E,B02,083774,Staff,10,0,30,20
1650464530935,MATH 103A,A01,083777,Staff,0,12,30,30
1650464530935,MATH 103A,A02,083778,Staff,0,12,30,30
1650464530935,MATH 103A,B01,083779,Staff,0,13,30,30
1650464530935,MATH 103A,B02,083780,Staff,0,12,30,30
1650464536960,MATH 105,A01,085443,Staff,0,23,30,30
1650464542989,MATH 109,A01,083213,Anzaldo; Leesa B,0,7,30,30
1650464542989,MATH 109,A02,083214,Anzaldo; Leesa B,0,7,30,30
1650464542989,MATH 109,B01,083215,Anzaldo; Leesa B,0,5,30,30
1650464542989,MATH 109,B02,083216,Anzaldo; Leesa B,0,6,30,30
1650464549020,MATH 142A,A01,083219,Chow; Bennett,0,14,30,30
1650464549020,MATH 142A,A02,083220,Chow; Bennett,0,13,30,30
1650464549020,MATH 142A,B01,083221,Chow; Bennett,0,12,30,30
1650464549020,MATH 142A,B02,083222,Chow; Bennett,0,13,30,30
1650464555044,MATH 193A,A01,083224,Staff,0,5,30,30
1650464555044,MATH 193A,A02,083225,Staff,0,5,30,30
1650464555044,MATH 193A,A03,083781,Staff,0,4,30,30
1650464555044,MATH 193A,A04,083782,Staff,0,5,30,30
1650464561067,MATH 197,001,091859,McAuley; Julian John,9998,0,9999,1
1650464567128,COGS 9,A01,083615,Staff,0,14,60,60
1650464573155,COGS 11,A01,083617,Boyle; Mary E. T.,21,0,40,19
1650464579180,COGS 13,A01,083071,Staff,0,34,40,40
1650464585205,COGS 14A,A01,092681,Staff,1,25,100,99
1650464591228,COGS 14B,A01,083073,Cheng; Tzu-Han,0,11,50,50
1650464597256,COGS 17,A01,092677,Staff,22,0,75,53
1650464603280,COGS 100,A01,083619,Staff,0,26,60,60
1650464609302,COGS 101A,A01,083621,Davis; Joshua Daniel,0,21,60,60
1650464615334,COGS 101B,A01,091572,Staff,0,4,60,60
1650464621357,COGS 101C,A01,083625,Delgado; Tania,16,0,30,14
1650464627382,COGS 107A,A01,083627,Boyle; Mary E. T.,0,11,60,60
1650464633409,COGS 118A,A01,083075,Staff,2,0,60,58
1650464639437,CSE 3,A50,083646,Miranda; Gregory Joseph,20,0,38,18
1650464639437,CSE 3,A51,083647,Miranda; Gregory Joseph,36,0,37,1
1650464645466,CSE 8A,A50,083650,Miranda; Gregory Joseph,0,28,40,40
1650464651499,CSE 11,A01,083080,Cao; Yingjun,0,92,40,40
1650464657525,CSE 12,A01,083652,Staff,0,16,100,100
1650464663553,CSE 15L,A01,083654,Staff,0,1,50,50
1650464663553,CSE 15L,A02,083655,Staff,1,0,50,49
1650464669578,CSE 20,A01,083657,Staff,51,0,80,29
1650464675606,CSE 30,A01,083084,Eldon; John,0,76,40,40
1650464681630,CSE 100,A01,083659,Cao; Yingjun,0,66,50,50
1650464687652,CSE 134B,A01,083661,Powell; Thomas Allan,0,32,65,65
1650464693677,CSE 140,A01,083663,Staff,0,2,75,75
1650464699702,CSE 140L,A01,083088,Eldon; John,0,8,75,75
1650464705727,CSE 175,A01,083665,Kumar; Rakesh,7,0,25,18
1650464711750,CSE 190,A00,092507,Dubnov; Shlomo,14,0,20,6
1650464717774,ECE 45,A01,083139,Staff,20,18,60,40
1650464723798,ECE 65,A50,083695,Staff,0,6,30,30
1650464729824,ECE 109,A01,091882,Touri; Behrouz,38,0,70,32
1650464735851,ECE 180,A00,083140,Abi Samra; Nicholas Camill,23,0,30,7
1650464735851,ECE 180,B00,083141,Abi Samra; Nicholas Camill,0,0,30,30
1650464741878,MATH 10A,A01,083735,Patchell; Gregory David,7,0,30,23
1650464741878,MATH 10A,A02,083736,Patchell; Gregory David,28,0,30,2
1650464741878,MATH 10A,A03,083737,Patchell; Gregory David,25,0,30,5
1650464747905,MATH 10B,A01,083207,Staff,0,7,30,30
1650464747905,MATH 10B,A02,083208,Staff,0,7,30,30
1650464747905,MATH 10B,B01,083739,Staff,13,0,30,17
1650464747905,MATH 10B,B02,083740,Staff,28,0,30,2
1650464753928,MATH 18,A01,083743,Staff,1,0,30,29
1650464753928,MATH 18,A02,083744,Staff,27,0,30,3
1650464753928,MATH 18,A03,083745,Staff,22,0,30,8
1650464753928,MATH 18,A04,083746,Staff,26,0,30,4
1650464753928,MATH 18,B01,083748,Staff,0,11,30,30
1650464753928,MATH 18,B02,083749,Staff,0,12,30,30
1650464753928,MATH 18,B03,083750,Staff,0,11,30,30
1650464753928,MATH 18,B04,083751,Staff,0,12,30,30
1650464759955,MATH 20A,A01,083754,Staff,25,0,40,15
1650464765983,MATH 20B,A01,083756,Staff,0,10,30,30
1650464765983,MATH 20B,A02,083757,Staff,0,10,30,30
1650464772012,MATH 20C,A01,083760,Staff,0,15,30,30
1650464772012,MATH 20C,A02,083761,Staff,1,14,30,29
1650464772012,MATH 20C,B01,083762,Staff,13,0,30,17
1650464772012,MATH 20C,B02,083763,Staff,28,0,30,2
1650464778038,MATH 20D,A01,083765,Staff,0,1,30,30
1650464778038,MATH 20D,A02,083766,Staff,9,0,30,21
1650464778038,MATH 20D,A03,083767,Staff,25,0,30,5
1650464784063,MATH 20E,A01,083771,Staff,6,0,30,24
1650464784063,MATH 20E,A02,083772,Staff,18,0,30,12
1650464784063,MATH 20E,B01,083773,Staff,0,0,30,30
1650464784063,MATH 20E,B02,083774,Staff,10,0,30,20
1650464790087,MATH 103A,A01,083777,Staff,0,12,30,30
1650464790087,MATH 103A,A02,083778,Staff,0,12,30,30
1650464790087,MATH 103A,B01,083779,Staff,0,13,30,30
1650464790087,MATH 103A,B02,083780,Staff,0,12,30,30
1650464796112,MATH 105,A01,085443,Staff,0,23,30,30
1650464802137,MATH 109,A01,083213,Anzaldo; Leesa B,0,7,30,30
1650464802137,MATH 109,A02,083214,Anzaldo; Leesa B,0,7,30,30
1650464802137,MATH 109,B01,083215,Anzaldo; Leesa B,0,5,30,30
1650464802137,MATH 109,B02,083216,Anzaldo; Leesa B,0,6,30,30
1650464808162,MATH 142A,A01,083219,Chow; Bennett,0,14,30,30
1650464808162,MATH 142A,A02,083220,Chow; Bennett,0,13,30,30
1650464808162,MATH 142A,B01,083221,Chow; Bennett,0,12,30,30
1650464808162,MATH 142A,B02,083222,Chow; Bennett,0,13,30,30
1650464814186,MATH 193A,A01,083224,Staff,0,5,30,30
1650464814186,MATH 193A,A02,083225,Staff,0,5,30,30
1650464814186,MATH 193A,A03,083781,Staff,0,4,30,30
1650464814186,MATH 193A,A04,083782,Staff,0,5,30,30
1650464820219,MATH 197,001,091859,McAuley; Julian John,9998,0,9999,1
1650464826283,COGS 9,A01,083615,Staff,0,14,60,60
1650464832307,COGS 11,A01,083617,Boyle; Mary E. T.,21,0,40,19
1650464838334,COGS 13,A01,083071,Staff,0,34,40,40
1650464844359,COGS 14A,A01,092681,Staff,1,25,100,99
1650464850383,COGS 14B,A01,083073,Cheng; Tzu-Han,0,11,50,50
1650464856410,COGS 17,A01,092677,Staff,22,0,75,53
1650464862433,COGS 100,A01,083619,Staff,0,26,60,60
1650464868461,COGS 101A,A01,083621,Davis; Joshua Daniel,0,21,60,60
1650464874485,COGS 101B,A01,091572,Staff,0,4,60,60
1650464880514,COGS 101C,A01,083625,Delgado; Tania,16,0,30,14
1650464886550,COGS 107A,A01,083627,Boyle; Mary E. T.,0,11,60,60
1650464892582,COGS 118A,A01,083075,Staff,2,0,60,58
1650464898609,CSE 3,A50,083646,Miranda; Gregory Joseph,20,0,38,18
1650464898609,CSE 3,A51,083647,Miranda; Gregory Joseph,36,0,37,1
1650464904634,CSE 8A,A50,083650,Miranda; Gregory Joseph,0,28,40,40
1650464910669,CSE 11,A01,083080,Cao; Yingjun,0,92,40,40
1650464916694,CSE 12,A01,083652,Staff,0,16,100,100
1650464922716,CSE 15L,A01,083654,Staff,0,1,50,50
1650464922716,CSE 15L,A02,083655,Staff,1,0,50,49
1650464928740,CSE 20,A01,083657,Staff,51,0,80,29
1650464934763,CSE 30,A01,083084,Eldon; John,0,76,40,40
1650464940785,CSE 100,A01,083659,Cao; Yingjun,0,66,50,50
1650464946818,CSE 134B,A01,083661,Powell; Thomas Allan,0,32,65,65
1650464952852,CSE 140,A01,083663,Staff,0,2,75,75
1650464958880,CSE 140L,A01,083088,Eldon; John,0,8,75,75
1650464964977,CSE 175,A01,083665,Kumar; Rakesh,7,0,25,18
1650464971000,CSE 190,A00,092507,Dubnov; Shlomo,14,0,20,6
1650464977024,ECE 45,A01,083139,Staff,20,18,60,40
1650464983049,ECE 65,A50,083695,Staff,0,6,30,30
1650464989076,ECE 109,A01,091882,Touri; Behrouz,38,0,70,32
1650464995103,ECE 180,A00,083140,Abi Samra; Nicholas Camill,23,0,30,7
1650464995103,ECE 180,B00,083141,Abi Samra; Nicholas Camill,0,0,30,30
1650465001129,MATH 10A,A01,083735,Patchell; Gregory David,7,0,30,23
1650465001129,MATH 10A,A02,083736,Patchell; Gregory David,28,0,30,2
1650465001129,MATH 10A,A03,083737,Patchell; Gregory David,25,0,30,5
1650465007157,MATH 10B,A01,083207,Staff,0,7,30,30
1650465007157,MATH 10B,A02,083208,Staff,0,7,30,30
1650465007157,MATH 10B,B01,083739,Staff,13,0,30,17
1650465007157,MATH 10B,B02,083740,Staff,28,0,30,2
1650465013187,MATH 18,A01,083743,Staff,1,0,30,29
1650465013187,MATH 18,A02,083744,Staff,27,0,30,3
1650465013187,MATH 18,A03,083745,Staff,22,0,30,8
1650465013187,MATH 18,A04,083746,Staff,26,0,30,4
1650465013187,MATH 18,B01,083748,Staff,0,11,30,30
1650465013187,MATH 18,B02,083749,Staff,0,12,30,30
1650465013187,MATH 18,B03,083750,Staff,0,11,30,30
1650465013187,MATH 18,B04,083751,Staff,0,12,30,30
1650465019213,MATH 20A,A01,083754,Staff,25,0,40,15
1650465025241,MATH 20B,A01,083756,Staff,0,10,30,30
1650465025241,MATH 20B,A02,083757,Staff,0,10,30,30
1650465031265,MATH 20C,A01,083760,Staff,0,15,30,30
1650465031265,MATH 20C,A02,083761,Staff,1,14,30,29
1650465031265,MATH 20C,B01,083762,Staff,13,0,30,17
1650465031265,MATH 20C,B02,083763,Staff,28,0,30,2
1650465037293,MATH 20D,A01,083765,Staff,0,1,30,30
1650465037293,MATH 20D,A02,083766,Staff,9,0,30,21
1650465037293,MATH 20D,A03,083767,Staff,25,0,30,5
1650465043321,MATH 20E,A01,083771,Staff,6,0,30,24
1650465043321,MATH 20E,A02,083772,Staff,18,0,30,12
1650465043321,MATH 20E,B01,083773,Staff,0,0,30,30
1650465043321,MATH 20E,B02,083774,Staff,10,0,30,20
1650465049343,MATH 103A,A01,083777,Staff,0,12,30,30
1650465049343,MATH 103A,A02,083778,Staff,0,12,30,30
1650465049343,MATH 103A,B01,083779,Staff,0,13,30,30
1650465049343,MATH 103A,B02,083780,Staff,0,12,30,30
1650465055373,MATH 105,A01,085443,Staff,0,23,30,30
1650465061399,MATH 109,A01,083213,Anzaldo; Leesa B,0,7,30,30
1650465061399,MATH 109,A02,083214,Anzaldo; Leesa B,0,7,30,30
1650465061399,MATH 109,B01,083215,Anzaldo; Leesa B,0,5,30,30
1650465061399,MATH 109,B02,083216,Anzaldo; Leesa B,0,6,30,30
1650465067429,MATH 142A,A01,083219,Chow; Bennett,0,14,30,30
1650465067429,MATH 142A,A02,083220,Chow; Bennett,0,13,30,30
1650465067429,MATH 142A,B01,083221,Chow; Bennett,0,12,30,30
1650465067429,MATH 142A,B02,083222,Chow; Bennett,0,13,30,30
1650465073453,MATH 193A,A01,083224,Staff,0,5,30,30
1650465073453,MATH 193A,A02,083225,Staff,0,5,30,30
1650465073453,MATH 193A,A03,083781,Staff,0,4,30,30
1650465073453,MATH 193A,A04,083782,Staff,0,5,30,30
1650465079479,MATH 197,001,091859,McAuley; Julian John,9998,0,9999,1
1650465085553,COGS 9,A01,083615,Staff,0,14,60,60
1650465091585,COGS 11,A01,083617,Boyle; Mary E. T.,21,0,40,19
1650465097609,COGS 13,A01,083071,Staff,0,34,40,40
1650465103634,COGS 14A,A01,092681,Staff,1,25,100,99
1650465109659,COGS 14B,A01,083073,Cheng; Tzu-Han,0,11,50,50
1650465115686,COGS 17,A01,092677,Staff,22,0,75,53
1650465121714,COGS 100,A01,083619,Staff,0,26,60,60
1650465127743,COGS 101A,A01,083621,Davis; Joshua Daniel,0,21,60,60
1650465133770,COGS 101B,A01,091572,Staff,0,4,60,60
1650465139797,COGS 101C,A01,083625,Delgado; Tania,16,0,30,14
1650465145836,COGS 107A,A01,083627,Boyle; Mary E. T.,0,11,60,60
1650465151860,COGS 118A,A01,083075,Staff,2,0,60,58
1650465157888,CSE 3,A50,083646,Miranda; Gregory Joseph,20,0,38,18
1650465157888,CSE 3,A51,083647,Miranda; Gregory Joseph,36,0,37,1
1650465163916,CSE 8A,A50,083650,Miranda; Gregory Joseph,0,28,40,40
1650465169943,CSE 11,A01,083080,Cao; Yingjun,0,92,40,40
1650465175969,CSE 12,A01,083652,Staff,0,16,100,100
1650465182004,CSE 15L,A01,083654,Staff,0,1,50,50
1650465182004,CSE 15L,A02,083655,Staff,1,0,50,49
1650465188028,CSE 20,A01,083657,Staff,51,0,80,29
1650465194052,CSE 30,A01,083084,Eldon; John,0,76,40,40
1650465200081,CSE 100,A01,083659,Cao; Yingjun,0,66,50,50
1650465206107,CSE 134B,A01,083661,Powell; Thomas Allan,0,32,65,65
1650465212131,CSE 140,A01,083663,Staff,0,2,75,75
1650465218154,CSE 140L,A01,083088,Eldon; John,0,8,75,75
1650465224181,CSE 175,A01,083665,Kumar; Rakesh,7,0,25,18
1650465230210,CSE 190,A00,092507,Dubnov; Shlomo,14,0,20,6
1650465236240,ECE 45,A01,083139,Staff,20,18,60,40
1650465242265,ECE 65,A50,083695,Staff,0,6,30,30
1650465248291,ECE 109,A01,091882,Touri; Behrouz,38,0,70,32
1650465254317,ECE 180,A00,083140,Abi Samra; Nicholas Camill,23,0,30,7
1650465254317,ECE 180,B00,083141,Abi Samra; Nicholas Camill,0,0,30,30
1650465260345,MATH 10A,A01,083735,Patchell; Gregory David,7,0,30,23
1650465260345,MATH 10A,A02,083736,Patchell; Gregory David,28,0,30,2
1650465260345,MATH 10A,A03,083737,Patchell; Gregory David,25,0,30,5
1650465266370,MATH 10B,A01,083207,Staff,0,7,30,30
1650465266370,MATH 10B,A02,083208,Staff,0,7,30,30
1650465266370,MATH 10B,B01,083739,Staff,13,0,30,17
1650465266370,MATH 10B,B02,083740,Staff,28,0,30,2
1650465272395,MATH 18,A01,083743,Staff,1,0,30,29
1650465272395,MATH 18,A02,083744,Staff,27,0,30,3
1650465272395,MATH 18,A03,083745,Staff,22,0,30,8
1650465272395,MATH 18,A04,083746,Staff,26,0,30,4
1650465272395,MATH 18,B01,083748,Staff,0,11,30,30
1650465272395,MATH 18,B02,083749,Staff,0,12,30,30
1650465272395,MATH 18,B03,083750,Staff,0,11,30,30
1650465272395,MATH 18,B04,083751,Staff,0,12,30,30
1650465278418,MATH 20A,A01,083754,Staff,25,0,40,15
1650465284442,MATH 20B,A01,083756,Staff,0,10,30,30
1650465284442,MATH 20B,A02,083757,Staff,0,10,30,30
1650465290470,MATH 20C,A01,083760,Staff,0,15,30,30
1650465290470,MATH 20C,A02,083761,Staff,1,14,30,29
1650465290470,MATH 20C,B01,083762,Staff,13,0,30,17
1650465290470,MATH 20C,B02,083763,Staff,28,0,30,2
1650465296496,MATH 20D,A01,083765,Staff,0,1,30,30
1650465296496,MATH 20D,A02,083766,Staff,9,0,30,21
1650465296496,MATH 20D,A03,083767,Staff,25,0,30,5
1650465302520,MATH 20E,A01,083771,Staff,6,0,30,24
1650465302520,MATH 20E,A02,083772,Staff,18,0,30,12
1650465302520,MATH 20E,B01,083773,Staff,0,0,30,30
1650465302520,MATH 20E,B02,083774,Staff,10,0,30,20
1650465308545,MATH 103A,A01,083777,Staff,0,12,30,30
1650465308545,MATH 103A,A02,083778,Staff,0,12,30,30
1650465308545,MATH 103A,B01,083779,Staff,0,13,30,30
1650465308545,MATH 103A,B02,083780,Staff,0,12,30,30
1650465314572,MATH 105,A01,085443,Staff,0,23,30,30
1650465320601,MATH 109,A01,083213,Anzaldo; Leesa B,0,7,30,30
1650465320601,MATH 109,A02,083214,Anzaldo; Leesa B,0,7,30,30
1650465320601,MATH 109,B01,083215,Anzaldo; Leesa B,0,5,30,30
1650465320601,MATH 109,B02,083216,Anzaldo; Leesa B,0,6,30,30
1650465326628,MATH 142A,A01,083219,Chow; Bennett,0,14,30,30
1650465326628,MATH 142A,A02,083220,Chow; Bennett,0,13,30,30
1650465326628,MATH 142A,B01,083221,Chow; Bennett,0,12,30,30
1650465326628,MATH 142A,B02,083222,Chow; Bennett,0,13,30,30
1650465332653,MATH 193A,A01,083224,Staff,0,5,30,30
1650465332653,MATH 193A,A02,083225,Staff,0,5,30,30
1650465332653,MATH 193A,A03,083781,Staff,0,4,30,30
1650465332653,MATH 193A,A04,083782,Staff,0,5,30,30
1650465338709,MATH 197,001,091859,McAuley; Julian John,9998,0,9999,1
1650465344774,COGS 9,A01,083615,Staff,0,14,60,60
1650465350798,COGS 11,A01,083617,Boyle; Mary E. T.,21,0,40,19
1650465356822,COGS 13,A01,083071,Staff,0,34,40,40
1650465362847,COGS 14A,A01,092681,Staff,1,25,100,99
1650465368874,COGS 14B,A01,083073,Cheng; Tzu-Han,0,11,50,50
1650465374897,COGS 17,A01,092677,Staff,22,0,75,53
1650465380921,COGS 100,A01,083619,Staff,0,26,60,60
1650465386946,COGS 101A,A01,083621,Davis; Joshua Daniel,0,21,60,60
1650465392970,COGS 101B,A01,091572,Staff,0,4,60,60
1650465398994,COGS 101C,A01,083625,Delgado; Tania,16,0,30,14
1650465405019,COGS 107A,A01,083627,Boyle; Mary E. T.,0,11,60,60
1650465411045,COGS 118A,A01,083075,Staff,2,0,60,58
1650465417070,CSE 3,A50,083646,Miranda; Gregory Joseph,20,0,38,18
1650465417070,CSE 3,A51,083647,Miranda; Gregory Joseph,36,0,37,1
1650465423094,CSE 8A,A50,083650,Miranda; Gregory Joseph,0,28,40,40
1650465429120,CSE 11,A01,083080,Cao; Yingjun,0,92,40,40
1650465435144,CSE 12,A01,083652,Staff,0,16,100,100
1650465441168,CSE 15L,A01,083654,Staff,0,1,50,50
1650465441168,CSE 15L,A02,083655,Staff,1,0,50,49
1650465447195,CSE 20,A01,083657,Staff,51,0,80,29
1650465453219,CSE 30,A01,083084,Eldon; John,0,76,40,40
1650465459244,CSE 100,A01,083659,Cao; Yingjun,0,66,50,50
1650465465270,CSE 134B,A01,083661,Powell; Thomas Allan,0,32,65,65
1650465471294,CSE 140,A01,083663,Staff,0,2,75,75
1650465477322,CSE 140L,A01,083088,Eldon; John,0,8,75,75
1650465483346,CSE 175,A01,083665,Kumar; Rakesh,7,0,25,18
1650465489370,CSE 190,A00,092507,Dubnov; Shlomo,14,0,20,6
1650465495394,ECE 45,A01,083139,Staff,20,18,60,40
1650465501417,ECE 65,A50,083695,Staff,0,6,30,30
1650465507454,ECE 109,A01,091882,Touri; Behrouz,38,0,70,32
1650465513482,ECE 180,A00,083140,Abi Samra; Nicholas Camill,23,0,30,7
1650465513482,ECE 180,B00,083141,Abi Samra; Nicholas Camill,0,0,30,30
1650465519506,MATH 10A,A01,083735,Patchell; Gregory David,7,0,30,23
1650465519506,MATH 10A,A02,083736,Patchell; Gregory David,28,0,30,2
1650465519506,MATH 10A,A03,083737,Patchell; Gregory David,25,0,30,5
1650465525528,MATH 10B,A01,083207,Staff,0,7,30,30
1650465525528,MATH 10B,A02,083208,Staff,0,7,30,30
1650465525528,MATH 10B,B01,083739,Staff,13,0,30,17
1650465525528,MATH 10B,B02,083740,Staff,28,0,30,2
1650465531558,MATH 18,A01,083743,Staff,1,0,30,29
1650465531558,MATH 18,A02,083744,Staff,27,0,30,3
1650465531558,MATH 18,A03,083745,Staff,22,0,30,8
1650465531558,MATH 18,A04,083746,Staff,26,0,30,4
1650465531558,MATH 18,B01,083748,Staff,0,11,30,30
1650465531558,MATH 18,B02,083749,Staff,0,12,30,30
1650465531558,MATH 18,B03,083750,Staff,0,11,30,30
1650465531558,MATH 18,B04,083751,Staff,0,12,30,30
1650465537582,MATH 20A,A01,083754,Staff,25,0,40,15
1650465543604,MATH 20B,A01,083756,Staff,0,10,30,30
1650465543604,MATH 20B,A02,083757,Staff,0,10,30,30
1650465549626,MATH 20C,A01,083760,Staff,0,15,30,30
1650465549626,MATH 20C,A02,083761,Staff,1,14,30,29
1650465549626,MATH 20C,B01,083762,Staff,13,0,30,17
1650465549626,MATH 20C,B02,083763,Staff,28,0,30,2
1650465555650,MATH 20D,A01,083765,Staff,0,1,30,30
1650465555650,MATH 20D,A02,083766,Staff,9,0,30,21
1650465555650,MATH 20D,A03,083767,Staff,25,0,30,5
1650465561747,MATH 20E,A01,083771,Staff,6,0,30,24
1650465561747,MATH 20E,A02,083772,Staff,18,0,30,12
1650465561747,MATH 20E,B01,083773,Staff,0,0,30,30
1650465561747,MATH 20E,B02,083774,Staff,10,0,30,20
1650465567775,MATH 103A,A01,083777,Staff,0,12,30,30
1650465567775,MATH 103A,A02,083778,Staff,0,12,30,30
1650465567775,MATH 103A,B01,083779,Staff,0,13,30,30
1650465567775,MATH 103A,B02,083780,Staff,0,12,30,30
1650465573801,MATH 105,A01,085443,Staff,0,23,30,30
1650465579825,MATH 109,A01,083213,Anzaldo; Leesa B,0,7,30,30
1650465579825,MATH 109,A02,083214,Anzaldo; Leesa B,0,7,30,30
1650465579825,MATH 109,B01,083215,Anzaldo; Leesa B,0,5,30,30
1650465579825,MATH 109,B02,083216,Anzaldo; Leesa B,0,6,30,30
1650465585854,MATH 142A,A01,083219,Chow; Bennett,0,14,30,30
1650465585854,MATH 142A,A02,083220,Chow; Bennett,0,13,30,30
1650465585854,MATH 142A,B01,083221,Chow; Bennett,0,12,30,30
1650465585854,MATH 142A,B02,083222,Chow; Bennett,0,13,30,30
1650465591883,MATH 193A,A01,083224,Staff,0,5,30,30
1650465591883,MATH 193A,A02,083225,Staff,0,5,30,30
1650465591883,MATH 193A,A03,083781,Staff,0,4,30,30
1650465591883,MATH 193A,A04,083782,Staff,0,5,30,30
1650465597908,MATH 197,001,091859,McAuley; Julian John,9998,0,9999,1
1650465603962,COGS 9,A01,083615,Staff,0,14,60,60
1650465609991,COGS 11,A01,083617,Boyle; Mary E. T.,21,0,40,19
1650465616016,COGS 13,A01,083071,Staff,0,34,40,40
1650465622039,COGS 14A,A01,092681,Staff,1,25,100,99
1650465628067,COGS 14B,A01,083073,Cheng; Tzu-Han,0,11,50,50
1650465634099,COGS 17,A01,092677,Staff,22,0,75,53
1650465640129,COGS 100,A01,083619,Staff,0,26,60,60
1650465646152,COGS 101A,A01,083621,Davis; Joshua Daniel,0,21,60,60
1650465652179,COGS 101B,A01,091572,Staff,0,4,60,60
1650465658206,COGS 101C,A01,083625,Delgado; Tania,16,0,30,14
1650465664233,COGS 107A,A01,083627,Boyle; Mary E. T.,0,11,60,60
1650465670256,COGS 118A,A01,083075,Staff,2,0,60,58
1650465676286,CSE 3,A50,083646,Miranda; Gregory Joseph,20,0,38,18
1650465676286,CSE 3,A51,083647,Miranda; Gregory Joseph,36,0,37,1
1650465682311,CSE 8A,A50,083650,Miranda; Gregory Joseph,0,28,40,40
1650465688336,CSE 11,A01,083080,Cao; Yingjun,0,92,40,40
1650465694373,CSE 12,A01,083652,Staff,0,16,100,100
1650465700396,CSE 15L,A01,083654,Staff,0,1,50,50
1650465700396,CSE 15L,A02,083655,Staff,1,0,50,49
1650465706421,CSE 20,A01,083657,Staff,51,0,80,29
1650465712445,CSE 30,A01,083084,Eldon; John,0,76,40,40
1650465718468,CSE 100,A01,083659,Cao; Yingjun,0,66,50,50
1650465724499,CSE 134B,A01,083661,Powell; Thomas Allan,0,32,65,65
1650465730530,CSE 140,A01,083663,Staff,0,2,75,75
1650465736555,CSE 140L,A01,083088,Eldon; John,0,8,75,75
1650465742582,CSE 175,A01,083665,Kumar; Rakesh,7,0,25,18
1650465748607,CSE 190,A00,092507,Dubnov; Shlomo,14,0,20,6
1650465754634,ECE 45,A01,083139,Staff,20,18,60,40
1650465760665,ECE 65,A50,083695,Staff,0,6,30,30
1650465766687,ECE 109,A01,091882,Touri; Behrouz,38,0,70,32
1650465772711,ECE 180,A00,083140,Abi Samra; Nicholas Camill,23,0,30,7
1650465772711,ECE 180,B00,083141,Abi Samra; Nicholas Camill,0,0,30,30
1650465778735,MATH 10A,A01,083735,Patchell; Gregory David,7,0,30,23
1650465778735,MATH 10A,A02,083736,Patchell; Gregory David,28,0,30,2
1650465778735,MATH 10A,A03,083737,Patchell; Gregory David,25,0,30,5
1650465784759,MATH 10B,A01,083207,Staff,0,7,30,30
1650465784759,MATH 10B,A02,083208,Staff,0,7,30,30
1650465784759,MATH 10B,B01,083739,Staff,13,0,30,17
1650465784759,MATH 10B,B02,083740,Staff,28,0,30,2
1650465790785,MATH 18,A01,083743,Staff,1,0,30,29
1650465790785,MATH 18,A02,083744,Staff,27,0,30,3
1650465790785,MATH 18,A03,083745,Staff,22,0,30,8
1650465790785,MATH 18,A04,083746,Staff,26,0,30,4
1650465790785,MATH 18,B01,083748,Staff,0,11,30,30
1650465790785,MATH 18,B02,083749,Staff,0,12,30,30
1650465790785,MATH 18,B03,083750,Staff,0,11,30,30
1650465790785,MATH 18,B04,083751,Staff,0,12,30,30
1650465796811,MATH 20A,A01,083754,Staff,25,0,40,15
1650465802835,MATH 20B,A01,083756,Staff,0,10,30,30
1650465802835,MATH 20B,A02,083757,Staff,0,10,30,30
1650465808862,MATH 20C,A01,083760,Staff,0,15,30,30
1650465808862,MATH 20C,A02,083761,Staff,1,14,30,29
1650465808862,MATH 20C,B01,083762,Staff,13,0,30,17
1650465808862,MATH 20C,B02,083763,Staff,28,0,30,2
1650465814886,MATH 20D,A01,083765,Staff,0,1,30,30
1650465814886,MATH 20D,A02,083766,Staff,9,0,30,21
1650465814886,MATH 20D,A03,083767,Staff,25,0,30,5
1650465820913,MATH 20E,A01,083771,Staff,6,0,30,24
1650465820913,MATH 20E,A02,083772,Staff,18,0,30,12
1650465820913,MATH 20E,B01,083773,Staff,0,0,30,30
1650465820913,MATH 20E,B02,083774,Staff,10,0,30,20
1650465826940,MATH 103A,A01,083777,Staff,0,12,30,30
1650465826940,MATH 103A,A02,083778,Staff,0,12,30,30
1650465826940,MATH 103A,B01,083779,Staff,0,13,30,30
1650465826940,MATH 103A,B02,083780,Staff,0,12,30,30
1650465832965,MATH 105,A01,085443,Staff,0,23,30,30
1650465838990,MATH 109,A01,083213,Anzaldo; Leesa B,0,7,30,30
1650465838990,MATH 109,A02,083214,Anzaldo; Leesa B,0,7,30,30
1650465838990,MATH 109,B01,083215,Anzaldo; Leesa B,0,5,30,30
1650465838990,MATH 109,B02,083216,Anzaldo; Leesa B,0,6,30,30
1650465845014,MATH 142A,A01,083219,Chow; Bennett,0,14,30,30
1650465845014,MATH 142A,A02,083220,Chow; Bennett,0,13,30,30
1650465845014,MATH 142A,B01,083221,Chow; Bennett,0,12,30,30
1650465845014,MATH 142A,B02,083222,Chow; Bennett,0,13,30,30
1650465851043,MATH 193A,A01,083224,Staff,0,5,30,30
1650465851043,MATH 193A,A02,083225,Staff,0,5,30,30
1650465851043,MATH 193A,A03,083781,Staff,0,4,30,30
1650465851043,MATH 193A,A04,083782,Staff,0,5,30,30
1650465857067,MATH 197,001,091859,McAuley; Julian John,9998,0,9999,1
1650465863126,COGS 9,A01,083615,Staff,0,14,60,60
1650465869158,COGS 11,A01,083617,Boyle; Mary E. T.,21,0,40,19
1650465875185,COGS 13,A01,083071,Staff,0,34,40,40
1650465881212,COGS 14A,A01,092681,Staff,1,25,100,99
1650465887235,COGS 14B,A01,083073,Cheng; Tzu-Han,0,11,50,50
1650465893260,COGS 17,A01,092677,Staff,22,0,75,53
1650465899284,COGS 100,A01,083619,Staff,0,26,60,60
1650465905307,COGS 101A,A01,083621,Davis; Joshua Daniel,0,21,60,60
1650465911353,COGS 101B,A01,091572,Staff,0,4,60,60
1650465917377,COGS 101C,A01,083625,Delgado; Tania,16,0,30,14
1650465923405,COGS 107A,A01,083627,Boyle; Mary E. T.,0,11,60,60
1650465929436,COGS 118A,A01,083075,Staff,2,0,60,58
1650465935461,CSE 3,A50,083646,Miranda; Gregory Joseph,20,0,38,18
1650465935461,CSE 3,A51,083647,Miranda; Gregory Joseph,36,0,37,1
1650465941486,CSE 8A,A50,083650,Miranda; Gregory Joseph,0,28,40,40
1650465947511,CSE 11,A01,083080,Cao; Yingjun,0,92,40,40
1650465953538,CSE 12,A01,083652,Staff,0,16,100,100
1650465959563,CSE 15L,A01,083654,Staff,0,1,50,50
1650465959563,CSE 15L,A02,083655,Staff,1,0,50,49
1650465965585,CSE 20,A01,083657,Staff,51,0,80,29
1650465971617,CSE 30,A01,083084,Eldon; John,0,76,40,40
1650465977649,CSE 100,A01,083659,Cao; Yingjun,0,66,50,50
1650465983674,CSE 134B,A01,083661,Powell; Thomas Allan,0,32,65,65
1650465989700,CSE 140,A01,083663,Staff,0,2,75,75
1650465995723,CSE 140L,A01,083088,Eldon; John,0,8,75,75
1650466001747,CSE 175,A01,083665,Kumar; Rakesh,7,0,25,18
1650466007773,CSE 190,A00,092507,Dubnov; Shlomo,14,0,20,6
1650466013796,ECE 45,A01,083139,Staff,20,18,60,40
1650466019820,ECE 65,A50,083695,Staff,0,6,30,30
1650466025846,ECE 109,A01,091882,Touri; Behrouz,38,0,70,32
1650466031870,ECE 180,A00,083140,Abi Samra; Nicholas Camill,23,0,30,7
1650466031870,ECE 180,B00,083141,Abi Samra; Nicholas Camill,0,0,30,30
1650466037894,MATH 10A,A01,083735,Patchell; Gregory David,7,0,30,23
1650466037894,MATH 10A,A02,083736,Patchell; Gregory David,28,0,30,2
1650466037894,MATH 10A,A03,083737,Patchell; Gregory David,25,0,30,5
1650466043921,MATH 10B,A01,083207,Staff,0,7,30,30
1650466043921,MATH 10B,A02,083208,Staff,0,7,30,30
1650466043921,MATH 10B,B01,083739,Staff,13,0,30,17
1650466043921,MATH 10B,B02,083740,Staff,28,0,30,2
1650466049947,MATH 18,A01,083743,Staff,1,0,30,29
1650466049947,MATH 18,A02,083744,Staff,27,0,30,3
1650466049947,MATH 18,A03,083745,Staff,22,0,30,8
1650466049947,MATH 18,A04,083746,Staff,26,0,30,4
1650466049947,MATH 18,B01,083748,Staff,0,11,30,30
1650466049947,MATH 18,B02,083749,Staff,0,12,30,30
1650466049947,MATH 18,B03,083750,Staff,0,11,30,30
1650466049947,MATH 18,B04,083751,Staff,0,12,30,30
1650466055970,MATH 20A,A01,083754,Staff,25,0,40,15
1650466061993,MATH 20B,A01,083756,Staff,0,10,30,30
1650466061993,MATH 20B,A02,083757,Staff,0,10,30,30
1650466068018,MATH 20C,A01,083760,Staff,0,15,30,30
1650466068018,MATH 20C,A02,083761,Staff,1,14,30,29
1650466068018,MATH 20C,B01,083762,Staff,13,0,30,17
1650466068018,MATH 20C,B02,083763,Staff,28,0,30,2
1650466074042,MATH 20D,A01,083765,Staff,0,1,30,30
1650466074042,MATH 20D,A02,083766,Staff,9,0,30,21
1650466074042,MATH 20D,A03,083767,Staff,25,0,30,5
1650466080065,MATH 20E,A01,083771,Staff,6,0,30,24
1650466080065,MATH 20E,A02,083772,Staff,18,0,30,12
1650466080065,MATH 20E,B01,083773,Staff,0,0,30,30
1650466080065,MATH 20E,B02,083774,Staff,10,0,30,20
1650466086094,MATH 103A,A01,083777,Staff,0,12,30,30
1650466086094,MATH 103A,A02,083778,Staff,0,12,30,30
1650466086094,MATH 103A,B01,083779,Staff,0,13,30,30
1650466086094,MATH 103A,B02,083780,Staff,0,12,30,30
1650466092119,MATH 105,A01,085443,Staff,0,23,30,30
1650466098144,MATH 109,A01,083213,Anzaldo; Leesa B,0,7,30,30
1650466098144,MATH 109,A02,083214,Anzaldo; Leesa B,0,7,30,30
1650466098144,MATH 109,B01,083215,Anzaldo; Leesa B,0,5,30,30
1650466098144,MATH 109,B02,083216,Anzaldo; Leesa B,0,6,30,30
1650466104176,MATH 142A,A01,083219,Chow; Bennett,0,14,30,30
1650466104176,MATH 142A,A02,083220,Chow; Bennett,0,13,30,30
1650466104176,MATH 142A,B01,083221,Chow; Bennett,0,12,30,30
1650466104176,MATH 142A,B02,083222,Chow; Bennett,0,13,30,30
1650466110199,MATH 193A,A01,083224,Staff,0,5,30,30
1650466110199,MATH 193A,A02,083225,Staff,0,5,30,30
1650466110199,MATH 193A,A03,083781,Staff,0,4,30,30
1650466110199,MATH 193A,A04,083782,Staff,0,5,30,30
1650466116223,MATH 197,001,091859,McAuley; Julian John,9998,0,9999,1
1650466122276,COGS 9,A01,083615,Staff,0,14,60,60
1650466128301,COGS 11,A01,083617,Boyle; Mary E. T.,21,0,40,19
1650466134324,COGS 13,A01,083071,Staff,0,34,40,40
1650466140348,COGS 14A,A01,092681,Staff,1,25,100,99
1650466146373,COGS 14B,A01,083073,Cheng; Tzu-Han,0,11,50,50
1650466152487,COGS 17,A01,092677,Staff,22,0,75,53
1650466158509,COGS 100,A01,083619,Staff,0,26,60,60
1650466164541,COGS 101A,A01,083621,Davis; Joshua Daniel,0,21,60,60
1650466170566,COGS 101B,A01,091572,Staff,0,4,60,60
1650466176591,COGS 101C,A01,083625,Delgado; Tania,16,0,30,14
1650466182618,COGS 107A,A01,083627,Boyle; Mary E. T.,0,11,60,60
1650466188645,COGS 118A,A01,083075,Staff,2,0,60,58
1650466194674,CSE 3,A50,083646,Miranda; Gregory Joseph,20,0,38,18
1650466194674,CSE 3,A51,083647,Miranda; Gregory Joseph,36,0,37,1
1650466200701,CSE 8A,A50,083650,Miranda; Gregory Joseph,0,28,40,40
1650466206727,CSE 11,A01,083080,Cao; Yingjun,0,92,40,40
1650466212752,CSE 12,A01,083652,Staff,0,16,100,100
1650466218778,CSE 15L,A01,083654,Staff,0,1,50,50
1650466218778,CSE 15L,A02,083655,Staff,1,0,50,49
1650466224803,CSE 20,A01,083657,Staff,51,0,80,29
1650466230827,CSE 30,A01,083084,Eldon; John,0,76,40,40
1650466236854,CSE 100,A01,083659,Cao; Yingjun,0,66,50,50
1650466242881,CSE 134B,A01,083661,Powell; Thomas Allan,0,32,65,65
1650466248908,CSE 140,A01,083663,Staff,0,2,75,75
1650466254931,CSE 140L,A01,083088,Eldon; John,0,8,75,75
1650466260956,CSE 175,A01,083665,Kumar; Rakesh,7,0,25,18
1650466266984,CSE 190,A00,092507,Dubnov; Shlomo,14,0,20,6
1650466273007,ECE 45,A01,083139,Staff,20,18,60,40
1650466279032,ECE 65,A50,083695,Staff,0,6,30,30
1650466285059,ECE 109,A01,091882,Touri; Behrouz,38,0,70,32
1650466291081,ECE 180,A00,083140,Abi Samra; Nicholas Camill,23,0,30,7
1650466291081,ECE 180,B00,083141,Abi Samra; Nicholas Camill,0,0,30,30
1650466297109,MATH 10A,A01,083735,Patchell; Gregory David,7,0,30,23
1650466297109,MATH 10A,A02,083736,Patchell; Gregory David,28,0,30,2
1650466297109,MATH 10A,A03,083737,Patchell; Gregory David,25,0,30,5
1650466303132,MATH 10B,A01,083207,Staff,0,7,30,30
1650466303132,MATH 10B,A02,083208,Staff,0,7,30,30
1650466303132,MATH 10B,B01,083739,Staff,13,0,30,17
1650466303132,MATH 10B,B02,083740,Staff,28,0,30,2
1650466309157,MATH 18,A01,083743,Staff,1,0,30,29
1650466309157,MATH 18,A02,083744,Staff,27,0,30,3
1650466309157,MATH 18,A03,083745,Staff,22,0,30,8
1650466309157,MATH 18,A04,083746,Staff,26,0,30,4
1650466309157,MATH 18,B01,083748,Staff,0,11,30,30
1650466309157,MATH 18,B02,083749,Staff,0,12,30,30
1650466309157,MATH 18,B03,083750,Staff,0,11,30,30
1650466309157,MATH 18,B04,083751,Staff,0,12,30,30
1650466315181,MATH 20A,A01,083754,Staff,25,0,40,15
1650466321208,MATH 20B,A01,083756,Staff,0,10,30,30
1650466321208,MATH 20B,A02,083757,Staff,0,10,30,30
1650466327236,MATH 20C,A01,083760,Staff,0,15,30,30
1650466327236,MATH 20C,A02,083761,Staff,1,14,30,29
1650466327236,MATH 20C,B01,083762,Staff,13,0,30,17
1650466327236,MATH 20C,B02,083763,Staff,28,0,30,2
1650466333262,MATH 20D,A01,083765,Staff,0,1,30,30
1650466333262,MATH 20D,A02,083766,Staff,9,0,30,21
1650466333262,MATH 20D,A03,083767,Staff,25,0,30,5
1650466339288,MATH 20E,A01,083771,Staff,6,0,30,24
1650466339288,MATH 20E,A02,083772,Staff,18,0,30,12
1650466339288,MATH 20E,B01,083773,Staff,0,0,30,30
1650466339288,MATH 20E,B02,083774,Staff,10,0,30,20
1650466345321,MATH 103A,A01,083777,Staff,0,12,30,30
1650466345321,MATH 103A,A02,083778,Staff,0,12,30,30
1650466345321,MATH 103A,B01,083779,Staff,0,13,30,30
1650466345321,MATH 103A,B02,083780,Staff,0,12,30,30
1650466351345,MATH 105,A01,085443,Staff,0,23,30,30
1650466357369,MATH 109,A01,083213,Anzaldo; Leesa B,0,7,30,30
1650466357369,MATH 109,A02,083214,Anzaldo; Leesa B,0,7,30,30
1650466357369,MATH 109,B01,083215,Anzaldo; Leesa B,0,5,30,30
1650466357369,MATH 109,B02,083216,Anzaldo; Leesa B,0,6,30,30
1650466363413,MATH 142A,A01,083219,Chow; Bennett,0,14,30,30
1650466363413,MATH 142A,A02,083220,Chow; Bennett,0,13,30,30
1650466363413,MATH 142A,B01,083221,Chow; Bennett,0,12,30,30
1650466363413,MATH 142A,B02,083222,Chow; Bennett,0,13,30,30
1650466369441,MATH 193A,A01,083224,Staff,0,5,30,30
1650466369441,MATH 193A,A02,083225,Staff,0,5,30,30
1650466369441,MATH 193A,A03,083781,Staff,0,4,30,30
1650466369441,MATH 193A,A04,083782,Staff,0,5,30,30
1650466375465,MATH 197,001,091859,McAuley; Julian John,9998,0,9999,1
1650466381518,COGS 9,A01,083615,Staff,0,14,60,60
1650466387545,COGS 11,A01,083617,Boyle; Mary E. T.,21,0,40,19
1650466393571,COGS 13,A01,083071,Staff,0,34,40,40
1650466399603,COGS 14A,A01,092681,Staff,1,25,100,99
1650466405639,COGS 14B,A01,083073,Cheng; Tzu-Han,0,11,50,50
1650466411663,COGS 17,A01,092677,Staff,22,0,75,53
1650466417687,COGS 100,A01,083619,Staff,0,26,60,60
1650466423725,COGS 101A,A01,083621,Davis; Joshua Daniel,0,21,60,60
1650466429750,COGS 101B,A01,091572,Staff,0,4,60,60
1650466435776,COGS 101C,A01,083625,Delgado; Tania,16,0,30,14
1650466441800,COGS 107A,A01,083627,Boyle; Mary E. T.,0,11,60,60
1650466447831,COGS 118A,A01,083075,Staff,2,0,60,58
1650466453857,CSE 3,A50,083646,Miranda; Gregory Joseph,20,0,38,18
1650466453857,CSE 3,A51,083647,Miranda; Gregory Joseph,36,0,37,1
1650466459880,CSE 8A,A50,083650,Miranda; Gregory Joseph,0,28,40,40
1650466465905,CSE 11,A01,083080,Cao; Yingjun,0,92,40,40
1650466471928,CSE 12,A01,083652,Staff,0,16,100,100
1650466477959,CSE 15L,A01,083654,Staff,0,1,50,50
1650466477959,CSE 15L,A02,083655,Staff,1,0,50,49
1650466483988,CSE 20,A01,083657,Staff,51,0,80,29
1650466490019,CSE 30,A01,083084,Eldon; John,0,76,40,40
1650466496040,CSE 100,A01,083659,Cao; Yingjun,0,66,50,50
1650466502082,CSE 134B,A01,083661,Powell; Thomas Allan,0,32,65,65
1650466508106,CSE 140,A01,083663,Staff,0,2,75,75
1650466514132,CSE 140L,A01,083088,Eldon; John,0,8,75,75
1650466520156,CSE 175,A01,083665,Kumar; Rakesh,7,0,25,18
1650466526180,CSE 190,A00,092507,Dubnov; Shlomo,14,0,20,6
1650466532207,ECE 45,A01,083139,Staff,20,18,60,40
1650466538233,ECE 65,A50,083695,Staff,0,6,30,30
1650466544259,ECE 109,A01,091882,Touri; Behrouz,38,0,70,32
1650466550283,ECE 180,A00,083140,Abi Samra; Nicholas Camill,23,0,30,7
1650466550283,ECE 180,B00,083141,Abi Samra; Nicholas Camill,0,0,30,30
1650466556307,MATH 10A,A01,083735,Patchell; Gregory David,7,0,30,23
1650466556307,MATH 10A,A02,083736,Patchell; Gregory David,28,0,30,2
1650466556307,MATH 10A,A03,083737,Patchell; Gregory David,25,0,30,5
1650466562330,MATH 10B,A01,083207,Staff,0,7,30,30
1650466562330,MATH 10B,A02,083208,Staff,0,7,30,30
1650466562330,MATH 10B,B01,083739,Staff,13,0,30,17
1650466562330,MATH 10B,B02,083740,Staff,28,0,30,2
1650466568354,MATH 18,A01,083743,Staff,1,0,30,29
1650466568354,MATH 18,A02,083744,Staff,27,0,30,3
1650466568354,MATH 18,A03,083745,Staff,22,0,30,8
1650466568354,MATH 18,A04,083746,Staff,26,0,30,4
1650466568354,MATH 18,B01,083748,Staff,0,11,30,30
1650466568354,MATH 18,B02,083749,Staff,0,12,30,30
1650466568354,MATH 18,B03,083750,Staff,0,11,30,30
1650466568354,MATH 18,B04,083751,Staff,0,12,30,30
1650466574378,MATH 20A,A01,083754,Staff,25,0,40,15
1650466580404,MATH 20B,A01,083756,Staff,0,10,30,30
1650466580404,MATH 20B,A02,083757,Staff,0,10,30,30
1650466586432,MATH 20C,A01,083760,Staff,0,15,30,30
1650466586432,MATH 20C,A02,083761,Staff,1,14,30,29
1650466586432,MATH 20C,B01,083762,Staff,13,0,30,17
1650466586432,MATH 20C,B02,083763,Staff,28,0,30,2
1650466592462,MATH 20D,A01,083765,Staff,0,1,30,30
1650466592462,MATH 20D,A02,083766,Staff,9,0,30,21
1650466592462,MATH 20D,A03,083767,Staff,25,0,30,5
1650466598485,MATH 20E,A01,083771,Staff,6,0,30,24
1650466598485,MATH 20E,A02,083772,Staff,18,0,30,12
1650466598485,MATH 20E,B01,083773,Staff,0,0,30,30
1650466598485,MATH 20E,B02,083774,Staff,10,0,30,20
1650466604514,MATH 103A,A01,083777,Staff,0,12,30,30
1650466604514,MATH 103A,A02,083778,Staff,0,12,30,30
1650466604514,MATH 103A,B01,083779,Staff,0,13,30,30
1650466604514,MATH 103A,B02,083780,Staff,0,12,30,30
1650466610539,MATH 105,A01,085443,Staff,0,23,30,30
1650466616567,MATH 109,A01,083213,Anzaldo; Leesa B,0,7,30,30
1650466616567,MATH 109,A02,083214,Anzaldo; Leesa B,0,7,30,30
1650466616567,MATH 109,B01,083215,Anzaldo; Leesa B,0,5,30,30
1650466616567,MATH 109,B02,083216,Anzaldo; Leesa B,0,6,30,30
1650466622592,MATH 142A,A01,083219,Chow; Bennett,0,14,30,30
1650466622592,MATH 142A,A02,083220,Chow; Bennett,0,13,30,30
1650466622592,MATH 142A,B01,083221,Chow; Bennett,0,12,30,30
1650466622592,MATH 142A,B02,083222,Chow; Bennett,0,13,30,30
1650466628626,MATH 193A,A01,083224,Staff,0,5,30,30
1650466628626,MATH 193A,A02,083225,Staff,0,5,30,30
1650466628626,MATH 193A,A03,083781,Staff,0,4,30,30
1650466628626,MATH 193A,A04,083782,Staff,0,5,30,30
1650466634653,MATH 197,001,091859,McAuley; Julian John,9998,0,9999,1
1650466640704,COGS 9,A01,083615,Staff,0,14,60,60
1650466646731,COGS 11,A01,083617,Boyle; Mary E. T.,21,0,40,19
1650466652764,COGS 13,A01,083071,Staff,0,34,40,40
1650466658793,COGS 14A,A01,092681,Staff,1,25,100,99
1650466664816,COGS 14B,A01,083073,Cheng; Tzu-Han,0,11,50,50
1650466670839,COGS 17,A01,092677,Staff,22,0,75,53
1650466676865,COGS 100,A01,083619,Staff,0,26,60,60
1650466682895,COGS 101A,A01,083621,Davis; Joshua Daniel,0,21,60,60
1650466688925,COGS 101B,A01,091572,Staff,0,4,60,60
1650466694952,COGS 101C,A01,083625,Delgado; Tania,16,0,30,14
1650466700976,COGS 107A,A01,083627,Boyle; Mary E. T.,0,11,60,60
1650466707001,COGS 118A,A01,083075,Staff,2,0,60,58
1650466713026,CSE 3,A50,083646,Miranda; Gregory Joseph,20,0,38,18
1650466713026,CSE 3,A51,083647,Miranda; Gregory Joseph,36,0,37,1
1650466719054,CSE 8A,A50,083650,Miranda; Gregory Joseph,0,28,40,40
1650466725080,CSE 11,A01,083080,Cao; Yingjun,0,92,40,40
1650466731106,CSE 12,A01,083652,Staff,0,16,100,100
1650466737133,CSE 15L,A01,083654,Staff,0,1,50,50
1650466737133,CSE 15L,A02,083655,Staff,1,0,50,49
1650466743161,CSE 20,A01,083657,Staff,51,0,80,29
1650466749266,CSE 30,A01,083084,Eldon; John,0,76,40,40
1650466755291,CSE 100,A01,083659,Cao; Yingjun,0,66,50,50
1650466761321,CSE 134B,A01,083661,Powell; Thomas Allan,0,32,65,65
1650466767346,CSE 140,A01,083663,Staff,0,2,75,75
1650466773370,CSE 140L,A01,083088,Eldon; John,0,8,75,75
1650466779394,CSE 175,A01,083665,Kumar; Rakesh,7,0,25,18
1650466785420,CSE 190,A00,092507,Dubnov; Shlomo,14,0,20,6
1650466791452,ECE 45,A01,083139,Staff,20,18,60,40
1650466797477,ECE 65,A50,083695,Staff,0,6,30,30
1650466803503,ECE 109,A01,091882,Touri; Behrouz,38,0,70,32
1650466809530,ECE 180,A00,083140,Abi Samra; Nicholas Camill,23,0,30,7
1650466809530,ECE 180,B00,083141,Abi Samra; Nicholas Camill,0,0,30,30
1650466815561,MATH 10A,A01,083735,Patchell; Gregory David,7,0,30,23
1650466815561,MATH 10A,A02,083736,Patchell; Gregory David,28,0,30,2
1650466815561,MATH 10A,A03,083737,Patchell; Gregory David,25,0,30,5
1650466821588,MATH 10B,A01,083207,Staff,0,7,30,30
1650466821588,MATH 10B,A02,083208,Staff,0,7,30,30
1650466821588,MATH 10B,B01,083739,Staff,13,0,30,17
1650466821588,MATH 10B,B02,083740,Staff,28,0,30,2
1650466827612,MATH 18,A01,083743,Staff,1,0,30,29
1650466827612,MATH 18,A02,083744,Staff,27,0,30,3
1650466827612,MATH 18,A03,083745,Staff,22,0,30,8
1650466827612,MATH 18,A04,083746,Staff,26,0,30,4
1650466827612,MATH 18,B01,083748,Staff,0,11,30,30
1650466827612,MATH 18,B02,083749,Staff,0,12,30,30
1650466827612,MATH 18,B03,083750,Staff,0,11,30,30
1650466827612,MATH 18,B04,083751,Staff,0,12,30,30
1650466833638,MATH 20A,A01,083754,Staff,25,0,40,15
1650466839664,MATH 20B,A01,083756,Staff,0,10,30,30
1650466839664,MATH 20B,A02,083757,Staff,0,10,30,30
1650466845708,MATH 20C,A01,083760,Staff,0,15,30,30
1650466845708,MATH 20C,A02,083761,Staff,1,14,30,29
1650466845708,MATH 20C,B01,083762,Staff,13,0,30,17
1650466845708,MATH 20C,B02,083763,Staff,28,0,30,2
1650466851737,MATH 20D,A01,083765,Staff,0,1,30,30
1650466851737,MATH 20D,A02,083766,Staff,9,0,30,21
1650466851737,MATH 20D,A03,083767,Staff,25,0,30,5
1650466857761,MATH 20E,A01,083771,Staff,6,0,30,24
1650466857761,MATH 20E,A02,083772,Staff,18,0,30,12
1650466857761,MATH 20E,B01,083773,Staff,0,0,30,30
1650466857761,MATH 20E,B02,083774,Staff,10,0,30,20
1650466863798,MATH 103A,A01,083777,Staff,0,12,30,30
1650466863798,MATH 103A,A02,083778,Staff,0,12,30,30
1650466863798,MATH 103A,B01,083779,Staff,0,13,30,30
1650466863798,MATH 103A,B02,083780,Staff,0,12,30,30
1650466869821,MATH 105,A01,085443,Staff,0,23,30,30
1650466875846,MATH 109,A01,083213,Anzaldo; Leesa B,0,7,30,30
1650466875846,MATH 109,A02,083214,Anzaldo; Leesa B,0,7,30,30
1650466875846,MATH 109,B01,083215,Anzaldo; Leesa B,0,5,30,30
1650466875846,MATH 109,B02,083216,Anzaldo; Leesa B,0,6,30,30
1650466881874,MATH 142A,A01,083219,Chow; Bennett,0,14,30,30
1650466881874,MATH 142A,A02,083220,Chow; Bennett,0,13,30,30
1650466881874,MATH 142A,B01,083221,Chow; Bennett,0,12,30,30
1650466881874,MATH 142A,B02,083222,Chow; Bennett,0,13,30,30
1650466887903,MATH 193A,A01,083224,Staff,0,5,30,30
1650466887903,MATH 193A,A02,083225,Staff,0,5,30,30
1650466887903,MATH 193A,A03,083781,Staff,0,4,30,30
1650466887903,MATH 193A,A04,083782,Staff,0,5,30,30
1650466893926,MATH 197,001,091859,McAuley; Julian John,9998,0,9999,1
1650466899998,COGS 9,A01,083615,Staff,0,14,60,60
1650466906022,COGS 11,A01,083617,Boyle; Mary E. T.,21,0,40,19
1650466912046,COGS 13,A01,083071,Staff,0,34,40,40
1650466918077,COGS 14A,A01,092681,Staff,1,25,100,99
1650466924118,COGS 14B,A01,083073,Cheng; Tzu-Han,0,11,50,50
1650466930142,COGS 17,A01,092677,Staff,22,0,75,53
1650466936169,COGS 100,A01,083619,Staff,0,26,60,60
1650466942211,COGS 101A,A01,083621,Davis; Joshua Daniel,0,21,60,60
1650466948236,COGS 101B,A01,091572,Staff,0,4,60,60
1650466954266,COGS 101C,A01,083625,Delgado; Tania,16,0,30,14
1650466960296,COGS 107A,A01,083627,Boyle; Mary E. T.,0,11,60,60
1650466966320,COGS 118A,A01,083075,Staff,2,0,60,58
1650466972344,CSE 3,A50,083646,Miranda; Gregory Joseph,20,0,38,18
1650466972344,CSE 3,A51,083647,Miranda; Gregory Joseph,36,0,37,1
1650466978368,CSE 8A,A50,083650,Miranda; Gregory Joseph,0,28,40,40
1650466984393,CSE 11,A01,083080,Cao; Yingjun,0,92,40,40
1650466990416,CSE 12,A01,083652,Staff,0,16,100,100
1650466996440,CSE 15L,A01,083654,Staff,0,1,50,50
1650466996440,CSE 15L,A02,083655,Staff,1,0,50,49
1650467002480,CSE 20,A01,083657,Staff,51,0,80,29
1650467008505,CSE 30,A01,083084,Eldon; John,0,76,40,40
1650467014529,CSE 100,A01,083659,Cao; Yingjun,0,66,50,50
1650467020554,CSE 134B,A01,083661,Powell; Thomas Allan,0,32,65,65
1650467026577,CSE 140,A01,083663,Staff,0,2,75,75
1650467032601,CSE 140L,A01,083088,Eldon; John,0,8,75,75
1650467038626,CSE 175,A01,083665,Kumar; Rakesh,7,0,25,18
1650467044660,CSE 190,A00,092507,Dubnov; Shlomo,14,0,20,6
1650467050683,ECE 45,A01,083139,Staff,20,18,60,40
1650467056709,ECE 65,A50,083695,Staff,0,6,30,30
1650467062735,ECE 109,A01,091882,Touri; Behrouz,38,0,70,32
1650467068761,ECE 180,A00,083140,Abi Samra; Nicholas Camill,23,0,30,7
1650467068761,ECE 180,B00,083141,Abi Samra; Nicholas Camill,0,0,30,30
1650467074794,MATH 10A,A01,083735,Patchell; Gregory David,7,0,30,23
1650467074794,MATH 10A,A02,083736,Patchell; Gregory David,28,0,30,2
1650467074794,MATH 10A,A03,083737,Patchell; Gregory David,25,0,30,5
1650467080817,MATH 10B,A01,083207,Staff,0,7,30,30
1650467080817,MATH 10B,A02,083208,Staff,0,7,30,30
1650467080817,MATH 10B,B01,083739,Staff,13,0,30,17
1650467080817,MATH 10B,B02,083740,Staff,28,0,30,2
1650467086842,MATH 18,A01,083743,Staff,1,0,30,29
1650467086842,MATH 18,A02,083744,Staff,27,0,30,3
1650467086842,MATH 18,A03,083745,Staff,22,0,30,8
1650467086842,MATH 18,A04,083746,Staff,26,0,30,4
1650467086842,MATH 18,B01,083748,Staff,0,11,30,30
1650467086842,MATH 18,B02,083749,Staff,0,12,30,30
1650467086842,MATH 18,B03,083750,Staff,0,11,30,30
1650467086842,MATH 18,B04,083751,Staff,0,12,30,30
1650467092869,MATH 20A,A01,083754,Staff,25,0,40,15
1650467098892,MATH 20B,A01,083756,Staff,0,10,30,30
1650467098892,MATH 20B,A02,083757,Staff,0,10,30,30
1650467104941,MATH 20C,A01,083760,Staff,0,15,30,30
1650467104941,MATH 20C,A02,083761,Staff,1,14,30,29
1650467104941,MATH 20C,B01,083762,Staff,13,0,30,17
1650467104941,MATH 20C,B02,083763,Staff,28,0,30,2
1650467110968,MATH 20D,A01,083765,Staff,0,1,30,30
1650467110968,MATH 20D,A02,083766,Staff,9,0,30,21
1650467110968,MATH 20D,A03,083767,Staff,25,0,30,5
1650467117006,MATH 20E,A01,083771,Staff,6,0,30,24
1650467117006,MATH 20E,A02,083772,Staff,18,0,30,12
1650467117006,MATH 20E,B01,083773,Staff,0,0,30,30
1650467117006,MATH 20E,B02,083774,Staff,10,0,30,20
1650467123034,MATH 103A,A01,083777,Staff,0,12,30,30
1650467123034,MATH 103A,A02,083778,Staff,0,12,30,30
1650467123034,MATH 103A,B01,083779,Staff,0,13,30,30
1650467123034,MATH 103A,B02,083780,Staff,0,12,30,30
1650467129062,MATH 105,A01,085443,Staff,0,23,30,30
1650467135093,MATH 109,A01,083213,Anzaldo; Leesa B,0,7,30,30
1650467135093,MATH 109,A02,083214,Anzaldo; Leesa B,0,7,30,30
1650467135093,MATH 109,B01,083215,Anzaldo; Leesa B,0,5,30,30
1650467135093,MATH 109,B02,083216,Anzaldo; Leesa B,0,6,30,30
1650467141117,MATH 142A,A01,083219,Chow; Bennett,0,14,30,30
1650467141117,MATH 142A,A02,083220,Chow; Bennett,0,13,30,30
1650467141117,MATH 142A,B01,083221,Chow; Bennett,0,12,30,30
1650467141117,MATH 142A,B02,083222,Chow; Bennett,0,13,30,30
1650467147142,MATH 193A,A01,083224,Staff,0,5,30,30
1650467147142,MATH 193A,A02,083225,Staff,0,5,30,30
1650467147142,MATH 193A,A03,083781,Staff,0,4,30,30
1650467147142,MATH 193A,A04,083782,Staff,0,5,30,30
1650467153173,MATH 197,001,091859,McAuley; Julian John,9998,0,9999,1
1650467159223,COGS 9,A01,083615,Staff,0,14,60,60
1650467165247,COGS 11,A01,083617,Boyle; Mary E. T.,21,0,40,19
1650467171272,COGS 13,A01,083071,Staff,0,34,40,40
1650467177298,COGS 14A,A01,092681,Staff,1,25,100,99
1650467183337,COGS 14B,A01,083073,Cheng; Tzu-Han,0,11,50,50
1650467189362,COGS 17,A01,092677,Staff,22,0,75,53
1650467195395,COGS 100,A01,083619,Staff,0,26,60,60
1650467201418,COGS 101A,A01,083621,Davis; Joshua Daniel,0,21,60,60
1650467207440,COGS 101B,A01,091572,Staff,0,4,60,60
1650467213467,COGS 101C,A01,083625,Delgado; Tania,16,0,30,14
1650467219495,COGS 107A,A01,083627,Boyle; Mary E. T.,0,11,60,60
1650467225518,COGS 118A,A01,083075,Staff,2,0,60,58
1650467231634,CSE 3,A50,083646,Miranda; Gregory Joseph,20,0,38,18
1650467231634,CSE 3,A51,083647,Miranda; Gregory Joseph,36,0,37,1
1650467237662,CSE 8A,A50,083650,Miranda; Gregory Joseph,0,28,40,40
1650467243690,CSE 11,A01,083080,Cao; Yingjun,0,92,40,40
1650467249713,CSE 12,A01,083652,Staff,0,16,100,100
1650467255737,CSE 15L,A01,083654,Staff,0,1,50,50
1650467255737,CSE 15L,A02,083655,Staff,1,0,50,49
1650467261765,CSE 20,A01,083657,Staff,51,0,80,29
1650467267788,CSE 30,A01,083084,Eldon; John,0,76,40,40
1650467273812,CSE 100,A01,083659,Cao; Yingjun,0,66,50,50
1650467279836,CSE 134B,A01,083661,Powell; Thomas Allan,0,32,65,65
1650467285865,CSE 140,A01,083663,Staff,0,2,75,75
1650467291901,CSE 140L,A01,083088,Eldon; John,0,8,75,75
1650467297925,CSE 175,A01,083665,Kumar; Rakesh,7,0,25,18
1650467303951,CSE 190,A00,092507,Dubnov; Shlomo,14,0,20,6
1650467309983,ECE 45,A01,083139,Staff,20,18,60,40
1650467316010,ECE 65,A50,083695,Staff,0,6,30,30
1650467322042,ECE 109,A01,091882,Touri; Behrouz,38,0,70,32
1650467328066,ECE 180,A00,083140,Abi Samra; Nicholas Camill,23,0,30,7
1650467328066,ECE 180,B00,083141,Abi Samra; Nicholas Camill,0,0,30,30
1650467334090,MATH 10A,A01,083735,Patchell; Gregory David,7,0,30,23
1650467334090,MATH 10A,A02,083736,Patchell; Gregory David,28,0,30,2
1650467334090,MATH 10A,A03,083737,Patchell; Gregory David,25,0,30,5
1650467340115,MATH 10B,A01,083207,Staff,0,7,30,30
1650467340115,MATH 10B,A02,083208,Staff,0,7,30,30
1650467340115,MATH 10B,B01,083739,Staff,13,0,30,17
1650467340115,MATH 10B,B02,083740,Staff,28,0,30,2
1650467346237,MATH 18,A01,083743,Staff,1,0,30,29
1650467346237,MATH 18,A02,083744,Staff,27,0,30,3
1650467346237,MATH 18,A03,083745,Staff,22,0,30,8
1650467346237,MATH 18,A04,083746,Staff,26,0,30,4
1650467346237,MATH 18,B01,083748,Staff,0,11,30,30
1650467346237,MATH 18,B02,083749,Staff,0,12,30,30
1650467346237,MATH 18,B03,083750,Staff,0,11,30,30
1650467346237,MATH 18,B04,083751,Staff,0,12,30,30
1650467352272,MATH 20A,A01,083754,Staff,25,0,40,15
1650467358299,MATH 20B,A01,083756,Staff,0,10,30,30
1650467358299,MATH 20B,A02,083757,Staff,0,10,30,30
1650467364327,MATH 20C,A01,083760,Staff,0,15,30,30
1650467364327,MATH 20C,A02,083761,Staff,1,14,30,29
1650467364327,MATH 20C,B01,083762,Staff,13,0,30,17
1650467364327,MATH 20C,B02,083763,Staff,28,0,30,2
1650467370351,MATH 20D,A01,083765,Staff,0,1,30,30
1650467370351,MATH 20D,A02,083766,Staff,9,0,30,21
1650467370351,MATH 20D,A03,083767,Staff,25,0,30,5
1650467376374,MATH 20E,A01,083771,Staff,6,0,30,24
1650467376374,MATH 20E,A02,083772,Staff,18,0,30,12
1650467376374,MATH 20E,B01,083773,Staff,0,0,30,30
1650467376374,MATH 20E,B02,083774,Staff,10,0,30,20
1650467382405,MATH 103A,A01,083777,Staff,0,12,30,30
1650467382405,MATH 103A,A02,083778,Staff,0,12,30,30
1650467382405,MATH 103A,B01,083779,Staff,0,13,30,30
1650467382405,MATH 103A,B02,083780,Staff,0,12,30,30
1650467388438,MATH 105,A01,085443,Staff,0,23,30,30
1650467394462,MATH 109,A01,083213,Anzaldo; Leesa B,0,7,30,30
1650467394462,MATH 109,A02,083214,Anzaldo; Leesa B,0,7,30,30
1650467394462,MATH 109,B01,083215,Anzaldo; Leesa B,0,5,30,30
1650467394462,MATH 109,B02,083216,Anzaldo; Leesa B,0,6,30,30
1650467400502,MATH 142A,A01,083219,Chow; Bennett,0,14,30,30
1650467400502,MATH 142A,A02,083220,Chow; Bennett,0,13,30,30
1650467400502,MATH 142A,B01,083221,Chow; Bennett,0,12,30,30
1650467400502,MATH 142A,B02,083222,Chow; Bennett,0,13,30,30
1650467406525,MATH 193A,A01,083224,Staff,0,5,30,30
1650467406525,MATH 193A,A02,083225,Staff,0,5,30,30
1650467406525,MATH 193A,A03,083781,Staff,0,4,30,30
1650467406525,MATH 193A,A04,083782,Staff,0,5,30,30
1650467412550,MATH 197,001,091859,McAuley; Julian John,9998,0,9999,1
1650467418603,COGS 9,A01,083615,Staff,0,14,60,60
1650467424628,COGS 11,A01,083617,Boyle; Mary E. T.,21,0,40,19
1650467430655,COGS 13,A01,083071,Staff,0,34,40,40
1650467436682,COGS 14A,A01,092681,Staff,1,25,100,99
1650467442719,COGS 14B,A01,083073,Cheng; Tzu-Han,0,11,50,50
1650467448745,COGS 17,A01,092677,Staff,22,0,75,53
1650467454773,COGS 100,A01,083619,Staff,0,26,60,60
1650467460796,COGS 101A,A01,083621,Davis; Joshua Daniel,0,21,60,60
1650467466822,COGS 101B,A01,091572,Staff,0,4,60,60
1650467472846,COGS 101C,A01,083625,Delgado; Tania,16,0,30,14
1650467478871,COGS 107A,A01,083627,Boyle; Mary E. T.,0,11,60,60
1650467484902,COGS 118A,A01,083075,Staff,2,0,60,58
1650467490931,CSE 3,A50,083646,Miranda; Gregory Joseph,20,0,38,18
1650467490931,CSE 3,A51,083647,Miranda; Gregory Joseph,36,0,37,1
1650467496959,CSE 8A,A50,083650,Miranda; Gregory Joseph,0,28,40,40
1650467502996,CSE 11,A01,083080,Cao; Yingjun,0,92,40,40
1650467509024,CSE 12,A01,083652,Staff,0,16,100,100
1650467515048,CSE 15L,A01,083654,Staff,0,1,50,50
1650467515048,CSE 15L,A02,083655,Staff,1,0,50,49
1650467521083,CSE 20,A01,083657,Staff,51,0,80,29
1650467527107,CSE 30,A01,083084,Eldon; John,0,76,40,40
1650467533146,CSE 100,A01,083659,Cao; Yingjun,0,66,50,50
1650467539173,CSE 134B,A01,083661,Powell; Thomas Allan,0,32,65,65
1650467545196,CSE 140,A01,083663,Staff,0,2,75,75
1650467551224,CSE 140L,A01,083088,Eldon; John,0,8,75,75
1650467557266,CSE 175,A01,083665,Kumar; Rakesh,7,0,25,18
1650467563291,CSE 190,A00,092507,Dubnov; Shlomo,14,0,20,6
1650467569334,ECE 45,A01,083139,Staff,20,18,60,40
1650467575385,ECE 65,A50,083695,Staff,0,6,30,30
1650467581411,ECE 109,A01,091882,Touri; Behrouz,38,0,70,32
1650467587436,ECE 180,A00,083140,Abi Samra; Nicholas Camill,23,0,30,7
1650467587436,ECE 180,B00,083141,Abi Samra; Nicholas Camill,0,0,30,30
1650467593461,MATH 10A,A01,083735,Patchell; Gregory David,7,0,30,23
1650467593461,MATH 10A,A02,083736,Patchell; Gregory David,28,0,30,2
1650467593461,MATH 10A,A03,083737,Patchell; Gregory David,25,0,30,5
1650467599486,MATH 10B,A01,083207,Staff,0,7,30,30
1650467599486,MATH 10B,A02,083208,Staff,0,7,30,30
1650467599486,MATH 10B,B01,083739,Staff,13,0,30,17
1650467599486,MATH 10B,B02,083740,Staff,28,0,30,2
1650467605512,MATH 18,A01,083743,Staff,1,0,30,29
1650467605512,MATH 18,A02,083744,Staff,27,0,30,3
1650467605512,MATH 18,A03,083745,Staff,22,0,30,8
1650467605512,MATH 18,A04,083746,Staff,26,0,30,4
1650467605512,MATH 18,B01,083748,Staff,0,11,30,30
1650467605512,MATH 18,B02,083749,Staff,0,12,30,30
1650467605512,MATH 18,B03,083750,Staff,0,11,30,30
1650467605512,MATH 18,B04,083751,Staff,0,12,30,30
1650467611540,MATH 20A,A01,083754,Staff,25,0,40,15
1650467617567,MATH 20B,A01,083756,Staff,0,10,30,30
1650467617567,MATH 20B,A02,083757,Staff,0,10,30,30
1650467623599,MATH 20C,A01,083760,Staff,0,15,30,30
1650467623599,MATH 20C,A02,083761,Staff,1,14,30,29
1650467623599,MATH 20C,B01,083762,Staff,13,0,30,17
1650467623599,MATH 20C,B02,083763,Staff,28,0,30,2
1650467629624,MATH 20D,A01,083765,Staff,0,1,30,30
1650467629624,MATH 20D,A02,083766,Staff,9,0,30,21
1650467629624,MATH 20D,A03,083767,Staff,25,0,30,5
1650467635648,MATH 20E,A01,083771,Staff,6,0,30,24
1650467635648,MATH 20E,A02,083772,Staff,18,0,30,12
1650467635648,MATH 20E,B01,083773,Staff,0,0,30,30
1650467635648,MATH 20E,B02,083774,Staff,10,0,30,20
1650467641676,MATH 103A,A01,083777,Staff,0,12,30,30
1650467641676,MATH 103A,A02,083778,Staff,0,12,30,30
1650467641676,MATH 103A,B01,083779,Staff,0,13,30,30
1650467641676,MATH 103A,B02,083780,Staff,0,12,30,30
1650467647714,MATH 105,A01,085443,Staff,0,23,30,30
1650467653738,MATH 109,A01,083213,Anzaldo; Leesa B,0,7,30,30
1650467653738,MATH 109,A02,083214,Anzaldo; Leesa B,0,7,30,30
1650467653738,MATH 109,B01,083215,Anzaldo; Leesa B,0,5,30,30
1650467653738,MATH 109,B02,083216,Anzaldo; Leesa B,0,6,30,30
1650467659770,MATH 142A,A01,083219,Chow; Bennett,0,14,30,30
1650467659770,MATH 142A,A02,083220,Chow; Bennett,0,13,30,30
1650467659770,MATH 142A,B01,083221,Chow; Bennett,0,12,30,30
1650467659770,MATH 142A,B02,083222,Chow; Bennett,0,13,30,30
1650467665799,MATH 193A,A01,083224,Staff,0,5,30,30
1650467665799,MATH 193A,A02,083225,Staff,0,5,30,30
1650467665799,MATH 193A,A03,083781,Staff,0,4,30,30
1650467665799,MATH 193A,A04,083782,Staff,0,5,30,30
1650467671831,MATH 197,001,091859,McAuley; Julian John,9998,0,9999,1
1650467677888,COGS 9,A01,083615,Staff,0,14,60,60
1650467683921,COGS 11,A01,083617,Boyle; Mary E. T.,21,0,40,19
1650467689956,COGS 13,A01,083071,Staff,0,34,40,40
1650467695983,COGS 14A,A01,092681,Staff,1,25,100,99
1650467702010,COGS 14B,A01,083073,Cheng; Tzu-Han,0,11,50,50
1650467708032,COGS 17,A01,092677,Staff,22,0,75,53
1650467714057,COGS 100,A01,083619,Staff,0,26,60,60
1650467720085,COGS 101A,A01,083621,Davis; Joshua Daniel,0,21,60,60
1650467726114,COGS 101B,A01,091572,Staff,0,4,60,60
1650467732141,COGS 101C,A01,083625,Delgado; Tania,16,0,30,14
1650467738170,COGS 107A,A01,083627,Boyle; Mary E. T.,0,11,60,60
1650467744219,COGS 118A,A01,083075,Staff,2,0,60,58
1650467750257,CSE 3,A50,083646,Miranda; Gregory Joseph,20,0,38,18
1650467750257,CSE 3,A51,083647,Miranda; Gregory Joseph,36,0,37,1
1650467756281,CSE 8A,A50,083650,Miranda; Gregory Joseph,0,28,40,40
1650467762305,CSE 11,A01,083080,Cao; Yingjun,0,92,40,40
1650467768331,CSE 12,A01,083652,Staff,0,16,100,100
1650467774359,CSE 15L,A01,083654,Staff,0,1,50,50
1650467774359,CSE 15L,A02,083655,Staff,1,0,50,49
1650467780385,CSE 20,A01,083657,Staff,51,0,80,29
1650467786410,CSE 30,A01,083084,Eldon; John,0,76,40,40
1650467792437,CSE 100,A01,083659,Cao; Yingjun,0,66,50,50
1650467798461,CSE 134B,A01,083661,Powell; Thomas Allan,0,32,65,65
1650467804487,CSE 140,A01,083663,Staff,0,2,75,75
1650467810515,CSE 140L,A01,083088,Eldon; John,0,8,75,75
1650467816541,CSE 175,A01,083665,Kumar; Rakesh,7,0,25,18
1650467822576,CSE 190,A00,092507,Dubnov; Shlomo,14,0,20,6
1650467828603,ECE 45,A01,083139,Staff,20,18,60,40
1650467834628,ECE 65,A50,083695,Staff,0,6,30,30
1650467840656,ECE 109,A01,091882,Touri; Behrouz,38,0,70,32
1650467846683,ECE 180,A00,083140,Abi Samra; Nicholas Camill,23,0,30,7
1650467846683,ECE 180,B00,083141,Abi Samra; Nicholas Camill,0,0,30,30
1650467852709,MATH 10A,A01,083735,Patchell; Gregory David,7,0,30,23
1650467852709,MATH 10A,A02,083736,Patchell; Gregory David,28,0,30,2
1650467852709,MATH 10A,A03,083737,Patchell; Gregory David,25,0,30,5
1650467858734,MATH 10B,A01,083207,Staff,0,7,30,30
1650467858734,MATH 10B,A02,083208,Staff,0,7,30,30
1650467858734,MATH 10B,B01,083739,Staff,13,0,30,17
1650467858734,MATH 10B,B02,083740,Staff,28,0,30,2
1650467864760,MATH 18,A01,083743,Staff,1,0,30,29
1650467864760,MATH 18,A02,083744,Staff,27,0,30,3
1650467864760,MATH 18,A03,083745,Staff,22,0,30,8
1650467864760,MATH 18,A04,083746,Staff,26,0,30,4
1650467864760,MATH 18,B01,083748,Staff,0,11,30,30
1650467864760,MATH 18,B02,083749,Staff,0,12,30,30
1650467864760,MATH 18,B03,083750,Staff,0,11,30,30
1650467864760,MATH 18,B04,083751,Staff,0,12,30,30
1650467870786,MATH 20A,A01,083754,Staff,25,0,40,15
1650467876814,MATH 20B,A01,083756,Staff,0,10,30,30
1650467876814,MATH 20B,A02,083757,Staff,0,10,30,30
1650467882852,MATH 20C,A01,083760,Staff,0,15,30,30
1650467882852,MATH 20C,A02,083761,Staff,1,14,30,29
1650467882852,MATH 20C,B01,083762,Staff,13,0,30,17
1650467882852,MATH 20C,B02,083763,Staff,28,0,30,2
1650467888893,MATH 20D,A01,083765,Staff,0,1,30,30
1650467888893,MATH 20D,A02,083766,Staff,9,0,30,21
1650467888893,MATH 20D,A03,083767,Staff,25,0,30,5
1650467894922,MATH 20E,A01,083771,Staff,6,0,30,24
1650467894922,MATH 20E,A02,083772,Staff,18,0,30,12
1650467894922,MATH 20E,B01,083773,Staff,0,0,30,30
1650467894922,MATH 20E,B02,083774,Staff,10,0,30,20
1650467900957,MATH 103A,A01,083777,Staff,0,12,30,30
1650467900957,MATH 103A,A02,083778,Staff,0,12,30,30
1650467900957,MATH 103A,B01,083779,Staff,0,13,30,30
1650467900957,MATH 103A,B02,083780,Staff,0,12,30,30
1650467906990,MATH 105,A01,085443,Staff,0,23,30,30
1650467913024,MATH 109,A01,083213,Anzaldo; Leesa B,0,7,30,30
1650467913024,MATH 109,A02,083214,Anzaldo; Leesa B,0,7,30,30
1650467913024,MATH 109,B01,083215,Anzaldo; Leesa B,0,5,30,30
1650467913024,MATH 109,B02,083216,Anzaldo; Leesa B,0,6,30,30
1650467919058,MATH 142A,A01,083219,Chow; Bennett,0,14,30,30
1650467919058,MATH 142A,A02,083220,Chow; Bennett,0,13,30,30
1650467919058,MATH 142A,B01,083221,Chow; Bennett,0,12,30,30
1650467919058,MATH 142A,B02,083222,Chow; Bennett,0,13,30,30
1650467925087,MATH 193A,A01,083224,Staff,0,5,30,30
1650467925087,MATH 193A,A02,083225,Staff,0,5,30,30
1650467925087,MATH 193A,A03,083781,Staff,0,4,30,30
1650467925087,MATH 193A,A04,083782,Staff,0,5,30,30
1650467931112,MATH 197,001,091859,McAuley; Julian John,9998,0,9999,1
1650467937252,COGS 9,A01,083615,Staff,0,14,60,60
1650467943287,COGS 11,A01,083617,Boyle; Mary E. T.,21,0,40,19
1650467949311,COGS 13,A01,083071,Staff,0,34,40,40
1650467955344,COGS 14A,A01,092681,Staff,1,25,100,99
1650467961371,COGS 14B,A01,083073,Cheng; Tzu-Han,0,11,50,50
1650467967398,COGS 17,A01,092677,Staff,22,0,75,53
1650467973422,COGS 100,A01,083619,Staff,0,26,60,60
1650467979445,COGS 101A,A01,083621,Davis; Joshua Daniel,0,21,60,60
1650467985478,COGS 101B,A01,091572,Staff,0,4,60,60
1650467991504,COGS 101C,A01,083625,Delgado; Tania,16,0,30,14
1650467997538,COGS 107A,A01,083627,Boyle; Mary E. T.,0,11,60,60
1650468003562,COGS 118A,A01,083075,Staff,2,0,60,58
1650468009591,CSE 3,A50,083646,Miranda; Gregory Joseph,20,0,38,18
1650468009591,CSE 3,A51,083647,Miranda; Gregory Joseph,36,0,37,1
1650468015614,CSE 8A,A50,083650,Miranda; Gregory Joseph,0,28,40,40
1650468021637,CSE 11,A01,083080,Cao; Yingjun,0,92,40,40
1650468027660,CSE 12,A01,083652,Staff,0,16,100,100
1650468033686,CSE 15L,A01,083654,Staff,0,1,50,50
1650468033686,CSE 15L,A02,083655,Staff,1,0,50,49
1650468039712,CSE 20,A01,083657,Staff,51,0,80,29
1650468045738,CSE 30,A01,083084,Eldon; John,0,76,40,40
1650468051772,CSE 100,A01,083659,Cao; Yingjun,0,66,50,50
1650468057800,CSE 134B,A01,083661,Powell; Thomas Allan,0,32,65,65
1650468063823,CSE 140,A01,083663,Staff,0,2,75,75
1650468069850,CSE 140L,A01,083088,Eldon; John,0,8,75,75
1650468075873,CSE 175,A01,083665,Kumar; Rakesh,7,0,25,18
1650468081897,CSE 190,A00,092507,Dubnov; Shlomo,14,0,20,6
1650468087921,ECE 45,A01,083139,Staff,20,18,60,40
1650468093949,ECE 65,A50,083695,Staff,0,6,30,30
1650468099979,ECE 109,A01,091882,Touri; Behrouz,38,0,70,32
1650468106016,ECE 180,A00,083140,Abi Samra; Nicholas Camill,23,0,30,7
1650468106016,ECE 180,B00,083141,Abi Samra; Nicholas Camill,0,0,30,30
1650468112040,MATH 10A,A01,083735,Patchell; Gregory David,7,0,30,23
1650468112040,MATH 10A,A02,083736,Patchell; Gregory David,28,0,30,2
1650468112040,MATH 10A,A03,083737,Patchell; Gregory David,25,0,30,5
1650468118064,MATH 10B,A01,083207,Staff,0,7,30,30
1650468118064,MATH 10B,A02,083208,Staff,0,7,30,30
1650468118064,MATH 10B,B01,083739,Staff,13,0,30,17
1650468118064,MATH 10B,B02,083740,Staff,28,0,30,2
1650468124098,MATH 18,A01,083743,Staff,1,0,30,29
1650468124098,MATH 18,A02,083744,Staff,27,0,30,3
1650468124098,MATH 18,A03,083745,Staff,22,0,30,8
1650468124098,MATH 18,A04,083746,Staff,26,0,30,4
1650468124098,MATH 18,B01,083748,Staff,0,11,30,30
1650468124098,MATH 18,B02,083749,Staff,0,12,30,30
1650468124098,MATH 18,B03,083750,Staff,0,11,30,30
1650468124098,MATH 18,B04,083751,Staff,0,12,30,30
1650468130124,MATH 20A,A01,083754,Staff,25,0,40,15
1650468136151,MATH 20B,A01,083756,Staff,0,10,30,30
1650468136151,MATH 20B,A02,083757,Staff,0,10,30,30
1650468142179,MATH 20C,A01,083760,Staff,0,15,30,30
1650468142179,MATH 20C,A02,083761,Staff,1,14,30,29
1650468142179,MATH 20C,B01,083762,Staff,13,0,30,17
1650468142179,MATH 20C,B02,083763,Staff,28,0,30,2
1650468148202,MATH 20D,A01,083765,Staff,0,1,30,30
1650468148202,MATH 20D,A02,083766,Staff,9,0,30,21
1650468148202,MATH 20D,A03,083767,Staff,25,0,30,5
1650468154226,MATH 20E,A01,083771,Staff,6,0,30,24
1650468154226,MATH 20E,A02,083772,Staff,18,0,30,12
1650468154226,MATH 20E,B01,083773,Staff,0,0,30,30
1650468154226,MATH 20E,B02,083774,Staff,10,0,30,20
1650468160250,MATH 103A,A01,083777,Staff,0,12,30,30
1650468160250,MATH 103A,A02,083778,Staff,0,12,30,30
1650468160250,MATH 103A,B01,083779,Staff,0,13,30,30
1650468160250,MATH 103A,B02,083780,Staff,0,12,30,30
1650468166277,MATH 105,A01,085443,Staff,0,23,30,30
1650468172305,MATH 109,A01,083213,Anzaldo; Leesa B,0,7,30,30
1650468172305,MATH 109,A02,083214,Anzaldo; Leesa B,0,7,30,30
1650468172305,MATH 109,B01,083215,Anzaldo; Leesa B,0,5,30,30
1650468172305,MATH 109,B02,083216,Anzaldo; Leesa B,0,6,30,30
1650468178330,MATH 142A,A01,083219,Chow; Bennett,0,14,30,30
1650468178330,MATH 142A,A02,083220,Chow; Bennett,0,13,30,30
1650468178330,MATH 142A,B01,083221,Chow; Bennett,0,12,30,30
1650468178330,MATH 142A,B02,083222,Chow; Bennett,0,13,30,30
1650468184371,MATH 193A,A01,083224,Staff,0,5,30,30
1650468184371,MATH 193A,A02,083225,Staff,0,5,30,30
1650468184371,MATH 193A,A03,083781,Staff,0,4,30,30
1650468184371,MATH 193A,A04,083782,Staff,0,5,30,30
1650468190400,MATH 197,001,091859,McAuley; Julian John,9998,0,9999,1
1650468196471,COGS 9,A01,083615,Staff,0,14,60,60
1650468202507,COGS 11,A01,083617,Boyle; Mary E. T.,21,0,40,19
1650468208535,COGS 13,A01,083071,Staff,0,34,40,40
1650468214560,COGS 14A,A01,092681,Staff,1,25,100,99
1650468220587,COGS 14B,A01,083073,Cheng; Tzu-Han,0,11,50,50
1650468226610,COGS 17,A01,092677,Staff,22,0,75,53
1650468232634,COGS 100,A01,083619,Staff,0,26,60,60
1650468238665,COGS 101A,A01,083621,Davis; Joshua Daniel,0,21,60,60
1650468244689,COGS 101B,A01,091572,Staff,0,4,60,60
1650468250715,COGS 101C,A01,083625,Delgado; Tania,16,0,30,14
1650468256755,COGS 107A,A01,083627,Boyle; Mary E. T.,0,11,60,60
1650468262779,COGS 118A,A01,083075,Staff,2,0,60,58
1650468268802,CSE 3,A50,083646,Miranda; Gregory Joseph,20,0,38,18
1650468268802,CSE 3,A51,083647,Miranda; Gregory Joseph,36,0,37,1
1650468274826,CSE 8A,A50,083650,Miranda; Gregory Joseph,0,28,40,40
1650468280852,CSE 11,A01,083080,Cao; Yingjun,0,92,40,40
1650468286883,CSE 12,A01,083652,Staff,0,16,100,100
1650468292914,CSE 15L,A01,083654,Staff,0,1,50,50
1650468292914,CSE 15L,A02,083655,Staff,1,0,50,49
1650468298946,CSE 20,A01,083657,Staff,51,0,80,29
1650468304975,CSE 30,A01,083084,Eldon; John,0,76,40,40
1650468311005,CSE 100,A01,083659,Cao; Yingjun,0,66,50,50
1650468317030,CSE 134B,A01,083661,Powell; Thomas Allan,0,32,65,65
1650468323066,CSE 140,A01,083663,Staff,0,2,75,75
1650468329099,CSE 140L,A01,083088,Eldon; John,0,8,75,75
1650468335121,CSE 175,A01,083665,Kumar; Rakesh,7,0,25,18
1650468341145,CSE 190,A00,092507,Dubnov; Shlomo,14,0,20,6
1650468347170,ECE 45,A01,083139,Staff,20,18,60,40
1650468353214,ECE 65,A50,083695,Staff,0,6,30,30
1650468359239,ECE 109,A01,091882,Touri; Behrouz,38,0,70,32
1650468365266,ECE 180,A00,083140,Abi Samra; Nicholas Camill,23,0,30,7
1650468365266,ECE 180,B00,083141,Abi Samra; Nicholas Camill,0,0,30,30
1650468371293,MATH 10A,A01,083735,Patchell; Gregory David,7,0,30,23
1650468371293,MATH 10A,A02,083736,Patchell; Gregory David,28,0,30,2
1650468371293,MATH 10A,A03,083737,Patchell; Gregory David,25,0,30,5
1650468377317,MATH 10B,A01,083207,Staff,0,7,30,30
1650468377317,MATH 10B,A02,083208,Staff,0,7,30,30
1650468377317,MATH 10B,B01,083739,Staff,13,0,30,17
1650468377317,MATH 10B,B02,083740,Staff,28,0,30,2
1650468383349,MATH 18,A01,083743,Staff,1,0,30,29
1650468383349,MATH 18,A02,083744,Staff,27,0,30,3
1650468383349,MATH 18,A03,083745,Staff,22,0,30,8
1650468383349,MATH 18,A04,083746,Staff,26,0,30,4
1650468383349,MATH 18,B01,083748,Staff,0,11,30,30
1650468383349,MATH 18,B02,083749,Staff,0,12,30,30
1650468383349,MATH 18,B03,083750,Staff,0,11,30,30
1650468383349,MATH 18,B04,083751,Staff,0,12,30,30
1650468389375,MATH 20A,A01,083754,Staff,25,0,40,15
1650468395401,MATH 20B,A01,083756,Staff,0,10,30,30
1650468395401,MATH 20B,A02,083757,Staff,0,10,30,30
1650468401429,MATH 20C,A01,083760,Staff,0,15,30,30
1650468401429,MATH 20C,A02,083761,Staff,1,14,30,29
1650468401429,MATH 20C,B01,083762,Staff,13,0,30,17
1650468401429,MATH 20C,B02,083763,Staff,28,0,30,2
1650468407457,MATH 20D,A01,083765,Staff,0,1,30,30
1650468407457,MATH 20D,A02,083766,Staff,9,0,30,21
1650468407457,MATH 20D,A03,083767,Staff,25,0,30,5
1650468413482,MATH 20E,A01,083771,Staff,6,0,30,24
1650468413482,MATH 20E,A02,083772,Staff,18,0,30,12
1650468413482,MATH 20E,B01,083773,Staff,0,0,30,30
1650468413482,MATH 20E,B02,083774,Staff,10,0,30,20
1650468419512,MATH 103A,A01,083777,Staff,0,12,30,30
1650468419512,MATH 103A,A02,083778,Staff,0,12,30,30
1650468419512,MATH 103A,B01,083779,Staff,0,13,30,30
1650468419512,MATH 103A,B02,083780,Staff,0,12,30,30
1650468425549,MATH 105,A01,085443,Staff,0,23,30,30
1650468431572,MATH 109,A01,083213,Anzaldo; Leesa B,0,7,30,30
1650468431572,MATH 109,A02,083214,Anzaldo; Leesa B,0,7,30,30
1650468431572,MATH 109,B01,083215,Anzaldo; Leesa B,0,5,30,30
1650468431572,MATH 109,B02,083216,Anzaldo; Leesa B,0,6,30,30
1650468437598,MATH 142A,A01,083219,Chow; Bennett,0,14,30,30
1650468437598,MATH 142A,A02,083220,Chow; Bennett,0,13,30,30
1650468437598,MATH 142A,B01,083221,Chow; Bennett,0,12,30,30
1650468437598,MATH 142A,B02,083222,Chow; Bennett,0,13,30,30
1650468443625,MATH 193A,A01,083224,Staff,0,5,30,30
1650468443625,MATH 193A,A02,083225,Staff,0,5,30,30
1650468443625,MATH 193A,A03,083781,Staff,0,4,30,30
1650468443625,MATH 193A,A04,083782,Staff,0,5,30,30
1650468449649,MATH 197,001,091859,McAuley; Julian John,9998,0,9999,1
1650468455703,COGS 9,A01,083615,Staff,0,14,60,60
1650468461727,COGS 11,A01,083617,Boyle; Mary E. T.,21,0,40,19
1650468467751,COGS 13,A01,083071,Staff,0,34,40,40
1650468473775,COGS 14A,A01,092681,Staff,1,25,100,99
1650468479803,COGS 14B,A01,083073,Cheng; Tzu-Han,0,11,50,50
1650468485837,COGS 17,A01,092677,Staff,22,0,75,53
1650468491859,COGS 100,A01,083619,Staff,0,26,60,60
1650468497884,COGS 101A,A01,083621,Davis; Joshua Daniel,0,21,60,60
1650468503916,COGS 101B,A01,091572,Staff,0,4,60,60
1650468509939,COGS 101C,A01,083625,Delgado; Tania,16,0,30,14
1650468515985,COGS 107A,A01,083627,Boyle; Mary E. T.,0,11,60,60
1650468522010,COGS 118A,A01,083075,Staff,2,0,60,58
1650468528045,CSE 3,A50,083646,Miranda; Gregory Joseph,20,0,38,18
1650468528045,CSE 3,A51,083647,Miranda; Gregory Joseph,36,0,37,1
1650468534149,CSE 8A,A50,083650,Miranda; Gregory Joseph,0,28,40,40
1650468540179,CSE 11,A01,083080,Cao; Yingjun,0,92,40,40
1650468546204,CSE 12,A01,083652,Staff,0,16,100,100
1650468552228,CSE 15L,A01,083654,Staff,0,1,50,50
1650468552228,CSE 15L,A02,083655,Staff,1,0,50,49
1650468558251,CSE 20,A01,083657,Staff,51,0,80,29
1650468564282,CSE 30,A01,083084,Eldon; John,0,76,40,40
1650468570309,CSE 100,A01,083659,Cao; Yingjun,0,66,50,50
1650468576337,CSE 134B,A01,083661,Powell; Thomas Allan,0,32,65,65
1650468582361,CSE 140,A01,083663,Staff,0,2,75,75
1650468588391,CSE 140L,A01,083088,Eldon; John,0,8,75,75
1650468594424,CSE 175,A01,083665,Kumar; Rakesh,7,0,25,18
1650468600455,CSE 190,A00,092507,Dubnov; Shlomo,14,0,20,6
1650468606480,ECE 45,A01,083139,Staff,20,18,60,40
1650468612504,ECE 65,A50,083695,Staff,0,6,30,30
1650468618530,ECE 109,A01,091882,Touri; Behrouz,38,0,70,32
1650468624557,ECE 180,A00,083140,Abi Samra; Nicholas Camill,23,0,30,7
1650468624557,ECE 180,B00,083141,Abi Samra; Nicholas Camill,0,0,30,30
1650468630592,MATH 10A,A01,083735,Patchell; Gregory David,7,0,30,23
1650468630592,MATH 10A,A02,083736,Patchell; Gregory David,28,0,30,2
1650468630592,MATH 10A,A03,083737,Patchell; Gregory David,25,0,30,5
1650468636615,MATH 10B,A01,083207,Staff,0,7,30,30
1650468636615,MATH 10B,A02,083208,Staff,0,7,30,30
1650468636615,MATH 10B,B01,083739,Staff,13,0,30,17
1650468636615,MATH 10B,B02,083740,Staff,28,0,30,2
1650468642647,MATH 18,A01,083743,Staff,1,0,30,29
1650468642647,MATH 18,A02,083744,Staff,27,0,30,3
1650468642647,MATH 18,A03,083745,Staff,22,0,30,8
1650468642647,MATH 18,A04,083746,Staff,26,0,30,4
1650468642647,MATH 18,B01,083748,Staff,0,11,30,30
1650468642647,MATH 18,B02,083749,Staff,0,12,30,30
1650468642647,MATH 18,B03,083750,Staff,0,11,30,30
1650468642647,MATH 18,B04,083751,Staff,0,12,30,30
1650468648675,MATH 20A,A01,083754,Staff,25,0,40,15
1650468654698,MATH 20B,A01,083756,Staff,0,10,30,30
1650468654698,MATH 20B,A02,083757,Staff,0,10,30,30
1650468660726,MATH 20C,A01,083760,Staff,0,15,30,30
1650468660726,MATH 20C,A02,083761,Staff,1,14,30,29
1650468660726,MATH 20C,B01,083762,Staff,13,0,30,17
1650468660726,MATH 20C,B02,083763,Staff,28,0,30,2
1650468666749,MATH 20D,A01,083765,Staff,0,1,30,30
1650468666749,MATH 20D,A02,083766,Staff,9,0,30,21
1650468666749,MATH 20D,A03,083767,Staff,25,0,30,5
1650468672774,MATH 20E,A01,083771,Staff,6,0,30,24
1650468672774,MATH 20E,A02,083772,Staff,18,0,30,12
1650468672774,MATH 20E,B01,083773,Staff,0,0,30,30
1650468672774,MATH 20E,B02,083774,Staff,10,0,30,20
1650468678803,MATH 103A,A01,083777,Staff,0,12,30,30
1650468678803,MATH 103A,A02,083778,Staff,0,12,30,30
1650468678803,MATH 103A,B01,083779,Staff,0,13,30,30
1650468678803,MATH 103A,B02,083780,Staff,0,12,30,30
1650468684827,MATH 105,A01,085443,Staff,0,23,30,30
1650468690855,MATH 109,A01,083213,Anzaldo; Leesa B,0,7,30,30
1650468690855,MATH 109,A02,083214,Anzaldo; Leesa B,0,7,30,30
1650468690855,MATH 109,B01,083215,Anzaldo; Leesa B,0,5,30,30
1650468690855,MATH 109,B02,083216,Anzaldo; Leesa B,0,6,30,30
1650468696879,MATH 142A,A01,083219,Chow; Bennett,0,14,30,30
1650468696879,MATH 142A,A02,083220,Chow; Bennett,0,13,30,30
1650468696879,MATH 142A,B01,083221,Chow; Bennett,0,12,30,30
1650468696879,MATH 142A,B02,083222,Chow; Bennett,0,13,30,30
1650468702902,MATH 193A,A01,083224,Staff,0,5,30,30
1650468702902,MATH 193A,A02,083225,Staff,0,5,30,30
1650468702902,MATH 193A,A03,083781,Staff,0,4,30,30
1650468702902,MATH 193A,A04,083782,Staff,0,5,30,30
1650468708940,MATH 197,001,091859,McAuley; Julian John,9998,0,9999,1
1650468714997,COGS 9,A01,083615,Staff,0,14,60,60
1650468721033,COGS 11,A01,083617,Boyle; Mary E. T.,21,0,40,19
1650468727057,COGS 13,A01,083071,Staff,0,34,40,40
1650468733094,COGS 14A,A01,092681,Staff,1,25,100,99
1650468739122,COGS 14B,A01,083073,Cheng; Tzu-Han,0,11,50,50
1650468745152,COGS 17,A01,092677,Staff,22,0,75,53
1650468751176,COGS 100,A01,083619,Staff,0,26,60,60
1650468757208,COGS 101A,A01,083621,Davis; Joshua Daniel,0,21,60,60
1650468763232,COGS 101B,A01,091572,Staff,0,4,60,60
1650468769264,COGS 101C,A01,083625,Delgado; Tania,16,0,30,14
1650468775290,COGS 107A,A01,083627,Boyle; Mary E. T.,0,11,60,60
1650468781319,COGS 118A,A01,083075,Staff,2,0,60,58
1650468787344,CSE 3,A50,083646,Miranda; Gregory Joseph,20,0,38,18
1650468787344,CSE 3,A51,083647,Miranda; Gregory Joseph,36,0,37,1
1650468793372,CSE 8A,A50,083650,Miranda; Gregory Joseph,0,28,40,40
1650468799395,CSE 11,A01,083080,Cao; Yingjun,0,92,40,40
1650468805423,CSE 12,A01,083652,Staff,0,16,100,100
1650468811450,CSE 15L,A01,083654,Staff,0,1,50,50
1650468811450,CSE 15L,A02,083655,Staff,1,0,50,49
1650468817473,CSE 20,A01,083657,Staff,51,0,80,29
1650468823500,CSE 30,A01,083084,Eldon; John,0,76,40,40
1650468829535,CSE 100,A01,083659,Cao; Yingjun,0,66,50,50
1650468835563,CSE 134B,A01,083661,Powell; Thomas Allan,0,32,65,65
1650468841585,CSE 140,A01,083663,Staff,0,2,75,75
1650468847613,CSE 140L,A01,083088,Eldon; John,0,8,75,75
1650468853637,CSE 175,A01,083665,Kumar; Rakesh,7,0,25,18
1650468859670,CSE 190,A00,092507,Dubnov; Shlomo,14,0,20,6
1650468865696,ECE 45,A01,083139,Staff,20,18,60,40
1650468871721,ECE 65,A50,083695,Staff,0,6,30,30
1650468877748,ECE 109,A01,091882,Touri; Behrouz,38,0,70,32
1650468883773,ECE 180,A00,083140,Abi Samra; Nicholas Camill,23,0,30,7
1650468883773,ECE 180,B00,083141,Abi Samra; Nicholas Camill,0,0,30,30
1650468889798,MATH 10A,A01,083735,Patchell; Gregory David,7,0,30,23
1650468889798,MATH 10A,A02,083736,Patchell; Gregory David,28,0,30,2
1650468889798,MATH 10A,A03,083737,Patchell; Gregory David,25,0,30,5
1650468895824,MATH 10B,A01,083207,Staff,0,7,30,30
1650468895824,MATH 10B,A02,083208,Staff,0,7,30,30
1650468895824,MATH 10B,B01,083739,Staff,13,0,30,17
1650468895824,MATH 10B,B02,083740,Staff,28,0,30,2
1650468901852,MATH 18,A01,083743,Staff,1,0,30,29
1650468901852,MATH 18,A02,083744,Staff,27,0,30,3
1650468901852,MATH 18,A03,083745,Staff,22,0,30,8
1650468901852,MATH 18,A04,083746,Staff,26,0,30,4
1650468901852,MATH 18,B01,083748,Staff,0,11,30,30
1650468901852,MATH 18,B02,083749,Staff,0,12,30,30
1650468901852,MATH 18,B03,083750,Staff,0,11,30,30
1650468901852,MATH 18,B04,083751,Staff,0,12,30,30
1650468907875,MATH 20A,A01,083754,Staff,25,0,40,15
1650468913910,MATH 20B,A01,083756,Staff,0,10,30,30
1650468913910,MATH 20B,A02,083757,Staff,0,10,30,30
1650468919949,MATH 20C,A01,083760,Staff,0,15,30,30
1650468919949,MATH 20C,A02,083761,Staff,1,14,30,29
1650468919949,MATH 20C,B01,083762,Staff,13,0,30,17
1650468919949,MATH 20C,B02,083763,Staff,28,0,30,2
1650468925979,MATH 20D,A01,083765,Staff,0,1,30,30
1650468925979,MATH 20D,A02,083766,Staff,9,0,30,21
1650468925979,MATH 20D,A03,083767,Staff,25,0,30,5
1650468932015,MATH 20E,A01,083771,Staff,6,0,30,24
1650468932015,MATH 20E,A02,083772,Staff,18,0,30,12
1650468932015,MATH 20E,B01,083773,Staff,0,0,30,30
1650468932015,MATH 20E,B02,083774,Staff,10,0,30,20
1650468938043,MATH 103A,A01,083777,Staff,0,12,30,30
1650468938043,MATH 103A,A02,083778,Staff,0,12,30,30
1650468938043,MATH 103A,B01,083779,Staff,0,13,30,30
1650468938043,MATH 103A,B02,083780,Staff,0,12,30,30
1650468944067,MATH 105,A01,085443,Staff,0,23,30,30
1650468950098,MATH 109,A01,083213,Anzaldo; Leesa B,0,7,30,30
1650468950098,MATH 109,A02,083214,Anzaldo; Leesa B,0,7,30,30
1650468950098,MATH 109,B01,083215,Anzaldo; Leesa B,0,5,30,30
1650468950098,MATH 109,B02,083216,Anzaldo; Leesa B,0,6,30,30
1650468956122,MATH 142A,A01,083219,Chow; Bennett,0,14,30,30
1650468956122,MATH 142A,A02,083220,Chow; Bennett,0,13,30,30
1650468956122,MATH 142A,B01,083221,Chow; Bennett,0,12,30,30
1650468956122,MATH 142A,B02,083222,Chow; Bennett,0,13,30,30
1650468962149,MATH 193A,A01,083224,Staff,0,5,30,30
1650468962149,MATH 193A,A02,083225,Staff,0,5,30,30
1650468962149,MATH 193A,A03,083781,Staff,0,4,30,30
1650468962149,MATH 193A,A04,083782,Staff,0,5,30,30
1650468968180,MATH 197,001,091859,McAuley; Julian John,9998,0,9999,1
1650468974249,COGS 9,A01,083615,Staff,0,14,60,60
1650468980275,COGS 11,A01,083617,Boyle; Mary E. T.,21,0,40,19
1650468986318,COGS 13,A01,083071,Staff,0,34,40,40
1650468992342,COGS 14A,A01,092681,Staff,1,25,100,99
1650468998366,COGS 14B,A01,083073,Cheng; Tzu-Han,0,11,50,50
1650469004399,COGS 17,A01,092677,Staff,22,0,75,53
1650469010434,COGS 100,A01,083619,Staff,0,26,60,60
1650469016460,COGS 101A,A01,083621,Davis; Joshua Daniel,0,21,60,60
1650469022483,COGS 101B,A01,091572,Staff,0,4,60,60
1650469028508,COGS 101C,A01,083625,Delgado; Tania,16,0,30,14
1650469034538,COGS 107A,A01,083627,Boyle; Mary E. T.,0,11,60,60
1650469040579,COGS 118A,A01,083075,Staff,2,0,60,58
1650469046607,CSE 3,A50,083646,Miranda; Gregory Joseph,20,0,38,18
1650469046607,CSE 3,A51,083647,Miranda; Gregory Joseph,36,0,37,1
1650469052636,CSE 8A,A50,083650,Miranda; Gregory Joseph,0,28,40,40
1650469058660,CSE 11,A01,083080,Cao; Yingjun,0,92,40,40
1650469064686,CSE 12,A01,083652,Staff,0,16,100,100
1650469070715,CSE 15L,A01,083654,Staff,0,1,50,50
1650469070715,CSE 15L,A02,083655,Staff,1,0,50,49
1650469076741,CSE 20,A01,083657,Staff,51,0,80,29
1650469082766,CSE 30,A01,083084,Eldon; John,0,76,40,40
1650469088790,CSE 100,A01,083659,Cao; Yingjun,0,66,50,50
1650469094814,CSE 134B,A01,083661,Powell; Thomas Allan,0,32,65,65
1650469100839,CSE 140,A01,083663,Staff,0,3,75,75
1650469106863,CSE 140L,A01,083088,Eldon; John,0,8,75,75
1650469112890,CSE 175,A01,083665,Kumar; Rakesh,7,0,25,18
1650469118927,CSE 190,A00,092507,Dubnov; Shlomo,14,0,20,6
1650469124964,ECE 45,A01,083139,Staff,20,18,60,40
1650469131063,ECE 65,A50,083695,Staff,0,6,30,30
1650469137089,ECE 109,A01,091882,Touri; Behrouz,38,0,70,32
1650469143126,ECE 180,A00,083140,Abi Samra; Nicholas Camill,23,0,30,7
1650469143126,ECE 180,B00,083141,Abi Samra; Nicholas Camill,0,0,30,30
1650469149149,MATH 10A,A01,083735,Patchell; Gregory David,7,0,30,23
1650469149149,MATH 10A,A02,083736,Patchell; Gregory David,28,0,30,2
1650469149149,MATH 10A,A03,083737,Patchell; Gregory David,25,0,30,5
1650469155173,MATH 10B,A01,083207,Staff,0,7,30,30
1650469155173,MATH 10B,A02,083208,Staff,0,7,30,30
1650469155173,MATH 10B,B01,083739,Staff,13,0,30,17
1650469155173,MATH 10B,B02,083740,Staff,28,0,30,2
1650469161211,MATH 18,A01,083743,Staff,1,0,30,29
1650469161211,MATH 18,A02,083744,Staff,27,0,30,3
1650469161211,MATH 18,A03,083745,Staff,22,0,30,8
1650469161211,MATH 18,A04,083746,Staff,26,0,30,4
1650469161211,MATH 18,B01,083748,Staff,0,11,30,30
1650469161211,MATH 18,B02,083749,Staff,0,12,30,30
1650469161211,MATH 18,B03,083750,Staff,0,11,30,30
1650469161211,MATH 18,B04,083751,Staff,0,12,30,30
1650469167234,MATH 20A,A01,083754,Staff,25,0,40,15
1650469173259,MATH 20B,A01,083756,Staff,0,10,30,30
1650469173259,MATH 20B,A02,083757,Staff,0,10,30,30
1650469179295,MATH 20C,A01,083760,Staff,0,15,30,30
1650469179295,MATH 20C,A02,083761,Staff,1,14,30,29
1650469179295,MATH 20C,B01,083762,Staff,13,0,30,17
1650469179295,MATH 20C,B02,083763,Staff,28,0,30,2
1650469185324,MATH 20D,A01,083765,Staff,0,1,30,30
1650469185324,MATH 20D,A02,083766,Staff,9,0,30,21
1650469185324,MATH 20D,A03,083767,Staff,25,0,30,5
1650469191350,MATH 20E,A01,083771,Staff,6,0,30,24
1650469191350,MATH 20E,A02,083772,Staff,18,0,30,12
1650469191350,MATH 20E,B01,083773,Staff,0,0,30,30
1650469191350,MATH 20E,B02,083774,Staff,10,0,30,20
1650469197376,MATH 103A,A01,083777,Staff,0,12,30,30
1650469197376,MATH 103A,A02,083778,Staff,0,12,30,30
1650469197376,MATH 103A,B01,083779,Staff,0,13,30,30
1650469197376,MATH 103A,B02,083780,Staff,0,12,30,30
1650469203404,MATH 105,A01,085443,Staff,0,23,30,30
1650469209428,MATH 109,A01,083213,Anzaldo; Leesa B,0,7,30,30
1650469209428,MATH 109,A02,083214,Anzaldo; Leesa B,0,7,30,30
1650469209428,MATH 109,B01,083215,Anzaldo; Leesa B,0,5,30,30
1650469209428,MATH 109,B02,083216,Anzaldo; Leesa B,0,6,30,30
1650469215463,MATH 142A,A01,083219,Chow; Bennett,0,14,30,30
1650469215463,MATH 142A,A02,083220,Chow; Bennett,0,13,30,30
1650469215463,MATH 142A,B01,083221,Chow; Bennett,0,12,30,30
1650469215463,MATH 142A,B02,083222,Chow; Bennett,0,13,30,30
1650469221489,MATH 193A,A01,083224,Staff,0,5,30,30
1650469221489,MATH 193A,A02,083225,Staff,0,5,30,30
1650469221489,MATH 193A,A03,083781,Staff,0,4,30,30
1650469221489,MATH 193A,A04,083782,Staff,0,5,30,30
1650469227511,MATH 197,001,091859,McAuley; Julian John,9998,0,9999,1
1650469233581,COGS 9,A01,083615,Staff,0,14,60,60
1650469239604,COGS 11,A01,083617,Boyle; Mary E. T.,21,0,40,19
1650469245643,COGS 13,A01,083071,Staff,0,34,40,40
1650469251666,COGS 14A,A01,092681,Staff,1,25,100,99
1650469257697,COGS 14B,A01,083073,Cheng; Tzu-Han,0,11,50,50
1650469263727,COGS 17,A01,092677,Staff,22,0,75,53
1650469269755,COGS 100,A01,083619,Staff,0,26,60,60
1650469275784,COGS 101A,A01,083621,Davis; Joshua Daniel,0,21,60,60
1650469281809,COGS 101B,A01,091572,Staff,0,4,60,60
1650469287846,COGS 101C,A01,083625,Delgado; Tania,16,0,30,14
1650469293875,COGS 107A,A01,083627,Boyle; Mary E. T.,0,11,60,60
1650469299902,COGS 118A,A01,083075,Staff,2,0,60,58
1650469305935,CSE 3,A50,083646,Miranda; Gregory Joseph,20,0,38,18
1650469305935,CSE 3,A51,083647,Miranda; Gregory Joseph,36,0,37,1
1650469311964,CSE 8A,A50,083650,Miranda; Gregory Joseph,0,28,40,40
1650469317992,CSE 11,A01,083080,Cao; Yingjun,0,92,40,40
1650469324028,CSE 12,A01,083652,Staff,0,16,100,100
1650469330058,CSE 15L,A01,083654,Staff,0,1,50,50
1650469330058,CSE 15L,A02,083655,Staff,1,0,50,49
1650469336086,CSE 20,A01,083657,Staff,51,0,80,29
1650469342112,CSE 30,A01,083084,Eldon; John,0,76,40,40
1650469348135,CSE 100,A01,083659,Cao; Yingjun,0,66,50,50
1650469354161,CSE 134B,A01,083661,Powell; Thomas Allan,0,32,65,65
1650469360186,CSE 140,A01,083663,Staff,0,3,75,75
1650469366210,CSE 140L,A01,083088,Eldon; John,0,8,75,75
1650469372234,CSE 175,A01,083665,Kumar; Rakesh,7,0,25,18
1650469378259,CSE 190,A00,092507,Dubnov; Shlomo,14,0,20,6
1650469384282,ECE 45,A01,083139,Staff,20,18,60,40
1650469390306,ECE 65,A50,083695,Staff,0,6,30,30
1650469396331,ECE 109,A01,091882,Touri; Behrouz,38,0,70,32
1650469402355,ECE 180,A00,083140,Abi Samra; Nicholas Camill,23,0,30,7
1650469402355,ECE 180,B00,083141,Abi Samra; Nicholas Camill,0,0,30,30
1650469417480,MATH 10A,A01,083735,Patchell; Gregory David,7,0,30,23
1650469417480,MATH 10A,A02,083736,Patchell; Gregory David,28,0,30,2
1650469417480,MATH 10A,A03,083737,Patchell; Gregory David,25,0,30,5
1650469423504,MATH 10B,A01,083207,Staff,0,7,30,30
1650469423504,MATH 10B,A02,083208,Staff,0,7,30,30
1650469423504,MATH 10B,B01,083739,Staff,13,0,30,17
1650469423504,MATH 10B,B02,083740,Staff,28,0,30,2
1650469429535,MATH 18,A01,083743,Staff,1,0,30,29
1650469429535,MATH 18,A02,083744,Staff,27,0,30,3
1650469429535,MATH 18,A03,083745,Staff,22,0,30,8
1650469429535,MATH 18,A04,083746,Staff,26,0,30,4
1650469429535,MATH 18,B01,083748,Staff,0,11,30,30
1650469429535,MATH 18,B02,083749,Staff,0,12,30,30
1650469429535,MATH 18,B03,083750,Staff,0,11,30,30
1650469429535,MATH 18,B04,083751,Staff,0,12,30,30
1650469435574,MATH 20A,A01,083754,Staff,25,0,40,15
1650469441599,MATH 20B,A01,083756,Staff,0,10,30,30
1650469441599,MATH 20B,A02,083757,Staff,0,10,30,30
1650469447626,MATH 20C,A01,083760,Staff,0,15,30,30
1650469447626,MATH 20C,A02,083761,Staff,1,14,30,29
1650469447626,MATH 20C,B01,083762,Staff,13,0,30,17
1650469447626,MATH 20C,B02,083763,Staff,28,0,30,2
1650469453660,MATH 20D,A01,083765,Staff,0,1,30,30
1650469453660,MATH 20D,A02,083766,Staff,9,0,30,21
1650469453660,MATH 20D,A03,083767,Staff,25,0,30,5
1650469459686,MATH 20E,A01,083771,Staff,6,0,30,24
1650469459686,MATH 20E,A02,083772,Staff,18,0,30,12
1650469459686,MATH 20E,B01,083773,Staff,0,0,30,30
1650469459686,MATH 20E,B02,083774,Staff,10,0,30,20
1650469465713,MATH 103A,A01,083777,Staff,0,12,30,30
1650469465713,MATH 103A,A02,083778,Staff,0,12,30,30
1650469465713,MATH 103A,B01,083779,Staff,0,13,30,30
1650469465713,MATH 103A,B02,083780,Staff,0,12,30,30
1650469471740,MATH 105,A01,085443,Staff,0,23,30,30
1650469477763,MATH 109,A01,083213,Anzaldo; Leesa B,0,7,30,30
1650469477763,MATH 109,A02,083214,Anzaldo; Leesa B,0,7,30,30
1650469477763,MATH 109,B01,083215,Anzaldo; Leesa B,0,5,30,30
1650469477763,MATH 109,B02,083216,Anzaldo; Leesa B,0,6,30,30
1650469483792,MATH 142A,A01,083219,Chow; Bennett,0,14,30,30
1650469483792,MATH 142A,A02,083220,Chow; Bennett,0,13,30,30
1650469483792,MATH 142A,B01,083221,Chow; Bennett,0,12,30,30
1650469483792,MATH 142A,B02,083222,Chow; Bennett,0,13,30,30
1650469489817,MATH 193A,A01,083224,Staff,0,5,30,30
1650469489817,MATH 193A,A02,083225,Staff,0,5,30,30
1650469489817,MATH 193A,A03,083781,Staff,0,4,30,30
1650469489817,MATH 193A,A04,083782,Staff,0,5,30,30
1650469495842,MATH 197,001,091859,McAuley; Julian John,9998,0,9999,1
1650469501895,COGS 9,A01,083615,Staff,0,14,60,60
1650469507920,COGS 11,A01,083617,Boyle; Mary E. T.,21,0,40,19
1650469513946,COGS 13,A01,083071,Staff,0,34,40,40
1650469519970,COGS 14A,A01,092681,Staff,1,25,100,99
1650469525994,COGS 14B,A01,083073,Cheng; Tzu-Han,0,11,50,50
1650469532029,COGS 17,A01,092677,Staff,22,0,75,53
1650469538058,COGS 100,A01,083619,Staff,0,26,60,60
1650469544085,COGS 101A,A01,083621,Davis; Joshua Daniel,0,21,60,60
1650469550109,COGS 101B,A01,091572,Staff,0,4,60,60
1650469556136,COGS 101C,A01,083625,Delgado; Tania,16,0,30,14
1650469562158,COGS 107A,A01,083627,Boyle; Mary E. T.,0,11,60,60
1650469568182,COGS 118A,A01,083075,Staff,2,0,60,58
1650469574212,CSE 3,A50,083646,Miranda; Gregory Joseph,20,0,38,18
1650469574212,CSE 3,A51,083647,Miranda; Gregory Joseph,36,0,37,1
1650469580240,CSE 8A,A50,083650,Miranda; Gregory Joseph,0,28,40,40
1650469586268,CSE 11,A01,083080,Cao; Yingjun,0,92,40,40
1650469592304,CSE 12,A01,083652,Staff,0,16,100,100
1650469598329,CSE 15L,A01,083654,Staff,0,1,50,50
1650469598329,CSE 15L,A02,083655,Staff,1,0,50,49
1650469604358,CSE 20,A01,083657,Staff,51,0,80,29
1650469610382,CSE 30,A01,083084,Eldon; John,0,76,40,40
1650469616407,CSE 100,A01,083659,Cao; Yingjun,0,66,50,50
1650469622435,CSE 134B,A01,083661,Powell; Thomas Allan,0,32,65,65
1650469628471,CSE 140,A01,083663,Staff,0,3,75,75
1650469634503,CSE 140L,A01,083088,Eldon; John,0,8,75,75
1650469640530,CSE 175,A01,083665,Kumar; Rakesh,7,0,25,18
1650469646564,CSE 190,A00,092507,Dubnov; Shlomo,14,0,20,6
1650469652598,ECE 45,A01,083139,Staff,20,18,60,40
1650469658629,ECE 65,A50,083695,Staff,0,6,30,30
1650469664656,ECE 109,A01,091882,Touri; Behrouz,38,0,70,32
1650469670689,ECE 180,A00,083140,Abi Samra; Nicholas Camill,23,0,30,7
1650469670689,ECE 180,B00,083141,Abi Samra; Nicholas Camill,0,0,30,30
1650469676714,MATH 10A,A01,083735,Patchell; Gregory David,7,0,30,23
1650469676714,MATH 10A,A02,083736,Patchell; Gregory David,28,0,30,2
1650469676714,MATH 10A,A03,083737,Patchell; Gregory David,25,0,30,5
1650469682739,MATH 10B,A01,083207,Staff,0,7,30,30
1650469682739,MATH 10B,A02,083208,Staff,0,7,30,30
1650469682739,MATH 10B,B01,083739,Staff,13,0,30,17
1650469682739,MATH 10B,B02,083740,Staff,28,0,30,2
1650469688769,MATH 18,A01,083743,Staff,1,0,30,29
1650469688769,MATH 18,A02,083744,Staff,27,0,30,3
1650469688769,MATH 18,A03,083745,Staff,22,0,30,8
1650469688769,MATH 18,A04,083746,Staff,26,0,30,4
1650469688769,MATH 18,B01,083748,Staff,0,11,30,30
1650469688769,MATH 18,B02,083749,Staff,0,12,30,30
1650469688769,MATH 18,B03,083750,Staff,0,11,30,30
1650469688769,MATH 18,B04,083751,Staff,0,12,30,30
1650469694811,MATH 20A,A01,083754,Staff,25,0,40,15
1650469700846,MATH 20B,A01,083756,Staff,0,10,30,30
1650469700846,MATH 20B,A02,083757,Staff,0,10,30,30
1650469706879,MATH 20C,A01,083760,Staff,0,15,30,30
1650469706879,MATH 20C,A02,083761,Staff,1,14,30,29
1650469706879,MATH 20C,B01,083762,Staff,13,0,30,17
1650469706879,MATH 20C,B02,083763,Staff,28,0,30,2
1650469712906,MATH 20D,A01,083765,Staff,0,1,30,30
1650469712906,MATH 20D,A02,083766,Staff,9,0,30,21
1650469712906,MATH 20D,A03,083767,Staff,25,0,30,5
1650469718937,MATH 20E,A01,083771,Staff,6,0,30,24
1650469718937,MATH 20E,A02,083772,Staff,18,0,30,12
1650469718937,MATH 20E,B01,083773,Staff,0,0,30,30
1650469718937,MATH 20E,B02,083774,Staff,10,0,30,20
1650469724959,MATH 103A,A01,083777,Staff,0,12,30,30
1650469724959,MATH 103A,A02,083778,Staff,0,12,30,30
1650469724959,MATH 103A,B01,083779,Staff,0,13,30,30
1650469724959,MATH 103A,B02,083780,Staff,0,12,30,30
1650469730984,MATH 105,A01,085443,Staff,0,23,30,30
1650469737080,MATH 109,A01,083213,Anzaldo; Leesa B,0,7,30,30
1650469737080,MATH 109,A02,083214,Anzaldo; Leesa B,0,7,30,30
1650469737080,MATH 109,B01,083215,Anzaldo; Leesa B,0,5,30,30
1650469737080,MATH 109,B02,083216,Anzaldo; Leesa B,0,6,30,30
1650469743106,MATH 142A,A01,083219,Chow; Bennett,0,14,30,30
1650469743106,MATH 142A,A02,083220,Chow; Bennett,0,13,30,30
1650469743106,MATH 142A,B01,083221,Chow; Bennett,0,12,30,30
1650469743106,MATH 142A,B02,083222,Chow; Bennett,0,13,30,30
1650469749134,MATH 193A,A01,083224,Staff,0,5,30,30
1650469749134,MATH 193A,A02,083225,Staff,0,5,30,30
1650469749134,MATH 193A,A03,083781,Staff,0,4,30,30
1650469749134,MATH 193A,A04,083782,Staff,0,5,30,30
1650469755163,MATH 197,001,091859,McAuley; Julian John,9998,0,9999,1
1650469761215,COGS 9,A01,083615,Staff,0,14,60,60
1650469767246,COGS 11,A01,083617,Boyle; Mary E. T.,21,0,40,19
1650469773272,COGS 13,A01,083071,Staff,0,34,40,40
1650469779303,COGS 14A,A01,092681,Staff,1,25,100,99
1650469785332,COGS 14B,A01,083073,Cheng; Tzu-Han,0,11,50,50
1650469791355,COGS 17,A01,092677,Staff,22,0,75,53
1650469797385,COGS 100,A01,083619,Staff,0,26,60,60
1650469803438,COGS 101A,A01,083621,Davis; Joshua Daniel,0,21,60,60
1650469809462,COGS 101B,A01,091572,Staff,0,4,60,60
1650469815485,COGS 101C,A01,083625,Delgado; Tania,16,0,30,14
1650469821525,COGS 107A,A01,083627,Boyle; Mary E. T.,0,11,60,60
1650469827552,COGS 118A,A01,083075,Staff,2,0,60,58
1650469833578,CSE 3,A50,083646,Miranda; Gregory Joseph,20,0,38,18
1650469833578,CSE 3,A51,083647,Miranda; Gregory Joseph,36,0,37,1
1650469839614,CSE 8A,A50,083650,Miranda; Gregory Joseph,0,28,40,40
1650469845638,CSE 11,A01,083080,Cao; Yingjun,0,92,40,40
1650469851670,CSE 12,A01,083652,Staff,0,16,100,100
1650469857702,CSE 15L,A01,083654,Staff,0,1,50,50
1650469857702,CSE 15L,A02,083655,Staff,1,0,50,49
1650469863738,CSE 20,A01,083657,Staff,51,0,80,29
1650469869763,CSE 30,A01,083084,Eldon; John,0,76,40,40
1650469875797,CSE 100,A01,083659,Cao; Yingjun,0,66,50,50
1650469881829,CSE 134B,A01,083661,Powell; Thomas Allan,0,32,65,65
1650469887853,CSE 140,A01,083663,Staff,0,3,75,75
1650469893894,CSE 140L,A01,083088,Eldon; John,0,8,75,75
1650469899922,CSE 175,A01,083665,Kumar; Rakesh,7,0,25,18
1650469905949,CSE 190,A00,092507,Dubnov; Shlomo,14,0,20,6
1650469911975,ECE 45,A01,083139,Staff,20,18,60,40
1650469918002,ECE 65,A50,083695,Staff,0,6,30,30
1650469924037,ECE 109,A01,091882,Touri; Behrouz,38,0,70,32
1650469930061,ECE 180,A00,083140,Abi Samra; Nicholas Camill,23,0,30,7
1650469930061,ECE 180,B00,083141,Abi Samra; Nicholas Camill,0,0,30,30
1650469936091,MATH 10A,A01,083735,Patchell; Gregory David,7,0,30,23
1650469936091,MATH 10A,A02,083736,Patchell; Gregory David,28,0,30,2
1650469936091,MATH 10A,A03,083737,Patchell; Gregory David,25,0,30,5
1650469942122,MATH 10B,A01,083207,Staff,0,7,30,30
1650469942122,MATH 10B,A02,083208,Staff,0,7,30,30
1650469942122,MATH 10B,B01,083739,Staff,13,0,30,17
1650469942122,MATH 10B,B02,083740,Staff,28,0,30,2
1650469948147,MATH 18,A01,083743,Staff,1,0,30,29
1650469948147,MATH 18,A02,083744,Staff,27,0,30,3
1650469948147,MATH 18,A03,083745,Staff,22,0,30,8
1650469948147,MATH 18,A04,083746,Staff,26,0,30,4
1650469948147,MATH 18,B01,083748,Staff,0,11,30,30
1650469948147,MATH 18,B02,083749,Staff,0,12,30,30
1650469948147,MATH 18,B03,083750,Staff,0,11,30,30
1650469948147,MATH 18,B04,083751,Staff,0,12,30,30
1650469954173,MATH 20A,A01,083754,Staff,25,0,40,15
1650469960197,MATH 20B,A01,083756,Staff,0,10,30,30
1650469960197,MATH 20B,A02,083757,Staff,0,10,30,30
1650469966235,MATH 20C,A01,083760,Staff,0,15,30,30
1650469966235,MATH 20C,A02,083761,Staff,1,14,30,29
1650469966235,MATH 20C,B01,083762,Staff,13,0,30,17
1650469966235,MATH 20C,B02,083763,Staff,28,0,30,2
1650469972261,MATH 20D,A01,083765,Staff,0,1,30,30
1650469972261,MATH 20D,A02,083766,Staff,9,0,30,21
1650469972261,MATH 20D,A03,083767,Staff,25,0,30,5
1650469978288,MATH 20E,A01,083771,Staff,6,0,30,24
1650469978288,MATH 20E,A02,083772,Staff,18,0,30,12
1650469978288,MATH 20E,B01,083773,Staff,0,0,30,30
1650469978288,MATH 20E,B02,083774,Staff,10,0,30,20
1650469984330,MATH 103A,A01,083777,Staff,0,12,30,30
1650469984330,MATH 103A,A02,083778,Staff,0,12,30,30
1650469984330,MATH 103A,B01,083779,Staff,0,13,30,30
1650469984330,MATH 103A,B02,083780,Staff,0,12,30,30
1650469990353,MATH 105,A01,085443,Staff,0,23,30,30
1650469996390,MATH 109,A01,083213,Anzaldo; Leesa B,0,7,30,30
1650469996390,MATH 109,A02,083214,Anzaldo; Leesa B,0,7,30,30
1650469996390,MATH 109,B01,083215,Anzaldo; Leesa B,0,5,30,30
1650469996390,MATH 109,B02,083216,Anzaldo; Leesa B,0,6,30,30
1650470002421,MATH 142A,A01,083219,Chow; Bennett,0,14,30,30
1650470002421,MATH 142A,A02,083220,Chow; Bennett,0,13,30,30
1650470002421,MATH 142A,B01,083221,Chow; Bennett,0,12,30,30
1650470002421,MATH 142A,B02,083222,Chow; Bennett,0,13,30,30
1650470008445,MATH 193A,A01,083224,Staff,0,5,30,30
1650470008445,MATH 193A,A02,083225,Staff,0,5,30,30
1650470008445,MATH 193A,A03,083781,Staff,0,4,30,30
1650470008445,MATH 193A,A04,083782,Staff,0,5,30,30
1650470014467,MATH 197,001,091859,McAuley; Julian John,9998,0,9999,1
1650470020532,COGS 9,A01,083615,Staff,0,14,60,60
1650470026556,COGS 11,A01,083617,Boyle; Mary E. T.,21,0,40,19
1650470032590,COGS 13,A01,083071,Staff,0,34,40,40
1650470038612,COGS 14A,A01,092681,Staff,1,25,100,99
1650470044636,COGS 14B,A01,083073,Cheng; Tzu-Han,0,11,50,50
1650470050660,COGS 17,A01,092677,Staff,22,0,75,53
1650470056686,COGS 100,A01,083619,Staff,0,26,60,60
1650470062708,COGS 101A,A01,083621,Davis; Joshua Daniel,0,21,60,60
1650470068734,COGS 101B,A01,091572,Staff,0,4,60,60
1650470074762,COGS 101C,A01,083625,Delgado; Tania,16,0,30,14
1650470080788,COGS 107A,A01,083627,Boyle; Mary E. T.,0,11,60,60
1650470086818,COGS 118A,A01,083075,Staff,1,0,60,59
1650470092842,CSE 3,A50,083646,Miranda; Gregory Joseph,20,0,38,18
1650470092842,CSE 3,A51,083647,Miranda; Gregory Joseph,36,0,37,1
1650470098870,CSE 8A,A50,083650,Miranda; Gregory Joseph,0,28,40,40
1650470104896,CSE 11,A01,083080,Cao; Yingjun,0,92,40,40
1650470110923,CSE 12,A01,083652,Staff,0,16,100,100
1650470116947,CSE 15L,A01,083654,Staff,0,1,50,50
1650470116947,CSE 15L,A02,083655,Staff,1,0,50,49
1650470122970,CSE 20,A01,083657,Staff,51,0,80,29
1650470128995,CSE 30,A01,083084,Eldon; John,0,76,40,40
1650470135019,CSE 100,A01,083659,Cao; Yingjun,0,66,50,50
1650470141051,CSE 134B,A01,083661,Powell; Thomas Allan,0,32,65,65
1650470147074,CSE 140,A01,083663,Staff,0,3,75,75
1650470153110,CSE 140L,A01,083088,Eldon; John,0,8,75,75
1650470159134,CSE 175,A01,083665,Kumar; Rakesh,7,0,25,18
1650470165159,CSE 190,A00,092507,Dubnov; Shlomo,14,0,20,6
1650470171186,ECE 45,A01,083139,Staff,20,18,60,40
1650470177209,ECE 65,A50,083695,Staff,0,6,30,30
1650470183246,ECE 109,A01,091882,Touri; Behrouz,38,0,70,32
1650470189270,ECE 180,A00,083140,Abi Samra; Nicholas Camill,23,0,30,7
1650470189270,ECE 180,B00,083141,Abi Samra; Nicholas Camill,0,0,30,30
1650470195296,MATH 10A,A01,083735,Patchell; Gregory David,7,0,30,23
1650470195296,MATH 10A,A02,083736,Patchell; Gregory David,28,0,30,2
1650470195296,MATH 10A,A03,083737,Patchell; Gregory David,25,0,30,5
1650470201319,MATH 10B,A01,083207,Staff,0,7,30,30
1650470201319,MATH 10B,A02,083208,Staff,0,7,30,30
1650470201319,MATH 10B,B01,083739,Staff,13,0,30,17
1650470201319,MATH 10B,B02,083740,Staff,28,0,30,2
1650470207349,MATH 18,A01,083743,Staff,1,0,30,29
1650470207349,MATH 18,A02,083744,Staff,27,0,30,3
1650470207349,MATH 18,A03,083745,Staff,22,0,30,8
1650470207349,MATH 18,A04,083746,Staff,26,0,30,4
1650470207349,MATH 18,B01,083748,Staff,0,11,30,30
1650470207349,MATH 18,B02,083749,Staff,0,12,30,30
1650470207349,MATH 18,B03,083750,Staff,0,11,30,30
1650470207349,MATH 18,B04,083751,Staff,0,12,30,30
1650470213379,MATH 20A,A01,083754,Staff,25,0,40,15
1650470219423,MATH 20B,A01,083756,Staff,0,10,30,30
1650470219423,MATH 20B,A02,083757,Staff,0,10,30,30
1650470225454,MATH 20C,A01,083760,Staff,0,15,30,30
1650470225454,MATH 20C,A02,083761,Staff,1,14,30,29
1650470225454,MATH 20C,B01,083762,Staff,13,0,30,17
1650470225454,MATH 20C,B02,083763,Staff,28,0,30,2
1650470231478,MATH 20D,A01,083765,Staff,0,1,30,30
1650470231478,MATH 20D,A02,083766,Staff,9,0,30,21
1650470231478,MATH 20D,A03,083767,Staff,25,0,30,5
1650470237504,MATH 20E,A01,083771,Staff,6,0,30,24
1650470237504,MATH 20E,A02,083772,Staff,18,0,30,12
1650470237504,MATH 20E,B01,083773,Staff,0,0,30,30
1650470237504,MATH 20E,B02,083774,Staff,10,0,30,20
1650470243541,MATH 103A,A01,083777,Staff,0,12,30,30
1650470243541,MATH 103A,A02,083778,Staff,0,12,30,30
1650470243541,MATH 103A,B01,083779,Staff,0,13,30,30
1650470243541,MATH 103A,B02,083780,Staff,0,12,30,30
1650470249568,MATH 105,A01,085443,Staff,0,23,30,30
1650470255590,MATH 109,A01,083213,Anzaldo; Leesa B,0,7,30,30
1650470255590,MATH 109,A02,083214,Anzaldo; Leesa B,0,7,30,30
1650470255590,MATH 109,B01,083215,Anzaldo; Leesa B,0,5,30,30
1650470255590,MATH 109,B02,083216,Anzaldo; Leesa B,0,6,30,30
1650470261620,MATH 142A,A01,083219,Chow; Bennett,0,14,30,30
1650470261620,MATH 142A,A02,083220,Chow; Bennett,0,13,30,30
1650470261620,MATH 142A,B01,083221,Chow; Bennett,0,12,30,30
1650470261620,MATH 142A,B02,083222,Chow; Bennett,0,13,30,30
1650470267645,MATH 193A,A01,083224,Staff,0,5,30,30
1650470267645,MATH 193A,A02,083225,Staff,0,5,30,30
1650470267645,MATH 193A,A03,083781,Staff,0,4,30,30
1650470267645,MATH 193A,A04,083782,Staff,0,5,30,30
1650470273668,MATH 197,001,091859,McAuley; Julian John,9998,0,9999,1
1650470279724,COGS 9,A01,083615,Staff,0,14,60,60
1650470285747,COGS 11,A01,083617,Boyle; Mary E. T.,21,0,40,19
1650470291773,COGS 13,A01,083071,Staff,0,34,40,40
1650470297806,COGS 14A,A01,092681,Staff,1,25,100,99
1650470303832,COGS 14B,A01,083073,Cheng; Tzu-Han,0,11,50,50
1650470309853,COGS 17,A01,092677,Staff,22,0,75,53
1650470315880,COGS 100,A01,083619,Staff,0,26,60,60
1650470321907,COGS 101A,A01,083621,Davis; Joshua Daniel,0,21,60,60
1650470328001,COGS 101B,A01,091572,Staff,0,4,60,60
1650470334024,COGS 101C,A01,083625,Delgado; Tania,16,0,30,14
1650470340049,COGS 107A,A01,083627,Boyle; Mary E. T.,0,11,60,60
1650470346081,COGS 118A,A01,083075,Staff,0,0,60,60
1650470352108,CSE 3,A50,083646,Miranda; Gregory Joseph,20,0,38,18
1650470352108,CSE 3,A51,083647,Miranda; Gregory Joseph,36,0,37,1
1650470358130,CSE 8A,A50,083650,Miranda; Gregory Joseph,0,28,40,40
1650470364158,CSE 11,A01,083080,Cao; Yingjun,0,92,40,40
1650470370182,CSE 12,A01,083652,Staff,0,16,100,100
1650470376222,CSE 15L,A01,083654,Staff,0,1,50,50
1650470376222,CSE 15L,A02,083655,Staff,1,0,50,49
1650470382250,CSE 20,A01,083657,Staff,51,0,80,29
1650470388276,CSE 30,A01,083084,Eldon; John,0,76,40,40
1650470394302,CSE 100,A01,083659,Cao; Yingjun,0,66,50,50
1650470400333,CSE 134B,A01,083661,Powell; Thomas Allan,0,32,65,65
1650470406359,CSE 140,A01,083663,Staff,0,3,75,75
1650470412382,CSE 140L,A01,083088,Eldon; John,0,8,75,75
1650470418413,CSE 175,A01,083665,Kumar; Rakesh,7,0,25,18
1650470424439,CSE 190,A00,092507,Dubnov; Shlomo,14,0,20,6
1650470430462,ECE 45,A01,083139,Staff,20,18,60,40
1650470436484,ECE 65,A50,083695,Staff,0,6,30,30
1650470442510,ECE 109,A01,091882,Touri; Behrouz,38,0,70,32
1650470448540,ECE 180,A00,083140,Abi Samra; Nicholas Camill,23,0,30,7
1650470448540,ECE 180,B00,083141,Abi Samra; Nicholas Camill,0,0,30,30
1650470454561,MATH 10A,A01,083735,Patchell; Gregory David,7,0,30,23
1650470454561,MATH 10A,A02,083736,Patchell; Gregory David,28,0,30,2
1650470454561,MATH 10A,A03,083737,Patchell; Gregory David,25,0,30,5
1650470460588,MATH 10B,A01,083207,Staff,0,7,30,30
1650470460588,MATH 10B,A02,083208,Staff,0,7,30,30
1650470460588,MATH 10B,B01,083739,Staff,13,0,30,17
1650470460588,MATH 10B,B02,083740,Staff,28,0,30,2
1650470466613,MATH 18,A01,083743,Staff,1,0,30,29
1650470466613,MATH 18,A02,083744,Staff,27,0,30,3
1650470466613,MATH 18,A03,083745,Staff,22,0,30,8
1650470466613,MATH 18,A04,083746,Staff,26,0,30,4
1650470466613,MATH 18,B01,083748,Staff,0,11,30,30
1650470466613,MATH 18,B02,083749,Staff,0,12,30,30
1650470466613,MATH 18,B03,083750,Staff,0,11,30,30
1650470466613,MATH 18,B04,083751,Staff,0,12,30,30
1650470472633,MATH 20A,A01,083754,Staff,25,0,40,15
1650470478660,MATH 20B,A01,083756,Staff,0,10,30,30
1650470478660,MATH 20B,A02,083757,Staff,0,10,30,30
1650470484692,MATH 20C,A01,083760,Staff,0,15,30,30
1650470484692,MATH 20C,A02,083761,Staff,1,14,30,29
1650470484692,MATH 20C,B01,083762,Staff,13,0,30,17
1650470484692,MATH 20C,B02,083763,Staff,28,0,30,2
1650470490718,MATH 20D,A01,083765,Staff,0,1,30,30
1650470490718,MATH 20D,A02,083766,Staff,9,0,30,21
1650470490718,MATH 20D,A03,083767,Staff,25,0,30,5
1650470496756,MATH 20E,A01,083771,Staff,6,0,30,24
1650470496756,MATH 20E,A02,083772,Staff,18,0,30,12
1650470496756,MATH 20E,B01,083773,Staff,0,0,30,30
1650470496756,MATH 20E,B02,083774,Staff,10,0,30,20
1650470502789,MATH 103A,A01,083777,Staff,0,12,30,30
1650470502789,MATH 103A,A02,083778,Staff,0,12,30,30
1650470502789,MATH 103A,B01,083779,Staff,0,13,30,30
1650470502789,MATH 103A,B02,083780,Staff,0,12,30,30
1650470508816,MATH 105,A01,085443,Staff,0,23,30,30
1650470514844,MATH 109,A01,083213,Anzaldo; Leesa B,0,7,30,30
1650470514844,MATH 109,A02,083214,Anzaldo; Leesa B,0,7,30,30
1650470514844,MATH 109,B01,083215,Anzaldo; Leesa B,0,5,30,30
1650470514844,MATH 109,B02,083216,Anzaldo; Leesa B,0,6,30,30
1650470520868,MATH 142A,A01,083219,Chow; Bennett,0,14,30,30
1650470520868,MATH 142A,A02,083220,Chow; Bennett,0,13,30,30
1650470520868,MATH 142A,B01,083221,Chow; Bennett,0,12,30,30
1650470520868,MATH 142A,B02,083222,Chow; Bennett,0,13,30,30
1650470526901,MATH 193A,A01,083224,Staff,0,5,30,30
1650470526901,MATH 193A,A02,083225,Staff,0,5,30,30
1650470526901,MATH 193A,A03,083781,Staff,0,4,30,30
1650470526901,MATH 193A,A04,083782,Staff,0,5,30,30
1650470532924,MATH 197,001,091859,McAuley; Julian John,9998,0,9999,1
1650470538989,COGS 9,A01,083615,Staff,0,14,60,60
1650470545015,COGS 11,A01,083617,Boyle; Mary E. T.,21,0,40,19
1650470551041,COGS 13,A01,083071,Staff,0,34,40,40
1650470557067,COGS 14A,A01,092681,Staff,1,25,100,99
1650470563113,COGS 14B,A01,083073,Cheng; Tzu-Han,0,11,50,50
1650470569148,COGS 17,A01,092677,Staff,22,0,75,53
1650470575173,COGS 100,A01,083619,Staff,0,26,60,60
1650470581202,COGS 101A,A01,083621,Davis; Joshua Daniel,0,21,60,60
1650470587226,COGS 101B,A01,091572,Staff,0,4,60,60
1650470593250,COGS 101C,A01,083625,Delgado; Tania,16,0,30,14
1650470599292,COGS 107A,A01,083627,Boyle; Mary E. T.,0,11,60,60
1650470605326,COGS 118A,A01,083075,Staff,0,0,60,60
1650470611358,CSE 3,A50,083646,Miranda; Gregory Joseph,20,0,38,18
1650470611358,CSE 3,A51,083647,Miranda; Gregory Joseph,36,0,37,1
1650470617382,CSE 8A,A50,083650,Miranda; Gregory Joseph,0,28,40,40
1650470623409,CSE 11,A01,083080,Cao; Yingjun,0,92,40,40
1650470629437,CSE 12,A01,083652,Staff,0,16,100,100
1650470635460,CSE 15L,A01,083654,Staff,0,1,50,50
1650470635460,CSE 15L,A02,083655,Staff,1,0,50,49
1650470641493,CSE 20,A01,083657,Staff,51,0,80,29
1650470647520,CSE 30,A01,083084,Eldon; John,0,76,40,40
1650470653555,CSE 100,A01,083659,Cao; Yingjun,0,66,50,50
1650470659592,CSE 134B,A01,083661,Powell; Thomas Allan,0,32,65,65
1650470665615,CSE 140,A01,083663,Staff,0,3,75,75
1650470671639,CSE 140L,A01,083088,Eldon; John,0,8,75,75
1650470677666,CSE 175,A01,083665,Kumar; Rakesh,7,0,25,18
1650470683688,CSE 190,A00,092507,Dubnov; Shlomo,14,0,20,6
1650470689711,ECE 45,A01,083139,Staff,20,18,60,40
1650470695737,ECE 65,A50,083695,Staff,0,6,30,30
1650470701767,ECE 109,A01,091882,Touri; Behrouz,38,0,70,32
1650470707789,ECE 180,A00,083140,Abi Samra; Nicholas Camill,23,0,30,7
1650470707789,ECE 180,B00,083141,Abi Samra; Nicholas Camill,0,0,30,30
1650470713817,MATH 10A,A01,083735,Patchell; Gregory David,7,0,30,23
1650470713817,MATH 10A,A02,083736,Patchell; Gregory David,28,0,30,2
1650470713817,MATH 10A,A03,083737,Patchell; Gregory David,25,0,30,5
1650470719844,MATH 10B,A01,083207,Staff,0,7,30,30
1650470719844,MATH 10B,A02,083208,Staff,0,7,30,30
1650470719844,MATH 10B,B01,083739,Staff,13,0,30,17
1650470719844,MATH 10B,B02,083740,Staff,28,0,30,2
1650470725870,MATH 18,A01,083743,Staff,1,0,30,29
1650470725870,MATH 18,A02,083744,Staff,27,0,30,3
1650470725870,MATH 18,A03,083745,Staff,22,0,30,8
1650470725870,MATH 18,A04,083746,Staff,26,0,30,4
1650470725870,MATH 18,B01,083748,Staff,0,11,30,30
1650470725870,MATH 18,B02,083749,Staff,0,12,30,30
1650470725870,MATH 18,B03,083750,Staff,0,11,30,30
1650470725870,MATH 18,B04,083751,Staff,0,12,30,30
1650470731899,MATH 20A,A01,083754,Staff,25,0,40,15
1650470737930,MATH 20B,A01,083756,Staff,0,10,30,30
1650470737930,MATH 20B,A02,083757,Staff,0,10,30,30
1650470743962,MATH 20C,A01,083760,Staff,0,15,30,30
1650470743962,MATH 20C,A02,083761,Staff,1,14,30,29
1650470743962,MATH 20C,B01,083762,Staff,13,0,30,17
1650470743962,MATH 20C,B02,083763,Staff,28,0,30,2
1650470749986,MATH 20D,A01,083765,Staff,0,1,30,30
1650470749986,MATH 20D,A02,083766,Staff,9,0,30,21
1650470749986,MATH 20D,A03,083767,Staff,25,0,30,5
1650470756010,MATH 20E,A01,083771,Staff,6,0,30,24
1650470756010,MATH 20E,A02,083772,Staff,18,0,30,12
1650470756010,MATH 20E,B01,083773,Staff,0,0,30,30
1650470756010,MATH 20E,B02,083774,Staff,10,0,30,20
1650470762034,MATH 103A,A01,083777,Staff,0,12,30,30
1650470762034,MATH 103A,A02,083778,Staff,0,12,30,30
1650470762034,MATH 103A,B01,083779,Staff,0,13,30,30
1650470762034,MATH 103A,B02,083780,Staff,0,12,30,30
1650470768060,MATH 105,A01,085443,Staff,0,23,30,30
1650470774088,MATH 109,A01,083213,Anzaldo; Leesa B,0,7,30,30
1650470774088,MATH 109,A02,083214,Anzaldo; Leesa B,0,7,30,30
1650470774088,MATH 109,B01,083215,Anzaldo; Leesa B,0,5,30,30
1650470774088,MATH 109,B02,083216,Anzaldo; Leesa B,0,6,30,30
1650470780130,MATH 142A,A01,083219,Chow; Bennett,0,14,30,30
1650470780130,MATH 142A,A02,083220,Chow; Bennett,0,13,30,30
1650470780130,MATH 142A,B01,083221,Chow; Bennett,0,12,30,30
1650470780130,MATH 142A,B02,083222,Chow; Bennett,0,13,30,30
1650470786155,MATH 193A,A01,083224,Staff,0,5,30,30
1650470786155,MATH 193A,A02,083225,Staff,0,5,30,30
1650470786155,MATH 193A,A03,083781,Staff,0,4,30,30
1650470786155,MATH 193A,A04,083782,Staff,0,5,30,30
1650470792179,MATH 197,001,091859,McAuley; Julian John,9998,0,9999,1
1650470798244,COGS 9,A01,083615,Staff,0,14,60,60
1650470804272,COGS 11,A01,083617,Boyle; Mary E. T.,21,0,40,19
1650470810295,COGS 13,A01,083071,Staff,0,34,40,40
1650470816324,COGS 14A,A01,092681,Staff,1,25,100,99
1650470822350,COGS 14B,A01,083073,Cheng; Tzu-Han,0,11,50,50
1650470828382,COGS 17,A01,092677,Staff,22,0,75,53
1650470834417,COGS 100,A01,083619,Staff,0,26,60,60
1650470840440,COGS 101A,A01,083621,Davis; Joshua Daniel,0,21,60,60
1650470846471,COGS 101B,A01,091572,Staff,0,4,60,60
1650470852502,COGS 101C,A01,083625,Delgado; Tania,16,0,30,14
1650470858530,COGS 107A,A01,083627,Boyle; Mary E. T.,0,11,60,60
1650470864557,COGS 118A,A01,083075,Staff,0,0,60,60
1650470870581,CSE 3,A50,083646,Miranda; Gregory Joseph,20,0,38,18
1650470870581,CSE 3,A51,083647,Miranda; Gregory Joseph,36,0,37,1
1650470876609,CSE 8A,A50,083650,Miranda; Gregory Joseph,0,28,40,40
1650470882636,CSE 11,A01,083080,Cao; Yingjun,0,92,40,40
1650470888664,CSE 12,A01,083652,Staff,0,16,100,100
1650470894688,CSE 15L,A01,083654,Staff,0,1,50,50
1650470894688,CSE 15L,A02,083655,Staff,1,0,50,49
1650470900720,CSE 20,A01,083657,Staff,51,0,80,29
1650470906743,CSE 30,A01,083084,Eldon; John,0,76,40,40
1650470912771,CSE 100,A01,083659,Cao; Yingjun,0,66,50,50
1650470918801,CSE 134B,A01,083661,Powell; Thomas Allan,0,32,65,65
1650470924902,CSE 140,A01,083663,Staff,0,3,75,75
1650470930932,CSE 140L,A01,083088,Eldon; John,0,8,75,75
1650470936955,CSE 175,A01,083665,Kumar; Rakesh,7,0,25,18
1650470942987,CSE 190,A00,092507,Dubnov; Shlomo,14,0,20,6
1650470949013,ECE 45,A01,083139,Staff,20,18,60,40
1650470955046,ECE 65,A50,083695,Staff,0,6,30,30
1650470961073,ECE 109,A01,091882,Touri; Behrouz,38,0,70,32
1650470967105,ECE 180,A00,083140,Abi Samra; Nicholas Camill,23,0,30,7
1650470967105,ECE 180,B00,083141,Abi Samra; Nicholas Camill,0,0,30,30
1650470973128,MATH 10A,A01,083735,Patchell; Gregory David,7,0,30,23
1650470973128,MATH 10A,A02,083736,Patchell; Gregory David,28,0,30,2
1650470973128,MATH 10A,A03,083737,Patchell; Gregory David,25,0,30,5
1650470979152,MATH 10B,A01,083207,Staff,0,7,30,30
1650470979152,MATH 10B,A02,083208,Staff,0,7,30,30
1650470979152,MATH 10B,B01,083739,Staff,13,0,30,17
1650470979152,MATH 10B,B02,083740,Staff,28,0,30,2
1650470985177,MATH 18,A01,083743,Staff,1,0,30,29
1650470985177,MATH 18,A02,083744,Staff,27,0,30,3
1650470985177,MATH 18,A03,083745,Staff,22,0,30,8
1650470985177,MATH 18,A04,083746,Staff,26,0,30,4
1650470985177,MATH 18,B01,083748,Staff,0,11,30,30
1650470985177,MATH 18,B02,083749,Staff,0,12,30,30
1650470985177,MATH 18,B03,083750,Staff,0,11,30,30
1650470985177,MATH 18,B04,083751,Staff,0,12,30,30
1650470991207,MATH 20A,A01,083754,Staff,25,0,40,15
1650470997242,MATH 20B,A01,083756,Staff,0,10,30,30
1650470997242,MATH 20B,A02,083757,Staff,0,10,30,30
1650471003266,MATH 20C,A01,083760,Staff,0,15,30,30
1650471003266,MATH 20C,A02,083761,Staff,1,15,30,29
1650471003266,MATH 20C,B01,083762,Staff,13,0,30,17
1650471003266,MATH 20C,B02,083763,Staff,28,0,30,2
1650471009290,MATH 20D,A01,083765,Staff,0,1,30,30
1650471009290,MATH 20D,A02,083766,Staff,9,0,30,21
1650471009290,MATH 20D,A03,083767,Staff,25,0,30,5
1650471015329,MATH 20E,A01,083771,Staff,6,0,30,24
1650471015329,MATH 20E,A02,083772,Staff,18,0,30,12
1650471015329,MATH 20E,B01,083773,Staff,0,0,30,30
1650471015329,MATH 20E,B02,083774,Staff,10,0,30,20
1650471021355,MATH 103A,A01,083777,Staff,0,12,30,30
1650471021355,MATH 103A,A02,083778,Staff,0,12,30,30
1650471021355,MATH 103A,B01,083779,Staff,0,13,30,30
1650471021355,MATH 103A,B02,083780,Staff,0,12,30,30
1650471027381,MATH 105,A01,085443,Staff,0,23,30,30
1650471033411,MATH 109,A01,083213,Anzaldo; Leesa B,0,7,30,30
1650471033411,MATH 109,A02,083214,Anzaldo; Leesa B,0,7,30,30
1650471033411,MATH 109,B01,083215,Anzaldo; Leesa B,0,5,30,30
1650471033411,MATH 109,B02,083216,Anzaldo; Leesa B,0,6,30,30
1650471039439,MATH 142A,A01,083219,Chow; Bennett,0,14,30,30
1650471039439,MATH 142A,A02,083220,Chow; Bennett,0,13,30,30
1650471039439,MATH 142A,B01,083221,Chow; Bennett,0,12,30,30
1650471039439,MATH 142A,B02,083222,Chow; Bennett,0,13,30,30
1650471045471,MATH 193A,A01,083224,Staff,0,5,30,30
1650471045471,MATH 193A,A02,083225,Staff,0,5,30,30
1650471045471,MATH 193A,A03,083781,Staff,0,4,30,30
1650471045471,MATH 193A,A04,083782,Staff,0,5,30,30
1650471051499,MATH 197,001,091859,McAuley; Julian John,9998,0,9999,1
1650471057584,COGS 9,A01,083615,Staff,0,14,60,60
1650471063608,COGS 11,A01,083617,Boyle; Mary E. T.,21,0,40,19
1650471069633,COGS 13,A01,083071,Staff,0,34,40,40
1650471075673,COGS 14A,A01,092681,Staff,1,25,100,99
1650471081704,COGS 14B,A01,083073,Cheng; Tzu-Han,0,11,50,50
1650471087731,COGS 17,A01,092677,Staff,22,0,75,53
1650471093755,COGS 100,A01,083619,Staff,0,26,60,60
1650471099776,COGS 101A,A01,083621,Davis; Joshua Daniel,0,21,60,60
1650471105801,COGS 101B,A01,091572,Staff,0,4,60,60
1650471111824,COGS 101C,A01,083625,Delgado; Tania,16,0,30,14
1650471117859,COGS 107A,A01,083627,Boyle; Mary E. T.,0,11,60,60
1650471123882,COGS 118A,A01,083075,Staff,0,0,60,60
1650471129906,CSE 3,A50,083646,Miranda; Gregory Joseph,20,0,38,18
1650471129906,CSE 3,A51,083647,Miranda; Gregory Joseph,36,0,37,1
1650471135931,CSE 8A,A50,083650,Miranda; Gregory Joseph,0,28,40,40
1650471141965,CSE 11,A01,083080,Cao; Yingjun,0,92,40,40
1650471147992,CSE 12,A01,083652,Staff,0,16,100,100
1650471154020,CSE 15L,A01,083654,Staff,0,1,50,50
1650471154020,CSE 15L,A02,083655,Staff,1,0,50,49
1650471160048,CSE 20,A01,083657,Staff,51,0,80,29
1650471166071,CSE 30,A01,083084,Eldon; John,0,76,40,40
1650471172098,CSE 100,A01,083659,Cao; Yingjun,0,66,50,50
1650471178125,CSE 134B,A01,083661,Powell; Thomas Allan,0,32,65,65
1650471184148,CSE 140,A01,083663,Staff,0,3,75,75
1650471190174,CSE 140L,A01,083088,Eldon; John,0,8,75,75
1650471196197,CSE 175,A01,083665,Kumar; Rakesh,7,0,25,18
1650471202226,CSE 190,A00,092507,Dubnov; Shlomo,14,0,20,6
1650471208257,ECE 45,A01,083139,Staff,20,18,60,40
1650471214281,ECE 65,A50,083695,Staff,0,6,30,30
1650471220312,ECE 109,A01,091882,Touri; Behrouz,38,0,70,32
1650471226343,ECE 180,A00,083140,Abi Samra; Nicholas Camill,23,0,30,7
1650471226343,ECE 180,B00,083141,Abi Samra; Nicholas Camill,0,0,30,30
1650471232379,MATH 10A,A01,083735,Patchell; Gregory David,7,0,30,23
1650471232379,MATH 10A,A02,083736,Patchell; Gregory David,28,0,30,2
1650471232379,MATH 10A,A03,083737,Patchell; Gregory David,25,0,30,5
1650471238402,MATH 10B,A01,083207,Staff,0,8,30,30
1650471238402,MATH 10B,A02,083208,Staff,0,7,30,30
1650471238402,MATH 10B,B01,083739,Staff,13,0,30,17
1650471238402,MATH 10B,B02,083740,Staff,28,0,30,2
1650471244433,MATH 18,A01,083743,Staff,1,0,30,29
1650471244433,MATH 18,A02,083744,Staff,27,0,30,3
1650471244433,MATH 18,A03,083745,Staff,22,0,30,8
1650471244433,MATH 18,A04,083746,Staff,26,0,30,4
1650471244433,MATH 18,B01,083748,Staff,0,11,30,30
1650471244433,MATH 18,B02,083749,Staff,0,12,30,30
1650471244433,MATH 18,B03,083750,Staff,0,11,30,30
1650471244433,MATH 18,B04,083751,Staff,0,12,30,30
1650471250458,MATH 20A,A01,083754,Staff,25,0,40,15
1650471256482,MATH 20B,A01,083756,Staff,0,10,30,30
1650471256482,MATH 20B,A02,083757,Staff,0,10,30,30
1650471262513,MATH 20C,A01,083760,Staff,0,15,30,30
1650471262513,MATH 20C,A02,083761,Staff,1,15,30,29
1650471262513,MATH 20C,B01,083762,Staff,13,0,30,17
1650471262513,MATH 20C,B02,083763,Staff,28,0,30,2
1650471268539,MATH 20D,A01,083765,Staff,0,1,30,30
1650471268539,MATH 20D,A02,083766,Staff,9,0,30,21
1650471268539,MATH 20D,A03,083767,Staff,25,0,30,5
1650471274570,MATH 20E,A01,083771,Staff,6,0,30,24
1650471274570,MATH 20E,A02,083772,Staff,18,0,30,12
1650471274570,MATH 20E,B01,083773,Staff,0,0,30,30
1650471274570,MATH 20E,B02,083774,Staff,10,0,30,20
1650471280597,MATH 103A,A01,083777,Staff,0,12,30,30
1650471280597,MATH 103A,A02,083778,Staff,0,12,30,30
1650471280597,MATH 103A,B01,083779,Staff,0,13,30,30
1650471280597,MATH 103A,B02,083780,Staff,0,12,30,30
1650471286625,MATH 105,A01,085443,Staff,0,23,30,30
1650471292648,MATH 109,A01,083213,Anzaldo; Leesa B,0,7,30,30
1650471292648,MATH 109,A02,083214,Anzaldo; Leesa B,0,7,30,30
1650471292648,MATH 109,B01,083215,Anzaldo; Leesa B,0,5,30,30
1650471292648,MATH 109,B02,083216,Anzaldo; Leesa B,0,6,30,30
1650471298672,MATH 142A,A01,083219,Chow; Bennett,0,14,30,30
1650471298672,MATH 142A,A02,083220,Chow; Bennett,0,13,30,30
1650471298672,MATH 142A,B01,083221,Chow; Bennett,0,12,30,30
1650471298672,MATH 142A,B02,083222,Chow; Bennett,0,13,30,30
1650471304699,MATH 193A,A01,083224,Staff,0,5,30,30
1650471304699,MATH 193A,A02,083225,Staff,0,5,30,30
1650471304699,MATH 193A,A03,083781,Staff,0,4,30,30
1650471304699,MATH 193A,A04,083782,Staff,0,5,30,30
1650471310727,MATH 197,001,091859,McAuley; Julian John,9998,0,9999,1
1650471316785,COGS 9,A01,083615,Staff,0,14,60,60
1650471322808,COGS 11,A01,083617,Boyle; Mary E. T.,21,0,40,19
1650471328835,COGS 13,A01,083071,Staff,0,34,40,40
1650471334858,COGS 14A,A01,092681,Staff,1,25,100,99
1650471340885,COGS 14B,A01,083073,Cheng; Tzu-Han,0,11,50,50
1650471346909,COGS 17,A01,092677,Staff,22,0,75,53
1650471352933,COGS 100,A01,083619,Staff,0,26,60,60
1650471358960,COGS 101A,A01,083621,Davis; Joshua Daniel,0,21,60,60
1650471364984,COGS 101B,A01,091572,Staff,0,4,60,60
1650471371008,COGS 101C,A01,083625,Delgado; Tania,16,0,30,14
1650471377031,COGS 107A,A01,083627,Boyle; Mary E. T.,0,11,60,60
1650471383057,COGS 118A,A01,083075,Staff,0,0,60,60
1650471389082,CSE 3,A50,083646,Miranda; Gregory Joseph,20,0,38,18
1650471389082,CSE 3,A51,083647,Miranda; Gregory Joseph,36,0,37,1
1650471395110,CSE 8A,A50,083650,Miranda; Gregory Joseph,0,28,40,40
1650471401142,CSE 11,A01,083080,Cao; Yingjun,0,92,40,40
1650471407186,CSE 12,A01,083652,Staff,0,16,100,100
1650471413211,CSE 15L,A01,083654,Staff,0,1,50,50
1650471413211,CSE 15L,A02,083655,Staff,1,0,50,49
1650471419250,CSE 20,A01,083657,Staff,51,0,80,29
1650471425274,CSE 30,A01,083084,Eldon; John,0,76,40,40
1650471431303,CSE 100,A01,083659,Cao; Yingjun,0,66,50,50
1650471437329,CSE 134B,A01,083661,Powell; Thomas Allan,0,32,65,65
1650471443352,CSE 140,A01,083663,Staff,0,3,75,75
1650471449379,CSE 140L,A01,083088,Eldon; John,0,8,75,75
1650471455403,CSE 175,A01,083665,Kumar; Rakesh,7,0,25,18
1650471461427,CSE 190,A00,092507,Dubnov; Shlomo,14,0,20,6
1650471467452,ECE 45,A01,083139,Staff,20,18,60,40
1650471473475,ECE 65,A50,083695,Staff,0,6,30,30
1650471479501,ECE 109,A01,091882,Touri; Behrouz,38,0,70,32
1650471485531,ECE 180,A00,083140,Abi Samra; Nicholas Camill,23,0,30,7
1650471485531,ECE 180,B00,083141,Abi Samra; Nicholas Camill,0,0,30,30
1650471491557,MATH 10A,A01,083735,Patchell; Gregory David,7,0,30,23
1650471491557,MATH 10A,A02,083736,Patchell; Gregory David,28,0,30,2
1650471491557,MATH 10A,A03,083737,Patchell; Gregory David,25,0,30,5
1650471497587,MATH 10B,A01,083207,Staff,0,8,30,30
1650471497587,MATH 10B,A02,083208,Staff,0,7,30,30
1650471497587,MATH 10B,B01,083739,Staff,13,0,30,17
1650471497587,MATH 10B,B02,083740,Staff,28,0,30,2
1650471503616,MATH 18,A01,083743,Staff,1,0,30,29
1650471503616,MATH 18,A02,083744,Staff,27,0,30,3
1650471503616,MATH 18,A03,083745,Staff,22,0,30,8
1650471503616,MATH 18,A04,083746,Staff,26,0,30,4
1650471503616,MATH 18,B01,083748,Staff,0,11,30,30
1650471503616,MATH 18,B02,083749,Staff,0,12,30,30
1650471503616,MATH 18,B03,083750,Staff,0,11,30,30
1650471503616,MATH 18,B04,083751,Staff,0,12,30,30
1650471509645,MATH 20A,A01,083754,Staff,25,0,40,15
1650471515668,MATH 20B,A01,083756,Staff,0,10,30,30
1650471515668,MATH 20B,A02,083757,Staff,0,10,30,30
1650471521765,MATH 20C,A01,083760,Staff,0,15,30,30
1650471521765,MATH 20C,A02,083761,Staff,1,15,30,29
1650471521765,MATH 20C,B01,083762,Staff,13,0,30,17
1650471521765,MATH 20C,B02,083763,Staff,28,0,30,2
1650471527788,MATH 20D,A01,083765,Staff,0,1,30,30
1650471527788,MATH 20D,A02,083766,Staff,9,0,30,21
1650471527788,MATH 20D,A03,083767,Staff,25,0,30,5
1650471533820,MATH 20E,A01,083771,Staff,6,0,30,24
1650471533820,MATH 20E,A02,083772,Staff,18,0,30,12
1650471533820,MATH 20E,B01,083773,Staff,0,0,30,30
1650471533820,MATH 20E,B02,083774,Staff,10,0,30,20
1650471539844,MATH 103A,A01,083777,Staff,0,12,30,30
1650471539844,MATH 103A,A02,083778,Staff,0,12,30,30
1650471539844,MATH 103A,B01,083779,Staff,0,13,30,30
1650471539844,MATH 103A,B02,083780,Staff,0,12,30,30
1650471545877,MATH 105,A01,085443,Staff,0,23,30,30
1650471551904,MATH 109,A01,083213,Anzaldo; Leesa B,0,7,30,30
1650471551904,MATH 109,A02,083214,Anzaldo; Leesa B,0,7,30,30
1650471551904,MATH 109,B01,083215,Anzaldo; Leesa B,0,5,30,30
1650471551904,MATH 109,B02,083216,Anzaldo; Leesa B,0,6,30,30
1650471557933,MATH 142A,A01,083219,Chow; Bennett,0,14,30,30
1650471557933,MATH 142A,A02,083220,Chow; Bennett,0,13,30,30
1650471557933,MATH 142A,B01,083221,Chow; Bennett,0,12,30,30
1650471557933,MATH 142A,B02,083222,Chow; Bennett,0,13,30,30
1650471563957,MATH 193A,A01,083224,Staff,0,5,30,30
1650471563957,MATH 193A,A02,083225,Staff,0,5,30,30
1650471563957,MATH 193A,A03,083781,Staff,0,4,30,30
1650471563957,MATH 193A,A04,083782,Staff,0,5,30,30
1650471569979,MATH 197,001,091859,McAuley; Julian John,9998,0,9999,1
1650471576046,COGS 9,A01,083615,Staff,0,14,60,60
1650471582077,COGS 11,A01,083617,Boyle; Mary E. T.,21,0,40,19
1650471588100,COGS 13,A01,083071,Staff,0,34,40,40
1650471594137,COGS 14A,A01,092681,Staff,1,25,100,99
1650471600161,COGS 14B,A01,083073,Cheng; Tzu-Han,0,11,50,50
1650471606184,COGS 17,A01,092677,Staff,22,0,75,53
1650471612207,COGS 100,A01,083619,Staff,0,26,60,60
1650471618231,COGS 101A,A01,083621,Davis; Joshua Daniel,0,21,60,60
1650471624259,COGS 101B,A01,091572,Staff,0,4,60,60
1650471630286,COGS 101C,A01,083625,Delgado; Tania,16,0,30,14
1650471636324,COGS 107A,A01,083627,Boyle; Mary E. T.,0,11,60,60
1650471642354,COGS 118A,A01,083075,Staff,0,0,60,60
1650471648381,CSE 3,A50,083646,Miranda; Gregory Joseph,20,0,38,18
1650471648381,CSE 3,A51,083647,Miranda; Gregory Joseph,36,0,37,1
1650471654404,CSE 8A,A50,083650,Miranda; Gregory Joseph,0,28,40,40
1650471660427,CSE 11,A01,083080,Cao; Yingjun,0,92,40,40
1650471666451,CSE 12,A01,083652,Staff,0,16,100,100
1650471672475,CSE 15L,A01,083654,Staff,0,1,50,50
1650471672475,CSE 15L,A02,083655,Staff,1,0,50,49
1650471678501,CSE 20,A01,083657,Staff,51,0,80,29
1650471684539,CSE 30,A01,083084,Eldon; John,0,76,40,40
1650471690563,CSE 100,A01,083659,Cao; Yingjun,0,66,50,50
1650471696586,CSE 134B,A01,083661,Powell; Thomas Allan,0,32,65,65
1650471702606,CSE 140,A01,083663,Staff,0,3,75,75
1650471708629,CSE 140L,A01,083088,Eldon; John,0,8,75,75
1650471714655,CSE 175,A01,083665,Kumar; Rakesh,7,0,25,18
1650471720678,CSE 190,A00,092507,Dubnov; Shlomo,14,0,20,6
1650471726700,ECE 45,A01,083139,Staff,20,18,60,40
1650471732723,ECE 65,A50,083695,Staff,0,6,30,30
1650471738746,ECE 109,A01,091882,Touri; Behrouz,38,0,70,32
1650471744769,ECE 180,A00,083140,Abi Samra; Nicholas Camill,23,0,30,7
1650471744769,ECE 180,B00,083141,Abi Samra; Nicholas Camill,0,0,30,30
1650471750801,MATH 10A,A01,083735,Patchell; Gregory David,7,0,30,23
1650471750801,MATH 10A,A02,083736,Patchell; Gregory David,28,0,30,2
1650471750801,MATH 10A,A03,083737,Patchell; Gregory David,25,0,30,5
1650471756829,MATH 10B,A01,083207,Staff,0,8,30,30
1650471756829,MATH 10B,A02,083208,Staff,0,7,30,30
1650471756829,MATH 10B,B01,083739,Staff,13,0,30,17
1650471756829,MATH 10B,B02,083740,Staff,28,0,30,2
1650471762863,MATH 18,A01,083743,Staff,1,0,30,29
1650471762863,MATH 18,A02,083744,Staff,27,0,30,3
1650471762863,MATH 18,A03,083745,Staff,22,0,30,8
1650471762863,MATH 18,A04,083746,Staff,26,0,30,4
1650471762863,MATH 18,B01,083748,Staff,0,11,30,30
1650471762863,MATH 18,B02,083749,Staff,0,12,30,30
1650471762863,MATH 18,B03,083750,Staff,0,11,30,30
1650471762863,MATH 18,B04,083751,Staff,0,12,30,30
1650471768890,MATH 20A,A01,083754,Staff,25,0,40,15
1650471774914,MATH 20B,A01,083756,Staff,0,10,30,30
1650471774914,MATH 20B,A02,083757,Staff,0,10,30,30
1650471780938,MATH 20C,A01,083760,Staff,0,15,30,30
1650471780938,MATH 20C,A02,083761,Staff,1,15,30,29
1650471780938,MATH 20C,B01,083762,Staff,13,0,30,17
1650471780938,MATH 20C,B02,083763,Staff,28,0,30,2
1650471786962,MATH 20D,A01,083765,Staff,0,1,30,30
1650471786962,MATH 20D,A02,083766,Staff,9,0,30,21
1650471786962,MATH 20D,A03,083767,Staff,25,0,30,5
1650471792985,MATH 20E,A01,083771,Staff,6,0,30,24
1650471792985,MATH 20E,A02,083772,Staff,18,0,30,12
1650471792985,MATH 20E,B01,083773,Staff,0,0,30,30
1650471792985,MATH 20E,B02,083774,Staff,10,0,30,20
1650471799013,MATH 103A,A01,083777,Staff,0,12,30,30
1650471799013,MATH 103A,A02,083778,Staff,0,12,30,30
1650471799013,MATH 103A,B01,083779,Staff,0,13,30,30
1650471799013,MATH 103A,B02,083780,Staff,0,12,30,30
1650471805045,MATH 105,A01,085443,Staff,0,23,30,30
1650471811072,MATH 109,A01,083213,Anzaldo; Leesa B,0,7,30,30
1650471811072,MATH 109,A02,083214,Anzaldo; Leesa B,0,7,30,30
1650471811072,MATH 109,B01,083215,Anzaldo; Leesa B,0,5,30,30
1650471811072,MATH 109,B02,083216,Anzaldo; Leesa B,0,6,30,30
1650471817111,MATH 142A,A01,083219,Chow; Bennett,0,14,30,30
1650471817111,MATH 142A,A02,083220,Chow; Bennett,0,13,30,30
1650471817111,MATH 142A,B01,083221,Chow; Bennett,0,12,30,30
1650471817111,MATH 142A,B02,083222,Chow; Bennett,0,13,30,30
1650471823135,MATH 193A,A01,083224,Staff,0,5,30,30
1650471823135,MATH 193A,A02,083225,Staff,0,5,30,30
1650471823135,MATH 193A,A03,083781,Staff,0,4,30,30
1650471823135,MATH 193A,A04,083782,Staff,0,6,30,30
1650471829168,MATH 197,001,091859,McAuley; Julian John,9998,0,9999,1
1650471835223,COGS 9,A01,083615,Staff,0,14,60,60
1650471841245,COGS 11,A01,083617,Boyle; Mary E. T.,21,0,40,19
1650471847276,COGS 13,A01,083071,Staff,0,34,40,40
1650471853304,COGS 14A,A01,092681,Staff,1,25,100,99
1650471859331,COGS 14B,A01,083073,Cheng; Tzu-Han,0,11,50,50
1650471865353,COGS 17,A01,092677,Staff,22,0,75,53
1650471871381,COGS 100,A01,083619,Staff,0,26,60,60
1650471877404,COGS 101A,A01,083621,Davis; Joshua Daniel,0,21,60,60
1650471883428,COGS 101B,A01,091572,Staff,0,4,60,60
1650471889454,COGS 101C,A01,083625,Delgado; Tania,16,0,30,14
1650471895476,COGS 107A,A01,083627,Boyle; Mary E. T.,0,11,60,60
1650471901507,COGS 118A,A01,083075,Staff,0,0,60,60
1650471907535,CSE 3,A50,083646,Miranda; Gregory Joseph,20,0,38,18
1650471907535,CSE 3,A51,083647,Miranda; Gregory Joseph,36,0,37,1
1650471913574,CSE 8A,A50,083650,Miranda; Gregory Joseph,0,28,40,40
1650471919598,CSE 11,A01,083080,Cao; Yingjun,0,92,40,40
1650471925625,CSE 12,A01,083652,Staff,0,16,100,100
1650471931647,CSE 15L,A01,083654,Staff,0,1,50,50
1650471931647,CSE 15L,A02,083655,Staff,1,0,50,49
1650471937670,CSE 20,A01,083657,Staff,51,0,80,29
1650471943704,CSE 30,A01,083084,Eldon; John,0,76,40,40
1650471949731,CSE 100,A01,083659,Cao; Yingjun,0,66,50,50
1650471955757,CSE 134B,A01,083661,Powell; Thomas Allan,0,32,65,65
1650471961787,CSE 140,A01,083663,Staff,0,3,75,75
1650471967815,CSE 140L,A01,083088,Eldon; John,0,8,75,75
1650471973838,CSE 175,A01,083665,Kumar; Rakesh,7,0,25,18
1650471979862,CSE 190,A00,092507,Dubnov; Shlomo,14,0,20,6
1650471985888,ECE 45,A01,083139,Staff,20,18,60,40
1650471991923,ECE 65,A50,083695,Staff,0,6,30,30
1650471997949,ECE 109,A01,091882,Touri; Behrouz,38,0,70,32
1650472003973,ECE 180,A00,083140,Abi Samra; Nicholas Camill,23,0,30,7
1650472003973,ECE 180,B00,083141,Abi Samra; Nicholas Camill,0,0,30,30
1650472009996,MATH 10A,A01,083735,Patchell; Gregory David,7,0,30,23
1650472009996,MATH 10A,A02,083736,Patchell; Gregory David,27,0,30,3
1650472009996,MATH 10A,A03,083737,Patchell; Gregory David,25,0,30,5
1650472016020,MATH 10B,A01,083207,Staff,0,8,30,30
1650472016020,MATH 10B,A02,083208,Staff,0,7,30,30
1650472016020,MATH 10B,B01,083739,Staff,13,0,30,17
1650472016020,MATH 10B,B02,083740,Staff,28,0,30,2
1650472022044,MATH 18,A01,083743,Staff,1,0,30,29
1650472022044,MATH 18,A02,083744,Staff,27,0,30,3
1650472022044,MATH 18,A03,083745,Staff,22,0,30,8
1650472022044,MATH 18,A04,083746,Staff,26,0,30,4
1650472022044,MATH 18,B01,083748,Staff,0,11,30,30
1650472022044,MATH 18,B02,083749,Staff,0,12,30,30
1650472022044,MATH 18,B03,083750,Staff,0,11,30,30
1650472022044,MATH 18,B04,083751,Staff,0,12,30,30
1650472028069,MATH 20A,A01,083754,Staff,25,0,40,15
1650472034092,MATH 20B,A01,083756,Staff,0,10,30,30
1650472034092,MATH 20B,A02,083757,Staff,0,10,30,30
1650472040126,MATH 20C,A01,083760,Staff,0,15,30,30
1650472040126,MATH 20C,A02,083761,Staff,1,15,30,29
1650472040126,MATH 20C,B01,083762,Staff,13,0,30,17
1650472040126,MATH 20C,B02,083763,Staff,28,0,30,2
1650472046149,MATH 20D,A01,083765,Staff,0,1,30,30
1650472046149,MATH 20D,A02,083766,Staff,9,0,30,21
1650472046149,MATH 20D,A03,083767,Staff,25,0,30,5
1650472052179,MATH 20E,A01,083771,Staff,6,0,30,24
1650472052179,MATH 20E,A02,083772,Staff,18,0,30,12
1650472052179,MATH 20E,B01,083773,Staff,0,0,30,30
1650472052179,MATH 20E,B02,083774,Staff,10,0,30,20
1650472058208,MATH 103A,A01,083777,Staff,0,12,30,30
1650472058208,MATH 103A,A02,083778,Staff,0,12,30,30
1650472058208,MATH 103A,B01,083779,Staff,0,13,30,30
1650472058208,MATH 103A,B02,083780,Staff,0,12,30,30
1650472064232,MATH 105,A01,085443,Staff,0,23,30,30
1650472070256,MATH 109,A01,083213,Anzaldo; Leesa B,0,7,30,30
1650472070256,MATH 109,A02,083214,Anzaldo; Leesa B,0,7,30,30
1650472070256,MATH 109,B01,083215,Anzaldo; Leesa B,0,5,30,30
1650472070256,MATH 109,B02,083216,Anzaldo; Leesa B,0,6,30,30
1650472076284,MATH 142A,A01,083219,Chow; Bennett,0,14,30,30
1650472076284,MATH 142A,A02,083220,Chow; Bennett,0,13,30,30
1650472076284,MATH 142A,B01,083221,Chow; Bennett,0,12,30,30
1650472076284,MATH 142A,B02,083222,Chow; Bennett,0,13,30,30
1650472082308,MATH 193A,A01,083224,Staff,0,5,30,30
1650472082308,MATH 193A,A02,083225,Staff,0,5,30,30
1650472082308,MATH 193A,A03,083781,Staff,0,4,30,30
1650472082308,MATH 193A,A04,083782,Staff,0,6,30,30
1650472088336,MATH 197,001,091859,McAuley; Julian John,9998,0,9999,1
1650472094388,COGS 9,A01,083615,Staff,0,14,60,60
1650472100413,COGS 11,A01,083617,Boyle; Mary E. T.,21,0,40,19
1650472106440,COGS 13,A01,083071,Staff,0,34,40,40
1650472112544,COGS 14A,A01,092681,Staff,1,25,100,99
1650472118567,COGS 14B,A01,083073,Cheng; Tzu-Han,0,11,50,50
1650472124592,COGS 17,A01,092677,Staff,22,0,75,53
1650472130614,COGS 100,A01,083619,Staff,0,26,60,60
1650472136640,COGS 101A,A01,083621,Davis; Joshua Daniel,0,21,60,60
1650472142669,COGS 101B,A01,091572,Staff,0,4,60,60
1650472148697,COGS 101C,A01,083625,Delgado; Tania,16,0,30,14
1650472154749,COGS 107A,A01,083627,Boyle; Mary E. T.,0,11,60,60
1650472160786,COGS 118A,A01,083075,Staff,0,1,60,60
1650472166809,CSE 3,A50,083646,Miranda; Gregory Joseph,20,0,38,18
1650472166809,CSE 3,A51,083647,Miranda; Gregory Joseph,36,0,37,1
1650472172833,CSE 8A,A50,083650,Miranda; Gregory Joseph,0,28,40,40
1650472178860,CSE 11,A01,083080,Cao; Yingjun,0,92,40,40
1650472184884,CSE 12,A01,083652,Staff,0,16,100,100
1650472190908,CSE 15L,A01,083654,Staff,0,1,50,50
1650472190908,CSE 15L,A02,083655,Staff,1,0,50,49
1650472196933,CSE 20,A01,083657,Staff,51,0,80,29
1650472202967,CSE 30,A01,083084,Eldon; John,0,76,40,40
1650472208992,CSE 100,A01,083659,Cao; Yingjun,0,66,50,50
1650472215018,CSE 134B,A01,083661,Powell; Thomas Allan,0,32,65,65
1650472221042,CSE 140,A01,083663,Staff,0,3,75,75
1650472227064,CSE 140L,A01,083088,Eldon; John,0,8,75,75
1650472233090,CSE 175,A01,083665,Kumar; Rakesh,7,0,25,18
1650472239127,CSE 190,A00,092507,Dubnov; Shlomo,14,0,20,6
1650472245149,ECE 45,A01,083139,Staff,20,18,60,40
1650472251175,ECE 65,A50,083695,Staff,0,6,30,30
1650472257198,ECE 109,A01,091882,Touri; Behrouz,38,0,70,32
1650472263223,ECE 180,A00,083140,Abi Samra; Nicholas Camill,23,0,30,7
1650472263223,ECE 180,B00,083141,Abi Samra; Nicholas Camill,0,0,30,30
1650472269250,MATH 10A,A01,083735,Patchell; Gregory David,7,0,30,23
1650472269250,MATH 10A,A02,083736,Patchell; Gregory David,27,0,30,3
1650472269250,MATH 10A,A03,083737,Patchell; Gregory David,25,0,30,5
1650472275276,MATH 10B,A01,083207,Staff,0,8,30,30
1650472275276,MATH 10B,A02,083208,Staff,0,7,30,30
1650472275276,MATH 10B,B01,083739,Staff,13,0,30,17
1650472275276,MATH 10B,B02,083740,Staff,28,0,30,2
1650472281301,MATH 18,A01,083743,Staff,1,0,30,29
1650472281301,MATH 18,A02,083744,Staff,27,0,30,3
1650472281301,MATH 18,A03,083745,Staff,22,0,30,8
1650472281301,MATH 18,A04,083746,Staff,26,0,30,4
1650472281301,MATH 18,B01,083748,Staff,0,11,30,30
1650472281301,MATH 18,B02,083749,Staff,0,12,30,30
1650472281301,MATH 18,B03,083750,Staff,0,11,30,30
1650472281301,MATH 18,B04,083751,Staff,0,12,30,30
1650472287323,MATH 20A,A01,083754,Staff,25,0,40,15
1650472293350,MATH 20B,A01,083756,Staff,0,10,30,30
1650472293350,MATH 20B,A02,083757,Staff,0,10,30,30
1650472299386,MATH 20C,A01,083760,Staff,0,15,30,30
1650472299386,MATH 20C,A02,083761,Staff,1,15,30,29
1650472299386,MATH 20C,B01,083762,Staff,13,0,30,17
1650472299386,MATH 20C,B02,083763,Staff,28,0,30,2
1650472305421,MATH 20D,A01,083765,Staff,0,1,30,30
1650472305421,MATH 20D,A02,083766,Staff,9,0,30,21
1650472305421,MATH 20D,A03,083767,Staff,25,0,30,5
1650472311446,MATH 20E,A01,083771,Staff,6,0,30,24
1650472311446,MATH 20E,A02,083772,Staff,18,0,30,12
1650472311446,MATH 20E,B01,083773,Staff,0,0,30,30
1650472311446,MATH 20E,B02,083774,Staff,10,0,30,20
1650472317467,MATH 103A,A01,083777,Staff,0,12,30,30
1650472317467,MATH 103A,A02,083778,Staff,0,12,30,30
1650472317467,MATH 103A,B01,083779,Staff,0,13,30,30
1650472317467,MATH 103A,B02,083780,Staff,0,12,30,30
1650472323490,MATH 105,A01,085443,Staff,0,23,30,30
1650472329520,MATH 109,A01,083213,Anzaldo; Leesa B,0,7,30,30
1650472329520,MATH 109,A02,083214,Anzaldo; Leesa B,0,7,30,30
1650472329520,MATH 109,B01,083215,Anzaldo; Leesa B,0,5,30,30
1650472329520,MATH 109,B02,083216,Anzaldo; Leesa B,0,6,30,30
1650472335545,MATH 142A,A01,083219,Chow; Bennett,0,14,30,30
1650472335545,MATH 142A,A02,083220,Chow; Bennett,0,13,30,30
1650472335545,MATH 142A,B01,083221,Chow; Bennett,0,12,30,30
1650472335545,MATH 142A,B02,083222,Chow; Bennett,0,13,30,30
1650472341566,MATH 193A,A01,083224,Staff,0,5,30,30
1650472341566,MATH 193A,A02,083225,Staff,0,5,30,30
1650472341566,MATH 193A,A03,083781,Staff,0,4,30,30
1650472341566,MATH 193A,A04,083782,Staff,0,6,30,30
1650472347597,MATH 197,001,091859,McAuley; Julian John,9998,0,9999,1
1650472353659,COGS 9,A01,083615,Staff,0,14,60,60
1650472359685,COGS 11,A01,083617,Boyle; Mary E. T.,21,0,40,19
1650472365707,COGS 13,A01,083071,Staff,0,34,40,40
1650472371738,COGS 14A,A01,092681,Staff,1,25,100,99
1650472377764,COGS 14B,A01,083073,Cheng; Tzu-Han,0,11,50,50
1650472383786,COGS 17,A01,092677,Staff,22,0,75,53
1650472389814,COGS 100,A01,083619,Staff,0,26,60,60
1650472395849,COGS 101A,A01,083621,Davis; Joshua Daniel,0,21,60,60
1650472401875,COGS 101B,A01,091572,Staff,0,4,60,60
1650472407906,COGS 101C,A01,083625,Delgado; Tania,16,0,30,14
1650472413933,COGS 107A,A01,083627,Boyle; Mary E. T.,0,11,60,60
1650472419959,COGS 118A,A01,083075,Staff,0,1,60,60
1650472425989,CSE 3,A50,083646,Miranda; Gregory Joseph,20,0,38,18
1650472425989,CSE 3,A51,083647,Miranda; Gregory Joseph,36,0,37,1
1650472432011,CSE 8A,A50,083650,Miranda; Gregory Joseph,0,28,40,40
1650472438038,CSE 11,A01,083080,Cao; Yingjun,0,92,40,40
1650472444065,CSE 12,A01,083652,Staff,0,16,100,100
1650472450091,CSE 15L,A01,083654,Staff,0,1,50,50
1650472450091,CSE 15L,A02,083655,Staff,1,0,50,49
1650472456116,CSE 20,A01,083657,Staff,51,0,80,29
1650472462146,CSE 30,A01,083084,Eldon; John,0,76,40,40
1650472468168,CSE 100,A01,083659,Cao; Yingjun,0,66,50,50
1650472474192,CSE 134B,A01,083661,Powell; Thomas Allan,0,32,65,65
1650472480215,CSE 140,A01,083663,Staff,0,3,75,75
1650472486238,CSE 140L,A01,083088,Eldon; John,0,8,75,75
1650472492261,CSE 175,A01,083665,Kumar; Rakesh,7,0,25,18
1650472498287,CSE 190,A00,092507,Dubnov; Shlomo,14,0,20,6
1650472504314,ECE 45,A01,083139,Staff,20,18,60,40
1650472510342,ECE 65,A50,083695,Staff,0,6,30,30
1650472516365,ECE 109,A01,091882,Touri; Behrouz,39,0,70,31
1650472522388,ECE 180,A00,083140,Abi Samra; Nicholas Camill,23,0,30,7
1650472522388,ECE 180,B00,083141,Abi Samra; Nicholas Camill,0,0,30,30
1650472528409,MATH 10A,A01,083735,Patchell; Gregory David,7,0,30,23
1650472528409,MATH 10A,A02,083736,Patchell; Gregory David,27,0,30,3
1650472528409,MATH 10A,A03,083737,Patchell; Gregory David,25,0,30,5
1650472534432,MATH 10B,A01,083207,Staff,0,8,30,30
1650472534432,MATH 10B,A02,083208,Staff,0,7,30,30
1650472534432,MATH 10B,B01,083739,Staff,13,0,30,17
1650472534432,MATH 10B,B02,083740,Staff,28,0,30,2
1650472540455,MATH 18,A01,083743,Staff,1,0,30,29
1650472540455,MATH 18,A02,083744,Staff,27,0,30,3
1650472540455,MATH 18,A03,083745,Staff,22,0,30,8
1650472540455,MATH 18,A04,083746,Staff,26,0,30,4
1650472540455,MATH 18,B01,083748,Staff,0,11,30,30
1650472540455,MATH 18,B02,083749,Staff,0,12,30,30
1650472540455,MATH 18,B03,083750,Staff,0,11,30,30
1650472540455,MATH 18,B04,083751,Staff,0,12,30,30
1650472546490,MATH 20A,A01,083754,Staff,25,0,40,15
1650472552513,MATH 20B,A01,083756,Staff,0,10,30,30
1650472552513,MATH 20B,A02,083757,Staff,0,10,30,30
1650472558563,MATH 20C,A01,083760,Staff,0,15,30,30
1650472558563,MATH 20C,A02,083761,Staff,1,15,30,29
1650472558563,MATH 20C,B01,083762,Staff,13,0,30,17
1650472558563,MATH 20C,B02,083763,Staff,28,0,30,2
1650472564586,MATH 20D,A01,083765,Staff,0,1,30,30
1650472564586,MATH 20D,A02,083766,Staff,9,0,30,21
1650472564586,MATH 20D,A03,083767,Staff,25,0,30,5
1650472570611,MATH 20E,A01,083771,Staff,6,0,30,24
1650472570611,MATH 20E,A02,083772,Staff,18,0,30,12
1650472570611,MATH 20E,B01,083773,Staff,0,0,30,30
1650472570611,MATH 20E,B02,083774,Staff,10,0,30,20
1650472576657,MATH 103A,A01,083777,Staff,0,12,30,30
1650472576657,MATH 103A,A02,083778,Staff,0,12,30,30
1650472576657,MATH 103A,B01,083779,Staff,0,13,30,30
1650472576657,MATH 103A,B02,083780,Staff,0,12,30,30
1650472582681,MATH 105,A01,085443,Staff,0,23,30,30
1650472588706,MATH 109,A01,083213,Anzaldo; Leesa B,0,7,30,30
1650472588706,MATH 109,A02,083214,Anzaldo; Leesa B,0,7,30,30
1650472588706,MATH 109,B01,083215,Anzaldo; Leesa B,0,5,30,30
1650472588706,MATH 109,B02,083216,Anzaldo; Leesa B,0,6,30,30
1650472594730,MATH 142A,A01,083219,Chow; Bennett,0,14,30,30
1650472594730,MATH 142A,A02,083220,Chow; Bennett,0,13,30,30
1650472594730,MATH 142A,B01,083221,Chow; Bennett,0,12,30,30
1650472594730,MATH 142A,B02,083222,Chow; Bennett,0,13,30,30
1650472600757,MATH 193A,A01,083224,Staff,0,5,30,30
1650472600757,MATH 193A,A02,083225,Staff,0,5,30,30
1650472600757,MATH 193A,A03,083781,Staff,0,4,30,30
1650472600757,MATH 193A,A04,083782,Staff,0,6,30,30
1650472606792,MATH 197,001,091859,McAuley; Julian John,9998,0,9999,1
1650472612852,COGS 9,A01,083615,Staff,0,14,60,60
1650472618876,COGS 11,A01,083617,Boyle; Mary E. T.,21,0,40,19
1650472624902,COGS 13,A01,083071,Staff,0,34,40,40
1650472630944,COGS 14A,A01,092681,Staff,1,25,100,99
1650472636969,COGS 14B,A01,083073,Cheng; Tzu-Han,0,11,50,50
1650472642995,COGS 17,A01,092677,Staff,22,0,75,53
1650472649018,COGS 100,A01,083619,Staff,0,26,60,60
1650472655052,COGS 101A,A01,083621,Davis; Joshua Daniel,0,21,60,60
1650472661075,COGS 101B,A01,091572,Staff,0,4,60,60
1650472667099,COGS 101C,A01,083625,Delgado; Tania,16,0,30,14
1650472673125,COGS 107A,A01,083627,Boyle; Mary E. T.,0,11,60,60
1650472679163,COGS 118A,A01,083075,Staff,0,1,60,60
1650472685194,CSE 3,A50,083646,Miranda; Gregory Joseph,20,0,38,18
1650472685194,CSE 3,A51,083647,Miranda; Gregory Joseph,36,0,37,1
1650472691222,CSE 8A,A50,083650,Miranda; Gregory Joseph,0,28,40,40
1650472697250,CSE 11,A01,083080,Cao; Yingjun,0,92,40,40
1650472703274,CSE 12,A01,083652,Staff,0,16,100,100
1650472709373,CSE 15L,A01,083654,Staff,0,1,50,50
1650472709373,CSE 15L,A02,083655,Staff,1,0,50,49
1650472715400,CSE 20,A01,083657,Staff,51,0,80,29
1650472721426,CSE 30,A01,083084,Eldon; John,0,76,40,40
1650472727452,CSE 100,A01,083659,Cao; Yingjun,0,66,50,50
1650472733485,CSE 134B,A01,083661,Powell; Thomas Allan,0,32,65,65
1650472739523,CSE 140,A01,083663,Staff,0,3,75,75
1650472745570,CSE 140L,A01,083088,Eldon; John,0,8,75,75
1650472751601,CSE 175,A01,083665,Kumar; Rakesh,7,0,25,18
1650472757627,CSE 190,A00,092507,Dubnov; Shlomo,14,0,20,6
1650472763652,ECE 45,A01,083139,Staff,20,18,60,40
1650472769675,ECE 65,A50,083695,Staff,0,6,30,30
1650472775699,ECE 109,A01,091882,Touri; Behrouz,39,0,70,31
1650472781738,ECE 180,A00,083140,Abi Samra; Nicholas Camill,23,0,30,7
1650472781738,ECE 180,B00,083141,Abi Samra; Nicholas Camill,0,0,30,30
1650472787761,MATH 10A,A01,083735,Patchell; Gregory David,7,0,30,23
1650472787761,MATH 10A,A02,083736,Patchell; Gregory David,27,0,30,3
1650472787761,MATH 10A,A03,083737,Patchell; Gregory David,25,0,30,5
1650472793788,MATH 10B,A01,083207,Staff,0,8,30,30
1650472793788,MATH 10B,A02,083208,Staff,0,7,30,30
1650472793788,MATH 10B,B01,083739,Staff,13,0,30,17
1650472793788,MATH 10B,B02,083740,Staff,28,0,30,2
1650472799824,MATH 18,A01,083743,Staff,1,0,30,29
1650472799824,MATH 18,A02,083744,Staff,27,0,30,3
1650472799824,MATH 18,A03,083745,Staff,22,0,30,8
1650472799824,MATH 18,A04,083746,Staff,26,0,30,4
1650472799824,MATH 18,B01,083748,Staff,0,11,30,30
1650472799824,MATH 18,B02,083749,Staff,0,12,30,30
1650472799824,MATH 18,B03,083750,Staff,0,11,30,30
1650472799824,MATH 18,B04,083751,Staff,0,12,30,30
1650472805857,MATH 20A,A01,083754,Staff,25,0,40,15
1650472811881,MATH 20B,A01,083756,Staff,0,10,30,30
1650472811881,MATH 20B,A02,083757,Staff,0,10,30,30
1650472817908,MATH 20C,A01,083760,Staff,0,15,30,30
1650472817908,MATH 20C,A02,083761,Staff,1,15,30,29
1650472817908,MATH 20C,B01,083762,Staff,13,0,30,17
1650472817908,MATH 20C,B02,083763,Staff,28,0,30,2
1650472823935,MATH 20D,A01,083765,Staff,0,1,30,30
1650472823935,MATH 20D,A02,083766,Staff,9,0,30,21
1650472823935,MATH 20D,A03,083767,Staff,25,0,30,5
1650472829962,MATH 20E,A01,083771,Staff,6,0,30,24
1650472829962,MATH 20E,A02,083772,Staff,18,0,30,12
1650472829962,MATH 20E,B01,083773,Staff,0,0,30,30
1650472829962,MATH 20E,B02,083774,Staff,10,0,30,20
1650472835986,MATH 103A,A01,083777,Staff,0,12,30,30
1650472835986,MATH 103A,A02,083778,Staff,0,12,30,30
1650472835986,MATH 103A,B01,083779,Staff,0,13,30,30
1650472835986,MATH 103A,B02,083780,Staff,0,12,30,30
1650472842010,MATH 105,A01,085443,Staff,0,23,30,30
1650472848038,MATH 109,A01,083213,Anzaldo; Leesa B,0,7,30,30
1650472848038,MATH 109,A02,083214,Anzaldo; Leesa B,0,7,30,30
1650472848038,MATH 109,B01,083215,Anzaldo; Leesa B,0,5,30,30
1650472848038,MATH 109,B02,083216,Anzaldo; Leesa B,0,6,30,30
1650472854077,MATH 142A,A01,083219,Chow; Bennett,0,14,30,30
1650472854077,MATH 142A,A02,083220,Chow; Bennett,0,13,30,30
1650472854077,MATH 142A,B01,083221,Chow; Bennett,0,12,30,30
1650472854077,MATH 142A,B02,083222,Chow; Bennett,0,13,30,30
1650472860102,MATH 193A,A01,083224,Staff,0,5,30,30
1650472860102,MATH 193A,A02,083225,Staff,0,5,30,30
1650472860102,MATH 193A,A03,083781,Staff,0,4,30,30
1650472860102,MATH 193A,A04,083782,Staff,0,6,30,30
1650472866142,MATH 197,001,091859,McAuley; Julian John,9998,0,9999,1
1650472872192,COGS 9,A01,083615,Staff,0,14,60,60
1650472878216,COGS 11,A01,083617,Boyle; Mary E. T.,21,0,40,19
1650472884242,COGS 13,A01,083071,Staff,0,34,40,40
1650472890265,COGS 14A,A01,092681,Staff,1,25,100,99
1650472896291,COGS 14B,A01,083073,Cheng; Tzu-Han,0,11,50,50
1650472902314,COGS 17,A01,092677,Staff,22,0,75,53
1650472908338,COGS 100,A01,083619,Staff,0,26,60,60
1650472914369,COGS 101A,A01,083621,Davis; Joshua Daniel,0,21,60,60
1650472920394,COGS 101B,A01,091572,Staff,0,4,60,60
1650472926422,COGS 101C,A01,083625,Delgado; Tania,16,0,30,14
1650472932444,COGS 107A,A01,083627,Boyle; Mary E. T.,0,11,60,60
1650472938469,COGS 118A,A01,083075,Staff,0,2,60,60
1650472944504,CSE 3,A50,083646,Miranda; Gregory Joseph,20,0,38,18
1650472944504,CSE 3,A51,083647,Miranda; Gregory Joseph,36,0,37,1
1650472950529,CSE 8A,A50,083650,Miranda; Gregory Joseph,0,28,40,40
1650472956552,CSE 11,A01,083080,Cao; Yingjun,0,92,40,40
1650472962577,CSE 12,A01,083652,Staff,0,16,100,100
1650472968598,CSE 15L,A01,083654,Staff,0,1,50,50
1650472968598,CSE 15L,A02,083655,Staff,1,0,50,49
1650472974624,CSE 20,A01,083657,Staff,51,0,80,29
1650472980666,CSE 30,A01,083084,Eldon; John,0,76,40,40
1650472986691,CSE 100,A01,083659,Cao; Yingjun,0,66,50,50
1650472992715,CSE 134B,A01,083661,Powell; Thomas Allan,0,32,65,65
1650472998739,CSE 140,A01,083663,Staff,0,3,75,75
1650473004765,CSE 140L,A01,083088,Eldon; John,0,8,75,75
1650473010795,CSE 175,A01,083665,Kumar; Rakesh,7,0,25,18
1650473016819,CSE 190,A00,092507,Dubnov; Shlomo,14,0,20,6
1650473022844,ECE 45,A01,083139,Staff,20,18,60,40
1650473028870,ECE 65,A50,083695,Staff,0,6,30,30
1650473034894,ECE 109,A01,091882,Touri; Behrouz,39,0,70,31
1650473040931,ECE 180,A00,083140,Abi Samra; Nicholas Camill,23,0,30,7
1650473040931,ECE 180,B00,083141,Abi Samra; Nicholas Camill,0,0,30,30
1650473046964,MATH 10A,A01,083735,Patchell; Gregory David,7,0,30,23
1650473046964,MATH 10A,A02,083736,Patchell; Gregory David,27,0,30,3
1650473046964,MATH 10A,A03,083737,Patchell; Gregory David,25,0,30,5
1650473052989,MATH 10B,A01,083207,Staff,0,8,30,30
1650473052989,MATH 10B,A02,083208,Staff,0,7,30,30
1650473052989,MATH 10B,B01,083739,Staff,13,0,30,17
1650473052989,MATH 10B,B02,083740,Staff,28,0,30,2
1650473059020,MATH 18,A01,083743,Staff,1,0,30,29
1650473059020,MATH 18,A02,083744,Staff,27,0,30,3
1650473059020,MATH 18,A03,083745,Staff,22,0,30,8
1650473059020,MATH 18,A04,083746,Staff,26,0,30,4
1650473059020,MATH 18,B01,083748,Staff,0,11,30,30
1650473059020,MATH 18,B02,083749,Staff,0,12,30,30
1650473059020,MATH 18,B03,083750,Staff,0,11,30,30
1650473059020,MATH 18,B04,083751,Staff,0,12,30,30
1650473065041,MATH 20A,A01,083754,Staff,25,0,40,15
1650473071088,MATH 20B,A01,083756,Staff,0,10,30,30
1650473071088,MATH 20B,A02,083757,Staff,0,10,30,30
1650473077118,MATH 20C,A01,083760,Staff,0,15,30,30
1650473077118,MATH 20C,A02,083761,Staff,1,15,30,29
1650473077118,MATH 20C,B01,083762,Staff,13,0,30,17
1650473077118,MATH 20C,B02,083763,Staff,28,0,30,2
1650473083143,MATH 20D,A01,083765,Staff,0,1,30,30
1650473083143,MATH 20D,A02,083766,Staff,9,0,30,21
1650473083143,MATH 20D,A03,083767,Staff,25,0,30,5
1650473089170,MATH 20E,A01,083771,Staff,6,0,30,24
1650473089170,MATH 20E,A02,083772,Staff,18,0,30,12
1650473089170,MATH 20E,B01,083773,Staff,0,0,30,30
1650473089170,MATH 20E,B02,083774,Staff,10,0,30,20
1650473095211,MATH 103A,A01,083777,Staff,0,12,30,30
1650473095211,MATH 103A,A02,083778,Staff,0,12,30,30
1650473095211,MATH 103A,B01,083779,Staff,0,13,30,30
1650473095211,MATH 103A,B02,083780,Staff,0,12,30,30
1650473101237,MATH 105,A01,085443,Staff,0,23,30,30
1650473107275,MATH 109,A01,083213,Anzaldo; Leesa B,0,7,30,30
1650473107275,MATH 109,A02,083214,Anzaldo; Leesa B,0,7,30,30
1650473107275,MATH 109,B01,083215,Anzaldo; Leesa B,0,5,30,30
1650473107275,MATH 109,B02,083216,Anzaldo; Leesa B,0,6,30,30
1650473113314,MATH 142A,A01,083219,Chow; Bennett,0,14,30,30
1650473113314,MATH 142A,A02,083220,Chow; Bennett,0,13,30,30
1650473113314,MATH 142A,B01,083221,Chow; Bennett,0,12,30,30
1650473113314,MATH 142A,B02,083222,Chow; Bennett,0,13,30,30
1650473119351,MATH 193A,A01,083224,Staff,0,5,30,30
1650473119351,MATH 193A,A02,083225,Staff,0,5,30,30
1650473119351,MATH 193A,A03,083781,Staff,0,4,30,30
1650473119351,MATH 193A,A04,083782,Staff,0,6,30,30
1650473125379,MATH 197,001,091859,McAuley; Julian John,9998,0,9999,1
1650473131452,COGS 9,A01,083615,Staff,0,14,60,60
1650473137482,COGS 11,A01,083617,Boyle; Mary E. T.,21,0,40,19
1650473143506,COGS 13,A01,083071,Staff,0,34,40,40
1650473149531,COGS 14A,A01,092681,Staff,1,25,100,99
1650473155555,COGS 14B,A01,083073,Cheng; Tzu-Han,0,11,50,50
1650473161585,COGS 17,A01,092677,Staff,22,0,75,53
1650473167607,COGS 100,A01,083619,Staff,0,26,60,60
1650473173632,COGS 101A,A01,083621,Davis; Joshua Daniel,0,21,60,60
1650473179658,COGS 101B,A01,091572,Staff,0,4,60,60
1650473185685,COGS 101C,A01,083625,Delgado; Tania,16,0,30,14
1650473191712,COGS 107A,A01,083627,Boyle; Mary E. T.,0,11,60,60
1650473197739,COGS 118A,A01,083075,Staff,0,2,60,60
1650473203768,CSE 3,A50,083646,Miranda; Gregory Joseph,20,0,38,18
1650473203768,CSE 3,A51,083647,Miranda; Gregory Joseph,36,0,37,1
1650473209793,CSE 8A,A50,083650,Miranda; Gregory Joseph,0,28,40,40
1650473215816,CSE 11,A01,083080,Cao; Yingjun,0,92,40,40
1650473221849,CSE 12,A01,083652,Staff,0,16,100,100
1650473227876,CSE 15L,A01,083654,Staff,0,1,50,50
1650473227876,CSE 15L,A02,083655,Staff,1,0,50,49
1650473233902,CSE 20,A01,083657,Staff,51,0,80,29
1650473239924,CSE 30,A01,083084,Eldon; John,0,76,40,40
1650473245950,CSE 100,A01,083659,Cao; Yingjun,0,66,50,50
1650473251974,CSE 134B,A01,083661,Powell; Thomas Allan,0,32,65,65
1650473257998,CSE 140,A01,083663,Staff,0,3,75,75
1650473264033,CSE 140L,A01,083088,Eldon; John,0,8,75,75
1650473270062,CSE 175,A01,083665,Kumar; Rakesh,7,0,25,18
1650473276088,CSE 190,A00,092507,Dubnov; Shlomo,14,0,20,6
1650473282112,ECE 45,A01,083139,Staff,20,18,60,40
1650473288136,ECE 65,A50,083695,Staff,0,6,30,30
1650473294162,ECE 109,A01,091882,Touri; Behrouz,39,0,70,31
1650473300187,ECE 180,A00,083140,Abi Samra; Nicholas Camill,23,0,30,7
1650473300187,ECE 180,B00,083141,Abi Samra; Nicholas Camill,0,0,30,30
1650473306297,MATH 10A,A01,083735,Patchell; Gregory David,7,0,30,23
1650473306297,MATH 10A,A02,083736,Patchell; Gregory David,27,0,30,3
1650473306297,MATH 10A,A03,083737,Patchell; Gregory David,25,0,30,5
1650473312328,MATH 10B,A01,083207,Staff,0,8,30,30
1650473312328,MATH 10B,A02,083208,Staff,0,7,30,30
1650473312328,MATH 10B,B01,083739,Staff,13,0,30,17
1650473312328,MATH 10B,B02,083740,Staff,28,0,30,2
1650473318354,MATH 18,A01,083743,Staff,1,0,30,29
1650473318354,MATH 18,A02,083744,Staff,27,0,30,3
1650473318354,MATH 18,A03,083745,Staff,22,0,30,8
1650473318354,MATH 18,A04,083746,Staff,26,0,30,4
1650473318354,MATH 18,B01,083748,Staff,0,11,30,30
1650473318354,MATH 18,B02,083749,Staff,0,12,30,30
1650473318354,MATH 18,B03,083750,Staff,0,11,30,30
1650473318354,MATH 18,B04,083751,Staff,0,12,30,30
1650473324379,MATH 20A,A01,083754,Staff,25,0,40,15
1650473330407,MATH 20B,A01,083756,Staff,0,10,30,30
1650473330407,MATH 20B,A02,083757,Staff,0,10,30,30
1650473336439,MATH 20C,A01,083760,Staff,0,15,30,30
1650473336439,MATH 20C,A02,083761,Staff,1,15,30,29
1650473336439,MATH 20C,B01,083762,Staff,13,0,30,17
1650473336439,MATH 20C,B02,083763,Staff,28,0,30,2
1650473342464,MATH 20D,A01,083765,Staff,0,1,30,30
1650473342464,MATH 20D,A02,083766,Staff,9,0,30,21
1650473342464,MATH 20D,A03,083767,Staff,25,0,30,5
1650473348490,MATH 20E,A01,083771,Staff,6,0,30,24
1650473348490,MATH 20E,A02,083772,Staff,18,0,30,12
1650473348490,MATH 20E,B01,083773,Staff,0,0,30,30
1650473348490,MATH 20E,B02,083774,Staff,10,0,30,20
1650473354517,MATH 103A,A01,083777,Staff,0,12,30,30
1650473354517,MATH 103A,A02,083778,Staff,0,12,30,30
1650473354517,MATH 103A,B01,083779,Staff,0,13,30,30
1650473354517,MATH 103A,B02,083780,Staff,0,12,30,30
1650473360541,MATH 105,A01,085443,Staff,0,23,30,30
1650473366575,MATH 109,A01,083213,Anzaldo; Leesa B,0,7,30,30
1650473366575,MATH 109,A02,083214,Anzaldo; Leesa B,0,7,30,30
1650473366575,MATH 109,B01,083215,Anzaldo; Leesa B,0,5,30,30
1650473366575,MATH 109,B02,083216,Anzaldo; Leesa B,0,6,30,30
1650473372607,MATH 142A,A01,083219,Chow; Bennett,0,14,30,30
1650473372607,MATH 142A,A02,083220,Chow; Bennett,0,13,30,30
1650473372607,MATH 142A,B01,083221,Chow; Bennett,0,12,30,30
1650473372607,MATH 142A,B02,083222,Chow; Bennett,0,13,30,30
1650473378644,MATH 193A,A01,083224,Staff,0,5,30,30
1650473378644,MATH 193A,A02,083225,Staff,0,5,30,30
1650473378644,MATH 193A,A03,083781,Staff,0,4,30,30
1650473378644,MATH 193A,A04,083782,Staff,0,6,30,30
1650473384668,MATH 197,001,091859,McAuley; Julian John,9998,0,9999,1
1650473390738,COGS 9,A01,083615,Staff,0,14,60,60
1650473396763,COGS 11,A01,083617,Boyle; Mary E. T.,21,0,40,19
1650473402787,COGS 13,A01,083071,Staff,0,34,40,40
1650473408812,COGS 14A,A01,092681,Staff,1,25,100,99
1650473414836,COGS 14B,A01,083073,Cheng; Tzu-Han,0,11,50,50
1650473420862,COGS 17,A01,092677,Staff,22,0,75,53
1650473426885,COGS 100,A01,083619,Staff,0,26,60,60
1650473432915,COGS 101A,A01,083621,Davis; Joshua Daniel,0,21,60,60
1650473438941,COGS 101B,A01,091572,Staff,0,4,60,60
1650473444966,COGS 101C,A01,083625,Delgado; Tania,16,0,30,14
1650473450989,COGS 107A,A01,083627,Boyle; Mary E. T.,0,11,60,60
1650473457021,COGS 118A,A01,083075,Staff,0,2,60,60
1650473463044,CSE 3,A50,083646,Miranda; Gregory Joseph,20,0,38,18
1650473463044,CSE 3,A51,083647,Miranda; Gregory Joseph,36,0,37,1
1650473469075,CSE 8A,A50,083650,Miranda; Gregory Joseph,0,28,40,40
1650473475105,CSE 11,A01,083080,Cao; Yingjun,0,92,40,40
1650473481128,CSE 12,A01,083652,Staff,0,16,100,100
1650473487152,CSE 15L,A01,083654,Staff,0,1,50,50
1650473487152,CSE 15L,A02,083655,Staff,1,0,50,49
1650473493176,CSE 20,A01,083657,Staff,51,0,80,29
1650473499198,CSE 30,A01,083084,Eldon; John,0,76,40,40
1650473505223,CSE 100,A01,083659,Cao; Yingjun,0,66,50,50
1650473511245,CSE 134B,A01,083661,Powell; Thomas Allan,0,32,65,65
1650473517270,CSE 140,A01,083663,Staff,0,3,75,75
1650473523294,CSE 140L,A01,083088,Eldon; John,0,8,75,75
1650473529319,CSE 175,A01,083665,Kumar; Rakesh,7,0,25,18
1650473535342,CSE 190,A00,092507,Dubnov; Shlomo,14,0,20,6
1650473541377,ECE 45,A01,083139,Staff,20,18,60,40
1650473547405,ECE 65,A50,083695,Staff,0,6,30,30
1650473553431,ECE 109,A01,091882,Touri; Behrouz,39,0,70,31
1650473559454,ECE 180,A00,083140,Abi Samra; Nicholas Camill,23,0,30,7
1650473559454,ECE 180,B00,083141,Abi Samra; Nicholas Camill,0,0,30,30
1650473565481,MATH 10A,A01,083735,Patchell; Gregory David,7,0,30,23
1650473565481,MATH 10A,A02,083736,Patchell; Gregory David,27,0,30,3
1650473565481,MATH 10A,A03,083737,Patchell; Gregory David,25,0,30,5
1650473571505,MATH 10B,A01,083207,Staff,0,8,30,30
1650473571505,MATH 10B,A02,083208,Staff,0,7,30,30
1650473571505,MATH 10B,B01,083739,Staff,13,0,30,17
1650473571505,MATH 10B,B02,083740,Staff,28,0,30,2
1650473577530,MATH 18,A01,083743,Staff,1,0,30,29
1650473577530,MATH 18,A02,083744,Staff,27,0,30,3
1650473577530,MATH 18,A03,083745,Staff,22,0,30,8
1650473577530,MATH 18,A04,083746,Staff,26,0,30,4
1650473577530,MATH 18,B01,083748,Staff,0,11,30,30
1650473577530,MATH 18,B02,083749,Staff,0,12,30,30
1650473577530,MATH 18,B03,083750,Staff,0,11,30,30
1650473577530,MATH 18,B04,083751,Staff,0,12,30,30
1650473583553,MATH 20A,A01,083754,Staff,25,0,40,15
1650473589577,MATH 20B,A01,083756,Staff,0,10,30,30
1650473589577,MATH 20B,A02,083757,Staff,0,10,30,30
1650473595605,MATH 20C,A01,083760,Staff,0,15,30,30
1650473595605,MATH 20C,A02,083761,Staff,1,15,30,29
1650473595605,MATH 20C,B01,083762,Staff,13,0,30,17
1650473595605,MATH 20C,B02,083763,Staff,28,0,30,2
1650473601632,MATH 20D,A01,083765,Staff,0,1,30,30
1650473601632,MATH 20D,A02,083766,Staff,9,0,30,21
1650473601632,MATH 20D,A03,083767,Staff,25,0,30,5
1650473607666,MATH 20E,A01,083771,Staff,6,0,30,24
1650473607666,MATH 20E,A02,083772,Staff,18,0,30,12
1650473607666,MATH 20E,B01,083773,Staff,0,0,30,30
1650473607666,MATH 20E,B02,083774,Staff,10,0,30,20
1650473613689,MATH 103A,A01,083777,Staff,0,12,30,30
1650473613689,MATH 103A,A02,083778,Staff,0,12,30,30
1650473613689,MATH 103A,B01,083779,Staff,0,13,30,30
1650473613689,MATH 103A,B02,083780,Staff,0,12,30,30
1650473619715,MATH 105,A01,085443,Staff,0,23,30,30
1650473625737,MATH 109,A01,083213,Anzaldo; Leesa B,0,7,30,30
1650473625737,MATH 109,A02,083214,Anzaldo; Leesa B,0,7,30,30
1650473625737,MATH 109,B01,083215,Anzaldo; Leesa B,0,5,30,30
1650473625737,MATH 109,B02,083216,Anzaldo; Leesa B,0,6,30,30
1650473631764,MATH 142A,A01,083219,Chow; Bennett,0,14,30,30
1650473631764,MATH 142A,A02,083220,Chow; Bennett,0,13,30,30
1650473631764,MATH 142A,B01,083221,Chow; Bennett,0,12,30,30
1650473631764,MATH 142A,B02,083222,Chow; Bennett,0,13,30,30
1650473637801,MATH 193A,A01,083224,Staff,0,5,30,30
1650473637801,MATH 193A,A02,083225,Staff,0,5,30,30
1650473637801,MATH 193A,A03,083781,Staff,0,4,30,30
1650473637801,MATH 193A,A04,083782,Staff,0,6,30,30
1650473643826,MATH 197,001,091859,McAuley; Julian John,9998,0,9999,1
1650473649882,COGS 9,A01,083615,Staff,0,14,60,60
1650473655926,COGS 11,A01,083617,Boyle; Mary E. T.,21,0,40,19
1650473661951,COGS 13,A01,083071,Staff,0,34,40,40
1650473667985,COGS 14A,A01,092681,Staff,1,25,100,99
1650473674021,COGS 14B,A01,083073,Cheng; Tzu-Han,0,11,50,50
1650473680047,COGS 17,A01,092677,Staff,22,0,75,53
1650473686077,COGS 100,A01,083619,Staff,0,26,60,60
1650473692104,COGS 101A,A01,083621,Davis; Joshua Daniel,0,21,60,60
1650473698136,COGS 101B,A01,091572,Staff,0,4,60,60
1650473704160,COGS 101C,A01,083625,Delgado; Tania,16,0,30,14
1650473710183,COGS 107A,A01,083627,Boyle; Mary E. T.,0,11,60,60
1650473716207,COGS 118A,A01,083075,Staff,0,2,60,60
1650473722231,CSE 3,A50,083646,Miranda; Gregory Joseph,20,0,38,18
1650473722231,CSE 3,A51,083647,Miranda; Gregory Joseph,36,0,37,1
1650473728255,CSE 8A,A50,083650,Miranda; Gregory Joseph,0,28,40,40
1650473734282,CSE 11,A01,083080,Cao; Yingjun,0,92,40,40
1650473740306,CSE 12,A01,083652,Staff,0,16,100,100
1650473746330,CSE 15L,A01,083654,Staff,0,1,50,50
1650473746330,CSE 15L,A02,083655,Staff,1,0,50,49
1650473752382,CSE 20,A01,083657,Staff,51,0,80,29
1650473758406,CSE 30,A01,083084,Eldon; John,0,76,40,40
1650473764433,CSE 100,A01,083659,Cao; Yingjun,0,66,50,50
1650473770457,CSE 134B,A01,083661,Powell; Thomas Allan,0,32,65,65
1650473776480,CSE 140,A01,083663,Staff,0,3,75,75
1650473782506,CSE 140L,A01,083088,Eldon; John,0,8,75,75
1650473788527,CSE 175,A01,083665,Kumar; Rakesh,7,0,25,18
1650473794551,CSE 190,A00,092507,Dubnov; Shlomo,14,0,20,6
1650473800575,ECE 45,A01,083139,Staff,20,18,60,40
1650473806599,ECE 65,A50,083695,Staff,0,6,30,30
1650473812630,ECE 109,A01,091882,Touri; Behrouz,39,0,70,31
1650473818662,ECE 180,A00,083140,Abi Samra; Nicholas Camill,23,0,30,7
1650473818662,ECE 180,B00,083141,Abi Samra; Nicholas Camill,0,0,30,30
1650473824689,MATH 10A,A01,083735,Patchell; Gregory David,7,0,30,23
1650473824689,MATH 10A,A02,083736,Patchell; Gregory David,27,0,30,3
1650473824689,MATH 10A,A03,083737,Patchell; Gregory David,25,0,30,5
1650473830734,MATH 10B,A01,083207,Staff,0,8,30,30
1650473830734,MATH 10B,A02,083208,Staff,0,7,30,30
1650473830734,MATH 10B,B01,083739,Staff,13,0,30,17
1650473830734,MATH 10B,B02,083740,Staff,28,0,30,2
1650473836759,MATH 18,A01,083743,Staff,1,0,30,29
1650473836759,MATH 18,A02,083744,Staff,27,0,30,3
1650473836759,MATH 18,A03,083745,Staff,22,0,30,8
1650473836759,MATH 18,A04,083746,Staff,26,0,30,4
1650473836759,MATH 18,B01,083748,Staff,0,11,30,30
1650473836759,MATH 18,B02,083749,Staff,0,12,30,30
1650473836759,MATH 18,B03,083750,Staff,0,11,30,30
1650473836759,MATH 18,B04,083751,Staff,0,12,30,30
1650473842785,MATH 20A,A01,083754,Staff,25,0,40,15
1650473848809,MATH 20B,A01,083756,Staff,0,10,30,30
1650473848809,MATH 20B,A02,083757,Staff,0,10,30,30
1650473854831,MATH 20C,A01,083760,Staff,0,15,30,30
1650473854831,MATH 20C,A02,083761,Staff,1,15,30,29
1650473854831,MATH 20C,B01,083762,Staff,13,0,30,17
1650473854831,MATH 20C,B02,083763,Staff,28,0,30,2
1650473860863,MATH 20D,A01,083765,Staff,0,1,30,30
1650473860863,MATH 20D,A02,083766,Staff,9,0,30,21
1650473860863,MATH 20D,A03,083767,Staff,25,0,30,5
1650473866890,MATH 20E,A01,083771,Staff,6,0,30,24
1650473866890,MATH 20E,A02,083772,Staff,18,0,30,12
1650473866890,MATH 20E,B01,083773,Staff,0,0,30,30
1650473866890,MATH 20E,B02,083774,Staff,10,0,30,20
1650473872922,MATH 103A,A01,083777,Staff,0,12,30,30
1650473872922,MATH 103A,A02,083778,Staff,0,12,30,30
1650473872922,MATH 103A,B01,083779,Staff,0,13,30,30
1650473872922,MATH 103A,B02,083780,Staff,0,12,30,30
1650473878955,MATH 105,A01,085443,Staff,0,23,30,30
1650473884987,MATH 109,A01,083213,Anzaldo; Leesa B,0,7,30,30
1650473884987,MATH 109,A02,083214,Anzaldo; Leesa B,0,7,30,30
1650473884987,MATH 109,B01,083215,Anzaldo; Leesa B,0,5,30,30
1650473884987,MATH 109,B02,083216,Anzaldo; Leesa B,0,6,30,30
1650473891016,MATH 142A,A01,083219,Chow; Bennett,0,14,30,30
1650473891016,MATH 142A,A02,083220,Chow; Bennett,0,13,30,30
1650473891016,MATH 142A,B01,083221,Chow; Bennett,0,12,30,30
1650473891016,MATH 142A,B02,083222,Chow; Bennett,0,13,30,30
1650473897046,MATH 193A,A01,083224,Staff,0,5,30,30
1650473897046,MATH 193A,A02,083225,Staff,0,5,30,30
1650473897046,MATH 193A,A03,083781,Staff,0,4,30,30
1650473897046,MATH 193A,A04,083782,Staff,0,6,30,30
1650473903180,MATH 197,001,091859,McAuley; Julian John,9998,0,9999,1
1650473909250,COGS 9,A01,083615,Staff,0,14,60,60
1650473915275,COGS 11,A01,083617,Boyle; Mary E. T.,21,0,40,19
1650473921312,COGS 13,A01,083071,Staff,0,34,40,40
1650473927335,COGS 14A,A01,092681,Staff,1,25,100,99
1650473933363,COGS 14B,A01,083073,Cheng; Tzu-Han,0,11,50,50
1650473939384,COGS 17,A01,092677,Staff,22,0,75,53
1650473945408,COGS 100,A01,083619,Staff,0,26,60,60
1650473951431,COGS 101A,A01,083621,Davis; Joshua Daniel,0,21,60,60
1650473957455,COGS 101B,A01,091572,Staff,0,4,60,60
1650473963483,COGS 101C,A01,083625,Delgado; Tania,16,0,30,14
1650473969507,COGS 107A,A01,083627,Boyle; Mary E. T.,0,11,60,60
1650473975530,COGS 118A,A01,083075,Staff,0,2,60,60
1650473981557,CSE 3,A50,083646,Miranda; Gregory Joseph,20,0,38,18
1650473981557,CSE 3,A51,083647,Miranda; Gregory Joseph,36,0,37,1
1650473987585,CSE 8A,A50,083650,Miranda; Gregory Joseph,0,28,40,40
1650473993610,CSE 11,A01,083080,Cao; Yingjun,0,92,40,40
1650473999632,CSE 12,A01,083652,Staff,0,16,100,100
1650474005654,CSE 15L,A01,083654,Staff,0,1,50,50
1650474005654,CSE 15L,A02,083655,Staff,1,0,50,49
1650474011680,CSE 20,A01,083657,Staff,51,0,80,29
1650474017705,CSE 30,A01,083084,Eldon; John,0,76,40,40
1650474023733,CSE 100,A01,083659,Cao; Yingjun,0,66,50,50
1650474029754,CSE 134B,A01,083661,Powell; Thomas Allan,0,32,65,65
1650474035788,CSE 140,A01,083663,Staff,0,3,75,75
1650474041820,CSE 140L,A01,083088,Eldon; John,0,8,75,75
1650474047846,CSE 175,A01,083665,Kumar; Rakesh,7,0,25,18
1650474053871,CSE 190,A00,092507,Dubnov; Shlomo,14,0,20,6
1650474059898,ECE 45,A01,083139,Staff,20,18,60,40
1650474065925,ECE 65,A50,083695,Staff,0,6,30,30
1650474071948,ECE 109,A01,091882,Touri; Behrouz,39,0,70,31
1650474077974,ECE 180,A00,083140,Abi Samra; Nicholas Camill,23,0,30,7
1650474077974,ECE 180,B00,083141,Abi Samra; Nicholas Camill,0,0,30,30
1650474084005,MATH 10A,A01,083735,Patchell; Gregory David,7,0,30,23
1650474084005,MATH 10A,A02,083736,Patchell; Gregory David,27,0,30,3
1650474084005,MATH 10A,A03,083737,Patchell; Gregory David,25,0,30,5
1650474090036,MATH 10B,A01,083207,Staff,0,8,30,30
1650474090036,MATH 10B,A02,083208,Staff,0,7,30,30
1650474090036,MATH 10B,B01,083739,Staff,13,0,30,17
1650474090036,MATH 10B,B02,083740,Staff,28,0,30,2
1650474096061,MATH 18,A01,083743,Staff,1,0,30,29
1650474096061,MATH 18,A02,083744,Staff,27,0,30,3
1650474096061,MATH 18,A03,083745,Staff,22,0,30,8
1650474096061,MATH 18,A04,083746,Staff,26,0,30,4
1650474096061,MATH 18,B01,083748,Staff,0,11,30,30
1650474096061,MATH 18,B02,083749,Staff,0,12,30,30
1650474096061,MATH 18,B03,083750,Staff,0,11,30,30
1650474096061,MATH 18,B04,083751,Staff,0,12,30,30
1650474102086,MATH 20A,A01,083754,Staff,25,0,40,15
1650474108110,MATH 20B,A01,083756,Staff,0,10,30,30
1650474108110,MATH 20B,A02,083757,Staff,0,10,30,30
1650474114134,MATH 20C,A01,083760,Staff,0,15,30,30
1650474114134,MATH 20C,A02,083761,Staff,1,15,30,29
1650474114134,MATH 20C,B01,083762,Staff,13,0,30,17
1650474114134,MATH 20C,B02,083763,Staff,28,0,30,2
1650474120163,MATH 20D,A01,083765,Staff,0,1,30,30
1650474120163,MATH 20D,A02,083766,Staff,9,0,30,21
1650474120163,MATH 20D,A03,083767,Staff,25,0,30,5
1650474126199,MATH 20E,A01,083771,Staff,6,0,30,24
1650474126199,MATH 20E,A02,083772,Staff,18,0,30,12
1650474126199,MATH 20E,B01,083773,Staff,0,0,30,30
1650474126199,MATH 20E,B02,083774,Staff,10,0,30,20
1650474132223,MATH 103A,A01,083777,Staff,0,12,30,30
1650474132223,MATH 103A,A02,083778,Staff,0,12,30,30
1650474132223,MATH 103A,B01,083779,Staff,0,13,30,30
1650474132223,MATH 103A,B02,083780,Staff,0,12,30,30
1650474138247,MATH 105,A01,085443,Staff,0,23,30,30
1650474144268,MATH 109,A01,083213,Anzaldo; Leesa B,0,7,30,30
1650474144268,MATH 109,A02,083214,Anzaldo; Leesa B,0,7,30,30
1650474144268,MATH 109,B01,083215,Anzaldo; Leesa B,0,5,30,30
1650474144268,MATH 109,B02,083216,Anzaldo; Leesa B,0,6,30,30
1650474150292,MATH 142A,A01,083219,Chow; Bennett,0,14,30,30
1650474150292,MATH 142A,A02,083220,Chow; Bennett,0,13,30,30
1650474150292,MATH 142A,B01,083221,Chow; Bennett,0,12,30,30
1650474150292,MATH 142A,B02,083222,Chow; Bennett,0,13,30,30
1650474156337,MATH 193A,A01,083224,Staff,0,5,30,30
1650474156337,MATH 193A,A02,083225,Staff,0,5,30,30
1650474156337,MATH 193A,A03,083781,Staff,0,4,30,30
1650474156337,MATH 193A,A04,083782,Staff,0,6,30,30
1650474162362,MATH 197,001,091859,McAuley; Julian John,9998,0,9999,1
1650474168427,COGS 9,A01,083615,Staff,0,14,60,60
1650474174451,COGS 11,A01,083617,Boyle; Mary E. T.,21,0,40,19
1650474180477,COGS 13,A01,083071,Staff,0,34,40,40
1650474186504,COGS 14A,A01,092681,Staff,1,25,100,99
1650474192529,COGS 14B,A01,083073,Cheng; Tzu-Han,0,11,50,50
1650474198550,COGS 17,A01,092677,Staff,22,0,75,53
1650474204576,COGS 100,A01,083619,Staff,0,26,60,60
1650474210610,COGS 101A,A01,083621,Davis; Joshua Daniel,0,21,60,60
1650474216636,COGS 101B,A01,091572,Staff,0,4,60,60
1650474222664,COGS 101C,A01,083625,Delgado; Tania,16,0,30,14
1650474228687,COGS 107A,A01,083627,Boyle; Mary E. T.,0,11,60,60
1650474234715,COGS 118A,A01,083075,Staff,0,2,60,60
1650474240739,CSE 3,A50,083646,Miranda; Gregory Joseph,20,0,38,18
1650474240739,CSE 3,A51,083647,Miranda; Gregory Joseph,36,0,37,1
1650474246786,CSE 8A,A50,083650,Miranda; Gregory Joseph,0,28,40,40
1650474252820,CSE 11,A01,083080,Cao; Yingjun,0,92,40,40
1650474258852,CSE 12,A01,083652,Staff,0,16,100,100
1650474264882,CSE 15L,A01,083654,Staff,0,1,50,50
1650474264882,CSE 15L,A02,083655,Staff,1,0,50,49
1650474270906,CSE 20,A01,083657,Staff,51,0,80,29
1650474276935,CSE 30,A01,083084,Eldon; John,0,76,40,40
1650474282962,CSE 100,A01,083659,Cao; Yingjun,0,66,50,50
1650474288986,CSE 134B,A01,083661,Powell; Thomas Allan,0,32,65,65
1650474295023,CSE 140,A01,083663,Staff,0,4,75,75
1650474301046,CSE 140L,A01,083088,Eldon; John,0,9,75,75
1650474307072,CSE 175,A01,083665,Kumar; Rakesh,7,0,25,18
1650474313095,CSE 190,A00,092507,Dubnov; Shlomo,14,0,20,6
1650474319121,ECE 45,A01,083139,Staff,20,18,60,40
1650474325144,ECE 65,A50,083695,Staff,0,6,30,30
1650474331166,ECE 109,A01,091882,Touri; Behrouz,39,0,70,31
1650474337192,ECE 180,A00,083140,Abi Samra; Nicholas Camill,23,0,30,7
1650474337192,ECE 180,B00,083141,Abi Samra; Nicholas Camill,0,0,30,30
1650474343222,MATH 10A,A01,083735,Patchell; Gregory David,7,0,30,23
1650474343222,MATH 10A,A02,083736,Patchell; Gregory David,27,0,30,3
1650474343222,MATH 10A,A03,083737,Patchell; Gregory David,25,0,30,5
1650474349250,MATH 10B,A01,083207,Staff,0,8,30,30
1650474349250,MATH 10B,A02,083208,Staff,0,7,30,30
1650474349250,MATH 10B,B01,083739,Staff,13,0,30,17
1650474349250,MATH 10B,B02,083740,Staff,28,0,30,2
1650474355275,MATH 18,A01,083743,Staff,1,0,30,29
1650474355275,MATH 18,A02,083744,Staff,27,0,30,3
1650474355275,MATH 18,A03,083745,Staff,22,0,30,8
1650474355275,MATH 18,A04,083746,Staff,26,0,30,4
1650474355275,MATH 18,B01,083748,Staff,0,11,30,30
1650474355275,MATH 18,B02,083749,Staff,0,12,30,30
1650474355275,MATH 18,B03,083750,Staff,0,11,30,30
1650474355275,MATH 18,B04,083751,Staff,0,12,30,30
1650474361301,MATH 20A,A01,083754,Staff,25,0,40,15
1650474367335,MATH 20B,A01,083756,Staff,0,10,30,30
1650474367335,MATH 20B,A02,083757,Staff,0,10,30,30
1650474373359,MATH 20C,A01,083760,Staff,0,15,30,30
1650474373359,MATH 20C,A02,083761,Staff,1,15,30,29
1650474373359,MATH 20C,B01,083762,Staff,13,0,30,17
1650474373359,MATH 20C,B02,083763,Staff,28,0,30,2
1650474379385,MATH 20D,A01,083765,Staff,0,1,30,30
1650474379385,MATH 20D,A02,083766,Staff,9,0,30,21
1650474379385,MATH 20D,A03,083767,Staff,25,0,30,5
1650474385412,MATH 20E,A01,083771,Staff,6,0,30,24
1650474385412,MATH 20E,A02,083772,Staff,18,0,30,12
1650474385412,MATH 20E,B01,083773,Staff,0,0,30,30
1650474385412,MATH 20E,B02,083774,Staff,10,0,30,20
1650474391435,MATH 103A,A01,083777,Staff,0,12,30,30
1650474391435,MATH 103A,A02,083778,Staff,0,12,30,30
1650474391435,MATH 103A,B01,083779,Staff,0,13,30,30
1650474391435,MATH 103A,B02,083780,Staff,0,12,30,30
1650474397463,MATH 105,A01,085443,Staff,0,23,30,30
1650474403487,MATH 109,A01,083213,Anzaldo; Leesa B,0,7,30,30
1650474403487,MATH 109,A02,083214,Anzaldo; Leesa B,0,7,30,30
1650474403487,MATH 109,B01,083215,Anzaldo; Leesa B,0,5,30,30
1650474403487,MATH 109,B02,083216,Anzaldo; Leesa B,0,6,30,30
1650474409515,MATH 142A,A01,083219,Chow; Bennett,0,14,30,30
1650474409515,MATH 142A,A02,083220,Chow; Bennett,0,13,30,30
1650474409515,MATH 142A,B01,083221,Chow; Bennett,0,12,30,30
1650474409515,MATH 142A,B02,083222,Chow; Bennett,0,13,30,30
1650474415538,MATH 193A,A01,083224,Staff,0,5,30,30
1650474415538,MATH 193A,A02,083225,Staff,0,5,30,30
1650474415538,MATH 193A,A03,083781,Staff,0,4,30,30
1650474415538,MATH 193A,A04,083782,Staff,0,6,30,30
1650474421569,MATH 197,001,091859,McAuley; Julian John,9998,0,9999,1
1650474427628,COGS 9,A01,083615,Staff,0,14,60,60
1650474433651,COGS 11,A01,083617,Boyle; Mary E. T.,21,0,40,19
1650474439678,COGS 13,A01,083071,Staff,0,34,40,40
1650474445700,COGS 14A,A01,092681,Staff,1,25,100,99
1650474451724,COGS 14B,A01,083073,Cheng; Tzu-Han,0,11,50,50
1650474457762,COGS 17,A01,092677,Staff,22,0,75,53
1650474463785,COGS 100,A01,083619,Staff,0,26,60,60
1650474469813,COGS 101A,A01,083621,Davis; Joshua Daniel,0,21,60,60
1650474475839,COGS 101B,A01,091572,Staff,0,4,60,60
1650474481863,COGS 101C,A01,083625,Delgado; Tania,16,0,30,14
1650474487888,COGS 107A,A01,083627,Boyle; Mary E. T.,0,11,60,60
1650474493988,COGS 118A,A01,083075,Staff,0,2,60,60
1650474500020,CSE 3,A50,083646,Miranda; Gregory Joseph,20,0,38,18
1650474500020,CSE 3,A51,083647,Miranda; Gregory Joseph,36,0,37,1
1650474506044,CSE 8A,A50,083650,Miranda; Gregory Joseph,0,28,40,40
1650474512071,CSE 11,A01,083080,Cao; Yingjun,0,92,40,40
1650474518096,CSE 12,A01,083652,Staff,0,16,100,100
1650474524134,CSE 15L,A01,083654,Staff,0,1,50,50
1650474524134,CSE 15L,A02,083655,Staff,1,0,50,49
1650474530157,CSE 20,A01,083657,Staff,51,0,80,29
1650474536198,CSE 30,A01,083084,Eldon; John,0,76,40,40
1650474542221,CSE 100,A01,083659,Cao; Yingjun,0,66,50,50
1650474548256,CSE 134B,A01,083661,Powell; Thomas Allan,0,32,65,65
1650474554286,CSE 140,A01,083663,Staff,0,4,75,75
1650474560308,CSE 140L,A01,083088,Eldon; John,0,9,75,75
1650474566330,CSE 175,A01,083665,Kumar; Rakesh,7,0,25,18
1650474572356,CSE 190,A00,092507,Dubnov; Shlomo,14,0,20,6
1650474578383,ECE 45,A01,083139,Staff,20,18,60,40
1650474584409,ECE 65,A50,083695,Staff,0,6,30,30
1650474590438,ECE 109,A01,091882,Touri; Behrouz,39,0,70,31
1650474596465,ECE 180,A00,083140,Abi Samra; Nicholas Camill,23,0,30,7
1650474596465,ECE 180,B00,083141,Abi Samra; Nicholas Camill,0,0,30,30
1650474602489,MATH 10A,A01,083735,Patchell; Gregory David,7,0,30,23
1650474602489,MATH 10A,A02,083736,Patchell; Gregory David,27,0,30,3
1650474602489,MATH 10A,A03,083737,Patchell; Gregory David,25,0,30,5
1650474608524,MATH 10B,A01,083207,Staff,0,8,30,30
1650474608524,MATH 10B,A02,083208,Staff,0,7,30,30
1650474608524,MATH 10B,B01,083739,Staff,13,0,30,17
1650474608524,MATH 10B,B02,083740,Staff,28,0,30,2
1650474614567,MATH 18,A01,083743,Staff,1,0,30,29
1650474614567,MATH 18,A02,083744,Staff,27,0,30,3
1650474614567,MATH 18,A03,083745,Staff,22,0,30,8
1650474614567,MATH 18,A04,083746,Staff,26,0,30,4
1650474614567,MATH 18,B01,083748,Staff,0,11,30,30
1650474614567,MATH 18,B02,083749,Staff,0,12,30,30
1650474614567,MATH 18,B03,083750,Staff,0,11,30,30
1650474614567,MATH 18,B04,083751,Staff,0,12,30,30
1650474620593,MATH 20A,A01,083754,Staff,25,0,40,15
1650474626615,MATH 20B,A01,083756,Staff,0,10,30,30
1650474626615,MATH 20B,A02,083757,Staff,0,10,30,30
1650474632645,MATH 20C,A01,083760,Staff,0,15,30,30
1650474632645,MATH 20C,A02,083761,Staff,1,15,30,29
1650474632645,MATH 20C,B01,083762,Staff,13,0,30,17
1650474632645,MATH 20C,B02,083763,Staff,28,0,30,2
1650474638669,MATH 20D,A01,083765,Staff,0,1,30,30
1650474638669,MATH 20D,A02,083766,Staff,9,0,30,21
1650474638669,MATH 20D,A03,083767,Staff,25,0,30,5
1650474644692,MATH 20E,A01,083771,Staff,6,0,30,24
1650474644692,MATH 20E,A02,083772,Staff,18,0,30,12
1650474644692,MATH 20E,B01,083773,Staff,0,0,30,30
1650474644692,MATH 20E,B02,083774,Staff,10,0,30,20
1650474650720,MATH 103A,A01,083777,Staff,0,12,30,30
1650474650720,MATH 103A,A02,083778,Staff,0,12,30,30
1650474650720,MATH 103A,B01,083779,Staff,0,13,30,30
1650474650720,MATH 103A,B02,083780,Staff,0,12,30,30
1650474656750,MATH 105,A01,085443,Staff,0,23,30,30
1650474662778,MATH 109,A01,083213,Anzaldo; Leesa B,0,7,30,30
1650474662778,MATH 109,A02,083214,Anzaldo; Leesa B,0,7,30,30
1650474662778,MATH 109,B01,083215,Anzaldo; Leesa B,0,5,30,30
1650474662778,MATH 109,B02,083216,Anzaldo; Leesa B,0,6,30,30
1650474668802,MATH 142A,A01,083219,Chow; Bennett,0,15,30,30
1650474668802,MATH 142A,A02,083220,Chow; Bennett,0,13,30,30
1650474668802,MATH 142A,B01,083221,Chow; Bennett,0,12,30,30
1650474668802,MATH 142A,B02,083222,Chow; Bennett,0,13,30,30
1650474674830,MATH 193A,A01,083224,Staff,0,5,30,30
1650474674830,MATH 193A,A02,083225,Staff,0,5,30,30
1650474674830,MATH 193A,A03,083781,Staff,0,4,30,30
1650474674830,MATH 193A,A04,083782,Staff,0,6,30,30
1650474680853,MATH 197,001,091859,McAuley; Julian John,9998,0,9999,1
1650474686917,COGS 9,A01,083615,Staff,0,14,60,60
1650474692945,COGS 11,A01,083617,Boyle; Mary E. T.,21,0,40,19
1650474698968,COGS 13,A01,083071,Staff,0,34,40,40
1650474704992,COGS 14A,A01,092681,Staff,1,25,100,99
1650474711020,COGS 14B,A01,083073,Cheng; Tzu-Han,0,11,50,50
1650474717062,COGS 17,A01,092677,Staff,22,0,75,53
1650474723084,COGS 100,A01,083619,Staff,0,26,60,60
1650474729109,COGS 101A,A01,083621,Davis; Joshua Daniel,0,21,60,60
1650474735147,COGS 101B,A01,091572,Staff,0,4,60,60
1650474741170,COGS 101C,A01,083625,Delgado; Tania,16,0,30,14
1650474747197,COGS 107A,A01,083627,Boyle; Mary E. T.,0,11,60,60
1650474753230,COGS 118A,A01,083075,Staff,0,2,60,60
1650474759258,CSE 3,A50,083646,Miranda; Gregory Joseph,20,0,38,18
1650474759258,CSE 3,A51,083647,Miranda; Gregory Joseph,36,0,37,1
1650474765281,CSE 8A,A50,083650,Miranda; Gregory Joseph,0,28,40,40
1650474771305,CSE 11,A01,083080,Cao; Yingjun,0,92,40,40
1650474777327,CSE 12,A01,083652,Staff,0,16,100,100
1650474783350,CSE 15L,A01,083654,Staff,0,1,50,50
1650474783350,CSE 15L,A02,083655,Staff,1,0,50,49
1650474789375,CSE 20,A01,083657,Staff,51,0,80,29
1650474795399,CSE 30,A01,083084,Eldon; John,0,76,40,40
1650474801435,CSE 100,A01,083659,Cao; Yingjun,0,66,50,50
1650474807459,CSE 134B,A01,083661,Powell; Thomas Allan,0,32,65,65
1650474813483,CSE 140,A01,083663,Staff,0,4,75,75
1650474819508,CSE 140L,A01,083088,Eldon; John,0,9,75,75
1650474825534,CSE 175,A01,083665,Kumar; Rakesh,7,0,25,18
1650474831558,CSE 190,A00,092507,Dubnov; Shlomo,14,0,20,6
1650474837580,ECE 45,A01,083139,Staff,20,18,60,40
1650474843605,ECE 65,A50,083695,Staff,0,6,30,30
1650474849635,ECE 109,A01,091882,Touri; Behrouz,39,0,70,31
1650474855657,ECE 180,A00,083140,Abi Samra; Nicholas Camill,23,0,30,7
1650474855657,ECE 180,B00,083141,Abi Samra; Nicholas Camill,0,0,30,30
1650474861679,MATH 10A,A01,083735,Patchell; Gregory David,7,0,30,23
1650474861679,MATH 10A,A02,083736,Patchell; Gregory David,27,0,30,3
1650474861679,MATH 10A,A03,083737,Patchell; Gregory David,25,0,30,5
1650474867711,MATH 10B,A01,083207,Staff,0,8,30,30
1650474867711,MATH 10B,A02,083208,Staff,0,7,30,30
1650474867711,MATH 10B,B01,083739,Staff,13,0,30,17
1650474867711,MATH 10B,B02,083740,Staff,28,0,30,2
1650474873740,MATH 18,A01,083743,Staff,1,0,30,29
1650474873740,MATH 18,A02,083744,Staff,27,0,30,3
1650474873740,MATH 18,A03,083745,Staff,22,0,30,8
1650474873740,MATH 18,A04,083746,Staff,26,0,30,4
1650474873740,MATH 18,B01,083748,Staff,0,11,30,30
1650474873740,MATH 18,B02,083749,Staff,0,12,30,30
1650474873740,MATH 18,B03,083750,Staff,0,11,30,30
1650474873740,MATH 18,B04,083751,Staff,0,12,30,30
1650474879763,MATH 20A,A01,083754,Staff,25,0,40,15
1650474885798,MATH 20B,A01,083756,Staff,0,10,30,30
1650474885798,MATH 20B,A02,083757,Staff,0,10,30,30
1650474891820,MATH 20C,A01,083760,Staff,0,15,30,30
1650474891820,MATH 20C,A02,083761,Staff,1,15,30,29
1650474891820,MATH 20C,B01,083762,Staff,13,0,30,17
1650474891820,MATH 20C,B02,083763,Staff,28,0,30,2
1650474897845,MATH 20D,A01,083765,Staff,0,1,30,30
1650474897845,MATH 20D,A02,083766,Staff,9,0,30,21
1650474897845,MATH 20D,A03,083767,Staff,25,0,30,5
1650474903874,MATH 20E,A01,083771,Staff,6,0,30,24
1650474903874,MATH 20E,A02,083772,Staff,18,0,30,12
1650474903874,MATH 20E,B01,083773,Staff,0,0,30,30
1650474903874,MATH 20E,B02,083774,Staff,10,0,30,20
1650474909899,MATH 103A,A01,083777,Staff,0,12,30,30
1650474909899,MATH 103A,A02,083778,Staff,0,12,30,30
1650474909899,MATH 103A,B01,083779,Staff,0,13,30,30
1650474909899,MATH 103A,B02,083780,Staff,0,12,30,30
1650474915930,MATH 105,A01,085443,Staff,0,23,30,30
1650474921979,MATH 109,A01,083213,Anzaldo; Leesa B,0,7,30,30
1650474921979,MATH 109,A02,083214,Anzaldo; Leesa B,0,7,30,30
1650474921979,MATH 109,B01,083215,Anzaldo; Leesa B,0,5,30,30
1650474921979,MATH 109,B02,083216,Anzaldo; Leesa B,0,6,30,30
1650474928003,MATH 142A,A01,083219,Chow; Bennett,0,15,30,30
1650474928003,MATH 142A,A02,083220,Chow; Bennett,0,13,30,30
1650474928003,MATH 142A,B01,083221,Chow; Bennett,0,12,30,30
1650474928003,MATH 142A,B02,083222,Chow; Bennett,0,13,30,30
1650474934029,MATH 193A,A01,083224,Staff,0,5,30,30
1650474934029,MATH 193A,A02,083225,Staff,0,5,30,30
1650474934029,MATH 193A,A03,083781,Staff,0,4,30,30
1650474934029,MATH 193A,A04,083782,Staff,0,6,30,30
1650474940057,MATH 197,001,091859,McAuley; Julian John,9998,0,9999,1
1650474946123,COGS 9,A01,083615,Staff,0,14,60,60
1650474952163,COGS 11,A01,083617,Boyle; Mary E. T.,21,0,40,19
1650474958185,COGS 13,A01,083071,Staff,0,34,40,40
1650474964219,COGS 14A,A01,092681,Staff,1,25,100,99
1650474970245,COGS 14B,A01,083073,Cheng; Tzu-Han,0,11,50,50
1650474976268,COGS 17,A01,092677,Staff,22,0,75,53
1650474982292,COGS 100,A01,083619,Staff,0,26,60,60
1650474988315,COGS 101A,A01,083621,Davis; Joshua Daniel,0,21,60,60
1650474994349,COGS 101B,A01,091572,Staff,0,4,60,60
1650475000385,COGS 101C,A01,083625,Delgado; Tania,16,0,30,14
1650475006409,COGS 107A,A01,083627,Boyle; Mary E. T.,0,11,60,60
1650475012433,COGS 118A,A01,083075,Staff,0,2,60,60
1650475018459,CSE 3,A50,083646,Miranda; Gregory Joseph,20,0,38,18
1650475018459,CSE 3,A51,083647,Miranda; Gregory Joseph,36,0,37,1
1650475024488,CSE 8A,A50,083650,Miranda; Gregory Joseph,0,28,40,40
1650475030518,CSE 11,A01,083080,Cao; Yingjun,0,92,40,40
1650475036541,CSE 12,A01,083652,Staff,0,16,100,100
1650475042571,CSE 15L,A01,083654,Staff,0,1,50,50
1650475042571,CSE 15L,A02,083655,Staff,1,0,50,49
1650475048593,CSE 20,A01,083657,Staff,51,0,80,29
1650475054616,CSE 30,A01,083084,Eldon; John,0,76,40,40
1650475060643,CSE 100,A01,083659,Cao; Yingjun,0,66,50,50
1650475066666,CSE 134B,A01,083661,Powell; Thomas Allan,0,32,65,65
1650475072715,CSE 140,A01,083663,Staff,0,4,75,75
1650475078749,CSE 140L,A01,083088,Eldon; John,0,9,75,75
1650475084785,CSE 175,A01,083665,Kumar; Rakesh,7,0,25,18
1650475090892,CSE 190,A00,092507,Dubnov; Shlomo,14,0,20,6
1650475096920,ECE 45,A01,083139,Staff,20,18,60,40
1650475102943,ECE 65,A50,083695,Staff,0,6,30,30
1650475108967,ECE 109,A01,091882,Touri; Behrouz,39,0,70,31
1650475114994,ECE 180,A00,083140,Abi Samra; Nicholas Camill,23,0,30,7
1650475114994,ECE 180,B00,083141,Abi Samra; Nicholas Camill,0,0,30,30
1650475121021,MATH 10A,A01,083735,Patchell; Gregory David,7,0,30,23
1650475121021,MATH 10A,A02,083736,Patchell; Gregory David,27,0,30,3
1650475121021,MATH 10A,A03,083737,Patchell; Gregory David,25,0,30,5
1650475127047,MATH 10B,A01,083207,Staff,0,8,30,30
1650475127047,MATH 10B,A02,083208,Staff,0,7,30,30
1650475127047,MATH 10B,B01,083739,Staff,13,0,30,17
1650475127047,MATH 10B,B02,083740,Staff,28,0,30,2
1650475133078,MATH 18,A01,083743,Staff,1,0,30,29
1650475133078,MATH 18,A02,083744,Staff,27,0,30,3
1650475133078,MATH 18,A03,083745,Staff,22,0,30,8
1650475133078,MATH 18,A04,083746,Staff,26,0,30,4
1650475133078,MATH 18,B01,083748,Staff,0,11,30,30
1650475133078,MATH 18,B02,083749,Staff,0,12,30,30
1650475133078,MATH 18,B03,083750,Staff,0,11,30,30
1650475133078,MATH 18,B04,083751,Staff,0,12,30,30
1650475139116,MATH 20A,A01,083754,Staff,25,0,40,15
1650475145144,MATH 20B,A01,083756,Staff,0,10,30,30
1650475145144,MATH 20B,A02,083757,Staff,0,10,30,30
1650475151171,MATH 20C,A01,083760,Staff,0,15,30,30
1650475151171,MATH 20C,A02,083761,Staff,1,15,30,29
1650475151171,MATH 20C,B01,083762,Staff,13,0,30,17
1650475151171,MATH 20C,B02,083763,Staff,28,0,30,2
1650475157197,MATH 20D,A01,083765,Staff,0,1,30,30
1650475157197,MATH 20D,A02,083766,Staff,9,0,30,21
1650475157197,MATH 20D,A03,083767,Staff,25,0,30,5
1650475163223,MATH 20E,A01,083771,Staff,6,0,30,24
1650475163223,MATH 20E,A02,083772,Staff,18,0,30,12
1650475163223,MATH 20E,B01,083773,Staff,0,0,30,30
1650475163223,MATH 20E,B02,083774,Staff,10,0,30,20
1650475169247,MATH 103A,A01,083777,Staff,0,12,30,30
1650475169247,MATH 103A,A02,083778,Staff,0,12,30,30
1650475169247,MATH 103A,B01,083779,Staff,0,13,30,30
1650475169247,MATH 103A,B02,083780,Staff,0,12,30,30
1650475175271,MATH 105,A01,085443,Staff,0,23,30,30
1650475181298,MATH 109,A01,083213,Anzaldo; Leesa B,0,7,30,30
1650475181298,MATH 109,A02,083214,Anzaldo; Leesa B,0,7,30,30
1650475181298,MATH 109,B01,083215,Anzaldo; Leesa B,0,5,30,30
1650475181298,MATH 109,B02,083216,Anzaldo; Leesa B,0,6,30,30
1650475187322,MATH 142A,A01,083219,Chow; Bennett,0,15,30,30
1650475187322,MATH 142A,A02,083220,Chow; Bennett,0,13,30,30
1650475187322,MATH 142A,B01,083221,Chow; Bennett,0,12,30,30
1650475187322,MATH 142A,B02,083222,Chow; Bennett,0,13,30,30
1650475193360,MATH 193A,A01,083224,Staff,0,5,30,30
1650475193360,MATH 193A,A02,083225,Staff,0,5,30,30
1650475193360,MATH 193A,A03,083781,Staff,0,4,30,30
1650475193360,MATH 193A,A04,083782,Staff,0,6,30,30
1650475199383,MATH 197,001,091859,McAuley; Julian John,9998,0,9999,1
1650475205443,COGS 9,A01,083615,Staff,0,14,60,60
1650475211466,COGS 11,A01,083617,Boyle; Mary E. T.,21,0,40,19
1650475217489,COGS 13,A01,083071,Staff,0,34,40,40
1650475223512,COGS 14A,A01,092681,Staff,1,25,100,99
1650475229536,COGS 14B,A01,083073,Cheng; Tzu-Han,0,11,50,50
1650475235584,COGS 17,A01,092677,Staff,22,0,75,53
1650475241608,COGS 100,A01,083619,Staff,0,26,60,60
1650475247637,COGS 101A,A01,083621,Davis; Joshua Daniel,0,21,60,60
1650475253665,COGS 101B,A01,091572,Staff,0,4,60,60
1650475259692,COGS 101C,A01,083625,Delgado; Tania,16,0,30,14
1650475265727,COGS 107A,A01,083627,Boyle; Mary E. T.,0,11,60,60
1650475271762,COGS 118A,A01,083075,Staff,0,2,60,60
1650475277787,CSE 3,A50,083646,Miranda; Gregory Joseph,20,0,38,18
1650475277787,CSE 3,A51,083647,Miranda; Gregory Joseph,36,0,37,1
1650475283812,CSE 8A,A50,083650,Miranda; Gregory Joseph,0,28,40,40
1650475289835,CSE 11,A01,083080,Cao; Yingjun,0,92,40,40
1650475295871,CSE 12,A01,083652,Staff,0,16,100,100
1650475301897,CSE 15L,A01,083654,Staff,0,1,50,50
1650475301897,CSE 15L,A02,083655,Staff,1,0,50,49
1650475307920,CSE 20,A01,083657,Staff,51,0,80,29
1650475313958,CSE 30,A01,083084,Eldon; John,0,76,40,40
1650475319984,CSE 100,A01,083659,Cao; Yingjun,0,66,50,50
1650475326014,CSE 134B,A01,083661,Powell; Thomas Allan,0,32,65,65
1650475332039,CSE 140,A01,083663,Staff,0,4,75,75
1650475338064,CSE 140L,A01,083088,Eldon; John,0,9,75,75
1650475344094,CSE 175,A01,083665,Kumar; Rakesh,7,0,25,18
1650475350118,CSE 190,A00,092507,Dubnov; Shlomo,14,0,20,6
1650475356148,ECE 45,A01,083139,Staff,20,18,60,40
1650475362174,ECE 65,A50,083695,Staff,0,6,30,30
1650475368205,ECE 109,A01,091882,Touri; Behrouz,39,0,70,31
1650475374231,ECE 180,A00,083140,Abi Samra; Nicholas Camill,23,0,30,7
1650475374231,ECE 180,B00,083141,Abi Samra; Nicholas Camill,0,0,30,30
1650475380255,MATH 10A,A01,083735,Patchell; Gregory David,7,0,30,23
1650475380255,MATH 10A,A02,083736,Patchell; Gregory David,27,0,30,3
1650475380255,MATH 10A,A03,083737,Patchell; Gregory David,25,0,30,5
1650475386281,MATH 10B,A01,083207,Staff,0,8,30,30
1650475386281,MATH 10B,A02,083208,Staff,0,7,30,30
1650475386281,MATH 10B,B01,083739,Staff,13,0,30,17
1650475386281,MATH 10B,B02,083740,Staff,28,0,30,2
1650475392313,MATH 18,A01,083743,Staff,1,0,30,29
1650475392313,MATH 18,A02,083744,Staff,27,0,30,3
1650475392313,MATH 18,A03,083745,Staff,22,0,30,8
1650475392313,MATH 18,A04,083746,Staff,26,0,30,4
1650475392313,MATH 18,B01,083748,Staff,0,11,30,30
1650475392313,MATH 18,B02,083749,Staff,0,12,30,30
1650475392313,MATH 18,B03,083750,Staff,0,11,30,30
1650475392313,MATH 18,B04,083751,Staff,0,12,30,30
1650475398339,MATH 20A,A01,083754,Staff,25,0,40,15
1650475404383,MATH 20B,A01,083756,Staff,0,10,30,30
1650475404383,MATH 20B,A02,083757,Staff,0,10,30,30
1650475410420,MATH 20C,A01,083760,Staff,0,15,30,30
1650475410420,MATH 20C,A02,083761,Staff,1,15,30,29
1650475410420,MATH 20C,B01,083762,Staff,13,0,30,17
1650475410420,MATH 20C,B02,083763,Staff,28,0,30,2
1650475416441,MATH 20D,A01,083765,Staff,0,1,30,30
1650475416441,MATH 20D,A02,083766,Staff,9,0,30,21
1650475416441,MATH 20D,A03,083767,Staff,25,0,30,5
1650475422465,MATH 20E,A01,083771,Staff,6,0,30,24
1650475422465,MATH 20E,A02,083772,Staff,18,0,30,12
1650475422465,MATH 20E,B01,083773,Staff,0,0,30,30
1650475422465,MATH 20E,B02,083774,Staff,10,0,30,20
1650475428491,MATH 103A,A01,083777,Staff,0,12,30,30
1650475428491,MATH 103A,A02,083778,Staff,0,12,30,30
1650475428491,MATH 103A,B01,083779,Staff,0,13,30,30
1650475428491,MATH 103A,B02,083780,Staff,0,12,30,30
1650475434516,MATH 105,A01,085443,Staff,0,23,30,30
1650475440545,MATH 109,A01,083213,Anzaldo; Leesa B,0,7,30,30
1650475440545,MATH 109,A02,083214,Anzaldo; Leesa B,0,7,30,30
1650475440545,MATH 109,B01,083215,Anzaldo; Leesa B,0,5,30,30
1650475440545,MATH 109,B02,083216,Anzaldo; Leesa B,0,6,30,30
1650475446569,MATH 142A,A01,083219,Chow; Bennett,0,15,30,30
1650475446569,MATH 142A,A02,083220,Chow; Bennett,0,13,30,30
1650475446569,MATH 142A,B01,083221,Chow; Bennett,0,12,30,30
1650475446569,MATH 142A,B02,083222,Chow; Bennett,0,13,30,30
1650475452592,MATH 193A,A01,083224,Staff,0,5,30,30
1650475452592,MATH 193A,A02,083225,Staff,0,5,30,30
1650475452592,MATH 193A,A03,083781,Staff,0,4,30,30
1650475452592,MATH 193A,A04,083782,Staff,0,6,30,30
1650475458615,MATH 197,001,091859,McAuley; Julian John,9998,0,9999,1
1650475464671,COGS 9,A01,083615,Staff,0,14,60,60
1650475470708,COGS 11,A01,083617,Boyle; Mary E. T.,21,0,40,19
1650475476738,COGS 13,A01,083071,Staff,0,34,40,40
1650475482761,COGS 14A,A01,092681,Staff,1,25,100,99
1650475488784,COGS 14B,A01,083073,Cheng; Tzu-Han,0,11,50,50
1650475494807,COGS 17,A01,092677,Staff,22,0,75,53
1650475500862,COGS 100,A01,083619,Staff,0,26,60,60
1650475506889,COGS 101A,A01,083621,Davis; Joshua Daniel,0,21,60,60
1650475512913,COGS 101B,A01,091572,Staff,0,4,60,60
1650475518943,COGS 101C,A01,083625,Delgado; Tania,16,0,30,14
1650475524975,COGS 107A,A01,083627,Boyle; Mary E. T.,0,11,60,60
1650475530999,COGS 118A,A01,083075,Staff,0,2,60,60
1650475537023,CSE 3,A50,083646,Miranda; Gregory Joseph,20,0,38,18
1650475537023,CSE 3,A51,083647,Miranda; Gregory Joseph,36,0,37,1
1650475543048,CSE 8A,A50,083650,Miranda; Gregory Joseph,0,28,40,40
1650475549081,CSE 11,A01,083080,Cao; Yingjun,0,92,40,40
1650475555104,CSE 12,A01,083652,Staff,0,16,100,100
1650475561135,CSE 15L,A01,083654,Staff,0,1,50,50
1650475561135,CSE 15L,A02,083655,Staff,1,0,50,49
1650475567158,CSE 20,A01,083657,Staff,51,0,80,29
1650475573183,CSE 30,A01,083084,Eldon; John,0,76,40,40
1650475579218,CSE 100,A01,083659,Cao; Yingjun,0,66,50,50
1650475585243,CSE 134B,A01,083661,Powell; Thomas Allan,0,32,65,65
1650475591276,CSE 140,A01,083663,Staff,0,4,75,75
1650475597319,CSE 140L,A01,083088,Eldon; John,0,9,75,75
1650475603342,CSE 175,A01,083665,Kumar; Rakesh,7,0,25,18
1650475609375,CSE 190,A00,092507,Dubnov; Shlomo,14,0,20,6
1650475615404,ECE 45,A01,083139,Staff,20,18,60,40
1650475621428,ECE 65,A50,083695,Staff,0,6,30,30
1650475627455,ECE 109,A01,091882,Touri; Behrouz,39,0,70,31
1650475633479,ECE 180,A00,083140,Abi Samra; Nicholas Camill,23,0,30,7
1650475633479,ECE 180,B00,083141,Abi Samra; Nicholas Camill,0,0,30,30
1650475639503,MATH 10A,A01,083735,Patchell; Gregory David,7,0,30,23
1650475639503,MATH 10A,A02,083736,Patchell; Gregory David,27,0,30,3
1650475639503,MATH 10A,A03,083737,Patchell; Gregory David,25,0,30,5
1650475645526,MATH 10B,A01,083207,Staff,0,8,30,30
1650475645526,MATH 10B,A02,083208,Staff,0,7,30,30
1650475645526,MATH 10B,B01,083739,Staff,13,0,30,17
1650475645526,MATH 10B,B02,083740,Staff,28,0,30,2
1650475651553,MATH 18,A01,083743,Staff,1,0,30,29
1650475651553,MATH 18,A02,083744,Staff,27,0,30,3
1650475651553,MATH 18,A03,083745,Staff,22,0,30,8
1650475651553,MATH 18,A04,083746,Staff,26,0,30,4
1650475651553,MATH 18,B01,083748,Staff,0,11,30,30
1650475651553,MATH 18,B02,083749,Staff,0,12,30,30
1650475651553,MATH 18,B03,083750,Staff,0,11,30,30
1650475651553,MATH 18,B04,083751,Staff,0,12,30,30
1650475657586,MATH 20A,A01,083754,Staff,25,0,40,15
1650475663609,MATH 20B,A01,083756,Staff,0,10,30,30
1650475663609,MATH 20B,A02,083757,Staff,0,10,30,30
1650475669639,MATH 20C,A01,083760,Staff,0,15,30,30
1650475669639,MATH 20C,A02,083761,Staff,1,15,30,29
1650475669639,MATH 20C,B01,083762,Staff,13,0,30,17
1650475669639,MATH 20C,B02,083763,Staff,28,0,30,2
1650475675663,MATH 20D,A01,083765,Staff,0,1,30,30
1650475675663,MATH 20D,A02,083766,Staff,9,0,30,21
1650475675663,MATH 20D,A03,083767,Staff,25,0,30,5
1650475681687,MATH 20E,A01,083771,Staff,6,0,30,24
1650475681687,MATH 20E,A02,083772,Staff,18,0,30,12
1650475681687,MATH 20E,B01,083773,Staff,0,0,30,30
1650475681687,MATH 20E,B02,083774,Staff,10,0,30,20
1650475687790,MATH 103A,A01,083777,Staff,0,12,30,30
1650475687790,MATH 103A,A02,083778,Staff,0,12,30,30
1650475687790,MATH 103A,B01,083779,Staff,0,13,30,30
1650475687790,MATH 103A,B02,083780,Staff,0,12,30,30
1650475693819,MATH 105,A01,085443,Staff,0,23,30,30
1650475699854,MATH 109,A01,083213,Anzaldo; Leesa B,0,7,30,30
1650475699854,MATH 109,A02,083214,Anzaldo; Leesa B,0,7,30,30
1650475699854,MATH 109,B01,083215,Anzaldo; Leesa B,0,5,30,30
1650475699854,MATH 109,B02,083216,Anzaldo; Leesa B,0,6,30,30
1650475705883,MATH 142A,A01,083219,Chow; Bennett,0,15,30,30
1650475705883,MATH 142A,A02,083220,Chow; Bennett,0,13,30,30
1650475705883,MATH 142A,B01,083221,Chow; Bennett,0,12,30,30
1650475705883,MATH 142A,B02,083222,Chow; Bennett,0,13,30,30
1650475711911,MATH 193A,A01,083224,Staff,0,5,30,30
1650475711911,MATH 193A,A02,083225,Staff,0,5,30,30
1650475711911,MATH 193A,A03,083781,Staff,0,4,30,30
1650475711911,MATH 193A,A04,083782,Staff,0,6,30,30
1650475717938,MATH 197,001,091859,McAuley; Julian John,9998,0,9999,1
1650475723997,COGS 9,A01,083615,Staff,0,14,60,60
1650475730022,COGS 11,A01,083617,Boyle; Mary E. T.,21,0,40,19
1650475736044,COGS 13,A01,083071,Staff,0,34,40,40
1650475742067,COGS 14A,A01,092681,Staff,1,25,100,99
1650475748095,COGS 14B,A01,083073,Cheng; Tzu-Han,0,11,50,50
1650475754122,COGS 17,A01,092677,Staff,22,0,75,53
1650475760157,COGS 100,A01,083619,Staff,0,26,60,60
1650475766192,COGS 101A,A01,083621,Davis; Joshua Daniel,0,21,60,60
1650475772218,COGS 101B,A01,091572,Staff,0,4,60,60
1650475778242,COGS 101C,A01,083625,Delgado; Tania,16,0,30,14
1650475784274,COGS 107A,A01,083627,Boyle; Mary E. T.,0,11,60,60
1650475790297,COGS 118A,A01,083075,Staff,0,3,60,60
1650475796329,CSE 3,A50,083646,Miranda; Gregory Joseph,20,0,38,18
1650475796329,CSE 3,A51,083647,Miranda; Gregory Joseph,36,0,37,1
1650475802373,CSE 8A,A50,083650,Miranda; Gregory Joseph,0,28,40,40
1650475808402,CSE 11,A01,083080,Cao; Yingjun,0,92,40,40
1650475814440,CSE 12,A01,083652,Staff,0,16,100,100
1650475820463,CSE 15L,A01,083654,Staff,0,1,50,50
1650475820463,CSE 15L,A02,083655,Staff,1,0,50,49
1650475826485,CSE 20,A01,083657,Staff,51,0,80,29
1650475832516,CSE 30,A01,083084,Eldon; John,0,76,40,40
1650475838538,CSE 100,A01,083659,Cao; Yingjun,0,66,50,50
1650475844563,CSE 134B,A01,083661,Powell; Thomas Allan,0,32,65,65
1650475850586,CSE 140,A01,083663,Staff,0,4,75,75
1650475856617,CSE 140L,A01,083088,Eldon; John,0,9,75,75
1650475862641,CSE 175,A01,083665,Kumar; Rakesh,7,0,25,18
1650475868664,CSE 190,A00,092507,Dubnov; Shlomo,14,0,20,6
1650475874691,ECE 45,A01,083139,Staff,20,18,60,40
1650475880716,ECE 65,A50,083695,Staff,0,6,30,30
1650475886741,ECE 109,A01,091882,Touri; Behrouz,39,0,70,31
1650475892773,ECE 180,A00,083140,Abi Samra; Nicholas Camill,23,0,30,7
1650475892773,ECE 180,B00,083141,Abi Samra; Nicholas Camill,0,0,30,30
1650475898800,MATH 10A,A01,083735,Patchell; Gregory David,7,0,30,23
1650475898800,MATH 10A,A02,083736,Patchell; Gregory David,27,0,30,3
1650475898800,MATH 10A,A03,083737,Patchell; Gregory David,25,0,30,5
1650475904826,MATH 10B,A01,083207,Staff,0,8,30,30
1650475904826,MATH 10B,A02,083208,Staff,0,7,30,30
1650475904826,MATH 10B,B01,083739,Staff,13,0,30,17
1650475904826,MATH 10B,B02,083740,Staff,28,0,30,2
1650475910874,MATH 18,A01,083743,Staff,1,0,30,29
1650475910874,MATH 18,A02,083744,Staff,27,0,30,3
1650475910874,MATH 18,A03,083745,Staff,22,0,30,8
1650475910874,MATH 18,A04,083746,Staff,26,0,30,4
1650475910874,MATH 18,B01,083748,Staff,0,11,30,30
1650475910874,MATH 18,B02,083749,Staff,0,12,30,30
1650475910874,MATH 18,B03,083750,Staff,0,11,30,30
1650475910874,MATH 18,B04,083751,Staff,0,12,30,30
1650475916900,MATH 20A,A01,083754,Staff,25,0,40,15
1650475922925,MATH 20B,A01,083756,Staff,0,10,30,30
1650475922925,MATH 20B,A02,083757,Staff,0,10,30,30
1650475928958,MATH 20C,A01,083760,Staff,0,15,30,30
1650475928958,MATH 20C,A02,083761,Staff,1,15,30,29
1650475928958,MATH 20C,B01,083762,Staff,13,0,30,17
1650475928958,MATH 20C,B02,083763,Staff,28,0,30,2
1650475934985,MATH 20D,A01,083765,Staff,0,1,30,30
1650475934985,MATH 20D,A02,083766,Staff,9,0,30,21
1650475934985,MATH 20D,A03,083767,Staff,25,0,30,5
1650475941024,MATH 20E,A01,083771,Staff,6,0,30,24
1650475941024,MATH 20E,A02,083772,Staff,18,0,30,12
1650475941024,MATH 20E,B01,083773,Staff,0,0,30,30
1650475941024,MATH 20E,B02,083774,Staff,10,0,30,20
1650475947050,MATH 103A,A01,083777,Staff,0,12,30,30
1650475947050,MATH 103A,A02,083778,Staff,0,12,30,30
1650475947050,MATH 103A,B01,083779,Staff,0,13,30,30
1650475947050,MATH 103A,B02,083780,Staff,0,12,30,30
1650475953073,MATH 105,A01,085443,Staff,0,23,30,30
1650475959112,MATH 109,A01,083213,Anzaldo; Leesa B,0,7,30,30
1650475959112,MATH 109,A02,083214,Anzaldo; Leesa B,0,7,30,30
1650475959112,MATH 109,B01,083215,Anzaldo; Leesa B,0,5,30,30
1650475959112,MATH 109,B02,083216,Anzaldo; Leesa B,0,6,30,30
1650475965139,MATH 142A,A01,083219,Chow; Bennett,0,15,30,30
1650475965139,MATH 142A,A02,083220,Chow; Bennett,0,13,30,30
1650475965139,MATH 142A,B01,083221,Chow; Bennett,0,12,30,30
1650475965139,MATH 142A,B02,083222,Chow; Bennett,0,13,30,30
1650475971163,MATH 193A,A01,083224,Staff,0,5,30,30
1650475971163,MATH 193A,A02,083225,Staff,0,5,30,30
1650475971163,MATH 193A,A03,083781,Staff,0,4,30,30
1650475971163,MATH 193A,A04,083782,Staff,0,6,30,30
1650475977189,MATH 197,001,091859,McAuley; Julian John,9998,0,9999,1
1650475983254,COGS 9,A01,083615,Staff,0,14,60,60
1650475989281,COGS 11,A01,083617,Boyle; Mary E. T.,21,0,40,19
1650475995309,COGS 13,A01,083071,Staff,0,34,40,40
1650476001341,COGS 14A,A01,092681,Staff,1,25,100,99
1650476007368,COGS 14B,A01,083073,Cheng; Tzu-Han,0,11,50,50
1650476013397,COGS 17,A01,092677,Staff,22,0,75,53
1650476019420,COGS 100,A01,083619,Staff,0,26,60,60
1650476025444,COGS 101A,A01,083621,Davis; Joshua Daniel,0,21,60,60
1650476031469,COGS 101B,A01,091572,Staff,0,4,60,60
1650476037503,COGS 101C,A01,083625,Delgado; Tania,16,0,30,14
1650476043528,COGS 107A,A01,083627,Boyle; Mary E. T.,0,11,60,60
1650476049566,COGS 118A,A01,083075,Staff,0,3,60,60
1650476055592,CSE 3,A50,083646,Miranda; Gregory Joseph,20,0,38,18
1650476055592,CSE 3,A51,083647,Miranda; Gregory Joseph,36,0,37,1
1650476061628,CSE 8A,A50,083650,Miranda; Gregory Joseph,0,28,40,40
1650476067659,CSE 11,A01,083080,Cao; Yingjun,0,92,40,40
1650476073682,CSE 12,A01,083652,Staff,0,16,100,100
1650476079708,CSE 15L,A01,083654,Staff,0,1,50,50
1650476079708,CSE 15L,A02,083655,Staff,1,0,50,49
1650476085731,CSE 20,A01,083657,Staff,51,0,80,29
1650476091773,CSE 30,A01,083084,Eldon; John,0,76,40,40
1650476097811,CSE 100,A01,083659,Cao; Yingjun,0,66,50,50
1650476103835,CSE 134B,A01,083661,Powell; Thomas Allan,0,32,65,65
1650476109875,CSE 140,A01,083663,Staff,0,4,75,75
1650476115916,CSE 140L,A01,083088,Eldon; John,0,9,75,75
1650476121944,CSE 175,A01,083665,Kumar; Rakesh,7,0,25,18
1650476127968,CSE 190,A00,092507,Dubnov; Shlomo,14,0,20,6
1650476133991,ECE 45,A01,083139,Staff,20,18,60,40
1650476140017,ECE 65,A50,083695,Staff,0,6,30,30
1650476146043,ECE 109,A01,091882,Touri; Behrouz,39,0,70,31
1650476152069,ECE 180,A00,083140,Abi Samra; Nicholas Camill,23,0,30,7
1650476152069,ECE 180,B00,083141,Abi Samra; Nicholas Camill,0,0,30,30
1650476158095,MATH 10A,A01,083735,Patchell; Gregory David,7,0,30,23
1650476158095,MATH 10A,A02,083736,Patchell; Gregory David,27,0,30,3
1650476158095,MATH 10A,A03,083737,Patchell; Gregory David,25,0,30,5
1650476164118,MATH 10B,A01,083207,Staff,0,8,30,30
1650476164118,MATH 10B,A02,083208,Staff,0,7,30,30
1650476164118,MATH 10B,B01,083739,Staff,13,0,30,17
1650476164118,MATH 10B,B02,083740,Staff,28,0,30,2
1650476170167,MATH 18,A01,083743,Staff,1,0,30,29
1650476170167,MATH 18,A02,083744,Staff,27,0,30,3
1650476170167,MATH 18,A03,083745,Staff,22,0,30,8
1650476170167,MATH 18,A04,083746,Staff,26,0,30,4
1650476170167,MATH 18,B01,083748,Staff,0,11,30,30
1650476170167,MATH 18,B02,083749,Staff,0,12,30,30
1650476170167,MATH 18,B03,083750,Staff,0,11,30,30
1650476170167,MATH 18,B04,083751,Staff,0,12,30,30
1650476176196,MATH 20A,A01,083754,Staff,25,0,40,15
1650476182230,MATH 20B,A01,083756,Staff,0,10,30,30
1650476182230,MATH 20B,A02,083757,Staff,0,11,30,30
1650476188260,MATH 20C,A01,083760,Staff,0,15,30,30
1650476188260,MATH 20C,A02,083761,Staff,1,15,30,29
1650476188260,MATH 20C,B01,083762,Staff,13,0,30,17
1650476188260,MATH 20C,B02,083763,Staff,28,0,30,2
1650476194284,MATH 20D,A01,083765,Staff,0,1,30,30
1650476194284,MATH 20D,A02,083766,Staff,9,0,30,21
1650476194284,MATH 20D,A03,083767,Staff,25,0,30,5
1650476200310,MATH 20E,A01,083771,Staff,6,0,30,24
1650476200310,MATH 20E,A02,083772,Staff,18,0,30,12
1650476200310,MATH 20E,B01,083773,Staff,0,0,30,30
1650476200310,MATH 20E,B02,083774,Staff,10,0,30,20
1650476206339,MATH 103A,A01,083777,Staff,0,12,30,30
1650476206339,MATH 103A,A02,083778,Staff,0,12,30,30
1650476206339,MATH 103A,B01,083779,Staff,0,13,30,30
1650476206339,MATH 103A,B02,083780,Staff,0,12,30,30
1650476212367,MATH 105,A01,085443,Staff,0,23,30,30
1650476218395,MATH 109,A01,083213,Anzaldo; Leesa B,0,7,30,30
1650476218395,MATH 109,A02,083214,Anzaldo; Leesa B,0,7,30,30
1650476218395,MATH 109,B01,083215,Anzaldo; Leesa B,0,5,30,30
1650476218395,MATH 109,B02,083216,Anzaldo; Leesa B,0,6,30,30
1650476224429,MATH 142A,A01,083219,Chow; Bennett,0,15,30,30
1650476224429,MATH 142A,A02,083220,Chow; Bennett,0,13,30,30
1650476224429,MATH 142A,B01,083221,Chow; Bennett,0,12,30,30
1650476224429,MATH 142A,B02,083222,Chow; Bennett,0,13,30,30
1650476230453,MATH 193A,A01,083224,Staff,0,5,30,30
1650476230453,MATH 193A,A02,083225,Staff,0,5,30,30
1650476230453,MATH 193A,A03,083781,Staff,0,4,30,30
1650476230453,MATH 193A,A04,083782,Staff,0,6,30,30
1650476236475,MATH 197,001,091859,McAuley; Julian John,9998,0,9999,1
1650476242534,COGS 9,A01,083615,Staff,0,14,60,60
1650476248557,COGS 11,A01,083617,Boyle; Mary E. T.,21,0,40,19
1650476254580,COGS 13,A01,083071,Staff,0,34,40,40
1650476260603,COGS 14A,A01,092681,Staff,1,25,100,99
1650476266627,COGS 14B,A01,083073,Cheng; Tzu-Han,0,11,50,50
1650476272654,COGS 17,A01,092677,Staff,22,0,75,53
1650476278763,COGS 100,A01,083619,Staff,0,26,60,60
1650476284792,COGS 101A,A01,083621,Davis; Joshua Daniel,0,21,60,60
1650476290817,COGS 101B,A01,091572,Staff,0,4,60,60
1650476296845,COGS 101C,A01,083625,Delgado; Tania,16,0,30,14
1650476302869,COGS 107A,A01,083627,Boyle; Mary E. T.,0,11,60,60
1650476308893,COGS 118A,A01,083075,Staff,0,3,60,60
1650476314916,CSE 3,A50,083646,Miranda; Gregory Joseph,20,0,38,18
1650476314916,CSE 3,A51,083647,Miranda; Gregory Joseph,36,0,37,1
1650476320942,CSE 8A,A50,083650,Miranda; Gregory Joseph,0,28,40,40
1650476326969,CSE 11,A01,083080,Cao; Yingjun,0,92,40,40
1650476332991,CSE 12,A01,083652,Staff,0,16,100,100
1650476339018,CSE 15L,A01,083654,Staff,0,1,50,50
1650476339018,CSE 15L,A02,083655,Staff,1,0,50,49
1650476345043,CSE 20,A01,083657,Staff,51,0,80,29
1650476351069,CSE 30,A01,083084,Eldon; John,0,76,40,40
1650476357094,CSE 100,A01,083659,Cao; Yingjun,0,66,50,50
1650476363125,CSE 134B,A01,083661,Powell; Thomas Allan,0,32,65,65
1650476369156,CSE 140,A01,083663,Staff,0,4,75,75
1650476375183,CSE 140L,A01,083088,Eldon; John,0,9,75,75
1650476381205,CSE 175,A01,083665,Kumar; Rakesh,7,0,25,18
1650476387232,CSE 190,A00,092507,Dubnov; Shlomo,14,0,20,6
1650476393257,ECE 45,A01,083139,Staff,20,18,60,40
1650476399279,ECE 65,A50,083695,Staff,0,6,30,30
1650476405303,ECE 109,A01,091882,Touri; Behrouz,39,0,70,31
1650476411331,ECE 180,A00,083140,Abi Samra; Nicholas Camill,23,0,30,7
1650476411331,ECE 180,B00,083141,Abi Samra; Nicholas Camill,0,0,30,30
1650476417358,MATH 10A,A01,083735,Patchell; Gregory David,7,0,30,23
1650476417358,MATH 10A,A02,083736,Patchell; Gregory David,27,0,30,3
1650476417358,MATH 10A,A03,083737,Patchell; Gregory David,25,0,30,5
1650476423381,MATH 10B,A01,083207,Staff,0,8,30,30
1650476423381,MATH 10B,A02,083208,Staff,0,7,30,30
1650476423381,MATH 10B,B01,083739,Staff,13,0,30,17
1650476423381,MATH 10B,B02,083740,Staff,28,0,30,2
1650476429409,MATH 18,A01,083743,Staff,1,0,30,29
1650476429409,MATH 18,A02,083744,Staff,27,0,30,3
1650476429409,MATH 18,A03,083745,Staff,22,0,30,8
1650476429409,MATH 18,A04,083746,Staff,26,0,30,4
1650476429409,MATH 18,B01,083748,Staff,0,11,30,30
1650476429409,MATH 18,B02,083749,Staff,0,12,30,30
1650476429409,MATH 18,B03,083750,Staff,0,11,30,30
1650476429409,MATH 18,B04,083751,Staff,0,12,30,30
1650476435450,MATH 20A,A01,083754,Staff,25,0,40,15
1650476446825,MATH 20B,A01,083756,Staff,0,10,30,30
1650476446825,MATH 20B,A02,083757,Staff,0,11,30,30
1650476453372,MATH 20C,A01,083760,Staff,0,15,30,30
1650476453372,MATH 20C,A02,083761,Staff,1,15,30,29
1650476453372,MATH 20C,B01,083762,Staff,13,0,30,17
1650476453372,MATH 20C,B02,083763,Staff,28,0,30,2
1650476459397,MATH 20D,A01,083765,Staff,0,1,30,30
1650476459397,MATH 20D,A02,083766,Staff,9,0,30,21
1650476459397,MATH 20D,A03,083767,Staff,25,0,30,5
1650476465424,MATH 20E,A01,083771,Staff,6,0,30,24
1650476465424,MATH 20E,A02,083772,Staff,18,0,30,12
1650476465424,MATH 20E,B01,083773,Staff,0,0,30,30
1650476465424,MATH 20E,B02,083774,Staff,10,0,30,20
1650476471447,MATH 103A,A01,083777,Staff,0,12,30,30
1650476471447,MATH 103A,A02,083778,Staff,0,12,30,30
1650476471447,MATH 103A,B01,083779,Staff,0,13,30,30
1650476471447,MATH 103A,B02,083780,Staff,0,12,30,30
1650476477471,MATH 105,A01,085443,Staff,0,23,30,30
1650476483501,MATH 109,A01,083213,Anzaldo; Leesa B,0,7,30,30
1650476483501,MATH 109,A02,083214,Anzaldo; Leesa B,0,7,30,30
1650476483501,MATH 109,B01,083215,Anzaldo; Leesa B,0,5,30,30
1650476483501,MATH 109,B02,083216,Anzaldo; Leesa B,0,6,30,30
1650476489534,MATH 142A,A01,083219,Chow; Bennett,0,15,30,30
1650476489534,MATH 142A,A02,083220,Chow; Bennett,0,13,30,30
1650476489534,MATH 142A,B01,083221,Chow; Bennett,0,12,30,30
1650476489534,MATH 142A,B02,083222,Chow; Bennett,0,13,30,30
1650476495578,MATH 193A,A01,083224,Staff,0,5,30,30
1650476495578,MATH 193A,A02,083225,Staff,0,5,30,30
1650476495578,MATH 193A,A03,083781,Staff,0,4,30,30
1650476495578,MATH 193A,A04,083782,Staff,0,6,30,30
1650476501611,MATH 197,001,091859,McAuley; Julian John,9998,0,9999,1
1650476507663,COGS 9,A01,083615,Staff,0,14,60,60
1650476513687,COGS 11,A01,083617,Boyle; Mary E. T.,21,0,40,19
1650476519713,COGS 13,A01,083071,Staff,0,34,40,40
1650476525740,COGS 14A,A01,092681,Staff,1,25,100,99
1650476531765,COGS 14B,A01,083073,Cheng; Tzu-Han,0,11,50,50
1650476537788,COGS 17,A01,092677,Staff,22,0,75,53
1650476543816,COGS 100,A01,083619,Staff,0,26,60,60
1650476549843,COGS 101A,A01,083621,Davis; Joshua Daniel,0,21,60,60
1650476555880,COGS 101B,A01,091572,Staff,0,4,60,60
1650476561910,COGS 101C,A01,083625,Delgado; Tania,16,0,30,14
1650476567938,COGS 107A,A01,083627,Boyle; Mary E. T.,0,11,60,60
1650476573963,COGS 118A,A01,083075,Staff,0,3,60,60
1650476579991,CSE 3,A50,083646,Miranda; Gregory Joseph,20,0,38,18
1650476579991,CSE 3,A51,083647,Miranda; Gregory Joseph,36,0,37,1
1650476586018,CSE 8A,A50,083650,Miranda; Gregory Joseph,0,28,40,40
1650476592047,CSE 11,A01,083080,Cao; Yingjun,0,92,40,40
1650476598077,CSE 12,A01,083652,Staff,0,16,100,100
1650476604106,CSE 15L,A01,083654,Staff,0,1,50,50
1650476604106,CSE 15L,A02,083655,Staff,1,0,50,49
1650476610140,CSE 20,A01,083657,Staff,51,0,80,29
1650476616165,CSE 30,A01,083084,Eldon; John,0,76,40,40
1650476622196,CSE 100,A01,083659,Cao; Yingjun,0,66,50,50
1650476628223,CSE 134B,A01,083661,Powell; Thomas Allan,0,32,65,65
1650476634246,CSE 140,A01,083663,Staff,0,4,75,75
1650476640270,CSE 140L,A01,083088,Eldon; John,0,9,75,75
1650476646298,CSE 175,A01,083665,Kumar; Rakesh,7,0,25,18
1650476652328,CSE 190,A00,092507,Dubnov; Shlomo,14,0,20,6
1650476658353,ECE 45,A01,083139,Staff,20,18,60,40
1650476664388,ECE 65,A50,083695,Staff,0,6,30,30
1650476670418,ECE 109,A01,091882,Touri; Behrouz,39,0,70,31
1650476676446,ECE 180,A00,083140,Abi Samra; Nicholas Camill,23,0,30,7
1650476676446,ECE 180,B00,083141,Abi Samra; Nicholas Camill,0,0,30,30
1650476682467,MATH 10A,A01,083735,Patchell; Gregory David,7,0,30,23
1650476682467,MATH 10A,A02,083736,Patchell; Gregory David,27,0,30,3
1650476682467,MATH 10A,A03,083737,Patchell; Gregory David,25,0,30,5
1650476688494,MATH 10B,A01,083207,Staff,0,8,30,30
1650476688494,MATH 10B,A02,083208,Staff,0,7,30,30
1650476688494,MATH 10B,B01,083739,Staff,13,0,30,17
1650476688494,MATH 10B,B02,083740,Staff,28,0,30,2
1650476694522,MATH 18,A01,083743,Staff,1,0,30,29
1650476694522,MATH 18,A02,083744,Staff,27,0,30,3
1650476694522,MATH 18,A03,083745,Staff,22,0,30,8
1650476694522,MATH 18,A04,083746,Staff,26,0,30,4
1650476694522,MATH 18,B01,083748,Staff,0,11,30,30
1650476694522,MATH 18,B02,083749,Staff,0,12,30,30
1650476694522,MATH 18,B03,083750,Staff,0,11,30,30
1650476694522,MATH 18,B04,083751,Staff,0,12,30,30
1650476700554,MATH 20A,A01,083754,Staff,25,0,40,15
1650476706576,MATH 20B,A01,083756,Staff,0,10,30,30
1650476706576,MATH 20B,A02,083757,Staff,0,11,30,30
1650476712602,MATH 20C,A01,083760,Staff,0,15,30,30
1650476712602,MATH 20C,A02,083761,Staff,1,15,30,29
1650476712602,MATH 20C,B01,083762,Staff,13,0,30,17
1650476712602,MATH 20C,B02,083763,Staff,28,0,30,2
1650476718625,MATH 20D,A01,083765,Staff,0,1,30,30
1650476718625,MATH 20D,A02,083766,Staff,9,0,30,21
1650476718625,MATH 20D,A03,083767,Staff,25,0,30,5
1650476724652,MATH 20E,A01,083771,Staff,6,0,30,24
1650476724652,MATH 20E,A02,083772,Staff,18,0,30,12
1650476724652,MATH 20E,B01,083773,Staff,0,0,30,30
1650476724652,MATH 20E,B02,083774,Staff,10,0,30,20
1650476730677,MATH 103A,A01,083777,Staff,0,12,30,30
1650476730677,MATH 103A,A02,083778,Staff,0,12,30,30
1650476730677,MATH 103A,B01,083779,Staff,0,13,30,30
1650476730677,MATH 103A,B02,083780,Staff,0,12,30,30
1650476736707,MATH 105,A01,085443,Staff,0,23,30,30
1650476742736,MATH 109,A01,083213,Anzaldo; Leesa B,0,7,30,30
1650476742736,MATH 109,A02,083214,Anzaldo; Leesa B,0,7,30,30
1650476742736,MATH 109,B01,083215,Anzaldo; Leesa B,0,5,30,30
1650476742736,MATH 109,B02,083216,Anzaldo; Leesa B,0,6,30,30
1650476748760,MATH 142A,A01,083219,Chow; Bennett,0,15,30,30
1650476748760,MATH 142A,A02,083220,Chow; Bennett,0,13,30,30
1650476748760,MATH 142A,B01,083221,Chow; Bennett,0,12,30,30
1650476748760,MATH 142A,B02,083222,Chow; Bennett,0,13,30,30
1650476754786,MATH 193A,A01,083224,Staff,0,5,30,30
1650476754786,MATH 193A,A02,083225,Staff,0,5,30,30
1650476754786,MATH 193A,A03,083781,Staff,0,4,30,30
1650476754786,MATH 193A,A04,083782,Staff,0,6,30,30
1650476760811,MATH 197,001,091859,McAuley; Julian John,9998,0,9999,1
1650476766875,COGS 9,A01,083615,Staff,0,14,60,60
1650476772901,COGS 11,A01,083617,Boyle; Mary E. T.,21,0,40,19
1650476778926,COGS 13,A01,083071,Staff,0,34,40,40
1650476784961,COGS 14A,A01,092681,Staff,1,25,100,99
1650476790985,COGS 14B,A01,083073,Cheng; Tzu-Han,0,11,50,50
1650476797019,COGS 17,A01,092677,Staff,22,0,75,53
1650476803056,COGS 100,A01,083619,Staff,0,26,60,60
1650476809083,COGS 101A,A01,083621,Davis; Joshua Daniel,0,22,60,60
1650476815108,COGS 101B,A01,091572,Staff,0,4,60,60
1650476821136,COGS 101C,A01,083625,Delgado; Tania,16,0,30,14
1650476827162,COGS 107A,A01,083627,Boyle; Mary E. T.,0,11,60,60
1650476833187,COGS 118A,A01,083075,Staff,0,3,60,60
1650476839214,CSE 3,A50,083646,Miranda; Gregory Joseph,20,0,38,18
1650476839214,CSE 3,A51,083647,Miranda; Gregory Joseph,36,0,37,1
1650476845257,CSE 8A,A50,083650,Miranda; Gregory Joseph,0,28,40,40
1650476851290,CSE 11,A01,083080,Cao; Yingjun,0,92,40,40
1650476857315,CSE 12,A01,083652,Staff,0,16,100,100
1650476863340,CSE 15L,A01,083654,Staff,0,1,50,50
1650476863340,CSE 15L,A02,083655,Staff,1,0,50,49
1650476869364,CSE 20,A01,083657,Staff,51,0,80,29
1650476875386,CSE 30,A01,083084,Eldon; John,0,76,40,40
1650476881491,CSE 100,A01,083659,Cao; Yingjun,0,66,50,50
1650476887515,CSE 134B,A01,083661,Powell; Thomas Allan,0,32,65,65
1650476893540,CSE 140,A01,083663,Staff,0,4,75,75
1650476899573,CSE 140L,A01,083088,Eldon; John,0,9,75,75
1650476905601,CSE 175,A01,083665,Kumar; Rakesh,7,0,25,18
1650476911624,CSE 190,A00,092507,Dubnov; Shlomo,14,0,20,6
1650476917655,ECE 45,A01,083139,Staff,20,18,60,40
1650476923680,ECE 65,A50,083695,Staff,0,6,30,30
1650476929716,ECE 109,A01,091882,Touri; Behrouz,39,0,70,31
1650476935740,ECE 180,A00,083140,Abi Samra; Nicholas Camill,23,0,30,7
1650476935740,ECE 180,B00,083141,Abi Samra; Nicholas Camill,0,0,30,30
1650476941764,MATH 10A,A01,083735,Patchell; Gregory David,7,0,30,23
1650476941764,MATH 10A,A02,083736,Patchell; Gregory David,27,0,30,3
1650476941764,MATH 10A,A03,083737,Patchell; Gregory David,25,0,30,5
1650476947787,MATH 10B,A01,083207,Staff,0,8,30,30
1650476947787,MATH 10B,A02,083208,Staff,0,7,30,30
1650476947787,MATH 10B,B01,083739,Staff,13,0,30,17
1650476947787,MATH 10B,B02,083740,Staff,28,0,30,2
1650476953816,MATH 18,A01,083743,Staff,1,0,30,29
1650476953816,MATH 18,A02,083744,Staff,27,0,30,3
1650476953816,MATH 18,A03,083745,Staff,22,0,30,8
1650476953816,MATH 18,A04,083746,Staff,26,0,30,4
1650476953816,MATH 18,B01,083748,Staff,0,11,30,30
1650476953816,MATH 18,B02,083749,Staff,0,12,30,30
1650476953816,MATH 18,B03,083750,Staff,0,11,30,30
1650476953816,MATH 18,B04,083751,Staff,0,12,30,30
1650476959850,MATH 20A,A01,083754,Staff,25,0,40,15
1650476965874,MATH 20B,A01,083756,Staff,0,10,30,30
1650476965874,MATH 20B,A02,083757,Staff,0,11,30,30
1650476971912,MATH 20C,A01,083760,Staff,0,15,30,30
1650476971912,MATH 20C,A02,083761,Staff,2,15,30,28
1650476971912,MATH 20C,B01,083762,Staff,13,0,30,17
1650476971912,MATH 20C,B02,083763,Staff,28,0,30,2
1650476977937,MATH 20D,A01,083765,Staff,0,1,30,30
1650476977937,MATH 20D,A02,083766,Staff,9,0,30,21
1650476977937,MATH 20D,A03,083767,Staff,25,0,30,5
1650476983961,MATH 20E,A01,083771,Staff,6,0,30,24
1650476983961,MATH 20E,A02,083772,Staff,18,0,30,12
1650476983961,MATH 20E,B01,083773,Staff,0,0,30,30
1650476983961,MATH 20E,B02,083774,Staff,10,0,30,20
1650476989986,MATH 103A,A01,083777,Staff,0,12,30,30
1650476989986,MATH 103A,A02,083778,Staff,0,12,30,30
1650476989986,MATH 103A,B01,083779,Staff,0,13,30,30
1650476989986,MATH 103A,B02,083780,Staff,0,12,30,30
1650476996013,MATH 105,A01,085443,Staff,0,23,30,30
1650477002038,MATH 109,A01,083213,Anzaldo; Leesa B,0,7,30,30
1650477002038,MATH 109,A02,083214,Anzaldo; Leesa B,0,7,30,30
1650477002038,MATH 109,B01,083215,Anzaldo; Leesa B,0,5,30,30
1650477002038,MATH 109,B02,083216,Anzaldo; Leesa B,0,6,30,30
1650477008063,MATH 142A,A01,083219,Chow; Bennett,0,15,30,30
1650477008063,MATH 142A,A02,083220,Chow; Bennett,0,13,30,30
1650477008063,MATH 142A,B01,083221,Chow; Bennett,0,12,30,30
1650477008063,MATH 142A,B02,083222,Chow; Bennett,0,13,30,30
1650477014086,MATH 193A,A01,083224,Staff,0,5,30,30
1650477014086,MATH 193A,A02,083225,Staff,0,5,30,30
1650477014086,MATH 193A,A03,083781,Staff,0,5,30,30
1650477014086,MATH 193A,A04,083782,Staff,0,6,30,30
1650477020112,MATH 197,001,091859,McAuley; Julian John,9998,0,9999,1
1650477026172,COGS 9,A01,083615,Staff,0,14,60,60
1650477032196,COGS 11,A01,083617,Boyle; Mary E. T.,21,0,40,19
1650477038222,COGS 13,A01,083071,Staff,0,34,40,40
1650477044245,COGS 14A,A01,092681,Staff,1,25,100,99
1650477050273,COGS 14B,A01,083073,Cheng; Tzu-Han,0,11,50,50
1650477056304,COGS 17,A01,092677,Staff,22,0,75,53
1650477062327,COGS 100,A01,083619,Staff,0,26,60,60
1650477068351,COGS 101A,A01,083621,Davis; Joshua Daniel,0,22,60,60
1650477074377,COGS 101B,A01,091572,Staff,0,4,60,60
1650477080401,COGS 101C,A01,083625,Delgado; Tania,16,0,30,14
1650477086424,COGS 107A,A01,083627,Boyle; Mary E. T.,0,11,60,60
1650477092449,COGS 118A,A01,083075,Staff,0,3,60,60
1650477098503,CSE 3,A50,083646,Miranda; Gregory Joseph,20,0,38,18
1650477098503,CSE 3,A51,083647,Miranda; Gregory Joseph,36,0,37,1
1650477104531,CSE 8A,A50,083650,Miranda; Gregory Joseph,0,28,40,40
1650477110558,CSE 11,A01,083080,Cao; Yingjun,0,92,40,40
1650477116581,CSE 12,A01,083652,Staff,0,16,100,100
1650477122606,CSE 15L,A01,083654,Staff,0,1,50,50
1650477122606,CSE 15L,A02,083655,Staff,1,0,50,49
1650477128633,CSE 20,A01,083657,Staff,51,0,80,29
1650477134662,CSE 30,A01,083084,Eldon; John,0,76,40,40
1650477140692,CSE 100,A01,083659,Cao; Yingjun,0,66,50,50
1650477146717,CSE 134B,A01,083661,Powell; Thomas Allan,0,32,65,65
1650477152740,CSE 140,A01,083663,Staff,0,4,75,75
1650477158776,CSE 140L,A01,083088,Eldon; John,0,9,75,75
1650477164806,CSE 175,A01,083665,Kumar; Rakesh,7,0,25,18
1650477170829,CSE 190,A00,092507,Dubnov; Shlomo,13,0,20,7
1650477176851,ECE 45,A01,083139,Staff,20,18,60,40
1650477182876,ECE 65,A50,083695,Staff,0,6,30,30
1650477188904,ECE 109,A01,091882,Touri; Behrouz,39,0,70,31
1650477194936,ECE 180,A00,083140,Abi Samra; Nicholas Camill,23,0,30,7
1650477194936,ECE 180,B00,083141,Abi Samra; Nicholas Camill,0,0,30,30
1650477200962,MATH 10A,A01,083735,Patchell; Gregory David,7,0,30,23
1650477200962,MATH 10A,A02,083736,Patchell; Gregory David,27,0,30,3
1650477200962,MATH 10A,A03,083737,Patchell; Gregory David,25,0,30,5
1650477206991,MATH 10B,A01,083207,Staff,0,8,30,30
1650477206991,MATH 10B,A02,083208,Staff,0,7,30,30
1650477206991,MATH 10B,B01,083739,Staff,13,0,30,17
1650477206991,MATH 10B,B02,083740,Staff,28,0,30,2
1650477213021,MATH 18,A01,083743,Staff,1,0,30,29
1650477213021,MATH 18,A02,083744,Staff,27,0,30,3
1650477213021,MATH 18,A03,083745,Staff,22,0,30,8
1650477213021,MATH 18,A04,083746,Staff,26,0,30,4
1650477213021,MATH 18,B01,083748,Staff,0,11,30,30
1650477213021,MATH 18,B02,083749,Staff,0,12,30,30
1650477213021,MATH 18,B03,083750,Staff,0,11,30,30
1650477213021,MATH 18,B04,083751,Staff,0,12,30,30
1650477219045,MATH 20A,A01,083754,Staff,25,0,40,15
1650477225085,MATH 20B,A01,083756,Staff,0,10,30,30
1650477225085,MATH 20B,A02,083757,Staff,0,11,30,30
1650477231113,MATH 20C,A01,083760,Staff,0,15,30,30
1650477231113,MATH 20C,A02,083761,Staff,2,15,30,28
1650477231113,MATH 20C,B01,083762,Staff,13,0,30,17
1650477231113,MATH 20C,B02,083763,Staff,28,0,30,2
1650477237140,MATH 20D,A01,083765,Staff,0,1,30,30
1650477237140,MATH 20D,A02,083766,Staff,9,0,30,21
1650477237140,MATH 20D,A03,083767,Staff,25,0,30,5
1650477243183,MATH 20E,A01,083771,Staff,6,0,30,24
1650477243183,MATH 20E,A02,083772,Staff,18,0,30,12
1650477243183,MATH 20E,B01,083773,Staff,0,0,30,30
1650477243183,MATH 20E,B02,083774,Staff,10,0,30,20
1650477249207,MATH 103A,A01,083777,Staff,0,12,30,30
1650477249207,MATH 103A,A02,083778,Staff,0,12,30,30
1650477249207,MATH 103A,B01,083779,Staff,0,13,30,30
1650477249207,MATH 103A,B02,083780,Staff,0,12,30,30
1650477255230,MATH 105,A01,085443,Staff,0,23,30,30
1650477261253,MATH 109,A01,083213,Anzaldo; Leesa B,0,7,30,30
1650477261253,MATH 109,A02,083214,Anzaldo; Leesa B,0,7,30,30
1650477261253,MATH 109,B01,083215,Anzaldo; Leesa B,0,5,30,30
1650477261253,MATH 109,B02,083216,Anzaldo; Leesa B,0,6,30,30
1650477267280,MATH 142A,A01,083219,Chow; Bennett,0,15,30,30
1650477267280,MATH 142A,A02,083220,Chow; Bennett,0,13,30,30
1650477267280,MATH 142A,B01,083221,Chow; Bennett,0,12,30,30
1650477267280,MATH 142A,B02,083222,Chow; Bennett,0,13,30,30
1650477273313,MATH 193A,A01,083224,Staff,0,5,30,30
1650477273313,MATH 193A,A02,083225,Staff,0,5,30,30
1650477273313,MATH 193A,A03,083781,Staff,0,5,30,30
1650477273313,MATH 193A,A04,083782,Staff,0,6,30,30
1650477279344,MATH 197,001,091859,McAuley; Julian John,9998,0,9999,1
1650477285402,COGS 9,A01,083615,Staff,0,14,60,60
1650477291439,COGS 11,A01,083617,Boyle; Mary E. T.,21,0,40,19
1650477297475,COGS 13,A01,083071,Staff,0,34,40,40
1650477303498,COGS 14A,A01,092681,Staff,1,25,100,99
1650477309525,COGS 14B,A01,083073,Cheng; Tzu-Han,0,11,50,50
1650477315549,COGS 17,A01,092677,Staff,22,0,75,53
1650477321574,COGS 100,A01,083619,Staff,0,26,60,60
1650477327596,COGS 101A,A01,083621,Davis; Joshua Daniel,0,22,60,60
1650477333622,COGS 101B,A01,091572,Staff,0,4,60,60
1650477339649,COGS 101C,A01,083625,Delgado; Tania,16,0,30,14
1650477345680,COGS 107A,A01,083627,Boyle; Mary E. T.,0,11,60,60
1650477351711,COGS 118A,A01,083075,Staff,0,3,60,60
1650477357738,CSE 3,A50,083646,Miranda; Gregory Joseph,20,0,38,18
1650477357738,CSE 3,A51,083647,Miranda; Gregory Joseph,36,0,37,1
1650477363762,CSE 8A,A50,083650,Miranda; Gregory Joseph,0,28,40,40
1650477369785,CSE 11,A01,083080,Cao; Yingjun,0,92,40,40
1650477375810,CSE 12,A01,083652,Staff,0,16,100,100
1650477381834,CSE 15L,A01,083654,Staff,0,1,50,50
1650477381834,CSE 15L,A02,083655,Staff,1,0,50,49
1650477387856,CSE 20,A01,083657,Staff,51,0,80,29
1650477393883,CSE 30,A01,083084,Eldon; John,0,76,40,40
1650477399906,CSE 100,A01,083659,Cao; Yingjun,0,66,50,50
1650477405934,CSE 134B,A01,083661,Powell; Thomas Allan,0,32,65,65
1650477411957,CSE 140,A01,083663,Staff,0,5,75,75
1650477417989,CSE 140L,A01,083088,Eldon; John,0,9,75,75
1650477424017,CSE 175,A01,083665,Kumar; Rakesh,7,0,25,18
1650477430043,CSE 190,A00,092507,Dubnov; Shlomo,13,0,20,7
1650477436068,ECE 45,A01,083139,Staff,20,18,60,40
1650477442091,ECE 65,A50,083695,Staff,0,6,30,30
1650477448119,ECE 109,A01,091882,Touri; Behrouz,39,0,70,31
1650477454142,ECE 180,A00,083140,Abi Samra; Nicholas Camill,23,0,30,7
1650477454142,ECE 180,B00,083141,Abi Samra; Nicholas Camill,0,0,30,30
1650477460179,MATH 10A,A01,083735,Patchell; Gregory David,7,0,30,23
1650477460179,MATH 10A,A02,083736,Patchell; Gregory David,27,0,30,3
1650477460179,MATH 10A,A03,083737,Patchell; Gregory David,25,0,30,5
1650477466203,MATH 10B,A01,083207,Staff,0,8,30,30
1650477466203,MATH 10B,A02,083208,Staff,0,7,30,30
1650477466203,MATH 10B,B01,083739,Staff,13,0,30,17
1650477466203,MATH 10B,B02,083740,Staff,28,0,30,2
1650477472233,MATH 18,A01,083743,Staff,1,0,30,29
1650477472233,MATH 18,A02,083744,Staff,27,0,30,3
1650477472233,MATH 18,A03,083745,Staff,22,0,30,8
1650477472233,MATH 18,A04,083746,Staff,26,0,30,4
1650477472233,MATH 18,B01,083748,Staff,0,11,30,30
1650477472233,MATH 18,B02,083749,Staff,0,12,30,30
1650477472233,MATH 18,B03,083750,Staff,0,11,30,30
1650477472233,MATH 18,B04,083751,Staff,0,12,30,30
1650477478351,MATH 20A,A01,083754,Staff,25,0,40,15
1650477484376,MATH 20B,A01,083756,Staff,0,10,30,30
1650477484376,MATH 20B,A02,083757,Staff,0,11,30,30
1650477490410,MATH 20C,A01,083760,Staff,0,15,30,30
1650477490410,MATH 20C,A02,083761,Staff,2,15,30,28
1650477490410,MATH 20C,B01,083762,Staff,13,0,30,17
1650477490410,MATH 20C,B02,083763,Staff,28,0,30,2
1650477496440,MATH 20D,A01,083765,Staff,0,1,30,30
1650477496440,MATH 20D,A02,083766,Staff,9,0,30,21
1650477496440,MATH 20D,A03,083767,Staff,25,0,30,5
1650477502462,MATH 20E,A01,083771,Staff,6,0,30,24
1650477502462,MATH 20E,A02,083772,Staff,18,0,30,12
1650477502462,MATH 20E,B01,083773,Staff,0,0,30,30
1650477502462,MATH 20E,B02,083774,Staff,10,0,30,20
1650477508487,MATH 103A,A01,083777,Staff,0,12,30,30
1650477508487,MATH 103A,A02,083778,Staff,0,12,30,30
1650477508487,MATH 103A,B01,083779,Staff,0,13,30,30
1650477508487,MATH 103A,B02,083780,Staff,0,12,30,30
1650477514517,MATH 105,A01,085443,Staff,0,23,30,30
1650477520549,MATH 109,A01,083213,Anzaldo; Leesa B,0,7,30,30
1650477520549,MATH 109,A02,083214,Anzaldo; Leesa B,0,7,30,30
1650477520549,MATH 109,B01,083215,Anzaldo; Leesa B,0,5,30,30
1650477520549,MATH 109,B02,083216,Anzaldo; Leesa B,0,6,30,30
1650477526576,MATH 142A,A01,083219,Chow; Bennett,0,15,30,30
1650477526576,MATH 142A,A02,083220,Chow; Bennett,0,13,30,30
1650477526576,MATH 142A,B01,083221,Chow; Bennett,0,12,30,30
1650477526576,MATH 142A,B02,083222,Chow; Bennett,0,13,30,30
1650477532620,MATH 193A,A01,083224,Staff,0,5,30,30
1650477532620,MATH 193A,A02,083225,Staff,0,5,30,30
1650477532620,MATH 193A,A03,083781,Staff,0,5,30,30
1650477532620,MATH 193A,A04,083782,Staff,0,6,30,30
1650477538656,MATH 197,001,091859,McAuley; Julian John,9998,0,9999,1
1650477544722,COGS 9,A01,083615,Staff,0,14,60,60
1650477550752,COGS 11,A01,083617,Boyle; Mary E. T.,21,0,40,19
1650477556792,COGS 13,A01,083071,Staff,0,34,40,40
1650477562821,COGS 14A,A01,092681,Staff,1,25,100,99
1650477568847,COGS 14B,A01,083073,Cheng; Tzu-Han,0,11,50,50
1650477574871,COGS 17,A01,092677,Staff,22,0,75,53
1650477580901,COGS 100,A01,083619,Staff,0,26,60,60
1650477586924,COGS 101A,A01,083621,Davis; Joshua Daniel,0,22,60,60
1650477592948,COGS 101B,A01,091572,Staff,0,4,60,60
1650477598971,COGS 101C,A01,083625,Delgado; Tania,16,0,30,14
1650477605027,COGS 107A,A01,083627,Boyle; Mary E. T.,0,11,60,60
1650477611059,COGS 118A,A01,083075,Staff,0,3,60,60
1650477617093,CSE 3,A50,083646,Miranda; Gregory Joseph,19,0,38,19
1650477617093,CSE 3,A51,083647,Miranda; Gregory Joseph,36,0,37,1
1650477623115,CSE 8A,A50,083650,Miranda; Gregory Joseph,0,28,40,40
1650477629143,CSE 11,A01,083080,Cao; Yingjun,0,92,40,40
1650477635168,CSE 12,A01,083652,Staff,0,16,100,100
1650477641192,CSE 15L,A01,083654,Staff,0,1,50,50
1650477641192,CSE 15L,A02,083655,Staff,1,0,50,49
1650477647218,CSE 20,A01,083657,Staff,51,0,80,29
1650477653244,CSE 30,A01,083084,Eldon; John,0,76,40,40
1650477659281,CSE 100,A01,083659,Cao; Yingjun,0,66,50,50
1650477665314,CSE 134B,A01,083661,Powell; Thomas Allan,0,32,65,65
1650477671343,CSE 140,A01,083663,Staff,0,5,75,75
1650477677369,CSE 140L,A01,083088,Eldon; John,0,9,75,75
1650477683396,CSE 175,A01,083665,Kumar; Rakesh,7,0,25,18
1650477689419,CSE 190,A00,092507,Dubnov; Shlomo,13,0,20,7
1650477695447,ECE 45,A01,083139,Staff,20,18,60,40
1650477701472,ECE 65,A50,083695,Staff,0,6,30,30
1650477707496,ECE 109,A01,091882,Touri; Behrouz,39,0,70,31
1650477713520,ECE 180,A00,083140,Abi Samra; Nicholas Camill,23,0,30,7
1650477713520,ECE 180,B00,083141,Abi Samra; Nicholas Camill,0,0,30,30
1650477719554,MATH 10A,A01,083735,Patchell; Gregory David,7,0,30,23
1650477719554,MATH 10A,A02,083736,Patchell; Gregory David,27,0,30,3
1650477719554,MATH 10A,A03,083737,Patchell; Gregory David,25,0,30,5
1650477725582,MATH 10B,A01,083207,Staff,0,8,30,30
1650477725582,MATH 10B,A02,083208,Staff,0,7,30,30
1650477725582,MATH 10B,B01,083739,Staff,13,0,30,17
1650477725582,MATH 10B,B02,083740,Staff,28,0,30,2
1650477731619,MATH 18,A01,083743,Staff,1,0,30,29
1650477731619,MATH 18,A02,083744,Staff,27,0,30,3
1650477731619,MATH 18,A03,083745,Staff,22,0,30,8
1650477731619,MATH 18,A04,083746,Staff,26,0,30,4
1650477731619,MATH 18,B01,083748,Staff,0,11,30,30
1650477731619,MATH 18,B02,083749,Staff,0,12,30,30
1650477731619,MATH 18,B03,083750,Staff,0,11,30,30
1650477731619,MATH 18,B04,083751,Staff,0,12,30,30
1650477737646,MATH 20A,A01,083754,Staff,25,0,40,15
1650477743672,MATH 20B,A01,083756,Staff,0,10,30,30
1650477743672,MATH 20B,A02,083757,Staff,0,11,30,30
1650477749709,MATH 20C,A01,083760,Staff,0,15,30,30
1650477749709,MATH 20C,A02,083761,Staff,2,15,30,28
1650477749709,MATH 20C,B01,083762,Staff,13,0,30,17
1650477749709,MATH 20C,B02,083763,Staff,28,0,30,2
1650477755738,MATH 20D,A01,083765,Staff,0,1,30,30
1650477755738,MATH 20D,A02,083766,Staff,9,0,30,21
1650477755738,MATH 20D,A03,083767,Staff,25,0,30,5
1650477761766,MATH 20E,A01,083771,Staff,6,0,30,24
1650477761766,MATH 20E,A02,083772,Staff,18,0,30,12
1650477761766,MATH 20E,B01,083773,Staff,0,0,30,30
1650477761766,MATH 20E,B02,083774,Staff,10,0,30,20
1650477767789,MATH 103A,A01,083777,Staff,0,12,30,30
1650477767789,MATH 103A,A02,083778,Staff,0,12,30,30
1650477767789,MATH 103A,B01,083779,Staff,0,13,30,30
1650477767789,MATH 103A,B02,083780,Staff,0,12,30,30
1650477773819,MATH 105,A01,085443,Staff,0,23,30,30
1650477779843,MATH 109,A01,083213,Anzaldo; Leesa B,0,7,30,30
1650477779843,MATH 109,A02,083214,Anzaldo; Leesa B,0,7,30,30
1650477779843,MATH 109,B01,083215,Anzaldo; Leesa B,0,5,30,30
1650477779843,MATH 109,B02,083216,Anzaldo; Leesa B,0,6,30,30
1650477785866,MATH 142A,A01,083219,Chow; Bennett,0,15,30,30
1650477785866,MATH 142A,A02,083220,Chow; Bennett,0,13,30,30
1650477785866,MATH 142A,B01,083221,Chow; Bennett,0,12,30,30
1650477785866,MATH 142A,B02,083222,Chow; Bennett,0,13,30,30
1650477791889,MATH 193A,A01,083224,Staff,0,5,30,30
1650477791889,MATH 193A,A02,083225,Staff,0,5,30,30
1650477791889,MATH 193A,A03,083781,Staff,0,5,30,30
1650477791889,MATH 193A,A04,083782,Staff,0,6,30,30
1650477797911,MATH 197,001,091859,McAuley; Julian John,9998,0,9999,1
1650477803961,COGS 9,A01,083615,Staff,0,14,60,60
1650477809983,COGS 11,A01,083617,Boyle; Mary E. T.,21,0,40,19
1650477816008,COGS 13,A01,083071,Staff,0,34,40,40
1650477822032,COGS 14A,A01,092681,Staff,1,25,100,99
1650477828055,COGS 14B,A01,083073,Cheng; Tzu-Han,0,11,50,50
1650477834084,COGS 17,A01,092677,Staff,22,0,75,53
1650477840121,COGS 100,A01,083619,Staff,0,26,60,60
1650477846145,COGS 101A,A01,083621,Davis; Joshua Daniel,0,22,60,60
1650477852169,COGS 101B,A01,091572,Staff,0,4,60,60
1650477858199,COGS 101C,A01,083625,Delgado; Tania,16,0,30,14
1650477864222,COGS 107A,A01,083627,Boyle; Mary E. T.,0,11,60,60
1650477870246,COGS 118A,A01,083075,Staff,0,3,60,60
1650477876270,CSE 3,A50,083646,Miranda; Gregory Joseph,19,0,38,19
1650477876270,CSE 3,A51,083647,Miranda; Gregory Joseph,36,0,37,1
1650477882294,CSE 8A,A50,083650,Miranda; Gregory Joseph,0,28,40,40
1650477888319,CSE 11,A01,083080,Cao; Yingjun,0,92,40,40
1650477894353,CSE 12,A01,083652,Staff,0,16,100,100
1650477900376,CSE 15L,A01,083654,Staff,0,1,50,50
1650477900376,CSE 15L,A02,083655,Staff,1,0,50,49
1650477906401,CSE 20,A01,083657,Staff,51,0,80,29
1650477912426,CSE 30,A01,083084,Eldon; John,0,76,40,40
1650477918454,CSE 100,A01,083659,Cao; Yingjun,0,66,50,50
1650477924481,CSE 134B,A01,083661,Powell; Thomas Allan,0,32,65,65
1650477930512,CSE 140,A01,083663,Staff,0,5,75,75
1650477936544,CSE 140L,A01,083088,Eldon; John,0,9,75,75
1650477942567,CSE 175,A01,083665,Kumar; Rakesh,7,0,25,18
1650477948603,CSE 190,A00,092507,Dubnov; Shlomo,12,0,20,8
1650477954630,ECE 45,A01,083139,Staff,20,19,60,40
1650477960652,ECE 65,A50,083695,Staff,0,6,30,30
1650477966676,ECE 109,A01,091882,Touri; Behrouz,39,0,70,31
1650477972702,ECE 180,A00,083140,Abi Samra; Nicholas Camill,23,0,30,7
1650477972702,ECE 180,B00,083141,Abi Samra; Nicholas Camill,0,0,30,30
1650477978732,MATH 10A,A01,083735,Patchell; Gregory David,7,0,30,23
1650477978732,MATH 10A,A02,083736,Patchell; Gregory David,27,0,30,3
1650477978732,MATH 10A,A03,083737,Patchell; Gregory David,25,0,30,5
1650477984759,MATH 10B,A01,083207,Staff,0,8,30,30
1650477984759,MATH 10B,A02,083208,Staff,0,7,30,30
1650477984759,MATH 10B,B01,083739,Staff,13,0,30,17
1650477984759,MATH 10B,B02,083740,Staff,28,0,30,2
1650477990788,MATH 18,A01,083743,Staff,1,0,30,29
1650477990788,MATH 18,A02,083744,Staff,27,0,30,3
1650477990788,MATH 18,A03,083745,Staff,22,0,30,8
1650477990788,MATH 18,A04,083746,Staff,26,0,30,4
1650477990788,MATH 18,B01,083748,Staff,0,11,30,30
1650477990788,MATH 18,B02,083749,Staff,0,12,30,30
1650477990788,MATH 18,B03,083750,Staff,0,11,30,30
1650477990788,MATH 18,B04,083751,Staff,0,12,30,30
1650477996812,MATH 20A,A01,083754,Staff,25,0,40,15
1650478002840,MATH 20B,A01,083756,Staff,0,10,30,30
1650478002840,MATH 20B,A02,083757,Staff,0,11,30,30
1650478008863,MATH 20C,A01,083760,Staff,0,15,30,30
1650478008863,MATH 20C,A02,083761,Staff,2,15,30,28
1650478008863,MATH 20C,B01,083762,Staff,13,0,30,17
1650478008863,MATH 20C,B02,083763,Staff,28,0,30,2
1650478014896,MATH 20D,A01,083765,Staff,0,1,30,30
1650478014896,MATH 20D,A02,083766,Staff,9,0,30,21
1650478014896,MATH 20D,A03,083767,Staff,25,0,30,5
1650478020923,MATH 20E,A01,083771,Staff,6,0,30,24
1650478020923,MATH 20E,A02,083772,Staff,18,0,30,12
1650478020923,MATH 20E,B01,083773,Staff,0,0,30,30
1650478020923,MATH 20E,B02,083774,Staff,10,0,30,20
1650478026946,MATH 103A,A01,083777,Staff,0,12,30,30
1650478026946,MATH 103A,A02,083778,Staff,0,12,30,30
1650478026946,MATH 103A,B01,083779,Staff,0,13,30,30
1650478026946,MATH 103A,B02,083780,Staff,0,12,30,30
1650478032977,MATH 105,A01,085443,Staff,0,23,30,30
1650478039003,MATH 109,A01,083213,Anzaldo; Leesa B,0,7,30,30
1650478039003,MATH 109,A02,083214,Anzaldo; Leesa B,0,7,30,30
1650478039003,MATH 109,B01,083215,Anzaldo; Leesa B,0,5,30,30
1650478039003,MATH 109,B02,083216,Anzaldo; Leesa B,0,6,30,30
1650478045031,MATH 142A,A01,083219,Chow; Bennett,0,15,30,30
1650478045031,MATH 142A,A02,083220,Chow; Bennett,0,13,30,30
1650478045031,MATH 142A,B01,083221,Chow; Bennett,0,12,30,30
1650478045031,MATH 142A,B02,083222,Chow; Bennett,0,13,30,30
1650478051054,MATH 193A,A01,083224,Staff,0,5,30,30
1650478051054,MATH 193A,A02,083225,Staff,0,5,30,30
1650478051054,MATH 193A,A03,083781,Staff,0,5,30,30
1650478051054,MATH 193A,A04,083782,Staff,0,6,30,30
1650478057132,MATH 197,001,091859,McAuley; Julian John,9998,0,9999,1
1650478063195,COGS 9,A01,083615,Staff,0,14,60,60
1650478069339,COGS 11,A01,083617,Boyle; Mary E. T.,21,0,40,19
1650478075365,COGS 13,A01,083071,Staff,0,34,40,40
1650478081388,COGS 14A,A01,092681,Staff,1,25,100,99
1650478087412,COGS 14B,A01,083073,Cheng; Tzu-Han,0,11,50,50
1650478093436,COGS 17,A01,092677,Staff,22,0,75,53
1650478099464,COGS 100,A01,083619,Staff,0,26,60,60
1650478105490,COGS 101A,A01,083621,Davis; Joshua Daniel,0,22,60,60
1650478111514,COGS 101B,A01,091572,Staff,0,4,60,60
1650478117536,COGS 101C,A01,083625,Delgado; Tania,16,0,30,14
1650478123559,COGS 107A,A01,083627,Boyle; Mary E. T.,0,11,60,60
1650478129590,COGS 118A,A01,083075,Staff,0,3,60,60
1650478135621,CSE 3,A50,083646,Miranda; Gregory Joseph,19,0,38,19
1650478135621,CSE 3,A51,083647,Miranda; Gregory Joseph,36,0,37,1
1650478141645,CSE 8A,A50,083650,Miranda; Gregory Joseph,0,28,40,40
1650478147679,CSE 11,A01,083080,Cao; Yingjun,0,92,40,40
1650478153706,CSE 12,A01,083652,Staff,0,16,100,100
1650478159730,CSE 15L,A01,083654,Staff,0,1,50,50
1650478159730,CSE 15L,A02,083655,Staff,1,0,50,49
1650478165754,CSE 20,A01,083657,Staff,51,0,80,29
1650478171776,CSE 30,A01,083084,Eldon; John,0,76,40,40
1650478177803,CSE 100,A01,083659,Cao; Yingjun,0,66,50,50
1650478183826,CSE 134B,A01,083661,Powell; Thomas Allan,0,32,65,65
1650478189848,CSE 140,A01,083663,Staff,0,5,75,75
1650478195875,CSE 140L,A01,083088,Eldon; John,0,9,75,75
1650478201897,CSE 175,A01,083665,Kumar; Rakesh,7,0,25,18
1650478207921,CSE 190,A00,092507,Dubnov; Shlomo,12,0,20,8
1650478213944,ECE 45,A01,083139,Staff,20,19,60,40
1650478219979,ECE 65,A50,083695,Staff,0,6,30,30
1650478226003,ECE 109,A01,091882,Touri; Behrouz,39,0,70,31
1650478232027,ECE 180,A00,083140,Abi Samra; Nicholas Camill,23,0,30,7
1650478232027,ECE 180,B00,083141,Abi Samra; Nicholas Camill,0,0,30,30
1650478238051,MATH 10A,A01,083735,Patchell; Gregory David,7,0,30,23
1650478238051,MATH 10A,A02,083736,Patchell; Gregory David,27,0,30,3
1650478238051,MATH 10A,A03,083737,Patchell; Gregory David,25,0,30,5
1650478244076,MATH 10B,A01,083207,Staff,0,8,30,30
1650478244076,MATH 10B,A02,083208,Staff,0,7,30,30
1650478244076,MATH 10B,B01,083739,Staff,13,0,30,17
1650478244076,MATH 10B,B02,083740,Staff,28,0,30,2
1650478250102,MATH 18,A01,083743,Staff,1,0,30,29
1650478250102,MATH 18,A02,083744,Staff,27,0,30,3
1650478250102,MATH 18,A03,083745,Staff,22,0,30,8
1650478250102,MATH 18,A04,083746,Staff,26,0,30,4
1650478250102,MATH 18,B01,083748,Staff,0,11,30,30
1650478250102,MATH 18,B02,083749,Staff,0,12,30,30
1650478250102,MATH 18,B03,083750,Staff,0,11,30,30
1650478250102,MATH 18,B04,083751,Staff,0,12,30,30
1650478256131,MATH 20A,A01,083754,Staff,25,0,40,15
1650478262161,MATH 20B,A01,083756,Staff,0,10,30,30
1650478262161,MATH 20B,A02,083757,Staff,0,11,30,30
1650478268185,MATH 20C,A01,083760,Staff,0,15,30,30
1650478268185,MATH 20C,A02,083761,Staff,2,15,30,28
1650478268185,MATH 20C,B01,083762,Staff,13,0,30,17
1650478268185,MATH 20C,B02,083763,Staff,28,0,30,2
1650478274222,MATH 20D,A01,083765,Staff,0,1,30,30
1650478274222,MATH 20D,A02,083766,Staff,9,0,30,21
1650478274222,MATH 20D,A03,083767,Staff,25,0,30,5
1650478280258,MATH 20E,A01,083771,Staff,6,0,30,24
1650478280258,MATH 20E,A02,083772,Staff,18,0,30,12
1650478280258,MATH 20E,B01,083773,Staff,0,0,30,30
1650478280258,MATH 20E,B02,083774,Staff,10,0,30,20
1650478286297,MATH 103A,A01,083777,Staff,0,12,30,30
1650478286297,MATH 103A,A02,083778,Staff,0,12,30,30
1650478286297,MATH 103A,B01,083779,Staff,0,13,30,30
1650478286297,MATH 103A,B02,083780,Staff,0,12,30,30
1650478292326,MATH 105,A01,085443,Staff,0,23,30,30
1650478298350,MATH 109,A01,083213,Anzaldo; Leesa B,0,7,30,30
1650478298350,MATH 109,A02,083214,Anzaldo; Leesa B,0,7,30,30
1650478298350,MATH 109,B01,083215,Anzaldo; Leesa B,0,5,30,30
1650478298350,MATH 109,B02,083216,Anzaldo; Leesa B,0,6,30,30
1650478304380,MATH 142A,A01,083219,Chow; Bennett,0,15,30,30
1650478304380,MATH 142A,A02,083220,Chow; Bennett,0,13,30,30
1650478304380,MATH 142A,B01,083221,Chow; Bennett,0,12,30,30
1650478304380,MATH 142A,B02,083222,Chow; Bennett,0,13,30,30
1650478310403,MATH 193A,A01,083224,Staff,0,5,30,30
1650478310403,MATH 193A,A02,083225,Staff,0,5,30,30
1650478310403,MATH 193A,A03,083781,Staff,0,5,30,30
1650478310403,MATH 193A,A04,083782,Staff,0,6,30,30
1650478316431,MATH 197,001,091859,McAuley; Julian John,9998,0,9999,1
1650478322483,COGS 9,A01,083615,Staff,0,14,60,60
1650478328509,COGS 11,A01,083617,Boyle; Mary E. T.,21,0,40,19
1650478334537,COGS 13,A01,083071,Staff,0,34,40,40
1650478340577,COGS 14A,A01,092681,Staff,1,25,100,99
1650478346615,COGS 14B,A01,083073,Cheng; Tzu-Han,0,11,50,50
1650478352649,COGS 17,A01,092677,Staff,22,0,75,53
1650478358672,COGS 100,A01,083619,Staff,0,26,60,60
1650478364695,COGS 101A,A01,083621,Davis; Joshua Daniel,0,22,60,60
1650478370723,COGS 101B,A01,091572,Staff,0,4,60,60
1650478376747,COGS 101C,A01,083625,Delgado; Tania,16,0,30,14
1650478382770,COGS 107A,A01,083627,Boyle; Mary E. T.,0,11,60,60
1650478388795,COGS 118A,A01,083075,Staff,0,3,60,60
1650478394818,CSE 3,A50,083646,Miranda; Gregory Joseph,19,0,38,19
1650478394818,CSE 3,A51,083647,Miranda; Gregory Joseph,36,0,37,1
1650478400842,CSE 8A,A50,083650,Miranda; Gregory Joseph,0,28,40,40
1650478406875,CSE 11,A01,083080,Cao; Yingjun,0,92,40,40
1650478412907,CSE 12,A01,083652,Staff,0,16,100,100
1650478418936,CSE 15L,A01,083654,Staff,0,1,50,50
1650478418936,CSE 15L,A02,083655,Staff,1,0,50,49
1650478424962,CSE 20,A01,083657,Staff,51,0,80,29
1650478431003,CSE 30,A01,083084,Eldon; John,0,76,40,40
1650478437034,CSE 100,A01,083659,Cao; Yingjun,0,66,50,50
1650478443057,CSE 134B,A01,083661,Powell; Thomas Allan,0,32,65,65
1650478449081,CSE 140,A01,083663,Staff,0,5,75,75
1650478455115,CSE 140L,A01,083088,Eldon; John,0,9,75,75
1650478461141,CSE 175,A01,083665,Kumar; Rakesh,7,0,25,18
1650478467165,CSE 190,A00,092507,Dubnov; Shlomo,12,0,20,8
1650478473195,ECE 45,A01,083139,Staff,20,19,60,40
1650478479221,ECE 65,A50,083695,Staff,0,6,30,30
1650478485245,ECE 109,A01,091882,Touri; Behrouz,39,0,70,31
1650478491272,ECE 180,A00,083140,Abi Samra; Nicholas Camill,23,0,30,7
1650478491272,ECE 180,B00,083141,Abi Samra; Nicholas Camill,0,0,30,30
1650478497303,MATH 10A,A01,083735,Patchell; Gregory David,7,0,30,23
1650478497303,MATH 10A,A02,083736,Patchell; Gregory David,27,0,30,3
1650478497303,MATH 10A,A03,083737,Patchell; Gregory David,25,0,30,5
1650478503331,MATH 10B,A01,083207,Staff,0,8,30,30
1650478503331,MATH 10B,A02,083208,Staff,0,7,30,30
1650478503331,MATH 10B,B01,083739,Staff,13,0,30,17
1650478503331,MATH 10B,B02,083740,Staff,28,0,30,2
1650478509356,MATH 18,A01,083743,Staff,1,0,30,29
1650478509356,MATH 18,A02,083744,Staff,27,0,30,3
1650478509356,MATH 18,A03,083745,Staff,22,0,30,8
1650478509356,MATH 18,A04,083746,Staff,26,0,30,4
1650478509356,MATH 18,B01,083748,Staff,0,11,30,30
1650478509356,MATH 18,B02,083749,Staff,0,12,30,30
1650478509356,MATH 18,B03,083750,Staff,0,11,30,30
1650478509356,MATH 18,B04,083751,Staff,0,12,30,30
1650478515409,MATH 20A,A01,083754,Staff,25,0,40,15
1650478521432,MATH 20B,A01,083756,Staff,0,10,30,30
1650478521432,MATH 20B,A02,083757,Staff,0,11,30,30
1650478527460,MATH 20C,A01,083760,Staff,0,15,30,30
1650478527460,MATH 20C,A02,083761,Staff,2,15,30,28
1650478527460,MATH 20C,B01,083762,Staff,13,0,30,17
1650478527460,MATH 20C,B02,083763,Staff,28,0,30,2
1650478533485,MATH 20D,A01,083765,Staff,0,1,30,30
1650478533485,MATH 20D,A02,083766,Staff,9,0,30,21
1650478533485,MATH 20D,A03,083767,Staff,25,0,30,5
1650478539508,MATH 20E,A01,083771,Staff,6,0,30,24
1650478539508,MATH 20E,A02,083772,Staff,18,0,30,12
1650478539508,MATH 20E,B01,083773,Staff,0,0,30,30
1650478539508,MATH 20E,B02,083774,Staff,10,0,30,20
1650478545544,MATH 103A,A01,083777,Staff,0,12,30,30
1650478545544,MATH 103A,A02,083778,Staff,0,12,30,30
1650478545544,MATH 103A,B01,083779,Staff,0,13,30,30
1650478545544,MATH 103A,B02,083780,Staff,0,12,30,30
1650478551575,MATH 105,A01,085443,Staff,0,23,30,30
1650478557604,MATH 109,A01,083213,Anzaldo; Leesa B,0,7,30,30
1650478557604,MATH 109,A02,083214,Anzaldo; Leesa B,0,7,30,30
1650478557604,MATH 109,B01,083215,Anzaldo; Leesa B,0,5,30,30
1650478557604,MATH 109,B02,083216,Anzaldo; Leesa B,0,6,30,30
1650478563628,MATH 142A,A01,083219,Chow; Bennett,0,15,30,30
1650478563628,MATH 142A,A02,083220,Chow; Bennett,0,13,30,30
1650478563628,MATH 142A,B01,083221,Chow; Bennett,0,12,30,30
1650478563628,MATH 142A,B02,083222,Chow; Bennett,0,13,30,30
1650478569656,MATH 193A,A01,083224,Staff,0,5,30,30
1650478569656,MATH 193A,A02,083225,Staff,0,5,30,30
1650478569656,MATH 193A,A03,083781,Staff,0,5,30,30
1650478569656,MATH 193A,A04,083782,Staff,0,6,30,30
1650478575680,MATH 197,001,091859,McAuley; Julian John,9998,0,9999,1
1650478581736,COGS 9,A01,083615,Staff,0,14,60,60
1650478587762,COGS 11,A01,083617,Boyle; Mary E. T.,21,0,40,19
1650478593785,COGS 13,A01,083071,Staff,0,34,40,40
1650478599811,COGS 14A,A01,092681,Staff,1,25,100,99
1650478605837,COGS 14B,A01,083073,Cheng; Tzu-Han,0,11,50,50
1650478611873,COGS 17,A01,092677,Staff,21,0,75,54
1650478617902,COGS 100,A01,083619,Staff,0,26,60,60
1650478623934,COGS 101A,A01,083621,Davis; Joshua Daniel,0,22,60,60
1650478629970,COGS 101B,A01,091572,Staff,0,4,60,60
1650478636002,COGS 101C,A01,083625,Delgado; Tania,16,0,30,14
1650478642030,COGS 107A,A01,083627,Boyle; Mary E. T.,0,11,60,60
1650478648067,COGS 118A,A01,083075,Staff,0,3,60,60
1650478654092,CSE 3,A50,083646,Miranda; Gregory Joseph,19,0,38,19
1650478654092,CSE 3,A51,083647,Miranda; Gregory Joseph,36,0,37,1
1650478660115,CSE 8A,A50,083650,Miranda; Gregory Joseph,0,28,40,40
1650478666225,CSE 11,A01,083080,Cao; Yingjun,0,92,40,40
1650478672250,CSE 12,A01,083652,Staff,0,16,100,100
1650478678276,CSE 15L,A01,083654,Staff,0,1,50,50
1650478678276,CSE 15L,A02,083655,Staff,1,0,50,49
1650478684300,CSE 20,A01,083657,Staff,51,0,80,29
1650478690325,CSE 30,A01,083084,Eldon; John,0,76,40,40
1650478696351,CSE 100,A01,083659,Cao; Yingjun,0,66,50,50
1650478702380,CSE 134B,A01,083661,Powell; Thomas Allan,0,32,65,65
1650478708409,CSE 140,A01,083663,Staff,0,5,75,75
1650478714435,CSE 140L,A01,083088,Eldon; John,0,9,75,75
1650478720468,CSE 175,A01,083665,Kumar; Rakesh,7,0,25,18
1650478726491,CSE 190,A00,092507,Dubnov; Shlomo,12,0,20,8
1650478732524,ECE 45,A01,083139,Staff,20,19,60,40
1650478738548,ECE 65,A50,083695,Staff,0,6,30,30
1650478744571,ECE 109,A01,091882,Touri; Behrouz,38,0,70,32
1650478750597,ECE 180,A00,083140,Abi Samra; Nicholas Camill,23,0,30,7
1650478750597,ECE 180,B00,083141,Abi Samra; Nicholas Camill,0,0,30,30
1650478756627,MATH 10A,A01,083735,Patchell; Gregory David,7,0,30,23
1650478756627,MATH 10A,A02,083736,Patchell; Gregory David,27,0,30,3
1650478756627,MATH 10A,A03,083737,Patchell; Gregory David,25,0,30,5
1650478762652,MATH 10B,A01,083207,Staff,0,8,30,30
1650478762652,MATH 10B,A02,083208,Staff,0,7,30,30
1650478762652,MATH 10B,B01,083739,Staff,13,0,30,17
1650478762652,MATH 10B,B02,083740,Staff,28,0,30,2
1650478768677,MATH 18,A01,083743,Staff,1,0,30,29
1650478768677,MATH 18,A02,083744,Staff,27,0,30,3
1650478768677,MATH 18,A03,083745,Staff,22,0,30,8
1650478768677,MATH 18,A04,083746,Staff,26,0,30,4
1650478768677,MATH 18,B01,083748,Staff,0,11,30,30
1650478768677,MATH 18,B02,083749,Staff,0,12,30,30
1650478768677,MATH 18,B03,083750,Staff,0,11,30,30
1650478768677,MATH 18,B04,083751,Staff,0,12,30,30
1650478774703,MATH 20A,A01,083754,Staff,25,0,40,15
1650478780731,MATH 20B,A01,083756,Staff,0,10,30,30
1650478780731,MATH 20B,A02,083757,Staff,0,11,30,30
1650478786757,MATH 20C,A01,083760,Staff,0,15,30,30
1650478786757,MATH 20C,A02,083761,Staff,2,15,30,28
1650478786757,MATH 20C,B01,083762,Staff,13,0,30,17
1650478786757,MATH 20C,B02,083763,Staff,28,0,30,2
1650478792785,MATH 20D,A01,083765,Staff,0,1,30,30
1650478792785,MATH 20D,A02,083766,Staff,9,0,30,21
1650478792785,MATH 20D,A03,083767,Staff,25,0,30,5
1650478798813,MATH 20E,A01,083771,Staff,6,0,30,24
1650478798813,MATH 20E,A02,083772,Staff,18,0,30,12
1650478798813,MATH 20E,B01,083773,Staff,0,0,30,30
1650478798813,MATH 20E,B02,083774,Staff,10,0,30,20
1650478804841,MATH 103A,A01,083777,Staff,0,12,30,30
1650478804841,MATH 103A,A02,083778,Staff,0,12,30,30
1650478804841,MATH 103A,B01,083779,Staff,0,13,30,30
1650478804841,MATH 103A,B02,083780,Staff,0,12,30,30
1650478810865,MATH 105,A01,085443,Staff,0,23,30,30
1650478816891,MATH 109,A01,083213,Anzaldo; Leesa B,0,7,30,30
1650478816891,MATH 109,A02,083214,Anzaldo; Leesa B,0,7,30,30
1650478816891,MATH 109,B01,083215,Anzaldo; Leesa B,0,5,30,30
1650478816891,MATH 109,B02,083216,Anzaldo; Leesa B,0,6,30,30
1650478822915,MATH 142A,A01,083219,Chow; Bennett,0,15,30,30
1650478822915,MATH 142A,A02,083220,Chow; Bennett,0,13,30,30
1650478822915,MATH 142A,B01,083221,Chow; Bennett,0,12,30,30
1650478822915,MATH 142A,B02,083222,Chow; Bennett,0,13,30,30
1650478828943,MATH 193A,A01,083224,Staff,0,5,30,30
1650478828943,MATH 193A,A02,083225,Staff,0,5,30,30
1650478828943,MATH 193A,A03,083781,Staff,0,5,30,30
1650478828943,MATH 193A,A04,083782,Staff,0,6,30,30
1650478834967,MATH 197,001,091859,McAuley; Julian John,9998,0,9999,1
1650478841020,COGS 9,A01,083615,Staff,0,14,60,60
1650478847045,COGS 11,A01,083617,Boyle; Mary E. T.,21,0,40,19
1650478853073,COGS 13,A01,083071,Staff,0,34,40,40
1650478859096,COGS 14A,A01,092681,Staff,1,25,100,99
1650478865120,COGS 14B,A01,083073,Cheng; Tzu-Han,0,11,50,50
1650478871150,COGS 17,A01,092677,Staff,21,0,75,54
1650478877173,COGS 100,A01,083619,Staff,0,26,60,60
1650478883198,COGS 101A,A01,083621,Davis; Joshua Daniel,0,22,60,60
1650478889221,COGS 101B,A01,091572,Staff,0,4,60,60
1650478895252,COGS 101C,A01,083625,Delgado; Tania,16,0,30,14
1650478901278,COGS 107A,A01,083627,Boyle; Mary E. T.,0,11,60,60
1650478907320,COGS 118A,A01,083075,Staff,0,3,60,60
1650478913346,CSE 3,A50,083646,Miranda; Gregory Joseph,19,0,38,19
1650478913346,CSE 3,A51,083647,Miranda; Gregory Joseph,36,0,37,1
1650478919374,CSE 8A,A50,083650,Miranda; Gregory Joseph,0,28,40,40
1650478925416,CSE 11,A01,083080,Cao; Yingjun,0,92,40,40
1650478931447,CSE 12,A01,083652,Staff,0,16,100,100
1650478937478,CSE 15L,A01,083654,Staff,0,1,50,50
1650478937478,CSE 15L,A02,083655,Staff,1,0,50,49
1650478943504,CSE 20,A01,083657,Staff,51,0,80,29
1650478949527,CSE 30,A01,083084,Eldon; John,0,76,40,40
1650478955551,CSE 100,A01,083659,Cao; Yingjun,0,66,50,50
1650478961580,CSE 134B,A01,083661,Powell; Thomas Allan,0,32,65,65
1650478967616,CSE 140,A01,083663,Staff,0,5,75,75
1650478973639,CSE 140L,A01,083088,Eldon; John,0,9,75,75
1650478979661,CSE 175,A01,083665,Kumar; Rakesh,7,0,25,18
1650478985688,CSE 190,A00,092507,Dubnov; Shlomo,12,0,20,8
1650478991717,ECE 45,A01,083139,Staff,20,19,60,40
1650478997754,ECE 65,A50,083695,Staff,0,6,30,30
1650479003782,ECE 109,A01,091882,Touri; Behrouz,38,0,70,32
1650479009807,ECE 180,A00,083140,Abi Samra; Nicholas Camill,23,0,30,7
1650479009807,ECE 180,B00,083141,Abi Samra; Nicholas Camill,0,0,30,30
1650479015832,MATH 10A,A01,083735,Patchell; Gregory David,6,0,30,24
1650479015832,MATH 10A,A02,083736,Patchell; Gregory David,27,0,30,3
1650479015832,MATH 10A,A03,083737,Patchell; Gregory David,25,0,30,5
1650479021857,MATH 10B,A01,083207,Staff,0,8,30,30
1650479021857,MATH 10B,A02,083208,Staff,0,7,30,30
1650479021857,MATH 10B,B01,083739,Staff,13,0,30,17
1650479021857,MATH 10B,B02,083740,Staff,28,0,30,2
1650479027883,MATH 18,A01,083743,Staff,1,0,30,29
1650479027883,MATH 18,A02,083744,Staff,27,0,30,3
1650479027883,MATH 18,A03,083745,Staff,22,0,30,8
1650479027883,MATH 18,A04,083746,Staff,26,0,30,4
1650479027883,MATH 18,B01,083748,Staff,0,11,30,30
1650479027883,MATH 18,B02,083749,Staff,0,12,30,30
1650479027883,MATH 18,B03,083750,Staff,0,11,30,30
1650479027883,MATH 18,B04,083751,Staff,0,12,30,30
1650479033909,MATH 20A,A01,083754,Staff,25,0,40,15
1650479039932,MATH 20B,A01,083756,Staff,0,10,30,30
1650479039932,MATH 20B,A02,083757,Staff,0,11,30,30
1650479045961,MATH 20C,A01,083760,Staff,0,15,30,30
1650479045961,MATH 20C,A02,083761,Staff,2,15,30,28
1650479045961,MATH 20C,B01,083762,Staff,13,0,30,17
1650479045961,MATH 20C,B02,083763,Staff,28,0,30,2
1650479052001,MATH 20D,A01,083765,Staff,0,1,30,30
1650479052001,MATH 20D,A02,083766,Staff,9,0,30,21
1650479052001,MATH 20D,A03,083767,Staff,25,0,30,5
1650479058029,MATH 20E,A01,083771,Staff,6,0,30,24
1650479058029,MATH 20E,A02,083772,Staff,18,0,30,12
1650479058029,MATH 20E,B01,083773,Staff,0,0,30,30
1650479058029,MATH 20E,B02,083774,Staff,10,0,30,20
1650479064058,MATH 103A,A01,083777,Staff,0,12,30,30
1650479064058,MATH 103A,A02,083778,Staff,0,12,30,30
1650479064058,MATH 103A,B01,083779,Staff,0,13,30,30
1650479064058,MATH 103A,B02,083780,Staff,0,12,30,30
1650479070081,MATH 105,A01,085443,Staff,0,23,30,30
1650479076104,MATH 109,A01,083213,Anzaldo; Leesa B,0,7,30,30
1650479076104,MATH 109,A02,083214,Anzaldo; Leesa B,0,7,30,30
1650479076104,MATH 109,B01,083215,Anzaldo; Leesa B,0,5,30,30
1650479076104,MATH 109,B02,083216,Anzaldo; Leesa B,0,6,30,30
1650479082129,MATH 142A,A01,083219,Chow; Bennett,0,15,30,30
1650479082129,MATH 142A,A02,083220,Chow; Bennett,0,13,30,30
1650479082129,MATH 142A,B01,083221,Chow; Bennett,0,12,30,30
1650479082129,MATH 142A,B02,083222,Chow; Bennett,0,13,30,30
1650479088156,MATH 193A,A01,083224,Staff,0,5,30,30
1650479088156,MATH 193A,A02,083225,Staff,0,5,30,30
1650479088156,MATH 193A,A03,083781,Staff,0,5,30,30
1650479088156,MATH 193A,A04,083782,Staff,0,6,30,30
1650479094183,MATH 197,001,091859,McAuley; Julian John,9998,0,9999,1
1650479100232,COGS 9,A01,083615,Staff,0,14,60,60
1650479106256,COGS 11,A01,083617,Boyle; Mary E. T.,21,0,40,19
1650479112282,COGS 13,A01,083071,Staff,0,34,40,40
1650479118307,COGS 14A,A01,092681,Staff,1,25,100,99
1650479124339,COGS 14B,A01,083073,Cheng; Tzu-Han,0,11,50,50
1650479130364,COGS 17,A01,092677,Staff,21,0,75,54
1650479136388,COGS 100,A01,083619,Staff,0,26,60,60
1650479142412,COGS 101A,A01,083621,Davis; Joshua Daniel,0,22,60,60
1650479148444,COGS 101B,A01,091572,Staff,0,4,60,60
1650479154475,COGS 101C,A01,083625,Delgado; Tania,16,0,30,14
1650479160502,COGS 107A,A01,083627,Boyle; Mary E. T.,0,11,60,60
1650479166528,COGS 118A,A01,083075,Staff,0,3,60,60
1650479172552,CSE 3,A50,083646,Miranda; Gregory Joseph,19,0,38,19
1650479172552,CSE 3,A51,083647,Miranda; Gregory Joseph,36,0,37,1
1650479178580,CSE 8A,A50,083650,Miranda; Gregory Joseph,0,28,40,40
1650479184607,CSE 11,A01,083080,Cao; Yingjun,0,92,40,40
1650479190629,CSE 12,A01,083652,Staff,0,16,100,100
1650479196655,CSE 15L,A01,083654,Staff,0,1,50,50
1650479196655,CSE 15L,A02,083655,Staff,1,0,50,49
1650479202679,CSE 20,A01,083657,Staff,51,0,80,29
1650479208703,CSE 30,A01,083084,Eldon; John,0,76,40,40
1650479214727,CSE 100,A01,083659,Cao; Yingjun,0,66,50,50
1650479220752,CSE 134B,A01,083661,Powell; Thomas Allan,0,32,65,65
1650479226774,CSE 140,A01,083663,Staff,0,5,75,75
1650479232798,CSE 140L,A01,083088,Eldon; John,0,9,75,75
1650479238825,CSE 175,A01,083665,Kumar; Rakesh,7,0,25,18
1650479244859,CSE 190,A00,092507,Dubnov; Shlomo,12,0,20,8
1650479250889,ECE 45,A01,083139,Staff,20,19,60,40
1650479256913,ECE 65,A50,083695,Staff,0,6,30,30
1650479263008,ECE 109,A01,091882,Touri; Behrouz,38,0,70,32
1650479269044,ECE 180,A00,083140,Abi Samra; Nicholas Camill,23,0,30,7
1650479269044,ECE 180,B00,083141,Abi Samra; Nicholas Camill,0,0,30,30
1650479275068,MATH 10A,A01,083735,Patchell; Gregory David,6,0,30,24
1650479275068,MATH 10A,A02,083736,Patchell; Gregory David,27,0,30,3
1650479275068,MATH 10A,A03,083737,Patchell; Gregory David,25,0,30,5
1650479281095,MATH 10B,A01,083207,Staff,0,8,30,30
1650479281095,MATH 10B,A02,083208,Staff,0,7,30,30
1650479281095,MATH 10B,B01,083739,Staff,13,0,30,17
1650479281095,MATH 10B,B02,083740,Staff,28,0,30,2
1650479287130,MATH 18,A01,083743,Staff,1,0,30,29
1650479287130,MATH 18,A02,083744,Staff,27,0,30,3
1650479287130,MATH 18,A03,083745,Staff,22,0,30,8
1650479287130,MATH 18,A04,083746,Staff,26,0,30,4
1650479287130,MATH 18,B01,083748,Staff,0,11,30,30
1650479287130,MATH 18,B02,083749,Staff,0,12,30,30
1650479287130,MATH 18,B03,083750,Staff,0,11,30,30
1650479287130,MATH 18,B04,083751,Staff,0,12,30,30
1650479293162,MATH 20A,A01,083754,Staff,25,0,40,15
1650479299191,MATH 20B,A01,083756,Staff,0,10,30,30
1650479299191,MATH 20B,A02,083757,Staff,0,11,30,30
1650479305244,MATH 20C,A01,083760,Staff,0,15,30,30
1650479305244,MATH 20C,A02,083761,Staff,2,15,30,28
1650479305244,MATH 20C,B01,083762,Staff,13,0,30,17
1650479305244,MATH 20C,B02,083763,Staff,28,0,30,2
1650479311271,MATH 20D,A01,083765,Staff,0,1,30,30
1650479311271,MATH 20D,A02,083766,Staff,9,0,30,21
1650479311271,MATH 20D,A03,083767,Staff,25,0,30,5
1650479317299,MATH 20E,A01,083771,Staff,6,0,30,24
1650479317299,MATH 20E,A02,083772,Staff,18,0,30,12
1650479317299,MATH 20E,B01,083773,Staff,0,0,30,30
1650479317299,MATH 20E,B02,083774,Staff,10,0,30,20
1650479323324,MATH 103A,A01,083777,Staff,0,12,30,30
1650479323324,MATH 103A,A02,083778,Staff,0,12,30,30
1650479323324,MATH 103A,B01,083779,Staff,0,13,30,30
1650479323324,MATH 103A,B02,083780,Staff,0,12,30,30
1650479329349,MATH 105,A01,085443,Staff,0,23,30,30
1650479335372,MATH 109,A01,083213,Anzaldo; Leesa B,0,7,30,30
1650479335372,MATH 109,A02,083214,Anzaldo; Leesa B,0,7,30,30
1650479335372,MATH 109,B01,083215,Anzaldo; Leesa B,0,5,30,30
1650479335372,MATH 109,B02,083216,Anzaldo; Leesa B,0,6,30,30
1650479341401,MATH 142A,A01,083219,Chow; Bennett,0,15,30,30
1650479341401,MATH 142A,A02,083220,Chow; Bennett,0,13,30,30
1650479341401,MATH 142A,B01,083221,Chow; Bennett,0,12,30,30
1650479341401,MATH 142A,B02,083222,Chow; Bennett,0,13,30,30
1650479347425,MATH 193A,A01,083224,Staff,0,5,30,30
1650479347425,MATH 193A,A02,083225,Staff,0,5,30,30
1650479347425,MATH 193A,A03,083781,Staff,0,5,30,30
1650479347425,MATH 193A,A04,083782,Staff,0,6,30,30
1650479353451,MATH 197,001,091859,McAuley; Julian John,9998,0,9999,1
1650479359516,COGS 9,A01,083615,Staff,0,14,60,60
1650479365548,COGS 11,A01,083617,Boyle; Mary E. T.,21,0,40,19
1650479371575,COGS 13,A01,083071,Staff,0,34,40,40
1650479377603,COGS 14A,A01,092681,Staff,1,25,100,99
1650479383627,COGS 14B,A01,083073,Cheng; Tzu-Han,0,11,50,50
1650479389666,COGS 17,A01,092677,Staff,21,0,75,54
1650479395692,COGS 100,A01,083619,Staff,0,26,60,60
1650479401714,COGS 101A,A01,083621,Davis; Joshua Daniel,0,22,60,60
1650479407754,COGS 101B,A01,091572,Staff,0,4,60,60
1650479413780,COGS 101C,A01,083625,Delgado; Tania,16,0,30,14
1650479419804,COGS 107A,A01,083627,Boyle; Mary E. T.,0,11,60,60
1650479425831,COGS 118A,A01,083075,Staff,0,3,60,60
1650479431858,CSE 3,A50,083646,Miranda; Gregory Joseph,20,0,38,18
1650479431858,CSE 3,A51,083647,Miranda; Gregory Joseph,36,0,37,1
1650479437884,CSE 8A,A50,083650,Miranda; Gregory Joseph,0,28,40,40
1650479443911,CSE 11,A01,083080,Cao; Yingjun,0,92,40,40
1650479449934,CSE 12,A01,083652,Staff,0,17,100,100
1650479455958,CSE 15L,A01,083654,Staff,0,1,50,50
1650479455958,CSE 15L,A02,083655,Staff,1,0,50,49
1650479461986,CSE 20,A01,083657,Staff,51,0,80,29
1650479468011,CSE 30,A01,083084,Eldon; John,0,76,40,40
1650479474044,CSE 100,A01,083659,Cao; Yingjun,0,66,50,50
1650479480067,CSE 134B,A01,083661,Powell; Thomas Allan,0,32,65,65
1650479486091,CSE 140,A01,083663,Staff,0,5,75,75
1650479492117,CSE 140L,A01,083088,Eldon; John,0,9,75,75
1650479498149,CSE 175,A01,083665,Kumar; Rakesh,7,0,25,18
1650479504172,CSE 190,A00,092507,Dubnov; Shlomo,12,0,20,8
1650479510197,ECE 45,A01,083139,Staff,20,19,60,40
1650479516224,ECE 65,A50,083695,Staff,0,6,30,30
1650479522249,ECE 109,A01,091882,Touri; Behrouz,38,0,70,32
1650479528279,ECE 180,A00,083140,Abi Samra; Nicholas Camill,22,0,30,8
1650479528279,ECE 180,B00,083141,Abi Samra; Nicholas Camill,0,0,30,30
1650479534308,MATH 10A,A01,083735,Patchell; Gregory David,6,0,30,24
1650479534308,MATH 10A,A02,083736,Patchell; Gregory David,27,0,30,3
1650479534308,MATH 10A,A03,083737,Patchell; Gregory David,25,0,30,5
1650479540335,MATH 10B,A01,083207,Staff,0,8,30,30
1650479540335,MATH 10B,A02,083208,Staff,0,7,30,30
1650479540335,MATH 10B,B01,083739,Staff,13,0,30,17
1650479540335,MATH 10B,B02,083740,Staff,28,0,30,2
1650479546365,MATH 18,A01,083743,Staff,1,0,30,29
1650479546365,MATH 18,A02,083744,Staff,27,0,30,3
1650479546365,MATH 18,A03,083745,Staff,22,0,30,8
1650479546365,MATH 18,A04,083746,Staff,26,0,30,4
1650479546365,MATH 18,B01,083748,Staff,0,11,30,30
1650479546365,MATH 18,B02,083749,Staff,0,12,30,30
1650479546365,MATH 18,B03,083750,Staff,0,11,30,30
1650479546365,MATH 18,B04,083751,Staff,0,12,30,30
1650479552391,MATH 20A,A01,083754,Staff,25,0,40,15
1650479558415,MATH 20B,A01,083756,Staff,0,10,30,30
1650479558415,MATH 20B,A02,083757,Staff,0,11,30,30
1650479564437,MATH 20C,A01,083760,Staff,0,15,30,30
1650479564437,MATH 20C,A02,083761,Staff,2,15,30,28
1650479564437,MATH 20C,B01,083762,Staff,13,0,30,17
1650479564437,MATH 20C,B02,083763,Staff,28,0,30,2
1650479570460,MATH 20D,A01,083765,Staff,0,1,30,30
1650479570460,MATH 20D,A02,083766,Staff,9,0,30,21
1650479570460,MATH 20D,A03,083767,Staff,25,0,30,5
1650479576483,MATH 20E,A01,083771,Staff,6,0,30,24
1650479576483,MATH 20E,A02,083772,Staff,18,0,30,12
1650479576483,MATH 20E,B01,083773,Staff,0,0,30,30
1650479576483,MATH 20E,B02,083774,Staff,10,0,30,20
1650479582528,MATH 103A,A01,083777,Staff,0,12,30,30
1650479582528,MATH 103A,A02,083778,Staff,0,12,30,30
1650479582528,MATH 103A,B01,083779,Staff,0,13,30,30
1650479582528,MATH 103A,B02,083780,Staff,0,12,30,30
1650479588562,MATH 105,A01,085443,Staff,0,23,30,30
1650479594588,MATH 109,A01,083213,Anzaldo; Leesa B,0,7,30,30
1650479594588,MATH 109,A02,083214,Anzaldo; Leesa B,0,7,30,30
1650479594588,MATH 109,B01,083215,Anzaldo; Leesa B,0,5,30,30
1650479594588,MATH 109,B02,083216,Anzaldo; Leesa B,0,6,30,30
1650479600613,MATH 142A,A01,083219,Chow; Bennett,0,15,30,30
1650479600613,MATH 142A,A02,083220,Chow; Bennett,0,13,30,30
1650479600613,MATH 142A,B01,083221,Chow; Bennett,0,12,30,30
1650479600613,MATH 142A,B02,083222,Chow; Bennett,0,13,30,30
1650479606646,MATH 193A,A01,083224,Staff,0,5,30,30
1650479606646,MATH 193A,A02,083225,Staff,0,5,30,30
1650479606646,MATH 193A,A03,083781,Staff,0,5,30,30
1650479606646,MATH 193A,A04,083782,Staff,0,6,30,30
1650479612672,MATH 197,001,091859,McAuley; Julian John,9998,0,9999,1
1650479618741,COGS 9,A01,083615,Staff,0,14,60,60
1650479624769,COGS 11,A01,083617,Boyle; Mary E. T.,20,0,40,20
1650479630793,COGS 13,A01,083071,Staff,0,34,40,40
1650479636821,COGS 14A,A01,092681,Staff,1,25,100,99
1650479642846,COGS 14B,A01,083073,Cheng; Tzu-Han,0,11,50,50
1650479648874,COGS 17,A01,092677,Staff,21,0,75,54
1650479654899,COGS 100,A01,083619,Staff,0,26,60,60
1650479660923,COGS 101A,A01,083621,Davis; Joshua Daniel,0,22,60,60
1650479666951,COGS 101B,A01,091572,Staff,0,4,60,60
1650479672973,COGS 101C,A01,083625,Delgado; Tania,16,0,30,14
1650479678999,COGS 107A,A01,083627,Boyle; Mary E. T.,0,11,60,60
1650479685044,COGS 118A,A01,083075,Staff,0,3,60,60
1650479691068,CSE 3,A50,083646,Miranda; Gregory Joseph,20,0,38,18
1650479691068,CSE 3,A51,083647,Miranda; Gregory Joseph,36,0,37,1
1650479697092,CSE 8A,A50,083650,Miranda; Gregory Joseph,0,28,40,40
1650479703115,CSE 11,A01,083080,Cao; Yingjun,0,92,40,40
1650479709142,CSE 12,A01,083652,Staff,0,17,100,100
1650479715174,CSE 15L,A01,083654,Staff,0,1,50,50
1650479715174,CSE 15L,A02,083655,Staff,1,0,50,49
1650479721208,CSE 20,A01,083657,Staff,51,0,80,29
1650479727235,CSE 30,A01,083084,Eldon; John,0,76,40,40
1650479733261,CSE 100,A01,083659,Cao; Yingjun,0,66,50,50
1650479739285,CSE 134B,A01,083661,Powell; Thomas Allan,0,32,65,65
1650479745320,CSE 140,A01,083663,Staff,0,5,75,75
1650479751346,CSE 140L,A01,083088,Eldon; John,0,9,75,75
1650479757370,CSE 175,A01,083665,Kumar; Rakesh,7,0,25,18
1650479763395,CSE 190,A00,092507,Dubnov; Shlomo,12,0,20,8
1650479769426,ECE 45,A01,083139,Staff,20,19,60,40
1650479775461,ECE 65,A50,083695,Staff,0,6,30,30
1650479781493,ECE 109,A01,091882,Touri; Behrouz,38,0,70,32
1650479787520,ECE 180,A00,083140,Abi Samra; Nicholas Camill,22,0,30,8
1650479787520,ECE 180,B00,083141,Abi Samra; Nicholas Camill,0,0,30,30
1650479793543,MATH 10A,A01,083735,Patchell; Gregory David,6,0,30,24
1650479793543,MATH 10A,A02,083736,Patchell; Gregory David,27,0,30,3
1650479793543,MATH 10A,A03,083737,Patchell; Gregory David,25,0,30,5
1650479799570,MATH 10B,A01,083207,Staff,0,8,30,30
1650479799570,MATH 10B,A02,083208,Staff,0,7,30,30
1650479799570,MATH 10B,B01,083739,Staff,13,0,30,17
1650479799570,MATH 10B,B02,083740,Staff,28,0,30,2
1650479805593,MATH 18,A01,083743,Staff,1,0,30,29
1650479805593,MATH 18,A02,083744,Staff,27,0,30,3
1650479805593,MATH 18,A03,083745,Staff,22,0,30,8
1650479805593,MATH 18,A04,083746,Staff,26,0,30,4
1650479805593,MATH 18,B01,083748,Staff,0,11,30,30
1650479805593,MATH 18,B02,083749,Staff,0,12,30,30
1650479805593,MATH 18,B03,083750,Staff,0,11,30,30
1650479805593,MATH 18,B04,083751,Staff,0,12,30,30
1650479811625,MATH 20A,A01,083754,Staff,25,0,40,15
1650479817648,MATH 20B,A01,083756,Staff,0,10,30,30
1650479817648,MATH 20B,A02,083757,Staff,0,11,30,30
1650479823686,MATH 20C,A01,083760,Staff,0,15,30,30
1650479823686,MATH 20C,A02,083761,Staff,2,15,30,28
1650479823686,MATH 20C,B01,083762,Staff,13,0,30,17
1650479823686,MATH 20C,B02,083763,Staff,28,0,30,2
1650479829712,MATH 20D,A01,083765,Staff,0,1,30,30
1650479829712,MATH 20D,A02,083766,Staff,9,0,30,21
1650479829712,MATH 20D,A03,083767,Staff,25,0,30,5
1650479835733,MATH 20E,A01,083771,Staff,6,0,30,24
1650479835733,MATH 20E,A02,083772,Staff,18,0,30,12
1650479835733,MATH 20E,B01,083773,Staff,0,0,30,30
1650479835733,MATH 20E,B02,083774,Staff,10,0,30,20
1650479841764,MATH 103A,A01,083777,Staff,0,12,30,30
1650479841764,MATH 103A,A02,083778,Staff,0,12,30,30
1650479841764,MATH 103A,B01,083779,Staff,0,13,30,30
1650479841764,MATH 103A,B02,083780,Staff,0,12,30,30
1650479847800,MATH 105,A01,085443,Staff,0,23,30,30
1650479853827,MATH 109,A01,083213,Anzaldo; Leesa B,0,7,30,30
1650479853827,MATH 109,A02,083214,Anzaldo; Leesa B,0,7,30,30
1650479853827,MATH 109,B01,083215,Anzaldo; Leesa B,0,5,30,30
1650479853827,MATH 109,B02,083216,Anzaldo; Leesa B,0,6,30,30
1650479859942,MATH 142A,A01,083219,Chow; Bennett,0,15,30,30
1650479859942,MATH 142A,A02,083220,Chow; Bennett,0,13,30,30
1650479859942,MATH 142A,B01,083221,Chow; Bennett,0,12,30,30
1650479859942,MATH 142A,B02,083222,Chow; Bennett,0,13,30,30
1650479865979,MATH 193A,A01,083224,Staff,0,5,30,30
1650479865979,MATH 193A,A02,083225,Staff,0,5,30,30
1650479865979,MATH 193A,A03,083781,Staff,0,5,30,30
1650479865979,MATH 193A,A04,083782,Staff,0,6,30,30
1650479872004,MATH 197,001,091859,McAuley; Julian John,9998,0,9999,1
1650479878063,COGS 9,A01,083615,Staff,0,14,60,60
1650479884085,COGS 11,A01,083617,Boyle; Mary E. T.,20,0,40,20
1650479890110,COGS 13,A01,083071,Staff,0,34,40,40
1650479896137,COGS 14A,A01,092681,Staff,1,25,100,99
1650479902172,COGS 14B,A01,083073,Cheng; Tzu-Han,0,11,50,50
1650479908201,COGS 17,A01,092677,Staff,22,0,75,53
1650479914224,COGS 100,A01,083619,Staff,0,26,60,60
1650479920250,COGS 101A,A01,083621,Davis; Joshua Daniel,0,22,60,60
1650479926275,COGS 101B,A01,091572,Staff,0,4,60,60
1650479932315,COGS 101C,A01,083625,Delgado; Tania,16,0,30,14
1650479938352,COGS 107A,A01,083627,Boyle; Mary E. T.,0,11,60,60
1650479944379,COGS 118A,A01,083075,Staff,0,3,60,60
1650479950403,CSE 3,A50,083646,Miranda; Gregory Joseph,20,0,38,18
1650479950403,CSE 3,A51,083647,Miranda; Gregory Joseph,36,0,37,1
1650479956427,CSE 8A,A50,083650,Miranda; Gregory Joseph,0,28,40,40
1650479962449,CSE 11,A01,083080,Cao; Yingjun,0,92,40,40
1650479968479,CSE 12,A01,083652,Staff,0,17,100,100
1650479974510,CSE 15L,A01,083654,Staff,0,1,50,50
1650479974510,CSE 15L,A02,083655,Staff,1,0,50,49
1650479980534,CSE 20,A01,083657,Staff,51,0,80,29
1650479986556,CSE 30,A01,083084,Eldon; John,0,76,40,40
1650479992585,CSE 100,A01,083659,Cao; Yingjun,0,66,50,50
1650479998615,CSE 134B,A01,083661,Powell; Thomas Allan,0,32,65,65
1650480004641,CSE 140,A01,083663,Staff,0,5,75,75
1650480010665,CSE 140L,A01,083088,Eldon; John,0,9,75,75
1650480016692,CSE 175,A01,083665,Kumar; Rakesh,7,0,25,18
1650480022715,CSE 190,A00,092507,Dubnov; Shlomo,12,0,20,8
1650480028737,ECE 45,A01,083139,Staff,20,19,60,40
1650480034762,ECE 65,A50,083695,Staff,0,6,30,30
1650480040793,ECE 109,A01,091882,Touri; Behrouz,38,0,70,32
1650480046833,ECE 180,A00,083140,Abi Samra; Nicholas Camill,22,0,30,8
1650480046833,ECE 180,B00,083141,Abi Samra; Nicholas Camill,0,0,30,30
1650480052859,MATH 10A,A01,083735,Patchell; Gregory David,5,0,30,25
1650480052859,MATH 10A,A02,083736,Patchell; Gregory David,27,0,30,3
1650480052859,MATH 10A,A03,083737,Patchell; Gregory David,25,0,30,5
1650480058885,MATH 10B,A01,083207,Staff,0,8,30,30
1650480058885,MATH 10B,A02,083208,Staff,0,7,30,30
1650480058885,MATH 10B,B01,083739,Staff,13,0,30,17
1650480058885,MATH 10B,B02,083740,Staff,28,0,30,2
1650480064908,MATH 18,A01,083743,Staff,1,0,30,29
1650480064908,MATH 18,A02,083744,Staff,27,0,30,3
1650480064908,MATH 18,A03,083745,Staff,22,0,30,8
1650480064908,MATH 18,A04,083746,Staff,26,0,30,4
1650480064908,MATH 18,B01,083748,Staff,0,11,30,30
1650480064908,MATH 18,B02,083749,Staff,0,12,30,30
1650480064908,MATH 18,B03,083750,Staff,0,11,30,30
1650480064908,MATH 18,B04,083751,Staff,0,12,30,30
1650480070931,MATH 20A,A01,083754,Staff,25,0,40,15
1650480076955,MATH 20B,A01,083756,Staff,0,10,30,30
1650480076955,MATH 20B,A02,083757,Staff,0,11,30,30
1650480082980,MATH 20C,A01,083760,Staff,0,15,30,30
1650480082980,MATH 20C,A02,083761,Staff,2,15,30,28
1650480082980,MATH 20C,B01,083762,Staff,13,0,30,17
1650480082980,MATH 20C,B02,083763,Staff,28,0,30,2
1650480089009,MATH 20D,A01,083765,Staff,0,1,30,30
1650480089009,MATH 20D,A02,083766,Staff,9,0,30,21
1650480089009,MATH 20D,A03,083767,Staff,25,0,30,5
1650480095033,MATH 20E,A01,083771,Staff,6,0,30,24
1650480095033,MATH 20E,A02,083772,Staff,18,0,30,12
1650480095033,MATH 20E,B01,083773,Staff,0,0,30,30
1650480095033,MATH 20E,B02,083774,Staff,10,0,30,20
1650480101059,MATH 103A,A01,083777,Staff,0,12,30,30
1650480101059,MATH 103A,A02,083778,Staff,0,12,30,30
1650480101059,MATH 103A,B01,083779,Staff,0,13,30,30
1650480101059,MATH 103A,B02,083780,Staff,0,12,30,30
1650480107092,MATH 105,A01,085443,Staff,0,23,30,30
1650480113116,MATH 109,A01,083213,Anzaldo; Leesa B,0,7,30,30
1650480113116,MATH 109,A02,083214,Anzaldo; Leesa B,0,7,30,30
1650480113116,MATH 109,B01,083215,Anzaldo; Leesa B,0,5,30,30
1650480113116,MATH 109,B02,083216,Anzaldo; Leesa B,0,6,30,30
1650480119140,MATH 142A,A01,083219,Chow; Bennett,0,15,30,30
1650480119140,MATH 142A,A02,083220,Chow; Bennett,0,13,30,30
1650480119140,MATH 142A,B01,083221,Chow; Bennett,0,12,30,30
1650480119140,MATH 142A,B02,083222,Chow; Bennett,0,13,30,30
1650480125167,MATH 193A,A01,083224,Staff,0,5,30,30
1650480125167,MATH 193A,A02,083225,Staff,0,5,30,30
1650480125167,MATH 193A,A03,083781,Staff,0,5,30,30
1650480125167,MATH 193A,A04,083782,Staff,0,6,30,30
1650480131191,MATH 197,001,091859,McAuley; Julian John,9998,0,9999,1
1650480137255,COGS 9,A01,083615,Staff,0,14,60,60
1650480143277,COGS 11,A01,083617,Boyle; Mary E. T.,20,0,40,20
1650480149306,COGS 13,A01,083071,Staff,0,34,40,40
1650480155338,COGS 14A,A01,092681,Staff,1,25,100,99
1650480161362,COGS 14B,A01,083073,Cheng; Tzu-Han,0,11,50,50
1650480167395,COGS 17,A01,092677,Staff,22,0,75,53
1650480173419,COGS 100,A01,083619,Staff,0,26,60,60
1650480179445,COGS 101A,A01,083621,Davis; Joshua Daniel,0,22,60,60
1650480185480,COGS 101B,A01,091572,Staff,0,4,60,60
1650480191519,COGS 101C,A01,083625,Delgado; Tania,16,0,30,14
1650480197542,COGS 107A,A01,083627,Boyle; Mary E. T.,0,11,60,60
1650480203572,COGS 118A,A01,083075,Staff,0,3,60,60
1650480209604,CSE 3,A50,083646,Miranda; Gregory Joseph,20,0,38,18
1650480209604,CSE 3,A51,083647,Miranda; Gregory Joseph,36,0,37,1
1650480215639,CSE 8A,A50,083650,Miranda; Gregory Joseph,0,28,40,40
1650480221663,CSE 11,A01,083080,Cao; Yingjun,0,92,40,40
1650480227689,CSE 12,A01,083652,Staff,0,17,100,100
1650480233715,CSE 15L,A01,083654,Staff,0,1,50,50
1650480233715,CSE 15L,A02,083655,Staff,1,0,50,49
1650480239743,CSE 20,A01,083657,Staff,51,0,80,29
1650480245765,CSE 30,A01,083084,Eldon; John,0,76,40,40
1650480251790,CSE 100,A01,083659,Cao; Yingjun,0,66,50,50
1650480257816,CSE 134B,A01,083661,Powell; Thomas Allan,0,32,65,65
1650480263839,CSE 140,A01,083663,Staff,0,5,75,75
1650480269871,CSE 140L,A01,083088,Eldon; John,0,9,75,75
1650480275905,CSE 175,A01,083665,Kumar; Rakesh,7,0,25,18
1650480281929,CSE 190,A00,092507,Dubnov; Shlomo,12,0,20,8
1650480287952,ECE 45,A01,083139,Staff,20,19,60,40
1650480293978,ECE 65,A50,083695,Staff,0,6,30,30
1650480300005,ECE 109,A01,091882,Touri; Behrouz,38,0,70,32
1650480306041,ECE 180,A00,083140,Abi Samra; Nicholas Camill,22,0,30,8
1650480306041,ECE 180,B00,083141,Abi Samra; Nicholas Camill,0,0,30,30
1650480312074,MATH 10A,A01,083735,Patchell; Gregory David,5,0,30,25
1650480312074,MATH 10A,A02,083736,Patchell; Gregory David,27,0,30,3
1650480312074,MATH 10A,A03,083737,Patchell; Gregory David,25,0,30,5
1650480318098,MATH 10B,A01,083207,Staff,0,8,30,30
1650480318098,MATH 10B,A02,083208,Staff,0,7,30,30
1650480318098,MATH 10B,B01,083739,Staff,13,0,30,17
1650480318098,MATH 10B,B02,083740,Staff,28,0,30,2
1650480324123,MATH 18,A01,083743,Staff,1,0,30,29
1650480324123,MATH 18,A02,083744,Staff,27,0,30,3
1650480324123,MATH 18,A03,083745,Staff,22,0,30,8
1650480324123,MATH 18,A04,083746,Staff,26,0,30,4
1650480324123,MATH 18,B01,083748,Staff,0,11,30,30
1650480324123,MATH 18,B02,083749,Staff,0,12,30,30
1650480324123,MATH 18,B03,083750,Staff,0,11,30,30
1650480324123,MATH 18,B04,083751,Staff,0,12,30,30
1650480330146,MATH 20A,A01,083754,Staff,25,0,40,15
1650480336175,MATH 20B,A01,083756,Staff,0,10,30,30
1650480336175,MATH 20B,A02,083757,Staff,0,11,30,30
1650480342199,MATH 20C,A01,083760,Staff,0,15,30,30
1650480342199,MATH 20C,A02,083761,Staff,2,15,30,28
1650480342199,MATH 20C,B01,083762,Staff,13,0,30,17
1650480342199,MATH 20C,B02,083763,Staff,28,0,30,2
1650480348226,MATH 20D,A01,083765,Staff,0,1,30,30
1650480348226,MATH 20D,A02,083766,Staff,9,0,30,21
1650480348226,MATH 20D,A03,083767,Staff,25,0,30,5
1650480354249,MATH 20E,A01,083771,Staff,6,0,30,24
1650480354249,MATH 20E,A02,083772,Staff,18,0,30,12
1650480354249,MATH 20E,B01,083773,Staff,0,0,30,30
1650480354249,MATH 20E,B02,083774,Staff,10,0,30,20
1650480360291,MATH 103A,A01,083777,Staff,0,12,30,30
1650480360291,MATH 103A,A02,083778,Staff,0,12,30,30
1650480360291,MATH 103A,B01,083779,Staff,0,13,30,30
1650480360291,MATH 103A,B02,083780,Staff,0,12,30,30
1650480366318,MATH 105,A01,085443,Staff,0,23,30,30
1650480372341,MATH 109,A01,083213,Anzaldo; Leesa B,0,7,30,30
1650480372341,MATH 109,A02,083214,Anzaldo; Leesa B,0,7,30,30
1650480372341,MATH 109,B01,083215,Anzaldo; Leesa B,0,5,30,30
1650480372341,MATH 109,B02,083216,Anzaldo; Leesa B,0,6,30,30
1650480378368,MATH 142A,A01,083219,Chow; Bennett,0,15,30,30
1650480378368,MATH 142A,A02,083220,Chow; Bennett,0,13,30,30
1650480378368,MATH 142A,B01,083221,Chow; Bennett,0,12,30,30
1650480378368,MATH 142A,B02,083222,Chow; Bennett,0,13,30,30
1650480384396,MATH 193A,A01,083224,Staff,0,5,30,30
1650480384396,MATH 193A,A02,083225,Staff,0,5,30,30
1650480384396,MATH 193A,A03,083781,Staff,0,5,30,30
1650480384396,MATH 193A,A04,083782,Staff,0,6,30,30
1650480390422,MATH 197,001,091859,McAuley; Julian John,9998,0,9999,1
1650480396509,COGS 9,A01,083615,Staff,0,14,60,60
1650480402533,COGS 11,A01,083617,Boyle; Mary E. T.,20,0,40,20
1650480408559,COGS 13,A01,083071,Staff,0,34,40,40
1650480414586,COGS 14A,A01,092681,Staff,1,25,100,99
1650480420628,COGS 14B,A01,083073,Cheng; Tzu-Han,0,11,50,50
1650480426652,COGS 17,A01,092677,Staff,22,0,75,53
1650480432677,COGS 100,A01,083619,Staff,0,26,60,60
1650480438703,COGS 101A,A01,083621,Davis; Joshua Daniel,0,22,60,60
1650480444727,COGS 101B,A01,091572,Staff,0,4,60,60
1650480450838,COGS 101C,A01,083625,Delgado; Tania,16,0,30,14
1650480456880,COGS 107A,A01,083627,Boyle; Mary E. T.,0,11,60,60
1650480462906,COGS 118A,A01,083075,Staff,0,3,60,60
1650480468935,CSE 3,A50,083646,Miranda; Gregory Joseph,20,0,38,18
1650480468935,CSE 3,A51,083647,Miranda; Gregory Joseph,36,0,37,1
1650480474961,CSE 8A,A50,083650,Miranda; Gregory Joseph,0,28,40,40
1650480480992,CSE 11,A01,083080,Cao; Yingjun,0,92,40,40
1650480487023,CSE 12,A01,083652,Staff,0,17,100,100
1650480493050,CSE 15L,A01,083654,Staff,0,1,50,50
1650480493050,CSE 15L,A02,083655,Staff,0,0,50,50
1650480499075,CSE 20,A01,083657,Staff,51,0,80,29
1650480505097,CSE 30,A01,083084,Eldon; John,0,76,40,40
1650480511125,CSE 100,A01,083659,Cao; Yingjun,0,66,50,50
1650480517150,CSE 134B,A01,083661,Powell; Thomas Allan,0,32,65,65
1650480523173,CSE 140,A01,083663,Staff,0,5,75,75
1650480529197,CSE 140L,A01,083088,Eldon; John,0,9,75,75
1650480535224,CSE 175,A01,083665,Kumar; Rakesh,7,0,25,18
1650480541250,CSE 190,A00,092507,Dubnov; Shlomo,12,0,20,8
1650480547273,ECE 45,A01,083139,Staff,20,19,60,40
1650480553296,ECE 65,A50,083695,Staff,0,6,30,30
1650480559320,ECE 109,A01,091882,Touri; Behrouz,38,0,70,32
1650480565345,ECE 180,A00,083140,Abi Samra; Nicholas Camill,22,0,30,8
1650480565345,ECE 180,B00,083141,Abi Samra; Nicholas Camill,0,0,30,30
1650480571368,MATH 10A,A01,083735,Patchell; Gregory David,5,0,30,25
1650480571368,MATH 10A,A02,083736,Patchell; Gregory David,27,0,30,3
1650480571368,MATH 10A,A03,083737,Patchell; Gregory David,25,0,30,5
1650480577394,MATH 10B,A01,083207,Staff,0,8,30,30
1650480577394,MATH 10B,A02,083208,Staff,0,7,30,30
1650480577394,MATH 10B,B01,083739,Staff,13,0,30,17
1650480577394,MATH 10B,B02,083740,Staff,28,0,30,2
1650480583423,MATH 18,A01,083743,Staff,1,0,30,29
1650480583423,MATH 18,A02,083744,Staff,27,0,30,3
1650480583423,MATH 18,A03,083745,Staff,22,0,30,8
1650480583423,MATH 18,A04,083746,Staff,26,0,30,4
1650480583423,MATH 18,B01,083748,Staff,0,11,30,30
1650480583423,MATH 18,B02,083749,Staff,0,12,30,30
1650480583423,MATH 18,B03,083750,Staff,0,11,30,30
1650480583423,MATH 18,B04,083751,Staff,0,12,30,30
1650480589447,MATH 20A,A01,083754,Staff,25,0,40,15
1650480595471,MATH 20B,A01,083756,Staff,0,10,30,30
1650480595471,MATH 20B,A02,083757,Staff,0,11,30,30
1650480601497,MATH 20C,A01,083760,Staff,0,15,30,30
1650480601497,MATH 20C,A02,083761,Staff,2,15,30,28
1650480601497,MATH 20C,B01,083762,Staff,13,0,30,17
1650480601497,MATH 20C,B02,083763,Staff,28,0,30,2
1650480607521,MATH 20D,A01,083765,Staff,0,1,30,30
1650480607521,MATH 20D,A02,083766,Staff,9,0,30,21
1650480607521,MATH 20D,A03,083767,Staff,25,0,30,5
1650480613552,MATH 20E,A01,083771,Staff,6,0,30,24
1650480613552,MATH 20E,A02,083772,Staff,18,0,30,12
1650480613552,MATH 20E,B01,083773,Staff,0,0,30,30
1650480613552,MATH 20E,B02,083774,Staff,10,0,30,20
1650480619576,MATH 103A,A01,083777,Staff,0,12,30,30
1650480619576,MATH 103A,A02,083778,Staff,0,12,30,30
1650480619576,MATH 103A,B01,083779,Staff,0,13,30,30
1650480619576,MATH 103A,B02,083780,Staff,0,12,30,30
1650480625599,MATH 105,A01,085443,Staff,0,23,30,30
1650480631622,MATH 109,A01,083213,Anzaldo; Leesa B,0,7,30,30
1650480631622,MATH 109,A02,083214,Anzaldo; Leesa B,0,7,30,30
1650480631622,MATH 109,B01,083215,Anzaldo; Leesa B,0,5,30,30
1650480631622,MATH 109,B02,083216,Anzaldo; Leesa B,0,6,30,30
1650480637654,MATH 142A,A01,083219,Chow; Bennett,0,15,30,30
1650480637654,MATH 142A,A02,083220,Chow; Bennett,0,13,30,30
1650480637654,MATH 142A,B01,083221,Chow; Bennett,0,12,30,30
1650480637654,MATH 142A,B02,083222,Chow; Bennett,0,13,30,30
1650480643677,MATH 193A,A01,083224,Staff,0,5,30,30
1650480643677,MATH 193A,A02,083225,Staff,0,5,30,30
1650480643677,MATH 193A,A03,083781,Staff,0,5,30,30
1650480643677,MATH 193A,A04,083782,Staff,0,6,30,30
1650480649710,MATH 197,001,091859,McAuley; Julian John,9998,0,9999,1
1650480655775,COGS 9,A01,083615,Staff,0,14,60,60
1650480661804,COGS 11,A01,083617,Boyle; Mary E. T.,20,0,40,20
1650480667828,COGS 13,A01,083071,Staff,0,34,40,40
1650480673851,COGS 14A,A01,092681,Staff,1,25,100,99
1650480679887,COGS 14B,A01,083073,Cheng; Tzu-Han,0,11,50,50
1650480685911,COGS 17,A01,092677,Staff,22,0,75,53
1650480691941,COGS 100,A01,083619,Staff,0,26,60,60
1650480697974,COGS 101A,A01,083621,Davis; Joshua Daniel,0,22,60,60
1650480704000,COGS 101B,A01,091572,Staff,0,4,60,60
1650480710041,COGS 101C,A01,083625,Delgado; Tania,16,0,30,14
1650480716079,COGS 107A,A01,083627,Boyle; Mary E. T.,0,11,60,60
1650480722102,COGS 118A,A01,083075,Staff,0,3,60,60
1650480728125,CSE 3,A50,083646,Miranda; Gregory Joseph,20,0,38,18
1650480728125,CSE 3,A51,083647,Miranda; Gregory Joseph,36,0,37,1
1650480734149,CSE 8A,A50,083650,Miranda; Gregory Joseph,0,28,40,40
1650480740178,CSE 11,A01,083080,Cao; Yingjun,0,92,40,40
1650480746203,CSE 12,A01,083652,Staff,0,17,100,100
1650480752235,CSE 15L,A01,083654,Staff,0,1,50,50
1650480752235,CSE 15L,A02,083655,Staff,0,0,50,50
1650480758260,CSE 20,A01,083657,Staff,51,0,80,29
1650480764290,CSE 30,A01,083084,Eldon; John,0,76,40,40
1650480770314,CSE 100,A01,083659,Cao; Yingjun,0,66,50,50
1650480776344,CSE 134B,A01,083661,Powell; Thomas Allan,0,32,65,65
1650480782368,CSE 140,A01,083663,Staff,0,5,75,75
1650480788399,CSE 140L,A01,083088,Eldon; John,0,9,75,75
1650480794422,CSE 175,A01,083665,Kumar; Rakesh,7,0,25,18
1650480800451,CSE 190,A00,092507,Dubnov; Shlomo,12,0,20,8
1650480806499,ECE 45,A01,083139,Staff,20,19,60,40
1650480812543,ECE 65,A50,083695,Staff,0,6,30,30
1650480818571,ECE 109,A01,091882,Touri; Behrouz,38,0,70,32
1650480824595,ECE 180,A00,083140,Abi Samra; Nicholas Camill,22,0,30,8
1650480824595,ECE 180,B00,083141,Abi Samra; Nicholas Camill,0,0,30,30
1650480830622,MATH 10A,A01,083735,Patchell; Gregory David,5,0,30,25
1650480830622,MATH 10A,A02,083736,Patchell; Gregory David,27,0,30,3
1650480830622,MATH 10A,A03,083737,Patchell; Gregory David,25,0,30,5
1650480836653,MATH 10B,A01,083207,Staff,0,8,30,30
1650480836653,MATH 10B,A02,083208,Staff,0,7,30,30
1650480836653,MATH 10B,B01,083739,Staff,13,0,30,17
1650480836653,MATH 10B,B02,083740,Staff,28,0,30,2
1650480842678,MATH 18,A01,083743,Staff,1,0,30,29
1650480842678,MATH 18,A02,083744,Staff,27,0,30,3
1650480842678,MATH 18,A03,083745,Staff,22,0,30,8
1650480842678,MATH 18,A04,083746,Staff,26,0,30,4
1650480842678,MATH 18,B01,083748,Staff,0,11,30,30
1650480842678,MATH 18,B02,083749,Staff,0,12,30,30
1650480842678,MATH 18,B03,083750,Staff,0,11,30,30
1650480842678,MATH 18,B04,083751,Staff,0,12,30,30
1650480848702,MATH 20A,A01,083754,Staff,25,0,40,15
1650480854729,MATH 20B,A01,083756,Staff,0,10,30,30
1650480854729,MATH 20B,A02,083757,Staff,0,11,30,30
1650480860760,MATH 20C,A01,083760,Staff,0,15,30,30
1650480860760,MATH 20C,A02,083761,Staff,2,15,30,28
1650480860760,MATH 20C,B01,083762,Staff,13,0,30,17
1650480860760,MATH 20C,B02,083763,Staff,28,0,30,2
1650480866788,MATH 20D,A01,083765,Staff,0,1,30,30
1650480866788,MATH 20D,A02,083766,Staff,9,0,30,21
1650480866788,MATH 20D,A03,083767,Staff,25,0,30,5
1650480872817,MATH 20E,A01,083771,Staff,6,0,30,24
1650480872817,MATH 20E,A02,083772,Staff,18,0,30,12
1650480872817,MATH 20E,B01,083773,Staff,0,0,30,30
1650480872817,MATH 20E,B02,083774,Staff,10,0,30,20
1650480878850,MATH 103A,A01,083777,Staff,0,12,30,30
1650480878850,MATH 103A,A02,083778,Staff,0,12,30,30
1650480878850,MATH 103A,B01,083779,Staff,0,13,30,30
1650480878850,MATH 103A,B02,083780,Staff,0,12,30,30
1650480884873,MATH 105,A01,085443,Staff,0,23,30,30
1650480890902,MATH 109,A01,083213,Anzaldo; Leesa B,0,7,30,30
1650480890902,MATH 109,A02,083214,Anzaldo; Leesa B,0,7,30,30
1650480890902,MATH 109,B01,083215,Anzaldo; Leesa B,0,5,30,30
1650480890902,MATH 109,B02,083216,Anzaldo; Leesa B,0,6,30,30
1650480896928,MATH 142A,A01,083219,Chow; Bennett,0,15,30,30
1650480896928,MATH 142A,A02,083220,Chow; Bennett,0,13,30,30
1650480896928,MATH 142A,B01,083221,Chow; Bennett,0,12,30,30
1650480896928,MATH 142A,B02,083222,Chow; Bennett,0,13,30,30
1650480902952,MATH 193A,A01,083224,Staff,0,5,30,30
1650480902952,MATH 193A,A02,083225,Staff,0,5,30,30
1650480902952,MATH 193A,A03,083781,Staff,0,5,30,30
1650480902952,MATH 193A,A04,083782,Staff,0,6,30,30
1650480908976,MATH 197,001,091859,McAuley; Julian John,9998,0,9999,1
1650480915048,COGS 9,A01,083615,Staff,0,14,60,60
1650480921081,COGS 11,A01,083617,Boyle; Mary E. T.,20,0,40,20
1650480927109,COGS 13,A01,083071,Staff,0,34,40,40
1650480933131,COGS 14A,A01,092681,Staff,1,25,100,99
1650480939158,COGS 14B,A01,083073,Cheng; Tzu-Han,0,11,50,50
1650480945183,COGS 17,A01,092677,Staff,22,0,75,53
1650480951208,COGS 100,A01,083619,Staff,0,26,60,60
1650480957234,COGS 101A,A01,083621,Davis; Joshua Daniel,0,22,60,60
1650480963262,COGS 101B,A01,091572,Staff,0,4,60,60
1650480969285,COGS 101C,A01,083625,Delgado; Tania,16,0,30,14
1650480975311,COGS 107A,A01,083627,Boyle; Mary E. T.,0,11,60,60
1650480981339,COGS 118A,A01,083075,Staff,0,3,60,60
1650480987363,CSE 3,A50,083646,Miranda; Gregory Joseph,20,0,38,18
1650480987363,CSE 3,A51,083647,Miranda; Gregory Joseph,36,0,37,1
1650480993385,CSE 8A,A50,083650,Miranda; Gregory Joseph,0,28,40,40
1650480999408,CSE 11,A01,083080,Cao; Yingjun,0,92,40,40
1650481005439,CSE 12,A01,083652,Staff,0,17,100,100
1650481011470,CSE 15L,A01,083654,Staff,0,1,50,50
1650481011470,CSE 15L,A02,083655,Staff,0,0,50,50
1650481017493,CSE 20,A01,083657,Staff,51,0,80,29
1650481023515,CSE 30,A01,083084,Eldon; John,0,76,40,40
1650481029538,CSE 100,A01,083659,Cao; Yingjun,0,66,50,50
1650481035559,CSE 134B,A01,083661,Powell; Thomas Allan,0,32,65,65
1650481041582,CSE 140,A01,083663,Staff,0,5,75,75
1650481047678,CSE 140L,A01,083088,Eldon; John,0,9,75,75
1650481053701,CSE 175,A01,083665,Kumar; Rakesh,7,0,25,18
1650481059724,CSE 190,A00,092507,Dubnov; Shlomo,12,0,20,8
1650481065756,ECE 45,A01,083139,Staff,20,19,60,40
1650481071778,ECE 65,A50,083695,Staff,0,6,30,30
1650481077803,ECE 109,A01,091882,Touri; Behrouz,38,0,70,32
1650481083826,ECE 180,A00,083140,Abi Samra; Nicholas Camill,22,0,30,8
1650481083826,ECE 180,B00,083141,Abi Samra; Nicholas Camill,0,0,30,30
1650481089850,MATH 10A,A01,083735,Patchell; Gregory David,5,0,30,25
1650481089850,MATH 10A,A02,083736,Patchell; Gregory David,27,0,30,3
1650481089850,MATH 10A,A03,083737,Patchell; Gregory David,25,0,30,5
1650481095877,MATH 10B,A01,083207,Staff,0,8,30,30
1650481095877,MATH 10B,A02,083208,Staff,0,7,30,30
1650481095877,MATH 10B,B01,083739,Staff,13,0,30,17
1650481095877,MATH 10B,B02,083740,Staff,28,0,30,2
1650481101902,MATH 18,A01,083743,Staff,1,0,30,29
1650481101902,MATH 18,A02,083744,Staff,27,0,30,3
1650481101902,MATH 18,A03,083745,Staff,22,0,30,8
1650481101902,MATH 18,A04,083746,Staff,26,0,30,4
1650481101902,MATH 18,B01,083748,Staff,0,11,30,30
1650481101902,MATH 18,B02,083749,Staff,0,12,30,30
1650481101902,MATH 18,B03,083750,Staff,0,11,30,30
1650481101902,MATH 18,B04,083751,Staff,0,12,30,30
1650481107928,MATH 20A,A01,083754,Staff,25,0,40,15
1650481113963,MATH 20B,A01,083756,Staff,0,11,30,30
1650481113963,MATH 20B,A02,083757,Staff,0,11,30,30
1650481119987,MATH 20C,A01,083760,Staff,0,15,30,30
1650481119987,MATH 20C,A02,083761,Staff,2,15,30,28
1650481119987,MATH 20C,B01,083762,Staff,13,0,30,17
1650481119987,MATH 20C,B02,083763,Staff,28,0,30,2
1650481126009,MATH 20D,A01,083765,Staff,0,1,30,30
1650481126009,MATH 20D,A02,083766,Staff,9,0,30,21
1650481126009,MATH 20D,A03,083767,Staff,25,0,30,5
1650481132041,MATH 20E,A01,083771,Staff,6,0,30,24
1650481132041,MATH 20E,A02,083772,Staff,18,0,30,12
1650481132041,MATH 20E,B01,083773,Staff,0,0,30,30
1650481132041,MATH 20E,B02,083774,Staff,10,0,30,20
1650481138068,MATH 103A,A01,083777,Staff,0,12,30,30
1650481138068,MATH 103A,A02,083778,Staff,0,12,30,30
1650481138068,MATH 103A,B01,083779,Staff,0,13,30,30
1650481138068,MATH 103A,B02,083780,Staff,0,12,30,30
1650481144092,MATH 105,A01,085443,Staff,0,23,30,30
1650481150129,MATH 109,A01,083213,Anzaldo; Leesa B,0,7,30,30
1650481150129,MATH 109,A02,083214,Anzaldo; Leesa B,0,7,30,30
1650481150129,MATH 109,B01,083215,Anzaldo; Leesa B,0,5,30,30
1650481150129,MATH 109,B02,083216,Anzaldo; Leesa B,0,6,30,30
1650481156167,MATH 142A,A01,083219,Chow; Bennett,0,15,30,30
1650481156167,MATH 142A,A02,083220,Chow; Bennett,0,13,30,30
1650481156167,MATH 142A,B01,083221,Chow; Bennett,0,12,30,30
1650481156167,MATH 142A,B02,083222,Chow; Bennett,0,13,30,30
1650481162193,MATH 193A,A01,083224,Staff,0,5,30,30
1650481162193,MATH 193A,A02,083225,Staff,0,5,30,30
1650481162193,MATH 193A,A03,083781,Staff,0,5,30,30
1650481162193,MATH 193A,A04,083782,Staff,0,6,30,30
1650481168217,MATH 197,001,091859,McAuley; Julian John,9998,0,9999,1
1650481174267,COGS 9,A01,083615,Staff,0,14,60,60
1650481180294,COGS 11,A01,083617,Boyle; Mary E. T.,20,0,40,20
1650481186323,COGS 13,A01,083071,Staff,0,34,40,40
1650481192346,COGS 14A,A01,092681,Staff,1,25,100,99
1650481198380,COGS 14B,A01,083073,Cheng; Tzu-Han,0,11,50,50
1650481204406,COGS 17,A01,092677,Staff,22,0,75,53
1650481210448,COGS 100,A01,083619,Staff,0,26,60,60
1650481216475,COGS 101A,A01,083621,Davis; Joshua Daniel,0,22,60,60
1650481222501,COGS 101B,A01,091572,Staff,0,4,60,60
1650481228523,COGS 101C,A01,083625,Delgado; Tania,16,0,30,14
1650481234548,COGS 107A,A01,083627,Boyle; Mary E. T.,0,11,60,60
1650481240574,COGS 118A,A01,083075,Staff,0,3,60,60
1650481246599,CSE 3,A50,083646,Miranda; Gregory Joseph,20,0,38,18
1650481246599,CSE 3,A51,083647,Miranda; Gregory Joseph,36,0,37,1
1650481252624,CSE 8A,A50,083650,Miranda; Gregory Joseph,0,28,40,40
1650481266045,CSE 11,A01,083080,Cao; Yingjun,0,92,40,40
1650481272071,CSE 12,A01,083652,Staff,0,17,100,100
1650481278098,CSE 15L,A01,083654,Staff,0,1,50,50
1650481278098,CSE 15L,A02,083655,Staff,0,0,50,50
1650481284123,CSE 20,A01,083657,Staff,51,0,80,29
1650481290148,CSE 30,A01,083084,Eldon; John,0,76,40,40
1650481296176,CSE 100,A01,083659,Cao; Yingjun,0,66,50,50
1650481302201,CSE 134B,A01,083661,Powell; Thomas Allan,0,32,65,65
1650481308225,CSE 140,A01,083663,Staff,0,5,75,75
1650481314251,CSE 140L,A01,083088,Eldon; John,0,9,75,75
1650481320283,CSE 175,A01,083665,Kumar; Rakesh,7,0,25,18
1650481326516,CSE 190,A00,092507,Dubnov; Shlomo,12,0,20,8
1650481332554,ECE 45,A01,083139,Staff,20,19,60,40
1650481338577,ECE 65,A50,083695,Staff,0,6,30,30
1650481344605,ECE 109,A01,091882,Touri; Behrouz,38,0,70,32
1650481350630,ECE 180,A00,083140,Abi Samra; Nicholas Camill,22,0,30,8
1650481350630,ECE 180,B00,083141,Abi Samra; Nicholas Camill,0,0,30,30
1650481356653,MATH 10A,A01,083735,Patchell; Gregory David,5,0,30,25
1650481356653,MATH 10A,A02,083736,Patchell; Gregory David,27,0,30,3
1650481356653,MATH 10A,A03,083737,Patchell; Gregory David,25,0,30,5
1650481362677,MATH 10B,A01,083207,Staff,0,8,30,30
1650481362677,MATH 10B,A02,083208,Staff,0,7,30,30
1650481362677,MATH 10B,B01,083739,Staff,13,0,30,17
1650481362677,MATH 10B,B02,083740,Staff,28,0,30,2
1650481368707,MATH 18,A01,083743,Staff,1,0,30,29
1650481368707,MATH 18,A02,083744,Staff,27,0,30,3
1650481368707,MATH 18,A03,083745,Staff,22,0,30,8
1650481368707,MATH 18,A04,083746,Staff,26,0,30,4
1650481368707,MATH 18,B01,083748,Staff,0,11,30,30
1650481368707,MATH 18,B02,083749,Staff,0,12,30,30
1650481368707,MATH 18,B03,083750,Staff,0,11,30,30
1650481368707,MATH 18,B04,083751,Staff,0,12,30,30
1650481374731,MATH 20A,A01,083754,Staff,25,0,40,15
1650481380761,MATH 20B,A01,083756,Staff,0,11,30,30
1650481380761,MATH 20B,A02,083757,Staff,0,11,30,30
1650481386787,MATH 20C,A01,083760,Staff,0,15,30,30
1650481386787,MATH 20C,A02,083761,Staff,2,15,30,28
1650481386787,MATH 20C,B01,083762,Staff,13,0,30,17
1650481386787,MATH 20C,B02,083763,Staff,28,0,30,2
1650481392813,MATH 20D,A01,083765,Staff,0,1,30,30
1650481392813,MATH 20D,A02,083766,Staff,9,0,30,21
1650481392813,MATH 20D,A03,083767,Staff,25,0,30,5
1650481398836,MATH 20E,A01,083771,Staff,6,0,30,24
1650481398836,MATH 20E,A02,083772,Staff,18,0,30,12
1650481398836,MATH 20E,B01,083773,Staff,0,0,30,30
1650481398836,MATH 20E,B02,083774,Staff,10,0,30,20
1650481404865,MATH 103A,A01,083777,Staff,0,12,30,30
1650481404865,MATH 103A,A02,083778,Staff,0,12,30,30
1650481404865,MATH 103A,B01,083779,Staff,0,13,30,30
1650481404865,MATH 103A,B02,083780,Staff,0,12,30,30
1650481410891,MATH 105,A01,085443,Staff,0,23,30,30
1650481416915,MATH 109,A01,083213,Anzaldo; Leesa B,0,7,30,30
1650481416915,MATH 109,A02,083214,Anzaldo; Leesa B,0,7,30,30
1650481416915,MATH 109,B01,083215,Anzaldo; Leesa B,0,5,30,30
1650481416915,MATH 109,B02,083216,Anzaldo; Leesa B,0,6,30,30
1650481422945,MATH 142A,A01,083219,Chow; Bennett,0,15,30,30
1650481422945,MATH 142A,A02,083220,Chow; Bennett,0,13,30,30
1650481422945,MATH 142A,B01,083221,Chow; Bennett,0,12,30,30
1650481422945,MATH 142A,B02,083222,Chow; Bennett,0,13,30,30
1650481428967,MATH 193A,A01,083224,Staff,0,5,30,30
1650481428967,MATH 193A,A02,083225,Staff,0,5,30,30
1650481428967,MATH 193A,A03,083781,Staff,0,5,30,30
1650481428967,MATH 193A,A04,083782,Staff,0,6,30,30
1650481434991,MATH 197,001,091859,McAuley; Julian John,9998,0,9999,1
1650481441048,COGS 9,A01,083615,Staff,0,14,60,60
1650481447071,COGS 11,A01,083617,Boyle; Mary E. T.,20,0,40,20
1650481453105,COGS 13,A01,083071,Staff,0,34,40,40
1650481459132,COGS 14A,A01,092681,Staff,1,25,100,99
1650481465159,COGS 14B,A01,083073,Cheng; Tzu-Han,0,11,50,50
1650481471191,COGS 17,A01,092677,Staff,22,0,75,53
1650481477216,COGS 100,A01,083619,Staff,0,26,60,60
1650481483245,COGS 101A,A01,083621,Davis; Joshua Daniel,0,22,60,60
1650481489269,COGS 101B,A01,091572,Staff,0,4,60,60
1650481495292,COGS 101C,A01,083625,Delgado; Tania,16,0,30,14
1650481501317,COGS 107A,A01,083627,Boyle; Mary E. T.,0,11,60,60
1650481507347,COGS 118A,A01,083075,Staff,0,3,60,60
1650481513376,CSE 3,A50,083646,Miranda; Gregory Joseph,20,0,38,18
1650481513376,CSE 3,A51,083647,Miranda; Gregory Joseph,36,0,37,1
1650481519414,CSE 8A,A50,083650,Miranda; Gregory Joseph,0,28,40,40
1650481525440,CSE 11,A01,083080,Cao; Yingjun,0,92,40,40
1650481531478,CSE 12,A01,083652,Staff,0,17,100,100
1650481537508,CSE 15L,A01,083654,Staff,0,1,50,50
1650481537508,CSE 15L,A02,083655,Staff,0,0,50,50
1650481543531,CSE 20,A01,083657,Staff,51,0,80,29
1650481549560,CSE 30,A01,083084,Eldon; John,0,76,40,40
1650481555588,CSE 100,A01,083659,Cao; Yingjun,0,66,50,50
1650481561614,CSE 134B,A01,083661,Powell; Thomas Allan,0,32,65,65
1650481567641,CSE 140,A01,083663,Staff,0,5,75,75
1650481573667,CSE 140L,A01,083088,Eldon; John,0,9,75,75
1650481579691,CSE 175,A01,083665,Kumar; Rakesh,7,0,25,18
1650481585716,CSE 190,A00,092507,Dubnov; Shlomo,12,0,20,8
1650481591747,ECE 45,A01,083139,Staff,20,19,60,40
1650481597772,ECE 65,A50,083695,Staff,0,6,30,30
1650481603807,ECE 109,A01,091882,Touri; Behrouz,38,0,70,32
1650481609831,ECE 180,A00,083140,Abi Samra; Nicholas Camill,22,0,30,8
1650481609831,ECE 180,B00,083141,Abi Samra; Nicholas Camill,0,0,30,30
1650481615855,MATH 10A,A01,083735,Patchell; Gregory David,5,0,30,25
1650481615855,MATH 10A,A02,083736,Patchell; Gregory David,27,0,30,3
1650481615855,MATH 10A,A03,083737,Patchell; Gregory David,25,0,30,5
1650481621879,MATH 10B,A01,083207,Staff,0,8,30,30
1650481621879,MATH 10B,A02,083208,Staff,0,7,30,30
1650481621879,MATH 10B,B01,083739,Staff,13,0,30,17
1650481621879,MATH 10B,B02,083740,Staff,28,0,30,2
1650481627904,MATH 18,A01,083743,Staff,1,0,30,29
1650481627904,MATH 18,A02,083744,Staff,27,0,30,3
1650481627904,MATH 18,A03,083745,Staff,22,0,30,8
1650481627904,MATH 18,A04,083746,Staff,26,0,30,4
1650481627904,MATH 18,B01,083748,Staff,0,11,30,30
1650481627904,MATH 18,B02,083749,Staff,0,12,30,30
1650481627904,MATH 18,B03,083750,Staff,0,11,30,30
1650481627904,MATH 18,B04,083751,Staff,0,12,30,30
1650481633928,MATH 20A,A01,083754,Staff,25,0,40,15
1650481639956,MATH 20B,A01,083756,Staff,0,11,30,30
1650481639956,MATH 20B,A02,083757,Staff,0,11,30,30
1650481645979,MATH 20C,A01,083760,Staff,0,15,30,30
1650481645979,MATH 20C,A02,083761,Staff,2,15,30,28
1650481645979,MATH 20C,B01,083762,Staff,13,0,30,17
1650481645979,MATH 20C,B02,083763,Staff,28,0,30,2
1650481652092,MATH 20D,A01,083765,Staff,0,1,30,30
1650481652092,MATH 20D,A02,083766,Staff,9,0,30,21
1650481652092,MATH 20D,A03,083767,Staff,25,0,30,5
1650481658115,MATH 20E,A01,083771,Staff,6,0,30,24
1650481658115,MATH 20E,A02,083772,Staff,18,0,30,12
1650481658115,MATH 20E,B01,083773,Staff,0,0,30,30
1650481658115,MATH 20E,B02,083774,Staff,10,0,30,20
1650481664140,MATH 103A,A01,083777,Staff,0,12,30,30
1650481664140,MATH 103A,A02,083778,Staff,0,12,30,30
1650481664140,MATH 103A,B01,083779,Staff,0,13,30,30
1650481664140,MATH 103A,B02,083780,Staff,0,12,30,30
1650481670164,MATH 105,A01,085443,Staff,0,23,30,30
1650481676188,MATH 109,A01,083213,Anzaldo; Leesa B,0,7,30,30
1650481676188,MATH 109,A02,083214,Anzaldo; Leesa B,0,7,30,30
1650481676188,MATH 109,B01,083215,Anzaldo; Leesa B,0,5,30,30
1650481676188,MATH 109,B02,083216,Anzaldo; Leesa B,0,6,30,30
1650481682221,MATH 142A,A01,083219,Chow; Bennett,0,15,30,30
1650481682221,MATH 142A,A02,083220,Chow; Bennett,0,13,30,30
1650481682221,MATH 142A,B01,083221,Chow; Bennett,0,12,30,30
1650481682221,MATH 142A,B02,083222,Chow; Bennett,0,13,30,30
1650481688249,MATH 193A,A01,083224,Staff,0,5,30,30
1650481688249,MATH 193A,A02,083225,Staff,0,5,30,30
1650481688249,MATH 193A,A03,083781,Staff,0,5,30,30
1650481688249,MATH 193A,A04,083782,Staff,0,6,30,30
1650481694281,MATH 197,001,091859,McAuley; Julian John,9998,0,9999,1
1650481700334,COGS 9,A01,083615,Staff,0,14,60,60
1650481706360,COGS 11,A01,083617,Boyle; Mary E. T.,20,0,40,20
1650481712394,COGS 13,A01,083071,Staff,0,34,40,40
1650481718418,COGS 14A,A01,092681,Staff,1,25,100,99
1650481724457,COGS 14B,A01,083073,Cheng; Tzu-Han,0,11,50,50
1650481730480,COGS 17,A01,092677,Staff,22,0,75,53
1650481736519,COGS 100,A01,083619,Staff,0,26,60,60
1650481742545,COGS 101A,A01,083621,Davis; Joshua Daniel,0,22,60,60
1650481748576,COGS 101B,A01,091572,Staff,0,4,60,60
1650481754602,COGS 101C,A01,083625,Delgado; Tania,16,0,30,14
1650481760626,COGS 107A,A01,083627,Boyle; Mary E. T.,0,11,60,60
1650481766653,COGS 118A,A01,083075,Staff,0,3,60,60
1650481772678,CSE 3,A50,083646,Miranda; Gregory Joseph,20,0,38,18
1650481772678,CSE 3,A51,083647,Miranda; Gregory Joseph,36,0,37,1
1650481778702,CSE 8A,A50,083650,Miranda; Gregory Joseph,0,28,40,40
1650481784727,CSE 11,A01,083080,Cao; Yingjun,0,92,40,40
1650481790754,CSE 12,A01,083652,Staff,0,17,100,100
1650481796778,CSE 15L,A01,083654,Staff,0,1,50,50
1650481796778,CSE 15L,A02,083655,Staff,0,0,50,50
1650481802805,CSE 20,A01,083657,Staff,51,0,80,29
1650481808844,CSE 30,A01,083084,Eldon; John,0,76,40,40
1650481814871,CSE 100,A01,083659,Cao; Yingjun,0,66,50,50
1650481820899,CSE 134B,A01,083661,Powell; Thomas Allan,0,32,65,65
1650481826927,CSE 140,A01,083663,Staff,0,5,75,75
1650481832958,CSE 140L,A01,083088,Eldon; John,0,9,75,75
1650481838985,CSE 175,A01,083665,Kumar; Rakesh,7,0,25,18
1650481845021,CSE 190,A00,092507,Dubnov; Shlomo,12,0,20,8
1650481851045,ECE 45,A01,083139,Staff,20,19,60,40
1650481857071,ECE 65,A50,083695,Staff,0,6,30,30
1650481863100,ECE 109,A01,091882,Touri; Behrouz,38,0,70,32
1650481869124,ECE 180,A00,083140,Abi Samra; Nicholas Camill,22,0,30,8
1650481869124,ECE 180,B00,083141,Abi Samra; Nicholas Camill,0,0,30,30
1650481875149,MATH 10A,A01,083735,Patchell; Gregory David,5,0,30,25
1650481875149,MATH 10A,A02,083736,Patchell; Gregory David,27,0,30,3
1650481875149,MATH 10A,A03,083737,Patchell; Gregory David,25,0,30,5
1650481881173,MATH 10B,A01,083207,Staff,0,8,30,30
1650481881173,MATH 10B,A02,083208,Staff,0,7,30,30
1650481881173,MATH 10B,B01,083739,Staff,13,0,30,17
1650481881173,MATH 10B,B02,083740,Staff,28,0,30,2
1650481887198,MATH 18,A01,083743,Staff,1,0,30,29
1650481887198,MATH 18,A02,083744,Staff,27,0,30,3
1650481887198,MATH 18,A03,083745,Staff,22,0,30,8
1650481887198,MATH 18,A04,083746,Staff,26,0,30,4
1650481887198,MATH 18,B01,083748,Staff,0,11,30,30
1650481887198,MATH 18,B02,083749,Staff,0,12,30,30
1650481887198,MATH 18,B03,083750,Staff,0,11,30,30
1650481887198,MATH 18,B04,083751,Staff,0,12,30,30
1650481893226,MATH 20A,A01,083754,Staff,25,0,40,15
1650481899252,MATH 20B,A01,083756,Staff,0,11,30,30
1650481899252,MATH 20B,A02,083757,Staff,0,11,30,30
1650481905289,MATH 20C,A01,083760,Staff,0,15,30,30
1650481905289,MATH 20C,A02,083761,Staff,2,15,30,28
1650481905289,MATH 20C,B01,083762,Staff,13,0,30,17
1650481905289,MATH 20C,B02,083763,Staff,28,0,30,2
1650481911312,MATH 20D,A01,083765,Staff,0,1,30,30
1650481911312,MATH 20D,A02,083766,Staff,9,0,30,21
1650481911312,MATH 20D,A03,083767,Staff,25,0,30,5
1650481917338,MATH 20E,A01,083771,Staff,6,0,30,24
1650481917338,MATH 20E,A02,083772,Staff,18,0,30,12
1650481917338,MATH 20E,B01,083773,Staff,0,0,30,30
1650481917338,MATH 20E,B02,083774,Staff,10,0,30,20
1650481923368,MATH 103A,A01,083777,Staff,0,12,30,30
1650481923368,MATH 103A,A02,083778,Staff,0,12,30,30
1650481923368,MATH 103A,B01,083779,Staff,0,13,30,30
1650481923368,MATH 103A,B02,083780,Staff,0,12,30,30
1650481929394,MATH 105,A01,085443,Staff,0,23,30,30
1650481935435,MATH 109,A01,083213,Anzaldo; Leesa B,0,7,30,30
1650481935435,MATH 109,A02,083214,Anzaldo; Leesa B,0,7,30,30
1650481935435,MATH 109,B01,083215,Anzaldo; Leesa B,0,5,30,30
1650481935435,MATH 109,B02,083216,Anzaldo; Leesa B,0,6,30,30
1650481941460,MATH 142A,A01,083219,Chow; Bennett,0,15,30,30
1650481941460,MATH 142A,A02,083220,Chow; Bennett,0,13,30,30
1650481941460,MATH 142A,B01,083221,Chow; Bennett,0,12,30,30
1650481941460,MATH 142A,B02,083222,Chow; Bennett,0,13,30,30
1650481947486,MATH 193A,A01,083224,Staff,0,5,30,30
1650481947486,MATH 193A,A02,083225,Staff,0,5,30,30
1650481947486,MATH 193A,A03,083781,Staff,0,5,30,30
1650481947486,MATH 193A,A04,083782,Staff,0,6,30,30
1650481953510,MATH 197,001,091859,McAuley; Julian John,9998,0,9999,1
1650481959579,COGS 9,A01,083615,Staff,0,14,60,60
1650481965606,COGS 11,A01,083617,Boyle; Mary E. T.,20,0,40,20
1650481971646,COGS 13,A01,083071,Staff,0,34,40,40
1650481977669,COGS 14A,A01,092681,Staff,1,25,100,99
1650481983696,COGS 14B,A01,083073,Cheng; Tzu-Han,0,11,50,50
1650481989722,COGS 17,A01,092677,Staff,22,0,75,53
1650481995746,COGS 100,A01,083619,Staff,0,26,60,60
1650482001773,COGS 101A,A01,083621,Davis; Joshua Daniel,0,22,60,60
1650482007797,COGS 101B,A01,091572,Staff,0,4,60,60
1650482013820,COGS 101C,A01,083625,Delgado; Tania,16,0,30,14
1650482019853,COGS 107A,A01,083627,Boyle; Mary E. T.,0,11,60,60
1650482025879,COGS 118A,A01,083075,Staff,0,3,60,60
1650482031906,CSE 3,A50,083646,Miranda; Gregory Joseph,20,0,38,18
1650482031906,CSE 3,A51,083647,Miranda; Gregory Joseph,36,0,37,1
1650482037930,CSE 8A,A50,083650,Miranda; Gregory Joseph,0,28,40,40
1650482043956,CSE 11,A01,083080,Cao; Yingjun,0,92,40,40
1650482049989,CSE 12,A01,083652,Staff,0,17,100,100
1650482056014,CSE 15L,A01,083654,Staff,0,1,50,50
1650482056014,CSE 15L,A02,083655,Staff,0,0,50,50
1650482062045,CSE 20,A01,083657,Staff,51,0,80,29
1650482068070,CSE 30,A01,083084,Eldon; John,0,76,40,40
1650482074103,CSE 100,A01,083659,Cao; Yingjun,0,66,50,50
1650482080138,CSE 134B,A01,083661,Powell; Thomas Allan,0,32,65,65
1650482086165,CSE 140,A01,083663,Staff,0,5,75,75
1650482092200,CSE 140L,A01,083088,Eldon; John,0,9,75,75
1650482098224,CSE 175,A01,083665,Kumar; Rakesh,7,0,25,18
1650482104247,CSE 190,A00,092507,Dubnov; Shlomo,12,0,20,8
1650482110284,ECE 45,A01,083139,Staff,20,19,60,40
1650482116307,ECE 65,A50,083695,Staff,0,6,30,30
1650482122337,ECE 109,A01,091882,Touri; Behrouz,38,0,70,32
1650482128366,ECE 180,A00,083140,Abi Samra; Nicholas Camill,22,0,30,8
1650482128366,ECE 180,B00,083141,Abi Samra; Nicholas Camill,0,0,30,30
1650482134390,MATH 10A,A01,083735,Patchell; Gregory David,5,0,30,25
1650482134390,MATH 10A,A02,083736,Patchell; Gregory David,27,0,30,3
1650482134390,MATH 10A,A03,083737,Patchell; Gregory David,25,0,30,5
1650482140415,MATH 10B,A01,083207,Staff,0,8,30,30
1650482140415,MATH 10B,A02,083208,Staff,0,7,30,30
1650482140415,MATH 10B,B01,083739,Staff,13,0,30,17
1650482140415,MATH 10B,B02,083740,Staff,28,0,30,2
1650482146440,MATH 18,A01,083743,Staff,1,0,30,29
1650482146440,MATH 18,A02,083744,Staff,27,0,30,3
1650482146440,MATH 18,A03,083745,Staff,22,0,30,8
1650482146440,MATH 18,A04,083746,Staff,26,0,30,4
1650482146440,MATH 18,B01,083748,Staff,0,11,30,30
1650482146440,MATH 18,B02,083749,Staff,0,12,30,30
1650482146440,MATH 18,B03,083750,Staff,0,11,30,30
1650482146440,MATH 18,B04,083751,Staff,0,12,30,30
1650482152467,MATH 20A,A01,083754,Staff,25,0,40,15
1650482158491,MATH 20B,A01,083756,Staff,0,11,30,30
1650482158491,MATH 20B,A02,083757,Staff,0,11,30,30
1650482164515,MATH 20C,A01,083760,Staff,0,15,30,30
1650482164515,MATH 20C,A02,083761,Staff,2,15,30,28
1650482164515,MATH 20C,B01,083762,Staff,13,0,30,17
1650482164515,MATH 20C,B02,083763,Staff,28,0,30,2
1650482170566,MATH 20D,A01,083765,Staff,0,1,30,30
1650482170566,MATH 20D,A02,083766,Staff,9,0,30,21
1650482170566,MATH 20D,A03,083767,Staff,25,0,30,5
1650482176593,MATH 20E,A01,083771,Staff,6,0,30,24
1650482176593,MATH 20E,A02,083772,Staff,18,0,30,12
1650482176593,MATH 20E,B01,083773,Staff,0,0,30,30
1650482176593,MATH 20E,B02,083774,Staff,10,0,30,20
1650482182617,MATH 103A,A01,083777,Staff,0,12,30,30
1650482182617,MATH 103A,A02,083778,Staff,0,12,30,30
1650482182617,MATH 103A,B01,083779,Staff,0,13,30,30
1650482182617,MATH 103A,B02,083780,Staff,0,12,30,30
1650482188641,MATH 105,A01,085443,Staff,0,23,30,30
1650482194668,MATH 109,A01,083213,Anzaldo; Leesa B,0,7,30,30
1650482194668,MATH 109,A02,083214,Anzaldo; Leesa B,0,7,30,30
1650482194668,MATH 109,B01,083215,Anzaldo; Leesa B,0,5,30,30
1650482194668,MATH 109,B02,083216,Anzaldo; Leesa B,0,6,30,30
1650482200703,MATH 142A,A01,083219,Chow; Bennett,0,15,30,30
1650482200703,MATH 142A,A02,083220,Chow; Bennett,0,13,30,30
1650482200703,MATH 142A,B01,083221,Chow; Bennett,0,12,30,30
1650482200703,MATH 142A,B02,083222,Chow; Bennett,0,13,30,30
1650482206729,MATH 193A,A01,083224,Staff,0,5,30,30
1650482206729,MATH 193A,A02,083225,Staff,0,5,30,30
1650482206729,MATH 193A,A03,083781,Staff,0,5,30,30
1650482206729,MATH 193A,A04,083782,Staff,0,6,30,30
1650482212755,MATH 197,001,091859,McAuley; Julian John,9998,0,9999,1
1650482218806,COGS 9,A01,083615,Staff,0,14,60,60
1650482224833,COGS 11,A01,083617,Boyle; Mary E. T.,20,0,40,20
1650482230856,COGS 13,A01,083071,Staff,0,34,40,40
1650482236880,COGS 14A,A01,092681,Staff,1,25,100,99
1650482242995,COGS 14B,A01,083073,Cheng; Tzu-Han,0,11,50,50
1650482249021,COGS 17,A01,092677,Staff,22,0,75,53
1650482255053,COGS 100,A01,083619,Staff,0,26,60,60
1650482261076,COGS 101A,A01,083621,Davis; Joshua Daniel,0,22,60,60
1650482267102,COGS 101B,A01,091572,Staff,0,4,60,60
1650482273130,COGS 101C,A01,083625,Delgado; Tania,16,0,30,14
1650482279160,COGS 107A,A01,083627,Boyle; Mary E. T.,0,11,60,60
1650482285181,COGS 118A,A01,083075,Staff,0,3,60,60
1650482291204,CSE 3,A50,083646,Miranda; Gregory Joseph,20,0,38,18
1650482291204,CSE 3,A51,083647,Miranda; Gregory Joseph,36,0,37,1
1650482297229,CSE 8A,A50,083650,Miranda; Gregory Joseph,0,28,40,40
1650482303254,CSE 11,A01,083080,Cao; Yingjun,0,92,40,40
1650482309278,CSE 12,A01,083652,Staff,0,17,100,100
1650482315310,CSE 15L,A01,083654,Staff,0,1,50,50
1650482315310,CSE 15L,A02,083655,Staff,0,0,50,50
1650482321337,CSE 20,A01,083657,Staff,51,0,80,29
1650482327360,CSE 30,A01,083084,Eldon; John,0,76,40,40
1650482333384,CSE 100,A01,083659,Cao; Yingjun,0,66,50,50
1650482339411,CSE 134B,A01,083661,Powell; Thomas Allan,0,32,65,65
1650482345434,CSE 140,A01,083663,Staff,0,5,75,75
1650482351458,CSE 140L,A01,083088,Eldon; John,0,9,75,75
1650482357484,CSE 175,A01,083665,Kumar; Rakesh,7,0,25,18
1650482363508,CSE 190,A00,092507,Dubnov; Shlomo,12,0,20,8
1650482369532,ECE 45,A01,083139,Staff,20,19,60,40
1650482375589,ECE 65,A50,083695,Staff,0,6,30,30
1650482381617,ECE 109,A01,091882,Touri; Behrouz,38,0,70,32
1650482387646,ECE 180,A00,083140,Abi Samra; Nicholas Camill,22,0,30,8
1650482387646,ECE 180,B00,083141,Abi Samra; Nicholas Camill,0,0,30,30
1650482393672,MATH 10A,A01,083735,Patchell; Gregory David,5,0,30,25
1650482393672,MATH 10A,A02,083736,Patchell; Gregory David,27,0,30,3
1650482393672,MATH 10A,A03,083737,Patchell; Gregory David,25,0,30,5
1650482399709,MATH 10B,A01,083207,Staff,0,8,30,30
1650482399709,MATH 10B,A02,083208,Staff,0,7,30,30
1650482399709,MATH 10B,B01,083739,Staff,13,0,30,17
1650482399709,MATH 10B,B02,083740,Staff,28,0,30,2
1650482405745,MATH 18,A01,083743,Staff,1,0,30,29
1650482405745,MATH 18,A02,083744,Staff,27,0,30,3
1650482405745,MATH 18,A03,083745,Staff,22,0,30,8
1650482405745,MATH 18,A04,083746,Staff,26,0,30,4
1650482405745,MATH 18,B01,083748,Staff,0,11,30,30
1650482405745,MATH 18,B02,083749,Staff,0,12,30,30
1650482405745,MATH 18,B03,083750,Staff,0,11,30,30
1650482405745,MATH 18,B04,083751,Staff,0,12,30,30
1650482411768,MATH 20A,A01,083754,Staff,25,0,40,15
1650482417799,MATH 20B,A01,083756,Staff,0,11,30,30
1650482417799,MATH 20B,A02,083757,Staff,0,11,30,30
1650482423823,MATH 20C,A01,083760,Staff,0,15,30,30
1650482423823,MATH 20C,A02,083761,Staff,2,15,30,28
1650482423823,MATH 20C,B01,083762,Staff,13,0,30,17
1650482423823,MATH 20C,B02,083763,Staff,28,0,30,2
1650482429850,MATH 20D,A01,083765,Staff,0,1,30,30
1650482429850,MATH 20D,A02,083766,Staff,9,0,30,21
1650482429850,MATH 20D,A03,083767,Staff,25,0,30,5
1650482435876,MATH 20E,A01,083771,Staff,6,0,30,24
1650482435876,MATH 20E,A02,083772,Staff,18,0,30,12
1650482435876,MATH 20E,B01,083773,Staff,0,0,30,30
1650482435876,MATH 20E,B02,083774,Staff,10,0,30,20
1650482441914,MATH 103A,A01,083777,Staff,0,12,30,30
1650482441914,MATH 103A,A02,083778,Staff,0,12,30,30
1650482441914,MATH 103A,B01,083779,Staff,0,13,30,30
1650482441914,MATH 103A,B02,083780,Staff,0,12,30,30
1650482447939,MATH 105,A01,085443,Staff,0,23,30,30
1650482453964,MATH 109,A01,083213,Anzaldo; Leesa B,0,7,30,30
1650482453964,MATH 109,A02,083214,Anzaldo; Leesa B,0,7,30,30
1650482453964,MATH 109,B01,083215,Anzaldo; Leesa B,0,5,30,30
1650482453964,MATH 109,B02,083216,Anzaldo; Leesa B,0,6,30,30
1650482459987,MATH 142A,A01,083219,Chow; Bennett,0,15,30,30
1650482459987,MATH 142A,A02,083220,Chow; Bennett,0,13,30,30
1650482459987,MATH 142A,B01,083221,Chow; Bennett,0,12,30,30
1650482459987,MATH 142A,B02,083222,Chow; Bennett,0,13,30,30
1650482466014,MATH 193A,A01,083224,Staff,0,5,30,30
1650482466014,MATH 193A,A02,083225,Staff,0,5,30,30
1650482466014,MATH 193A,A03,083781,Staff,0,5,30,30
1650482466014,MATH 193A,A04,083782,Staff,0,6,30,30
1650482472041,MATH 197,001,091859,McAuley; Julian John,9998,0,9999,1
1650482478090,COGS 9,A01,083615,Staff,0,14,60,60
1650482484113,COGS 11,A01,083617,Boyle; Mary E. T.,20,0,40,20
1650482490140,COGS 13,A01,083071,Staff,0,34,40,40
1650482496164,COGS 14A,A01,092681,Staff,1,25,100,99
1650482502187,COGS 14B,A01,083073,Cheng; Tzu-Han,0,11,50,50
1650482508211,COGS 17,A01,092677,Staff,22,0,75,53
1650482514235,COGS 100,A01,083619,Staff,0,26,60,60
1650482520264,COGS 101A,A01,083621,Davis; Joshua Daniel,0,22,60,60
1650482526289,COGS 101B,A01,091572,Staff,0,4,60,60
1650482532312,COGS 101C,A01,083625,Delgado; Tania,16,0,30,14
1650482538349,COGS 107A,A01,083627,Boyle; Mary E. T.,0,11,60,60
1650482544382,COGS 118A,A01,083075,Staff,0,3,60,60
1650482550406,CSE 3,A50,083646,Miranda; Gregory Joseph,20,0,38,18
1650482550406,CSE 3,A51,083647,Miranda; Gregory Joseph,36,0,37,1
1650482556429,CSE 8A,A50,083650,Miranda; Gregory Joseph,0,28,40,40
1650482562455,CSE 11,A01,083080,Cao; Yingjun,0,92,40,40
1650482568480,CSE 12,A01,083652,Staff,0,17,100,100
1650482574506,CSE 15L,A01,083654,Staff,0,1,50,50
1650482574506,CSE 15L,A02,083655,Staff,0,0,50,50
1650482580538,CSE 20,A01,083657,Staff,51,0,80,29
1650482586562,CSE 30,A01,083084,Eldon; John,0,76,40,40
1650482592587,CSE 100,A01,083659,Cao; Yingjun,0,66,50,50
1650482598613,CSE 134B,A01,083661,Powell; Thomas Allan,0,32,65,65
1650482604635,CSE 140,A01,083663,Staff,0,5,75,75
1650482610662,CSE 140L,A01,083088,Eldon; John,0,9,75,75
1650482616684,CSE 175,A01,083665,Kumar; Rakesh,7,0,25,18
1650482622709,CSE 190,A00,092507,Dubnov; Shlomo,12,0,20,8
1650482628734,ECE 45,A01,083139,Staff,20,19,60,40
1650482634759,ECE 65,A50,083695,Staff,0,6,30,30
1650482640793,ECE 109,A01,091882,Touri; Behrouz,38,0,70,32
1650482646816,ECE 180,A00,083140,Abi Samra; Nicholas Camill,22,0,30,8
1650482646816,ECE 180,B00,083141,Abi Samra; Nicholas Camill,0,0,30,30
1650482652838,MATH 10A,A01,083735,Patchell; Gregory David,5,0,30,25
1650482652838,MATH 10A,A02,083736,Patchell; Gregory David,27,0,30,3
1650482652838,MATH 10A,A03,083737,Patchell; Gregory David,25,0,30,5
1650482658874,MATH 10B,A01,083207,Staff,0,8,30,30
1650482658874,MATH 10B,A02,083208,Staff,0,7,30,30
1650482658874,MATH 10B,B01,083739,Staff,13,0,30,17
1650482658874,MATH 10B,B02,083740,Staff,28,0,30,2
1650482664900,MATH 18,A01,083743,Staff,1,0,30,29
1650482664900,MATH 18,A02,083744,Staff,27,0,30,3
1650482664900,MATH 18,A03,083745,Staff,22,0,30,8
1650482664900,MATH 18,A04,083746,Staff,26,0,30,4
1650482664900,MATH 18,B01,083748,Staff,0,11,30,30
1650482664900,MATH 18,B02,083749,Staff,0,12,30,30
1650482664900,MATH 18,B03,083750,Staff,0,11,30,30
1650482664900,MATH 18,B04,083751,Staff,0,12,30,30
1650482670926,MATH 20A,A01,083754,Staff,25,0,40,15
1650482676953,MATH 20B,A01,083756,Staff,0,11,30,30
1650482676953,MATH 20B,A02,083757,Staff,0,11,30,30
1650482682980,MATH 20C,A01,083760,Staff,0,15,30,30
1650482682980,MATH 20C,A02,083761,Staff,2,15,30,28
1650482682980,MATH 20C,B01,083762,Staff,13,0,30,17
1650482682980,MATH 20C,B02,083763,Staff,28,0,30,2
1650482689004,MATH 20D,A01,083765,Staff,0,1,30,30
1650482689004,MATH 20D,A02,083766,Staff,9,0,30,21
1650482689004,MATH 20D,A03,083767,Staff,25,0,30,5
1650482695028,MATH 20E,A01,083771,Staff,5,0,30,25
1650482695028,MATH 20E,A02,083772,Staff,18,0,30,12
1650482695028,MATH 20E,B01,083773,Staff,0,0,30,30
1650482695028,MATH 20E,B02,083774,Staff,10,0,30,20
1650482701058,MATH 103A,A01,083777,Staff,0,12,30,30
1650482701058,MATH 103A,A02,083778,Staff,0,12,30,30
1650482701058,MATH 103A,B01,083779,Staff,0,13,30,30
1650482701058,MATH 103A,B02,083780,Staff,0,12,30,30
1650482707081,MATH 105,A01,085443,Staff,0,23,30,30
1650482713109,MATH 109,A01,083213,Anzaldo; Leesa B,0,7,30,30
1650482713109,MATH 109,A02,083214,Anzaldo; Leesa B,0,7,30,30
1650482713109,MATH 109,B01,083215,Anzaldo; Leesa B,0,5,30,30
1650482713109,MATH 109,B02,083216,Anzaldo; Leesa B,0,6,30,30
1650482719135,MATH 142A,A01,083219,Chow; Bennett,0,15,30,30
1650482719135,MATH 142A,A02,083220,Chow; Bennett,0,13,30,30
1650482719135,MATH 142A,B01,083221,Chow; Bennett,0,12,30,30
1650482719135,MATH 142A,B02,083222,Chow; Bennett,0,13,30,30
1650482725164,MATH 193A,A01,083224,Staff,0,5,30,30
1650482725164,MATH 193A,A02,083225,Staff,0,5,30,30
1650482725164,MATH 193A,A03,083781,Staff,0,5,30,30
1650482725164,MATH 193A,A04,083782,Staff,0,6,30,30
1650482731187,MATH 197,001,091859,McAuley; Julian John,9998,0,9999,1
1650482737246,COGS 9,A01,083615,Staff,0,14,60,60
1650482743269,COGS 11,A01,083617,Boyle; Mary E. T.,20,0,40,20
1650482749297,COGS 13,A01,083071,Staff,0,34,40,40
1650482755323,COGS 14A,A01,092681,Staff,1,25,100,99
1650482761476,COGS 14B,A01,083073,Cheng; Tzu-Han,0,11,50,50
1650482767503,COGS 17,A01,092677,Staff,22,0,75,53
1650482773536,COGS 100,A01,083619,Staff,0,26,60,60
1650482779560,COGS 101A,A01,083621,Davis; Joshua Daniel,0,22,60,60
1650482785582,COGS 101B,A01,091572,Staff,0,4,60,60
1650482791615,COGS 101C,A01,083625,Delgado; Tania,16,0,30,14
1650482797643,COGS 107A,A01,083627,Boyle; Mary E. T.,0,11,60,60
1650482803665,COGS 118A,A01,083075,Staff,0,3,60,60
1650482809690,CSE 3,A50,083646,Miranda; Gregory Joseph,20,0,38,18
1650482809690,CSE 3,A51,083647,Miranda; Gregory Joseph,36,0,37,1
1650482815720,CSE 8A,A50,083650,Miranda; Gregory Joseph,0,28,40,40
1650482821745,CSE 11,A01,083080,Cao; Yingjun,0,92,40,40
1650482827768,CSE 12,A01,083652,Staff,0,17,100,100
1650482833803,CSE 15L,A01,083654,Staff,0,1,50,50
1650482833803,CSE 15L,A02,083655,Staff,0,0,50,50
1650482839929,CSE 20,A01,083657,Staff,51,0,80,29
1650482845951,CSE 30,A01,083084,Eldon; John,0,76,40,40
1650482851976,CSE 100,A01,083659,Cao; Yingjun,0,66,50,50
1650482858001,CSE 134B,A01,083661,Powell; Thomas Allan,0,32,65,65
1650482864025,CSE 140,A01,083663,Staff,0,5,75,75
1650482870053,CSE 140L,A01,083088,Eldon; John,0,9,75,75
1650482876075,CSE 175,A01,083665,Kumar; Rakesh,7,0,25,18
1650482882099,CSE 190,A00,092507,Dubnov; Shlomo,12,0,20,8
1650482888133,ECE 45,A01,083139,Staff,20,19,60,40
1650482894156,ECE 65,A50,083695,Staff,0,6,30,30
1650482900179,ECE 109,A01,091882,Touri; Behrouz,38,0,70,32
1650482906203,ECE 180,A00,083140,Abi Samra; Nicholas Camill,22,0,30,8
1650482906203,ECE 180,B00,083141,Abi Samra; Nicholas Camill,0,0,30,30
1650482912232,MATH 10A,A01,083735,Patchell; Gregory David,5,0,30,25
1650482912232,MATH 10A,A02,083736,Patchell; Gregory David,27,0,30,3
1650482912232,MATH 10A,A03,083737,Patchell; Gregory David,25,0,30,5
1650482918317,MATH 10B,A01,083207,Staff,0,8,30,30
1650482918317,MATH 10B,A02,083208,Staff,0,7,30,30
1650482918317,MATH 10B,B01,083739,Staff,13,0,30,17
1650482918317,MATH 10B,B02,083740,Staff,28,0,30,2
1650482924344,MATH 18,A01,083743,Staff,1,0,30,29
1650482924344,MATH 18,A02,083744,Staff,27,0,30,3
1650482924344,MATH 18,A03,083745,Staff,22,0,30,8
1650482924344,MATH 18,A04,083746,Staff,26,0,30,4
1650482924344,MATH 18,B01,083748,Staff,0,11,30,30
1650482924344,MATH 18,B02,083749,Staff,0,12,30,30
1650482924344,MATH 18,B03,083750,Staff,0,11,30,30
1650482924344,MATH 18,B04,083751,Staff,0,12,30,30
1650482930373,MATH 20A,A01,083754,Staff,25,0,40,15
1650482936397,MATH 20B,A01,083756,Staff,0,11,30,30
1650482936397,MATH 20B,A02,083757,Staff,0,11,30,30
1650482942421,MATH 20C,A01,083760,Staff,0,15,30,30
1650482942421,MATH 20C,A02,083761,Staff,2,15,30,28
1650482942421,MATH 20C,B01,083762,Staff,13,0,30,17
1650482942421,MATH 20C,B02,083763,Staff,28,0,30,2
1650482948448,MATH 20D,A01,083765,Staff,0,1,30,30
1650482948448,MATH 20D,A02,083766,Staff,9,0,30,21
1650482948448,MATH 20D,A03,083767,Staff,25,0,30,5
1650482954475,MATH 20E,A01,083771,Staff,5,0,30,25
1650482954475,MATH 20E,A02,083772,Staff,18,0,30,12
1650482954475,MATH 20E,B01,083773,Staff,0,0,30,30
1650482954475,MATH 20E,B02,083774,Staff,10,0,30,20
1650482960503,MATH 103A,A01,083777,Staff,0,12,30,30
1650482960503,MATH 103A,A02,083778,Staff,0,12,30,30
1650482960503,MATH 103A,B01,083779,Staff,0,13,30,30
1650482960503,MATH 103A,B02,083780,Staff,0,12,30,30
1650482966526,MATH 105,A01,085443,Staff,0,23,30,30
1650482972549,MATH 109,A01,083213,Anzaldo; Leesa B,0,7,30,30
1650482972549,MATH 109,A02,083214,Anzaldo; Leesa B,0,7,30,30
1650482972549,MATH 109,B01,083215,Anzaldo; Leesa B,0,5,30,30
1650482972549,MATH 109,B02,083216,Anzaldo; Leesa B,0,6,30,30
1650482978575,MATH 142A,A01,083219,Chow; Bennett,0,15,30,30
1650482978575,MATH 142A,A02,083220,Chow; Bennett,0,13,30,30
1650482978575,MATH 142A,B01,083221,Chow; Bennett,0,12,30,30
1650482978575,MATH 142A,B02,083222,Chow; Bennett,0,13,30,30
1650482984599,MATH 193A,A01,083224,Staff,0,5,30,30
1650482984599,MATH 193A,A02,083225,Staff,0,5,30,30
1650482984599,MATH 193A,A03,083781,Staff,0,5,30,30
1650482984599,MATH 193A,A04,083782,Staff,0,6,30,30
1650482990620,MATH 197,001,091859,McAuley; Julian John,9998,0,9999,1
1650482996672,COGS 9,A01,083615,Staff,0,14,60,60
1650483002695,COGS 11,A01,083617,Boyle; Mary E. T.,20,0,40,20
1650483008721,COGS 13,A01,083071,Staff,0,34,40,40
1650483014756,COGS 14A,A01,092681,Staff,1,25,100,99
1650483020793,COGS 14B,A01,083073,Cheng; Tzu-Han,0,11,50,50
1650483026824,COGS 17,A01,092677,Staff,22,0,75,53
1650483032848,COGS 100,A01,083619,Staff,0,26,60,60
1650483038877,COGS 101A,A01,083621,Davis; Joshua Daniel,0,22,60,60
1650483044899,COGS 101B,A01,091572,Staff,0,4,60,60
1650483050926,COGS 101C,A01,083625,Delgado; Tania,16,0,30,14
1650483056949,COGS 107A,A01,083627,Boyle; Mary E. T.,0,11,60,60
1650483062975,COGS 118A,A01,083075,Staff,0,3,60,60
1650483068999,CSE 3,A50,083646,Miranda; Gregory Joseph,20,0,38,18
1650483068999,CSE 3,A51,083647,Miranda; Gregory Joseph,36,0,37,1
1650483075022,CSE 8A,A50,083650,Miranda; Gregory Joseph,0,28,40,40
1650483081047,CSE 11,A01,083080,Cao; Yingjun,0,92,40,40
1650483087073,CSE 12,A01,083652,Staff,0,17,100,100
1650483093107,CSE 15L,A01,083654,Staff,0,1,50,50
1650483093107,CSE 15L,A02,083655,Staff,0,0,50,50
1650483099131,CSE 20,A01,083657,Staff,51,0,80,29
1650483105157,CSE 30,A01,083084,Eldon; John,0,76,40,40
1650483111181,CSE 100,A01,083659,Cao; Yingjun,0,66,50,50
1650483117204,CSE 134B,A01,083661,Powell; Thomas Allan,0,32,65,65
1650483123235,CSE 140,A01,083663,Staff,0,5,75,75
1650483129261,CSE 140L,A01,083088,Eldon; John,0,9,75,75
1650483135286,CSE 175,A01,083665,Kumar; Rakesh,7,0,25,18
1650483141309,CSE 190,A00,092507,Dubnov; Shlomo,12,0,20,8
1650483147334,ECE 45,A01,083139,Staff,20,19,60,40
1650483153366,ECE 65,A50,083695,Staff,0,6,30,30
1650483159401,ECE 109,A01,091882,Touri; Behrouz,38,0,70,32
1650483165429,ECE 180,A00,083140,Abi Samra; Nicholas Camill,22,0,30,8
1650483165429,ECE 180,B00,083141,Abi Samra; Nicholas Camill,0,0,30,30
1650483171451,MATH 10A,A01,083735,Patchell; Gregory David,5,0,30,25
1650483171451,MATH 10A,A02,083736,Patchell; Gregory David,27,0,30,3
1650483171451,MATH 10A,A03,083737,Patchell; Gregory David,25,0,30,5
1650483177474,MATH 10B,A01,083207,Staff,0,8,30,30
1650483177474,MATH 10B,A02,083208,Staff,0,7,30,30
1650483177474,MATH 10B,B01,083739,Staff,13,0,30,17
1650483177474,MATH 10B,B02,083740,Staff,28,0,30,2
1650483183503,MATH 18,A01,083743,Staff,1,0,30,29
1650483183503,MATH 18,A02,083744,Staff,27,0,30,3
1650483183503,MATH 18,A03,083745,Staff,22,0,30,8
1650483183503,MATH 18,A04,083746,Staff,26,0,30,4
1650483183503,MATH 18,B01,083748,Staff,0,11,30,30
1650483183503,MATH 18,B02,083749,Staff,0,12,30,30
1650483183503,MATH 18,B03,083750,Staff,0,11,30,30
1650483183503,MATH 18,B04,083751,Staff,0,12,30,30
1650483189528,MATH 20A,A01,083754,Staff,25,0,40,15
1650483195555,MATH 20B,A01,083756,Staff,0,11,30,30
1650483195555,MATH 20B,A02,083757,Staff,0,11,30,30
1650483201578,MATH 20C,A01,083760,Staff,0,15,30,30
1650483201578,MATH 20C,A02,083761,Staff,2,15,30,28
1650483201578,MATH 20C,B01,083762,Staff,13,0,30,17
1650483201578,MATH 20C,B02,083763,Staff,28,0,30,2
1650483207604,MATH 20D,A01,083765,Staff,0,1,30,30
1650483207604,MATH 20D,A02,083766,Staff,9,0,30,21
1650483207604,MATH 20D,A03,083767,Staff,25,0,30,5
1650483213639,MATH 20E,A01,083771,Staff,5,0,30,25
1650483213639,MATH 20E,A02,083772,Staff,18,0,30,12
1650483213639,MATH 20E,B01,083773,Staff,0,0,30,30
1650483213639,MATH 20E,B02,083774,Staff,10,0,30,20
1650483219663,MATH 103A,A01,083777,Staff,0,12,30,30
1650483219663,MATH 103A,A02,083778,Staff,0,12,30,30
1650483219663,MATH 103A,B01,083779,Staff,0,13,30,30
1650483219663,MATH 103A,B02,083780,Staff,0,12,30,30
1650483225687,MATH 105,A01,085443,Staff,0,23,30,30
1650483231710,MATH 109,A01,083213,Anzaldo; Leesa B,0,7,30,30
1650483231710,MATH 109,A02,083214,Anzaldo; Leesa B,0,7,30,30
1650483231710,MATH 109,B01,083215,Anzaldo; Leesa B,0,5,30,30
1650483231710,MATH 109,B02,083216,Anzaldo; Leesa B,0,6,30,30
1650483237735,MATH 142A,A01,083219,Chow; Bennett,0,15,30,30
1650483237735,MATH 142A,A02,083220,Chow; Bennett,0,13,30,30
1650483237735,MATH 142A,B01,083221,Chow; Bennett,0,12,30,30
1650483237735,MATH 142A,B02,083222,Chow; Bennett,0,13,30,30
1650483243760,MATH 193A,A01,083224,Staff,0,5,30,30
1650483243760,MATH 193A,A02,083225,Staff,0,5,30,30
1650483243760,MATH 193A,A03,083781,Staff,0,5,30,30
1650483243760,MATH 193A,A04,083782,Staff,0,6,30,30
1650483249783,MATH 197,001,091859,McAuley; Julian John,9998,0,9999,1
1650483255842,COGS 9,A01,083615,Staff,0,14,60,60
1650483261868,COGS 11,A01,083617,Boyle; Mary E. T.,20,0,40,20
1650483267893,COGS 13,A01,083071,Staff,0,34,40,40
1650483273916,COGS 14A,A01,092681,Staff,1,25,100,99
1650483279944,COGS 14B,A01,083073,Cheng; Tzu-Han,0,11,50,50
1650483285969,COGS 17,A01,092677,Staff,22,0,75,53
1650483291997,COGS 100,A01,083619,Staff,0,26,60,60
1650483298019,COGS 101A,A01,083621,Davis; Joshua Daniel,0,22,60,60
1650483304047,COGS 101B,A01,091572,Staff,0,4,60,60
1650483310071,COGS 101C,A01,083625,Delgado; Tania,16,0,30,14
1650483316102,COGS 107A,A01,083627,Boyle; Mary E. T.,0,11,60,60
1650483322129,COGS 118A,A01,083075,Staff,0,3,60,60
1650483328156,CSE 3,A50,083646,Miranda; Gregory Joseph,20,0,38,18
1650483328156,CSE 3,A51,083647,Miranda; Gregory Joseph,36,0,37,1
1650483334179,CSE 8A,A50,083650,Miranda; Gregory Joseph,0,28,40,40
1650483340209,CSE 11,A01,083080,Cao; Yingjun,0,92,40,40
1650483346237,CSE 12,A01,083652,Staff,0,17,100,100
1650483352263,CSE 15L,A01,083654,Staff,0,1,50,50
1650483352263,CSE 15L,A02,083655,Staff,0,0,50,50
1650483358290,CSE 20,A01,083657,Staff,51,0,80,29
1650483364313,CSE 30,A01,083084,Eldon; John,0,76,40,40
1650483370346,CSE 100,A01,083659,Cao; Yingjun,0,66,50,50
1650483376369,CSE 134B,A01,083661,Powell; Thomas Allan,0,32,65,65
1650483382396,CSE 140,A01,083663,Staff,0,5,75,75
1650483388421,CSE 140L,A01,083088,Eldon; John,0,9,75,75
1650483394450,CSE 175,A01,083665,Kumar; Rakesh,7,0,25,18
1650483400481,CSE 190,A00,092507,Dubnov; Shlomo,12,0,20,8
1650483406505,ECE 45,A01,083139,Staff,20,19,60,40
1650483412536,ECE 65,A50,083695,Staff,0,6,30,30
1650483418565,ECE 109,A01,091882,Touri; Behrouz,38,0,70,32
1650483424592,ECE 180,A00,083140,Abi Samra; Nicholas Camill,22,0,30,8
1650483424592,ECE 180,B00,083141,Abi Samra; Nicholas Camill,0,0,30,30
1650483430614,MATH 10A,A01,083735,Patchell; Gregory David,5,0,30,25
1650483430614,MATH 10A,A02,083736,Patchell; Gregory David,27,0,30,3
1650483430614,MATH 10A,A03,083737,Patchell; Gregory David,25,0,30,5
1650483436729,MATH 10B,A01,083207,Staff,0,8,30,30
1650483436729,MATH 10B,A02,083208,Staff,0,7,30,30
1650483436729,MATH 10B,B01,083739,Staff,13,0,30,17
1650483436729,MATH 10B,B02,083740,Staff,28,0,30,2
1650483442759,MATH 18,A01,083743,Staff,1,0,30,29
1650483442759,MATH 18,A02,083744,Staff,27,0,30,3
1650483442759,MATH 18,A03,083745,Staff,22,0,30,8
1650483442759,MATH 18,A04,083746,Staff,26,0,30,4
1650483442759,MATH 18,B01,083748,Staff,0,11,30,30
1650483442759,MATH 18,B02,083749,Staff,0,12,30,30
1650483442759,MATH 18,B03,083750,Staff,0,11,30,30
1650483442759,MATH 18,B04,083751,Staff,0,12,30,30
1650483448794,MATH 20A,A01,083754,Staff,25,0,40,15
1650483454818,MATH 20B,A01,083756,Staff,0,11,30,30
1650483454818,MATH 20B,A02,083757,Staff,0,11,30,30
1650483460845,MATH 20C,A01,083760,Staff,0,15,30,30
1650483460845,MATH 20C,A02,083761,Staff,2,15,30,28
1650483460845,MATH 20C,B01,083762,Staff,13,0,30,17
1650483460845,MATH 20C,B02,083763,Staff,28,0,30,2
1650483466872,MATH 20D,A01,083765,Staff,0,1,30,30
1650483466872,MATH 20D,A02,083766,Staff,9,0,30,21
1650483466872,MATH 20D,A03,083767,Staff,25,0,30,5
1650483472907,MATH 20E,A01,083771,Staff,5,0,30,25
1650483472907,MATH 20E,A02,083772,Staff,18,0,30,12
1650483472907,MATH 20E,B01,083773,Staff,0,0,30,30
1650483472907,MATH 20E,B02,083774,Staff,10,0,30,20
1650483478932,MATH 103A,A01,083777,Staff,0,12,30,30
1650483478932,MATH 103A,A02,083778,Staff,0,12,30,30
1650483478932,MATH 103A,B01,083779,Staff,0,13,30,30
1650483478932,MATH 103A,B02,083780,Staff,0,12,30,30
1650483484966,MATH 105,A01,085443,Staff,0,23,30,30
1650483490995,MATH 109,A01,083213,Anzaldo; Leesa B,0,7,30,30
1650483490995,MATH 109,A02,083214,Anzaldo; Leesa B,0,7,30,30
1650483490995,MATH 109,B01,083215,Anzaldo; Leesa B,0,5,30,30
1650483490995,MATH 109,B02,083216,Anzaldo; Leesa B,0,6,30,30
1650483497040,MATH 142A,A01,083219,Chow; Bennett,0,15,30,30
1650483497040,MATH 142A,A02,083220,Chow; Bennett,0,13,30,30
1650483497040,MATH 142A,B01,083221,Chow; Bennett,0,12,30,30
1650483497040,MATH 142A,B02,083222,Chow; Bennett,0,13,30,30
1650483503076,MATH 193A,A01,083224,Staff,0,5,30,30
1650483503076,MATH 193A,A02,083225,Staff,0,5,30,30
1650483503076,MATH 193A,A03,083781,Staff,0,5,30,30
1650483503076,MATH 193A,A04,083782,Staff,0,6,30,30
1650483509101,MATH 197,001,091859,McAuley; Julian John,9998,0,9999,1
1650483515155,COGS 9,A01,083615,Staff,0,14,60,60
1650483521183,COGS 11,A01,083617,Boyle; Mary E. T.,20,0,40,20
1650483527215,COGS 13,A01,083071,Staff,0,34,40,40
1650483533239,COGS 14A,A01,092681,Staff,1,25,100,99
1650483539275,COGS 14B,A01,083073,Cheng; Tzu-Han,0,11,50,50
1650483545298,COGS 17,A01,092677,Staff,22,0,75,53
1650483551322,COGS 100,A01,083619,Staff,0,26,60,60
1650483557350,COGS 101A,A01,083621,Davis; Joshua Daniel,0,22,60,60
1650483563381,COGS 101B,A01,091572,Staff,0,4,60,60
1650483569406,COGS 101C,A01,083625,Delgado; Tania,16,0,30,14
1650483575429,COGS 107A,A01,083627,Boyle; Mary E. T.,0,11,60,60
1650483581460,COGS 118A,A01,083075,Staff,0,3,60,60
1650483587510,CSE 3,A50,083646,Miranda; Gregory Joseph,20,0,38,18
1650483587510,CSE 3,A51,083647,Miranda; Gregory Joseph,36,0,37,1
1650483593532,CSE 8A,A50,083650,Miranda; Gregory Joseph,0,28,40,40
1650483599557,CSE 11,A01,083080,Cao; Yingjun,0,92,40,40
1650483605581,CSE 12,A01,083652,Staff,0,17,100,100
1650483611610,CSE 15L,A01,083654,Staff,0,1,50,50
1650483611610,CSE 15L,A02,083655,Staff,0,0,50,50
1650483617633,CSE 20,A01,083657,Staff,51,0,80,29
1650483623664,CSE 30,A01,083084,Eldon; John,0,76,40,40
1650483629690,CSE 100,A01,083659,Cao; Yingjun,0,66,50,50
1650483635715,CSE 134B,A01,083661,Powell; Thomas Allan,0,32,65,65
1650483641739,CSE 140,A01,083663,Staff,0,5,75,75
1650483647763,CSE 140L,A01,083088,Eldon; John,0,9,75,75
1650483653786,CSE 175,A01,083665,Kumar; Rakesh,7,0,25,18
1650483659809,CSE 190,A00,092507,Dubnov; Shlomo,12,0,20,8
1650483665833,ECE 45,A01,083139,Staff,20,19,60,40
1650483671859,ECE 65,A50,083695,Staff,0,6,30,30
1650483677883,ECE 109,A01,091882,Touri; Behrouz,38,0,70,32
1650483683915,ECE 180,A00,083140,Abi Samra; Nicholas Camill,22,0,30,8
1650483683915,ECE 180,B00,083141,Abi Samra; Nicholas Camill,0,0,30,30
1650483689943,MATH 10A,A01,083735,Patchell; Gregory David,5,0,30,25
1650483689943,MATH 10A,A02,083736,Patchell; Gregory David,27,0,30,3
1650483689943,MATH 10A,A03,083737,Patchell; Gregory David,25,0,30,5
1650483695972,MATH 10B,A01,083207,Staff,0,8,30,30
1650483695972,MATH 10B,A02,083208,Staff,0,7,30,30
1650483695972,MATH 10B,B01,083739,Staff,13,0,30,17
1650483695972,MATH 10B,B02,083740,Staff,28,0,30,2
1650483702000,MATH 18,A01,083743,Staff,1,0,30,29
1650483702000,MATH 18,A02,083744,Staff,27,0,30,3
1650483702000,MATH 18,A03,083745,Staff,22,0,30,8
1650483702000,MATH 18,A04,083746,Staff,26,0,30,4
1650483702000,MATH 18,B01,083748,Staff,0,11,30,30
1650483702000,MATH 18,B02,083749,Staff,0,12,30,30
1650483702000,MATH 18,B03,083750,Staff,0,11,30,30
1650483702000,MATH 18,B04,083751,Staff,0,12,30,30
1650483708024,MATH 20A,A01,083754,Staff,25,0,40,15
1650483714057,MATH 20B,A01,083756,Staff,0,11,30,30
1650483714057,MATH 20B,A02,083757,Staff,0,11,30,30
1650483720081,MATH 20C,A01,083760,Staff,0,15,30,30
1650483720081,MATH 20C,A02,083761,Staff,2,15,30,28
1650483720081,MATH 20C,B01,083762,Staff,13,0,30,17
1650483720081,MATH 20C,B02,083763,Staff,28,0,30,2
1650483726105,MATH 20D,A01,083765,Staff,0,1,30,30
1650483726105,MATH 20D,A02,083766,Staff,9,0,30,21
1650483726105,MATH 20D,A03,083767,Staff,25,0,30,5
1650483732142,MATH 20E,A01,083771,Staff,5,0,30,25
1650483732142,MATH 20E,A02,083772,Staff,18,0,30,12
1650483732142,MATH 20E,B01,083773,Staff,0,0,30,30
1650483732142,MATH 20E,B02,083774,Staff,10,0,30,20
1650483738169,MATH 103A,A01,083777,Staff,0,12,30,30
1650483738169,MATH 103A,A02,083778,Staff,0,12,30,30
1650483738169,MATH 103A,B01,083779,Staff,0,13,30,30
1650483738169,MATH 103A,B02,083780,Staff,0,12,30,30
1650483744193,MATH 105,A01,085443,Staff,0,23,30,30
1650483750222,MATH 109,A01,083213,Anzaldo; Leesa B,0,7,30,30
1650483750222,MATH 109,A02,083214,Anzaldo; Leesa B,0,7,30,30
1650483750222,MATH 109,B01,083215,Anzaldo; Leesa B,0,5,30,30
1650483750222,MATH 109,B02,083216,Anzaldo; Leesa B,0,6,30,30
1650483756246,MATH 142A,A01,083219,Chow; Bennett,0,15,30,30
1650483756246,MATH 142A,A02,083220,Chow; Bennett,0,13,30,30
1650483756246,MATH 142A,B01,083221,Chow; Bennett,0,12,30,30
1650483756246,MATH 142A,B02,083222,Chow; Bennett,0,13,30,30
1650483762272,MATH 193A,A01,083224,Staff,0,5,30,30
1650483762272,MATH 193A,A02,083225,Staff,0,5,30,30
1650483762272,MATH 193A,A03,083781,Staff,0,5,30,30
1650483762272,MATH 193A,A04,083782,Staff,0,6,30,30
1650483768297,MATH 197,001,091859,McAuley; Julian John,9998,0,9999,1
1650483774346,COGS 9,A01,083615,Staff,0,14,60,60
1650483780381,COGS 11,A01,083617,Boyle; Mary E. T.,20,0,40,20
1650483786410,COGS 13,A01,083071,Staff,0,34,40,40
1650483792435,COGS 14A,A01,092681,Staff,1,25,100,99
1650483798462,COGS 14B,A01,083073,Cheng; Tzu-Han,0,11,50,50
1650483804495,COGS 17,A01,092677,Staff,22,0,75,53
1650483810519,COGS 100,A01,083619,Staff,0,26,60,60
1650483816553,COGS 101A,A01,083621,Davis; Joshua Daniel,0,22,60,60
1650483822578,COGS 101B,A01,091572,Staff,0,4,60,60
1650483828601,COGS 101C,A01,083625,Delgado; Tania,16,0,30,14
1650483834626,COGS 107A,A01,083627,Boyle; Mary E. T.,0,11,60,60
1650483840664,COGS 118A,A01,083075,Staff,0,3,60,60
1650483846692,CSE 3,A50,083646,Miranda; Gregory Joseph,20,0,38,18
1650483846692,CSE 3,A51,083647,Miranda; Gregory Joseph,36,0,37,1
1650483852717,CSE 8A,A50,083650,Miranda; Gregory Joseph,0,28,40,40
1650483858742,CSE 11,A01,083080,Cao; Yingjun,0,92,40,40
1650483864764,CSE 12,A01,083652,Staff,0,17,100,100
1650483870790,CSE 15L,A01,083654,Staff,0,1,50,50
1650483870790,CSE 15L,A02,083655,Staff,0,0,50,50
1650483876819,CSE 20,A01,083657,Staff,51,0,80,29
1650483882856,CSE 30,A01,083084,Eldon; John,0,76,40,40
1650483888879,CSE 100,A01,083659,Cao; Yingjun,0,66,50,50
1650483894913,CSE 134B,A01,083661,Powell; Thomas Allan,0,32,65,65
1650483900937,CSE 140,A01,083663,Staff,0,5,75,75
1650483906961,CSE 140L,A01,083088,Eldon; John,0,9,75,75
1650483912996,CSE 175,A01,083665,Kumar; Rakesh,7,0,25,18
1650483919019,CSE 190,A00,092507,Dubnov; Shlomo,12,0,20,8
1650483925045,ECE 45,A01,083139,Staff,20,19,60,40
1650483931068,ECE 65,A50,083695,Staff,0,6,30,30
1650483937094,ECE 109,A01,091882,Touri; Behrouz,38,0,70,32
1650483943120,ECE 180,A00,083140,Abi Samra; Nicholas Camill,22,0,30,8
1650483943120,ECE 180,B00,083141,Abi Samra; Nicholas Camill,0,0,30,30
1650483949147,MATH 10A,A01,083735,Patchell; Gregory David,5,0,30,25
1650483949147,MATH 10A,A02,083736,Patchell; Gregory David,27,0,30,3
1650483949147,MATH 10A,A03,083737,Patchell; Gregory David,25,0,30,5
1650483955173,MATH 10B,A01,083207,Staff,0,8,30,30
1650483955173,MATH 10B,A02,083208,Staff,0,7,30,30
1650483955173,MATH 10B,B01,083739,Staff,13,0,30,17
1650483955173,MATH 10B,B02,083740,Staff,28,0,30,2
1650483961211,MATH 18,A01,083743,Staff,1,0,30,29
1650483961211,MATH 18,A02,083744,Staff,27,0,30,3
1650483961211,MATH 18,A03,083745,Staff,22,0,30,8
1650483961211,MATH 18,A04,083746,Staff,26,0,30,4
1650483961211,MATH 18,B01,083748,Staff,0,11,30,30
1650483961211,MATH 18,B02,083749,Staff,0,12,30,30
1650483961211,MATH 18,B03,083750,Staff,0,11,30,30
1650483961211,MATH 18,B04,083751,Staff,0,12,30,30
1650483967235,MATH 20A,A01,083754,Staff,25,0,40,15
1650483973257,MATH 20B,A01,083756,Staff,0,11,30,30
1650483973257,MATH 20B,A02,083757,Staff,0,11,30,30
1650483979284,MATH 20C,A01,083760,Staff,0,15,30,30
1650483979284,MATH 20C,A02,083761,Staff,2,15,30,28
1650483979284,MATH 20C,B01,083762,Staff,13,0,30,17
1650483979284,MATH 20C,B02,083763,Staff,28,0,30,2
1650483985310,MATH 20D,A01,083765,Staff,0,1,30,30
1650483985310,MATH 20D,A02,083766,Staff,9,0,30,21
1650483985310,MATH 20D,A03,083767,Staff,25,0,30,5
1650483991337,MATH 20E,A01,083771,Staff,5,0,30,25
1650483991337,MATH 20E,A02,083772,Staff,18,0,30,12
1650483991337,MATH 20E,B01,083773,Staff,0,0,30,30
1650483991337,MATH 20E,B02,083774,Staff,10,0,30,20
1650483997370,MATH 103A,A01,083777,Staff,0,12,30,30
1650483997370,MATH 103A,A02,083778,Staff,0,12,30,30
1650483997370,MATH 103A,B01,083779,Staff,0,13,30,30
1650483997370,MATH 103A,B02,083780,Staff,0,12,30,30
1650484003401,MATH 105,A01,085443,Staff,0,23,30,30
1650484009425,MATH 109,A01,083213,Anzaldo; Leesa B,0,7,30,30
1650484009425,MATH 109,A02,083214,Anzaldo; Leesa B,0,7,30,30
1650484009425,MATH 109,B01,083215,Anzaldo; Leesa B,0,5,30,30
1650484009425,MATH 109,B02,083216,Anzaldo; Leesa B,0,6,30,30
1650484015461,MATH 142A,A01,083219,Chow; Bennett,0,15,30,30
1650484015461,MATH 142A,A02,083220,Chow; Bennett,0,13,30,30
1650484015461,MATH 142A,B01,083221,Chow; Bennett,0,12,30,30
1650484015461,MATH 142A,B02,083222,Chow; Bennett,0,13,30,30
1650484021488,MATH 193A,A01,083224,Staff,0,5,30,30
1650484021488,MATH 193A,A02,083225,Staff,0,5,30,30
1650484021488,MATH 193A,A03,083781,Staff,0,5,30,30
1650484021488,MATH 193A,A04,083782,Staff,0,6,30,30
1650484027513,MATH 197,001,091859,McAuley; Julian John,9998,0,9999,1
1650484033665,COGS 9,A01,083615,Staff,0,14,60,60
1650484039692,COGS 11,A01,083617,Boyle; Mary E. T.,20,0,40,20
1650484045716,COGS 13,A01,083071,Staff,0,34,40,40
1650484051756,COGS 14A,A01,092681,Staff,1,25,100,99
1650484057786,COGS 14B,A01,083073,Cheng; Tzu-Han,0,11,50,50
1650484063816,COGS 17,A01,092677,Staff,22,0,75,53
1650484069852,COGS 100,A01,083619,Staff,0,26,60,60
1650484075877,COGS 101A,A01,083621,Davis; Joshua Daniel,0,22,60,60
1650484081911,COGS 101B,A01,091572,Staff,0,4,60,60
1650484087943,COGS 101C,A01,083625,Delgado; Tania,16,0,30,14
1650484093975,COGS 107A,A01,083627,Boyle; Mary E. T.,0,11,60,60
1650484100007,COGS 118A,A01,083075,Staff,0,3,60,60
1650484106032,CSE 3,A50,083646,Miranda; Gregory Joseph,20,0,38,18
1650484106032,CSE 3,A51,083647,Miranda; Gregory Joseph,36,0,37,1
1650484112061,CSE 8A,A50,083650,Miranda; Gregory Joseph,0,28,40,40
1650484118097,CSE 11,A01,083080,Cao; Yingjun,0,92,40,40
1650484124121,CSE 12,A01,083652,Staff,0,17,100,100
1650484130149,CSE 15L,A01,083654,Staff,0,1,50,50
1650484130149,CSE 15L,A02,083655,Staff,0,0,50,50
1650484136171,CSE 20,A01,083657,Staff,51,0,80,29
1650484142199,CSE 30,A01,083084,Eldon; John,0,76,40,40
1650484148230,CSE 100,A01,083659,Cao; Yingjun,0,66,50,50
1650484154264,CSE 134B,A01,083661,Powell; Thomas Allan,0,32,65,65
1650484160290,CSE 140,A01,083663,Staff,0,5,75,75
1650484166327,CSE 140L,A01,083088,Eldon; John,0,9,75,75
1650484172350,CSE 175,A01,083665,Kumar; Rakesh,7,0,25,18
1650484178377,CSE 190,A00,092507,Dubnov; Shlomo,12,0,20,8
1650484184404,ECE 45,A01,083139,Staff,20,19,60,40
1650484190431,ECE 65,A50,083695,Staff,0,6,30,30
1650484196464,ECE 109,A01,091882,Touri; Behrouz,38,0,70,32
1650484202494,ECE 180,A00,083140,Abi Samra; Nicholas Camill,22,0,30,8
1650484202494,ECE 180,B00,083141,Abi Samra; Nicholas Camill,0,0,30,30
1650484208526,MATH 10A,A01,083735,Patchell; Gregory David,5,0,30,25
1650484208526,MATH 10A,A02,083736,Patchell; Gregory David,27,0,30,3
1650484208526,MATH 10A,A03,083737,Patchell; Gregory David,25,0,30,5
1650484214549,MATH 10B,A01,083207,Staff,0,8,30,30
1650484214549,MATH 10B,A02,083208,Staff,0,7,30,30
1650484214549,MATH 10B,B01,083739,Staff,13,0,30,17
1650484214549,MATH 10B,B02,083740,Staff,28,0,30,2
1650484220579,MATH 18,A01,083743,Staff,1,0,30,29
1650484220579,MATH 18,A02,083744,Staff,27,0,30,3
1650484220579,MATH 18,A03,083745,Staff,22,0,30,8
1650484220579,MATH 18,A04,083746,Staff,26,0,30,4
1650484220579,MATH 18,B01,083748,Staff,0,11,30,30
1650484220579,MATH 18,B02,083749,Staff,0,12,30,30
1650484220579,MATH 18,B03,083750,Staff,0,11,30,30
1650484220579,MATH 18,B04,083751,Staff,0,12,30,30
1650484226612,MATH 20A,A01,083754,Staff,25,0,40,15
1650484232637,MATH 20B,A01,083756,Staff,0,11,30,30
1650484232637,MATH 20B,A02,083757,Staff,0,11,30,30
1650484238682,MATH 20C,A01,083760,Staff,0,15,30,30
1650484238682,MATH 20C,A02,083761,Staff,2,15,30,28
1650484238682,MATH 20C,B01,083762,Staff,13,0,30,17
1650484238682,MATH 20C,B02,083763,Staff,28,0,30,2
1650484244708,MATH 20D,A01,083765,Staff,0,1,30,30
1650484244708,MATH 20D,A02,083766,Staff,9,0,30,21
1650484244708,MATH 20D,A03,083767,Staff,25,0,30,5
1650484250732,MATH 20E,A01,083771,Staff,5,0,30,25
1650484250732,MATH 20E,A02,083772,Staff,18,0,30,12
1650484250732,MATH 20E,B01,083773,Staff,0,0,30,30
1650484250732,MATH 20E,B02,083774,Staff,10,0,30,20
1650484256755,MATH 103A,A01,083777,Staff,0,12,30,30
1650484256755,MATH 103A,A02,083778,Staff,0,12,30,30
1650484256755,MATH 103A,B01,083779,Staff,0,13,30,30
1650484256755,MATH 103A,B02,083780,Staff,0,12,30,30
1650484262779,MATH 105,A01,085443,Staff,0,23,30,30
1650484268811,MATH 109,A01,083213,Anzaldo; Leesa B,0,7,30,30
1650484268811,MATH 109,A02,083214,Anzaldo; Leesa B,0,7,30,30
1650484268811,MATH 109,B01,083215,Anzaldo; Leesa B,0,5,30,30
1650484268811,MATH 109,B02,083216,Anzaldo; Leesa B,0,6,30,30
1650484274838,MATH 142A,A01,083219,Chow; Bennett,0,15,30,30
1650484274838,MATH 142A,A02,083220,Chow; Bennett,0,13,30,30
1650484274838,MATH 142A,B01,083221,Chow; Bennett,0,12,30,30
1650484274838,MATH 142A,B02,083222,Chow; Bennett,0,13,30,30
1650484280861,MATH 193A,A01,083224,Staff,0,5,30,30
1650484280861,MATH 193A,A02,083225,Staff,0,5,30,30
1650484280861,MATH 193A,A03,083781,Staff,0,5,30,30
1650484280861,MATH 193A,A04,083782,Staff,0,6,30,30
1650484286884,MATH 197,001,091859,McAuley; Julian John,9998,0,9999,1
1650484292951,COGS 9,A01,083615,Staff,0,14,60,60
1650484298974,COGS 11,A01,083617,Boyle; Mary E. T.,20,0,40,20
1650484305006,COGS 13,A01,083071,Staff,0,34,40,40
1650484311028,COGS 14A,A01,092681,Staff,1,25,100,99
1650484317052,COGS 14B,A01,083073,Cheng; Tzu-Han,0,11,50,50
1650484323076,COGS 17,A01,092677,Staff,22,0,75,53
1650484329102,COGS 100,A01,083619,Staff,0,26,60,60
1650484335128,COGS 101A,A01,083621,Davis; Joshua Daniel,0,22,60,60
1650484341153,COGS 101B,A01,091572,Staff,0,4,60,60
1650484347177,COGS 101C,A01,083625,Delgado; Tania,16,0,30,14
1650484353204,COGS 107A,A01,083627,Boyle; Mary E. T.,0,11,60,60
1650484359231,COGS 118A,A01,083075,Staff,0,3,60,60
1650484365255,CSE 3,A50,083646,Miranda; Gregory Joseph,20,0,38,18
1650484365255,CSE 3,A51,083647,Miranda; Gregory Joseph,36,0,37,1
1650484371283,CSE 8A,A50,083650,Miranda; Gregory Joseph,0,28,40,40
1650484377308,CSE 11,A01,083080,Cao; Yingjun,0,92,40,40
1650484383347,CSE 12,A01,083652,Staff,0,17,100,100
1650484389373,CSE 15L,A01,083654,Staff,0,1,50,50
1650484389373,CSE 15L,A02,083655,Staff,0,0,50,50
1650484395401,CSE 20,A01,083657,Staff,51,0,80,29
1650484401425,CSE 30,A01,083084,Eldon; John,0,76,40,40
1650484407452,CSE 100,A01,083659,Cao; Yingjun,0,66,50,50
1650484413476,CSE 134B,A01,083661,Powell; Thomas Allan,0,32,65,65
1650484419503,CSE 140,A01,083663,Staff,0,5,75,75
1650484425527,CSE 140L,A01,083088,Eldon; John,0,9,75,75
1650484431552,CSE 175,A01,083665,Kumar; Rakesh,7,0,25,18
1650484437577,CSE 190,A00,092507,Dubnov; Shlomo,11,0,20,9
1650484443602,ECE 45,A01,083139,Staff,20,19,60,40
1650484449626,ECE 65,A50,083695,Staff,0,6,30,30
1650484455658,ECE 109,A01,091882,Touri; Behrouz,38,0,70,32
1650484461681,ECE 180,A00,083140,Abi Samra; Nicholas Camill,22,0,30,8
1650484461681,ECE 180,B00,083141,Abi Samra; Nicholas Camill,0,0,30,30
1650484467712,MATH 10A,A01,083735,Patchell; Gregory David,5,0,30,25
1650484467712,MATH 10A,A02,083736,Patchell; Gregory David,27,0,30,3
1650484467712,MATH 10A,A03,083737,Patchell; Gregory David,25,0,30,5
1650484473742,MATH 10B,A01,083207,Staff,0,8,30,30
1650484473742,MATH 10B,A02,083208,Staff,0,7,30,30
1650484473742,MATH 10B,B01,083739,Staff,13,0,30,17
1650484473742,MATH 10B,B02,083740,Staff,28,0,30,2
1650484479766,MATH 18,A01,083743,Staff,0,0,30,30
1650484479766,MATH 18,A02,083744,Staff,27,0,30,3
1650484479766,MATH 18,A03,083745,Staff,22,0,30,8
1650484479766,MATH 18,A04,083746,Staff,26,0,30,4
1650484479766,MATH 18,B01,083748,Staff,0,11,30,30
1650484479766,MATH 18,B02,083749,Staff,0,12,30,30
1650484479766,MATH 18,B03,083750,Staff,0,11,30,30
1650484479766,MATH 18,B04,083751,Staff,0,12,30,30
1650484485791,MATH 20A,A01,083754,Staff,25,0,40,15
1650484491818,MATH 20B,A01,083756,Staff,0,11,30,30
1650484491818,MATH 20B,A02,083757,Staff,0,11,30,30
1650484497842,MATH 20C,A01,083760,Staff,0,15,30,30
1650484497842,MATH 20C,A02,083761,Staff,2,15,30,28
1650484497842,MATH 20C,B01,083762,Staff,13,0,30,17
1650484497842,MATH 20C,B02,083763,Staff,28,0,30,2
1650484503881,MATH 20D,A01,083765,Staff,0,1,30,30
1650484503881,MATH 20D,A02,083766,Staff,9,0,30,21
1650484503881,MATH 20D,A03,083767,Staff,25,0,30,5
1650484509905,MATH 20E,A01,083771,Staff,5,0,30,25
1650484509905,MATH 20E,A02,083772,Staff,18,0,30,12
1650484509905,MATH 20E,B01,083773,Staff,0,0,30,30
1650484509905,MATH 20E,B02,083774,Staff,10,0,30,20
1650484515933,MATH 103A,A01,083777,Staff,0,12,30,30
1650484515933,MATH 103A,A02,083778,Staff,0,12,30,30
1650484515933,MATH 103A,B01,083779,Staff,0,13,30,30
1650484515933,MATH 103A,B02,083780,Staff,0,12,30,30
1650484521959,MATH 105,A01,085443,Staff,0,23,30,30
1650484527985,MATH 109,A01,083213,Anzaldo; Leesa B,0,7,30,30
1650484527985,MATH 109,A02,083214,Anzaldo; Leesa B,0,7,30,30
1650484527985,MATH 109,B01,083215,Anzaldo; Leesa B,0,5,30,30
1650484527985,MATH 109,B02,083216,Anzaldo; Leesa B,0,6,30,30
1650484534010,MATH 142A,A01,083219,Chow; Bennett,0,15,30,30
1650484534010,MATH 142A,A02,083220,Chow; Bennett,0,13,30,30
1650484534010,MATH 142A,B01,083221,Chow; Bennett,0,12,30,30
1650484534010,MATH 142A,B02,083222,Chow; Bennett,0,13,30,30
1650484540046,MATH 193A,A01,083224,Staff,0,5,30,30
1650484540046,MATH 193A,A02,083225,Staff,0,5,30,30
1650484540046,MATH 193A,A03,083781,Staff,0,5,30,30
1650484540046,MATH 193A,A04,083782,Staff,0,6,30,30
1650484546080,MATH 197,001,091859,McAuley; Julian John,9998,0,9999,1
1650484552135,COGS 9,A01,083615,Staff,0,14,60,60
1650484558158,COGS 11,A01,083617,Boyle; Mary E. T.,20,0,40,20
1650484564185,COGS 13,A01,083071,Staff,0,34,40,40
1650484570210,COGS 14A,A01,092681,Staff,1,25,100,99
1650484576232,COGS 14B,A01,083073,Cheng; Tzu-Han,0,11,50,50
1650484582255,COGS 17,A01,092677,Staff,22,0,75,53
1650484588279,COGS 100,A01,083619,Staff,0,26,60,60
1650484594305,COGS 101A,A01,083621,Davis; Joshua Daniel,0,22,60,60
1650484600332,COGS 101B,A01,091572,Staff,0,4,60,60
1650484606355,COGS 101C,A01,083625,Delgado; Tania,16,0,30,14
1650484612379,COGS 107A,A01,083627,Boyle; Mary E. T.,0,11,60,60
1650484618407,COGS 118A,A01,083075,Staff,0,3,60,60
1650484624525,CSE 3,A50,083646,Miranda; Gregory Joseph,20,0,38,18
1650484624525,CSE 3,A51,083647,Miranda; Gregory Joseph,36,0,37,1
1650484630560,CSE 8A,A50,083650,Miranda; Gregory Joseph,0,28,40,40
1650484636583,CSE 11,A01,083080,Cao; Yingjun,0,92,40,40
1650484642606,CSE 12,A01,083652,Staff,0,17,100,100
1650484648636,CSE 15L,A01,083654,Staff,0,1,50,50
1650484648636,CSE 15L,A02,083655,Staff,0,0,50,50
1650484654661,CSE 20,A01,083657,Staff,51,0,80,29
1650484660685,CSE 30,A01,083084,Eldon; John,0,76,40,40
1650484666710,CSE 100,A01,083659,Cao; Yingjun,0,66,50,50
1650484672739,CSE 134B,A01,083661,Powell; Thomas Allan,0,32,65,65
1650484678775,CSE 140,A01,083663,Staff,0,5,75,75
1650484684804,CSE 140L,A01,083088,Eldon; John,0,9,75,75
1650484690828,CSE 175,A01,083665,Kumar; Rakesh,7,0,25,18
1650484696850,CSE 190,A00,092507,Dubnov; Shlomo,11,0,20,9
1650484702878,ECE 45,A01,083139,Staff,20,19,60,40
1650484708899,ECE 65,A50,083695,Staff,0,6,30,30
1650484714923,ECE 109,A01,091882,Touri; Behrouz,38,0,70,32
1650484720949,ECE 180,A00,083140,Abi Samra; Nicholas Camill,22,0,30,8
1650484720949,ECE 180,B00,083141,Abi Samra; Nicholas Camill,0,0,30,30
1650484726977,MATH 10A,A01,083735,Patchell; Gregory David,5,0,30,25
1650484726977,MATH 10A,A02,083736,Patchell; Gregory David,27,0,30,3
1650484726977,MATH 10A,A03,083737,Patchell; Gregory David,25,0,30,5
1650484733004,MATH 10B,A01,083207,Staff,0,8,30,30
1650484733004,MATH 10B,A02,083208,Staff,0,7,30,30
1650484733004,MATH 10B,B01,083739,Staff,13,0,30,17
1650484733004,MATH 10B,B02,083740,Staff,28,0,30,2
1650484739035,MATH 18,A01,083743,Staff,1,0,30,29
1650484739035,MATH 18,A02,083744,Staff,27,0,30,3
1650484739035,MATH 18,A03,083745,Staff,22,0,30,8
1650484739035,MATH 18,A04,083746,Staff,26,0,30,4
1650484739035,MATH 18,B01,083748,Staff,0,11,30,30
1650484739035,MATH 18,B02,083749,Staff,0,12,30,30
1650484739035,MATH 18,B03,083750,Staff,0,11,30,30
1650484739035,MATH 18,B04,083751,Staff,0,12,30,30
1650484745062,MATH 20A,A01,083754,Staff,25,0,40,15
1650484751086,MATH 20B,A01,083756,Staff,0,11,30,30
1650484751086,MATH 20B,A02,083757,Staff,0,11,30,30
1650484757114,MATH 20C,A01,083760,Staff,0,15,30,30
1650484757114,MATH 20C,A02,083761,Staff,2,15,30,28
1650484757114,MATH 20C,B01,083762,Staff,13,0,30,17
1650484757114,MATH 20C,B02,083763,Staff,28,0,30,2
1650484763140,MATH 20D,A01,083765,Staff,0,1,30,30
1650484763140,MATH 20D,A02,083766,Staff,9,0,30,21
1650484763140,MATH 20D,A03,083767,Staff,25,0,30,5
1650484769176,MATH 20E,A01,083771,Staff,5,0,30,25
1650484769176,MATH 20E,A02,083772,Staff,18,0,30,12
1650484769176,MATH 20E,B01,083773,Staff,0,0,30,30
1650484769176,MATH 20E,B02,083774,Staff,10,0,30,20
1650484775201,MATH 103A,A01,083777,Staff,0,12,30,30
1650484775201,MATH 103A,A02,083778,Staff,0,12,30,30
1650484775201,MATH 103A,B01,083779,Staff,0,13,30,30
1650484775201,MATH 103A,B02,083780,Staff,0,12,30,30
1650484781224,MATH 105,A01,085443,Staff,0,23,30,30
1650484787253,MATH 109,A01,083213,Anzaldo; Leesa B,0,7,30,30
1650484787253,MATH 109,A02,083214,Anzaldo; Leesa B,0,7,30,30
1650484787253,MATH 109,B01,083215,Anzaldo; Leesa B,0,5,30,30
1650484787253,MATH 109,B02,083216,Anzaldo; Leesa B,0,6,30,30
1650484793276,MATH 142A,A01,083219,Chow; Bennett,0,15,30,30
1650484793276,MATH 142A,A02,083220,Chow; Bennett,0,13,30,30
1650484793276,MATH 142A,B01,083221,Chow; Bennett,0,12,30,30
1650484793276,MATH 142A,B02,083222,Chow; Bennett,0,13,30,30
1650484799309,MATH 193A,A01,083224,Staff,0,5,30,30
1650484799309,MATH 193A,A02,083225,Staff,0,5,30,30
1650484799309,MATH 193A,A03,083781,Staff,0,5,30,30
1650484799309,MATH 193A,A04,083782,Staff,0,6,30,30
1650484805340,MATH 197,001,091859,McAuley; Julian John,9998,0,9999,1
1650484811396,COGS 9,A01,083615,Staff,0,14,60,60
1650484817431,COGS 11,A01,083617,Boyle; Mary E. T.,20,0,40,20
1650484823458,COGS 13,A01,083071,Staff,0,34,40,40
1650484829482,COGS 14A,A01,092681,Staff,1,25,100,99
1650484835511,COGS 14B,A01,083073,Cheng; Tzu-Han,0,11,50,50
1650484841535,COGS 17,A01,092677,Staff,22,0,75,53
1650484847560,COGS 100,A01,083619,Staff,0,26,60,60
1650484853600,COGS 101A,A01,083621,Davis; Joshua Daniel,0,22,60,60
1650484859627,COGS 101B,A01,091572,Staff,0,4,60,60
1650484865656,COGS 101C,A01,083625,Delgado; Tania,16,0,30,14
1650484871679,COGS 107A,A01,083627,Boyle; Mary E. T.,0,11,60,60
1650484877703,COGS 118A,A01,083075,Staff,0,3,60,60
1650484883727,CSE 3,A50,083646,Miranda; Gregory Joseph,20,0,38,18
1650484883727,CSE 3,A51,083647,Miranda; Gregory Joseph,36,0,37,1
1650484889764,CSE 8A,A50,083650,Miranda; Gregory Joseph,1,28,40,39
1650484895790,CSE 11,A01,083080,Cao; Yingjun,0,92,40,40
1650484901815,CSE 12,A01,083652,Staff,0,17,100,100
1650484907839,CSE 15L,A01,083654,Staff,0,1,50,50
1650484907839,CSE 15L,A02,083655,Staff,0,0,50,50
1650484913866,CSE 20,A01,083657,Staff,51,0,80,29
1650484919908,CSE 30,A01,083084,Eldon; John,0,76,40,40
1650484925934,CSE 100,A01,083659,Cao; Yingjun,0,66,50,50
1650484931961,CSE 134B,A01,083661,Powell; Thomas Allan,0,32,65,65
1650484937984,CSE 140,A01,083663,Staff,0,5,75,75
1650484944020,CSE 140L,A01,083088,Eldon; John,0,9,75,75
1650484950043,CSE 175,A01,083665,Kumar; Rakesh,7,0,25,18
1650484956069,CSE 190,A00,092507,Dubnov; Shlomo,11,0,20,9
1650484962101,ECE 45,A01,083139,Staff,20,19,60,40
1650484968124,ECE 65,A50,083695,Staff,0,6,30,30
1650484974150,ECE 109,A01,091882,Touri; Behrouz,38,0,70,32
1650484980186,ECE 180,A00,083140,Abi Samra; Nicholas Camill,22,0,30,8
1650484980186,ECE 180,B00,083141,Abi Samra; Nicholas Camill,0,0,30,30
1650484986210,MATH 10A,A01,083735,Patchell; Gregory David,5,0,30,25
1650484986210,MATH 10A,A02,083736,Patchell; Gregory David,27,0,30,3
1650484986210,MATH 10A,A03,083737,Patchell; Gregory David,25,0,30,5
1650484992278,MATH 10B,A01,083207,Staff,0,8,30,30
1650484992278,MATH 10B,A02,083208,Staff,0,7,30,30
1650484992278,MATH 10B,B01,083739,Staff,13,0,30,17
1650484992278,MATH 10B,B02,083740,Staff,28,0,30,2
1650484998305,MATH 18,A01,083743,Staff,0,0,30,30
1650484998305,MATH 18,A02,083744,Staff,27,0,30,3
1650484998305,MATH 18,A03,083745,Staff,22,0,30,8
1650484998305,MATH 18,A04,083746,Staff,26,0,30,4
1650484998305,MATH 18,B01,083748,Staff,0,11,30,30
1650484998305,MATH 18,B02,083749,Staff,0,12,30,30
1650484998305,MATH 18,B03,083750,Staff,0,11,30,30
1650484998305,MATH 18,B04,083751,Staff,0,12,30,30
1650485004334,MATH 20A,A01,083754,Staff,25,0,40,15
1650485010365,MATH 20B,A01,083756,Staff,0,11,30,30
1650485010365,MATH 20B,A02,083757,Staff,0,11,30,30
1650485016392,MATH 20C,A01,083760,Staff,0,15,30,30
1650485016392,MATH 20C,A02,083761,Staff,2,15,30,28
1650485016392,MATH 20C,B01,083762,Staff,13,0,30,17
1650485016392,MATH 20C,B02,083763,Staff,28,0,30,2
1650485022424,MATH 20D,A01,083765,Staff,0,1,30,30
1650485022424,MATH 20D,A02,083766,Staff,9,0,30,21
1650485022424,MATH 20D,A03,083767,Staff,25,0,30,5
1650485028447,MATH 20E,A01,083771,Staff,5,0,30,25
1650485028447,MATH 20E,A02,083772,Staff,18,0,30,12
1650485028447,MATH 20E,B01,083773,Staff,0,0,30,30
1650485028447,MATH 20E,B02,083774,Staff,10,0,30,20
1650485034474,MATH 103A,A01,083777,Staff,0,12,30,30
1650485034474,MATH 103A,A02,083778,Staff,0,12,30,30
1650485034474,MATH 103A,B01,083779,Staff,0,13,30,30
1650485034474,MATH 103A,B02,083780,Staff,0,12,30,30
1650485040497,MATH 105,A01,085443,Staff,0,23,30,30
1650485046523,MATH 109,A01,083213,Anzaldo; Leesa B,0,7,30,30
1650485046523,MATH 109,A02,083214,Anzaldo; Leesa B,0,7,30,30
1650485046523,MATH 109,B01,083215,Anzaldo; Leesa B,0,5,30,30
1650485046523,MATH 109,B02,083216,Anzaldo; Leesa B,0,6,30,30
1650485052549,MATH 142A,A01,083219,Chow; Bennett,0,15,30,30
1650485052549,MATH 142A,A02,083220,Chow; Bennett,0,13,30,30
1650485052549,MATH 142A,B01,083221,Chow; Bennett,0,12,30,30
1650485052549,MATH 142A,B02,083222,Chow; Bennett,0,13,30,30
1650485058579,MATH 193A,A01,083224,Staff,0,5,30,30
1650485058579,MATH 193A,A02,083225,Staff,0,5,30,30
1650485058579,MATH 193A,A03,083781,Staff,0,5,30,30
1650485058579,MATH 193A,A04,083782,Staff,0,6,30,30
1650485064603,MATH 197,001,091859,McAuley; Julian John,9998,0,9999,1
1650485070664,COGS 9,A01,083615,Staff,0,14,60,60
1650485076692,COGS 11,A01,083617,Boyle; Mary E. T.,20,0,40,20
1650485082714,COGS 13,A01,083071,Staff,0,34,40,40
1650485088736,COGS 14A,A01,092681,Staff,1,25,100,99
1650485094761,COGS 14B,A01,083073,Cheng; Tzu-Han,0,11,50,50
1650485100785,COGS 17,A01,092677,Staff,22,0,75,53
1650485106810,COGS 100,A01,083619,Staff,0,26,60,60
1650485112836,COGS 101A,A01,083621,Davis; Joshua Daniel,0,22,60,60
1650485118861,COGS 101B,A01,091572,Staff,0,4,60,60
1650485124886,COGS 101C,A01,083625,Delgado; Tania,16,0,30,14
1650485130914,COGS 107A,A01,083627,Boyle; Mary E. T.,0,11,60,60
1650485136936,COGS 118A,A01,083075,Staff,0,3,60,60
1650485142959,CSE 3,A50,083646,Miranda; Gregory Joseph,20,0,38,18
1650485142959,CSE 3,A51,083647,Miranda; Gregory Joseph,36,0,37,1
1650485149004,CSE 8A,A50,083650,Miranda; Gregory Joseph,1,28,40,39
1650485155035,CSE 11,A01,083080,Cao; Yingjun,0,92,40,40
1650485161070,CSE 12,A01,083652,Staff,0,17,100,100
1650485167100,CSE 15L,A01,083654,Staff,0,1,50,50
1650485167100,CSE 15L,A02,083655,Staff,0,0,50,50
1650485173123,CSE 20,A01,083657,Staff,51,0,80,29
1650485179147,CSE 30,A01,083084,Eldon; John,0,76,40,40
1650485185170,CSE 100,A01,083659,Cao; Yingjun,0,66,50,50
1650485191198,CSE 134B,A01,083661,Powell; Thomas Allan,0,32,65,65
1650485197227,CSE 140,A01,083663,Staff,0,5,75,75
1650485203252,CSE 140L,A01,083088,Eldon; John,0,9,75,75
1650485209275,CSE 175,A01,083665,Kumar; Rakesh,7,0,25,18
1650485215309,CSE 190,A00,092507,Dubnov; Shlomo,11,0,20,9
1650485221430,ECE 45,A01,083139,Staff,20,19,60,40
1650485227453,ECE 65,A50,083695,Staff,0,6,30,30
1650485233475,ECE 109,A01,091882,Touri; Behrouz,38,0,70,32
1650485239499,ECE 180,A00,083140,Abi Samra; Nicholas Camill,22,0,30,8
1650485239499,ECE 180,B00,083141,Abi Samra; Nicholas Camill,0,0,30,30
1650485245523,MATH 10A,A01,083735,Patchell; Gregory David,5,0,30,25
1650485245523,MATH 10A,A02,083736,Patchell; Gregory David,27,0,30,3
1650485245523,MATH 10A,A03,083737,Patchell; Gregory David,25,0,30,5
1650485251560,MATH 10B,A01,083207,Staff,0,8,30,30
1650485251560,MATH 10B,A02,083208,Staff,0,7,30,30
1650485251560,MATH 10B,B01,083739,Staff,13,0,30,17
1650485251560,MATH 10B,B02,083740,Staff,28,0,30,2
1650485257589,MATH 18,A01,083743,Staff,0,0,30,30
1650485257589,MATH 18,A02,083744,Staff,27,0,30,3
1650485257589,MATH 18,A03,083745,Staff,22,0,30,8
1650485257589,MATH 18,A04,083746,Staff,26,0,30,4
1650485257589,MATH 18,B01,083748,Staff,0,11,30,30
1650485257589,MATH 18,B02,083749,Staff,0,12,30,30
1650485257589,MATH 18,B03,083750,Staff,0,11,30,30
1650485257589,MATH 18,B04,083751,Staff,0,12,30,30
1650485263615,MATH 20A,A01,083754,Staff,25,0,40,15
1650485269645,MATH 20B,A01,083756,Staff,0,11,30,30
1650485269645,MATH 20B,A02,083757,Staff,0,11,30,30
1650485275684,MATH 20C,A01,083760,Staff,0,15,30,30
1650485275684,MATH 20C,A02,083761,Staff,2,15,30,28
1650485275684,MATH 20C,B01,083762,Staff,13,0,30,17
1650485275684,MATH 20C,B02,083763,Staff,28,0,30,2
1650485281707,MATH 20D,A01,083765,Staff,0,1,30,30
1650485281707,MATH 20D,A02,083766,Staff,9,0,30,21
1650485281707,MATH 20D,A03,083767,Staff,25,0,30,5
1650485287734,MATH 20E,A01,083771,Staff,5,0,30,25
1650485287734,MATH 20E,A02,083772,Staff,18,0,30,12
1650485287734,MATH 20E,B01,083773,Staff,0,0,30,30
1650485287734,MATH 20E,B02,083774,Staff,10,0,30,20
1650485293757,MATH 103A,A01,083777,Staff,0,12,30,30
1650485293757,MATH 103A,A02,083778,Staff,0,12,30,30
1650485293757,MATH 103A,B01,083779,Staff,0,13,30,30
1650485293757,MATH 103A,B02,083780,Staff,0,12,30,30
1650485299779,MATH 105,A01,085443,Staff,0,23,30,30
1650485305807,MATH 109,A01,083213,Anzaldo; Leesa B,0,7,30,30
1650485305807,MATH 109,A02,083214,Anzaldo; Leesa B,0,7,30,30
1650485305807,MATH 109,B01,083215,Anzaldo; Leesa B,0,5,30,30
1650485305807,MATH 109,B02,083216,Anzaldo; Leesa B,0,6,30,30
1650485311836,MATH 142A,A01,083219,Chow; Bennett,0,15,30,30
1650485311836,MATH 142A,A02,083220,Chow; Bennett,0,13,30,30
1650485311836,MATH 142A,B01,083221,Chow; Bennett,0,12,30,30
1650485311836,MATH 142A,B02,083222,Chow; Bennett,0,13,30,30
1650485317864,MATH 193A,A01,083224,Staff,0,5,30,30
1650485317864,MATH 193A,A02,083225,Staff,0,5,30,30
1650485317864,MATH 193A,A03,083781,Staff,0,5,30,30
1650485317864,MATH 193A,A04,083782,Staff,0,6,30,30
1650485323886,MATH 197,001,091859,McAuley; Julian John,9998,0,9999,1
1650485329943,COGS 9,A01,083615,Staff,0,14,60,60
1650485335965,COGS 11,A01,083617,Boyle; Mary E. T.,20,0,40,20
1650485341989,COGS 13,A01,083071,Staff,0,34,40,40
1650485348019,COGS 14A,A01,092681,Staff,1,25,100,99
1650485354046,COGS 14B,A01,083073,Cheng; Tzu-Han,0,11,50,50
1650485360072,COGS 17,A01,092677,Staff,22,0,75,53
1650485366095,COGS 100,A01,083619,Staff,0,26,60,60
1650485372117,COGS 101A,A01,083621,Davis; Joshua Daniel,0,22,60,60
1650485378140,COGS 101B,A01,091572,Staff,0,4,60,60
1650485384164,COGS 101C,A01,083625,Delgado; Tania,16,0,30,14
1650485390185,COGS 107A,A01,083627,Boyle; Mary E. T.,0,11,60,60
1650485396209,COGS 118A,A01,083075,Staff,0,3,60,60
1650485402233,CSE 3,A50,083646,Miranda; Gregory Joseph,20,0,38,18
1650485402233,CSE 3,A51,083647,Miranda; Gregory Joseph,36,0,37,1
1650485408257,CSE 8A,A50,083650,Miranda; Gregory Joseph,1,28,40,39
1650485414280,CSE 11,A01,083080,Cao; Yingjun,0,92,40,40
1650485420311,CSE 12,A01,083652,Staff,0,17,100,100
1650485426338,CSE 15L,A01,083654,Staff,0,1,50,50
1650485426338,CSE 15L,A02,083655,Staff,0,0,50,50
1650485432361,CSE 20,A01,083657,Staff,51,0,80,29
1650485438386,CSE 30,A01,083084,Eldon; John,0,76,40,40
1650485444412,CSE 100,A01,083659,Cao; Yingjun,0,66,50,50
1650485450436,CSE 134B,A01,083661,Powell; Thomas Allan,0,32,65,65
1650485456462,CSE 140,A01,083663,Staff,0,5,75,75
1650485462494,CSE 140L,A01,083088,Eldon; John,0,9,75,75
1650485468525,CSE 175,A01,083665,Kumar; Rakesh,7,0,25,18
1650485474559,CSE 190,A00,092507,Dubnov; Shlomo,11,0,20,9
1650485480585,ECE 45,A01,083139,Staff,20,19,60,40
1650485486615,ECE 65,A50,083695,Staff,0,6,30,30
1650485492638,ECE 109,A01,091882,Touri; Behrouz,38,0,70,32
1650485498662,ECE 180,A00,083140,Abi Samra; Nicholas Camill,22,0,30,8
1650485498662,ECE 180,B00,083141,Abi Samra; Nicholas Camill,0,0,30,30
1650485504686,MATH 10A,A01,083735,Patchell; Gregory David,5,0,30,25
1650485504686,MATH 10A,A02,083736,Patchell; Gregory David,27,0,30,3
1650485504686,MATH 10A,A03,083737,Patchell; Gregory David,25,0,30,5
1650485510714,MATH 10B,A01,083207,Staff,0,8,30,30
1650485510714,MATH 10B,A02,083208,Staff,0,7,30,30
1650485510714,MATH 10B,B01,083739,Staff,13,0,30,17
1650485510714,MATH 10B,B02,083740,Staff,28,0,30,2
1650485516742,MATH 18,A01,083743,Staff,0,0,30,30
1650485516742,MATH 18,A02,083744,Staff,27,0,30,3
1650485516742,MATH 18,A03,083745,Staff,22,0,30,8
1650485516742,MATH 18,A04,083746,Staff,26,0,30,4
1650485516742,MATH 18,B01,083748,Staff,0,11,30,30
1650485516742,MATH 18,B02,083749,Staff,0,12,30,30
1650485516742,MATH 18,B03,083750,Staff,0,11,30,30
1650485516742,MATH 18,B04,083751,Staff,0,12,30,30
1650485522769,MATH 20A,A01,083754,Staff,25,0,40,15
1650485528793,MATH 20B,A01,083756,Staff,0,11,30,30
1650485528793,MATH 20B,A02,083757,Staff,0,11,30,30
1650485534825,MATH 20C,A01,083760,Staff,0,15,30,30
1650485534825,MATH 20C,A02,083761,Staff,2,15,30,28
1650485534825,MATH 20C,B01,083762,Staff,13,0,30,17
1650485534825,MATH 20C,B02,083763,Staff,28,0,30,2
1650485540848,MATH 20D,A01,083765,Staff,0,1,30,30
1650485540848,MATH 20D,A02,083766,Staff,9,0,30,21
1650485540848,MATH 20D,A03,083767,Staff,25,0,30,5
1650485546874,MATH 20E,A01,083771,Staff,5,0,30,25
1650485546874,MATH 20E,A02,083772,Staff,18,0,30,12
1650485546874,MATH 20E,B01,083773,Staff,0,0,30,30
1650485546874,MATH 20E,B02,083774,Staff,10,0,30,20
1650485552910,MATH 103A,A01,083777,Staff,0,12,30,30
1650485552910,MATH 103A,A02,083778,Staff,0,12,30,30
1650485552910,MATH 103A,B01,083779,Staff,0,13,30,30
1650485552910,MATH 103A,B02,083780,Staff,0,12,30,30
1650485558934,MATH 105,A01,085443,Staff,0,23,30,30
1650485564958,MATH 109,A01,083213,Anzaldo; Leesa B,0,7,30,30
1650485564958,MATH 109,A02,083214,Anzaldo; Leesa B,0,7,30,30
1650485564958,MATH 109,B01,083215,Anzaldo; Leesa B,0,5,30,30
1650485564958,MATH 109,B02,083216,Anzaldo; Leesa B,0,6,30,30
1650485570990,MATH 142A,A01,083219,Chow; Bennett,0,15,30,30
1650485570990,MATH 142A,A02,083220,Chow; Bennett,0,13,30,30
1650485570990,MATH 142A,B01,083221,Chow; Bennett,0,12,30,30
1650485570990,MATH 142A,B02,083222,Chow; Bennett,0,13,30,30
1650485577014,MATH 193A,A01,083224,Staff,0,5,30,30
1650485577014,MATH 193A,A02,083225,Staff,0,5,30,30
1650485577014,MATH 193A,A03,083781,Staff,0,5,30,30
1650485577014,MATH 193A,A04,083782,Staff,0,6,30,30
1650485583040,MATH 197,001,091859,McAuley; Julian John,9998,0,9999,1
1650485589107,COGS 9,A01,083615,Staff,0,14,60,60
1650485595131,COGS 11,A01,083617,Boyle; Mary E. T.,20,0,40,20
1650485601153,COGS 13,A01,083071,Staff,0,34,40,40
1650485607177,COGS 14A,A01,092681,Staff,1,25,100,99
1650485613200,COGS 14B,A01,083073,Cheng; Tzu-Han,0,11,50,50
1650485619221,COGS 17,A01,092677,Staff,22,0,75,53
1650485625246,COGS 100,A01,083619,Staff,0,26,60,60
1650485631274,COGS 101A,A01,083621,Davis; Joshua Daniel,0,22,60,60
1650485637300,COGS 101B,A01,091572,Staff,0,4,60,60
1650485643326,COGS 101C,A01,083625,Delgado; Tania,16,0,30,14
1650485649364,COGS 107A,A01,083627,Boyle; Mary E. T.,0,11,60,60
1650485655392,COGS 118A,A01,083075,Staff,0,3,60,60
1650485661419,CSE 3,A50,083646,Miranda; Gregory Joseph,20,0,38,18
1650485661419,CSE 3,A51,083647,Miranda; Gregory Joseph,36,0,37,1
1650485667449,CSE 8A,A50,083650,Miranda; Gregory Joseph,1,28,40,39
1650485673474,CSE 11,A01,083080,Cao; Yingjun,0,92,40,40
1650485679501,CSE 12,A01,083652,Staff,0,17,100,100
1650485685524,CSE 15L,A01,083654,Staff,0,1,50,50
1650485685524,CSE 15L,A02,083655,Staff,0,0,50,50
1650485691547,CSE 20,A01,083657,Staff,51,0,80,29
1650485697570,CSE 30,A01,083084,Eldon; John,0,76,40,40
1650485703595,CSE 100,A01,083659,Cao; Yingjun,0,66,50,50
1650485709621,CSE 134B,A01,083661,Powell; Thomas Allan,0,32,65,65
1650485715645,CSE 140,A01,083663,Staff,0,5,75,75
1650485721672,CSE 140L,A01,083088,Eldon; John,0,9,75,75
1650485727696,CSE 175,A01,083665,Kumar; Rakesh,7,0,25,18
1650485733720,CSE 190,A00,092507,Dubnov; Shlomo,11,0,20,9
1650485739747,ECE 45,A01,083139,Staff,20,19,60,40
1650485745775,ECE 65,A50,083695,Staff,0,6,30,30
1650485751810,ECE 109,A01,091882,Touri; Behrouz,38,0,70,32
1650485757835,ECE 180,A00,083140,Abi Samra; Nicholas Camill,22,0,30,8
1650485757835,ECE 180,B00,083141,Abi Samra; Nicholas Camill,0,0,30,30
1650485763858,MATH 10A,A01,083735,Patchell; Gregory David,5,0,30,25
1650485763858,MATH 10A,A02,083736,Patchell; Gregory David,27,0,30,3
1650485763858,MATH 10A,A03,083737,Patchell; Gregory David,25,0,30,5
1650485769881,MATH 10B,A01,083207,Staff,0,8,30,30
1650485769881,MATH 10B,A02,083208,Staff,0,7,30,30
1650485769881,MATH 10B,B01,083739,Staff,13,0,30,17
1650485769881,MATH 10B,B02,083740,Staff,28,0,30,2
1650485775912,MATH 18,A01,083743,Staff,0,0,30,30
1650485775912,MATH 18,A02,083744,Staff,27,0,30,3
1650485775912,MATH 18,A03,083745,Staff,22,0,30,8
1650485775912,MATH 18,A04,083746,Staff,26,0,30,4
1650485775912,MATH 18,B01,083748,Staff,0,11,30,30
1650485775912,MATH 18,B02,083749,Staff,0,12,30,30
1650485775912,MATH 18,B03,083750,Staff,0,11,30,30
1650485775912,MATH 18,B04,083751,Staff,0,12,30,30
1650485781934,MATH 20A,A01,083754,Staff,25,0,40,15
1650485787976,MATH 20B,A01,083756,Staff,0,11,30,30
1650485787976,MATH 20B,A02,083757,Staff,0,11,30,30
1650485794003,MATH 20C,A01,083760,Staff,0,15,30,30
1650485794003,MATH 20C,A02,083761,Staff,2,15,30,28
1650485794003,MATH 20C,B01,083762,Staff,13,0,30,17
1650485794003,MATH 20C,B02,083763,Staff,28,0,30,2
1650485800030,MATH 20D,A01,083765,Staff,0,1,30,30
1650485800030,MATH 20D,A02,083766,Staff,9,0,30,21
1650485800030,MATH 20D,A03,083767,Staff,25,0,30,5
1650485806072,MATH 20E,A01,083771,Staff,5,0,30,25
1650485806072,MATH 20E,A02,083772,Staff,18,0,30,12
1650485806072,MATH 20E,B01,083773,Staff,0,0,30,30
1650485806072,MATH 20E,B02,083774,Staff,10,0,30,20
1650485812095,MATH 103A,A01,083777,Staff,0,12,30,30
1650485812095,MATH 103A,A02,083778,Staff,0,12,30,30
1650485812095,MATH 103A,B01,083779,Staff,0,13,30,30
1650485812095,MATH 103A,B02,083780,Staff,0,12,30,30
1650485818213,MATH 105,A01,085443,Staff,0,23,30,30
1650485824238,MATH 109,A01,083213,Anzaldo; Leesa B,0,7,30,30
1650485824238,MATH 109,A02,083214,Anzaldo; Leesa B,0,7,30,30
1650485824238,MATH 109,B01,083215,Anzaldo; Leesa B,0,5,30,30
1650485824238,MATH 109,B02,083216,Anzaldo; Leesa B,0,6,30,30
1650485830270,MATH 142A,A01,083219,Chow; Bennett,0,15,30,30
1650485830270,MATH 142A,A02,083220,Chow; Bennett,0,13,30,30
1650485830270,MATH 142A,B01,083221,Chow; Bennett,0,12,30,30
1650485830270,MATH 142A,B02,083222,Chow; Bennett,0,13,30,30
1650485836299,MATH 193A,A01,083224,Staff,0,5,30,30
1650485836299,MATH 193A,A02,083225,Staff,0,5,30,30
1650485836299,MATH 193A,A03,083781,Staff,0,5,30,30
1650485836299,MATH 193A,A04,083782,Staff,0,6,30,30
1650485842321,MATH 197,001,091859,McAuley; Julian John,9998,0,9999,1
1650485848376,COGS 9,A01,083615,Staff,0,14,60,60
1650485854400,COGS 11,A01,083617,Boyle; Mary E. T.,20,0,40,20
1650485860425,COGS 13,A01,083071,Staff,0,34,40,40
1650485866462,COGS 14A,A01,092681,Staff,1,25,100,99
1650485872488,COGS 14B,A01,083073,Cheng; Tzu-Han,0,11,50,50
1650485878513,COGS 17,A01,092677,Staff,22,0,75,53
1650485884543,COGS 100,A01,083619,Staff,0,26,60,60
1650485890570,COGS 101A,A01,083621,Davis; Joshua Daniel,0,22,60,60
1650485896590,COGS 101B,A01,091572,Staff,0,4,60,60
1650485902617,COGS 101C,A01,083625,Delgado; Tania,16,0,30,14
1650485908641,COGS 107A,A01,083627,Boyle; Mary E. T.,0,11,60,60
1650485914663,COGS 118A,A01,083075,Staff,0,3,60,60
1650485920689,CSE 3,A50,083646,Miranda; Gregory Joseph,20,0,38,18
1650485920689,CSE 3,A51,083647,Miranda; Gregory Joseph,36,0,37,1
1650485926717,CSE 8A,A50,083650,Miranda; Gregory Joseph,1,28,40,39
1650485932741,CSE 11,A01,083080,Cao; Yingjun,0,92,40,40
1650485938767,CSE 12,A01,083652,Staff,0,17,100,100
1650485944794,CSE 15L,A01,083654,Staff,0,1,50,50
1650485944794,CSE 15L,A02,083655,Staff,0,0,50,50
1650485950828,CSE 20,A01,083657,Staff,51,0,80,29
1650485956855,CSE 30,A01,083084,Eldon; John,0,76,40,40
1650485962892,CSE 100,A01,083659,Cao; Yingjun,0,66,50,50
1650485968917,CSE 134B,A01,083661,Powell; Thomas Allan,0,31,65,65
1650485974945,CSE 140,A01,083663,Staff,0,5,75,75
1650485980974,CSE 140L,A01,083088,Eldon; John,0,9,75,75
1650485987003,CSE 175,A01,083665,Kumar; Rakesh,7,0,25,18
1650485993037,CSE 190,A00,092507,Dubnov; Shlomo,11,0,20,9
1650485999061,ECE 45,A01,083139,Staff,20,19,60,40
1650486005090,ECE 65,A50,083695,Staff,0,6,30,30
1650486011116,ECE 109,A01,091882,Touri; Behrouz,38,0,70,32
1650486017149,ECE 180,A00,083140,Abi Samra; Nicholas Camill,22,0,30,8
1650486017149,ECE 180,B00,083141,Abi Samra; Nicholas Camill,0,0,30,30
1650486023173,MATH 10A,A01,083735,Patchell; Gregory David,5,0,30,25
1650486023173,MATH 10A,A02,083736,Patchell; Gregory David,27,0,30,3
1650486023173,MATH 10A,A03,083737,Patchell; Gregory David,25,0,30,5
1650486029196,MATH 10B,A01,083207,Staff,0,8,30,30
1650486029196,MATH 10B,A02,083208,Staff,0,7,30,30
1650486029196,MATH 10B,B01,083739,Staff,13,0,30,17
1650486029196,MATH 10B,B02,083740,Staff,28,0,30,2
1650486035222,MATH 18,A01,083743,Staff,0,0,30,30
1650486035222,MATH 18,A02,083744,Staff,27,0,30,3
1650486035222,MATH 18,A03,083745,Staff,22,0,30,8
1650486035222,MATH 18,A04,083746,Staff,26,0,30,4
1650486035222,MATH 18,B01,083748,Staff,0,11,30,30
1650486035222,MATH 18,B02,083749,Staff,0,12,30,30
1650486035222,MATH 18,B03,083750,Staff,0,11,30,30
1650486035222,MATH 18,B04,083751,Staff,0,12,30,30
1650486041250,MATH 20A,A01,083754,Staff,25,0,40,15
1650486047276,MATH 20B,A01,083756,Staff,0,11,30,30
1650486047276,MATH 20B,A02,083757,Staff,0,11,30,30
1650486053300,MATH 20C,A01,083760,Staff,0,15,30,30
1650486053300,MATH 20C,A02,083761,Staff,2,15,30,28
1650486053300,MATH 20C,B01,083762,Staff,13,0,30,17
1650486053300,MATH 20C,B02,083763,Staff,28,0,30,2
1650486059323,MATH 20D,A01,083765,Staff,0,1,30,30
1650486059323,MATH 20D,A02,083766,Staff,9,0,30,21
1650486059323,MATH 20D,A03,083767,Staff,25,0,30,5
1650486065348,MATH 20E,A01,083771,Staff,5,0,30,25
1650486065348,MATH 20E,A02,083772,Staff,18,0,30,12
1650486065348,MATH 20E,B01,083773,Staff,0,0,30,30
1650486065348,MATH 20E,B02,083774,Staff,10,0,30,20
1650486078194,MATH 103A,A01,083777,Staff,0,12,30,30
1650486078194,MATH 103A,A02,083778,Staff,0,12,30,30
1650486078194,MATH 103A,B01,083779,Staff,0,13,30,30
1650486078194,MATH 103A,B02,083780,Staff,0,12,30,30
1650486084220,MATH 105,A01,085443,Staff,0,23,30,30
1650486090256,MATH 109,A01,083213,Anzaldo; Leesa B,0,7,30,30
1650486090256,MATH 109,A02,083214,Anzaldo; Leesa B,0,7,30,30
1650486090256,MATH 109,B01,083215,Anzaldo; Leesa B,0,5,30,30
1650486090256,MATH 109,B02,083216,Anzaldo; Leesa B,0,6,30,30
1650486096290,MATH 142A,A01,083219,Chow; Bennett,0,15,30,30
1650486096290,MATH 142A,A02,083220,Chow; Bennett,0,13,30,30
1650486096290,MATH 142A,B01,083221,Chow; Bennett,0,12,30,30
1650486096290,MATH 142A,B02,083222,Chow; Bennett,0,13,30,30
1650486102324,MATH 193A,A01,083224,Staff,0,5,30,30
1650486102324,MATH 193A,A02,083225,Staff,0,5,30,30
1650486102324,MATH 193A,A03,083781,Staff,0,5,30,30
1650486102324,MATH 193A,A04,083782,Staff,0,6,30,30
1650486108346,MATH 197,001,091859,McAuley; Julian John,9998,0,9999,1
1650486114397,COGS 9,A01,083615,Staff,0,14,60,60
1650486120419,COGS 11,A01,083617,Boyle; Mary E. T.,20,0,40,20
1650486126441,COGS 13,A01,083071,Staff,0,34,40,40
1650486132466,COGS 14A,A01,092681,Staff,1,25,100,99
1650486138497,COGS 14B,A01,083073,Cheng; Tzu-Han,0,11,50,50
1650486144532,COGS 17,A01,092677,Staff,22,0,75,53
1650486150560,COGS 100,A01,083619,Staff,0,26,60,60
1650486156585,COGS 101A,A01,083621,Davis; Joshua Daniel,0,22,60,60
1650486162609,COGS 101B,A01,091572,Staff,0,4,60,60
1650486168636,COGS 101C,A01,083625,Delgado; Tania,16,0,30,14
1650486174661,COGS 107A,A01,083627,Boyle; Mary E. T.,0,11,60,60
1650486180688,COGS 118A,A01,083075,Staff,0,3,60,60
1650486186712,CSE 3,A50,083646,Miranda; Gregory Joseph,20,0,38,18
1650486186712,CSE 3,A51,083647,Miranda; Gregory Joseph,36,0,37,1
1650486192739,CSE 8A,A50,083650,Miranda; Gregory Joseph,1,28,40,39
1650486198763,CSE 11,A01,083080,Cao; Yingjun,0,92,40,40
1650486204785,CSE 12,A01,083652,Staff,0,17,100,100
1650486210821,CSE 15L,A01,083654,Staff,0,1,50,50
1650486210821,CSE 15L,A02,083655,Staff,0,0,50,50
1650486216849,CSE 20,A01,083657,Staff,51,0,80,29
1650486222872,CSE 30,A01,083084,Eldon; John,0,76,40,40
1650486228898,CSE 100,A01,083659,Cao; Yingjun,0,66,50,50
1650486234926,CSE 134B,A01,083661,Powell; Thomas Allan,0,31,65,65
1650486240953,CSE 140,A01,083663,Staff,0,5,75,75
1650486246980,CSE 140L,A01,083088,Eldon; John,0,9,75,75
1650486253004,CSE 175,A01,083665,Kumar; Rakesh,7,0,25,18
1650486259034,CSE 190,A00,092507,Dubnov; Shlomo,11,0,20,9
1650486265057,ECE 45,A01,083139,Staff,20,19,60,40
1650486271080,ECE 65,A50,083695,Staff,0,6,30,30
1650486277115,ECE 109,A01,091882,Touri; Behrouz,38,0,70,32
1650486283142,ECE 180,A00,083140,Abi Samra; Nicholas Camill,22,0,30,8
1650486283142,ECE 180,B00,083141,Abi Samra; Nicholas Camill,0,0,30,30
1650486289172,MATH 10A,A01,083735,Patchell; Gregory David,5,0,30,25
1650486289172,MATH 10A,A02,083736,Patchell; Gregory David,27,0,30,3
1650486289172,MATH 10A,A03,083737,Patchell; Gregory David,25,0,30,5
1650486295196,MATH 10B,A01,083207,Staff,0,8,30,30
1650486295196,MATH 10B,A02,083208,Staff,0,7,30,30
1650486295196,MATH 10B,B01,083739,Staff,13,0,30,17
1650486295196,MATH 10B,B02,083740,Staff,28,0,30,2
1650486301227,MATH 18,A01,083743,Staff,0,0,30,30
1650486301227,MATH 18,A02,083744,Staff,27,0,30,3
1650486301227,MATH 18,A03,083745,Staff,22,0,30,8
1650486301227,MATH 18,A04,083746,Staff,26,0,30,4
1650486301227,MATH 18,B01,083748,Staff,0,11,30,30
1650486301227,MATH 18,B02,083749,Staff,0,12,30,30
1650486301227,MATH 18,B03,083750,Staff,0,11,30,30
1650486301227,MATH 18,B04,083751,Staff,0,12,30,30
1650486307257,MATH 20A,A01,083754,Staff,25,0,40,15
1650486313278,MATH 20B,A01,083756,Staff,0,11,30,30
1650486313278,MATH 20B,A02,083757,Staff,0,11,30,30
1650486319311,MATH 20C,A01,083760,Staff,0,15,30,30
1650486319311,MATH 20C,A02,083761,Staff,2,15,30,28
1650486319311,MATH 20C,B01,083762,Staff,13,0,30,17
1650486319311,MATH 20C,B02,083763,Staff,28,0,30,2
1650486325341,MATH 20D,A01,083765,Staff,0,1,30,30
1650486325341,MATH 20D,A02,083766,Staff,9,0,30,21
1650486325341,MATH 20D,A03,083767,Staff,25,0,30,5
1650486331364,MATH 20E,A01,083771,Staff,5,0,30,25
1650486331364,MATH 20E,A02,083772,Staff,18,0,30,12
1650486331364,MATH 20E,B01,083773,Staff,0,0,30,30
1650486331364,MATH 20E,B02,083774,Staff,10,0,30,20
1650486337388,MATH 103A,A01,083777,Staff,0,12,30,30
1650486337388,MATH 103A,A02,083778,Staff,0,12,30,30
1650486337388,MATH 103A,B01,083779,Staff,0,13,30,30
1650486337388,MATH 103A,B02,083780,Staff,0,12,30,30
1650486343413,MATH 105,A01,085443,Staff,0,23,30,30
1650486349437,MATH 109,A01,083213,Anzaldo; Leesa B,0,7,30,30
1650486349437,MATH 109,A02,083214,Anzaldo; Leesa B,0,7,30,30
1650486349437,MATH 109,B01,083215,Anzaldo; Leesa B,0,5,30,30
1650486349437,MATH 109,B02,083216,Anzaldo; Leesa B,0,6,30,30
1650486355464,MATH 142A,A01,083219,Chow; Bennett,0,15,30,30
1650486355464,MATH 142A,A02,083220,Chow; Bennett,0,13,30,30
1650486355464,MATH 142A,B01,083221,Chow; Bennett,0,12,30,30
1650486355464,MATH 142A,B02,083222,Chow; Bennett,0,13,30,30
1650486361493,MATH 193A,A01,083224,Staff,0,5,30,30
1650486361493,MATH 193A,A02,083225,Staff,0,5,30,30
1650486361493,MATH 193A,A03,083781,Staff,0,5,30,30
1650486361493,MATH 193A,A04,083782,Staff,0,6,30,30
1650486367515,MATH 197,001,091859,McAuley; Julian John,9998,0,9999,1
1650486373575,COGS 9,A01,083615,Staff,0,14,60,60
1650486379598,COGS 11,A01,083617,Boyle; Mary E. T.,20,0,40,20
1650486385624,COGS 13,A01,083071,Staff,0,34,40,40
1650486391653,COGS 14A,A01,092681,Staff,1,25,100,99
1650486397677,COGS 14B,A01,083073,Cheng; Tzu-Han,0,11,50,50
1650486403701,COGS 17,A01,092677,Staff,22,0,75,53
1650486409725,COGS 100,A01,083619,Staff,0,26,60,60
1650486415839,COGS 101A,A01,083621,Davis; Joshua Daniel,0,22,60,60
1650486421864,COGS 101B,A01,091572,Staff,0,4,60,60
1650486427900,COGS 101C,A01,083625,Delgado; Tania,16,0,30,14
1650486433923,COGS 107A,A01,083627,Boyle; Mary E. T.,0,11,60,60
1650486439945,COGS 118A,A01,083075,Staff,0,3,60,60
1650486445974,CSE 3,A50,083646,Miranda; Gregory Joseph,20,0,38,18
1650486445974,CSE 3,A51,083647,Miranda; Gregory Joseph,36,0,37,1
1650486452003,CSE 8A,A50,083650,Miranda; Gregory Joseph,1,28,40,39
1650486458027,CSE 11,A01,083080,Cao; Yingjun,0,92,40,40
1650486464055,CSE 12,A01,083652,Staff,0,17,100,100
1650486470076,CSE 15L,A01,083654,Staff,0,1,50,50
1650486470076,CSE 15L,A02,083655,Staff,0,0,50,50
1650486476109,CSE 20,A01,083657,Staff,51,0,80,29
1650486482145,CSE 30,A01,083084,Eldon; John,0,76,40,40
1650486488169,CSE 100,A01,083659,Cao; Yingjun,0,66,50,50
1650486494196,CSE 134B,A01,083661,Powell; Thomas Allan,0,31,65,65
1650486500221,CSE 140,A01,083663,Staff,0,5,75,75
1650486506246,CSE 140L,A01,083088,Eldon; John,0,9,75,75
1650486512280,CSE 175,A01,083665,Kumar; Rakesh,7,0,25,18
1650486518303,CSE 190,A00,092507,Dubnov; Shlomo,11,0,20,9
1650486524331,ECE 45,A01,083139,Staff,20,19,60,40
1650486530358,ECE 65,A50,083695,Staff,0,6,30,30
1650486536382,ECE 109,A01,091882,Touri; Behrouz,38,0,70,32
1650486542411,ECE 180,A00,083140,Abi Samra; Nicholas Camill,22,0,30,8
1650486542411,ECE 180,B00,083141,Abi Samra; Nicholas Camill,0,0,30,30
1650486548438,MATH 10A,A01,083735,Patchell; Gregory David,5,0,30,25
1650486548438,MATH 10A,A02,083736,Patchell; Gregory David,27,0,30,3
1650486548438,MATH 10A,A03,083737,Patchell; Gregory David,25,0,30,5
1650486554462,MATH 10B,A01,083207,Staff,0,8,30,30
1650486554462,MATH 10B,A02,083208,Staff,0,7,30,30
1650486554462,MATH 10B,B01,083739,Staff,13,0,30,17
1650486554462,MATH 10B,B02,083740,Staff,28,0,30,2
1650486560489,MATH 18,A01,083743,Staff,0,0,30,30
1650486560489,MATH 18,A02,083744,Staff,27,0,30,3
1650486560489,MATH 18,A03,083745,Staff,22,0,30,8
1650486560489,MATH 18,A04,083746,Staff,26,0,30,4
1650486560489,MATH 18,B01,083748,Staff,0,11,30,30
1650486560489,MATH 18,B02,083749,Staff,0,12,30,30
1650486560489,MATH 18,B03,083750,Staff,0,11,30,30
1650486560489,MATH 18,B04,083751,Staff,0,12,30,30
1650486566513,MATH 20A,A01,083754,Staff,25,0,40,15
1650486572547,MATH 20B,A01,083756,Staff,0,11,30,30
1650486572547,MATH 20B,A02,083757,Staff,0,11,30,30
1650486578574,MATH 20C,A01,083760,Staff,0,15,30,30
1650486578574,MATH 20C,A02,083761,Staff,2,15,30,28
1650486578574,MATH 20C,B01,083762,Staff,13,0,30,17
1650486578574,MATH 20C,B02,083763,Staff,28,0,30,2
1650486584597,MATH 20D,A01,083765,Staff,0,1,30,30
1650486584597,MATH 20D,A02,083766,Staff,9,0,30,21
1650486584597,MATH 20D,A03,083767,Staff,25,0,30,5
1650486590619,MATH 20E,A01,083771,Staff,5,0,30,25
1650486590619,MATH 20E,A02,083772,Staff,18,0,30,12
1650486590619,MATH 20E,B01,083773,Staff,0,0,30,30
1650486590619,MATH 20E,B02,083774,Staff,10,0,30,20
1650486596650,MATH 103A,A01,083777,Staff,0,12,30,30
1650486596650,MATH 103A,A02,083778,Staff,0,12,30,30
1650486596650,MATH 103A,B01,083779,Staff,0,13,30,30
1650486596650,MATH 103A,B02,083780,Staff,0,12,30,30
1650486602685,MATH 105,A01,085443,Staff,0,23,30,30
1650486608715,MATH 109,A01,083213,Anzaldo; Leesa B,0,7,30,30
1650486608715,MATH 109,A02,083214,Anzaldo; Leesa B,0,7,30,30
1650486608715,MATH 109,B01,083215,Anzaldo; Leesa B,0,5,30,30
1650486608715,MATH 109,B02,083216,Anzaldo; Leesa B,0,6,30,30
1650486614744,MATH 142A,A01,083219,Chow; Bennett,0,15,30,30
1650486614744,MATH 142A,A02,083220,Chow; Bennett,0,13,30,30
1650486614744,MATH 142A,B01,083221,Chow; Bennett,0,12,30,30
1650486614744,MATH 142A,B02,083222,Chow; Bennett,0,13,30,30
1650486620767,MATH 193A,A01,083224,Staff,0,5,30,30
1650486620767,MATH 193A,A02,083225,Staff,0,5,30,30
1650486620767,MATH 193A,A03,083781,Staff,0,5,30,30
1650486620767,MATH 193A,A04,083782,Staff,0,6,30,30
1650486626793,MATH 197,001,091859,McAuley; Julian John,9998,0,9999,1
1650486632855,COGS 9,A01,083615,Staff,0,14,60,60
1650486638882,COGS 11,A01,083617,Boyle; Mary E. T.,20,0,40,20
1650486644908,COGS 13,A01,083071,Staff,0,34,40,40
1650486650934,COGS 14A,A01,092681,Staff,1,25,100,99
1650486656962,COGS 14B,A01,083073,Cheng; Tzu-Han,0,11,50,50
1650486662986,COGS 17,A01,092677,Staff,22,0,75,53
1650486669019,COGS 100,A01,083619,Staff,0,26,60,60
1650486675048,COGS 101A,A01,083621,Davis; Joshua Daniel,0,22,60,60
1650486681071,COGS 101B,A01,091572,Staff,0,4,60,60
1650486687100,COGS 101C,A01,083625,Delgado; Tania,16,0,30,14
1650486693122,COGS 107A,A01,083627,Boyle; Mary E. T.,0,11,60,60
1650486699147,COGS 118A,A01,083075,Staff,0,3,60,60
1650486705175,CSE 3,A50,083646,Miranda; Gregory Joseph,20,0,38,18
1650486705175,CSE 3,A51,083647,Miranda; Gregory Joseph,36,0,37,1
1650486711215,CSE 8A,A50,083650,Miranda; Gregory Joseph,1,28,40,39
1650486717237,CSE 11,A01,083080,Cao; Yingjun,0,92,40,40
1650486723274,CSE 12,A01,083652,Staff,0,17,100,100
1650486729301,CSE 15L,A01,083654,Staff,0,1,50,50
1650486729301,CSE 15L,A02,083655,Staff,0,0,50,50
1650486735326,CSE 20,A01,083657,Staff,51,0,80,29
1650486741358,CSE 30,A01,083084,Eldon; John,0,76,40,40
1650486747391,CSE 100,A01,083659,Cao; Yingjun,0,66,50,50
1650486753424,CSE 134B,A01,083661,Powell; Thomas Allan,0,31,65,65
1650486759463,CSE 140,A01,083663,Staff,0,5,75,75
1650486765512,CSE 140L,A01,083088,Eldon; John,0,9,75,75
1650486771538,CSE 175,A01,083665,Kumar; Rakesh,7,0,25,18
1650486777563,CSE 190,A00,092507,Dubnov; Shlomo,11,0,20,9
1650486783589,ECE 45,A01,083139,Staff,20,19,60,40
1650486789611,ECE 65,A50,083695,Staff,0,6,30,30
1650486795641,ECE 109,A01,091882,Touri; Behrouz,38,0,70,32
1650486801670,ECE 180,A00,083140,Abi Samra; Nicholas Camill,22,0,30,8
1650486801670,ECE 180,B00,083141,Abi Samra; Nicholas Camill,0,0,30,30
1650486807693,MATH 10A,A01,083735,Patchell; Gregory David,5,0,30,25
1650486807693,MATH 10A,A02,083736,Patchell; Gregory David,27,0,30,3
1650486807693,MATH 10A,A03,083737,Patchell; Gregory David,25,0,30,5
1650486813721,MATH 10B,A01,083207,Staff,0,8,30,30
1650486813721,MATH 10B,A02,083208,Staff,0,7,30,30
1650486813721,MATH 10B,B01,083739,Staff,13,0,30,17
1650486813721,MATH 10B,B02,083740,Staff,28,0,30,2
1650486819746,MATH 18,A01,083743,Staff,0,0,30,30
1650486819746,MATH 18,A02,083744,Staff,27,0,30,3
1650486819746,MATH 18,A03,083745,Staff,22,0,30,8
1650486819746,MATH 18,A04,083746,Staff,26,0,30,4
1650486819746,MATH 18,B01,083748,Staff,0,11,30,30
1650486819746,MATH 18,B02,083749,Staff,0,12,30,30
1650486819746,MATH 18,B03,083750,Staff,0,11,30,30
1650486819746,MATH 18,B04,083751,Staff,0,12,30,30
1650486825775,MATH 20A,A01,083754,Staff,25,0,40,15
1650486831799,MATH 20B,A01,083756,Staff,0,11,30,30
1650486831799,MATH 20B,A02,083757,Staff,0,11,30,30
1650486837839,MATH 20C,A01,083760,Staff,0,15,30,30
1650486837839,MATH 20C,A02,083761,Staff,2,15,30,28
1650486837839,MATH 20C,B01,083762,Staff,13,0,30,17
1650486837839,MATH 20C,B02,083763,Staff,28,0,30,2
1650486843868,MATH 20D,A01,083765,Staff,0,1,30,30
1650486843868,MATH 20D,A02,083766,Staff,9,0,30,21
1650486843868,MATH 20D,A03,083767,Staff,25,0,30,5
1650486849895,MATH 20E,A01,083771,Staff,6,0,30,24
1650486849895,MATH 20E,A02,083772,Staff,18,0,30,12
1650486849895,MATH 20E,B01,083773,Staff,0,0,30,30
1650486849895,MATH 20E,B02,083774,Staff,10,0,30,20
1650486855919,MATH 103A,A01,083777,Staff,0,12,30,30
1650486855919,MATH 103A,A02,083778,Staff,0,12,30,30
1650486855919,MATH 103A,B01,083779,Staff,0,13,30,30
1650486855919,MATH 103A,B02,083780,Staff,0,12,30,30
1650486861956,MATH 105,A01,085443,Staff,0,23,30,30
1650486867983,MATH 109,A01,083213,Anzaldo; Leesa B,0,7,30,30
1650486867983,MATH 109,A02,083214,Anzaldo; Leesa B,0,7,30,30
1650486867983,MATH 109,B01,083215,Anzaldo; Leesa B,0,5,30,30
1650486867983,MATH 109,B02,083216,Anzaldo; Leesa B,0,6,30,30
1650486874008,MATH 142A,A01,083219,Chow; Bennett,0,15,30,30
1650486874008,MATH 142A,A02,083220,Chow; Bennett,0,13,30,30
1650486874008,MATH 142A,B01,083221,Chow; Bennett,0,12,30,30
1650486874008,MATH 142A,B02,083222,Chow; Bennett,0,13,30,30
1650486880036,MATH 193A,A01,083224,Staff,0,5,30,30
1650486880036,MATH 193A,A02,083225,Staff,0,5,30,30
1650486880036,MATH 193A,A03,083781,Staff,0,5,30,30
1650486880036,MATH 193A,A04,083782,Staff,0,6,30,30
1650486886059,MATH 197,001,091859,McAuley; Julian John,9998,0,9999,1
1650486892111,COGS 9,A01,083615,Staff,0,14,60,60
1650486898135,COGS 11,A01,083617,Boyle; Mary E. T.,20,0,40,20
1650486904157,COGS 13,A01,083071,Staff,0,34,40,40
1650486910182,COGS 14A,A01,092681,Staff,1,25,100,99
1650486916209,COGS 14B,A01,083073,Cheng; Tzu-Han,0,11,50,50
1650486922234,COGS 17,A01,092677,Staff,22,0,75,53
1650486928269,COGS 100,A01,083619,Staff,0,26,60,60
1650486934297,COGS 101A,A01,083621,Davis; Joshua Daniel,0,22,60,60
1650486940329,COGS 101B,A01,091572,Staff,0,4,60,60
1650486946366,COGS 101C,A01,083625,Delgado; Tania,16,0,30,14
1650486952392,COGS 107A,A01,083627,Boyle; Mary E. T.,0,11,60,60
1650486958415,COGS 118A,A01,083075,Staff,0,3,60,60
1650486964440,CSE 3,A50,083646,Miranda; Gregory Joseph,20,0,38,18
1650486964440,CSE 3,A51,083647,Miranda; Gregory Joseph,36,0,37,1
1650486970463,CSE 8A,A50,083650,Miranda; Gregory Joseph,1,28,40,39
1650486976493,CSE 11,A01,083080,Cao; Yingjun,0,92,40,40
1650486982518,CSE 12,A01,083652,Staff,0,17,100,100
1650486988548,CSE 15L,A01,083654,Staff,0,1,50,50
1650486988548,CSE 15L,A02,083655,Staff,0,0,50,50
1650486994575,CSE 20,A01,083657,Staff,51,0,80,29
1650487000601,CSE 30,A01,083084,Eldon; John,0,76,40,40
1650487006632,CSE 100,A01,083659,Cao; Yingjun,0,66,50,50
1650487012764,CSE 134B,A01,083661,Powell; Thomas Allan,0,31,65,65
1650487018790,CSE 140,A01,083663,Staff,0,5,75,75
1650487024828,CSE 140L,A01,083088,Eldon; John,0,9,75,75
1650487030854,CSE 175,A01,083665,Kumar; Rakesh,7,0,25,18
1650487036881,CSE 190,A00,092507,Dubnov; Shlomo,11,0,20,9
1650487042907,ECE 45,A01,083139,Staff,20,19,60,40
1650487048931,ECE 65,A50,083695,Staff,0,6,30,30
1650487054958,ECE 109,A01,091882,Touri; Behrouz,38,0,70,32
1650487060985,ECE 180,A00,083140,Abi Samra; Nicholas Camill,22,0,30,8
1650487060985,ECE 180,B00,083141,Abi Samra; Nicholas Camill,0,0,30,30
1650487067013,MATH 10A,A01,083735,Patchell; Gregory David,5,0,30,25
1650487067013,MATH 10A,A02,083736,Patchell; Gregory David,27,0,30,3
1650487067013,MATH 10A,A03,083737,Patchell; Gregory David,25,0,30,5
1650487073036,MATH 10B,A01,083207,Staff,0,8,30,30
1650487073036,MATH 10B,A02,083208,Staff,0,7,30,30
1650487073036,MATH 10B,B01,083739,Staff,13,0,30,17
1650487073036,MATH 10B,B02,083740,Staff,28,0,30,2
1650487079065,MATH 18,A01,083743,Staff,0,0,30,30
1650487079065,MATH 18,A02,083744,Staff,27,0,30,3
1650487079065,MATH 18,A03,083745,Staff,22,0,30,8
1650487079065,MATH 18,A04,083746,Staff,26,0,30,4
1650487079065,MATH 18,B01,083748,Staff,0,11,30,30
1650487079065,MATH 18,B02,083749,Staff,0,12,30,30
1650487079065,MATH 18,B03,083750,Staff,0,11,30,30
1650487079065,MATH 18,B04,083751,Staff,0,12,30,30
1650487085088,MATH 20A,A01,083754,Staff,25,0,40,15
1650487091116,MATH 20B,A01,083756,Staff,0,11,30,30
1650487091116,MATH 20B,A02,083757,Staff,0,11,30,30
1650487097140,MATH 20C,A01,083760,Staff,0,15,30,30
1650487097140,MATH 20C,A02,083761,Staff,2,15,30,28
1650487097140,MATH 20C,B01,083762,Staff,13,0,30,17
1650487097140,MATH 20C,B02,083763,Staff,28,0,30,2
1650487103164,MATH 20D,A01,083765,Staff,0,1,30,30
1650487103164,MATH 20D,A02,083766,Staff,9,0,30,21
1650487103164,MATH 20D,A03,083767,Staff,25,0,30,5
1650487109196,MATH 20E,A01,083771,Staff,6,0,30,24
1650487109196,MATH 20E,A02,083772,Staff,18,0,30,12
1650487109196,MATH 20E,B01,083773,Staff,0,0,30,30
1650487109196,MATH 20E,B02,083774,Staff,10,0,30,20
1650487115224,MATH 103A,A01,083777,Staff,0,12,30,30
1650487115224,MATH 103A,A02,083778,Staff,0,12,30,30
1650487115224,MATH 103A,B01,083779,Staff,0,13,30,30
1650487115224,MATH 103A,B02,083780,Staff,0,12,30,30
1650487121250,MATH 105,A01,085443,Staff,0,23,30,30
1650487127274,MATH 109,A01,083213,Anzaldo; Leesa B,0,7,30,30
1650487127274,MATH 109,A02,083214,Anzaldo; Leesa B,0,7,30,30
1650487127274,MATH 109,B01,083215,Anzaldo; Leesa B,0,5,30,30
1650487127274,MATH 109,B02,083216,Anzaldo; Leesa B,0,6,30,30
1650487133303,MATH 142A,A01,083219,Chow; Bennett,0,15,30,30
1650487133303,MATH 142A,A02,083220,Chow; Bennett,0,13,30,30
1650487133303,MATH 142A,B01,083221,Chow; Bennett,0,12,30,30
1650487133303,MATH 142A,B02,083222,Chow; Bennett,0,13,30,30
1650487139327,MATH 193A,A01,083224,Staff,0,5,30,30
1650487139327,MATH 193A,A02,083225,Staff,0,5,30,30
1650487139327,MATH 193A,A03,083781,Staff,0,5,30,30
1650487139327,MATH 193A,A04,083782,Staff,0,6,30,30
1650487145354,MATH 197,001,091859,McAuley; Julian John,9998,0,9999,1
1650487151406,COGS 9,A01,083615,Staff,0,14,60,60
1650487157430,COGS 11,A01,083617,Boyle; Mary E. T.,20,0,40,20
1650487163455,COGS 13,A01,083071,Staff,0,34,40,40
1650487169495,COGS 14A,A01,092681,Staff,1,25,100,99
1650487175519,COGS 14B,A01,083073,Cheng; Tzu-Han,0,11,50,50
1650487181548,COGS 17,A01,092677,Staff,22,0,75,53
1650487187570,COGS 100,A01,083619,Staff,0,26,60,60
1650487193598,COGS 101A,A01,083621,Davis; Joshua Daniel,0,22,60,60
1650487199622,COGS 101B,A01,091572,Staff,0,4,60,60
1650487205650,COGS 101C,A01,083625,Delgado; Tania,16,0,30,14
1650487211673,COGS 107A,A01,083627,Boyle; Mary E. T.,0,11,60,60
1650487217706,COGS 118A,A01,083075,Staff,0,3,60,60
1650487223730,CSE 3,A50,083646,Miranda; Gregory Joseph,20,0,38,18
1650487223730,CSE 3,A51,083647,Miranda; Gregory Joseph,36,0,37,1
1650487229761,CSE 8A,A50,083650,Miranda; Gregory Joseph,1,28,40,39
1650487235792,CSE 11,A01,083080,Cao; Yingjun,0,92,40,40
1650487241817,CSE 12,A01,083652,Staff,0,17,100,100
1650487247841,CSE 15L,A01,083654,Staff,0,1,50,50
1650487247841,CSE 15L,A02,083655,Staff,0,0,50,50
1650487253865,CSE 20,A01,083657,Staff,51,0,80,29
1650487259900,CSE 30,A01,083084,Eldon; John,0,76,40,40
1650487265926,CSE 100,A01,083659,Cao; Yingjun,0,66,50,50
1650487271952,CSE 134B,A01,083661,Powell; Thomas Allan,0,31,65,65
1650487277996,CSE 140,A01,083663,Staff,0,5,75,75
1650487284030,CSE 140L,A01,083088,Eldon; John,0,9,75,75
1650487290054,CSE 175,A01,083665,Kumar; Rakesh,7,0,25,18
1650487296103,CSE 190,A00,092507,Dubnov; Shlomo,11,0,20,9
1650487302142,ECE 45,A01,083139,Staff,20,19,60,40
1650487308166,ECE 65,A50,083695,Staff,0,6,30,30
1650487314190,ECE 109,A01,091882,Touri; Behrouz,38,0,70,32
1650487320214,ECE 180,A00,083140,Abi Samra; Nicholas Camill,22,0,30,8
1650487320214,ECE 180,B00,083141,Abi Samra; Nicholas Camill,0,0,30,30
1650487326237,MATH 10A,A01,083735,Patchell; Gregory David,5,0,30,25
1650487326237,MATH 10A,A02,083736,Patchell; Gregory David,27,0,30,3
1650487326237,MATH 10A,A03,083737,Patchell; Gregory David,25,0,30,5
1650487332264,MATH 10B,A01,083207,Staff,0,8,30,30
1650487332264,MATH 10B,A02,083208,Staff,0,7,30,30
1650487332264,MATH 10B,B01,083739,Staff,13,0,30,17
1650487332264,MATH 10B,B02,083740,Staff,28,0,30,2
1650487338289,MATH 18,A01,083743,Staff,0,0,30,30
1650487338289,MATH 18,A02,083744,Staff,27,0,30,3
1650487338289,MATH 18,A03,083745,Staff,22,0,30,8
1650487338289,MATH 18,A04,083746,Staff,26,0,30,4
1650487338289,MATH 18,B01,083748,Staff,0,11,30,30
1650487338289,MATH 18,B02,083749,Staff,0,12,30,30
1650487338289,MATH 18,B03,083750,Staff,0,11,30,30
1650487338289,MATH 18,B04,083751,Staff,0,12,30,30
1650487344313,MATH 20A,A01,083754,Staff,25,0,40,15
1650487350350,MATH 20B,A01,083756,Staff,0,11,30,30
1650487350350,MATH 20B,A02,083757,Staff,0,11,30,30
1650487356372,MATH 20C,A01,083760,Staff,0,15,30,30
1650487356372,MATH 20C,A02,083761,Staff,2,15,30,28
1650487356372,MATH 20C,B01,083762,Staff,13,0,30,17
1650487356372,MATH 20C,B02,083763,Staff,28,0,30,2
1650487362396,MATH 20D,A01,083765,Staff,0,1,30,30
1650487362396,MATH 20D,A02,083766,Staff,9,0,30,21
1650487362396,MATH 20D,A03,083767,Staff,25,0,30,5
1650487368427,MATH 20E,A01,083771,Staff,6,0,30,24
1650487368427,MATH 20E,A02,083772,Staff,18,0,30,12
1650487368427,MATH 20E,B01,083773,Staff,0,0,30,30
1650487368427,MATH 20E,B02,083774,Staff,10,0,30,20
1650487374462,MATH 103A,A01,083777,Staff,0,12,30,30
1650487374462,MATH 103A,A02,083778,Staff,0,12,30,30
1650487374462,MATH 103A,B01,083779,Staff,0,13,30,30
1650487374462,MATH 103A,B02,083780,Staff,0,12,30,30
1650487380487,MATH 105,A01,085443,Staff,0,23,30,30
1650487386510,MATH 109,A01,083213,Anzaldo; Leesa B,0,7,30,30
1650487386510,MATH 109,A02,083214,Anzaldo; Leesa B,0,7,30,30
1650487386510,MATH 109,B01,083215,Anzaldo; Leesa B,0,5,30,30
1650487386510,MATH 109,B02,083216,Anzaldo; Leesa B,0,6,30,30
1650487392536,MATH 142A,A01,083219,Chow; Bennett,0,15,30,30
1650487392536,MATH 142A,A02,083220,Chow; Bennett,0,13,30,30
1650487392536,MATH 142A,B01,083221,Chow; Bennett,0,12,30,30
1650487392536,MATH 142A,B02,083222,Chow; Bennett,0,13,30,30
1650487398558,MATH 193A,A01,083224,Staff,0,5,30,30
1650487398558,MATH 193A,A02,083225,Staff,0,5,30,30
1650487398558,MATH 193A,A03,083781,Staff,0,5,30,30
1650487398558,MATH 193A,A04,083782,Staff,0,6,30,30
1650487404594,MATH 197,001,091859,McAuley; Julian John,9998,0,9999,1
1650487410642,COGS 9,A01,083615,Staff,0,14,60,60
1650487416668,COGS 11,A01,083617,Boyle; Mary E. T.,20,0,40,20
1650487422697,COGS 13,A01,083071,Staff,0,34,40,40
1650487428720,COGS 14A,A01,092681,Staff,1,25,100,99
1650487434741,COGS 14B,A01,083073,Cheng; Tzu-Han,0,11,50,50
1650487440768,COGS 17,A01,092677,Staff,22,0,75,53
1650487446793,COGS 100,A01,083619,Staff,0,26,60,60
1650487452819,COGS 101A,A01,083621,Davis; Joshua Daniel,0,22,60,60
1650487458848,COGS 101B,A01,091572,Staff,0,4,60,60
1650487464884,COGS 101C,A01,083625,Delgado; Tania,16,0,30,14
1650487470911,COGS 107A,A01,083627,Boyle; Mary E. T.,0,11,60,60
1650487476935,COGS 118A,A01,083075,Staff,0,3,60,60
1650487482959,CSE 3,A50,083646,Miranda; Gregory Joseph,20,0,38,18
1650487482959,CSE 3,A51,083647,Miranda; Gregory Joseph,36,0,37,1
1650487488986,CSE 8A,A50,083650,Miranda; Gregory Joseph,1,28,40,39
1650487495010,CSE 11,A01,083080,Cao; Yingjun,0,92,40,40
1650487501039,CSE 12,A01,083652,Staff,0,17,100,100
1650487507063,CSE 15L,A01,083654,Staff,0,1,50,50
1650487507063,CSE 15L,A02,083655,Staff,0,0,50,50
1650487513090,CSE 20,A01,083657,Staff,51,0,80,29
1650487519121,CSE 30,A01,083084,Eldon; John,0,76,40,40
1650487525146,CSE 100,A01,083659,Cao; Yingjun,0,66,50,50
1650487531171,CSE 134B,A01,083661,Powell; Thomas Allan,0,31,65,65
1650487537198,CSE 140,A01,083663,Staff,0,5,75,75
1650487543229,CSE 140L,A01,083088,Eldon; John,0,9,75,75
1650487549252,CSE 175,A01,083665,Kumar; Rakesh,7,0,25,18
1650487555277,CSE 190,A00,092507,Dubnov; Shlomo,11,0,20,9
1650487561302,ECE 45,A01,083139,Staff,20,19,60,40
1650487567330,ECE 65,A50,083695,Staff,0,6,30,30
1650487573361,ECE 109,A01,091882,Touri; Behrouz,38,0,70,32
1650487579385,ECE 180,A00,083140,Abi Samra; Nicholas Camill,22,0,30,8
1650487579385,ECE 180,B00,083141,Abi Samra; Nicholas Camill,0,0,30,30
1650487585413,MATH 10A,A01,083735,Patchell; Gregory David,5,0,30,25
1650487585413,MATH 10A,A02,083736,Patchell; Gregory David,27,0,30,3
1650487585413,MATH 10A,A03,083737,Patchell; Gregory David,25,0,30,5
1650487591442,MATH 10B,A01,083207,Staff,0,8,30,30
1650487591442,MATH 10B,A02,083208,Staff,0,7,30,30
1650487591442,MATH 10B,B01,083739,Staff,13,0,30,17
1650487591442,MATH 10B,B02,083740,Staff,28,0,30,2
1650487597465,MATH 18,A01,083743,Staff,0,0,30,30
1650487597465,MATH 18,A02,083744,Staff,27,0,30,3
1650487597465,MATH 18,A03,083745,Staff,22,0,30,8
1650487597465,MATH 18,A04,083746,Staff,26,0,30,4
1650487597465,MATH 18,B01,083748,Staff,0,11,30,30
1650487597465,MATH 18,B02,083749,Staff,0,12,30,30
1650487597465,MATH 18,B03,083750,Staff,0,11,30,30
1650487597465,MATH 18,B04,083751,Staff,0,12,30,30
1650487603490,MATH 20A,A01,083754,Staff,25,0,40,15
1650487609608,MATH 20B,A01,083756,Staff,0,11,30,30
1650487609608,MATH 20B,A02,083757,Staff,0,11,30,30
1650487615636,MATH 20C,A01,083760,Staff,0,15,30,30
1650487615636,MATH 20C,A02,083761,Staff,2,15,30,28
1650487615636,MATH 20C,B01,083762,Staff,13,0,30,17
1650487615636,MATH 20C,B02,083763,Staff,28,0,30,2
1650487621660,MATH 20D,A01,083765,Staff,0,1,30,30
1650487621660,MATH 20D,A02,083766,Staff,9,0,30,21
1650487621660,MATH 20D,A03,083767,Staff,25,0,30,5
1650487627688,MATH 20E,A01,083771,Staff,6,0,30,24
1650487627688,MATH 20E,A02,083772,Staff,18,0,30,12
1650487627688,MATH 20E,B01,083773,Staff,0,0,30,30
1650487627688,MATH 20E,B02,083774,Staff,10,0,30,20
1650487633712,MATH 103A,A01,083777,Staff,0,12,30,30
1650487633712,MATH 103A,A02,083778,Staff,0,12,30,30
1650487633712,MATH 103A,B01,083779,Staff,0,13,30,30
1650487633712,MATH 103A,B02,083780,Staff,0,12,30,30
1650487639736,MATH 105,A01,085443,Staff,0,23,30,30
1650487645767,MATH 109,A01,083213,Anzaldo; Leesa B,0,7,30,30
1650487645767,MATH 109,A02,083214,Anzaldo; Leesa B,0,7,30,30
1650487645767,MATH 109,B01,083215,Anzaldo; Leesa B,0,5,30,30
1650487645767,MATH 109,B02,083216,Anzaldo; Leesa B,0,6,30,30
1650487651793,MATH 142A,A01,083219,Chow; Bennett,0,15,30,30
1650487651793,MATH 142A,A02,083220,Chow; Bennett,0,13,30,30
1650487651793,MATH 142A,B01,083221,Chow; Bennett,0,12,30,30
1650487651793,MATH 142A,B02,083222,Chow; Bennett,0,13,30,30
1650487657819,MATH 193A,A01,083224,Staff,0,5,30,30
1650487657819,MATH 193A,A02,083225,Staff,0,5,30,30
1650487657819,MATH 193A,A03,083781,Staff,0,5,30,30
1650487657819,MATH 193A,A04,083782,Staff,0,6,30,30
1650487663845,MATH 197,001,091859,McAuley; Julian John,9998,0,9999,1
1650487669911,COGS 9,A01,083615,Staff,0,14,60,60
1650487675940,COGS 11,A01,083617,Boyle; Mary E. T.,20,0,40,20
1650487681970,COGS 13,A01,083071,Staff,0,34,40,40
1650487687996,COGS 14A,A01,092681,Staff,1,25,100,99
1650487694018,COGS 14B,A01,083073,Cheng; Tzu-Han,0,11,50,50
1650487700052,COGS 17,A01,092677,Staff,22,0,75,53
1650487706076,COGS 100,A01,083619,Staff,0,26,60,60
1650487712102,COGS 101A,A01,083621,Davis; Joshua Daniel,0,22,60,60
1650487718125,COGS 101B,A01,091572,Staff,0,4,60,60
1650487724154,COGS 101C,A01,083625,Delgado; Tania,16,0,30,14
1650487730181,COGS 107A,A01,083627,Boyle; Mary E. T.,0,11,60,60
1650487736206,COGS 118A,A01,083075,Staff,0,3,60,60
1650487742230,CSE 3,A50,083646,Miranda; Gregory Joseph,20,0,38,18
1650487742230,CSE 3,A51,083647,Miranda; Gregory Joseph,36,0,37,1
1650487748254,CSE 8A,A50,083650,Miranda; Gregory Joseph,1,28,40,39
1650487754280,CSE 11,A01,083080,Cao; Yingjun,0,92,40,40
1650487760304,CSE 12,A01,083652,Staff,0,17,100,100
1650487766329,CSE 15L,A01,083654,Staff,0,1,50,50
1650487766329,CSE 15L,A02,083655,Staff,0,0,50,50
1650487772361,CSE 20,A01,083657,Staff,51,0,80,29
1650487778384,CSE 30,A01,083084,Eldon; John,0,76,40,40
1650487784408,CSE 100,A01,083659,Cao; Yingjun,0,66,50,50
1650487790432,CSE 134B,A01,083661,Powell; Thomas Allan,0,31,65,65
1650487796455,CSE 140,A01,083663,Staff,0,5,75,75
1650487802500,CSE 140L,A01,083088,Eldon; John,0,9,75,75
1650487808528,CSE 175,A01,083665,Kumar; Rakesh,7,0,25,18
1650487814559,CSE 190,A00,092507,Dubnov; Shlomo,11,0,20,9
1650487820588,ECE 45,A01,083139,Staff,20,19,60,40
1650487826613,ECE 65,A50,083695,Staff,0,6,30,30
1650487832639,ECE 109,A01,091882,Touri; Behrouz,38,0,70,32
1650487838670,ECE 180,A00,083140,Abi Samra; Nicholas Camill,22,0,30,8
1650487838670,ECE 180,B00,083141,Abi Samra; Nicholas Camill,0,0,30,30
1650487844694,MATH 10A,A01,083735,Patchell; Gregory David,5,0,30,25
1650487844694,MATH 10A,A02,083736,Patchell; Gregory David,27,0,30,3
1650487844694,MATH 10A,A03,083737,Patchell; Gregory David,25,0,30,5
1650487850722,MATH 10B,A01,083207,Staff,0,8,30,30
1650487850722,MATH 10B,A02,083208,Staff,0,7,30,30
1650487850722,MATH 10B,B01,083739,Staff,13,0,30,17
1650487850722,MATH 10B,B02,083740,Staff,28,0,30,2
1650487856748,MATH 18,A01,083743,Staff,0,0,30,30
1650487856748,MATH 18,A02,083744,Staff,27,0,30,3
1650487856748,MATH 18,A03,083745,Staff,22,0,30,8
1650487856748,MATH 18,A04,083746,Staff,26,0,30,4
1650487856748,MATH 18,B01,083748,Staff,0,11,30,30
1650487856748,MATH 18,B02,083749,Staff,0,12,30,30
1650487856748,MATH 18,B03,083750,Staff,0,11,30,30
1650487856748,MATH 18,B04,083751,Staff,0,12,30,30
1650487862775,MATH 20A,A01,083754,Staff,25,0,40,15
1650487868804,MATH 20B,A01,083756,Staff,0,11,30,30
1650487868804,MATH 20B,A02,083757,Staff,0,11,30,30
1650487874831,MATH 20C,A01,083760,Staff,0,15,30,30
1650487874831,MATH 20C,A02,083761,Staff,2,15,30,28
1650487874831,MATH 20C,B01,083762,Staff,13,0,30,17
1650487874831,MATH 20C,B02,083763,Staff,28,0,30,2
1650487880854,MATH 20D,A01,083765,Staff,0,1,30,30
1650487880854,MATH 20D,A02,083766,Staff,9,0,30,21
1650487880854,MATH 20D,A03,083767,Staff,25,0,30,5
1650487886883,MATH 20E,A01,083771,Staff,6,0,30,24
1650487886883,MATH 20E,A02,083772,Staff,18,0,30,12
1650487886883,MATH 20E,B01,083773,Staff,0,0,30,30
1650487886883,MATH 20E,B02,083774,Staff,10,0,30,20
1650487892916,MATH 103A,A01,083777,Staff,0,12,30,30
1650487892916,MATH 103A,A02,083778,Staff,0,12,30,30
1650487892916,MATH 103A,B01,083779,Staff,0,13,30,30
1650487892916,MATH 103A,B02,083780,Staff,0,12,30,30
1650487898948,MATH 105,A01,085443,Staff,0,23,30,30
1650487904973,MATH 109,A01,083213,Anzaldo; Leesa B,0,7,30,30
1650487904973,MATH 109,A02,083214,Anzaldo; Leesa B,0,7,30,30
1650487904973,MATH 109,B01,083215,Anzaldo; Leesa B,0,5,30,30
1650487904973,MATH 109,B02,083216,Anzaldo; Leesa B,0,6,30,30
1650487910997,MATH 142A,A01,083219,Chow; Bennett,0,15,30,30
1650487910997,MATH 142A,A02,083220,Chow; Bennett,0,13,30,30
1650487910997,MATH 142A,B01,083221,Chow; Bennett,0,12,30,30
1650487910997,MATH 142A,B02,083222,Chow; Bennett,0,13,30,30
1650487917033,MATH 193A,A01,083224,Staff,0,5,30,30
1650487917033,MATH 193A,A02,083225,Staff,0,5,30,30
1650487917033,MATH 193A,A03,083781,Staff,0,5,30,30
1650487917033,MATH 193A,A04,083782,Staff,0,6,30,30
1650487923062,MATH 197,001,091859,McAuley; Julian John,9998,0,9999,1
1650487929116,COGS 9,A01,083615,Staff,0,14,60,60
1650487935146,COGS 11,A01,083617,Boyle; Mary E. T.,20,0,40,20
1650487941175,COGS 13,A01,083071,Staff,0,34,40,40
1650487947201,COGS 14A,A01,092681,Staff,1,25,100,99
1650487953229,COGS 14B,A01,083073,Cheng; Tzu-Han,0,11,50,50
1650487959252,COGS 17,A01,092677,Staff,22,0,75,53
1650487965279,COGS 100,A01,083619,Staff,0,26,60,60
1650487971303,COGS 101A,A01,083621,Davis; Joshua Daniel,0,22,60,60
1650487977326,COGS 101B,A01,091572,Staff,0,4,60,60
1650487983351,COGS 101C,A01,083625,Delgado; Tania,16,0,30,14
1650487989377,COGS 107A,A01,083627,Boyle; Mary E. T.,0,11,60,60
1650487995406,COGS 118A,A01,083075,Staff,0,3,60,60
1650488001441,CSE 3,A50,083646,Miranda; Gregory Joseph,20,0,38,18
1650488001441,CSE 3,A51,083647,Miranda; Gregory Joseph,36,0,37,1
1650488007476,CSE 8A,A50,083650,Miranda; Gregory Joseph,1,28,40,39
1650488013500,CSE 11,A01,083080,Cao; Yingjun,0,92,40,40
1650488019533,CSE 12,A01,083652,Staff,0,17,100,100
1650488025560,CSE 15L,A01,083654,Staff,0,1,50,50
1650488025560,CSE 15L,A02,083655,Staff,0,0,50,50
1650488031582,CSE 20,A01,083657,Staff,51,0,80,29
1650488037633,CSE 30,A01,083084,Eldon; John,0,76,40,40
1650488043666,CSE 100,A01,083659,Cao; Yingjun,0,67,50,50
1650488049696,CSE 134B,A01,083661,Powell; Thomas Allan,0,31,65,65
1650488055723,CSE 140,A01,083663,Staff,0,5,75,75
1650488061748,CSE 140L,A01,083088,Eldon; John,0,9,75,75
1650488067780,CSE 175,A01,083665,Kumar; Rakesh,7,0,25,18
1650488073805,CSE 190,A00,092507,Dubnov; Shlomo,11,0,20,9
1650488079832,ECE 45,A01,083139,Staff,20,19,60,40
1650488085857,ECE 65,A50,083695,Staff,0,6,30,30
1650488091894,ECE 109,A01,091882,Touri; Behrouz,38,0,70,32
1650488097922,ECE 180,A00,083140,Abi Samra; Nicholas Camill,22,0,30,8
1650488097922,ECE 180,B00,083141,Abi Samra; Nicholas Camill,0,0,30,30
1650488103949,MATH 10A,A01,083735,Patchell; Gregory David,5,0,30,25
1650488103949,MATH 10A,A02,083736,Patchell; Gregory David,27,0,30,3
1650488103949,MATH 10A,A03,083737,Patchell; Gregory David,25,0,30,5
1650488109990,MATH 10B,A01,083207,Staff,0,8,30,30
1650488109990,MATH 10B,A02,083208,Staff,0,7,30,30
1650488109990,MATH 10B,B01,083739,Staff,13,0,30,17
1650488109990,MATH 10B,B02,083740,Staff,28,0,30,2
1650488116031,MATH 18,A01,083743,Staff,0,0,30,30
1650488116031,MATH 18,A02,083744,Staff,27,0,30,3
1650488116031,MATH 18,A03,083745,Staff,22,0,30,8
1650488116031,MATH 18,A04,083746,Staff,26,0,30,4
1650488116031,MATH 18,B01,083748,Staff,0,11,30,30
1650488116031,MATH 18,B02,083749,Staff,0,12,30,30
1650488116031,MATH 18,B03,083750,Staff,0,11,30,30
1650488116031,MATH 18,B04,083751,Staff,0,12,30,30
1650488122057,MATH 20A,A01,083754,Staff,25,0,40,15
1650488128089,MATH 20B,A01,083756,Staff,0,11,30,30
1650488128089,MATH 20B,A02,083757,Staff,0,11,30,30
1650488134118,MATH 20C,A01,083760,Staff,0,15,30,30
1650488134118,MATH 20C,A02,083761,Staff,2,15,30,28
1650488134118,MATH 20C,B01,083762,Staff,13,0,30,17
1650488134118,MATH 20C,B02,083763,Staff,28,0,30,2
1650488140142,MATH 20D,A01,083765,Staff,0,1,30,30
1650488140142,MATH 20D,A02,083766,Staff,9,0,30,21
1650488140142,MATH 20D,A03,083767,Staff,25,0,30,5
1650488146179,MATH 20E,A01,083771,Staff,6,0,30,24
1650488146179,MATH 20E,A02,083772,Staff,18,0,30,12
1650488146179,MATH 20E,B01,083773,Staff,0,0,30,30
1650488146179,MATH 20E,B02,083774,Staff,10,0,30,20
1650488152215,MATH 103A,A01,083777,Staff,0,12,30,30
1650488152215,MATH 103A,A02,083778,Staff,0,12,30,30
1650488152215,MATH 103A,B01,083779,Staff,0,13,30,30
1650488152215,MATH 103A,B02,083780,Staff,0,12,30,30
1650488158242,MATH 105,A01,085443,Staff,0,23,30,30
1650488164267,MATH 109,A01,083213,Anzaldo; Leesa B,0,7,30,30
1650488164267,MATH 109,A02,083214,Anzaldo; Leesa B,0,7,30,30
1650488164267,MATH 109,B01,083215,Anzaldo; Leesa B,0,5,30,30
1650488164267,MATH 109,B02,083216,Anzaldo; Leesa B,0,6,30,30
1650488170298,MATH 142A,A01,083219,Chow; Bennett,0,15,30,30
1650488170298,MATH 142A,A02,083220,Chow; Bennett,0,13,30,30
1650488170298,MATH 142A,B01,083221,Chow; Bennett,0,12,30,30
1650488170298,MATH 142A,B02,083222,Chow; Bennett,0,13,30,30
1650488176323,MATH 193A,A01,083224,Staff,0,5,30,30
1650488176323,MATH 193A,A02,083225,Staff,0,5,30,30
1650488176323,MATH 193A,A03,083781,Staff,0,5,30,30
1650488176323,MATH 193A,A04,083782,Staff,0,6,30,30
1650488182353,MATH 197,001,091859,McAuley; Julian John,9998,0,9999,1
1650488188412,COGS 9,A01,083615,Staff,0,14,60,60
1650488194440,COGS 11,A01,083617,Boyle; Mary E. T.,20,0,40,20
1650488200575,COGS 13,A01,083071,Staff,0,34,40,40
1650488206600,COGS 14A,A01,092681,Staff,1,25,100,99
1650488212626,COGS 14B,A01,083073,Cheng; Tzu-Han,0,11,50,50
1650488218658,COGS 17,A01,092677,Staff,22,0,75,53
1650488224680,COGS 100,A01,083619,Staff,0,26,60,60
1650488230705,COGS 101A,A01,083621,Davis; Joshua Daniel,0,22,60,60
1650488236731,COGS 101B,A01,091572,Staff,0,4,60,60
1650488242757,COGS 101C,A01,083625,Delgado; Tania,16,0,30,14
1650488248781,COGS 107A,A01,083627,Boyle; Mary E. T.,0,11,60,60
1650488254806,COGS 118A,A01,083075,Staff,0,3,60,60
1650488260842,CSE 3,A50,083646,Miranda; Gregory Joseph,20,0,38,18
1650488260842,CSE 3,A51,083647,Miranda; Gregory Joseph,36,0,37,1
1650488266865,CSE 8A,A50,083650,Miranda; Gregory Joseph,1,28,40,39
1650488272898,CSE 11,A01,083080,Cao; Yingjun,0,92,40,40
1650488278921,CSE 12,A01,083652,Staff,0,17,100,100
1650488284946,CSE 15L,A01,083654,Staff,0,1,50,50
1650488284946,CSE 15L,A02,083655,Staff,0,0,50,50
1650488290969,CSE 20,A01,083657,Staff,51,0,80,29
1650488297004,CSE 30,A01,083084,Eldon; John,0,76,40,40
1650488303041,CSE 100,A01,083659,Cao; Yingjun,0,67,50,50
1650488309068,CSE 134B,A01,083661,Powell; Thomas Allan,0,31,65,65
1650488315098,CSE 140,A01,083663,Staff,0,5,75,75
1650488321121,CSE 140L,A01,083088,Eldon; John,0,9,75,75
1650488327147,CSE 175,A01,083665,Kumar; Rakesh,7,0,25,18
1650488333173,CSE 190,A00,092507,Dubnov; Shlomo,11,0,20,9
1650488339205,ECE 45,A01,083139,Staff,20,19,60,40
1650488345231,ECE 65,A50,083695,Staff,0,6,30,30
1650488351256,ECE 109,A01,091882,Touri; Behrouz,38,0,70,32
1650488357283,ECE 180,A00,083140,Abi Samra; Nicholas Camill,22,0,30,8
1650488357283,ECE 180,B00,083141,Abi Samra; Nicholas Camill,0,0,30,30
1650488363310,MATH 10A,A01,083735,Patchell; Gregory David,5,0,30,25
1650488363310,MATH 10A,A02,083736,Patchell; Gregory David,27,0,30,3
1650488363310,MATH 10A,A03,083737,Patchell; Gregory David,25,0,30,5
1650488369334,MATH 10B,A01,083207,Staff,0,8,30,30
1650488369334,MATH 10B,A02,083208,Staff,0,7,30,30
1650488369334,MATH 10B,B01,083739,Staff,13,0,30,17
1650488369334,MATH 10B,B02,083740,Staff,28,0,30,2
1650488375363,MATH 18,A01,083743,Staff,0,0,30,30
1650488375363,MATH 18,A02,083744,Staff,27,0,30,3
1650488375363,MATH 18,A03,083745,Staff,22,0,30,8
1650488375363,MATH 18,A04,083746,Staff,26,0,30,4
1650488375363,MATH 18,B01,083748,Staff,0,11,30,30
1650488375363,MATH 18,B02,083749,Staff,0,12,30,30
1650488375363,MATH 18,B03,083750,Staff,0,11,30,30
1650488375363,MATH 18,B04,083751,Staff,0,12,30,30
1650488381391,MATH 20A,A01,083754,Staff,25,0,40,15
1650488387418,MATH 20B,A01,083756,Staff,0,11,30,30
1650488387418,MATH 20B,A02,083757,Staff,0,11,30,30
1650488393444,MATH 20C,A01,083760,Staff,0,15,30,30
1650488393444,MATH 20C,A02,083761,Staff,2,15,30,28
1650488393444,MATH 20C,B01,083762,Staff,13,0,30,17
1650488393444,MATH 20C,B02,083763,Staff,28,0,30,2
1650488399472,MATH 20D,A01,083765,Staff,0,1,30,30
1650488399472,MATH 20D,A02,083766,Staff,9,0,30,21
1650488399472,MATH 20D,A03,083767,Staff,25,0,30,5
1650488405502,MATH 20E,A01,083771,Staff,6,0,30,24
1650488405502,MATH 20E,A02,083772,Staff,18,0,30,12
1650488405502,MATH 20E,B01,083773,Staff,0,0,30,30
1650488405502,MATH 20E,B02,083774,Staff,10,0,30,20
1650488411531,MATH 103A,A01,083777,Staff,0,12,30,30
1650488411531,MATH 103A,A02,083778,Staff,0,12,30,30
1650488411531,MATH 103A,B01,083779,Staff,0,13,30,30
1650488411531,MATH 103A,B02,083780,Staff,0,12,30,30
1650488417558,MATH 105,A01,085443,Staff,0,23,30,30
1650488423582,MATH 109,A01,083213,Anzaldo; Leesa B,0,7,30,30
1650488423582,MATH 109,A02,083214,Anzaldo; Leesa B,0,7,30,30
1650488423582,MATH 109,B01,083215,Anzaldo; Leesa B,0,5,30,30
1650488423582,MATH 109,B02,083216,Anzaldo; Leesa B,0,6,30,30
1650488429615,MATH 142A,A01,083219,Chow; Bennett,0,15,30,30
1650488429615,MATH 142A,A02,083220,Chow; Bennett,0,13,30,30
1650488429615,MATH 142A,B01,083221,Chow; Bennett,0,12,30,30
1650488429615,MATH 142A,B02,083222,Chow; Bennett,0,13,30,30
1650488435640,MATH 193A,A01,083224,Staff,0,5,30,30
1650488435640,MATH 193A,A02,083225,Staff,0,5,30,30
1650488435640,MATH 193A,A03,083781,Staff,0,5,30,30
1650488435640,MATH 193A,A04,083782,Staff,0,6,30,30
1650488441663,MATH 197,001,091859,McAuley; Julian John,9998,0,9999,1
1650488447735,COGS 9,A01,083615,Staff,0,14,60,60
1650488453761,COGS 11,A01,083617,Boyle; Mary E. T.,20,0,40,20
1650488459788,COGS 13,A01,083071,Staff,0,34,40,40
1650488465818,COGS 14A,A01,092681,Staff,1,25,100,99
1650488471847,COGS 14B,A01,083073,Cheng; Tzu-Han,0,11,50,50
1650488477876,COGS 17,A01,092677,Staff,22,0,75,53
1650488483898,COGS 100,A01,083619,Staff,0,26,60,60
1650488489935,COGS 101A,A01,083621,Davis; Joshua Daniel,0,22,60,60
1650488495968,COGS 101B,A01,091572,Staff,0,4,60,60
1650488501995,COGS 101C,A01,083625,Delgado; Tania,16,0,30,14
1650488508023,COGS 107A,A01,083627,Boyle; Mary E. T.,0,11,60,60
1650488514049,COGS 118A,A01,083075,Staff,0,3,60,60
1650488520080,CSE 3,A50,083646,Miranda; Gregory Joseph,20,0,38,18
1650488520080,CSE 3,A51,083647,Miranda; Gregory Joseph,36,0,37,1
1650488526109,CSE 8A,A50,083650,Miranda; Gregory Joseph,1,28,40,39
1650488532136,CSE 11,A01,083080,Cao; Yingjun,0,92,40,40
1650488538160,CSE 12,A01,083652,Staff,0,17,100,100
1650488544189,CSE 15L,A01,083654,Staff,0,1,50,50
1650488544189,CSE 15L,A02,083655,Staff,0,0,50,50
1650488550214,CSE 20,A01,083657,Staff,51,0,80,29
1650488556241,CSE 30,A01,083084,Eldon; John,0,76,40,40
1650488562272,CSE 100,A01,083659,Cao; Yingjun,0,67,50,50
1650488568294,CSE 134B,A01,083661,Powell; Thomas Allan,0,31,65,65
1650488574323,CSE 140,A01,083663,Staff,0,5,75,75
1650488580345,CSE 140L,A01,083088,Eldon; John,0,9,75,75
1650488586374,CSE 175,A01,083665,Kumar; Rakesh,7,0,25,18
1650488592398,CSE 190,A00,092507,Dubnov; Shlomo,11,0,20,9
1650488598422,ECE 45,A01,083139,Staff,20,19,60,40
1650488604449,ECE 65,A50,083695,Staff,0,6,30,30
1650488610475,ECE 109,A01,091882,Touri; Behrouz,38,0,70,32
1650488616508,ECE 180,A00,083140,Abi Samra; Nicholas Camill,22,0,30,8
1650488616508,ECE 180,B00,083141,Abi Samra; Nicholas Camill,0,0,30,30
1650488622544,MATH 10A,A01,083735,Patchell; Gregory David,5,0,30,25
1650488622544,MATH 10A,A02,083736,Patchell; Gregory David,27,0,30,3
1650488622544,MATH 10A,A03,083737,Patchell; Gregory David,25,0,30,5
1650488628581,MATH 10B,A01,083207,Staff,0,8,30,30
1650488628581,MATH 10B,A02,083208,Staff,0,7,30,30
1650488628581,MATH 10B,B01,083739,Staff,13,0,30,17
1650488628581,MATH 10B,B02,083740,Staff,28,0,30,2
1650488634613,MATH 18,A01,083743,Staff,0,0,30,30
1650488634613,MATH 18,A02,083744,Staff,27,0,30,3
1650488634613,MATH 18,A03,083745,Staff,22,0,30,8
1650488634613,MATH 18,A04,083746,Staff,26,0,30,4
1650488634613,MATH 18,B01,083748,Staff,0,11,30,30
1650488634613,MATH 18,B02,083749,Staff,0,12,30,30
1650488634613,MATH 18,B03,083750,Staff,0,11,30,30
1650488634613,MATH 18,B04,083751,Staff,0,12,30,30
1650488640635,MATH 20A,A01,083754,Staff,25,0,40,15
1650488646663,MATH 20B,A01,083756,Staff,0,11,30,30
1650488646663,MATH 20B,A02,083757,Staff,0,11,30,30
1650488652690,MATH 20C,A01,083760,Staff,0,15,30,30
1650488652690,MATH 20C,A02,083761,Staff,2,15,30,28
1650488652690,MATH 20C,B01,083762,Staff,13,0,30,17
1650488652690,MATH 20C,B02,083763,Staff,28,0,30,2
1650488658714,MATH 20D,A01,083765,Staff,0,1,30,30
1650488658714,MATH 20D,A02,083766,Staff,9,0,30,21
1650488658714,MATH 20D,A03,083767,Staff,25,0,30,5
1650488664738,MATH 20E,A01,083771,Staff,6,0,30,24
1650488664738,MATH 20E,A02,083772,Staff,18,0,30,12
1650488664738,MATH 20E,B01,083773,Staff,0,0,30,30
1650488664738,MATH 20E,B02,083774,Staff,10,0,30,20
1650488670761,MATH 103A,A01,083777,Staff,0,12,30,30
1650488670761,MATH 103A,A02,083778,Staff,0,12,30,30
1650488670761,MATH 103A,B01,083779,Staff,0,13,30,30
1650488670761,MATH 103A,B02,083780,Staff,0,12,30,30
1650488676787,MATH 105,A01,085443,Staff,0,23,30,30
1650488682811,MATH 109,A01,083213,Anzaldo; Leesa B,0,7,30,30
1650488682811,MATH 109,A02,083214,Anzaldo; Leesa B,0,7,30,30
1650488682811,MATH 109,B01,083215,Anzaldo; Leesa B,0,5,30,30
1650488682811,MATH 109,B02,083216,Anzaldo; Leesa B,0,6,30,30
1650488688846,MATH 142A,A01,083219,Chow; Bennett,0,15,30,30
1650488688846,MATH 142A,A02,083220,Chow; Bennett,0,13,30,30
1650488688846,MATH 142A,B01,083221,Chow; Bennett,0,12,30,30
1650488688846,MATH 142A,B02,083222,Chow; Bennett,0,13,30,30
1650488694886,MATH 193A,A01,083224,Staff,0,5,30,30
1650488694886,MATH 193A,A02,083225,Staff,0,5,30,30
1650488694886,MATH 193A,A03,083781,Staff,0,5,30,30
1650488694886,MATH 193A,A04,083782,Staff,0,6,30,30
1650488700910,MATH 197,001,091859,McAuley; Julian John,9998,0,9999,1
1650488706967,COGS 9,A01,083615,Staff,0,14,60,60
1650488712993,COGS 11,A01,083617,Boyle; Mary E. T.,20,0,40,20
1650488719020,COGS 13,A01,083071,Staff,0,34,40,40
1650488725046,COGS 14A,A01,092681,Staff,1,25,100,99
1650488731070,COGS 14B,A01,083073,Cheng; Tzu-Han,0,11,50,50
1650488737101,COGS 17,A01,092677,Staff,22,0,75,53
1650488743127,COGS 100,A01,083619,Staff,0,26,60,60
1650488749153,COGS 101A,A01,083621,Davis; Joshua Daniel,0,22,60,60
1650488755178,COGS 101B,A01,091572,Staff,0,4,60,60
1650488761214,COGS 101C,A01,083625,Delgado; Tania,16,0,30,14
1650488767240,COGS 107A,A01,083627,Boyle; Mary E. T.,0,11,60,60
1650488773270,COGS 118A,A01,083075,Staff,0,3,60,60
1650488779293,CSE 3,A50,083646,Miranda; Gregory Joseph,20,0,38,18
1650488779293,CSE 3,A51,083647,Miranda; Gregory Joseph,36,0,37,1
1650488785321,CSE 8A,A50,083650,Miranda; Gregory Joseph,1,28,40,39
1650488791351,CSE 11,A01,083080,Cao; Yingjun,0,92,40,40
1650488797463,CSE 12,A01,083652,Staff,0,17,100,100
1650488803492,CSE 15L,A01,083654,Staff,0,1,50,50
1650488803492,CSE 15L,A02,083655,Staff,0,0,50,50
1650488809528,CSE 20,A01,083657,Staff,51,0,80,29
1650488815551,CSE 30,A01,083084,Eldon; John,0,76,40,40
1650488821586,CSE 100,A01,083659,Cao; Yingjun,0,67,50,50
1650488827615,CSE 134B,A01,083661,Powell; Thomas Allan,0,31,65,65
1650488833639,CSE 140,A01,083663,Staff,0,5,75,75
1650488839662,CSE 140L,A01,083088,Eldon; John,0,9,75,75
1650488845689,CSE 175,A01,083665,Kumar; Rakesh,7,0,25,18
1650488851716,CSE 190,A00,092507,Dubnov; Shlomo,10,0,20,10
1650488857741,ECE 45,A01,083139,Staff,20,19,60,40
1650488863771,ECE 65,A50,083695,Staff,0,6,30,30
1650488869807,ECE 109,A01,091882,Touri; Behrouz,38,0,70,32
1650488875834,ECE 180,A00,083140,Abi Samra; Nicholas Camill,22,0,30,8
1650488875834,ECE 180,B00,083141,Abi Samra; Nicholas Camill,0,0,30,30
1650488881862,MATH 10A,A01,083735,Patchell; Gregory David,5,0,30,25
1650488881862,MATH 10A,A02,083736,Patchell; Gregory David,27,0,30,3
1650488881862,MATH 10A,A03,083737,Patchell; Gregory David,25,0,30,5
1650488887892,MATH 10B,A01,083207,Staff,0,8,30,30
1650488887892,MATH 10B,A02,083208,Staff,0,7,30,30
1650488887892,MATH 10B,B01,083739,Staff,13,0,30,17
1650488887892,MATH 10B,B02,083740,Staff,28,0,30,2
1650488893918,MATH 18,A01,083743,Staff,0,0,30,30
1650488893918,MATH 18,A02,083744,Staff,27,0,30,3
1650488893918,MATH 18,A03,083745,Staff,22,0,30,8
1650488893918,MATH 18,A04,083746,Staff,26,0,30,4
1650488893918,MATH 18,B01,083748,Staff,0,11,30,30
1650488893918,MATH 18,B02,083749,Staff,0,12,30,30
1650488893918,MATH 18,B03,083750,Staff,0,11,30,30
1650488893918,MATH 18,B04,083751,Staff,0,12,30,30
1650488899945,MATH 20A,A01,083754,Staff,25,0,40,15
1650488905968,MATH 20B,A01,083756,Staff,0,11,30,30
1650488905968,MATH 20B,A02,083757,Staff,0,11,30,30
1650488911999,MATH 20C,A01,083760,Staff,0,15,30,30
1650488911999,MATH 20C,A02,083761,Staff,2,15,30,28
1650488911999,MATH 20C,B01,083762,Staff,13,0,30,17
1650488911999,MATH 20C,B02,083763,Staff,28,0,30,2
1650488918025,MATH 20D,A01,083765,Staff,0,1,30,30
1650488918025,MATH 20D,A02,083766,Staff,9,0,30,21
1650488918025,MATH 20D,A03,083767,Staff,25,0,30,5
1650488924054,MATH 20E,A01,083771,Staff,6,0,30,24
1650488924054,MATH 20E,A02,083772,Staff,18,0,30,12
1650488924054,MATH 20E,B01,083773,Staff,0,0,30,30
1650488924054,MATH 20E,B02,083774,Staff,10,0,30,20
1650488930082,MATH 103A,A01,083777,Staff,0,12,30,30
1650488930082,MATH 103A,A02,083778,Staff,0,12,30,30
1650488930082,MATH 103A,B01,083779,Staff,0,13,30,30
1650488930082,MATH 103A,B02,083780,Staff,0,13,30,30
1650488936114,MATH 105,A01,085443,Staff,0,23,30,30
1650488942137,MATH 109,A01,083213,Anzaldo; Leesa B,0,7,30,30
1650488942137,MATH 109,A02,083214,Anzaldo; Leesa B,0,7,30,30
1650488942137,MATH 109,B01,083215,Anzaldo; Leesa B,0,5,30,30
1650488942137,MATH 109,B02,083216,Anzaldo; Leesa B,0,6,30,30
1650488948166,MATH 142A,A01,083219,Chow; Bennett,0,15,30,30
1650488948166,MATH 142A,A02,083220,Chow; Bennett,0,13,30,30
1650488948166,MATH 142A,B01,083221,Chow; Bennett,0,12,30,30
1650488948166,MATH 142A,B02,083222,Chow; Bennett,0,13,30,30
1650488954192,MATH 193A,A01,083224,Staff,0,5,30,30
1650488954192,MATH 193A,A02,083225,Staff,0,5,30,30
1650488954192,MATH 193A,A03,083781,Staff,0,5,30,30
1650488954192,MATH 193A,A04,083782,Staff,0,6,30,30
1650488960230,MATH 197,001,091859,McAuley; Julian John,9998,0,9999,1
1650488966288,COGS 9,A01,083615,Staff,0,14,60,60
1650488972315,COGS 11,A01,083617,Boyle; Mary E. T.,20,0,40,20
1650488978355,COGS 13,A01,083071,Staff,0,34,40,40
1650488984391,COGS 14A,A01,092681,Staff,1,25,100,99
1650488990414,COGS 14B,A01,083073,Cheng; Tzu-Han,0,11,50,50
1650488996438,COGS 17,A01,092677,Staff,22,0,75,53
1650489002467,COGS 100,A01,083619,Staff,0,26,60,60
1650489008491,COGS 101A,A01,083621,Davis; Joshua Daniel,0,22,60,60
1650489014519,COGS 101B,A01,091572,Staff,0,4,60,60
1650489020554,COGS 101C,A01,083625,Delgado; Tania,16,0,30,14
1650489026585,COGS 107A,A01,083627,Boyle; Mary E. T.,0,11,60,60
1650489032611,COGS 118A,A01,083075,Staff,0,3,60,60
1650489038638,CSE 3,A50,083646,Miranda; Gregory Joseph,20,0,38,18
1650489038638,CSE 3,A51,083647,Miranda; Gregory Joseph,36,0,37,1
1650489044665,CSE 8A,A50,083650,Miranda; Gregory Joseph,1,28,40,39
1650489050693,CSE 11,A01,083080,Cao; Yingjun,0,92,40,40
1650489056719,CSE 12,A01,083652,Staff,0,17,100,100
1650489062752,CSE 15L,A01,083654,Staff,0,1,50,50
1650489062752,CSE 15L,A02,083655,Staff,0,0,50,50
1650489068782,CSE 20,A01,083657,Staff,51,0,80,29
1650489074806,CSE 30,A01,083084,Eldon; John,0,76,40,40
1650489080829,CSE 100,A01,083659,Cao; Yingjun,0,67,50,50
1650489086854,CSE 134B,A01,083661,Powell; Thomas Allan,0,31,65,65
1650489092895,CSE 140,A01,083663,Staff,0,5,75,75
1650489098918,CSE 140L,A01,083088,Eldon; John,0,9,75,75
1650489104945,CSE 175,A01,083665,Kumar; Rakesh,7,0,25,18
1650489110969,CSE 190,A00,092507,Dubnov; Shlomo,10,0,20,10
1650489116993,ECE 45,A01,083139,Staff,20,19,60,40
1650489123023,ECE 65,A50,083695,Staff,0,6,30,30
1650489129049,ECE 109,A01,091882,Touri; Behrouz,38,0,70,32
1650489135075,ECE 180,A00,083140,Abi Samra; Nicholas Camill,22,0,30,8
1650489135075,ECE 180,B00,083141,Abi Samra; Nicholas Camill,0,0,30,30
1650489141099,MATH 10A,A01,083735,Patchell; Gregory David,5,0,30,25
1650489141099,MATH 10A,A02,083736,Patchell; Gregory David,27,0,30,3
1650489141099,MATH 10A,A03,083737,Patchell; Gregory David,25,0,30,5
1650489147122,MATH 10B,A01,083207,Staff,0,8,30,30
1650489147122,MATH 10B,A02,083208,Staff,0,7,30,30
1650489147122,MATH 10B,B01,083739,Staff,13,0,30,17
1650489147122,MATH 10B,B02,083740,Staff,28,0,30,2
1650489153154,MATH 18,A01,083743,Staff,0,0,30,30
1650489153154,MATH 18,A02,083744,Staff,27,0,30,3
1650489153154,MATH 18,A03,083745,Staff,22,0,30,8
1650489153154,MATH 18,A04,083746,Staff,26,0,30,4
1650489153154,MATH 18,B01,083748,Staff,0,11,30,30
1650489153154,MATH 18,B02,083749,Staff,0,12,30,30
1650489153154,MATH 18,B03,083750,Staff,0,11,30,30
1650489153154,MATH 18,B04,083751,Staff,0,12,30,30
1650489159178,MATH 20A,A01,083754,Staff,25,0,40,15
1650489165205,MATH 20B,A01,083756,Staff,0,11,30,30
1650489165205,MATH 20B,A02,083757,Staff,0,11,30,30
1650489171229,MATH 20C,A01,083760,Staff,0,15,30,30
1650489171229,MATH 20C,A02,083761,Staff,2,15,30,28
1650489171229,MATH 20C,B01,083762,Staff,13,0,30,17
1650489171229,MATH 20C,B02,083763,Staff,28,0,30,2
1650489177258,MATH 20D,A01,083765,Staff,0,1,30,30
1650489177258,MATH 20D,A02,083766,Staff,9,0,30,21
1650489177258,MATH 20D,A03,083767,Staff,25,0,30,5
1650489183286,MATH 20E,A01,083771,Staff,6,0,30,24
1650489183286,MATH 20E,A02,083772,Staff,18,0,30,12
1650489183286,MATH 20E,B01,083773,Staff,0,0,30,30
1650489183286,MATH 20E,B02,083774,Staff,10,0,30,20
1650489189310,MATH 103A,A01,083777,Staff,0,12,30,30
1650489189310,MATH 103A,A02,083778,Staff,0,12,30,30
1650489189310,MATH 103A,B01,083779,Staff,0,13,30,30
1650489189310,MATH 103A,B02,083780,Staff,0,13,30,30
1650489195344,MATH 105,A01,085443,Staff,0,23,30,30
1650489201368,MATH 109,A01,083213,Anzaldo; Leesa B,0,7,30,30
1650489201368,MATH 109,A02,083214,Anzaldo; Leesa B,0,7,30,30
1650489201368,MATH 109,B01,083215,Anzaldo; Leesa B,0,5,30,30
1650489201368,MATH 109,B02,083216,Anzaldo; Leesa B,0,6,30,30
1650489207394,MATH 142A,A01,083219,Chow; Bennett,0,15,30,30
1650489207394,MATH 142A,A02,083220,Chow; Bennett,0,13,30,30
1650489207394,MATH 142A,B01,083221,Chow; Bennett,0,12,30,30
1650489207394,MATH 142A,B02,083222,Chow; Bennett,0,13,30,30
1650489213422,MATH 193A,A01,083224,Staff,0,5,30,30
1650489213422,MATH 193A,A02,083225,Staff,0,5,30,30
1650489213422,MATH 193A,A03,083781,Staff,0,5,30,30
1650489213422,MATH 193A,A04,083782,Staff,0,6,30,30
1650489219450,MATH 197,001,091859,McAuley; Julian John,9998,0,9999,1
1650489225519,COGS 9,A01,083615,Staff,0,14,60,60
1650489231542,COGS 11,A01,083617,Boyle; Mary E. T.,20,0,40,20
1650489237566,COGS 13,A01,083071,Staff,0,34,40,40
1650489243588,COGS 14A,A01,092681,Staff,1,25,100,99
1650489249613,COGS 14B,A01,083073,Cheng; Tzu-Han,0,11,50,50
1650489255638,COGS 17,A01,092677,Staff,22,0,75,53
1650489261661,COGS 100,A01,083619,Staff,0,26,60,60
1650489267689,COGS 101A,A01,083621,Davis; Joshua Daniel,0,22,60,60
1650489273721,COGS 101B,A01,091572,Staff,0,4,60,60
1650489279746,COGS 101C,A01,083625,Delgado; Tania,16,0,30,14
1650489285776,COGS 107A,A01,083627,Boyle; Mary E. T.,0,11,60,60
1650489291798,COGS 118A,A01,083075,Staff,0,3,60,60
1650489297822,CSE 3,A50,083646,Miranda; Gregory Joseph,20,0,38,18
1650489297822,CSE 3,A51,083647,Miranda; Gregory Joseph,36,0,37,1
1650489303859,CSE 8A,A50,083650,Miranda; Gregory Joseph,1,28,40,39
1650489309892,CSE 11,A01,083080,Cao; Yingjun,0,92,40,40
1650489315920,CSE 12,A01,083652,Staff,0,17,100,100
1650489321945,CSE 15L,A01,083654,Staff,0,1,50,50
1650489321945,CSE 15L,A02,083655,Staff,0,0,50,50
1650489327978,CSE 20,A01,083657,Staff,51,0,80,29
1650489334001,CSE 30,A01,083084,Eldon; John,0,76,40,40
1650489340026,CSE 100,A01,083659,Cao; Yingjun,0,67,50,50
1650489346055,CSE 134B,A01,083661,Powell; Thomas Allan,0,31,65,65
1650489352076,CSE 140,A01,083663,Staff,0,5,75,75
1650489358105,CSE 140L,A01,083088,Eldon; John,0,9,75,75
1650489364134,CSE 175,A01,083665,Kumar; Rakesh,7,0,25,18
1650489370160,CSE 190,A00,092507,Dubnov; Shlomo,10,0,20,10
1650489376187,ECE 45,A01,083139,Staff,20,19,60,40
1650489382211,ECE 65,A50,083695,Staff,0,6,30,30
1650489388238,ECE 109,A01,091882,Touri; Behrouz,38,0,70,32
1650489394334,ECE 180,A00,083140,Abi Samra; Nicholas Camill,22,0,30,8
1650489394334,ECE 180,B00,083141,Abi Samra; Nicholas Camill,0,0,30,30
1650489400357,MATH 10A,A01,083735,Patchell; Gregory David,5,0,30,25
1650489400357,MATH 10A,A02,083736,Patchell; Gregory David,27,0,30,3
1650489400357,MATH 10A,A03,083737,Patchell; Gregory David,25,0,30,5
1650489406385,MATH 10B,A01,083207,Staff,0,8,30,30
1650489406385,MATH 10B,A02,083208,Staff,0,7,30,30
1650489406385,MATH 10B,B01,083739,Staff,13,0,30,17
1650489406385,MATH 10B,B02,083740,Staff,28,0,30,2
1650489412416,MATH 18,A01,083743,Staff,0,0,30,30
1650489412416,MATH 18,A02,083744,Staff,27,0,30,3
1650489412416,MATH 18,A03,083745,Staff,22,0,30,8
1650489412416,MATH 18,A04,083746,Staff,26,0,30,4
1650489412416,MATH 18,B01,083748,Staff,0,11,30,30
1650489412416,MATH 18,B02,083749,Staff,0,12,30,30
1650489412416,MATH 18,B03,083750,Staff,0,11,30,30
1650489412416,MATH 18,B04,083751,Staff,0,12,30,30
1650489418452,MATH 20A,A01,083754,Staff,25,0,40,15
1650489424488,MATH 20B,A01,083756,Staff,0,11,30,30
1650489424488,MATH 20B,A02,083757,Staff,0,11,30,30
1650489430515,MATH 20C,A01,083760,Staff,0,15,30,30
1650489430515,MATH 20C,A02,083761,Staff,2,15,30,28
1650489430515,MATH 20C,B01,083762,Staff,13,0,30,17
1650489430515,MATH 20C,B02,083763,Staff,28,0,30,2
1650489436543,MATH 20D,A01,083765,Staff,0,1,30,30
1650489436543,MATH 20D,A02,083766,Staff,9,0,30,21
1650489436543,MATH 20D,A03,083767,Staff,25,0,30,5
1650489442566,MATH 20E,A01,083771,Staff,6,0,30,24
1650489442566,MATH 20E,A02,083772,Staff,18,0,30,12
1650489442566,MATH 20E,B01,083773,Staff,0,0,30,30
1650489442566,MATH 20E,B02,083774,Staff,10,0,30,20
1650489448588,MATH 103A,A01,083777,Staff,0,12,30,30
1650489448588,MATH 103A,A02,083778,Staff,0,12,30,30
1650489448588,MATH 103A,B01,083779,Staff,0,13,30,30
1650489448588,MATH 103A,B02,083780,Staff,0,13,30,30
1650489454615,MATH 105,A01,085443,Staff,0,23,30,30
1650489460643,MATH 109,A01,083213,Anzaldo; Leesa B,0,7,30,30
1650489460643,MATH 109,A02,083214,Anzaldo; Leesa B,0,7,30,30
1650489460643,MATH 109,B01,083215,Anzaldo; Leesa B,0,5,30,30
1650489460643,MATH 109,B02,083216,Anzaldo; Leesa B,0,6,30,30
1650489466666,MATH 142A,A01,083219,Chow; Bennett,0,15,30,30
1650489466666,MATH 142A,A02,083220,Chow; Bennett,0,13,30,30
1650489466666,MATH 142A,B01,083221,Chow; Bennett,0,12,30,30
1650489466666,MATH 142A,B02,083222,Chow; Bennett,0,13,30,30
1650489472695,MATH 193A,A01,083224,Staff,0,5,30,30
1650489472695,MATH 193A,A02,083225,Staff,0,5,30,30
1650489472695,MATH 193A,A03,083781,Staff,0,5,30,30
1650489472695,MATH 193A,A04,083782,Staff,0,6,30,30
1650489478725,MATH 197,001,091859,McAuley; Julian John,9998,0,9999,1
1650489484787,COGS 9,A01,083615,Staff,0,14,60,60
1650489490814,COGS 11,A01,083617,Boyle; Mary E. T.,20,0,40,20
1650489496838,COGS 13,A01,083071,Staff,0,34,40,40
1650489502867,COGS 14A,A01,092681,Staff,1,25,100,99
1650489508893,COGS 14B,A01,083073,Cheng; Tzu-Han,0,11,50,50
1650489514915,COGS 17,A01,092677,Staff,22,0,75,53
1650489520938,COGS 100,A01,083619,Staff,0,26,60,60
1650489526962,COGS 101A,A01,083621,Davis; Joshua Daniel,0,22,60,60
1650489532987,COGS 101B,A01,091572,Staff,0,4,60,60
1650489539023,COGS 101C,A01,083625,Delgado; Tania,16,0,30,14
1650489545046,COGS 107A,A01,083627,Boyle; Mary E. T.,0,11,60,60
1650489551076,COGS 118A,A01,083075,Staff,0,3,60,60
1650489557104,CSE 3,A50,083646,Miranda; Gregory Joseph,20,0,38,18
1650489557104,CSE 3,A51,083647,Miranda; Gregory Joseph,36,0,37,1
1650489563128,CSE 8A,A50,083650,Miranda; Gregory Joseph,1,28,40,39
1650489569150,CSE 11,A01,083080,Cao; Yingjun,0,92,40,40
1650489575176,CSE 12,A01,083652,Staff,0,17,100,100
1650489581200,CSE 15L,A01,083654,Staff,0,1,50,50
1650489581200,CSE 15L,A02,083655,Staff,0,0,50,50
1650489587225,CSE 20,A01,083657,Staff,51,0,80,29
1650489593261,CSE 30,A01,083084,Eldon; John,0,77,40,40
1650489599285,CSE 100,A01,083659,Cao; Yingjun,0,67,50,50
1650489605309,CSE 134B,A01,083661,Powell; Thomas Allan,0,31,65,65
1650489611340,CSE 140,A01,083663,Staff,0,5,75,75
1650489617367,CSE 140L,A01,083088,Eldon; John,0,9,75,75
1650489623391,CSE 175,A01,083665,Kumar; Rakesh,7,0,25,18
1650489629423,CSE 190,A00,092507,Dubnov; Shlomo,10,0,20,10
1650489635448,ECE 45,A01,083139,Staff,20,19,60,40
1650489641475,ECE 65,A50,083695,Staff,0,6,30,30
1650489647503,ECE 109,A01,091882,Touri; Behrouz,38,0,70,32
1650489653527,ECE 180,A00,083140,Abi Samra; Nicholas Camill,22,0,30,8
1650489653527,ECE 180,B00,083141,Abi Samra; Nicholas Camill,0,0,30,30
1650489659555,MATH 10A,A01,083735,Patchell; Gregory David,5,0,30,25
1650489659555,MATH 10A,A02,083736,Patchell; Gregory David,27,0,30,3
1650489659555,MATH 10A,A03,083737,Patchell; Gregory David,25,0,30,5
1650489665583,MATH 10B,A01,083207,Staff,0,8,30,30
1650489665583,MATH 10B,A02,083208,Staff,0,7,30,30
1650489665583,MATH 10B,B01,083739,Staff,13,0,30,17
1650489665583,MATH 10B,B02,083740,Staff,28,0,30,2
1650489671616,MATH 18,A01,083743,Staff,0,0,30,30
1650489671616,MATH 18,A02,083744,Staff,27,0,30,3
1650489671616,MATH 18,A03,083745,Staff,22,0,30,8
1650489671616,MATH 18,A04,083746,Staff,26,0,30,4
1650489671616,MATH 18,B01,083748,Staff,0,11,30,30
1650489671616,MATH 18,B02,083749,Staff,0,12,30,30
1650489671616,MATH 18,B03,083750,Staff,0,11,30,30
1650489671616,MATH 18,B04,083751,Staff,0,12,30,30
1650489677639,MATH 20A,A01,083754,Staff,25,0,40,15
1650489683666,MATH 20B,A01,083756,Staff,0,11,30,30
1650489683666,MATH 20B,A02,083757,Staff,0,11,30,30
1650489689691,MATH 20C,A01,083760,Staff,0,15,30,30
1650489689691,MATH 20C,A02,083761,Staff,2,15,30,28
1650489689691,MATH 20C,B01,083762,Staff,13,0,30,17
1650489689691,MATH 20C,B02,083763,Staff,28,0,30,2
1650489695715,MATH 20D,A01,083765,Staff,0,1,30,30
1650489695715,MATH 20D,A02,083766,Staff,9,0,30,21
1650489695715,MATH 20D,A03,083767,Staff,25,0,30,5
1650489701737,MATH 20E,A01,083771,Staff,6,0,30,24
1650489701737,MATH 20E,A02,083772,Staff,18,0,30,12
1650489701737,MATH 20E,B01,083773,Staff,0,0,30,30
1650489701737,MATH 20E,B02,083774,Staff,10,0,30,20
1650489707779,MATH 103A,A01,083777,Staff,0,12,30,30
1650489707779,MATH 103A,A02,083778,Staff,0,12,30,30
1650489707779,MATH 103A,B01,083779,Staff,0,13,30,30
1650489707779,MATH 103A,B02,083780,Staff,0,13,30,30
1650489713815,MATH 105,A01,085443,Staff,0,23,30,30
1650489719838,MATH 109,A01,083213,Anzaldo; Leesa B,0,7,30,30
1650489719838,MATH 109,A02,083214,Anzaldo; Leesa B,0,7,30,30
1650489719838,MATH 109,B01,083215,Anzaldo; Leesa B,0,5,30,30
1650489719838,MATH 109,B02,083216,Anzaldo; Leesa B,0,6,30,30
1650489725877,MATH 142A,A01,083219,Chow; Bennett,0,15,30,30
1650489725877,MATH 142A,A02,083220,Chow; Bennett,0,13,30,30
1650489725877,MATH 142A,B01,083221,Chow; Bennett,0,12,30,30
1650489725877,MATH 142A,B02,083222,Chow; Bennett,0,13,30,30
1650489731912,MATH 193A,A01,083224,Staff,0,5,30,30
1650489731912,MATH 193A,A02,083225,Staff,0,5,30,30
1650489731912,MATH 193A,A03,083781,Staff,0,5,30,30
1650489731912,MATH 193A,A04,083782,Staff,0,6,30,30
1650489737934,MATH 197,001,091859,McAuley; Julian John,9998,0,9999,1
1650489743985,COGS 9,A01,083615,Staff,0,14,60,60
1650489750008,COGS 11,A01,083617,Boyle; Mary E. T.,20,0,40,20
1650489756032,COGS 13,A01,083071,Staff,0,34,40,40
1650489762062,COGS 14A,A01,092681,Staff,1,25,100,99
1650489768087,COGS 14B,A01,083073,Cheng; Tzu-Han,0,11,50,50
1650489774114,COGS 17,A01,092677,Staff,22,0,75,53
1650489780143,COGS 100,A01,083619,Staff,0,26,60,60
1650489786166,COGS 101A,A01,083621,Davis; Joshua Daniel,0,22,60,60
1650489792200,COGS 101B,A01,091572,Staff,0,4,60,60
1650489798228,COGS 101C,A01,083625,Delgado; Tania,16,0,30,14
1650489811005,COGS 107A,A01,083627,Boyle; Mary E. T.,0,11,60,60
1650489817030,COGS 118A,A01,083075,Staff,0,3,60,60
1650489823055,CSE 3,A50,083646,Miranda; Gregory Joseph,20,0,38,18
1650489823055,CSE 3,A51,083647,Miranda; Gregory Joseph,36,0,37,1
1650489829078,CSE 8A,A50,083650,Miranda; Gregory Joseph,1,28,40,39
1650489835112,CSE 11,A01,083080,Cao; Yingjun,0,92,40,40
1650489841136,CSE 12,A01,083652,Staff,0,17,100,100
1650489847161,CSE 15L,A01,083654,Staff,0,1,50,50
1650489847161,CSE 15L,A02,083655,Staff,0,0,50,50
1650489853200,CSE 20,A01,083657,Staff,51,0,80,29
1650489859230,CSE 30,A01,083084,Eldon; John,0,77,40,40
1650489865261,CSE 100,A01,083659,Cao; Yingjun,0,67,50,50
1650489871283,CSE 134B,A01,083661,Powell; Thomas Allan,0,31,65,65
1650489877320,CSE 140,A01,083663,Staff,0,5,75,75
1650489883343,CSE 140L,A01,083088,Eldon; John,0,9,75,75
1650489889369,CSE 175,A01,083665,Kumar; Rakesh,7,0,25,18
1650489895415,CSE 190,A00,092507,Dubnov; Shlomo,10,0,20,10
1650489901443,ECE 45,A01,083139,Staff,20,19,60,40
1650489907470,ECE 65,A50,083695,Staff,0,6,30,30
1650489913494,ECE 109,A01,091882,Touri; Behrouz,38,0,70,32
1650489919520,ECE 180,A00,083140,Abi Samra; Nicholas Camill,22,0,30,8
1650489919520,ECE 180,B00,083141,Abi Samra; Nicholas Camill,0,0,30,30
1650489925548,MATH 10A,A01,083735,Patchell; Gregory David,5,0,30,25
1650489925548,MATH 10A,A02,083736,Patchell; Gregory David,27,0,30,3
1650489925548,MATH 10A,A03,083737,Patchell; Gregory David,25,0,30,5
1650489931584,MATH 10B,A01,083207,Staff,0,8,30,30
1650489931584,MATH 10B,A02,083208,Staff,0,7,30,30
1650489931584,MATH 10B,B01,083739,Staff,13,0,30,17
1650489931584,MATH 10B,B02,083740,Staff,28,0,30,2
1650489937621,MATH 18,A01,083743,Staff,0,0,30,30
1650489937621,MATH 18,A02,083744,Staff,27,0,30,3
1650489937621,MATH 18,A03,083745,Staff,22,0,30,8
1650489937621,MATH 18,A04,083746,Staff,26,0,30,4
1650489937621,MATH 18,B01,083748,Staff,0,11,30,30
1650489937621,MATH 18,B02,083749,Staff,0,12,30,30
1650489937621,MATH 18,B03,083750,Staff,0,11,30,30
1650489937621,MATH 18,B04,083751,Staff,0,12,30,30
1650489943647,MATH 20A,A01,083754,Staff,25,0,40,15
1650489949675,MATH 20B,A01,083756,Staff,0,11,30,30
1650489949675,MATH 20B,A02,083757,Staff,0,11,30,30
1650489955699,MATH 20C,A01,083760,Staff,0,15,30,30
1650489955699,MATH 20C,A02,083761,Staff,2,15,30,28
1650489955699,MATH 20C,B01,083762,Staff,13,0,30,17
1650489955699,MATH 20C,B02,083763,Staff,28,0,30,2
1650489961724,MATH 20D,A01,083765,Staff,0,1,30,30
1650489961724,MATH 20D,A02,083766,Staff,9,0,30,21
1650489961724,MATH 20D,A03,083767,Staff,25,0,30,5
1650489967760,MATH 20E,A01,083771,Staff,6,0,30,24
1650489967760,MATH 20E,A02,083772,Staff,18,0,30,12
1650489967760,MATH 20E,B01,083773,Staff,0,0,30,30
1650489967760,MATH 20E,B02,083774,Staff,10,0,30,20
1650489973786,MATH 103A,A01,083777,Staff,0,12,30,30
1650489973786,MATH 103A,A02,083778,Staff,0,12,30,30
1650489973786,MATH 103A,B01,083779,Staff,0,13,30,30
1650489973786,MATH 103A,B02,083780,Staff,0,13,30,30
1650489979813,MATH 105,A01,085443,Staff,0,23,30,30
1650489985844,MATH 109,A01,083213,Anzaldo; Leesa B,0,7,30,30
1650489985844,MATH 109,A02,083214,Anzaldo; Leesa B,0,7,30,30
1650489985844,MATH 109,B01,083215,Anzaldo; Leesa B,0,5,30,30
1650489985844,MATH 109,B02,083216,Anzaldo; Leesa B,0,6,30,30
1650489991873,MATH 142A,A01,083219,Chow; Bennett,0,15,30,30
1650489991873,MATH 142A,A02,083220,Chow; Bennett,0,13,30,30
1650489991873,MATH 142A,B01,083221,Chow; Bennett,0,12,30,30
1650489991873,MATH 142A,B02,083222,Chow; Bennett,0,13,30,30
1650489997982,MATH 193A,A01,083224,Staff,0,5,30,30
1650489997982,MATH 193A,A02,083225,Staff,0,5,30,30
1650489997982,MATH 193A,A03,083781,Staff,0,5,30,30
1650489997982,MATH 193A,A04,083782,Staff,0,6,30,30
1650490004007,MATH 197,001,091859,McAuley; Julian John,9998,0,9999,1
1650490010054,COGS 9,A01,083615,Staff,0,14,60,60
1650490016095,COGS 11,A01,083617,Boyle; Mary E. T.,20,0,40,20
1650490022120,COGS 13,A01,083071,Staff,0,34,40,40
1650490028146,COGS 14A,A01,092681,Staff,1,25,100,99
1650490034173,COGS 14B,A01,083073,Cheng; Tzu-Han,0,11,50,50
1650490040199,COGS 17,A01,092677,Staff,22,0,75,53
1650490046227,COGS 100,A01,083619,Staff,0,26,60,60
1650490052252,COGS 101A,A01,083621,Davis; Joshua Daniel,0,22,60,60
1650490058287,COGS 101B,A01,091572,Staff,0,4,60,60
1650490064312,COGS 101C,A01,083625,Delgado; Tania,16,0,30,14
1650490070338,COGS 107A,A01,083627,Boyle; Mary E. T.,0,11,60,60
1650490076362,COGS 118A,A01,083075,Staff,0,3,60,60
1650490082387,CSE 3,A50,083646,Miranda; Gregory Joseph,20,0,38,18
1650490082387,CSE 3,A51,083647,Miranda; Gregory Joseph,36,0,37,1
1650490088426,CSE 8A,A50,083650,Miranda; Gregory Joseph,1,28,40,39
1650490094449,CSE 11,A01,083080,Cao; Yingjun,0,92,40,40
1650490100483,CSE 12,A01,083652,Staff,0,17,100,100
1650490106510,CSE 15L,A01,083654,Staff,0,1,50,50
1650490106510,CSE 15L,A02,083655,Staff,0,0,50,50
1650490112534,CSE 20,A01,083657,Staff,51,0,80,29
1650490118561,CSE 30,A01,083084,Eldon; John,0,77,40,40
1650490124596,CSE 100,A01,083659,Cao; Yingjun,0,67,50,50
1650490130622,CSE 134B,A01,083661,Powell; Thomas Allan,0,31,65,65
1650490136646,CSE 140,A01,083663,Staff,0,5,75,75
1650490142670,CSE 140L,A01,083088,Eldon; John,0,9,75,75
1650490148693,CSE 175,A01,083665,Kumar; Rakesh,7,0,25,18
1650490154730,CSE 190,A00,092507,Dubnov; Shlomo,10,0,20,10
1650490160759,ECE 45,A01,083139,Staff,20,19,60,40
1650490166783,ECE 65,A50,083695,Staff,0,6,30,30
1650490172810,ECE 109,A01,091882,Touri; Behrouz,38,0,70,32
1650490178835,ECE 180,A00,083140,Abi Samra; Nicholas Camill,22,0,30,8
1650490178835,ECE 180,B00,083141,Abi Samra; Nicholas Camill,0,0,30,30
1650490184858,MATH 10A,A01,083735,Patchell; Gregory David,5,0,30,25
1650490184858,MATH 10A,A02,083736,Patchell; Gregory David,27,0,30,3
1650490184858,MATH 10A,A03,083737,Patchell; Gregory David,25,0,30,5
1650490190883,MATH 10B,A01,083207,Staff,0,8,30,30
1650490190883,MATH 10B,A02,083208,Staff,0,7,30,30
1650490190883,MATH 10B,B01,083739,Staff,13,0,30,17
1650490190883,MATH 10B,B02,083740,Staff,28,0,30,2
1650490196908,MATH 18,A01,083743,Staff,0,0,30,30
1650490196908,MATH 18,A02,083744,Staff,27,0,30,3
1650490196908,MATH 18,A03,083745,Staff,22,0,30,8
1650490196908,MATH 18,A04,083746,Staff,26,0,30,4
1650490196908,MATH 18,B01,083748,Staff,0,11,30,30
1650490196908,MATH 18,B02,083749,Staff,0,12,30,30
1650490196908,MATH 18,B03,083750,Staff,0,11,30,30
1650490196908,MATH 18,B04,083751,Staff,0,12,30,30
1650490202931,MATH 20A,A01,083754,Staff,25,0,40,15
1650490208956,MATH 20B,A01,083756,Staff,0,11,30,30
1650490208956,MATH 20B,A02,083757,Staff,0,11,30,30
1650490214985,MATH 20C,A01,083760,Staff,0,15,30,30
1650490214985,MATH 20C,A02,083761,Staff,2,15,30,28
1650490214985,MATH 20C,B01,083762,Staff,13,0,30,17
1650490214985,MATH 20C,B02,083763,Staff,28,0,30,2
1650490221013,MATH 20D,A01,083765,Staff,0,1,30,30
1650490221013,MATH 20D,A02,083766,Staff,9,0,30,21
1650490221013,MATH 20D,A03,083767,Staff,25,0,30,5
1650490227042,MATH 20E,A01,083771,Staff,6,0,30,24
1650490227042,MATH 20E,A02,083772,Staff,18,0,30,12
1650490227042,MATH 20E,B01,083773,Staff,0,0,30,30
1650490227042,MATH 20E,B02,083774,Staff,10,0,30,20
1650490233065,MATH 103A,A01,083777,Staff,0,12,30,30
1650490233065,MATH 103A,A02,083778,Staff,0,12,30,30
1650490233065,MATH 103A,B01,083779,Staff,0,13,30,30
1650490233065,MATH 103A,B02,083780,Staff,0,13,30,30
1650490239092,MATH 105,A01,085443,Staff,0,23,30,30
1650490245117,MATH 109,A01,083213,Anzaldo; Leesa B,0,7,30,30
1650490245117,MATH 109,A02,083214,Anzaldo; Leesa B,0,7,30,30
1650490245117,MATH 109,B01,083215,Anzaldo; Leesa B,0,5,30,30
1650490245117,MATH 109,B02,083216,Anzaldo; Leesa B,0,6,30,30
1650490251158,MATH 142A,A01,083219,Chow; Bennett,0,15,30,30
1650490251158,MATH 142A,A02,083220,Chow; Bennett,0,13,30,30
1650490251158,MATH 142A,B01,083221,Chow; Bennett,0,12,30,30
1650490251158,MATH 142A,B02,083222,Chow; Bennett,0,13,30,30
1650490257199,MATH 193A,A01,083224,Staff,0,5,30,30
1650490257199,MATH 193A,A02,083225,Staff,0,5,30,30
1650490257199,MATH 193A,A03,083781,Staff,0,5,30,30
1650490257199,MATH 193A,A04,083782,Staff,0,6,30,30
1650490263221,MATH 197,001,091859,McAuley; Julian John,9998,0,9999,1
1650490269285,COGS 9,A01,083615,Staff,0,14,60,60
1650490275312,COGS 11,A01,083617,Boyle; Mary E. T.,20,0,40,20
1650490281340,COGS 13,A01,083071,Staff,0,34,40,40
1650490287363,COGS 14A,A01,092681,Staff,1,25,100,99
1650490293387,COGS 14B,A01,083073,Cheng; Tzu-Han,0,11,50,50
1650490299424,COGS 17,A01,092677,Staff,22,0,75,53
1650490305455,COGS 100,A01,083619,Staff,0,26,60,60
1650490311483,COGS 101A,A01,083621,Davis; Joshua Daniel,0,22,60,60
1650490317509,COGS 101B,A01,091572,Staff,0,4,60,60
1650490323548,COGS 101C,A01,083625,Delgado; Tania,16,0,30,14
1650490329572,COGS 107A,A01,083627,Boyle; Mary E. T.,0,11,60,60
1650490335593,COGS 118A,A01,083075,Staff,0,3,60,60
1650490341622,CSE 3,A50,083646,Miranda; Gregory Joseph,20,0,38,18
1650490341622,CSE 3,A51,083647,Miranda; Gregory Joseph,36,0,37,1
1650490347646,CSE 8A,A50,083650,Miranda; Gregory Joseph,1,28,40,39
1650490353668,CSE 11,A01,083080,Cao; Yingjun,0,92,40,40
1650490359692,CSE 12,A01,083652,Staff,0,17,100,100
1650490365720,CSE 15L,A01,083654,Staff,0,1,50,50
1650490365720,CSE 15L,A02,083655,Staff,0,0,50,50
1650490371756,CSE 20,A01,083657,Staff,51,0,80,29
1650490377781,CSE 30,A01,083084,Eldon; John,0,77,40,40
1650490383804,CSE 100,A01,083659,Cao; Yingjun,0,67,50,50
1650490389831,CSE 134B,A01,083661,Powell; Thomas Allan,0,31,65,65
1650490395858,CSE 140,A01,083663,Staff,0,5,75,75
1650490401881,CSE 140L,A01,083088,Eldon; John,0,9,75,75
1650490407906,CSE 175,A01,083665,Kumar; Rakesh,7,0,25,18
1650490413933,CSE 190,A00,092507,Dubnov; Shlomo,10,0,20,10
1650490419962,ECE 45,A01,083139,Staff,20,19,60,40
1650490425985,ECE 65,A50,083695,Staff,0,6,30,30
1650490432012,ECE 109,A01,091882,Touri; Behrouz,38,0,70,32
1650490438047,ECE 180,A00,083140,Abi Samra; Nicholas Camill,22,0,30,8
1650490438047,ECE 180,B00,083141,Abi Samra; Nicholas Camill,0,0,30,30
1650490444073,MATH 10A,A01,083735,Patchell; Gregory David,5,0,30,25
1650490444073,MATH 10A,A02,083736,Patchell; Gregory David,27,0,30,3
1650490444073,MATH 10A,A03,083737,Patchell; Gregory David,25,0,30,5
1650490450103,MATH 10B,A01,083207,Staff,0,8,30,30
1650490450103,MATH 10B,A02,083208,Staff,0,7,30,30
1650490450103,MATH 10B,B01,083739,Staff,13,0,30,17
1650490450103,MATH 10B,B02,083740,Staff,28,0,30,2
1650490456135,MATH 18,A01,083743,Staff,0,0,30,30
1650490456135,MATH 18,A02,083744,Staff,27,0,30,3
1650490456135,MATH 18,A03,083745,Staff,22,0,30,8
1650490456135,MATH 18,A04,083746,Staff,26,0,30,4
1650490456135,MATH 18,B01,083748,Staff,0,11,30,30
1650490456135,MATH 18,B02,083749,Staff,0,12,30,30
1650490456135,MATH 18,B03,083750,Staff,0,11,30,30
1650490456135,MATH 18,B04,083751,Staff,0,12,30,30
1650490462166,MATH 20A,A01,083754,Staff,25,0,40,15
1650490468192,MATH 20B,A01,083756,Staff,0,11,30,30
1650490468192,MATH 20B,A02,083757,Staff,0,11,30,30
1650490474216,MATH 20C,A01,083760,Staff,0,15,30,30
1650490474216,MATH 20C,A02,083761,Staff,2,15,30,28
1650490474216,MATH 20C,B01,083762,Staff,13,0,30,17
1650490474216,MATH 20C,B02,083763,Staff,28,0,30,2
1650490480253,MATH 20D,A01,083765,Staff,0,1,30,30
1650490480253,MATH 20D,A02,083766,Staff,9,0,30,21
1650490480253,MATH 20D,A03,083767,Staff,25,0,30,5
1650490486286,MATH 20E,A01,083771,Staff,6,0,30,24
1650490486286,MATH 20E,A02,083772,Staff,18,0,30,12
1650490486286,MATH 20E,B01,083773,Staff,0,0,30,30
1650490486286,MATH 20E,B02,083774,Staff,10,0,30,20
1650490492319,MATH 103A,A01,083777,Staff,0,12,30,30
1650490492319,MATH 103A,A02,083778,Staff,0,12,30,30
1650490492319,MATH 103A,B01,083779,Staff,0,13,30,30
1650490492319,MATH 103A,B02,083780,Staff,0,13,30,30
1650490498344,MATH 105,A01,085443,Staff,0,23,30,30
1650490504367,MATH 109,A01,083213,Anzaldo; Leesa B,0,7,30,30
1650490504367,MATH 109,A02,083214,Anzaldo; Leesa B,0,7,30,30
1650490504367,MATH 109,B01,083215,Anzaldo; Leesa B,0,5,30,30
1650490504367,MATH 109,B02,083216,Anzaldo; Leesa B,0,6,30,30
1650490510392,MATH 142A,A01,083219,Chow; Bennett,0,15,30,30
1650490510392,MATH 142A,A02,083220,Chow; Bennett,0,13,30,30
1650490510392,MATH 142A,B01,083221,Chow; Bennett,0,12,30,30
1650490510392,MATH 142A,B02,083222,Chow; Bennett,0,13,30,30
1650490516423,MATH 193A,A01,083224,Staff,0,5,30,30
1650490516423,MATH 193A,A02,083225,Staff,0,5,30,30
1650490516423,MATH 193A,A03,083781,Staff,0,5,30,30
1650490516423,MATH 193A,A04,083782,Staff,0,6,30,30
1650490522453,MATH 197,001,091859,McAuley; Julian John,9998,0,9999,1
1650490528510,COGS 9,A01,083615,Staff,0,14,60,60
1650490534536,COGS 11,A01,083617,Boyle; Mary E. T.,20,0,40,20
1650490540560,COGS 13,A01,083071,Staff,0,34,40,40
1650490546590,COGS 14A,A01,092681,Staff,1,25,100,99
1650490552616,COGS 14B,A01,083073,Cheng; Tzu-Han,0,11,50,50
1650490558650,COGS 17,A01,092677,Staff,22,0,75,53
1650490564673,COGS 100,A01,083619,Staff,0,26,60,60
1650490570697,COGS 101A,A01,083621,Davis; Joshua Daniel,0,22,60,60
1650490576721,COGS 101B,A01,091572,Staff,0,4,60,60
1650490582747,COGS 101C,A01,083625,Delgado; Tania,16,0,30,14
1650490588844,COGS 107A,A01,083627,Boyle; Mary E. T.,0,11,60,60
1650490594866,COGS 118A,A01,083075,Staff,0,3,60,60
1650490600894,CSE 3,A50,083646,Miranda; Gregory Joseph,20,0,38,18
1650490600894,CSE 3,A51,083647,Miranda; Gregory Joseph,36,0,37,1
1650490606939,CSE 8A,A50,083650,Miranda; Gregory Joseph,1,28,40,39
1650490612962,CSE 11,A01,083080,Cao; Yingjun,0,92,40,40
1650490618984,CSE 12,A01,083652,Staff,0,17,100,100
1650490625011,CSE 15L,A01,083654,Staff,0,1,50,50
1650490625011,CSE 15L,A02,083655,Staff,0,0,50,50
1650490631036,CSE 20,A01,083657,Staff,51,0,80,29
1650490637059,CSE 30,A01,083084,Eldon; John,0,77,40,40
1650490643083,CSE 100,A01,083659,Cao; Yingjun,0,67,50,50
1650490649127,CSE 134B,A01,083661,Powell; Thomas Allan,0,31,65,65
1650490655162,CSE 140,A01,083663,Staff,0,5,75,75
1650490661188,CSE 140L,A01,083088,Eldon; John,0,9,75,75
1650490667214,CSE 175,A01,083665,Kumar; Rakesh,7,0,25,18
1650490673245,CSE 190,A00,092507,Dubnov; Shlomo,10,0,20,10
1650490679272,ECE 45,A01,083139,Staff,20,19,60,40
1650490685299,ECE 65,A50,083695,Staff,0,6,30,30
1650490691323,ECE 109,A01,091882,Touri; Behrouz,38,0,70,32
1650490697354,ECE 180,A00,083140,Abi Samra; Nicholas Camill,22,0,30,8
1650490697354,ECE 180,B00,083141,Abi Samra; Nicholas Camill,0,0,30,30
1650490703391,MATH 10A,A01,083735,Patchell; Gregory David,5,0,30,25
1650490703391,MATH 10A,A02,083736,Patchell; Gregory David,27,0,30,3
1650490703391,MATH 10A,A03,083737,Patchell; Gregory David,25,0,30,5
1650490709422,MATH 10B,A01,083207,Staff,0,8,30,30
1650490709422,MATH 10B,A02,083208,Staff,0,7,30,30
1650490709422,MATH 10B,B01,083739,Staff,13,0,30,17
1650490709422,MATH 10B,B02,083740,Staff,28,0,30,2
1650490715445,MATH 18,A01,083743,Staff,0,0,30,30
1650490715445,MATH 18,A02,083744,Staff,27,0,30,3
1650490715445,MATH 18,A03,083745,Staff,22,0,30,8
1650490715445,MATH 18,A04,083746,Staff,26,0,30,4
1650490715445,MATH 18,B01,083748,Staff,0,11,30,30
1650490715445,MATH 18,B02,083749,Staff,0,12,30,30
1650490715445,MATH 18,B03,083750,Staff,0,11,30,30
1650490715445,MATH 18,B04,083751,Staff,0,12,30,30
1650490721472,MATH 20A,A01,083754,Staff,25,0,40,15
1650490727498,MATH 20B,A01,083756,Staff,0,11,30,30
1650490727498,MATH 20B,A02,083757,Staff,0,11,30,30
1650490733532,MATH 20C,A01,083760,Staff,0,15,30,30
1650490733532,MATH 20C,A02,083761,Staff,2,15,30,28
1650490733532,MATH 20C,B01,083762,Staff,13,0,30,17
1650490733532,MATH 20C,B02,083763,Staff,28,0,30,2
1650490739561,MATH 20D,A01,083765,Staff,0,1,30,30
1650490739561,MATH 20D,A02,083766,Staff,9,0,30,21
1650490739561,MATH 20D,A03,083767,Staff,25,0,30,5
1650490745589,MATH 20E,A01,083771,Staff,6,0,30,24
1650490745589,MATH 20E,A02,083772,Staff,18,0,30,12
1650490745589,MATH 20E,B01,083773,Staff,0,0,30,30
1650490745589,MATH 20E,B02,083774,Staff,10,0,30,20
1650490751617,MATH 103A,A01,083777,Staff,0,12,30,30
1650490751617,MATH 103A,A02,083778,Staff,0,12,30,30
1650490751617,MATH 103A,B01,083779,Staff,0,13,30,30
1650490751617,MATH 103A,B02,083780,Staff,0,13,30,30
1650490757646,MATH 105,A01,085443,Staff,0,23,30,30
1650490763679,MATH 109,A01,083213,Anzaldo; Leesa B,0,7,30,30
1650490763679,MATH 109,A02,083214,Anzaldo; Leesa B,0,7,30,30
1650490763679,MATH 109,B01,083215,Anzaldo; Leesa B,0,5,30,30
1650490763679,MATH 109,B02,083216,Anzaldo; Leesa B,0,6,30,30
1650490769707,MATH 142A,A01,083219,Chow; Bennett,0,15,30,30
1650490769707,MATH 142A,A02,083220,Chow; Bennett,0,13,30,30
1650490769707,MATH 142A,B01,083221,Chow; Bennett,0,12,30,30
1650490769707,MATH 142A,B02,083222,Chow; Bennett,0,13,30,30
1650490775740,MATH 193A,A01,083224,Staff,0,5,30,30
1650490775740,MATH 193A,A02,083225,Staff,0,5,30,30
1650490775740,MATH 193A,A03,083781,Staff,0,5,30,30
1650490775740,MATH 193A,A04,083782,Staff,0,6,30,30
1650490781764,MATH 197,001,091859,McAuley; Julian John,9998,0,9999,1
1650490787815,COGS 9,A01,083615,Staff,0,14,60,60
1650490793838,COGS 11,A01,083617,Boyle; Mary E. T.,20,0,40,20
1650490799872,COGS 13,A01,083071,Staff,0,34,40,40
1650490805895,COGS 14A,A01,092681,Staff,1,25,100,99
1650490811919,COGS 14B,A01,083073,Cheng; Tzu-Han,0,11,50,50
1650490817943,COGS 17,A01,092677,Staff,22,0,75,53
1650490823970,COGS 100,A01,083619,Staff,0,26,60,60
1650490830036,COGS 101A,A01,083621,Davis; Joshua Daniel,0,23,60,60
1650490836066,COGS 101B,A01,091572,Staff,0,4,60,60
1650490842094,COGS 101C,A01,083625,Delgado; Tania,16,0,30,14
1650490848126,COGS 107A,A01,083627,Boyle; Mary E. T.,0,11,60,60
1650490854154,COGS 118A,A01,083075,Staff,0,3,60,60
1650490860190,CSE 3,A50,083646,Miranda; Gregory Joseph,20,0,38,18
1650490860190,CSE 3,A51,083647,Miranda; Gregory Joseph,36,0,37,1
1650490866218,CSE 8A,A50,083650,Miranda; Gregory Joseph,1,28,40,39
1650490872243,CSE 11,A01,083080,Cao; Yingjun,0,92,40,40
1650490878270,CSE 12,A01,083652,Staff,0,17,100,100
1650490884294,CSE 15L,A01,083654,Staff,0,1,50,50
1650490884294,CSE 15L,A02,083655,Staff,0,0,50,50
1650490890328,CSE 20,A01,083657,Staff,51,0,80,29
1650490896359,CSE 30,A01,083084,Eldon; John,0,77,40,40
1650490902383,CSE 100,A01,083659,Cao; Yingjun,0,67,50,50
1650490908407,CSE 134B,A01,083661,Powell; Thomas Allan,0,31,65,65
1650490914429,CSE 140,A01,083663,Staff,0,5,75,75
1650490920460,CSE 140L,A01,083088,Eldon; John,0,9,75,75
1650490926483,CSE 175,A01,083665,Kumar; Rakesh,7,0,25,18
1650490932511,CSE 190,A00,092507,Dubnov; Shlomo,10,0,20,10
1650490938537,ECE 45,A01,083139,Staff,20,19,60,40
1650490944564,ECE 65,A50,083695,Staff,0,6,30,30
1650490950586,ECE 109,A01,091882,Touri; Behrouz,38,0,70,32
1650490956608,ECE 180,A00,083140,Abi Samra; Nicholas Camill,22,0,30,8
1650490956608,ECE 180,B00,083141,Abi Samra; Nicholas Camill,0,0,30,30
1650490962631,MATH 10A,A01,083735,Patchell; Gregory David,5,0,30,25
1650490962631,MATH 10A,A02,083736,Patchell; Gregory David,27,0,30,3
1650490962631,MATH 10A,A03,083737,Patchell; Gregory David,25,0,30,5
1650490968667,MATH 10B,A01,083207,Staff,0,8,30,30
1650490968667,MATH 10B,A02,083208,Staff,0,7,30,30
1650490968667,MATH 10B,B01,083739,Staff,13,0,30,17
1650490968667,MATH 10B,B02,083740,Staff,28,0,30,2
1650490974696,MATH 18,A01,083743,Staff,0,0,30,30
1650490974696,MATH 18,A02,083744,Staff,27,0,30,3
1650490974696,MATH 18,A03,083745,Staff,22,0,30,8
1650490974696,MATH 18,A04,083746,Staff,26,0,30,4
1650490974696,MATH 18,B01,083748,Staff,0,11,30,30
1650490974696,MATH 18,B02,083749,Staff,0,12,30,30
1650490974696,MATH 18,B03,083750,Staff,0,11,30,30
1650490974696,MATH 18,B04,083751,Staff,0,12,30,30
1650490980725,MATH 20A,A01,083754,Staff,25,0,40,15
1650490986753,MATH 20B,A01,083756,Staff,0,11,30,30
1650490986753,MATH 20B,A02,083757,Staff,0,11,30,30
1650490992775,MATH 20C,A01,083760,Staff,0,16,30,30
1650490992775,MATH 20C,A02,083761,Staff,2,15,30,28
1650490992775,MATH 20C,B01,083762,Staff,13,0,30,17
1650490992775,MATH 20C,B02,083763,Staff,28,0,30,2
1650490998799,MATH 20D,A01,083765,Staff,0,1,30,30
1650490998799,MATH 20D,A02,083766,Staff,9,0,30,21
1650490998799,MATH 20D,A03,083767,Staff,25,0,30,5
1650491004822,MATH 20E,A01,083771,Staff,6,0,30,24
1650491004822,MATH 20E,A02,083772,Staff,18,0,30,12
1650491004822,MATH 20E,B01,083773,Staff,0,0,30,30
1650491004822,MATH 20E,B02,083774,Staff,10,0,30,20
1650491010848,MATH 103A,A01,083777,Staff,0,12,30,30
1650491010848,MATH 103A,A02,083778,Staff,0,12,30,30
1650491010848,MATH 103A,B01,083779,Staff,0,13,30,30
1650491010848,MATH 103A,B02,083780,Staff,0,13,30,30
1650491016874,MATH 105,A01,085443,Staff,0,23,30,30
1650491022904,MATH 109,A01,083213,Anzaldo; Leesa B,0,7,30,30
1650491022904,MATH 109,A02,083214,Anzaldo; Leesa B,0,7,30,30
1650491022904,MATH 109,B01,083215,Anzaldo; Leesa B,0,5,30,30
1650491022904,MATH 109,B02,083216,Anzaldo; Leesa B,0,6,30,30
1650491028935,MATH 142A,A01,083219,Chow; Bennett,0,15,30,30
1650491028935,MATH 142A,A02,083220,Chow; Bennett,0,13,30,30
1650491028935,MATH 142A,B01,083221,Chow; Bennett,0,12,30,30
1650491028935,MATH 142A,B02,083222,Chow; Bennett,0,13,30,30
1650491034959,MATH 193A,A01,083224,Staff,0,5,30,30
1650491034959,MATH 193A,A02,083225,Staff,0,5,30,30
1650491034959,MATH 193A,A03,083781,Staff,0,5,30,30
1650491034959,MATH 193A,A04,083782,Staff,0,6,30,30
1650491040986,MATH 197,001,091859,McAuley; Julian John,9998,0,9999,1
1650491047041,COGS 9,A01,083615,Staff,0,14,60,60
1650491053072,COGS 11,A01,083617,Boyle; Mary E. T.,20,0,40,20
1650491059097,COGS 13,A01,083071,Staff,0,34,40,40
1650491065120,COGS 14A,A01,092681,Staff,1,25,100,99
1650491071144,COGS 14B,A01,083073,Cheng; Tzu-Han,0,11,50,50
1650491077173,COGS 17,A01,092677,Staff,22,0,75,53
1650491083197,COGS 100,A01,083619,Staff,0,26,60,60
1650491089220,COGS 101A,A01,083621,Davis; Joshua Daniel,0,23,60,60
1650491095280,COGS 101B,A01,091572,Staff,0,4,60,60
1650491101313,COGS 101C,A01,083625,Delgado; Tania,16,0,30,14
1650491107341,COGS 107A,A01,083627,Boyle; Mary E. T.,0,11,60,60
1650491113365,COGS 118A,A01,083075,Staff,0,3,60,60
1650491119398,CSE 3,A50,083646,Miranda; Gregory Joseph,20,0,38,18
1650491119398,CSE 3,A51,083647,Miranda; Gregory Joseph,36,0,37,1
1650491125425,CSE 8A,A50,083650,Miranda; Gregory Joseph,1,28,40,39
1650491131451,CSE 11,A01,083080,Cao; Yingjun,0,92,40,40
1650491137477,CSE 12,A01,083652,Staff,0,17,100,100
1650491143510,CSE 15L,A01,083654,Staff,0,1,50,50
1650491143510,CSE 15L,A02,083655,Staff,0,0,50,50
1650491149540,CSE 20,A01,083657,Staff,51,0,80,29
1650491155562,CSE 30,A01,083084,Eldon; John,0,77,40,40
1650491161593,CSE 100,A01,083659,Cao; Yingjun,0,67,50,50
1650491167615,CSE 134B,A01,083661,Powell; Thomas Allan,0,31,65,65
1650491173639,CSE 140,A01,083663,Staff,0,5,75,75
1650491179663,CSE 140L,A01,083088,Eldon; John,0,9,75,75
1650491185759,CSE 175,A01,083665,Kumar; Rakesh,7,0,25,18
1650491191796,CSE 190,A00,092507,Dubnov; Shlomo,10,0,20,10
1650491197833,ECE 45,A01,083139,Staff,20,19,60,40
1650491203870,ECE 65,A50,083695,Staff,0,6,30,30
1650491209892,ECE 109,A01,091882,Touri; Behrouz,38,0,70,32
1650491215934,ECE 180,A00,083140,Abi Samra; Nicholas Camill,22,0,30,8
1650491215934,ECE 180,B00,083141,Abi Samra; Nicholas Camill,0,0,30,30
1650491221971,MATH 10A,A01,083735,Patchell; Gregory David,5,0,30,25
1650491221971,MATH 10A,A02,083736,Patchell; Gregory David,27,0,30,3
1650491221971,MATH 10A,A03,083737,Patchell; Gregory David,25,0,30,5
1650491227994,MATH 10B,A01,083207,Staff,0,8,30,30
1650491227994,MATH 10B,A02,083208,Staff,0,7,30,30
1650491227994,MATH 10B,B01,083739,Staff,13,0,30,17
1650491227994,MATH 10B,B02,083740,Staff,28,0,30,2
1650491234023,MATH 18,A01,083743,Staff,0,0,30,30
1650491234023,MATH 18,A02,083744,Staff,27,0,30,3
1650491234023,MATH 18,A03,083745,Staff,22,0,30,8
1650491234023,MATH 18,A04,083746,Staff,26,0,30,4
1650491234023,MATH 18,B01,083748,Staff,0,11,30,30
1650491234023,MATH 18,B02,083749,Staff,0,12,30,30
1650491234023,MATH 18,B03,083750,Staff,0,11,30,30
1650491234023,MATH 18,B04,083751,Staff,0,12,30,30
1650491240047,MATH 20A,A01,083754,Staff,25,0,40,15
1650491246071,MATH 20B,A01,083756,Staff,0,11,30,30
1650491246071,MATH 20B,A02,083757,Staff,0,11,30,30
1650491252108,MATH 20C,A01,083760,Staff,0,16,30,30
1650491252108,MATH 20C,A02,083761,Staff,2,15,30,28
1650491252108,MATH 20C,B01,083762,Staff,13,0,30,17
1650491252108,MATH 20C,B02,083763,Staff,28,0,30,2
1650491258134,MATH 20D,A01,083765,Staff,0,1,30,30
1650491258134,MATH 20D,A02,083766,Staff,9,0,30,21
1650491258134,MATH 20D,A03,083767,Staff,25,0,30,5
1650491264171,MATH 20E,A01,083771,Staff,6,0,30,24
1650491264171,MATH 20E,A02,083772,Staff,18,0,30,12
1650491264171,MATH 20E,B01,083773,Staff,0,0,30,30
1650491264171,MATH 20E,B02,083774,Staff,10,0,30,20
1650491270195,MATH 103A,A01,083777,Staff,0,12,30,30
1650491270195,MATH 103A,A02,083778,Staff,0,12,30,30
1650491270195,MATH 103A,B01,083779,Staff,0,13,30,30
1650491270195,MATH 103A,B02,083780,Staff,0,13,30,30
1650491276218,MATH 105,A01,085443,Staff,0,23,30,30
1650491282246,MATH 109,A01,083213,Anzaldo; Leesa B,0,7,30,30
1650491282246,MATH 109,A02,083214,Anzaldo; Leesa B,0,7,30,30
1650491282246,MATH 109,B01,083215,Anzaldo; Leesa B,0,5,30,30
1650491282246,MATH 109,B02,083216,Anzaldo; Leesa B,0,6,30,30
1650491288274,MATH 142A,A01,083219,Chow; Bennett,0,15,30,30
1650491288274,MATH 142A,A02,083220,Chow; Bennett,0,13,30,30
1650491288274,MATH 142A,B01,083221,Chow; Bennett,0,12,30,30
1650491288274,MATH 142A,B02,083222,Chow; Bennett,0,13,30,30
1650491294298,MATH 193A,A01,083224,Staff,0,5,30,30
1650491294298,MATH 193A,A02,083225,Staff,0,5,30,30
1650491294298,MATH 193A,A03,083781,Staff,0,5,30,30
1650491294298,MATH 193A,A04,083782,Staff,0,6,30,30
1650491300324,MATH 197,001,091859,McAuley; Julian John,9998,0,9999,1
1650491306384,COGS 9,A01,083615,Staff,0,14,60,60
1650491312408,COGS 11,A01,083617,Boyle; Mary E. T.,20,0,40,20
1650491318442,COGS 13,A01,083071,Staff,0,34,40,40
1650491324466,COGS 14A,A01,092681,Staff,1,25,100,99
1650491330488,COGS 14B,A01,083073,Cheng; Tzu-Han,0,11,50,50
1650491336515,COGS 17,A01,092677,Staff,21,0,75,54
1650491342554,COGS 100,A01,083619,Staff,0,26,60,60
1650491348580,COGS 101A,A01,083621,Davis; Joshua Daniel,0,23,60,60
1650491354605,COGS 101B,A01,091572,Staff,0,4,60,60
1650491360629,COGS 101C,A01,083625,Delgado; Tania,16,0,30,14
1650491366653,COGS 107A,A01,083627,Boyle; Mary E. T.,0,11,60,60
1650491372683,COGS 118A,A01,083075,Staff,0,3,60,60
1650491378707,CSE 3,A50,083646,Miranda; Gregory Joseph,20,0,38,18
1650491378707,CSE 3,A51,083647,Miranda; Gregory Joseph,36,0,37,1
1650491384739,CSE 8A,A50,083650,Miranda; Gregory Joseph,1,28,40,39
1650491390763,CSE 11,A01,083080,Cao; Yingjun,0,92,40,40
1650491396787,CSE 12,A01,083652,Staff,0,17,100,100
1650491402811,CSE 15L,A01,083654,Staff,0,1,50,50
1650491402811,CSE 15L,A02,083655,Staff,0,0,50,50
1650491408834,CSE 20,A01,083657,Staff,51,0,80,29
1650491414863,CSE 30,A01,083084,Eldon; John,0,77,40,40
1650491420890,CSE 100,A01,083659,Cao; Yingjun,0,67,50,50
1650491426921,CSE 134B,A01,083661,Powell; Thomas Allan,0,31,65,65
1650491432944,CSE 140,A01,083663,Staff,0,5,75,75
1650491438970,CSE 140L,A01,083088,Eldon; John,0,9,75,75
1650491445003,CSE 175,A01,083665,Kumar; Rakesh,7,0,25,18
1650491451039,CSE 190,A00,092507,Dubnov; Shlomo,10,0,20,10
1650491457065,ECE 45,A01,083139,Staff,20,19,60,40
1650491463100,ECE 65,A50,083695,Staff,0,6,30,30
1650491469126,ECE 109,A01,091882,Touri; Behrouz,38,0,70,32
1650491475173,ECE 180,A00,083140,Abi Samra; Nicholas Camill,22,0,30,8
1650491475173,ECE 180,B00,083141,Abi Samra; Nicholas Camill,0,0,30,30
1650491481196,MATH 10A,A01,083735,Patchell; Gregory David,5,0,30,25
1650491481196,MATH 10A,A02,083736,Patchell; Gregory David,27,0,30,3
1650491481196,MATH 10A,A03,083737,Patchell; Gregory David,25,0,30,5
1650491487220,MATH 10B,A01,083207,Staff,0,8,30,30
1650491487220,MATH 10B,A02,083208,Staff,0,7,30,30
1650491487220,MATH 10B,B01,083739,Staff,13,0,30,17
1650491487220,MATH 10B,B02,083740,Staff,28,0,30,2
1650491493244,MATH 18,A01,083743,Staff,0,0,30,30
1650491493244,MATH 18,A02,083744,Staff,27,0,30,3
1650491493244,MATH 18,A03,083745,Staff,22,0,30,8
1650491493244,MATH 18,A04,083746,Staff,26,0,30,4
1650491493244,MATH 18,B01,083748,Staff,0,11,30,30
1650491493244,MATH 18,B02,083749,Staff,0,12,30,30
1650491493244,MATH 18,B03,083750,Staff,0,11,30,30
1650491493244,MATH 18,B04,083751,Staff,0,12,30,30
1650491499277,MATH 20A,A01,083754,Staff,25,0,40,15
1650491505311,MATH 20B,A01,083756,Staff,0,11,30,30
1650491505311,MATH 20B,A02,083757,Staff,0,11,30,30
1650491511336,MATH 20C,A01,083760,Staff,0,16,30,30
1650491511336,MATH 20C,A02,083761,Staff,2,15,30,28
1650491511336,MATH 20C,B01,083762,Staff,13,0,30,17
1650491511336,MATH 20C,B02,083763,Staff,28,0,30,2
1650491517362,MATH 20D,A01,083765,Staff,0,1,30,30
1650491517362,MATH 20D,A02,083766,Staff,9,0,30,21
1650491517362,MATH 20D,A03,083767,Staff,25,0,30,5
1650491523386,MATH 20E,A01,083771,Staff,6,0,30,24
1650491523386,MATH 20E,A02,083772,Staff,18,0,30,12
1650491523386,MATH 20E,B01,083773,Staff,0,0,30,30
1650491523386,MATH 20E,B02,083774,Staff,10,0,30,20
1650491529429,MATH 103A,A01,083777,Staff,0,12,30,30
1650491529429,MATH 103A,A02,083778,Staff,0,12,30,30
1650491529429,MATH 103A,B01,083779,Staff,0,13,30,30
1650491529429,MATH 103A,B02,083780,Staff,0,13,30,30
1650491535468,MATH 105,A01,085443,Staff,0,23,30,30
1650491541567,MATH 109,A01,083213,Anzaldo; Leesa B,0,7,30,30
1650491541567,MATH 109,A02,083214,Anzaldo; Leesa B,0,7,30,30
1650491541567,MATH 109,B01,083215,Anzaldo; Leesa B,0,5,30,30
1650491541567,MATH 109,B02,083216,Anzaldo; Leesa B,0,6,30,30
1650491547614,MATH 142A,A01,083219,Chow; Bennett,0,15,30,30
1650491547614,MATH 142A,A02,083220,Chow; Bennett,0,13,30,30
1650491547614,MATH 142A,B01,083221,Chow; Bennett,0,12,30,30
1650491547614,MATH 142A,B02,083222,Chow; Bennett,0,13,30,30
1650491553656,MATH 193A,A01,083224,Staff,0,5,30,30
1650491553656,MATH 193A,A02,083225,Staff,0,5,30,30
1650491553656,MATH 193A,A03,083781,Staff,0,5,30,30
1650491553656,MATH 193A,A04,083782,Staff,0,6,30,30
1650491559679,MATH 197,001,091859,McAuley; Julian John,9998,0,9999,1
1650491565751,COGS 9,A01,083615,Staff,0,14,60,60
1650491571775,COGS 11,A01,083617,Boyle; Mary E. T.,20,0,40,20
1650491577801,COGS 13,A01,083071,Staff,0,34,40,40
1650491583824,COGS 14A,A01,092681,Staff,1,25,100,99
1650491589848,COGS 14B,A01,083073,Cheng; Tzu-Han,0,11,50,50
1650491595873,COGS 17,A01,092677,Staff,21,0,75,54
1650491601903,COGS 100,A01,083619,Staff,0,26,60,60
1650491607927,COGS 101A,A01,083621,Davis; Joshua Daniel,0,23,60,60
1650491613955,COGS 101B,A01,091572,Staff,0,4,60,60
1650491619985,COGS 101C,A01,083625,Delgado; Tania,16,0,30,14
1650491626021,COGS 107A,A01,083627,Boyle; Mary E. T.,0,11,60,60
1650491632049,COGS 118A,A01,083075,Staff,0,3,60,60
1650491638087,CSE 3,A50,083646,Miranda; Gregory Joseph,20,0,38,18
1650491638087,CSE 3,A51,083647,Miranda; Gregory Joseph,36,0,37,1
1650491644110,CSE 8A,A50,083650,Miranda; Gregory Joseph,1,28,40,39
1650491650147,CSE 11,A01,083080,Cao; Yingjun,0,92,40,40
1650491656187,CSE 12,A01,083652,Staff,0,17,100,100
1650491662233,CSE 15L,A01,083654,Staff,0,1,50,50
1650491662233,CSE 15L,A02,083655,Staff,0,0,50,50
1650491668271,CSE 20,A01,083657,Staff,51,0,80,29
1650491674307,CSE 30,A01,083084,Eldon; John,0,77,40,40
1650491680331,CSE 100,A01,083659,Cao; Yingjun,0,67,50,50
1650491686358,CSE 134B,A01,083661,Powell; Thomas Allan,0,31,65,65
1650491692388,CSE 140,A01,083663,Staff,0,5,75,75
1650491698415,CSE 140L,A01,083088,Eldon; John,0,9,75,75
1650491704439,CSE 175,A01,083665,Kumar; Rakesh,7,0,25,18
1650491710472,CSE 190,A00,092507,Dubnov; Shlomo,10,0,20,10
1650491716504,ECE 45,A01,083139,Staff,20,19,60,40
1650491722542,ECE 65,A50,083695,Staff,0,6,30,30
1650491728587,ECE 109,A01,091882,Touri; Behrouz,38,0,70,32
1650491734613,ECE 180,A00,083140,Abi Samra; Nicholas Camill,22,0,30,8
1650491734613,ECE 180,B00,083141,Abi Samra; Nicholas Camill,0,0,30,30
1650491740637,MATH 10A,A01,083735,Patchell; Gregory David,5,0,30,25
1650491740637,MATH 10A,A02,083736,Patchell; Gregory David,27,0,30,3
1650491740637,MATH 10A,A03,083737,Patchell; Gregory David,25,0,30,5
1650491746662,MATH 10B,A01,083207,Staff,0,8,30,30
1650491746662,MATH 10B,A02,083208,Staff,0,7,30,30
1650491746662,MATH 10B,B01,083739,Staff,13,0,30,17
1650491746662,MATH 10B,B02,083740,Staff,28,0,30,2
1650491752695,MATH 18,A01,083743,Staff,0,0,30,30
1650491752695,MATH 18,A02,083744,Staff,27,0,30,3
1650491752695,MATH 18,A03,083745,Staff,22,0,30,8
1650491752695,MATH 18,A04,083746,Staff,26,0,30,4
1650491752695,MATH 18,B01,083748,Staff,0,11,30,30
1650491752695,MATH 18,B02,083749,Staff,0,12,30,30
1650491752695,MATH 18,B03,083750,Staff,0,11,30,30
1650491752695,MATH 18,B04,083751,Staff,0,12,30,30
1650491758719,MATH 20A,A01,083754,Staff,25,0,40,15
1650491764743,MATH 20B,A01,083756,Staff,0,11,30,30
1650491764743,MATH 20B,A02,083757,Staff,0,11,30,30
1650491770770,MATH 20C,A01,083760,Staff,0,16,30,30
1650491770770,MATH 20C,A02,083761,Staff,2,15,30,28
1650491770770,MATH 20C,B01,083762,Staff,13,0,30,17
1650491770770,MATH 20C,B02,083763,Staff,28,0,30,2
1650491776805,MATH 20D,A01,083765,Staff,0,1,30,30
1650491776805,MATH 20D,A02,083766,Staff,9,0,30,21
1650491776805,MATH 20D,A03,083767,Staff,25,0,30,5
1650491782904,MATH 20E,A01,083771,Staff,6,0,30,24
1650491782904,MATH 20E,A02,083772,Staff,18,0,30,12
1650491782904,MATH 20E,B01,083773,Staff,0,0,30,30
1650491782904,MATH 20E,B02,083774,Staff,10,0,30,20
1650491788943,MATH 103A,A01,083777,Staff,0,12,30,30
1650491788943,MATH 103A,A02,083778,Staff,0,12,30,30
1650491788943,MATH 103A,B01,083779,Staff,0,13,30,30
1650491788943,MATH 103A,B02,083780,Staff,0,13,30,30
1650491794968,MATH 105,A01,085443,Staff,0,23,30,30
1650491800993,MATH 109,A01,083213,Anzaldo; Leesa B,0,7,30,30
1650491800993,MATH 109,A02,083214,Anzaldo; Leesa B,0,7,30,30
1650491800993,MATH 109,B01,083215,Anzaldo; Leesa B,0,5,30,30
1650491800993,MATH 109,B02,083216,Anzaldo; Leesa B,0,6,30,30
1650491807018,MATH 142A,A01,083219,Chow; Bennett,0,15,30,30
1650491807018,MATH 142A,A02,083220,Chow; Bennett,0,13,30,30
1650491807018,MATH 142A,B01,083221,Chow; Bennett,0,12,30,30
1650491807018,MATH 142A,B02,083222,Chow; Bennett,0,13,30,30
1650491813045,MATH 193A,A01,083224,Staff,0,5,30,30
1650491813045,MATH 193A,A02,083225,Staff,0,5,30,30
1650491813045,MATH 193A,A03,083781,Staff,0,5,30,30
1650491813045,MATH 193A,A04,083782,Staff,0,6,30,30
1650491819084,MATH 197,001,091859,McAuley; Julian John,9998,0,9999,1
1650491825136,COGS 9,A01,083615,Staff,0,14,60,60
1650491831168,COGS 11,A01,083617,Boyle; Mary E. T.,20,0,40,20
1650491837191,COGS 13,A01,083071,Staff,0,34,40,40
1650491843216,COGS 14A,A01,092681,Staff,1,25,100,99
1650491849240,COGS 14B,A01,083073,Cheng; Tzu-Han,0,11,50,50
1650491855269,COGS 17,A01,092677,Staff,21,0,75,54
1650491861298,COGS 100,A01,083619,Staff,0,26,60,60
1650491867331,COGS 101A,A01,083621,Davis; Joshua Daniel,0,23,60,60
1650491873354,COGS 101B,A01,091572,Staff,0,4,60,60
1650491879378,COGS 101C,A01,083625,Delgado; Tania,16,0,30,14
1650491885406,COGS 107A,A01,083627,Boyle; Mary E. T.,0,11,60,60
1650491891440,COGS 118A,A01,083075,Staff,0,3,60,60
1650491897487,CSE 3,A50,083646,Miranda; Gregory Joseph,20,0,38,18
1650491897487,CSE 3,A51,083647,Miranda; Gregory Joseph,36,0,37,1
1650491903517,CSE 8A,A50,083650,Miranda; Gregory Joseph,1,28,40,39
1650491909541,CSE 11,A01,083080,Cao; Yingjun,0,92,40,40
1650491915565,CSE 12,A01,083652,Staff,0,17,100,100
1650491921591,CSE 15L,A01,083654,Staff,0,1,50,50
1650491921591,CSE 15L,A02,083655,Staff,0,0,50,50
1650491927615,CSE 20,A01,083657,Staff,51,0,80,29
1650491933648,CSE 30,A01,083084,Eldon; John,0,77,40,40
1650491939694,CSE 100,A01,083659,Cao; Yingjun,0,67,50,50
1650491945718,CSE 134B,A01,083661,Powell; Thomas Allan,0,31,65,65
1650491951749,CSE 140,A01,083663,Staff,0,5,75,75
1650491957773,CSE 140L,A01,083088,Eldon; John,0,9,75,75
1650491963797,CSE 175,A01,083665,Kumar; Rakesh,7,0,25,18
1650491969824,CSE 190,A00,092507,Dubnov; Shlomo,10,0,20,10
1650491975846,ECE 45,A01,083139,Staff,20,19,60,40
1650491981872,ECE 65,A50,083695,Staff,0,6,30,30
1650491987901,ECE 109,A01,091882,Touri; Behrouz,38,0,70,32
1650491993927,ECE 180,A00,083140,Abi Samra; Nicholas Camill,22,0,30,8
1650491993927,ECE 180,B00,083141,Abi Samra; Nicholas Camill,0,0,30,30
1650491999950,MATH 10A,A01,083735,Patchell; Gregory David,5,0,30,25
1650491999950,MATH 10A,A02,083736,Patchell; Gregory David,27,0,30,3
1650491999950,MATH 10A,A03,083737,Patchell; Gregory David,25,0,30,5
1650492005973,MATH 10B,A01,083207,Staff,0,8,30,30
1650492005973,MATH 10B,A02,083208,Staff,0,7,30,30
1650492005973,MATH 10B,B01,083739,Staff,13,0,30,17
1650492005973,MATH 10B,B02,083740,Staff,28,0,30,2
1650492012006,MATH 18,A01,083743,Staff,0,0,30,30
1650492012006,MATH 18,A02,083744,Staff,27,0,30,3
1650492012006,MATH 18,A03,083745,Staff,22,0,30,8
1650492012006,MATH 18,A04,083746,Staff,26,0,30,4
1650492012006,MATH 18,B01,083748,Staff,0,11,30,30
1650492012006,MATH 18,B02,083749,Staff,0,12,30,30
1650492012006,MATH 18,B03,083750,Staff,0,11,30,30
1650492012006,MATH 18,B04,083751,Staff,0,12,30,30
1650492018035,MATH 20A,A01,083754,Staff,25,0,40,15
1650492024060,MATH 20B,A01,083756,Staff,0,11,30,30
1650492024060,MATH 20B,A02,083757,Staff,0,11,30,30
1650492030087,MATH 20C,A01,083760,Staff,0,16,30,30
1650492030087,MATH 20C,A02,083761,Staff,2,15,30,28
1650492030087,MATH 20C,B01,083762,Staff,13,0,30,17
1650492030087,MATH 20C,B02,083763,Staff,28,0,30,2
1650492036111,MATH 20D,A01,083765,Staff,0,1,30,30
1650492036111,MATH 20D,A02,083766,Staff,9,0,30,21
1650492036111,MATH 20D,A03,083767,Staff,25,0,30,5
1650492042140,MATH 20E,A01,083771,Staff,6,0,30,24
1650492042140,MATH 20E,A02,083772,Staff,18,0,30,12
1650492042140,MATH 20E,B01,083773,Staff,0,0,30,30
1650492042140,MATH 20E,B02,083774,Staff,10,0,30,20
1650492048178,MATH 103A,A01,083777,Staff,0,12,30,30
1650492048178,MATH 103A,A02,083778,Staff,0,12,30,30
1650492048178,MATH 103A,B01,083779,Staff,0,13,30,30
1650492048178,MATH 103A,B02,083780,Staff,0,13,30,30
1650492054203,MATH 105,A01,085443,Staff,0,23,30,30
1650492060228,MATH 109,A01,083213,Anzaldo; Leesa B,0,7,30,30
1650492060228,MATH 109,A02,083214,Anzaldo; Leesa B,0,7,30,30
1650492060228,MATH 109,B01,083215,Anzaldo; Leesa B,0,5,30,30
1650492060228,MATH 109,B02,083216,Anzaldo; Leesa B,0,6,30,30
1650492066251,MATH 142A,A01,083219,Chow; Bennett,0,15,30,30
1650492066251,MATH 142A,A02,083220,Chow; Bennett,0,13,30,30
1650492066251,MATH 142A,B01,083221,Chow; Bennett,0,12,30,30
1650492066251,MATH 142A,B02,083222,Chow; Bennett,0,13,30,30
1650492072287,MATH 193A,A01,083224,Staff,0,5,30,30
1650492072287,MATH 193A,A02,083225,Staff,0,5,30,30
1650492072287,MATH 193A,A03,083781,Staff,0,5,30,30
1650492072287,MATH 193A,A04,083782,Staff,0,6,30,30
1650492078315,MATH 197,001,091859,McAuley; Julian John,9998,0,9999,1
1650492084372,COGS 9,A01,083615,Staff,0,14,60,60
1650492090399,COGS 11,A01,083617,Boyle; Mary E. T.,20,0,40,20
1650492096431,COGS 13,A01,083071,Staff,0,34,40,40
1650492102454,COGS 14A,A01,092681,Staff,1,25,100,99
1650492108479,COGS 14B,A01,083073,Cheng; Tzu-Han,0,11,50,50
1650492114502,COGS 17,A01,092677,Staff,21,0,75,54
1650492120540,COGS 100,A01,083619,Staff,0,26,60,60
1650492126567,COGS 101A,A01,083621,Davis; Joshua Daniel,0,23,60,60
1650492132597,COGS 101B,A01,091572,Staff,0,4,60,60
1650492138623,COGS 101C,A01,083625,Delgado; Tania,16,0,30,14
1650492144649,COGS 107A,A01,083627,Boyle; Mary E. T.,0,11,60,60
1650492150672,COGS 118A,A01,083075,Staff,0,3,60,60
1650492156703,CSE 3,A50,083646,Miranda; Gregory Joseph,20,0,38,18
1650492156703,CSE 3,A51,083647,Miranda; Gregory Joseph,36,0,37,1
1650492162728,CSE 8A,A50,083650,Miranda; Gregory Joseph,1,28,40,39
1650492168763,CSE 11,A01,083080,Cao; Yingjun,0,92,40,40
1650492174795,CSE 12,A01,083652,Staff,0,17,100,100
1650492180820,CSE 15L,A01,083654,Staff,0,1,50,50
1650492180820,CSE 15L,A02,083655,Staff,0,0,50,50
1650492186846,CSE 20,A01,083657,Staff,51,0,80,29
1650492192875,CSE 30,A01,083084,Eldon; John,0,77,40,40
1650492198897,CSE 100,A01,083659,Cao; Yingjun,0,67,50,50
1650492204921,CSE 134B,A01,083661,Powell; Thomas Allan,0,31,65,65
1650492210945,CSE 140,A01,083663,Staff,0,5,75,75
1650492216967,CSE 140L,A01,083088,Eldon; John,0,9,75,75
1650492222994,CSE 175,A01,083665,Kumar; Rakesh,7,0,25,18
1650492229020,CSE 190,A00,092507,Dubnov; Shlomo,10,0,20,10
1650492235047,ECE 45,A01,083139,Staff,20,19,60,40
1650492241071,ECE 65,A50,083695,Staff,0,6,30,30
1650492247098,ECE 109,A01,091882,Touri; Behrouz,38,0,70,32
1650492253125,ECE 180,A00,083140,Abi Samra; Nicholas Camill,22,0,30,8
1650492253125,ECE 180,B00,083141,Abi Samra; Nicholas Camill,0,0,30,30
1650492259152,MATH 10A,A01,083735,Patchell; Gregory David,5,0,30,25
1650492259152,MATH 10A,A02,083736,Patchell; Gregory David,27,0,30,3
1650492259152,MATH 10A,A03,083737,Patchell; Gregory David,25,0,30,5
1650492265176,MATH 10B,A01,083207,Staff,0,8,30,30
1650492265176,MATH 10B,A02,083208,Staff,0,7,30,30
1650492265176,MATH 10B,B01,083739,Staff,13,0,30,17
1650492265176,MATH 10B,B02,083740,Staff,28,0,30,2
1650492271205,MATH 18,A01,083743,Staff,0,0,30,30
1650492271205,MATH 18,A02,083744,Staff,27,0,30,3
1650492271205,MATH 18,A03,083745,Staff,22,0,30,8
1650492271205,MATH 18,A04,083746,Staff,26,0,30,4
1650492271205,MATH 18,B01,083748,Staff,0,11,30,30
1650492271205,MATH 18,B02,083749,Staff,0,12,30,30
1650492271205,MATH 18,B03,083750,Staff,0,11,30,30
1650492271205,MATH 18,B04,083751,Staff,0,12,30,30
1650492277231,MATH 20A,A01,083754,Staff,25,0,40,15
1650492283263,MATH 20B,A01,083756,Staff,0,11,30,30
1650492283263,MATH 20B,A02,083757,Staff,0,11,30,30
1650492289290,MATH 20C,A01,083760,Staff,0,16,30,30
1650492289290,MATH 20C,A02,083761,Staff,2,15,30,28
1650492289290,MATH 20C,B01,083762,Staff,13,0,30,17
1650492289290,MATH 20C,B02,083763,Staff,28,0,30,2
1650492295320,MATH 20D,A01,083765,Staff,0,1,30,30
1650492295320,MATH 20D,A02,083766,Staff,9,0,30,21
1650492295320,MATH 20D,A03,083767,Staff,25,0,30,5
1650492301344,MATH 20E,A01,083771,Staff,6,0,30,24
1650492301344,MATH 20E,A02,083772,Staff,18,0,30,12
1650492301344,MATH 20E,B01,083773,Staff,0,0,30,30
1650492301344,MATH 20E,B02,083774,Staff,10,0,30,20
1650492307374,MATH 103A,A01,083777,Staff,0,12,30,30
1650492307374,MATH 103A,A02,083778,Staff,0,12,30,30
1650492307374,MATH 103A,B01,083779,Staff,0,13,30,30
1650492307374,MATH 103A,B02,083780,Staff,0,13,30,30
1650492313399,MATH 105,A01,085443,Staff,0,23,30,30
1650492319422,MATH 109,A01,083213,Anzaldo; Leesa B,0,7,30,30
1650492319422,MATH 109,A02,083214,Anzaldo; Leesa B,0,7,30,30
1650492319422,MATH 109,B01,083215,Anzaldo; Leesa B,0,5,30,30
1650492319422,MATH 109,B02,083216,Anzaldo; Leesa B,0,6,30,30
1650492325451,MATH 142A,A01,083219,Chow; Bennett,0,15,30,30
1650492325451,MATH 142A,A02,083220,Chow; Bennett,0,13,30,30
1650492325451,MATH 142A,B01,083221,Chow; Bennett,0,12,30,30
1650492325451,MATH 142A,B02,083222,Chow; Bennett,0,13,30,30
1650492331487,MATH 193A,A01,083224,Staff,0,5,30,30
1650492331487,MATH 193A,A02,083225,Staff,0,5,30,30
1650492331487,MATH 193A,A03,083781,Staff,0,5,30,30
1650492331487,MATH 193A,A04,083782,Staff,0,6,30,30
1650492337510,MATH 197,001,091859,McAuley; Julian John,9998,0,9999,1
1650492343567,COGS 9,A01,083615,Staff,0,14,60,60
1650492349603,COGS 11,A01,083617,Boyle; Mary E. T.,20,0,40,20
1650492355626,COGS 13,A01,083071,Staff,0,34,40,40
1650492361665,COGS 14A,A01,092681,Staff,1,25,100,99
1650492367696,COGS 14B,A01,083073,Cheng; Tzu-Han,0,11,50,50
1650492373812,COGS 17,A01,092677,Staff,21,0,75,54
1650492379835,COGS 100,A01,083619,Staff,0,26,60,60
1650492385870,COGS 101A,A01,083621,Davis; Joshua Daniel,0,23,60,60
1650492391898,COGS 101B,A01,091572,Staff,0,4,60,60
1650492397921,COGS 101C,A01,083625,Delgado; Tania,16,0,30,14
1650492403944,COGS 107A,A01,083627,Boyle; Mary E. T.,0,11,60,60
1650492409970,COGS 118A,A01,083075,Staff,0,3,60,60
1650492415993,CSE 3,A50,083646,Miranda; Gregory Joseph,20,0,38,18
1650492415993,CSE 3,A51,083647,Miranda; Gregory Joseph,36,0,37,1
1650492422028,CSE 8A,A50,083650,Miranda; Gregory Joseph,1,28,40,39
1650492428065,CSE 11,A01,083080,Cao; Yingjun,0,92,40,40
1650492434105,CSE 12,A01,083652,Staff,0,17,100,100
1650492440134,CSE 15L,A01,083654,Staff,0,1,50,50
1650492440134,CSE 15L,A02,083655,Staff,0,0,50,50
1650492446157,CSE 20,A01,083657,Staff,51,0,80,29
1650492452180,CSE 30,A01,083084,Eldon; John,0,77,40,40
1650492458212,CSE 100,A01,083659,Cao; Yingjun,0,67,50,50
1650492464243,CSE 134B,A01,083661,Powell; Thomas Allan,0,31,65,65
1650492470264,CSE 140,A01,083663,Staff,0,5,75,75
1650492476288,CSE 140L,A01,083088,Eldon; John,0,9,75,75
1650492482314,CSE 175,A01,083665,Kumar; Rakesh,7,0,25,18
1650492488339,CSE 190,A00,092507,Dubnov; Shlomo,10,0,20,10
1650492494369,ECE 45,A01,083139,Staff,20,19,60,40
1650492500413,ECE 65,A50,083695,Staff,0,6,30,30
1650492506438,ECE 109,A01,091882,Touri; Behrouz,38,0,70,32
1650492512470,ECE 180,A00,083140,Abi Samra; Nicholas Camill,22,0,30,8
1650492512470,ECE 180,B00,083141,Abi Samra; Nicholas Camill,0,0,30,30
1650492518496,MATH 10A,A01,083735,Patchell; Gregory David,5,0,30,25
1650492518496,MATH 10A,A02,083736,Patchell; Gregory David,27,0,30,3
1650492518496,MATH 10A,A03,083737,Patchell; Gregory David,25,0,30,5
1650492524535,MATH 10B,A01,083207,Staff,0,8,30,30
1650492524535,MATH 10B,A02,083208,Staff,0,7,30,30
1650492524535,MATH 10B,B01,083739,Staff,13,0,30,17
1650492524535,MATH 10B,B02,083740,Staff,28,0,30,2
1650492530567,MATH 18,A01,083743,Staff,0,0,30,30
1650492530567,MATH 18,A02,083744,Staff,27,0,30,3
1650492530567,MATH 18,A03,083745,Staff,22,0,30,8
1650492530567,MATH 18,A04,083746,Staff,26,0,30,4
1650492530567,MATH 18,B01,083748,Staff,0,11,30,30
1650492530567,MATH 18,B02,083749,Staff,0,12,30,30
1650492530567,MATH 18,B03,083750,Staff,0,11,30,30
1650492530567,MATH 18,B04,083751,Staff,0,12,30,30
1650492536590,MATH 20A,A01,083754,Staff,25,0,40,15
1650492542629,MATH 20B,A01,083756,Staff,0,11,30,30
1650492542629,MATH 20B,A02,083757,Staff,0,11,30,30
1650492548655,MATH 20C,A01,083760,Staff,0,16,30,30
1650492548655,MATH 20C,A02,083761,Staff,2,15,30,28
1650492548655,MATH 20C,B01,083762,Staff,13,0,30,17
1650492548655,MATH 20C,B02,083763,Staff,28,0,30,2
1650492554679,MATH 20D,A01,083765,Staff,0,1,30,30
1650492554679,MATH 20D,A02,083766,Staff,9,0,30,21
1650492554679,MATH 20D,A03,083767,Staff,25,0,30,5
1650492560704,MATH 20E,A01,083771,Staff,6,0,30,24
1650492560704,MATH 20E,A02,083772,Staff,18,0,30,12
1650492560704,MATH 20E,B01,083773,Staff,0,0,30,30
1650492560704,MATH 20E,B02,083774,Staff,10,0,30,20
1650492566739,MATH 103A,A01,083777,Staff,0,12,30,30
1650492566739,MATH 103A,A02,083778,Staff,0,12,30,30
1650492566739,MATH 103A,B01,083779,Staff,0,13,30,30
1650492566739,MATH 103A,B02,083780,Staff,0,13,30,30
1650492572774,MATH 105,A01,085443,Staff,0,23,30,30
1650492578802,MATH 109,A01,083213,Anzaldo; Leesa B,0,7,30,30
1650492578802,MATH 109,A02,083214,Anzaldo; Leesa B,0,7,30,30
1650492578802,MATH 109,B01,083215,Anzaldo; Leesa B,0,5,30,30
1650492578802,MATH 109,B02,083216,Anzaldo; Leesa B,0,6,30,30
1650492584838,MATH 142A,A01,083219,Chow; Bennett,0,15,30,30
1650492584838,MATH 142A,A02,083220,Chow; Bennett,0,13,30,30
1650492584838,MATH 142A,B01,083221,Chow; Bennett,0,12,30,30
1650492584838,MATH 142A,B02,083222,Chow; Bennett,0,13,30,30
1650492590884,MATH 193A,A01,083224,Staff,0,5,30,30
1650492590884,MATH 193A,A02,083225,Staff,0,5,30,30
1650492590884,MATH 193A,A03,083781,Staff,0,5,30,30
1650492590884,MATH 193A,A04,083782,Staff,0,6,30,30
1650492596918,MATH 197,001,091859,McAuley; Julian John,9998,0,9999,1
1650492602972,COGS 9,A01,083615,Staff,0,14,60,60
1650492608999,COGS 11,A01,083617,Boyle; Mary E. T.,20,0,40,20
1650492615034,COGS 13,A01,083071,Staff,0,34,40,40
1650492621058,COGS 14A,A01,092681,Staff,1,25,100,99
1650492627083,COGS 14B,A01,083073,Cheng; Tzu-Han,0,11,50,50
1650492633110,COGS 17,A01,092677,Staff,21,0,75,54
1650492639132,COGS 100,A01,083619,Staff,0,26,60,60
1650492645160,COGS 101A,A01,083621,Davis; Joshua Daniel,0,23,60,60
1650492651191,COGS 101B,A01,091572,Staff,0,4,60,60
1650492657219,COGS 101C,A01,083625,Delgado; Tania,16,0,30,14
1650492663246,COGS 107A,A01,083627,Boyle; Mary E. T.,0,11,60,60
1650492669270,COGS 118A,A01,083075,Staff,0,3,60,60
1650492675312,CSE 3,A50,083646,Miranda; Gregory Joseph,20,0,38,18
1650492675312,CSE 3,A51,083647,Miranda; Gregory Joseph,36,0,37,1
1650492681346,CSE 8A,A50,083650,Miranda; Gregory Joseph,1,28,40,39
1650492687381,CSE 11,A01,083080,Cao; Yingjun,0,92,40,40
1650492693404,CSE 12,A01,083652,Staff,0,17,100,100
1650492699426,CSE 15L,A01,083654,Staff,0,1,50,50
1650492699426,CSE 15L,A02,083655,Staff,0,0,50,50
1650492705453,CSE 20,A01,083657,Staff,51,0,80,29
1650492711478,CSE 30,A01,083084,Eldon; John,0,77,40,40
1650492717500,CSE 100,A01,083659,Cao; Yingjun,0,67,50,50
1650492723524,CSE 134B,A01,083661,Powell; Thomas Allan,0,31,65,65
1650492729549,CSE 140,A01,083663,Staff,0,5,75,75
1650492735572,CSE 140L,A01,083088,Eldon; John,0,9,75,75
1650492741595,CSE 175,A01,083665,Kumar; Rakesh,7,0,25,18
1650492747617,CSE 190,A00,092507,Dubnov; Shlomo,10,0,20,10
1650492753639,ECE 45,A01,083139,Staff,20,19,60,40
1650492759663,ECE 65,A50,083695,Staff,0,6,30,30
1650492765689,ECE 109,A01,091882,Touri; Behrouz,38,0,70,32
1650492771713,ECE 180,A00,083140,Abi Samra; Nicholas Camill,22,0,30,8
1650492771713,ECE 180,B00,083141,Abi Samra; Nicholas Camill,0,0,30,30
1650492777737,MATH 10A,A01,083735,Patchell; Gregory David,5,0,30,25
1650492777737,MATH 10A,A02,083736,Patchell; Gregory David,27,0,30,3
1650492777737,MATH 10A,A03,083737,Patchell; Gregory David,25,0,30,5
1650492783760,MATH 10B,A01,083207,Staff,0,8,30,30
1650492783760,MATH 10B,A02,083208,Staff,0,7,30,30
1650492783760,MATH 10B,B01,083739,Staff,13,0,30,17
1650492783760,MATH 10B,B02,083740,Staff,28,0,30,2
1650492789792,MATH 18,A01,083743,Staff,0,0,30,30
1650492789792,MATH 18,A02,083744,Staff,27,0,30,3
1650492789792,MATH 18,A03,083745,Staff,22,0,30,8
1650492789792,MATH 18,A04,083746,Staff,26,0,30,4
1650492789792,MATH 18,B01,083748,Staff,0,11,30,30
1650492789792,MATH 18,B02,083749,Staff,0,12,30,30
1650492789792,MATH 18,B03,083750,Staff,0,11,30,30
1650492789792,MATH 18,B04,083751,Staff,0,12,30,30
1650492795818,MATH 20A,A01,083754,Staff,25,0,40,15
1650492801841,MATH 20B,A01,083756,Staff,0,11,30,30
1650492801841,MATH 20B,A02,083757,Staff,0,11,30,30
1650492807877,MATH 20C,A01,083760,Staff,0,16,30,30
1650492807877,MATH 20C,A02,083761,Staff,2,15,30,28
1650492807877,MATH 20C,B01,083762,Staff,13,0,30,17
1650492807877,MATH 20C,B02,083763,Staff,28,0,30,2
1650492813901,MATH 20D,A01,083765,Staff,0,1,30,30
1650492813901,MATH 20D,A02,083766,Staff,9,0,30,21
1650492813901,MATH 20D,A03,083767,Staff,25,0,30,5
1650492819925,MATH 20E,A01,083771,Staff,6,0,30,24
1650492819925,MATH 20E,A02,083772,Staff,18,0,30,12
1650492819925,MATH 20E,B01,083773,Staff,0,0,30,30
1650492819925,MATH 20E,B02,083774,Staff,10,0,30,20
1650492825950,MATH 103A,A01,083777,Staff,0,12,30,30
1650492825950,MATH 103A,A02,083778,Staff,0,12,30,30
1650492825950,MATH 103A,B01,083779,Staff,0,13,30,30
1650492825950,MATH 103A,B02,083780,Staff,0,13,30,30
1650492831977,MATH 105,A01,085443,Staff,0,23,30,30
1650492838001,MATH 109,A01,083213,Anzaldo; Leesa B,0,7,30,30
1650492838001,MATH 109,A02,083214,Anzaldo; Leesa B,0,7,30,30
1650492838001,MATH 109,B01,083215,Anzaldo; Leesa B,0,5,30,30
1650492838001,MATH 109,B02,083216,Anzaldo; Leesa B,0,6,30,30
1650492844033,MATH 142A,A01,083219,Chow; Bennett,0,15,30,30
1650492844033,MATH 142A,A02,083220,Chow; Bennett,0,13,30,30
1650492844033,MATH 142A,B01,083221,Chow; Bennett,0,12,30,30
1650492844033,MATH 142A,B02,083222,Chow; Bennett,0,13,30,30
1650492850061,MATH 193A,A01,083224,Staff,0,5,30,30
1650492850061,MATH 193A,A02,083225,Staff,0,5,30,30
1650492850061,MATH 193A,A03,083781,Staff,0,5,30,30
1650492850061,MATH 193A,A04,083782,Staff,0,6,30,30
1650492856083,MATH 197,001,091859,McAuley; Julian John,9998,0,9999,1
1650492862143,COGS 9,A01,083615,Staff,0,14,60,60
1650492868174,COGS 11,A01,083617,Boyle; Mary E. T.,20,0,40,20
1650492874207,COGS 13,A01,083071,Staff,0,34,40,40
1650492880245,COGS 14A,A01,092681,Staff,1,25,100,99
1650492886269,COGS 14B,A01,083073,Cheng; Tzu-Han,0,11,50,50
1650492892298,COGS 17,A01,092677,Staff,20,0,75,55
1650492898321,COGS 100,A01,083619,Staff,0,26,60,60
1650492904349,COGS 101A,A01,083621,Davis; Joshua Daniel,0,23,60,60
1650492910375,COGS 101B,A01,091572,Staff,0,4,60,60
1650492916407,COGS 101C,A01,083625,Delgado; Tania,16,0,30,14
1650492922430,COGS 107A,A01,083627,Boyle; Mary E. T.,0,11,60,60
1650492928456,COGS 118A,A01,083075,Staff,0,3,60,60
1650492934486,CSE 3,A50,083646,Miranda; Gregory Joseph,20,0,38,18
1650492934486,CSE 3,A51,083647,Miranda; Gregory Joseph,36,0,37,1
1650492940511,CSE 8A,A50,083650,Miranda; Gregory Joseph,1,28,40,39
1650492946539,CSE 11,A01,083080,Cao; Yingjun,0,91,40,40
1650492952562,CSE 12,A01,083652,Staff,0,17,100,100
1650492958585,CSE 15L,A01,083654,Staff,0,1,50,50
1650492958585,CSE 15L,A02,083655,Staff,0,0,50,50
1650492964611,CSE 20,A01,083657,Staff,51,0,80,29
1650492970736,CSE 30,A01,083084,Eldon; John,0,77,40,40
1650492976769,CSE 100,A01,083659,Cao; Yingjun,0,67,50,50
1650492982803,CSE 134B,A01,083661,Powell; Thomas Allan,0,31,65,65
1650492988830,CSE 140,A01,083663,Staff,0,5,75,75
1650492994854,CSE 140L,A01,083088,Eldon; John,0,9,75,75
1650493000879,CSE 175,A01,083665,Kumar; Rakesh,7,0,25,18
1650493006906,CSE 190,A00,092507,Dubnov; Shlomo,10,0,20,10
1650493012932,ECE 45,A01,083139,Staff,20,19,60,40
1650493018958,ECE 65,A50,083695,Staff,0,6,30,30
1650493024982,ECE 109,A01,091882,Touri; Behrouz,38,0,70,32
1650493031012,ECE 180,A00,083140,Abi Samra; Nicholas Camill,22,0,30,8
1650493031012,ECE 180,B00,083141,Abi Samra; Nicholas Camill,0,0,30,30
1650493037036,MATH 10A,A01,083735,Patchell; Gregory David,5,0,30,25
1650493037036,MATH 10A,A02,083736,Patchell; Gregory David,27,0,30,3
1650493037036,MATH 10A,A03,083737,Patchell; Gregory David,25,0,30,5
1650493043061,MATH 10B,A01,083207,Staff,0,8,30,30
1650493043061,MATH 10B,A02,083208,Staff,0,7,30,30
1650493043061,MATH 10B,B01,083739,Staff,13,0,30,17
1650493043061,MATH 10B,B02,083740,Staff,28,0,30,2
1650493049090,MATH 18,A01,083743,Staff,0,0,30,30
1650493049090,MATH 18,A02,083744,Staff,27,0,30,3
1650493049090,MATH 18,A03,083745,Staff,22,0,30,8
1650493049090,MATH 18,A04,083746,Staff,26,0,30,4
1650493049090,MATH 18,B01,083748,Staff,0,11,30,30
1650493049090,MATH 18,B02,083749,Staff,0,12,30,30
1650493049090,MATH 18,B03,083750,Staff,0,11,30,30
1650493049090,MATH 18,B04,083751,Staff,0,12,30,30
1650493055117,MATH 20A,A01,083754,Staff,25,0,40,15
1650493061140,MATH 20B,A01,083756,Staff,0,11,30,30
1650493061140,MATH 20B,A02,083757,Staff,0,11,30,30
1650493067166,MATH 20C,A01,083760,Staff,0,16,30,30
1650493067166,MATH 20C,A02,083761,Staff,2,15,30,28
1650493067166,MATH 20C,B01,083762,Staff,13,0,30,17
1650493067166,MATH 20C,B02,083763,Staff,28,0,30,2
1650493073193,MATH 20D,A01,083765,Staff,0,1,30,30
1650493073193,MATH 20D,A02,083766,Staff,9,0,30,21
1650493073193,MATH 20D,A03,083767,Staff,25,0,30,5
1650493079227,MATH 20E,A01,083771,Staff,6,0,30,24
1650493079227,MATH 20E,A02,083772,Staff,18,0,30,12
1650493079227,MATH 20E,B01,083773,Staff,0,0,30,30
1650493079227,MATH 20E,B02,083774,Staff,10,0,30,20
1650493085255,MATH 103A,A01,083777,Staff,0,12,30,30
1650493085255,MATH 103A,A02,083778,Staff,0,12,30,30
1650493085255,MATH 103A,B01,083779,Staff,0,13,30,30
1650493085255,MATH 103A,B02,083780,Staff,0,13,30,30
1650493091281,MATH 105,A01,085443,Staff,0,23,30,30
1650493097308,MATH 109,A01,083213,Anzaldo; Leesa B,0,7,30,30
1650493097308,MATH 109,A02,083214,Anzaldo; Leesa B,0,7,30,30
1650493097308,MATH 109,B01,083215,Anzaldo; Leesa B,0,5,30,30
1650493097308,MATH 109,B02,083216,Anzaldo; Leesa B,0,6,30,30
1650493103336,MATH 142A,A01,083219,Chow; Bennett,0,15,30,30
1650493103336,MATH 142A,A02,083220,Chow; Bennett,0,13,30,30
1650493103336,MATH 142A,B01,083221,Chow; Bennett,0,12,30,30
1650493103336,MATH 142A,B02,083222,Chow; Bennett,0,13,30,30
1650493109361,MATH 193A,A01,083224,Staff,0,5,30,30
1650493109361,MATH 193A,A02,083225,Staff,0,5,30,30
1650493109361,MATH 193A,A03,083781,Staff,0,5,30,30
1650493109361,MATH 193A,A04,083782,Staff,0,6,30,30
1650493115393,MATH 197,001,091859,McAuley; Julian John,9998,0,9999,1
1650493121445,COGS 9,A01,083615,Staff,0,14,60,60
1650493127481,COGS 11,A01,083617,Boyle; Mary E. T.,20,0,40,20
1650493133524,COGS 13,A01,083071,Staff,0,34,40,40
1650493139555,COGS 14A,A01,092681,Staff,1,25,100,99
1650493145579,COGS 14B,A01,083073,Cheng; Tzu-Han,0,11,50,50
1650493151606,COGS 17,A01,092677,Staff,20,0,75,55
1650493157630,COGS 100,A01,083619,Staff,0,26,60,60
1650493163673,COGS 101A,A01,083621,Davis; Joshua Daniel,0,23,60,60
1650493169697,COGS 101B,A01,091572,Staff,0,4,60,60
1650493175728,COGS 101C,A01,083625,Delgado; Tania,16,0,30,14
1650493181754,COGS 107A,A01,083627,Boyle; Mary E. T.,0,11,60,60
1650493187778,COGS 118A,A01,083075,Staff,0,3,60,60
1650493193803,CSE 3,A50,083646,Miranda; Gregory Joseph,20,0,38,18
1650493193803,CSE 3,A51,083647,Miranda; Gregory Joseph,36,0,37,1
1650493199827,CSE 8A,A50,083650,Miranda; Gregory Joseph,1,28,40,39
1650493205857,CSE 11,A01,083080,Cao; Yingjun,0,91,40,40
1650493211883,CSE 12,A01,083652,Staff,0,17,100,100
1650493217909,CSE 15L,A01,083654,Staff,0,1,50,50
1650493217909,CSE 15L,A02,083655,Staff,0,0,50,50
1650493223933,CSE 20,A01,083657,Staff,51,0,80,29
1650493229955,CSE 30,A01,083084,Eldon; John,0,77,40,40
1650493235980,CSE 100,A01,083659,Cao; Yingjun,0,67,50,50
1650493242004,CSE 134B,A01,083661,Powell; Thomas Allan,0,31,65,65
1650493248029,CSE 140,A01,083663,Staff,0,5,75,75
1650493254052,CSE 140L,A01,083088,Eldon; John,0,9,75,75
1650493260074,CSE 175,A01,083665,Kumar; Rakesh,7,0,25,18
1650493266101,CSE 190,A00,092507,Dubnov; Shlomo,10,0,20,10
1650493272124,ECE 45,A01,083139,Staff,20,19,60,40
1650493278150,ECE 65,A50,083695,Staff,0,6,30,30
1650493284176,ECE 109,A01,091882,Touri; Behrouz,38,0,70,32
1650493290200,ECE 180,A00,083140,Abi Samra; Nicholas Camill,22,0,30,8
1650493290200,ECE 180,B00,083141,Abi Samra; Nicholas Camill,0,0,30,30
1650493296223,MATH 10A,A01,083735,Patchell; Gregory David,5,0,30,25
1650493296223,MATH 10A,A02,083736,Patchell; Gregory David,27,0,30,3
1650493296223,MATH 10A,A03,083737,Patchell; Gregory David,25,0,30,5
1650493302253,MATH 10B,A01,083207,Staff,0,8,30,30
1650493302253,MATH 10B,A02,083208,Staff,0,7,30,30
1650493302253,MATH 10B,B01,083739,Staff,13,0,30,17
1650493302253,MATH 10B,B02,083740,Staff,28,0,30,2
1650493308278,MATH 18,A01,083743,Staff,0,0,30,30
1650493308278,MATH 18,A02,083744,Staff,27,0,30,3
1650493308278,MATH 18,A03,083745,Staff,22,0,30,8
1650493308278,MATH 18,A04,083746,Staff,26,0,30,4
1650493308278,MATH 18,B01,083748,Staff,0,11,30,30
1650493308278,MATH 18,B02,083749,Staff,0,12,30,30
1650493308278,MATH 18,B03,083750,Staff,0,11,30,30
1650493308278,MATH 18,B04,083751,Staff,0,12,30,30
1650493314302,MATH 20A,A01,083754,Staff,25,0,40,15
1650493320331,MATH 20B,A01,083756,Staff,0,11,30,30
1650493320331,MATH 20B,A02,083757,Staff,0,11,30,30
1650493326356,MATH 20C,A01,083760,Staff,0,16,30,30
1650493326356,MATH 20C,A02,083761,Staff,2,15,30,28
1650493326356,MATH 20C,B01,083762,Staff,13,0,30,17
1650493326356,MATH 20C,B02,083763,Staff,28,0,30,2
1650493332380,MATH 20D,A01,083765,Staff,0,1,30,30
1650493332380,MATH 20D,A02,083766,Staff,9,0,30,21
1650493332380,MATH 20D,A03,083767,Staff,25,0,30,5
1650493338410,MATH 20E,A01,083771,Staff,6,0,30,24
1650493338410,MATH 20E,A02,083772,Staff,18,0,30,12
1650493338410,MATH 20E,B01,083773,Staff,0,0,30,30
1650493338410,MATH 20E,B02,083774,Staff,10,0,30,20
1650493344433,MATH 103A,A01,083777,Staff,0,12,30,30
1650493344433,MATH 103A,A02,083778,Staff,0,12,30,30
1650493344433,MATH 103A,B01,083779,Staff,0,13,30,30
1650493344433,MATH 103A,B02,083780,Staff,0,13,30,30
1650493350473,MATH 105,A01,085443,Staff,0,23,30,30
1650493356500,MATH 109,A01,083213,Anzaldo; Leesa B,0,7,30,30
1650493356500,MATH 109,A02,083214,Anzaldo; Leesa B,0,7,30,30
1650493356500,MATH 109,B01,083215,Anzaldo; Leesa B,0,5,30,30
1650493356500,MATH 109,B02,083216,Anzaldo; Leesa B,0,6,30,30
1650493362529,MATH 142A,A01,083219,Chow; Bennett,0,15,30,30
1650493362529,MATH 142A,A02,083220,Chow; Bennett,0,13,30,30
1650493362529,MATH 142A,B01,083221,Chow; Bennett,0,12,30,30
1650493362529,MATH 142A,B02,083222,Chow; Bennett,0,13,30,30
1650493368557,MATH 193A,A01,083224,Staff,0,5,30,30
1650493368557,MATH 193A,A02,083225,Staff,0,5,30,30
1650493368557,MATH 193A,A03,083781,Staff,0,5,30,30
1650493368557,MATH 193A,A04,083782,Staff,0,6,30,30
1650493374594,MATH 197,001,091859,McAuley; Julian John,9998,0,9999,1
1650493380651,COGS 9,A01,083615,Staff,0,14,60,60
1650493386676,COGS 11,A01,083617,Boyle; Mary E. T.,20,0,40,20
1650493392700,COGS 13,A01,083071,Staff,0,34,40,40
1650493398730,COGS 14A,A01,092681,Staff,1,25,100,99
1650493404755,COGS 14B,A01,083073,Cheng; Tzu-Han,0,11,50,50
1650493410821,COGS 17,A01,092677,Staff,20,0,75,55
1650493416847,COGS 100,A01,083619,Staff,0,26,60,60
1650493422871,COGS 101A,A01,083621,Davis; Joshua Daniel,0,23,60,60
1650493428894,COGS 101B,A01,091572,Staff,0,4,60,60
1650493434918,COGS 101C,A01,083625,Delgado; Tania,16,0,30,14
1650493440947,COGS 107A,A01,083627,Boyle; Mary E. T.,0,11,60,60
1650493446975,COGS 118A,A01,083075,Staff,0,3,60,60
1650493452999,CSE 3,A50,083646,Miranda; Gregory Joseph,20,0,38,18
1650493452999,CSE 3,A51,083647,Miranda; Gregory Joseph,36,0,37,1
1650493459024,CSE 8A,A50,083650,Miranda; Gregory Joseph,1,28,40,39
1650493465054,CSE 11,A01,083080,Cao; Yingjun,0,91,40,40
1650493471088,CSE 12,A01,083652,Staff,0,17,100,100
1650493477112,CSE 15L,A01,083654,Staff,0,1,50,50
1650493477112,CSE 15L,A02,083655,Staff,0,0,50,50
1650493483136,CSE 20,A01,083657,Staff,51,0,80,29
1650493489170,CSE 30,A01,083084,Eldon; John,0,77,40,40
1650493495198,CSE 100,A01,083659,Cao; Yingjun,0,67,50,50
1650493501234,CSE 134B,A01,083661,Powell; Thomas Allan,0,31,65,65
1650493507267,CSE 140,A01,083663,Staff,0,5,75,75
1650493513291,CSE 140L,A01,083088,Eldon; John,0,9,75,75
1650493519317,CSE 175,A01,083665,Kumar; Rakesh,7,0,25,18
1650493525356,CSE 190,A00,092507,Dubnov; Shlomo,10,0,20,10
1650493531380,ECE 45,A01,083139,Staff,20,19,60,40
1650493537406,ECE 65,A50,083695,Staff,0,6,30,30
1650493543433,ECE 109,A01,091882,Touri; Behrouz,38,0,70,32
1650493549462,ECE 180,A00,083140,Abi Samra; Nicholas Camill,21,0,30,9
1650493549462,ECE 180,B00,083141,Abi Samra; Nicholas Camill,0,0,30,30
1650493555490,MATH 10A,A01,083735,Patchell; Gregory David,5,0,30,25
1650493555490,MATH 10A,A02,083736,Patchell; Gregory David,27,0,30,3
1650493555490,MATH 10A,A03,083737,Patchell; Gregory David,25,0,30,5
1650493561554,MATH 10B,A01,083207,Staff,0,8,30,30
1650493561554,MATH 10B,A02,083208,Staff,0,7,30,30
1650493561554,MATH 10B,B01,083739,Staff,13,0,30,17
1650493561554,MATH 10B,B02,083740,Staff,28,0,30,2
1650493567672,MATH 18,A01,083743,Staff,0,0,30,30
1650493567672,MATH 18,A02,083744,Staff,27,0,30,3
1650493567672,MATH 18,A03,083745,Staff,22,0,30,8
1650493567672,MATH 18,A04,083746,Staff,26,0,30,4
1650493567672,MATH 18,B01,083748,Staff,0,11,30,30
1650493567672,MATH 18,B02,083749,Staff,0,12,30,30
1650493567672,MATH 18,B03,083750,Staff,0,11,30,30
1650493567672,MATH 18,B04,083751,Staff,0,12,30,30
1650493573698,MATH 20A,A01,083754,Staff,25,0,40,15
1650493579732,MATH 20B,A01,083756,Staff,0,11,30,30
1650493579732,MATH 20B,A02,083757,Staff,0,11,30,30
1650493585764,MATH 20C,A01,083760,Staff,0,16,30,30
1650493585764,MATH 20C,A02,083761,Staff,2,15,30,28
1650493585764,MATH 20C,B01,083762,Staff,13,0,30,17
1650493585764,MATH 20C,B02,083763,Staff,28,0,30,2
1650493591790,MATH 20D,A01,083765,Staff,0,1,30,30
1650493591790,MATH 20D,A02,083766,Staff,9,0,30,21
1650493591790,MATH 20D,A03,083767,Staff,25,0,30,5
1650493597816,MATH 20E,A01,083771,Staff,6,0,30,24
1650493597816,MATH 20E,A02,083772,Staff,18,0,30,12
1650493597816,MATH 20E,B01,083773,Staff,0,0,30,30
1650493597816,MATH 20E,B02,083774,Staff,10,0,30,20
1650493603842,MATH 103A,A01,083777,Staff,0,12,30,30
1650493603842,MATH 103A,A02,083778,Staff,0,12,30,30
1650493603842,MATH 103A,B01,083779,Staff,0,13,30,30
1650493603842,MATH 103A,B02,083780,Staff,0,13,30,30
1650493609865,MATH 105,A01,085443,Staff,0,23,30,30
1650493615914,MATH 109,A01,083213,Anzaldo; Leesa B,0,7,30,30
1650493615914,MATH 109,A02,083214,Anzaldo; Leesa B,0,7,30,30
1650493615914,MATH 109,B01,083215,Anzaldo; Leesa B,0,5,30,30
1650493615914,MATH 109,B02,083216,Anzaldo; Leesa B,0,6,30,30
1650493621938,MATH 142A,A01,083219,Chow; Bennett,0,15,30,30
1650493621938,MATH 142A,A02,083220,Chow; Bennett,0,13,30,30
1650493621938,MATH 142A,B01,083221,Chow; Bennett,0,12,30,30
1650493621938,MATH 142A,B02,083222,Chow; Bennett,0,13,30,30
1650493627965,MATH 193A,A01,083224,Staff,0,5,30,30
1650493627965,MATH 193A,A02,083225,Staff,0,5,30,30
1650493627965,MATH 193A,A03,083781,Staff,0,5,30,30
1650493627965,MATH 193A,A04,083782,Staff,0,6,30,30
1650493633995,MATH 197,001,091859,McAuley; Julian John,9998,0,9999,1
1650493640054,COGS 9,A01,083615,Staff,0,14,60,60
1650493646102,COGS 11,A01,083617,Boyle; Mary E. T.,20,0,40,20
1650493652127,COGS 13,A01,083071,Staff,0,34,40,40
1650493658162,COGS 14A,A01,092681,Staff,1,25,100,99
1650493664186,COGS 14B,A01,083073,Cheng; Tzu-Han,0,11,50,50
1650493670209,COGS 17,A01,092677,Staff,20,0,75,55
1650493676233,COGS 100,A01,083619,Staff,0,26,60,60
1650493682259,COGS 101A,A01,083621,Davis; Joshua Daniel,0,23,60,60
1650493688289,COGS 101B,A01,091572,Staff,0,4,60,60
1650493694314,COGS 101C,A01,083625,Delgado; Tania,16,0,30,14
1650493700342,COGS 107A,A01,083627,Boyle; Mary E. T.,0,12,60,60
1650493706372,COGS 118A,A01,083075,Staff,0,3,60,60
1650493712409,CSE 3,A50,083646,Miranda; Gregory Joseph,20,0,38,18
1650493712409,CSE 3,A51,083647,Miranda; Gregory Joseph,36,0,37,1
1650493718438,CSE 8A,A50,083650,Miranda; Gregory Joseph,1,28,40,39
1650493724473,CSE 11,A01,083080,Cao; Yingjun,0,91,40,40
1650493730501,CSE 12,A01,083652,Staff,0,17,100,100
1650493736533,CSE 15L,A01,083654,Staff,0,1,50,50
1650493736533,CSE 15L,A02,083655,Staff,0,0,50,50
1650493742555,CSE 20,A01,083657,Staff,51,0,80,29
1650493748591,CSE 30,A01,083084,Eldon; John,0,77,40,40
1650493754615,CSE 100,A01,083659,Cao; Yingjun,0,67,50,50
1650493760637,CSE 134B,A01,083661,Powell; Thomas Allan,0,31,65,65
1650493766660,CSE 140,A01,083663,Staff,0,5,75,75
1650493772682,CSE 140L,A01,083088,Eldon; John,0,9,75,75
1650493778706,CSE 175,A01,083665,Kumar; Rakesh,7,0,25,18
1650493784731,CSE 190,A00,092507,Dubnov; Shlomo,10,0,20,10
1650493790753,ECE 45,A01,083139,Staff,20,19,60,40
1650493796778,ECE 65,A50,083695,Staff,0,6,30,30
1650493802806,ECE 109,A01,091882,Touri; Behrouz,38,0,70,32
1650493808829,ECE 180,A00,083140,Abi Samra; Nicholas Camill,21,0,30,9
1650493808829,ECE 180,B00,083141,Abi Samra; Nicholas Camill,0,0,30,30
1650493814857,MATH 10A,A01,083735,Patchell; Gregory David,5,0,30,25
1650493814857,MATH 10A,A02,083736,Patchell; Gregory David,27,0,30,3
1650493814857,MATH 10A,A03,083737,Patchell; Gregory David,25,0,30,5
1650493820886,MATH 10B,A01,083207,Staff,0,8,30,30
1650493820886,MATH 10B,A02,083208,Staff,0,7,30,30
1650493820886,MATH 10B,B01,083739,Staff,13,0,30,17
1650493820886,MATH 10B,B02,083740,Staff,28,0,30,2
1650493826912,MATH 18,A01,083743,Staff,0,0,30,30
1650493826912,MATH 18,A02,083744,Staff,27,0,30,3
1650493826912,MATH 18,A03,083745,Staff,22,0,30,8
1650493826912,MATH 18,A04,083746,Staff,26,0,30,4
1650493826912,MATH 18,B01,083748,Staff,0,11,30,30
1650493826912,MATH 18,B02,083749,Staff,0,12,30,30
1650493826912,MATH 18,B03,083750,Staff,0,11,30,30
1650493826912,MATH 18,B04,083751,Staff,0,12,30,30
1650493832933,MATH 20A,A01,083754,Staff,25,0,40,15
1650493838962,MATH 20B,A01,083756,Staff,0,11,30,30
1650493838962,MATH 20B,A02,083757,Staff,0,11,30,30
1650493844984,MATH 20C,A01,083760,Staff,0,16,30,30
1650493844984,MATH 20C,A02,083761,Staff,2,15,30,28
1650493844984,MATH 20C,B01,083762,Staff,13,0,30,17
1650493844984,MATH 20C,B02,083763,Staff,28,0,30,2
1650493851012,MATH 20D,A01,083765,Staff,0,1,30,30
1650493851012,MATH 20D,A02,083766,Staff,9,0,30,21
1650493851012,MATH 20D,A03,083767,Staff,25,0,30,5
1650493857044,MATH 20E,A01,083771,Staff,6,0,30,24
1650493857044,MATH 20E,A02,083772,Staff,18,0,30,12
1650493857044,MATH 20E,B01,083773,Staff,0,0,30,30
1650493857044,MATH 20E,B02,083774,Staff,10,0,30,20
1650493863067,MATH 103A,A01,083777,Staff,0,12,30,30
1650493863067,MATH 103A,A02,083778,Staff,0,12,30,30
1650493863067,MATH 103A,B01,083779,Staff,0,13,30,30
1650493863067,MATH 103A,B02,083780,Staff,0,13,30,30
1650493869095,MATH 105,A01,085443,Staff,0,23,30,30
1650493875118,MATH 109,A01,083213,Anzaldo; Leesa B,0,7,30,30
1650493875118,MATH 109,A02,083214,Anzaldo; Leesa B,0,7,30,30
1650493875118,MATH 109,B01,083215,Anzaldo; Leesa B,0,5,30,30
1650493875118,MATH 109,B02,083216,Anzaldo; Leesa B,0,6,30,30
1650493881144,MATH 142A,A01,083219,Chow; Bennett,0,15,30,30
1650493881144,MATH 142A,A02,083220,Chow; Bennett,0,13,30,30
1650493881144,MATH 142A,B01,083221,Chow; Bennett,0,12,30,30
1650493881144,MATH 142A,B02,083222,Chow; Bennett,0,13,30,30
1650493887171,MATH 193A,A01,083224,Staff,0,5,30,30
1650493887171,MATH 193A,A02,083225,Staff,0,5,30,30
1650493887171,MATH 193A,A03,083781,Staff,0,5,30,30
1650493887171,MATH 193A,A04,083782,Staff,0,6,30,30
1650493893194,MATH 197,001,091859,McAuley; Julian John,9998,0,9999,1
1650493899248,COGS 9,A01,083615,Staff,0,14,60,60
1650493905272,COGS 11,A01,083617,Boyle; Mary E. T.,20,0,40,20
1650493911309,COGS 13,A01,083071,Staff,0,34,40,40
1650493917334,COGS 14A,A01,092681,Staff,1,25,100,99
1650493923366,COGS 14B,A01,083073,Cheng; Tzu-Han,0,11,50,50
1650493929388,COGS 17,A01,092677,Staff,20,0,75,55
1650493935416,COGS 100,A01,083619,Staff,0,26,60,60
1650493941442,COGS 101A,A01,083621,Davis; Joshua Daniel,0,23,60,60
1650493947466,COGS 101B,A01,091572,Staff,0,4,60,60
1650493953488,COGS 101C,A01,083625,Delgado; Tania,16,0,30,14
1650493959511,COGS 107A,A01,083627,Boyle; Mary E. T.,0,12,60,60
1650493965542,COGS 118A,A01,083075,Staff,0,3,60,60
1650493971641,CSE 3,A50,083646,Miranda; Gregory Joseph,20,0,38,18
1650493971641,CSE 3,A51,083647,Miranda; Gregory Joseph,36,0,37,1
1650493977669,CSE 8A,A50,083650,Miranda; Gregory Joseph,1,28,40,39
1650493983692,CSE 11,A01,083080,Cao; Yingjun,0,91,40,40
1650493989716,CSE 12,A01,083652,Staff,0,17,100,100
1650493995747,CSE 15L,A01,083654,Staff,0,1,50,50
1650493995747,CSE 15L,A02,083655,Staff,0,0,50,50
1650494001769,CSE 20,A01,083657,Staff,51,0,80,29
1650494007808,CSE 30,A01,083084,Eldon; John,0,77,40,40
1650494013835,CSE 100,A01,083659,Cao; Yingjun,0,67,50,50
1650494019868,CSE 134B,A01,083661,Powell; Thomas Allan,0,31,65,65
1650494025897,CSE 140,A01,083663,Staff,0,5,75,75
1650494031919,CSE 140L,A01,083088,Eldon; John,0,9,75,75
1650494037945,CSE 175,A01,083665,Kumar; Rakesh,7,0,25,18
1650494043979,CSE 190,A00,092507,Dubnov; Shlomo,10,0,20,10
1650494050003,ECE 45,A01,083139,Staff,20,19,60,40
1650494056030,ECE 65,A50,083695,Staff,0,6,30,30
1650494062069,ECE 109,A01,091882,Touri; Behrouz,38,0,70,32
1650494068096,ECE 180,A00,083140,Abi Samra; Nicholas Camill,21,0,30,9
1650494068096,ECE 180,B00,083141,Abi Samra; Nicholas Camill,0,0,30,30
1650494074122,MATH 10A,A01,083735,Patchell; Gregory David,5,0,30,25
1650494074122,MATH 10A,A02,083736,Patchell; Gregory David,27,0,30,3
1650494074122,MATH 10A,A03,083737,Patchell; Gregory David,25,0,30,5
1650494080146,MATH 10B,A01,083207,Staff,0,8,30,30
1650494080146,MATH 10B,A02,083208,Staff,0,7,30,30
1650494080146,MATH 10B,B01,083739,Staff,13,0,30,17
1650494080146,MATH 10B,B02,083740,Staff,28,0,30,2
1650494086170,MATH 18,A01,083743,Staff,0,0,30,30
1650494086170,MATH 18,A02,083744,Staff,27,0,30,3
1650494086170,MATH 18,A03,083745,Staff,22,0,30,8
1650494086170,MATH 18,A04,083746,Staff,26,0,30,4
1650494086170,MATH 18,B01,083748,Staff,0,11,30,30
1650494086170,MATH 18,B02,083749,Staff,0,12,30,30
1650494086170,MATH 18,B03,083750,Staff,0,11,30,30
1650494086170,MATH 18,B04,083751,Staff,0,12,30,30
1650494092206,MATH 20A,A01,083754,Staff,25,0,40,15
1650494098242,MATH 20B,A01,083756,Staff,0,11,30,30
1650494098242,MATH 20B,A02,083757,Staff,0,11,30,30
1650494104269,MATH 20C,A01,083760,Staff,0,16,30,30
1650494104269,MATH 20C,A02,083761,Staff,2,15,30,28
1650494104269,MATH 20C,B01,083762,Staff,13,0,30,17
1650494104269,MATH 20C,B02,083763,Staff,28,0,30,2
1650494110294,MATH 20D,A01,083765,Staff,0,1,30,30
1650494110294,MATH 20D,A02,083766,Staff,9,0,30,21
1650494110294,MATH 20D,A03,083767,Staff,25,0,30,5
1650494116318,MATH 20E,A01,083771,Staff,6,0,30,24
1650494116318,MATH 20E,A02,083772,Staff,18,0,30,12
1650494116318,MATH 20E,B01,083773,Staff,0,0,30,30
1650494116318,MATH 20E,B02,083774,Staff,10,0,30,20
1650494122382,MATH 103A,A01,083777,Staff,0,12,30,30
1650494122382,MATH 103A,A02,083778,Staff,0,12,30,30
1650494122382,MATH 103A,B01,083779,Staff,0,13,30,30
1650494122382,MATH 103A,B02,083780,Staff,0,13,30,30
1650494128411,MATH 105,A01,085443,Staff,1,23,30,29
1650494134439,MATH 109,A01,083213,Anzaldo; Leesa B,0,7,30,30
1650494134439,MATH 109,A02,083214,Anzaldo; Leesa B,0,7,30,30
1650494134439,MATH 109,B01,083215,Anzaldo; Leesa B,0,5,30,30
1650494134439,MATH 109,B02,083216,Anzaldo; Leesa B,0,6,30,30
1650494140465,MATH 142A,A01,083219,Chow; Bennett,0,15,30,30
1650494140465,MATH 142A,A02,083220,Chow; Bennett,0,13,30,30
1650494140465,MATH 142A,B01,083221,Chow; Bennett,0,12,30,30
1650494140465,MATH 142A,B02,083222,Chow; Bennett,0,13,30,30
1650494146487,MATH 193A,A01,083224,Staff,0,5,30,30
1650494146487,MATH 193A,A02,083225,Staff,0,5,30,30
1650494146487,MATH 193A,A03,083781,Staff,0,5,30,30
1650494146487,MATH 193A,A04,083782,Staff,0,6,30,30
1650494152536,MATH 197,001,091859,McAuley; Julian John,9998,0,9999,1
1650494158684,COGS 9,A01,083615,Staff,0,14,60,60
1650494164708,COGS 11,A01,083617,Boyle; Mary E. T.,20,0,40,20
1650494170736,COGS 13,A01,083071,Staff,0,34,40,40
1650494176763,COGS 14A,A01,092681,Staff,1,25,100,99
1650494182795,COGS 14B,A01,083073,Cheng; Tzu-Han,0,11,50,50
1650494188820,COGS 17,A01,092677,Staff,20,0,75,55
1650494194850,COGS 100,A01,083619,Staff,0,26,60,60
1650494200886,COGS 101A,A01,083621,Davis; Joshua Daniel,0,23,60,60
1650494206911,COGS 101B,A01,091572,Staff,0,4,60,60
1650494212944,COGS 101C,A01,083625,Delgado; Tania,16,0,30,14
1650494218967,COGS 107A,A01,083627,Boyle; Mary E. T.,0,12,60,60
1650494225006,COGS 118A,A01,083075,Staff,0,3,60,60
1650494231031,CSE 3,A50,083646,Miranda; Gregory Joseph,20,0,38,18
1650494231031,CSE 3,A51,083647,Miranda; Gregory Joseph,36,0,37,1
1650494237054,CSE 8A,A50,083650,Miranda; Gregory Joseph,1,28,40,39
1650494243081,CSE 11,A01,083080,Cao; Yingjun,0,91,40,40
1650494249104,CSE 12,A01,083652,Staff,0,17,100,100
1650494255135,CSE 15L,A01,083654,Staff,0,1,50,50
1650494255135,CSE 15L,A02,083655,Staff,0,0,50,50
1650494261163,CSE 20,A01,083657,Staff,51,0,80,29
1650494267187,CSE 30,A01,083084,Eldon; John,0,77,40,40
1650494273222,CSE 100,A01,083659,Cao; Yingjun,0,67,50,50
1650494279245,CSE 134B,A01,083661,Powell; Thomas Allan,0,31,65,65
1650494285277,CSE 140,A01,083663,Staff,0,5,75,75
1650494291304,CSE 140L,A01,083088,Eldon; John,0,9,75,75
1650494297331,CSE 175,A01,083665,Kumar; Rakesh,7,0,25,18
1650494303353,CSE 190,A00,092507,Dubnov; Shlomo,10,0,20,10
1650494309378,ECE 45,A01,083139,Staff,20,19,60,40
1650494315401,ECE 65,A50,083695,Staff,0,6,30,30
1650494321428,ECE 109,A01,091882,Touri; Behrouz,38,0,70,32
1650494327454,ECE 180,A00,083140,Abi Samra; Nicholas Camill,21,0,30,9
1650494327454,ECE 180,B00,083141,Abi Samra; Nicholas Camill,0,0,30,30
1650494333482,MATH 10A,A01,083735,Patchell; Gregory David,5,0,30,25
1650494333482,MATH 10A,A02,083736,Patchell; Gregory David,27,0,30,3
1650494333482,MATH 10A,A03,083737,Patchell; Gregory David,25,0,30,5
1650494339511,MATH 10B,A01,083207,Staff,0,8,30,30
1650494339511,MATH 10B,A02,083208,Staff,0,7,30,30
1650494339511,MATH 10B,B01,083739,Staff,13,0,30,17
1650494339511,MATH 10B,B02,083740,Staff,28,0,30,2
1650494345538,MATH 18,A01,083743,Staff,0,0,30,30
1650494345538,MATH 18,A02,083744,Staff,27,0,30,3
1650494345538,MATH 18,A03,083745,Staff,22,0,30,8
1650494345538,MATH 18,A04,083746,Staff,26,0,30,4
1650494345538,MATH 18,B01,083748,Staff,0,11,30,30
1650494345538,MATH 18,B02,083749,Staff,0,12,30,30
1650494345538,MATH 18,B03,083750,Staff,0,11,30,30
1650494345538,MATH 18,B04,083751,Staff,0,12,30,30
1650494351565,MATH 20A,A01,083754,Staff,25,0,40,15
1650494357592,MATH 20B,A01,083756,Staff,0,11,30,30
1650494357592,MATH 20B,A02,083757,Staff,0,11,30,30
1650494363617,MATH 20C,A01,083760,Staff,0,16,30,30
1650494363617,MATH 20C,A02,083761,Staff,2,15,30,28
1650494363617,MATH 20C,B01,083762,Staff,13,0,30,17
1650494363617,MATH 20C,B02,083763,Staff,28,0,30,2
1650494369641,MATH 20D,A01,083765,Staff,0,1,30,30
1650494369641,MATH 20D,A02,083766,Staff,9,0,30,21
1650494369641,MATH 20D,A03,083767,Staff,25,0,30,5
1650494375670,MATH 20E,A01,083771,Staff,6,0,30,24
1650494375670,MATH 20E,A02,083772,Staff,18,0,30,12
1650494375670,MATH 20E,B01,083773,Staff,0,0,30,30
1650494375670,MATH 20E,B02,083774,Staff,10,0,30,20
1650494381695,MATH 103A,A01,083777,Staff,0,12,30,30
1650494381695,MATH 103A,A02,083778,Staff,0,12,30,30
1650494381695,MATH 103A,B01,083779,Staff,0,13,30,30
1650494381695,MATH 103A,B02,083780,Staff,0,13,30,30
1650494387717,MATH 105,A01,085443,Staff,1,23,30,29
1650494393741,MATH 109,A01,083213,Anzaldo; Leesa B,0,7,30,30
1650494393741,MATH 109,A02,083214,Anzaldo; Leesa B,0,7,30,30
1650494393741,MATH 109,B01,083215,Anzaldo; Leesa B,0,5,30,30
1650494393741,MATH 109,B02,083216,Anzaldo; Leesa B,0,6,30,30
1650494399765,MATH 142A,A01,083219,Chow; Bennett,0,15,30,30
1650494399765,MATH 142A,A02,083220,Chow; Bennett,0,13,30,30
1650494399765,MATH 142A,B01,083221,Chow; Bennett,0,12,30,30
1650494399765,MATH 142A,B02,083222,Chow; Bennett,0,13,30,30
1650494405797,MATH 193A,A01,083224,Staff,0,5,30,30
1650494405797,MATH 193A,A02,083225,Staff,0,5,30,30
1650494405797,MATH 193A,A03,083781,Staff,0,5,30,30
1650494405797,MATH 193A,A04,083782,Staff,0,6,30,30
1650494411819,MATH 197,001,091859,McAuley; Julian John,9998,0,9999,1
1650494417878,COGS 9,A01,083615,Staff,0,14,60,60
1650494423910,COGS 11,A01,083617,Boyle; Mary E. T.,20,0,40,20
1650494429934,COGS 13,A01,083071,Staff,0,34,40,40
1650494435963,COGS 14A,A01,092681,Staff,1,25,100,99
1650494441989,COGS 14B,A01,083073,Cheng; Tzu-Han,0,11,50,50
1650494448033,COGS 17,A01,092677,Staff,20,0,75,55
1650494454054,COGS 100,A01,083619,Staff,0,26,60,60
1650494460078,COGS 101A,A01,083621,Davis; Joshua Daniel,0,23,60,60
1650494466100,COGS 101B,A01,091572,Staff,0,4,60,60
1650494472123,COGS 101C,A01,083625,Delgado; Tania,16,0,30,14
1650494478148,COGS 107A,A01,083627,Boyle; Mary E. T.,0,12,60,60
1650494484170,COGS 118A,A01,083075,Staff,0,3,60,60
1650494490200,CSE 3,A50,083646,Miranda; Gregory Joseph,20,0,38,18
1650494490200,CSE 3,A51,083647,Miranda; Gregory Joseph,36,0,37,1
1650494496226,CSE 8A,A50,083650,Miranda; Gregory Joseph,1,28,40,39
1650494502252,CSE 11,A01,083080,Cao; Yingjun,0,91,40,40
1650494508279,CSE 12,A01,083652,Staff,0,17,100,100
1650494514302,CSE 15L,A01,083654,Staff,0,1,50,50
1650494514302,CSE 15L,A02,083655,Staff,0,0,50,50
1650494520336,CSE 20,A01,083657,Staff,51,0,80,29
1650494526364,CSE 30,A01,083084,Eldon; John,0,77,40,40
1650494532388,CSE 100,A01,083659,Cao; Yingjun,0,67,50,50
1650494538414,CSE 134B,A01,083661,Powell; Thomas Allan,0,31,65,65
1650494544448,CSE 140,A01,083663,Staff,0,5,75,75
1650494550478,CSE 140L,A01,083088,Eldon; John,0,9,75,75
1650494556512,CSE 175,A01,083665,Kumar; Rakesh,7,0,25,18
1650494562535,CSE 190,A00,092507,Dubnov; Shlomo,10,0,20,10
1650494568577,ECE 45,A01,083139,Staff,20,19,60,40
1650494574600,ECE 65,A50,083695,Staff,0,6,30,30
1650494580632,ECE 109,A01,091882,Touri; Behrouz,38,0,70,32
1650494586657,ECE 180,A00,083140,Abi Samra; Nicholas Camill,21,0,30,9
1650494586657,ECE 180,B00,083141,Abi Samra; Nicholas Camill,0,0,30,30
1650494592684,MATH 10A,A01,083735,Patchell; Gregory David,5,0,30,25
1650494592684,MATH 10A,A02,083736,Patchell; Gregory David,27,0,30,3
1650494592684,MATH 10A,A03,083737,Patchell; Gregory David,25,0,30,5
1650494598718,MATH 10B,A01,083207,Staff,0,8,30,30
1650494598718,MATH 10B,A02,083208,Staff,0,7,30,30
1650494598718,MATH 10B,B01,083739,Staff,13,0,30,17
1650494598718,MATH 10B,B02,083740,Staff,28,0,30,2
1650494604759,MATH 18,A01,083743,Staff,0,0,30,30
1650494604759,MATH 18,A02,083744,Staff,27,0,30,3
1650494604759,MATH 18,A03,083745,Staff,22,0,30,8
1650494604759,MATH 18,A04,083746,Staff,26,0,30,4
1650494604759,MATH 18,B01,083748,Staff,0,11,30,30
1650494604759,MATH 18,B02,083749,Staff,0,12,30,30
1650494604759,MATH 18,B03,083750,Staff,0,11,30,30
1650494604759,MATH 18,B04,083751,Staff,0,12,30,30
1650494610784,MATH 20A,A01,083754,Staff,25,0,40,15
1650494616810,MATH 20B,A01,083756,Staff,0,11,30,30
1650494616810,MATH 20B,A02,083757,Staff,0,11,30,30
1650494622834,MATH 20C,A01,083760,Staff,0,16,30,30
1650494622834,MATH 20C,A02,083761,Staff,2,15,30,28
1650494622834,MATH 20C,B01,083762,Staff,13,0,30,17
1650494622834,MATH 20C,B02,083763,Staff,28,0,30,2
1650494628862,MATH 20D,A01,083765,Staff,0,1,30,30
1650494628862,MATH 20D,A02,083766,Staff,9,0,30,21
1650494628862,MATH 20D,A03,083767,Staff,25,0,30,5
1650494634885,MATH 20E,A01,083771,Staff,6,0,30,24
1650494634885,MATH 20E,A02,083772,Staff,18,0,30,12
1650494634885,MATH 20E,B01,083773,Staff,0,0,30,30
1650494634885,MATH 20E,B02,083774,Staff,10,0,30,20
1650494640912,MATH 103A,A01,083777,Staff,0,12,30,30
1650494640912,MATH 103A,A02,083778,Staff,0,12,30,30
1650494640912,MATH 103A,B01,083779,Staff,0,13,30,30
1650494640912,MATH 103A,B02,083780,Staff,0,13,30,30
1650494646936,MATH 105,A01,085443,Staff,1,23,30,29
1650494652960,MATH 109,A01,083213,Anzaldo; Leesa B,0,7,30,30
1650494652960,MATH 109,A02,083214,Anzaldo; Leesa B,0,7,30,30
1650494652960,MATH 109,B01,083215,Anzaldo; Leesa B,0,5,30,30
1650494652960,MATH 109,B02,083216,Anzaldo; Leesa B,0,6,30,30
1650494658992,MATH 142A,A01,083219,Chow; Bennett,0,15,30,30
1650494658992,MATH 142A,A02,083220,Chow; Bennett,0,13,30,30
1650494658992,MATH 142A,B01,083221,Chow; Bennett,0,12,30,30
1650494658992,MATH 142A,B02,083222,Chow; Bennett,0,13,30,30
1650494665013,MATH 193A,A01,083224,Staff,0,5,30,30
1650494665013,MATH 193A,A02,083225,Staff,0,5,30,30
1650494665013,MATH 193A,A03,083781,Staff,0,5,30,30
1650494665013,MATH 193A,A04,083782,Staff,0,6,30,30
1650494671050,MATH 197,001,091859,McAuley; Julian John,9998,0,9999,1
1650494677112,COGS 9,A01,083615,Staff,0,14,60,60
1650494683135,COGS 11,A01,083617,Boyle; Mary E. T.,20,0,40,20
1650494689162,COGS 13,A01,083071,Staff,0,34,40,40
1650494695184,COGS 14A,A01,092681,Staff,1,25,100,99
1650494701211,COGS 14B,A01,083073,Cheng; Tzu-Han,0,11,50,50
1650494707240,COGS 17,A01,092677,Staff,20,0,75,55
1650494713264,COGS 100,A01,083619,Staff,0,26,60,60
1650494719291,COGS 101A,A01,083621,Davis; Joshua Daniel,0,23,60,60
1650494725316,COGS 101B,A01,091572,Staff,0,4,60,60
1650494731416,COGS 101C,A01,083625,Delgado; Tania,16,0,30,14
1650494737441,COGS 107A,A01,083627,Boyle; Mary E. T.,0,12,60,60
1650494743467,COGS 118A,A01,083075,Staff,0,3,60,60
1650494749492,CSE 3,A50,083646,Miranda; Gregory Joseph,20,0,38,18
1650494749492,CSE 3,A51,083647,Miranda; Gregory Joseph,36,0,37,1
1650494755591,CSE 8A,A50,083650,Miranda; Gregory Joseph,1,28,40,39
1650494761619,CSE 11,A01,083080,Cao; Yingjun,0,91,40,40
1650494767650,CSE 12,A01,083652,Staff,0,17,100,100
1650494773678,CSE 15L,A01,083654,Staff,0,1,50,50
1650494773678,CSE 15L,A02,083655,Staff,0,0,50,50
1650494779707,CSE 20,A01,083657,Staff,51,0,80,29
1650494785733,CSE 30,A01,083084,Eldon; John,0,77,40,40
1650494791756,CSE 100,A01,083659,Cao; Yingjun,0,67,50,50
1650494797779,CSE 134B,A01,083661,Powell; Thomas Allan,0,31,65,65
1650494803802,CSE 140,A01,083663,Staff,0,5,75,75
1650494809826,CSE 140L,A01,083088,Eldon; John,0,9,75,75
1650494815851,CSE 175,A01,083665,Kumar; Rakesh,7,0,25,18
1650494821886,CSE 190,A00,092507,Dubnov; Shlomo,10,0,20,10
1650494827908,ECE 45,A01,083139,Staff,20,19,60,40
1650494833935,ECE 65,A50,083695,Staff,0,6,30,30
1650494839961,ECE 109,A01,091882,Touri; Behrouz,38,0,70,32
1650494845993,ECE 180,A00,083140,Abi Samra; Nicholas Camill,21,0,30,9
1650494845993,ECE 180,B00,083141,Abi Samra; Nicholas Camill,0,0,30,30
1650494852020,MATH 10A,A01,083735,Patchell; Gregory David,5,0,30,25
1650494852020,MATH 10A,A02,083736,Patchell; Gregory David,27,0,30,3
1650494852020,MATH 10A,A03,083737,Patchell; Gregory David,25,0,30,5
1650494858042,MATH 10B,A01,083207,Staff,0,8,30,30
1650494858042,MATH 10B,A02,083208,Staff,0,7,30,30
1650494858042,MATH 10B,B01,083739,Staff,13,0,30,17
1650494858042,MATH 10B,B02,083740,Staff,28,0,30,2
1650494864082,MATH 18,A01,083743,Staff,0,0,30,30
1650494864082,MATH 18,A02,083744,Staff,27,0,30,3
1650494864082,MATH 18,A03,083745,Staff,22,0,30,8
1650494864082,MATH 18,A04,083746,Staff,26,0,30,4
1650494864082,MATH 18,B01,083748,Staff,0,11,30,30
1650494864082,MATH 18,B02,083749,Staff,0,12,30,30
1650494864082,MATH 18,B03,083750,Staff,0,11,30,30
1650494864082,MATH 18,B04,083751,Staff,0,12,30,30
1650494870114,MATH 20A,A01,083754,Staff,25,0,40,15
1650494876141,MATH 20B,A01,083756,Staff,0,11,30,30
1650494876141,MATH 20B,A02,083757,Staff,0,11,30,30
1650494882173,MATH 20C,A01,083760,Staff,0,16,30,30
1650494882173,MATH 20C,A02,083761,Staff,2,15,30,28
1650494882173,MATH 20C,B01,083762,Staff,13,0,30,17
1650494882173,MATH 20C,B02,083763,Staff,28,0,30,2
1650494888198,MATH 20D,A01,083765,Staff,0,1,30,30
1650494888198,MATH 20D,A02,083766,Staff,9,0,30,21
1650494888198,MATH 20D,A03,083767,Staff,25,0,30,5
1650494894222,MATH 20E,A01,083771,Staff,6,0,30,24
1650494894222,MATH 20E,A02,083772,Staff,18,0,30,12
1650494894222,MATH 20E,B01,083773,Staff,0,0,30,30
1650494894222,MATH 20E,B02,083774,Staff,10,0,30,20
1650494900248,MATH 103A,A01,083777,Staff,0,12,30,30
1650494900248,MATH 103A,A02,083778,Staff,0,12,30,30
1650494900248,MATH 103A,B01,083779,Staff,0,13,30,30
1650494900248,MATH 103A,B02,083780,Staff,0,13,30,30
1650494906271,MATH 105,A01,085443,Staff,1,23,30,29
1650494912305,MATH 109,A01,083213,Anzaldo; Leesa B,0,7,30,30
1650494912305,MATH 109,A02,083214,Anzaldo; Leesa B,0,7,30,30
1650494912305,MATH 109,B01,083215,Anzaldo; Leesa B,0,5,30,30
1650494912305,MATH 109,B02,083216,Anzaldo; Leesa B,0,6,30,30
1650494918330,MATH 142A,A01,083219,Chow; Bennett,0,15,30,30
1650494918330,MATH 142A,A02,083220,Chow; Bennett,0,13,30,30
1650494918330,MATH 142A,B01,083221,Chow; Bennett,0,12,30,30
1650494918330,MATH 142A,B02,083222,Chow; Bennett,0,13,30,30
1650494924356,MATH 193A,A01,083224,Staff,0,5,30,30
1650494924356,MATH 193A,A02,083225,Staff,0,5,30,30
1650494924356,MATH 193A,A03,083781,Staff,0,5,30,30
1650494924356,MATH 193A,A04,083782,Staff,0,6,30,30
1650494930390,MATH 197,001,091859,McAuley; Julian John,9998,0,9999,1
1650494936464,COGS 9,A01,083615,Staff,0,14,60,60
1650494942489,COGS 11,A01,083617,Boyle; Mary E. T.,20,0,40,20
1650494948514,COGS 13,A01,083071,Staff,0,34,40,40
1650494954540,COGS 14A,A01,092681,Staff,1,25,100,99
1650494960576,COGS 14B,A01,083073,Cheng; Tzu-Han,0,11,50,50
1650494966602,COGS 17,A01,092677,Staff,20,0,75,55
1650494972625,COGS 100,A01,083619,Staff,0,26,60,60
1650494978655,COGS 101A,A01,083621,Davis; Joshua Daniel,0,23,60,60
1650494984679,COGS 101B,A01,091572,Staff,0,4,60,60
1650494990705,COGS 101C,A01,083625,Delgado; Tania,16,0,30,14
1650494996731,COGS 107A,A01,083627,Boyle; Mary E. T.,0,12,60,60
1650495002758,COGS 118A,A01,083075,Staff,0,3,60,60
1650495008782,CSE 3,A50,083646,Miranda; Gregory Joseph,20,0,38,18
1650495008782,CSE 3,A51,083647,Miranda; Gregory Joseph,36,0,37,1
1650495014809,CSE 8A,A50,083650,Miranda; Gregory Joseph,1,28,40,39
1650495020839,CSE 11,A01,083080,Cao; Yingjun,0,91,40,40
1650495026866,CSE 12,A01,083652,Staff,0,17,100,100
1650495032889,CSE 15L,A01,083654,Staff,0,1,50,50
1650495032889,CSE 15L,A02,083655,Staff,0,0,50,50
1650495038914,CSE 20,A01,083657,Staff,51,0,80,29
1650495044939,CSE 30,A01,083084,Eldon; John,0,77,40,40
1650495050962,CSE 100,A01,083659,Cao; Yingjun,0,67,50,50
1650495056988,CSE 134B,A01,083661,Powell; Thomas Allan,0,31,65,65
1650495063012,CSE 140,A01,083663,Staff,0,5,75,75
1650495069035,CSE 140L,A01,083088,Eldon; John,0,9,75,75
1650495075061,CSE 175,A01,083665,Kumar; Rakesh,7,0,25,18
1650495081091,CSE 190,A00,092507,Dubnov; Shlomo,10,0,20,10
1650495087114,ECE 45,A01,083139,Staff,20,19,60,40
1650495093137,ECE 65,A50,083695,Staff,0,6,30,30
1650495099161,ECE 109,A01,091882,Touri; Behrouz,38,0,70,32
1650495105184,ECE 180,A00,083140,Abi Samra; Nicholas Camill,21,0,30,9
1650495105184,ECE 180,B00,083141,Abi Samra; Nicholas Camill,0,0,30,30
1650495111212,MATH 10A,A01,083735,Patchell; Gregory David,5,0,30,25
1650495111212,MATH 10A,A02,083736,Patchell; Gregory David,27,0,30,3
1650495111212,MATH 10A,A03,083737,Patchell; Gregory David,25,0,30,5
1650495117237,MATH 10B,A01,083207,Staff,0,8,30,30
1650495117237,MATH 10B,A02,083208,Staff,0,7,30,30
1650495117237,MATH 10B,B01,083739,Staff,13,0,30,17
1650495117237,MATH 10B,B02,083740,Staff,28,0,30,2
1650495123268,MATH 18,A01,083743,Staff,0,0,30,30
1650495123268,MATH 18,A02,083744,Staff,27,0,30,3
1650495123268,MATH 18,A03,083745,Staff,22,0,30,8
1650495123268,MATH 18,A04,083746,Staff,26,0,30,4
1650495123268,MATH 18,B01,083748,Staff,0,11,30,30
1650495123268,MATH 18,B02,083749,Staff,0,12,30,30
1650495123268,MATH 18,B03,083750,Staff,0,11,30,30
1650495123268,MATH 18,B04,083751,Staff,0,12,30,30
1650495129304,MATH 20A,A01,083754,Staff,25,0,40,15
1650495135330,MATH 20B,A01,083756,Staff,0,11,30,30
1650495135330,MATH 20B,A02,083757,Staff,0,11,30,30
1650495141357,MATH 20C,A01,083760,Staff,0,16,30,30
1650495141357,MATH 20C,A02,083761,Staff,2,15,30,28
1650495141357,MATH 20C,B01,083762,Staff,13,0,30,17
1650495141357,MATH 20C,B02,083763,Staff,28,0,30,2
1650495147384,MATH 20D,A01,083765,Staff,0,1,30,30
1650495147384,MATH 20D,A02,083766,Staff,9,0,30,21
1650495147384,MATH 20D,A03,083767,Staff,25,0,30,5
1650495153409,MATH 20E,A01,083771,Staff,6,0,30,24
1650495153409,MATH 20E,A02,083772,Staff,18,0,30,12
1650495153409,MATH 20E,B01,083773,Staff,0,0,30,30
1650495153409,MATH 20E,B02,083774,Staff,10,0,30,20
1650495159444,MATH 103A,A01,083777,Staff,0,12,30,30
1650495159444,MATH 103A,A02,083778,Staff,0,12,30,30
1650495159444,MATH 103A,B01,083779,Staff,0,13,30,30
1650495159444,MATH 103A,B02,083780,Staff,0,13,30,30
1650495165468,MATH 105,A01,085443,Staff,1,23,30,29
1650495171490,MATH 109,A01,083213,Anzaldo; Leesa B,0,7,30,30
1650495171490,MATH 109,A02,083214,Anzaldo; Leesa B,0,7,30,30
1650495171490,MATH 109,B01,083215,Anzaldo; Leesa B,0,5,30,30
1650495171490,MATH 109,B02,083216,Anzaldo; Leesa B,0,6,30,30
1650495177523,MATH 142A,A01,083219,Chow; Bennett,0,15,30,30
1650495177523,MATH 142A,A02,083220,Chow; Bennett,0,13,30,30
1650495177523,MATH 142A,B01,083221,Chow; Bennett,0,12,30,30
1650495177523,MATH 142A,B02,083222,Chow; Bennett,0,13,30,30
1650495183553,MATH 193A,A01,083224,Staff,0,5,30,30
1650495183553,MATH 193A,A02,083225,Staff,0,5,30,30
1650495183553,MATH 193A,A03,083781,Staff,0,5,30,30
1650495183553,MATH 193A,A04,083782,Staff,0,6,30,30
1650495189575,MATH 197,001,091859,McAuley; Julian John,9998,0,9999,1
1650495195626,COGS 9,A01,083615,Staff,0,14,60,60
1650495201661,COGS 11,A01,083617,Boyle; Mary E. T.,20,0,40,20
1650495207687,COGS 13,A01,083071,Staff,0,34,40,40
1650495224301,COGS 14A,A01,092681,Staff,1,25,100,99
1650495230324,COGS 14B,A01,083073,Cheng; Tzu-Han,0,11,50,50
1650495236349,COGS 17,A01,092677,Staff,20,0,75,55
1650495242376,COGS 100,A01,083619,Staff,0,26,60,60
1650495248401,COGS 101A,A01,083621,Davis; Joshua Daniel,0,23,60,60
1650495254426,COGS 101B,A01,091572,Staff,0,4,60,60
1650495260449,COGS 101C,A01,083625,Delgado; Tania,16,0,30,14
1650495266475,COGS 107A,A01,083627,Boyle; Mary E. T.,0,12,60,60
1650495272499,COGS 118A,A01,083075,Staff,0,3,60,60
1650495278524,CSE 3,A50,083646,Miranda; Gregory Joseph,20,0,38,18
1650495278524,CSE 3,A51,083647,Miranda; Gregory Joseph,36,0,37,1
1650495284548,CSE 8A,A50,083650,Miranda; Gregory Joseph,1,28,40,39
1650495290573,CSE 11,A01,083080,Cao; Yingjun,0,91,40,40
1650495296600,CSE 12,A01,083652,Staff,0,17,100,100
1650495302630,CSE 15L,A01,083654,Staff,0,1,50,50
1650495302630,CSE 15L,A02,083655,Staff,0,0,50,50
1650495308653,CSE 20,A01,083657,Staff,51,0,80,29
1650495314684,CSE 30,A01,083084,Eldon; John,0,77,40,40
1650495320706,CSE 100,A01,083659,Cao; Yingjun,0,67,50,50
1650495326732,CSE 134B,A01,083661,Powell; Thomas Allan,0,32,65,65
1650495332753,CSE 140,A01,083663,Staff,0,5,75,75
1650495338778,CSE 140L,A01,083088,Eldon; John,0,9,75,75
1650495344814,CSE 175,A01,083665,Kumar; Rakesh,7,0,25,18
1650495350839,CSE 190,A00,092507,Dubnov; Shlomo,10,0,20,10
1650495356865,ECE 45,A01,083139,Staff,20,19,60,40
1650495363001,ECE 65,A50,083695,Staff,0,6,30,30
1650495369028,ECE 109,A01,091882,Touri; Behrouz,37,0,70,33
1650495375051,ECE 180,A00,083140,Abi Samra; Nicholas Camill,21,0,30,9
1650495375051,ECE 180,B00,083141,Abi Samra; Nicholas Camill,0,0,30,30
1650495381080,MATH 10A,A01,083735,Patchell; Gregory David,5,0,30,25
1650495381080,MATH 10A,A02,083736,Patchell; Gregory David,27,0,30,3
1650495381080,MATH 10A,A03,083737,Patchell; Gregory David,25,0,30,5
1650495387104,MATH 10B,A01,083207,Staff,0,8,30,30
1650495387104,MATH 10B,A02,083208,Staff,0,7,30,30
1650495387104,MATH 10B,B01,083739,Staff,13,0,30,17
1650495387104,MATH 10B,B02,083740,Staff,28,0,30,2
1650495393134,MATH 18,A01,083743,Staff,0,0,30,30
1650495393134,MATH 18,A02,083744,Staff,27,0,30,3
1650495393134,MATH 18,A03,083745,Staff,22,0,30,8
1650495393134,MATH 18,A04,083746,Staff,26,0,30,4
1650495393134,MATH 18,B01,083748,Staff,0,11,30,30
1650495393134,MATH 18,B02,083749,Staff,0,12,30,30
1650495393134,MATH 18,B03,083750,Staff,0,11,30,30
1650495393134,MATH 18,B04,083751,Staff,0,12,30,30
1650495399161,MATH 20A,A01,083754,Staff,25,0,40,15
1650495405184,MATH 20B,A01,083756,Staff,0,11,30,30
1650495405184,MATH 20B,A02,083757,Staff,0,11,30,30
1650495411208,MATH 20C,A01,083760,Staff,0,16,30,30
1650495411208,MATH 20C,A02,083761,Staff,2,15,30,28
1650495411208,MATH 20C,B01,083762,Staff,13,0,30,17
1650495411208,MATH 20C,B02,083763,Staff,28,0,30,2
1650495417232,MATH 20D,A01,083765,Staff,0,1,30,30
1650495417232,MATH 20D,A02,083766,Staff,9,0,30,21
1650495417232,MATH 20D,A03,083767,Staff,25,0,30,5
1650495423269,MATH 20E,A01,083771,Staff,6,0,30,24
1650495423269,MATH 20E,A02,083772,Staff,18,0,30,12
1650495423269,MATH 20E,B01,083773,Staff,0,0,30,30
1650495423269,MATH 20E,B02,083774,Staff,10,0,30,20
1650495429297,MATH 103A,A01,083777,Staff,0,12,30,30
1650495429297,MATH 103A,A02,083778,Staff,0,12,30,30
1650495429297,MATH 103A,B01,083779,Staff,0,13,30,30
1650495429297,MATH 103A,B02,083780,Staff,0,13,30,30
1650495435325,MATH 105,A01,085443,Staff,1,23,30,29
1650495441351,MATH 109,A01,083213,Anzaldo; Leesa B,0,7,30,30
1650495441351,MATH 109,A02,083214,Anzaldo; Leesa B,0,7,30,30
1650495441351,MATH 109,B01,083215,Anzaldo; Leesa B,0,5,30,30
1650495441351,MATH 109,B02,083216,Anzaldo; Leesa B,0,6,30,30
1650495447373,MATH 142A,A01,083219,Chow; Bennett,0,15,30,30
1650495447373,MATH 142A,A02,083220,Chow; Bennett,0,13,30,30
1650495447373,MATH 142A,B01,083221,Chow; Bennett,0,12,30,30
1650495447373,MATH 142A,B02,083222,Chow; Bennett,0,13,30,30
1650495453397,MATH 193A,A01,083224,Staff,0,5,30,30
1650495453397,MATH 193A,A02,083225,Staff,0,5,30,30
1650495453397,MATH 193A,A03,083781,Staff,0,5,30,30
1650495453397,MATH 193A,A04,083782,Staff,0,6,30,30
1650495459423,MATH 197,001,091859,McAuley; Julian John,9998,0,9999,1
1650495465473,COGS 9,A01,083615,Staff,0,14,60,60
1650495471497,COGS 11,A01,083617,Boyle; Mary E. T.,20,0,40,20
1650495477523,COGS 13,A01,083071,Staff,0,34,40,40
1650495483554,COGS 14A,A01,092681,Staff,1,25,100,99
1650495489584,COGS 14B,A01,083073,Cheng; Tzu-Han,0,11,50,50
1650495495614,COGS 17,A01,092677,Staff,20,0,75,55
1650495501646,COGS 100,A01,083619,Staff,0,26,60,60
1650495507679,COGS 101A,A01,083621,Davis; Joshua Daniel,0,23,60,60
1650495513702,COGS 101B,A01,091572,Staff,0,4,60,60
1650495519733,COGS 101C,A01,083625,Delgado; Tania,16,0,30,14
1650495525758,COGS 107A,A01,083627,Boyle; Mary E. T.,0,12,60,60
1650495531780,COGS 118A,A01,083075,Staff,0,3,60,60
1650495537805,CSE 3,A50,083646,Miranda; Gregory Joseph,20,0,38,18
1650495537805,CSE 3,A51,083647,Miranda; Gregory Joseph,36,0,37,1
1650495543828,CSE 8A,A50,083650,Miranda; Gregory Joseph,1,28,40,39
1650495549862,CSE 11,A01,083080,Cao; Yingjun,0,91,40,40
1650495555890,CSE 12,A01,083652,Staff,0,17,100,100
1650495561919,CSE 15L,A01,083654,Staff,0,1,50,50
1650495561919,CSE 15L,A02,083655,Staff,0,0,50,50
1650495567943,CSE 20,A01,083657,Staff,51,0,80,29
1650495573969,CSE 30,A01,083084,Eldon; John,0,77,40,40
1650495579991,CSE 100,A01,083659,Cao; Yingjun,0,67,50,50
1650495586013,CSE 134B,A01,083661,Powell; Thomas Allan,0,32,65,65
1650495592039,CSE 140,A01,083663,Staff,0,5,75,75
1650495598065,CSE 140L,A01,083088,Eldon; John,0,9,75,75
1650495604095,CSE 175,A01,083665,Kumar; Rakesh,7,0,25,18
1650495610118,CSE 190,A00,092507,Dubnov; Shlomo,10,0,20,10
1650495616141,ECE 45,A01,083139,Staff,20,19,60,40
1650495622168,ECE 65,A50,083695,Staff,0,6,30,30
1650495628193,ECE 109,A01,091882,Touri; Behrouz,37,0,70,33
1650495634228,ECE 180,A00,083140,Abi Samra; Nicholas Camill,21,0,30,9
1650495634228,ECE 180,B00,083141,Abi Samra; Nicholas Camill,0,0,30,30
1650495640254,MATH 10A,A01,083735,Patchell; Gregory David,5,0,30,25
1650495640254,MATH 10A,A02,083736,Patchell; Gregory David,27,0,30,3
1650495640254,MATH 10A,A03,083737,Patchell; Gregory David,25,0,30,5
1650495646276,MATH 10B,A01,083207,Staff,0,8,30,30
1650495646276,MATH 10B,A02,083208,Staff,0,7,30,30
1650495646276,MATH 10B,B01,083739,Staff,13,0,30,17
1650495646276,MATH 10B,B02,083740,Staff,28,0,30,2
1650495652300,MATH 18,A01,083743,Staff,0,0,30,30
1650495652300,MATH 18,A02,083744,Staff,27,0,30,3
1650495652300,MATH 18,A03,083745,Staff,22,0,30,8
1650495652300,MATH 18,A04,083746,Staff,26,0,30,4
1650495652300,MATH 18,B01,083748,Staff,0,11,30,30
1650495652300,MATH 18,B02,083749,Staff,0,12,30,30
1650495652300,MATH 18,B03,083750,Staff,0,11,30,30
1650495652300,MATH 18,B04,083751,Staff,0,12,30,30
1650495658327,MATH 20A,A01,083754,Staff,25,0,40,15
1650495664352,MATH 20B,A01,083756,Staff,0,11,30,30
1650495664352,MATH 20B,A02,083757,Staff,0,11,30,30
1650495670379,MATH 20C,A01,083760,Staff,0,16,30,30
1650495670379,MATH 20C,A02,083761,Staff,2,15,30,28
1650495670379,MATH 20C,B01,083762,Staff,13,0,30,17
1650495670379,MATH 20C,B02,083763,Staff,28,0,30,2
1650495676419,MATH 20D,A01,083765,Staff,0,1,30,30
1650495676419,MATH 20D,A02,083766,Staff,9,0,30,21
1650495676419,MATH 20D,A03,083767,Staff,25,0,30,5
1650495682454,MATH 20E,A01,083771,Staff,6,0,30,24
1650495682454,MATH 20E,A02,083772,Staff,18,0,30,12
1650495682454,MATH 20E,B01,083773,Staff,0,0,30,30
1650495682454,MATH 20E,B02,083774,Staff,10,0,30,20
1650495688488,MATH 103A,A01,083777,Staff,0,12,30,30
1650495688488,MATH 103A,A02,083778,Staff,0,12,30,30
1650495688488,MATH 103A,B01,083779,Staff,0,13,30,30
1650495688488,MATH 103A,B02,083780,Staff,0,13,30,30
1650495694512,MATH 105,A01,085443,Staff,1,23,30,29
1650495700548,MATH 109,A01,083213,Anzaldo; Leesa B,0,7,30,30
1650495700548,MATH 109,A02,083214,Anzaldo; Leesa B,0,7,30,30
1650495700548,MATH 109,B01,083215,Anzaldo; Leesa B,0,5,30,30
1650495700548,MATH 109,B02,083216,Anzaldo; Leesa B,0,6,30,30
1650495706570,MATH 142A,A01,083219,Chow; Bennett,0,15,30,30
1650495706570,MATH 142A,A02,083220,Chow; Bennett,0,13,30,30
1650495706570,MATH 142A,B01,083221,Chow; Bennett,0,12,30,30
1650495706570,MATH 142A,B02,083222,Chow; Bennett,0,13,30,30
1650495712596,MATH 193A,A01,083224,Staff,0,5,30,30
1650495712596,MATH 193A,A02,083225,Staff,0,5,30,30
1650495712596,MATH 193A,A03,083781,Staff,0,5,30,30
1650495712596,MATH 193A,A04,083782,Staff,0,6,30,30
1650495718619,MATH 197,001,091859,McAuley; Julian John,9998,0,9999,1
1650495724667,COGS 9,A01,083615,Staff,0,14,60,60
1650495730693,COGS 11,A01,083617,Boyle; Mary E. T.,20,0,40,20
1650495736720,COGS 13,A01,083071,Staff,0,34,40,40
1650495742753,COGS 14A,A01,092681,Staff,1,25,100,99
1650495748776,COGS 14B,A01,083073,Cheng; Tzu-Han,0,11,50,50
1650495754812,COGS 17,A01,092677,Staff,20,0,75,55
1650495760857,COGS 100,A01,083619,Staff,0,26,60,60
1650495766887,COGS 101A,A01,083621,Davis; Joshua Daniel,0,23,60,60
1650495772911,COGS 101B,A01,091572,Staff,0,4,60,60
1650495778939,COGS 101C,A01,083625,Delgado; Tania,16,0,30,14
1650495784972,COGS 107A,A01,083627,Boyle; Mary E. T.,0,12,60,60
1650495791007,COGS 118A,A01,083075,Staff,0,3,60,60
1650495797039,CSE 3,A50,083646,Miranda; Gregory Joseph,20,0,38,18
1650495797039,CSE 3,A51,083647,Miranda; Gregory Joseph,36,0,37,1
1650495803061,CSE 8A,A50,083650,Miranda; Gregory Joseph,1,28,40,39
1650495809084,CSE 11,A01,083080,Cao; Yingjun,0,91,40,40
1650495815105,CSE 12,A01,083652,Staff,0,17,100,100
1650495821128,CSE 15L,A01,083654,Staff,0,1,50,50
1650495821128,CSE 15L,A02,083655,Staff,0,0,50,50
1650495827151,CSE 20,A01,083657,Staff,51,0,80,29
1650495833178,CSE 30,A01,083084,Eldon; John,0,77,40,40
1650495839205,CSE 100,A01,083659,Cao; Yingjun,0,67,50,50
1650495845229,CSE 134B,A01,083661,Powell; Thomas Allan,0,32,65,65
1650495851251,CSE 140,A01,083663,Staff,0,5,75,75
1650495857278,CSE 140L,A01,083088,Eldon; John,0,9,75,75
1650495863301,CSE 175,A01,083665,Kumar; Rakesh,7,0,25,18
1650495869324,CSE 190,A00,092507,Dubnov; Shlomo,10,0,20,10
1650495875348,ECE 45,A01,083139,Staff,20,19,60,40
1650495881385,ECE 65,A50,083695,Staff,0,6,30,30
1650495887410,ECE 109,A01,091882,Touri; Behrouz,37,0,70,33
1650495893432,ECE 180,A00,083140,Abi Samra; Nicholas Camill,21,0,30,9
1650495893432,ECE 180,B00,083141,Abi Samra; Nicholas Camill,0,0,30,30
1650495899456,MATH 10A,A01,083735,Patchell; Gregory David,5,0,30,25
1650495899456,MATH 10A,A02,083736,Patchell; Gregory David,27,0,30,3
1650495899456,MATH 10A,A03,083737,Patchell; Gregory David,25,0,30,5
1650495905482,MATH 10B,A01,083207,Staff,0,8,30,30
1650495905482,MATH 10B,A02,083208,Staff,0,7,30,30
1650495905482,MATH 10B,B01,083739,Staff,13,0,30,17
1650495905482,MATH 10B,B02,083740,Staff,28,0,30,2
1650495911516,MATH 18,A01,083743,Staff,0,0,30,30
1650495911516,MATH 18,A02,083744,Staff,27,0,30,3
1650495911516,MATH 18,A03,083745,Staff,22,0,30,8
1650495911516,MATH 18,A04,083746,Staff,26,0,30,4
1650495911516,MATH 18,B01,083748,Staff,0,11,30,30
1650495911516,MATH 18,B02,083749,Staff,0,12,30,30
1650495911516,MATH 18,B03,083750,Staff,0,11,30,30
1650495911516,MATH 18,B04,083751,Staff,0,12,30,30
1650495917541,MATH 20A,A01,083754,Staff,25,0,40,15
1650495923565,MATH 20B,A01,083756,Staff,0,11,30,30
1650495923565,MATH 20B,A02,083757,Staff,0,11,30,30
1650495929592,MATH 20C,A01,083760,Staff,0,16,30,30
1650495929592,MATH 20C,A02,083761,Staff,2,15,30,28
1650495929592,MATH 20C,B01,083762,Staff,13,0,30,17
1650495929592,MATH 20C,B02,083763,Staff,28,0,30,2
1650495935616,MATH 20D,A01,083765,Staff,0,1,30,30
1650495935616,MATH 20D,A02,083766,Staff,9,0,30,21
1650495935616,MATH 20D,A03,083767,Staff,25,0,30,5
1650495941643,MATH 20E,A01,083771,Staff,6,0,30,24
1650495941643,MATH 20E,A02,083772,Staff,18,0,30,12
1650495941643,MATH 20E,B01,083773,Staff,0,0,30,30
1650495941643,MATH 20E,B02,083774,Staff,10,0,30,20
1650495947672,MATH 103A,A01,083777,Staff,0,12,30,30
1650495947672,MATH 103A,A02,083778,Staff,0,12,30,30
1650495947672,MATH 103A,B01,083779,Staff,0,13,30,30
1650495947672,MATH 103A,B02,083780,Staff,0,13,30,30
1650495953697,MATH 105,A01,085443,Staff,1,23,30,29
1650495959827,MATH 109,A01,083213,Anzaldo; Leesa B,0,7,30,30
1650495959827,MATH 109,A02,083214,Anzaldo; Leesa B,0,7,30,30
1650495959827,MATH 109,B01,083215,Anzaldo; Leesa B,0,5,30,30
1650495959827,MATH 109,B02,083216,Anzaldo; Leesa B,0,6,30,30
1650495965851,MATH 142A,A01,083219,Chow; Bennett,0,15,30,30
1650495965851,MATH 142A,A02,083220,Chow; Bennett,0,13,30,30
1650495965851,MATH 142A,B01,083221,Chow; Bennett,0,12,30,30
1650495965851,MATH 142A,B02,083222,Chow; Bennett,0,13,30,30
1650495971879,MATH 193A,A01,083224,Staff,0,5,30,30
1650495971879,MATH 193A,A02,083225,Staff,0,5,30,30
1650495971879,MATH 193A,A03,083781,Staff,0,5,30,30
1650495971879,MATH 193A,A04,083782,Staff,0,6,30,30
1650495977901,MATH 197,001,091859,McAuley; Julian John,9998,0,9999,1
1650495983971,COGS 9,A01,083615,Staff,0,14,60,60
1650495990014,COGS 11,A01,083617,Boyle; Mary E. T.,20,0,40,20
1650495996041,COGS 13,A01,083071,Staff,0,34,40,40
1650496002063,COGS 14A,A01,092681,Staff,1,25,100,99
1650496008090,COGS 14B,A01,083073,Cheng; Tzu-Han,0,11,50,50
1650496014115,COGS 17,A01,092677,Staff,20,0,75,55
1650496020138,COGS 100,A01,083619,Staff,0,26,60,60
1650496026165,COGS 101A,A01,083621,Davis; Joshua Daniel,0,23,60,60
1650496032188,COGS 101B,A01,091572,Staff,0,4,60,60
1650496038219,COGS 101C,A01,083625,Delgado; Tania,16,0,30,14
1650496044245,COGS 107A,A01,083627,Boyle; Mary E. T.,0,12,60,60
1650496050268,COGS 118A,A01,083075,Staff,0,3,60,60
1650496056291,CSE 3,A50,083646,Miranda; Gregory Joseph,20,0,38,18
1650496056291,CSE 3,A51,083647,Miranda; Gregory Joseph,36,0,37,1
1650496062313,CSE 8A,A50,083650,Miranda; Gregory Joseph,1,28,40,39
1650496068338,CSE 11,A01,083080,Cao; Yingjun,0,91,40,40
1650496074376,CSE 12,A01,083652,Staff,0,17,100,100
1650496080400,CSE 15L,A01,083654,Staff,0,1,50,50
1650496080400,CSE 15L,A02,083655,Staff,0,0,50,50
1650496086423,CSE 20,A01,083657,Staff,51,0,80,29
1650496092445,CSE 30,A01,083084,Eldon; John,0,77,40,40
1650496098468,CSE 100,A01,083659,Cao; Yingjun,0,67,50,50
1650496104500,CSE 134B,A01,083661,Powell; Thomas Allan,0,32,65,65
1650496110525,CSE 140,A01,083663,Staff,0,5,75,75
1650496116552,CSE 140L,A01,083088,Eldon; John,0,9,75,75
1650496122580,CSE 175,A01,083665,Kumar; Rakesh,7,0,25,18
1650496128603,CSE 190,A00,092507,Dubnov; Shlomo,10,0,20,10
1650496134628,ECE 45,A01,083139,Staff,20,19,60,40
1650496140653,ECE 65,A50,083695,Staff,0,6,30,30
1650496146676,ECE 109,A01,091882,Touri; Behrouz,37,0,70,33
1650496152698,ECE 180,A00,083140,Abi Samra; Nicholas Camill,21,0,30,9
1650496152698,ECE 180,B00,083141,Abi Samra; Nicholas Camill,0,0,30,30
1650496158733,MATH 10A,A01,083735,Patchell; Gregory David,5,0,30,25
1650496158733,MATH 10A,A02,083736,Patchell; Gregory David,27,0,30,3
1650496158733,MATH 10A,A03,083737,Patchell; Gregory David,25,0,30,5
1650496164755,MATH 10B,A01,083207,Staff,0,8,30,30
1650496164755,MATH 10B,A02,083208,Staff,0,7,30,30
1650496164755,MATH 10B,B01,083739,Staff,13,0,30,17
1650496164755,MATH 10B,B02,083740,Staff,28,0,30,2
1650496170789,MATH 18,A01,083743,Staff,0,0,30,30
1650496170789,MATH 18,A02,083744,Staff,27,0,30,3
1650496170789,MATH 18,A03,083745,Staff,22,0,30,8
1650496170789,MATH 18,A04,083746,Staff,26,0,30,4
1650496170789,MATH 18,B01,083748,Staff,0,11,30,30
1650496170789,MATH 18,B02,083749,Staff,0,12,30,30
1650496170789,MATH 18,B03,083750,Staff,0,11,30,30
1650496170789,MATH 18,B04,083751,Staff,0,12,30,30
1650496176824,MATH 20A,A01,083754,Staff,25,0,40,15
1650496182847,MATH 20B,A01,083756,Staff,0,11,30,30
1650496182847,MATH 20B,A02,083757,Staff,0,11,30,30
1650496188874,MATH 20C,A01,083760,Staff,0,16,30,30
1650496188874,MATH 20C,A02,083761,Staff,2,15,30,28
1650496188874,MATH 20C,B01,083762,Staff,13,0,30,17
1650496188874,MATH 20C,B02,083763,Staff,28,0,30,2
1650496194901,MATH 20D,A01,083765,Staff,0,1,30,30
1650496194901,MATH 20D,A02,083766,Staff,9,0,30,21
1650496194901,MATH 20D,A03,083767,Staff,25,0,30,5
1650496200927,MATH 20E,A01,083771,Staff,6,0,30,24
1650496200927,MATH 20E,A02,083772,Staff,18,0,30,12
1650496200927,MATH 20E,B01,083773,Staff,0,0,30,30
1650496200927,MATH 20E,B02,083774,Staff,10,0,30,20
1650496206951,MATH 103A,A01,083777,Staff,0,12,30,30
1650496206951,MATH 103A,A02,083778,Staff,0,12,30,30
1650496206951,MATH 103A,B01,083779,Staff,0,13,30,30
1650496206951,MATH 103A,B02,083780,Staff,0,13,30,30
1650496212982,MATH 105,A01,085443,Staff,1,23,30,29
1650496219006,MATH 109,A01,083213,Anzaldo; Leesa B,0,7,30,30
1650496219006,MATH 109,A02,083214,Anzaldo; Leesa B,0,7,30,30
1650496219006,MATH 109,B01,083215,Anzaldo; Leesa B,0,5,30,30
1650496219006,MATH 109,B02,083216,Anzaldo; Leesa B,0,6,30,30
1650496225029,MATH 142A,A01,083219,Chow; Bennett,0,15,30,30
1650496225029,MATH 142A,A02,083220,Chow; Bennett,0,13,30,30
1650496225029,MATH 142A,B01,083221,Chow; Bennett,0,12,30,30
1650496225029,MATH 142A,B02,083222,Chow; Bennett,0,13,30,30
1650496231054,MATH 193A,A01,083224,Staff,0,5,30,30
1650496231054,MATH 193A,A02,083225,Staff,0,5,30,30
1650496231054,MATH 193A,A03,083781,Staff,0,5,30,30
1650496231054,MATH 193A,A04,083782,Staff,0,6,30,30
1650496237080,MATH 197,001,091859,McAuley; Julian John,9998,0,9999,1
1650496243127,COGS 9,A01,083615,Staff,0,14,60,60
1650496249153,COGS 11,A01,083617,Boyle; Mary E. T.,20,0,40,20
1650496255176,COGS 13,A01,083071,Staff,0,34,40,40
1650496261200,COGS 14A,A01,092681,Staff,1,25,100,99
1650496267223,COGS 14B,A01,083073,Cheng; Tzu-Han,0,11,50,50
1650496273245,COGS 17,A01,092677,Staff,20,0,75,55
1650496279273,COGS 100,A01,083619,Staff,0,26,60,60
1650496285300,COGS 101A,A01,083621,Davis; Joshua Daniel,0,23,60,60
1650496291325,COGS 101B,A01,091572,Staff,0,4,60,60
1650496297348,COGS 101C,A01,083625,Delgado; Tania,16,0,30,14
1650496303379,COGS 107A,A01,083627,Boyle; Mary E. T.,0,12,60,60
1650496309402,COGS 118A,A01,083075,Staff,0,3,60,60
1650496315429,CSE 3,A50,083646,Miranda; Gregory Joseph,20,0,38,18
1650496315429,CSE 3,A51,083647,Miranda; Gregory Joseph,36,0,37,1
1650496321461,CSE 8A,A50,083650,Miranda; Gregory Joseph,1,28,40,39
1650496327487,CSE 11,A01,083080,Cao; Yingjun,0,91,40,40
1650496333512,CSE 12,A01,083652,Staff,0,17,100,100
1650496339542,CSE 15L,A01,083654,Staff,0,1,50,50
1650496339542,CSE 15L,A02,083655,Staff,0,0,50,50
1650496345563,CSE 20,A01,083657,Staff,51,0,80,29
1650496351589,CSE 30,A01,083084,Eldon; John,0,77,40,40
1650496357612,CSE 100,A01,083659,Cao; Yingjun,0,67,50,50
1650496363642,CSE 134B,A01,083661,Powell; Thomas Allan,0,32,65,65
1650496369666,CSE 140,A01,083663,Staff,0,5,75,75
1650496375692,CSE 140L,A01,083088,Eldon; John,0,9,75,75
1650496381717,CSE 175,A01,083665,Kumar; Rakesh,7,0,25,18
1650496387740,CSE 190,A00,092507,Dubnov; Shlomo,10,0,20,10
1650496393764,ECE 45,A01,083139,Staff,20,19,60,40
1650496399793,ECE 65,A50,083695,Staff,0,6,30,30
1650496405819,ECE 109,A01,091882,Touri; Behrouz,37,0,70,33
1650496411842,ECE 180,A00,083140,Abi Samra; Nicholas Camill,21,0,30,9
1650496411842,ECE 180,B00,083141,Abi Samra; Nicholas Camill,0,0,30,30
1650496417869,MATH 10A,A01,083735,Patchell; Gregory David,5,0,30,25
1650496417869,MATH 10A,A02,083736,Patchell; Gregory David,27,0,30,3
1650496417869,MATH 10A,A03,083737,Patchell; Gregory David,25,0,30,5
1650496423893,MATH 10B,A01,083207,Staff,0,8,30,30
1650496423893,MATH 10B,A02,083208,Staff,0,7,30,30
1650496423893,MATH 10B,B01,083739,Staff,13,0,30,17
1650496423893,MATH 10B,B02,083740,Staff,28,0,30,2
1650496429918,MATH 18,A01,083743,Staff,0,0,30,30
1650496429918,MATH 18,A02,083744,Staff,27,0,30,3
1650496429918,MATH 18,A03,083745,Staff,22,0,30,8
1650496429918,MATH 18,A04,083746,Staff,26,0,30,4
1650496429918,MATH 18,B01,083748,Staff,0,11,30,30
1650496429918,MATH 18,B02,083749,Staff,0,12,30,30
1650496429918,MATH 18,B03,083750,Staff,0,11,30,30
1650496429918,MATH 18,B04,083751,Staff,0,12,30,30
1650496435945,MATH 20A,A01,083754,Staff,25,0,40,15
1650496441981,MATH 20B,A01,083756,Staff,0,11,30,30
1650496441981,MATH 20B,A02,083757,Staff,0,11,30,30
1650496448010,MATH 20C,A01,083760,Staff,0,16,30,30
1650496448010,MATH 20C,A02,083761,Staff,2,15,30,28
1650496448010,MATH 20C,B01,083762,Staff,13,0,30,17
1650496448010,MATH 20C,B02,083763,Staff,28,0,30,2
1650496454036,MATH 20D,A01,083765,Staff,0,1,30,30
1650496454036,MATH 20D,A02,083766,Staff,9,0,30,21
1650496454036,MATH 20D,A03,083767,Staff,25,0,30,5
1650496460059,MATH 20E,A01,083771,Staff,6,0,30,24
1650496460059,MATH 20E,A02,083772,Staff,18,0,30,12
1650496460059,MATH 20E,B01,083773,Staff,0,0,30,30
1650496460059,MATH 20E,B02,083774,Staff,10,0,30,20
1650496466086,MATH 103A,A01,083777,Staff,0,12,30,30
1650496466086,MATH 103A,A02,083778,Staff,0,12,30,30
1650496466086,MATH 103A,B01,083779,Staff,0,13,30,30
1650496466086,MATH 103A,B02,083780,Staff,0,13,30,30
1650496472114,MATH 105,A01,085443,Staff,1,23,30,29
1650496478138,MATH 109,A01,083213,Anzaldo; Leesa B,0,7,30,30
1650496478138,MATH 109,A02,083214,Anzaldo; Leesa B,0,7,30,30
1650496478138,MATH 109,B01,083215,Anzaldo; Leesa B,0,5,30,30
1650496478138,MATH 109,B02,083216,Anzaldo; Leesa B,0,6,30,30
1650496484162,MATH 142A,A01,083219,Chow; Bennett,0,15,30,30
1650496484162,MATH 142A,A02,083220,Chow; Bennett,0,13,30,30
1650496484162,MATH 142A,B01,083221,Chow; Bennett,0,12,30,30
1650496484162,MATH 142A,B02,083222,Chow; Bennett,0,13,30,30
1650496490189,MATH 193A,A01,083224,Staff,0,5,30,30
1650496490189,MATH 193A,A02,083225,Staff,0,5,30,30
1650496490189,MATH 193A,A03,083781,Staff,0,5,30,30
1650496490189,MATH 193A,A04,083782,Staff,0,6,30,30
1650496496212,MATH 197,001,091859,McAuley; Julian John,9998,0,9999,1
1650496502260,COGS 9,A01,083615,Staff,0,14,60,60
1650496508298,COGS 11,A01,083617,Boyle; Mary E. T.,20,0,40,20
1650496514319,COGS 13,A01,083071,Staff,0,34,40,40
1650496520354,COGS 14A,A01,092681,Staff,1,25,100,99
1650496526376,COGS 14B,A01,083073,Cheng; Tzu-Han,0,11,50,50
1650496532401,COGS 17,A01,092677,Staff,20,0,75,55
1650496538435,COGS 100,A01,083619,Staff,0,26,60,60
1650496544461,COGS 101A,A01,083621,Davis; Joshua Daniel,0,23,60,60
1650496550580,COGS 101B,A01,091572,Staff,0,4,60,60
1650496556604,COGS 101C,A01,083625,Delgado; Tania,16,0,30,14
1650496562628,COGS 107A,A01,083627,Boyle; Mary E. T.,0,12,60,60
1650496568653,COGS 118A,A01,083075,Staff,0,3,60,60
1650496574677,CSE 3,A50,083646,Miranda; Gregory Joseph,20,0,38,18
1650496574677,CSE 3,A51,083647,Miranda; Gregory Joseph,36,0,37,1
1650496580704,CSE 8A,A50,083650,Miranda; Gregory Joseph,1,28,40,39
1650496586728,CSE 11,A01,083080,Cao; Yingjun,0,91,40,40
1650496592751,CSE 12,A01,083652,Staff,0,17,100,100
1650496598774,CSE 15L,A01,083654,Staff,0,1,50,50
1650496598774,CSE 15L,A02,083655,Staff,0,0,50,50
1650496604797,CSE 20,A01,083657,Staff,51,0,80,29
1650496610822,CSE 30,A01,083084,Eldon; John,0,77,40,40
1650496616853,CSE 100,A01,083659,Cao; Yingjun,0,67,50,50
1650496622882,CSE 134B,A01,083661,Powell; Thomas Allan,0,32,65,65
1650496628906,CSE 140,A01,083663,Staff,0,5,75,75
1650496634932,CSE 140L,A01,083088,Eldon; John,0,9,75,75
1650496640955,CSE 175,A01,083665,Kumar; Rakesh,7,0,25,18
1650496646981,CSE 190,A00,092507,Dubnov; Shlomo,10,0,20,10
1650496653003,ECE 45,A01,083139,Staff,20,19,60,40
1650496659039,ECE 65,A50,083695,Staff,0,6,30,30
1650496665063,ECE 109,A01,091882,Touri; Behrouz,37,0,70,33
1650496671097,ECE 180,A00,083140,Abi Samra; Nicholas Camill,21,0,30,9
1650496671097,ECE 180,B00,083141,Abi Samra; Nicholas Camill,0,0,30,30
1650496677120,MATH 10A,A01,083735,Patchell; Gregory David,5,0,30,25
1650496677120,MATH 10A,A02,083736,Patchell; Gregory David,27,0,30,3
1650496677120,MATH 10A,A03,083737,Patchell; Gregory David,25,0,30,5
1650496683143,MATH 10B,A01,083207,Staff,0,8,30,30
1650496683143,MATH 10B,A02,083208,Staff,0,7,30,30
1650496683143,MATH 10B,B01,083739,Staff,13,0,30,17
1650496683143,MATH 10B,B02,083740,Staff,28,0,30,2
1650496689173,MATH 18,A01,083743,Staff,0,0,30,30
1650496689173,MATH 18,A02,083744,Staff,27,0,30,3
1650496689173,MATH 18,A03,083745,Staff,22,0,30,8
1650496689173,MATH 18,A04,083746,Staff,26,0,30,4
1650496689173,MATH 18,B01,083748,Staff,0,11,30,30
1650496689173,MATH 18,B02,083749,Staff,0,12,30,30
1650496689173,MATH 18,B03,083750,Staff,0,11,30,30
1650496689173,MATH 18,B04,083751,Staff,0,12,30,30
1650496695206,MATH 20A,A01,083754,Staff,25,0,40,15
1650496701233,MATH 20B,A01,083756,Staff,0,11,30,30
1650496701233,MATH 20B,A02,083757,Staff,0,11,30,30
1650496707262,MATH 20C,A01,083760,Staff,0,16,30,30
1650496707262,MATH 20C,A02,083761,Staff,2,15,30,28
1650496707262,MATH 20C,B01,083762,Staff,13,0,30,17
1650496707262,MATH 20C,B02,083763,Staff,28,0,30,2
1650496713286,MATH 20D,A01,083765,Staff,0,1,30,30
1650496713286,MATH 20D,A02,083766,Staff,9,0,30,21
1650496713286,MATH 20D,A03,083767,Staff,25,0,30,5
1650496719310,MATH 20E,A01,083771,Staff,6,0,30,24
1650496719310,MATH 20E,A02,083772,Staff,18,0,30,12
1650496719310,MATH 20E,B01,083773,Staff,0,0,30,30
1650496719310,MATH 20E,B02,083774,Staff,10,0,30,20
1650496725333,MATH 103A,A01,083777,Staff,0,12,30,30
1650496725333,MATH 103A,A02,083778,Staff,0,12,30,30
1650496725333,MATH 103A,B01,083779,Staff,0,13,30,30
1650496725333,MATH 103A,B02,083780,Staff,0,13,30,30
1650496731356,MATH 105,A01,085443,Staff,1,23,30,29
1650496737383,MATH 109,A01,083213,Anzaldo; Leesa B,0,7,30,30
1650496737383,MATH 109,A02,083214,Anzaldo; Leesa B,0,7,30,30
1650496737383,MATH 109,B01,083215,Anzaldo; Leesa B,0,5,30,30
1650496737383,MATH 109,B02,083216,Anzaldo; Leesa B,0,6,30,30
1650496743412,MATH 142A,A01,083219,Chow; Bennett,0,15,30,30
1650496743412,MATH 142A,A02,083220,Chow; Bennett,0,13,30,30
1650496743412,MATH 142A,B01,083221,Chow; Bennett,0,12,30,30
1650496743412,MATH 142A,B02,083222,Chow; Bennett,0,13,30,30
1650496749434,MATH 193A,A01,083224,Staff,0,5,30,30
1650496749434,MATH 193A,A02,083225,Staff,0,5,30,30
1650496749434,MATH 193A,A03,083781,Staff,0,5,30,30
1650496749434,MATH 193A,A04,083782,Staff,0,6,30,30
1650496755459,MATH 197,001,091859,McAuley; Julian John,9998,0,9999,1
1650496761506,COGS 9,A01,083615,Staff,0,14,60,60
1650496767528,COGS 11,A01,083617,Boyle; Mary E. T.,20,0,40,20
1650496773554,COGS 13,A01,083071,Staff,0,34,40,40
1650496779583,COGS 14A,A01,092681,Staff,1,25,100,99
1650496785606,COGS 14B,A01,083073,Cheng; Tzu-Han,0,11,50,50
1650496791631,COGS 17,A01,092677,Staff,20,0,75,55
1650496797657,COGS 100,A01,083619,Staff,0,26,60,60
1650496803682,COGS 101A,A01,083621,Davis; Joshua Daniel,0,23,60,60
1650496809706,COGS 101B,A01,091572,Staff,0,4,60,60
1650496815740,COGS 101C,A01,083625,Delgado; Tania,16,0,30,14
1650496821765,COGS 107A,A01,083627,Boyle; Mary E. T.,0,12,60,60
1650496827790,COGS 118A,A01,083075,Staff,0,3,60,60
1650496833813,CSE 3,A50,083646,Miranda; Gregory Joseph,20,0,38,18
1650496833813,CSE 3,A51,083647,Miranda; Gregory Joseph,36,0,37,1
1650496839838,CSE 8A,A50,083650,Miranda; Gregory Joseph,1,28,40,39
1650496845861,CSE 11,A01,083080,Cao; Yingjun,0,91,40,40
1650496851892,CSE 12,A01,083652,Staff,0,17,100,100
1650496857929,CSE 15L,A01,083654,Staff,0,1,50,50
1650496857929,CSE 15L,A02,083655,Staff,0,0,50,50
1650496863954,CSE 20,A01,083657,Staff,51,0,80,29
1650496869980,CSE 30,A01,083084,Eldon; John,0,77,40,40
1650496876009,CSE 100,A01,083659,Cao; Yingjun,0,67,50,50
1650496882033,CSE 134B,A01,083661,Powell; Thomas Allan,0,32,65,65
1650496888058,CSE 140,A01,083663,Staff,0,5,75,75
1650496894082,CSE 140L,A01,083088,Eldon; John,0,10,75,75
1650496900109,CSE 175,A01,083665,Kumar; Rakesh,7,0,25,18
1650496906131,CSE 190,A00,092507,Dubnov; Shlomo,10,0,20,10
1650496912155,ECE 45,A01,083139,Staff,20,19,60,40
1650496918180,ECE 65,A50,083695,Staff,0,6,30,30
1650496924206,ECE 109,A01,091882,Touri; Behrouz,37,0,70,33
1650496930229,ECE 180,A00,083140,Abi Samra; Nicholas Camill,21,0,30,9
1650496930229,ECE 180,B00,083141,Abi Samra; Nicholas Camill,0,0,30,30
1650496936252,MATH 10A,A01,083735,Patchell; Gregory David,5,0,30,25
1650496936252,MATH 10A,A02,083736,Patchell; Gregory David,27,0,30,3
1650496936252,MATH 10A,A03,083737,Patchell; Gregory David,25,0,30,5
1650496942279,MATH 10B,A01,083207,Staff,0,8,30,30
1650496942279,MATH 10B,A02,083208,Staff,0,7,30,30
1650496942279,MATH 10B,B01,083739,Staff,13,0,30,17
1650496942279,MATH 10B,B02,083740,Staff,28,0,30,2
1650496948302,MATH 18,A01,083743,Staff,0,0,30,30
1650496948302,MATH 18,A02,083744,Staff,27,0,30,3
1650496948302,MATH 18,A03,083745,Staff,22,0,30,8
1650496948302,MATH 18,A04,083746,Staff,26,0,30,4
1650496948302,MATH 18,B01,083748,Staff,0,11,30,30
1650496948302,MATH 18,B02,083749,Staff,0,12,30,30
1650496948302,MATH 18,B03,083750,Staff,0,11,30,30
1650496948302,MATH 18,B04,083751,Staff,0,12,30,30
1650496954325,MATH 20A,A01,083754,Staff,25,0,40,15
1650496960351,MATH 20B,A01,083756,Staff,0,11,30,30
1650496960351,MATH 20B,A02,083757,Staff,0,11,30,30
1650496966375,MATH 20C,A01,083760,Staff,0,16,30,30
1650496966375,MATH 20C,A02,083761,Staff,2,15,30,28
1650496966375,MATH 20C,B01,083762,Staff,13,0,30,17
1650496966375,MATH 20C,B02,083763,Staff,28,0,30,2
1650496972406,MATH 20D,A01,083765,Staff,0,1,30,30
1650496972406,MATH 20D,A02,083766,Staff,9,0,30,21
1650496972406,MATH 20D,A03,083767,Staff,25,0,30,5
1650496978435,MATH 20E,A01,083771,Staff,6,0,30,24
1650496978435,MATH 20E,A02,083772,Staff,18,0,30,12
1650496978435,MATH 20E,B01,083773,Staff,0,0,30,30
1650496978435,MATH 20E,B02,083774,Staff,10,0,30,20
1650496984457,MATH 103A,A01,083777,Staff,0,12,30,30
1650496984457,MATH 103A,A02,083778,Staff,0,12,30,30
1650496984457,MATH 103A,B01,083779,Staff,0,13,30,30
1650496984457,MATH 103A,B02,083780,Staff,0,13,30,30
1650496990483,MATH 105,A01,085443,Staff,1,23,30,29
1650496996507,MATH 109,A01,083213,Anzaldo; Leesa B,0,7,30,30
1650496996507,MATH 109,A02,083214,Anzaldo; Leesa B,0,7,30,30
1650496996507,MATH 109,B01,083215,Anzaldo; Leesa B,0,5,30,30
1650496996507,MATH 109,B02,083216,Anzaldo; Leesa B,0,6,30,30
1650497002542,MATH 142A,A01,083219,Chow; Bennett,0,15,30,30
1650497002542,MATH 142A,A02,083220,Chow; Bennett,0,13,30,30
1650497002542,MATH 142A,B01,083221,Chow; Bennett,0,12,30,30
1650497002542,MATH 142A,B02,083222,Chow; Bennett,0,13,30,30
1650497008573,MATH 193A,A01,083224,Staff,0,5,30,30
1650497008573,MATH 193A,A02,083225,Staff,0,5,30,30
1650497008573,MATH 193A,A03,083781,Staff,0,5,30,30
1650497008573,MATH 193A,A04,083782,Staff,0,6,30,30
1650497014599,MATH 197,001,091859,McAuley; Julian John,9998,0,9999,1
1650497020667,COGS 9,A01,083615,Staff,0,14,60,60
1650497026693,COGS 11,A01,083617,Boyle; Mary E. T.,20,0,40,20
1650497032721,COGS 13,A01,083071,Staff,0,34,40,40
1650497038748,COGS 14A,A01,092681,Staff,1,25,100,99
1650497044771,COGS 14B,A01,083073,Cheng; Tzu-Han,0,11,50,50
1650497050795,COGS 17,A01,092677,Staff,20,0,75,55
1650497056828,COGS 100,A01,083619,Staff,0,26,60,60
1650497062852,COGS 101A,A01,083621,Davis; Joshua Daniel,0,23,60,60
1650497068875,COGS 101B,A01,091572,Staff,0,4,60,60
1650497074901,COGS 101C,A01,083625,Delgado; Tania,16,0,30,14
1650497080923,COGS 107A,A01,083627,Boyle; Mary E. T.,0,12,60,60
1650497086951,COGS 118A,A01,083075,Staff,0,3,60,60
1650497092982,CSE 3,A50,083646,Miranda; Gregory Joseph,20,0,38,18
1650497092982,CSE 3,A51,083647,Miranda; Gregory Joseph,36,0,37,1
1650497099013,CSE 8A,A50,083650,Miranda; Gregory Joseph,1,28,40,39
1650497105037,CSE 11,A01,083080,Cao; Yingjun,0,91,40,40
1650497111068,CSE 12,A01,083652,Staff,0,17,100,100
1650497117104,CSE 15L,A01,083654,Staff,0,1,50,50
1650497117104,CSE 15L,A02,083655,Staff,0,0,50,50
1650497123144,CSE 20,A01,083657,Staff,51,0,80,29
1650497129170,CSE 30,A01,083084,Eldon; John,0,77,40,40
1650497135193,CSE 100,A01,083659,Cao; Yingjun,0,67,50,50
1650497141220,CSE 134B,A01,083661,Powell; Thomas Allan,0,32,65,65
1650497147333,CSE 140,A01,083663,Staff,0,5,75,75
1650497153356,CSE 140L,A01,083088,Eldon; John,0,10,75,75
1650497159382,CSE 175,A01,083665,Kumar; Rakesh,7,0,25,18
1650497165405,CSE 190,A00,092507,Dubnov; Shlomo,10,0,20,10
1650497171428,ECE 45,A01,083139,Staff,20,19,60,40
1650497177451,ECE 65,A50,083695,Staff,0,6,30,30
1650497183479,ECE 109,A01,091882,Touri; Behrouz,37,0,70,33
1650497189502,ECE 180,A00,083140,Abi Samra; Nicholas Camill,21,0,30,9
1650497189502,ECE 180,B00,083141,Abi Samra; Nicholas Camill,0,0,30,30
1650497195526,MATH 10A,A01,083735,Patchell; Gregory David,5,0,30,25
1650497195526,MATH 10A,A02,083736,Patchell; Gregory David,27,0,30,3
1650497195526,MATH 10A,A03,083737,Patchell; Gregory David,25,0,30,5
1650497201550,MATH 10B,A01,083207,Staff,0,8,30,30
1650497201550,MATH 10B,A02,083208,Staff,0,7,30,30
1650497201550,MATH 10B,B01,083739,Staff,13,0,30,17
1650497201550,MATH 10B,B02,083740,Staff,28,0,30,2
1650497207580,MATH 18,A01,083743,Staff,0,0,30,30
1650497207580,MATH 18,A02,083744,Staff,27,0,30,3
1650497207580,MATH 18,A03,083745,Staff,22,0,30,8
1650497207580,MATH 18,A04,083746,Staff,26,0,30,4
1650497207580,MATH 18,B01,083748,Staff,0,11,30,30
1650497207580,MATH 18,B02,083749,Staff,0,12,30,30
1650497207580,MATH 18,B03,083750,Staff,0,11,30,30
1650497207580,MATH 18,B04,083751,Staff,0,12,30,30
1650497213615,MATH 20A,A01,083754,Staff,25,0,40,15
1650497219645,MATH 20B,A01,083756,Staff,0,11,30,30
1650497219645,MATH 20B,A02,083757,Staff,0,11,30,30
1650497225669,MATH 20C,A01,083760,Staff,0,16,30,30
1650497225669,MATH 20C,A02,083761,Staff,2,15,30,28
1650497225669,MATH 20C,B01,083762,Staff,13,0,30,17
1650497225669,MATH 20C,B02,083763,Staff,28,0,30,2
1650497231704,MATH 20D,A01,083765,Staff,0,1,30,30
1650497231704,MATH 20D,A02,083766,Staff,9,0,30,21
1650497231704,MATH 20D,A03,083767,Staff,25,0,30,5
1650497237732,MATH 20E,A01,083771,Staff,6,0,30,24
1650497237732,MATH 20E,A02,083772,Staff,18,0,30,12
1650497237732,MATH 20E,B01,083773,Staff,0,0,30,30
1650497237732,MATH 20E,B02,083774,Staff,10,0,30,20
1650497243761,MATH 103A,A01,083777,Staff,0,12,30,30
1650497243761,MATH 103A,A02,083778,Staff,0,12,30,30
1650497243761,MATH 103A,B01,083779,Staff,0,13,30,30
1650497243761,MATH 103A,B02,083780,Staff,0,13,30,30
1650497249784,MATH 105,A01,085443,Staff,1,23,30,29
1650497255812,MATH 109,A01,083213,Anzaldo; Leesa B,0,7,30,30
1650497255812,MATH 109,A02,083214,Anzaldo; Leesa B,0,7,30,30
1650497255812,MATH 109,B01,083215,Anzaldo; Leesa B,0,5,30,30
1650497255812,MATH 109,B02,083216,Anzaldo; Leesa B,0,6,30,30
1650497261837,MATH 142A,A01,083219,Chow; Bennett,0,15,30,30
1650497261837,MATH 142A,A02,083220,Chow; Bennett,0,13,30,30
1650497261837,MATH 142A,B01,083221,Chow; Bennett,0,12,30,30
1650497261837,MATH 142A,B02,083222,Chow; Bennett,0,13,30,30
1650497267864,MATH 193A,A01,083224,Staff,0,5,30,30
1650497267864,MATH 193A,A02,083225,Staff,0,5,30,30
1650497267864,MATH 193A,A03,083781,Staff,0,5,30,30
1650497267864,MATH 193A,A04,083782,Staff,0,6,30,30
1650497273889,MATH 197,001,091859,McAuley; Julian John,9998,0,9999,1
1650497279941,COGS 9,A01,083615,Staff,0,14,60,60
1650497285965,COGS 11,A01,083617,Boyle; Mary E. T.,20,0,40,20
1650497291988,COGS 13,A01,083071,Staff,0,34,40,40
1650497298012,COGS 14A,A01,092681,Staff,1,25,100,99
1650497304044,COGS 14B,A01,083073,Cheng; Tzu-Han,0,11,50,50
1650497310068,COGS 17,A01,092677,Staff,20,0,75,55
1650497316091,COGS 100,A01,083619,Staff,0,26,60,60
1650497322123,COGS 101A,A01,083621,Davis; Joshua Daniel,0,23,60,60
1650497328148,COGS 101B,A01,091572,Staff,0,4,60,60
1650497334176,COGS 101C,A01,083625,Delgado; Tania,16,0,30,14
1650497340203,COGS 107A,A01,083627,Boyle; Mary E. T.,0,12,60,60
1650497346233,COGS 118A,A01,083075,Staff,0,3,60,60
1650497352261,CSE 3,A50,083646,Miranda; Gregory Joseph,20,0,38,18
1650497352261,CSE 3,A51,083647,Miranda; Gregory Joseph,36,0,37,1
1650497358288,CSE 8A,A50,083650,Miranda; Gregory Joseph,1,28,40,39
1650497364311,CSE 11,A01,083080,Cao; Yingjun,0,91,40,40
1650497370332,CSE 12,A01,083652,Staff,0,17,100,100
1650497376357,CSE 15L,A01,083654,Staff,0,1,50,50
1650497376357,CSE 15L,A02,083655,Staff,0,0,50,50
1650497382385,CSE 20,A01,083657,Staff,51,0,80,29
1650497388410,CSE 30,A01,083084,Eldon; John,0,77,40,40
1650497394431,CSE 100,A01,083659,Cao; Yingjun,0,67,50,50
1650497400454,CSE 134B,A01,083661,Powell; Thomas Allan,0,32,65,65
1650497406479,CSE 140,A01,083663,Staff,0,5,75,75
1650497412512,CSE 140L,A01,083088,Eldon; John,0,10,75,75
1650497418536,CSE 175,A01,083665,Kumar; Rakesh,7,0,25,18
1650497424561,CSE 190,A00,092507,Dubnov; Shlomo,10,0,20,10
1650497430591,ECE 45,A01,083139,Staff,20,19,60,40
1650497436614,ECE 65,A50,083695,Staff,0,6,30,30
1650497442636,ECE 109,A01,091882,Touri; Behrouz,37,0,70,33
1650497448661,ECE 180,A00,083140,Abi Samra; Nicholas Camill,21,0,30,9
1650497448661,ECE 180,B00,083141,Abi Samra; Nicholas Camill,0,0,30,30
1650497454684,MATH 10A,A01,083735,Patchell; Gregory David,5,0,30,25
1650497454684,MATH 10A,A02,083736,Patchell; Gregory David,27,0,30,3
1650497454684,MATH 10A,A03,083737,Patchell; Gregory David,25,0,30,5
1650497460707,MATH 10B,A01,083207,Staff,0,8,30,30
1650497460707,MATH 10B,A02,083208,Staff,0,7,30,30
1650497460707,MATH 10B,B01,083739,Staff,13,0,30,17
1650497460707,MATH 10B,B02,083740,Staff,28,0,30,2
1650497466732,MATH 18,A01,083743,Staff,0,0,30,30
1650497466732,MATH 18,A02,083744,Staff,27,0,30,3
1650497466732,MATH 18,A03,083745,Staff,22,0,30,8
1650497466732,MATH 18,A04,083746,Staff,26,0,30,4
1650497466732,MATH 18,B01,083748,Staff,0,11,30,30
1650497466732,MATH 18,B02,083749,Staff,0,12,30,30
1650497466732,MATH 18,B03,083750,Staff,0,11,30,30
1650497466732,MATH 18,B04,083751,Staff,0,12,30,30
1650497472755,MATH 20A,A01,083754,Staff,25,0,40,15
1650497478779,MATH 20B,A01,083756,Staff,0,11,30,30
1650497478779,MATH 20B,A02,083757,Staff,0,11,30,30
1650497484804,MATH 20C,A01,083760,Staff,0,16,30,30
1650497484804,MATH 20C,A02,083761,Staff,2,15,30,28
1650497484804,MATH 20C,B01,083762,Staff,13,0,30,17
1650497484804,MATH 20C,B02,083763,Staff,28,0,30,2
1650497490836,MATH 20D,A01,083765,Staff,0,1,30,30
1650497490836,MATH 20D,A02,083766,Staff,9,0,30,21
1650497490836,MATH 20D,A03,083767,Staff,25,0,30,5
1650497496861,MATH 20E,A01,083771,Staff,6,0,30,24
1650497496861,MATH 20E,A02,083772,Staff,18,0,30,12
1650497496861,MATH 20E,B01,083773,Staff,0,0,30,30
1650497496861,MATH 20E,B02,083774,Staff,10,0,30,20
1650497502887,MATH 103A,A01,083777,Staff,0,12,30,30
1650497502887,MATH 103A,A02,083778,Staff,0,12,30,30
1650497502887,MATH 103A,B01,083779,Staff,0,13,30,30
1650497502887,MATH 103A,B02,083780,Staff,0,13,30,30
1650497508919,MATH 105,A01,085443,Staff,1,23,30,29
1650497514943,MATH 109,A01,083213,Anzaldo; Leesa B,0,7,30,30
1650497514943,MATH 109,A02,083214,Anzaldo; Leesa B,0,7,30,30
1650497514943,MATH 109,B01,083215,Anzaldo; Leesa B,0,5,30,30
1650497514943,MATH 109,B02,083216,Anzaldo; Leesa B,0,6,30,30
1650497520968,MATH 142A,A01,083219,Chow; Bennett,0,15,30,30
1650497520968,MATH 142A,A02,083220,Chow; Bennett,0,13,30,30
1650497520968,MATH 142A,B01,083221,Chow; Bennett,0,12,30,30
1650497520968,MATH 142A,B02,083222,Chow; Bennett,0,13,30,30
1650497526992,MATH 193A,A01,083224,Staff,0,5,30,30
1650497526992,MATH 193A,A02,083225,Staff,0,5,30,30
1650497526992,MATH 193A,A03,083781,Staff,0,5,30,30
1650497526992,MATH 193A,A04,083782,Staff,0,6,30,30
1650497533016,MATH 197,001,091859,McAuley; Julian John,9998,0,9999,1
1650497539067,COGS 9,A01,083615,Staff,0,14,60,60
1650497545094,COGS 11,A01,083617,Boyle; Mary E. T.,20,0,40,20
1650497551117,COGS 13,A01,083071,Staff,0,34,40,40
1650497557142,COGS 14A,A01,092681,Staff,1,25,100,99
1650497563176,COGS 14B,A01,083073,Cheng; Tzu-Han,0,11,50,50
1650497569201,COGS 17,A01,092677,Staff,20,0,75,55
1650497575223,COGS 100,A01,083619,Staff,0,26,60,60
1650497581252,COGS 101A,A01,083621,Davis; Joshua Daniel,0,23,60,60
1650497587277,COGS 101B,A01,091572,Staff,0,4,60,60
1650497593306,COGS 101C,A01,083625,Delgado; Tania,16,0,30,14
1650497599341,COGS 107A,A01,083627,Boyle; Mary E. T.,0,12,60,60
1650497605370,COGS 118A,A01,083075,Staff,0,3,60,60
1650497611398,CSE 3,A50,083646,Miranda; Gregory Joseph,20,0,38,18
1650497611398,CSE 3,A51,083647,Miranda; Gregory Joseph,36,0,37,1
1650497617425,CSE 8A,A50,083650,Miranda; Gregory Joseph,1,28,40,39
1650497623450,CSE 11,A01,083080,Cao; Yingjun,0,91,40,40
1650497629478,CSE 12,A01,083652,Staff,0,17,100,100
1650497635504,CSE 15L,A01,083654,Staff,0,1,50,50
1650497635504,CSE 15L,A02,083655,Staff,0,0,50,50
1650497641528,CSE 20,A01,083657,Staff,51,0,80,29
1650497647567,CSE 30,A01,083084,Eldon; John,0,77,40,40
1650497653591,CSE 100,A01,083659,Cao; Yingjun,0,67,50,50
1650497659622,CSE 134B,A01,083661,Powell; Thomas Allan,0,32,65,65
1650497665646,CSE 140,A01,083663,Staff,0,5,75,75
1650497671673,CSE 140L,A01,083088,Eldon; John,0,10,75,75
1650497677697,CSE 175,A01,083665,Kumar; Rakesh,7,0,25,18
1650497683727,CSE 190,A00,092507,Dubnov; Shlomo,10,0,20,10
1650497689750,ECE 45,A01,083139,Staff,20,19,60,40
1650497695774,ECE 65,A50,083695,Staff,0,6,30,30
1650497701800,ECE 109,A01,091882,Touri; Behrouz,37,0,70,33
1650497707823,ECE 180,A00,083140,Abi Samra; Nicholas Camill,21,0,30,9
1650497707823,ECE 180,B00,083141,Abi Samra; Nicholas Camill,0,0,30,30
1650497713852,MATH 10A,A01,083735,Patchell; Gregory David,5,0,30,25
1650497713852,MATH 10A,A02,083736,Patchell; Gregory David,27,0,30,3
1650497713852,MATH 10A,A03,083737,Patchell; Gregory David,25,0,30,5
1650497719880,MATH 10B,A01,083207,Staff,0,8,30,30
1650497719880,MATH 10B,A02,083208,Staff,0,7,30,30
1650497719880,MATH 10B,B01,083739,Staff,13,0,30,17
1650497719880,MATH 10B,B02,083740,Staff,28,0,30,2
1650497725908,MATH 18,A01,083743,Staff,0,0,30,30
1650497725908,MATH 18,A02,083744,Staff,27,0,30,3
1650497725908,MATH 18,A03,083745,Staff,22,0,30,8
1650497725908,MATH 18,A04,083746,Staff,26,0,30,4
1650497725908,MATH 18,B01,083748,Staff,0,11,30,30
1650497725908,MATH 18,B02,083749,Staff,0,12,30,30
1650497725908,MATH 18,B03,083750,Staff,0,11,30,30
1650497725908,MATH 18,B04,083751,Staff,0,12,30,30
1650497731932,MATH 20A,A01,083754,Staff,25,0,40,15
1650497737960,MATH 20B,A01,083756,Staff,0,11,30,30
1650497737960,MATH 20B,A02,083757,Staff,0,11,30,30
1650497744093,MATH 20C,A01,083760,Staff,0,16,30,30
1650497744093,MATH 20C,A02,083761,Staff,2,15,30,28
1650497744093,MATH 20C,B01,083762,Staff,13,0,30,17
1650497744093,MATH 20C,B02,083763,Staff,28,0,30,2
1650497750120,MATH 20D,A01,083765,Staff,0,1,30,30
1650497750120,MATH 20D,A02,083766,Staff,9,0,30,21
1650497750120,MATH 20D,A03,083767,Staff,25,0,30,5
1650497756145,MATH 20E,A01,083771,Staff,6,0,30,24
1650497756145,MATH 20E,A02,083772,Staff,18,0,30,12
1650497756145,MATH 20E,B01,083773,Staff,0,0,30,30
1650497756145,MATH 20E,B02,083774,Staff,10,0,30,20
1650497762169,MATH 103A,A01,083777,Staff,0,12,30,30
1650497762169,MATH 103A,A02,083778,Staff,0,12,30,30
1650497762169,MATH 103A,B01,083779,Staff,0,13,30,30
1650497762169,MATH 103A,B02,083780,Staff,0,13,30,30
1650497768196,MATH 105,A01,085443,Staff,1,23,30,29
1650497774223,MATH 109,A01,083213,Anzaldo; Leesa B,0,7,30,30
1650497774223,MATH 109,A02,083214,Anzaldo; Leesa B,0,7,30,30
1650497774223,MATH 109,B01,083215,Anzaldo; Leesa B,0,5,30,30
1650497774223,MATH 109,B02,083216,Anzaldo; Leesa B,0,6,30,30
1650497780247,MATH 142A,A01,083219,Chow; Bennett,0,15,30,30
1650497780247,MATH 142A,A02,083220,Chow; Bennett,0,13,30,30
1650497780247,MATH 142A,B01,083221,Chow; Bennett,0,12,30,30
1650497780247,MATH 142A,B02,083222,Chow; Bennett,0,13,30,30
1650497786281,MATH 193A,A01,083224,Staff,0,5,30,30
1650497786281,MATH 193A,A02,083225,Staff,0,5,30,30
1650497786281,MATH 193A,A03,083781,Staff,0,5,30,30
1650497786281,MATH 193A,A04,083782,Staff,0,6,30,30
1650497792308,MATH 197,001,091859,McAuley; Julian John,9998,0,9999,1
1650497798361,COGS 9,A01,083615,Staff,0,14,60,60
1650497804387,COGS 11,A01,083617,Boyle; Mary E. T.,20,0,40,20
1650497810411,COGS 13,A01,083071,Staff,0,34,40,40
1650497816435,COGS 14A,A01,092681,Staff,1,25,100,99
1650497822459,COGS 14B,A01,083073,Cheng; Tzu-Han,0,11,50,50
1650497828483,COGS 17,A01,092677,Staff,20,0,75,55
1650497834505,COGS 100,A01,083619,Staff,0,26,60,60
1650497840529,COGS 101A,A01,083621,Davis; Joshua Daniel,0,23,60,60
1650497846554,COGS 101B,A01,091572,Staff,0,4,60,60
1650497852578,COGS 101C,A01,083625,Delgado; Tania,16,0,30,14
1650497858612,COGS 107A,A01,083627,Boyle; Mary E. T.,0,12,60,60
1650497864637,COGS 118A,A01,083075,Staff,0,3,60,60
1650497870665,CSE 3,A50,083646,Miranda; Gregory Joseph,20,0,38,18
1650497870665,CSE 3,A51,083647,Miranda; Gregory Joseph,36,0,37,1
1650497876689,CSE 8A,A50,083650,Miranda; Gregory Joseph,1,28,40,39
1650497882714,CSE 11,A01,083080,Cao; Yingjun,0,91,40,40
1650497888737,CSE 12,A01,083652,Staff,0,17,100,100
1650497894763,CSE 15L,A01,083654,Staff,0,1,50,50
1650497894763,CSE 15L,A02,083655,Staff,0,0,50,50
1650497900789,CSE 20,A01,083657,Staff,51,0,80,29
1650497906817,CSE 30,A01,083084,Eldon; John,0,77,40,40
1650497912844,CSE 100,A01,083659,Cao; Yingjun,0,67,50,50
1650497918868,CSE 134B,A01,083661,Powell; Thomas Allan,0,32,65,65
1650497924891,CSE 140,A01,083663,Staff,0,5,75,75
1650497930918,CSE 140L,A01,083088,Eldon; John,0,10,75,75
1650497936945,CSE 175,A01,083665,Kumar; Rakesh,7,0,25,18
1650497942976,CSE 190,A00,092507,Dubnov; Shlomo,10,0,20,10
1650497949010,ECE 45,A01,083139,Staff,20,19,60,40
1650497955034,ECE 65,A50,083695,Staff,0,6,30,30
1650497961060,ECE 109,A01,091882,Touri; Behrouz,37,0,70,33
1650497967083,ECE 180,A00,083140,Abi Samra; Nicholas Camill,21,0,30,9
1650497967083,ECE 180,B00,083141,Abi Samra; Nicholas Camill,0,0,30,30
1650497973111,MATH 10A,A01,083735,Patchell; Gregory David,5,0,30,25
1650497973111,MATH 10A,A02,083736,Patchell; Gregory David,27,0,30,3
1650497973111,MATH 10A,A03,083737,Patchell; Gregory David,25,0,30,5
1650497979137,MATH 10B,A01,083207,Staff,0,8,30,30
1650497979137,MATH 10B,A02,083208,Staff,0,7,30,30
1650497979137,MATH 10B,B01,083739,Staff,13,0,30,17
1650497979137,MATH 10B,B02,083740,Staff,28,0,30,2
1650497985162,MATH 18,A01,083743,Staff,0,0,30,30
1650497985162,MATH 18,A02,083744,Staff,27,0,30,3
1650497985162,MATH 18,A03,083745,Staff,22,0,30,8
1650497985162,MATH 18,A04,083746,Staff,26,0,30,4
1650497985162,MATH 18,B01,083748,Staff,0,11,30,30
1650497985162,MATH 18,B02,083749,Staff,0,12,30,30
1650497985162,MATH 18,B03,083750,Staff,0,11,30,30
1650497985162,MATH 18,B04,083751,Staff,0,12,30,30
1650497991189,MATH 20A,A01,083754,Staff,25,0,40,15
1650497997218,MATH 20B,A01,083756,Staff,0,11,30,30
1650497997218,MATH 20B,A02,083757,Staff,0,11,30,30
1650498003247,MATH 20C,A01,083760,Staff,0,16,30,30
1650498003247,MATH 20C,A02,083761,Staff,2,15,30,28
1650498003247,MATH 20C,B01,083762,Staff,13,0,30,17
1650498003247,MATH 20C,B02,083763,Staff,28,0,30,2
1650498009276,MATH 20D,A01,083765,Staff,0,1,30,30
1650498009276,MATH 20D,A02,083766,Staff,9,0,30,21
1650498009276,MATH 20D,A03,083767,Staff,25,0,30,5
1650498015317,MATH 20E,A01,083771,Staff,6,0,30,24
1650498015317,MATH 20E,A02,083772,Staff,18,0,30,12
1650498015317,MATH 20E,B01,083773,Staff,0,0,30,30
1650498015317,MATH 20E,B02,083774,Staff,10,0,30,20
1650498021348,MATH 103A,A01,083777,Staff,0,12,30,30
1650498021348,MATH 103A,A02,083778,Staff,0,12,30,30
1650498021348,MATH 103A,B01,083779,Staff,0,13,30,30
1650498021348,MATH 103A,B02,083780,Staff,0,13,30,30
1650498027372,MATH 105,A01,085443,Staff,1,23,30,29
1650498033395,MATH 109,A01,083213,Anzaldo; Leesa B,0,7,30,30
1650498033395,MATH 109,A02,083214,Anzaldo; Leesa B,0,7,30,30
1650498033395,MATH 109,B01,083215,Anzaldo; Leesa B,0,5,30,30
1650498033395,MATH 109,B02,083216,Anzaldo; Leesa B,0,6,30,30
1650498039419,MATH 142A,A01,083219,Chow; Bennett,0,15,30,30
1650498039419,MATH 142A,A02,083220,Chow; Bennett,0,13,30,30
1650498039419,MATH 142A,B01,083221,Chow; Bennett,0,12,30,30
1650498039419,MATH 142A,B02,083222,Chow; Bennett,0,13,30,30
1650498045447,MATH 193A,A01,083224,Staff,0,5,30,30
1650498045447,MATH 193A,A02,083225,Staff,0,5,30,30
1650498045447,MATH 193A,A03,083781,Staff,0,5,30,30
1650498045447,MATH 193A,A04,083782,Staff,0,6,30,30
1650498051475,MATH 197,001,091859,McAuley; Julian John,9998,0,9999,1
1650498057544,COGS 9,A01,083615,Staff,0,14,60,60
1650498063567,COGS 11,A01,083617,Boyle; Mary E. T.,20,0,40,20
1650498069589,COGS 13,A01,083071,Staff,0,34,40,40
1650498075612,COGS 14A,A01,092681,Staff,1,25,100,99
1650498081635,COGS 14B,A01,083073,Cheng; Tzu-Han,0,11,50,50
1650498087660,COGS 17,A01,092677,Staff,20,0,75,55
1650498093685,COGS 100,A01,083619,Staff,0,26,60,60
1650498099707,COGS 101A,A01,083621,Davis; Joshua Daniel,0,23,60,60
1650498105743,COGS 101B,A01,091572,Staff,0,4,60,60
1650498111765,COGS 101C,A01,083625,Delgado; Tania,16,0,30,14
1650498117788,COGS 107A,A01,083627,Boyle; Mary E. T.,0,12,60,60
1650498123812,COGS 118A,A01,083075,Staff,0,3,60,60
1650498129848,CSE 3,A50,083646,Miranda; Gregory Joseph,20,0,38,18
1650498129848,CSE 3,A51,083647,Miranda; Gregory Joseph,36,0,37,1
1650498135898,CSE 8A,A50,083650,Miranda; Gregory Joseph,1,28,40,39
1650498141928,CSE 11,A01,083080,Cao; Yingjun,0,91,40,40
1650498147951,CSE 12,A01,083652,Staff,0,17,100,100
1650498153974,CSE 15L,A01,083654,Staff,0,1,50,50
1650498153974,CSE 15L,A02,083655,Staff,0,0,50,50
1650498160001,CSE 20,A01,083657,Staff,51,0,80,29
1650498166024,CSE 30,A01,083084,Eldon; John,0,77,40,40
1650498172050,CSE 100,A01,083659,Cao; Yingjun,0,67,50,50
1650498178073,CSE 134B,A01,083661,Powell; Thomas Allan,0,32,65,65
1650498184102,CSE 140,A01,083663,Staff,0,5,75,75
1650498190133,CSE 140L,A01,083088,Eldon; John,0,10,75,75
1650498196156,CSE 175,A01,083665,Kumar; Rakesh,7,0,25,18
1650498202179,CSE 190,A00,092507,Dubnov; Shlomo,10,0,20,10
1650498208210,ECE 45,A01,083139,Staff,20,19,60,40
1650498214232,ECE 65,A50,083695,Staff,0,6,30,30
1650498220264,ECE 109,A01,091882,Touri; Behrouz,37,0,70,33
1650498226289,ECE 180,A00,083140,Abi Samra; Nicholas Camill,21,0,30,9
1650498226289,ECE 180,B00,083141,Abi Samra; Nicholas Camill,0,0,30,30
1650498232315,MATH 10A,A01,083735,Patchell; Gregory David,5,0,30,25
1650498232315,MATH 10A,A02,083736,Patchell; Gregory David,27,0,30,3
1650498232315,MATH 10A,A03,083737,Patchell; Gregory David,25,0,30,5
1650498238349,MATH 10B,A01,083207,Staff,0,8,30,30
1650498238349,MATH 10B,A02,083208,Staff,0,7,30,30
1650498238349,MATH 10B,B01,083739,Staff,13,0,30,17
1650498238349,MATH 10B,B02,083740,Staff,28,0,30,2
1650498244378,MATH 18,A01,083743,Staff,0,0,30,30
1650498244378,MATH 18,A02,083744,Staff,27,0,30,3
1650498244378,MATH 18,A03,083745,Staff,22,0,30,8
1650498244378,MATH 18,A04,083746,Staff,26,0,30,4
1650498244378,MATH 18,B01,083748,Staff,0,11,30,30
1650498244378,MATH 18,B02,083749,Staff,0,12,30,30
1650498244378,MATH 18,B03,083750,Staff,0,11,30,30
1650498244378,MATH 18,B04,083751,Staff,0,12,30,30
1650498250402,MATH 20A,A01,083754,Staff,25,0,40,15
1650498256427,MATH 20B,A01,083756,Staff,0,11,30,30
1650498256427,MATH 20B,A02,083757,Staff,0,11,30,30
1650498262456,MATH 20C,A01,083760,Staff,0,16,30,30
1650498262456,MATH 20C,A02,083761,Staff,2,15,30,28
1650498262456,MATH 20C,B01,083762,Staff,13,0,30,17
1650498262456,MATH 20C,B02,083763,Staff,28,0,30,2
1650498268482,MATH 20D,A01,083765,Staff,0,1,30,30
1650498268482,MATH 20D,A02,083766,Staff,9,0,30,21
1650498268482,MATH 20D,A03,083767,Staff,25,0,30,5
1650498274508,MATH 20E,A01,083771,Staff,6,0,30,24
1650498274508,MATH 20E,A02,083772,Staff,18,0,30,12
1650498274508,MATH 20E,B01,083773,Staff,0,0,30,30
1650498274508,MATH 20E,B02,083774,Staff,10,0,30,20
1650498280530,MATH 103A,A01,083777,Staff,0,12,30,30
1650498280530,MATH 103A,A02,083778,Staff,0,12,30,30
1650498280530,MATH 103A,B01,083779,Staff,0,13,30,30
1650498280530,MATH 103A,B02,083780,Staff,0,13,30,30
1650498286559,MATH 105,A01,085443,Staff,1,23,30,29
1650498292589,MATH 109,A01,083213,Anzaldo; Leesa B,0,7,30,30
1650498292589,MATH 109,A02,083214,Anzaldo; Leesa B,0,7,30,30
1650498292589,MATH 109,B01,083215,Anzaldo; Leesa B,0,5,30,30
1650498292589,MATH 109,B02,083216,Anzaldo; Leesa B,0,6,30,30
1650498298617,MATH 142A,A01,083219,Chow; Bennett,0,15,30,30
1650498298617,MATH 142A,A02,083220,Chow; Bennett,0,13,30,30
1650498298617,MATH 142A,B01,083221,Chow; Bennett,0,12,30,30
1650498298617,MATH 142A,B02,083222,Chow; Bennett,0,13,30,30
1650498304643,MATH 193A,A01,083224,Staff,0,5,30,30
1650498304643,MATH 193A,A02,083225,Staff,0,5,30,30
1650498304643,MATH 193A,A03,083781,Staff,0,5,30,30
1650498304643,MATH 193A,A04,083782,Staff,0,6,30,30
1650498310670,MATH 197,001,091859,McAuley; Julian John,9998,0,9999,1
1650498316722,COGS 9,A01,083615,Staff,0,14,60,60
1650498322748,COGS 11,A01,083617,Boyle; Mary E. T.,20,0,40,20
1650498328779,COGS 13,A01,083071,Staff,0,34,40,40
1650498334876,COGS 14A,A01,092681,Staff,1,25,100,99
1650498340911,COGS 14B,A01,083073,Cheng; Tzu-Han,0,11,50,50
1650498346938,COGS 17,A01,092677,Staff,20,0,75,55
1650498352965,COGS 100,A01,083619,Staff,0,26,60,60
1650498358989,COGS 101A,A01,083621,Davis; Joshua Daniel,0,23,60,60
1650498365030,COGS 101B,A01,091572,Staff,0,4,60,60
1650498371055,COGS 101C,A01,083625,Delgado; Tania,16,0,30,14
1650498377076,COGS 107A,A01,083627,Boyle; Mary E. T.,0,12,60,60
1650498383097,COGS 118A,A01,083075,Staff,0,3,60,60
1650498389125,CSE 3,A50,083646,Miranda; Gregory Joseph,20,0,38,18
1650498389125,CSE 3,A51,083647,Miranda; Gregory Joseph,36,0,37,1
1650498395153,CSE 8A,A50,083650,Miranda; Gregory Joseph,1,28,40,39
1650498401177,CSE 11,A01,083080,Cao; Yingjun,0,91,40,40
1650498407199,CSE 12,A01,083652,Staff,0,17,100,100
1650498413223,CSE 15L,A01,083654,Staff,0,1,50,50
1650498413223,CSE 15L,A02,083655,Staff,0,0,50,50
1650498419250,CSE 20,A01,083657,Staff,51,0,80,29
1650498425275,CSE 30,A01,083084,Eldon; John,0,77,40,40
1650498431305,CSE 100,A01,083659,Cao; Yingjun,0,67,50,50
1650498437327,CSE 134B,A01,083661,Powell; Thomas Allan,0,32,65,65
1650498443349,CSE 140,A01,083663,Staff,0,5,75,75
1650498449374,CSE 140L,A01,083088,Eldon; John,0,10,75,75
1650498455405,CSE 175,A01,083665,Kumar; Rakesh,7,0,25,18
1650498461477,CSE 190,A00,092507,Dubnov; Shlomo,10,0,20,10
1650498467499,ECE 45,A01,083139,Staff,20,19,60,40
1650498473526,ECE 65,A50,083695,Staff,0,6,30,30
1650498479549,ECE 109,A01,091882,Touri; Behrouz,37,0,70,33
1650498485575,ECE 180,A00,083140,Abi Samra; Nicholas Camill,21,0,30,9
1650498485575,ECE 180,B00,083141,Abi Samra; Nicholas Camill,0,0,30,30
1650498491602,MATH 10A,A01,083735,Patchell; Gregory David,5,0,30,25
1650498491602,MATH 10A,A02,083736,Patchell; Gregory David,27,0,30,3
1650498491602,MATH 10A,A03,083737,Patchell; Gregory David,25,0,30,5
1650498497637,MATH 10B,A01,083207,Staff,0,8,30,30
1650498497637,MATH 10B,A02,083208,Staff,0,7,30,30
1650498497637,MATH 10B,B01,083739,Staff,13,0,30,17
1650498497637,MATH 10B,B02,083740,Staff,28,0,30,2
1650498503668,MATH 18,A01,083743,Staff,0,0,30,30
1650498503668,MATH 18,A02,083744,Staff,27,0,30,3
1650498503668,MATH 18,A03,083745,Staff,22,0,30,8
1650498503668,MATH 18,A04,083746,Staff,26,0,30,4
1650498503668,MATH 18,B01,083748,Staff,0,11,30,30
1650498503668,MATH 18,B02,083749,Staff,0,12,30,30
1650498503668,MATH 18,B03,083750,Staff,0,11,30,30
1650498503668,MATH 18,B04,083751,Staff,0,12,30,30
1650498509691,MATH 20A,A01,083754,Staff,25,0,40,15
1650498515720,MATH 20B,A01,083756,Staff,0,11,30,30
1650498515720,MATH 20B,A02,083757,Staff,0,11,30,30
1650498521743,MATH 20C,A01,083760,Staff,0,16,30,30
1650498521743,MATH 20C,A02,083761,Staff,2,15,30,28
1650498521743,MATH 20C,B01,083762,Staff,13,0,30,17
1650498521743,MATH 20C,B02,083763,Staff,28,0,30,2
1650498527769,MATH 20D,A01,083765,Staff,0,1,30,30
1650498527769,MATH 20D,A02,083766,Staff,9,0,30,21
1650498527769,MATH 20D,A03,083767,Staff,25,0,30,5
1650498533792,MATH 20E,A01,083771,Staff,6,0,30,24
1650498533792,MATH 20E,A02,083772,Staff,18,0,30,12
1650498533792,MATH 20E,B01,083773,Staff,0,0,30,30
1650498533792,MATH 20E,B02,083774,Staff,10,0,30,20
1650498539822,MATH 103A,A01,083777,Staff,0,12,30,30
1650498539822,MATH 103A,A02,083778,Staff,0,12,30,30
1650498539822,MATH 103A,B01,083779,Staff,0,13,30,30
1650498539822,MATH 103A,B02,083780,Staff,0,13,30,30
1650498545850,MATH 105,A01,085443,Staff,1,23,30,29
1650498551876,MATH 109,A01,083213,Anzaldo; Leesa B,0,7,30,30
1650498551876,MATH 109,A02,083214,Anzaldo; Leesa B,0,7,30,30
1650498551876,MATH 109,B01,083215,Anzaldo; Leesa B,0,5,30,30
1650498551876,MATH 109,B02,083216,Anzaldo; Leesa B,0,6,30,30
1650498557900,MATH 142A,A01,083219,Chow; Bennett,0,15,30,30
1650498557900,MATH 142A,A02,083220,Chow; Bennett,0,13,30,30
1650498557900,MATH 142A,B01,083221,Chow; Bennett,0,12,30,30
1650498557900,MATH 142A,B02,083222,Chow; Bennett,0,13,30,30
1650498563927,MATH 193A,A01,083224,Staff,0,5,30,30
1650498563927,MATH 193A,A02,083225,Staff,0,5,30,30
1650498563927,MATH 193A,A03,083781,Staff,0,5,30,30
1650498563927,MATH 193A,A04,083782,Staff,0,6,30,30
1650498569954,MATH 197,001,091859,McAuley; Julian John,9998,0,9999,1
1650498576006,COGS 9,A01,083615,Staff,0,14,60,60
1650498582030,COGS 11,A01,083617,Boyle; Mary E. T.,20,0,40,20
1650498588058,COGS 13,A01,083071,Staff,0,34,40,40
1650498594081,COGS 14A,A01,092681,Staff,1,25,100,99
1650498600109,COGS 14B,A01,083073,Cheng; Tzu-Han,0,11,50,50
1650498606138,COGS 17,A01,092677,Staff,20,0,75,55
1650498612172,COGS 100,A01,083619,Staff,0,26,60,60
1650498618203,COGS 101A,A01,083621,Davis; Joshua Daniel,0,23,60,60
1650498624226,COGS 101B,A01,091572,Staff,0,4,60,60
1650498630252,COGS 101C,A01,083625,Delgado; Tania,16,0,30,14
1650498636275,COGS 107A,A01,083627,Boyle; Mary E. T.,0,12,60,60
1650498642311,COGS 118A,A01,083075,Staff,0,3,60,60
1650498648344,CSE 3,A50,083646,Miranda; Gregory Joseph,20,0,38,18
1650498648344,CSE 3,A51,083647,Miranda; Gregory Joseph,36,0,37,1
1650498654368,CSE 8A,A50,083650,Miranda; Gregory Joseph,1,28,40,39
1650498660394,CSE 11,A01,083080,Cao; Yingjun,0,92,40,40
1650498666421,CSE 12,A01,083652,Staff,0,17,100,100
1650498672443,CSE 15L,A01,083654,Staff,0,1,50,50
1650498672443,CSE 15L,A02,083655,Staff,0,0,50,50
1650498678466,CSE 20,A01,083657,Staff,51,0,80,29
1650498684491,CSE 30,A01,083084,Eldon; John,0,77,40,40
1650498690514,CSE 100,A01,083659,Cao; Yingjun,0,67,50,50
1650498696537,CSE 134B,A01,083661,Powell; Thomas Allan,0,32,65,65
1650498702559,CSE 140,A01,083663,Staff,0,5,75,75
1650498717220,CSE 140L,A01,083088,Eldon; John,0,10,75,75
1650498723247,CSE 175,A01,083665,Kumar; Rakesh,7,0,25,18
1650498729274,CSE 190,A00,092507,Dubnov; Shlomo,10,0,20,10
1650498735296,ECE 45,A01,083139,Staff,20,19,60,40
1650498741321,ECE 65,A50,083695,Staff,0,6,30,30
1650498747352,ECE 109,A01,091882,Touri; Behrouz,37,0,70,33
1650498753375,ECE 180,A00,083140,Abi Samra; Nicholas Camill,21,0,30,9
1650498753375,ECE 180,B00,083141,Abi Samra; Nicholas Camill,0,0,30,30
1650498759398,MATH 10A,A01,083735,Patchell; Gregory David,5,0,30,25
1650498759398,MATH 10A,A02,083736,Patchell; Gregory David,27,0,30,3
1650498759398,MATH 10A,A03,083737,Patchell; Gregory David,25,0,30,5
1650498765432,MATH 10B,A01,083207,Staff,0,8,30,30
1650498765432,MATH 10B,A02,083208,Staff,0,7,30,30
1650498765432,MATH 10B,B01,083739,Staff,13,0,30,17
1650498765432,MATH 10B,B02,083740,Staff,28,0,30,2
1650498771454,MATH 18,A01,083743,Staff,0,0,30,30
1650498771454,MATH 18,A02,083744,Staff,27,0,30,3
1650498771454,MATH 18,A03,083745,Staff,22,0,30,8
1650498771454,MATH 18,A04,083746,Staff,26,0,30,4
1650498771454,MATH 18,B01,083748,Staff,0,11,30,30
1650498771454,MATH 18,B02,083749,Staff,0,12,30,30
1650498771454,MATH 18,B03,083750,Staff,0,11,30,30
1650498771454,MATH 18,B04,083751,Staff,0,12,30,30
1650498777481,MATH 20A,A01,083754,Staff,25,0,40,15
1650498783522,MATH 20B,A01,083756,Staff,0,11,30,30
1650498783522,MATH 20B,A02,083757,Staff,0,11,30,30
1650498789548,MATH 20C,A01,083760,Staff,0,16,30,30
1650498789548,MATH 20C,A02,083761,Staff,2,15,30,28
1650498789548,MATH 20C,B01,083762,Staff,13,0,30,17
1650498789548,MATH 20C,B02,083763,Staff,28,0,30,2
1650498795579,MATH 20D,A01,083765,Staff,0,1,30,30
1650498795579,MATH 20D,A02,083766,Staff,9,0,30,21
1650498795579,MATH 20D,A03,083767,Staff,25,0,30,5
1650498801605,MATH 20E,A01,083771,Staff,6,0,30,24
1650498801605,MATH 20E,A02,083772,Staff,18,0,30,12
1650498801605,MATH 20E,B01,083773,Staff,0,0,30,30
1650498801605,MATH 20E,B02,083774,Staff,10,0,30,20
1650498807630,MATH 103A,A01,083777,Staff,0,12,30,30
1650498807630,MATH 103A,A02,083778,Staff,0,12,30,30
1650498807630,MATH 103A,B01,083779,Staff,0,13,30,30
1650498807630,MATH 103A,B02,083780,Staff,0,13,30,30
1650498813654,MATH 105,A01,085443,Staff,1,23,30,29
1650498819680,MATH 109,A01,083213,Anzaldo; Leesa B,0,7,30,30
1650498819680,MATH 109,A02,083214,Anzaldo; Leesa B,0,7,30,30
1650498819680,MATH 109,B01,083215,Anzaldo; Leesa B,0,5,30,30
1650498819680,MATH 109,B02,083216,Anzaldo; Leesa B,0,6,30,30
1650498825711,MATH 142A,A01,083219,Chow; Bennett,0,15,30,30
1650498825711,MATH 142A,A02,083220,Chow; Bennett,0,13,30,30
1650498825711,MATH 142A,B01,083221,Chow; Bennett,0,12,30,30
1650498825711,MATH 142A,B02,083222,Chow; Bennett,0,13,30,30
1650498831737,MATH 193A,A01,083224,Staff,0,5,30,30
1650498831737,MATH 193A,A02,083225,Staff,0,5,30,30
1650498831737,MATH 193A,A03,083781,Staff,0,5,30,30
1650498831737,MATH 193A,A04,083782,Staff,0,6,30,30
1650498837760,MATH 197,001,091859,McAuley; Julian John,9998,0,9999,1
1650498843821,COGS 9,A01,083615,Staff,0,14,60,60
1650498849849,COGS 11,A01,083617,Boyle; Mary E. T.,20,0,40,20
1650498855873,COGS 13,A01,083071,Staff,0,34,40,40
1650498861902,COGS 14A,A01,092681,Staff,1,25,100,99
1650498867930,COGS 14B,A01,083073,Cheng; Tzu-Han,0,11,50,50
1650498873951,COGS 17,A01,092677,Staff,20,0,75,55
1650498879976,COGS 100,A01,083619,Staff,0,26,60,60
1650498886013,COGS 101A,A01,083621,Davis; Joshua Daniel,0,23,60,60
1650498892041,COGS 101B,A01,091572,Staff,0,4,60,60
1650498898067,COGS 101C,A01,083625,Delgado; Tania,16,0,30,14
1650498904102,COGS 107A,A01,083627,Boyle; Mary E. T.,0,12,60,60
1650498910125,COGS 118A,A01,083075,Staff,0,3,60,60
1650498916150,CSE 3,A50,083646,Miranda; Gregory Joseph,20,0,38,18
1650498916150,CSE 3,A51,083647,Miranda; Gregory Joseph,36,0,37,1
1650498922173,CSE 8A,A50,083650,Miranda; Gregory Joseph,1,28,40,39
1650498928210,CSE 11,A01,083080,Cao; Yingjun,0,92,40,40
1650498934238,CSE 12,A01,083652,Staff,0,17,100,100
1650498940367,CSE 15L,A01,083654,Staff,0,1,50,50
1650498940367,CSE 15L,A02,083655,Staff,0,0,50,50
1650498946395,CSE 20,A01,083657,Staff,51,0,80,29
1650498952420,CSE 30,A01,083084,Eldon; John,0,77,40,40
1650498958454,CSE 100,A01,083659,Cao; Yingjun,0,67,50,50
1650498964487,CSE 134B,A01,083661,Powell; Thomas Allan,0,32,65,65
1650498970510,CSE 140,A01,083663,Staff,0,5,75,75
1650498976537,CSE 140L,A01,083088,Eldon; John,0,10,75,75
1650498982560,CSE 175,A01,083665,Kumar; Rakesh,7,0,25,18
1650498988585,CSE 190,A00,092507,Dubnov; Shlomo,10,0,20,10
1650498994609,ECE 45,A01,083139,Staff,20,19,60,40
1650499000642,ECE 65,A50,083695,Staff,0,6,30,30
1650499006670,ECE 109,A01,091882,Touri; Behrouz,37,0,70,33
1650499012698,ECE 180,A00,083140,Abi Samra; Nicholas Camill,21,0,30,9
1650499012698,ECE 180,B00,083141,Abi Samra; Nicholas Camill,0,0,30,30
1650499018727,MATH 10A,A01,083735,Patchell; Gregory David,5,0,30,25
1650499018727,MATH 10A,A02,083736,Patchell; Gregory David,27,0,30,3
1650499018727,MATH 10A,A03,083737,Patchell; Gregory David,25,0,30,5
1650499024753,MATH 10B,A01,083207,Staff,0,8,30,30
1650499024753,MATH 10B,A02,083208,Staff,0,7,30,30
1650499024753,MATH 10B,B01,083739,Staff,13,0,30,17
1650499024753,MATH 10B,B02,083740,Staff,28,0,30,2
1650499030783,MATH 18,A01,083743,Staff,0,0,30,30
1650499030783,MATH 18,A02,083744,Staff,27,0,30,3
1650499030783,MATH 18,A03,083745,Staff,22,0,30,8
1650499030783,MATH 18,A04,083746,Staff,26,0,30,4
1650499030783,MATH 18,B01,083748,Staff,0,11,30,30
1650499030783,MATH 18,B02,083749,Staff,0,12,30,30
1650499030783,MATH 18,B03,083750,Staff,0,11,30,30
1650499030783,MATH 18,B04,083751,Staff,0,12,30,30
1650499036806,MATH 20A,A01,083754,Staff,25,0,40,15
1650499042834,MATH 20B,A01,083756,Staff,0,11,30,30
1650499042834,MATH 20B,A02,083757,Staff,0,11,30,30
1650499048863,MATH 20C,A01,083760,Staff,0,16,30,30
1650499048863,MATH 20C,A02,083761,Staff,2,15,30,28
1650499048863,MATH 20C,B01,083762,Staff,13,0,30,17
1650499048863,MATH 20C,B02,083763,Staff,28,0,30,2
1650499054892,MATH 20D,A01,083765,Staff,0,1,30,30
1650499054892,MATH 20D,A02,083766,Staff,9,0,30,21
1650499054892,MATH 20D,A03,083767,Staff,25,0,30,5
1650499060922,MATH 20E,A01,083771,Staff,6,0,30,24
1650499060922,MATH 20E,A02,083772,Staff,18,0,30,12
1650499060922,MATH 20E,B01,083773,Staff,0,0,30,30
1650499060922,MATH 20E,B02,083774,Staff,10,0,30,20
1650499066951,MATH 103A,A01,083777,Staff,0,12,30,30
1650499066951,MATH 103A,A02,083778,Staff,0,12,30,30
1650499066951,MATH 103A,B01,083779,Staff,0,13,30,30
1650499066951,MATH 103A,B02,083780,Staff,0,13,30,30
1650499072989,MATH 105,A01,085443,Staff,1,23,30,29
1650499079016,MATH 109,A01,083213,Anzaldo; Leesa B,0,7,30,30
1650499079016,MATH 109,A02,083214,Anzaldo; Leesa B,0,7,30,30
1650499079016,MATH 109,B01,083215,Anzaldo; Leesa B,0,5,30,30
1650499079016,MATH 109,B02,083216,Anzaldo; Leesa B,0,6,30,30
1650499085046,MATH 142A,A01,083219,Chow; Bennett,0,15,30,30
1650499085046,MATH 142A,A02,083220,Chow; Bennett,0,13,30,30
1650499085046,MATH 142A,B01,083221,Chow; Bennett,0,13,30,30
1650499085046,MATH 142A,B02,083222,Chow; Bennett,0,13,30,30
1650499091069,MATH 193A,A01,083224,Staff,0,5,30,30
1650499091069,MATH 193A,A02,083225,Staff,0,5,30,30
1650499091069,MATH 193A,A03,083781,Staff,0,5,30,30
1650499091069,MATH 193A,A04,083782,Staff,0,6,30,30
1650499097093,MATH 197,001,091859,McAuley; Julian John,9998,0,9999,1
1650499103150,COGS 9,A01,083615,Staff,0,14,60,60
1650499109173,COGS 11,A01,083617,Boyle; Mary E. T.,20,0,40,20
1650499115197,COGS 13,A01,083071,Staff,0,34,40,40
1650499121225,COGS 14A,A01,092681,Staff,1,25,100,99
1650499127252,COGS 14B,A01,083073,Cheng; Tzu-Han,0,11,50,50
1650499133275,COGS 17,A01,092677,Staff,20,0,75,55
1650499139298,COGS 100,A01,083619,Staff,0,26,60,60
1650499145324,COGS 101A,A01,083621,Davis; Joshua Daniel,0,23,60,60
1650499151353,COGS 101B,A01,091572,Staff,0,4,60,60
1650499157381,COGS 101C,A01,083625,Delgado; Tania,16,0,30,14
1650499163410,COGS 107A,A01,083627,Boyle; Mary E. T.,0,12,60,60
1650499169433,COGS 118A,A01,083075,Staff,0,3,60,60
1650499175458,CSE 3,A50,083646,Miranda; Gregory Joseph,20,0,38,18
1650499175458,CSE 3,A51,083647,Miranda; Gregory Joseph,36,0,37,1
1650499181495,CSE 8A,A50,083650,Miranda; Gregory Joseph,1,28,40,39
1650499187523,CSE 11,A01,083080,Cao; Yingjun,0,92,40,40
1650499193550,CSE 12,A01,083652,Staff,0,17,100,100
1650499199582,CSE 15L,A01,083654,Staff,0,1,50,50
1650499199582,CSE 15L,A02,083655,Staff,0,0,50,50
1650499205605,CSE 20,A01,083657,Staff,51,0,80,29
1650499211641,CSE 30,A01,083084,Eldon; John,0,77,40,40
1650499217666,CSE 100,A01,083659,Cao; Yingjun,0,67,50,50
1650499223689,CSE 134B,A01,083661,Powell; Thomas Allan,0,32,65,65
1650499229714,CSE 140,A01,083663,Staff,0,5,75,75
1650499235742,CSE 140L,A01,083088,Eldon; John,0,11,75,75
1650499241777,CSE 175,A01,083665,Kumar; Rakesh,7,0,25,18
1650499247799,CSE 190,A00,092507,Dubnov; Shlomo,10,0,20,10
1650499253825,ECE 45,A01,083139,Staff,20,19,60,40
1650499259854,ECE 65,A50,083695,Staff,0,6,30,30
1650499265885,ECE 109,A01,091882,Touri; Behrouz,36,0,70,34
1650499271909,ECE 180,A00,083140,Abi Samra; Nicholas Camill,21,0,30,9
1650499271909,ECE 180,B00,083141,Abi Samra; Nicholas Camill,0,0,30,30
1650499277937,MATH 10A,A01,083735,Patchell; Gregory David,5,0,30,25
1650499277937,MATH 10A,A02,083736,Patchell; Gregory David,27,0,30,3
1650499277937,MATH 10A,A03,083737,Patchell; Gregory David,25,0,30,5
1650499283967,MATH 10B,A01,083207,Staff,0,8,30,30
1650499283967,MATH 10B,A02,083208,Staff,0,7,30,30
1650499283967,MATH 10B,B01,083739,Staff,13,0,30,17
1650499283967,MATH 10B,B02,083740,Staff,28,0,30,2
1650499290017,MATH 18,A01,083743,Staff,0,0,30,30
1650499290017,MATH 18,A02,083744,Staff,27,0,30,3
1650499290017,MATH 18,A03,083745,Staff,22,0,30,8
1650499290017,MATH 18,A04,083746,Staff,26,0,30,4
1650499290017,MATH 18,B01,083748,Staff,0,11,30,30
1650499290017,MATH 18,B02,083749,Staff,0,12,30,30
1650499290017,MATH 18,B03,083750,Staff,0,11,30,30
1650499290017,MATH 18,B04,083751,Staff,0,12,30,30
1650499296048,MATH 20A,A01,083754,Staff,25,0,40,15
1650499302077,MATH 20B,A01,083756,Staff,0,11,30,30
1650499302077,MATH 20B,A02,083757,Staff,0,11,30,30
1650499308101,MATH 20C,A01,083760,Staff,0,16,30,30
1650499308101,MATH 20C,A02,083761,Staff,2,15,30,28
1650499308101,MATH 20C,B01,083762,Staff,13,0,30,17
1650499308101,MATH 20C,B02,083763,Staff,28,0,30,2
1650499314129,MATH 20D,A01,083765,Staff,0,1,30,30
1650499314129,MATH 20D,A02,083766,Staff,9,0,30,21
1650499314129,MATH 20D,A03,083767,Staff,25,0,30,5
1650499320154,MATH 20E,A01,083771,Staff,6,0,30,24
1650499320154,MATH 20E,A02,083772,Staff,18,0,30,12
1650499320154,MATH 20E,B01,083773,Staff,0,0,30,30
1650499320154,MATH 20E,B02,083774,Staff,10,0,30,20
1650499326182,MATH 103A,A01,083777,Staff,0,12,30,30
1650499326182,MATH 103A,A02,083778,Staff,0,12,30,30
1650499326182,MATH 103A,B01,083779,Staff,0,13,30,30
1650499326182,MATH 103A,B02,083780,Staff,0,13,30,30
1650499332205,MATH 105,A01,085443,Staff,1,23,30,29
1650499338234,MATH 109,A01,083213,Anzaldo; Leesa B,0,7,30,30
1650499338234,MATH 109,A02,083214,Anzaldo; Leesa B,0,7,30,30
1650499338234,MATH 109,B01,083215,Anzaldo; Leesa B,0,5,30,30
1650499338234,MATH 109,B02,083216,Anzaldo; Leesa B,0,6,30,30
1650499344262,MATH 142A,A01,083219,Chow; Bennett,0,15,30,30
1650499344262,MATH 142A,A02,083220,Chow; Bennett,0,13,30,30
1650499344262,MATH 142A,B01,083221,Chow; Bennett,0,13,30,30
1650499344262,MATH 142A,B02,083222,Chow; Bennett,0,13,30,30
1650499350293,MATH 193A,A01,083224,Staff,0,5,30,30
1650499350293,MATH 193A,A02,083225,Staff,0,5,30,30
1650499350293,MATH 193A,A03,083781,Staff,0,5,30,30
1650499350293,MATH 193A,A04,083782,Staff,0,6,30,30
1650499356318,MATH 197,001,091859,McAuley; Julian John,9998,0,9999,1
1650499362371,COGS 9,A01,083615,Staff,0,14,60,60
1650499368401,COGS 11,A01,083617,Boyle; Mary E. T.,20,0,40,20
1650499374424,COGS 13,A01,083071,Staff,0,34,40,40
1650499380449,COGS 14A,A01,092681,Staff,1,25,100,99
1650499386488,COGS 14B,A01,083073,Cheng; Tzu-Han,0,11,50,50
1650499392514,COGS 17,A01,092677,Staff,20,0,75,55
1650499398539,COGS 100,A01,083619,Staff,0,26,60,60
1650499404564,COGS 101A,A01,083621,Davis; Joshua Daniel,0,23,60,60
1650499410590,COGS 101B,A01,091572,Staff,0,4,60,60
1650499416619,COGS 101C,A01,083625,Delgado; Tania,16,0,30,14
1650499422654,COGS 107A,A01,083627,Boyle; Mary E. T.,0,12,60,60
1650499428684,COGS 118A,A01,083075,Staff,0,3,60,60
1650499434709,CSE 3,A50,083646,Miranda; Gregory Joseph,20,0,38,18
1650499434709,CSE 3,A51,083647,Miranda; Gregory Joseph,36,0,37,1
1650499440733,CSE 8A,A50,083650,Miranda; Gregory Joseph,1,28,40,39
1650499446761,CSE 11,A01,083080,Cao; Yingjun,0,92,40,40
1650499452792,CSE 12,A01,083652,Staff,0,17,100,100
1650499458817,CSE 15L,A01,083654,Staff,0,1,50,50
1650499458817,CSE 15L,A02,083655,Staff,0,0,50,50
1650499464844,CSE 20,A01,083657,Staff,51,0,80,29
1650499470876,CSE 30,A01,083084,Eldon; John,0,77,40,40
1650499476902,CSE 100,A01,083659,Cao; Yingjun,0,67,50,50
1650499482926,CSE 134B,A01,083661,Powell; Thomas Allan,0,32,65,65
1650499488950,CSE 140,A01,083663,Staff,0,5,75,75
1650499494979,CSE 140L,A01,083088,Eldon; John,0,11,75,75
1650499501011,CSE 175,A01,083665,Kumar; Rakesh,7,0,25,18
1650499507036,CSE 190,A00,092507,Dubnov; Shlomo,10,0,20,10
1650499513064,ECE 45,A01,083139,Staff,20,19,60,40
1650499519094,ECE 65,A50,083695,Staff,0,6,30,30
1650499525119,ECE 109,A01,091882,Touri; Behrouz,36,0,70,34
1650499531148,ECE 180,A00,083140,Abi Samra; Nicholas Camill,21,0,30,9
1650499531148,ECE 180,B00,083141,Abi Samra; Nicholas Camill,0,0,30,30
1650499537271,MATH 10A,A01,083735,Patchell; Gregory David,5,0,30,25
1650499537271,MATH 10A,A02,083736,Patchell; Gregory David,27,0,30,3
1650499537271,MATH 10A,A03,083737,Patchell; Gregory David,25,0,30,5
1650499543313,MATH 10B,A01,083207,Staff,0,8,30,30
1650499543313,MATH 10B,A02,083208,Staff,0,7,30,30
1650499543313,MATH 10B,B01,083739,Staff,13,0,30,17
1650499543313,MATH 10B,B02,083740,Staff,28,0,30,2
1650499549338,MATH 18,A01,083743,Staff,0,0,30,30
1650499549338,MATH 18,A02,083744,Staff,27,0,30,3
1650499549338,MATH 18,A03,083745,Staff,22,0,30,8
1650499549338,MATH 18,A04,083746,Staff,26,0,30,4
1650499549338,MATH 18,B01,083748,Staff,0,11,30,30
1650499549338,MATH 18,B02,083749,Staff,0,12,30,30
1650499549338,MATH 18,B03,083750,Staff,0,11,30,30
1650499549338,MATH 18,B04,083751,Staff,0,12,30,30
1650499555368,MATH 20A,A01,083754,Staff,25,0,40,15
1650499561399,MATH 20B,A01,083756,Staff,0,11,30,30
1650499561399,MATH 20B,A02,083757,Staff,0,11,30,30
1650499567434,MATH 20C,A01,083760,Staff,0,16,30,30
1650499567434,MATH 20C,A02,083761,Staff,2,15,30,28
1650499567434,MATH 20C,B01,083762,Staff,13,0,30,17
1650499567434,MATH 20C,B02,083763,Staff,28,0,30,2
1650499573459,MATH 20D,A01,083765,Staff,0,1,30,30
1650499573459,MATH 20D,A02,083766,Staff,9,0,30,21
1650499573459,MATH 20D,A03,083767,Staff,25,0,30,5
1650499579487,MATH 20E,A01,083771,Staff,6,0,30,24
1650499579487,MATH 20E,A02,083772,Staff,18,0,30,12
1650499579487,MATH 20E,B01,083773,Staff,0,0,30,30
1650499579487,MATH 20E,B02,083774,Staff,10,0,30,20
1650499585517,MATH 103A,A01,083777,Staff,0,12,30,30
1650499585517,MATH 103A,A02,083778,Staff,0,12,30,30
1650499585517,MATH 103A,B01,083779,Staff,0,13,30,30
1650499585517,MATH 103A,B02,083780,Staff,0,13,30,30
1650499591539,MATH 105,A01,085443,Staff,1,23,30,29
1650499597568,MATH 109,A01,083213,Anzaldo; Leesa B,0,7,30,30
1650499597568,MATH 109,A02,083214,Anzaldo; Leesa B,0,7,30,30
1650499597568,MATH 109,B01,083215,Anzaldo; Leesa B,0,5,30,30
1650499597568,MATH 109,B02,083216,Anzaldo; Leesa B,0,6,30,30
1650499603590,MATH 142A,A01,083219,Chow; Bennett,0,15,30,30
1650499603590,MATH 142A,A02,083220,Chow; Bennett,0,13,30,30
1650499603590,MATH 142A,B01,083221,Chow; Bennett,0,13,30,30
1650499603590,MATH 142A,B02,083222,Chow; Bennett,0,13,30,30
1650499609614,MATH 193A,A01,083224,Staff,0,5,30,30
1650499609614,MATH 193A,A02,083225,Staff,0,5,30,30
1650499609614,MATH 193A,A03,083781,Staff,0,5,30,30
1650499609614,MATH 193A,A04,083782,Staff,0,6,30,30
1650499615639,MATH 197,001,091859,McAuley; Julian John,9998,0,9999,1
1650499621695,COGS 9,A01,083615,Staff,0,14,60,60
1650499627718,COGS 11,A01,083617,Boyle; Mary E. T.,20,0,40,20
1650499633740,COGS 13,A01,083071,Staff,0,34,40,40
1650499639764,COGS 14A,A01,092681,Staff,1,25,100,99
1650499645788,COGS 14B,A01,083073,Cheng; Tzu-Han,0,11,50,50
1650499651809,COGS 17,A01,092677,Staff,20,0,75,55
1650499657833,COGS 100,A01,083619,Staff,0,26,60,60
1650499663858,COGS 101A,A01,083621,Davis; Joshua Daniel,0,23,60,60
1650499669883,COGS 101B,A01,091572,Staff,0,4,60,60
1650499675913,COGS 101C,A01,083625,Delgado; Tania,16,0,30,14
1650499681946,COGS 107A,A01,083627,Boyle; Mary E. T.,0,12,60,60
1650499687970,COGS 118A,A01,083075,Staff,0,3,60,60
1650499694005,CSE 3,A50,083646,Miranda; Gregory Joseph,20,0,38,18
1650499694005,CSE 3,A51,083647,Miranda; Gregory Joseph,36,0,37,1
1650499700035,CSE 8A,A50,083650,Miranda; Gregory Joseph,1,28,40,39
1650499706067,CSE 11,A01,083080,Cao; Yingjun,0,92,40,40
1650499712093,CSE 12,A01,083652,Staff,0,17,100,100
1650499718119,CSE 15L,A01,083654,Staff,0,1,50,50
1650499718119,CSE 15L,A02,083655,Staff,0,0,50,50
1650499724146,CSE 20,A01,083657,Staff,51,0,80,29
1650499730169,CSE 30,A01,083084,Eldon; John,0,77,40,40
1650499736193,CSE 100,A01,083659,Cao; Yingjun,0,67,50,50
1650499742232,CSE 134B,A01,083661,Powell; Thomas Allan,0,32,65,65
1650499748259,CSE 140,A01,083663,Staff,0,5,75,75
1650499754283,CSE 140L,A01,083088,Eldon; John,0,11,75,75
1650499760309,CSE 175,A01,083665,Kumar; Rakesh,7,0,25,18
1650499766333,CSE 190,A00,092507,Dubnov; Shlomo,10,0,20,10
1650499772355,ECE 45,A01,083139,Staff,20,19,60,40
1650499778380,ECE 65,A50,083695,Staff,0,6,30,30
1650499784407,ECE 109,A01,091882,Touri; Behrouz,36,0,70,34
1650499790430,ECE 180,A00,083140,Abi Samra; Nicholas Camill,21,0,30,9
1650499790430,ECE 180,B00,083141,Abi Samra; Nicholas Camill,0,0,30,30
1650499796454,MATH 10A,A01,083735,Patchell; Gregory David,5,0,30,25
1650499796454,MATH 10A,A02,083736,Patchell; Gregory David,27,0,30,3
1650499796454,MATH 10A,A03,083737,Patchell; Gregory David,25,0,30,5
1650499802477,MATH 10B,A01,083207,Staff,0,8,30,30
1650499802477,MATH 10B,A02,083208,Staff,0,7,30,30
1650499802477,MATH 10B,B01,083739,Staff,13,0,30,17
1650499802477,MATH 10B,B02,083740,Staff,28,0,30,2
1650499808514,MATH 18,A01,083743,Staff,0,0,30,30
1650499808514,MATH 18,A02,083744,Staff,27,0,30,3
1650499808514,MATH 18,A03,083745,Staff,22,0,30,8
1650499808514,MATH 18,A04,083746,Staff,26,0,30,4
1650499808514,MATH 18,B01,083748,Staff,0,11,30,30
1650499808514,MATH 18,B02,083749,Staff,0,12,30,30
1650499808514,MATH 18,B03,083750,Staff,0,11,30,30
1650499808514,MATH 18,B04,083751,Staff,0,12,30,30
1650499814553,MATH 20A,A01,083754,Staff,25,0,40,15
1650499820581,MATH 20B,A01,083756,Staff,0,11,30,30
1650499820581,MATH 20B,A02,083757,Staff,0,11,30,30
1650499826620,MATH 20C,A01,083760,Staff,0,16,30,30
1650499826620,MATH 20C,A02,083761,Staff,2,15,30,28
1650499826620,MATH 20C,B01,083762,Staff,13,0,30,17
1650499826620,MATH 20C,B02,083763,Staff,28,0,30,2
1650499832645,MATH 20D,A01,083765,Staff,0,1,30,30
1650499832645,MATH 20D,A02,083766,Staff,9,0,30,21
1650499832645,MATH 20D,A03,083767,Staff,25,0,30,5
1650499838669,MATH 20E,A01,083771,Staff,6,0,30,24
1650499838669,MATH 20E,A02,083772,Staff,18,0,30,12
1650499838669,MATH 20E,B01,083773,Staff,0,0,30,30
1650499838669,MATH 20E,B02,083774,Staff,10,0,30,20
1650499844693,MATH 103A,A01,083777,Staff,0,12,30,30
1650499844693,MATH 103A,A02,083778,Staff,0,12,30,30
1650499844693,MATH 103A,B01,083779,Staff,0,13,30,30
1650499844693,MATH 103A,B02,083780,Staff,0,13,30,30
1650499850718,MATH 105,A01,085443,Staff,1,23,30,29
1650499856741,MATH 109,A01,083213,Anzaldo; Leesa B,0,7,30,30
1650499856741,MATH 109,A02,083214,Anzaldo; Leesa B,0,7,30,30
1650499856741,MATH 109,B01,083215,Anzaldo; Leesa B,0,5,30,30
1650499856741,MATH 109,B02,083216,Anzaldo; Leesa B,0,6,30,30
1650499862776,MATH 142A,A01,083219,Chow; Bennett,0,15,30,30
1650499862776,MATH 142A,A02,083220,Chow; Bennett,0,14,30,30
1650499862776,MATH 142A,B01,083221,Chow; Bennett,0,13,30,30
1650499862776,MATH 142A,B02,083222,Chow; Bennett,0,13,30,30
1650499868805,MATH 193A,A01,083224,Staff,0,5,30,30
1650499868805,MATH 193A,A02,083225,Staff,0,5,30,30
1650499868805,MATH 193A,A03,083781,Staff,0,5,30,30
1650499868805,MATH 193A,A04,083782,Staff,0,6,30,30
1650499874831,MATH 197,001,091859,McAuley; Julian John,9998,0,9999,1
1650499880890,COGS 9,A01,083615,Staff,0,14,60,60
1650499886930,COGS 11,A01,083617,Boyle; Mary E. T.,20,0,40,20
1650499892954,COGS 13,A01,083071,Staff,0,34,40,40
1650499898981,COGS 14A,A01,092681,Staff,1,25,100,99
1650499905007,COGS 14B,A01,083073,Cheng; Tzu-Han,0,11,50,50
1650499911034,COGS 17,A01,092677,Staff,20,0,75,55
1650499917079,COGS 100,A01,083619,Staff,0,26,60,60
1650499923109,COGS 101A,A01,083621,Davis; Joshua Daniel,0,23,60,60
1650499929134,COGS 101B,A01,091572,Staff,0,4,60,60
1650499935160,COGS 101C,A01,083625,Delgado; Tania,16,0,30,14
1650499941185,COGS 107A,A01,083627,Boyle; Mary E. T.,0,12,60,60
1650499947217,COGS 118A,A01,083075,Staff,0,3,60,60
1650499953245,CSE 3,A50,083646,Miranda; Gregory Joseph,20,0,38,18
1650499953245,CSE 3,A51,083647,Miranda; Gregory Joseph,36,0,37,1
1650499959274,CSE 8A,A50,083650,Miranda; Gregory Joseph,1,29,40,39
1650499965304,CSE 11,A01,083080,Cao; Yingjun,0,92,40,40
1650499971328,CSE 12,A01,083652,Staff,0,17,100,100
1650499977352,CSE 15L,A01,083654,Staff,0,1,50,50
1650499977352,CSE 15L,A02,083655,Staff,0,0,50,50
1650499983379,CSE 20,A01,083657,Staff,51,0,80,29
1650499989403,CSE 30,A01,083084,Eldon; John,0,77,40,40
1650499995441,CSE 100,A01,083659,Cao; Yingjun,0,67,50,50
1650500001472,CSE 134B,A01,083661,Powell; Thomas Allan,0,32,65,65
1650500007496,CSE 140,A01,083663,Staff,0,5,75,75
1650500013520,CSE 140L,A01,083088,Eldon; John,0,11,75,75
1650500019547,CSE 175,A01,083665,Kumar; Rakesh,7,0,25,18
1650500025570,CSE 190,A00,092507,Dubnov; Shlomo,10,0,20,10
1650500031599,ECE 45,A01,083139,Staff,20,19,60,40
1650500037630,ECE 65,A50,083695,Staff,0,6,30,30
1650500043656,ECE 109,A01,091882,Touri; Behrouz,36,0,70,34
1650500049682,ECE 180,A00,083140,Abi Samra; Nicholas Camill,21,0,30,9
1650500049682,ECE 180,B00,083141,Abi Samra; Nicholas Camill,0,0,30,30
1650500055713,MATH 10A,A01,083735,Patchell; Gregory David,5,0,30,25
1650500055713,MATH 10A,A02,083736,Patchell; Gregory David,27,0,30,3
1650500055713,MATH 10A,A03,083737,Patchell; Gregory David,25,0,30,5
1650500061745,MATH 10B,A01,083207,Staff,0,8,30,30
1650500061745,MATH 10B,A02,083208,Staff,0,7,30,30
1650500061745,MATH 10B,B01,083739,Staff,13,0,30,17
1650500061745,MATH 10B,B02,083740,Staff,28,0,30,2
1650500067769,MATH 18,A01,083743,Staff,0,0,30,30
1650500067769,MATH 18,A02,083744,Staff,27,0,30,3
1650500067769,MATH 18,A03,083745,Staff,22,0,30,8
1650500067769,MATH 18,A04,083746,Staff,26,0,30,4
1650500067769,MATH 18,B01,083748,Staff,0,11,30,30
1650500067769,MATH 18,B02,083749,Staff,0,12,30,30
1650500067769,MATH 18,B03,083750,Staff,0,11,30,30
1650500067769,MATH 18,B04,083751,Staff,0,12,30,30
1650500073791,MATH 20A,A01,083754,Staff,25,0,40,15
1650500079815,MATH 20B,A01,083756,Staff,0,11,30,30
1650500079815,MATH 20B,A02,083757,Staff,0,11,30,30
1650500085842,MATH 20C,A01,083760,Staff,0,16,30,30
1650500085842,MATH 20C,A02,083761,Staff,2,15,30,28
1650500085842,MATH 20C,B01,083762,Staff,13,0,30,17
1650500085842,MATH 20C,B02,083763,Staff,28,0,30,2
1650500091866,MATH 20D,A01,083765,Staff,0,1,30,30
1650500091866,MATH 20D,A02,083766,Staff,9,0,30,21
1650500091866,MATH 20D,A03,083767,Staff,25,0,30,5
1650500097900,MATH 20E,A01,083771,Staff,6,0,30,24
1650500097900,MATH 20E,A02,083772,Staff,18,0,30,12
1650500097900,MATH 20E,B01,083773,Staff,0,0,30,30
1650500097900,MATH 20E,B02,083774,Staff,10,0,30,20
1650500103927,MATH 103A,A01,083777,Staff,0,12,30,30
1650500103927,MATH 103A,A02,083778,Staff,0,12,30,30
1650500103927,MATH 103A,B01,083779,Staff,0,13,30,30
1650500103927,MATH 103A,B02,083780,Staff,0,13,30,30
1650500109953,MATH 105,A01,085443,Staff,1,23,30,29
1650500115980,MATH 109,A01,083213,Anzaldo; Leesa B,0,7,30,30
1650500115980,MATH 109,A02,083214,Anzaldo; Leesa B,0,7,30,30
1650500115980,MATH 109,B01,083215,Anzaldo; Leesa B,0,5,30,30
1650500115980,MATH 109,B02,083216,Anzaldo; Leesa B,0,6,30,30
1650500122003,MATH 142A,A01,083219,Chow; Bennett,0,15,30,30
1650500122003,MATH 142A,A02,083220,Chow; Bennett,0,14,30,30
1650500122003,MATH 142A,B01,083221,Chow; Bennett,0,13,30,30
1650500122003,MATH 142A,B02,083222,Chow; Bennett,0,13,30,30
1650500128035,MATH 193A,A01,083224,Staff,0,5,30,30
1650500128035,MATH 193A,A02,083225,Staff,0,5,30,30
1650500128035,MATH 193A,A03,083781,Staff,0,5,30,30
1650500128035,MATH 193A,A04,083782,Staff,0,6,30,30
1650500134147,MATH 197,001,091859,McAuley; Julian John,9998,0,9999,1
1650500140208,COGS 9,A01,083615,Staff,0,14,60,60
1650500146235,COGS 11,A01,083617,Boyle; Mary E. T.,20,0,40,20
1650500152260,COGS 13,A01,083071,Staff,0,34,40,40
1650500158287,COGS 14A,A01,092681,Staff,1,25,100,99
1650500164311,COGS 14B,A01,083073,Cheng; Tzu-Han,0,11,50,50
1650500170332,COGS 17,A01,092677,Staff,20,0,75,55
1650500176357,COGS 100,A01,083619,Staff,0,26,60,60
1650500182383,COGS 101A,A01,083621,Davis; Joshua Daniel,0,23,60,60
1650500188407,COGS 101B,A01,091572,Staff,0,4,60,60
1650500194439,COGS 101C,A01,083625,Delgado; Tania,16,0,30,14
1650500200469,COGS 107A,A01,083627,Boyle; Mary E. T.,0,12,60,60
1650500206493,COGS 118A,A01,083075,Staff,0,3,60,60
1650500212524,CSE 3,A50,083646,Miranda; Gregory Joseph,20,0,38,18
1650500212524,CSE 3,A51,083647,Miranda; Gregory Joseph,36,0,37,1
1650500218552,CSE 8A,A50,083650,Miranda; Gregory Joseph,1,29,40,39
1650500224581,CSE 11,A01,083080,Cao; Yingjun,0,92,40,40
1650500230611,CSE 12,A01,083652,Staff,0,17,100,100
1650500236635,CSE 15L,A01,083654,Staff,0,1,50,50
1650500236635,CSE 15L,A02,083655,Staff,0,0,50,50
1650500242662,CSE 20,A01,083657,Staff,51,0,80,29
1650500248688,CSE 30,A01,083084,Eldon; John,0,77,40,40
1650500254712,CSE 100,A01,083659,Cao; Yingjun,0,67,50,50
1650500260737,CSE 134B,A01,083661,Powell; Thomas Allan,0,32,65,65
1650500266761,CSE 140,A01,083663,Staff,0,5,75,75
1650500272783,CSE 140L,A01,083088,Eldon; John,0,11,75,75
1650500278806,CSE 175,A01,083665,Kumar; Rakesh,7,0,25,18
1650500284829,CSE 190,A00,092507,Dubnov; Shlomo,10,0,20,10
1650500290861,ECE 45,A01,083139,Staff,20,19,60,40
1650500296883,ECE 65,A50,083695,Staff,0,6,30,30
1650500302913,ECE 109,A01,091882,Touri; Behrouz,36,0,70,34
1650500308938,ECE 180,A00,083140,Abi Samra; Nicholas Camill,21,0,30,9
1650500308938,ECE 180,B00,083141,Abi Samra; Nicholas Camill,0,0,30,30
1650500314965,MATH 10A,A01,083735,Patchell; Gregory David,5,0,30,25
1650500314965,MATH 10A,A02,083736,Patchell; Gregory David,27,0,30,3
1650500314965,MATH 10A,A03,083737,Patchell; Gregory David,25,0,30,5
1650500320991,MATH 10B,A01,083207,Staff,0,8,30,30
1650500320991,MATH 10B,A02,083208,Staff,0,7,30,30
1650500320991,MATH 10B,B01,083739,Staff,13,0,30,17
1650500320991,MATH 10B,B02,083740,Staff,28,0,30,2
1650500327020,MATH 18,A01,083743,Staff,0,0,30,30
1650500327020,MATH 18,A02,083744,Staff,27,0,30,3
1650500327020,MATH 18,A03,083745,Staff,22,0,30,8
1650500327020,MATH 18,A04,083746,Staff,26,0,30,4
1650500327020,MATH 18,B01,083748,Staff,0,11,30,30
1650500327020,MATH 18,B02,083749,Staff,0,12,30,30
1650500327020,MATH 18,B03,083750,Staff,0,11,30,30
1650500327020,MATH 18,B04,083751,Staff,0,12,30,30
1650500333044,MATH 20A,A01,083754,Staff,25,0,40,15
1650500339067,MATH 20B,A01,083756,Staff,0,11,30,30
1650500339067,MATH 20B,A02,083757,Staff,0,11,30,30
1650500345094,MATH 20C,A01,083760,Staff,0,16,30,30
1650500345094,MATH 20C,A02,083761,Staff,2,15,30,28
1650500345094,MATH 20C,B01,083762,Staff,13,0,30,17
1650500345094,MATH 20C,B02,083763,Staff,28,0,30,2
1650500351120,MATH 20D,A01,083765,Staff,0,1,30,30
1650500351120,MATH 20D,A02,083766,Staff,9,0,30,21
1650500351120,MATH 20D,A03,083767,Staff,25,0,30,5
1650500357147,MATH 20E,A01,083771,Staff,6,0,30,24
1650500357147,MATH 20E,A02,083772,Staff,18,0,30,12
1650500357147,MATH 20E,B01,083773,Staff,0,0,30,30
1650500357147,MATH 20E,B02,083774,Staff,10,0,30,20
1650500363170,MATH 103A,A01,083777,Staff,0,12,30,30
1650500363170,MATH 103A,A02,083778,Staff,0,12,30,30
1650500363170,MATH 103A,B01,083779,Staff,0,13,30,30
1650500363170,MATH 103A,B02,083780,Staff,0,13,30,30
1650500369192,MATH 105,A01,085443,Staff,1,23,30,29
1650500375217,MATH 109,A01,083213,Anzaldo; Leesa B,0,7,30,30
1650500375217,MATH 109,A02,083214,Anzaldo; Leesa B,0,7,30,30
1650500375217,MATH 109,B01,083215,Anzaldo; Leesa B,0,5,30,30
1650500375217,MATH 109,B02,083216,Anzaldo; Leesa B,0,6,30,30
1650500381238,MATH 142A,A01,083219,Chow; Bennett,0,15,30,30
1650500381238,MATH 142A,A02,083220,Chow; Bennett,0,14,30,30
1650500381238,MATH 142A,B01,083221,Chow; Bennett,0,13,30,30
1650500381238,MATH 142A,B02,083222,Chow; Bennett,0,13,30,30
1650500387263,MATH 193A,A01,083224,Staff,0,5,30,30
1650500387263,MATH 193A,A02,083225,Staff,0,5,30,30
1650500387263,MATH 193A,A03,083781,Staff,0,5,30,30
1650500387263,MATH 193A,A04,083782,Staff,0,6,30,30
1650500393289,MATH 197,001,091859,McAuley; Julian John,9998,0,9999,1
1650500399341,COGS 9,A01,083615,Staff,0,14,60,60
1650500405363,COGS 11,A01,083617,Boyle; Mary E. T.,20,0,40,20
1650500411388,COGS 13,A01,083071,Staff,0,34,40,40
1650500417415,COGS 14A,A01,092681,Staff,1,25,100,99
1650500423440,COGS 14B,A01,083073,Cheng; Tzu-Han,0,11,50,50
1650500429465,COGS 17,A01,092677,Staff,20,0,75,55
1650500435491,COGS 100,A01,083619,Staff,0,26,60,60
1650500441517,COGS 101A,A01,083621,Davis; Joshua Daniel,0,23,60,60
1650500447543,COGS 101B,A01,091572,Staff,0,4,60,60
1650500453581,COGS 101C,A01,083625,Delgado; Tania,16,0,30,14
1650500459603,COGS 107A,A01,083627,Boyle; Mary E. T.,0,12,60,60
1650500465626,COGS 118A,A01,083075,Staff,0,3,60,60
1650500471652,CSE 3,A50,083646,Miranda; Gregory Joseph,20,0,38,18
1650500471652,CSE 3,A51,083647,Miranda; Gregory Joseph,36,0,37,1
1650500477680,CSE 8A,A50,083650,Miranda; Gregory Joseph,1,29,40,39
1650500483716,CSE 11,A01,083080,Cao; Yingjun,0,92,40,40
1650500489738,CSE 12,A01,083652,Staff,0,17,100,100
1650500495762,CSE 15L,A01,083654,Staff,0,1,50,50
1650500495762,CSE 15L,A02,083655,Staff,0,0,50,50
1650500501786,CSE 20,A01,083657,Staff,51,0,80,29
1650500507808,CSE 30,A01,083084,Eldon; John,0,77,40,40
1650500513834,CSE 100,A01,083659,Cao; Yingjun,0,67,50,50
1650500519857,CSE 134B,A01,083661,Powell; Thomas Allan,0,32,65,65
1650500525881,CSE 140,A01,083663,Staff,0,5,75,75
1650500531913,CSE 140L,A01,083088,Eldon; John,0,11,75,75
1650500537940,CSE 175,A01,083665,Kumar; Rakesh,7,0,25,18
1650500543963,CSE 190,A00,092507,Dubnov; Shlomo,10,0,20,10
1650500549987,ECE 45,A01,083139,Staff,20,19,60,40
1650500556013,ECE 65,A50,083695,Staff,0,6,30,30
1650500562044,ECE 109,A01,091882,Touri; Behrouz,36,0,70,34
1650500568072,ECE 180,A00,083140,Abi Samra; Nicholas Camill,21,0,30,9
1650500568072,ECE 180,B00,083141,Abi Samra; Nicholas Camill,0,0,30,30
1650500574097,MATH 10A,A01,083735,Patchell; Gregory David,5,0,30,25
1650500574097,MATH 10A,A02,083736,Patchell; Gregory David,27,0,30,3
1650500574097,MATH 10A,A03,083737,Patchell; Gregory David,25,0,30,5
1650500580124,MATH 10B,A01,083207,Staff,0,8,30,30
1650500580124,MATH 10B,A02,083208,Staff,0,7,30,30
1650500580124,MATH 10B,B01,083739,Staff,13,0,30,17
1650500580124,MATH 10B,B02,083740,Staff,28,0,30,2
1650500586164,MATH 18,A01,083743,Staff,0,0,30,30
1650500586164,MATH 18,A02,083744,Staff,27,0,30,3
1650500586164,MATH 18,A03,083745,Staff,22,0,30,8
1650500586164,MATH 18,A04,083746,Staff,26,0,30,4
1650500586164,MATH 18,B01,083748,Staff,0,11,30,30
1650500586164,MATH 18,B02,083749,Staff,0,12,30,30
1650500586164,MATH 18,B03,083750,Staff,0,11,30,30
1650500586164,MATH 18,B04,083751,Staff,0,12,30,30
1650500592199,MATH 20A,A01,083754,Staff,25,0,40,15
1650500598223,MATH 20B,A01,083756,Staff,0,11,30,30
1650500598223,MATH 20B,A02,083757,Staff,0,11,30,30
1650500604245,MATH 20C,A01,083760,Staff,0,16,30,30
1650500604245,MATH 20C,A02,083761,Staff,2,15,30,28
1650500604245,MATH 20C,B01,083762,Staff,13,0,30,17
1650500604245,MATH 20C,B02,083763,Staff,28,0,30,2
1650500610277,MATH 20D,A01,083765,Staff,0,1,30,30
1650500610277,MATH 20D,A02,083766,Staff,9,0,30,21
1650500610277,MATH 20D,A03,083767,Staff,25,0,30,5
1650500616299,MATH 20E,A01,083771,Staff,6,0,30,24
1650500616299,MATH 20E,A02,083772,Staff,18,0,30,12
1650500616299,MATH 20E,B01,083773,Staff,0,0,30,30
1650500616299,MATH 20E,B02,083774,Staff,10,0,30,20
1650500622322,MATH 103A,A01,083777,Staff,0,12,30,30
1650500622322,MATH 103A,A02,083778,Staff,0,12,30,30
1650500622322,MATH 103A,B01,083779,Staff,0,13,30,30
1650500622322,MATH 103A,B02,083780,Staff,0,13,30,30
1650500628345,MATH 105,A01,085443,Staff,1,23,30,29
1650500634372,MATH 109,A01,083213,Anzaldo; Leesa B,0,7,30,30
1650500634372,MATH 109,A02,083214,Anzaldo; Leesa B,0,7,30,30
1650500634372,MATH 109,B01,083215,Anzaldo; Leesa B,0,5,30,30
1650500634372,MATH 109,B02,083216,Anzaldo; Leesa B,0,6,30,30
1650500640396,MATH 142A,A01,083219,Chow; Bennett,0,15,30,30
1650500640396,MATH 142A,A02,083220,Chow; Bennett,0,14,30,30
1650500640396,MATH 142A,B01,083221,Chow; Bennett,0,13,30,30
1650500640396,MATH 142A,B02,083222,Chow; Bennett,0,13,30,30
1650500646420,MATH 193A,A01,083224,Staff,0,5,30,30
1650500646420,MATH 193A,A02,083225,Staff,0,5,30,30
1650500646420,MATH 193A,A03,083781,Staff,0,5,30,30
1650500646420,MATH 193A,A04,083782,Staff,0,6,30,30
1650500652444,MATH 197,001,091859,McAuley; Julian John,9998,0,9999,1
1650500658496,COGS 9,A01,083615,Staff,0,14,60,60
1650500664526,COGS 11,A01,083617,Boyle; Mary E. T.,20,0,40,20
1650500670551,COGS 13,A01,083071,Staff,0,34,40,40
1650500676577,COGS 14A,A01,092681,Staff,1,25,100,99
1650500682599,COGS 14B,A01,083073,Cheng; Tzu-Han,0,11,50,50
1650500688622,COGS 17,A01,092677,Staff,20,0,75,55
1650500694645,COGS 100,A01,083619,Staff,0,26,60,60
1650500700668,COGS 101A,A01,083621,Davis; Joshua Daniel,0,23,60,60
1650500706697,COGS 101B,A01,091572,Staff,0,4,60,60
1650500712728,COGS 101C,A01,083625,Delgado; Tania,16,0,30,14
1650500718753,COGS 107A,A01,083627,Boyle; Mary E. T.,0,12,60,60
1650500724867,COGS 118A,A01,083075,Staff,0,3,60,60
1650500730892,CSE 3,A50,083646,Miranda; Gregory Joseph,20,0,38,18
1650500730892,CSE 3,A51,083647,Miranda; Gregory Joseph,36,0,37,1
1650500736919,CSE 8A,A50,083650,Miranda; Gregory Joseph,1,29,40,39
1650500742946,CSE 11,A01,083080,Cao; Yingjun,0,92,40,40
1650500748971,CSE 12,A01,083652,Staff,0,17,100,100
1650500754997,CSE 15L,A01,083654,Staff,0,1,50,50
1650500754997,CSE 15L,A02,083655,Staff,0,0,50,50
1650500761021,CSE 20,A01,083657,Staff,51,0,80,29
1650500767054,CSE 30,A01,083084,Eldon; John,0,77,40,40
1650500773085,CSE 100,A01,083659,Cao; Yingjun,0,67,50,50
1650500779114,CSE 134B,A01,083661,Powell; Thomas Allan,0,32,65,65
1650500785145,CSE 140,A01,083663,Staff,0,5,75,75
1650500791171,CSE 140L,A01,083088,Eldon; John,0,11,75,75
1650500797194,CSE 175,A01,083665,Kumar; Rakesh,7,0,25,18
1650500803219,CSE 190,A00,092507,Dubnov; Shlomo,10,0,20,10
1650500809242,ECE 45,A01,083139,Staff,20,19,60,40
1650500815264,ECE 65,A50,083695,Staff,0,6,30,30
1650500821291,ECE 109,A01,091882,Touri; Behrouz,36,0,70,34
1650500827322,ECE 180,A00,083140,Abi Samra; Nicholas Camill,21,0,30,9
1650500827322,ECE 180,B00,083141,Abi Samra; Nicholas Camill,0,0,30,30
1650500833350,MATH 10A,A01,083735,Patchell; Gregory David,5,0,30,25
1650500833350,MATH 10A,A02,083736,Patchell; Gregory David,27,0,30,3
1650500833350,MATH 10A,A03,083737,Patchell; Gregory David,25,0,30,5
1650500839393,MATH 10B,A01,083207,Staff,0,8,30,30
1650500839393,MATH 10B,A02,083208,Staff,0,7,30,30
1650500839393,MATH 10B,B01,083739,Staff,13,0,30,17
1650500839393,MATH 10B,B02,083740,Staff,28,0,30,2
1650500845425,MATH 18,A01,083743,Staff,0,0,30,30
1650500845425,MATH 18,A02,083744,Staff,27,0,30,3
1650500845425,MATH 18,A03,083745,Staff,22,0,30,8
1650500845425,MATH 18,A04,083746,Staff,26,0,30,4
1650500845425,MATH 18,B01,083748,Staff,0,11,30,30
1650500845425,MATH 18,B02,083749,Staff,0,12,30,30
1650500845425,MATH 18,B03,083750,Staff,0,11,30,30
1650500845425,MATH 18,B04,083751,Staff,0,12,30,30
1650500851451,MATH 20A,A01,083754,Staff,25,0,40,15
1650500857479,MATH 20B,A01,083756,Staff,0,11,30,30
1650500857479,MATH 20B,A02,083757,Staff,0,11,30,30
1650500863505,MATH 20C,A01,083760,Staff,0,16,30,30
1650500863505,MATH 20C,A02,083761,Staff,2,15,30,28
1650500863505,MATH 20C,B01,083762,Staff,13,0,30,17
1650500863505,MATH 20C,B02,083763,Staff,28,0,30,2
1650500869530,MATH 20D,A01,083765,Staff,0,1,30,30
1650500869530,MATH 20D,A02,083766,Staff,9,0,30,21
1650500869530,MATH 20D,A03,083767,Staff,25,0,30,5
1650500875563,MATH 20E,A01,083771,Staff,6,0,30,24
1650500875563,MATH 20E,A02,083772,Staff,18,0,30,12
1650500875563,MATH 20E,B01,083773,Staff,0,0,30,30
1650500875563,MATH 20E,B02,083774,Staff,10,0,30,20
1650500881594,MATH 103A,A01,083777,Staff,0,12,30,30
1650500881594,MATH 103A,A02,083778,Staff,0,12,30,30
1650500881594,MATH 103A,B01,083779,Staff,0,13,30,30
1650500881594,MATH 103A,B02,083780,Staff,0,13,30,30
1650500887617,MATH 105,A01,085443,Staff,1,23,30,29
1650500893648,MATH 109,A01,083213,Anzaldo; Leesa B,0,7,30,30
1650500893648,MATH 109,A02,083214,Anzaldo; Leesa B,0,7,30,30
1650500893648,MATH 109,B01,083215,Anzaldo; Leesa B,0,5,30,30
1650500893648,MATH 109,B02,083216,Anzaldo; Leesa B,0,6,30,30
1650500899677,MATH 142A,A01,083219,Chow; Bennett,0,15,30,30
1650500899677,MATH 142A,A02,083220,Chow; Bennett,0,14,30,30
1650500899677,MATH 142A,B01,083221,Chow; Bennett,0,13,30,30
1650500899677,MATH 142A,B02,083222,Chow; Bennett,0,13,30,30
1650500905707,MATH 193A,A01,083224,Staff,0,5,30,30
1650500905707,MATH 193A,A02,083225,Staff,0,5,30,30
1650500905707,MATH 193A,A03,083781,Staff,0,5,30,30
1650500905707,MATH 193A,A04,083782,Staff,0,6,30,30
1650500911733,MATH 197,001,091859,McAuley; Julian John,9998,0,9999,1
1650500917800,COGS 9,A01,083615,Staff,0,14,60,60
1650500923824,COGS 11,A01,083617,Boyle; Mary E. T.,20,0,40,20
1650500929851,COGS 13,A01,083071,Staff,0,34,40,40
1650500935874,COGS 14A,A01,092681,Staff,1,25,100,99
1650500941897,COGS 14B,A01,083073,Cheng; Tzu-Han,0,11,50,50
1650500947921,COGS 17,A01,092677,Staff,20,0,75,55
1650500953943,COGS 100,A01,083619,Staff,0,26,60,60
1650500959967,COGS 101A,A01,083621,Davis; Joshua Daniel,0,23,60,60
1650500965991,COGS 101B,A01,091572,Staff,0,4,60,60
1650500972013,COGS 101C,A01,083625,Delgado; Tania,16,0,30,14
1650500978041,COGS 107A,A01,083627,Boyle; Mary E. T.,0,12,60,60
1650500984067,COGS 118A,A01,083075,Staff,0,3,60,60
1650500990094,CSE 3,A50,083646,Miranda; Gregory Joseph,20,0,38,18
1650500990094,CSE 3,A51,083647,Miranda; Gregory Joseph,36,0,37,1
1650500996118,CSE 8A,A50,083650,Miranda; Gregory Joseph,1,29,40,39
1650501002141,CSE 11,A01,083080,Cao; Yingjun,0,92,40,40
1650501008168,CSE 12,A01,083652,Staff,0,17,100,100
1650501014195,CSE 15L,A01,083654,Staff,0,1,50,50
1650501014195,CSE 15L,A02,083655,Staff,0,0,50,50
1650501020219,CSE 20,A01,083657,Staff,51,0,80,29
1650501026246,CSE 30,A01,083084,Eldon; John,0,77,40,40
1650501032272,CSE 100,A01,083659,Cao; Yingjun,0,67,50,50
1650501038298,CSE 134B,A01,083661,Powell; Thomas Allan,0,32,65,65
1650501044326,CSE 140,A01,083663,Staff,0,5,75,75
1650501050362,CSE 140L,A01,083088,Eldon; John,0,11,75,75
1650501056386,CSE 175,A01,083665,Kumar; Rakesh,7,0,25,18
1650501062412,CSE 190,A00,092507,Dubnov; Shlomo,10,0,20,10
1650501068438,ECE 45,A01,083139,Staff,20,19,60,40
1650501074462,ECE 65,A50,083695,Staff,0,6,30,30
1650501080490,ECE 109,A01,091882,Touri; Behrouz,36,0,70,34
1650501086517,ECE 180,A00,083140,Abi Samra; Nicholas Camill,21,0,30,9
1650501086517,ECE 180,B00,083141,Abi Samra; Nicholas Camill,0,0,30,30
1650501092541,MATH 10A,A01,083735,Patchell; Gregory David,5,0,30,25
1650501092541,MATH 10A,A02,083736,Patchell; Gregory David,27,0,30,3
1650501092541,MATH 10A,A03,083737,Patchell; Gregory David,25,0,30,5
1650501098568,MATH 10B,A01,083207,Staff,0,8,30,30
1650501098568,MATH 10B,A02,083208,Staff,0,7,30,30
1650501098568,MATH 10B,B01,083739,Staff,13,0,30,17
1650501098568,MATH 10B,B02,083740,Staff,28,0,30,2
1650501104592,MATH 18,A01,083743,Staff,0,0,30,30
1650501104592,MATH 18,A02,083744,Staff,27,0,30,3
1650501104592,MATH 18,A03,083745,Staff,22,0,30,8
1650501104592,MATH 18,A04,083746,Staff,26,0,30,4
1650501104592,MATH 18,B01,083748,Staff,0,11,30,30
1650501104592,MATH 18,B02,083749,Staff,0,12,30,30
1650501104592,MATH 18,B03,083750,Staff,0,11,30,30
1650501104592,MATH 18,B04,083751,Staff,0,12,30,30
1650501110620,MATH 20A,A01,083754,Staff,25,0,40,15
1650501116643,MATH 20B,A01,083756,Staff,0,11,30,30
1650501116643,MATH 20B,A02,083757,Staff,0,11,30,30
1650501122670,MATH 20C,A01,083760,Staff,0,16,30,30
1650501122670,MATH 20C,A02,083761,Staff,2,15,30,28
1650501122670,MATH 20C,B01,083762,Staff,13,0,30,17
1650501122670,MATH 20C,B02,083763,Staff,28,0,30,2
1650501128704,MATH 20D,A01,083765,Staff,0,1,30,30
1650501128704,MATH 20D,A02,083766,Staff,9,0,30,21
1650501128704,MATH 20D,A03,083767,Staff,25,0,30,5
1650501134732,MATH 20E,A01,083771,Staff,6,0,30,24
1650501134732,MATH 20E,A02,083772,Staff,18,0,30,12
1650501134732,MATH 20E,B01,083773,Staff,0,0,30,30
1650501134732,MATH 20E,B02,083774,Staff,10,0,30,20
1650501140756,MATH 103A,A01,083777,Staff,0,12,30,30
1650501140756,MATH 103A,A02,083778,Staff,0,12,30,30
1650501140756,MATH 103A,B01,083779,Staff,0,13,30,30
1650501140756,MATH 103A,B02,083780,Staff,0,13,30,30
1650501146779,MATH 105,A01,085443,Staff,1,23,30,29
1650501152811,MATH 109,A01,083213,Anzaldo; Leesa B,0,7,30,30
1650501152811,MATH 109,A02,083214,Anzaldo; Leesa B,0,7,30,30
1650501152811,MATH 109,B01,083215,Anzaldo; Leesa B,0,5,30,30
1650501152811,MATH 109,B02,083216,Anzaldo; Leesa B,0,6,30,30
1650501158835,MATH 142A,A01,083219,Chow; Bennett,0,15,30,30
1650501158835,MATH 142A,A02,083220,Chow; Bennett,0,14,30,30
1650501158835,MATH 142A,B01,083221,Chow; Bennett,0,13,30,30
1650501158835,MATH 142A,B02,083222,Chow; Bennett,0,13,30,30
1650501164862,MATH 193A,A01,083224,Staff,0,5,30,30
1650501164862,MATH 193A,A02,083225,Staff,0,5,30,30
1650501164862,MATH 193A,A03,083781,Staff,0,5,30,30
1650501164862,MATH 193A,A04,083782,Staff,0,6,30,30
1650501170885,MATH 197,001,091859,McAuley; Julian John,9998,0,9999,1
1650501176945,COGS 9,A01,083615,Staff,0,14,60,60
1650501182969,COGS 11,A01,083617,Boyle; Mary E. T.,20,0,40,20
1650501188992,COGS 13,A01,083071,Staff,0,34,40,40
1650501195018,COGS 14A,A01,092681,Staff,1,25,100,99
1650501201041,COGS 14B,A01,083073,Cheng; Tzu-Han,0,11,50,50
1650501207064,COGS 17,A01,092677,Staff,20,0,75,55
1650501213088,COGS 100,A01,083619,Staff,0,26,60,60
1650501219117,COGS 101A,A01,083621,Davis; Joshua Daniel,0,23,60,60
1650501225142,COGS 101B,A01,091572,Staff,0,4,60,60
1650501231166,COGS 101C,A01,083625,Delgado; Tania,16,0,30,14
1650501237192,COGS 107A,A01,083627,Boyle; Mary E. T.,0,12,60,60
1650501243222,COGS 118A,A01,083075,Staff,0,3,60,60
1650501249257,CSE 3,A50,083646,Miranda; Gregory Joseph,20,0,38,18
1650501249257,CSE 3,A51,083647,Miranda; Gregory Joseph,36,0,37,1
1650501255285,CSE 8A,A50,083650,Miranda; Gregory Joseph,1,29,40,39
1650501261310,CSE 11,A01,083080,Cao; Yingjun,0,92,40,40
1650501267332,CSE 12,A01,083652,Staff,0,17,100,100
1650501273357,CSE 15L,A01,083654,Staff,0,1,50,50
1650501273357,CSE 15L,A02,083655,Staff,0,0,50,50
1650501279382,CSE 20,A01,083657,Staff,51,0,80,29
1650501285409,CSE 30,A01,083084,Eldon; John,0,77,40,40
1650501291432,CSE 100,A01,083659,Cao; Yingjun,0,67,50,50
1650501297459,CSE 134B,A01,083661,Powell; Thomas Allan,0,32,65,65
1650501303486,CSE 140,A01,083663,Staff,0,5,75,75
1650501309508,CSE 140L,A01,083088,Eldon; John,0,11,75,75
1650501315532,CSE 175,A01,083665,Kumar; Rakesh,7,0,25,18
1650501321646,CSE 190,A00,092507,Dubnov; Shlomo,10,0,20,10
1650501327670,ECE 45,A01,083139,Staff,20,19,60,40
1650501333697,ECE 65,A50,083695,Staff,0,6,30,30
1650501339720,ECE 109,A01,091882,Touri; Behrouz,36,0,70,34
1650501345742,ECE 180,A00,083140,Abi Samra; Nicholas Camill,21,0,30,9
1650501345742,ECE 180,B00,083141,Abi Samra; Nicholas Camill,0,0,30,30
1650501351769,MATH 10A,A01,083735,Patchell; Gregory David,5,0,30,25
1650501351769,MATH 10A,A02,083736,Patchell; Gregory David,27,0,30,3
1650501351769,MATH 10A,A03,083737,Patchell; Gregory David,25,0,30,5
1650501357792,MATH 10B,A01,083207,Staff,0,8,30,30
1650501357792,MATH 10B,A02,083208,Staff,0,7,30,30
1650501357792,MATH 10B,B01,083739,Staff,13,0,30,17
1650501357792,MATH 10B,B02,083740,Staff,28,0,30,2
1650501363823,MATH 18,A01,083743,Staff,0,0,30,30
1650501363823,MATH 18,A02,083744,Staff,27,0,30,3
1650501363823,MATH 18,A03,083745,Staff,22,0,30,8
1650501363823,MATH 18,A04,083746,Staff,26,0,30,4
1650501363823,MATH 18,B01,083748,Staff,0,11,30,30
1650501363823,MATH 18,B02,083749,Staff,0,12,30,30
1650501363823,MATH 18,B03,083750,Staff,0,11,30,30
1650501363823,MATH 18,B04,083751,Staff,0,12,30,30
1650501369846,MATH 20A,A01,083754,Staff,25,0,40,15
1650501375870,MATH 20B,A01,083756,Staff,0,11,30,30
1650501375870,MATH 20B,A02,083757,Staff,0,11,30,30
1650501381895,MATH 20C,A01,083760,Staff,0,16,30,30
1650501381895,MATH 20C,A02,083761,Staff,2,15,30,28
1650501381895,MATH 20C,B01,083762,Staff,13,0,30,17
1650501381895,MATH 20C,B02,083763,Staff,28,0,30,2
1650501387918,MATH 20D,A01,083765,Staff,0,1,30,30
1650501387918,MATH 20D,A02,083766,Staff,9,0,30,21
1650501387918,MATH 20D,A03,083767,Staff,25,0,30,5
1650501393940,MATH 20E,A01,083771,Staff,6,0,30,24
1650501393940,MATH 20E,A02,083772,Staff,18,0,30,12
1650501393940,MATH 20E,B01,083773,Staff,0,0,30,30
1650501393940,MATH 20E,B02,083774,Staff,10,0,30,20
1650501399968,MATH 103A,A01,083777,Staff,0,12,30,30
1650501399968,MATH 103A,A02,083778,Staff,0,12,30,30
1650501399968,MATH 103A,B01,083779,Staff,0,13,30,30
1650501399968,MATH 103A,B02,083780,Staff,0,13,30,30
1650501405995,MATH 105,A01,085443,Staff,1,23,30,29
1650501412023,MATH 109,A01,083213,Anzaldo; Leesa B,0,7,30,30
1650501412023,MATH 109,A02,083214,Anzaldo; Leesa B,0,7,30,30
1650501412023,MATH 109,B01,083215,Anzaldo; Leesa B,0,5,30,30
1650501412023,MATH 109,B02,083216,Anzaldo; Leesa B,0,6,30,30
1650501418050,MATH 142A,A01,083219,Chow; Bennett,0,15,30,30
1650501418050,MATH 142A,A02,083220,Chow; Bennett,0,14,30,30
1650501418050,MATH 142A,B01,083221,Chow; Bennett,0,13,30,30
1650501418050,MATH 142A,B02,083222,Chow; Bennett,0,13,30,30
1650501424084,MATH 193A,A01,083224,Staff,0,5,30,30
1650501424084,MATH 193A,A02,083225,Staff,0,5,30,30
1650501424084,MATH 193A,A03,083781,Staff,0,5,30,30
1650501424084,MATH 193A,A04,083782,Staff,0,7,30,30
1650501430119,MATH 197,001,091859,McAuley; Julian John,9998,0,9999,1
1650501436171,COGS 9,A01,083615,Staff,0,14,60,60
1650501442197,COGS 11,A01,083617,Boyle; Mary E. T.,20,0,40,20
1650501448223,COGS 13,A01,083071,Staff,0,34,40,40
1650501454246,COGS 14A,A01,092681,Staff,1,25,100,99
1650501460280,COGS 14B,A01,083073,Cheng; Tzu-Han,0,11,50,50
1650501466304,COGS 17,A01,092677,Staff,20,0,75,55
1650501472330,COGS 100,A01,083619,Staff,0,26,60,60
1650501478357,COGS 101A,A01,083621,Davis; Joshua Daniel,0,23,60,60
1650501484386,COGS 101B,A01,091572,Staff,0,4,60,60
1650501490410,COGS 101C,A01,083625,Delgado; Tania,16,0,30,14
1650501496433,COGS 107A,A01,083627,Boyle; Mary E. T.,0,12,60,60
1650501502467,COGS 118A,A01,083075,Staff,0,3,60,60
1650501508491,CSE 3,A50,083646,Miranda; Gregory Joseph,20,0,38,18
1650501508491,CSE 3,A51,083647,Miranda; Gregory Joseph,36,0,37,1
1650501514527,CSE 8A,A50,083650,Miranda; Gregory Joseph,1,29,40,39
1650501520557,CSE 11,A01,083080,Cao; Yingjun,0,92,40,40
1650501526581,CSE 12,A01,083652,Staff,0,17,100,100
1650501532619,CSE 15L,A01,083654,Staff,0,1,50,50
1650501532619,CSE 15L,A02,083655,Staff,0,0,50,50
1650501538644,CSE 20,A01,083657,Staff,51,0,80,29
1650501544671,CSE 30,A01,083084,Eldon; John,0,77,40,40
1650501550697,CSE 100,A01,083659,Cao; Yingjun,0,67,50,50
1650501556724,CSE 134B,A01,083661,Powell; Thomas Allan,0,32,65,65
1650501562747,CSE 140,A01,083663,Staff,0,5,75,75
1650501568769,CSE 140L,A01,083088,Eldon; John,0,11,75,75
1650501574793,CSE 175,A01,083665,Kumar; Rakesh,7,0,25,18
1650501580822,CSE 190,A00,092507,Dubnov; Shlomo,10,0,20,10
1650501586845,ECE 45,A01,083139,Staff,20,19,60,40
1650501592869,ECE 65,A50,083695,Staff,0,6,30,30
1650501598901,ECE 109,A01,091882,Touri; Behrouz,36,0,70,34
1650501604925,ECE 180,A00,083140,Abi Samra; Nicholas Camill,21,0,30,9
1650501604925,ECE 180,B00,083141,Abi Samra; Nicholas Camill,0,0,30,30
1650501610952,MATH 10A,A01,083735,Patchell; Gregory David,5,0,30,25
1650501610952,MATH 10A,A02,083736,Patchell; Gregory David,27,0,30,3
1650501610952,MATH 10A,A03,083737,Patchell; Gregory David,25,0,30,5
1650501616976,MATH 10B,A01,083207,Staff,0,8,30,30
1650501616976,MATH 10B,A02,083208,Staff,0,7,30,30
1650501616976,MATH 10B,B01,083739,Staff,13,0,30,17
1650501616976,MATH 10B,B02,083740,Staff,28,0,30,2
1650501623012,MATH 18,A01,083743,Staff,0,0,30,30
1650501623012,MATH 18,A02,083744,Staff,27,0,30,3
1650501623012,MATH 18,A03,083745,Staff,22,0,30,8
1650501623012,MATH 18,A04,083746,Staff,26,0,30,4
1650501623012,MATH 18,B01,083748,Staff,0,11,30,30
1650501623012,MATH 18,B02,083749,Staff,0,12,30,30
1650501623012,MATH 18,B03,083750,Staff,0,11,30,30
1650501623012,MATH 18,B04,083751,Staff,0,12,30,30
1650501629037,MATH 20A,A01,083754,Staff,25,0,40,15
1650501635060,MATH 20B,A01,083756,Staff,0,11,30,30
1650501635060,MATH 20B,A02,083757,Staff,0,11,30,30
1650501641084,MATH 20C,A01,083760,Staff,0,16,30,30
1650501641084,MATH 20C,A02,083761,Staff,2,15,30,28
1650501641084,MATH 20C,B01,083762,Staff,13,0,30,17
1650501641084,MATH 20C,B02,083763,Staff,28,0,30,2
1650501647118,MATH 20D,A01,083765,Staff,0,1,30,30
1650501647118,MATH 20D,A02,083766,Staff,9,0,30,21
1650501647118,MATH 20D,A03,083767,Staff,25,0,30,5
1650501653146,MATH 20E,A01,083771,Staff,6,0,30,24
1650501653146,MATH 20E,A02,083772,Staff,18,0,30,12
1650501653146,MATH 20E,B01,083773,Staff,0,0,30,30
1650501653146,MATH 20E,B02,083774,Staff,10,0,30,20
1650501659169,MATH 103A,A01,083777,Staff,0,12,30,30
1650501659169,MATH 103A,A02,083778,Staff,0,12,30,30
1650501659169,MATH 103A,B01,083779,Staff,0,13,30,30
1650501659169,MATH 103A,B02,083780,Staff,0,13,30,30
1650501665201,MATH 105,A01,085443,Staff,1,23,30,29
1650501671227,MATH 109,A01,083213,Anzaldo; Leesa B,0,7,30,30
1650501671227,MATH 109,A02,083214,Anzaldo; Leesa B,0,7,30,30
1650501671227,MATH 109,B01,083215,Anzaldo; Leesa B,0,5,30,30
1650501671227,MATH 109,B02,083216,Anzaldo; Leesa B,0,6,30,30
1650501677258,MATH 142A,A01,083219,Chow; Bennett,0,15,30,30
1650501677258,MATH 142A,A02,083220,Chow; Bennett,0,14,30,30
1650501677258,MATH 142A,B01,083221,Chow; Bennett,0,13,30,30
1650501677258,MATH 142A,B02,083222,Chow; Bennett,0,13,30,30
1650501683283,MATH 193A,A01,083224,Staff,0,5,30,30
1650501683283,MATH 193A,A02,083225,Staff,0,5,30,30
1650501683283,MATH 193A,A03,083781,Staff,0,5,30,30
1650501683283,MATH 193A,A04,083782,Staff,0,7,30,30
1650501689313,MATH 197,001,091859,McAuley; Julian John,9998,0,9999,1
1650501695371,COGS 9,A01,083615,Staff,0,15,60,60
1650501701402,COGS 11,A01,083617,Boyle; Mary E. T.,20,0,40,20
1650501707429,COGS 13,A01,083071,Staff,0,34,40,40
1650501713454,COGS 14A,A01,092681,Staff,1,25,100,99
1650501719478,COGS 14B,A01,083073,Cheng; Tzu-Han,0,11,50,50
1650501725502,COGS 17,A01,092677,Staff,20,0,75,55
1650501731527,COGS 100,A01,083619,Staff,0,26,60,60
1650501737551,COGS 101A,A01,083621,Davis; Joshua Daniel,0,23,60,60
1650501743575,COGS 101B,A01,091572,Staff,0,4,60,60
1650501749602,COGS 101C,A01,083625,Delgado; Tania,16,0,30,14
1650501755626,COGS 107A,A01,083627,Boyle; Mary E. T.,0,12,60,60
1650501761650,COGS 118A,A01,083075,Staff,0,3,60,60
1650501767677,CSE 3,A50,083646,Miranda; Gregory Joseph,20,0,38,18
1650501767677,CSE 3,A51,083647,Miranda; Gregory Joseph,36,0,37,1
1650501773702,CSE 8A,A50,083650,Miranda; Gregory Joseph,1,29,40,39
1650501779723,CSE 11,A01,083080,Cao; Yingjun,0,92,40,40
1650501785747,CSE 12,A01,083652,Staff,0,17,100,100
1650501791771,CSE 15L,A01,083654,Staff,0,1,50,50
1650501791771,CSE 15L,A02,083655,Staff,0,0,50,50
1650501797797,CSE 20,A01,083657,Staff,51,0,80,29
1650501803821,CSE 30,A01,083084,Eldon; John,0,77,40,40
1650501809843,CSE 100,A01,083659,Cao; Yingjun,0,67,50,50
1650501815869,CSE 134B,A01,083661,Powell; Thomas Allan,0,32,65,65
1650501821897,CSE 140,A01,083663,Staff,0,5,75,75
1650501827922,CSE 140L,A01,083088,Eldon; John,0,11,75,75
1650501833943,CSE 175,A01,083665,Kumar; Rakesh,7,0,25,18
1650501839967,CSE 190,A00,092507,Dubnov; Shlomo,10,0,20,10
1650501845998,ECE 45,A01,083139,Staff,20,19,60,40
1650501852020,ECE 65,A50,083695,Staff,0,6,30,30
1650501858045,ECE 109,A01,091882,Touri; Behrouz,36,0,70,34
1650501864071,ECE 180,A00,083140,Abi Samra; Nicholas Camill,21,0,30,9
1650501864071,ECE 180,B00,083141,Abi Samra; Nicholas Camill,0,0,30,30
1650501870095,MATH 10A,A01,083735,Patchell; Gregory David,5,0,30,25
1650501870095,MATH 10A,A02,083736,Patchell; Gregory David,27,0,30,3
1650501870095,MATH 10A,A03,083737,Patchell; Gregory David,25,0,30,5
1650501876125,MATH 10B,A01,083207,Staff,0,8,30,30
1650501876125,MATH 10B,A02,083208,Staff,0,7,30,30
1650501876125,MATH 10B,B01,083739,Staff,13,0,30,17
1650501876125,MATH 10B,B02,083740,Staff,28,0,30,2
1650501882154,MATH 18,A01,083743,Staff,0,0,30,30
1650501882154,MATH 18,A02,083744,Staff,27,0,30,3
1650501882154,MATH 18,A03,083745,Staff,22,0,30,8
1650501882154,MATH 18,A04,083746,Staff,26,0,30,4
1650501882154,MATH 18,B01,083748,Staff,0,11,30,30
1650501882154,MATH 18,B02,083749,Staff,0,12,30,30
1650501882154,MATH 18,B03,083750,Staff,0,11,30,30
1650501882154,MATH 18,B04,083751,Staff,0,12,30,30
1650501888179,MATH 20A,A01,083754,Staff,25,0,40,15
1650501894207,MATH 20B,A01,083756,Staff,0,11,30,30
1650501894207,MATH 20B,A02,083757,Staff,0,11,30,30
1650501900233,MATH 20C,A01,083760,Staff,0,16,30,30
1650501900233,MATH 20C,A02,083761,Staff,2,15,30,28
1650501900233,MATH 20C,B01,083762,Staff,13,0,30,17
1650501900233,MATH 20C,B02,083763,Staff,28,0,30,2
1650501906257,MATH 20D,A01,083765,Staff,0,1,30,30
1650501906257,MATH 20D,A02,083766,Staff,9,0,30,21
1650501906257,MATH 20D,A03,083767,Staff,25,0,30,5
1650501912284,MATH 20E,A01,083771,Staff,6,0,30,24
1650501912284,MATH 20E,A02,083772,Staff,18,0,30,12
1650501912284,MATH 20E,B01,083773,Staff,0,0,30,30
1650501912284,MATH 20E,B02,083774,Staff,10,0,30,20
1650501918396,MATH 103A,A01,083777,Staff,0,12,30,30
1650501918396,MATH 103A,A02,083778,Staff,0,12,30,30
1650501918396,MATH 103A,B01,083779,Staff,0,13,30,30
1650501918396,MATH 103A,B02,083780,Staff,0,13,30,30
1650501924422,MATH 105,A01,085443,Staff,1,23,30,29
1650501930445,MATH 109,A01,083213,Anzaldo; Leesa B,0,7,30,30
1650501930445,MATH 109,A02,083214,Anzaldo; Leesa B,0,7,30,30
1650501930445,MATH 109,B01,083215,Anzaldo; Leesa B,0,5,30,30
1650501930445,MATH 109,B02,083216,Anzaldo; Leesa B,0,6,30,30
1650501936470,MATH 142A,A01,083219,Chow; Bennett,0,15,30,30
1650501936470,MATH 142A,A02,083220,Chow; Bennett,0,14,30,30
1650501936470,MATH 142A,B01,083221,Chow; Bennett,0,13,30,30
1650501936470,MATH 142A,B02,083222,Chow; Bennett,0,13,30,30
1650501942493,MATH 193A,A01,083224,Staff,0,5,30,30
1650501942493,MATH 193A,A02,083225,Staff,0,5,30,30
1650501942493,MATH 193A,A03,083781,Staff,0,5,30,30
1650501942493,MATH 193A,A04,083782,Staff,0,7,30,30
1650501948517,MATH 197,001,091859,McAuley; Julian John,9998,0,9999,1
1650501954578,COGS 9,A01,083615,Staff,0,15,60,60
1650501960612,COGS 11,A01,083617,Boyle; Mary E. T.,20,0,40,20
1650501966643,COGS 13,A01,083071,Staff,0,34,40,40
1650501972667,COGS 14A,A01,092681,Staff,1,25,100,99
1650501978695,COGS 14B,A01,083073,Cheng; Tzu-Han,0,11,50,50
1650501984720,COGS 17,A01,092677,Staff,20,0,75,55
1650501990744,COGS 100,A01,083619,Staff,0,26,60,60
1650501996775,COGS 101A,A01,083621,Davis; Joshua Daniel,0,23,60,60
1650502002801,COGS 101B,A01,091572,Staff,0,4,60,60
1650502008828,COGS 101C,A01,083625,Delgado; Tania,16,0,30,14
1650502014850,COGS 107A,A01,083627,Boyle; Mary E. T.,0,12,60,60
1650502020876,COGS 118A,A01,083075,Staff,0,3,60,60
1650502026898,CSE 3,A50,083646,Miranda; Gregory Joseph,20,0,38,18
1650502026898,CSE 3,A51,083647,Miranda; Gregory Joseph,36,0,37,1
1650502032922,CSE 8A,A50,083650,Miranda; Gregory Joseph,1,29,40,39
1650502038956,CSE 11,A01,083080,Cao; Yingjun,0,92,40,40
1650502044980,CSE 12,A01,083652,Staff,0,17,100,100
1650502051009,CSE 15L,A01,083654,Staff,0,1,50,50
1650502051009,CSE 15L,A02,083655,Staff,0,0,50,50
1650502057035,CSE 20,A01,083657,Staff,51,0,80,29
1650502063067,CSE 30,A01,083084,Eldon; John,0,77,40,40
1650502069111,CSE 100,A01,083659,Cao; Yingjun,0,67,50,50
1650502075136,CSE 134B,A01,083661,Powell; Thomas Allan,0,32,65,65
1650502081175,CSE 140,A01,083663,Staff,0,5,75,75
1650502087207,CSE 140L,A01,083088,Eldon; John,0,11,75,75
1650502093233,CSE 175,A01,083665,Kumar; Rakesh,7,0,25,18
1650502099259,CSE 190,A00,092507,Dubnov; Shlomo,10,0,20,10
1650502105280,ECE 45,A01,083139,Staff,20,19,60,40
1650502111304,ECE 65,A50,083695,Staff,0,6,30,30
1650502117329,ECE 109,A01,091882,Touri; Behrouz,36,0,70,34
1650502123358,ECE 180,A00,083140,Abi Samra; Nicholas Camill,21,0,30,9
1650502123358,ECE 180,B00,083141,Abi Samra; Nicholas Camill,0,0,30,30
1650502129394,MATH 10A,A01,083735,Patchell; Gregory David,5,0,30,25
1650502129394,MATH 10A,A02,083736,Patchell; Gregory David,27,0,30,3
1650502129394,MATH 10A,A03,083737,Patchell; Gregory David,25,0,30,5
1650502135422,MATH 10B,A01,083207,Staff,0,8,30,30
1650502135422,MATH 10B,A02,083208,Staff,0,7,30,30
1650502135422,MATH 10B,B01,083739,Staff,13,0,30,17
1650502135422,MATH 10B,B02,083740,Staff,28,0,30,2
1650502141448,MATH 18,A01,083743,Staff,0,0,30,30
1650502141448,MATH 18,A02,083744,Staff,27,0,30,3
1650502141448,MATH 18,A03,083745,Staff,22,0,30,8
1650502141448,MATH 18,A04,083746,Staff,26,0,30,4
1650502141448,MATH 18,B01,083748,Staff,0,11,30,30
1650502141448,MATH 18,B02,083749,Staff,0,12,30,30
1650502141448,MATH 18,B03,083750,Staff,0,11,30,30
1650502141448,MATH 18,B04,083751,Staff,0,12,30,30
1650502147470,MATH 20A,A01,083754,Staff,25,0,40,15
1650502153494,MATH 20B,A01,083756,Staff,0,11,30,30
1650502153494,MATH 20B,A02,083757,Staff,0,11,30,30
1650502159517,MATH 20C,A01,083760,Staff,0,16,30,30
1650502159517,MATH 20C,A02,083761,Staff,2,15,30,28
1650502159517,MATH 20C,B01,083762,Staff,13,0,30,17
1650502159517,MATH 20C,B02,083763,Staff,28,0,30,2
1650502165543,MATH 20D,A01,083765,Staff,0,1,30,30
1650502165543,MATH 20D,A02,083766,Staff,9,0,30,21
1650502165543,MATH 20D,A03,083767,Staff,25,0,30,5
1650502171567,MATH 20E,A01,083771,Staff,6,0,30,24
1650502171567,MATH 20E,A02,083772,Staff,18,0,30,12
1650502171567,MATH 20E,B01,083773,Staff,0,0,30,30
1650502171567,MATH 20E,B02,083774,Staff,10,0,30,20
1650502177594,MATH 103A,A01,083777,Staff,0,12,30,30
1650502177594,MATH 103A,A02,083778,Staff,0,12,30,30
1650502177594,MATH 103A,B01,083779,Staff,0,13,30,30
1650502177594,MATH 103A,B02,083780,Staff,0,13,30,30
1650502183616,MATH 105,A01,085443,Staff,1,23,30,29
1650502189642,MATH 109,A01,083213,Anzaldo; Leesa B,0,7,30,30
1650502189642,MATH 109,A02,083214,Anzaldo; Leesa B,0,7,30,30
1650502189642,MATH 109,B01,083215,Anzaldo; Leesa B,0,5,30,30
1650502189642,MATH 109,B02,083216,Anzaldo; Leesa B,0,6,30,30
1650502195666,MATH 142A,A01,083219,Chow; Bennett,0,15,30,30
1650502195666,MATH 142A,A02,083220,Chow; Bennett,0,14,30,30
1650502195666,MATH 142A,B01,083221,Chow; Bennett,0,13,30,30
1650502195666,MATH 142A,B02,083222,Chow; Bennett,0,13,30,30
1650502201693,MATH 193A,A01,083224,Staff,0,5,30,30
1650502201693,MATH 193A,A02,083225,Staff,0,5,30,30
1650502201693,MATH 193A,A03,083781,Staff,0,5,30,30
1650502201693,MATH 193A,A04,083782,Staff,0,7,30,30
1650502207725,MATH 197,001,091859,McAuley; Julian John,9998,0,9999,1
1650502213787,COGS 9,A01,083615,Staff,0,15,60,60
1650502219813,COGS 11,A01,083617,Boyle; Mary E. T.,20,0,40,20
1650502225839,COGS 13,A01,083071,Staff,0,34,40,40
1650502231867,COGS 14A,A01,092681,Staff,1,25,100,99
1650502237892,COGS 14B,A01,083073,Cheng; Tzu-Han,0,11,50,50
1650502243918,COGS 17,A01,092677,Staff,20,0,75,55
1650502249941,COGS 100,A01,083619,Staff,0,27,60,60
1650502255968,COGS 101A,A01,083621,Davis; Joshua Daniel,0,23,60,60
1650502261992,COGS 101B,A01,091572,Staff,0,4,60,60
1650502268021,COGS 101C,A01,083625,Delgado; Tania,16,0,30,14
1650502274044,COGS 107A,A01,083627,Boyle; Mary E. T.,0,12,60,60
1650502280069,COGS 118A,A01,083075,Staff,0,3,60,60
1650502286093,CSE 3,A50,083646,Miranda; Gregory Joseph,20,0,38,18
1650502286093,CSE 3,A51,083647,Miranda; Gregory Joseph,36,0,37,1
1650502292117,CSE 8A,A50,083650,Miranda; Gregory Joseph,1,29,40,39
1650502298144,CSE 11,A01,083080,Cao; Yingjun,0,92,40,40
1650502304170,CSE 12,A01,083652,Staff,0,17,100,100
1650502310198,CSE 15L,A01,083654,Staff,0,1,50,50
1650502310198,CSE 15L,A02,083655,Staff,0,0,50,50
1650502316221,CSE 20,A01,083657,Staff,51,0,80,29
1650502322244,CSE 30,A01,083084,Eldon; John,0,77,40,40
1650502328268,CSE 100,A01,083659,Cao; Yingjun,0,67,50,50
1650502334290,CSE 134B,A01,083661,Powell; Thomas Allan,0,32,65,65
1650502340317,CSE 140,A01,083663,Staff,0,5,75,75
1650502346340,CSE 140L,A01,083088,Eldon; John,0,11,75,75
1650502352365,CSE 175,A01,083665,Kumar; Rakesh,7,0,25,18
1650502358387,CSE 190,A00,092507,Dubnov; Shlomo,10,0,20,10
1650502364411,ECE 45,A01,083139,Staff,20,19,60,40
1650502370435,ECE 65,A50,083695,Staff,0,6,30,30
1650502376459,ECE 109,A01,091882,Touri; Behrouz,36,0,70,34
1650502382486,ECE 180,A00,083140,Abi Samra; Nicholas Camill,21,0,30,9
1650502382486,ECE 180,B00,083141,Abi Samra; Nicholas Camill,0,0,30,30
1650502388512,MATH 10A,A01,083735,Patchell; Gregory David,5,0,30,25
1650502388512,MATH 10A,A02,083736,Patchell; Gregory David,27,0,30,3
1650502388512,MATH 10A,A03,083737,Patchell; Gregory David,25,0,30,5
1650502394534,MATH 10B,A01,083207,Staff,0,8,30,30
1650502394534,MATH 10B,A02,083208,Staff,0,7,30,30
1650502394534,MATH 10B,B01,083739,Staff,13,0,30,17
1650502394534,MATH 10B,B02,083740,Staff,28,0,30,2
1650502400557,MATH 18,A01,083743,Staff,0,0,30,30
1650502400557,MATH 18,A02,083744,Staff,27,0,30,3
1650502400557,MATH 18,A03,083745,Staff,22,0,30,8
1650502400557,MATH 18,A04,083746,Staff,26,0,30,4
1650502400557,MATH 18,B01,083748,Staff,0,11,30,30
1650502400557,MATH 18,B02,083749,Staff,0,12,30,30
1650502400557,MATH 18,B03,083750,Staff,0,11,30,30
1650502400557,MATH 18,B04,083751,Staff,0,12,30,30
1650502406583,MATH 20A,A01,083754,Staff,25,0,40,15
1650502412609,MATH 20B,A01,083756,Staff,0,11,30,30
1650502412609,MATH 20B,A02,083757,Staff,0,11,30,30
1650502418632,MATH 20C,A01,083760,Staff,0,16,30,30
1650502418632,MATH 20C,A02,083761,Staff,2,15,30,28
1650502418632,MATH 20C,B01,083762,Staff,13,0,30,17
1650502418632,MATH 20C,B02,083763,Staff,28,0,30,2
1650502424654,MATH 20D,A01,083765,Staff,0,1,30,30
1650502424654,MATH 20D,A02,083766,Staff,9,0,30,21
1650502424654,MATH 20D,A03,083767,Staff,25,0,30,5
1650502430678,MATH 20E,A01,083771,Staff,6,0,30,24
1650502430678,MATH 20E,A02,083772,Staff,18,0,30,12
1650502430678,MATH 20E,B01,083773,Staff,0,0,30,30
1650502430678,MATH 20E,B02,083774,Staff,10,0,30,20
1650502436706,MATH 103A,A01,083777,Staff,0,12,30,30
1650502436706,MATH 103A,A02,083778,Staff,0,12,30,30
1650502436706,MATH 103A,B01,083779,Staff,0,13,30,30
1650502436706,MATH 103A,B02,083780,Staff,0,13,30,30
1650502442733,MATH 105,A01,085443,Staff,1,23,30,29
1650502448761,MATH 109,A01,083213,Anzaldo; Leesa B,0,7,30,30
1650502448761,MATH 109,A02,083214,Anzaldo; Leesa B,0,7,30,30
1650502448761,MATH 109,B01,083215,Anzaldo; Leesa B,0,5,30,30
1650502448761,MATH 109,B02,083216,Anzaldo; Leesa B,0,6,30,30
1650502454784,MATH 142A,A01,083219,Chow; Bennett,0,15,30,30
1650502454784,MATH 142A,A02,083220,Chow; Bennett,0,14,30,30
1650502454784,MATH 142A,B01,083221,Chow; Bennett,0,13,30,30
1650502454784,MATH 142A,B02,083222,Chow; Bennett,0,13,30,30
1650502460812,MATH 193A,A01,083224,Staff,0,5,30,30
1650502460812,MATH 193A,A02,083225,Staff,0,5,30,30
1650502460812,MATH 193A,A03,083781,Staff,0,5,30,30
1650502460812,MATH 193A,A04,083782,Staff,0,7,30,30
1650502466835,MATH 197,001,091859,McAuley; Julian John,9998,0,9999,1
1650502472893,COGS 9,A01,083615,Staff,0,15,60,60
1650502478918,COGS 11,A01,083617,Boyle; Mary E. T.,20,0,40,20
1650502484942,COGS 13,A01,083071,Staff,0,34,40,40
1650502490965,COGS 14A,A01,092681,Staff,1,25,100,99
1650502496991,COGS 14B,A01,083073,Cheng; Tzu-Han,0,11,50,50
1650502503019,COGS 17,A01,092677,Staff,20,0,75,55
1650502509139,COGS 100,A01,083619,Staff,0,27,60,60
1650502515161,COGS 101A,A01,083621,Davis; Joshua Daniel,0,23,60,60
1650502521190,COGS 101B,A01,091572,Staff,0,4,60,60
1650502527212,COGS 101C,A01,083625,Delgado; Tania,16,0,30,14
1650502533238,COGS 107A,A01,083627,Boyle; Mary E. T.,0,12,60,60
1650502539260,COGS 118A,A01,083075,Staff,0,3,60,60
1650502545289,CSE 3,A50,083646,Miranda; Gregory Joseph,20,0,38,18
1650502545289,CSE 3,A51,083647,Miranda; Gregory Joseph,36,0,37,1
1650502551315,CSE 8A,A50,083650,Miranda; Gregory Joseph,1,29,40,39
1650502557349,CSE 11,A01,083080,Cao; Yingjun,0,92,40,40
1650502563372,CSE 12,A01,083652,Staff,0,17,100,100
1650502569399,CSE 15L,A01,083654,Staff,0,1,50,50
1650502569399,CSE 15L,A02,083655,Staff,0,0,50,50
1650502575425,CSE 20,A01,083657,Staff,51,0,80,29
1650502581461,CSE 30,A01,083084,Eldon; John,0,77,40,40
1650502587486,CSE 100,A01,083659,Cao; Yingjun,0,67,50,50
1650502593509,CSE 134B,A01,083661,Powell; Thomas Allan,0,32,65,65
1650502599531,CSE 140,A01,083663,Staff,0,5,75,75
1650502605563,CSE 140L,A01,083088,Eldon; John,0,11,75,75
1650502611590,CSE 175,A01,083665,Kumar; Rakesh,7,0,25,18
1650502617615,CSE 190,A00,092507,Dubnov; Shlomo,10,0,20,10
1650502623642,ECE 45,A01,083139,Staff,20,19,60,40
1650502629666,ECE 65,A50,083695,Staff,0,6,30,30
1650502635687,ECE 109,A01,091882,Touri; Behrouz,36,0,70,34
1650502641711,ECE 180,A00,083140,Abi Samra; Nicholas Camill,21,0,30,9
1650502641711,ECE 180,B00,083141,Abi Samra; Nicholas Camill,0,0,30,30
1650502647738,MATH 10A,A01,083735,Patchell; Gregory David,5,0,30,25
1650502647738,MATH 10A,A02,083736,Patchell; Gregory David,27,0,30,3
1650502647738,MATH 10A,A03,083737,Patchell; Gregory David,25,0,30,5
1650502653761,MATH 10B,A01,083207,Staff,0,8,30,30
1650502653761,MATH 10B,A02,083208,Staff,0,7,30,30
1650502653761,MATH 10B,B01,083739,Staff,13,0,30,17
1650502653761,MATH 10B,B02,083740,Staff,28,0,30,2
1650502659788,MATH 18,A01,083743,Staff,0,0,30,30
1650502659788,MATH 18,A02,083744,Staff,27,0,30,3
1650502659788,MATH 18,A03,083745,Staff,22,0,30,8
1650502659788,MATH 18,A04,083746,Staff,26,0,30,4
1650502659788,MATH 18,B01,083748,Staff,0,11,30,30
1650502659788,MATH 18,B02,083749,Staff,0,12,30,30
1650502659788,MATH 18,B03,083750,Staff,0,11,30,30
1650502659788,MATH 18,B04,083751,Staff,0,12,30,30
1650502665819,MATH 20A,A01,083754,Staff,24,0,40,16
1650502671843,MATH 20B,A01,083756,Staff,0,11,30,30
1650502671843,MATH 20B,A02,083757,Staff,0,11,30,30
1650502677871,MATH 20C,A01,083760,Staff,0,16,30,30
1650502677871,MATH 20C,A02,083761,Staff,2,15,30,28
1650502677871,MATH 20C,B01,083762,Staff,13,0,30,17
1650502677871,MATH 20C,B02,083763,Staff,28,0,30,2
1650502683895,MATH 20D,A01,083765,Staff,0,1,30,30
1650502683895,MATH 20D,A02,083766,Staff,9,0,30,21
1650502683895,MATH 20D,A03,083767,Staff,25,0,30,5
1650502689919,MATH 20E,A01,083771,Staff,6,0,30,24
1650502689919,MATH 20E,A02,083772,Staff,18,0,30,12
1650502689919,MATH 20E,B01,083773,Staff,0,0,30,30
1650502689919,MATH 20E,B02,083774,Staff,10,0,30,20
1650502695944,MATH 103A,A01,083777,Staff,0,13,30,30
1650502695944,MATH 103A,A02,083778,Staff,0,12,30,30
1650502695944,MATH 103A,B01,083779,Staff,0,13,30,30
1650502695944,MATH 103A,B02,083780,Staff,0,13,30,30
1650502701969,MATH 105,A01,085443,Staff,1,23,30,29
1650502707996,MATH 109,A01,083213,Anzaldo; Leesa B,0,7,30,30
1650502707996,MATH 109,A02,083214,Anzaldo; Leesa B,0,7,30,30
1650502707996,MATH 109,B01,083215,Anzaldo; Leesa B,0,5,30,30
1650502707996,MATH 109,B02,083216,Anzaldo; Leesa B,0,6,30,30
1650502714024,MATH 142A,A01,083219,Chow; Bennett,0,15,30,30
1650502714024,MATH 142A,A02,083220,Chow; Bennett,0,14,30,30
1650502714024,MATH 142A,B01,083221,Chow; Bennett,0,13,30,30
1650502714024,MATH 142A,B02,083222,Chow; Bennett,0,13,30,30
1650502720049,MATH 193A,A01,083224,Staff,0,5,30,30
1650502720049,MATH 193A,A02,083225,Staff,0,5,30,30
1650502720049,MATH 193A,A03,083781,Staff,0,5,30,30
1650502720049,MATH 193A,A04,083782,Staff,0,7,30,30
1650502726081,MATH 197,001,091859,McAuley; Julian John,9998,0,9999,1
1650502732141,COGS 9,A01,083615,Staff,0,15,60,60
1650502738163,COGS 11,A01,083617,Boyle; Mary E. T.,20,0,40,20
1650502744190,COGS 13,A01,083071,Staff,0,34,40,40
1650502750219,COGS 14A,A01,092681,Staff,1,25,100,99
1650502756243,COGS 14B,A01,083073,Cheng; Tzu-Han,0,11,50,50
1650502762267,COGS 17,A01,092677,Staff,20,0,75,55
1650502768293,COGS 100,A01,083619,Staff,0,27,60,60
1650502774315,COGS 101A,A01,083621,Davis; Joshua Daniel,0,23,60,60
1650502780346,COGS 101B,A01,091572,Staff,0,4,60,60
1650502786368,COGS 101C,A01,083625,Delgado; Tania,16,0,30,14
1650502792394,COGS 107A,A01,083627,Boyle; Mary E. T.,0,12,60,60
1650502798417,COGS 118A,A01,083075,Staff,0,3,60,60
1650502804440,CSE 3,A50,083646,Miranda; Gregory Joseph,20,0,38,18
1650502804440,CSE 3,A51,083647,Miranda; Gregory Joseph,36,0,37,1
1650502810470,CSE 8A,A50,083650,Miranda; Gregory Joseph,1,29,40,39
1650502816503,CSE 11,A01,083080,Cao; Yingjun,0,92,40,40
1650502822526,CSE 12,A01,083652,Staff,0,17,100,100
1650502828557,CSE 15L,A01,083654,Staff,0,1,50,50
1650502828557,CSE 15L,A02,083655,Staff,0,0,50,50
1650502834589,CSE 20,A01,083657,Staff,51,0,80,29
1650502840613,CSE 30,A01,083084,Eldon; John,0,77,40,40
1650502846637,CSE 100,A01,083659,Cao; Yingjun,0,67,50,50
1650502852665,CSE 134B,A01,083661,Powell; Thomas Allan,0,32,65,65
1650502858688,CSE 140,A01,083663,Staff,0,5,75,75
1650502864717,CSE 140L,A01,083088,Eldon; John,0,11,75,75
1650502870751,CSE 175,A01,083665,Kumar; Rakesh,7,0,25,18
1650502876774,CSE 190,A00,092507,Dubnov; Shlomo,10,0,20,10
1650502882796,ECE 45,A01,083139,Staff,20,19,60,40
1650502888819,ECE 65,A50,083695,Staff,0,6,30,30
1650502894845,ECE 109,A01,091882,Touri; Behrouz,36,0,70,34
1650502900868,ECE 180,A00,083140,Abi Samra; Nicholas Camill,21,0,30,9
1650502900868,ECE 180,B00,083141,Abi Samra; Nicholas Camill,0,0,30,30
1650502906894,MATH 10A,A01,083735,Patchell; Gregory David,5,0,30,25
1650502906894,MATH 10A,A02,083736,Patchell; Gregory David,27,0,30,3
1650502906894,MATH 10A,A03,083737,Patchell; Gregory David,25,0,30,5
1650502912922,MATH 10B,A01,083207,Staff,0,8,30,30
1650502912922,MATH 10B,A02,083208,Staff,0,7,30,30
1650502912922,MATH 10B,B01,083739,Staff,13,0,30,17
1650502912922,MATH 10B,B02,083740,Staff,28,0,30,2
1650502918955,MATH 18,A01,083743,Staff,0,0,30,30
1650502918955,MATH 18,A02,083744,Staff,27,0,30,3
1650502918955,MATH 18,A03,083745,Staff,22,0,30,8
1650502918955,MATH 18,A04,083746,Staff,26,0,30,4
1650502918955,MATH 18,B01,083748,Staff,0,11,30,30
1650502918955,MATH 18,B02,083749,Staff,0,12,30,30
1650502918955,MATH 18,B03,083750,Staff,0,11,30,30
1650502918955,MATH 18,B04,083751,Staff,0,12,30,30
1650502924981,MATH 20A,A01,083754,Staff,24,0,40,16
1650502931004,MATH 20B,A01,083756,Staff,0,11,30,30
1650502931004,MATH 20B,A02,083757,Staff,0,11,30,30
1650502937028,MATH 20C,A01,083760,Staff,0,16,30,30
1650502937028,MATH 20C,A02,083761,Staff,2,15,30,28
1650502937028,MATH 20C,B01,083762,Staff,13,0,30,17
1650502937028,MATH 20C,B02,083763,Staff,28,0,30,2
1650502943051,MATH 20D,A01,083765,Staff,0,1,30,30
1650502943051,MATH 20D,A02,083766,Staff,9,0,30,21
1650502943051,MATH 20D,A03,083767,Staff,25,0,30,5
1650502949076,MATH 20E,A01,083771,Staff,6,0,30,24
1650502949076,MATH 20E,A02,083772,Staff,18,0,30,12
1650502949076,MATH 20E,B01,083773,Staff,0,0,30,30
1650502949076,MATH 20E,B02,083774,Staff,10,0,30,20
1650502955100,MATH 103A,A01,083777,Staff,0,13,30,30
1650502955100,MATH 103A,A02,083778,Staff,0,13,30,30
1650502955100,MATH 103A,B01,083779,Staff,0,13,30,30
1650502955100,MATH 103A,B02,083780,Staff,0,13,30,30
1650502961133,MATH 105,A01,085443,Staff,1,23,30,29
1650502967158,MATH 109,A01,083213,Anzaldo; Leesa B,0,7,30,30
1650502967158,MATH 109,A02,083214,Anzaldo; Leesa B,0,7,30,30
1650502967158,MATH 109,B01,083215,Anzaldo; Leesa B,0,5,30,30
1650502967158,MATH 109,B02,083216,Anzaldo; Leesa B,0,6,30,30
1650502973184,MATH 142A,A01,083219,Chow; Bennett,0,15,30,30
1650502973184,MATH 142A,A02,083220,Chow; Bennett,0,14,30,30
1650502973184,MATH 142A,B01,083221,Chow; Bennett,0,13,30,30
1650502973184,MATH 142A,B02,083222,Chow; Bennett,0,13,30,30
1650502979207,MATH 193A,A01,083224,Staff,0,5,30,30
1650502979207,MATH 193A,A02,083225,Staff,0,5,30,30
1650502979207,MATH 193A,A03,083781,Staff,0,5,30,30
1650502979207,MATH 193A,A04,083782,Staff,0,7,30,30
1650502985233,MATH 197,001,091859,McAuley; Julian John,9998,0,9999,1
1650502991290,COGS 9,A01,083615,Staff,0,15,60,60
1650502997316,COGS 11,A01,083617,Boyle; Mary E. T.,20,0,40,20
1650503003338,COGS 13,A01,083071,Staff,0,34,40,40
1650503009376,COGS 14A,A01,092681,Staff,1,25,100,99
1650503015408,COGS 14B,A01,083073,Cheng; Tzu-Han,0,11,50,50
1650503021433,COGS 17,A01,092677,Staff,20,0,75,55
1650503027458,COGS 100,A01,083619,Staff,0,27,60,60
1650503033481,COGS 101A,A01,083621,Davis; Joshua Daniel,0,23,60,60
1650503050877,COGS 101B,A01,091572,Staff,0,4,60,60
1650503056904,COGS 101C,A01,083625,Delgado; Tania,16,0,30,14
1650503062928,COGS 107A,A01,083627,Boyle; Mary E. T.,0,12,60,60
1650503068951,COGS 118A,A01,083075,Staff,0,3,60,60
1650503074979,CSE 3,A50,083646,Miranda; Gregory Joseph,20,0,38,18
1650503074979,CSE 3,A51,083647,Miranda; Gregory Joseph,36,0,37,1
1650503081003,CSE 8A,A50,083650,Miranda; Gregory Joseph,1,29,40,39
1650503087025,CSE 11,A01,083080,Cao; Yingjun,0,92,40,40
1650503093047,CSE 12,A01,083652,Staff,0,17,100,100
1650503099071,CSE 15L,A01,083654,Staff,0,1,50,50
1650503099071,CSE 15L,A02,083655,Staff,0,0,50,50
1650503105095,CSE 20,A01,083657,Staff,51,0,80,29
1650503111118,CSE 30,A01,083084,Eldon; John,0,77,40,40
1650503117232,CSE 100,A01,083659,Cao; Yingjun,0,67,50,50
1650503123259,CSE 134B,A01,083661,Powell; Thomas Allan,0,32,65,65
1650503129282,CSE 140,A01,083663,Staff,0,5,75,75
1650503135313,CSE 140L,A01,083088,Eldon; John,0,11,75,75
1650503141339,CSE 175,A01,083665,Kumar; Rakesh,7,0,25,18
1650503147363,CSE 190,A00,092507,Dubnov; Shlomo,10,0,20,10
1650503153389,ECE 45,A01,083139,Staff,20,19,60,40
1650503159423,ECE 65,A50,083695,Staff,0,6,30,30
1650503165454,ECE 109,A01,091882,Touri; Behrouz,36,0,70,34
1650503171478,ECE 180,A00,083140,Abi Samra; Nicholas Camill,21,0,30,9
1650503171478,ECE 180,B00,083141,Abi Samra; Nicholas Camill,0,0,30,30
1650503177504,MATH 10A,A01,083735,Patchell; Gregory David,5,0,30,25
1650503177504,MATH 10A,A02,083736,Patchell; Gregory David,27,0,30,3
1650503177504,MATH 10A,A03,083737,Patchell; Gregory David,25,0,30,5
1650503183532,MATH 10B,A01,083207,Staff,0,8,30,30
1650503183532,MATH 10B,A02,083208,Staff,0,7,30,30
1650503183532,MATH 10B,B01,083739,Staff,13,0,30,17
1650503183532,MATH 10B,B02,083740,Staff,28,0,30,2
1650503189560,MATH 18,A01,083743,Staff,0,0,30,30
1650503189560,MATH 18,A02,083744,Staff,27,0,30,3
1650503189560,MATH 18,A03,083745,Staff,22,0,30,8
1650503189560,MATH 18,A04,083746,Staff,26,0,30,4
1650503189560,MATH 18,B01,083748,Staff,0,11,30,30
1650503189560,MATH 18,B02,083749,Staff,0,12,30,30
1650503189560,MATH 18,B03,083750,Staff,0,11,30,30
1650503189560,MATH 18,B04,083751,Staff,0,12,30,30
1650503195589,MATH 20A,A01,083754,Staff,24,0,40,16
1650503201619,MATH 20B,A01,083756,Staff,0,11,30,30
1650503201619,MATH 20B,A02,083757,Staff,0,11,30,30
1650503207647,MATH 20C,A01,083760,Staff,0,16,30,30
1650503207647,MATH 20C,A02,083761,Staff,2,15,30,28
1650503207647,MATH 20C,B01,083762,Staff,13,0,30,17
1650503207647,MATH 20C,B02,083763,Staff,28,0,30,2
1650503213674,MATH 20D,A01,083765,Staff,0,1,30,30
1650503213674,MATH 20D,A02,083766,Staff,9,0,30,21
1650503213674,MATH 20D,A03,083767,Staff,25,0,30,5
1650503219698,MATH 20E,A01,083771,Staff,6,0,30,24
1650503219698,MATH 20E,A02,083772,Staff,18,0,30,12
1650503219698,MATH 20E,B01,083773,Staff,0,0,30,30
1650503219698,MATH 20E,B02,083774,Staff,10,0,30,20
1650503225722,MATH 103A,A01,083777,Staff,0,13,30,30
1650503225722,MATH 103A,A02,083778,Staff,0,13,30,30
1650503225722,MATH 103A,B01,083779,Staff,0,13,30,30
1650503225722,MATH 103A,B02,083780,Staff,0,13,30,30
1650503231756,MATH 105,A01,085443,Staff,1,23,30,29
1650503237785,MATH 109,A01,083213,Anzaldo; Leesa B,0,7,30,30
1650503237785,MATH 109,A02,083214,Anzaldo; Leesa B,0,7,30,30
1650503237785,MATH 109,B01,083215,Anzaldo; Leesa B,0,5,30,30
1650503237785,MATH 109,B02,083216,Anzaldo; Leesa B,0,6,30,30
1650503243824,MATH 142A,A01,083219,Chow; Bennett,0,15,30,30
1650503243824,MATH 142A,A02,083220,Chow; Bennett,0,14,30,30
1650503243824,MATH 142A,B01,083221,Chow; Bennett,0,13,30,30
1650503243824,MATH 142A,B02,083222,Chow; Bennett,0,13,30,30
1650503249849,MATH 193A,A01,083224,Staff,0,5,30,30
1650503249849,MATH 193A,A02,083225,Staff,0,5,30,30
1650503249849,MATH 193A,A03,083781,Staff,0,5,30,30
1650503249849,MATH 193A,A04,083782,Staff,0,7,30,30
1650503255872,MATH 197,001,091859,McAuley; Julian John,9998,0,9999,1
1650503261923,COGS 9,A01,083615,Staff,0,15,60,60
1650503267946,COGS 11,A01,083617,Boyle; Mary E. T.,20,0,40,20
1650503273976,COGS 13,A01,083071,Staff,0,34,40,40
1650503279999,COGS 14A,A01,092681,Staff,1,25,100,99
1650503286027,COGS 14B,A01,083073,Cheng; Tzu-Han,0,12,50,50
1650503292052,COGS 17,A01,092677,Staff,20,0,75,55
1650503298076,COGS 100,A01,083619,Staff,0,27,60,60
1650503304104,COGS 101A,A01,083621,Davis; Joshua Daniel,0,23,60,60
1650503310136,COGS 101B,A01,091572,Staff,0,4,60,60
1650503316159,COGS 101C,A01,083625,Delgado; Tania,16,0,30,14
1650503322187,COGS 107A,A01,083627,Boyle; Mary E. T.,0,12,60,60
1650503328210,COGS 118A,A01,083075,Staff,0,3,60,60
1650503334238,CSE 3,A50,083646,Miranda; Gregory Joseph,20,0,38,18
1650503334238,CSE 3,A51,083647,Miranda; Gregory Joseph,36,0,37,1
1650503340268,CSE 8A,A50,083650,Miranda; Gregory Joseph,1,29,40,39
1650503346298,CSE 11,A01,083080,Cao; Yingjun,0,92,40,40
1650503352323,CSE 12,A01,083652,Staff,0,17,100,100
1650503358348,CSE 15L,A01,083654,Staff,0,1,50,50
1650503358348,CSE 15L,A02,083655,Staff,0,0,50,50
1650503364371,CSE 20,A01,083657,Staff,51,0,80,29
1650503370394,CSE 30,A01,083084,Eldon; John,0,77,40,40
1650503376422,CSE 100,A01,083659,Cao; Yingjun,0,67,50,50
1650503382458,CSE 134B,A01,083661,Powell; Thomas Allan,0,32,65,65
1650503388492,CSE 140,A01,083663,Staff,0,5,75,75
1650503394516,CSE 140L,A01,083088,Eldon; John,0,11,75,75
1650503400552,CSE 175,A01,083665,Kumar; Rakesh,7,0,25,18
1650503406574,CSE 190,A00,092507,Dubnov; Shlomo,10,0,20,10
1650503412598,ECE 45,A01,083139,Staff,20,19,60,40
1650503418632,ECE 65,A50,083695,Staff,0,6,30,30
1650503424657,ECE 109,A01,091882,Touri; Behrouz,36,0,70,34
1650503430687,ECE 180,A00,083140,Abi Samra; Nicholas Camill,21,0,30,9
1650503430687,ECE 180,B00,083141,Abi Samra; Nicholas Camill,0,0,30,30
1650503436716,MATH 10A,A01,083735,Patchell; Gregory David,5,0,30,25
1650503436716,MATH 10A,A02,083736,Patchell; Gregory David,27,0,30,3
1650503436716,MATH 10A,A03,083737,Patchell; Gregory David,25,0,30,5
1650503442743,MATH 10B,A01,083207,Staff,0,8,30,30
1650503442743,MATH 10B,A02,083208,Staff,0,7,30,30
1650503442743,MATH 10B,B01,083739,Staff,13,0,30,17
1650503442743,MATH 10B,B02,083740,Staff,28,0,30,2
1650503448781,MATH 18,A01,083743,Staff,0,0,30,30
1650503448781,MATH 18,A02,083744,Staff,27,0,30,3
1650503448781,MATH 18,A03,083745,Staff,22,0,30,8
1650503448781,MATH 18,A04,083746,Staff,26,0,30,4
1650503448781,MATH 18,B01,083748,Staff,0,11,30,30
1650503448781,MATH 18,B02,083749,Staff,0,12,30,30
1650503448781,MATH 18,B03,083750,Staff,0,11,30,30
1650503448781,MATH 18,B04,083751,Staff,0,12,30,30
1650503454805,MATH 20A,A01,083754,Staff,24,0,40,16
1650503460829,MATH 20B,A01,083756,Staff,0,11,30,30
1650503460829,MATH 20B,A02,083757,Staff,0,11,30,30
1650503466851,MATH 20C,A01,083760,Staff,0,16,30,30
1650503466851,MATH 20C,A02,083761,Staff,2,15,30,28
1650503466851,MATH 20C,B01,083762,Staff,13,0,30,17
1650503466851,MATH 20C,B02,083763,Staff,28,0,30,2
1650503472873,MATH 20D,A01,083765,Staff,0,1,30,30
1650503472873,MATH 20D,A02,083766,Staff,9,0,30,21
1650503472873,MATH 20D,A03,083767,Staff,25,0,30,5
1650503478895,MATH 20E,A01,083771,Staff,6,0,30,24
1650503478895,MATH 20E,A02,083772,Staff,18,0,30,12
1650503478895,MATH 20E,B01,083773,Staff,0,0,30,30
1650503478895,MATH 20E,B02,083774,Staff,10,0,30,20
1650503484921,MATH 103A,A01,083777,Staff,0,13,30,30
1650503484921,MATH 103A,A02,083778,Staff,0,13,30,30
1650503484921,MATH 103A,B01,083779,Staff,0,13,30,30
1650503484921,MATH 103A,B02,083780,Staff,0,13,30,30
1650503490944,MATH 105,A01,085443,Staff,1,23,30,29
1650503496972,MATH 109,A01,083213,Anzaldo; Leesa B,0,7,30,30
1650503496972,MATH 109,A02,083214,Anzaldo; Leesa B,0,7,30,30
1650503496972,MATH 109,B01,083215,Anzaldo; Leesa B,0,5,30,30
1650503496972,MATH 109,B02,083216,Anzaldo; Leesa B,0,6,30,30
1650503502996,MATH 142A,A01,083219,Chow; Bennett,0,15,30,30
1650503502996,MATH 142A,A02,083220,Chow; Bennett,0,14,30,30
1650503502996,MATH 142A,B01,083221,Chow; Bennett,0,13,30,30
1650503502996,MATH 142A,B02,083222,Chow; Bennett,0,13,30,30
1650503509018,MATH 193A,A01,083224,Staff,0,5,30,30
1650503509018,MATH 193A,A02,083225,Staff,0,5,30,30
1650503509018,MATH 193A,A03,083781,Staff,0,5,30,30
1650503509018,MATH 193A,A04,083782,Staff,0,7,30,30
1650503515047,MATH 197,001,091859,McAuley; Julian John,9998,0,9999,1
1650503521120,COGS 9,A01,083615,Staff,0,15,60,60
1650503527142,COGS 11,A01,083617,Boyle; Mary E. T.,20,0,40,20
1650503533166,COGS 13,A01,083071,Staff,0,34,40,40
1650503539191,COGS 14A,A01,092681,Staff,1,25,100,99
1650503545215,COGS 14B,A01,083073,Cheng; Tzu-Han,0,12,50,50
1650503551242,COGS 17,A01,092677,Staff,20,0,75,55
1650503557265,COGS 100,A01,083619,Staff,0,27,60,60
1650503563292,COGS 101A,A01,083621,Davis; Joshua Daniel,0,23,60,60
1650503569313,COGS 101B,A01,091572,Staff,0,4,60,60
1650503575345,COGS 101C,A01,083625,Delgado; Tania,16,0,30,14
1650503581367,COGS 107A,A01,083627,Boyle; Mary E. T.,0,12,60,60
1650503587396,COGS 118A,A01,083075,Staff,0,3,60,60
1650503593420,CSE 3,A50,083646,Miranda; Gregory Joseph,20,0,38,18
1650503593420,CSE 3,A51,083647,Miranda; Gregory Joseph,36,0,37,1
1650503599447,CSE 8A,A50,083650,Miranda; Gregory Joseph,1,29,40,39
1650503605469,CSE 11,A01,083080,Cao; Yingjun,0,92,40,40
1650503611495,CSE 12,A01,083652,Staff,0,17,100,100
1650503617518,CSE 15L,A01,083654,Staff,0,1,50,50
1650503617518,CSE 15L,A02,083655,Staff,0,0,50,50
1650503623548,CSE 20,A01,083657,Staff,51,0,80,29
1650503629574,CSE 30,A01,083084,Eldon; John,0,77,40,40
1650503635598,CSE 100,A01,083659,Cao; Yingjun,0,67,50,50
1650503641626,CSE 134B,A01,083661,Powell; Thomas Allan,0,32,65,65
1650503647649,CSE 140,A01,083663,Staff,0,5,75,75
1650503653672,CSE 140L,A01,083088,Eldon; John,0,11,75,75
1650503659693,CSE 175,A01,083665,Kumar; Rakesh,7,0,25,18
1650503665725,CSE 190,A00,092507,Dubnov; Shlomo,10,0,20,10
1650503671748,ECE 45,A01,083139,Staff,20,19,60,40
1650503677773,ECE 65,A50,083695,Staff,0,6,30,30
1650503683798,ECE 109,A01,091882,Touri; Behrouz,36,0,70,34
1650503689820,ECE 180,A00,083140,Abi Samra; Nicholas Camill,21,0,30,9
1650503689820,ECE 180,B00,083141,Abi Samra; Nicholas Camill,0,0,30,30
1650503695847,MATH 10A,A01,083735,Patchell; Gregory David,5,0,30,25
1650503695847,MATH 10A,A02,083736,Patchell; Gregory David,27,0,30,3
1650503695847,MATH 10A,A03,083737,Patchell; Gregory David,25,0,30,5
1650503701873,MATH 10B,A01,083207,Staff,0,8,30,30
1650503701873,MATH 10B,A02,083208,Staff,0,7,30,30
1650503701873,MATH 10B,B01,083739,Staff,13,0,30,17
1650503701873,MATH 10B,B02,083740,Staff,28,0,30,2
1650503707897,MATH 18,A01,083743,Staff,0,0,30,30
1650503707897,MATH 18,A02,083744,Staff,27,0,30,3
1650503707897,MATH 18,A03,083745,Staff,22,0,30,8
1650503707897,MATH 18,A04,083746,Staff,26,0,30,4
1650503707897,MATH 18,B01,083748,Staff,0,11,30,30
1650503707897,MATH 18,B02,083749,Staff,0,12,30,30
1650503707897,MATH 18,B03,083750,Staff,0,11,30,30
1650503707897,MATH 18,B04,083751,Staff,0,12,30,30
1650503714013,MATH 20A,A01,083754,Staff,24,0,40,16
1650503720039,MATH 20B,A01,083756,Staff,0,11,30,30
1650503720039,MATH 20B,A02,083757,Staff,0,11,30,30
1650503726068,MATH 20C,A01,083760,Staff,0,16,30,30
1650503726068,MATH 20C,A02,083761,Staff,2,15,30,28
1650503726068,MATH 20C,B01,083762,Staff,13,0,30,17
1650503726068,MATH 20C,B02,083763,Staff,28,0,30,2
1650503732093,MATH 20D,A01,083765,Staff,0,1,30,30
1650503732093,MATH 20D,A02,083766,Staff,9,0,30,21
1650503732093,MATH 20D,A03,083767,Staff,25,0,30,5
1650503738133,MATH 20E,A01,083771,Staff,6,0,30,24
1650503738133,MATH 20E,A02,083772,Staff,18,0,30,12
1650503738133,MATH 20E,B01,083773,Staff,0,0,30,30
1650503738133,MATH 20E,B02,083774,Staff,10,0,30,20
1650503744158,MATH 103A,A01,083777,Staff,0,13,30,30
1650503744158,MATH 103A,A02,083778,Staff,0,13,30,30
1650503744158,MATH 103A,B01,083779,Staff,0,13,30,30
1650503744158,MATH 103A,B02,083780,Staff,0,13,30,30
1650503750182,MATH 105,A01,085443,Staff,1,23,30,29
1650503756206,MATH 109,A01,083213,Anzaldo; Leesa B,0,7,30,30
1650503756206,MATH 109,A02,083214,Anzaldo; Leesa B,0,7,30,30
1650503756206,MATH 109,B01,083215,Anzaldo; Leesa B,0,5,30,30
1650503756206,MATH 109,B02,083216,Anzaldo; Leesa B,0,6,30,30
1650503762229,MATH 142A,A01,083219,Chow; Bennett,0,15,30,30
1650503762229,MATH 142A,A02,083220,Chow; Bennett,0,14,30,30
1650503762229,MATH 142A,B01,083221,Chow; Bennett,0,13,30,30
1650503762229,MATH 142A,B02,083222,Chow; Bennett,0,13,30,30
1650503768251,MATH 193A,A01,083224,Staff,0,5,30,30
1650503768251,MATH 193A,A02,083225,Staff,0,5,30,30
1650503768251,MATH 193A,A03,083781,Staff,0,5,30,30
1650503768251,MATH 193A,A04,083782,Staff,0,7,30,30
1650503774294,MATH 197,001,091859,McAuley; Julian John,9998,0,9999,1
1650503780344,COGS 9,A01,083615,Staff,0,15,60,60
1650503786370,COGS 11,A01,083617,Boyle; Mary E. T.,20,0,40,20
1650503792397,COGS 13,A01,083071,Staff,0,34,40,40
1650503798421,COGS 14A,A01,092681,Staff,1,25,100,99
1650503804443,COGS 14B,A01,083073,Cheng; Tzu-Han,0,12,50,50
1650503810469,COGS 17,A01,092677,Staff,20,0,75,55
1650503816495,COGS 100,A01,083619,Staff,0,27,60,60
1650503822529,COGS 101A,A01,083621,Davis; Joshua Daniel,0,23,60,60
1650503828559,COGS 101B,A01,091572,Staff,0,4,60,60
1650503834586,COGS 101C,A01,083625,Delgado; Tania,16,0,30,14
1650503840613,COGS 107A,A01,083627,Boyle; Mary E. T.,0,12,60,60
1650503846642,COGS 118A,A01,083075,Staff,0,3,60,60
1650503852667,CSE 3,A50,083646,Miranda; Gregory Joseph,20,0,38,18
1650503852667,CSE 3,A51,083647,Miranda; Gregory Joseph,36,0,37,1
1650503858694,CSE 8A,A50,083650,Miranda; Gregory Joseph,1,29,40,39
1650503864721,CSE 11,A01,083080,Cao; Yingjun,0,92,40,40
1650503870750,CSE 12,A01,083652,Staff,0,17,100,100
1650503876774,CSE 15L,A01,083654,Staff,0,1,50,50
1650503876774,CSE 15L,A02,083655,Staff,0,0,50,50
1650503882801,CSE 20,A01,083657,Staff,51,0,80,29
1650503888826,CSE 30,A01,083084,Eldon; John,0,77,40,40
1650503894852,CSE 100,A01,083659,Cao; Yingjun,0,67,50,50
1650503900879,CSE 134B,A01,083661,Powell; Thomas Allan,0,33,65,65
1650503906901,CSE 140,A01,083663,Staff,0,5,75,75
1650503912925,CSE 140L,A01,083088,Eldon; John,0,11,75,75
1650503918947,CSE 175,A01,083665,Kumar; Rakesh,7,0,25,18
1650503924972,CSE 190,A00,092507,Dubnov; Shlomo,10,0,20,10
1650503930995,ECE 45,A01,083139,Staff,20,19,60,40
1650503937034,ECE 65,A50,083695,Staff,0,6,30,30
1650503943067,ECE 109,A01,091882,Touri; Behrouz,36,0,70,34
1650503949093,ECE 180,A00,083140,Abi Samra; Nicholas Camill,21,0,30,9
1650503949093,ECE 180,B00,083141,Abi Samra; Nicholas Camill,0,0,30,30
1650503955120,MATH 10A,A01,083735,Patchell; Gregory David,5,0,30,25
1650503955120,MATH 10A,A02,083736,Patchell; Gregory David,27,0,30,3
1650503955120,MATH 10A,A03,083737,Patchell; Gregory David,25,0,30,5
1650503961151,MATH 10B,A01,083207,Staff,0,8,30,30
1650503961151,MATH 10B,A02,083208,Staff,0,7,30,30
1650503961151,MATH 10B,B01,083739,Staff,13,0,30,17
1650503961151,MATH 10B,B02,083740,Staff,28,0,30,2
1650503967180,MATH 18,A01,083743,Staff,0,0,30,30
1650503967180,MATH 18,A02,083744,Staff,27,0,30,3
1650503967180,MATH 18,A03,083745,Staff,22,0,30,8
1650503967180,MATH 18,A04,083746,Staff,26,0,30,4
1650503967180,MATH 18,B01,083748,Staff,0,11,30,30
1650503967180,MATH 18,B02,083749,Staff,0,12,30,30
1650503967180,MATH 18,B03,083750,Staff,0,11,30,30
1650503967180,MATH 18,B04,083751,Staff,0,12,30,30
1650503973211,MATH 20A,A01,083754,Staff,24,0,40,16
1650503979246,MATH 20B,A01,083756,Staff,0,11,30,30
1650503979246,MATH 20B,A02,083757,Staff,0,11,30,30
1650503985271,MATH 20C,A01,083760,Staff,0,16,30,30
1650503985271,MATH 20C,A02,083761,Staff,2,15,30,28
1650503985271,MATH 20C,B01,083762,Staff,13,0,30,17
1650503985271,MATH 20C,B02,083763,Staff,28,0,30,2
1650503991295,MATH 20D,A01,083765,Staff,0,1,30,30
1650503991295,MATH 20D,A02,083766,Staff,9,0,30,21
1650503991295,MATH 20D,A03,083767,Staff,25,0,30,5
1650503997317,MATH 20E,A01,083771,Staff,6,0,30,24
1650503997317,MATH 20E,A02,083772,Staff,18,0,30,12
1650503997317,MATH 20E,B01,083773,Staff,0,0,30,30
1650503997317,MATH 20E,B02,083774,Staff,10,0,30,20
1650504003341,MATH 103A,A01,083777,Staff,0,13,30,30
1650504003341,MATH 103A,A02,083778,Staff,0,13,30,30
1650504003341,MATH 103A,B01,083779,Staff,0,13,30,30
1650504003341,MATH 103A,B02,083780,Staff,0,13,30,30
1650504009369,MATH 105,A01,085443,Staff,1,23,30,29
1650504015392,MATH 109,A01,083213,Anzaldo; Leesa B,0,7,30,30
1650504015392,MATH 109,A02,083214,Anzaldo; Leesa B,0,7,30,30
1650504015392,MATH 109,B01,083215,Anzaldo; Leesa B,0,5,30,30
1650504015392,MATH 109,B02,083216,Anzaldo; Leesa B,0,6,30,30
1650504021417,MATH 142A,A01,083219,Chow; Bennett,0,15,30,30
1650504021417,MATH 142A,A02,083220,Chow; Bennett,0,14,30,30
1650504021417,MATH 142A,B01,083221,Chow; Bennett,0,13,30,30
1650504021417,MATH 142A,B02,083222,Chow; Bennett,0,13,30,30
1650504027447,MATH 193A,A01,083224,Staff,0,5,30,30
1650504027447,MATH 193A,A02,083225,Staff,0,5,30,30
1650504027447,MATH 193A,A03,083781,Staff,0,5,30,30
1650504027447,MATH 193A,A04,083782,Staff,0,7,30,30
1650504033476,MATH 197,001,091859,McAuley; Julian John,9998,0,9999,1
1650504039541,COGS 9,A01,083615,Staff,0,15,60,60
1650504045566,COGS 11,A01,083617,Boyle; Mary E. T.,20,0,40,20
1650504051588,COGS 13,A01,083071,Staff,0,35,40,40
1650504057611,COGS 14A,A01,092681,Staff,1,25,100,99
1650504063637,COGS 14B,A01,083073,Cheng; Tzu-Han,0,13,50,50
1650504069660,COGS 17,A01,092677,Staff,20,0,75,55
1650504075682,COGS 100,A01,083619,Staff,0,27,60,60
1650504081712,COGS 101A,A01,083621,Davis; Joshua Daniel,0,23,60,60
1650504087736,COGS 101B,A01,091572,Staff,0,4,60,60
1650504093769,COGS 101C,A01,083625,Delgado; Tania,16,0,30,14
1650504099791,COGS 107A,A01,083627,Boyle; Mary E. T.,0,12,60,60
1650504105836,COGS 118A,A01,083075,Staff,0,3,60,60
1650504111861,CSE 3,A50,083646,Miranda; Gregory Joseph,20,0,38,18
1650504111861,CSE 3,A51,083647,Miranda; Gregory Joseph,36,0,37,1
1650504117886,CSE 8A,A50,083650,Miranda; Gregory Joseph,1,29,40,39
1650504123911,CSE 11,A01,083080,Cao; Yingjun,0,92,40,40
1650504129950,CSE 12,A01,083652,Staff,0,17,100,100
1650504135975,CSE 15L,A01,083654,Staff,0,1,50,50
1650504135975,CSE 15L,A02,083655,Staff,0,0,50,50
1650504142003,CSE 20,A01,083657,Staff,51,0,80,29
1650504148031,CSE 30,A01,083084,Eldon; John,0,77,40,40
1650504154059,CSE 100,A01,083659,Cao; Yingjun,0,67,50,50
1650504160088,CSE 134B,A01,083661,Powell; Thomas Allan,0,33,65,65
1650504166111,CSE 140,A01,083663,Staff,0,5,75,75
1650504172135,CSE 140L,A01,083088,Eldon; John,0,11,75,75
1650504178160,CSE 175,A01,083665,Kumar; Rakesh,7,0,25,18
1650504184182,CSE 190,A00,092507,Dubnov; Shlomo,10,0,20,10
1650504190210,ECE 45,A01,083139,Staff,20,19,60,40
1650504196242,ECE 65,A50,083695,Staff,0,6,30,30
1650504202268,ECE 109,A01,091882,Touri; Behrouz,36,0,70,34
1650504208303,ECE 180,A00,083140,Abi Samra; Nicholas Camill,21,0,30,9
1650504208303,ECE 180,B00,083141,Abi Samra; Nicholas Camill,0,0,30,30
1650504214329,MATH 10A,A01,083735,Patchell; Gregory David,5,0,30,25
1650504214329,MATH 10A,A02,083736,Patchell; Gregory David,27,0,30,3
1650504214329,MATH 10A,A03,083737,Patchell; Gregory David,25,0,30,5
1650504220353,MATH 10B,A01,083207,Staff,0,9,30,30
1650504220353,MATH 10B,A02,083208,Staff,0,7,30,30
1650504220353,MATH 10B,B01,083739,Staff,13,0,30,17
1650504220353,MATH 10B,B02,083740,Staff,28,0,30,2
1650504226385,MATH 18,A01,083743,Staff,0,0,30,30
1650504226385,MATH 18,A02,083744,Staff,27,0,30,3
1650504226385,MATH 18,A03,083745,Staff,22,0,30,8
1650504226385,MATH 18,A04,083746,Staff,26,0,30,4
1650504226385,MATH 18,B01,083748,Staff,0,11,30,30
1650504226385,MATH 18,B02,083749,Staff,0,12,30,30
1650504226385,MATH 18,B03,083750,Staff,0,11,30,30
1650504226385,MATH 18,B04,083751,Staff,0,12,30,30
1650504232411,MATH 20A,A01,083754,Staff,24,0,40,16
1650504238467,MATH 20B,A01,083756,Staff,0,11,30,30
1650504238467,MATH 20B,A02,083757,Staff,0,11,30,30
1650504244491,MATH 20C,A01,083760,Staff,0,16,30,30
1650504244491,MATH 20C,A02,083761,Staff,2,15,30,28
1650504244491,MATH 20C,B01,083762,Staff,13,0,30,17
1650504244491,MATH 20C,B02,083763,Staff,28,0,30,2
1650504250521,MATH 20D,A01,083765,Staff,0,1,30,30
1650504250521,MATH 20D,A02,083766,Staff,9,0,30,21
1650504250521,MATH 20D,A03,083767,Staff,25,0,30,5
1650504256552,MATH 20E,A01,083771,Staff,6,0,30,24
1650504256552,MATH 20E,A02,083772,Staff,18,0,30,12
1650504256552,MATH 20E,B01,083773,Staff,0,0,30,30
1650504256552,MATH 20E,B02,083774,Staff,10,0,30,20
1650504262584,MATH 103A,A01,083777,Staff,0,13,30,30
1650504262584,MATH 103A,A02,083778,Staff,0,13,30,30
1650504262584,MATH 103A,B01,083779,Staff,0,13,30,30
1650504262584,MATH 103A,B02,083780,Staff,0,13,30,30
1650504268615,MATH 105,A01,085443,Staff,1,23,30,29
1650504274655,MATH 109,A01,083213,Anzaldo; Leesa B,0,7,30,30
1650504274655,MATH 109,A02,083214,Anzaldo; Leesa B,0,7,30,30
1650504274655,MATH 109,B01,083215,Anzaldo; Leesa B,0,5,30,30
1650504274655,MATH 109,B02,083216,Anzaldo; Leesa B,0,6,30,30
1650504280698,MATH 142A,A01,083219,Chow; Bennett,0,15,30,30
1650504280698,MATH 142A,A02,083220,Chow; Bennett,0,14,30,30
1650504280698,MATH 142A,B01,083221,Chow; Bennett,0,13,30,30
1650504280698,MATH 142A,B02,083222,Chow; Bennett,0,13,30,30
1650504286721,MATH 193A,A01,083224,Staff,0,5,30,30
1650504286721,MATH 193A,A02,083225,Staff,0,5,30,30
1650504286721,MATH 193A,A03,083781,Staff,0,5,30,30
1650504286721,MATH 193A,A04,083782,Staff,0,7,30,30
1650504292751,MATH 197,001,091859,McAuley; Julian John,9998,0,9999,1
1650504298812,COGS 9,A01,083615,Staff,0,15,60,60
1650504304928,COGS 11,A01,083617,Boyle; Mary E. T.,20,0,40,20
1650504310951,COGS 13,A01,083071,Staff,0,35,40,40
1650504316978,COGS 14A,A01,092681,Staff,1,25,100,99
1650504323001,COGS 14B,A01,083073,Cheng; Tzu-Han,0,13,50,50
1650504329023,COGS 17,A01,092677,Staff,20,0,75,55
1650504335047,COGS 100,A01,083619,Staff,0,27,60,60
1650504341074,COGS 101A,A01,083621,Davis; Joshua Daniel,0,23,60,60
1650504347097,COGS 101B,A01,091572,Staff,0,4,60,60
1650504353121,COGS 101C,A01,083625,Delgado; Tania,16,0,30,14
1650504359148,COGS 107A,A01,083627,Boyle; Mary E. T.,0,12,60,60
1650504365170,COGS 118A,A01,083075,Staff,0,3,60,60
1650504371193,CSE 3,A50,083646,Miranda; Gregory Joseph,20,0,38,18
1650504371193,CSE 3,A51,083647,Miranda; Gregory Joseph,36,0,37,1
1650504377220,CSE 8A,A50,083650,Miranda; Gregory Joseph,1,29,40,39
1650504383251,CSE 11,A01,083080,Cao; Yingjun,0,92,40,40
1650504389286,CSE 12,A01,083652,Staff,0,17,100,100
1650504395309,CSE 15L,A01,083654,Staff,0,1,50,50
1650504395309,CSE 15L,A02,083655,Staff,0,0,50,50
1650504401339,CSE 20,A01,083657,Staff,51,0,80,29
1650504407367,CSE 30,A01,083084,Eldon; John,0,77,40,40
1650504413394,CSE 100,A01,083659,Cao; Yingjun,0,67,50,50
1650504419421,CSE 134B,A01,083661,Powell; Thomas Allan,0,33,65,65
1650504425452,CSE 140,A01,083663,Staff,0,5,75,75
1650504431475,CSE 140L,A01,083088,Eldon; John,0,11,75,75
1650504437497,CSE 175,A01,083665,Kumar; Rakesh,7,0,25,18
1650504443523,CSE 190,A00,092507,Dubnov; Shlomo,10,0,20,10
1650504449547,ECE 45,A01,083139,Staff,20,19,60,40
1650504455573,ECE 65,A50,083695,Staff,0,6,30,30
1650504461598,ECE 109,A01,091882,Touri; Behrouz,36,0,70,34
1650504467626,ECE 180,A00,083140,Abi Samra; Nicholas Camill,21,0,30,9
1650504467626,ECE 180,B00,083141,Abi Samra; Nicholas Camill,0,0,30,30
1650504473653,MATH 10A,A01,083735,Patchell; Gregory David,5,0,30,25
1650504473653,MATH 10A,A02,083736,Patchell; Gregory David,27,0,30,3
1650504473653,MATH 10A,A03,083737,Patchell; Gregory David,25,0,30,5
1650504479682,MATH 10B,A01,083207,Staff,0,9,30,30
1650504479682,MATH 10B,A02,083208,Staff,0,7,30,30
1650504479682,MATH 10B,B01,083739,Staff,13,0,30,17
1650504479682,MATH 10B,B02,083740,Staff,28,0,30,2
1650504485712,MATH 18,A01,083743,Staff,0,0,30,30
1650504485712,MATH 18,A02,083744,Staff,27,0,30,3
1650504485712,MATH 18,A03,083745,Staff,22,0,30,8
1650504485712,MATH 18,A04,083746,Staff,26,0,30,4
1650504485712,MATH 18,B01,083748,Staff,0,11,30,30
1650504485712,MATH 18,B02,083749,Staff,0,12,30,30
1650504485712,MATH 18,B03,083750,Staff,0,11,30,30
1650504485712,MATH 18,B04,083751,Staff,0,12,30,30
1650504491745,MATH 20A,A01,083754,Staff,24,0,40,16
1650504497782,MATH 20B,A01,083756,Staff,0,11,30,30
1650504497782,MATH 20B,A02,083757,Staff,0,11,30,30
1650504503805,MATH 20C,A01,083760,Staff,0,16,30,30
1650504503805,MATH 20C,A02,083761,Staff,2,15,30,28
1650504503805,MATH 20C,B01,083762,Staff,13,0,30,17
1650504503805,MATH 20C,B02,083763,Staff,28,0,30,2
1650504509829,MATH 20D,A01,083765,Staff,0,1,30,30
1650504509829,MATH 20D,A02,083766,Staff,9,0,30,21
1650504509829,MATH 20D,A03,083767,Staff,25,0,30,5
1650504515854,MATH 20E,A01,083771,Staff,6,0,30,24
1650504515854,MATH 20E,A02,083772,Staff,18,0,30,12
1650504515854,MATH 20E,B01,083773,Staff,0,0,30,30
1650504515854,MATH 20E,B02,083774,Staff,10,0,30,20
1650504521883,MATH 103A,A01,083777,Staff,0,13,30,30
1650504521883,MATH 103A,A02,083778,Staff,0,13,30,30
1650504521883,MATH 103A,B01,083779,Staff,0,13,30,30
1650504521883,MATH 103A,B02,083780,Staff,0,13,30,30
1650504527907,MATH 105,A01,085443,Staff,1,23,30,29
1650504533943,MATH 109,A01,083213,Anzaldo; Leesa B,0,7,30,30
1650504533943,MATH 109,A02,083214,Anzaldo; Leesa B,0,7,30,30
1650504533943,MATH 109,B01,083215,Anzaldo; Leesa B,0,5,30,30
1650504533943,MATH 109,B02,083216,Anzaldo; Leesa B,0,6,30,30
1650504539968,MATH 142A,A01,083219,Chow; Bennett,0,15,30,30
1650504539968,MATH 142A,A02,083220,Chow; Bennett,0,14,30,30
1650504539968,MATH 142A,B01,083221,Chow; Bennett,0,13,30,30
1650504539968,MATH 142A,B02,083222,Chow; Bennett,0,13,30,30
1650504545994,MATH 193A,A01,083224,Staff,0,5,30,30
1650504545994,MATH 193A,A02,083225,Staff,0,5,30,30
1650504545994,MATH 193A,A03,083781,Staff,0,5,30,30
1650504545994,MATH 193A,A04,083782,Staff,0,7,30,30
1650504552017,MATH 197,001,091859,McAuley; Julian John,9998,0,9999,1
1650504558070,COGS 9,A01,083615,Staff,0,15,60,60
1650504564093,COGS 11,A01,083617,Boyle; Mary E. T.,20,0,40,20
1650504570120,COGS 13,A01,083071,Staff,0,35,40,40
1650504576145,COGS 14A,A01,092681,Staff,1,25,100,99
1650504582171,COGS 14B,A01,083073,Cheng; Tzu-Han,0,13,50,50
1650504588196,COGS 17,A01,092677,Staff,20,0,75,55
1650504594231,COGS 100,A01,083619,Staff,0,27,60,60
1650504600255,COGS 101A,A01,083621,Davis; Joshua Daniel,0,23,60,60
1650504606281,COGS 101B,A01,091572,Staff,0,4,60,60
1650504612308,COGS 101C,A01,083625,Delgado; Tania,16,0,30,14
1650504618337,COGS 107A,A01,083627,Boyle; Mary E. T.,0,12,60,60
1650504624362,COGS 118A,A01,083075,Staff,0,3,60,60
1650504630384,CSE 3,A50,083646,Miranda; Gregory Joseph,20,0,38,18
1650504630384,CSE 3,A51,083647,Miranda; Gregory Joseph,36,0,37,1
1650504636407,CSE 8A,A50,083650,Miranda; Gregory Joseph,1,29,40,39
1650504642439,CSE 11,A01,083080,Cao; Yingjun,0,92,40,40
1650504648465,CSE 12,A01,083652,Staff,0,17,100,100
1650504654490,CSE 15L,A01,083654,Staff,0,1,50,50
1650504654490,CSE 15L,A02,083655,Staff,0,0,50,50
1650504660529,CSE 20,A01,083657,Staff,51,0,80,29
1650504666558,CSE 30,A01,083084,Eldon; John,0,77,40,40
1650504672582,CSE 100,A01,083659,Cao; Yingjun,0,67,50,50
1650504678608,CSE 134B,A01,083661,Powell; Thomas Allan,0,33,65,65
1650504684630,CSE 140,A01,083663,Staff,0,5,75,75
1650504690657,CSE 140L,A01,083088,Eldon; John,0,11,75,75
1650504696683,CSE 175,A01,083665,Kumar; Rakesh,7,0,25,18
1650504702709,CSE 190,A00,092507,Dubnov; Shlomo,10,0,20,10
1650504708735,ECE 45,A01,083139,Staff,20,19,60,40
1650504714763,ECE 65,A50,083695,Staff,0,6,30,30
1650504720786,ECE 109,A01,091882,Touri; Behrouz,36,0,70,34
1650504726812,ECE 180,A00,083140,Abi Samra; Nicholas Camill,21,0,30,9
1650504726812,ECE 180,B00,083141,Abi Samra; Nicholas Camill,0,0,30,30
1650504732840,MATH 10A,A01,083735,Patchell; Gregory David,5,0,30,25
1650504732840,MATH 10A,A02,083736,Patchell; Gregory David,27,0,30,3
1650504732840,MATH 10A,A03,083737,Patchell; Gregory David,25,0,30,5
1650504738871,MATH 10B,A01,083207,Staff,0,9,30,30
1650504738871,MATH 10B,A02,083208,Staff,0,7,30,30
1650504738871,MATH 10B,B01,083739,Staff,13,0,30,17
1650504738871,MATH 10B,B02,083740,Staff,28,0,30,2
1650504744899,MATH 18,A01,083743,Staff,0,0,30,30
1650504744899,MATH 18,A02,083744,Staff,27,0,30,3
1650504744899,MATH 18,A03,083745,Staff,22,0,30,8
1650504744899,MATH 18,A04,083746,Staff,26,0,30,4
1650504744899,MATH 18,B01,083748,Staff,0,11,30,30
1650504744899,MATH 18,B02,083749,Staff,0,12,30,30
1650504744899,MATH 18,B03,083750,Staff,0,11,30,30
1650504744899,MATH 18,B04,083751,Staff,0,12,30,30
1650504750924,MATH 20A,A01,083754,Staff,24,0,40,16
1650504756949,MATH 20B,A01,083756,Staff,0,11,30,30
1650504756949,MATH 20B,A02,083757,Staff,0,11,30,30
1650504762977,MATH 20C,A01,083760,Staff,0,16,30,30
1650504762977,MATH 20C,A02,083761,Staff,2,15,30,28
1650504762977,MATH 20C,B01,083762,Staff,13,0,30,17
1650504762977,MATH 20C,B02,083763,Staff,28,0,30,2
1650504769001,MATH 20D,A01,083765,Staff,0,1,30,30
1650504769001,MATH 20D,A02,083766,Staff,9,0,30,21
1650504769001,MATH 20D,A03,083767,Staff,25,0,30,5
1650504775027,MATH 20E,A01,083771,Staff,6,0,30,24
1650504775027,MATH 20E,A02,083772,Staff,18,0,30,12
1650504775027,MATH 20E,B01,083773,Staff,0,0,30,30
1650504775027,MATH 20E,B02,083774,Staff,10,0,30,20
1650504781050,MATH 103A,A01,083777,Staff,0,13,30,30
1650504781050,MATH 103A,A02,083778,Staff,0,13,30,30
1650504781050,MATH 103A,B01,083779,Staff,0,13,30,30
1650504781050,MATH 103A,B02,083780,Staff,0,13,30,30
1650504787079,MATH 105,A01,085443,Staff,1,23,30,29
1650504793107,MATH 109,A01,083213,Anzaldo; Leesa B,0,7,30,30
1650504793107,MATH 109,A02,083214,Anzaldo; Leesa B,0,7,30,30
1650504793107,MATH 109,B01,083215,Anzaldo; Leesa B,0,5,30,30
1650504793107,MATH 109,B02,083216,Anzaldo; Leesa B,0,6,30,30
1650504799139,MATH 142A,A01,083219,Chow; Bennett,0,15,30,30
1650504799139,MATH 142A,A02,083220,Chow; Bennett,0,14,30,30
1650504799139,MATH 142A,B01,083221,Chow; Bennett,0,13,30,30
1650504799139,MATH 142A,B02,083222,Chow; Bennett,0,13,30,30
1650504805167,MATH 193A,A01,083224,Staff,0,5,30,30
1650504805167,MATH 193A,A02,083225,Staff,0,5,30,30
1650504805167,MATH 193A,A03,083781,Staff,0,5,30,30
1650504805167,MATH 193A,A04,083782,Staff,0,7,30,30
1650504811191,MATH 197,001,091859,McAuley; Julian John,9998,0,9999,1
1650504817242,COGS 9,A01,083615,Staff,0,15,60,60
1650504823270,COGS 11,A01,083617,Boyle; Mary E. T.,20,0,40,20
1650504829306,COGS 13,A01,083071,Staff,0,35,40,40
1650504835335,COGS 14A,A01,092681,Staff,1,25,100,99
1650504841358,COGS 14B,A01,083073,Cheng; Tzu-Han,0,12,50,50
1650504847383,COGS 17,A01,092677,Staff,20,0,75,55
1650504853416,COGS 100,A01,083619,Staff,0,27,60,60
1650504859438,COGS 101A,A01,083621,Davis; Joshua Daniel,0,23,60,60
1650504865465,COGS 101B,A01,091572,Staff,0,4,60,60
1650504871494,COGS 101C,A01,083625,Delgado; Tania,16,0,30,14
1650504877525,COGS 107A,A01,083627,Boyle; Mary E. T.,0,12,60,60
1650504883552,COGS 118A,A01,083075,Staff,0,3,60,60
1650504889577,CSE 3,A50,083646,Miranda; Gregory Joseph,20,0,38,18
1650504889577,CSE 3,A51,083647,Miranda; Gregory Joseph,36,0,37,1
1650504895604,CSE 8A,A50,083650,Miranda; Gregory Joseph,1,29,40,39
1650504901701,CSE 11,A01,083080,Cao; Yingjun,0,92,40,40
1650504907727,CSE 12,A01,083652,Staff,0,17,100,100
1650504913753,CSE 15L,A01,083654,Staff,0,1,50,50
1650504913753,CSE 15L,A02,083655,Staff,0,0,50,50
1650504919779,CSE 20,A01,083657,Staff,51,0,80,29
1650504925805,CSE 30,A01,083084,Eldon; John,0,77,40,40
1650504931829,CSE 100,A01,083659,Cao; Yingjun,0,67,50,50
1650504937851,CSE 134B,A01,083661,Powell; Thomas Allan,0,33,65,65
1650504943874,CSE 140,A01,083663,Staff,0,5,75,75
1650504949897,CSE 140L,A01,083088,Eldon; John,0,11,75,75
1650504955920,CSE 175,A01,083665,Kumar; Rakesh,7,0,25,18
1650504961951,CSE 190,A00,092507,Dubnov; Shlomo,10,0,20,10
1650504967977,ECE 45,A01,083139,Staff,20,19,60,40
1650504974003,ECE 65,A50,083695,Staff,0,6,30,30
1650504980028,ECE 109,A01,091882,Touri; Behrouz,36,0,70,34
1650504986051,ECE 180,A00,083140,Abi Samra; Nicholas Camill,21,0,30,9
1650504986051,ECE 180,B00,083141,Abi Samra; Nicholas Camill,0,0,30,30
1650504992074,MATH 10A,A01,083735,Patchell; Gregory David,5,0,30,25
1650504992074,MATH 10A,A02,083736,Patchell; Gregory David,27,0,30,3
1650504992074,MATH 10A,A03,083737,Patchell; Gregory David,25,0,30,5
1650504998101,MATH 10B,A01,083207,Staff,0,9,30,30
1650504998101,MATH 10B,A02,083208,Staff,0,7,30,30
1650504998101,MATH 10B,B01,083739,Staff,13,0,30,17
1650504998101,MATH 10B,B02,083740,Staff,28,0,30,2
1650505004126,MATH 18,A01,083743,Staff,0,0,30,30
1650505004126,MATH 18,A02,083744,Staff,27,0,30,3
1650505004126,MATH 18,A03,083745,Staff,22,0,30,8
1650505004126,MATH 18,A04,083746,Staff,26,0,30,4
1650505004126,MATH 18,B01,083748,Staff,0,11,30,30
1650505004126,MATH 18,B02,083749,Staff,0,12,30,30
1650505004126,MATH 18,B03,083750,Staff,0,11,30,30
1650505004126,MATH 18,B04,083751,Staff,0,12,30,30
1650505010151,MATH 20A,A01,083754,Staff,24,0,40,16
1650505016180,MATH 20B,A01,083756,Staff,0,11,30,30
1650505016180,MATH 20B,A02,083757,Staff,0,11,30,30
1650505022207,MATH 20C,A01,083760,Staff,0,16,30,30
1650505022207,MATH 20C,A02,083761,Staff,2,15,30,28
1650505022207,MATH 20C,B01,083762,Staff,13,0,30,17
1650505022207,MATH 20C,B02,083763,Staff,28,0,30,2
1650505028231,MATH 20D,A01,083765,Staff,0,1,30,30
1650505028231,MATH 20D,A02,083766,Staff,9,0,30,21
1650505028231,MATH 20D,A03,083767,Staff,25,0,30,5
1650505034258,MATH 20E,A01,083771,Staff,6,0,30,24
1650505034258,MATH 20E,A02,083772,Staff,18,0,30,12
1650505034258,MATH 20E,B01,083773,Staff,0,0,30,30
1650505034258,MATH 20E,B02,083774,Staff,10,0,30,20
1650505040282,MATH 103A,A01,083777,Staff,0,13,30,30
1650505040282,MATH 103A,A02,083778,Staff,0,13,30,30
1650505040282,MATH 103A,B01,083779,Staff,0,13,30,30
1650505040282,MATH 103A,B02,083780,Staff,0,13,30,30
1650505046308,MATH 105,A01,085443,Staff,1,23,30,29
1650505052343,MATH 109,A01,083213,Anzaldo; Leesa B,0,7,30,30
1650505052343,MATH 109,A02,083214,Anzaldo; Leesa B,0,7,30,30
1650505052343,MATH 109,B01,083215,Anzaldo; Leesa B,0,5,30,30
1650505052343,MATH 109,B02,083216,Anzaldo; Leesa B,0,6,30,30
1650505058369,MATH 142A,A01,083219,Chow; Bennett,0,15,30,30
1650505058369,MATH 142A,A02,083220,Chow; Bennett,0,14,30,30
1650505058369,MATH 142A,B01,083221,Chow; Bennett,0,13,30,30
1650505058369,MATH 142A,B02,083222,Chow; Bennett,0,13,30,30
1650505064392,MATH 193A,A01,083224,Staff,0,5,30,30
1650505064392,MATH 193A,A02,083225,Staff,0,5,30,30
1650505064392,MATH 193A,A03,083781,Staff,0,5,30,30
1650505064392,MATH 193A,A04,083782,Staff,0,7,30,30
1650505070415,MATH 197,001,091859,McAuley; Julian John,9998,0,9999,1
1650505076474,COGS 9,A01,083615,Staff,0,15,60,60
1650505082500,COGS 11,A01,083617,Boyle; Mary E. T.,19,0,40,21
1650505088526,COGS 13,A01,083071,Staff,0,35,40,40
1650505094552,COGS 14A,A01,092681,Staff,1,25,100,99
1650505100575,COGS 14B,A01,083073,Cheng; Tzu-Han,0,12,50,50
1650505106598,COGS 17,A01,092677,Staff,20,0,75,55
1650505112622,COGS 100,A01,083619,Staff,0,27,60,60
1650505118648,COGS 101A,A01,083621,Davis; Joshua Daniel,0,23,60,60
1650505124674,COGS 101B,A01,091572,Staff,0,4,60,60
1650505130700,COGS 101C,A01,083625,Delgado; Tania,16,0,30,14
1650505136722,COGS 107A,A01,083627,Boyle; Mary E. T.,0,12,60,60
1650505142747,COGS 118A,A01,083075,Staff,0,3,60,60
1650505148771,CSE 3,A50,083646,Miranda; Gregory Joseph,20,0,38,18
1650505148771,CSE 3,A51,083647,Miranda; Gregory Joseph,36,0,37,1
1650505154795,CSE 8A,A50,083650,Miranda; Gregory Joseph,1,29,40,39
1650505160818,CSE 11,A01,083080,Cao; Yingjun,0,91,40,40
1650505166841,CSE 12,A01,083652,Staff,0,17,100,100
1650505172872,CSE 15L,A01,083654,Staff,0,1,50,50
1650505172872,CSE 15L,A02,083655,Staff,0,0,50,50
1650505178904,CSE 20,A01,083657,Staff,51,0,80,29
1650505184927,CSE 30,A01,083084,Eldon; John,0,77,40,40
1650505190954,CSE 100,A01,083659,Cao; Yingjun,0,67,50,50
1650505196980,CSE 134B,A01,083661,Powell; Thomas Allan,0,33,65,65
1650505203010,CSE 140,A01,083663,Staff,0,5,75,75
1650505211206,CSE 140L,A01,083088,Eldon; John,0,11,75,75
1650505217231,CSE 175,A01,083665,Kumar; Rakesh,7,0,25,18
1650505223257,CSE 190,A00,092507,Dubnov; Shlomo,10,0,20,10
1650505229282,ECE 45,A01,083139,Staff,20,19,60,40
1650505235311,ECE 65,A50,083695,Staff,0,6,30,30
1650505241333,ECE 109,A01,091882,Touri; Behrouz,36,0,70,34
1650505247356,ECE 180,A00,083140,Abi Samra; Nicholas Camill,21,0,30,9
1650505247356,ECE 180,B00,083141,Abi Samra; Nicholas Camill,0,0,30,30
1650505253383,MATH 10A,A01,083735,Patchell; Gregory David,5,0,30,25
1650505253383,MATH 10A,A02,083736,Patchell; Gregory David,27,0,30,3
1650505253383,MATH 10A,A03,083737,Patchell; Gregory David,24,0,30,6
1650505259408,MATH 10B,A01,083207,Staff,0,9,30,30
1650505259408,MATH 10B,A02,083208,Staff,0,7,30,30
1650505259408,MATH 10B,B01,083739,Staff,13,0,30,17
1650505259408,MATH 10B,B02,083740,Staff,28,0,30,2
1650505265431,MATH 18,A01,083743,Staff,0,0,30,30
1650505265431,MATH 18,A02,083744,Staff,27,0,30,3
1650505265431,MATH 18,A03,083745,Staff,22,0,30,8
1650505265431,MATH 18,A04,083746,Staff,26,0,30,4
1650505265431,MATH 18,B01,083748,Staff,0,11,30,30
1650505265431,MATH 18,B02,083749,Staff,0,12,30,30
1650505265431,MATH 18,B03,083750,Staff,0,11,30,30
1650505265431,MATH 18,B04,083751,Staff,0,12,30,30
1650505271460,MATH 20A,A01,083754,Staff,24,0,40,16
1650505277488,MATH 20B,A01,083756,Staff,0,11,30,30
1650505277488,MATH 20B,A02,083757,Staff,0,11,30,30
1650505283520,MATH 20C,A01,083760,Staff,0,16,30,30
1650505283520,MATH 20C,A02,083761,Staff,2,15,30,28
1650505283520,MATH 20C,B01,083762,Staff,13,0,30,17
1650505283520,MATH 20C,B02,083763,Staff,28,0,30,2
1650505289544,MATH 20D,A01,083765,Staff,0,1,30,30
1650505289544,MATH 20D,A02,083766,Staff,8,0,30,22
1650505289544,MATH 20D,A03,083767,Staff,25,0,30,5
1650505295571,MATH 20E,A01,083771,Staff,6,0,30,24
1650505295571,MATH 20E,A02,083772,Staff,18,0,30,12
1650505295571,MATH 20E,B01,083773,Staff,0,0,30,30
1650505295571,MATH 20E,B02,083774,Staff,10,0,30,20
1650505301593,MATH 103A,A01,083777,Staff,0,13,30,30
1650505301593,MATH 103A,A02,083778,Staff,0,13,30,30
1650505301593,MATH 103A,B01,083779,Staff,0,13,30,30
1650505301593,MATH 103A,B02,083780,Staff,0,13,30,30
1650505307620,MATH 105,A01,085443,Staff,1,23,30,29
1650505313646,MATH 109,A01,083213,Anzaldo; Leesa B,0,7,30,30
1650505313646,MATH 109,A02,083214,Anzaldo; Leesa B,0,7,30,30
1650505313646,MATH 109,B01,083215,Anzaldo; Leesa B,0,5,30,30
1650505313646,MATH 109,B02,083216,Anzaldo; Leesa B,0,6,30,30
1650505319671,MATH 142A,A01,083219,Chow; Bennett,0,15,30,30
1650505319671,MATH 142A,A02,083220,Chow; Bennett,0,14,30,30
1650505319671,MATH 142A,B01,083221,Chow; Bennett,0,13,30,30
1650505319671,MATH 142A,B02,083222,Chow; Bennett,0,13,30,30
1650505325698,MATH 193A,A01,083224,Staff,0,5,30,30
1650505325698,MATH 193A,A02,083225,Staff,0,5,30,30
1650505325698,MATH 193A,A03,083781,Staff,0,5,30,30
1650505325698,MATH 193A,A04,083782,Staff,0,7,30,30
1650505331734,MATH 197,001,091859,McAuley; Julian John,9998,0,9999,1
1650505337786,COGS 9,A01,083615,Staff,0,15,60,60
1650505343809,COGS 11,A01,083617,Boyle; Mary E. T.,19,0,40,21
1650505349835,COGS 13,A01,083071,Staff,0,35,40,40
1650505355865,COGS 14A,A01,092681,Staff,1,25,100,99
1650505361895,COGS 14B,A01,083073,Cheng; Tzu-Han,0,12,50,50
1650505367919,COGS 17,A01,092677,Staff,20,0,75,55
1650505373944,COGS 100,A01,083619,Staff,0,27,60,60
1650505379967,COGS 101A,A01,083621,Davis; Joshua Daniel,0,23,60,60
1650505385990,COGS 101B,A01,091572,Staff,0,4,60,60
1650505392013,COGS 101C,A01,083625,Delgado; Tania,16,0,30,14
1650505398051,COGS 107A,A01,083627,Boyle; Mary E. T.,0,12,60,60
1650505404075,COGS 118A,A01,083075,Staff,0,3,60,60
1650505410097,CSE 3,A50,083646,Miranda; Gregory Joseph,20,0,38,18
1650505410097,CSE 3,A51,083647,Miranda; Gregory Joseph,36,0,37,1
1650505416120,CSE 8A,A50,083650,Miranda; Gregory Joseph,1,29,40,39
1650505422149,CSE 11,A01,083080,Cao; Yingjun,0,91,40,40
1650505428179,CSE 12,A01,083652,Staff,0,17,100,100
1650505434204,CSE 15L,A01,083654,Staff,0,1,50,50
1650505434204,CSE 15L,A02,083655,Staff,0,0,50,50
1650505440230,CSE 20,A01,083657,Staff,51,0,80,29
1650505446253,CSE 30,A01,083084,Eldon; John,0,77,40,40
1650505452276,CSE 100,A01,083659,Cao; Yingjun,0,67,50,50
1650505458302,CSE 134B,A01,083661,Powell; Thomas Allan,0,33,65,65
1650505464323,CSE 140,A01,083663,Staff,0,5,75,75
1650505470348,CSE 140L,A01,083088,Eldon; John,0,11,75,75
1650505476371,CSE 175,A01,083665,Kumar; Rakesh,7,0,25,18
1650505482397,CSE 190,A00,092507,Dubnov; Shlomo,10,0,20,10
1650505488422,ECE 45,A01,083139,Staff,20,19,60,40
1650505494445,ECE 65,A50,083695,Staff,0,6,30,30
1650505500572,ECE 109,A01,091882,Touri; Behrouz,35,0,70,35
1650505506598,ECE 180,A00,083140,Abi Samra; Nicholas Camill,21,0,30,9
1650505506598,ECE 180,B00,083141,Abi Samra; Nicholas Camill,0,0,30,30
1650505512622,MATH 10A,A01,083735,Patchell; Gregory David,5,0,30,25
1650505512622,MATH 10A,A02,083736,Patchell; Gregory David,27,0,30,3
1650505512622,MATH 10A,A03,083737,Patchell; Gregory David,24,0,30,6
1650505518648,MATH 10B,A01,083207,Staff,0,9,30,30
1650505518648,MATH 10B,A02,083208,Staff,0,7,30,30
1650505518648,MATH 10B,B01,083739,Staff,13,0,30,17
1650505518648,MATH 10B,B02,083740,Staff,28,0,30,2
1650505524679,MATH 18,A01,083743,Staff,0,0,30,30
1650505524679,MATH 18,A02,083744,Staff,27,0,30,3
1650505524679,MATH 18,A03,083745,Staff,22,0,30,8
1650505524679,MATH 18,A04,083746,Staff,26,0,30,4
1650505524679,MATH 18,B01,083748,Staff,0,11,30,30
1650505524679,MATH 18,B02,083749,Staff,0,12,30,30
1650505524679,MATH 18,B03,083750,Staff,0,11,30,30
1650505524679,MATH 18,B04,083751,Staff,0,12,30,30
1650505530701,MATH 20A,A01,083754,Staff,24,0,40,16
1650505536730,MATH 20B,A01,083756,Staff,0,11,30,30
1650505536730,MATH 20B,A02,083757,Staff,0,11,30,30
1650505542753,MATH 20C,A01,083760,Staff,0,16,30,30
1650505542753,MATH 20C,A02,083761,Staff,2,15,30,28
1650505542753,MATH 20C,B01,083762,Staff,13,0,30,17
1650505542753,MATH 20C,B02,083763,Staff,28,0,30,2
1650505548780,MATH 20D,A01,083765,Staff,0,1,30,30
1650505548780,MATH 20D,A02,083766,Staff,8,0,30,22
1650505548780,MATH 20D,A03,083767,Staff,25,0,30,5
1650505554804,MATH 20E,A01,083771,Staff,6,0,30,24
1650505554804,MATH 20E,A02,083772,Staff,18,0,30,12
1650505554804,MATH 20E,B01,083773,Staff,0,0,30,30
1650505554804,MATH 20E,B02,083774,Staff,10,0,30,20
1650505560829,MATH 103A,A01,083777,Staff,0,13,30,30
1650505560829,MATH 103A,A02,083778,Staff,0,13,30,30
1650505560829,MATH 103A,B01,083779,Staff,0,13,30,30
1650505560829,MATH 103A,B02,083780,Staff,0,13,30,30
1650505566854,MATH 105,A01,085443,Staff,1,23,30,29
1650505572880,MATH 109,A01,083213,Anzaldo; Leesa B,0,7,30,30
1650505572880,MATH 109,A02,083214,Anzaldo; Leesa B,0,7,30,30
1650505572880,MATH 109,B01,083215,Anzaldo; Leesa B,0,5,30,30
1650505572880,MATH 109,B02,083216,Anzaldo; Leesa B,0,6,30,30
1650505578903,MATH 142A,A01,083219,Chow; Bennett,0,15,30,30
1650505578903,MATH 142A,A02,083220,Chow; Bennett,0,14,30,30
1650505578903,MATH 142A,B01,083221,Chow; Bennett,0,13,30,30
1650505578903,MATH 142A,B02,083222,Chow; Bennett,0,13,30,30
1650505584927,MATH 193A,A01,083224,Staff,0,5,30,30
1650505584927,MATH 193A,A02,083225,Staff,0,5,30,30
1650505584927,MATH 193A,A03,083781,Staff,0,5,30,30
1650505584927,MATH 193A,A04,083782,Staff,0,7,30,30
1650505590956,MATH 197,001,091859,McAuley; Julian John,9998,0,9999,1
1650505597013,COGS 9,A01,083615,Staff,0,15,60,60
1650505603037,COGS 11,A01,083617,Boyle; Mary E. T.,19,0,40,21
1650505609059,COGS 13,A01,083071,Staff,0,35,40,40
1650505615082,COGS 14A,A01,092681,Staff,1,25,100,99
1650505621112,COGS 14B,A01,083073,Cheng; Tzu-Han,0,12,50,50
1650505627140,COGS 17,A01,092677,Staff,20,0,75,55
1650505633168,COGS 100,A01,083619,Staff,0,27,60,60
1650505639191,COGS 101A,A01,083621,Davis; Joshua Daniel,0,23,60,60
1650505645222,COGS 101B,A01,091572,Staff,0,4,60,60
1650505651249,COGS 101C,A01,083625,Delgado; Tania,16,0,30,14
1650505657274,COGS 107A,A01,083627,Boyle; Mary E. T.,0,12,60,60
1650505663299,COGS 118A,A01,083075,Staff,0,3,60,60
1650505669323,CSE 3,A50,083646,Miranda; Gregory Joseph,20,0,38,18
1650505669323,CSE 3,A51,083647,Miranda; Gregory Joseph,36,0,37,1
1650505675350,CSE 8A,A50,083650,Miranda; Gregory Joseph,1,29,40,39
1650505681378,CSE 11,A01,083080,Cao; Yingjun,0,91,40,40
1650505687402,CSE 12,A01,083652,Staff,0,17,100,100
1650505693427,CSE 15L,A01,083654,Staff,0,1,50,50
1650505693427,CSE 15L,A02,083655,Staff,0,0,50,50
1650505699449,CSE 20,A01,083657,Staff,51,0,80,29
1650505705471,CSE 30,A01,083084,Eldon; John,0,77,40,40
1650505711494,CSE 100,A01,083659,Cao; Yingjun,0,67,50,50
1650505717521,CSE 134B,A01,083661,Powell; Thomas Allan,0,33,65,65
1650505723552,CSE 140,A01,083663,Staff,0,5,75,75
1650505729580,CSE 140L,A01,083088,Eldon; John,0,11,75,75
1650505735605,CSE 175,A01,083665,Kumar; Rakesh,7,0,25,18
1650505741628,CSE 190,A00,092507,Dubnov; Shlomo,10,0,20,10
1650505747654,ECE 45,A01,083139,Staff,20,19,60,40
1650505753681,ECE 65,A50,083695,Staff,0,6,30,30
1650505759704,ECE 109,A01,091882,Touri; Behrouz,35,0,70,35
1650505765728,ECE 180,A00,083140,Abi Samra; Nicholas Camill,21,0,30,9
1650505765728,ECE 180,B00,083141,Abi Samra; Nicholas Camill,0,0,30,30
1650505771752,MATH 10A,A01,083735,Patchell; Gregory David,5,0,30,25
1650505771752,MATH 10A,A02,083736,Patchell; Gregory David,27,0,30,3
1650505771752,MATH 10A,A03,083737,Patchell; Gregory David,24,0,30,6
1650505777778,MATH 10B,A01,083207,Staff,0,9,30,30
1650505777778,MATH 10B,A02,083208,Staff,0,7,30,30
1650505777778,MATH 10B,B01,083739,Staff,13,0,30,17
1650505777778,MATH 10B,B02,083740,Staff,28,0,30,2
1650505783805,MATH 18,A01,083743,Staff,0,0,30,30
1650505783805,MATH 18,A02,083744,Staff,27,0,30,3
1650505783805,MATH 18,A03,083745,Staff,22,0,30,8
1650505783805,MATH 18,A04,083746,Staff,26,0,30,4
1650505783805,MATH 18,B01,083748,Staff,0,11,30,30
1650505783805,MATH 18,B02,083749,Staff,0,12,30,30
1650505783805,MATH 18,B03,083750,Staff,0,11,30,30
1650505783805,MATH 18,B04,083751,Staff,0,12,30,30
1650505789830,MATH 20A,A01,083754,Staff,24,0,40,16
1650505795852,MATH 20B,A01,083756,Staff,0,11,30,30
1650505795852,MATH 20B,A02,083757,Staff,0,11,30,30
1650505801876,MATH 20C,A01,083760,Staff,0,16,30,30
1650505801876,MATH 20C,A02,083761,Staff,2,15,30,28
1650505801876,MATH 20C,B01,083762,Staff,13,0,30,17
1650505801876,MATH 20C,B02,083763,Staff,28,0,30,2
1650505807899,MATH 20D,A01,083765,Staff,0,1,30,30
1650505807899,MATH 20D,A02,083766,Staff,7,0,30,23
1650505807899,MATH 20D,A03,083767,Staff,25,0,30,5
1650505813928,MATH 20E,A01,083771,Staff,6,0,30,24
1650505813928,MATH 20E,A02,083772,Staff,18,0,30,12
1650505813928,MATH 20E,B01,083773,Staff,0,0,30,30
1650505813928,MATH 20E,B02,083774,Staff,10,0,30,20
1650505819955,MATH 103A,A01,083777,Staff,0,13,30,30
1650505819955,MATH 103A,A02,083778,Staff,0,13,30,30
1650505819955,MATH 103A,B01,083779,Staff,0,13,30,30
1650505819955,MATH 103A,B02,083780,Staff,0,13,30,30
1650505825989,MATH 105,A01,085443,Staff,1,23,30,29
1650505832014,MATH 109,A01,083213,Anzaldo; Leesa B,0,7,30,30
1650505832014,MATH 109,A02,083214,Anzaldo; Leesa B,0,7,30,30
1650505832014,MATH 109,B01,083215,Anzaldo; Leesa B,0,5,30,30
1650505832014,MATH 109,B02,083216,Anzaldo; Leesa B,0,6,30,30
1650505838039,MATH 142A,A01,083219,Chow; Bennett,0,15,30,30
1650505838039,MATH 142A,A02,083220,Chow; Bennett,0,14,30,30
1650505838039,MATH 142A,B01,083221,Chow; Bennett,0,13,30,30
1650505838039,MATH 142A,B02,083222,Chow; Bennett,0,13,30,30
1650505844068,MATH 193A,A01,083224,Staff,0,5,30,30
1650505844068,MATH 193A,A02,083225,Staff,0,5,30,30
1650505844068,MATH 193A,A03,083781,Staff,0,5,30,30
1650505844068,MATH 193A,A04,083782,Staff,0,7,30,30
1650505850091,MATH 197,001,091859,McAuley; Julian John,9998,0,9999,1
1650505856152,COGS 9,A01,083615,Staff,0,15,60,60
1650505862179,COGS 11,A01,083617,Boyle; Mary E. T.,19,0,40,21
1650505868201,COGS 13,A01,083071,Staff,0,35,40,40
1650505874226,COGS 14A,A01,092681,Staff,1,25,100,99
1650505880250,COGS 14B,A01,083073,Cheng; Tzu-Han,0,12,50,50
1650505886278,COGS 17,A01,092677,Staff,20,0,75,55
1650505892301,COGS 100,A01,083619,Staff,0,27,60,60
1650505898327,COGS 101A,A01,083621,Davis; Joshua Daniel,0,23,60,60
1650505904350,COGS 101B,A01,091572,Staff,0,4,60,60
1650505910377,COGS 101C,A01,083625,Delgado; Tania,16,0,30,14
1650505916401,COGS 107A,A01,083627,Boyle; Mary E. T.,0,12,60,60
1650505922431,COGS 118A,A01,083075,Staff,0,3,60,60
1650505928455,CSE 3,A50,083646,Miranda; Gregory Joseph,20,0,38,18
1650505928455,CSE 3,A51,083647,Miranda; Gregory Joseph,36,0,37,1
1650505934497,CSE 8A,A50,083650,Miranda; Gregory Joseph,1,29,40,39
1650505940521,CSE 11,A01,083080,Cao; Yingjun,0,91,40,40
1650505946550,CSE 12,A01,083652,Staff,0,17,100,100
1650505952579,CSE 15L,A01,083654,Staff,0,1,50,50
1650505952579,CSE 15L,A02,083655,Staff,0,0,50,50
1650505958612,CSE 20,A01,083657,Staff,51,0,80,29
1650505964635,CSE 30,A01,083084,Eldon; John,0,77,40,40
1650505970660,CSE 100,A01,083659,Cao; Yingjun,0,67,50,50
1650505976688,CSE 134B,A01,083661,Powell; Thomas Allan,0,33,65,65
1650505982714,CSE 140,A01,083663,Staff,0,5,75,75
1650505988751,CSE 140L,A01,083088,Eldon; John,0,11,75,75
1650505994775,CSE 175,A01,083665,Kumar; Rakesh,7,0,25,18
1650506000810,CSE 190,A00,092507,Dubnov; Shlomo,10,0,20,10
1650506006834,ECE 45,A01,083139,Staff,20,19,60,40
1650506012861,ECE 65,A50,083695,Staff,0,6,30,30
1650506018889,ECE 109,A01,091882,Touri; Behrouz,35,0,70,35
1650506024916,ECE 180,A00,083140,Abi Samra; Nicholas Camill,21,0,30,9
1650506024916,ECE 180,B00,083141,Abi Samra; Nicholas Camill,0,0,30,30
1650506030941,MATH 10A,A01,083735,Patchell; Gregory David,5,0,30,25
1650506030941,MATH 10A,A02,083736,Patchell; Gregory David,27,0,30,3
1650506030941,MATH 10A,A03,083737,Patchell; Gregory David,24,0,30,6
1650506036966,MATH 10B,A01,083207,Staff,0,9,30,30
1650506036966,MATH 10B,A02,083208,Staff,0,7,30,30
1650506036966,MATH 10B,B01,083739,Staff,13,0,30,17
1650506036966,MATH 10B,B02,083740,Staff,28,0,30,2
1650506042991,MATH 18,A01,083743,Staff,0,0,30,30
1650506042991,MATH 18,A02,083744,Staff,27,0,30,3
1650506042991,MATH 18,A03,083745,Staff,22,0,30,8
1650506042991,MATH 18,A04,083746,Staff,26,0,30,4
1650506042991,MATH 18,B01,083748,Staff,0,11,30,30
1650506042991,MATH 18,B02,083749,Staff,0,12,30,30
1650506042991,MATH 18,B03,083750,Staff,0,11,30,30
1650506042991,MATH 18,B04,083751,Staff,0,12,30,30
1650506049030,MATH 20A,A01,083754,Staff,24,0,40,16
1650506055056,MATH 20B,A01,083756,Staff,0,11,30,30
1650506055056,MATH 20B,A02,083757,Staff,0,11,30,30
1650506061085,MATH 20C,A01,083760,Staff,0,16,30,30
1650506061085,MATH 20C,A02,083761,Staff,2,15,30,28
1650506061085,MATH 20C,B01,083762,Staff,13,0,30,17
1650506061085,MATH 20C,B02,083763,Staff,28,0,30,2
1650506067113,MATH 20D,A01,083765,Staff,0,1,30,30
1650506067113,MATH 20D,A02,083766,Staff,7,0,30,23
1650506067113,MATH 20D,A03,083767,Staff,25,0,30,5
1650506073137,MATH 20E,A01,083771,Staff,6,0,30,24
1650506073137,MATH 20E,A02,083772,Staff,18,0,30,12
1650506073137,MATH 20E,B01,083773,Staff,0,0,30,30
1650506073137,MATH 20E,B02,083774,Staff,10,0,30,20
1650506079164,MATH 103A,A01,083777,Staff,0,13,30,30
1650506079164,MATH 103A,A02,083778,Staff,0,13,30,30
1650506079164,MATH 103A,B01,083779,Staff,0,13,30,30
1650506079164,MATH 103A,B02,083780,Staff,0,13,30,30
1650506085192,MATH 105,A01,085443,Staff,1,23,30,29
1650506091218,MATH 109,A01,083213,Anzaldo; Leesa B,0,7,30,30
1650506091218,MATH 109,A02,083214,Anzaldo; Leesa B,0,7,30,30
1650506091218,MATH 109,B01,083215,Anzaldo; Leesa B,0,5,30,30
1650506091218,MATH 109,B02,083216,Anzaldo; Leesa B,0,6,30,30
1650506097344,MATH 142A,A01,083219,Chow; Bennett,0,15,30,30
1650506097344,MATH 142A,A02,083220,Chow; Bennett,0,14,30,30
1650506097344,MATH 142A,B01,083221,Chow; Bennett,0,13,30,30
1650506097344,MATH 142A,B02,083222,Chow; Bennett,0,13,30,30
1650506103366,MATH 193A,A01,083224,Staff,0,5,30,30
1650506103366,MATH 193A,A02,083225,Staff,0,5,30,30
1650506103366,MATH 193A,A03,083781,Staff,0,5,30,30
1650506103366,MATH 193A,A04,083782,Staff,0,7,30,30
1650506109391,MATH 197,001,091859,McAuley; Julian John,9998,0,9999,1
1650506115457,COGS 9,A01,083615,Staff,0,15,60,60
1650506121487,COGS 11,A01,083617,Boyle; Mary E. T.,19,0,40,21
1650506127516,COGS 13,A01,083071,Staff,0,35,40,40
1650506133539,COGS 14A,A01,092681,Staff,1,25,100,99
1650506139567,COGS 14B,A01,083073,Cheng; Tzu-Han,0,12,50,50
1650506145589,COGS 17,A01,092677,Staff,20,0,75,55
1650506151614,COGS 100,A01,083619,Staff,0,27,60,60
1650506157636,COGS 101A,A01,083621,Davis; Joshua Daniel,0,23,60,60
1650506163662,COGS 101B,A01,091572,Staff,0,4,60,60
1650506169694,COGS 101C,A01,083625,Delgado; Tania,16,0,30,14
1650506175736,COGS 107A,A01,083627,Boyle; Mary E. T.,0,12,60,60
1650506181758,COGS 118A,A01,083075,Staff,0,3,60,60
1650506187781,CSE 3,A50,083646,Miranda; Gregory Joseph,20,0,38,18
1650506187781,CSE 3,A51,083647,Miranda; Gregory Joseph,36,0,37,1
1650506193808,CSE 8A,A50,083650,Miranda; Gregory Joseph,1,29,40,39
1650506199834,CSE 11,A01,083080,Cao; Yingjun,0,91,40,40
1650506205866,CSE 12,A01,083652,Staff,0,17,100,100
1650506211899,CSE 15L,A01,083654,Staff,0,1,50,50
1650506211899,CSE 15L,A02,083655,Staff,0,0,50,50
1650506217920,CSE 20,A01,083657,Staff,51,0,80,29
1650506223962,CSE 30,A01,083084,Eldon; John,0,77,40,40
1650506229987,CSE 100,A01,083659,Cao; Yingjun,0,66,50,50
1650506236009,CSE 134B,A01,083661,Powell; Thomas Allan,0,34,65,65
1650506242035,CSE 140,A01,083663,Staff,0,5,75,75
1650506248061,CSE 140L,A01,083088,Eldon; John,0,11,75,75
1650506254089,CSE 175,A01,083665,Kumar; Rakesh,7,0,25,18
1650506260116,CSE 190,A00,092507,Dubnov; Shlomo,10,0,20,10
1650506266139,ECE 45,A01,083139,Staff,20,19,60,40
1650506272170,ECE 65,A50,083695,Staff,0,6,30,30
1650506278193,ECE 109,A01,091882,Touri; Behrouz,35,0,70,35
1650506284219,ECE 180,A00,083140,Abi Samra; Nicholas Camill,21,0,30,9
1650506284219,ECE 180,B00,083141,Abi Samra; Nicholas Camill,0,0,30,30
1650506290244,MATH 10A,A01,083735,Patchell; Gregory David,5,0,30,25
1650506290244,MATH 10A,A02,083736,Patchell; Gregory David,27,0,30,3
1650506290244,MATH 10A,A03,083737,Patchell; Gregory David,24,0,30,6
1650506296272,MATH 10B,A01,083207,Staff,0,9,30,30
1650506296272,MATH 10B,A02,083208,Staff,0,7,30,30
1650506296272,MATH 10B,B01,083739,Staff,13,0,30,17
1650506296272,MATH 10B,B02,083740,Staff,28,0,30,2
1650506302302,MATH 18,A01,083743,Staff,0,0,30,30
1650506302302,MATH 18,A02,083744,Staff,27,0,30,3
1650506302302,MATH 18,A03,083745,Staff,22,0,30,8
1650506302302,MATH 18,A04,083746,Staff,26,0,30,4
1650506302302,MATH 18,B01,083748,Staff,0,11,30,30
1650506302302,MATH 18,B02,083749,Staff,0,12,30,30
1650506302302,MATH 18,B03,083750,Staff,0,11,30,30
1650506302302,MATH 18,B04,083751,Staff,0,12,30,30
1650506308328,MATH 20A,A01,083754,Staff,24,0,40,16
1650506314355,MATH 20B,A01,083756,Staff,0,11,30,30
1650506314355,MATH 20B,A02,083757,Staff,0,11,30,30
1650506320383,MATH 20C,A01,083760,Staff,0,16,30,30
1650506320383,MATH 20C,A02,083761,Staff,2,15,30,28
1650506320383,MATH 20C,B01,083762,Staff,13,0,30,17
1650506320383,MATH 20C,B02,083763,Staff,28,0,30,2
1650506326410,MATH 20D,A01,083765,Staff,0,1,30,30
1650506326410,MATH 20D,A02,083766,Staff,7,0,30,23
1650506326410,MATH 20D,A03,083767,Staff,25,0,30,5
1650506332443,MATH 20E,A01,083771,Staff,6,0,30,24
1650506332443,MATH 20E,A02,083772,Staff,18,0,30,12
1650506332443,MATH 20E,B01,083773,Staff,0,0,30,30
1650506332443,MATH 20E,B02,083774,Staff,10,0,30,20
1650506338472,MATH 103A,A01,083777,Staff,0,13,30,30
1650506338472,MATH 103A,A02,083778,Staff,0,13,30,30
1650506338472,MATH 103A,B01,083779,Staff,0,13,30,30
1650506338472,MATH 103A,B02,083780,Staff,0,13,30,30
1650506344504,MATH 105,A01,085443,Staff,1,23,30,29
1650506350528,MATH 109,A01,083213,Anzaldo; Leesa B,0,7,30,30
1650506350528,MATH 109,A02,083214,Anzaldo; Leesa B,0,7,30,30
1650506350528,MATH 109,B01,083215,Anzaldo; Leesa B,0,5,30,30
1650506350528,MATH 109,B02,083216,Anzaldo; Leesa B,0,6,30,30
1650506356563,MATH 142A,A01,083219,Chow; Bennett,0,15,30,30
1650506356563,MATH 142A,A02,083220,Chow; Bennett,0,14,30,30
1650506356563,MATH 142A,B01,083221,Chow; Bennett,0,13,30,30
1650506356563,MATH 142A,B02,083222,Chow; Bennett,0,13,30,30
1650506362591,MATH 193A,A01,083224,Staff,0,5,30,30
1650506362591,MATH 193A,A02,083225,Staff,0,5,30,30
1650506362591,MATH 193A,A03,083781,Staff,0,5,30,30
1650506362591,MATH 193A,A04,083782,Staff,0,7,30,30
1650506368616,MATH 197,001,091859,McAuley; Julian John,9998,0,9999,1
1650506374677,COGS 9,A01,083615,Staff,0,15,60,60
1650506380701,COGS 11,A01,083617,Boyle; Mary E. T.,19,0,40,21
1650506386725,COGS 13,A01,083071,Staff,0,35,40,40
1650506392755,COGS 14A,A01,092681,Staff,1,25,100,99
1650506398780,COGS 14B,A01,083073,Cheng; Tzu-Han,1,12,50,49
1650506404809,COGS 17,A01,092677,Staff,20,0,75,55
1650506410832,COGS 100,A01,083619,Staff,0,27,60,60
1650506416865,COGS 101A,A01,083621,Davis; Joshua Daniel,0,25,60,60
1650506422891,COGS 101B,A01,091572,Staff,0,4,60,60
1650506428917,COGS 101C,A01,083625,Delgado; Tania,16,0,30,14
1650506434941,COGS 107A,A01,083627,Boyle; Mary E. T.,0,12,60,60
1650506440970,COGS 118A,A01,083075,Staff,0,3,60,60
1650506447002,CSE 3,A50,083646,Miranda; Gregory Joseph,20,0,38,18
1650506447002,CSE 3,A51,083647,Miranda; Gregory Joseph,36,0,37,1
1650506453027,CSE 8A,A50,083650,Miranda; Gregory Joseph,1,29,40,39
1650506459057,CSE 11,A01,083080,Cao; Yingjun,0,91,40,40
1650506465083,CSE 12,A01,083652,Staff,0,17,100,100
1650506471107,CSE 15L,A01,083654,Staff,0,1,50,50
1650506471107,CSE 15L,A02,083655,Staff,0,0,50,50
1650506477143,CSE 20,A01,083657,Staff,51,0,80,29
1650506483166,CSE 30,A01,083084,Eldon; John,0,77,40,40
1650506489191,CSE 100,A01,083659,Cao; Yingjun,0,66,50,50
1650506495226,CSE 134B,A01,083661,Powell; Thomas Allan,0,34,65,65
1650506501250,CSE 140,A01,083663,Staff,0,5,75,75
1650506507276,CSE 140L,A01,083088,Eldon; John,0,11,75,75
1650506513300,CSE 175,A01,083665,Kumar; Rakesh,7,0,25,18
1650506519323,CSE 190,A00,092507,Dubnov; Shlomo,10,0,20,10
1650506525348,ECE 45,A01,083139,Staff,20,19,60,40
1650506531372,ECE 65,A50,083695,Staff,0,6,30,30
1650506537399,ECE 109,A01,091882,Touri; Behrouz,35,0,70,35
1650506543424,ECE 180,A00,083140,Abi Samra; Nicholas Camill,21,0,30,9
1650506543424,ECE 180,B00,083141,Abi Samra; Nicholas Camill,0,0,30,30
1650506549460,MATH 10A,A01,083735,Patchell; Gregory David,5,0,30,25
1650506549460,MATH 10A,A02,083736,Patchell; Gregory David,27,0,30,3
1650506549460,MATH 10A,A03,083737,Patchell; Gregory David,24,0,30,6
1650506555488,MATH 10B,A01,083207,Staff,0,9,30,30
1650506555488,MATH 10B,A02,083208,Staff,0,7,30,30
1650506555488,MATH 10B,B01,083739,Staff,13,0,30,17
1650506555488,MATH 10B,B02,083740,Staff,28,0,30,2
1650506561514,MATH 18,A01,083743,Staff,0,0,30,30
1650506561514,MATH 18,A02,083744,Staff,27,0,30,3
1650506561514,MATH 18,A03,083745,Staff,22,0,30,8
1650506561514,MATH 18,A04,083746,Staff,26,0,30,4
1650506561514,MATH 18,B01,083748,Staff,0,11,30,30
1650506561514,MATH 18,B02,083749,Staff,0,12,30,30
1650506561514,MATH 18,B03,083750,Staff,0,11,30,30
1650506561514,MATH 18,B04,083751,Staff,0,12,30,30
1650506567541,MATH 20A,A01,083754,Staff,24,0,40,16
1650506573569,MATH 20B,A01,083756,Staff,0,11,30,30
1650506573569,MATH 20B,A02,083757,Staff,0,11,30,30
1650506579598,MATH 20C,A01,083760,Staff,0,16,30,30
1650506579598,MATH 20C,A02,083761,Staff,2,15,30,28
1650506579598,MATH 20C,B01,083762,Staff,13,0,30,17
1650506579598,MATH 20C,B02,083763,Staff,28,0,30,2
1650506585627,MATH 20D,A01,083765,Staff,0,1,30,30
1650506585627,MATH 20D,A02,083766,Staff,7,0,30,23
1650506585627,MATH 20D,A03,083767,Staff,25,0,30,5
1650506591667,MATH 20E,A01,083771,Staff,6,0,30,24
1650506591667,MATH 20E,A02,083772,Staff,18,0,30,12
1650506591667,MATH 20E,B01,083773,Staff,0,0,30,30
1650506591667,MATH 20E,B02,083774,Staff,10,0,30,20
1650506597692,MATH 103A,A01,083777,Staff,0,13,30,30
1650506597692,MATH 103A,A02,083778,Staff,0,13,30,30
1650506597692,MATH 103A,B01,083779,Staff,0,13,30,30
1650506597692,MATH 103A,B02,083780,Staff,0,13,30,30
1650506603720,MATH 105,A01,085443,Staff,1,23,30,29
1650506609743,MATH 109,A01,083213,Anzaldo; Leesa B,0,7,30,30
1650506609743,MATH 109,A02,083214,Anzaldo; Leesa B,0,7,30,30
1650506609743,MATH 109,B01,083215,Anzaldo; Leesa B,0,5,30,30
1650506609743,MATH 109,B02,083216,Anzaldo; Leesa B,0,6,30,30
1650506615765,MATH 142A,A01,083219,Chow; Bennett,0,15,30,30
1650506615765,MATH 142A,A02,083220,Chow; Bennett,0,14,30,30
1650506615765,MATH 142A,B01,083221,Chow; Bennett,0,13,30,30
1650506615765,MATH 142A,B02,083222,Chow; Bennett,0,13,30,30
1650506621789,MATH 193A,A01,083224,Staff,0,5,30,30
1650506621789,MATH 193A,A02,083225,Staff,0,5,30,30
1650506621789,MATH 193A,A03,083781,Staff,0,5,30,30
1650506621789,MATH 193A,A04,083782,Staff,0,7,30,30
1650506627819,MATH 197,001,091859,McAuley; Julian John,9998,0,9999,1
1650506633872,COGS 9,A01,083615,Staff,0,15,60,60
1650506639896,COGS 11,A01,083617,Boyle; Mary E. T.,19,0,40,21
1650506645920,COGS 13,A01,083071,Staff,0,35,40,40
1650506651946,COGS 14A,A01,092681,Staff,1,25,100,99
1650506657973,COGS 14B,A01,083073,Cheng; Tzu-Han,1,12,50,49
1650506664009,COGS 17,A01,092677,Staff,20,0,75,55
1650506670034,COGS 100,A01,083619,Staff,0,27,60,60
1650506676062,COGS 101A,A01,083621,Davis; Joshua Daniel,0,25,60,60
1650506682088,COGS 101B,A01,091572,Staff,0,4,60,60
1650506688203,COGS 101C,A01,083625,Delgado; Tania,16,0,30,14
1650506694238,COGS 107A,A01,083627,Boyle; Mary E. T.,0,12,60,60
1650506700265,COGS 118A,A01,083075,Staff,0,3,60,60
1650506706292,CSE 3,A50,083646,Miranda; Gregory Joseph,20,0,38,18
1650506706292,CSE 3,A51,083647,Miranda; Gregory Joseph,36,0,37,1
1650506712315,CSE 8A,A50,083650,Miranda; Gregory Joseph,1,29,40,39
1650506718339,CSE 11,A01,083080,Cao; Yingjun,0,91,40,40
1650506724362,CSE 12,A01,083652,Staff,0,17,100,100
1650506730398,CSE 15L,A01,083654,Staff,0,1,50,50
1650506730398,CSE 15L,A02,083655,Staff,0,0,50,50
1650506736423,CSE 20,A01,083657,Staff,51,0,80,29
1650506742446,CSE 30,A01,083084,Eldon; John,0,77,40,40
1650506748469,CSE 100,A01,083659,Cao; Yingjun,0,66,50,50
1650506754495,CSE 134B,A01,083661,Powell; Thomas Allan,0,34,65,65
1650506760521,CSE 140,A01,083663,Staff,0,5,75,75
1650506766549,CSE 140L,A01,083088,Eldon; John,0,11,75,75
1650506772575,CSE 175,A01,083665,Kumar; Rakesh,7,0,25,18
1650506778597,CSE 190,A00,092507,Dubnov; Shlomo,10,0,20,10
1650506784620,ECE 45,A01,083139,Staff,20,19,60,40
1650506790648,ECE 65,A50,083695,Staff,0,6,30,30
1650506796675,ECE 109,A01,091882,Touri; Behrouz,35,0,70,35
1650506802700,ECE 180,A00,083140,Abi Samra; Nicholas Camill,21,0,30,9
1650506802700,ECE 180,B00,083141,Abi Samra; Nicholas Camill,0,0,30,30
1650506808724,MATH 10A,A01,083735,Patchell; Gregory David,5,0,30,25
1650506808724,MATH 10A,A02,083736,Patchell; Gregory David,27,0,30,3
1650506808724,MATH 10A,A03,083737,Patchell; Gregory David,24,0,30,6
1650506814762,MATH 10B,A01,083207,Staff,0,9,30,30
1650506814762,MATH 10B,A02,083208,Staff,0,7,30,30
1650506814762,MATH 10B,B01,083739,Staff,13,0,30,17
1650506814762,MATH 10B,B02,083740,Staff,28,0,30,2
1650506820792,MATH 18,A01,083743,Staff,0,0,30,30
1650506820792,MATH 18,A02,083744,Staff,27,0,30,3
1650506820792,MATH 18,A03,083745,Staff,22,0,30,8
1650506820792,MATH 18,A04,083746,Staff,26,0,30,4
1650506820792,MATH 18,B01,083748,Staff,0,11,30,30
1650506820792,MATH 18,B02,083749,Staff,0,12,30,30
1650506820792,MATH 18,B03,083750,Staff,0,11,30,30
1650506820792,MATH 18,B04,083751,Staff,0,12,30,30
1650506826818,MATH 20A,A01,083754,Staff,24,0,40,16
1650506832846,MATH 20B,A01,083756,Staff,0,11,30,30
1650506832846,MATH 20B,A02,083757,Staff,0,11,30,30
1650506838871,MATH 20C,A01,083760,Staff,0,16,30,30
1650506838871,MATH 20C,A02,083761,Staff,2,15,30,28
1650506838871,MATH 20C,B01,083762,Staff,13,0,30,17
1650506838871,MATH 20C,B02,083763,Staff,28,0,30,2
1650506844899,MATH 20D,A01,083765,Staff,0,1,30,30
1650506844899,MATH 20D,A02,083766,Staff,7,0,30,23
1650506844899,MATH 20D,A03,083767,Staff,25,0,30,5
1650506850922,MATH 20E,A01,083771,Staff,6,0,30,24
1650506850922,MATH 20E,A02,083772,Staff,18,0,30,12
1650506850922,MATH 20E,B01,083773,Staff,0,0,30,30
1650506850922,MATH 20E,B02,083774,Staff,10,0,30,20
1650506856951,MATH 103A,A01,083777,Staff,0,13,30,30
1650506856951,MATH 103A,A02,083778,Staff,0,13,30,30
1650506856951,MATH 103A,B01,083779,Staff,0,13,30,30
1650506856951,MATH 103A,B02,083780,Staff,0,13,30,30
1650506862978,MATH 105,A01,085443,Staff,1,23,30,29
1650506869007,MATH 109,A01,083213,Anzaldo; Leesa B,0,7,30,30
1650506869007,MATH 109,A02,083214,Anzaldo; Leesa B,0,7,30,30
1650506869007,MATH 109,B01,083215,Anzaldo; Leesa B,0,5,30,30
1650506869007,MATH 109,B02,083216,Anzaldo; Leesa B,0,6,30,30
1650506875030,MATH 142A,A01,083219,Chow; Bennett,0,15,30,30
1650506875030,MATH 142A,A02,083220,Chow; Bennett,0,14,30,30
1650506875030,MATH 142A,B01,083221,Chow; Bennett,0,13,30,30
1650506875030,MATH 142A,B02,083222,Chow; Bennett,0,13,30,30
1650506881060,MATH 193A,A01,083224,Staff,0,5,30,30
1650506881060,MATH 193A,A02,083225,Staff,0,5,30,30
1650506881060,MATH 193A,A03,083781,Staff,0,5,30,30
1650506881060,MATH 193A,A04,083782,Staff,0,7,30,30
1650506887087,MATH 197,001,091859,McAuley; Julian John,9998,0,9999,1
1650506893139,COGS 9,A01,083615,Staff,0,15,60,60
1650506899162,COGS 11,A01,083617,Boyle; Mary E. T.,19,0,40,21
1650506905183,COGS 13,A01,083071,Staff,0,35,40,40
1650506911223,COGS 14A,A01,092681,Staff,1,25,100,99
1650506917249,COGS 14B,A01,083073,Cheng; Tzu-Han,1,12,50,49
1650506923274,COGS 17,A01,092677,Staff,20,0,75,55
1650506929300,COGS 100,A01,083619,Staff,0,27,60,60
1650506935326,COGS 101A,A01,083621,Davis; Joshua Daniel,0,25,60,60
1650506941363,COGS 101B,A01,091572,Staff,0,4,60,60
1650506947388,COGS 101C,A01,083625,Delgado; Tania,16,0,30,14
1650506953410,COGS 107A,A01,083627,Boyle; Mary E. T.,0,12,60,60
1650506959440,COGS 118A,A01,083075,Staff,0,3,60,60
1650506965464,CSE 3,A50,083646,Miranda; Gregory Joseph,20,0,38,18
1650506965464,CSE 3,A51,083647,Miranda; Gregory Joseph,36,0,37,1
1650506971491,CSE 8A,A50,083650,Miranda; Gregory Joseph,1,30,40,39
1650506977517,CSE 11,A01,083080,Cao; Yingjun,0,92,40,40
1650506983541,CSE 12,A01,083652,Staff,0,17,100,100
1650506989572,CSE 15L,A01,083654,Staff,0,1,50,50
1650506989572,CSE 15L,A02,083655,Staff,0,0,50,50
1650506995596,CSE 20,A01,083657,Staff,51,0,80,29
1650507001633,CSE 30,A01,083084,Eldon; John,0,77,40,40
1650507007663,CSE 100,A01,083659,Cao; Yingjun,0,66,50,50
1650507013691,CSE 134B,A01,083661,Powell; Thomas Allan,0,34,65,65
1650507019714,CSE 140,A01,083663,Staff,0,5,75,75
1650507025739,CSE 140L,A01,083088,Eldon; John,0,11,75,75
1650507031768,CSE 175,A01,083665,Kumar; Rakesh,7,0,25,18
1650507037790,CSE 190,A00,092507,Dubnov; Shlomo,10,0,20,10
1650507043818,ECE 45,A01,083139,Staff,20,19,60,40
1650507049840,ECE 65,A50,083695,Staff,0,6,30,30
1650507055872,ECE 109,A01,091882,Touri; Behrouz,35,0,70,35
1650507061904,ECE 180,A00,083140,Abi Samra; Nicholas Camill,21,0,30,9
1650507061904,ECE 180,B00,083141,Abi Samra; Nicholas Camill,0,0,30,30
1650507067932,MATH 10A,A01,083735,Patchell; Gregory David,5,0,30,25
1650507067932,MATH 10A,A02,083736,Patchell; Gregory David,27,0,30,3
1650507067932,MATH 10A,A03,083737,Patchell; Gregory David,24,0,30,6
1650507073957,MATH 10B,A01,083207,Staff,0,9,30,30
1650507073957,MATH 10B,A02,083208,Staff,0,7,30,30
1650507073957,MATH 10B,B01,083739,Staff,13,0,30,17
1650507073957,MATH 10B,B02,083740,Staff,28,0,30,2
1650507079982,MATH 18,A01,083743,Staff,0,0,30,30
1650507079982,MATH 18,A02,083744,Staff,27,0,30,3
1650507079982,MATH 18,A03,083745,Staff,22,0,30,8
1650507079982,MATH 18,A04,083746,Staff,26,0,30,4
1650507079982,MATH 18,B01,083748,Staff,0,11,30,30
1650507079982,MATH 18,B02,083749,Staff,0,12,30,30
1650507079982,MATH 18,B03,083750,Staff,0,11,30,30
1650507079982,MATH 18,B04,083751,Staff,0,12,30,30
1650507086007,MATH 20A,A01,083754,Staff,24,0,40,16
1650507092039,MATH 20B,A01,083756,Staff,0,11,30,30
1650507092039,MATH 20B,A02,083757,Staff,0,11,30,30
1650507098076,MATH 20C,A01,083760,Staff,0,16,30,30
1650507098076,MATH 20C,A02,083761,Staff,2,15,30,28
1650507098076,MATH 20C,B01,083762,Staff,13,0,30,17
1650507098076,MATH 20C,B02,083763,Staff,28,0,30,2
1650507104106,MATH 20D,A01,083765,Staff,0,1,30,30
1650507104106,MATH 20D,A02,083766,Staff,7,0,30,23
1650507104106,MATH 20D,A03,083767,Staff,25,0,30,5
1650507110129,MATH 20E,A01,083771,Staff,6,0,30,24
1650507110129,MATH 20E,A02,083772,Staff,18,0,30,12
1650507110129,MATH 20E,B01,083773,Staff,0,0,30,30
1650507110129,MATH 20E,B02,083774,Staff,10,0,30,20
1650507116154,MATH 103A,A01,083777,Staff,0,13,30,30
1650507116154,MATH 103A,A02,083778,Staff,0,13,30,30
1650507116154,MATH 103A,B01,083779,Staff,0,13,30,30
1650507116154,MATH 103A,B02,083780,Staff,0,13,30,30
1650507122182,MATH 105,A01,085443,Staff,1,23,30,29
1650507128209,MATH 109,A01,083213,Anzaldo; Leesa B,0,7,30,30
1650507128209,MATH 109,A02,083214,Anzaldo; Leesa B,0,7,30,30
1650507128209,MATH 109,B01,083215,Anzaldo; Leesa B,0,5,30,30
1650507128209,MATH 109,B02,083216,Anzaldo; Leesa B,0,6,30,30
1650507134238,MATH 142A,A01,083219,Chow; Bennett,0,15,30,30
1650507134238,MATH 142A,A02,083220,Chow; Bennett,0,14,30,30
1650507134238,MATH 142A,B01,083221,Chow; Bennett,0,13,30,30
1650507134238,MATH 142A,B02,083222,Chow; Bennett,0,13,30,30
1650507140266,MATH 193A,A01,083224,Staff,0,5,30,30
1650507140266,MATH 193A,A02,083225,Staff,0,5,30,30
1650507140266,MATH 193A,A03,083781,Staff,0,5,30,30
1650507140266,MATH 193A,A04,083782,Staff,0,7,30,30
1650507146292,MATH 197,001,091859,McAuley; Julian John,9998,0,9999,1
1650507152348,COGS 9,A01,083615,Staff,0,15,60,60
1650507158373,COGS 11,A01,083617,Boyle; Mary E. T.,19,0,40,21
1650507164395,COGS 13,A01,083071,Staff,0,35,40,40
1650507170435,COGS 14A,A01,092681,Staff,1,25,100,99
1650507176458,COGS 14B,A01,083073,Cheng; Tzu-Han,1,12,50,49
1650507182486,COGS 17,A01,092677,Staff,20,0,75,55
1650507188509,COGS 100,A01,083619,Staff,0,27,60,60
1650507194545,COGS 101A,A01,083621,Davis; Joshua Daniel,0,25,60,60
1650507200569,COGS 101B,A01,091572,Staff,0,4,60,60
1650507206593,COGS 101C,A01,083625,Delgado; Tania,16,0,30,14
1650507212617,COGS 107A,A01,083627,Boyle; Mary E. T.,0,12,60,60
1650507218640,COGS 118A,A01,083075,Staff,0,3,60,60
1650507224670,CSE 3,A50,083646,Miranda; Gregory Joseph,20,0,38,18
1650507224670,CSE 3,A51,083647,Miranda; Gregory Joseph,36,0,37,1
1650507230700,CSE 8A,A50,083650,Miranda; Gregory Joseph,1,30,40,39
1650507236737,CSE 11,A01,083080,Cao; Yingjun,0,92,40,40
1650507242765,CSE 12,A01,083652,Staff,0,17,100,100
1650507248793,CSE 15L,A01,083654,Staff,0,1,50,50
1650507248793,CSE 15L,A02,083655,Staff,0,0,50,50
1650507254819,CSE 20,A01,083657,Staff,51,0,80,29
1650507260845,CSE 30,A01,083084,Eldon; John,0,77,40,40
1650507266867,CSE 100,A01,083659,Cao; Yingjun,0,66,50,50
1650507272891,CSE 134B,A01,083661,Powell; Thomas Allan,0,34,65,65
1650507278925,CSE 140,A01,083663,Staff,0,5,75,75
1650507285043,CSE 140L,A01,083088,Eldon; John,0,11,75,75
1650507291067,CSE 175,A01,083665,Kumar; Rakesh,7,0,25,18
1650507297092,CSE 190,A00,092507,Dubnov; Shlomo,10,0,20,10
1650507303114,ECE 45,A01,083139,Staff,20,19,60,40
1650507309143,ECE 65,A50,083695,Staff,0,6,30,30
1650507315171,ECE 109,A01,091882,Touri; Behrouz,35,0,70,35
1650507321216,ECE 180,A00,083140,Abi Samra; Nicholas Camill,21,0,30,9
1650507321216,ECE 180,B00,083141,Abi Samra; Nicholas Camill,0,0,30,30
1650507327238,MATH 10A,A01,083735,Patchell; Gregory David,5,0,30,25
1650507327238,MATH 10A,A02,083736,Patchell; Gregory David,27,0,30,3
1650507327238,MATH 10A,A03,083737,Patchell; Gregory David,24,0,30,6
1650507333261,MATH 10B,A01,083207,Staff,0,9,30,30
1650507333261,MATH 10B,A02,083208,Staff,0,7,30,30
1650507333261,MATH 10B,B01,083739,Staff,13,0,30,17
1650507333261,MATH 10B,B02,083740,Staff,28,0,30,2
1650507339285,MATH 18,A01,083743,Staff,0,0,30,30
1650507339285,MATH 18,A02,083744,Staff,27,0,30,3
1650507339285,MATH 18,A03,083745,Staff,22,0,30,8
1650507339285,MATH 18,A04,083746,Staff,26,0,30,4
1650507339285,MATH 18,B01,083748,Staff,0,11,30,30
1650507339285,MATH 18,B02,083749,Staff,0,12,30,30
1650507339285,MATH 18,B03,083750,Staff,0,11,30,30
1650507339285,MATH 18,B04,083751,Staff,0,12,30,30
1650507345308,MATH 20A,A01,083754,Staff,24,0,40,16
1650507351331,MATH 20B,A01,083756,Staff,0,11,30,30
1650507351331,MATH 20B,A02,083757,Staff,0,11,30,30
1650507357358,MATH 20C,A01,083760,Staff,0,16,30,30
1650507357358,MATH 20C,A02,083761,Staff,2,15,30,28
1650507357358,MATH 20C,B01,083762,Staff,13,0,30,17
1650507357358,MATH 20C,B02,083763,Staff,28,0,30,2
1650507363383,MATH 20D,A01,083765,Staff,0,1,30,30
1650507363383,MATH 20D,A02,083766,Staff,7,0,30,23
1650507363383,MATH 20D,A03,083767,Staff,25,0,30,5
1650507369410,MATH 20E,A01,083771,Staff,6,0,30,24
1650507369410,MATH 20E,A02,083772,Staff,18,0,30,12
1650507369410,MATH 20E,B01,083773,Staff,0,0,30,30
1650507369410,MATH 20E,B02,083774,Staff,10,0,30,20
1650507375437,MATH 103A,A01,083777,Staff,0,13,30,30
1650507375437,MATH 103A,A02,083778,Staff,0,13,30,30
1650507375437,MATH 103A,B01,083779,Staff,0,13,30,30
1650507375437,MATH 103A,B02,083780,Staff,0,13,30,30
1650507381460,MATH 105,A01,085443,Staff,1,23,30,29
1650507387495,MATH 109,A01,083213,Anzaldo; Leesa B,0,7,30,30
1650507387495,MATH 109,A02,083214,Anzaldo; Leesa B,0,7,30,30
1650507387495,MATH 109,B01,083215,Anzaldo; Leesa B,0,5,30,30
1650507387495,MATH 109,B02,083216,Anzaldo; Leesa B,0,6,30,30
1650507393519,MATH 142A,A01,083219,Chow; Bennett,0,15,30,30
1650507393519,MATH 142A,A02,083220,Chow; Bennett,0,14,30,30
1650507393519,MATH 142A,B01,083221,Chow; Bennett,0,13,30,30
1650507393519,MATH 142A,B02,083222,Chow; Bennett,0,13,30,30
1650507399542,MATH 193A,A01,083224,Staff,0,5,30,30
1650507399542,MATH 193A,A02,083225,Staff,0,5,30,30
1650507399542,MATH 193A,A03,083781,Staff,0,5,30,30
1650507399542,MATH 193A,A04,083782,Staff,0,7,30,30
1650507405568,MATH 197,001,091859,McAuley; Julian John,9998,0,9999,1
1650507411628,COGS 9,A01,083615,Staff,0,15,60,60
1650507417654,COGS 11,A01,083617,Boyle; Mary E. T.,19,0,40,21
1650507423680,COGS 13,A01,083071,Staff,0,35,40,40
1650507429707,COGS 14A,A01,092681,Staff,1,25,100,99
1650507435731,COGS 14B,A01,083073,Cheng; Tzu-Han,1,12,50,49
1650507441755,COGS 17,A01,092677,Staff,20,0,75,55
1650507447779,COGS 100,A01,083619,Staff,0,27,60,60
1650507453802,COGS 101A,A01,083621,Davis; Joshua Daniel,0,25,60,60
1650507459838,COGS 101B,A01,091572,Staff,0,4,60,60
1650507465861,COGS 101C,A01,083625,Delgado; Tania,16,0,30,14
1650507471889,COGS 107A,A01,083627,Boyle; Mary E. T.,0,12,60,60
1650507477915,COGS 118A,A01,083075,Staff,0,3,60,60
1650507483939,CSE 3,A50,083646,Miranda; Gregory Joseph,20,0,38,18
1650507483939,CSE 3,A51,083647,Miranda; Gregory Joseph,36,0,37,1
1650507489962,CSE 8A,A50,083650,Miranda; Gregory Joseph,1,30,40,39
1650507495985,CSE 11,A01,083080,Cao; Yingjun,0,92,40,40
1650507502011,CSE 12,A01,083652,Staff,0,17,100,100
1650507508038,CSE 15L,A01,083654,Staff,0,1,50,50
1650507508038,CSE 15L,A02,083655,Staff,0,0,50,50
1650507514063,CSE 20,A01,083657,Staff,51,0,80,29
1650507520088,CSE 30,A01,083084,Eldon; John,0,77,40,40
1650507526112,CSE 100,A01,083659,Cao; Yingjun,0,66,50,50
1650507532141,CSE 134B,A01,083661,Powell; Thomas Allan,0,34,65,65
1650507538167,CSE 140,A01,083663,Staff,0,5,75,75
1650507544195,CSE 140L,A01,083088,Eldon; John,0,11,75,75
1650507550234,CSE 175,A01,083665,Kumar; Rakesh,7,0,25,18
1650507556260,CSE 190,A00,092507,Dubnov; Shlomo,10,0,20,10
1650507562284,ECE 45,A01,083139,Staff,20,19,60,40
1650507568307,ECE 65,A50,083695,Staff,0,6,30,30
1650507574331,ECE 109,A01,091882,Touri; Behrouz,35,0,70,35
1650507580357,ECE 180,A00,083140,Abi Samra; Nicholas Camill,21,0,30,9
1650507580357,ECE 180,B00,083141,Abi Samra; Nicholas Camill,0,0,30,30
1650507586386,MATH 10A,A01,083735,Patchell; Gregory David,5,0,30,25
1650507586386,MATH 10A,A02,083736,Patchell; Gregory David,27,0,30,3
1650507586386,MATH 10A,A03,083737,Patchell; Gregory David,24,0,30,6
1650507592408,MATH 10B,A01,083207,Staff,0,9,30,30
1650507592408,MATH 10B,A02,083208,Staff,0,7,30,30
1650507592408,MATH 10B,B01,083739,Staff,13,0,30,17
1650507592408,MATH 10B,B02,083740,Staff,28,0,30,2
1650507598440,MATH 18,A01,083743,Staff,0,0,30,30
1650507598440,MATH 18,A02,083744,Staff,27,0,30,3
1650507598440,MATH 18,A03,083745,Staff,22,0,30,8
1650507598440,MATH 18,A04,083746,Staff,26,0,30,4
1650507598440,MATH 18,B01,083748,Staff,0,11,30,30
1650507598440,MATH 18,B02,083749,Staff,0,12,30,30
1650507598440,MATH 18,B03,083750,Staff,0,11,30,30
1650507598440,MATH 18,B04,083751,Staff,0,12,30,30
1650507604476,MATH 20A,A01,083754,Staff,24,0,40,16
1650507610504,MATH 20B,A01,083756,Staff,0,11,30,30
1650507610504,MATH 20B,A02,083757,Staff,0,11,30,30
1650507616536,MATH 20C,A01,083760,Staff,0,16,30,30
1650507616536,MATH 20C,A02,083761,Staff,2,15,30,28
1650507616536,MATH 20C,B01,083762,Staff,13,0,30,17
1650507616536,MATH 20C,B02,083763,Staff,28,0,30,2
1650507622563,MATH 20D,A01,083765,Staff,0,1,30,30
1650507622563,MATH 20D,A02,083766,Staff,7,0,30,23
1650507622563,MATH 20D,A03,083767,Staff,25,0,30,5
1650507628587,MATH 20E,A01,083771,Staff,6,0,30,24
1650507628587,MATH 20E,A02,083772,Staff,18,0,30,12
1650507628587,MATH 20E,B01,083773,Staff,0,0,30,30
1650507628587,MATH 20E,B02,083774,Staff,10,0,30,20
1650507634616,MATH 103A,A01,083777,Staff,0,13,30,30
1650507634616,MATH 103A,A02,083778,Staff,0,13,30,30
1650507634616,MATH 103A,B01,083779,Staff,0,13,30,30
1650507634616,MATH 103A,B02,083780,Staff,0,13,30,30
1650507640724,MATH 105,A01,085443,Staff,1,23,30,29
1650507646754,MATH 109,A01,083213,Anzaldo; Leesa B,0,7,30,30
1650507646754,MATH 109,A02,083214,Anzaldo; Leesa B,0,7,30,30
1650507646754,MATH 109,B01,083215,Anzaldo; Leesa B,0,5,30,30
1650507646754,MATH 109,B02,083216,Anzaldo; Leesa B,0,6,30,30
1650507652776,MATH 142A,A01,083219,Chow; Bennett,0,16,30,30
1650507652776,MATH 142A,A02,083220,Chow; Bennett,0,14,30,30
1650507652776,MATH 142A,B01,083221,Chow; Bennett,0,13,30,30
1650507652776,MATH 142A,B02,083222,Chow; Bennett,0,13,30,30
1650507658800,MATH 193A,A01,083224,Staff,0,5,30,30
1650507658800,MATH 193A,A02,083225,Staff,0,5,30,30
1650507658800,MATH 193A,A03,083781,Staff,0,5,30,30
1650507658800,MATH 193A,A04,083782,Staff,0,7,30,30
1650507664826,MATH 197,001,091859,McAuley; Julian John,9998,0,9999,1
1650507670882,COGS 9,A01,083615,Staff,0,15,60,60
1650507676905,COGS 11,A01,083617,Boyle; Mary E. T.,19,0,40,21
1650507682931,COGS 13,A01,083071,Staff,0,35,40,40
1650507688952,COGS 14A,A01,092681,Staff,1,26,100,99
1650507694977,COGS 14B,A01,083073,Cheng; Tzu-Han,1,12,50,49
1650507701001,COGS 17,A01,092677,Staff,20,0,75,55
1650507707026,COGS 100,A01,083619,Staff,0,27,60,60
1650507713053,COGS 101A,A01,083621,Davis; Joshua Daniel,0,25,60,60
1650507719079,COGS 101B,A01,091572,Staff,0,4,60,60
1650507725102,COGS 101C,A01,083625,Delgado; Tania,16,0,30,14
1650507731128,COGS 107A,A01,083627,Boyle; Mary E. T.,0,12,60,60
1650507737161,COGS 118A,A01,083075,Staff,0,3,60,60
1650507743188,CSE 3,A50,083646,Miranda; Gregory Joseph,20,0,38,18
1650507743188,CSE 3,A51,083647,Miranda; Gregory Joseph,36,0,37,1
1650507749212,CSE 8A,A50,083650,Miranda; Gregory Joseph,1,30,40,39
1650507755249,CSE 11,A01,083080,Cao; Yingjun,0,92,40,40
1650507761274,CSE 12,A01,083652,Staff,0,17,100,100
1650507767295,CSE 15L,A01,083654,Staff,0,1,50,50
1650507767295,CSE 15L,A02,083655,Staff,0,0,50,50
1650507773320,CSE 20,A01,083657,Staff,51,0,80,29
1650507779351,CSE 30,A01,083084,Eldon; John,0,77,40,40
1650507785377,CSE 100,A01,083659,Cao; Yingjun,0,66,50,50
1650507791410,CSE 134B,A01,083661,Powell; Thomas Allan,0,34,65,65
1650507797435,CSE 140,A01,083663,Staff,0,5,75,75
1650507803458,CSE 140L,A01,083088,Eldon; John,0,11,75,75
1650507809482,CSE 175,A01,083665,Kumar; Rakesh,7,0,25,18
1650507815515,CSE 190,A00,092507,Dubnov; Shlomo,10,0,20,10
1650507821547,ECE 45,A01,083139,Staff,20,19,60,40
1650507827571,ECE 65,A50,083695,Staff,0,6,30,30
1650507833605,ECE 109,A01,091882,Touri; Behrouz,35,0,70,35
1650507839632,ECE 180,A00,083140,Abi Samra; Nicholas Camill,21,0,30,9
1650507839632,ECE 180,B00,083141,Abi Samra; Nicholas Camill,0,0,30,30
1650507845660,MATH 10A,A01,083735,Patchell; Gregory David,5,0,30,25
1650507845660,MATH 10A,A02,083736,Patchell; Gregory David,27,0,30,3
1650507845660,MATH 10A,A03,083737,Patchell; Gregory David,24,0,30,6
1650507851690,MATH 10B,A01,083207,Staff,0,9,30,30
1650507851690,MATH 10B,A02,083208,Staff,0,7,30,30
1650507851690,MATH 10B,B01,083739,Staff,13,0,30,17
1650507851690,MATH 10B,B02,083740,Staff,28,0,30,2
1650507857713,MATH 18,A01,083743,Staff,0,0,30,30
1650507857713,MATH 18,A02,083744,Staff,27,0,30,3
1650507857713,MATH 18,A03,083745,Staff,22,0,30,8
1650507857713,MATH 18,A04,083746,Staff,26,0,30,4
1650507857713,MATH 18,B01,083748,Staff,0,11,30,30
1650507857713,MATH 18,B02,083749,Staff,0,12,30,30
1650507857713,MATH 18,B03,083750,Staff,0,11,30,30
1650507857713,MATH 18,B04,083751,Staff,0,12,30,30
1650507863740,MATH 20A,A01,083754,Staff,24,0,40,16
1650507869765,MATH 20B,A01,083756,Staff,0,11,30,30
1650507869765,MATH 20B,A02,083757,Staff,0,11,30,30
1650507875795,MATH 20C,A01,083760,Staff,0,16,30,30
1650507875795,MATH 20C,A02,083761,Staff,2,15,30,28
1650507875795,MATH 20C,B01,083762,Staff,12,0,30,18
1650507875795,MATH 20C,B02,083763,Staff,28,0,30,2
1650507881912,MATH 20D,A01,083765,Staff,0,1,30,30
1650507881912,MATH 20D,A02,083766,Staff,7,0,30,23
1650507881912,MATH 20D,A03,083767,Staff,25,0,30,5
1650507887940,MATH 20E,A01,083771,Staff,6,0,30,24
1650507887940,MATH 20E,A02,083772,Staff,18,0,30,12
1650507887940,MATH 20E,B01,083773,Staff,0,0,30,30
1650507887940,MATH 20E,B02,083774,Staff,10,0,30,20
1650507893963,MATH 103A,A01,083777,Staff,0,13,30,30
1650507893963,MATH 103A,A02,083778,Staff,0,14,30,30
1650507893963,MATH 103A,B01,083779,Staff,0,13,30,30
1650507893963,MATH 103A,B02,083780,Staff,0,13,30,30
1650507899988,MATH 105,A01,085443,Staff,1,23,30,29
1650507906023,MATH 109,A01,083213,Anzaldo; Leesa B,0,7,30,30
1650507906023,MATH 109,A02,083214,Anzaldo; Leesa B,0,7,30,30
1650507906023,MATH 109,B01,083215,Anzaldo; Leesa B,0,5,30,30
1650507906023,MATH 109,B02,083216,Anzaldo; Leesa B,0,6,30,30
1650507912046,MATH 142A,A01,083219,Chow; Bennett,0,16,30,30
1650507912046,MATH 142A,A02,083220,Chow; Bennett,0,14,30,30
1650507912046,MATH 142A,B01,083221,Chow; Bennett,0,13,30,30
1650507912046,MATH 142A,B02,083222,Chow; Bennett,0,13,30,30
1650507918075,MATH 193A,A01,083224,Staff,0,5,30,30
1650507918075,MATH 193A,A02,083225,Staff,0,5,30,30
1650507918075,MATH 193A,A03,083781,Staff,0,5,30,30
1650507918075,MATH 193A,A04,083782,Staff,0,7,30,30
1650507924098,MATH 197,001,091859,McAuley; Julian John,9998,0,9999,1
1650507930157,COGS 9,A01,083615,Staff,0,15,60,60
1650507936179,COGS 11,A01,083617,Boyle; Mary E. T.,18,0,40,22
1650507942207,COGS 13,A01,083071,Staff,0,35,40,40
1650507948234,COGS 14A,A01,092681,Staff,1,26,100,99
1650507954257,COGS 14B,A01,083073,Cheng; Tzu-Han,1,12,50,49
1650507960296,COGS 17,A01,092677,Staff,20,0,75,55
1650507966320,COGS 100,A01,083619,Staff,0,27,60,60
1650507972350,COGS 101A,A01,083621,Davis; Joshua Daniel,0,25,60,60
1650507978378,COGS 101B,A01,091572,Staff,0,4,60,60
1650507984440,COGS 101C,A01,083625,Delgado; Tania,16,0,30,14
1650507990464,COGS 107A,A01,083627,Boyle; Mary E. T.,0,12,60,60
1650507996490,COGS 118A,A01,083075,Staff,0,3,60,60
1650508002519,CSE 3,A50,083646,Miranda; Gregory Joseph,20,0,38,18
1650508002519,CSE 3,A51,083647,Miranda; Gregory Joseph,36,0,37,1
1650508008542,CSE 8A,A50,083650,Miranda; Gregory Joseph,1,30,40,39
1650508014570,CSE 11,A01,083080,Cao; Yingjun,0,92,40,40
1650508020595,CSE 12,A01,083652,Staff,0,17,100,100
1650508026618,CSE 15L,A01,083654,Staff,0,1,50,50
1650508026618,CSE 15L,A02,083655,Staff,0,0,50,50
1650508032643,CSE 20,A01,083657,Staff,51,0,80,29
1650508038669,CSE 30,A01,083084,Eldon; John,0,77,40,40
1650508044695,CSE 100,A01,083659,Cao; Yingjun,0,66,50,50
1650508050721,CSE 134B,A01,083661,Powell; Thomas Allan,0,34,65,65
1650508056747,CSE 140,A01,083663,Staff,0,5,75,75
1650508062774,CSE 140L,A01,083088,Eldon; John,0,11,75,75
1650508068815,CSE 175,A01,083665,Kumar; Rakesh,7,0,25,18
1650508074846,CSE 190,A00,092507,Dubnov; Shlomo,10,0,20,10
1650508080874,ECE 45,A01,083139,Staff,20,19,60,40
1650508086898,ECE 65,A50,083695,Staff,0,6,30,30
1650508092921,ECE 109,A01,091882,Touri; Behrouz,35,0,70,35
1650508098945,ECE 180,A00,083140,Abi Samra; Nicholas Camill,21,0,30,9
1650508098945,ECE 180,B00,083141,Abi Samra; Nicholas Camill,0,0,30,30
1650508104972,MATH 10A,A01,083735,Patchell; Gregory David,5,0,30,25
1650508104972,MATH 10A,A02,083736,Patchell; Gregory David,27,0,30,3
1650508104972,MATH 10A,A03,083737,Patchell; Gregory David,24,0,30,6
1650508110997,MATH 10B,A01,083207,Staff,0,9,30,30
1650508110997,MATH 10B,A02,083208,Staff,0,7,30,30
1650508110997,MATH 10B,B01,083739,Staff,13,0,30,17
1650508110997,MATH 10B,B02,083740,Staff,28,0,30,2
1650508117021,MATH 18,A01,083743,Staff,0,0,30,30
1650508117021,MATH 18,A02,083744,Staff,27,0,30,3
1650508117021,MATH 18,A03,083745,Staff,22,0,30,8
1650508117021,MATH 18,A04,083746,Staff,26,0,30,4
1650508117021,MATH 18,B01,083748,Staff,0,11,30,30
1650508117021,MATH 18,B02,083749,Staff,0,12,30,30
1650508117021,MATH 18,B03,083750,Staff,0,11,30,30
1650508117021,MATH 18,B04,083751,Staff,0,12,30,30
1650508123044,MATH 20A,A01,083754,Staff,24,0,40,16
1650508129070,MATH 20B,A01,083756,Staff,0,11,30,30
1650508129070,MATH 20B,A02,083757,Staff,0,11,30,30
1650508135094,MATH 20C,A01,083760,Staff,0,16,30,30
1650508135094,MATH 20C,A02,083761,Staff,2,15,30,28
1650508135094,MATH 20C,B01,083762,Staff,12,0,30,18
1650508135094,MATH 20C,B02,083763,Staff,28,0,30,2
1650508141120,MATH 20D,A01,083765,Staff,0,1,30,30
1650508141120,MATH 20D,A02,083766,Staff,7,0,30,23
1650508141120,MATH 20D,A03,083767,Staff,25,0,30,5
1650508147143,MATH 20E,A01,083771,Staff,6,0,30,24
1650508147143,MATH 20E,A02,083772,Staff,18,0,30,12
1650508147143,MATH 20E,B01,083773,Staff,0,0,30,30
1650508147143,MATH 20E,B02,083774,Staff,10,0,30,20
1650508153180,MATH 103A,A01,083777,Staff,0,13,30,30
1650508153180,MATH 103A,A02,083778,Staff,0,14,30,30
1650508153180,MATH 103A,B01,083779,Staff,0,13,30,30
1650508153180,MATH 103A,B02,083780,Staff,0,13,30,30
1650508159214,MATH 105,A01,085443,Staff,1,23,30,29
1650508165237,MATH 109,A01,083213,Anzaldo; Leesa B,0,7,30,30
1650508165237,MATH 109,A02,083214,Anzaldo; Leesa B,0,7,30,30
1650508165237,MATH 109,B01,083215,Anzaldo; Leesa B,0,5,30,30
1650508165237,MATH 109,B02,083216,Anzaldo; Leesa B,0,6,30,30
1650508171271,MATH 142A,A01,083219,Chow; Bennett,0,16,30,30
1650508171271,MATH 142A,A02,083220,Chow; Bennett,0,14,30,30
1650508171271,MATH 142A,B01,083221,Chow; Bennett,0,13,30,30
1650508171271,MATH 142A,B02,083222,Chow; Bennett,0,13,30,30
1650508177298,MATH 193A,A01,083224,Staff,0,5,30,30
1650508177298,MATH 193A,A02,083225,Staff,0,5,30,30
1650508177298,MATH 193A,A03,083781,Staff,0,5,30,30
1650508177298,MATH 193A,A04,083782,Staff,0,7,30,30
1650508183361,MATH 197,001,091859,McAuley; Julian John,9998,0,9999,1
1650508189429,COGS 9,A01,083615,Staff,0,15,60,60
1650508195455,COGS 11,A01,083617,Boyle; Mary E. T.,18,0,40,22
1650508201484,COGS 13,A01,083071,Staff,0,35,40,40
1650508207507,COGS 14A,A01,092681,Staff,1,26,100,99
1650508213532,COGS 14B,A01,083073,Cheng; Tzu-Han,1,12,50,49
1650508219557,COGS 17,A01,092677,Staff,20,0,75,55
1650508225581,COGS 100,A01,083619,Staff,0,27,60,60
1650508231605,COGS 101A,A01,083621,Davis; Joshua Daniel,0,25,60,60
1650508237629,COGS 101B,A01,091572,Staff,0,4,60,60
1650508243675,COGS 101C,A01,083625,Delgado; Tania,16,0,30,14
1650508249698,COGS 107A,A01,083627,Boyle; Mary E. T.,0,12,60,60
1650508255721,COGS 118A,A01,083075,Staff,0,3,60,60
1650508261746,CSE 3,A50,083646,Miranda; Gregory Joseph,20,0,38,18
1650508261746,CSE 3,A51,083647,Miranda; Gregory Joseph,36,0,37,1
1650508267770,CSE 8A,A50,083650,Miranda; Gregory Joseph,1,30,40,39
1650508273799,CSE 11,A01,083080,Cao; Yingjun,0,92,40,40
1650508279823,CSE 12,A01,083652,Staff,0,17,100,100
1650508285847,CSE 15L,A01,083654,Staff,0,1,50,50
1650508285847,CSE 15L,A02,083655,Staff,0,0,50,50
1650508291881,CSE 20,A01,083657,Staff,51,0,80,29
1650508297907,CSE 30,A01,083084,Eldon; John,0,77,40,40
1650508303930,CSE 100,A01,083659,Cao; Yingjun,0,66,50,50
1650508309961,CSE 134B,A01,083661,Powell; Thomas Allan,0,34,65,65
1650508315987,CSE 140,A01,083663,Staff,0,5,75,75
1650508322011,CSE 140L,A01,083088,Eldon; John,0,11,75,75
1650508328036,CSE 175,A01,083665,Kumar; Rakesh,7,0,25,18
1650508334063,CSE 190,A00,092507,Dubnov; Shlomo,10,0,20,10
1650508340086,ECE 45,A01,083139,Staff,20,19,60,40
1650508346112,ECE 65,A50,083695,Staff,0,6,30,30
1650508352136,ECE 109,A01,091882,Touri; Behrouz,35,0,70,35
1650508358159,ECE 180,A00,083140,Abi Samra; Nicholas Camill,21,0,30,9
1650508358159,ECE 180,B00,083141,Abi Samra; Nicholas Camill,0,0,30,30
1650508364184,MATH 10A,A01,083735,Patchell; Gregory David,5,0,30,25
1650508364184,MATH 10A,A02,083736,Patchell; Gregory David,27,0,30,3
1650508364184,MATH 10A,A03,083737,Patchell; Gregory David,24,0,30,6
1650508370218,MATH 10B,A01,083207,Staff,0,9,30,30
1650508370218,MATH 10B,A02,083208,Staff,0,7,30,30
1650508370218,MATH 10B,B01,083739,Staff,13,0,30,17
1650508370218,MATH 10B,B02,083740,Staff,28,0,30,2
1650508376248,MATH 18,A01,083743,Staff,0,0,30,30
1650508376248,MATH 18,A02,083744,Staff,27,0,30,3
1650508376248,MATH 18,A03,083745,Staff,22,0,30,8
1650508376248,MATH 18,A04,083746,Staff,26,0,30,4
1650508376248,MATH 18,B01,083748,Staff,0,11,30,30
1650508376248,MATH 18,B02,083749,Staff,0,12,30,30
1650508376248,MATH 18,B03,083750,Staff,0,11,30,30
1650508376248,MATH 18,B04,083751,Staff,0,12,30,30
1650508382279,MATH 20A,A01,083754,Staff,24,0,40,16
1650508388305,MATH 20B,A01,083756,Staff,0,11,30,30
1650508388305,MATH 20B,A02,083757,Staff,0,11,30,30
1650508394331,MATH 20C,A01,083760,Staff,0,16,30,30
1650508394331,MATH 20C,A02,083761,Staff,2,15,30,28
1650508394331,MATH 20C,B01,083762,Staff,12,0,30,18
1650508394331,MATH 20C,B02,083763,Staff,28,0,30,2
1650508400354,MATH 20D,A01,083765,Staff,0,1,30,30
1650508400354,MATH 20D,A02,083766,Staff,7,0,30,23
1650508400354,MATH 20D,A03,083767,Staff,25,0,30,5
1650508406377,MATH 20E,A01,083771,Staff,6,0,30,24
1650508406377,MATH 20E,A02,083772,Staff,18,0,30,12
1650508406377,MATH 20E,B01,083773,Staff,0,0,30,30
1650508406377,MATH 20E,B02,083774,Staff,10,0,30,20
1650508412401,MATH 103A,A01,083777,Staff,0,13,30,30
1650508412401,MATH 103A,A02,083778,Staff,0,14,30,30
1650508412401,MATH 103A,B01,083779,Staff,0,13,30,30
1650508412401,MATH 103A,B02,083780,Staff,0,13,30,30
1650508418424,MATH 105,A01,085443,Staff,1,23,30,29
1650508424464,MATH 109,A01,083213,Anzaldo; Leesa B,0,7,30,30
1650508424464,MATH 109,A02,083214,Anzaldo; Leesa B,0,7,30,30
1650508424464,MATH 109,B01,083215,Anzaldo; Leesa B,0,5,30,30
1650508424464,MATH 109,B02,083216,Anzaldo; Leesa B,0,6,30,30
1650508430492,MATH 142A,A01,083219,Chow; Bennett,0,16,30,30
1650508430492,MATH 142A,A02,083220,Chow; Bennett,0,14,30,30
1650508430492,MATH 142A,B01,083221,Chow; Bennett,0,13,30,30
1650508430492,MATH 142A,B02,083222,Chow; Bennett,0,13,30,30
1650508436514,MATH 193A,A01,083224,Staff,0,5,30,30
1650508436514,MATH 193A,A02,083225,Staff,0,5,30,30
1650508436514,MATH 193A,A03,083781,Staff,0,5,30,30
1650508436514,MATH 193A,A04,083782,Staff,0,7,30,30
1650508442539,MATH 197,001,091859,McAuley; Julian John,9998,0,9999,1
1650508448593,COGS 9,A01,083615,Staff,0,15,60,60
1650508454617,COGS 11,A01,083617,Boyle; Mary E. T.,19,0,40,21
1650508460641,COGS 13,A01,083071,Staff,0,35,40,40
1650508466666,COGS 14A,A01,092681,Staff,1,26,100,99
1650508472769,COGS 14B,A01,083073,Cheng; Tzu-Han,1,12,50,49
1650508478794,COGS 17,A01,092677,Staff,20,0,75,55
1650508484827,COGS 100,A01,083619,Staff,0,27,60,60
1650508490862,COGS 101A,A01,083621,Davis; Joshua Daniel,0,25,60,60
1650508496891,COGS 101B,A01,091572,Staff,0,4,60,60
1650508502917,COGS 101C,A01,083625,Delgado; Tania,16,0,30,14
1650508508940,COGS 107A,A01,083627,Boyle; Mary E. T.,0,12,60,60
1650508514967,COGS 118A,A01,083075,Staff,0,3,60,60
1650508520990,CSE 3,A50,083646,Miranda; Gregory Joseph,20,0,38,18
1650508520990,CSE 3,A51,083647,Miranda; Gregory Joseph,36,0,37,1
1650508527020,CSE 8A,A50,083650,Miranda; Gregory Joseph,1,30,40,39
1650508533045,CSE 11,A01,083080,Cao; Yingjun,0,92,40,40
1650508539068,CSE 12,A01,083652,Staff,0,17,100,100
1650508545092,CSE 15L,A01,083654,Staff,0,1,50,50
1650508545092,CSE 15L,A02,083655,Staff,0,0,50,50
1650508551134,CSE 20,A01,083657,Staff,51,0,80,29
1650508557161,CSE 30,A01,083084,Eldon; John,0,77,40,40
1650508563187,CSE 100,A01,083659,Cao; Yingjun,0,66,50,50
1650508569213,CSE 134B,A01,083661,Powell; Thomas Allan,0,34,65,65
1650508575242,CSE 140,A01,083663,Staff,0,5,75,75
1650508581264,CSE 140L,A01,083088,Eldon; John,0,11,75,75
1650508587293,CSE 175,A01,083665,Kumar; Rakesh,7,0,25,18
1650508593316,CSE 190,A00,092507,Dubnov; Shlomo,10,0,20,10
1650508599343,ECE 45,A01,083139,Staff,20,19,60,40
1650508605370,ECE 65,A50,083695,Staff,0,6,30,30
1650508611404,ECE 109,A01,091882,Touri; Behrouz,35,0,70,35
1650508617428,ECE 180,A00,083140,Abi Samra; Nicholas Camill,21,0,30,9
1650508617428,ECE 180,B00,083141,Abi Samra; Nicholas Camill,0,0,30,30
1650508623452,MATH 10A,A01,083735,Patchell; Gregory David,5,0,30,25
1650508623452,MATH 10A,A02,083736,Patchell; Gregory David,27,0,30,3
1650508623452,MATH 10A,A03,083737,Patchell; Gregory David,24,0,30,6
1650508629477,MATH 10B,A01,083207,Staff,0,9,30,30
1650508629477,MATH 10B,A02,083208,Staff,0,7,30,30
1650508629477,MATH 10B,B01,083739,Staff,13,0,30,17
1650508629477,MATH 10B,B02,083740,Staff,28,0,30,2
1650508645147,MATH 18,A01,083743,Staff,0,0,30,30
1650508645147,MATH 18,A02,083744,Staff,27,0,30,3
1650508645147,MATH 18,A03,083745,Staff,22,0,30,8
1650508645147,MATH 18,A04,083746,Staff,26,0,30,4
1650508645147,MATH 18,B01,083748,Staff,0,11,30,30
1650508645147,MATH 18,B02,083749,Staff,0,12,30,30
1650508645147,MATH 18,B03,083750,Staff,0,11,30,30
1650508645147,MATH 18,B04,083751,Staff,0,12,30,30
1650508651173,MATH 20A,A01,083754,Staff,24,0,40,16
1650508657198,MATH 20B,A01,083756,Staff,0,11,30,30
1650508657198,MATH 20B,A02,083757,Staff,0,11,30,30
1650508663222,MATH 20C,A01,083760,Staff,0,16,30,30
1650508663222,MATH 20C,A02,083761,Staff,2,15,30,28
1650508663222,MATH 20C,B01,083762,Staff,12,0,30,18
1650508663222,MATH 20C,B02,083763,Staff,28,0,30,2
1650508669246,MATH 20D,A01,083765,Staff,0,1,30,30
1650508669246,MATH 20D,A02,083766,Staff,7,0,30,23
1650508669246,MATH 20D,A03,083767,Staff,25,0,30,5
1650508675271,MATH 20E,A01,083771,Staff,6,0,30,24
1650508675271,MATH 20E,A02,083772,Staff,18,0,30,12
1650508675271,MATH 20E,B01,083773,Staff,0,0,30,30
1650508675271,MATH 20E,B02,083774,Staff,10,0,30,20
1650508681294,MATH 103A,A01,083777,Staff,0,13,30,30
1650508681294,MATH 103A,A02,083778,Staff,0,14,30,30
1650508681294,MATH 103A,B01,083779,Staff,0,13,30,30
1650508681294,MATH 103A,B02,083780,Staff,0,13,30,30
1650508687323,MATH 105,A01,085443,Staff,1,23,30,29
1650508693351,MATH 109,A01,083213,Anzaldo; Leesa B,0,7,30,30
1650508693351,MATH 109,A02,083214,Anzaldo; Leesa B,0,7,30,30
1650508693351,MATH 109,B01,083215,Anzaldo; Leesa B,0,5,30,30
1650508693351,MATH 109,B02,083216,Anzaldo; Leesa B,0,6,30,30
1650508699376,MATH 142A,A01,083219,Chow; Bennett,0,16,30,30
1650508699376,MATH 142A,A02,083220,Chow; Bennett,0,14,30,30
1650508699376,MATH 142A,B01,083221,Chow; Bennett,0,13,30,30
1650508699376,MATH 142A,B02,083222,Chow; Bennett,0,13,30,30
1650508705401,MATH 193A,A01,083224,Staff,0,5,30,30
1650508705401,MATH 193A,A02,083225,Staff,0,5,30,30
1650508705401,MATH 193A,A03,083781,Staff,0,5,30,30
1650508705401,MATH 193A,A04,083782,Staff,0,7,30,30
1650508711427,MATH 197,001,091859,McAuley; Julian John,9998,0,9999,1
1650508717487,COGS 9,A01,083615,Staff,0,15,60,60
1650508723511,COGS 11,A01,083617,Boyle; Mary E. T.,19,0,40,21
1650508729546,COGS 13,A01,083071,Staff,0,35,40,40
1650508735573,COGS 14A,A01,092681,Staff,1,26,100,99
1650508741599,COGS 14B,A01,083073,Cheng; Tzu-Han,1,12,50,49
1650508747621,COGS 17,A01,092677,Staff,20,0,75,55
1650508753647,COGS 100,A01,083619,Staff,0,27,60,60
1650508759670,COGS 101A,A01,083621,Davis; Joshua Daniel,0,25,60,60
1650508765695,COGS 101B,A01,091572,Staff,0,4,60,60
1650508771729,COGS 101C,A01,083625,Delgado; Tania,16,0,30,14
1650508777752,COGS 107A,A01,083627,Boyle; Mary E. T.,0,12,60,60
1650508783781,COGS 118A,A01,083075,Staff,0,3,60,60
1650508789823,CSE 3,A50,083646,Miranda; Gregory Joseph,20,0,38,18
1650508789823,CSE 3,A51,083647,Miranda; Gregory Joseph,36,0,37,1
1650508795847,CSE 8A,A50,083650,Miranda; Gregory Joseph,1,30,40,39
1650508801873,CSE 11,A01,083080,Cao; Yingjun,0,92,40,40
1650508807900,CSE 12,A01,083652,Staff,0,17,100,100
1650508813924,CSE 15L,A01,083654,Staff,0,1,50,50
1650508813924,CSE 15L,A02,083655,Staff,0,0,50,50
1650508819951,CSE 20,A01,083657,Staff,51,0,80,29
1650508825975,CSE 30,A01,083084,Eldon; John,0,77,40,40
1650508832000,CSE 100,A01,083659,Cao; Yingjun,0,66,50,50
1650508838022,CSE 134B,A01,083661,Powell; Thomas Allan,0,34,65,65
1650508844044,CSE 140,A01,083663,Staff,0,5,75,75
1650508850066,CSE 140L,A01,083088,Eldon; John,0,11,75,75
1650508856088,CSE 175,A01,083665,Kumar; Rakesh,7,0,25,18
1650508862112,CSE 190,A00,092507,Dubnov; Shlomo,10,0,20,10
1650508868135,ECE 45,A01,083139,Staff,20,19,60,40
1650508874158,ECE 65,A50,083695,Staff,0,6,30,30
1650508880182,ECE 109,A01,091882,Touri; Behrouz,35,0,70,35
1650508886205,ECE 180,A00,083140,Abi Samra; Nicholas Camill,21,0,30,9
1650508886205,ECE 180,B00,083141,Abi Samra; Nicholas Camill,0,0,30,30
1650508892230,MATH 10A,A01,083735,Patchell; Gregory David,5,0,30,25
1650508892230,MATH 10A,A02,083736,Patchell; Gregory David,27,0,30,3
1650508892230,MATH 10A,A03,083737,Patchell; Gregory David,24,0,30,6
1650508898257,MATH 10B,A01,083207,Staff,0,9,30,30
1650508898257,MATH 10B,A02,083208,Staff,0,7,30,30
1650508898257,MATH 10B,B01,083739,Staff,13,0,30,17
1650508898257,MATH 10B,B02,083740,Staff,28,0,30,2
1650508904286,MATH 18,A01,083743,Staff,1,0,30,29
1650508904286,MATH 18,A02,083744,Staff,27,0,30,3
1650508904286,MATH 18,A03,083745,Staff,22,0,30,8
1650508904286,MATH 18,A04,083746,Staff,26,0,30,4
1650508904286,MATH 18,B01,083748,Staff,0,11,30,30
1650508904286,MATH 18,B02,083749,Staff,0,12,30,30
1650508904286,MATH 18,B03,083750,Staff,0,11,30,30
1650508904286,MATH 18,B04,083751,Staff,0,12,30,30
1650508910308,MATH 20A,A01,083754,Staff,24,0,40,16
1650508916333,MATH 20B,A01,083756,Staff,0,11,30,30
1650508916333,MATH 20B,A02,083757,Staff,0,11,30,30
1650508922357,MATH 20C,A01,083760,Staff,0,16,30,30
1650508922357,MATH 20C,A02,083761,Staff,2,15,30,28
1650508922357,MATH 20C,B01,083762,Staff,12,0,30,18
1650508922357,MATH 20C,B02,083763,Staff,28,0,30,2
1650508928379,MATH 20D,A01,083765,Staff,0,1,30,30
1650508928379,MATH 20D,A02,083766,Staff,7,0,30,23
1650508928379,MATH 20D,A03,083767,Staff,25,0,30,5
1650508934406,MATH 20E,A01,083771,Staff,6,0,30,24
1650508934406,MATH 20E,A02,083772,Staff,18,0,30,12
1650508934406,MATH 20E,B01,083773,Staff,0,0,30,30
1650508934406,MATH 20E,B02,083774,Staff,10,0,30,20
1650508940429,MATH 103A,A01,083777,Staff,0,13,30,30
1650508940429,MATH 103A,A02,083778,Staff,0,14,30,30
1650508940429,MATH 103A,B01,083779,Staff,0,13,30,30
1650508940429,MATH 103A,B02,083780,Staff,0,13,30,30
1650508946461,MATH 105,A01,085443,Staff,1,23,30,29
1650508952484,MATH 109,A01,083213,Anzaldo; Leesa B,0,7,30,30
1650508952484,MATH 109,A02,083214,Anzaldo; Leesa B,0,7,30,30
1650508952484,MATH 109,B01,083215,Anzaldo; Leesa B,0,5,30,30
1650508952484,MATH 109,B02,083216,Anzaldo; Leesa B,0,6,30,30
1650508958507,MATH 142A,A01,083219,Chow; Bennett,0,16,30,30
1650508958507,MATH 142A,A02,083220,Chow; Bennett,0,14,30,30
1650508958507,MATH 142A,B01,083221,Chow; Bennett,0,13,30,30
1650508958507,MATH 142A,B02,083222,Chow; Bennett,0,13,30,30
1650508964531,MATH 193A,A01,083224,Staff,0,5,30,30
1650508964531,MATH 193A,A02,083225,Staff,0,5,30,30
1650508964531,MATH 193A,A03,083781,Staff,0,5,30,30
1650508964531,MATH 193A,A04,083782,Staff,0,7,30,30
1650508970552,MATH 197,001,091859,McAuley; Julian John,9998,0,9999,1
1650508976601,COGS 9,A01,083615,Staff,0,15,60,60
1650508982629,COGS 11,A01,083617,Boyle; Mary E. T.,19,0,40,21
1650508988656,COGS 13,A01,083071,Staff,0,35,40,40
1650508994679,COGS 14A,A01,092681,Staff,1,26,100,99
1650509000707,COGS 14B,A01,083073,Cheng; Tzu-Han,1,12,50,49
1650509006738,COGS 17,A01,092677,Staff,20,0,75,55
1650509012762,COGS 100,A01,083619,Staff,0,27,60,60
1650509018788,COGS 101A,A01,083621,Davis; Joshua Daniel,0,25,60,60
1650509024820,COGS 101B,A01,091572,Staff,0,4,60,60
1650509030844,COGS 101C,A01,083625,Delgado; Tania,16,0,30,14
1650509036873,COGS 107A,A01,083627,Boyle; Mary E. T.,0,12,60,60
1650509042913,COGS 118A,A01,083075,Staff,0,3,60,60
1650509048955,CSE 3,A50,083646,Miranda; Gregory Joseph,20,0,38,18
1650509048955,CSE 3,A51,083647,Miranda; Gregory Joseph,36,0,37,1
1650509054981,CSE 8A,A50,083650,Miranda; Gregory Joseph,1,30,40,39
1650509061008,CSE 11,A01,083080,Cao; Yingjun,0,92,40,40
1650509067032,CSE 12,A01,083652,Staff,0,17,100,100
1650509073055,CSE 15L,A01,083654,Staff,0,1,50,50
1650509073055,CSE 15L,A02,083655,Staff,0,0,50,50
1650509079179,CSE 20,A01,083657,Staff,51,0,80,29
1650509085212,CSE 30,A01,083084,Eldon; John,0,77,40,40
1650509091236,CSE 100,A01,083659,Cao; Yingjun,0,66,50,50
1650509097263,CSE 134B,A01,083661,Powell; Thomas Allan,0,34,65,65
1650509103295,CSE 140,A01,083663,Staff,0,5,75,75
1650509109319,CSE 140L,A01,083088,Eldon; John,0,11,75,75
1650509115343,CSE 175,A01,083665,Kumar; Rakesh,7,0,25,18
1650509121365,CSE 190,A00,092507,Dubnov; Shlomo,10,0,20,10
1650509127390,ECE 45,A01,083139,Staff,20,19,60,40
1650509133413,ECE 65,A50,083695,Staff,0,6,30,30
1650509139439,ECE 109,A01,091882,Touri; Behrouz,35,0,70,35
1650509145462,ECE 180,A00,083140,Abi Samra; Nicholas Camill,21,0,30,9
1650509145462,ECE 180,B00,083141,Abi Samra; Nicholas Camill,0,0,30,30
1650509151493,MATH 10A,A01,083735,Patchell; Gregory David,5,0,30,25
1650509151493,MATH 10A,A02,083736,Patchell; Gregory David,27,0,30,3
1650509151493,MATH 10A,A03,083737,Patchell; Gregory David,24,0,30,6
1650509157516,MATH 10B,A01,083207,Staff,0,9,30,30
1650509157516,MATH 10B,A02,083208,Staff,0,7,30,30
1650509157516,MATH 10B,B01,083739,Staff,13,0,30,17
1650509157516,MATH 10B,B02,083740,Staff,28,0,30,2
1650509163543,MATH 18,A01,083743,Staff,1,0,30,29
1650509163543,MATH 18,A02,083744,Staff,27,0,30,3
1650509163543,MATH 18,A03,083745,Staff,22,0,30,8
1650509163543,MATH 18,A04,083746,Staff,26,0,30,4
1650509163543,MATH 18,B01,083748,Staff,0,11,30,30
1650509163543,MATH 18,B02,083749,Staff,0,12,30,30
1650509163543,MATH 18,B03,083750,Staff,0,11,30,30
1650509163543,MATH 18,B04,083751,Staff,0,12,30,30
1650509169566,MATH 20A,A01,083754,Staff,24,0,40,16
1650509175590,MATH 20B,A01,083756,Staff,0,11,30,30
1650509175590,MATH 20B,A02,083757,Staff,0,11,30,30
1650509181611,MATH 20C,A01,083760,Staff,0,16,30,30
1650509181611,MATH 20C,A02,083761,Staff,2,15,30,28
1650509181611,MATH 20C,B01,083762,Staff,12,0,30,18
1650509181611,MATH 20C,B02,083763,Staff,28,0,30,2
1650509187640,MATH 20D,A01,083765,Staff,0,1,30,30
1650509187640,MATH 20D,A02,083766,Staff,7,0,30,23
1650509187640,MATH 20D,A03,083767,Staff,25,0,30,5
1650509193664,MATH 20E,A01,083771,Staff,6,0,30,24
1650509193664,MATH 20E,A02,083772,Staff,18,0,30,12
1650509193664,MATH 20E,B01,083773,Staff,0,0,30,30
1650509193664,MATH 20E,B02,083774,Staff,10,0,30,20
1650509199690,MATH 103A,A01,083777,Staff,0,13,30,30
1650509199690,MATH 103A,A02,083778,Staff,0,14,30,30
1650509199690,MATH 103A,B01,083779,Staff,0,13,30,30
1650509199690,MATH 103A,B02,083780,Staff,0,13,30,30
1650509205721,MATH 105,A01,085443,Staff,1,23,30,29
1650509211748,MATH 109,A01,083213,Anzaldo; Leesa B,0,7,30,30
1650509211748,MATH 109,A02,083214,Anzaldo; Leesa B,0,7,30,30
1650509211748,MATH 109,B01,083215,Anzaldo; Leesa B,0,5,30,30
1650509211748,MATH 109,B02,083216,Anzaldo; Leesa B,0,6,30,30
1650509217776,MATH 142A,A01,083219,Chow; Bennett,0,16,30,30
1650509217776,MATH 142A,A02,083220,Chow; Bennett,0,14,30,30
1650509217776,MATH 142A,B01,083221,Chow; Bennett,0,13,30,30
1650509217776,MATH 142A,B02,083222,Chow; Bennett,0,13,30,30
1650509223798,MATH 193A,A01,083224,Staff,0,5,30,30
1650509223798,MATH 193A,A02,083225,Staff,0,5,30,30
1650509223798,MATH 193A,A03,083781,Staff,0,5,30,30
1650509223798,MATH 193A,A04,083782,Staff,0,7,30,30
1650509229820,MATH 197,001,091859,McAuley; Julian John,9998,0,9999,1
1650509235872,COGS 9,A01,083615,Staff,0,15,60,60
1650509241901,COGS 11,A01,083617,Boyle; Mary E. T.,19,0,40,21
1650509247924,COGS 13,A01,083071,Staff,0,35,40,40
1650509253949,COGS 14A,A01,092681,Staff,1,26,100,99
1650509259975,COGS 14B,A01,083073,Cheng; Tzu-Han,1,12,50,49
1650509266003,COGS 17,A01,092677,Staff,20,0,75,55
1650509272041,COGS 100,A01,083619,Staff,0,27,60,60
1650509278064,COGS 101A,A01,083621,Davis; Joshua Daniel,0,25,60,60
1650509284088,COGS 101B,A01,091572,Staff,0,4,60,60
1650509290110,COGS 101C,A01,083625,Delgado; Tania,16,0,30,14
1650509296133,COGS 107A,A01,083627,Boyle; Mary E. T.,0,12,60,60
1650509302155,COGS 118A,A01,083075,Staff,0,3,60,60
1650509308182,CSE 3,A50,083646,Miranda; Gregory Joseph,20,0,38,18
1650509308182,CSE 3,A51,083647,Miranda; Gregory Joseph,36,0,37,1
1650509314207,CSE 8A,A50,083650,Miranda; Gregory Joseph,1,30,40,39
1650509320231,CSE 11,A01,083080,Cao; Yingjun,0,92,40,40
1650509326256,CSE 12,A01,083652,Staff,0,17,100,100
1650509332282,CSE 15L,A01,083654,Staff,0,1,50,50
1650509332282,CSE 15L,A02,083655,Staff,0,0,50,50
1650509338304,CSE 20,A01,083657,Staff,51,0,80,29
1650509344325,CSE 30,A01,083084,Eldon; John,0,77,40,40
1650509350350,CSE 100,A01,083659,Cao; Yingjun,0,66,50,50
1650509356379,CSE 134B,A01,083661,Powell; Thomas Allan,0,34,65,65
1650509362401,CSE 140,A01,083663,Staff,0,5,75,75
1650509368424,CSE 140L,A01,083088,Eldon; John,0,11,75,75
1650509374461,CSE 175,A01,083665,Kumar; Rakesh,7,0,25,18
1650509380484,CSE 190,A00,092507,Dubnov; Shlomo,10,0,20,10
1650509386507,ECE 45,A01,083139,Staff,20,19,60,40
1650509392534,ECE 65,A50,083695,Staff,0,6,30,30
1650509398560,ECE 109,A01,091882,Touri; Behrouz,35,0,70,35
1650509404582,ECE 180,A00,083140,Abi Samra; Nicholas Camill,21,0,30,9
1650509404582,ECE 180,B00,083141,Abi Samra; Nicholas Camill,0,0,30,30
1650509410608,MATH 10A,A01,083735,Patchell; Gregory David,5,0,30,25
1650509410608,MATH 10A,A02,083736,Patchell; Gregory David,27,0,30,3
1650509410608,MATH 10A,A03,083737,Patchell; Gregory David,24,0,30,6
1650509416634,MATH 10B,A01,083207,Staff,0,9,30,30
1650509416634,MATH 10B,A02,083208,Staff,0,7,30,30
1650509416634,MATH 10B,B01,083739,Staff,13,0,30,17
1650509416634,MATH 10B,B02,083740,Staff,28,0,30,2
1650509422658,MATH 18,A01,083743,Staff,1,0,30,29
1650509422658,MATH 18,A02,083744,Staff,27,0,30,3
1650509422658,MATH 18,A03,083745,Staff,22,0,30,8
1650509422658,MATH 18,A04,083746,Staff,26,0,30,4
1650509422658,MATH 18,B01,083748,Staff,0,11,30,30
1650509422658,MATH 18,B02,083749,Staff,0,12,30,30
1650509422658,MATH 18,B03,083750,Staff,0,11,30,30
1650509422658,MATH 18,B04,083751,Staff,0,12,30,30
1650509428681,MATH 20A,A01,083754,Staff,24,0,40,16
1650509434706,MATH 20B,A01,083756,Staff,0,11,30,30
1650509434706,MATH 20B,A02,083757,Staff,0,11,30,30
1650509440729,MATH 20C,A01,083760,Staff,0,16,30,30
1650509440729,MATH 20C,A02,083761,Staff,2,15,30,28
1650509440729,MATH 20C,B01,083762,Staff,12,0,30,18
1650509440729,MATH 20C,B02,083763,Staff,28,0,30,2
1650509446752,MATH 20D,A01,083765,Staff,0,1,30,30
1650509446752,MATH 20D,A02,083766,Staff,7,0,30,23
1650509446752,MATH 20D,A03,083767,Staff,25,0,30,5
1650509452778,MATH 20E,A01,083771,Staff,6,0,30,24
1650509452778,MATH 20E,A02,083772,Staff,18,0,30,12
1650509452778,MATH 20E,B01,083773,Staff,0,0,30,30
1650509452778,MATH 20E,B02,083774,Staff,10,0,30,20
1650509458802,MATH 103A,A01,083777,Staff,0,13,30,30
1650509458802,MATH 103A,A02,083778,Staff,0,14,30,30
1650509458802,MATH 103A,B01,083779,Staff,0,13,30,30
1650509458802,MATH 103A,B02,083780,Staff,0,13,30,30
1650509464832,MATH 105,A01,085443,Staff,1,23,30,29
1650509470861,MATH 109,A01,083213,Anzaldo; Leesa B,0,7,30,30
1650509470861,MATH 109,A02,083214,Anzaldo; Leesa B,0,7,30,30
1650509470861,MATH 109,B01,083215,Anzaldo; Leesa B,0,5,30,30
1650509470861,MATH 109,B02,083216,Anzaldo; Leesa B,0,6,30,30
1650509476888,MATH 142A,A01,083219,Chow; Bennett,0,16,30,30
1650509476888,MATH 142A,A02,083220,Chow; Bennett,0,14,30,30
1650509476888,MATH 142A,B01,083221,Chow; Bennett,0,13,30,30
1650509476888,MATH 142A,B02,083222,Chow; Bennett,0,13,30,30
1650509482912,MATH 193A,A01,083224,Staff,0,5,30,30
1650509482912,MATH 193A,A02,083225,Staff,0,5,30,30
1650509482912,MATH 193A,A03,083781,Staff,0,5,30,30
1650509482912,MATH 193A,A04,083782,Staff,0,7,30,30
1650509488933,MATH 197,001,091859,McAuley; Julian John,9998,0,9999,1
1650509494994,COGS 9,A01,083615,Staff,0,15,60,60
1650509501017,COGS 11,A01,083617,Boyle; Mary E. T.,19,0,40,21
1650509507042,COGS 13,A01,083071,Staff,0,35,40,40
1650509513071,COGS 14A,A01,092681,Staff,1,25,100,99
1650509519097,COGS 14B,A01,083073,Cheng; Tzu-Han,1,12,50,49
1650509525119,COGS 17,A01,092677,Staff,20,0,75,55
1650509531145,COGS 100,A01,083619,Staff,0,27,60,60
1650509537172,COGS 101A,A01,083621,Davis; Joshua Daniel,0,25,60,60
1650509543199,COGS 101B,A01,091572,Staff,0,4,60,60
1650509549234,COGS 101C,A01,083625,Delgado; Tania,16,0,30,14
1650509555257,COGS 107A,A01,083627,Boyle; Mary E. T.,0,12,60,60
1650509561281,COGS 118A,A01,083075,Staff,0,3,60,60
1650509567306,CSE 3,A50,083646,Miranda; Gregory Joseph,20,0,38,18
1650509567306,CSE 3,A51,083647,Miranda; Gregory Joseph,36,0,37,1
1650509573333,CSE 8A,A50,083650,Miranda; Gregory Joseph,1,30,40,39
1650509579357,CSE 11,A01,083080,Cao; Yingjun,0,92,40,40
1650509585380,CSE 12,A01,083652,Staff,0,17,100,100
1650509591411,CSE 15L,A01,083654,Staff,0,1,50,50
1650509591411,CSE 15L,A02,083655,Staff,0,0,50,50
1650509597438,CSE 20,A01,083657,Staff,51,0,80,29
1650509603461,CSE 30,A01,083084,Eldon; John,0,77,40,40
1650509609490,CSE 100,A01,083659,Cao; Yingjun,0,66,50,50
1650509615522,CSE 134B,A01,083661,Powell; Thomas Allan,0,34,65,65
1650509621545,CSE 140,A01,083663,Staff,0,5,75,75
1650509627579,CSE 140L,A01,083088,Eldon; John,0,11,75,75
1650509633605,CSE 175,A01,083665,Kumar; Rakesh,7,0,25,18
1650509639630,CSE 190,A00,092507,Dubnov; Shlomo,10,0,20,10
1650509645652,ECE 45,A01,083139,Staff,20,19,60,40
1650509651677,ECE 65,A50,083695,Staff,0,6,30,30
1650509657703,ECE 109,A01,091882,Touri; Behrouz,35,0,70,35
1650509663726,ECE 180,A00,083140,Abi Samra; Nicholas Camill,21,0,30,9
1650509663726,ECE 180,B00,083141,Abi Samra; Nicholas Camill,0,0,30,30
1650509669754,MATH 10A,A01,083735,Patchell; Gregory David,5,0,30,25
1650509669754,MATH 10A,A02,083736,Patchell; Gregory David,27,0,30,3
1650509669754,MATH 10A,A03,083737,Patchell; Gregory David,24,0,30,6
1650509675867,MATH 10B,A01,083207,Staff,0,9,30,30
1650509675867,MATH 10B,A02,083208,Staff,0,7,30,30
1650509675867,MATH 10B,B01,083739,Staff,13,0,30,17
1650509675867,MATH 10B,B02,083740,Staff,28,0,30,2
1650509681894,MATH 18,A01,083743,Staff,1,0,30,29
1650509681894,MATH 18,A02,083744,Staff,27,0,30,3
1650509681894,MATH 18,A03,083745,Staff,22,0,30,8
1650509681894,MATH 18,A04,083746,Staff,26,0,30,4
1650509681894,MATH 18,B01,083748,Staff,0,11,30,30
1650509681894,MATH 18,B02,083749,Staff,0,12,30,30
1650509681894,MATH 18,B03,083750,Staff,0,11,30,30
1650509681894,MATH 18,B04,083751,Staff,0,12,30,30
1650509687917,MATH 20A,A01,083754,Staff,24,0,40,16
1650509693943,MATH 20B,A01,083756,Staff,0,11,30,30
1650509693943,MATH 20B,A02,083757,Staff,0,11,30,30
1650509699966,MATH 20C,A01,083760,Staff,0,16,30,30
1650509699966,MATH 20C,A02,083761,Staff,2,15,30,28
1650509699966,MATH 20C,B01,083762,Staff,12,0,30,18
1650509699966,MATH 20C,B02,083763,Staff,28,0,30,2
1650509705989,MATH 20D,A01,083765,Staff,0,1,30,30
1650509705989,MATH 20D,A02,083766,Staff,7,0,30,23
1650509705989,MATH 20D,A03,083767,Staff,25,0,30,5
1650509712013,MATH 20E,A01,083771,Staff,6,0,30,24
1650509712013,MATH 20E,A02,083772,Staff,18,0,30,12
1650509712013,MATH 20E,B01,083773,Staff,0,0,30,30
1650509712013,MATH 20E,B02,083774,Staff,10,0,30,20
1650509718046,MATH 103A,A01,083777,Staff,0,13,30,30
1650509718046,MATH 103A,A02,083778,Staff,0,14,30,30
1650509718046,MATH 103A,B01,083779,Staff,0,13,30,30
1650509718046,MATH 103A,B02,083780,Staff,0,13,30,30
1650509724074,MATH 105,A01,085443,Staff,1,23,30,29
1650509730096,MATH 109,A01,083213,Anzaldo; Leesa B,0,7,30,30
1650509730096,MATH 109,A02,083214,Anzaldo; Leesa B,0,7,30,30
1650509730096,MATH 109,B01,083215,Anzaldo; Leesa B,0,5,30,30
1650509730096,MATH 109,B02,083216,Anzaldo; Leesa B,0,6,30,30
1650509736133,MATH 142A,A01,083219,Chow; Bennett,0,16,30,30
1650509736133,MATH 142A,A02,083220,Chow; Bennett,0,14,30,30
1650509736133,MATH 142A,B01,083221,Chow; Bennett,0,13,30,30
1650509736133,MATH 142A,B02,083222,Chow; Bennett,0,13,30,30
1650509742163,MATH 193A,A01,083224,Staff,0,5,30,30
1650509742163,MATH 193A,A02,083225,Staff,0,5,30,30
1650509742163,MATH 193A,A03,083781,Staff,0,5,30,30
1650509742163,MATH 193A,A04,083782,Staff,0,7,30,30
1650509748186,MATH 197,001,091859,McAuley; Julian John,9998,0,9999,1
1650509754254,COGS 9,A01,083615,Staff,0,15,60,60
1650509760278,COGS 11,A01,083617,Boyle; Mary E. T.,19,0,40,21
1650509766304,COGS 13,A01,083071,Staff,0,35,40,40
1650509772329,COGS 14A,A01,092681,Staff,1,25,100,99
1650509778352,COGS 14B,A01,083073,Cheng; Tzu-Han,1,12,50,49
1650509784377,COGS 17,A01,092677,Staff,20,0,75,55
1650509790400,COGS 100,A01,083619,Staff,0,27,60,60
1650509796427,COGS 101A,A01,083621,Davis; Joshua Daniel,0,25,60,60
1650509802451,COGS 101B,A01,091572,Staff,0,4,60,60
1650509808476,COGS 101C,A01,083625,Delgado; Tania,16,0,30,14
1650509814503,COGS 107A,A01,083627,Boyle; Mary E. T.,0,12,60,60
1650509820526,COGS 118A,A01,083075,Staff,0,3,60,60
1650509826550,CSE 3,A50,083646,Miranda; Gregory Joseph,20,0,38,18
1650509826550,CSE 3,A51,083647,Miranda; Gregory Joseph,36,0,37,1
1650509832580,CSE 8A,A50,083650,Miranda; Gregory Joseph,1,30,40,39
1650509838604,CSE 11,A01,083080,Cao; Yingjun,0,92,40,40
1650509844637,CSE 12,A01,083652,Staff,0,17,100,100
1650509850675,CSE 15L,A01,083654,Staff,0,1,50,50
1650509850675,CSE 15L,A02,083655,Staff,0,0,50,50
1650509856699,CSE 20,A01,083657,Staff,51,0,80,29
1650509862736,CSE 30,A01,083084,Eldon; John,0,77,40,40
1650509868762,CSE 100,A01,083659,Cao; Yingjun,0,66,50,50
1650509874784,CSE 134B,A01,083661,Powell; Thomas Allan,0,34,65,65
1650509880815,CSE 140,A01,083663,Staff,0,5,75,75
1650509886839,CSE 140L,A01,083088,Eldon; John,0,11,75,75
1650509892865,CSE 175,A01,083665,Kumar; Rakesh,7,0,25,18
1650509898892,CSE 190,A00,092507,Dubnov; Shlomo,10,0,20,10
1650509904915,ECE 45,A01,083139,Staff,20,19,60,40
1650509910941,ECE 65,A50,083695,Staff,0,6,30,30
1650509916990,ECE 109,A01,091882,Touri; Behrouz,35,0,70,35
1650509923012,ECE 180,A00,083140,Abi Samra; Nicholas Camill,21,0,30,9
1650509923012,ECE 180,B00,083141,Abi Samra; Nicholas Camill,0,0,30,30
1650509929045,MATH 10A,A01,083735,Patchell; Gregory David,5,0,30,25
1650509929045,MATH 10A,A02,083736,Patchell; Gregory David,27,0,30,3
1650509929045,MATH 10A,A03,083737,Patchell; Gregory David,24,0,30,6
1650509935085,MATH 10B,A01,083207,Staff,0,9,30,30
1650509935085,MATH 10B,A02,083208,Staff,0,7,30,30
1650509935085,MATH 10B,B01,083739,Staff,13,0,30,17
1650509935085,MATH 10B,B02,083740,Staff,28,0,30,2
1650509941116,MATH 18,A01,083743,Staff,1,0,30,29
1650509941116,MATH 18,A02,083744,Staff,27,0,30,3
1650509941116,MATH 18,A03,083745,Staff,22,0,30,8
1650509941116,MATH 18,A04,083746,Staff,26,0,30,4
1650509941116,MATH 18,B01,083748,Staff,0,11,30,30
1650509941116,MATH 18,B02,083749,Staff,0,12,30,30
1650509941116,MATH 18,B03,083750,Staff,0,11,30,30
1650509941116,MATH 18,B04,083751,Staff,0,12,30,30
1650509947149,MATH 20A,A01,083754,Staff,24,0,40,16
1650509953174,MATH 20B,A01,083756,Staff,0,11,30,30
1650509953174,MATH 20B,A02,083757,Staff,0,11,30,30
1650509959201,MATH 20C,A01,083760,Staff,0,16,30,30
1650509959201,MATH 20C,A02,083761,Staff,2,15,30,28
1650509959201,MATH 20C,B01,083762,Staff,12,0,30,18
1650509959201,MATH 20C,B02,083763,Staff,28,0,30,2
1650509965228,MATH 20D,A01,083765,Staff,0,1,30,30
1650509965228,MATH 20D,A02,083766,Staff,7,0,30,23
1650509965228,MATH 20D,A03,083767,Staff,25,0,30,5
1650509971258,MATH 20E,A01,083771,Staff,6,0,30,24
1650509971258,MATH 20E,A02,083772,Staff,18,0,30,12
1650509971258,MATH 20E,B01,083773,Staff,0,0,30,30
1650509971258,MATH 20E,B02,083774,Staff,10,0,30,20
1650509977283,MATH 103A,A01,083777,Staff,0,13,30,30
1650509977283,MATH 103A,A02,083778,Staff,0,14,30,30
1650509977283,MATH 103A,B01,083779,Staff,0,13,30,30
1650509977283,MATH 103A,B02,083780,Staff,0,13,30,30
1650509983307,MATH 105,A01,085443,Staff,1,23,30,29
1650509989335,MATH 109,A01,083213,Anzaldo; Leesa B,0,7,30,30
1650509989335,MATH 109,A02,083214,Anzaldo; Leesa B,0,7,30,30
1650509989335,MATH 109,B01,083215,Anzaldo; Leesa B,0,5,30,30
1650509989335,MATH 109,B02,083216,Anzaldo; Leesa B,0,6,30,30
1650509995358,MATH 142A,A01,083219,Chow; Bennett,0,16,30,30
1650509995358,MATH 142A,A02,083220,Chow; Bennett,0,14,30,30
1650509995358,MATH 142A,B01,083221,Chow; Bennett,0,13,30,30
1650509995358,MATH 142A,B02,083222,Chow; Bennett,0,13,30,30
1650510001382,MATH 193A,A01,083224,Staff,0,5,30,30
1650510001382,MATH 193A,A02,083225,Staff,0,5,30,30
1650510001382,MATH 193A,A03,083781,Staff,0,5,30,30
1650510001382,MATH 193A,A04,083782,Staff,0,7,30,30
1650510007411,MATH 197,001,091859,McAuley; Julian John,9998,0,9999,1
1650510013463,COGS 9,A01,083615,Staff,0,15,60,60
1650510019486,COGS 11,A01,083617,Boyle; Mary E. T.,19,0,40,21
1650510025509,COGS 13,A01,083071,Staff,0,35,40,40
1650510031535,COGS 14A,A01,092681,Staff,1,25,100,99
1650510037563,COGS 14B,A01,083073,Cheng; Tzu-Han,1,12,50,49
1650510043586,COGS 17,A01,092677,Staff,20,0,75,55
1650510049608,COGS 100,A01,083619,Staff,0,27,60,60
1650510055639,COGS 101A,A01,083621,Davis; Joshua Daniel,0,25,60,60
1650510061665,COGS 101B,A01,091572,Staff,0,4,60,60
1650510067689,COGS 101C,A01,083625,Delgado; Tania,16,0,30,14
1650510073713,COGS 107A,A01,083627,Boyle; Mary E. T.,0,12,60,60
1650510079736,COGS 118A,A01,083075,Staff,0,3,60,60
1650510085765,CSE 3,A50,083646,Miranda; Gregory Joseph,20,0,38,18
1650510085765,CSE 3,A51,083647,Miranda; Gregory Joseph,36,0,37,1
1650510091793,CSE 8A,A50,083650,Miranda; Gregory Joseph,1,30,40,39
1650510097815,CSE 11,A01,083080,Cao; Yingjun,0,92,40,40
1650510103843,CSE 12,A01,083652,Staff,0,17,100,100
1650510109866,CSE 15L,A01,083654,Staff,0,1,50,50
1650510109866,CSE 15L,A02,083655,Staff,0,0,50,50
1650510115902,CSE 20,A01,083657,Staff,51,0,80,29
1650510121926,CSE 30,A01,083084,Eldon; John,0,77,40,40
1650510127948,CSE 100,A01,083659,Cao; Yingjun,0,66,50,50
1650510133977,CSE 134B,A01,083661,Powell; Thomas Allan,0,34,65,65
1650510139999,CSE 140,A01,083663,Staff,0,5,75,75
1650510146025,CSE 140L,A01,083088,Eldon; John,0,11,75,75
1650510152049,CSE 175,A01,083665,Kumar; Rakesh,7,0,25,18
1650510158075,CSE 190,A00,092507,Dubnov; Shlomo,10,0,20,10
1650510164099,ECE 45,A01,083139,Staff,20,19,60,40
1650510170127,ECE 65,A50,083695,Staff,0,6,30,30
1650510176152,ECE 109,A01,091882,Touri; Behrouz,35,0,70,35
1650510182179,ECE 180,A00,083140,Abi Samra; Nicholas Camill,21,0,30,9
1650510182179,ECE 180,B00,083141,Abi Samra; Nicholas Camill,0,0,30,30
1650510188202,MATH 10A,A01,083735,Patchell; Gregory David,5,0,30,25
1650510188202,MATH 10A,A02,083736,Patchell; Gregory David,27,0,30,3
1650510188202,MATH 10A,A03,083737,Patchell; Gregory David,24,0,30,6
1650510194230,MATH 10B,A01,083207,Staff,0,9,30,30
1650510194230,MATH 10B,A02,083208,Staff,0,7,30,30
1650510194230,MATH 10B,B01,083739,Staff,13,0,30,17
1650510194230,MATH 10B,B02,083740,Staff,28,0,30,2
1650510200254,MATH 18,A01,083743,Staff,1,0,30,29
1650510200254,MATH 18,A02,083744,Staff,27,0,30,3
1650510200254,MATH 18,A03,083745,Staff,22,0,30,8
1650510200254,MATH 18,A04,083746,Staff,26,0,30,4
1650510200254,MATH 18,B01,083748,Staff,0,11,30,30
1650510200254,MATH 18,B02,083749,Staff,0,12,30,30
1650510200254,MATH 18,B03,083750,Staff,0,11,30,30
1650510200254,MATH 18,B04,083751,Staff,0,12,30,30
1650510206280,MATH 20A,A01,083754,Staff,24,0,40,16
1650510212303,MATH 20B,A01,083756,Staff,0,11,30,30
1650510212303,MATH 20B,A02,083757,Staff,0,11,30,30
1650510218332,MATH 20C,A01,083760,Staff,0,16,30,30
1650510218332,MATH 20C,A02,083761,Staff,2,15,30,28
1650510218332,MATH 20C,B01,083762,Staff,12,0,30,18
1650510218332,MATH 20C,B02,083763,Staff,28,0,30,2
1650510224357,MATH 20D,A01,083765,Staff,0,1,30,30
1650510224357,MATH 20D,A02,083766,Staff,7,0,30,23
1650510224357,MATH 20D,A03,083767,Staff,25,0,30,5
1650510230382,MATH 20E,A01,083771,Staff,6,0,30,24
1650510230382,MATH 20E,A02,083772,Staff,18,0,30,12
1650510230382,MATH 20E,B01,083773,Staff,0,0,30,30
1650510230382,MATH 20E,B02,083774,Staff,10,0,30,20
1650510236406,MATH 103A,A01,083777,Staff,0,13,30,30
1650510236406,MATH 103A,A02,083778,Staff,0,14,30,30
1650510236406,MATH 103A,B01,083779,Staff,0,13,30,30
1650510236406,MATH 103A,B02,083780,Staff,0,13,30,30
1650510242429,MATH 105,A01,085443,Staff,1,23,30,29
1650510248454,MATH 109,A01,083213,Anzaldo; Leesa B,0,7,30,30
1650510248454,MATH 109,A02,083214,Anzaldo; Leesa B,0,7,30,30
1650510248454,MATH 109,B01,083215,Anzaldo; Leesa B,0,5,30,30
1650510248454,MATH 109,B02,083216,Anzaldo; Leesa B,0,6,30,30
1650510254479,MATH 142A,A01,083219,Chow; Bennett,0,16,30,30
1650510254479,MATH 142A,A02,083220,Chow; Bennett,0,14,30,30
1650510254479,MATH 142A,B01,083221,Chow; Bennett,0,13,30,30
1650510254479,MATH 142A,B02,083222,Chow; Bennett,0,13,30,30
1650510260506,MATH 193A,A01,083224,Staff,0,5,30,30
1650510260506,MATH 193A,A02,083225,Staff,0,5,30,30
1650510260506,MATH 193A,A03,083781,Staff,0,5,30,30
1650510260506,MATH 193A,A04,083782,Staff,0,7,30,30
1650510266531,MATH 197,001,091859,McAuley; Julian John,9998,0,9999,1
1650510272670,COGS 9,A01,083615,Staff,0,15,60,60
1650510278697,COGS 11,A01,083617,Boyle; Mary E. T.,19,0,40,21
1650510284719,COGS 13,A01,083071,Staff,0,35,40,40
1650510290741,COGS 14A,A01,092681,Staff,1,25,100,99
1650510296778,COGS 14B,A01,083073,Cheng; Tzu-Han,1,12,50,49
1650510302803,COGS 17,A01,092677,Staff,20,0,75,55
1650510308832,COGS 100,A01,083619,Staff,0,27,60,60
1650510314859,COGS 101A,A01,083621,Davis; Joshua Daniel,0,25,60,60
1650510320883,COGS 101B,A01,091572,Staff,0,4,60,60
1650510326905,COGS 101C,A01,083625,Delgado; Tania,16,0,30,14
1650510332930,COGS 107A,A01,083627,Boyle; Mary E. T.,0,12,60,60
1650510338967,COGS 118A,A01,083075,Staff,0,3,60,60
1650510344991,CSE 3,A50,083646,Miranda; Gregory Joseph,20,0,38,18
1650510344991,CSE 3,A51,083647,Miranda; Gregory Joseph,36,0,37,1
1650510351017,CSE 8A,A50,083650,Miranda; Gregory Joseph,1,30,40,39
1650510357044,CSE 11,A01,083080,Cao; Yingjun,0,92,40,40
1650510363071,CSE 12,A01,083652,Staff,0,17,100,100
1650510369095,CSE 15L,A01,083654,Staff,0,1,50,50
1650510369095,CSE 15L,A02,083655,Staff,0,0,50,50
1650510375123,CSE 20,A01,083657,Staff,51,0,80,29
1650510381148,CSE 30,A01,083084,Eldon; John,0,77,40,40
1650510387179,CSE 100,A01,083659,Cao; Yingjun,0,66,50,50
1650510393204,CSE 134B,A01,083661,Powell; Thomas Allan,0,34,65,65
1650510399232,CSE 140,A01,083663,Staff,0,5,75,75
1650510405255,CSE 140L,A01,083088,Eldon; John,0,11,75,75
1650510411279,CSE 175,A01,083665,Kumar; Rakesh,7,0,25,18
1650510417306,CSE 190,A00,092507,Dubnov; Shlomo,10,0,20,10
1650510423332,ECE 45,A01,083139,Staff,20,19,60,40
1650510429355,ECE 65,A50,083695,Staff,0,6,30,30
1650510435382,ECE 109,A01,091882,Touri; Behrouz,35,0,70,35
1650510441408,ECE 180,A00,083140,Abi Samra; Nicholas Camill,21,0,30,9
1650510441408,ECE 180,B00,083141,Abi Samra; Nicholas Camill,0,0,30,30
1650510447432,MATH 10A,A01,083735,Patchell; Gregory David,5,0,30,25
1650510447432,MATH 10A,A02,083736,Patchell; Gregory David,27,0,30,3
1650510447432,MATH 10A,A03,083737,Patchell; Gregory David,24,0,30,6
1650510453462,MATH 10B,A01,083207,Staff,0,9,30,30
1650510453462,MATH 10B,A02,083208,Staff,0,7,30,30
1650510453462,MATH 10B,B01,083739,Staff,13,0,30,17
1650510453462,MATH 10B,B02,083740,Staff,28,0,30,2
1650510459499,MATH 18,A01,083743,Staff,1,0,30,29
1650510459499,MATH 18,A02,083744,Staff,27,0,30,3
1650510459499,MATH 18,A03,083745,Staff,22,0,30,8
1650510459499,MATH 18,A04,083746,Staff,26,0,30,4
1650510459499,MATH 18,B01,083748,Staff,0,11,30,30
1650510459499,MATH 18,B02,083749,Staff,0,12,30,30
1650510459499,MATH 18,B03,083750,Staff,0,11,30,30
1650510459499,MATH 18,B04,083751,Staff,0,12,30,30
1650510465532,MATH 20A,A01,083754,Staff,24,0,40,16
1650510471556,MATH 20B,A01,083756,Staff,0,11,30,30
1650510471556,MATH 20B,A02,083757,Staff,0,11,30,30
1650510477586,MATH 20C,A01,083760,Staff,0,16,30,30
1650510477586,MATH 20C,A02,083761,Staff,2,15,30,28
1650510477586,MATH 20C,B01,083762,Staff,12,0,30,18
1650510477586,MATH 20C,B02,083763,Staff,28,0,30,2
1650510483611,MATH 20D,A01,083765,Staff,0,1,30,30
1650510483611,MATH 20D,A02,083766,Staff,7,0,30,23
1650510483611,MATH 20D,A03,083767,Staff,25,0,30,5
1650510489635,MATH 20E,A01,083771,Staff,6,0,30,24
1650510489635,MATH 20E,A02,083772,Staff,18,0,30,12
1650510489635,MATH 20E,B01,083773,Staff,0,0,30,30
1650510489635,MATH 20E,B02,083774,Staff,10,0,30,20
1650510495663,MATH 103A,A01,083777,Staff,0,13,30,30
1650510495663,MATH 103A,A02,083778,Staff,0,14,30,30
1650510495663,MATH 103A,B01,083779,Staff,0,13,30,30
1650510495663,MATH 103A,B02,083780,Staff,0,13,30,30
1650510501690,MATH 105,A01,085443,Staff,1,23,30,29
1650510507716,MATH 109,A01,083213,Anzaldo; Leesa B,0,7,30,30
1650510507716,MATH 109,A02,083214,Anzaldo; Leesa B,0,7,30,30
1650510507716,MATH 109,B01,083215,Anzaldo; Leesa B,0,5,30,30
1650510507716,MATH 109,B02,083216,Anzaldo; Leesa B,0,6,30,30
1650510513738,MATH 142A,A01,083219,Chow; Bennett,0,16,30,30
1650510513738,MATH 142A,A02,083220,Chow; Bennett,0,14,30,30
1650510513738,MATH 142A,B01,083221,Chow; Bennett,0,13,30,30
1650510513738,MATH 142A,B02,083222,Chow; Bennett,0,13,30,30
1650510519766,MATH 193A,A01,083224,Staff,0,5,30,30
1650510519766,MATH 193A,A02,083225,Staff,0,5,30,30
1650510519766,MATH 193A,A03,083781,Staff,0,5,30,30
1650510519766,MATH 193A,A04,083782,Staff,0,7,30,30
1650510525792,MATH 197,001,091859,McAuley; Julian John,9998,0,9999,1
1650510531850,COGS 9,A01,083615,Staff,0,15,60,60
1650510537876,COGS 11,A01,083617,Boyle; Mary E. T.,19,0,40,21
1650510543908,COGS 13,A01,083071,Staff,0,35,40,40
1650510549935,COGS 14A,A01,092681,Staff,1,25,100,99
1650510555958,COGS 14B,A01,083073,Cheng; Tzu-Han,1,12,50,49
1650510561980,COGS 17,A01,092677,Staff,20,0,75,55
1650510568010,COGS 100,A01,083619,Staff,0,27,60,60
1650510574046,COGS 101A,A01,083621,Davis; Joshua Daniel,0,25,60,60
1650510580068,COGS 101B,A01,091572,Staff,0,4,60,60
1650510586094,COGS 101C,A01,083625,Delgado; Tania,16,0,30,14
1650510592117,COGS 107A,A01,083627,Boyle; Mary E. T.,0,12,60,60
1650510598142,COGS 118A,A01,083075,Staff,0,3,60,60
1650510604169,CSE 3,A50,083646,Miranda; Gregory Joseph,20,0,38,18
1650510604169,CSE 3,A51,083647,Miranda; Gregory Joseph,36,0,37,1
1650510610193,CSE 8A,A50,083650,Miranda; Gregory Joseph,1,30,40,39
1650510616217,CSE 11,A01,083080,Cao; Yingjun,0,92,40,40
1650510622242,CSE 12,A01,083652,Staff,0,17,100,100
1650510628265,CSE 15L,A01,083654,Staff,0,1,50,50
1650510628265,CSE 15L,A02,083655,Staff,0,0,50,50
1650510634289,CSE 20,A01,083657,Staff,51,0,80,29
1650510640316,CSE 30,A01,083084,Eldon; John,0,77,40,40
1650510646342,CSE 100,A01,083659,Cao; Yingjun,0,66,50,50
1650510652368,CSE 134B,A01,083661,Powell; Thomas Allan,0,34,65,65
1650510658397,CSE 140,A01,083663,Staff,0,5,75,75
1650510664423,CSE 140L,A01,083088,Eldon; John,0,11,75,75
1650510670449,CSE 175,A01,083665,Kumar; Rakesh,7,0,25,18
1650510676481,CSE 190,A00,092507,Dubnov; Shlomo,10,0,20,10
1650510682505,ECE 45,A01,083139,Staff,20,19,60,40
1650510688528,ECE 65,A50,083695,Staff,0,6,30,30
1650510694558,ECE 109,A01,091882,Touri; Behrouz,35,0,70,35
1650510700600,ECE 180,A00,083140,Abi Samra; Nicholas Camill,21,0,30,9
1650510700600,ECE 180,B00,083141,Abi Samra; Nicholas Camill,0,0,30,30
1650510706624,MATH 10A,A01,083735,Patchell; Gregory David,5,0,30,25
1650510706624,MATH 10A,A02,083736,Patchell; Gregory David,27,0,30,3
1650510706624,MATH 10A,A03,083737,Patchell; Gregory David,24,0,30,6
1650510712656,MATH 10B,A01,083207,Staff,0,9,30,30
1650510712656,MATH 10B,A02,083208,Staff,0,7,30,30
1650510712656,MATH 10B,B01,083739,Staff,13,0,30,17
1650510712656,MATH 10B,B02,083740,Staff,28,0,30,2
1650510718681,MATH 18,A01,083743,Staff,1,0,30,29
1650510718681,MATH 18,A02,083744,Staff,27,0,30,3
1650510718681,MATH 18,A03,083745,Staff,22,0,30,8
1650510718681,MATH 18,A04,083746,Staff,26,0,30,4
1650510718681,MATH 18,B01,083748,Staff,0,11,30,30
1650510718681,MATH 18,B02,083749,Staff,0,12,30,30
1650510718681,MATH 18,B03,083750,Staff,0,11,30,30
1650510718681,MATH 18,B04,083751,Staff,0,12,30,30
1650510724710,MATH 20A,A01,083754,Staff,24,0,40,16
1650510730737,MATH 20B,A01,083756,Staff,0,11,30,30
1650510730737,MATH 20B,A02,083757,Staff,0,11,30,30
1650510736761,MATH 20C,A01,083760,Staff,0,16,30,30
1650510736761,MATH 20C,A02,083761,Staff,2,15,30,28
1650510736761,MATH 20C,B01,083762,Staff,12,0,30,18
1650510736761,MATH 20C,B02,083763,Staff,28,0,30,2
1650510742786,MATH 20D,A01,083765,Staff,0,1,30,30
1650510742786,MATH 20D,A02,083766,Staff,7,0,30,23
1650510742786,MATH 20D,A03,083767,Staff,25,0,30,5
1650510748820,MATH 20E,A01,083771,Staff,6,0,30,24
1650510748820,MATH 20E,A02,083772,Staff,18,0,30,12
1650510748820,MATH 20E,B01,083773,Staff,0,0,30,30
1650510748820,MATH 20E,B02,083774,Staff,10,0,30,20
1650510754847,MATH 103A,A01,083777,Staff,0,13,30,30
1650510754847,MATH 103A,A02,083778,Staff,0,14,30,30
1650510754847,MATH 103A,B01,083779,Staff,0,13,30,30
1650510754847,MATH 103A,B02,083780,Staff,0,13,30,30
1650510760874,MATH 105,A01,085443,Staff,1,23,30,29
1650510766898,MATH 109,A01,083213,Anzaldo; Leesa B,0,7,30,30
1650510766898,MATH 109,A02,083214,Anzaldo; Leesa B,0,7,30,30
1650510766898,MATH 109,B01,083215,Anzaldo; Leesa B,0,5,30,30
1650510766898,MATH 109,B02,083216,Anzaldo; Leesa B,0,6,30,30
1650510772923,MATH 142A,A01,083219,Chow; Bennett,0,16,30,30
1650510772923,MATH 142A,A02,083220,Chow; Bennett,0,14,30,30
1650510772923,MATH 142A,B01,083221,Chow; Bennett,0,13,30,30
1650510772923,MATH 142A,B02,083222,Chow; Bennett,0,13,30,30
1650510778951,MATH 193A,A01,083224,Staff,0,5,30,30
1650510778951,MATH 193A,A02,083225,Staff,0,5,30,30
1650510778951,MATH 193A,A03,083781,Staff,0,5,30,30
1650510778951,MATH 193A,A04,083782,Staff,0,7,30,30
1650510784982,MATH 197,001,091859,McAuley; Julian John,9998,0,9999,1
1650510791037,COGS 9,A01,083615,Staff,0,15,60,60
1650510797061,COGS 11,A01,083617,Boyle; Mary E. T.,19,0,40,21
1650510803085,COGS 13,A01,083071,Staff,0,35,40,40
1650510809107,COGS 14A,A01,092681,Staff,1,26,100,99
1650510815130,COGS 14B,A01,083073,Cheng; Tzu-Han,1,12,50,49
1650510821154,COGS 17,A01,092677,Staff,20,0,75,55
1650510827177,COGS 100,A01,083619,Staff,0,27,60,60
1650510833204,COGS 101A,A01,083621,Davis; Joshua Daniel,0,25,60,60
1650510839229,COGS 101B,A01,091572,Staff,0,4,60,60
1650510845253,COGS 101C,A01,083625,Delgado; Tania,16,0,30,14
1650510851287,COGS 107A,A01,083627,Boyle; Mary E. T.,0,12,60,60
1650510857313,COGS 118A,A01,083075,Staff,0,3,60,60
1650510863431,CSE 3,A50,083646,Miranda; Gregory Joseph,20,0,38,18
1650510863431,CSE 3,A51,083647,Miranda; Gregory Joseph,36,0,37,1
1650510869456,CSE 8A,A50,083650,Miranda; Gregory Joseph,1,30,40,39
1650510875482,CSE 11,A01,083080,Cao; Yingjun,0,92,40,40
1650510881505,CSE 12,A01,083652,Staff,0,17,100,100
1650510887529,CSE 15L,A01,083654,Staff,0,1,50,50
1650510887529,CSE 15L,A02,083655,Staff,0,0,50,50
1650510893552,CSE 20,A01,083657,Staff,51,0,80,29
1650510899576,CSE 30,A01,083084,Eldon; John,0,77,40,40
1650510905602,CSE 100,A01,083659,Cao; Yingjun,0,66,50,50
1650510911628,CSE 134B,A01,083661,Powell; Thomas Allan,0,34,65,65
1650510917654,CSE 140,A01,083663,Staff,0,5,75,75
1650510923680,CSE 140L,A01,083088,Eldon; John,0,11,75,75
1650510929714,CSE 175,A01,083665,Kumar; Rakesh,7,0,25,18
1650510935741,CSE 190,A00,092507,Dubnov; Shlomo,10,0,20,10
1650510941765,ECE 45,A01,083139,Staff,20,19,60,40
1650510947797,ECE 65,A50,083695,Staff,0,6,30,30
1650510953821,ECE 109,A01,091882,Touri; Behrouz,35,0,70,35
1650510959854,ECE 180,A00,083140,Abi Samra; Nicholas Camill,21,0,30,9
1650510959854,ECE 180,B00,083141,Abi Samra; Nicholas Camill,0,0,30,30
1650510965880,MATH 10A,A01,083735,Patchell; Gregory David,5,0,30,25
1650510965880,MATH 10A,A02,083736,Patchell; Gregory David,27,0,30,3
1650510965880,MATH 10A,A03,083737,Patchell; Gregory David,24,0,30,6
1650510971906,MATH 10B,A01,083207,Staff,0,9,30,30
1650510971906,MATH 10B,A02,083208,Staff,0,7,30,30
1650510971906,MATH 10B,B01,083739,Staff,13,0,30,17
1650510971906,MATH 10B,B02,083740,Staff,28,0,30,2
1650510977936,MATH 18,A01,083743,Staff,1,0,30,29
1650510977936,MATH 18,A02,083744,Staff,27,0,30,3
1650510977936,MATH 18,A03,083745,Staff,22,0,30,8
1650510977936,MATH 18,A04,083746,Staff,26,0,30,4
1650510977936,MATH 18,B01,083748,Staff,0,11,30,30
1650510977936,MATH 18,B02,083749,Staff,0,12,30,30
1650510977936,MATH 18,B03,083750,Staff,0,11,30,30
1650510977936,MATH 18,B04,083751,Staff,0,12,30,30
1650510983963,MATH 20A,A01,083754,Staff,24,0,40,16
1650510989985,MATH 20B,A01,083756,Staff,0,11,30,30
1650510989985,MATH 20B,A02,083757,Staff,0,11,30,30
1650510996022,MATH 20C,A01,083760,Staff,0,16,30,30
1650510996022,MATH 20C,A02,083761,Staff,2,15,30,28
1650510996022,MATH 20C,B01,083762,Staff,12,0,30,18
1650510996022,MATH 20C,B02,083763,Staff,28,0,30,2
1650511002045,MATH 20D,A01,083765,Staff,0,1,30,30
1650511002045,MATH 20D,A02,083766,Staff,7,0,30,23
1650511002045,MATH 20D,A03,083767,Staff,25,0,30,5
1650511008070,MATH 20E,A01,083771,Staff,6,0,30,24
1650511008070,MATH 20E,A02,083772,Staff,18,0,30,12
1650511008070,MATH 20E,B01,083773,Staff,0,0,30,30
1650511008070,MATH 20E,B02,083774,Staff,10,0,30,20
1650511014098,MATH 103A,A01,083777,Staff,0,13,30,30
1650511014098,MATH 103A,A02,083778,Staff,0,14,30,30
1650511014098,MATH 103A,B01,083779,Staff,0,13,30,30
1650511014098,MATH 103A,B02,083780,Staff,0,13,30,30
1650511020122,MATH 105,A01,085443,Staff,1,23,30,29
1650511026157,MATH 109,A01,083213,Anzaldo; Leesa B,0,7,30,30
1650511026157,MATH 109,A02,083214,Anzaldo; Leesa B,0,7,30,30
1650511026157,MATH 109,B01,083215,Anzaldo; Leesa B,0,5,30,30
1650511026157,MATH 109,B02,083216,Anzaldo; Leesa B,0,6,30,30
1650511032184,MATH 142A,A01,083219,Chow; Bennett,0,16,30,30
1650511032184,MATH 142A,A02,083220,Chow; Bennett,0,14,30,30
1650511032184,MATH 142A,B01,083221,Chow; Bennett,0,13,30,30
1650511032184,MATH 142A,B02,083222,Chow; Bennett,0,13,30,30
1650511038209,MATH 193A,A01,083224,Staff,0,5,30,30
1650511038209,MATH 193A,A02,083225,Staff,0,5,30,30
1650511038209,MATH 193A,A03,083781,Staff,0,5,30,30
1650511038209,MATH 193A,A04,083782,Staff,0,7,30,30
1650511044234,MATH 197,001,091859,McAuley; Julian John,9998,0,9999,1
1650511050290,COGS 9,A01,083615,Staff,0,15,60,60
1650511056313,COGS 11,A01,083617,Boyle; Mary E. T.,19,0,40,21
1650511062335,COGS 13,A01,083071,Staff,0,35,40,40
1650511068362,COGS 14A,A01,092681,Staff,1,26,100,99
1650511074388,COGS 14B,A01,083073,Cheng; Tzu-Han,1,13,50,49
1650511080414,COGS 17,A01,092677,Staff,20,0,75,55
1650511086437,COGS 100,A01,083619,Staff,0,27,60,60
1650511092459,COGS 101A,A01,083621,Davis; Joshua Daniel,0,25,60,60
1650511098481,COGS 101B,A01,091572,Staff,0,4,60,60
1650511104508,COGS 101C,A01,083625,Delgado; Tania,16,0,30,14
1650511110530,COGS 107A,A01,083627,Boyle; Mary E. T.,0,12,60,60
1650511116551,COGS 118A,A01,083075,Staff,0,3,60,60
1650511122577,CSE 3,A50,083646,Miranda; Gregory Joseph,20,0,38,18
1650511122577,CSE 3,A51,083647,Miranda; Gregory Joseph,36,0,37,1
1650511128602,CSE 8A,A50,083650,Miranda; Gregory Joseph,1,30,40,39
1650511134636,CSE 11,A01,083080,Cao; Yingjun,0,92,40,40
1650511140676,CSE 12,A01,083652,Staff,0,17,100,100
1650511146703,CSE 15L,A01,083654,Staff,0,1,50,50
1650511146703,CSE 15L,A02,083655,Staff,0,0,50,50
1650511152728,CSE 20,A01,083657,Staff,51,0,80,29
1650511158751,CSE 30,A01,083084,Eldon; John,0,77,40,40
1650511164775,CSE 100,A01,083659,Cao; Yingjun,0,66,50,50
1650511170797,CSE 134B,A01,083661,Powell; Thomas Allan,0,34,65,65
1650511176823,CSE 140,A01,083663,Staff,0,5,75,75
1650511182847,CSE 140L,A01,083088,Eldon; John,0,11,75,75
1650511188873,CSE 175,A01,083665,Kumar; Rakesh,7,0,25,18
1650511194901,CSE 190,A00,092507,Dubnov; Shlomo,10,0,20,10
1650511200927,ECE 45,A01,083139,Staff,20,19,60,40
1650511206950,ECE 65,A50,083695,Staff,0,6,30,30
1650511212982,ECE 109,A01,091882,Touri; Behrouz,35,0,70,35
1650511219008,ECE 180,A00,083140,Abi Samra; Nicholas Camill,21,0,30,9
1650511219008,ECE 180,B00,083141,Abi Samra; Nicholas Camill,0,0,30,30
1650511225038,MATH 10A,A01,083735,Patchell; Gregory David,5,0,30,25
1650511225038,MATH 10A,A02,083736,Patchell; Gregory David,27,0,30,3
1650511225038,MATH 10A,A03,083737,Patchell; Gregory David,24,0,30,6
1650511231063,MATH 10B,A01,083207,Staff,0,9,30,30
1650511231063,MATH 10B,A02,083208,Staff,0,7,30,30
1650511231063,MATH 10B,B01,083739,Staff,13,0,30,17
1650511231063,MATH 10B,B02,083740,Staff,28,0,30,2
1650511237093,MATH 18,A01,083743,Staff,1,0,30,29
1650511237093,MATH 18,A02,083744,Staff,27,0,30,3
1650511237093,MATH 18,A03,083745,Staff,22,0,30,8
1650511237093,MATH 18,A04,083746,Staff,26,0,30,4
1650511237093,MATH 18,B01,083748,Staff,0,11,30,30
1650511237093,MATH 18,B02,083749,Staff,0,12,30,30
1650511237093,MATH 18,B03,083750,Staff,0,11,30,30
1650511237093,MATH 18,B04,083751,Staff,0,12,30,30
1650511243119,MATH 20A,A01,083754,Staff,24,0,40,16
1650511249149,MATH 20B,A01,083756,Staff,0,11,30,30
1650511249149,MATH 20B,A02,083757,Staff,0,11,30,30
1650511255177,MATH 20C,A01,083760,Staff,0,16,30,30
1650511255177,MATH 20C,A02,083761,Staff,2,15,30,28
1650511255177,MATH 20C,B01,083762,Staff,12,0,30,18
1650511255177,MATH 20C,B02,083763,Staff,28,0,30,2
1650511261205,MATH 20D,A01,083765,Staff,0,1,30,30
1650511261205,MATH 20D,A02,083766,Staff,7,0,30,23
1650511261205,MATH 20D,A03,083767,Staff,25,0,30,5
1650511267232,MATH 20E,A01,083771,Staff,6,0,30,24
1650511267232,MATH 20E,A02,083772,Staff,18,0,30,12
1650511267232,MATH 20E,B01,083773,Staff,0,0,30,30
1650511267232,MATH 20E,B02,083774,Staff,10,0,30,20
1650511273255,MATH 103A,A01,083777,Staff,0,13,30,30
1650511273255,MATH 103A,A02,083778,Staff,0,14,30,30
1650511273255,MATH 103A,B01,083779,Staff,0,13,30,30
1650511273255,MATH 103A,B02,083780,Staff,0,13,30,30
1650511279280,MATH 105,A01,085443,Staff,1,23,30,29
1650511285304,MATH 109,A01,083213,Anzaldo; Leesa B,0,7,30,30
1650511285304,MATH 109,A02,083214,Anzaldo; Leesa B,0,7,30,30
1650511285304,MATH 109,B01,083215,Anzaldo; Leesa B,0,5,30,30
1650511285304,MATH 109,B02,083216,Anzaldo; Leesa B,0,6,30,30
1650511291331,MATH 142A,A01,083219,Chow; Bennett,0,16,30,30
1650511291331,MATH 142A,A02,083220,Chow; Bennett,0,14,30,30
1650511291331,MATH 142A,B01,083221,Chow; Bennett,0,13,30,30
1650511291331,MATH 142A,B02,083222,Chow; Bennett,0,13,30,30
1650511297355,MATH 193A,A01,083224,Staff,0,5,30,30
1650511297355,MATH 193A,A02,083225,Staff,0,5,30,30
1650511297355,MATH 193A,A03,083781,Staff,0,5,30,30
1650511297355,MATH 193A,A04,083782,Staff,0,7,30,30
1650511303380,MATH 197,001,091859,McAuley; Julian John,9998,0,9999,1
1650511309440,COGS 9,A01,083615,Staff,0,15,60,60
1650511315466,COGS 11,A01,083617,Boyle; Mary E. T.,19,0,40,21
1650511321493,COGS 13,A01,083071,Staff,0,35,40,40
1650511327519,COGS 14A,A01,092681,Staff,1,26,100,99
1650511333547,COGS 14B,A01,083073,Cheng; Tzu-Han,1,13,50,49
1650511339575,COGS 17,A01,092677,Staff,20,0,75,55
1650511345603,COGS 100,A01,083619,Staff,0,27,60,60
1650511351637,COGS 101A,A01,083621,Davis; Joshua Daniel,0,25,60,60
1650511357664,COGS 101B,A01,091572,Staff,0,4,60,60
1650511363687,COGS 101C,A01,083625,Delgado; Tania,16,0,30,14
1650511369713,COGS 107A,A01,083627,Boyle; Mary E. T.,0,12,60,60
1650511375737,COGS 118A,A01,083075,Staff,0,3,60,60
1650511381762,CSE 3,A50,083646,Miranda; Gregory Joseph,20,0,38,18
1650511381762,CSE 3,A51,083647,Miranda; Gregory Joseph,36,0,37,1
1650511387789,CSE 8A,A50,083650,Miranda; Gregory Joseph,1,30,40,39
1650511393815,CSE 11,A01,083080,Cao; Yingjun,0,92,40,40
1650511399842,CSE 12,A01,083652,Staff,0,17,100,100
1650511405872,CSE 15L,A01,083654,Staff,0,1,50,50
1650511405872,CSE 15L,A02,083655,Staff,0,0,50,50
1650511411898,CSE 20,A01,083657,Staff,51,0,80,29
1650511417928,CSE 30,A01,083084,Eldon; John,0,77,40,40
1650511423952,CSE 100,A01,083659,Cao; Yingjun,0,66,50,50
1650511429980,CSE 134B,A01,083661,Powell; Thomas Allan,0,34,65,65
1650511436003,CSE 140,A01,083663,Staff,0,5,75,75
1650511442027,CSE 140L,A01,083088,Eldon; John,0,11,75,75
1650511448061,CSE 175,A01,083665,Kumar; Rakesh,7,0,25,18
1650511454086,CSE 190,A00,092507,Dubnov; Shlomo,10,0,20,10
1650511460202,ECE 45,A01,083139,Staff,20,19,60,40
1650511466225,ECE 65,A50,083695,Staff,0,6,30,30
1650511472249,ECE 109,A01,091882,Touri; Behrouz,35,0,70,35
1650511478274,ECE 180,A00,083140,Abi Samra; Nicholas Camill,21,0,30,9
1650511478274,ECE 180,B00,083141,Abi Samra; Nicholas Camill,0,0,30,30
1650511484307,MATH 10A,A01,083735,Patchell; Gregory David,5,0,30,25
1650511484307,MATH 10A,A02,083736,Patchell; Gregory David,27,0,30,3
1650511484307,MATH 10A,A03,083737,Patchell; Gregory David,24,0,30,6
1650511490334,MATH 10B,A01,083207,Staff,0,9,30,30
1650511490334,MATH 10B,A02,083208,Staff,0,7,30,30
1650511490334,MATH 10B,B01,083739,Staff,13,0,30,17
1650511490334,MATH 10B,B02,083740,Staff,28,0,30,2
1650511496363,MATH 18,A01,083743,Staff,1,0,30,29
1650511496363,MATH 18,A02,083744,Staff,27,0,30,3
1650511496363,MATH 18,A03,083745,Staff,22,0,30,8
1650511496363,MATH 18,A04,083746,Staff,26,0,30,4
1650511496363,MATH 18,B01,083748,Staff,0,11,30,30
1650511496363,MATH 18,B02,083749,Staff,0,12,30,30
1650511496363,MATH 18,B03,083750,Staff,0,11,30,30
1650511496363,MATH 18,B04,083751,Staff,0,12,30,30
1650511502387,MATH 20A,A01,083754,Staff,24,0,40,16
1650511508409,MATH 20B,A01,083756,Staff,0,11,30,30
1650511508409,MATH 20B,A02,083757,Staff,0,11,30,30
1650511514437,MATH 20C,A01,083760,Staff,0,16,30,30
1650511514437,MATH 20C,A02,083761,Staff,2,15,30,28
1650511514437,MATH 20C,B01,083762,Staff,12,0,30,18
1650511514437,MATH 20C,B02,083763,Staff,28,0,30,2
1650511520471,MATH 20D,A01,083765,Staff,0,1,30,30
1650511520471,MATH 20D,A02,083766,Staff,7,0,30,23
1650511520471,MATH 20D,A03,083767,Staff,25,0,30,5
1650511526496,MATH 20E,A01,083771,Staff,6,0,30,24
1650511526496,MATH 20E,A02,083772,Staff,18,0,30,12
1650511526496,MATH 20E,B01,083773,Staff,0,0,30,30
1650511526496,MATH 20E,B02,083774,Staff,10,0,30,20
1650511532520,MATH 103A,A01,083777,Staff,0,13,30,30
1650511532520,MATH 103A,A02,083778,Staff,0,14,30,30
1650511532520,MATH 103A,B01,083779,Staff,0,13,30,30
1650511532520,MATH 103A,B02,083780,Staff,0,13,30,30
1650511538545,MATH 105,A01,085443,Staff,1,23,30,29
1650511544573,MATH 109,A01,083213,Anzaldo; Leesa B,0,7,30,30
1650511544573,MATH 109,A02,083214,Anzaldo; Leesa B,0,7,30,30
1650511544573,MATH 109,B01,083215,Anzaldo; Leesa B,0,5,30,30
1650511544573,MATH 109,B02,083216,Anzaldo; Leesa B,0,6,30,30
1650511550595,MATH 142A,A01,083219,Chow; Bennett,0,16,30,30
1650511550595,MATH 142A,A02,083220,Chow; Bennett,0,14,30,30
1650511550595,MATH 142A,B01,083221,Chow; Bennett,0,13,30,30
1650511550595,MATH 142A,B02,083222,Chow; Bennett,0,13,30,30
1650511556619,MATH 193A,A01,083224,Staff,0,5,30,30
1650511556619,MATH 193A,A02,083225,Staff,0,5,30,30
1650511556619,MATH 193A,A03,083781,Staff,0,5,30,30
1650511556619,MATH 193A,A04,083782,Staff,0,7,30,30
1650511562643,MATH 197,001,091859,McAuley; Julian John,9998,0,9999,1
1650511568694,COGS 9,A01,083615,Staff,0,15,60,60
1650511574718,COGS 11,A01,083617,Boyle; Mary E. T.,19,0,40,21
1650511580742,COGS 13,A01,083071,Staff,0,35,40,40
1650511586769,COGS 14A,A01,092681,Staff,1,26,100,99
1650511592793,COGS 14B,A01,083073,Cheng; Tzu-Han,1,13,50,49
1650511598816,COGS 17,A01,092677,Staff,20,0,75,55
1650511604843,COGS 100,A01,083619,Staff,0,27,60,60
1650511610866,COGS 101A,A01,083621,Davis; Joshua Daniel,0,25,60,60
1650511616891,COGS 101B,A01,091572,Staff,0,4,60,60
1650511622918,COGS 101C,A01,083625,Delgado; Tania,16,0,30,14
1650511628943,COGS 107A,A01,083627,Boyle; Mary E. T.,0,12,60,60
1650511634971,COGS 118A,A01,083075,Staff,0,3,60,60
1650511640995,CSE 3,A50,083646,Miranda; Gregory Joseph,20,0,38,18
1650511640995,CSE 3,A51,083647,Miranda; Gregory Joseph,36,0,37,1
1650511647020,CSE 8A,A50,083650,Miranda; Gregory Joseph,1,30,40,39
1650511653046,CSE 11,A01,083080,Cao; Yingjun,0,92,40,40
1650511659071,CSE 12,A01,083652,Staff,0,17,100,100
1650511665093,CSE 15L,A01,083654,Staff,0,1,50,50
1650511665093,CSE 15L,A02,083655,Staff,0,0,50,50
1650511671121,CSE 20,A01,083657,Staff,51,0,80,29
1650511677144,CSE 30,A01,083084,Eldon; John,0,77,40,40
1650511683169,CSE 100,A01,083659,Cao; Yingjun,0,66,50,50
1650511689195,CSE 134B,A01,083661,Powell; Thomas Allan,0,34,65,65
1650511695223,CSE 140,A01,083663,Staff,0,5,75,75
1650511701250,CSE 140L,A01,083088,Eldon; John,0,11,75,75
1650511707275,CSE 175,A01,083665,Kumar; Rakesh,7,0,25,18
1650511713299,CSE 190,A00,092507,Dubnov; Shlomo,10,0,20,10
1650511719321,ECE 45,A01,083139,Staff,20,19,60,40
1650511725345,ECE 65,A50,083695,Staff,0,6,30,30
1650511731372,ECE 109,A01,091882,Touri; Behrouz,35,0,70,35
1650511737403,ECE 180,A00,083140,Abi Samra; Nicholas Camill,21,0,30,9
1650511737403,ECE 180,B00,083141,Abi Samra; Nicholas Camill,0,0,30,30
1650511743430,MATH 10A,A01,083735,Patchell; Gregory David,5,0,30,25
1650511743430,MATH 10A,A02,083736,Patchell; Gregory David,27,0,30,3
1650511743430,MATH 10A,A03,083737,Patchell; Gregory David,24,0,30,6
1650511749465,MATH 10B,A01,083207,Staff,0,9,30,30
1650511749465,MATH 10B,A02,083208,Staff,0,7,30,30
1650511749465,MATH 10B,B01,083739,Staff,13,0,30,17
1650511749465,MATH 10B,B02,083740,Staff,28,0,30,2
1650511755492,MATH 18,A01,083743,Staff,1,0,30,29
1650511755492,MATH 18,A02,083744,Staff,27,0,30,3
1650511755492,MATH 18,A03,083745,Staff,22,0,30,8
1650511755492,MATH 18,A04,083746,Staff,26,0,30,4
1650511755492,MATH 18,B01,083748,Staff,0,11,30,30
1650511755492,MATH 18,B02,083749,Staff,0,12,30,30
1650511755492,MATH 18,B03,083750,Staff,0,11,30,30
1650511755492,MATH 18,B04,083751,Staff,0,12,30,30
1650511761515,MATH 20A,A01,083754,Staff,24,0,40,16
1650511767539,MATH 20B,A01,083756,Staff,0,11,30,30
1650511767539,MATH 20B,A02,083757,Staff,0,11,30,30
1650511773560,MATH 20C,A01,083760,Staff,0,16,30,30
1650511773560,MATH 20C,A02,083761,Staff,2,15,30,28
1650511773560,MATH 20C,B01,083762,Staff,12,0,30,18
1650511773560,MATH 20C,B02,083763,Staff,28,0,30,2
1650511779582,MATH 20D,A01,083765,Staff,0,1,30,30
1650511779582,MATH 20D,A02,083766,Staff,7,0,30,23
1650511779582,MATH 20D,A03,083767,Staff,25,0,30,5
1650511785605,MATH 20E,A01,083771,Staff,6,0,30,24
1650511785605,MATH 20E,A02,083772,Staff,18,0,30,12
1650511785605,MATH 20E,B01,083773,Staff,0,0,30,30
1650511785605,MATH 20E,B02,083774,Staff,10,0,30,20
1650511791627,MATH 103A,A01,083777,Staff,0,13,30,30
1650511791627,MATH 103A,A02,083778,Staff,0,14,30,30
1650511791627,MATH 103A,B01,083779,Staff,0,13,30,30
1650511791627,MATH 103A,B02,083780,Staff,0,13,30,30
1650511797649,MATH 105,A01,085443,Staff,1,23,30,29
1650511803675,MATH 109,A01,083213,Anzaldo; Leesa B,0,7,30,30
1650511803675,MATH 109,A02,083214,Anzaldo; Leesa B,0,7,30,30
1650511803675,MATH 109,B01,083215,Anzaldo; Leesa B,0,5,30,30
1650511803675,MATH 109,B02,083216,Anzaldo; Leesa B,0,6,30,30
1650511809703,MATH 142A,A01,083219,Chow; Bennett,0,16,30,30
1650511809703,MATH 142A,A02,083220,Chow; Bennett,0,14,30,30
1650511809703,MATH 142A,B01,083221,Chow; Bennett,0,13,30,30
1650511809703,MATH 142A,B02,083222,Chow; Bennett,0,13,30,30
1650511815735,MATH 193A,A01,083224,Staff,0,5,30,30
1650511815735,MATH 193A,A02,083225,Staff,0,5,30,30
1650511815735,MATH 193A,A03,083781,Staff,0,5,30,30
1650511815735,MATH 193A,A04,083782,Staff,0,7,30,30
1650511821771,MATH 197,001,091859,McAuley; Julian John,9998,0,9999,1
1650511827829,COGS 9,A01,083615,Staff,0,15,60,60
1650511833853,COGS 11,A01,083617,Boyle; Mary E. T.,19,0,40,21
1650511839884,COGS 13,A01,083071,Staff,0,35,40,40
1650511845909,COGS 14A,A01,092681,Staff,1,26,100,99
1650511851933,COGS 14B,A01,083073,Cheng; Tzu-Han,1,13,50,49
1650511857957,COGS 17,A01,092677,Staff,20,0,75,55
1650511863980,COGS 100,A01,083619,Staff,0,27,60,60
1650511870012,COGS 101A,A01,083621,Davis; Joshua Daniel,0,25,60,60
1650511876038,COGS 101B,A01,091572,Staff,0,4,60,60
1650511882066,COGS 101C,A01,083625,Delgado; Tania,16,0,30,14
1650511888088,COGS 107A,A01,083627,Boyle; Mary E. T.,0,12,60,60
1650511894115,COGS 118A,A01,083075,Staff,0,3,60,60
1650511900171,CSE 3,A50,083646,Miranda; Gregory Joseph,20,0,38,18
1650511900171,CSE 3,A51,083647,Miranda; Gregory Joseph,36,0,37,1
1650511906196,CSE 8A,A50,083650,Miranda; Gregory Joseph,1,30,40,39
1650511912233,CSE 11,A01,083080,Cao; Yingjun,0,92,40,40
1650511918259,CSE 12,A01,083652,Staff,0,17,100,100
1650511924287,CSE 15L,A01,083654,Staff,0,1,50,50
1650511924287,CSE 15L,A02,083655,Staff,0,0,50,50
1650511930318,CSE 20,A01,083657,Staff,51,0,80,29
1650511936345,CSE 30,A01,083084,Eldon; John,0,77,40,40
1650511942376,CSE 100,A01,083659,Cao; Yingjun,0,66,50,50
1650511948401,CSE 134B,A01,083661,Powell; Thomas Allan,0,34,65,65
1650511954424,CSE 140,A01,083663,Staff,0,5,75,75
1650511960447,CSE 140L,A01,083088,Eldon; John,0,11,75,75
1650511966474,CSE 175,A01,083665,Kumar; Rakesh,7,0,25,18
1650511972501,CSE 190,A00,092507,Dubnov; Shlomo,10,0,20,10
1650511978532,ECE 45,A01,083139,Staff,20,19,60,40
1650511984557,ECE 65,A50,083695,Staff,0,6,30,30
1650511990581,ECE 109,A01,091882,Touri; Behrouz,35,0,70,35
1650511996608,ECE 180,A00,083140,Abi Samra; Nicholas Camill,21,0,30,9
1650511996608,ECE 180,B00,083141,Abi Samra; Nicholas Camill,0,0,30,30
1650512002636,MATH 10A,A01,083735,Patchell; Gregory David,5,0,30,25
1650512002636,MATH 10A,A02,083736,Patchell; Gregory David,27,0,30,3
1650512002636,MATH 10A,A03,083737,Patchell; Gregory David,24,0,30,6
1650512008662,MATH 10B,A01,083207,Staff,0,9,30,30
1650512008662,MATH 10B,A02,083208,Staff,0,7,30,30
1650512008662,MATH 10B,B01,083739,Staff,13,0,30,17
1650512008662,MATH 10B,B02,083740,Staff,28,0,30,2
1650512014689,MATH 18,A01,083743,Staff,1,0,30,29
1650512014689,MATH 18,A02,083744,Staff,27,0,30,3
1650512014689,MATH 18,A03,083745,Staff,22,0,30,8
1650512014689,MATH 18,A04,083746,Staff,26,0,30,4
1650512014689,MATH 18,B01,083748,Staff,0,11,30,30
1650512014689,MATH 18,B02,083749,Staff,0,12,30,30
1650512014689,MATH 18,B03,083750,Staff,0,11,30,30
1650512014689,MATH 18,B04,083751,Staff,0,12,30,30
1650512020715,MATH 20A,A01,083754,Staff,24,0,40,16
1650512026741,MATH 20B,A01,083756,Staff,0,11,30,30
1650512026741,MATH 20B,A02,083757,Staff,0,11,30,30
1650512032770,MATH 20C,A01,083760,Staff,0,16,30,30
1650512032770,MATH 20C,A02,083761,Staff,2,15,30,28
1650512032770,MATH 20C,B01,083762,Staff,12,0,30,18
1650512032770,MATH 20C,B02,083763,Staff,28,0,30,2
1650512038800,MATH 20D,A01,083765,Staff,0,1,30,30
1650512038800,MATH 20D,A02,083766,Staff,7,0,30,23
1650512038800,MATH 20D,A03,083767,Staff,25,0,30,5
1650512044826,MATH 20E,A01,083771,Staff,6,0,30,24
1650512044826,MATH 20E,A02,083772,Staff,18,0,30,12
1650512044826,MATH 20E,B01,083773,Staff,0,0,30,30
1650512044826,MATH 20E,B02,083774,Staff,10,0,30,20
1650512050856,MATH 103A,A01,083777,Staff,0,13,30,30
1650512050856,MATH 103A,A02,083778,Staff,0,14,30,30
1650512050856,MATH 103A,B01,083779,Staff,0,13,30,30
1650512050856,MATH 103A,B02,083780,Staff,0,13,30,30
1650512056958,MATH 105,A01,085443,Staff,1,23,30,29
1650512062983,MATH 109,A01,083213,Anzaldo; Leesa B,0,7,30,30
1650512062983,MATH 109,A02,083214,Anzaldo; Leesa B,0,7,30,30
1650512062983,MATH 109,B01,083215,Anzaldo; Leesa B,0,5,30,30
1650512062983,MATH 109,B02,083216,Anzaldo; Leesa B,0,6,30,30
1650512069010,MATH 142A,A01,083219,Chow; Bennett,0,16,30,30
1650512069010,MATH 142A,A02,083220,Chow; Bennett,0,14,30,30
1650512069010,MATH 142A,B01,083221,Chow; Bennett,0,13,30,30
1650512069010,MATH 142A,B02,083222,Chow; Bennett,0,13,30,30
1650512075034,MATH 193A,A01,083224,Staff,0,5,30,30
1650512075034,MATH 193A,A02,083225,Staff,0,5,30,30
1650512075034,MATH 193A,A03,083781,Staff,0,5,30,30
1650512075034,MATH 193A,A04,083782,Staff,0,7,30,30
1650512081057,MATH 197,001,091859,McAuley; Julian John,9998,0,9999,1
1650512087108,COGS 9,A01,083615,Staff,0,15,60,60
1650512093130,COGS 11,A01,083617,Boyle; Mary E. T.,19,0,40,21
1650512099155,COGS 13,A01,083071,Staff,0,35,40,40
1650512105178,COGS 14A,A01,092681,Staff,1,26,100,99
1650512111211,COGS 14B,A01,083073,Cheng; Tzu-Han,1,13,50,49
1650512117235,COGS 17,A01,092677,Staff,20,0,75,55
1650512123258,COGS 100,A01,083619,Staff,0,27,60,60
1650512129285,COGS 101A,A01,083621,Davis; Joshua Daniel,0,25,60,60
1650512135308,COGS 101B,A01,091572,Staff,0,4,60,60
1650512141333,COGS 101C,A01,083625,Delgado; Tania,16,0,30,14
1650512147356,COGS 107A,A01,083627,Boyle; Mary E. T.,0,12,60,60
1650512153383,COGS 118A,A01,083075,Staff,0,3,60,60
1650512159411,CSE 3,A50,083646,Miranda; Gregory Joseph,20,0,38,18
1650512159411,CSE 3,A51,083647,Miranda; Gregory Joseph,36,0,37,1
1650512165439,CSE 8A,A50,083650,Miranda; Gregory Joseph,1,30,40,39
1650512171463,CSE 11,A01,083080,Cao; Yingjun,0,92,40,40
1650512177488,CSE 12,A01,083652,Staff,0,17,100,100
1650512183515,CSE 15L,A01,083654,Staff,0,1,50,50
1650512183515,CSE 15L,A02,083655,Staff,0,0,50,50
1650512189540,CSE 20,A01,083657,Staff,51,0,80,29
1650512195564,CSE 30,A01,083084,Eldon; John,0,77,40,40
1650512201588,CSE 100,A01,083659,Cao; Yingjun,0,66,50,50
1650512207612,CSE 134B,A01,083661,Powell; Thomas Allan,0,34,65,65
1650512213636,CSE 140,A01,083663,Staff,0,5,75,75
1650512219672,CSE 140L,A01,083088,Eldon; John,0,11,75,75
1650512225698,CSE 175,A01,083665,Kumar; Rakesh,7,0,25,18
1650512231726,CSE 190,A00,092507,Dubnov; Shlomo,10,0,20,10
1650512237752,ECE 45,A01,083139,Staff,20,19,60,40
1650512243781,ECE 65,A50,083695,Staff,0,6,30,30
1650512249804,ECE 109,A01,091882,Touri; Behrouz,35,0,70,35
1650512255841,ECE 180,A00,083140,Abi Samra; Nicholas Camill,21,0,30,9
1650512255841,ECE 180,B00,083141,Abi Samra; Nicholas Camill,0,0,30,30
1650512261869,MATH 10A,A01,083735,Patchell; Gregory David,5,0,30,25
1650512261869,MATH 10A,A02,083736,Patchell; Gregory David,27,0,30,3
1650512261869,MATH 10A,A03,083737,Patchell; Gregory David,24,0,30,6
1650512267900,MATH 10B,A01,083207,Staff,0,9,30,30
1650512267900,MATH 10B,A02,083208,Staff,0,7,30,30
1650512267900,MATH 10B,B01,083739,Staff,13,0,30,17
1650512267900,MATH 10B,B02,083740,Staff,28,0,30,2
1650512273936,MATH 18,A01,083743,Staff,1,0,30,29
1650512273936,MATH 18,A02,083744,Staff,27,0,30,3
1650512273936,MATH 18,A03,083745,Staff,22,0,30,8
1650512273936,MATH 18,A04,083746,Staff,26,0,30,4
1650512273936,MATH 18,B01,083748,Staff,0,11,30,30
1650512273936,MATH 18,B02,083749,Staff,0,12,30,30
1650512273936,MATH 18,B03,083750,Staff,0,11,30,30
1650512273936,MATH 18,B04,083751,Staff,0,12,30,30
1650512279958,MATH 20A,A01,083754,Staff,23,0,40,17
1650512285981,MATH 20B,A01,083756,Staff,0,11,30,30
1650512285981,MATH 20B,A02,083757,Staff,0,11,30,30
1650512292008,MATH 20C,A01,083760,Staff,0,16,30,30
1650512292008,MATH 20C,A02,083761,Staff,2,15,30,28
1650512292008,MATH 20C,B01,083762,Staff,12,0,30,18
1650512292008,MATH 20C,B02,083763,Staff,28,0,30,2
1650512298043,MATH 20D,A01,083765,Staff,0,1,30,30
1650512298043,MATH 20D,A02,083766,Staff,7,0,30,23
1650512298043,MATH 20D,A03,083767,Staff,25,0,30,5
1650512304072,MATH 20E,A01,083771,Staff,6,0,30,24
1650512304072,MATH 20E,A02,083772,Staff,18,0,30,12
1650512304072,MATH 20E,B01,083773,Staff,0,0,30,30
1650512304072,MATH 20E,B02,083774,Staff,10,0,30,20
1650512310099,MATH 103A,A01,083777,Staff,0,14,30,30
1650512310099,MATH 103A,A02,083778,Staff,0,14,30,30
1650512310099,MATH 103A,B01,083779,Staff,0,13,30,30
1650512310099,MATH 103A,B02,083780,Staff,0,13,30,30
1650512316121,MATH 105,A01,085443,Staff,1,23,30,29
1650512322149,MATH 109,A01,083213,Anzaldo; Leesa B,0,7,30,30
1650512322149,MATH 109,A02,083214,Anzaldo; Leesa B,0,7,30,30
1650512322149,MATH 109,B01,083215,Anzaldo; Leesa B,0,5,30,30
1650512322149,MATH 109,B02,083216,Anzaldo; Leesa B,0,6,30,30
1650512328176,MATH 142A,A01,083219,Chow; Bennett,0,16,30,30
1650512328176,MATH 142A,A02,083220,Chow; Bennett,0,14,30,30
1650512328176,MATH 142A,B01,083221,Chow; Bennett,0,13,30,30
1650512328176,MATH 142A,B02,083222,Chow; Bennett,0,13,30,30
1650512334203,MATH 193A,A01,083224,Staff,0,6,30,30
1650512334203,MATH 193A,A02,083225,Staff,0,5,30,30
1650512334203,MATH 193A,A03,083781,Staff,0,5,30,30
1650512334203,MATH 193A,A04,083782,Staff,0,7,30,30
1650512340234,MATH 197,001,091859,McAuley; Julian John,9998,0,9999,1
1650512346295,COGS 9,A01,083615,Staff,0,15,60,60
1650512352317,COGS 11,A01,083617,Boyle; Mary E. T.,19,0,40,21
1650512358350,COGS 13,A01,083071,Staff,0,35,40,40
1650512364375,COGS 14A,A01,092681,Staff,1,26,100,99
1650512370402,COGS 14B,A01,083073,Cheng; Tzu-Han,1,13,50,49
1650512376425,COGS 17,A01,092677,Staff,20,0,75,55
1650512382448,COGS 100,A01,083619,Staff,0,27,60,60
1650512388475,COGS 101A,A01,083621,Davis; Joshua Daniel,0,25,60,60
1650512394497,COGS 101B,A01,091572,Staff,0,4,60,60
1650512400525,COGS 101C,A01,083625,Delgado; Tania,16,0,30,14
1650512406552,COGS 107A,A01,083627,Boyle; Mary E. T.,0,12,60,60
1650512412577,COGS 118A,A01,083075,Staff,0,3,60,60
1650512418603,CSE 3,A50,083646,Miranda; Gregory Joseph,20,0,38,18
1650512418603,CSE 3,A51,083647,Miranda; Gregory Joseph,36,0,37,1
1650512424626,CSE 8A,A50,083650,Miranda; Gregory Joseph,1,30,40,39
1650512430648,CSE 11,A01,083080,Cao; Yingjun,0,92,40,40
1650512436675,CSE 12,A01,083652,Staff,0,17,100,100
1650512442697,CSE 15L,A01,083654,Staff,0,1,50,50
1650512442697,CSE 15L,A02,083655,Staff,0,0,50,50
1650512448721,CSE 20,A01,083657,Staff,51,0,80,29
1650512454750,CSE 30,A01,083084,Eldon; John,0,77,40,40
1650512460776,CSE 100,A01,083659,Cao; Yingjun,0,66,50,50
1650512466799,CSE 134B,A01,083661,Powell; Thomas Allan,0,34,65,65
1650512472822,CSE 140,A01,083663,Staff,0,5,75,75
1650512478845,CSE 140L,A01,083088,Eldon; John,0,11,75,75
1650512484868,CSE 175,A01,083665,Kumar; Rakesh,7,0,25,18
1650512490894,CSE 190,A00,092507,Dubnov; Shlomo,10,0,20,10
1650512496915,ECE 45,A01,083139,Staff,20,19,60,40
1650512502944,ECE 65,A50,083695,Staff,0,6,30,30
1650512508967,ECE 109,A01,091882,Touri; Behrouz,35,0,70,35
1650512514991,ECE 180,A00,083140,Abi Samra; Nicholas Camill,21,0,30,9
1650512514991,ECE 180,B00,083141,Abi Samra; Nicholas Camill,0,0,30,30
1650512521024,MATH 10A,A01,083735,Patchell; Gregory David,5,0,30,25
1650512521024,MATH 10A,A02,083736,Patchell; Gregory David,27,0,30,3
1650512521024,MATH 10A,A03,083737,Patchell; Gregory David,24,0,30,6
1650512527059,MATH 10B,A01,083207,Staff,0,9,30,30
1650512527059,MATH 10B,A02,083208,Staff,0,7,30,30
1650512527059,MATH 10B,B01,083739,Staff,13,0,30,17
1650512527059,MATH 10B,B02,083740,Staff,28,0,30,2
1650512533085,MATH 18,A01,083743,Staff,1,0,30,29
1650512533085,MATH 18,A02,083744,Staff,27,0,30,3
1650512533085,MATH 18,A03,083745,Staff,22,0,30,8
1650512533085,MATH 18,A04,083746,Staff,26,0,30,4
1650512533085,MATH 18,B01,083748,Staff,0,12,30,30
1650512533085,MATH 18,B02,083749,Staff,0,12,30,30
1650512533085,MATH 18,B03,083750,Staff,0,11,30,30
1650512533085,MATH 18,B04,083751,Staff,0,12,30,30
1650512539107,MATH 20A,A01,083754,Staff,23,0,40,17
1650512545134,MATH 20B,A01,083756,Staff,0,11,30,30
1650512545134,MATH 20B,A02,083757,Staff,0,11,30,30
1650512551158,MATH 20C,A01,083760,Staff,0,16,30,30
1650512551158,MATH 20C,A02,083761,Staff,2,15,30,28
1650512551158,MATH 20C,B01,083762,Staff,12,0,30,18
1650512551158,MATH 20C,B02,083763,Staff,28,0,30,2
1650512557185,MATH 20D,A01,083765,Staff,0,1,30,30
1650512557185,MATH 20D,A02,083766,Staff,7,0,30,23
1650512557185,MATH 20D,A03,083767,Staff,25,0,30,5
1650512563208,MATH 20E,A01,083771,Staff,6,0,30,24
1650512563208,MATH 20E,A02,083772,Staff,18,0,30,12
1650512563208,MATH 20E,B01,083773,Staff,0,0,30,30
1650512563208,MATH 20E,B02,083774,Staff,10,0,30,20
1650512569233,MATH 103A,A01,083777,Staff,0,14,30,30
1650512569233,MATH 103A,A02,083778,Staff,0,14,30,30
1650512569233,MATH 103A,B01,083779,Staff,0,13,30,30
1650512569233,MATH 103A,B02,083780,Staff,0,13,30,30
1650512575256,MATH 105,A01,085443,Staff,1,23,30,29
1650512581281,MATH 109,A01,083213,Anzaldo; Leesa B,0,7,30,30
1650512581281,MATH 109,A02,083214,Anzaldo; Leesa B,0,7,30,30
1650512581281,MATH 109,B01,083215,Anzaldo; Leesa B,0,5,30,30
1650512581281,MATH 109,B02,083216,Anzaldo; Leesa B,0,6,30,30
1650512587305,MATH 142A,A01,083219,Chow; Bennett,0,16,30,30
1650512587305,MATH 142A,A02,083220,Chow; Bennett,0,14,30,30
1650512587305,MATH 142A,B01,083221,Chow; Bennett,0,13,30,30
1650512587305,MATH 142A,B02,083222,Chow; Bennett,0,13,30,30
1650512593333,MATH 193A,A01,083224,Staff,0,6,30,30
1650512593333,MATH 193A,A02,083225,Staff,0,5,30,30
1650512593333,MATH 193A,A03,083781,Staff,0,5,30,30
1650512593333,MATH 193A,A04,083782,Staff,0,7,30,30
1650512599358,MATH 197,001,091859,McAuley; Julian John,9998,0,9999,1
1650512605416,COGS 9,A01,083615,Staff,0,15,60,60
1650512611443,COGS 11,A01,083617,Boyle; Mary E. T.,19,0,40,21
1650512617466,COGS 13,A01,083071,Staff,0,35,40,40
1650512623489,COGS 14A,A01,092681,Staff,1,26,100,99
1650512629516,COGS 14B,A01,083073,Cheng; Tzu-Han,1,13,50,49
1650512635538,COGS 17,A01,092677,Staff,20,0,75,55
1650512641563,COGS 100,A01,083619,Staff,0,27,60,60
1650512647682,COGS 101A,A01,083621,Davis; Joshua Daniel,0,25,60,60
1650512653709,COGS 101B,A01,091572,Staff,0,4,60,60
1650512659736,COGS 101C,A01,083625,Delgado; Tania,16,0,30,14
1650512665771,COGS 107A,A01,083627,Boyle; Mary E. T.,0,12,60,60
1650512671793,COGS 118A,A01,083075,Staff,0,3,60,60
1650512677818,CSE 3,A50,083646,Miranda; Gregory Joseph,20,0,38,18
1650512677818,CSE 3,A51,083647,Miranda; Gregory Joseph,36,0,37,1
1650512683845,CSE 8A,A50,083650,Miranda; Gregory Joseph,1,30,40,39
1650512689870,CSE 11,A01,083080,Cao; Yingjun,0,92,40,40
1650512695896,CSE 12,A01,083652,Staff,0,17,100,100
1650512701933,CSE 15L,A01,083654,Staff,0,1,50,50
1650512701933,CSE 15L,A02,083655,Staff,0,0,50,50
1650512707959,CSE 20,A01,083657,Staff,51,0,80,29
1650512713992,CSE 30,A01,083084,Eldon; John,0,77,40,40
1650512720016,CSE 100,A01,083659,Cao; Yingjun,0,66,50,50
1650512726044,CSE 134B,A01,083661,Powell; Thomas Allan,0,34,65,65
1650512732066,CSE 140,A01,083663,Staff,0,5,75,75
1650512738090,CSE 140L,A01,083088,Eldon; John,0,11,75,75
1650512744113,CSE 175,A01,083665,Kumar; Rakesh,7,0,25,18
1650512750148,CSE 190,A00,092507,Dubnov; Shlomo,10,0,20,10
1650512756171,ECE 45,A01,083139,Staff,20,19,60,40
1650512762198,ECE 65,A50,083695,Staff,0,6,30,30
1650512768221,ECE 109,A01,091882,Touri; Behrouz,35,0,70,35
1650512774257,ECE 180,A00,083140,Abi Samra; Nicholas Camill,21,0,30,9
1650512774257,ECE 180,B00,083141,Abi Samra; Nicholas Camill,0,0,30,30
1650512780281,MATH 10A,A01,083735,Patchell; Gregory David,5,0,30,25
1650512780281,MATH 10A,A02,083736,Patchell; Gregory David,27,0,30,3
1650512780281,MATH 10A,A03,083737,Patchell; Gregory David,24,0,30,6
1650512786309,MATH 10B,A01,083207,Staff,0,9,30,30
1650512786309,MATH 10B,A02,083208,Staff,0,7,30,30
1650512786309,MATH 10B,B01,083739,Staff,13,0,30,17
1650512786309,MATH 10B,B02,083740,Staff,28,0,30,2
1650512792335,MATH 18,A01,083743,Staff,1,0,30,29
1650512792335,MATH 18,A02,083744,Staff,27,0,30,3
1650512792335,MATH 18,A03,083745,Staff,22,0,30,8
1650512792335,MATH 18,A04,083746,Staff,26,0,30,4
1650512792335,MATH 18,B01,083748,Staff,0,12,30,30
1650512792335,MATH 18,B02,083749,Staff,0,12,30,30
1650512792335,MATH 18,B03,083750,Staff,0,11,30,30
1650512792335,MATH 18,B04,083751,Staff,0,12,30,30
1650512798369,MATH 20A,A01,083754,Staff,23,0,40,17
1650512804392,MATH 20B,A01,083756,Staff,0,11,30,30
1650512804392,MATH 20B,A02,083757,Staff,0,11,30,30
1650512810418,MATH 20C,A01,083760,Staff,0,16,30,30
1650512810418,MATH 20C,A02,083761,Staff,2,15,30,28
1650512810418,MATH 20C,B01,083762,Staff,12,0,30,18
1650512810418,MATH 20C,B02,083763,Staff,28,0,30,2
1650512816442,MATH 20D,A01,083765,Staff,0,1,30,30
1650512816442,MATH 20D,A02,083766,Staff,7,0,30,23
1650512816442,MATH 20D,A03,083767,Staff,25,0,30,5
1650512822465,MATH 20E,A01,083771,Staff,6,0,30,24
1650512822465,MATH 20E,A02,083772,Staff,18,0,30,12
1650512822465,MATH 20E,B01,083773,Staff,0,0,30,30
1650512822465,MATH 20E,B02,083774,Staff,10,0,30,20
1650512828490,MATH 103A,A01,083777,Staff,0,14,30,30
1650512828490,MATH 103A,A02,083778,Staff,0,14,30,30
1650512828490,MATH 103A,B01,083779,Staff,0,13,30,30
1650512828490,MATH 103A,B02,083780,Staff,0,13,30,30
1650512834517,MATH 105,A01,085443,Staff,1,23,30,29
1650512840545,MATH 109,A01,083213,Anzaldo; Leesa B,0,7,30,30
1650512840545,MATH 109,A02,083214,Anzaldo; Leesa B,0,7,30,30
1650512840545,MATH 109,B01,083215,Anzaldo; Leesa B,0,5,30,30
1650512840545,MATH 109,B02,083216,Anzaldo; Leesa B,0,6,30,30
1650512846574,MATH 142A,A01,083219,Chow; Bennett,0,16,30,30
1650512846574,MATH 142A,A02,083220,Chow; Bennett,0,14,30,30
1650512846574,MATH 142A,B01,083221,Chow; Bennett,0,13,30,30
1650512846574,MATH 142A,B02,083222,Chow; Bennett,0,13,30,30
1650512852607,MATH 193A,A01,083224,Staff,0,6,30,30
1650512852607,MATH 193A,A02,083225,Staff,0,5,30,30
1650512852607,MATH 193A,A03,083781,Staff,0,5,30,30
1650512852607,MATH 193A,A04,083782,Staff,0,7,30,30
1650512858631,MATH 197,001,091859,McAuley; Julian John,9998,0,9999,1
1650512864689,COGS 9,A01,083615,Staff,0,15,60,60
1650512870715,COGS 11,A01,083617,Boyle; Mary E. T.,19,0,40,21
1650512876744,COGS 13,A01,083071,Staff,0,35,40,40
1650512882768,COGS 14A,A01,092681,Staff,1,26,100,99
1650512888791,COGS 14B,A01,083073,Cheng; Tzu-Han,1,13,50,49
1650512894815,COGS 17,A01,092677,Staff,20,0,75,55
1650512900842,COGS 100,A01,083619,Staff,0,27,60,60
1650512906870,COGS 101A,A01,083621,Davis; Joshua Daniel,0,25,60,60
1650512912898,COGS 101B,A01,091572,Staff,0,4,60,60
1650512918933,COGS 101C,A01,083625,Delgado; Tania,16,0,30,14
1650512924957,COGS 107A,A01,083627,Boyle; Mary E. T.,0,12,60,60
1650512930981,COGS 118A,A01,083075,Staff,0,3,60,60
1650512937008,CSE 3,A50,083646,Miranda; Gregory Joseph,20,0,38,18
1650512937008,CSE 3,A51,083647,Miranda; Gregory Joseph,36,0,37,1
1650512943032,CSE 8A,A50,083650,Miranda; Gregory Joseph,1,30,40,39
1650512949057,CSE 11,A01,083080,Cao; Yingjun,0,92,40,40
1650512955080,CSE 12,A01,083652,Staff,0,17,100,100
1650512961103,CSE 15L,A01,083654,Staff,0,1,50,50
1650512961103,CSE 15L,A02,083655,Staff,0,0,50,50
1650512967130,CSE 20,A01,083657,Staff,51,0,80,29
1650512973154,CSE 30,A01,083084,Eldon; John,0,77,40,40
1650512979180,CSE 100,A01,083659,Cao; Yingjun,0,66,50,50
1650512985205,CSE 134B,A01,083661,Powell; Thomas Allan,0,34,65,65
1650512991232,CSE 140,A01,083663,Staff,0,5,75,75
1650512997260,CSE 140L,A01,083088,Eldon; John,0,11,75,75
1650513003283,CSE 175,A01,083665,Kumar; Rakesh,7,0,25,18
1650513009306,CSE 190,A00,092507,Dubnov; Shlomo,10,0,20,10
1650513015328,ECE 45,A01,083139,Staff,20,19,60,40
1650513021355,ECE 65,A50,083695,Staff,0,6,30,30
1650513027380,ECE 109,A01,091882,Touri; Behrouz,35,0,70,35
1650513033405,ECE 180,A00,083140,Abi Samra; Nicholas Camill,21,0,30,9
1650513033405,ECE 180,B00,083141,Abi Samra; Nicholas Camill,0,0,30,30
1650513039441,MATH 10A,A01,083735,Patchell; Gregory David,5,0,30,25
1650513039441,MATH 10A,A02,083736,Patchell; Gregory David,27,0,30,3
1650513039441,MATH 10A,A03,083737,Patchell; Gregory David,24,0,30,6
1650513045464,MATH 10B,A01,083207,Staff,0,9,30,30
1650513045464,MATH 10B,A02,083208,Staff,0,7,30,30
1650513045464,MATH 10B,B01,083739,Staff,13,0,30,17
1650513045464,MATH 10B,B02,083740,Staff,28,0,30,2
1650513051496,MATH 18,A01,083743,Staff,1,0,30,29
1650513051496,MATH 18,A02,083744,Staff,27,0,30,3
1650513051496,MATH 18,A03,083745,Staff,22,0,30,8
1650513051496,MATH 18,A04,083746,Staff,26,0,30,4
1650513051496,MATH 18,B01,083748,Staff,0,12,30,30
1650513051496,MATH 18,B02,083749,Staff,0,12,30,30
1650513051496,MATH 18,B03,083750,Staff,0,11,30,30
1650513051496,MATH 18,B04,083751,Staff,0,12,30,30
1650513057521,MATH 20A,A01,083754,Staff,23,0,40,17
1650513063546,MATH 20B,A01,083756,Staff,0,11,30,30
1650513063546,MATH 20B,A02,083757,Staff,0,11,30,30
1650513069573,MATH 20C,A01,083760,Staff,0,16,30,30
1650513069573,MATH 20C,A02,083761,Staff,2,16,30,28
1650513069573,MATH 20C,B01,083762,Staff,12,0,30,18
1650513069573,MATH 20C,B02,083763,Staff,28,0,30,2
1650513075595,MATH 20D,A01,083765,Staff,0,1,30,30
1650513075595,MATH 20D,A02,083766,Staff,7,0,30,23
1650513075595,MATH 20D,A03,083767,Staff,25,0,30,5
1650513081622,MATH 20E,A01,083771,Staff,6,0,30,24
1650513081622,MATH 20E,A02,083772,Staff,18,0,30,12
1650513081622,MATH 20E,B01,083773,Staff,0,0,30,30
1650513081622,MATH 20E,B02,083774,Staff,10,0,30,20
1650513087651,MATH 103A,A01,083777,Staff,0,14,30,30
1650513087651,MATH 103A,A02,083778,Staff,0,14,30,30
1650513087651,MATH 103A,B01,083779,Staff,0,13,30,30
1650513087651,MATH 103A,B02,083780,Staff,0,13,30,30
1650513093678,MATH 105,A01,085443,Staff,1,23,30,29
1650513099706,MATH 109,A01,083213,Anzaldo; Leesa B,0,7,30,30
1650513099706,MATH 109,A02,083214,Anzaldo; Leesa B,0,7,30,30
1650513099706,MATH 109,B01,083215,Anzaldo; Leesa B,0,5,30,30
1650513099706,MATH 109,B02,083216,Anzaldo; Leesa B,0,6,30,30
1650513105752,MATH 142A,A01,083219,Chow; Bennett,0,16,30,30
1650513105752,MATH 142A,A02,083220,Chow; Bennett,0,14,30,30
1650513105752,MATH 142A,B01,083221,Chow; Bennett,0,13,30,30
1650513105752,MATH 142A,B02,083222,Chow; Bennett,0,13,30,30
1650513111780,MATH 193A,A01,083224,Staff,0,6,30,30
1650513111780,MATH 193A,A02,083225,Staff,0,5,30,30
1650513111780,MATH 193A,A03,083781,Staff,0,5,30,30
1650513111780,MATH 193A,A04,083782,Staff,0,7,30,30
1650513117807,MATH 197,001,091859,McAuley; Julian John,9998,0,9999,1
1650513123870,COGS 9,A01,083615,Staff,0,15,60,60
1650513129901,COGS 11,A01,083617,Boyle; Mary E. T.,19,0,40,21
1650513135926,COGS 13,A01,083071,Staff,0,35,40,40
1650513141949,COGS 14A,A01,092681,Staff,1,26,100,99
1650513147977,COGS 14B,A01,083073,Cheng; Tzu-Han,1,13,50,49
1650513154001,COGS 17,A01,092677,Staff,20,0,75,55
1650513160028,COGS 100,A01,083619,Staff,0,27,60,60
1650513166052,COGS 101A,A01,083621,Davis; Joshua Daniel,0,25,60,60
1650513172076,COGS 101B,A01,091572,Staff,0,4,60,60
1650513178104,COGS 101C,A01,083625,Delgado; Tania,16,0,30,14
1650513184127,COGS 107A,A01,083627,Boyle; Mary E. T.,0,12,60,60
1650513190150,COGS 118A,A01,083075,Staff,0,3,60,60
1650513196187,CSE 3,A50,083646,Miranda; Gregory Joseph,20,0,38,18
1650513196187,CSE 3,A51,083647,Miranda; Gregory Joseph,36,0,37,1
1650513202215,CSE 8A,A50,083650,Miranda; Gregory Joseph,1,30,40,39
1650513208239,CSE 11,A01,083080,Cao; Yingjun,0,92,40,40
1650513214265,CSE 12,A01,083652,Staff,0,17,100,100
1650513220289,CSE 15L,A01,083654,Staff,0,1,50,50
1650513220289,CSE 15L,A02,083655,Staff,0,0,50,50
1650513226314,CSE 20,A01,083657,Staff,51,0,80,29
1650513232340,CSE 30,A01,083084,Eldon; John,0,77,40,40
1650513238364,CSE 100,A01,083659,Cao; Yingjun,0,66,50,50
1650513244478,CSE 134B,A01,083661,Powell; Thomas Allan,0,34,65,65
1650513250501,CSE 140,A01,083663,Staff,0,5,75,75
1650513256524,CSE 140L,A01,083088,Eldon; John,0,11,75,75
1650513262549,CSE 175,A01,083665,Kumar; Rakesh,7,0,25,18
1650513268587,CSE 190,A00,092507,Dubnov; Shlomo,10,0,20,10
1650513274613,ECE 45,A01,083139,Staff,20,19,60,40
1650513280638,ECE 65,A50,083695,Staff,0,6,30,30
1650513286661,ECE 109,A01,091882,Touri; Behrouz,35,0,70,35
1650513292686,ECE 180,A00,083140,Abi Samra; Nicholas Camill,21,0,30,9
1650513292686,ECE 180,B00,083141,Abi Samra; Nicholas Camill,0,0,30,30
1650513298713,MATH 10A,A01,083735,Patchell; Gregory David,5,0,30,25
1650513298713,MATH 10A,A02,083736,Patchell; Gregory David,27,0,30,3
1650513298713,MATH 10A,A03,083737,Patchell; Gregory David,24,0,30,6
1650513304740,MATH 10B,A01,083207,Staff,0,9,30,30
1650513304740,MATH 10B,A02,083208,Staff,0,7,30,30
1650513304740,MATH 10B,B01,083739,Staff,13,0,30,17
1650513304740,MATH 10B,B02,083740,Staff,28,0,30,2
1650513310766,MATH 18,A01,083743,Staff,1,0,30,29
1650513310766,MATH 18,A02,083744,Staff,27,0,30,3
1650513310766,MATH 18,A03,083745,Staff,22,0,30,8
1650513310766,MATH 18,A04,083746,Staff,26,0,30,4
1650513310766,MATH 18,B01,083748,Staff,0,12,30,30
1650513310766,MATH 18,B02,083749,Staff,0,12,30,30
1650513310766,MATH 18,B03,083750,Staff,0,11,30,30
1650513310766,MATH 18,B04,083751,Staff,0,12,30,30
1650513316792,MATH 20A,A01,083754,Staff,23,0,40,17
1650513322819,MATH 20B,A01,083756,Staff,0,11,30,30
1650513322819,MATH 20B,A02,083757,Staff,0,11,30,30
1650513328844,MATH 20C,A01,083760,Staff,0,16,30,30
1650513328844,MATH 20C,A02,083761,Staff,2,16,30,28
1650513328844,MATH 20C,B01,083762,Staff,12,0,30,18
1650513328844,MATH 20C,B02,083763,Staff,28,0,30,2
1650513334870,MATH 20D,A01,083765,Staff,0,1,30,30
1650513334870,MATH 20D,A02,083766,Staff,7,0,30,23
1650513334870,MATH 20D,A03,083767,Staff,25,0,30,5
1650513340894,MATH 20E,A01,083771,Staff,6,0,30,24
1650513340894,MATH 20E,A02,083772,Staff,18,0,30,12
1650513340894,MATH 20E,B01,083773,Staff,0,0,30,30
1650513340894,MATH 20E,B02,083774,Staff,10,0,30,20
1650513346920,MATH 103A,A01,083777,Staff,0,14,30,30
1650513346920,MATH 103A,A02,083778,Staff,0,14,30,30
1650513346920,MATH 103A,B01,083779,Staff,0,13,30,30
1650513346920,MATH 103A,B02,083780,Staff,0,13,30,30
1650513352943,MATH 105,A01,085443,Staff,1,23,30,29
1650513358969,MATH 109,A01,083213,Anzaldo; Leesa B,0,7,30,30
1650513358969,MATH 109,A02,083214,Anzaldo; Leesa B,0,7,30,30
1650513358969,MATH 109,B01,083215,Anzaldo; Leesa B,0,5,30,30
1650513358969,MATH 109,B02,083216,Anzaldo; Leesa B,0,6,30,30
1650513365006,MATH 142A,A01,083219,Chow; Bennett,0,16,30,30
1650513365006,MATH 142A,A02,083220,Chow; Bennett,0,14,30,30
1650513365006,MATH 142A,B01,083221,Chow; Bennett,0,13,30,30
1650513365006,MATH 142A,B02,083222,Chow; Bennett,0,13,30,30
1650513371031,MATH 193A,A01,083224,Staff,0,6,30,30
1650513371031,MATH 193A,A02,083225,Staff,0,5,30,30
1650513371031,MATH 193A,A03,083781,Staff,0,5,30,30
1650513371031,MATH 193A,A04,083782,Staff,0,7,30,30
1650513377055,MATH 197,001,091859,McAuley; Julian John,9998,0,9999,1
1650513383107,COGS 9,A01,083615,Staff,0,15,60,60
1650513389129,COGS 11,A01,083617,Boyle; Mary E. T.,19,0,40,21
1650513395154,COGS 13,A01,083071,Staff,0,35,40,40
1650513401178,COGS 14A,A01,092681,Staff,1,26,100,99
1650513407211,COGS 14B,A01,083073,Cheng; Tzu-Han,1,13,50,49
1650513413244,COGS 17,A01,092677,Staff,20,0,75,55
1650513419273,COGS 100,A01,083619,Staff,0,27,60,60
1650513425297,COGS 101A,A01,083621,Davis; Joshua Daniel,0,25,60,60
1650513431319,COGS 101B,A01,091572,Staff,0,4,60,60
1650513437343,COGS 101C,A01,083625,Delgado; Tania,16,0,30,14
1650513443373,COGS 107A,A01,083627,Boyle; Mary E. T.,0,12,60,60
1650513449395,COGS 118A,A01,083075,Staff,0,3,60,60
1650513455420,CSE 3,A50,083646,Miranda; Gregory Joseph,20,0,38,18
1650513455420,CSE 3,A51,083647,Miranda; Gregory Joseph,36,0,37,1
1650513461444,CSE 8A,A50,083650,Miranda; Gregory Joseph,1,30,40,39
1650513467472,CSE 11,A01,083080,Cao; Yingjun,0,92,40,40
1650513473496,CSE 12,A01,083652,Staff,0,17,100,100
1650513479522,CSE 15L,A01,083654,Staff,0,1,50,50
1650513479522,CSE 15L,A02,083655,Staff,0,0,50,50
1650513485548,CSE 20,A01,083657,Staff,51,0,80,29
1650513491572,CSE 30,A01,083084,Eldon; John,0,77,40,40
1650513497599,CSE 100,A01,083659,Cao; Yingjun,0,66,50,50
1650513503622,CSE 134B,A01,083661,Powell; Thomas Allan,0,34,65,65
1650513509644,CSE 140,A01,083663,Staff,0,5,75,75
1650513515666,CSE 140L,A01,083088,Eldon; John,0,11,75,75
1650513521695,CSE 175,A01,083665,Kumar; Rakesh,7,0,25,18
1650513527720,CSE 190,A00,092507,Dubnov; Shlomo,10,0,20,10
1650513533745,ECE 45,A01,083139,Staff,20,19,60,40
1650513539772,ECE 65,A50,083695,Staff,0,6,30,30
1650513545809,ECE 109,A01,091882,Touri; Behrouz,35,0,70,35
1650513551838,ECE 180,A00,083140,Abi Samra; Nicholas Camill,21,0,30,9
1650513551838,ECE 180,B00,083141,Abi Samra; Nicholas Camill,0,0,30,30
1650513557867,MATH 10A,A01,083735,Patchell; Gregory David,5,0,30,25
1650513557867,MATH 10A,A02,083736,Patchell; Gregory David,27,0,30,3
1650513557867,MATH 10A,A03,083737,Patchell; Gregory David,24,0,30,6
1650513563901,MATH 10B,A01,083207,Staff,0,9,30,30
1650513563901,MATH 10B,A02,083208,Staff,0,7,30,30
1650513563901,MATH 10B,B01,083739,Staff,13,0,30,17
1650513563901,MATH 10B,B02,083740,Staff,28,0,30,2
1650513569925,MATH 18,A01,083743,Staff,1,0,30,29
1650513569925,MATH 18,A02,083744,Staff,27,0,30,3
1650513569925,MATH 18,A03,083745,Staff,22,0,30,8
1650513569925,MATH 18,A04,083746,Staff,26,0,30,4
1650513569925,MATH 18,B01,083748,Staff,0,12,30,30
1650513569925,MATH 18,B02,083749,Staff,0,12,30,30
1650513569925,MATH 18,B03,083750,Staff,0,11,30,30
1650513569925,MATH 18,B04,083751,Staff,0,12,30,30
1650513575952,MATH 20A,A01,083754,Staff,23,0,40,17
1650513581977,MATH 20B,A01,083756,Staff,0,11,30,30
1650513581977,MATH 20B,A02,083757,Staff,0,11,30,30
1650513588000,MATH 20C,A01,083760,Staff,0,16,30,30
1650513588000,MATH 20C,A02,083761,Staff,2,16,30,28
1650513588000,MATH 20C,B01,083762,Staff,12,0,30,18
1650513588000,MATH 20C,B02,083763,Staff,28,0,30,2
1650513594027,MATH 20D,A01,083765,Staff,0,1,30,30
1650513594027,MATH 20D,A02,083766,Staff,7,0,30,23
1650513594027,MATH 20D,A03,083767,Staff,25,0,30,5
1650513600056,MATH 20E,A01,083771,Staff,6,0,30,24
1650513600056,MATH 20E,A02,083772,Staff,18,0,30,12
1650513600056,MATH 20E,B01,083773,Staff,0,0,30,30
1650513600056,MATH 20E,B02,083774,Staff,10,0,30,20
1650513606079,MATH 103A,A01,083777,Staff,0,14,30,30
1650513606079,MATH 103A,A02,083778,Staff,0,14,30,30
1650513606079,MATH 103A,B01,083779,Staff,0,13,30,30
1650513606079,MATH 103A,B02,083780,Staff,0,13,30,30
1650513612103,MATH 105,A01,085443,Staff,1,23,30,29
1650513618131,MATH 109,A01,083213,Anzaldo; Leesa B,0,7,30,30
1650513618131,MATH 109,A02,083214,Anzaldo; Leesa B,0,7,30,30
1650513618131,MATH 109,B01,083215,Anzaldo; Leesa B,0,5,30,30
1650513618131,MATH 109,B02,083216,Anzaldo; Leesa B,0,6,30,30
1650513624175,MATH 142A,A01,083219,Chow; Bennett,0,16,30,30
1650513624175,MATH 142A,A02,083220,Chow; Bennett,0,14,30,30
1650513624175,MATH 142A,B01,083221,Chow; Bennett,0,13,30,30
1650513624175,MATH 142A,B02,083222,Chow; Bennett,0,13,30,30
1650513630199,MATH 193A,A01,083224,Staff,0,6,30,30
1650513630199,MATH 193A,A02,083225,Staff,0,5,30,30
1650513630199,MATH 193A,A03,083781,Staff,0,5,30,30
1650513630199,MATH 193A,A04,083782,Staff,0,7,30,30
1650513636223,MATH 197,001,091859,McAuley; Julian John,9998,0,9999,1
1650513642284,COGS 9,A01,083615,Staff,0,15,60,60
1650513648311,COGS 11,A01,083617,Boyle; Mary E. T.,19,0,40,21
1650513654337,COGS 13,A01,083071,Staff,0,35,40,40
1650513660362,COGS 14A,A01,092681,Staff,1,26,100,99
1650513666384,COGS 14B,A01,083073,Cheng; Tzu-Han,1,13,50,49
1650513672410,COGS 17,A01,092677,Staff,20,0,75,55
1650513678436,COGS 100,A01,083619,Staff,0,27,60,60
1650513684462,COGS 101A,A01,083621,Davis; Joshua Daniel,0,25,60,60
1650513690488,COGS 101B,A01,091572,Staff,0,4,60,60
1650513696518,COGS 101C,A01,083625,Delgado; Tania,16,0,30,14
1650513702541,COGS 107A,A01,083627,Boyle; Mary E. T.,0,12,60,60
1650513708576,COGS 118A,A01,083075,Staff,0,3,60,60
1650513714598,CSE 3,A50,083646,Miranda; Gregory Joseph,20,0,38,18
1650513714598,CSE 3,A51,083647,Miranda; Gregory Joseph,36,0,37,1
1650513720625,CSE 8A,A50,083650,Miranda; Gregory Joseph,1,30,40,39
1650513726656,CSE 11,A01,083080,Cao; Yingjun,0,92,40,40
1650513732679,CSE 12,A01,083652,Staff,0,17,100,100
1650513738702,CSE 15L,A01,083654,Staff,0,1,50,50
1650513738702,CSE 15L,A02,083655,Staff,0,0,50,50
1650513744735,CSE 20,A01,083657,Staff,51,0,80,29
1650513750762,CSE 30,A01,083084,Eldon; John,0,77,40,40
1650513756784,CSE 100,A01,083659,Cao; Yingjun,0,66,50,50
1650513762813,CSE 134B,A01,083661,Powell; Thomas Allan,0,34,65,65
1650513768851,CSE 140,A01,083663,Staff,0,5,75,75
1650513774872,CSE 140L,A01,083088,Eldon; John,0,11,75,75
1650513780896,CSE 175,A01,083665,Kumar; Rakesh,7,0,25,18
1650513786921,CSE 190,A00,092507,Dubnov; Shlomo,10,0,20,10
1650513792946,ECE 45,A01,083139,Staff,20,19,60,40
1650513798979,ECE 65,A50,083695,Staff,0,6,30,30
1650513805012,ECE 109,A01,091882,Touri; Behrouz,35,0,70,35
1650513811040,ECE 180,A00,083140,Abi Samra; Nicholas Camill,21,0,30,9
1650513811040,ECE 180,B00,083141,Abi Samra; Nicholas Camill,0,0,30,30
1650513817064,MATH 10A,A01,083735,Patchell; Gregory David,5,0,30,25
1650513817064,MATH 10A,A02,083736,Patchell; Gregory David,27,0,30,3
1650513817064,MATH 10A,A03,083737,Patchell; Gregory David,24,0,30,6
1650513823092,MATH 10B,A01,083207,Staff,0,9,30,30
1650513823092,MATH 10B,A02,083208,Staff,0,7,30,30
1650513823092,MATH 10B,B01,083739,Staff,13,0,30,17
1650513823092,MATH 10B,B02,083740,Staff,28,0,30,2
1650513829117,MATH 18,A01,083743,Staff,1,0,30,29
1650513829117,MATH 18,A02,083744,Staff,27,0,30,3
1650513829117,MATH 18,A03,083745,Staff,22,0,30,8
1650513829117,MATH 18,A04,083746,Staff,26,0,30,4
1650513829117,MATH 18,B01,083748,Staff,0,12,30,30
1650513829117,MATH 18,B02,083749,Staff,0,12,30,30
1650513829117,MATH 18,B03,083750,Staff,0,11,30,30
1650513829117,MATH 18,B04,083751,Staff,0,12,30,30
1650513835139,MATH 20A,A01,083754,Staff,23,0,40,17
1650513841271,MATH 20B,A01,083756,Staff,0,11,30,30
1650513841271,MATH 20B,A02,083757,Staff,0,11,30,30
1650513847299,MATH 20C,A01,083760,Staff,0,16,30,30
1650513847299,MATH 20C,A02,083761,Staff,2,16,30,28
1650513847299,MATH 20C,B01,083762,Staff,12,0,30,18
1650513847299,MATH 20C,B02,083763,Staff,28,0,30,2
1650513853335,MATH 20D,A01,083765,Staff,0,1,30,30
1650513853335,MATH 20D,A02,083766,Staff,7,0,30,23
1650513853335,MATH 20D,A03,083767,Staff,25,0,30,5
1650513859373,MATH 20E,A01,083771,Staff,6,0,30,24
1650513859373,MATH 20E,A02,083772,Staff,18,0,30,12
1650513859373,MATH 20E,B01,083773,Staff,0,0,30,30
1650513859373,MATH 20E,B02,083774,Staff,10,0,30,20
1650513865406,MATH 103A,A01,083777,Staff,0,14,30,30
1650513865406,MATH 103A,A02,083778,Staff,0,14,30,30
1650513865406,MATH 103A,B01,083779,Staff,0,13,30,30
1650513865406,MATH 103A,B02,083780,Staff,0,13,30,30
1650513871430,MATH 105,A01,085443,Staff,1,23,30,29
1650513877457,MATH 109,A01,083213,Anzaldo; Leesa B,0,7,30,30
1650513877457,MATH 109,A02,083214,Anzaldo; Leesa B,0,7,30,30
1650513877457,MATH 109,B01,083215,Anzaldo; Leesa B,0,5,30,30
1650513877457,MATH 109,B02,083216,Anzaldo; Leesa B,0,6,30,30
1650513883481,MATH 142A,A01,083219,Chow; Bennett,0,16,30,30
1650513883481,MATH 142A,A02,083220,Chow; Bennett,0,14,30,30
1650513883481,MATH 142A,B01,083221,Chow; Bennett,0,13,30,30
1650513883481,MATH 142A,B02,083222,Chow; Bennett,0,13,30,30
1650513889508,MATH 193A,A01,083224,Staff,0,6,30,30
1650513889508,MATH 193A,A02,083225,Staff,0,5,30,30
1650513889508,MATH 193A,A03,083781,Staff,0,5,30,30
1650513889508,MATH 193A,A04,083782,Staff,0,7,30,30
1650513895533,MATH 197,001,091859,McAuley; Julian John,9998,0,9999,1
1650513901585,COGS 9,A01,083615,Staff,0,15,60,60
1650513907608,COGS 11,A01,083617,Boyle; Mary E. T.,19,0,40,21
1650513913631,COGS 13,A01,083071,Staff,0,35,40,40
1650513919659,COGS 14A,A01,092681,Staff,1,26,100,99
1650513925682,COGS 14B,A01,083073,Cheng; Tzu-Han,1,13,50,49
1650513931705,COGS 17,A01,092677,Staff,20,0,75,55
1650513937729,COGS 100,A01,083619,Staff,0,27,60,60
1650513943757,COGS 101A,A01,083621,Davis; Joshua Daniel,0,25,60,60
1650513949784,COGS 101B,A01,091572,Staff,0,4,60,60
1650513955809,COGS 101C,A01,083625,Delgado; Tania,16,0,30,14
1650513961836,COGS 107A,A01,083627,Boyle; Mary E. T.,0,12,60,60
1650513967865,COGS 118A,A01,083075,Staff,0,3,60,60
1650513973894,CSE 3,A50,083646,Miranda; Gregory Joseph,20,0,38,18
1650513973894,CSE 3,A51,083647,Miranda; Gregory Joseph,36,0,37,1
1650513979923,CSE 8A,A50,083650,Miranda; Gregory Joseph,1,30,40,39
1650513985950,CSE 11,A01,083080,Cao; Yingjun,0,92,40,40
1650513991972,CSE 12,A01,083652,Staff,0,17,100,100
1650513997997,CSE 15L,A01,083654,Staff,0,1,50,50
1650513997997,CSE 15L,A02,083655,Staff,0,0,50,50
1650514004021,CSE 20,A01,083657,Staff,51,0,80,29
1650514010047,CSE 30,A01,083084,Eldon; John,0,77,40,40
1650514016069,CSE 100,A01,083659,Cao; Yingjun,0,66,50,50
1650514022099,CSE 134B,A01,083661,Powell; Thomas Allan,0,34,65,65
1650514028125,CSE 140,A01,083663,Staff,0,5,75,75
1650514034168,CSE 140L,A01,083088,Eldon; John,0,11,75,75
1650514040190,CSE 175,A01,083665,Kumar; Rakesh,7,0,25,18
1650514046216,CSE 190,A00,092507,Dubnov; Shlomo,10,0,20,10
1650514052241,ECE 45,A01,083139,Staff,20,19,60,40
1650514058268,ECE 65,A50,083695,Staff,0,6,30,30
1650514064293,ECE 109,A01,091882,Touri; Behrouz,35,0,70,35
1650514070316,ECE 180,A00,083140,Abi Samra; Nicholas Camill,21,0,30,9
1650514070316,ECE 180,B00,083141,Abi Samra; Nicholas Camill,0,0,30,30
1650514076341,MATH 10A,A01,083735,Patchell; Gregory David,5,0,30,25
1650514076341,MATH 10A,A02,083736,Patchell; Gregory David,27,0,30,3
1650514076341,MATH 10A,A03,083737,Patchell; Gregory David,24,0,30,6
1650514082369,MATH 10B,A01,083207,Staff,0,9,30,30
1650514082369,MATH 10B,A02,083208,Staff,0,7,30,30
1650514082369,MATH 10B,B01,083739,Staff,13,0,30,17
1650514082369,MATH 10B,B02,083740,Staff,28,0,30,2
1650514088399,MATH 18,A01,083743,Staff,1,0,30,29
1650514088399,MATH 18,A02,083744,Staff,27,0,30,3
1650514088399,MATH 18,A03,083745,Staff,22,0,30,8
1650514088399,MATH 18,A04,083746,Staff,26,0,30,4
1650514088399,MATH 18,B01,083748,Staff,0,12,30,30
1650514088399,MATH 18,B02,083749,Staff,0,12,30,30
1650514088399,MATH 18,B03,083750,Staff,0,11,30,30
1650514088399,MATH 18,B04,083751,Staff,0,12,30,30
1650514094425,MATH 20A,A01,083754,Staff,23,0,40,17
1650514100454,MATH 20B,A01,083756,Staff,0,11,30,30
1650514100454,MATH 20B,A02,083757,Staff,0,11,30,30
1650514106478,MATH 20C,A01,083760,Staff,0,16,30,30
1650514106478,MATH 20C,A02,083761,Staff,2,16,30,28
1650514106478,MATH 20C,B01,083762,Staff,12,0,30,18
1650514106478,MATH 20C,B02,083763,Staff,28,0,30,2
1650514112511,MATH 20D,A01,083765,Staff,0,1,30,30
1650514112511,MATH 20D,A02,083766,Staff,7,0,30,23
1650514112511,MATH 20D,A03,083767,Staff,25,0,30,5
1650514118536,MATH 20E,A01,083771,Staff,6,0,30,24
1650514118536,MATH 20E,A02,083772,Staff,18,0,30,12
1650514118536,MATH 20E,B01,083773,Staff,0,0,30,30
1650514118536,MATH 20E,B02,083774,Staff,10,0,30,20
1650514124568,MATH 103A,A01,083777,Staff,0,14,30,30
1650514124568,MATH 103A,A02,083778,Staff,0,14,30,30
1650514124568,MATH 103A,B01,083779,Staff,0,13,30,30
1650514124568,MATH 103A,B02,083780,Staff,0,13,30,30
1650514130591,MATH 105,A01,085443,Staff,1,23,30,29
1650514136617,MATH 109,A01,083213,Anzaldo; Leesa B,0,7,30,30
1650514136617,MATH 109,A02,083214,Anzaldo; Leesa B,0,7,30,30
1650514136617,MATH 109,B01,083215,Anzaldo; Leesa B,0,5,30,30
1650514136617,MATH 109,B02,083216,Anzaldo; Leesa B,0,6,30,30
1650514142639,MATH 142A,A01,083219,Chow; Bennett,0,16,30,30
1650514142639,MATH 142A,A02,083220,Chow; Bennett,0,14,30,30
1650514142639,MATH 142A,B01,083221,Chow; Bennett,0,13,30,30
1650514142639,MATH 142A,B02,083222,Chow; Bennett,0,13,30,30
1650514148676,MATH 193A,A01,083224,Staff,0,6,30,30
1650514148676,MATH 193A,A02,083225,Staff,0,5,30,30
1650514148676,MATH 193A,A03,083781,Staff,0,5,30,30
1650514148676,MATH 193A,A04,083782,Staff,0,7,30,30
1650514154702,MATH 197,001,091859,McAuley; Julian John,9998,0,9999,1
1650514160764,COGS 9,A01,083615,Staff,0,15,60,60
1650514166786,COGS 11,A01,083617,Boyle; Mary E. T.,19,0,40,21
1650514172814,COGS 13,A01,083071,Staff,0,35,40,40
1650514178837,COGS 14A,A01,092681,Staff,1,26,100,99
1650514184861,COGS 14B,A01,083073,Cheng; Tzu-Han,1,13,50,49
1650514190884,COGS 17,A01,092677,Staff,20,0,75,55
1650514196908,COGS 100,A01,083619,Staff,0,27,60,60
1650514202931,COGS 101A,A01,083621,Davis; Joshua Daniel,0,25,60,60
1650514208955,COGS 101B,A01,091572,Staff,0,4,60,60
1650514214994,COGS 101C,A01,083625,Delgado; Tania,16,0,30,14
1650514221027,COGS 107A,A01,083627,Boyle; Mary E. T.,0,12,60,60
1650514227054,COGS 118A,A01,083075,Staff,0,3,60,60
1650514233088,CSE 3,A50,083646,Miranda; Gregory Joseph,20,0,38,18
1650514233088,CSE 3,A51,083647,Miranda; Gregory Joseph,36,0,37,1
1650514239116,CSE 8A,A50,083650,Miranda; Gregory Joseph,1,30,40,39
1650514245139,CSE 11,A01,083080,Cao; Yingjun,0,92,40,40
1650514251163,CSE 12,A01,083652,Staff,0,17,100,100
1650514257187,CSE 15L,A01,083654,Staff,0,1,50,50
1650514257187,CSE 15L,A02,083655,Staff,0,0,50,50
1650514263215,CSE 20,A01,083657,Staff,51,0,80,29
1650514269238,CSE 30,A01,083084,Eldon; John,0,77,40,40
1650514275267,CSE 100,A01,083659,Cao; Yingjun,0,66,50,50
1650514281290,CSE 134B,A01,083661,Powell; Thomas Allan,0,34,65,65
1650514287316,CSE 140,A01,083663,Staff,0,5,75,75
1650514293340,CSE 140L,A01,083088,Eldon; John,0,11,75,75
1650514299363,CSE 175,A01,083665,Kumar; Rakesh,7,0,25,18
1650514305387,CSE 190,A00,092507,Dubnov; Shlomo,10,0,20,10
1650514311416,ECE 45,A01,083139,Staff,20,19,60,40
1650514317439,ECE 65,A50,083695,Staff,0,6,30,30
1650514323466,ECE 109,A01,091882,Touri; Behrouz,35,0,70,35
1650514329491,ECE 180,A00,083140,Abi Samra; Nicholas Camill,21,0,30,9
1650514329491,ECE 180,B00,083141,Abi Samra; Nicholas Camill,0,0,30,30
1650514335513,MATH 10A,A01,083735,Patchell; Gregory David,5,0,30,25
1650514335513,MATH 10A,A02,083736,Patchell; Gregory David,27,0,30,3
1650514335513,MATH 10A,A03,083737,Patchell; Gregory David,24,0,30,6
1650514341535,MATH 10B,A01,083207,Staff,0,9,30,30
1650514341535,MATH 10B,A02,083208,Staff,0,7,30,30
1650514341535,MATH 10B,B01,083739,Staff,13,0,30,17
1650514341535,MATH 10B,B02,083740,Staff,28,0,30,2
1650514347567,MATH 18,A01,083743,Staff,1,0,30,29
1650514347567,MATH 18,A02,083744,Staff,27,0,30,3
1650514347567,MATH 18,A03,083745,Staff,22,0,30,8
1650514347567,MATH 18,A04,083746,Staff,26,0,30,4
1650514347567,MATH 18,B01,083748,Staff,0,12,30,30
1650514347567,MATH 18,B02,083749,Staff,0,12,30,30
1650514347567,MATH 18,B03,083750,Staff,0,11,30,30
1650514347567,MATH 18,B04,083751,Staff,0,12,30,30
1650514353591,MATH 20A,A01,083754,Staff,23,0,40,17
1650514359617,MATH 20B,A01,083756,Staff,0,11,30,30
1650514359617,MATH 20B,A02,083757,Staff,0,11,30,30
1650514365642,MATH 20C,A01,083760,Staff,0,16,30,30
1650514365642,MATH 20C,A02,083761,Staff,2,16,30,28
1650514365642,MATH 20C,B01,083762,Staff,12,0,30,18
1650514365642,MATH 20C,B02,083763,Staff,28,0,30,2
1650514371666,MATH 20D,A01,083765,Staff,0,1,30,30
1650514371666,MATH 20D,A02,083766,Staff,7,0,30,23
1650514371666,MATH 20D,A03,083767,Staff,25,0,30,5
1650514377700,MATH 20E,A01,083771,Staff,6,0,30,24
1650514377700,MATH 20E,A02,083772,Staff,18,0,30,12
1650514377700,MATH 20E,B01,083773,Staff,0,0,30,30
1650514377700,MATH 20E,B02,083774,Staff,10,0,30,20
1650514383727,MATH 103A,A01,083777,Staff,0,14,30,30
1650514383727,MATH 103A,A02,083778,Staff,0,14,30,30
1650514383727,MATH 103A,B01,083779,Staff,0,13,30,30
1650514383727,MATH 103A,B02,083780,Staff,0,13,30,30
1650514389752,MATH 105,A01,085443,Staff,1,23,30,29
1650514395776,MATH 109,A01,083213,Anzaldo; Leesa B,0,7,30,30
1650514395776,MATH 109,A02,083214,Anzaldo; Leesa B,0,7,30,30
1650514395776,MATH 109,B01,083215,Anzaldo; Leesa B,0,5,30,30
1650514395776,MATH 109,B02,083216,Anzaldo; Leesa B,0,6,30,30
1650514401801,MATH 142A,A01,083219,Chow; Bennett,0,16,30,30
1650514401801,MATH 142A,A02,083220,Chow; Bennett,0,14,30,30
1650514401801,MATH 142A,B01,083221,Chow; Bennett,0,13,30,30
1650514401801,MATH 142A,B02,083222,Chow; Bennett,0,13,30,30
1650514407828,MATH 193A,A01,083224,Staff,0,6,30,30
1650514407828,MATH 193A,A02,083225,Staff,0,5,30,30
1650514407828,MATH 193A,A03,083781,Staff,0,5,30,30
1650514407828,MATH 193A,A04,083782,Staff,0,7,30,30
1650514413852,MATH 197,001,091859,McAuley; Julian John,9998,0,9999,1
1650514419909,COGS 9,A01,083615,Staff,0,15,60,60
1650514425934,COGS 11,A01,083617,Boyle; Mary E. T.,19,0,40,21
1650514432047,COGS 13,A01,083071,Staff,0,35,40,40
1650514438070,COGS 14A,A01,092681,Staff,1,26,100,99
1650514444096,COGS 14B,A01,083073,Cheng; Tzu-Han,1,13,50,49
1650514450122,COGS 17,A01,092677,Staff,20,0,75,55
1650514456147,COGS 100,A01,083619,Staff,0,27,60,60
1650514462172,COGS 101A,A01,083621,Davis; Joshua Daniel,0,25,60,60
1650514468199,COGS 101B,A01,091572,Staff,0,4,60,60
1650514474222,COGS 101C,A01,083625,Delgado; Tania,16,0,30,14
1650514480246,COGS 107A,A01,083627,Boyle; Mary E. T.,0,12,60,60
1650514486271,COGS 118A,A01,083075,Staff,0,3,60,60
1650514492294,CSE 3,A50,083646,Miranda; Gregory Joseph,20,0,38,18
1650514492294,CSE 3,A51,083647,Miranda; Gregory Joseph,36,0,37,1
1650514498323,CSE 8A,A50,083650,Miranda; Gregory Joseph,1,30,40,39
1650514504348,CSE 11,A01,083080,Cao; Yingjun,0,92,40,40
1650514510390,CSE 12,A01,083652,Staff,0,17,100,100
1650514516414,CSE 15L,A01,083654,Staff,0,1,50,50
1650514516414,CSE 15L,A02,083655,Staff,0,0,50,50
1650514522439,CSE 20,A01,083657,Staff,51,0,80,29
1650514528471,CSE 30,A01,083084,Eldon; John,0,77,40,40
1650514534493,CSE 100,A01,083659,Cao; Yingjun,0,66,50,50
1650514540522,CSE 134B,A01,083661,Powell; Thomas Allan,0,34,65,65
1650514546546,CSE 140,A01,083663,Staff,0,5,75,75
1650514552571,CSE 140L,A01,083088,Eldon; John,0,11,75,75
1650514558597,CSE 175,A01,083665,Kumar; Rakesh,7,0,25,18
1650514564622,CSE 190,A00,092507,Dubnov; Shlomo,10,0,20,10
1650514570649,ECE 45,A01,083139,Staff,20,19,60,40
1650514576673,ECE 65,A50,083695,Staff,0,6,30,30
1650514582695,ECE 109,A01,091882,Touri; Behrouz,35,0,70,35
1650514588726,ECE 180,A00,083140,Abi Samra; Nicholas Camill,21,0,30,9
1650514588726,ECE 180,B00,083141,Abi Samra; Nicholas Camill,0,0,30,30
1650514594753,MATH 10A,A01,083735,Patchell; Gregory David,5,0,30,25
1650514594753,MATH 10A,A02,083736,Patchell; Gregory David,27,0,30,3
1650514594753,MATH 10A,A03,083737,Patchell; Gregory David,24,0,30,6
1650514600778,MATH 10B,A01,083207,Staff,0,9,30,30
1650514600778,MATH 10B,A02,083208,Staff,0,7,30,30
1650514600778,MATH 10B,B01,083739,Staff,13,0,30,17
1650514600778,MATH 10B,B02,083740,Staff,28,0,30,2
1650514606807,MATH 18,A01,083743,Staff,1,0,30,29
1650514606807,MATH 18,A02,083744,Staff,27,0,30,3
1650514606807,MATH 18,A03,083745,Staff,22,0,30,8
1650514606807,MATH 18,A04,083746,Staff,26,0,30,4
1650514606807,MATH 18,B01,083748,Staff,0,12,30,30
1650514606807,MATH 18,B02,083749,Staff,0,12,30,30
1650514606807,MATH 18,B03,083750,Staff,0,11,30,30
1650514606807,MATH 18,B04,083751,Staff,0,12,30,30
1650514612830,MATH 20A,A01,083754,Staff,23,0,40,17
1650514618858,MATH 20B,A01,083756,Staff,0,11,30,30
1650514618858,MATH 20B,A02,083757,Staff,0,11,30,30
1650514624885,MATH 20C,A01,083760,Staff,0,16,30,30
1650514624885,MATH 20C,A02,083761,Staff,2,16,30,28
1650514624885,MATH 20C,B01,083762,Staff,12,0,30,18
1650514624885,MATH 20C,B02,083763,Staff,28,0,30,2
1650514630912,MATH 20D,A01,083765,Staff,0,1,30,30
1650514630912,MATH 20D,A02,083766,Staff,7,0,30,23
1650514630912,MATH 20D,A03,083767,Staff,25,0,30,5
1650514636934,MATH 20E,A01,083771,Staff,6,0,30,24
1650514636934,MATH 20E,A02,083772,Staff,18,0,30,12
1650514636934,MATH 20E,B01,083773,Staff,0,0,30,30
1650514636934,MATH 20E,B02,083774,Staff,10,0,30,20
1650514642962,MATH 103A,A01,083777,Staff,0,14,30,30
1650514642962,MATH 103A,A02,083778,Staff,0,14,30,30
1650514642962,MATH 103A,B01,083779,Staff,0,13,30,30
1650514642962,MATH 103A,B02,083780,Staff,0,13,30,30
1650514648987,MATH 105,A01,085443,Staff,1,23,30,29
1650514655023,MATH 109,A01,083213,Anzaldo; Leesa B,0,7,30,30
1650514655023,MATH 109,A02,083214,Anzaldo; Leesa B,0,7,30,30
1650514655023,MATH 109,B01,083215,Anzaldo; Leesa B,0,5,30,30
1650514655023,MATH 109,B02,083216,Anzaldo; Leesa B,0,6,30,30
1650514661048,MATH 142A,A01,083219,Chow; Bennett,0,16,30,30
1650514661048,MATH 142A,A02,083220,Chow; Bennett,0,14,30,30
1650514661048,MATH 142A,B01,083221,Chow; Bennett,0,13,30,30
1650514661048,MATH 142A,B02,083222,Chow; Bennett,0,13,30,30
1650514667075,MATH 193A,A01,083224,Staff,0,6,30,30
1650514667075,MATH 193A,A02,083225,Staff,0,5,30,30
1650514667075,MATH 193A,A03,083781,Staff,0,5,30,30
1650514667075,MATH 193A,A04,083782,Staff,0,7,30,30
1650514673097,MATH 197,001,091859,McAuley; Julian John,9998,0,9999,1
1650514679150,COGS 9,A01,083615,Staff,0,15,60,60
1650514685178,COGS 11,A01,083617,Boyle; Mary E. T.,19,0,40,21
1650514691201,COGS 13,A01,083071,Staff,0,35,40,40
1650514697227,COGS 14A,A01,092681,Staff,1,26,100,99
1650514703255,COGS 14B,A01,083073,Cheng; Tzu-Han,1,13,50,49
1650514709279,COGS 17,A01,092677,Staff,20,0,75,55
1650514715303,COGS 100,A01,083619,Staff,0,28,60,60
1650514721329,COGS 101A,A01,083621,Davis; Joshua Daniel,0,25,60,60
1650514727356,COGS 101B,A01,091572,Staff,0,4,60,60
1650514733381,COGS 101C,A01,083625,Delgado; Tania,16,0,30,14
1650514739407,COGS 107A,A01,083627,Boyle; Mary E. T.,0,12,60,60
1650514745431,COGS 118A,A01,083075,Staff,0,3,60,60
1650514751459,CSE 3,A50,083646,Miranda; Gregory Joseph,20,0,38,18
1650514751459,CSE 3,A51,083647,Miranda; Gregory Joseph,36,0,37,1
1650514757486,CSE 8A,A50,083650,Miranda; Gregory Joseph,1,30,40,39
1650514763517,CSE 11,A01,083080,Cao; Yingjun,0,92,40,40
1650514769542,CSE 12,A01,083652,Staff,0,17,100,100
1650514775568,CSE 15L,A01,083654,Staff,0,1,50,50
1650514775568,CSE 15L,A02,083655,Staff,0,0,50,50
1650514781599,CSE 20,A01,083657,Staff,51,0,80,29
1650514787623,CSE 30,A01,083084,Eldon; John,0,77,40,40
1650514793737,CSE 100,A01,083659,Cao; Yingjun,0,66,50,50
1650514799765,CSE 134B,A01,083661,Powell; Thomas Allan,0,34,65,65
1650514805792,CSE 140,A01,083663,Staff,0,5,75,75
1650514811819,CSE 140L,A01,083088,Eldon; John,0,11,75,75
1650514817843,CSE 175,A01,083665,Kumar; Rakesh,7,0,25,18
1650514823869,CSE 190,A00,092507,Dubnov; Shlomo,10,0,20,10
1650514829895,ECE 45,A01,083139,Staff,20,19,60,40
1650514835919,ECE 65,A50,083695,Staff,0,6,30,30
1650514841950,ECE 109,A01,091882,Touri; Behrouz,35,0,70,35
1650514847975,ECE 180,A00,083140,Abi Samra; Nicholas Camill,21,0,30,9
1650514847975,ECE 180,B00,083141,Abi Samra; Nicholas Camill,0,0,30,30
1650514854006,MATH 10A,A01,083735,Patchell; Gregory David,5,0,30,25
1650514854006,MATH 10A,A02,083736,Patchell; Gregory David,27,0,30,3
1650514854006,MATH 10A,A03,083737,Patchell; Gregory David,24,0,30,6
1650514860030,MATH 10B,A01,083207,Staff,0,9,30,30
1650514860030,MATH 10B,A02,083208,Staff,0,7,30,30
1650514860030,MATH 10B,B01,083739,Staff,13,0,30,17
1650514860030,MATH 10B,B02,083740,Staff,28,0,30,2
1650514866061,MATH 18,A01,083743,Staff,1,0,30,29
1650514866061,MATH 18,A02,083744,Staff,27,0,30,3
1650514866061,MATH 18,A03,083745,Staff,22,0,30,8
1650514866061,MATH 18,A04,083746,Staff,26,0,30,4
1650514866061,MATH 18,B01,083748,Staff,0,12,30,30
1650514866061,MATH 18,B02,083749,Staff,0,12,30,30
1650514866061,MATH 18,B03,083750,Staff,0,11,30,30
1650514866061,MATH 18,B04,083751,Staff,0,12,30,30
1650514872082,MATH 20A,A01,083754,Staff,23,0,40,17
1650514878106,MATH 20B,A01,083756,Staff,0,11,30,30
1650514878106,MATH 20B,A02,083757,Staff,0,11,30,30
1650514884136,MATH 20C,A01,083760,Staff,0,16,30,30
1650514884136,MATH 20C,A02,083761,Staff,2,16,30,28
1650514884136,MATH 20C,B01,083762,Staff,12,0,30,18
1650514884136,MATH 20C,B02,083763,Staff,28,0,30,2
1650514890159,MATH 20D,A01,083765,Staff,0,1,30,30
1650514890159,MATH 20D,A02,083766,Staff,7,0,30,23
1650514890159,MATH 20D,A03,083767,Staff,25,0,30,5
1650514896201,MATH 20E,A01,083771,Staff,6,0,30,24
1650514896201,MATH 20E,A02,083772,Staff,18,0,30,12
1650514896201,MATH 20E,B01,083773,Staff,0,0,30,30
1650514896201,MATH 20E,B02,083774,Staff,10,0,30,20
1650514902225,MATH 103A,A01,083777,Staff,0,14,30,30
1650514902225,MATH 103A,A02,083778,Staff,0,14,30,30
1650514902225,MATH 103A,B01,083779,Staff,0,13,30,30
1650514902225,MATH 103A,B02,083780,Staff,0,13,30,30
1650514908257,MATH 105,A01,085443,Staff,1,23,30,29
1650514914289,MATH 109,A01,083213,Anzaldo; Leesa B,0,7,30,30
1650514914289,MATH 109,A02,083214,Anzaldo; Leesa B,0,7,30,30
1650514914289,MATH 109,B01,083215,Anzaldo; Leesa B,0,5,30,30
1650514914289,MATH 109,B02,083216,Anzaldo; Leesa B,0,6,30,30
1650514920323,MATH 142A,A01,083219,Chow; Bennett,0,16,30,30
1650514920323,MATH 142A,A02,083220,Chow; Bennett,0,14,30,30
1650514920323,MATH 142A,B01,083221,Chow; Bennett,0,13,30,30
1650514920323,MATH 142A,B02,083222,Chow; Bennett,0,13,30,30
1650514926351,MATH 193A,A01,083224,Staff,0,6,30,30
1650514926351,MATH 193A,A02,083225,Staff,0,5,30,30
1650514926351,MATH 193A,A03,083781,Staff,0,5,30,30
1650514926351,MATH 193A,A04,083782,Staff,0,7,30,30
1650514932374,MATH 197,001,091859,McAuley; Julian John,9998,0,9999,1
1650514938432,COGS 9,A01,083615,Staff,0,15,60,60
1650514944455,COGS 11,A01,083617,Boyle; Mary E. T.,19,0,40,21
1650514950489,COGS 13,A01,083071,Staff,0,35,40,40
1650514956516,COGS 14A,A01,092681,Staff,1,26,100,99
1650514962540,COGS 14B,A01,083073,Cheng; Tzu-Han,1,13,50,49
1650514968563,COGS 17,A01,092677,Staff,20,0,75,55
1650514974586,COGS 100,A01,083619,Staff,0,27,60,60
1650514980613,COGS 101A,A01,083621,Davis; Joshua Daniel,0,25,60,60
1650514986636,COGS 101B,A01,091572,Staff,0,4,60,60
1650514992658,COGS 101C,A01,083625,Delgado; Tania,16,0,30,14
1650514998682,COGS 107A,A01,083627,Boyle; Mary E. T.,0,12,60,60
1650515004714,COGS 118A,A01,083075,Staff,0,3,60,60
1650515010737,CSE 3,A50,083646,Miranda; Gregory Joseph,20,0,38,18
1650515010737,CSE 3,A51,083647,Miranda; Gregory Joseph,36,0,37,1
1650515016761,CSE 8A,A50,083650,Miranda; Gregory Joseph,1,30,40,39
1650515022784,CSE 11,A01,083080,Cao; Yingjun,0,92,40,40
1650515028904,CSE 12,A01,083652,Staff,0,17,100,100
1650515034934,CSE 15L,A01,083654,Staff,0,1,50,50
1650515034934,CSE 15L,A02,083655,Staff,0,0,50,50
1650515040959,CSE 20,A01,083657,Staff,51,0,80,29
1650515046983,CSE 30,A01,083084,Eldon; John,0,77,40,40
1650515053012,CSE 100,A01,083659,Cao; Yingjun,0,66,50,50
1650515059039,CSE 134B,A01,083661,Powell; Thomas Allan,0,34,65,65
1650515065070,CSE 140,A01,083663,Staff,0,5,75,75
1650515071099,CSE 140L,A01,083088,Eldon; John,0,11,75,75
1650515077123,CSE 175,A01,083665,Kumar; Rakesh,7,0,25,18
1650515083151,CSE 190,A00,092507,Dubnov; Shlomo,10,0,20,10
1650515089178,ECE 45,A01,083139,Staff,20,19,60,40
1650515095203,ECE 65,A50,083695,Staff,0,6,30,30
1650515101239,ECE 109,A01,091882,Touri; Behrouz,35,0,70,35
1650515107263,ECE 180,A00,083140,Abi Samra; Nicholas Camill,21,0,30,9
1650515107263,ECE 180,B00,083141,Abi Samra; Nicholas Camill,0,0,30,30
1650515113293,MATH 10A,A01,083735,Patchell; Gregory David,5,0,30,25
1650515113293,MATH 10A,A02,083736,Patchell; Gregory David,27,0,30,3
1650515113293,MATH 10A,A03,083737,Patchell; Gregory David,24,0,30,6
1650515119320,MATH 10B,A01,083207,Staff,0,9,30,30
1650515119320,MATH 10B,A02,083208,Staff,0,7,30,30
1650515119320,MATH 10B,B01,083739,Staff,13,0,30,17
1650515119320,MATH 10B,B02,083740,Staff,28,0,30,2
1650515125356,MATH 18,A01,083743,Staff,1,0,30,29
1650515125356,MATH 18,A02,083744,Staff,27,0,30,3
1650515125356,MATH 18,A03,083745,Staff,22,0,30,8
1650515125356,MATH 18,A04,083746,Staff,26,0,30,4
1650515125356,MATH 18,B01,083748,Staff,0,12,30,30
1650515125356,MATH 18,B02,083749,Staff,0,12,30,30
1650515125356,MATH 18,B03,083750,Staff,0,11,30,30
1650515125356,MATH 18,B04,083751,Staff,0,12,30,30
1650515131379,MATH 20A,A01,083754,Staff,23,0,40,17
1650515137407,MATH 20B,A01,083756,Staff,0,11,30,30
1650515137407,MATH 20B,A02,083757,Staff,0,11,30,30
1650515143431,MATH 20C,A01,083760,Staff,0,16,30,30
1650515143431,MATH 20C,A02,083761,Staff,2,16,30,28
1650515143431,MATH 20C,B01,083762,Staff,12,0,30,18
1650515143431,MATH 20C,B02,083763,Staff,28,0,30,2
1650515149457,MATH 20D,A01,083765,Staff,0,1,30,30
1650515149457,MATH 20D,A02,083766,Staff,7,0,30,23
1650515149457,MATH 20D,A03,083767,Staff,25,0,30,5
1650515155481,MATH 20E,A01,083771,Staff,6,0,30,24
1650515155481,MATH 20E,A02,083772,Staff,18,0,30,12
1650515155481,MATH 20E,B01,083773,Staff,0,0,30,30
1650515155481,MATH 20E,B02,083774,Staff,10,0,30,20
1650515161506,MATH 103A,A01,083777,Staff,0,14,30,30
1650515161506,MATH 103A,A02,083778,Staff,0,14,30,30
1650515161506,MATH 103A,B01,083779,Staff,0,13,30,30
1650515161506,MATH 103A,B02,083780,Staff,0,13,30,30
1650515167532,MATH 105,A01,085443,Staff,1,23,30,29
1650515173557,MATH 109,A01,083213,Anzaldo; Leesa B,0,7,30,30
1650515173557,MATH 109,A02,083214,Anzaldo; Leesa B,0,7,30,30
1650515173557,MATH 109,B01,083215,Anzaldo; Leesa B,0,5,30,30
1650515173557,MATH 109,B02,083216,Anzaldo; Leesa B,0,6,30,30
1650515179585,MATH 142A,A01,083219,Chow; Bennett,0,16,30,30
1650515179585,MATH 142A,A02,083220,Chow; Bennett,0,14,30,30
1650515179585,MATH 142A,B01,083221,Chow; Bennett,0,13,30,30
1650515179585,MATH 142A,B02,083222,Chow; Bennett,0,13,30,30
1650515185617,MATH 193A,A01,083224,Staff,0,6,30,30
1650515185617,MATH 193A,A02,083225,Staff,0,5,30,30
1650515185617,MATH 193A,A03,083781,Staff,0,5,30,30
1650515185617,MATH 193A,A04,083782,Staff,0,7,30,30
1650515191638,MATH 197,001,091859,McAuley; Julian John,9998,0,9999,1
1650515197696,COGS 9,A01,083615,Staff,0,15,60,60
1650515203720,COGS 11,A01,083617,Boyle; Mary E. T.,19,0,40,21
1650515209746,COGS 13,A01,083071,Staff,0,35,40,40
1650515215769,COGS 14A,A01,092681,Staff,1,26,100,99
1650515221794,COGS 14B,A01,083073,Cheng; Tzu-Han,1,13,50,49
1650515227833,COGS 17,A01,092677,Staff,20,0,75,55
1650515233856,COGS 100,A01,083619,Staff,0,27,60,60
1650515239886,COGS 101A,A01,083621,Davis; Joshua Daniel,0,25,60,60
1650515245912,COGS 101B,A01,091572,Staff,0,4,60,60
1650515251935,COGS 101C,A01,083625,Delgado; Tania,16,0,30,14
1650515257963,COGS 107A,A01,083627,Boyle; Mary E. T.,0,12,60,60
1650515263991,COGS 118A,A01,083075,Staff,0,3,60,60
1650515270024,CSE 3,A50,083646,Miranda; Gregory Joseph,20,0,38,18
1650515270024,CSE 3,A51,083647,Miranda; Gregory Joseph,36,0,37,1
1650515276048,CSE 8A,A50,083650,Miranda; Gregory Joseph,1,30,40,39
1650515282072,CSE 11,A01,083080,Cao; Yingjun,0,92,40,40
1650515288102,CSE 12,A01,083652,Staff,0,17,100,100
1650515294126,CSE 15L,A01,083654,Staff,0,1,50,50
1650515294126,CSE 15L,A02,083655,Staff,0,0,50,50
1650515300150,CSE 20,A01,083657,Staff,51,0,80,29
1650515306172,CSE 30,A01,083084,Eldon; John,0,77,40,40
1650515312195,CSE 100,A01,083659,Cao; Yingjun,0,66,50,50
1650515318230,CSE 134B,A01,083661,Powell; Thomas Allan,0,34,65,65
1650515324254,CSE 140,A01,083663,Staff,0,5,75,75
1650515330292,CSE 140L,A01,083088,Eldon; John,0,11,75,75
1650515336321,CSE 175,A01,083665,Kumar; Rakesh,7,0,25,18
1650515342354,CSE 190,A00,092507,Dubnov; Shlomo,10,0,20,10
1650515348379,ECE 45,A01,083139,Staff,20,19,60,40
1650515354403,ECE 65,A50,083695,Staff,0,6,30,30
1650515360435,ECE 109,A01,091882,Touri; Behrouz,35,0,70,35
1650515366466,ECE 180,A00,083140,Abi Samra; Nicholas Camill,21,0,30,9
1650515366466,ECE 180,B00,083141,Abi Samra; Nicholas Camill,0,0,30,30
1650515372489,MATH 10A,A01,083735,Patchell; Gregory David,5,0,30,25
1650515372489,MATH 10A,A02,083736,Patchell; Gregory David,27,0,30,3
1650515372489,MATH 10A,A03,083737,Patchell; Gregory David,24,0,30,6
1650515378513,MATH 10B,A01,083207,Staff,0,9,30,30
1650515378513,MATH 10B,A02,083208,Staff,0,7,30,30
1650515378513,MATH 10B,B01,083739,Staff,13,0,30,17
1650515378513,MATH 10B,B02,083740,Staff,28,0,30,2
1650515384539,MATH 18,A01,083743,Staff,1,0,30,29
1650515384539,MATH 18,A02,083744,Staff,27,0,30,3
1650515384539,MATH 18,A03,083745,Staff,22,0,30,8
1650515384539,MATH 18,A04,083746,Staff,26,0,30,4
1650515384539,MATH 18,B01,083748,Staff,0,12,30,30
1650515384539,MATH 18,B02,083749,Staff,0,12,30,30
1650515384539,MATH 18,B03,083750,Staff,0,11,30,30
1650515384539,MATH 18,B04,083751,Staff,0,12,30,30
1650515390573,MATH 20A,A01,083754,Staff,23,0,40,17
1650515396604,MATH 20B,A01,083756,Staff,0,11,30,30
1650515396604,MATH 20B,A02,083757,Staff,0,11,30,30
1650515402643,MATH 20C,A01,083760,Staff,0,16,30,30
1650515402643,MATH 20C,A02,083761,Staff,2,16,30,28
1650515402643,MATH 20C,B01,083762,Staff,12,0,30,18
1650515402643,MATH 20C,B02,083763,Staff,28,0,30,2
1650515408676,MATH 20D,A01,083765,Staff,0,1,30,30
1650515408676,MATH 20D,A02,083766,Staff,7,0,30,23
1650515408676,MATH 20D,A03,083767,Staff,25,0,30,5
1650515414698,MATH 20E,A01,083771,Staff,6,0,30,24
1650515414698,MATH 20E,A02,083772,Staff,18,0,30,12
1650515414698,MATH 20E,B01,083773,Staff,0,0,30,30
1650515414698,MATH 20E,B02,083774,Staff,10,0,30,20
1650515420723,MATH 103A,A01,083777,Staff,0,14,30,30
1650515420723,MATH 103A,A02,083778,Staff,0,14,30,30
1650515420723,MATH 103A,B01,083779,Staff,0,13,30,30
1650515420723,MATH 103A,B02,083780,Staff,0,13,30,30
1650515426750,MATH 105,A01,085443,Staff,1,23,30,29
1650515432774,MATH 109,A01,083213,Anzaldo; Leesa B,0,7,30,30
1650515432774,MATH 109,A02,083214,Anzaldo; Leesa B,0,7,30,30
1650515432774,MATH 109,B01,083215,Anzaldo; Leesa B,0,5,30,30
1650515432774,MATH 109,B02,083216,Anzaldo; Leesa B,0,6,30,30
1650515438798,MATH 142A,A01,083219,Chow; Bennett,0,16,30,30
1650515438798,MATH 142A,A02,083220,Chow; Bennett,0,14,30,30
1650515438798,MATH 142A,B01,083221,Chow; Bennett,0,13,30,30
1650515438798,MATH 142A,B02,083222,Chow; Bennett,0,13,30,30
1650515444822,MATH 193A,A01,083224,Staff,0,6,30,30
1650515444822,MATH 193A,A02,083225,Staff,0,5,30,30
1650515444822,MATH 193A,A03,083781,Staff,0,5,30,30
1650515444822,MATH 193A,A04,083782,Staff,0,7,30,30
1650515450846,MATH 197,001,091859,McAuley; Julian John,9998,0,9999,1
1650515456901,COGS 9,A01,083615,Staff,0,15,60,60
1650515462944,COGS 11,A01,083617,Boyle; Mary E. T.,19,0,40,21
1650515468968,COGS 13,A01,083071,Staff,0,35,40,40
1650515474994,COGS 14A,A01,092681,Staff,1,26,100,99
1650515481021,COGS 14B,A01,083073,Cheng; Tzu-Han,1,13,50,49
1650515487048,COGS 17,A01,092677,Staff,20,0,75,55
1650515493074,COGS 100,A01,083619,Staff,0,27,60,60
1650515499105,COGS 101A,A01,083621,Davis; Joshua Daniel,0,25,60,60
1650515505129,COGS 101B,A01,091572,Staff,0,4,60,60
1650515511153,COGS 101C,A01,083625,Delgado; Tania,16,0,30,14
1650515517179,COGS 107A,A01,083627,Boyle; Mary E. T.,0,12,60,60
1650515523203,COGS 118A,A01,083075,Staff,0,3,60,60
1650515529234,CSE 3,A50,083646,Miranda; Gregory Joseph,20,0,38,18
1650515529234,CSE 3,A51,083647,Miranda; Gregory Joseph,36,0,37,1
1650515535268,CSE 8A,A50,083650,Miranda; Gregory Joseph,1,30,40,39
1650515541296,CSE 11,A01,083080,Cao; Yingjun,0,92,40,40
1650515547324,CSE 12,A01,083652,Staff,0,17,100,100
1650515553349,CSE 15L,A01,083654,Staff,0,1,50,50
1650515553349,CSE 15L,A02,083655,Staff,0,0,50,50
1650515559372,CSE 20,A01,083657,Staff,51,0,80,29
1650515565400,CSE 30,A01,083084,Eldon; John,0,77,40,40
1650515571429,CSE 100,A01,083659,Cao; Yingjun,0,66,50,50
1650515577451,CSE 134B,A01,083661,Powell; Thomas Allan,0,34,65,65
1650515583507,CSE 140,A01,083663,Staff,0,5,75,75
1650515589529,CSE 140L,A01,083088,Eldon; John,0,11,75,75
1650515595552,CSE 175,A01,083665,Kumar; Rakesh,7,0,25,18
1650515601581,CSE 190,A00,092507,Dubnov; Shlomo,10,0,20,10
1650515607603,ECE 45,A01,083139,Staff,20,19,60,40
1650515613627,ECE 65,A50,083695,Staff,0,6,30,30
1650515619652,ECE 109,A01,091882,Touri; Behrouz,35,0,70,35
1650515625758,ECE 180,A00,083140,Abi Samra; Nicholas Camill,21,0,30,9
1650515625758,ECE 180,B00,083141,Abi Samra; Nicholas Camill,0,0,30,30
1650515631784,MATH 10A,A01,083735,Patchell; Gregory David,5,0,30,25
1650515631784,MATH 10A,A02,083736,Patchell; Gregory David,27,0,30,3
1650515631784,MATH 10A,A03,083737,Patchell; Gregory David,24,0,30,6
1650515637813,MATH 10B,A01,083207,Staff,0,9,30,30
1650515637813,MATH 10B,A02,083208,Staff,0,7,30,30
1650515637813,MATH 10B,B01,083739,Staff,13,0,30,17
1650515637813,MATH 10B,B02,083740,Staff,28,0,30,2
1650515643843,MATH 18,A01,083743,Staff,1,0,30,29
1650515643843,MATH 18,A02,083744,Staff,27,0,30,3
1650515643843,MATH 18,A03,083745,Staff,22,0,30,8
1650515643843,MATH 18,A04,083746,Staff,26,0,30,4
1650515643843,MATH 18,B01,083748,Staff,0,12,30,30
1650515643843,MATH 18,B02,083749,Staff,0,12,30,30
1650515643843,MATH 18,B03,083750,Staff,0,11,30,30
1650515643843,MATH 18,B04,083751,Staff,0,12,30,30
1650515649878,MATH 20A,A01,083754,Staff,23,0,40,17
1650515655906,MATH 20B,A01,083756,Staff,0,11,30,30
1650515655906,MATH 20B,A02,083757,Staff,0,11,30,30
1650515661931,MATH 20C,A01,083760,Staff,0,16,30,30
1650515661931,MATH 20C,A02,083761,Staff,2,16,30,28
1650515661931,MATH 20C,B01,083762,Staff,12,0,30,18
1650515661931,MATH 20C,B02,083763,Staff,28,0,30,2
1650515667955,MATH 20D,A01,083765,Staff,0,1,30,30
1650515667955,MATH 20D,A02,083766,Staff,7,0,30,23
1650515667955,MATH 20D,A03,083767,Staff,25,0,30,5
1650515673979,MATH 20E,A01,083771,Staff,6,0,30,24
1650515673979,MATH 20E,A02,083772,Staff,18,0,30,12
1650515673979,MATH 20E,B01,083773,Staff,0,0,30,30
1650515673979,MATH 20E,B02,083774,Staff,10,0,30,20
1650515680004,MATH 103A,A01,083777,Staff,0,14,30,30
1650515680004,MATH 103A,A02,083778,Staff,0,14,30,30
1650515680004,MATH 103A,B01,083779,Staff,0,13,30,30
1650515680004,MATH 103A,B02,083780,Staff,0,13,30,30
1650515686029,MATH 105,A01,085443,Staff,1,23,30,29
1650515692058,MATH 109,A01,083213,Anzaldo; Leesa B,0,7,30,30
1650515692058,MATH 109,A02,083214,Anzaldo; Leesa B,0,7,30,30
1650515692058,MATH 109,B01,083215,Anzaldo; Leesa B,0,5,30,30
1650515692058,MATH 109,B02,083216,Anzaldo; Leesa B,0,6,30,30
1650515698081,MATH 142A,A01,083219,Chow; Bennett,0,16,30,30
1650515698081,MATH 142A,A02,083220,Chow; Bennett,0,14,30,30
1650515698081,MATH 142A,B01,083221,Chow; Bennett,0,13,30,30
1650515698081,MATH 142A,B02,083222,Chow; Bennett,0,13,30,30
1650515704106,MATH 193A,A01,083224,Staff,0,6,30,30
1650515704106,MATH 193A,A02,083225,Staff,0,5,30,30
1650515704106,MATH 193A,A03,083781,Staff,0,5,30,30
1650515704106,MATH 193A,A04,083782,Staff,0,7,30,30
1650515710128,MATH 197,001,091859,McAuley; Julian John,9998,0,9999,1
1650515716195,COGS 9,A01,083615,Staff,0,15,60,60
1650515722220,COGS 11,A01,083617,Boyle; Mary E. T.,19,0,40,21
1650515728256,COGS 13,A01,083071,Staff,0,35,40,40
1650515734280,COGS 14A,A01,092681,Staff,1,26,100,99
1650515740304,COGS 14B,A01,083073,Cheng; Tzu-Han,1,13,50,49
1650515746339,COGS 17,A01,092677,Staff,20,0,75,55
1650515752363,COGS 100,A01,083619,Staff,0,27,60,60
1650515758388,COGS 101A,A01,083621,Davis; Joshua Daniel,0,25,60,60
1650515764411,COGS 101B,A01,091572,Staff,0,4,60,60
1650515770436,COGS 101C,A01,083625,Delgado; Tania,16,0,30,14
1650515776458,COGS 107A,A01,083627,Boyle; Mary E. T.,0,12,60,60
1650515782493,COGS 118A,A01,083075,Staff,0,3,60,60
1650515788518,CSE 3,A50,083646,Miranda; Gregory Joseph,20,0,38,18
1650515788518,CSE 3,A51,083647,Miranda; Gregory Joseph,36,0,37,1
1650515794550,CSE 8A,A50,083650,Miranda; Gregory Joseph,1,30,40,39
1650515800573,CSE 11,A01,083080,Cao; Yingjun,0,93,40,40
1650515806597,CSE 12,A01,083652,Staff,0,17,100,100
1650515812624,CSE 15L,A01,083654,Staff,0,1,50,50
1650515812624,CSE 15L,A02,083655,Staff,0,0,50,50
1650515818647,CSE 20,A01,083657,Staff,51,0,80,29
1650515824674,CSE 30,A01,083084,Eldon; John,0,77,40,40
1650515830701,CSE 100,A01,083659,Cao; Yingjun,0,66,50,50
1650515836724,CSE 134B,A01,083661,Powell; Thomas Allan,0,34,65,65
1650515842748,CSE 140,A01,083663,Staff,0,5,75,75
1650515848773,CSE 140L,A01,083088,Eldon; John,0,11,75,75
1650515854797,CSE 175,A01,083665,Kumar; Rakesh,7,0,25,18
1650515860821,CSE 190,A00,092507,Dubnov; Shlomo,10,0,20,10
1650515866848,ECE 45,A01,083139,Staff,20,19,60,40
1650515872876,ECE 65,A50,083695,Staff,0,6,30,30
1650515878903,ECE 109,A01,091882,Touri; Behrouz,35,0,70,35
1650515884927,ECE 180,A00,083140,Abi Samra; Nicholas Camill,21,0,30,9
1650515884927,ECE 180,B00,083141,Abi Samra; Nicholas Camill,0,0,30,30
1650515890954,MATH 10A,A01,083735,Patchell; Gregory David,5,0,30,25
1650515890954,MATH 10A,A02,083736,Patchell; Gregory David,27,0,30,3
1650515890954,MATH 10A,A03,083737,Patchell; Gregory David,24,0,30,6
1650515896978,MATH 10B,A01,083207,Staff,0,9,30,30
1650515896978,MATH 10B,A02,083208,Staff,0,7,30,30
1650515896978,MATH 10B,B01,083739,Staff,13,0,30,17
1650515896978,MATH 10B,B02,083740,Staff,28,0,30,2
1650515903007,MATH 18,A01,083743,Staff,1,0,30,29
1650515903007,MATH 18,A02,083744,Staff,27,0,30,3
1650515903007,MATH 18,A03,083745,Staff,22,0,30,8
1650515903007,MATH 18,A04,083746,Staff,26,0,30,4
1650515903007,MATH 18,B01,083748,Staff,0,12,30,30
1650515903007,MATH 18,B02,083749,Staff,0,12,30,30
1650515903007,MATH 18,B03,083750,Staff,0,11,30,30
1650515903007,MATH 18,B04,083751,Staff,0,12,30,30
1650515909030,MATH 20A,A01,083754,Staff,23,0,40,17
1650515915059,MATH 20B,A01,083756,Staff,0,11,30,30
1650515915059,MATH 20B,A02,083757,Staff,0,11,30,30
1650515921091,MATH 20C,A01,083760,Staff,0,16,30,30
1650515921091,MATH 20C,A02,083761,Staff,2,16,30,28
1650515921091,MATH 20C,B01,083762,Staff,12,0,30,18
1650515921091,MATH 20C,B02,083763,Staff,28,0,30,2
1650515927116,MATH 20D,A01,083765,Staff,0,1,30,30
1650515927116,MATH 20D,A02,083766,Staff,7,0,30,23
1650515927116,MATH 20D,A03,083767,Staff,25,0,30,5
1650515933146,MATH 20E,A01,083771,Staff,6,0,30,24
1650515933146,MATH 20E,A02,083772,Staff,18,0,30,12
1650515933146,MATH 20E,B01,083773,Staff,0,0,30,30
1650515933146,MATH 20E,B02,083774,Staff,10,0,30,20
1650515939183,MATH 103A,A01,083777,Staff,0,14,30,30
1650515939183,MATH 103A,A02,083778,Staff,0,14,30,30
1650515939183,MATH 103A,B01,083779,Staff,0,13,30,30
1650515939183,MATH 103A,B02,083780,Staff,0,13,30,30
1650515945205,MATH 105,A01,085443,Staff,1,23,30,29
1650515951236,MATH 109,A01,083213,Anzaldo; Leesa B,0,7,30,30
1650515951236,MATH 109,A02,083214,Anzaldo; Leesa B,0,7,30,30
1650515951236,MATH 109,B01,083215,Anzaldo; Leesa B,0,5,30,30
1650515951236,MATH 109,B02,083216,Anzaldo; Leesa B,0,6,30,30
1650515957265,MATH 142A,A01,083219,Chow; Bennett,0,16,30,30
1650515957265,MATH 142A,A02,083220,Chow; Bennett,0,14,30,30
1650515957265,MATH 142A,B01,083221,Chow; Bennett,0,13,30,30
1650515957265,MATH 142A,B02,083222,Chow; Bennett,0,13,30,30
1650515963290,MATH 193A,A01,083224,Staff,0,6,30,30
1650515963290,MATH 193A,A02,083225,Staff,0,5,30,30
1650515963290,MATH 193A,A03,083781,Staff,0,5,30,30
1650515963290,MATH 193A,A04,083782,Staff,0,7,30,30
1650515969318,MATH 197,001,091859,McAuley; Julian John,9998,0,9999,1
1650515975366,COGS 9,A01,083615,Staff,0,15,60,60
1650515981392,COGS 11,A01,083617,Boyle; Mary E. T.,19,0,40,21
1650515987416,COGS 13,A01,083071,Staff,0,35,40,40
1650515993440,COGS 14A,A01,092681,Staff,1,26,100,99
1650515999463,COGS 14B,A01,083073,Cheng; Tzu-Han,1,13,50,49
1650516005487,COGS 17,A01,092677,Staff,20,0,75,55
1650516011511,COGS 100,A01,083619,Staff,0,27,60,60
1650516017535,COGS 101A,A01,083621,Davis; Joshua Daniel,0,25,60,60
1650516023560,COGS 101B,A01,091572,Staff,0,4,60,60
1650516029591,COGS 101C,A01,083625,Delgado; Tania,16,0,30,14
1650516035618,COGS 107A,A01,083627,Boyle; Mary E. T.,0,12,60,60
1650516041643,COGS 118A,A01,083075,Staff,0,3,60,60
1650516047666,CSE 3,A50,083646,Miranda; Gregory Joseph,20,0,38,18
1650516047666,CSE 3,A51,083647,Miranda; Gregory Joseph,36,0,37,1
1650516053695,CSE 8A,A50,083650,Miranda; Gregory Joseph,1,30,40,39
1650516059720,CSE 11,A01,083080,Cao; Yingjun,0,93,40,40
1650516065748,CSE 12,A01,083652,Staff,0,17,100,100
1650516071774,CSE 15L,A01,083654,Staff,0,1,50,50
1650516071774,CSE 15L,A02,083655,Staff,0,0,50,50
1650516077800,CSE 20,A01,083657,Staff,51,0,80,29
1650516083833,CSE 30,A01,083084,Eldon; John,0,77,40,40
1650516089868,CSE 100,A01,083659,Cao; Yingjun,0,66,50,50
1650516095895,CSE 134B,A01,083661,Powell; Thomas Allan,0,34,65,65
1650516101918,CSE 140,A01,083663,Staff,0,5,75,75
1650516107948,CSE 140L,A01,083088,Eldon; John,0,11,75,75
1650516113981,CSE 175,A01,083665,Kumar; Rakesh,7,0,25,18
1650516120005,CSE 190,A00,092507,Dubnov; Shlomo,10,0,20,10
1650516126028,ECE 45,A01,083139,Staff,20,19,60,40
1650516132064,ECE 65,A50,083695,Staff,0,6,30,30
1650516138090,ECE 109,A01,091882,Touri; Behrouz,35,0,70,35
1650516144116,ECE 180,A00,083140,Abi Samra; Nicholas Camill,21,0,30,9
1650516144116,ECE 180,B00,083141,Abi Samra; Nicholas Camill,0,0,30,30
1650516150145,MATH 10A,A01,083735,Patchell; Gregory David,5,0,30,25
1650516150145,MATH 10A,A02,083736,Patchell; Gregory David,27,0,30,3
1650516150145,MATH 10A,A03,083737,Patchell; Gregory David,24,0,30,6
1650516156175,MATH 10B,A01,083207,Staff,0,9,30,30
1650516156175,MATH 10B,A02,083208,Staff,0,7,30,30
1650516156175,MATH 10B,B01,083739,Staff,13,0,30,17
1650516156175,MATH 10B,B02,083740,Staff,28,0,30,2
1650516162206,MATH 18,A01,083743,Staff,1,0,30,29
1650516162206,MATH 18,A02,083744,Staff,27,0,30,3
1650516162206,MATH 18,A03,083745,Staff,22,0,30,8
1650516162206,MATH 18,A04,083746,Staff,26,0,30,4
1650516162206,MATH 18,B01,083748,Staff,0,12,30,30
1650516162206,MATH 18,B02,083749,Staff,0,12,30,30
1650516162206,MATH 18,B03,083750,Staff,0,11,30,30
1650516162206,MATH 18,B04,083751,Staff,0,12,30,30
1650516168229,MATH 20A,A01,083754,Staff,23,0,40,17
1650516174250,MATH 20B,A01,083756,Staff,0,11,30,30
1650516174250,MATH 20B,A02,083757,Staff,0,11,30,30
1650516180292,MATH 20C,A01,083760,Staff,0,16,30,30
1650516180292,MATH 20C,A02,083761,Staff,2,16,30,28
1650516180292,MATH 20C,B01,083762,Staff,12,0,30,18
1650516180292,MATH 20C,B02,083763,Staff,28,0,30,2
1650516186318,MATH 20D,A01,083765,Staff,0,1,30,30
1650516186318,MATH 20D,A02,083766,Staff,7,0,30,23
1650516186318,MATH 20D,A03,083767,Staff,25,0,30,5
1650516192348,MATH 20E,A01,083771,Staff,6,0,30,24
1650516192348,MATH 20E,A02,083772,Staff,18,0,30,12
1650516192348,MATH 20E,B01,083773,Staff,0,0,30,30
1650516192348,MATH 20E,B02,083774,Staff,10,0,30,20
1650516198381,MATH 103A,A01,083777,Staff,0,14,30,30
1650516198381,MATH 103A,A02,083778,Staff,0,14,30,30
1650516198381,MATH 103A,B01,083779,Staff,0,13,30,30
1650516198381,MATH 103A,B02,083780,Staff,0,13,30,30
1650516204405,MATH 105,A01,085443,Staff,1,23,30,29
1650516210433,MATH 109,A01,083213,Anzaldo; Leesa B,0,7,30,30
1650516210433,MATH 109,A02,083214,Anzaldo; Leesa B,0,7,30,30
1650516210433,MATH 109,B01,083215,Anzaldo; Leesa B,0,5,30,30
1650516210433,MATH 109,B02,083216,Anzaldo; Leesa B,0,6,30,30
1650516216458,MATH 142A,A01,083219,Chow; Bennett,0,16,30,30
1650516216458,MATH 142A,A02,083220,Chow; Bennett,0,14,30,30
1650516216458,MATH 142A,B01,083221,Chow; Bennett,0,13,30,30
1650516216458,MATH 142A,B02,083222,Chow; Bennett,0,13,30,30
1650516222578,MATH 193A,A01,083224,Staff,0,6,30,30
1650516222578,MATH 193A,A02,083225,Staff,0,5,30,30
1650516222578,MATH 193A,A03,083781,Staff,0,5,30,30
1650516222578,MATH 193A,A04,083782,Staff,0,7,30,30
1650516228609,MATH 197,001,091859,McAuley; Julian John,9998,0,9999,1
1650516234679,COGS 9,A01,083615,Staff,0,15,60,60
1650516240709,COGS 11,A01,083617,Boyle; Mary E. T.,19,0,40,21
1650516246732,COGS 13,A01,083071,Staff,0,35,40,40
1650516252762,COGS 14A,A01,092681,Staff,1,26,100,99
1650516258788,COGS 14B,A01,083073,Cheng; Tzu-Han,1,13,50,49
1650516264814,COGS 17,A01,092677,Staff,20,0,75,55
1650516270840,COGS 100,A01,083619,Staff,0,27,60,60
1650516276866,COGS 101A,A01,083621,Davis; Joshua Daniel,0,25,60,60
1650516282889,COGS 101B,A01,091572,Staff,0,4,60,60
1650516288913,COGS 101C,A01,083625,Delgado; Tania,16,0,30,14
1650516294936,COGS 107A,A01,083627,Boyle; Mary E. T.,0,12,60,60
1650516300961,COGS 118A,A01,083075,Staff,0,3,60,60
1650516306991,CSE 3,A50,083646,Miranda; Gregory Joseph,20,0,38,18
1650516306991,CSE 3,A51,083647,Miranda; Gregory Joseph,36,0,37,1
1650516313014,CSE 8A,A50,083650,Miranda; Gregory Joseph,1,30,40,39
1650516319047,CSE 11,A01,083080,Cao; Yingjun,0,93,40,40
1650516325074,CSE 12,A01,083652,Staff,0,17,100,100
1650516331097,CSE 15L,A01,083654,Staff,0,1,50,50
1650516331097,CSE 15L,A02,083655,Staff,0,0,50,50
1650516337122,CSE 20,A01,083657,Staff,51,0,80,29
1650516343160,CSE 30,A01,083084,Eldon; John,0,77,40,40
1650516349185,CSE 100,A01,083659,Cao; Yingjun,0,66,50,50
1650516355209,CSE 134B,A01,083661,Powell; Thomas Allan,0,34,65,65
1650516361239,CSE 140,A01,083663,Staff,0,5,75,75
1650516367267,CSE 140L,A01,083088,Eldon; John,0,11,75,75
1650516373290,CSE 175,A01,083665,Kumar; Rakesh,7,0,25,18
1650516379324,CSE 190,A00,092507,Dubnov; Shlomo,10,0,20,10
1650516385354,ECE 45,A01,083139,Staff,20,19,60,40
1650516391378,ECE 65,A50,083695,Staff,0,6,30,30
1650516397410,ECE 109,A01,091882,Touri; Behrouz,35,0,70,35
1650516403433,ECE 180,A00,083140,Abi Samra; Nicholas Camill,21,0,30,9
1650516403433,ECE 180,B00,083141,Abi Samra; Nicholas Camill,0,0,30,30
1650516409468,MATH 10A,A01,083735,Patchell; Gregory David,5,0,30,25
1650516409468,MATH 10A,A02,083736,Patchell; Gregory David,27,0,30,3
1650516409468,MATH 10A,A03,083737,Patchell; Gregory David,24,0,30,6
1650516415503,MATH 10B,A01,083207,Staff,0,9,30,30
1650516415503,MATH 10B,A02,083208,Staff,0,7,30,30
1650516415503,MATH 10B,B01,083739,Staff,13,0,30,17
1650516415503,MATH 10B,B02,083740,Staff,28,0,30,2
1650516421533,MATH 18,A01,083743,Staff,1,0,30,29
1650516421533,MATH 18,A02,083744,Staff,27,0,30,3
1650516421533,MATH 18,A03,083745,Staff,22,0,30,8
1650516421533,MATH 18,A04,083746,Staff,26,0,30,4
1650516421533,MATH 18,B01,083748,Staff,0,12,30,30
1650516421533,MATH 18,B02,083749,Staff,0,12,30,30
1650516421533,MATH 18,B03,083750,Staff,0,11,30,30
1650516421533,MATH 18,B04,083751,Staff,0,12,30,30
1650516427607,MATH 20A,A01,083754,Staff,23,0,40,17
1650516433634,MATH 20B,A01,083756,Staff,0,11,30,30
1650516433634,MATH 20B,A02,083757,Staff,0,11,30,30
1650516439665,MATH 20C,A01,083760,Staff,0,16,30,30
1650516439665,MATH 20C,A02,083761,Staff,2,16,30,28
1650516439665,MATH 20C,B01,083762,Staff,12,0,30,18
1650516439665,MATH 20C,B02,083763,Staff,28,0,30,2
1650516445694,MATH 20D,A01,083765,Staff,0,1,30,30
1650516445694,MATH 20D,A02,083766,Staff,7,0,30,23
1650516445694,MATH 20D,A03,083767,Staff,25,0,30,5
1650516451731,MATH 20E,A01,083771,Staff,6,0,30,24
1650516451731,MATH 20E,A02,083772,Staff,18,0,30,12
1650516451731,MATH 20E,B01,083773,Staff,0,0,30,30
1650516451731,MATH 20E,B02,083774,Staff,10,0,30,20
1650516457755,MATH 103A,A01,083777,Staff,0,14,30,30
1650516457755,MATH 103A,A02,083778,Staff,0,14,30,30
1650516457755,MATH 103A,B01,083779,Staff,0,13,30,30
1650516457755,MATH 103A,B02,083780,Staff,0,13,30,30
1650516463793,MATH 105,A01,085443,Staff,1,23,30,29
1650516469822,MATH 109,A01,083213,Anzaldo; Leesa B,0,7,30,30
1650516469822,MATH 109,A02,083214,Anzaldo; Leesa B,0,7,30,30
1650516469822,MATH 109,B01,083215,Anzaldo; Leesa B,0,5,30,30
1650516469822,MATH 109,B02,083216,Anzaldo; Leesa B,0,6,30,30
1650516475851,MATH 142A,A01,083219,Chow; Bennett,0,16,30,30
1650516475851,MATH 142A,A02,083220,Chow; Bennett,0,14,30,30
1650516475851,MATH 142A,B01,083221,Chow; Bennett,0,13,30,30
1650516475851,MATH 142A,B02,083222,Chow; Bennett,0,13,30,30
1650516481878,MATH 193A,A01,083224,Staff,0,6,30,30
1650516481878,MATH 193A,A02,083225,Staff,0,5,30,30
1650516481878,MATH 193A,A03,083781,Staff,0,5,30,30
1650516481878,MATH 193A,A04,083782,Staff,0,7,30,30
1650516487912,MATH 197,001,091859,McAuley; Julian John,9998,0,9999,1
1650516493965,COGS 9,A01,083615,Staff,0,15,60,60
1650516499992,COGS 11,A01,083617,Boyle; Mary E. T.,19,0,40,21
1650516506016,COGS 13,A01,083071,Staff,0,35,40,40
1650516512052,COGS 14A,A01,092681,Staff,1,26,100,99
1650516518077,COGS 14B,A01,083073,Cheng; Tzu-Han,1,13,50,49
1650516524102,COGS 17,A01,092677,Staff,20,0,75,55
1650516530130,COGS 100,A01,083619,Staff,0,27,60,60
1650516536169,COGS 101A,A01,083621,Davis; Joshua Daniel,0,25,60,60
1650516542196,COGS 101B,A01,091572,Staff,0,4,60,60
1650516548223,COGS 101C,A01,083625,Delgado; Tania,16,0,30,14
1650516554246,COGS 107A,A01,083627,Boyle; Mary E. T.,0,12,60,60
1650516560271,COGS 118A,A01,083075,Staff,0,3,60,60
1650516566297,CSE 3,A50,083646,Miranda; Gregory Joseph,20,0,38,18
1650516566297,CSE 3,A51,083647,Miranda; Gregory Joseph,36,0,37,1
1650516572321,CSE 8A,A50,083650,Miranda; Gregory Joseph,1,30,40,39
1650516578346,CSE 11,A01,083080,Cao; Yingjun,0,93,40,40
1650516584370,CSE 12,A01,083652,Staff,0,17,100,100
1650516590394,CSE 15L,A01,083654,Staff,0,1,50,50
1650516590394,CSE 15L,A02,083655,Staff,0,0,50,50
1650516596420,CSE 20,A01,083657,Staff,51,0,80,29
1650516602458,CSE 30,A01,083084,Eldon; John,0,77,40,40
1650516608481,CSE 100,A01,083659,Cao; Yingjun,0,66,50,50
1650516614505,CSE 134B,A01,083661,Powell; Thomas Allan,0,34,65,65
1650516620529,CSE 140,A01,083663,Staff,0,5,75,75
1650516626553,CSE 140L,A01,083088,Eldon; John,0,11,75,75
1650516632579,CSE 175,A01,083665,Kumar; Rakesh,7,0,25,18
1650516638603,CSE 190,A00,092507,Dubnov; Shlomo,10,0,20,10
1650516644627,ECE 45,A01,083139,Staff,20,19,60,40
1650516650688,ECE 65,A50,083695,Staff,0,6,30,30
1650516656715,ECE 109,A01,091882,Touri; Behrouz,35,0,70,35
1650516662739,ECE 180,A00,083140,Abi Samra; Nicholas Camill,21,0,30,9
1650516662739,ECE 180,B00,083141,Abi Samra; Nicholas Camill,0,0,30,30
1650516668763,MATH 10A,A01,083735,Patchell; Gregory David,5,0,30,25
1650516668763,MATH 10A,A02,083736,Patchell; Gregory David,27,0,30,3
1650516668763,MATH 10A,A03,083737,Patchell; Gregory David,24,0,30,6
1650516674788,MATH 10B,A01,083207,Staff,0,9,30,30
1650516674788,MATH 10B,A02,083208,Staff,0,7,30,30
1650516674788,MATH 10B,B01,083739,Staff,13,0,30,17
1650516674788,MATH 10B,B02,083740,Staff,28,0,30,2
1650516680813,MATH 18,A01,083743,Staff,1,0,30,29
1650516680813,MATH 18,A02,083744,Staff,27,0,30,3
1650516680813,MATH 18,A03,083745,Staff,22,0,30,8
1650516680813,MATH 18,A04,083746,Staff,26,0,30,4
1650516680813,MATH 18,B01,083748,Staff,0,12,30,30
1650516680813,MATH 18,B02,083749,Staff,0,12,30,30
1650516680813,MATH 18,B03,083750,Staff,0,11,30,30
1650516680813,MATH 18,B04,083751,Staff,0,12,30,30
1650516686851,MATH 20A,A01,083754,Staff,23,0,40,17
1650516692878,MATH 20B,A01,083756,Staff,0,11,30,30
1650516692878,MATH 20B,A02,083757,Staff,0,11,30,30
1650516698905,MATH 20C,A01,083760,Staff,0,16,30,30
1650516698905,MATH 20C,A02,083761,Staff,2,16,30,28
1650516698905,MATH 20C,B01,083762,Staff,12,0,30,18
1650516698905,MATH 20C,B02,083763,Staff,28,0,30,2
1650516704933,MATH 20D,A01,083765,Staff,0,1,30,30
1650516704933,MATH 20D,A02,083766,Staff,7,0,30,23
1650516704933,MATH 20D,A03,083767,Staff,25,0,30,5
1650516710960,MATH 20E,A01,083771,Staff,6,0,30,24
1650516710960,MATH 20E,A02,083772,Staff,18,0,30,12
1650516710960,MATH 20E,B01,083773,Staff,0,0,30,30
1650516710960,MATH 20E,B02,083774,Staff,10,0,30,20
1650516716997,MATH 103A,A01,083777,Staff,0,14,30,30
1650516716997,MATH 103A,A02,083778,Staff,0,14,30,30
1650516716997,MATH 103A,B01,083779,Staff,0,13,30,30
1650516716997,MATH 103A,B02,083780,Staff,0,13,30,30
1650516723021,MATH 105,A01,085443,Staff,1,23,30,29
1650516729047,MATH 109,A01,083213,Anzaldo; Leesa B,0,7,30,30
1650516729047,MATH 109,A02,083214,Anzaldo; Leesa B,0,7,30,30
1650516729047,MATH 109,B01,083215,Anzaldo; Leesa B,0,5,30,30
1650516729047,MATH 109,B02,083216,Anzaldo; Leesa B,0,6,30,30
1650516735071,MATH 142A,A01,083219,Chow; Bennett,0,16,30,30
1650516735071,MATH 142A,A02,083220,Chow; Bennett,0,14,30,30
1650516735071,MATH 142A,B01,083221,Chow; Bennett,0,14,30,30
1650516735071,MATH 142A,B02,083222,Chow; Bennett,0,13,30,30
1650516741104,MATH 193A,A01,083224,Staff,0,6,30,30
1650516741104,MATH 193A,A02,083225,Staff,0,5,30,30
1650516741104,MATH 193A,A03,083781,Staff,0,5,30,30
1650516741104,MATH 193A,A04,083782,Staff,0,7,30,30
1650516747128,MATH 197,001,091859,McAuley; Julian John,9998,0,9999,1
1650516753192,COGS 9,A01,083615,Staff,0,15,60,60
1650516759216,COGS 11,A01,083617,Boyle; Mary E. T.,19,0,40,21
1650516765238,COGS 13,A01,083071,Staff,0,35,40,40
1650516771261,COGS 14A,A01,092681,Staff,1,26,100,99
1650516777288,COGS 14B,A01,083073,Cheng; Tzu-Han,1,13,50,49
1650516783313,COGS 17,A01,092677,Staff,20,0,75,55
1650516789336,COGS 100,A01,083619,Staff,0,27,60,60
1650516795362,COGS 101A,A01,083621,Davis; Joshua Daniel,0,25,60,60
1650516801388,COGS 101B,A01,091572,Staff,0,4,60,60
1650516807415,COGS 101C,A01,083625,Delgado; Tania,16,0,30,14
1650516813538,COGS 107A,A01,083627,Boyle; Mary E. T.,0,12,60,60
1650516819564,COGS 118A,A01,083075,Staff,0,3,60,60
1650516825592,CSE 3,A50,083646,Miranda; Gregory Joseph,20,0,38,18
1650516825592,CSE 3,A51,083647,Miranda; Gregory Joseph,36,0,37,1
1650516831614,CSE 8A,A50,083650,Miranda; Gregory Joseph,1,30,40,39
1650516837640,CSE 11,A01,083080,Cao; Yingjun,0,93,40,40
1650516843670,CSE 12,A01,083652,Staff,0,17,100,100
1650516849705,CSE 15L,A01,083654,Staff,0,1,50,50
1650516849705,CSE 15L,A02,083655,Staff,0,0,50,50
1650516855731,CSE 20,A01,083657,Staff,51,0,80,29
1650516861762,CSE 30,A01,083084,Eldon; John,0,77,40,40
1650516867841,CSE 100,A01,083659,Cao; Yingjun,0,66,50,50
1650516873868,CSE 134B,A01,083661,Powell; Thomas Allan,0,34,65,65
1650516879894,CSE 140,A01,083663,Staff,0,5,75,75
1650516885923,CSE 140L,A01,083088,Eldon; John,0,11,75,75
1650516891949,CSE 175,A01,083665,Kumar; Rakesh,7,0,25,18
1650516897973,CSE 190,A00,092507,Dubnov; Shlomo,10,0,20,10
1650516904001,ECE 45,A01,083139,Staff,20,19,60,40
1650516910023,ECE 65,A50,083695,Staff,0,6,30,30
1650516916046,ECE 109,A01,091882,Touri; Behrouz,35,0,70,35
1650516922070,ECE 180,A00,083140,Abi Samra; Nicholas Camill,21,0,30,9
1650516922070,ECE 180,B00,083141,Abi Samra; Nicholas Camill,0,0,30,30
1650516928095,MATH 10A,A01,083735,Patchell; Gregory David,5,0,30,25
1650516928095,MATH 10A,A02,083736,Patchell; Gregory David,27,0,30,3
1650516928095,MATH 10A,A03,083737,Patchell; Gregory David,24,0,30,6
1650516934124,MATH 10B,A01,083207,Staff,0,9,30,30
1650516934124,MATH 10B,A02,083208,Staff,0,7,30,30
1650516934124,MATH 10B,B01,083739,Staff,13,0,30,17
1650516934124,MATH 10B,B02,083740,Staff,28,0,30,2
1650516940154,MATH 18,A01,083743,Staff,1,0,30,29
1650516940154,MATH 18,A02,083744,Staff,27,0,30,3
1650516940154,MATH 18,A03,083745,Staff,22,0,30,8
1650516940154,MATH 18,A04,083746,Staff,26,0,30,4
1650516940154,MATH 18,B01,083748,Staff,0,12,30,30
1650516940154,MATH 18,B02,083749,Staff,0,12,30,30
1650516940154,MATH 18,B03,083750,Staff,0,11,30,30
1650516940154,MATH 18,B04,083751,Staff,0,12,30,30
1650516946178,MATH 20A,A01,083754,Staff,23,0,40,17
1650516952205,MATH 20B,A01,083756,Staff,0,11,30,30
1650516952205,MATH 20B,A02,083757,Staff,0,11,30,30
1650516958232,MATH 20C,A01,083760,Staff,0,16,30,30
1650516958232,MATH 20C,A02,083761,Staff,2,16,30,28
1650516958232,MATH 20C,B01,083762,Staff,12,0,30,18
1650516958232,MATH 20C,B02,083763,Staff,28,0,30,2
1650516964260,MATH 20D,A01,083765,Staff,0,1,30,30
1650516964260,MATH 20D,A02,083766,Staff,7,0,30,23
1650516964260,MATH 20D,A03,083767,Staff,25,0,30,5
1650516970286,MATH 20E,A01,083771,Staff,6,0,30,24
1650516970286,MATH 20E,A02,083772,Staff,18,0,30,12
1650516970286,MATH 20E,B01,083773,Staff,0,0,30,30
1650516970286,MATH 20E,B02,083774,Staff,10,0,30,20
1650516976365,MATH 103A,A01,083777,Staff,0,14,30,30
1650516976365,MATH 103A,A02,083778,Staff,0,14,30,30
1650516976365,MATH 103A,B01,083779,Staff,0,13,30,30
1650516976365,MATH 103A,B02,083780,Staff,0,13,30,30
1650516982393,MATH 105,A01,085443,Staff,1,23,30,29
1650516998695,MATH 109,A01,083213,Anzaldo; Leesa B,0,7,30,30
1650516998695,MATH 109,A02,083214,Anzaldo; Leesa B,0,7,30,30
1650516998695,MATH 109,B01,083215,Anzaldo; Leesa B,0,5,30,30
1650516998695,MATH 109,B02,083216,Anzaldo; Leesa B,0,6,30,30
1650517004724,MATH 142A,A01,083219,Chow; Bennett,0,16,30,30
1650517004724,MATH 142A,A02,083220,Chow; Bennett,0,14,30,30
1650517004724,MATH 142A,B01,083221,Chow; Bennett,0,14,30,30
1650517004724,MATH 142A,B02,083222,Chow; Bennett,0,13,30,30
1650517010751,MATH 193A,A01,083224,Staff,0,6,30,30
1650517010751,MATH 193A,A02,083225,Staff,0,5,30,30
1650517010751,MATH 193A,A03,083781,Staff,0,5,30,30
1650517010751,MATH 193A,A04,083782,Staff,0,7,30,30
1650517016775,MATH 197,001,091859,McAuley; Julian John,9998,0,9999,1
1650517022855,COGS 9,A01,083615,Staff,0,15,60,60
1650517028882,COGS 11,A01,083617,Boyle; Mary E. T.,19,0,40,21
1650517034905,COGS 13,A01,083071,Staff,0,35,40,40
1650517040938,COGS 14A,A01,092681,Staff,1,26,100,99
1650517046970,COGS 14B,A01,083073,Cheng; Tzu-Han,1,13,50,49
1650517052997,COGS 17,A01,092677,Staff,20,0,75,55
1650517059021,COGS 100,A01,083619,Staff,0,27,60,60
1650517065048,COGS 101A,A01,083621,Davis; Joshua Daniel,0,25,60,60
1650517071072,COGS 101B,A01,091572,Staff,0,4,60,60
1650517077100,COGS 101C,A01,083625,Delgado; Tania,16,0,30,14
1650517083123,COGS 107A,A01,083627,Boyle; Mary E. T.,0,12,60,60
1650517089146,COGS 118A,A01,083075,Staff,0,3,60,60
1650517095174,CSE 3,A50,083646,Miranda; Gregory Joseph,20,0,38,18
1650517095174,CSE 3,A51,083647,Miranda; Gregory Joseph,36,0,37,1
1650517101199,CSE 8A,A50,083650,Miranda; Gregory Joseph,1,30,40,39
1650517107224,CSE 11,A01,083080,Cao; Yingjun,0,93,40,40
1650517113251,CSE 12,A01,083652,Staff,0,17,100,100
1650517119283,CSE 15L,A01,083654,Staff,0,1,50,50
1650517119283,CSE 15L,A02,083655,Staff,0,0,50,50
1650517125306,CSE 20,A01,083657,Staff,51,0,80,29
1650517131332,CSE 30,A01,083084,Eldon; John,0,77,40,40
1650517137361,CSE 100,A01,083659,Cao; Yingjun,0,66,50,50
1650517143388,CSE 134B,A01,083661,Powell; Thomas Allan,0,34,65,65
1650517149413,CSE 140,A01,083663,Staff,0,5,75,75
1650517155436,CSE 140L,A01,083088,Eldon; John,0,11,75,75
1650517161462,CSE 175,A01,083665,Kumar; Rakesh,7,0,25,18
1650517167487,CSE 190,A00,092507,Dubnov; Shlomo,10,0,20,10
1650517173511,ECE 45,A01,083139,Staff,20,19,60,40
1650517179535,ECE 65,A50,083695,Staff,0,6,30,30
1650517185561,ECE 109,A01,091882,Touri; Behrouz,35,0,70,35
1650517191586,ECE 180,A00,083140,Abi Samra; Nicholas Camill,21,0,30,9
1650517191586,ECE 180,B00,083141,Abi Samra; Nicholas Camill,0,0,30,30
1650517197608,MATH 10A,A01,083735,Patchell; Gregory David,5,0,30,25
1650517197608,MATH 10A,A02,083736,Patchell; Gregory David,27,0,30,3
1650517197608,MATH 10A,A03,083737,Patchell; Gregory David,24,0,30,6
1650517203635,MATH 10B,A01,083207,Staff,0,9,30,30
1650517203635,MATH 10B,A02,083208,Staff,0,7,30,30
1650517203635,MATH 10B,B01,083739,Staff,13,0,30,17
1650517203635,MATH 10B,B02,083740,Staff,28,0,30,2
1650517209664,MATH 18,A01,083743,Staff,1,0,30,29
1650517209664,MATH 18,A02,083744,Staff,27,0,30,3
1650517209664,MATH 18,A03,083745,Staff,22,0,30,8
1650517209664,MATH 18,A04,083746,Staff,26,0,30,4
1650517209664,MATH 18,B01,083748,Staff,0,12,30,30
1650517209664,MATH 18,B02,083749,Staff,0,12,30,30
1650517209664,MATH 18,B03,083750,Staff,0,11,30,30
1650517209664,MATH 18,B04,083751,Staff,0,12,30,30
1650517215687,MATH 20A,A01,083754,Staff,23,0,40,17
1650517221709,MATH 20B,A01,083756,Staff,0,11,30,30
1650517221709,MATH 20B,A02,083757,Staff,0,11,30,30
1650517227736,MATH 20C,A01,083760,Staff,0,16,30,30
1650517227736,MATH 20C,A02,083761,Staff,2,16,30,28
1650517227736,MATH 20C,B01,083762,Staff,12,0,30,18
1650517227736,MATH 20C,B02,083763,Staff,28,0,30,2
1650517233762,MATH 20D,A01,083765,Staff,0,1,30,30
1650517233762,MATH 20D,A02,083766,Staff,7,0,30,23
1650517233762,MATH 20D,A03,083767,Staff,25,0,30,5
1650517239790,MATH 20E,A01,083771,Staff,6,0,30,24
1650517239790,MATH 20E,A02,083772,Staff,18,0,30,12
1650517239790,MATH 20E,B01,083773,Staff,0,0,30,30
1650517239790,MATH 20E,B02,083774,Staff,10,0,30,20
1650517245816,MATH 103A,A01,083777,Staff,0,14,30,30
1650517245816,MATH 103A,A02,083778,Staff,0,14,30,30
1650517245816,MATH 103A,B01,083779,Staff,0,13,30,30
1650517245816,MATH 103A,B02,083780,Staff,0,13,30,30
1650517251840,MATH 105,A01,085443,Staff,1,23,30,29
1650517257865,MATH 109,A01,083213,Anzaldo; Leesa B,0,7,30,30
1650517257865,MATH 109,A02,083214,Anzaldo; Leesa B,0,7,30,30
1650517257865,MATH 109,B01,083215,Anzaldo; Leesa B,0,5,30,30
1650517257865,MATH 109,B02,083216,Anzaldo; Leesa B,0,6,30,30
1650517263890,MATH 142A,A01,083219,Chow; Bennett,0,16,30,30
1650517263890,MATH 142A,A02,083220,Chow; Bennett,0,14,30,30
1650517263890,MATH 142A,B01,083221,Chow; Bennett,0,14,30,30
1650517263890,MATH 142A,B02,083222,Chow; Bennett,0,13,30,30
1650517269914,MATH 193A,A01,083224,Staff,0,6,30,30
1650517269914,MATH 193A,A02,083225,Staff,0,5,30,30
1650517269914,MATH 193A,A03,083781,Staff,0,5,30,30
1650517269914,MATH 193A,A04,083782,Staff,0,7,30,30
1650517275939,MATH 197,001,091859,McAuley; Julian John,9998,0,9999,1
1650517281994,COGS 9,A01,083615,Staff,0,15,60,60
1650517288018,COGS 11,A01,083617,Boyle; Mary E. T.,19,0,40,21
1650517294047,COGS 13,A01,083071,Staff,0,35,40,40
1650517300074,COGS 14A,A01,092681,Staff,1,26,100,99
1650517306101,COGS 14B,A01,083073,Cheng; Tzu-Han,1,13,50,49
1650517312128,COGS 17,A01,092677,Staff,20,0,75,55
1650517318159,COGS 100,A01,083619,Staff,0,27,60,60
1650517324183,COGS 101A,A01,083621,Davis; Joshua Daniel,0,25,60,60
1650517330207,COGS 101B,A01,091572,Staff,0,4,60,60
1650517336234,COGS 101C,A01,083625,Delgado; Tania,16,0,30,14
1650517342259,COGS 107A,A01,083627,Boyle; Mary E. T.,0,12,60,60
1650517348281,COGS 118A,A01,083075,Staff,0,3,60,60
1650517354308,CSE 3,A50,083646,Miranda; Gregory Joseph,20,0,38,18
1650517354308,CSE 3,A51,083647,Miranda; Gregory Joseph,36,0,37,1
1650517360337,CSE 8A,A50,083650,Miranda; Gregory Joseph,1,30,40,39
1650517366364,CSE 11,A01,083080,Cao; Yingjun,0,93,40,40
1650517372390,CSE 12,A01,083652,Staff,0,17,100,100
1650517378415,CSE 15L,A01,083654,Staff,0,1,50,50
1650517378415,CSE 15L,A02,083655,Staff,0,0,50,50
1650517384439,CSE 20,A01,083657,Staff,51,0,80,29
1650517390462,CSE 30,A01,083084,Eldon; John,0,77,40,40
1650517396487,CSE 100,A01,083659,Cao; Yingjun,0,66,50,50
1650517402517,CSE 134B,A01,083661,Powell; Thomas Allan,0,34,65,65
1650517408540,CSE 140,A01,083663,Staff,0,5,75,75
1650517414562,CSE 140L,A01,083088,Eldon; John,0,11,75,75
1650517420676,CSE 175,A01,083665,Kumar; Rakesh,7,0,25,18
1650517426699,CSE 190,A00,092507,Dubnov; Shlomo,10,0,20,10
1650517432723,ECE 45,A01,083139,Staff,20,19,60,40
1650517438746,ECE 65,A50,083695,Staff,0,6,30,30
1650517444771,ECE 109,A01,091882,Touri; Behrouz,35,0,70,35
1650517450794,ECE 180,A00,083140,Abi Samra; Nicholas Camill,21,0,30,9
1650517450794,ECE 180,B00,083141,Abi Samra; Nicholas Camill,0,0,30,30
1650517456821,MATH 10A,A01,083735,Patchell; Gregory David,5,0,30,25
1650517456821,MATH 10A,A02,083736,Patchell; Gregory David,27,0,30,3
1650517456821,MATH 10A,A03,083737,Patchell; Gregory David,24,0,30,6
1650517462845,MATH 10B,A01,083207,Staff,0,9,30,30
1650517462845,MATH 10B,A02,083208,Staff,0,7,30,30
1650517462845,MATH 10B,B01,083739,Staff,13,0,30,17
1650517462845,MATH 10B,B02,083740,Staff,28,0,30,2
1650517468870,MATH 18,A01,083743,Staff,1,0,30,29
1650517468870,MATH 18,A02,083744,Staff,27,0,30,3
1650517468870,MATH 18,A03,083745,Staff,22,0,30,8
1650517468870,MATH 18,A04,083746,Staff,26,0,30,4
1650517468870,MATH 18,B01,083748,Staff,0,12,30,30
1650517468870,MATH 18,B02,083749,Staff,0,12,30,30
1650517468870,MATH 18,B03,083750,Staff,0,11,30,30
1650517468870,MATH 18,B04,083751,Staff,0,12,30,30
1650517474894,MATH 20A,A01,083754,Staff,23,0,40,17
1650517480920,MATH 20B,A01,083756,Staff,0,11,30,30
1650517480920,MATH 20B,A02,083757,Staff,0,11,30,30
1650517486945,MATH 20C,A01,083760,Staff,0,16,30,30
1650517486945,MATH 20C,A02,083761,Staff,2,16,30,28
1650517486945,MATH 20C,B01,083762,Staff,12,0,30,18
1650517486945,MATH 20C,B02,083763,Staff,28,0,30,2
1650517492975,MATH 20D,A01,083765,Staff,0,1,30,30
1650517492975,MATH 20D,A02,083766,Staff,7,0,30,23
1650517492975,MATH 20D,A03,083767,Staff,25,0,30,5
1650517499008,MATH 20E,A01,083771,Staff,6,0,30,24
1650517499008,MATH 20E,A02,083772,Staff,18,0,30,12
1650517499008,MATH 20E,B01,083773,Staff,0,0,30,30
1650517499008,MATH 20E,B02,083774,Staff,10,0,30,20
1650517505034,MATH 103A,A01,083777,Staff,0,14,30,30
1650517505034,MATH 103A,A02,083778,Staff,0,14,30,30
1650517505034,MATH 103A,B01,083779,Staff,0,13,30,30
1650517505034,MATH 103A,B02,083780,Staff,0,13,30,30
1650517511061,MATH 105,A01,085443,Staff,1,23,30,29
1650517517090,MATH 109,A01,083213,Anzaldo; Leesa B,0,7,30,30
1650517517090,MATH 109,A02,083214,Anzaldo; Leesa B,0,7,30,30
1650517517090,MATH 109,B01,083215,Anzaldo; Leesa B,0,5,30,30
1650517517090,MATH 109,B02,083216,Anzaldo; Leesa B,0,6,30,30
1650517523114,MATH 142A,A01,083219,Chow; Bennett,0,16,30,30
1650517523114,MATH 142A,A02,083220,Chow; Bennett,0,14,30,30
1650517523114,MATH 142A,B01,083221,Chow; Bennett,0,14,30,30
1650517523114,MATH 142A,B02,083222,Chow; Bennett,0,13,30,30
1650517529139,MATH 193A,A01,083224,Staff,0,6,30,30
1650517529139,MATH 193A,A02,083225,Staff,0,5,30,30
1650517529139,MATH 193A,A03,083781,Staff,0,5,30,30
1650517529139,MATH 193A,A04,083782,Staff,0,7,30,30
1650517535164,MATH 197,001,091859,McAuley; Julian John,9998,0,9999,1
1650517541227,COGS 9,A01,083615,Staff,0,15,60,60
1650517547249,COGS 11,A01,083617,Boyle; Mary E. T.,19,0,40,21
1650517553274,COGS 13,A01,083071,Staff,0,35,40,40
1650517559299,COGS 14A,A01,092681,Staff,1,26,100,99
1650517565322,COGS 14B,A01,083073,Cheng; Tzu-Han,1,13,50,49
1650517571344,COGS 17,A01,092677,Staff,20,0,75,55
1650517577370,COGS 100,A01,083619,Staff,0,27,60,60
1650517583396,COGS 101A,A01,083621,Davis; Joshua Daniel,0,25,60,60
1650517589422,COGS 101B,A01,091572,Staff,0,4,60,60
1650517595449,COGS 101C,A01,083625,Delgado; Tania,16,0,30,14
1650517601480,COGS 107A,A01,083627,Boyle; Mary E. T.,0,12,60,60
1650517607510,COGS 118A,A01,083075,Staff,0,3,60,60
1650517613546,CSE 3,A50,083646,Miranda; Gregory Joseph,20,0,38,18
1650517613546,CSE 3,A51,083647,Miranda; Gregory Joseph,36,0,37,1
1650517619574,CSE 8A,A50,083650,Miranda; Gregory Joseph,1,30,40,39
1650517625601,CSE 11,A01,083080,Cao; Yingjun,0,93,40,40
1650517631624,CSE 12,A01,083652,Staff,0,17,100,100
1650517637652,CSE 15L,A01,083654,Staff,0,1,50,50
1650517637652,CSE 15L,A02,083655,Staff,0,0,50,50
1650517643695,CSE 20,A01,083657,Staff,51,0,80,29
1650517649723,CSE 30,A01,083084,Eldon; John,0,77,40,40
1650517655747,CSE 100,A01,083659,Cao; Yingjun,0,66,50,50
1650517661779,CSE 134B,A01,083661,Powell; Thomas Allan,0,34,65,65
1650517667803,CSE 140,A01,083663,Staff,0,5,75,75
1650517673847,CSE 140L,A01,083088,Eldon; John,0,11,75,75
1650517679884,CSE 175,A01,083665,Kumar; Rakesh,7,0,25,18
1650517685908,CSE 190,A00,092507,Dubnov; Shlomo,10,0,20,10
1650517691934,ECE 45,A01,083139,Staff,20,19,60,40
1650517697960,ECE 65,A50,083695,Staff,0,6,30,30
1650517703985,ECE 109,A01,091882,Touri; Behrouz,35,0,70,35
1650517710009,ECE 180,A00,083140,Abi Samra; Nicholas Camill,21,0,30,9
1650517710009,ECE 180,B00,083141,Abi Samra; Nicholas Camill,0,0,30,30
1650517716034,MATH 10A,A01,083735,Patchell; Gregory David,5,0,30,25
1650517716034,MATH 10A,A02,083736,Patchell; Gregory David,27,0,30,3
1650517716034,MATH 10A,A03,083737,Patchell; Gregory David,24,0,30,6
1650517722059,MATH 10B,A01,083207,Staff,0,9,30,30
1650517722059,MATH 10B,A02,083208,Staff,0,7,30,30
1650517722059,MATH 10B,B01,083739,Staff,13,0,30,17
1650517722059,MATH 10B,B02,083740,Staff,28,0,30,2
1650517728088,MATH 18,A01,083743,Staff,1,0,30,29
1650517728088,MATH 18,A02,083744,Staff,27,0,30,3
1650517728088,MATH 18,A03,083745,Staff,22,0,30,8
1650517728088,MATH 18,A04,083746,Staff,26,0,30,4
1650517728088,MATH 18,B01,083748,Staff,0,12,30,30
1650517728088,MATH 18,B02,083749,Staff,0,12,30,30
1650517728088,MATH 18,B03,083750,Staff,0,11,30,30
1650517728088,MATH 18,B04,083751,Staff,0,12,30,30
1650517734117,MATH 20A,A01,083754,Staff,23,0,40,17
1650517740139,MATH 20B,A01,083756,Staff,0,11,30,30
1650517740139,MATH 20B,A02,083757,Staff,0,11,30,30
1650517746164,MATH 20C,A01,083760,Staff,0,16,30,30
1650517746164,MATH 20C,A02,083761,Staff,2,16,30,28
1650517746164,MATH 20C,B01,083762,Staff,12,0,30,18
1650517746164,MATH 20C,B02,083763,Staff,28,0,30,2
1650517752192,MATH 20D,A01,083765,Staff,0,1,30,30
1650517752192,MATH 20D,A02,083766,Staff,7,0,30,23
1650517752192,MATH 20D,A03,083767,Staff,25,0,30,5
1650517758215,MATH 20E,A01,083771,Staff,6,0,30,24
1650517758215,MATH 20E,A02,083772,Staff,18,0,30,12
1650517758215,MATH 20E,B01,083773,Staff,0,0,30,30
1650517758215,MATH 20E,B02,083774,Staff,10,0,30,20
1650517764240,MATH 103A,A01,083777,Staff,0,14,30,30
1650517764240,MATH 103A,A02,083778,Staff,0,14,30,30
1650517764240,MATH 103A,B01,083779,Staff,0,13,30,30
1650517764240,MATH 103A,B02,083780,Staff,0,13,30,30
1650517770265,MATH 105,A01,085443,Staff,2,23,30,28
1650517776290,MATH 109,A01,083213,Anzaldo; Leesa B,0,8,30,30
1650517776290,MATH 109,A02,083214,Anzaldo; Leesa B,0,7,30,30
1650517776290,MATH 109,B01,083215,Anzaldo; Leesa B,0,5,30,30
1650517776290,MATH 109,B02,083216,Anzaldo; Leesa B,0,6,30,30
1650517782317,MATH 142A,A01,083219,Chow; Bennett,0,16,30,30
1650517782317,MATH 142A,A02,083220,Chow; Bennett,0,14,30,30
1650517782317,MATH 142A,B01,083221,Chow; Bennett,0,14,30,30
1650517782317,MATH 142A,B02,083222,Chow; Bennett,0,13,30,30
1650517788352,MATH 193A,A01,083224,Staff,0,6,30,30
1650517788352,MATH 193A,A02,083225,Staff,0,5,30,30
1650517788352,MATH 193A,A03,083781,Staff,0,5,30,30
1650517788352,MATH 193A,A04,083782,Staff,0,7,30,30
1650517794379,MATH 197,001,091859,McAuley; Julian John,9998,0,9999,1
1650517800434,COGS 9,A01,083615,Staff,0,15,60,60
1650517806457,COGS 11,A01,083617,Boyle; Mary E. T.,19,0,40,21
1650517812486,COGS 13,A01,083071,Staff,0,35,40,40
1650517818508,COGS 14A,A01,092681,Staff,1,26,100,99
1650517824538,COGS 14B,A01,083073,Cheng; Tzu-Han,1,13,50,49
1650517830565,COGS 17,A01,092677,Staff,20,0,75,55
1650517836587,COGS 100,A01,083619,Staff,0,27,60,60
1650517842609,COGS 101A,A01,083621,Davis; Joshua Daniel,0,26,60,60
1650517848637,COGS 101B,A01,091572,Staff,0,4,60,60
1650517854665,COGS 101C,A01,083625,Delgado; Tania,16,0,30,14
1650517860689,COGS 107A,A01,083627,Boyle; Mary E. T.,0,12,60,60
1650517866715,COGS 118A,A01,083075,Staff,0,3,60,60
1650517872742,CSE 3,A50,083646,Miranda; Gregory Joseph,20,0,38,18
1650517872742,CSE 3,A51,083647,Miranda; Gregory Joseph,36,0,37,1
1650517878764,CSE 8A,A50,083650,Miranda; Gregory Joseph,1,30,40,39
1650517884789,CSE 11,A01,083080,Cao; Yingjun,0,93,40,40
1650517890816,CSE 12,A01,083652,Staff,0,17,100,100
1650517896842,CSE 15L,A01,083654,Staff,0,1,50,50
1650517896842,CSE 15L,A02,083655,Staff,0,0,50,50
1650517902866,CSE 20,A01,083657,Staff,51,0,80,29
1650517908893,CSE 30,A01,083084,Eldon; John,0,77,40,40
1650517914921,CSE 100,A01,083659,Cao; Yingjun,0,66,50,50
1650517920946,CSE 134B,A01,083661,Powell; Thomas Allan,0,34,65,65
1650517926971,CSE 140,A01,083663,Staff,0,5,75,75
1650517932995,CSE 140L,A01,083088,Eldon; John,0,11,75,75
1650517939022,CSE 175,A01,083665,Kumar; Rakesh,7,0,25,18
1650517945049,CSE 190,A00,092507,Dubnov; Shlomo,10,0,20,10
1650517951078,ECE 45,A01,083139,Staff,20,19,60,40
1650517957111,ECE 65,A50,083695,Staff,0,6,30,30
1650517963134,ECE 109,A01,091882,Touri; Behrouz,35,0,70,35
1650517969161,ECE 180,A00,083140,Abi Samra; Nicholas Camill,21,0,30,9
1650517969161,ECE 180,B00,083141,Abi Samra; Nicholas Camill,0,0,30,30
1650517975183,MATH 10A,A01,083735,Patchell; Gregory David,5,0,30,25
1650517975183,MATH 10A,A02,083736,Patchell; Gregory David,27,0,30,3
1650517975183,MATH 10A,A03,083737,Patchell; Gregory David,24,0,30,6
1650517981213,MATH 10B,A01,083207,Staff,0,9,30,30
1650517981213,MATH 10B,A02,083208,Staff,0,7,30,30
1650517981213,MATH 10B,B01,083739,Staff,13,0,30,17
1650517981213,MATH 10B,B02,083740,Staff,28,0,30,2
1650517987237,MATH 18,A01,083743,Staff,1,0,30,29
1650517987237,MATH 18,A02,083744,Staff,27,0,30,3
1650517987237,MATH 18,A03,083745,Staff,22,0,30,8
1650517987237,MATH 18,A04,083746,Staff,26,0,30,4
1650517987237,MATH 18,B01,083748,Staff,0,12,30,30
1650517987237,MATH 18,B02,083749,Staff,0,12,30,30
1650517987237,MATH 18,B03,083750,Staff,0,11,30,30
1650517987237,MATH 18,B04,083751,Staff,0,12,30,30
1650517993264,MATH 20A,A01,083754,Staff,23,0,40,17
1650517999289,MATH 20B,A01,083756,Staff,0,11,30,30
1650517999289,MATH 20B,A02,083757,Staff,0,11,30,30
1650518005315,MATH 20C,A01,083760,Staff,0,16,30,30
1650518005315,MATH 20C,A02,083761,Staff,2,16,30,28
1650518005315,MATH 20C,B01,083762,Staff,12,0,30,18
1650518005315,MATH 20C,B02,083763,Staff,28,0,30,2
1650518011341,MATH 20D,A01,083765,Staff,0,1,30,30
1650518011341,MATH 20D,A02,083766,Staff,7,0,30,23
1650518011341,MATH 20D,A03,083767,Staff,25,0,30,5
1650518017461,MATH 20E,A01,083771,Staff,6,0,30,24
1650518017461,MATH 20E,A02,083772,Staff,18,0,30,12
1650518017461,MATH 20E,B01,083773,Staff,0,0,30,30
1650518017461,MATH 20E,B02,083774,Staff,10,0,30,20
1650518023488,MATH 103A,A01,083777,Staff,0,14,30,30
1650518023488,MATH 103A,A02,083778,Staff,0,14,30,30
1650518023488,MATH 103A,B01,083779,Staff,0,13,30,30
1650518023488,MATH 103A,B02,083780,Staff,0,13,30,30
1650518029515,MATH 105,A01,085443,Staff,2,23,30,28
1650518035545,MATH 109,A01,083213,Anzaldo; Leesa B,0,8,30,30
1650518035545,MATH 109,A02,083214,Anzaldo; Leesa B,0,7,30,30
1650518035545,MATH 109,B01,083215,Anzaldo; Leesa B,0,5,30,30
1650518035545,MATH 109,B02,083216,Anzaldo; Leesa B,0,6,30,30
1650518041572,MATH 142A,A01,083219,Chow; Bennett,0,16,30,30
1650518041572,MATH 142A,A02,083220,Chow; Bennett,0,14,30,30
1650518041572,MATH 142A,B01,083221,Chow; Bennett,0,14,30,30
1650518041572,MATH 142A,B02,083222,Chow; Bennett,0,13,30,30
1650518047599,MATH 193A,A01,083224,Staff,0,6,30,30
1650518047599,MATH 193A,A02,083225,Staff,0,5,30,30
1650518047599,MATH 193A,A03,083781,Staff,0,5,30,30
1650518047599,MATH 193A,A04,083782,Staff,0,7,30,30
1650518053623,MATH 197,001,091859,McAuley; Julian John,9998,0,9999,1
1650518059683,COGS 9,A01,083615,Staff,0,15,60,60
1650518065715,COGS 11,A01,083617,Boyle; Mary E. T.,19,0,40,21
1650518071737,COGS 13,A01,083071,Staff,0,35,40,40
1650518077768,COGS 14A,A01,092681,Staff,1,26,100,99
1650518083795,COGS 14B,A01,083073,Cheng; Tzu-Han,1,13,50,49
1650518089821,COGS 17,A01,092677,Staff,20,0,75,55
1650518095846,COGS 100,A01,083619,Staff,1,27,60,59
1650518101872,COGS 101A,A01,083621,Davis; Joshua Daniel,0,26,60,60
1650518107899,COGS 101B,A01,091572,Staff,0,4,60,60
1650518113922,COGS 101C,A01,083625,Delgado; Tania,16,0,30,14
1650518119947,COGS 107A,A01,083627,Boyle; Mary E. T.,1,12,60,59
1650518125972,COGS 118A,A01,083075,Staff,0,3,60,60
1650518131996,CSE 3,A50,083646,Miranda; Gregory Joseph,20,0,38,18
1650518131996,CSE 3,A51,083647,Miranda; Gregory Joseph,36,0,37,1
1650518138022,CSE 8A,A50,083650,Miranda; Gregory Joseph,1,30,40,39
1650518144049,CSE 11,A01,083080,Cao; Yingjun,0,93,40,40
1650518150075,CSE 12,A01,083652,Staff,0,17,100,100
1650518156104,CSE 15L,A01,083654,Staff,0,1,50,50
1650518156104,CSE 15L,A02,083655,Staff,0,0,50,50
1650518162131,CSE 20,A01,083657,Staff,51,0,80,29
1650518168158,CSE 30,A01,083084,Eldon; John,0,77,40,40
1650518174182,CSE 100,A01,083659,Cao; Yingjun,0,66,50,50
1650518180207,CSE 134B,A01,083661,Powell; Thomas Allan,0,34,65,65
1650518186230,CSE 140,A01,083663,Staff,0,5,75,75
1650518192252,CSE 140L,A01,083088,Eldon; John,0,11,75,75
1650518198282,CSE 175,A01,083665,Kumar; Rakesh,7,0,25,18
1650518204313,CSE 190,A00,092507,Dubnov; Shlomo,10,0,20,10
1650518210340,ECE 45,A01,083139,Staff,20,19,60,40
1650518216364,ECE 65,A50,083695,Staff,0,6,30,30
1650518222388,ECE 109,A01,091882,Touri; Behrouz,35,0,70,35
1650518228415,ECE 180,A00,083140,Abi Samra; Nicholas Camill,21,0,30,9
1650518228415,ECE 180,B00,083141,Abi Samra; Nicholas Camill,0,0,30,30
1650518234440,MATH 10A,A01,083735,Patchell; Gregory David,5,0,30,25
1650518234440,MATH 10A,A02,083736,Patchell; Gregory David,27,0,30,3
1650518234440,MATH 10A,A03,083737,Patchell; Gregory David,24,0,30,6
1650518240463,MATH 10B,A01,083207,Staff,0,9,30,30
1650518240463,MATH 10B,A02,083208,Staff,0,7,30,30
1650518240463,MATH 10B,B01,083739,Staff,13,0,30,17
1650518240463,MATH 10B,B02,083740,Staff,28,0,30,2
1650518246490,MATH 18,A01,083743,Staff,1,0,30,29
1650518246490,MATH 18,A02,083744,Staff,27,0,30,3
1650518246490,MATH 18,A03,083745,Staff,22,0,30,8
1650518246490,MATH 18,A04,083746,Staff,26,0,30,4
1650518246490,MATH 18,B01,083748,Staff,0,12,30,30
1650518246490,MATH 18,B02,083749,Staff,0,12,30,30
1650518246490,MATH 18,B03,083750,Staff,0,11,30,30
1650518246490,MATH 18,B04,083751,Staff,0,12,30,30
1650518252515,MATH 20A,A01,083754,Staff,23,0,40,17
1650518258541,MATH 20B,A01,083756,Staff,0,11,30,30
1650518258541,MATH 20B,A02,083757,Staff,0,11,30,30
1650518264573,MATH 20C,A01,083760,Staff,0,16,30,30
1650518264573,MATH 20C,A02,083761,Staff,2,16,30,28
1650518264573,MATH 20C,B01,083762,Staff,12,0,30,18
1650518264573,MATH 20C,B02,083763,Staff,28,0,30,2
1650518270601,MATH 20D,A01,083765,Staff,0,1,30,30
1650518270601,MATH 20D,A02,083766,Staff,7,0,30,23
1650518270601,MATH 20D,A03,083767,Staff,25,0,30,5
1650518276628,MATH 20E,A01,083771,Staff,6,0,30,24
1650518276628,MATH 20E,A02,083772,Staff,18,0,30,12
1650518276628,MATH 20E,B01,083773,Staff,0,0,30,30
1650518276628,MATH 20E,B02,083774,Staff,10,0,30,20
1650518282661,MATH 103A,A01,083777,Staff,0,14,30,30
1650518282661,MATH 103A,A02,083778,Staff,0,14,30,30
1650518282661,MATH 103A,B01,083779,Staff,0,13,30,30
1650518282661,MATH 103A,B02,083780,Staff,0,13,30,30
1650518288686,MATH 105,A01,085443,Staff,2,23,30,28
1650518294709,MATH 109,A01,083213,Anzaldo; Leesa B,0,8,30,30
1650518294709,MATH 109,A02,083214,Anzaldo; Leesa B,0,7,30,30
1650518294709,MATH 109,B01,083215,Anzaldo; Leesa B,0,5,30,30
1650518294709,MATH 109,B02,083216,Anzaldo; Leesa B,0,6,30,30
1650518300733,MATH 142A,A01,083219,Chow; Bennett,0,16,30,30
1650518300733,MATH 142A,A02,083220,Chow; Bennett,0,14,30,30
1650518300733,MATH 142A,B01,083221,Chow; Bennett,0,14,30,30
1650518300733,MATH 142A,B02,083222,Chow; Bennett,0,13,30,30
1650518306757,MATH 193A,A01,083224,Staff,0,6,30,30
1650518306757,MATH 193A,A02,083225,Staff,0,5,30,30
1650518306757,MATH 193A,A03,083781,Staff,0,5,30,30
1650518306757,MATH 193A,A04,083782,Staff,0,7,30,30
1650518312787,MATH 197,001,091859,McAuley; Julian John,9998,0,9999,1
1650518318848,COGS 9,A01,083615,Staff,0,15,60,60
1650518324876,COGS 11,A01,083617,Boyle; Mary E. T.,19,0,40,21
1650518330916,COGS 13,A01,083071,Staff,0,35,40,40
1650518336943,COGS 14A,A01,092681,Staff,1,26,100,99
1650518342966,COGS 14B,A01,083073,Cheng; Tzu-Han,1,13,50,49
1650518348994,COGS 17,A01,092677,Staff,20,0,75,55
1650518355022,COGS 100,A01,083619,Staff,1,27,60,59
1650518361048,COGS 101A,A01,083621,Davis; Joshua Daniel,0,26,60,60
1650518367074,COGS 101B,A01,091572,Staff,0,4,60,60
1650518373102,COGS 101C,A01,083625,Delgado; Tania,16,0,30,14
1650518379127,COGS 107A,A01,083627,Boyle; Mary E. T.,1,12,60,59
1650518385151,COGS 118A,A01,083075,Staff,0,3,60,60
1650518391184,CSE 3,A50,083646,Miranda; Gregory Joseph,20,0,38,18
1650518391184,CSE 3,A51,083647,Miranda; Gregory Joseph,36,0,37,1
1650518397207,CSE 8A,A50,083650,Miranda; Gregory Joseph,1,30,40,39
1650518403232,CSE 11,A01,083080,Cao; Yingjun,0,93,40,40
1650518409255,CSE 12,A01,083652,Staff,0,17,100,100
1650518415290,CSE 15L,A01,083654,Staff,0,1,50,50
1650518415290,CSE 15L,A02,083655,Staff,0,0,50,50
1650518421314,CSE 20,A01,083657,Staff,51,0,80,29
1650518427340,CSE 30,A01,083084,Eldon; John,0,77,40,40
1650518433363,CSE 100,A01,083659,Cao; Yingjun,0,66,50,50
1650518439386,CSE 134B,A01,083661,Powell; Thomas Allan,0,34,65,65
1650518445412,CSE 140,A01,083663,Staff,0,5,75,75
1650518451436,CSE 140L,A01,083088,Eldon; John,0,11,75,75
1650518457460,CSE 175,A01,083665,Kumar; Rakesh,7,0,25,18
1650518463490,CSE 190,A00,092507,Dubnov; Shlomo,10,0,20,10
1650518469523,ECE 45,A01,083139,Staff,20,19,60,40
1650518475550,ECE 65,A50,083695,Staff,0,6,30,30
1650518481572,ECE 109,A01,091882,Touri; Behrouz,35,0,70,35
1650518487596,ECE 180,A00,083140,Abi Samra; Nicholas Camill,21,0,30,9
1650518487596,ECE 180,B00,083141,Abi Samra; Nicholas Camill,0,0,30,30
1650518493625,MATH 10A,A01,083735,Patchell; Gregory David,5,0,30,25
1650518493625,MATH 10A,A02,083736,Patchell; Gregory David,27,0,30,3
1650518493625,MATH 10A,A03,083737,Patchell; Gregory David,24,0,30,6
1650518499651,MATH 10B,A01,083207,Staff,0,9,30,30
1650518499651,MATH 10B,A02,083208,Staff,0,7,30,30
1650518499651,MATH 10B,B01,083739,Staff,13,0,30,17
1650518499651,MATH 10B,B02,083740,Staff,28,0,30,2
1650518505674,MATH 18,A01,083743,Staff,1,0,30,29
1650518505674,MATH 18,A02,083744,Staff,27,0,30,3
1650518505674,MATH 18,A03,083745,Staff,22,0,30,8
1650518505674,MATH 18,A04,083746,Staff,26,0,30,4
1650518505674,MATH 18,B01,083748,Staff,0,12,30,30
1650518505674,MATH 18,B02,083749,Staff,0,12,30,30
1650518505674,MATH 18,B03,083750,Staff,0,11,30,30
1650518505674,MATH 18,B04,083751,Staff,0,12,30,30
1650518511703,MATH 20A,A01,083754,Staff,23,0,40,17
1650518517725,MATH 20B,A01,083756,Staff,0,11,30,30
1650518517725,MATH 20B,A02,083757,Staff,0,11,30,30
1650518523752,MATH 20C,A01,083760,Staff,0,16,30,30
1650518523752,MATH 20C,A02,083761,Staff,2,16,30,28
1650518523752,MATH 20C,B01,083762,Staff,12,0,30,18
1650518523752,MATH 20C,B02,083763,Staff,28,0,30,2
1650518529775,MATH 20D,A01,083765,Staff,0,1,30,30
1650518529775,MATH 20D,A02,083766,Staff,7,0,30,23
1650518529775,MATH 20D,A03,083767,Staff,25,0,30,5
1650518535797,MATH 20E,A01,083771,Staff,6,0,30,24
1650518535797,MATH 20E,A02,083772,Staff,18,0,30,12
1650518535797,MATH 20E,B01,083773,Staff,0,0,30,30
1650518535797,MATH 20E,B02,083774,Staff,10,0,30,20
1650518541822,MATH 103A,A01,083777,Staff,0,14,30,30
1650518541822,MATH 103A,A02,083778,Staff,0,14,30,30
1650518541822,MATH 103A,B01,083779,Staff,0,13,30,30
1650518541822,MATH 103A,B02,083780,Staff,0,13,30,30
1650518547848,MATH 105,A01,085443,Staff,2,23,30,28
1650518553878,MATH 109,A01,083213,Anzaldo; Leesa B,0,8,30,30
1650518553878,MATH 109,A02,083214,Anzaldo; Leesa B,0,7,30,30
1650518553878,MATH 109,B01,083215,Anzaldo; Leesa B,0,5,30,30
1650518553878,MATH 109,B02,083216,Anzaldo; Leesa B,0,6,30,30
1650518559907,MATH 142A,A01,083219,Chow; Bennett,0,16,30,30
1650518559907,MATH 142A,A02,083220,Chow; Bennett,0,14,30,30
1650518559907,MATH 142A,B01,083221,Chow; Bennett,0,14,30,30
1650518559907,MATH 142A,B02,083222,Chow; Bennett,0,13,30,30
1650518565936,MATH 193A,A01,083224,Staff,0,6,30,30
1650518565936,MATH 193A,A02,083225,Staff,0,5,30,30
1650518565936,MATH 193A,A03,083781,Staff,0,5,30,30
1650518565936,MATH 193A,A04,083782,Staff,0,7,30,30
1650518571958,MATH 197,001,091859,McAuley; Julian John,9998,0,9999,1
1650518578017,COGS 9,A01,083615,Staff,0,15,60,60
1650518584042,COGS 11,A01,083617,Boyle; Mary E. T.,19,0,40,21
1650518590066,COGS 13,A01,083071,Staff,0,35,40,40
1650518596095,COGS 14A,A01,092681,Staff,1,26,100,99
1650518602132,COGS 14B,A01,083073,Cheng; Tzu-Han,1,13,50,49
1650518608245,COGS 17,A01,092677,Staff,20,0,75,55
1650518614269,COGS 100,A01,083619,Staff,1,27,60,59
1650518620291,COGS 101A,A01,083621,Davis; Joshua Daniel,0,26,60,60
1650518626316,COGS 101B,A01,091572,Staff,0,4,60,60
1650518632340,COGS 101C,A01,083625,Delgado; Tania,16,0,30,14
1650518638362,COGS 107A,A01,083627,Boyle; Mary E. T.,1,12,60,59
1650518644388,COGS 118A,A01,083075,Staff,0,3,60,60
1650518650416,CSE 3,A50,083646,Miranda; Gregory Joseph,20,0,38,18
1650518650416,CSE 3,A51,083647,Miranda; Gregory Joseph,36,0,37,1
1650518656439,CSE 8A,A50,083650,Miranda; Gregory Joseph,1,30,40,39
1650518662465,CSE 11,A01,083080,Cao; Yingjun,0,94,40,40
1650518668490,CSE 12,A01,083652,Staff,0,17,100,100
1650518674519,CSE 15L,A01,083654,Staff,0,1,50,50
1650518674519,CSE 15L,A02,083655,Staff,0,0,50,50
1650518680545,CSE 20,A01,083657,Staff,51,0,80,29
1650518686578,CSE 30,A01,083084,Eldon; John,0,77,40,40
1650518692605,CSE 100,A01,083659,Cao; Yingjun,0,66,50,50
1650518698631,CSE 134B,A01,083661,Powell; Thomas Allan,0,34,65,65
1650518704653,CSE 140,A01,083663,Staff,0,5,75,75
1650518710676,CSE 140L,A01,083088,Eldon; John,0,11,75,75
1650518716700,CSE 175,A01,083665,Kumar; Rakesh,7,0,25,18
1650518722723,CSE 190,A00,092507,Dubnov; Shlomo,10,0,20,10
1650518728754,ECE 45,A01,083139,Staff,20,19,60,40
1650518734779,ECE 65,A50,083695,Staff,0,6,30,30
1650518740803,ECE 109,A01,091882,Touri; Behrouz,35,0,70,35
1650518746828,ECE 180,A00,083140,Abi Samra; Nicholas Camill,21,0,30,9
1650518746828,ECE 180,B00,083141,Abi Samra; Nicholas Camill,0,0,30,30
1650518752852,MATH 10A,A01,083735,Patchell; Gregory David,5,0,30,25
1650518752852,MATH 10A,A02,083736,Patchell; Gregory David,27,0,30,3
1650518752852,MATH 10A,A03,083737,Patchell; Gregory David,24,0,30,6
1650518758880,MATH 10B,A01,083207,Staff,0,9,30,30
1650518758880,MATH 10B,A02,083208,Staff,0,7,30,30
1650518758880,MATH 10B,B01,083739,Staff,13,0,30,17
1650518758880,MATH 10B,B02,083740,Staff,28,0,30,2
1650518764910,MATH 18,A01,083743,Staff,1,0,30,29
1650518764910,MATH 18,A02,083744,Staff,27,0,30,3
1650518764910,MATH 18,A03,083745,Staff,22,0,30,8
1650518764910,MATH 18,A04,083746,Staff,26,0,30,4
1650518764910,MATH 18,B01,083748,Staff,0,12,30,30
1650518764910,MATH 18,B02,083749,Staff,0,12,30,30
1650518764910,MATH 18,B03,083750,Staff,0,11,30,30
1650518764910,MATH 18,B04,083751,Staff,0,12,30,30
1650518770934,MATH 20A,A01,083754,Staff,23,0,40,17
1650518776962,MATH 20B,A01,083756,Staff,0,11,30,30
1650518776962,MATH 20B,A02,083757,Staff,0,11,30,30
1650518782986,MATH 20C,A01,083760,Staff,0,16,30,30
1650518782986,MATH 20C,A02,083761,Staff,2,16,30,28
1650518782986,MATH 20C,B01,083762,Staff,12,0,30,18
1650518782986,MATH 20C,B02,083763,Staff,28,0,30,2
1650518789020,MATH 20D,A01,083765,Staff,0,1,30,30
1650518789020,MATH 20D,A02,083766,Staff,7,0,30,23
1650518789020,MATH 20D,A03,083767,Staff,25,0,30,5
1650518795044,MATH 20E,A01,083771,Staff,6,0,30,24
1650518795044,MATH 20E,A02,083772,Staff,18,0,30,12
1650518795044,MATH 20E,B01,083773,Staff,0,0,30,30
1650518795044,MATH 20E,B02,083774,Staff,10,0,30,20
1650518801072,MATH 103A,A01,083777,Staff,0,14,30,30
1650518801072,MATH 103A,A02,083778,Staff,0,14,30,30
1650518801072,MATH 103A,B01,083779,Staff,0,13,30,30
1650518801072,MATH 103A,B02,083780,Staff,0,13,30,30
1650518807104,MATH 105,A01,085443,Staff,0,21,30,30
1650518813130,MATH 109,A01,083213,Anzaldo; Leesa B,0,8,30,30
1650518813130,MATH 109,A02,083214,Anzaldo; Leesa B,0,7,30,30
1650518813130,MATH 109,B01,083215,Anzaldo; Leesa B,0,5,30,30
1650518813130,MATH 109,B02,083216,Anzaldo; Leesa B,0,6,30,30
1650518819154,MATH 142A,A01,083219,Chow; Bennett,0,16,30,30
1650518819154,MATH 142A,A02,083220,Chow; Bennett,0,14,30,30
1650518819154,MATH 142A,B01,083221,Chow; Bennett,0,14,30,30
1650518819154,MATH 142A,B02,083222,Chow; Bennett,0,13,30,30
1650518825185,MATH 193A,A01,083224,Staff,0,6,30,30
1650518825185,MATH 193A,A02,083225,Staff,0,5,30,30
1650518825185,MATH 193A,A03,083781,Staff,0,5,30,30
1650518825185,MATH 193A,A04,083782,Staff,0,7,30,30
1650518831209,MATH 197,001,091859,McAuley; Julian John,9998,0,9999,1
1650518837267,COGS 9,A01,083615,Staff,0,15,60,60
1650518843290,COGS 11,A01,083617,Boyle; Mary E. T.,19,0,40,21
1650518849315,COGS 13,A01,083071,Staff,0,35,40,40
1650518855338,COGS 14A,A01,092681,Staff,0,25,100,100
1650518861362,COGS 14B,A01,083073,Cheng; Tzu-Han,0,12,50,50
1650518867386,COGS 17,A01,092677,Staff,20,0,75,55
1650518873410,COGS 100,A01,083619,Staff,0,26,60,60
1650518879434,COGS 101A,A01,083621,Davis; Joshua Daniel,0,26,60,60
1650518885458,COGS 101B,A01,091572,Staff,0,4,60,60
1650518891482,COGS 101C,A01,083625,Delgado; Tania,16,0,30,14
1650518897508,COGS 107A,A01,083627,Boyle; Mary E. T.,0,11,60,60
1650518903532,COGS 118A,A01,083075,Staff,0,3,60,60
1650518909556,CSE 3,A50,083646,Miranda; Gregory Joseph,20,0,38,18
1650518909556,CSE 3,A51,083647,Miranda; Gregory Joseph,36,0,37,1
1650518915579,CSE 8A,A50,083650,Miranda; Gregory Joseph,0,29,40,40
1650518921607,CSE 11,A01,083080,Cao; Yingjun,0,94,40,40
1650518927643,CSE 12,A01,083652,Staff,0,17,100,100
1650518933666,CSE 15L,A01,083654,Staff,0,1,50,50
1650518933666,CSE 15L,A02,083655,Staff,0,0,50,50
1650518939696,CSE 20,A01,083657,Staff,51,0,80,29
1650518945718,CSE 30,A01,083084,Eldon; John,0,77,40,40
1650518951748,CSE 100,A01,083659,Cao; Yingjun,0,66,50,50
1650518957775,CSE 134B,A01,083661,Powell; Thomas Allan,0,34,65,65
1650518963799,CSE 140,A01,083663,Staff,0,5,75,75
1650518969837,CSE 140L,A01,083088,Eldon; John,0,11,75,75
1650518975859,CSE 175,A01,083665,Kumar; Rakesh,7,0,25,18
1650518981885,CSE 190,A00,092507,Dubnov; Shlomo,10,0,20,10
1650518987909,ECE 45,A01,083139,Staff,1,0,60,59
1650518993938,ECE 65,A50,083695,Staff,0,6,30,30
1650518999965,ECE 109,A01,091882,Touri; Behrouz,35,0,70,35
1650519005987,ECE 180,A00,083140,Abi Samra; Nicholas Camill,21,0,30,9
1650519005987,ECE 180,B00,083141,Abi Samra; Nicholas Camill,0,0,30,30
1650519012011,MATH 10A,A01,083735,Patchell; Gregory David,5,0,30,25
1650519012011,MATH 10A,A02,083736,Patchell; Gregory David,27,0,30,3
1650519012011,MATH 10A,A03,083737,Patchell; Gregory David,24,0,30,6
1650519018035,MATH 10B,A01,083207,Staff,0,9,30,30
1650519018035,MATH 10B,A02,083208,Staff,0,7,30,30
1650519018035,MATH 10B,B01,083739,Staff,13,0,30,17
1650519018035,MATH 10B,B02,083740,Staff,28,0,30,2
1650519024061,MATH 18,A01,083743,Staff,1,0,30,29
1650519024061,MATH 18,A02,083744,Staff,27,0,30,3
1650519024061,MATH 18,A03,083745,Staff,22,0,30,8
1650519024061,MATH 18,A04,083746,Staff,26,0,30,4
1650519024061,MATH 18,B01,083748,Staff,0,12,30,30
1650519024061,MATH 18,B02,083749,Staff,0,12,30,30
1650519024061,MATH 18,B03,083750,Staff,0,11,30,30
1650519024061,MATH 18,B04,083751,Staff,0,12,30,30
1650519030088,MATH 20A,A01,083754,Staff,23,0,40,17
1650519036119,MATH 20B,A01,083756,Staff,0,11,30,30
1650519036119,MATH 20B,A02,083757,Staff,0,11,30,30
1650519042144,MATH 20C,A01,083760,Staff,0,16,30,30
1650519042144,MATH 20C,A02,083761,Staff,1,14,30,29
1650519042144,MATH 20C,B01,083762,Staff,12,0,30,18
1650519042144,MATH 20C,B02,083763,Staff,28,0,30,2
1650519048172,MATH 20D,A01,083765,Staff,0,1,30,30
1650519048172,MATH 20D,A02,083766,Staff,7,0,30,23
1650519048172,MATH 20D,A03,083767,Staff,25,0,30,5
1650519054206,MATH 20E,A01,083771,Staff,6,0,30,24
1650519054206,MATH 20E,A02,083772,Staff,18,0,30,12
1650519054206,MATH 20E,B01,083773,Staff,0,0,30,30
1650519054206,MATH 20E,B02,083774,Staff,10,0,30,20
1650519060236,MATH 103A,A01,083777,Staff,0,14,30,30
1650519060236,MATH 103A,A02,083778,Staff,0,14,30,30
1650519060236,MATH 103A,B01,083779,Staff,0,13,30,30
1650519060236,MATH 103A,B02,083780,Staff,0,13,30,30
1650519066264,MATH 105,A01,085443,Staff,0,21,30,30
1650519072294,MATH 109,A01,083213,Anzaldo; Leesa B,0,8,30,30
1650519072294,MATH 109,A02,083214,Anzaldo; Leesa B,0,7,30,30
1650519072294,MATH 109,B01,083215,Anzaldo; Leesa B,0,5,30,30
1650519072294,MATH 109,B02,083216,Anzaldo; Leesa B,0,6,30,30
1650519078332,MATH 142A,A01,083219,Chow; Bennett,0,16,30,30
1650519078332,MATH 142A,A02,083220,Chow; Bennett,0,14,30,30
1650519078332,MATH 142A,B01,083221,Chow; Bennett,0,14,30,30
1650519078332,MATH 142A,B02,083222,Chow; Bennett,0,13,30,30
1650519084357,MATH 193A,A01,083224,Staff,0,6,30,30
1650519084357,MATH 193A,A02,083225,Staff,0,5,30,30
1650519084357,MATH 193A,A03,083781,Staff,0,5,30,30
1650519084357,MATH 193A,A04,083782,Staff,0,7,30,30
1650519090381,MATH 197,001,091859,McAuley; Julian John,9998,0,9999,1
1650519096438,COGS 9,A01,083615,Staff,0,15,60,60
1650519102462,COGS 11,A01,083617,Boyle; Mary E. T.,19,0,40,21
1650519108494,COGS 13,A01,083071,Staff,0,35,40,40
1650519114521,COGS 14A,A01,092681,Staff,0,25,100,100
1650519120555,COGS 14B,A01,083073,Cheng; Tzu-Han,0,12,50,50
1650519126582,COGS 17,A01,092677,Staff,20,0,75,55
1650519132610,COGS 100,A01,083619,Staff,0,26,60,60
1650519138633,COGS 101A,A01,083621,Davis; Joshua Daniel,0,26,60,60
1650519144660,COGS 101B,A01,091572,Staff,0,4,60,60
1650519150683,COGS 101C,A01,083625,Delgado; Tania,16,0,30,14
1650519156711,COGS 107A,A01,083627,Boyle; Mary E. T.,0,11,60,60
1650519162738,COGS 118A,A01,083075,Staff,0,3,60,60
1650519168764,CSE 3,A50,083646,Miranda; Gregory Joseph,20,0,38,18
1650519168764,CSE 3,A51,083647,Miranda; Gregory Joseph,36,0,37,1
1650519174791,CSE 8A,A50,083650,Miranda; Gregory Joseph,0,29,40,40
1650519180834,CSE 11,A01,083080,Cao; Yingjun,0,94,40,40
1650519186870,CSE 12,A01,083652,Staff,0,17,100,100
1650519192896,CSE 15L,A01,083654,Staff,0,1,50,50
1650519192896,CSE 15L,A02,083655,Staff,0,0,50,50
1650519198925,CSE 20,A01,083657,Staff,51,0,80,29
1650519205042,CSE 30,A01,083084,Eldon; John,0,77,40,40
1650519211070,CSE 100,A01,083659,Cao; Yingjun,0,66,50,50
1650519217103,CSE 134B,A01,083661,Powell; Thomas Allan,0,34,65,65
1650519223127,CSE 140,A01,083663,Staff,0,5,75,75
1650519229152,CSE 140L,A01,083088,Eldon; John,0,11,75,75
1650519235180,CSE 175,A01,083665,Kumar; Rakesh,7,0,25,18
1650519241210,CSE 190,A00,092507,Dubnov; Shlomo,10,0,20,10
1650519247238,ECE 45,A01,083139,Staff,1,0,60,59
1650519253263,ECE 65,A50,083695,Staff,0,6,30,30
1650519259292,ECE 109,A01,091882,Touri; Behrouz,35,0,70,35
1650519265316,ECE 180,A00,083140,Abi Samra; Nicholas Camill,21,0,30,9
1650519265316,ECE 180,B00,083141,Abi Samra; Nicholas Camill,0,0,30,30
1650519271341,MATH 10A,A01,083735,Patchell; Gregory David,5,0,30,25
1650519271341,MATH 10A,A02,083736,Patchell; Gregory David,27,0,30,3
1650519271341,MATH 10A,A03,083737,Patchell; Gregory David,24,0,30,6
1650519277365,MATH 10B,A01,083207,Staff,0,9,30,30
1650519277365,MATH 10B,A02,083208,Staff,0,7,30,30
1650519277365,MATH 10B,B01,083739,Staff,13,0,30,17
1650519277365,MATH 10B,B02,083740,Staff,28,0,30,2
1650519283394,MATH 18,A01,083743,Staff,1,0,30,29
1650519283394,MATH 18,A02,083744,Staff,27,0,30,3
1650519283394,MATH 18,A03,083745,Staff,22,0,30,8
1650519283394,MATH 18,A04,083746,Staff,26,0,30,4
1650519283394,MATH 18,B01,083748,Staff,0,12,30,30
1650519283394,MATH 18,B02,083749,Staff,0,12,30,30
1650519283394,MATH 18,B03,083750,Staff,0,11,30,30
1650519283394,MATH 18,B04,083751,Staff,0,12,30,30
1650519289423,MATH 20A,A01,083754,Staff,23,0,40,17
1650519295447,MATH 20B,A01,083756,Staff,0,11,30,30
1650519295447,MATH 20B,A02,083757,Staff,0,11,30,30
1650519301469,MATH 20C,A01,083760,Staff,0,16,30,30
1650519301469,MATH 20C,A02,083761,Staff,2,14,30,28
1650519301469,MATH 20C,B01,083762,Staff,12,0,30,18
1650519301469,MATH 20C,B02,083763,Staff,28,0,30,2
1650519307503,MATH 20D,A01,083765,Staff,0,1,30,30
1650519307503,MATH 20D,A02,083766,Staff,7,0,30,23
1650519307503,MATH 20D,A03,083767,Staff,25,0,30,5
1650519313531,MATH 20E,A01,083771,Staff,6,0,30,24
1650519313531,MATH 20E,A02,083772,Staff,18,0,30,12
1650519313531,MATH 20E,B01,083773,Staff,0,0,30,30
1650519313531,MATH 20E,B02,083774,Staff,10,0,30,20
1650519319556,MATH 103A,A01,083777,Staff,0,14,30,30
1650519319556,MATH 103A,A02,083778,Staff,0,14,30,30
1650519319556,MATH 103A,B01,083779,Staff,0,13,30,30
1650519319556,MATH 103A,B02,083780,Staff,0,13,30,30
1650519325582,MATH 105,A01,085443,Staff,0,21,30,30
1650519331604,MATH 109,A01,083213,Anzaldo; Leesa B,0,8,30,30
1650519331604,MATH 109,A02,083214,Anzaldo; Leesa B,0,7,30,30
1650519331604,MATH 109,B01,083215,Anzaldo; Leesa B,0,5,30,30
1650519331604,MATH 109,B02,083216,Anzaldo; Leesa B,0,6,30,30
1650519337631,MATH 142A,A01,083219,Chow; Bennett,0,16,30,30
1650519337631,MATH 142A,A02,083220,Chow; Bennett,0,14,30,30
1650519337631,MATH 142A,B01,083221,Chow; Bennett,0,14,30,30
1650519337631,MATH 142A,B02,083222,Chow; Bennett,0,13,30,30
1650519343657,MATH 193A,A01,083224,Staff,0,6,30,30
1650519343657,MATH 193A,A02,083225,Staff,0,5,30,30
1650519343657,MATH 193A,A03,083781,Staff,0,5,30,30
1650519343657,MATH 193A,A04,083782,Staff,0,7,30,30
1650519349684,MATH 197,001,091859,McAuley; Julian John,9998,0,9999,1
1650519355738,COGS 9,A01,083615,Staff,0,15,60,60
1650519361766,COGS 11,A01,083617,Boyle; Mary E. T.,19,0,40,21
1650519367791,COGS 13,A01,083071,Staff,0,35,40,40
1650519373815,COGS 14A,A01,092681,Staff,0,25,100,100
1650519379841,COGS 14B,A01,083073,Cheng; Tzu-Han,0,12,50,50
1650519385869,COGS 17,A01,092677,Staff,20,0,75,55
1650519391895,COGS 100,A01,083619,Staff,0,26,60,60
1650519397928,COGS 101A,A01,083621,Davis; Joshua Daniel,0,26,60,60
1650519403952,COGS 101B,A01,091572,Staff,1,4,60,59
1650519409980,COGS 101C,A01,083625,Delgado; Tania,16,0,30,14
1650519416005,COGS 107A,A01,083627,Boyle; Mary E. T.,0,11,60,60
1650519422033,COGS 118A,A01,083075,Staff,0,3,60,60
1650519428056,CSE 3,A50,083646,Miranda; Gregory Joseph,20,0,38,18
1650519428056,CSE 3,A51,083647,Miranda; Gregory Joseph,36,0,37,1
1650519434082,CSE 8A,A50,083650,Miranda; Gregory Joseph,0,29,40,40
1650519440107,CSE 11,A01,083080,Cao; Yingjun,0,94,40,40
1650519446133,CSE 12,A01,083652,Staff,0,17,100,100
1650519452158,CSE 15L,A01,083654,Staff,0,1,50,50
1650519452158,CSE 15L,A02,083655,Staff,0,0,50,50
1650519458183,CSE 20,A01,083657,Staff,51,0,80,29
1650519464207,CSE 30,A01,083084,Eldon; John,0,77,40,40
1650519470234,CSE 100,A01,083659,Cao; Yingjun,0,66,50,50
1650519476262,CSE 134B,A01,083661,Powell; Thomas Allan,0,34,65,65
1650519482298,CSE 140,A01,083663,Staff,0,5,75,75
1650519488324,CSE 140L,A01,083088,Eldon; John,0,11,75,75
1650519494353,CSE 175,A01,083665,Kumar; Rakesh,7,0,25,18
1650519500376,CSE 190,A00,092507,Dubnov; Shlomo,10,0,20,10
1650519506400,ECE 45,A01,083139,Staff,1,0,60,59
1650519512424,ECE 65,A50,083695,Staff,0,6,30,30
1650519518450,ECE 109,A01,091882,Touri; Behrouz,35,0,70,35
1650519524475,ECE 180,A00,083140,Abi Samra; Nicholas Camill,21,0,30,9
1650519524475,ECE 180,B00,083141,Abi Samra; Nicholas Camill,0,0,30,30
1650519530498,MATH 10A,A01,083735,Patchell; Gregory David,5,0,30,25
1650519530498,MATH 10A,A02,083736,Patchell; Gregory David,27,0,30,3
1650519530498,MATH 10A,A03,083737,Patchell; Gregory David,24,0,30,6
1650519536528,MATH 10B,A01,083207,Staff,0,9,30,30
1650519536528,MATH 10B,A02,083208,Staff,0,7,30,30
1650519536528,MATH 10B,B01,083739,Staff,13,0,30,17
1650519536528,MATH 10B,B02,083740,Staff,28,0,30,2
1650519542556,MATH 18,A01,083743,Staff,1,0,30,29
1650519542556,MATH 18,A02,083744,Staff,27,0,30,3
1650519542556,MATH 18,A03,083745,Staff,22,0,30,8
1650519542556,MATH 18,A04,083746,Staff,26,0,30,4
1650519542556,MATH 18,B01,083748,Staff,0,12,30,30
1650519542556,MATH 18,B02,083749,Staff,0,12,30,30
1650519542556,MATH 18,B03,083750,Staff,0,11,30,30
1650519542556,MATH 18,B04,083751,Staff,0,12,30,30
1650519548589,MATH 20A,A01,083754,Staff,23,0,40,17
1650519554627,MATH 20B,A01,083756,Staff,0,11,30,30
1650519554627,MATH 20B,A02,083757,Staff,0,11,30,30
1650519560656,MATH 20C,A01,083760,Staff,0,16,30,30
1650519560656,MATH 20C,A02,083761,Staff,2,14,30,28
1650519560656,MATH 20C,B01,083762,Staff,12,0,30,18
1650519560656,MATH 20C,B02,083763,Staff,28,0,30,2
1650519566688,MATH 20D,A01,083765,Staff,0,1,30,30
1650519566688,MATH 20D,A02,083766,Staff,7,0,30,23
1650519566688,MATH 20D,A03,083767,Staff,25,0,30,5
1650519572728,MATH 20E,A01,083771,Staff,6,0,30,24
1650519572728,MATH 20E,A02,083772,Staff,18,0,30,12
1650519572728,MATH 20E,B01,083773,Staff,0,0,30,30
1650519572728,MATH 20E,B02,083774,Staff,10,0,30,20
1650519578755,MATH 103A,A01,083777,Staff,0,14,30,30
1650519578755,MATH 103A,A02,083778,Staff,0,14,30,30
1650519578755,MATH 103A,B01,083779,Staff,0,13,30,30
1650519578755,MATH 103A,B02,083780,Staff,0,13,30,30
1650519584778,MATH 105,A01,085443,Staff,0,21,30,30
1650519590802,MATH 109,A01,083213,Anzaldo; Leesa B,0,8,30,30
1650519590802,MATH 109,A02,083214,Anzaldo; Leesa B,0,7,30,30
1650519590802,MATH 109,B01,083215,Anzaldo; Leesa B,0,5,30,30
1650519590802,MATH 109,B02,083216,Anzaldo; Leesa B,0,6,30,30
1650519596826,MATH 142A,A01,083219,Chow; Bennett,0,16,30,30
1650519596826,MATH 142A,A02,083220,Chow; Bennett,0,14,30,30
1650519596826,MATH 142A,B01,083221,Chow; Bennett,0,14,30,30
1650519596826,MATH 142A,B02,083222,Chow; Bennett,0,13,30,30
1650519602851,MATH 193A,A01,083224,Staff,0,6,30,30
1650519602851,MATH 193A,A02,083225,Staff,0,5,30,30
1650519602851,MATH 193A,A03,083781,Staff,0,5,30,30
1650519602851,MATH 193A,A04,083782,Staff,0,7,30,30
1650519608877,MATH 197,001,091859,McAuley; Julian John,9998,0,9999,1
1650519614940,COGS 9,A01,083615,Staff,0,15,60,60
1650519620965,COGS 11,A01,083617,Boyle; Mary E. T.,19,0,40,21
1650519626990,COGS 13,A01,083071,Staff,0,35,40,40
1650519633024,COGS 14A,A01,092681,Staff,0,25,100,100
1650519639047,COGS 14B,A01,083073,Cheng; Tzu-Han,0,12,50,50
1650519645076,COGS 17,A01,092677,Staff,20,0,75,55
1650519651099,COGS 100,A01,083619,Staff,0,26,60,60
1650519657122,COGS 101A,A01,083621,Davis; Joshua Daniel,0,26,60,60
1650519663150,COGS 101B,A01,091572,Staff,1,4,60,59
1650519669180,COGS 101C,A01,083625,Delgado; Tania,16,0,30,14
1650519675207,COGS 107A,A01,083627,Boyle; Mary E. T.,0,11,60,60
1650519681235,COGS 118A,A01,083075,Staff,0,3,60,60
1650519687264,CSE 3,A50,083646,Miranda; Gregory Joseph,20,0,38,18
1650519687264,CSE 3,A51,083647,Miranda; Gregory Joseph,36,0,37,1
1650519693293,CSE 8A,A50,083650,Miranda; Gregory Joseph,0,29,40,40
1650519699321,CSE 11,A01,083080,Cao; Yingjun,0,94,40,40
1650519705345,CSE 12,A01,083652,Staff,0,17,100,100
1650519711371,CSE 15L,A01,083654,Staff,0,1,50,50
1650519711371,CSE 15L,A02,083655,Staff,0,0,50,50
1650519717402,CSE 20,A01,083657,Staff,51,0,80,29
1650519723425,CSE 30,A01,083084,Eldon; John,0,77,40,40
1650519729456,CSE 100,A01,083659,Cao; Yingjun,0,66,50,50
1650519735483,CSE 134B,A01,083661,Powell; Thomas Allan,0,34,65,65
1650519741508,CSE 140,A01,083663,Staff,0,5,75,75
1650519747536,CSE 140L,A01,083088,Eldon; John,0,11,75,75
1650519753559,CSE 175,A01,083665,Kumar; Rakesh,7,0,25,18
1650519759582,CSE 190,A00,092507,Dubnov; Shlomo,10,0,20,10
1650519765622,ECE 45,A01,083139,Staff,1,0,60,59
1650519771646,ECE 65,A50,083695,Staff,0,6,30,30
1650519777673,ECE 109,A01,091882,Touri; Behrouz,35,0,70,35
1650519783701,ECE 180,A00,083140,Abi Samra; Nicholas Camill,21,0,30,9
1650519783701,ECE 180,B00,083141,Abi Samra; Nicholas Camill,0,0,30,30
1650519789731,MATH 10A,A01,083735,Patchell; Gregory David,5,0,30,25
1650519789731,MATH 10A,A02,083736,Patchell; Gregory David,27,0,30,3
1650519789731,MATH 10A,A03,083737,Patchell; Gregory David,24,0,30,6
1650519795755,MATH 10B,A01,083207,Staff,0,9,30,30
1650519795755,MATH 10B,A02,083208,Staff,0,7,30,30
1650519795755,MATH 10B,B01,083739,Staff,13,0,30,17
1650519795755,MATH 10B,B02,083740,Staff,28,0,30,2
1650519801888,MATH 18,A01,083743,Staff,1,0,30,29
1650519801888,MATH 18,A02,083744,Staff,27,0,30,3
1650519801888,MATH 18,A03,083745,Staff,22,0,30,8
1650519801888,MATH 18,A04,083746,Staff,26,0,30,4
1650519801888,MATH 18,B01,083748,Staff,0,12,30,30
1650519801888,MATH 18,B02,083749,Staff,0,12,30,30
1650519801888,MATH 18,B03,083750,Staff,0,11,30,30
1650519801888,MATH 18,B04,083751,Staff,0,12,30,30
1650519807917,MATH 20A,A01,083754,Staff,23,0,40,17
1650519813944,MATH 20B,A01,083756,Staff,0,11,30,30
1650519813944,MATH 20B,A02,083757,Staff,0,11,30,30
1650519819969,MATH 20C,A01,083760,Staff,0,16,30,30
1650519819969,MATH 20C,A02,083761,Staff,2,14,30,28
1650519819969,MATH 20C,B01,083762,Staff,12,0,30,18
1650519819969,MATH 20C,B02,083763,Staff,28,0,30,2
1650519826000,MATH 20D,A01,083765,Staff,0,1,30,30
1650519826000,MATH 20D,A02,083766,Staff,7,0,30,23
1650519826000,MATH 20D,A03,083767,Staff,25,0,30,5
1650519832029,MATH 20E,A01,083771,Staff,6,0,30,24
1650519832029,MATH 20E,A02,083772,Staff,18,0,30,12
1650519832029,MATH 20E,B01,083773,Staff,0,0,30,30
1650519832029,MATH 20E,B02,083774,Staff,10,0,30,20
1650519838064,MATH 103A,A01,083777,Staff,0,14,30,30
1650519838064,MATH 103A,A02,083778,Staff,0,14,30,30
1650519838064,MATH 103A,B01,083779,Staff,0,13,30,30
1650519838064,MATH 103A,B02,083780,Staff,0,13,30,30
1650519844090,MATH 105,A01,085443,Staff,0,21,30,30
1650519850114,MATH 109,A01,083213,Anzaldo; Leesa B,0,8,30,30
1650519850114,MATH 109,A02,083214,Anzaldo; Leesa B,0,7,30,30
1650519850114,MATH 109,B01,083215,Anzaldo; Leesa B,0,5,30,30
1650519850114,MATH 109,B02,083216,Anzaldo; Leesa B,0,6,30,30
1650519856138,MATH 142A,A01,083219,Chow; Bennett,0,16,30,30
1650519856138,MATH 142A,A02,083220,Chow; Bennett,0,14,30,30
1650519856138,MATH 142A,B01,083221,Chow; Bennett,0,14,30,30
1650519856138,MATH 142A,B02,083222,Chow; Bennett,0,13,30,30
1650519862172,MATH 193A,A01,083224,Staff,0,6,30,30
1650519862172,MATH 193A,A02,083225,Staff,0,5,30,30
1650519862172,MATH 193A,A03,083781,Staff,0,5,30,30
1650519862172,MATH 193A,A04,083782,Staff,0,7,30,30
1650519868194,MATH 197,001,091859,McAuley; Julian John,9998,0,9999,1
1650519874283,COGS 9,A01,083615,Staff,0,15,60,60
1650519880306,COGS 11,A01,083617,Boyle; Mary E. T.,19,0,40,21
1650519886337,COGS 13,A01,083071,Staff,0,35,40,40
1650519892363,COGS 14A,A01,092681,Staff,0,25,100,100
1650519898396,COGS 14B,A01,083073,Cheng; Tzu-Han,0,12,50,50
1650519904418,COGS 17,A01,092677,Staff,20,0,75,55
1650519910441,COGS 100,A01,083619,Staff,0,26,60,60
1650519916467,COGS 101A,A01,083621,Davis; Joshua Daniel,0,26,60,60
1650519922501,COGS 101B,A01,091572,Staff,1,4,60,59
1650519928529,COGS 101C,A01,083625,Delgado; Tania,16,0,30,14
1650519934559,COGS 107A,A01,083627,Boyle; Mary E. T.,0,11,60,60
1650519940586,COGS 118A,A01,083075,Staff,0,3,60,60
1650519946617,CSE 3,A50,083646,Miranda; Gregory Joseph,20,0,38,18
1650519946617,CSE 3,A51,083647,Miranda; Gregory Joseph,36,0,37,1
1650519952642,CSE 8A,A50,083650,Miranda; Gregory Joseph,0,29,40,40
1650519958667,CSE 11,A01,083080,Cao; Yingjun,0,94,40,40
1650519964693,CSE 12,A01,083652,Staff,0,17,100,100
1650519970726,CSE 15L,A01,083654,Staff,0,1,50,50
1650519970726,CSE 15L,A02,083655,Staff,0,0,50,50
1650519976751,CSE 20,A01,083657,Staff,51,0,80,29
1650519982776,CSE 30,A01,083084,Eldon; John,0,77,40,40
1650519988800,CSE 100,A01,083659,Cao; Yingjun,0,66,50,50
1650519994824,CSE 134B,A01,083661,Powell; Thomas Allan,0,34,65,65
1650520000848,CSE 140,A01,083663,Staff,0,5,75,75
1650520006872,CSE 140L,A01,083088,Eldon; John,0,11,75,75
1650520012903,CSE 175,A01,083665,Kumar; Rakesh,7,0,25,18
1650520018928,CSE 190,A00,092507,Dubnov; Shlomo,10,0,20,10
1650520024954,ECE 45,A01,083139,Staff,1,0,60,59
1650520030978,ECE 65,A50,083695,Staff,0,6,30,30
1650520037003,ECE 109,A01,091882,Touri; Behrouz,35,0,70,35
1650520043027,ECE 180,A00,083140,Abi Samra; Nicholas Camill,21,0,30,9
1650520043027,ECE 180,B00,083141,Abi Samra; Nicholas Camill,0,0,30,30
1650520049060,MATH 10A,A01,083735,Patchell; Gregory David,5,0,30,25
1650520049060,MATH 10A,A02,083736,Patchell; Gregory David,27,0,30,3
1650520049060,MATH 10A,A03,083737,Patchell; Gregory David,24,0,30,6
1650520055085,MATH 10B,A01,083207,Staff,0,9,30,30
1650520055085,MATH 10B,A02,083208,Staff,0,7,30,30
1650520055085,MATH 10B,B01,083739,Staff,13,0,30,17
1650520055085,MATH 10B,B02,083740,Staff,28,0,30,2
1650520061116,MATH 18,A01,083743,Staff,1,0,30,29
1650520061116,MATH 18,A02,083744,Staff,27,0,30,3
1650520061116,MATH 18,A03,083745,Staff,22,0,30,8
1650520061116,MATH 18,A04,083746,Staff,26,0,30,4
1650520061116,MATH 18,B01,083748,Staff,0,12,30,30
1650520061116,MATH 18,B02,083749,Staff,0,12,30,30
1650520061116,MATH 18,B03,083750,Staff,0,11,30,30
1650520061116,MATH 18,B04,083751,Staff,0,12,30,30
1650520067146,MATH 20A,A01,083754,Staff,23,0,40,17
1650520073174,MATH 20B,A01,083756,Staff,0,11,30,30
1650520073174,MATH 20B,A02,083757,Staff,0,11,30,30
1650520079202,MATH 20C,A01,083760,Staff,0,16,30,30
1650520079202,MATH 20C,A02,083761,Staff,2,14,30,28
1650520079202,MATH 20C,B01,083762,Staff,12,0,30,18
1650520079202,MATH 20C,B02,083763,Staff,28,0,30,2
1650520085227,MATH 20D,A01,083765,Staff,0,1,30,30
1650520085227,MATH 20D,A02,083766,Staff,7,0,30,23
1650520085227,MATH 20D,A03,083767,Staff,25,0,30,5
1650520091255,MATH 20E,A01,083771,Staff,6,0,30,24
1650520091255,MATH 20E,A02,083772,Staff,18,0,30,12
1650520091255,MATH 20E,B01,083773,Staff,0,0,30,30
1650520091255,MATH 20E,B02,083774,Staff,10,0,30,20
1650520097287,MATH 103A,A01,083777,Staff,0,14,30,30
1650520097287,MATH 103A,A02,083778,Staff,0,14,30,30
1650520097287,MATH 103A,B01,083779,Staff,0,13,30,30
1650520097287,MATH 103A,B02,083780,Staff,0,13,30,30
1650520103310,MATH 105,A01,085443,Staff,0,21,30,30
1650520109333,MATH 109,A01,083213,Anzaldo; Leesa B,0,8,30,30
1650520109333,MATH 109,A02,083214,Anzaldo; Leesa B,0,7,30,30
1650520109333,MATH 109,B01,083215,Anzaldo; Leesa B,0,5,30,30
1650520109333,MATH 109,B02,083216,Anzaldo; Leesa B,0,6,30,30
1650520115357,MATH 142A,A01,083219,Chow; Bennett,0,16,30,30
1650520115357,MATH 142A,A02,083220,Chow; Bennett,0,14,30,30
1650520115357,MATH 142A,B01,083221,Chow; Bennett,0,14,30,30
1650520115357,MATH 142A,B02,083222,Chow; Bennett,0,13,30,30
1650520121380,MATH 193A,A01,083224,Staff,0,6,30,30
1650520121380,MATH 193A,A02,083225,Staff,0,5,30,30
1650520121380,MATH 193A,A03,083781,Staff,0,5,30,30
1650520121380,MATH 193A,A04,083782,Staff,0,7,30,30
1650520127409,MATH 197,001,091859,McAuley; Julian John,9998,0,9999,1
1650520133461,COGS 9,A01,083615,Staff,0,15,60,60
1650520139496,COGS 11,A01,083617,Boyle; Mary E. T.,19,0,40,21
1650520145524,COGS 13,A01,083071,Staff,0,35,40,40
1650520151547,COGS 14A,A01,092681,Staff,0,25,100,100
1650520157571,COGS 14B,A01,083073,Cheng; Tzu-Han,0,12,50,50
1650520163598,COGS 17,A01,092677,Staff,20,0,75,55
1650520169621,COGS 100,A01,083619,Staff,0,26,60,60
1650520175645,COGS 101A,A01,083621,Davis; Joshua Daniel,0,26,60,60
1650520181672,COGS 101B,A01,091572,Staff,1,4,60,59
1650520187696,COGS 101C,A01,083625,Delgado; Tania,16,0,30,14
1650520193720,COGS 107A,A01,083627,Boyle; Mary E. T.,0,11,60,60
1650520199742,COGS 118A,A01,083075,Staff,0,3,60,60
1650520205772,CSE 3,A50,083646,Miranda; Gregory Joseph,20,0,38,18
1650520205772,CSE 3,A51,083647,Miranda; Gregory Joseph,36,0,37,1
1650520211800,CSE 8A,A50,083650,Miranda; Gregory Joseph,0,29,40,40
1650520217824,CSE 11,A01,083080,Cao; Yingjun,0,94,40,40
1650520223852,CSE 12,A01,083652,Staff,0,17,100,100
1650520229877,CSE 15L,A01,083654,Staff,0,1,50,50
1650520229877,CSE 15L,A02,083655,Staff,0,0,50,50
1650520235905,CSE 20,A01,083657,Staff,51,0,80,29
1650520241931,CSE 30,A01,083084,Eldon; John,0,77,40,40
1650520247955,CSE 100,A01,083659,Cao; Yingjun,0,66,50,50
1650520253977,CSE 134B,A01,083661,Powell; Thomas Allan,0,34,65,65
1650520260001,CSE 140,A01,083663,Staff,0,5,75,75
1650520266026,CSE 140L,A01,083088,Eldon; John,0,11,75,75
1650520272048,CSE 175,A01,083665,Kumar; Rakesh,7,0,25,18
1650520278073,CSE 190,A00,092507,Dubnov; Shlomo,10,0,20,10
1650520284097,ECE 45,A01,083139,Staff,1,0,60,59
1650520290125,ECE 65,A50,083695,Staff,0,6,30,30
1650520296158,ECE 109,A01,091882,Touri; Behrouz,35,0,70,35
1650520302201,ECE 180,A00,083140,Abi Samra; Nicholas Camill,21,0,30,9
1650520302201,ECE 180,B00,083141,Abi Samra; Nicholas Camill,0,0,30,30
1650520308230,MATH 10A,A01,083735,Patchell; Gregory David,5,0,30,25
1650520308230,MATH 10A,A02,083736,Patchell; Gregory David,27,0,30,3
1650520308230,MATH 10A,A03,083737,Patchell; Gregory David,24,0,30,6
1650520314254,MATH 10B,A01,083207,Staff,0,9,30,30
1650520314254,MATH 10B,A02,083208,Staff,0,7,30,30
1650520314254,MATH 10B,B01,083739,Staff,13,0,30,17
1650520314254,MATH 10B,B02,083740,Staff,28,0,30,2
1650520320285,MATH 18,A01,083743,Staff,1,0,30,29
1650520320285,MATH 18,A02,083744,Staff,27,0,30,3
1650520320285,MATH 18,A03,083745,Staff,22,0,30,8
1650520320285,MATH 18,A04,083746,Staff,26,0,30,4
1650520320285,MATH 18,B01,083748,Staff,0,12,30,30
1650520320285,MATH 18,B02,083749,Staff,0,12,30,30
1650520320285,MATH 18,B03,083750,Staff,0,11,30,30
1650520320285,MATH 18,B04,083751,Staff,0,12,30,30
1650520326313,MATH 20A,A01,083754,Staff,23,0,40,17
1650520332339,MATH 20B,A01,083756,Staff,0,11,30,30
1650520332339,MATH 20B,A02,083757,Staff,0,12,30,30
1650520338366,MATH 20C,A01,083760,Staff,0,16,30,30
1650520338366,MATH 20C,A02,083761,Staff,2,14,30,28
1650520338366,MATH 20C,B01,083762,Staff,12,0,30,18
1650520338366,MATH 20C,B02,083763,Staff,28,0,30,2
1650520344395,MATH 20D,A01,083765,Staff,0,1,30,30
1650520344395,MATH 20D,A02,083766,Staff,7,0,30,23
1650520344395,MATH 20D,A03,083767,Staff,25,0,30,5
1650520350422,MATH 20E,A01,083771,Staff,6,0,30,24
1650520350422,MATH 20E,A02,083772,Staff,18,0,30,12
1650520350422,MATH 20E,B01,083773,Staff,0,0,30,30
1650520350422,MATH 20E,B02,083774,Staff,10,0,30,20
1650520356444,MATH 103A,A01,083777,Staff,0,14,30,30
1650520356444,MATH 103A,A02,083778,Staff,0,14,30,30
1650520356444,MATH 103A,B01,083779,Staff,0,13,30,30
1650520356444,MATH 103A,B02,083780,Staff,0,13,30,30
1650520362465,MATH 105,A01,085443,Staff,0,21,30,30
1650520368493,MATH 109,A01,083213,Anzaldo; Leesa B,0,8,30,30
1650520368493,MATH 109,A02,083214,Anzaldo; Leesa B,0,7,30,30
1650520368493,MATH 109,B01,083215,Anzaldo; Leesa B,0,5,30,30
1650520368493,MATH 109,B02,083216,Anzaldo; Leesa B,0,6,30,30
1650520374523,MATH 142A,A01,083219,Chow; Bennett,0,16,30,30
1650520374523,MATH 142A,A02,083220,Chow; Bennett,0,14,30,30
1650520374523,MATH 142A,B01,083221,Chow; Bennett,0,14,30,30
1650520374523,MATH 142A,B02,083222,Chow; Bennett,0,13,30,30
1650520380550,MATH 193A,A01,083224,Staff,0,6,30,30
1650520380550,MATH 193A,A02,083225,Staff,0,5,30,30
1650520380550,MATH 193A,A03,083781,Staff,0,5,30,30
1650520380550,MATH 193A,A04,083782,Staff,0,7,30,30
1650520386576,MATH 197,001,091859,McAuley; Julian John,9998,0,9999,1
1650520392718,COGS 9,A01,083615,Staff,0,15,60,60
1650520398740,COGS 11,A01,083617,Boyle; Mary E. T.,19,0,40,21
1650520404765,COGS 13,A01,083071,Staff,0,35,40,40
1650520410791,COGS 14A,A01,092681,Staff,0,25,100,100
1650520416819,COGS 14B,A01,083073,Cheng; Tzu-Han,0,12,50,50
1650520422847,COGS 17,A01,092677,Staff,20,0,75,55
1650520428872,COGS 100,A01,083619,Staff,0,26,60,60
1650520434898,COGS 101A,A01,083621,Davis; Joshua Daniel,0,26,60,60
1650520440945,COGS 101B,A01,091572,Staff,1,4,60,59
1650520446972,COGS 101C,A01,083625,Delgado; Tania,16,0,30,14
1650520453004,COGS 107A,A01,083627,Boyle; Mary E. T.,0,11,60,60
1650520459028,COGS 118A,A01,083075,Staff,0,3,60,60
1650520465051,CSE 3,A50,083646,Miranda; Gregory Joseph,20,0,38,18
1650520465051,CSE 3,A51,083647,Miranda; Gregory Joseph,36,0,37,1
1650520471077,CSE 8A,A50,083650,Miranda; Gregory Joseph,0,29,40,40
1650520477104,CSE 11,A01,083080,Cao; Yingjun,0,94,40,40
1650520483130,CSE 12,A01,083652,Staff,0,17,100,100
1650520489154,CSE 15L,A01,083654,Staff,0,1,50,50
1650520489154,CSE 15L,A02,083655,Staff,0,0,50,50
1650520495176,CSE 20,A01,083657,Staff,51,0,80,29
1650520501201,CSE 30,A01,083084,Eldon; John,0,77,40,40
1650520507227,CSE 100,A01,083659,Cao; Yingjun,0,66,50,50
1650520513251,CSE 134B,A01,083661,Powell; Thomas Allan,0,34,65,65
1650520519278,CSE 140,A01,083663,Staff,0,5,75,75
1650520525301,CSE 140L,A01,083088,Eldon; John,0,11,75,75
1650520531324,CSE 175,A01,083665,Kumar; Rakesh,7,0,25,18
1650520537350,CSE 190,A00,092507,Dubnov; Shlomo,10,0,20,10
1650520543378,ECE 45,A01,083139,Staff,1,0,60,59
1650520549401,ECE 65,A50,083695,Staff,0,6,30,30
1650520555427,ECE 109,A01,091882,Touri; Behrouz,35,0,70,35
1650520561452,ECE 180,A00,083140,Abi Samra; Nicholas Camill,21,0,30,9
1650520561452,ECE 180,B00,083141,Abi Samra; Nicholas Camill,0,0,30,30
1650520567477,MATH 10A,A01,083735,Patchell; Gregory David,5,0,30,25
1650520567477,MATH 10A,A02,083736,Patchell; Gregory David,27,0,30,3
1650520567477,MATH 10A,A03,083737,Patchell; Gregory David,24,0,30,6
1650520573503,MATH 10B,A01,083207,Staff,0,9,30,30
1650520573503,MATH 10B,A02,083208,Staff,0,7,30,30
1650520573503,MATH 10B,B01,083739,Staff,13,0,30,17
1650520573503,MATH 10B,B02,083740,Staff,28,0,30,2
1650520579529,MATH 18,A01,083743,Staff,1,0,30,29
1650520579529,MATH 18,A02,083744,Staff,27,0,30,3
1650520579529,MATH 18,A03,083745,Staff,22,0,30,8
1650520579529,MATH 18,A04,083746,Staff,26,0,30,4
1650520579529,MATH 18,B01,083748,Staff,0,12,30,30
1650520579529,MATH 18,B02,083749,Staff,0,12,30,30
1650520579529,MATH 18,B03,083750,Staff,0,11,30,30
1650520579529,MATH 18,B04,083751,Staff,0,12,30,30
1650520585556,MATH 20A,A01,083754,Staff,23,0,40,17
1650520591593,MATH 20B,A01,083756,Staff,0,11,30,30
1650520591593,MATH 20B,A02,083757,Staff,0,12,30,30
1650520597620,MATH 20C,A01,083760,Staff,0,16,30,30
1650520597620,MATH 20C,A02,083761,Staff,2,14,30,28
1650520597620,MATH 20C,B01,083762,Staff,12,0,30,18
1650520597620,MATH 20C,B02,083763,Staff,28,0,30,2
1650520603641,MATH 20D,A01,083765,Staff,0,1,30,30
1650520603641,MATH 20D,A02,083766,Staff,7,0,30,23
1650520603641,MATH 20D,A03,083767,Staff,25,0,30,5
1650520609666,MATH 20E,A01,083771,Staff,6,0,30,24
1650520609666,MATH 20E,A02,083772,Staff,18,0,30,12
1650520609666,MATH 20E,B01,083773,Staff,0,0,30,30
1650520609666,MATH 20E,B02,083774,Staff,10,0,30,20
1650520615691,MATH 103A,A01,083777,Staff,0,14,30,30
1650520615691,MATH 103A,A02,083778,Staff,0,14,30,30
1650520615691,MATH 103A,B01,083779,Staff,0,13,30,30
1650520615691,MATH 103A,B02,083780,Staff,0,13,30,30
1650520621718,MATH 105,A01,085443,Staff,0,21,30,30
1650520627744,MATH 109,A01,083213,Anzaldo; Leesa B,0,8,30,30
1650520627744,MATH 109,A02,083214,Anzaldo; Leesa B,0,7,30,30
1650520627744,MATH 109,B01,083215,Anzaldo; Leesa B,0,5,30,30
1650520627744,MATH 109,B02,083216,Anzaldo; Leesa B,0,6,30,30
1650520633769,MATH 142A,A01,083219,Chow; Bennett,0,16,30,30
1650520633769,MATH 142A,A02,083220,Chow; Bennett,0,14,30,30
1650520633769,MATH 142A,B01,083221,Chow; Bennett,0,14,30,30
1650520633769,MATH 142A,B02,083222,Chow; Bennett,0,13,30,30
1650520639804,MATH 193A,A01,083224,Staff,0,6,30,30
1650520639804,MATH 193A,A02,083225,Staff,0,5,30,30
1650520639804,MATH 193A,A03,083781,Staff,0,5,30,30
1650520639804,MATH 193A,A04,083782,Staff,0,7,30,30
1650520645830,MATH 197,001,091859,McAuley; Julian John,9998,0,9999,1
1650520651884,COGS 9,A01,083615,Staff,0,15,60,60
1650520657907,COGS 11,A01,083617,Boyle; Mary E. T.,19,0,40,21
1650520663931,COGS 13,A01,083071,Staff,0,35,40,40
1650520669958,COGS 14A,A01,092681,Staff,0,25,100,100
1650520675986,COGS 14B,A01,083073,Cheng; Tzu-Han,0,12,50,50
1650520682011,COGS 17,A01,092677,Staff,20,0,75,55
1650520688039,COGS 100,A01,083619,Staff,0,26,60,60
1650520694066,COGS 101A,A01,083621,Davis; Joshua Daniel,0,26,60,60
1650520700092,COGS 101B,A01,091572,Staff,1,4,60,59
1650520706118,COGS 101C,A01,083625,Delgado; Tania,16,0,30,14
1650520712145,COGS 107A,A01,083627,Boyle; Mary E. T.,0,11,60,60
1650520718172,COGS 118A,A01,083075,Staff,0,3,60,60
1650520724195,CSE 3,A50,083646,Miranda; Gregory Joseph,20,0,38,18
1650520724195,CSE 3,A51,083647,Miranda; Gregory Joseph,36,0,37,1
1650520730223,CSE 8A,A50,083650,Miranda; Gregory Joseph,0,29,40,40
1650520736250,CSE 11,A01,083080,Cao; Yingjun,0,94,40,40
1650520742273,CSE 12,A01,083652,Staff,0,17,100,100
1650520748303,CSE 15L,A01,083654,Staff,0,1,50,50
1650520748303,CSE 15L,A02,083655,Staff,0,0,50,50
1650520754327,CSE 20,A01,083657,Staff,51,0,80,29
1650520760349,CSE 30,A01,083084,Eldon; John,0,77,40,40
1650520766377,CSE 100,A01,083659,Cao; Yingjun,0,66,50,50
1650520772399,CSE 134B,A01,083661,Powell; Thomas Allan,0,34,65,65
1650520778423,CSE 140,A01,083663,Staff,0,5,75,75
1650520784467,CSE 140L,A01,083088,Eldon; John,0,11,75,75
1650520790490,CSE 175,A01,083665,Kumar; Rakesh,7,0,25,18
1650520796514,CSE 190,A00,092507,Dubnov; Shlomo,10,0,20,10
1650520802540,ECE 45,A01,083139,Staff,1,0,60,59
1650520808564,ECE 65,A50,083695,Staff,0,6,30,30
1650520814590,ECE 109,A01,091882,Touri; Behrouz,35,0,70,35
1650520820616,ECE 180,A00,083140,Abi Samra; Nicholas Camill,21,0,30,9
1650520820616,ECE 180,B00,083141,Abi Samra; Nicholas Camill,0,0,30,30
1650520826644,MATH 10A,A01,083735,Patchell; Gregory David,5,0,30,25
1650520826644,MATH 10A,A02,083736,Patchell; Gregory David,27,0,30,3
1650520826644,MATH 10A,A03,083737,Patchell; Gregory David,24,0,30,6
1650520832672,MATH 10B,A01,083207,Staff,0,9,30,30
1650520832672,MATH 10B,A02,083208,Staff,0,7,30,30
1650520832672,MATH 10B,B01,083739,Staff,13,0,30,17
1650520832672,MATH 10B,B02,083740,Staff,28,0,30,2
1650520838696,MATH 18,A01,083743,Staff,1,0,30,29
1650520838696,MATH 18,A02,083744,Staff,27,0,30,3
1650520838696,MATH 18,A03,083745,Staff,22,0,30,8
1650520838696,MATH 18,A04,083746,Staff,26,0,30,4
1650520838696,MATH 18,B01,083748,Staff,0,12,30,30
1650520838696,MATH 18,B02,083749,Staff,0,12,30,30
1650520838696,MATH 18,B03,083750,Staff,0,11,30,30
1650520838696,MATH 18,B04,083751,Staff,0,12,30,30
1650520844722,MATH 20A,A01,083754,Staff,23,0,40,17
1650520850747,MATH 20B,A01,083756,Staff,0,11,30,30
1650520850747,MATH 20B,A02,083757,Staff,0,12,30,30
1650520856773,MATH 20C,A01,083760,Staff,0,16,30,30
1650520856773,MATH 20C,A02,083761,Staff,2,14,30,28
1650520856773,MATH 20C,B01,083762,Staff,12,0,30,18
1650520856773,MATH 20C,B02,083763,Staff,28,0,30,2
1650520862810,MATH 20D,A01,083765,Staff,0,1,30,30
1650520862810,MATH 20D,A02,083766,Staff,7,0,30,23
1650520862810,MATH 20D,A03,083767,Staff,25,0,30,5
1650520868842,MATH 20E,A01,083771,Staff,6,0,30,24
1650520868842,MATH 20E,A02,083772,Staff,18,0,30,12
1650520868842,MATH 20E,B01,083773,Staff,0,0,30,30
1650520868842,MATH 20E,B02,083774,Staff,10,0,30,20
1650520874866,MATH 103A,A01,083777,Staff,0,14,30,30
1650520874866,MATH 103A,A02,083778,Staff,0,14,30,30
1650520874866,MATH 103A,B01,083779,Staff,0,13,30,30
1650520874866,MATH 103A,B02,083780,Staff,0,13,30,30
1650520880895,MATH 105,A01,085443,Staff,0,21,30,30
1650520886922,MATH 109,A01,083213,Anzaldo; Leesa B,0,8,30,30
1650520886922,MATH 109,A02,083214,Anzaldo; Leesa B,0,7,30,30
1650520886922,MATH 109,B01,083215,Anzaldo; Leesa B,0,5,30,30
1650520886922,MATH 109,B02,083216,Anzaldo; Leesa B,0,6,30,30
1650520892947,MATH 142A,A01,083219,Chow; Bennett,0,16,30,30
1650520892947,MATH 142A,A02,083220,Chow; Bennett,0,14,30,30
1650520892947,MATH 142A,B01,083221,Chow; Bennett,0,14,30,30
1650520892947,MATH 142A,B02,083222,Chow; Bennett,0,13,30,30
1650520898972,MATH 193A,A01,083224,Staff,0,6,30,30
1650520898972,MATH 193A,A02,083225,Staff,0,5,30,30
1650520898972,MATH 193A,A03,083781,Staff,0,5,30,30
1650520898972,MATH 193A,A04,083782,Staff,0,7,30,30
1650520904996,MATH 197,001,091859,McAuley; Julian John,9998,0,9999,1
1650520911050,COGS 9,A01,083615,Staff,0,15,60,60
1650520917075,COGS 11,A01,083617,Boyle; Mary E. T.,19,0,40,21
1650520923098,COGS 13,A01,083071,Staff,0,35,40,40
1650520929122,COGS 14A,A01,092681,Staff,0,25,100,100
1650520935149,COGS 14B,A01,083073,Cheng; Tzu-Han,0,12,50,50
1650520941176,COGS 17,A01,092677,Staff,20,0,75,55
1650520947201,COGS 100,A01,083619,Staff,0,26,60,60
1650520953226,COGS 101A,A01,083621,Davis; Joshua Daniel,0,26,60,60
1650520959248,COGS 101B,A01,091572,Staff,1,4,60,59
1650520965273,COGS 101C,A01,083625,Delgado; Tania,16,0,30,14
1650520971295,COGS 107A,A01,083627,Boyle; Mary E. T.,0,11,60,60
1650520977323,COGS 118A,A01,083075,Staff,0,3,60,60
1650520983347,CSE 3,A50,083646,Miranda; Gregory Joseph,20,0,38,18
1650520983347,CSE 3,A51,083647,Miranda; Gregory Joseph,36,0,37,1
1650520989464,CSE 8A,A50,083650,Miranda; Gregory Joseph,0,29,40,40
1650520995492,CSE 11,A01,083080,Cao; Yingjun,0,94,40,40
1650521001517,CSE 12,A01,083652,Staff,0,17,100,100
1650521007545,CSE 15L,A01,083654,Staff,0,1,50,50
1650521007545,CSE 15L,A02,083655,Staff,0,0,50,50
1650521013569,CSE 20,A01,083657,Staff,51,0,80,29
1650521019599,CSE 30,A01,083084,Eldon; John,0,77,40,40
1650521025622,CSE 100,A01,083659,Cao; Yingjun,0,66,50,50
1650521031648,CSE 134B,A01,083661,Powell; Thomas Allan,0,34,65,65
1650521037673,CSE 140,A01,083663,Staff,0,5,75,75
1650521043703,CSE 140L,A01,083088,Eldon; John,0,11,75,75
1650521049728,CSE 175,A01,083665,Kumar; Rakesh,7,0,25,18
1650521055752,CSE 190,A00,092507,Dubnov; Shlomo,10,0,20,10
1650521061778,ECE 45,A01,083139,Staff,1,0,60,59
1650521067802,ECE 65,A50,083695,Staff,0,6,30,30
1650521073829,ECE 109,A01,091882,Touri; Behrouz,35,0,70,35
1650521079853,ECE 180,A00,083140,Abi Samra; Nicholas Camill,21,0,30,9
1650521079853,ECE 180,B00,083141,Abi Samra; Nicholas Camill,0,0,30,30
1650521085888,MATH 10A,A01,083735,Patchell; Gregory David,5,0,30,25
1650521085888,MATH 10A,A02,083736,Patchell; Gregory David,27,0,30,3
1650521085888,MATH 10A,A03,083737,Patchell; Gregory David,24,0,30,6
1650521091918,MATH 10B,A01,083207,Staff,0,9,30,30
1650521091918,MATH 10B,A02,083208,Staff,0,7,30,30
1650521091918,MATH 10B,B01,083739,Staff,13,0,30,17
1650521091918,MATH 10B,B02,083740,Staff,28,0,30,2
1650521097951,MATH 18,A01,083743,Staff,1,0,30,29
1650521097951,MATH 18,A02,083744,Staff,27,0,30,3
1650521097951,MATH 18,A03,083745,Staff,22,0,30,8
1650521097951,MATH 18,A04,083746,Staff,26,0,30,4
1650521097951,MATH 18,B01,083748,Staff,0,12,30,30
1650521097951,MATH 18,B02,083749,Staff,0,12,30,30
1650521097951,MATH 18,B03,083750,Staff,0,11,30,30
1650521097951,MATH 18,B04,083751,Staff,0,12,30,30
1650521103976,MATH 20A,A01,083754,Staff,23,0,40,17
1650521110000,MATH 20B,A01,083756,Staff,0,11,30,30
1650521110000,MATH 20B,A02,083757,Staff,0,12,30,30
1650521116023,MATH 20C,A01,083760,Staff,0,16,30,30
1650521116023,MATH 20C,A02,083761,Staff,2,14,30,28
1650521116023,MATH 20C,B01,083762,Staff,12,0,30,18
1650521116023,MATH 20C,B02,083763,Staff,28,0,30,2
1650521122052,MATH 20D,A01,083765,Staff,0,1,30,30
1650521122052,MATH 20D,A02,083766,Staff,7,0,30,23
1650521122052,MATH 20D,A03,083767,Staff,25,0,30,5
1650521128075,MATH 20E,A01,083771,Staff,6,0,30,24
1650521128075,MATH 20E,A02,083772,Staff,18,0,30,12
1650521128075,MATH 20E,B01,083773,Staff,0,0,30,30
1650521128075,MATH 20E,B02,083774,Staff,10,0,30,20
1650521134100,MATH 103A,A01,083777,Staff,0,14,30,30
1650521134100,MATH 103A,A02,083778,Staff,0,14,30,30
1650521134100,MATH 103A,B01,083779,Staff,0,13,30,30
1650521134100,MATH 103A,B02,083780,Staff,0,13,30,30
1650521140124,MATH 105,A01,085443,Staff,0,21,30,30
1650521146153,MATH 109,A01,083213,Anzaldo; Leesa B,0,8,30,30
1650521146153,MATH 109,A02,083214,Anzaldo; Leesa B,0,7,30,30
1650521146153,MATH 109,B01,083215,Anzaldo; Leesa B,0,5,30,30
1650521146153,MATH 109,B02,083216,Anzaldo; Leesa B,0,6,30,30
1650521152182,MATH 142A,A01,083219,Chow; Bennett,0,16,30,30
1650521152182,MATH 142A,A02,083220,Chow; Bennett,0,14,30,30
1650521152182,MATH 142A,B01,083221,Chow; Bennett,0,14,30,30
1650521152182,MATH 142A,B02,083222,Chow; Bennett,0,13,30,30
1650521158217,MATH 193A,A01,083224,Staff,0,6,30,30
1650521158217,MATH 193A,A02,083225,Staff,0,5,30,30
1650521158217,MATH 193A,A03,083781,Staff,0,5,30,30
1650521158217,MATH 193A,A04,083782,Staff,0,7,30,30
1650521164244,MATH 197,001,091859,McAuley; Julian John,9998,0,9999,1
1650521170299,COGS 9,A01,083615,Staff,0,15,60,60
1650521176323,COGS 11,A01,083617,Boyle; Mary E. T.,19,0,40,21
1650521182349,COGS 13,A01,083071,Staff,0,35,40,40
1650521188372,COGS 14A,A01,092681,Staff,0,25,100,100
1650521194406,COGS 14B,A01,083073,Cheng; Tzu-Han,0,12,50,50
1650521200430,COGS 17,A01,092677,Staff,20,0,75,55
1650521206455,COGS 100,A01,083619,Staff,0,26,60,60
1650521212488,COGS 101A,A01,083621,Davis; Joshua Daniel,0,26,60,60
1650521218513,COGS 101B,A01,091572,Staff,1,4,60,59
1650521224537,COGS 101C,A01,083625,Delgado; Tania,16,0,30,14
1650521230570,COGS 107A,A01,083627,Boyle; Mary E. T.,0,11,60,60
1650521236600,COGS 118A,A01,083075,Staff,0,3,60,60
1650521242627,CSE 3,A50,083646,Miranda; Gregory Joseph,20,0,38,18
1650521242627,CSE 3,A51,083647,Miranda; Gregory Joseph,36,0,37,1
1650521248652,CSE 8A,A50,083650,Miranda; Gregory Joseph,0,29,40,40
1650521254722,CSE 11,A01,083080,Cao; Yingjun,0,94,40,40
1650521260753,CSE 12,A01,083652,Staff,0,17,100,100
1650521266778,CSE 15L,A01,083654,Staff,0,1,50,50
1650521266778,CSE 15L,A02,083655,Staff,0,0,50,50
1650521272806,CSE 20,A01,083657,Staff,51,0,80,29
1650521278839,CSE 30,A01,083084,Eldon; John,0,77,40,40
1650521284863,CSE 100,A01,083659,Cao; Yingjun,0,66,50,50
1650521290894,CSE 134B,A01,083661,Powell; Thomas Allan,0,34,65,65
1650521296964,CSE 140,A01,083663,Staff,0,5,75,75
1650521302991,CSE 140L,A01,083088,Eldon; John,0,11,75,75
1650521309012,CSE 175,A01,083665,Kumar; Rakesh,7,0,25,18
1650521315039,CSE 190,A00,092507,Dubnov; Shlomo,10,0,20,10
1650521321068,ECE 45,A01,083139,Staff,1,0,60,59
1650521327098,ECE 65,A50,083695,Staff,0,6,30,30
1650521333123,ECE 109,A01,091882,Touri; Behrouz,35,0,70,35
1650521339151,ECE 180,A00,083140,Abi Samra; Nicholas Camill,21,0,30,9
1650521339151,ECE 180,B00,083141,Abi Samra; Nicholas Camill,0,0,30,30
1650521345175,MATH 10A,A01,083735,Patchell; Gregory David,5,0,30,25
1650521345175,MATH 10A,A02,083736,Patchell; Gregory David,27,0,30,3
1650521345175,MATH 10A,A03,083737,Patchell; Gregory David,24,0,30,6
1650521351204,MATH 10B,A01,083207,Staff,0,9,30,30
1650521351204,MATH 10B,A02,083208,Staff,0,7,30,30
1650521351204,MATH 10B,B01,083739,Staff,13,0,30,17
1650521351204,MATH 10B,B02,083740,Staff,28,0,30,2
1650521357230,MATH 18,A01,083743,Staff,1,0,30,29
1650521357230,MATH 18,A02,083744,Staff,27,0,30,3
1650521357230,MATH 18,A03,083745,Staff,22,0,30,8
1650521357230,MATH 18,A04,083746,Staff,26,0,30,4
1650521357230,MATH 18,B01,083748,Staff,0,12,30,30
1650521357230,MATH 18,B02,083749,Staff,0,12,30,30
1650521357230,MATH 18,B03,083750,Staff,0,11,30,30
1650521357230,MATH 18,B04,083751,Staff,0,12,30,30
1650521363253,MATH 20A,A01,083754,Staff,23,0,40,17
1650521369279,MATH 20B,A01,083756,Staff,0,11,30,30
1650521369279,MATH 20B,A02,083757,Staff,0,12,30,30
1650521375312,MATH 20C,A01,083760,Staff,0,16,30,30
1650521375312,MATH 20C,A02,083761,Staff,2,14,30,28
1650521375312,MATH 20C,B01,083762,Staff,12,0,30,18
1650521375312,MATH 20C,B02,083763,Staff,28,0,30,2
1650521381337,MATH 20D,A01,083765,Staff,0,1,30,30
1650521381337,MATH 20D,A02,083766,Staff,7,0,30,23
1650521381337,MATH 20D,A03,083767,Staff,25,0,30,5
1650521387359,MATH 20E,A01,083771,Staff,6,0,30,24
1650521387359,MATH 20E,A02,083772,Staff,18,0,30,12
1650521387359,MATH 20E,B01,083773,Staff,0,0,30,30
1650521387359,MATH 20E,B02,083774,Staff,10,0,30,20
1650521393385,MATH 103A,A01,083777,Staff,0,14,30,30
1650521393385,MATH 103A,A02,083778,Staff,0,14,30,30
1650521393385,MATH 103A,B01,083779,Staff,0,13,30,30
1650521393385,MATH 103A,B02,083780,Staff,0,13,30,30
1650521399413,MATH 105,A01,085443,Staff,0,21,30,30
1650521405446,MATH 109,A01,083213,Anzaldo; Leesa B,0,8,30,30
1650521405446,MATH 109,A02,083214,Anzaldo; Leesa B,0,7,30,30
1650521405446,MATH 109,B01,083215,Anzaldo; Leesa B,0,5,30,30
1650521405446,MATH 109,B02,083216,Anzaldo; Leesa B,0,6,30,30
1650521411475,MATH 142A,A01,083219,Chow; Bennett,0,16,30,30
1650521411475,MATH 142A,A02,083220,Chow; Bennett,0,14,30,30
1650521411475,MATH 142A,B01,083221,Chow; Bennett,0,13,30,30
1650521411475,MATH 142A,B02,083222,Chow; Bennett,0,13,30,30
1650521417505,MATH 193A,A01,083224,Staff,0,6,30,30
1650521417505,MATH 193A,A02,083225,Staff,0,5,30,30
1650521417505,MATH 193A,A03,083781,Staff,0,5,30,30
1650521417505,MATH 193A,A04,083782,Staff,0,7,30,30
1650521423529,MATH 197,001,091859,McAuley; Julian John,9998,0,9999,1
1650521429584,COGS 9,A01,083615,Staff,0,16,60,60
1650521435611,COGS 11,A01,083617,Boyle; Mary E. T.,19,0,40,21
1650521441639,COGS 13,A01,083071,Staff,0,35,40,40
1650521447670,COGS 14A,A01,092681,Staff,0,25,100,100
1650521453698,COGS 14B,A01,083073,Cheng; Tzu-Han,0,12,50,50
1650521459721,COGS 17,A01,092677,Staff,20,0,75,55
1650521465746,COGS 100,A01,083619,Staff,0,26,60,60
1650521471770,COGS 101A,A01,083621,Davis; Joshua Daniel,0,26,60,60
1650521477796,COGS 101B,A01,091572,Staff,1,4,60,59
1650521483823,COGS 101C,A01,083625,Delgado; Tania,16,0,30,14
1650521489851,COGS 107A,A01,083627,Boyle; Mary E. T.,0,11,60,60
1650521495877,COGS 118A,A01,083075,Staff,0,3,60,60
1650521501902,CSE 3,A50,083646,Miranda; Gregory Joseph,20,0,38,18
1650521501902,CSE 3,A51,083647,Miranda; Gregory Joseph,36,0,37,1
1650521507930,CSE 8A,A50,083650,Miranda; Gregory Joseph,0,29,40,40
1650521513958,CSE 11,A01,083080,Cao; Yingjun,0,94,40,40
1650521519994,CSE 12,A01,083652,Staff,0,17,100,100
1650521526037,CSE 15L,A01,083654,Staff,0,1,50,50
1650521526037,CSE 15L,A02,083655,Staff,0,0,50,50
1650521532062,CSE 20,A01,083657,Staff,51,0,80,29
1650521538095,CSE 30,A01,083084,Eldon; John,0,77,40,40
1650521544128,CSE 100,A01,083659,Cao; Yingjun,0,66,50,50
1650521550153,CSE 134B,A01,083661,Powell; Thomas Allan,0,34,65,65
1650521556178,CSE 140,A01,083663,Staff,0,5,75,75
1650521562201,CSE 140L,A01,083088,Eldon; John,0,11,75,75
1650521568225,CSE 175,A01,083665,Kumar; Rakesh,7,0,25,18
1650521574249,CSE 190,A00,092507,Dubnov; Shlomo,10,0,20,10
1650521580274,ECE 45,A01,083139,Staff,1,0,60,59
1650521586391,ECE 65,A50,083695,Staff,0,6,30,30
1650521592418,ECE 109,A01,091882,Touri; Behrouz,35,0,70,35
1650521598442,ECE 180,A00,083140,Abi Samra; Nicholas Camill,21,0,30,9
1650521598442,ECE 180,B00,083141,Abi Samra; Nicholas Camill,0,0,30,30
1650521604478,MATH 10A,A01,083735,Patchell; Gregory David,5,0,30,25
1650521604478,MATH 10A,A02,083736,Patchell; Gregory David,27,0,30,3
1650521604478,MATH 10A,A03,083737,Patchell; Gregory David,24,0,30,6
1650521610502,MATH 10B,A01,083207,Staff,0,9,30,30
1650521610502,MATH 10B,A02,083208,Staff,0,7,30,30
1650521610502,MATH 10B,B01,083739,Staff,13,0,30,17
1650521610502,MATH 10B,B02,083740,Staff,28,0,30,2
1650521616532,MATH 18,A01,083743,Staff,1,0,30,29
1650521616532,MATH 18,A02,083744,Staff,27,0,30,3
1650521616532,MATH 18,A03,083745,Staff,22,0,30,8
1650521616532,MATH 18,A04,083746,Staff,26,0,30,4
1650521616532,MATH 18,B01,083748,Staff,0,12,30,30
1650521616532,MATH 18,B02,083749,Staff,0,12,30,30
1650521616532,MATH 18,B03,083750,Staff,0,11,30,30
1650521616532,MATH 18,B04,083751,Staff,0,12,30,30
1650521622561,MATH 20A,A01,083754,Staff,23,0,40,17
1650521628586,MATH 20B,A01,083756,Staff,0,11,30,30
1650521628586,MATH 20B,A02,083757,Staff,0,12,30,30
1650521634610,MATH 20C,A01,083760,Staff,0,16,30,30
1650521634610,MATH 20C,A02,083761,Staff,2,14,30,28
1650521634610,MATH 20C,B01,083762,Staff,12,0,30,18
1650521634610,MATH 20C,B02,083763,Staff,28,0,30,2
1650521640632,MATH 20D,A01,083765,Staff,0,1,30,30
1650521640632,MATH 20D,A02,083766,Staff,7,0,30,23
1650521640632,MATH 20D,A03,083767,Staff,25,0,30,5
1650521646655,MATH 20E,A01,083771,Staff,6,0,30,24
1650521646655,MATH 20E,A02,083772,Staff,18,0,30,12
1650521646655,MATH 20E,B01,083773,Staff,0,0,30,30
1650521646655,MATH 20E,B02,083774,Staff,10,0,30,20
1650521652678,MATH 103A,A01,083777,Staff,0,14,30,30
1650521652678,MATH 103A,A02,083778,Staff,0,14,30,30
1650521652678,MATH 103A,B01,083779,Staff,0,13,30,30
1650521652678,MATH 103A,B02,083780,Staff,0,13,30,30
1650521658704,MATH 105,A01,085443,Staff,0,21,30,30
1650521664729,MATH 109,A01,083213,Anzaldo; Leesa B,0,8,30,30
1650521664729,MATH 109,A02,083214,Anzaldo; Leesa B,0,7,30,30
1650521664729,MATH 109,B01,083215,Anzaldo; Leesa B,0,5,30,30
1650521664729,MATH 109,B02,083216,Anzaldo; Leesa B,0,6,30,30
1650521670753,MATH 142A,A01,083219,Chow; Bennett,0,16,30,30
1650521670753,MATH 142A,A02,083220,Chow; Bennett,0,14,30,30
1650521670753,MATH 142A,B01,083221,Chow; Bennett,0,13,30,30
1650521670753,MATH 142A,B02,083222,Chow; Bennett,0,13,30,30
1650521676790,MATH 193A,A01,083224,Staff,0,6,30,30
1650521676790,MATH 193A,A02,083225,Staff,0,5,30,30
1650521676790,MATH 193A,A03,083781,Staff,0,5,30,30
1650521676790,MATH 193A,A04,083782,Staff,0,7,30,30
1650521682815,MATH 197,001,091859,McAuley; Julian John,9998,0,9999,1
1650521688874,COGS 9,A01,083615,Staff,0,16,60,60
1650521694909,COGS 11,A01,083617,Boyle; Mary E. T.,19,0,40,21
1650521700933,COGS 13,A01,083071,Staff,0,35,40,40
1650521706957,COGS 14A,A01,092681,Staff,0,25,100,100
1650521712980,COGS 14B,A01,083073,Cheng; Tzu-Han,0,12,50,50
1650521719004,COGS 17,A01,092677,Staff,20,0,75,55
1650521725030,COGS 100,A01,083619,Staff,0,26,60,60
1650521731054,COGS 101A,A01,083621,Davis; Joshua Daniel,0,26,60,60
1650521737077,COGS 101B,A01,091572,Staff,1,4,60,59
1650521743101,COGS 101C,A01,083625,Delgado; Tania,16,0,30,14
1650521749134,COGS 107A,A01,083627,Boyle; Mary E. T.,0,11,60,60
1650521755161,COGS 118A,A01,083075,Staff,0,3,60,60
1650521761183,CSE 3,A50,083646,Miranda; Gregory Joseph,20,0,38,18
1650521761183,CSE 3,A51,083647,Miranda; Gregory Joseph,36,0,37,1
1650521767207,CSE 8A,A50,083650,Miranda; Gregory Joseph,0,29,40,40
1650521773234,CSE 11,A01,083080,Cao; Yingjun,0,94,40,40
1650521779257,CSE 12,A01,083652,Staff,0,17,100,100
1650521785290,CSE 15L,A01,083654,Staff,0,1,50,50
1650521785290,CSE 15L,A02,083655,Staff,0,0,50,50
1650521791313,CSE 20,A01,083657,Staff,51,0,80,29
1650521797336,CSE 30,A01,083084,Eldon; John,0,77,40,40
1650521803361,CSE 100,A01,083659,Cao; Yingjun,0,66,50,50
1650521809386,CSE 134B,A01,083661,Powell; Thomas Allan,0,34,65,65
1650521815416,CSE 140,A01,083663,Staff,0,5,75,75
1650521821453,CSE 140L,A01,083088,Eldon; John,0,11,75,75
1650521827477,CSE 175,A01,083665,Kumar; Rakesh,7,0,25,18
1650521833507,CSE 190,A00,092507,Dubnov; Shlomo,10,0,20,10
1650521839532,ECE 45,A01,083139,Staff,1,0,60,59
1650521845559,ECE 65,A50,083695,Staff,0,6,30,30
1650521851583,ECE 109,A01,091882,Touri; Behrouz,35,0,70,35
1650521857611,ECE 180,A00,083140,Abi Samra; Nicholas Camill,21,0,30,9
1650521857611,ECE 180,B00,083141,Abi Samra; Nicholas Camill,0,0,30,30
1650521863636,MATH 10A,A01,083735,Patchell; Gregory David,5,0,30,25
1650521863636,MATH 10A,A02,083736,Patchell; Gregory David,27,0,30,3
1650521863636,MATH 10A,A03,083737,Patchell; Gregory David,24,0,30,6
1650521869675,MATH 10B,A01,083207,Staff,0,9,30,30
1650521869675,MATH 10B,A02,083208,Staff,0,7,30,30
1650521869675,MATH 10B,B01,083739,Staff,13,0,30,17
1650521869675,MATH 10B,B02,083740,Staff,28,0,30,2
1650521875701,MATH 18,A01,083743,Staff,1,0,30,29
1650521875701,MATH 18,A02,083744,Staff,27,0,30,3
1650521875701,MATH 18,A03,083745,Staff,22,0,30,8
1650521875701,MATH 18,A04,083746,Staff,26,0,30,4
1650521875701,MATH 18,B01,083748,Staff,0,12,30,30
1650521875701,MATH 18,B02,083749,Staff,0,12,30,30
1650521875701,MATH 18,B03,083750,Staff,0,11,30,30
1650521875701,MATH 18,B04,083751,Staff,0,12,30,30
1650521881728,MATH 20A,A01,083754,Staff,23,0,40,17
1650521887755,MATH 20B,A01,083756,Staff,0,11,30,30
1650521887755,MATH 20B,A02,083757,Staff,0,12,30,30
1650521893778,MATH 20C,A01,083760,Staff,0,16,30,30
1650521893778,MATH 20C,A02,083761,Staff,2,14,30,28
1650521893778,MATH 20C,B01,083762,Staff,12,0,30,18
1650521893778,MATH 20C,B02,083763,Staff,28,0,30,2
1650521899804,MATH 20D,A01,083765,Staff,0,1,30,30
1650521899804,MATH 20D,A02,083766,Staff,7,0,30,23
1650521899804,MATH 20D,A03,083767,Staff,25,0,30,5
1650521905845,MATH 20E,A01,083771,Staff,6,0,30,24
1650521905845,MATH 20E,A02,083772,Staff,18,0,30,12
1650521905845,MATH 20E,B01,083773,Staff,0,0,30,30
1650521905845,MATH 20E,B02,083774,Staff,10,0,30,20
1650521911876,MATH 103A,A01,083777,Staff,0,14,30,30
1650521911876,MATH 103A,A02,083778,Staff,0,14,30,30
1650521911876,MATH 103A,B01,083779,Staff,0,13,30,30
1650521911876,MATH 103A,B02,083780,Staff,0,13,30,30
1650521917902,MATH 105,A01,085443,Staff,0,21,30,30
1650521923927,MATH 109,A01,083213,Anzaldo; Leesa B,0,8,30,30
1650521923927,MATH 109,A02,083214,Anzaldo; Leesa B,0,7,30,30
1650521923927,MATH 109,B01,083215,Anzaldo; Leesa B,0,5,30,30
1650521923927,MATH 109,B02,083216,Anzaldo; Leesa B,0,6,30,30
1650521929953,MATH 142A,A01,083219,Chow; Bennett,0,16,30,30
1650521929953,MATH 142A,A02,083220,Chow; Bennett,0,14,30,30
1650521929953,MATH 142A,B01,083221,Chow; Bennett,0,13,30,30
1650521929953,MATH 142A,B02,083222,Chow; Bennett,0,13,30,30
1650521935980,MATH 193A,A01,083224,Staff,0,6,30,30
1650521935980,MATH 193A,A02,083225,Staff,0,5,30,30
1650521935980,MATH 193A,A03,083781,Staff,0,5,30,30
1650521935980,MATH 193A,A04,083782,Staff,0,7,30,30
1650521942015,MATH 197,001,091859,McAuley; Julian John,9998,0,9999,1
1650521948073,COGS 9,A01,083615,Staff,0,16,60,60
1650521954099,COGS 11,A01,083617,Boyle; Mary E. T.,19,0,40,21
1650521960126,COGS 13,A01,083071,Staff,0,35,40,40
1650521966158,COGS 14A,A01,092681,Staff,0,25,100,100
1650521972187,COGS 14B,A01,083073,Cheng; Tzu-Han,0,12,50,50
1650521978212,COGS 17,A01,092677,Staff,20,0,75,55
1650521984236,COGS 100,A01,083619,Staff,0,26,60,60
1650521990260,COGS 101A,A01,083621,Davis; Joshua Daniel,0,26,60,60
1650521996284,COGS 101B,A01,091572,Staff,1,5,60,59
1650522002321,COGS 101C,A01,083625,Delgado; Tania,16,0,30,14
1650522008347,COGS 107A,A01,083627,Boyle; Mary E. T.,0,11,60,60
1650522014376,COGS 118A,A01,083075,Staff,0,3,60,60
1650522020401,CSE 3,A50,083646,Miranda; Gregory Joseph,20,0,38,18
1650522020401,CSE 3,A51,083647,Miranda; Gregory Joseph,36,0,37,1
1650522026429,CSE 8A,A50,083650,Miranda; Gregory Joseph,0,29,40,40
1650522032451,CSE 11,A01,083080,Cao; Yingjun,0,94,40,40
1650522038475,CSE 12,A01,083652,Staff,0,17,100,100
1650522044499,CSE 15L,A01,083654,Staff,0,1,50,50
1650522044499,CSE 15L,A02,083655,Staff,0,0,50,50
1650522050523,CSE 20,A01,083657,Staff,51,0,80,29
1650522056545,CSE 30,A01,083084,Eldon; John,0,77,40,40
1650522062569,CSE 100,A01,083659,Cao; Yingjun,0,66,50,50
1650522068596,CSE 134B,A01,083661,Powell; Thomas Allan,0,34,65,65
1650522074622,CSE 140,A01,083663,Staff,0,5,75,75
1650522080650,CSE 140L,A01,083088,Eldon; John,0,11,75,75
1650522086674,CSE 175,A01,083665,Kumar; Rakesh,7,0,25,18
1650522092699,CSE 190,A00,092507,Dubnov; Shlomo,10,0,20,10
1650522098723,ECE 45,A01,083139,Staff,1,0,60,59
1650522104756,ECE 65,A50,083695,Staff,0,6,30,30
1650522110779,ECE 109,A01,091882,Touri; Behrouz,35,0,70,35
1650522116815,ECE 180,A00,083140,Abi Samra; Nicholas Camill,21,0,30,9
1650522116815,ECE 180,B00,083141,Abi Samra; Nicholas Camill,0,0,30,30
1650522122840,MATH 10A,A01,083735,Patchell; Gregory David,5,0,30,25
1650522122840,MATH 10A,A02,083736,Patchell; Gregory David,27,0,30,3
1650522122840,MATH 10A,A03,083737,Patchell; Gregory David,24,0,30,6
1650522128875,MATH 10B,A01,083207,Staff,0,9,30,30
1650522128875,MATH 10B,A02,083208,Staff,0,7,30,30
1650522128875,MATH 10B,B01,083739,Staff,13,0,30,17
1650522128875,MATH 10B,B02,083740,Staff,28,0,30,2
1650522134902,MATH 18,A01,083743,Staff,1,0,30,29
1650522134902,MATH 18,A02,083744,Staff,27,0,30,3
1650522134902,MATH 18,A03,083745,Staff,22,0,30,8
1650522134902,MATH 18,A04,083746,Staff,26,0,30,4
1650522134902,MATH 18,B01,083748,Staff,0,12,30,30
1650522134902,MATH 18,B02,083749,Staff,0,12,30,30
1650522134902,MATH 18,B03,083750,Staff,0,11,30,30
1650522134902,MATH 18,B04,083751,Staff,0,12,30,30
1650522140927,MATH 20A,A01,083754,Staff,23,0,40,17
1650522146961,MATH 20B,A01,083756,Staff,0,11,30,30
1650522146961,MATH 20B,A02,083757,Staff,0,12,30,30
1650522152985,MATH 20C,A01,083760,Staff,0,16,30,30
1650522152985,MATH 20C,A02,083761,Staff,2,14,30,28
1650522152985,MATH 20C,B01,083762,Staff,12,0,30,18
1650522152985,MATH 20C,B02,083763,Staff,28,0,30,2
1650522159012,MATH 20D,A01,083765,Staff,0,1,30,30
1650522159012,MATH 20D,A02,083766,Staff,7,0,30,23
1650522159012,MATH 20D,A03,083767,Staff,25,0,30,5
1650522165047,MATH 20E,A01,083771,Staff,6,0,30,24
1650522165047,MATH 20E,A02,083772,Staff,18,0,30,12
1650522165047,MATH 20E,B01,083773,Staff,0,0,30,30
1650522165047,MATH 20E,B02,083774,Staff,10,0,30,20
1650522171072,MATH 103A,A01,083777,Staff,0,14,30,30
1650522171072,MATH 103A,A02,083778,Staff,0,14,30,30
1650522171072,MATH 103A,B01,083779,Staff,0,13,30,30
1650522171072,MATH 103A,B02,083780,Staff,0,13,30,30
1650522177101,MATH 105,A01,085443,Staff,0,21,30,30
1650522183198,MATH 109,A01,083213,Anzaldo; Leesa B,0,8,30,30
1650522183198,MATH 109,A02,083214,Anzaldo; Leesa B,0,7,30,30
1650522183198,MATH 109,B01,083215,Anzaldo; Leesa B,0,5,30,30
1650522183198,MATH 109,B02,083216,Anzaldo; Leesa B,0,6,30,30
1650522189223,MATH 142A,A01,083219,Chow; Bennett,0,16,30,30
1650522189223,MATH 142A,A02,083220,Chow; Bennett,0,14,30,30
1650522189223,MATH 142A,B01,083221,Chow; Bennett,0,13,30,30
1650522189223,MATH 142A,B02,083222,Chow; Bennett,0,13,30,30
1650522195250,MATH 193A,A01,083224,Staff,0,6,30,30
1650522195250,MATH 193A,A02,083225,Staff,0,5,30,30
1650522195250,MATH 193A,A03,083781,Staff,0,5,30,30
1650522195250,MATH 193A,A04,083782,Staff,0,7,30,30
1650522201282,MATH 197,001,091859,McAuley; Julian John,9998,0,9999,1
1650522207332,COGS 9,A01,083615,Staff,0,16,60,60
1650522213359,COGS 11,A01,083617,Boyle; Mary E. T.,19,0,40,21
1650522219385,COGS 13,A01,083071,Staff,0,35,40,40
1650522225409,COGS 14A,A01,092681,Staff,0,25,100,100
1650522231433,COGS 14B,A01,083073,Cheng; Tzu-Han,0,12,50,50
1650522237458,COGS 17,A01,092677,Staff,20,0,75,55
1650522243485,COGS 100,A01,083619,Staff,0,26,60,60
1650522249507,COGS 101A,A01,083621,Davis; Joshua Daniel,0,26,60,60
1650522255537,COGS 101B,A01,091572,Staff,1,5,60,59
1650522261560,COGS 101C,A01,083625,Delgado; Tania,16,0,30,14
1650522267583,COGS 107A,A01,083627,Boyle; Mary E. T.,0,11,60,60
1650522273608,COGS 118A,A01,083075,Staff,0,3,60,60
1650522279632,CSE 3,A50,083646,Miranda; Gregory Joseph,20,0,38,18
1650522279632,CSE 3,A51,083647,Miranda; Gregory Joseph,36,0,37,1
1650522285656,CSE 8A,A50,083650,Miranda; Gregory Joseph,0,29,40,40
1650522291680,CSE 11,A01,083080,Cao; Yingjun,0,94,40,40
1650522297704,CSE 12,A01,083652,Staff,0,17,100,100
1650522303728,CSE 15L,A01,083654,Staff,0,1,50,50
1650522303728,CSE 15L,A02,083655,Staff,0,0,50,50
1650522309753,CSE 20,A01,083657,Staff,51,0,80,29
1650522315776,CSE 30,A01,083084,Eldon; John,0,77,40,40
1650522321805,CSE 100,A01,083659,Cao; Yingjun,0,66,50,50
1650522327828,CSE 134B,A01,083661,Powell; Thomas Allan,0,34,65,65
1650522333852,CSE 140,A01,083663,Staff,0,5,75,75
1650522339877,CSE 140L,A01,083088,Eldon; John,0,11,75,75
1650522345900,CSE 175,A01,083665,Kumar; Rakesh,7,0,25,18
1650522351933,CSE 190,A00,092507,Dubnov; Shlomo,10,0,20,10
1650522357965,ECE 45,A01,083139,Staff,1,0,60,59
1650522363993,ECE 65,A50,083695,Staff,0,6,30,30
1650522370020,ECE 109,A01,091882,Touri; Behrouz,35,0,70,35
1650522376047,ECE 180,A00,083140,Abi Samra; Nicholas Camill,21,0,30,9
1650522376047,ECE 180,B00,083141,Abi Samra; Nicholas Camill,0,0,30,30
1650522382072,MATH 10A,A01,083735,Patchell; Gregory David,5,0,30,25
1650522382072,MATH 10A,A02,083736,Patchell; Gregory David,27,0,30,3
1650522382072,MATH 10A,A03,083737,Patchell; Gregory David,24,0,30,6
1650522388098,MATH 10B,A01,083207,Staff,0,9,30,30
1650522388098,MATH 10B,A02,083208,Staff,0,7,30,30
1650522388098,MATH 10B,B01,083739,Staff,13,0,30,17
1650522388098,MATH 10B,B02,083740,Staff,28,0,30,2
1650522394143,MATH 18,A01,083743,Staff,1,0,30,29
1650522394143,MATH 18,A02,083744,Staff,27,0,30,3
1650522394143,MATH 18,A03,083745,Staff,22,0,30,8
1650522394143,MATH 18,A04,083746,Staff,26,0,30,4
1650522394143,MATH 18,B01,083748,Staff,0,12,30,30
1650522394143,MATH 18,B02,083749,Staff,0,12,30,30
1650522394143,MATH 18,B03,083750,Staff,0,11,30,30
1650522394143,MATH 18,B04,083751,Staff,0,12,30,30
1650522400165,MATH 20A,A01,083754,Staff,22,0,40,18
1650522406189,MATH 20B,A01,083756,Staff,0,11,30,30
1650522406189,MATH 20B,A02,083757,Staff,0,12,30,30
1650522412218,MATH 20C,A01,083760,Staff,0,16,30,30
1650522412218,MATH 20C,A02,083761,Staff,2,14,30,28
1650522412218,MATH 20C,B01,083762,Staff,12,0,30,18
1650522412218,MATH 20C,B02,083763,Staff,28,0,30,2
1650522418245,MATH 20D,A01,083765,Staff,0,1,30,30
1650522418245,MATH 20D,A02,083766,Staff,7,0,30,23
1650522418245,MATH 20D,A03,083767,Staff,25,0,30,5
1650522424273,MATH 20E,A01,083771,Staff,6,0,30,24
1650522424273,MATH 20E,A02,083772,Staff,18,0,30,12
1650522424273,MATH 20E,B01,083773,Staff,0,0,30,30
1650522424273,MATH 20E,B02,083774,Staff,10,0,30,20
1650522430298,MATH 103A,A01,083777,Staff,0,14,30,30
1650522430298,MATH 103A,A02,083778,Staff,0,14,30,30
1650522430298,MATH 103A,B01,083779,Staff,0,13,30,30
1650522430298,MATH 103A,B02,083780,Staff,0,13,30,30
1650522436331,MATH 105,A01,085443,Staff,0,21,30,30
1650522442357,MATH 109,A01,083213,Anzaldo; Leesa B,0,8,30,30
1650522442357,MATH 109,A02,083214,Anzaldo; Leesa B,0,7,30,30
1650522442357,MATH 109,B01,083215,Anzaldo; Leesa B,0,5,30,30
1650522442357,MATH 109,B02,083216,Anzaldo; Leesa B,0,6,30,30
1650522448390,MATH 142A,A01,083219,Chow; Bennett,0,16,30,30
1650522448390,MATH 142A,A02,083220,Chow; Bennett,0,14,30,30
1650522448390,MATH 142A,B01,083221,Chow; Bennett,0,13,30,30
1650522448390,MATH 142A,B02,083222,Chow; Bennett,0,13,30,30
1650522454416,MATH 193A,A01,083224,Staff,0,6,30,30
1650522454416,MATH 193A,A02,083225,Staff,0,5,30,30
1650522454416,MATH 193A,A03,083781,Staff,0,5,30,30
1650522454416,MATH 193A,A04,083782,Staff,0,7,30,30
1650522460440,MATH 197,001,091859,McAuley; Julian John,9998,0,9999,1
1650522466501,COGS 9,A01,083615,Staff,0,16,60,60
1650522472526,COGS 11,A01,083617,Boyle; Mary E. T.,19,0,40,21
1650522478553,COGS 13,A01,083071,Staff,0,35,40,40
1650522484578,COGS 14A,A01,092681,Staff,0,25,100,100
1650522490605,COGS 14B,A01,083073,Cheng; Tzu-Han,0,12,50,50
1650522496631,COGS 17,A01,092677,Staff,20,0,75,55
1650522502658,COGS 100,A01,083619,Staff,0,26,60,60
1650522508681,COGS 101A,A01,083621,Davis; Joshua Daniel,0,26,60,60
1650522514705,COGS 101B,A01,091572,Staff,1,5,60,59
1650522520732,COGS 101C,A01,083625,Delgado; Tania,15,0,30,15
1650522526765,COGS 107A,A01,083627,Boyle; Mary E. T.,0,11,60,60
1650522532811,COGS 118A,A01,083075,Staff,0,3,60,60
1650522538839,CSE 3,A50,083646,Miranda; Gregory Joseph,20,0,38,18
1650522538839,CSE 3,A51,083647,Miranda; Gregory Joseph,36,0,37,1
1650522544866,CSE 8A,A50,083650,Miranda; Gregory Joseph,0,29,40,40
1650522550892,CSE 11,A01,083080,Cao; Yingjun,0,94,40,40
1650522556916,CSE 12,A01,083652,Staff,0,17,100,100
1650522562939,CSE 15L,A01,083654,Staff,0,1,50,50
1650522562939,CSE 15L,A02,083655,Staff,0,0,50,50
1650522568962,CSE 20,A01,083657,Staff,51,0,80,29
1650522574985,CSE 30,A01,083084,Eldon; John,0,77,40,40
1650522581018,CSE 100,A01,083659,Cao; Yingjun,0,66,50,50
1650522587043,CSE 134B,A01,083661,Powell; Thomas Allan,0,34,65,65
1650522593066,CSE 140,A01,083663,Staff,0,5,75,75
1650522599092,CSE 140L,A01,083088,Eldon; John,0,11,75,75
1650522605117,CSE 175,A01,083665,Kumar; Rakesh,7,0,25,18
1650522611144,CSE 190,A00,092507,Dubnov; Shlomo,10,0,20,10
1650522617175,ECE 45,A01,083139,Staff,1,0,60,59
1650522623199,ECE 65,A50,083695,Staff,0,6,30,30
1650522629223,ECE 109,A01,091882,Touri; Behrouz,35,0,70,35
1650522635249,ECE 180,A00,083140,Abi Samra; Nicholas Camill,21,0,30,9
1650522635249,ECE 180,B00,083141,Abi Samra; Nicholas Camill,0,0,30,30
1650522641275,MATH 10A,A01,083735,Patchell; Gregory David,5,0,30,25
1650522641275,MATH 10A,A02,083736,Patchell; Gregory David,27,0,30,3
1650522641275,MATH 10A,A03,083737,Patchell; Gregory David,24,0,30,6
1650522647298,MATH 10B,A01,083207,Staff,0,9,30,30
1650522647298,MATH 10B,A02,083208,Staff,0,7,30,30
1650522647298,MATH 10B,B01,083739,Staff,13,0,30,17
1650522647298,MATH 10B,B02,083740,Staff,28,0,30,2
1650522653322,MATH 18,A01,083743,Staff,1,0,30,29
1650522653322,MATH 18,A02,083744,Staff,27,0,30,3
1650522653322,MATH 18,A03,083745,Staff,22,0,30,8
1650522653322,MATH 18,A04,083746,Staff,26,0,30,4
1650522653322,MATH 18,B01,083748,Staff,0,12,30,30
1650522653322,MATH 18,B02,083749,Staff,0,12,30,30
1650522653322,MATH 18,B03,083750,Staff,0,11,30,30
1650522653322,MATH 18,B04,083751,Staff,0,12,30,30
1650522659352,MATH 20A,A01,083754,Staff,22,0,40,18
1650522665378,MATH 20B,A01,083756,Staff,0,11,30,30
1650522665378,MATH 20B,A02,083757,Staff,0,12,30,30
1650522671403,MATH 20C,A01,083760,Staff,0,16,30,30
1650522671403,MATH 20C,A02,083761,Staff,2,14,30,28
1650522671403,MATH 20C,B01,083762,Staff,12,0,30,18
1650522671403,MATH 20C,B02,083763,Staff,28,0,30,2
1650522677426,MATH 20D,A01,083765,Staff,0,1,30,30
1650522677426,MATH 20D,A02,083766,Staff,7,0,30,23
1650522677426,MATH 20D,A03,083767,Staff,25,0,30,5
1650522683449,MATH 20E,A01,083771,Staff,6,0,30,24
1650522683449,MATH 20E,A02,083772,Staff,18,0,30,12
1650522683449,MATH 20E,B01,083773,Staff,0,0,30,30
1650522683449,MATH 20E,B02,083774,Staff,10,0,30,20
1650522689475,MATH 103A,A01,083777,Staff,0,14,30,30
1650522689475,MATH 103A,A02,083778,Staff,0,14,30,30
1650522689475,MATH 103A,B01,083779,Staff,0,13,30,30
1650522689475,MATH 103A,B02,083780,Staff,0,13,30,30
1650522695511,MATH 105,A01,085443,Staff,0,21,30,30
1650522701533,MATH 109,A01,083213,Anzaldo; Leesa B,0,8,30,30
1650522701533,MATH 109,A02,083214,Anzaldo; Leesa B,0,7,30,30
1650522701533,MATH 109,B01,083215,Anzaldo; Leesa B,0,5,30,30
1650522701533,MATH 109,B02,083216,Anzaldo; Leesa B,0,6,30,30
1650522707563,MATH 142A,A01,083219,Chow; Bennett,0,16,30,30
1650522707563,MATH 142A,A02,083220,Chow; Bennett,0,14,30,30
1650522707563,MATH 142A,B01,083221,Chow; Bennett,0,13,30,30
1650522707563,MATH 142A,B02,083222,Chow; Bennett,0,13,30,30
1650522713590,MATH 193A,A01,083224,Staff,0,6,30,30
1650522713590,MATH 193A,A02,083225,Staff,0,5,30,30
1650522713590,MATH 193A,A03,083781,Staff,0,5,30,30
1650522713590,MATH 193A,A04,083782,Staff,0,7,30,30
1650522719614,MATH 197,001,091859,McAuley; Julian John,9998,0,9999,1
1650522725669,COGS 9,A01,083615,Staff,0,16,60,60
1650522731692,COGS 11,A01,083617,Boyle; Mary E. T.,19,0,40,21
1650522737717,COGS 13,A01,083071,Staff,0,35,40,40
1650522743740,COGS 14A,A01,092681,Staff,0,25,100,100
1650522749767,COGS 14B,A01,083073,Cheng; Tzu-Han,0,12,50,50
1650522755791,COGS 17,A01,092677,Staff,20,0,75,55
1650522761816,COGS 100,A01,083619,Staff,0,26,60,60
1650522767839,COGS 101A,A01,083621,Davis; Joshua Daniel,0,26,60,60
1650522773957,COGS 101B,A01,091572,Staff,1,5,60,59
1650522779985,COGS 101C,A01,083625,Delgado; Tania,15,0,30,15
1650522786012,COGS 107A,A01,083627,Boyle; Mary E. T.,0,11,60,60
1650522792041,COGS 118A,A01,083075,Staff,0,3,60,60
1650522798067,CSE 3,A50,083646,Miranda; Gregory Joseph,20,0,38,18
1650522798067,CSE 3,A51,083647,Miranda; Gregory Joseph,36,0,37,1
1650522804092,CSE 8A,A50,083650,Miranda; Gregory Joseph,0,29,40,40
1650522810115,CSE 11,A01,083080,Cao; Yingjun,0,94,40,40
1650522816161,CSE 12,A01,083652,Staff,0,17,100,100
1650522822184,CSE 15L,A01,083654,Staff,0,1,50,50
1650522822184,CSE 15L,A02,083655,Staff,0,0,50,50
1650522828207,CSE 20,A01,083657,Staff,51,0,80,29
1650522834230,CSE 30,A01,083084,Eldon; John,0,77,40,40
1650522840265,CSE 100,A01,083659,Cao; Yingjun,0,66,50,50
1650522846293,CSE 134B,A01,083661,Powell; Thomas Allan,0,34,65,65
1650522852320,CSE 140,A01,083663,Staff,0,5,75,75
1650522858352,CSE 140L,A01,083088,Eldon; John,0,11,75,75
1650522864378,CSE 175,A01,083665,Kumar; Rakesh,7,0,25,18
1650522870401,CSE 190,A00,092507,Dubnov; Shlomo,10,0,20,10
1650522876425,ECE 45,A01,083139,Staff,1,0,60,59
1650522882448,ECE 65,A50,083695,Staff,0,6,30,30
1650522888473,ECE 109,A01,091882,Touri; Behrouz,35,0,70,35
1650522894500,ECE 180,A00,083140,Abi Samra; Nicholas Camill,21,0,30,9
1650522894500,ECE 180,B00,083141,Abi Samra; Nicholas Camill,0,0,30,30
1650522900523,MATH 10A,A01,083735,Patchell; Gregory David,5,0,30,25
1650522900523,MATH 10A,A02,083736,Patchell; Gregory David,27,0,30,3
1650522900523,MATH 10A,A03,083737,Patchell; Gregory David,24,0,30,6
1650522906547,MATH 10B,A01,083207,Staff,0,9,30,30
1650522906547,MATH 10B,A02,083208,Staff,0,7,30,30
1650522906547,MATH 10B,B01,083739,Staff,13,0,30,17
1650522906547,MATH 10B,B02,083740,Staff,28,0,30,2
1650522912575,MATH 18,A01,083743,Staff,1,0,30,29
1650522912575,MATH 18,A02,083744,Staff,27,0,30,3
1650522912575,MATH 18,A03,083745,Staff,22,0,30,8
1650522912575,MATH 18,A04,083746,Staff,26,0,30,4
1650522912575,MATH 18,B01,083748,Staff,0,12,30,30
1650522912575,MATH 18,B02,083749,Staff,0,12,30,30
1650522912575,MATH 18,B03,083750,Staff,0,11,30,30
1650522912575,MATH 18,B04,083751,Staff,0,12,30,30
1650522918606,MATH 20A,A01,083754,Staff,22,0,40,18
1650522924630,MATH 20B,A01,083756,Staff,0,11,30,30
1650522924630,MATH 20B,A02,083757,Staff,0,12,30,30
1650522930657,MATH 20C,A01,083760,Staff,0,16,30,30
1650522930657,MATH 20C,A02,083761,Staff,2,14,30,28
1650522930657,MATH 20C,B01,083762,Staff,12,0,30,18
1650522930657,MATH 20C,B02,083763,Staff,28,0,30,2
1650522936684,MATH 20D,A01,083765,Staff,0,1,30,30
1650522936684,MATH 20D,A02,083766,Staff,7,0,30,23
1650522936684,MATH 20D,A03,083767,Staff,25,0,30,5
1650522942712,MATH 20E,A01,083771,Staff,6,0,30,24
1650522942712,MATH 20E,A02,083772,Staff,18,0,30,12
1650522942712,MATH 20E,B01,083773,Staff,0,0,30,30
1650522942712,MATH 20E,B02,083774,Staff,10,0,30,20
1650522948734,MATH 103A,A01,083777,Staff,0,14,30,30
1650522948734,MATH 103A,A02,083778,Staff,0,14,30,30
1650522948734,MATH 103A,B01,083779,Staff,0,13,30,30
1650522948734,MATH 103A,B02,083780,Staff,0,13,30,30
1650522954761,MATH 105,A01,085443,Staff,0,21,30,30
1650522960804,MATH 109,A01,083213,Anzaldo; Leesa B,0,8,30,30
1650522960804,MATH 109,A02,083214,Anzaldo; Leesa B,0,7,30,30
1650522960804,MATH 109,B01,083215,Anzaldo; Leesa B,0,5,30,30
1650522960804,MATH 109,B02,083216,Anzaldo; Leesa B,0,6,30,30
1650522966829,MATH 142A,A01,083219,Chow; Bennett,0,16,30,30
1650522966829,MATH 142A,A02,083220,Chow; Bennett,0,14,30,30
1650522966829,MATH 142A,B01,083221,Chow; Bennett,0,13,30,30
1650522966829,MATH 142A,B02,083222,Chow; Bennett,0,13,30,30
1650522972855,MATH 193A,A01,083224,Staff,0,6,30,30
1650522972855,MATH 193A,A02,083225,Staff,0,5,30,30
1650522972855,MATH 193A,A03,083781,Staff,0,5,30,30
1650522972855,MATH 193A,A04,083782,Staff,0,7,30,30
1650522978877,MATH 197,001,091859,McAuley; Julian John,9998,0,9999,1
1650522984945,COGS 9,A01,083615,Staff,0,16,60,60
1650522990971,COGS 11,A01,083617,Boyle; Mary E. T.,19,0,40,21
1650522996996,COGS 13,A01,083071,Staff,0,35,40,40
1650523003029,COGS 14A,A01,092681,Staff,0,25,100,100
1650523009054,COGS 14B,A01,083073,Cheng; Tzu-Han,0,12,50,50
1650523015078,COGS 17,A01,092677,Staff,20,0,75,55
1650523021103,COGS 100,A01,083619,Staff,0,26,60,60
1650523027128,COGS 101A,A01,083621,Davis; Joshua Daniel,0,26,60,60
1650523033152,COGS 101B,A01,091572,Staff,1,5,60,59
1650523039178,COGS 101C,A01,083625,Delgado; Tania,15,0,30,15
1650523045210,COGS 107A,A01,083627,Boyle; Mary E. T.,0,11,60,60
1650523051234,COGS 118A,A01,083075,Staff,0,3,60,60
1650523057265,CSE 3,A50,083646,Miranda; Gregory Joseph,20,0,38,18
1650523057265,CSE 3,A51,083647,Miranda; Gregory Joseph,36,0,37,1
1650523063291,CSE 8A,A50,083650,Miranda; Gregory Joseph,0,29,40,40
1650523069319,CSE 11,A01,083080,Cao; Yingjun,0,94,40,40
1650523075345,CSE 12,A01,083652,Staff,0,17,100,100
1650523081370,CSE 15L,A01,083654,Staff,0,1,50,50
1650523081370,CSE 15L,A02,083655,Staff,0,0,50,50
1650523087396,CSE 20,A01,083657,Staff,51,0,80,29
1650523093420,CSE 30,A01,083084,Eldon; John,0,77,40,40
1650523099446,CSE 100,A01,083659,Cao; Yingjun,0,66,50,50
1650523105470,CSE 134B,A01,083661,Powell; Thomas Allan,0,34,65,65
1650523111497,CSE 140,A01,083663,Staff,0,5,75,75
1650523117527,CSE 140L,A01,083088,Eldon; John,0,11,75,75
1650523123551,CSE 175,A01,083665,Kumar; Rakesh,7,0,25,18
1650523129576,CSE 190,A00,092507,Dubnov; Shlomo,10,0,20,10
1650523135599,ECE 45,A01,083139,Staff,1,0,60,59
1650523141625,ECE 65,A50,083695,Staff,0,6,30,30
1650523147653,ECE 109,A01,091882,Touri; Behrouz,35,0,70,35
1650523153679,ECE 180,A00,083140,Abi Samra; Nicholas Camill,21,0,30,9
1650523153679,ECE 180,B00,083141,Abi Samra; Nicholas Camill,0,0,30,30
1650523159704,MATH 10A,A01,083735,Patchell; Gregory David,5,0,30,25
1650523159704,MATH 10A,A02,083736,Patchell; Gregory David,27,0,30,3
1650523159704,MATH 10A,A03,083737,Patchell; Gregory David,24,0,30,6
1650523165730,MATH 10B,A01,083207,Staff,0,9,30,30
1650523165730,MATH 10B,A02,083208,Staff,0,7,30,30
1650523165730,MATH 10B,B01,083739,Staff,13,0,30,17
1650523165730,MATH 10B,B02,083740,Staff,28,0,30,2
1650523171755,MATH 18,A01,083743,Staff,1,0,30,29
1650523171755,MATH 18,A02,083744,Staff,27,0,30,3
1650523171755,MATH 18,A03,083745,Staff,22,0,30,8
1650523171755,MATH 18,A04,083746,Staff,26,0,30,4
1650523171755,MATH 18,B01,083748,Staff,0,12,30,30
1650523171755,MATH 18,B02,083749,Staff,0,12,30,30
1650523171755,MATH 18,B03,083750,Staff,0,11,30,30
1650523171755,MATH 18,B04,083751,Staff,0,12,30,30
1650523177791,MATH 20A,A01,083754,Staff,22,0,40,18
1650523183817,MATH 20B,A01,083756,Staff,0,11,30,30
1650523183817,MATH 20B,A02,083757,Staff,0,12,30,30
1650523189842,MATH 20C,A01,083760,Staff,0,16,30,30
1650523189842,MATH 20C,A02,083761,Staff,2,14,30,28
1650523189842,MATH 20C,B01,083762,Staff,12,0,30,18
1650523189842,MATH 20C,B02,083763,Staff,28,0,30,2
1650523195867,MATH 20D,A01,083765,Staff,0,1,30,30
1650523195867,MATH 20D,A02,083766,Staff,7,0,30,23
1650523195867,MATH 20D,A03,083767,Staff,25,0,30,5
1650523201893,MATH 20E,A01,083771,Staff,6,0,30,24
1650523201893,MATH 20E,A02,083772,Staff,18,0,30,12
1650523201893,MATH 20E,B01,083773,Staff,0,0,30,30
1650523201893,MATH 20E,B02,083774,Staff,10,0,30,20
1650523207916,MATH 103A,A01,083777,Staff,0,14,30,30
1650523207916,MATH 103A,A02,083778,Staff,0,14,30,30
1650523207916,MATH 103A,B01,083779,Staff,0,13,30,30
1650523207916,MATH 103A,B02,083780,Staff,0,13,30,30
1650523213942,MATH 105,A01,085443,Staff,0,21,30,30
1650523219966,MATH 109,A01,083213,Anzaldo; Leesa B,0,8,30,30
1650523219966,MATH 109,A02,083214,Anzaldo; Leesa B,0,7,30,30
1650523219966,MATH 109,B01,083215,Anzaldo; Leesa B,0,5,30,30
1650523219966,MATH 109,B02,083216,Anzaldo; Leesa B,0,6,30,30
1650523225989,MATH 142A,A01,083219,Chow; Bennett,0,16,30,30
1650523225989,MATH 142A,A02,083220,Chow; Bennett,0,14,30,30
1650523225989,MATH 142A,B01,083221,Chow; Bennett,0,13,30,30
1650523225989,MATH 142A,B02,083222,Chow; Bennett,0,13,30,30
1650523232012,MATH 193A,A01,083224,Staff,0,6,30,30
1650523232012,MATH 193A,A02,083225,Staff,0,5,30,30
1650523232012,MATH 193A,A03,083781,Staff,0,5,30,30
1650523232012,MATH 193A,A04,083782,Staff,0,7,30,30
1650523238035,MATH 197,001,091859,McAuley; Julian John,9998,0,9999,1
1650523244089,COGS 9,A01,083615,Staff,0,16,60,60
1650523250114,COGS 11,A01,083617,Boyle; Mary E. T.,19,0,40,21
1650523256139,COGS 13,A01,083071,Staff,0,35,40,40
1650523262166,COGS 14A,A01,092681,Staff,0,25,100,100
1650523268193,COGS 14B,A01,083073,Cheng; Tzu-Han,0,12,50,50
1650523274221,COGS 17,A01,092677,Staff,20,0,75,55
1650523280247,COGS 100,A01,083619,Staff,0,26,60,60
1650523286271,COGS 101A,A01,083621,Davis; Joshua Daniel,0,26,60,60
1650523292296,COGS 101B,A01,091572,Staff,1,5,60,59
1650523298319,COGS 101C,A01,083625,Delgado; Tania,15,0,30,15
1650523304342,COGS 107A,A01,083627,Boyle; Mary E. T.,0,11,60,60
1650523310367,COGS 118A,A01,083075,Staff,0,3,60,60
1650523316394,CSE 3,A50,083646,Miranda; Gregory Joseph,20,0,38,18
1650523316394,CSE 3,A51,083647,Miranda; Gregory Joseph,36,0,37,1
1650523322421,CSE 8A,A50,083650,Miranda; Gregory Joseph,0,29,40,40
1650523328444,CSE 11,A01,083080,Cao; Yingjun,0,94,40,40
1650523334467,CSE 12,A01,083652,Staff,0,17,100,100
1650523340489,CSE 15L,A01,083654,Staff,0,1,50,50
1650523340489,CSE 15L,A02,083655,Staff,0,0,50,50
1650523346513,CSE 20,A01,083657,Staff,51,0,80,29
1650523352545,CSE 30,A01,083084,Eldon; John,0,77,40,40
1650523358573,CSE 100,A01,083659,Cao; Yingjun,0,66,50,50
1650523364596,CSE 134B,A01,083661,Powell; Thomas Allan,0,34,65,65
1650523370725,CSE 140,A01,083663,Staff,0,5,75,75
1650523376751,CSE 140L,A01,083088,Eldon; John,0,11,75,75
1650523382777,CSE 175,A01,083665,Kumar; Rakesh,7,0,25,18
1650523388806,CSE 190,A00,092507,Dubnov; Shlomo,10,0,20,10
1650523394831,ECE 45,A01,083139,Staff,1,0,60,59
1650523400858,ECE 65,A50,083695,Staff,0,6,30,30
1650523406882,ECE 109,A01,091882,Touri; Behrouz,35,0,70,35
1650523412906,ECE 180,A00,083140,Abi Samra; Nicholas Camill,21,0,30,9
1650523412906,ECE 180,B00,083141,Abi Samra; Nicholas Camill,0,0,30,30
1650523418933,MATH 10A,A01,083735,Patchell; Gregory David,5,0,30,25
1650523418933,MATH 10A,A02,083736,Patchell; Gregory David,27,0,30,3
1650523418933,MATH 10A,A03,083737,Patchell; Gregory David,24,0,30,6
1650523424969,MATH 10B,A01,083207,Staff,0,9,30,30
1650523424969,MATH 10B,A02,083208,Staff,0,7,30,30
1650523424969,MATH 10B,B01,083739,Staff,13,0,30,17
1650523424969,MATH 10B,B02,083740,Staff,28,0,30,2
1650523430999,MATH 18,A01,083743,Staff,1,0,30,29
1650523430999,MATH 18,A02,083744,Staff,27,0,30,3
1650523430999,MATH 18,A03,083745,Staff,22,0,30,8
1650523430999,MATH 18,A04,083746,Staff,26,0,30,4
1650523430999,MATH 18,B01,083748,Staff,0,12,30,30
1650523430999,MATH 18,B02,083749,Staff,0,12,30,30
1650523430999,MATH 18,B03,083750,Staff,0,11,30,30
1650523430999,MATH 18,B04,083751,Staff,0,12,30,30
1650523437025,MATH 20A,A01,083754,Staff,22,0,40,18
1650523443051,MATH 20B,A01,083756,Staff,0,11,30,30
1650523443051,MATH 20B,A02,083757,Staff,0,12,30,30
1650523449075,MATH 20C,A01,083760,Staff,0,16,30,30
1650523449075,MATH 20C,A02,083761,Staff,2,14,30,28
1650523449075,MATH 20C,B01,083762,Staff,12,0,30,18
1650523449075,MATH 20C,B02,083763,Staff,28,0,30,2
1650523455099,MATH 20D,A01,083765,Staff,0,1,30,30
1650523455099,MATH 20D,A02,083766,Staff,7,0,30,23
1650523455099,MATH 20D,A03,083767,Staff,25,0,30,5
1650523461121,MATH 20E,A01,083771,Staff,6,0,30,24
1650523461121,MATH 20E,A02,083772,Staff,18,0,30,12
1650523461121,MATH 20E,B01,083773,Staff,0,0,30,30
1650523461121,MATH 20E,B02,083774,Staff,10,0,30,20
1650523467146,MATH 103A,A01,083777,Staff,0,14,30,30
1650523467146,MATH 103A,A02,083778,Staff,0,14,30,30
1650523467146,MATH 103A,B01,083779,Staff,0,13,30,30
1650523467146,MATH 103A,B02,083780,Staff,0,13,30,30
1650523473173,MATH 105,A01,085443,Staff,0,21,30,30
1650523479197,MATH 109,A01,083213,Anzaldo; Leesa B,0,8,30,30
1650523479197,MATH 109,A02,083214,Anzaldo; Leesa B,0,7,30,30
1650523479197,MATH 109,B01,083215,Anzaldo; Leesa B,0,5,30,30
1650523479197,MATH 109,B02,083216,Anzaldo; Leesa B,0,6,30,30
1650523485222,MATH 142A,A01,083219,Chow; Bennett,0,16,30,30
1650523485222,MATH 142A,A02,083220,Chow; Bennett,0,14,30,30
1650523485222,MATH 142A,B01,083221,Chow; Bennett,0,13,30,30
1650523485222,MATH 142A,B02,083222,Chow; Bennett,0,13,30,30
1650523491245,MATH 193A,A01,083224,Staff,0,6,30,30
1650523491245,MATH 193A,A02,083225,Staff,0,5,30,30
1650523491245,MATH 193A,A03,083781,Staff,0,5,30,30
1650523491245,MATH 193A,A04,083782,Staff,0,7,30,30
1650523497268,MATH 197,001,091859,McAuley; Julian John,9998,0,9999,1
1650523503322,COGS 9,A01,083615,Staff,0,16,60,60
1650523509345,COGS 11,A01,083617,Boyle; Mary E. T.,19,0,40,21
1650523515369,COGS 13,A01,083071,Staff,0,35,40,40
1650523521392,COGS 14A,A01,092681,Staff,0,25,100,100
1650523527415,COGS 14B,A01,083073,Cheng; Tzu-Han,0,12,50,50
1650523533445,COGS 17,A01,092677,Staff,20,0,75,55
1650523539469,COGS 100,A01,083619,Staff,0,26,60,60
1650523545495,COGS 101A,A01,083621,Davis; Joshua Daniel,0,26,60,60
1650523551519,COGS 101B,A01,091572,Staff,1,5,60,59
1650523557545,COGS 101C,A01,083625,Delgado; Tania,15,0,30,15
1650523563569,COGS 107A,A01,083627,Boyle; Mary E. T.,0,11,60,60
1650523569600,COGS 118A,A01,083075,Staff,0,3,60,60
1650523575625,CSE 3,A50,083646,Miranda; Gregory Joseph,20,0,38,18
1650523575625,CSE 3,A51,083647,Miranda; Gregory Joseph,36,0,37,1
1650523581650,CSE 8A,A50,083650,Miranda; Gregory Joseph,0,29,40,40
1650523587673,CSE 11,A01,083080,Cao; Yingjun,0,94,40,40
1650523593700,CSE 12,A01,083652,Staff,0,17,100,100
1650523599724,CSE 15L,A01,083654,Staff,0,1,50,50
1650523599724,CSE 15L,A02,083655,Staff,0,0,50,50
1650523605747,CSE 20,A01,083657,Staff,51,0,80,29
1650523611780,CSE 30,A01,083084,Eldon; John,0,77,40,40
1650523617803,CSE 100,A01,083659,Cao; Yingjun,0,66,50,50
1650523623831,CSE 134B,A01,083661,Powell; Thomas Allan,0,34,65,65
1650523629866,CSE 140,A01,083663,Staff,0,5,75,75
1650523635890,CSE 140L,A01,083088,Eldon; John,0,11,75,75
1650523641915,CSE 175,A01,083665,Kumar; Rakesh,7,0,25,18
1650523647939,CSE 190,A00,092507,Dubnov; Shlomo,10,0,20,10
1650523653966,ECE 45,A01,083139,Staff,1,0,60,59
1650523659991,ECE 65,A50,083695,Staff,0,6,30,30
1650523666014,ECE 109,A01,091882,Touri; Behrouz,35,0,70,35
1650523672039,ECE 180,A00,083140,Abi Samra; Nicholas Camill,21,0,30,9
1650523672039,ECE 180,B00,083141,Abi Samra; Nicholas Camill,0,0,30,30
1650523678066,MATH 10A,A01,083735,Patchell; Gregory David,5,0,30,25
1650523678066,MATH 10A,A02,083736,Patchell; Gregory David,27,0,30,3
1650523678066,MATH 10A,A03,083737,Patchell; Gregory David,24,0,30,6
1650523684091,MATH 10B,A01,083207,Staff,0,9,30,30
1650523684091,MATH 10B,A02,083208,Staff,0,7,30,30
1650523684091,MATH 10B,B01,083739,Staff,13,0,30,17
1650523684091,MATH 10B,B02,083740,Staff,28,0,30,2
1650523690115,MATH 18,A01,083743,Staff,1,0,30,29
1650523690115,MATH 18,A02,083744,Staff,27,0,30,3
1650523690115,MATH 18,A03,083745,Staff,22,0,30,8
1650523690115,MATH 18,A04,083746,Staff,26,0,30,4
1650523690115,MATH 18,B01,083748,Staff,0,12,30,30
1650523690115,MATH 18,B02,083749,Staff,0,12,30,30
1650523690115,MATH 18,B03,083750,Staff,0,11,30,30
1650523690115,MATH 18,B04,083751,Staff,0,12,30,30
1650523696138,MATH 20A,A01,083754,Staff,22,0,40,18
1650523702162,MATH 20B,A01,083756,Staff,0,11,30,30
1650523702162,MATH 20B,A02,083757,Staff,0,12,30,30
1650523708186,MATH 20C,A01,083760,Staff,0,16,30,30
1650523708186,MATH 20C,A02,083761,Staff,2,14,30,28
1650523708186,MATH 20C,B01,083762,Staff,12,0,30,18
1650523708186,MATH 20C,B02,083763,Staff,28,0,30,2
1650523714213,MATH 20D,A01,083765,Staff,0,1,30,30
1650523714213,MATH 20D,A02,083766,Staff,7,0,30,23
1650523714213,MATH 20D,A03,083767,Staff,25,0,30,5
1650523720244,MATH 20E,A01,083771,Staff,6,0,30,24
1650523720244,MATH 20E,A02,083772,Staff,18,0,30,12
1650523720244,MATH 20E,B01,083773,Staff,0,0,30,30
1650523720244,MATH 20E,B02,083774,Staff,10,0,30,20
1650523726268,MATH 103A,A01,083777,Staff,0,14,30,30
1650523726268,MATH 103A,A02,083778,Staff,0,14,30,30
1650523726268,MATH 103A,B01,083779,Staff,0,13,30,30
1650523726268,MATH 103A,B02,083780,Staff,0,13,30,30
1650523732296,MATH 105,A01,085443,Staff,0,21,30,30
1650523738322,MATH 109,A01,083213,Anzaldo; Leesa B,0,8,30,30
1650523738322,MATH 109,A02,083214,Anzaldo; Leesa B,0,7,30,30
1650523738322,MATH 109,B01,083215,Anzaldo; Leesa B,0,5,30,30
1650523738322,MATH 109,B02,083216,Anzaldo; Leesa B,0,6,30,30
1650523744346,MATH 142A,A01,083219,Chow; Bennett,0,16,30,30
1650523744346,MATH 142A,A02,083220,Chow; Bennett,0,14,30,30
1650523744346,MATH 142A,B01,083221,Chow; Bennett,0,13,30,30
1650523744346,MATH 142A,B02,083222,Chow; Bennett,0,13,30,30
1650523750367,MATH 193A,A01,083224,Staff,0,6,30,30
1650523750367,MATH 193A,A02,083225,Staff,0,5,30,30
1650523750367,MATH 193A,A03,083781,Staff,0,5,30,30
1650523750367,MATH 193A,A04,083782,Staff,0,7,30,30
1650523756393,MATH 197,001,091859,McAuley; Julian John,9998,0,9999,1
1650523762444,COGS 9,A01,083615,Staff,0,16,60,60
1650523768472,COGS 11,A01,083617,Boyle; Mary E. T.,19,0,40,21
1650523774498,COGS 13,A01,083071,Staff,0,35,40,40
1650523780524,COGS 14A,A01,092681,Staff,0,25,100,100
1650523786549,COGS 14B,A01,083073,Cheng; Tzu-Han,0,12,50,50
1650523792573,COGS 17,A01,092677,Staff,20,0,75,55
1650523798599,COGS 100,A01,083619,Staff,0,26,60,60
1650523804629,COGS 101A,A01,083621,Davis; Joshua Daniel,0,26,60,60
1650523810654,COGS 101B,A01,091572,Staff,1,5,60,59
1650523816680,COGS 101C,A01,083625,Delgado; Tania,15,0,30,15
1650523822704,COGS 107A,A01,083627,Boyle; Mary E. T.,0,11,60,60
1650523828727,COGS 118A,A01,083075,Staff,0,3,60,60
1650523834755,CSE 3,A50,083646,Miranda; Gregory Joseph,20,0,38,18
1650523834755,CSE 3,A51,083647,Miranda; Gregory Joseph,36,0,37,1
1650523840784,CSE 8A,A50,083650,Miranda; Gregory Joseph,0,29,40,40
1650523846809,CSE 11,A01,083080,Cao; Yingjun,0,94,40,40
1650523852837,CSE 12,A01,083652,Staff,0,17,100,100
1650523858873,CSE 15L,A01,083654,Staff,0,1,50,50
1650523858873,CSE 15L,A02,083655,Staff,0,0,50,50
1650523864897,CSE 20,A01,083657,Staff,51,0,80,29
1650523870921,CSE 30,A01,083084,Eldon; John,0,77,40,40
1650523876943,CSE 100,A01,083659,Cao; Yingjun,0,66,50,50
1650523882966,CSE 134B,A01,083661,Powell; Thomas Allan,0,34,65,65
1650523888988,CSE 140,A01,083663,Staff,0,5,75,75
1650523895019,CSE 140L,A01,083088,Eldon; John,0,11,75,75
1650523901044,CSE 175,A01,083665,Kumar; Rakesh,7,0,25,18
1650523907066,CSE 190,A00,092507,Dubnov; Shlomo,10,0,20,10
1650523913093,ECE 45,A01,083139,Staff,1,0,60,59
1650523919117,ECE 65,A50,083695,Staff,0,6,30,30
1650523925141,ECE 109,A01,091882,Touri; Behrouz,35,0,70,35
1650523931177,ECE 180,A00,083140,Abi Samra; Nicholas Camill,21,0,30,9
1650523931177,ECE 180,B00,083141,Abi Samra; Nicholas Camill,0,0,30,30
1650523937201,MATH 10A,A01,083735,Patchell; Gregory David,5,0,30,25
1650523937201,MATH 10A,A02,083736,Patchell; Gregory David,27,0,30,3
1650523937201,MATH 10A,A03,083737,Patchell; Gregory David,24,0,30,6
1650523943228,MATH 10B,A01,083207,Staff,0,9,30,30
1650523943228,MATH 10B,A02,083208,Staff,0,7,30,30
1650523943228,MATH 10B,B01,083739,Staff,13,0,30,17
1650523943228,MATH 10B,B02,083740,Staff,28,0,30,2
1650523949261,MATH 18,A01,083743,Staff,1,0,30,29
1650523949261,MATH 18,A02,083744,Staff,27,0,30,3
1650523949261,MATH 18,A03,083745,Staff,22,0,30,8
1650523949261,MATH 18,A04,083746,Staff,26,0,30,4
1650523949261,MATH 18,B01,083748,Staff,0,12,30,30
1650523949261,MATH 18,B02,083749,Staff,0,12,30,30
1650523949261,MATH 18,B03,083750,Staff,0,11,30,30
1650523949261,MATH 18,B04,083751,Staff,0,12,30,30
1650523955284,MATH 20A,A01,083754,Staff,22,0,40,18
1650523961309,MATH 20B,A01,083756,Staff,0,11,30,30
1650523961309,MATH 20B,A02,083757,Staff,0,12,30,30
1650523967422,MATH 20C,A01,083760,Staff,0,16,30,30
1650523967422,MATH 20C,A02,083761,Staff,2,14,30,28
1650523967422,MATH 20C,B01,083762,Staff,12,0,30,18
1650523967422,MATH 20C,B02,083763,Staff,28,0,30,2
1650523973445,MATH 20D,A01,083765,Staff,0,1,30,30
1650523973445,MATH 20D,A02,083766,Staff,7,0,30,23
1650523973445,MATH 20D,A03,083767,Staff,25,0,30,5
1650523979467,MATH 20E,A01,083771,Staff,6,0,30,24
1650523979467,MATH 20E,A02,083772,Staff,18,0,30,12
1650523979467,MATH 20E,B01,083773,Staff,0,0,30,30
1650523979467,MATH 20E,B02,083774,Staff,10,0,30,20
1650523985501,MATH 103A,A01,083777,Staff,0,14,30,30
1650523985501,MATH 103A,A02,083778,Staff,0,14,30,30
1650523985501,MATH 103A,B01,083779,Staff,0,13,30,30
1650523985501,MATH 103A,B02,083780,Staff,0,13,30,30
1650523991525,MATH 105,A01,085443,Staff,0,21,30,30
1650523997549,MATH 109,A01,083213,Anzaldo; Leesa B,0,8,30,30
1650523997549,MATH 109,A02,083214,Anzaldo; Leesa B,0,7,30,30
1650523997549,MATH 109,B01,083215,Anzaldo; Leesa B,0,5,30,30
1650523997549,MATH 109,B02,083216,Anzaldo; Leesa B,0,6,30,30
1650524003573,MATH 142A,A01,083219,Chow; Bennett,0,16,30,30
1650524003573,MATH 142A,A02,083220,Chow; Bennett,0,14,30,30
1650524003573,MATH 142A,B01,083221,Chow; Bennett,0,13,30,30
1650524003573,MATH 142A,B02,083222,Chow; Bennett,0,13,30,30
1650524009627,MATH 193A,A01,083224,Staff,0,6,30,30
1650524009627,MATH 193A,A02,083225,Staff,0,5,30,30
1650524009627,MATH 193A,A03,083781,Staff,0,5,30,30
1650524009627,MATH 193A,A04,083782,Staff,0,7,30,30
1650524015653,MATH 197,001,091859,McAuley; Julian John,9998,0,9999,1
1650524021705,COGS 9,A01,083615,Staff,0,16,60,60
1650524027728,COGS 11,A01,083617,Boyle; Mary E. T.,19,0,40,21
1650524033752,COGS 13,A01,083071,Staff,0,35,40,40
1650524039781,COGS 14A,A01,092681,Staff,0,25,100,100
1650524045806,COGS 14B,A01,083073,Cheng; Tzu-Han,0,12,50,50
1650524051832,COGS 17,A01,092677,Staff,20,0,75,55
1650524057855,COGS 100,A01,083619,Staff,0,26,60,60
1650524063879,COGS 101A,A01,083621,Davis; Joshua Daniel,0,26,60,60
1650524069901,COGS 101B,A01,091572,Staff,1,5,60,59
1650524075927,COGS 101C,A01,083625,Delgado; Tania,15,0,30,15
1650524081949,COGS 107A,A01,083627,Boyle; Mary E. T.,0,11,60,60
1650524087973,COGS 118A,A01,083075,Staff,0,3,60,60
1650524094000,CSE 3,A50,083646,Miranda; Gregory Joseph,20,0,38,18
1650524094000,CSE 3,A51,083647,Miranda; Gregory Joseph,36,0,37,1
1650524100031,CSE 8A,A50,083650,Miranda; Gregory Joseph,0,29,40,40
1650524106057,CSE 11,A01,083080,Cao; Yingjun,0,94,40,40
1650524112086,CSE 12,A01,083652,Staff,0,17,100,100
1650524118111,CSE 15L,A01,083654,Staff,0,1,50,50
1650524118111,CSE 15L,A02,083655,Staff,0,0,50,50
1650524124138,CSE 20,A01,083657,Staff,51,0,80,29
1650524130161,CSE 30,A01,083084,Eldon; John,0,77,40,40
1650524136184,CSE 100,A01,083659,Cao; Yingjun,0,66,50,50
1650524142207,CSE 134B,A01,083661,Powell; Thomas Allan,0,34,65,65
1650524148231,CSE 140,A01,083663,Staff,0,5,75,75
1650524154254,CSE 140L,A01,083088,Eldon; John,0,11,75,75
1650524160281,CSE 175,A01,083665,Kumar; Rakesh,7,0,25,18
1650524166304,CSE 190,A00,092507,Dubnov; Shlomo,10,0,20,10
1650524172330,ECE 45,A01,083139,Staff,1,0,60,59
1650524178357,ECE 65,A50,083695,Staff,0,6,30,30
1650524184382,ECE 109,A01,091882,Touri; Behrouz,35,0,70,35
1650524190409,ECE 180,A00,083140,Abi Samra; Nicholas Camill,21,0,30,9
1650524190409,ECE 180,B00,083141,Abi Samra; Nicholas Camill,0,0,30,30
1650524196440,MATH 10A,A01,083735,Patchell; Gregory David,5,0,30,25
1650524196440,MATH 10A,A02,083736,Patchell; Gregory David,27,0,30,3
1650524196440,MATH 10A,A03,083737,Patchell; Gregory David,24,0,30,6
1650524202463,MATH 10B,A01,083207,Staff,0,9,30,30
1650524202463,MATH 10B,A02,083208,Staff,0,7,30,30
1650524202463,MATH 10B,B01,083739,Staff,13,0,30,17
1650524202463,MATH 10B,B02,083740,Staff,28,0,30,2
1650524208487,MATH 18,A01,083743,Staff,1,0,30,29
1650524208487,MATH 18,A02,083744,Staff,27,0,30,3
1650524208487,MATH 18,A03,083745,Staff,22,0,30,8
1650524208487,MATH 18,A04,083746,Staff,26,0,30,4
1650524208487,MATH 18,B01,083748,Staff,0,12,30,30
1650524208487,MATH 18,B02,083749,Staff,0,12,30,30
1650524208487,MATH 18,B03,083750,Staff,0,11,30,30
1650524208487,MATH 18,B04,083751,Staff,0,12,30,30
1650524214515,MATH 20A,A01,083754,Staff,22,0,40,18
1650524220550,MATH 20B,A01,083756,Staff,0,11,30,30
1650524220550,MATH 20B,A02,083757,Staff,0,12,30,30
1650524226580,MATH 20C,A01,083760,Staff,0,16,30,30
1650524226580,MATH 20C,A02,083761,Staff,2,14,30,28
1650524226580,MATH 20C,B01,083762,Staff,12,0,30,18
1650524226580,MATH 20C,B02,083763,Staff,28,0,30,2
1650524232602,MATH 20D,A01,083765,Staff,0,1,30,30
1650524232602,MATH 20D,A02,083766,Staff,7,0,30,23
1650524232602,MATH 20D,A03,083767,Staff,25,0,30,5
1650524238629,MATH 20E,A01,083771,Staff,6,0,30,24
1650524238629,MATH 20E,A02,083772,Staff,18,0,30,12
1650524238629,MATH 20E,B01,083773,Staff,0,0,30,30
1650524238629,MATH 20E,B02,083774,Staff,10,0,30,20
1650524244653,MATH 103A,A01,083777,Staff,0,14,30,30
1650524244653,MATH 103A,A02,083778,Staff,0,14,30,30
1650524244653,MATH 103A,B01,083779,Staff,0,13,30,30
1650524244653,MATH 103A,B02,083780,Staff,0,13,30,30
1650524250675,MATH 105,A01,085443,Staff,0,21,30,30
1650524256706,MATH 109,A01,083213,Anzaldo; Leesa B,0,8,30,30
1650524256706,MATH 109,A02,083214,Anzaldo; Leesa B,0,7,30,30
1650524256706,MATH 109,B01,083215,Anzaldo; Leesa B,0,5,30,30
1650524256706,MATH 109,B02,083216,Anzaldo; Leesa B,0,6,30,30
1650524262734,MATH 142A,A01,083219,Chow; Bennett,0,16,30,30
1650524262734,MATH 142A,A02,083220,Chow; Bennett,0,14,30,30
1650524262734,MATH 142A,B01,083221,Chow; Bennett,0,13,30,30
1650524262734,MATH 142A,B02,083222,Chow; Bennett,0,13,30,30
1650524268757,MATH 193A,A01,083224,Staff,0,6,30,30
1650524268757,MATH 193A,A02,083225,Staff,0,5,30,30
1650524268757,MATH 193A,A03,083781,Staff,0,5,30,30
1650524268757,MATH 193A,A04,083782,Staff,0,7,30,30
1650524274783,MATH 197,001,091859,McAuley; Julian John,9998,0,9999,1
1650524280836,COGS 9,A01,083615,Staff,0,16,60,60
1650524286860,COGS 11,A01,083617,Boyle; Mary E. T.,19,0,40,21
1650524292884,COGS 13,A01,083071,Staff,0,35,40,40
1650524298911,COGS 14A,A01,092681,Staff,0,25,100,100
1650524304935,COGS 14B,A01,083073,Cheng; Tzu-Han,0,12,50,50
1650524310965,COGS 17,A01,092677,Staff,20,0,75,55
1650524316992,COGS 100,A01,083619,Staff,0,26,60,60
1650524323024,COGS 101A,A01,083621,Davis; Joshua Daniel,0,26,60,60
1650524329051,COGS 101B,A01,091572,Staff,1,5,60,59
1650524335077,COGS 101C,A01,083625,Delgado; Tania,15,0,30,15
1650524341105,COGS 107A,A01,083627,Boyle; Mary E. T.,0,11,60,60
1650524347131,COGS 118A,A01,083075,Staff,0,3,60,60
1650524353160,CSE 3,A50,083646,Miranda; Gregory Joseph,20,0,38,18
1650524353160,CSE 3,A51,083647,Miranda; Gregory Joseph,36,0,37,1
1650524359187,CSE 8A,A50,083650,Miranda; Gregory Joseph,0,29,40,40
1650524365214,CSE 11,A01,083080,Cao; Yingjun,0,94,40,40
1650524371237,CSE 12,A01,083652,Staff,0,17,100,100
1650524377265,CSE 15L,A01,083654,Staff,0,1,50,50
1650524377265,CSE 15L,A02,083655,Staff,0,0,50,50
1650524383288,CSE 20,A01,083657,Staff,51,0,80,29
1650524389314,CSE 30,A01,083084,Eldon; John,0,77,40,40
1650524395338,CSE 100,A01,083659,Cao; Yingjun,0,66,50,50
1650524401361,CSE 134B,A01,083661,Powell; Thomas Allan,0,34,65,65
1650524407391,CSE 140,A01,083663,Staff,0,5,75,75
1650524413418,CSE 140L,A01,083088,Eldon; John,0,11,75,75
1650524419444,CSE 175,A01,083665,Kumar; Rakesh,7,0,25,18
1650524425474,CSE 190,A00,092507,Dubnov; Shlomo,10,0,20,10
1650524431498,ECE 45,A01,083139,Staff,1,0,60,59
1650524437521,ECE 65,A50,083695,Staff,0,6,30,30
1650524443548,ECE 109,A01,091882,Touri; Behrouz,35,0,70,35
1650524449580,ECE 180,A00,083140,Abi Samra; Nicholas Camill,21,0,30,9
1650524449580,ECE 180,B00,083141,Abi Samra; Nicholas Camill,0,0,30,30
1650524455611,MATH 10A,A01,083735,Patchell; Gregory David,5,0,30,25
1650524455611,MATH 10A,A02,083736,Patchell; Gregory David,27,0,30,3
1650524455611,MATH 10A,A03,083737,Patchell; Gregory David,24,0,30,6
1650524461634,MATH 10B,A01,083207,Staff,0,9,30,30
1650524461634,MATH 10B,A02,083208,Staff,0,7,30,30
1650524461634,MATH 10B,B01,083739,Staff,13,0,30,17
1650524461634,MATH 10B,B02,083740,Staff,28,0,30,2
1650524467662,MATH 18,A01,083743,Staff,1,0,30,29
1650524467662,MATH 18,A02,083744,Staff,27,0,30,3
1650524467662,MATH 18,A03,083745,Staff,22,0,30,8
1650524467662,MATH 18,A04,083746,Staff,26,0,30,4
1650524467662,MATH 18,B01,083748,Staff,0,12,30,30
1650524467662,MATH 18,B02,083749,Staff,0,12,30,30
1650524467662,MATH 18,B03,083750,Staff,0,11,30,30
1650524467662,MATH 18,B04,083751,Staff,0,12,30,30
1650524473687,MATH 20A,A01,083754,Staff,22,0,40,18
1650524479718,MATH 20B,A01,083756,Staff,0,11,30,30
1650524479718,MATH 20B,A02,083757,Staff,0,12,30,30
1650524485744,MATH 20C,A01,083760,Staff,0,16,30,30
1650524485744,MATH 20C,A02,083761,Staff,2,14,30,28
1650524485744,MATH 20C,B01,083762,Staff,12,0,30,18
1650524485744,MATH 20C,B02,083763,Staff,28,0,30,2
1650524491773,MATH 20D,A01,083765,Staff,0,1,30,30
1650524491773,MATH 20D,A02,083766,Staff,7,0,30,23
1650524491773,MATH 20D,A03,083767,Staff,25,0,30,5
1650524497803,MATH 20E,A01,083771,Staff,6,0,30,24
1650524497803,MATH 20E,A02,083772,Staff,18,0,30,12
1650524497803,MATH 20E,B01,083773,Staff,0,0,30,30
1650524497803,MATH 20E,B02,083774,Staff,10,0,30,20
1650524503840,MATH 103A,A01,083777,Staff,0,14,30,30
1650524503840,MATH 103A,A02,083778,Staff,0,14,30,30
1650524503840,MATH 103A,B01,083779,Staff,0,13,30,30
1650524503840,MATH 103A,B02,083780,Staff,0,13,30,30
1650524509870,MATH 105,A01,085443,Staff,0,21,30,30
1650524515904,MATH 109,A01,083213,Anzaldo; Leesa B,0,8,30,30
1650524515904,MATH 109,A02,083214,Anzaldo; Leesa B,0,7,30,30
1650524515904,MATH 109,B01,083215,Anzaldo; Leesa B,0,5,30,30
1650524515904,MATH 109,B02,083216,Anzaldo; Leesa B,0,6,30,30
1650524521937,MATH 142A,A01,083219,Chow; Bennett,0,16,30,30
1650524521937,MATH 142A,A02,083220,Chow; Bennett,0,14,30,30
1650524521937,MATH 142A,B01,083221,Chow; Bennett,0,13,30,30
1650524521937,MATH 142A,B02,083222,Chow; Bennett,0,13,30,30
1650524527967,MATH 193A,A01,083224,Staff,0,6,30,30
1650524527967,MATH 193A,A02,083225,Staff,0,5,30,30
1650524527967,MATH 193A,A03,083781,Staff,0,5,30,30
1650524527967,MATH 193A,A04,083782,Staff,0,7,30,30
1650524533996,MATH 197,001,091859,McAuley; Julian John,9998,0,9999,1
1650524540054,COGS 9,A01,083615,Staff,0,16,60,60
1650524546083,COGS 11,A01,083617,Boyle; Mary E. T.,19,0,40,21
1650524552109,COGS 13,A01,083071,Staff,0,35,40,40
1650524558216,COGS 14A,A01,092681,Staff,0,25,100,100
1650524564245,COGS 14B,A01,083073,Cheng; Tzu-Han,0,12,50,50
1650524570277,COGS 17,A01,092677,Staff,20,0,75,55
1650524576323,COGS 100,A01,083619,Staff,0,26,60,60
1650524582346,COGS 101A,A01,083621,Davis; Joshua Daniel,0,26,60,60
1650524588373,COGS 101B,A01,091572,Staff,1,5,60,59
1650524594406,COGS 101C,A01,083625,Delgado; Tania,15,0,30,15
1650524600429,COGS 107A,A01,083627,Boyle; Mary E. T.,0,11,60,60
1650524606455,COGS 118A,A01,083075,Staff,0,3,60,60
1650524612485,CSE 3,A50,083646,Miranda; Gregory Joseph,20,0,38,18
1650524612485,CSE 3,A51,083647,Miranda; Gregory Joseph,36,0,37,1
1650524618509,CSE 8A,A50,083650,Miranda; Gregory Joseph,0,29,40,40
1650524624533,CSE 11,A01,083080,Cao; Yingjun,0,94,40,40
1650524630557,CSE 12,A01,083652,Staff,0,17,100,100
1650524636581,CSE 15L,A01,083654,Staff,0,1,50,50
1650524636581,CSE 15L,A02,083655,Staff,0,0,50,50
1650524642606,CSE 20,A01,083657,Staff,51,0,80,29
1650524648631,CSE 30,A01,083084,Eldon; John,0,77,40,40
1650524654661,CSE 100,A01,083659,Cao; Yingjun,0,66,50,50
1650524660691,CSE 134B,A01,083661,Powell; Thomas Allan,0,34,65,65
1650524666721,CSE 140,A01,083663,Staff,0,5,75,75
1650524672745,CSE 140L,A01,083088,Eldon; John,0,11,75,75
1650524678773,CSE 175,A01,083665,Kumar; Rakesh,7,0,25,18
1650524684795,CSE 190,A00,092507,Dubnov; Shlomo,10,0,20,10
1650524690823,ECE 45,A01,083139,Staff,1,0,60,59
1650524696847,ECE 65,A50,083695,Staff,0,6,30,30
1650524702873,ECE 109,A01,091882,Touri; Behrouz,34,0,70,36
1650524708897,ECE 180,A00,083140,Abi Samra; Nicholas Camill,21,0,30,9
1650524708897,ECE 180,B00,083141,Abi Samra; Nicholas Camill,0,0,30,30
1650524714926,MATH 10A,A01,083735,Patchell; Gregory David,5,0,30,25
1650524714926,MATH 10A,A02,083736,Patchell; Gregory David,27,0,30,3
1650524714926,MATH 10A,A03,083737,Patchell; Gregory David,24,0,30,6
1650524720953,MATH 10B,A01,083207,Staff,0,9,30,30
1650524720953,MATH 10B,A02,083208,Staff,0,7,30,30
1650524720953,MATH 10B,B01,083739,Staff,13,0,30,17
1650524720953,MATH 10B,B02,083740,Staff,28,0,30,2
1650524726981,MATH 18,A01,083743,Staff,1,0,30,29
1650524726981,MATH 18,A02,083744,Staff,27,0,30,3
1650524726981,MATH 18,A03,083745,Staff,22,0,30,8
1650524726981,MATH 18,A04,083746,Staff,26,0,30,4
1650524726981,MATH 18,B01,083748,Staff,0,12,30,30
1650524726981,MATH 18,B02,083749,Staff,0,12,30,30
1650524726981,MATH 18,B03,083750,Staff,0,11,30,30
1650524726981,MATH 18,B04,083751,Staff,0,12,30,30
1650524733010,MATH 20A,A01,083754,Staff,22,0,40,18
1650524739039,MATH 20B,A01,083756,Staff,0,11,30,30
1650524739039,MATH 20B,A02,083757,Staff,0,12,30,30
1650524745065,MATH 20C,A01,083760,Staff,0,16,30,30
1650524745065,MATH 20C,A02,083761,Staff,2,14,30,28
1650524745065,MATH 20C,B01,083762,Staff,12,0,30,18
1650524745065,MATH 20C,B02,083763,Staff,28,0,30,2
1650524751093,MATH 20D,A01,083765,Staff,0,1,30,30
1650524751093,MATH 20D,A02,083766,Staff,7,0,30,23
1650524751093,MATH 20D,A03,083767,Staff,25,0,30,5
1650524757119,MATH 20E,A01,083771,Staff,6,0,30,24
1650524757119,MATH 20E,A02,083772,Staff,18,0,30,12
1650524757119,MATH 20E,B01,083773,Staff,0,0,30,30
1650524757119,MATH 20E,B02,083774,Staff,10,0,30,20
1650524763145,MATH 103A,A01,083777,Staff,0,14,30,30
1650524763145,MATH 103A,A02,083778,Staff,0,14,30,30
1650524763145,MATH 103A,B01,083779,Staff,0,13,30,30
1650524763145,MATH 103A,B02,083780,Staff,0,13,30,30
1650524769176,MATH 105,A01,085443,Staff,0,21,30,30
1650524775203,MATH 109,A01,083213,Anzaldo; Leesa B,0,8,30,30
1650524775203,MATH 109,A02,083214,Anzaldo; Leesa B,0,7,30,30
1650524775203,MATH 109,B01,083215,Anzaldo; Leesa B,0,5,30,30
1650524775203,MATH 109,B02,083216,Anzaldo; Leesa B,0,6,30,30
1650524781229,MATH 142A,A01,083219,Chow; Bennett,0,16,30,30
1650524781229,MATH 142A,A02,083220,Chow; Bennett,0,14,30,30
1650524781229,MATH 142A,B01,083221,Chow; Bennett,0,13,30,30
1650524781229,MATH 142A,B02,083222,Chow; Bennett,0,13,30,30
1650524787255,MATH 193A,A01,083224,Staff,0,6,30,30
1650524787255,MATH 193A,A02,083225,Staff,0,5,30,30
1650524787255,MATH 193A,A03,083781,Staff,0,5,30,30
1650524787255,MATH 193A,A04,083782,Staff,0,7,30,30
1650524793296,MATH 197,001,091859,McAuley; Julian John,9998,0,9999,1
1650524799373,COGS 9,A01,083615,Staff,0,16,60,60
1650524805402,COGS 11,A01,083617,Boyle; Mary E. T.,19,0,40,21
1650524811430,COGS 13,A01,083071,Staff,0,35,40,40
1650524817461,COGS 14A,A01,092681,Staff,0,25,100,100
1650524823492,COGS 14B,A01,083073,Cheng; Tzu-Han,0,12,50,50
1650524829516,COGS 17,A01,092677,Staff,20,0,75,55
1650524835541,COGS 100,A01,083619,Staff,0,26,60,60
1650524841572,COGS 101A,A01,083621,Davis; Joshua Daniel,0,26,60,60
1650524847603,COGS 101B,A01,091572,Staff,1,5,60,59
1650524853632,COGS 101C,A01,083625,Delgado; Tania,15,0,30,15
1650524859657,COGS 107A,A01,083627,Boyle; Mary E. T.,0,11,60,60
1650524865685,COGS 118A,A01,083075,Staff,0,3,60,60
1650524871710,CSE 3,A50,083646,Miranda; Gregory Joseph,20,0,38,18
1650524871710,CSE 3,A51,083647,Miranda; Gregory Joseph,36,0,37,1
1650524877738,CSE 8A,A50,083650,Miranda; Gregory Joseph,0,29,40,40
1650524883768,CSE 11,A01,083080,Cao; Yingjun,0,94,40,40
1650524889791,CSE 12,A01,083652,Staff,0,17,100,100
1650524895818,CSE 15L,A01,083654,Staff,0,1,50,50
1650524895818,CSE 15L,A02,083655,Staff,0,0,50,50
1650524901844,CSE 20,A01,083657,Staff,51,0,80,29
1650524907869,CSE 30,A01,083084,Eldon; John,0,77,40,40
1650524913895,CSE 100,A01,083659,Cao; Yingjun,0,66,50,50
1650524919932,CSE 134B,A01,083661,Powell; Thomas Allan,0,34,65,65
1650524925960,CSE 140,A01,083663,Staff,0,5,75,75
1650524931991,CSE 140L,A01,083088,Eldon; John,0,11,75,75
1650524938019,CSE 175,A01,083665,Kumar; Rakesh,7,0,25,18
1650524944048,CSE 190,A00,092507,Dubnov; Shlomo,10,0,20,10
1650524950080,ECE 45,A01,083139,Staff,0,0,60,60
1650524956115,ECE 65,A50,083695,Staff,0,6,30,30
1650524962149,ECE 109,A01,091882,Touri; Behrouz,34,0,70,36
1650524968175,ECE 180,A00,083140,Abi Samra; Nicholas Camill,21,0,30,9
1650524968175,ECE 180,B00,083141,Abi Samra; Nicholas Camill,0,0,30,30
1650524974200,MATH 10A,A01,083735,Patchell; Gregory David,5,0,30,25
1650524974200,MATH 10A,A02,083736,Patchell; Gregory David,27,0,30,3
1650524974200,MATH 10A,A03,083737,Patchell; Gregory David,24,0,30,6
1650524980228,MATH 10B,A01,083207,Staff,0,9,30,30
1650524980228,MATH 10B,A02,083208,Staff,0,7,30,30
1650524980228,MATH 10B,B01,083739,Staff,13,0,30,17
1650524980228,MATH 10B,B02,083740,Staff,28,0,30,2
1650524986252,MATH 18,A01,083743,Staff,1,0,30,29
1650524986252,MATH 18,A02,083744,Staff,27,0,30,3
1650524986252,MATH 18,A03,083745,Staff,22,0,30,8
1650524986252,MATH 18,A04,083746,Staff,26,0,30,4
1650524986252,MATH 18,B01,083748,Staff,0,12,30,30
1650524986252,MATH 18,B02,083749,Staff,0,12,30,30
1650524986252,MATH 18,B03,083750,Staff,0,11,30,30
1650524986252,MATH 18,B04,083751,Staff,0,12,30,30
1650524992278,MATH 20A,A01,083754,Staff,22,0,40,18
1650524998306,MATH 20B,A01,083756,Staff,0,11,30,30
1650524998306,MATH 20B,A02,083757,Staff,0,12,30,30
1650525004331,MATH 20C,A01,083760,Staff,0,16,30,30
1650525004331,MATH 20C,A02,083761,Staff,2,14,30,28
1650525004331,MATH 20C,B01,083762,Staff,12,0,30,18
1650525004331,MATH 20C,B02,083763,Staff,28,0,30,2
1650525010357,MATH 20D,A01,083765,Staff,0,1,30,30
1650525010357,MATH 20D,A02,083766,Staff,7,0,30,23
1650525010357,MATH 20D,A03,083767,Staff,25,0,30,5
1650525016386,MATH 20E,A01,083771,Staff,6,0,30,24
1650525016386,MATH 20E,A02,083772,Staff,18,0,30,12
1650525016386,MATH 20E,B01,083773,Staff,0,0,30,30
1650525016386,MATH 20E,B02,083774,Staff,10,0,30,20
1650525022417,MATH 103A,A01,083777,Staff,0,14,30,30
1650525022417,MATH 103A,A02,083778,Staff,0,14,30,30
1650525022417,MATH 103A,B01,083779,Staff,0,13,30,30
1650525022417,MATH 103A,B02,083780,Staff,0,13,30,30
1650525028444,MATH 105,A01,085443,Staff,0,21,30,30
1650525034481,MATH 109,A01,083213,Anzaldo; Leesa B,0,8,30,30
1650525034481,MATH 109,A02,083214,Anzaldo; Leesa B,0,7,30,30
1650525034481,MATH 109,B01,083215,Anzaldo; Leesa B,0,5,30,30
1650525034481,MATH 109,B02,083216,Anzaldo; Leesa B,0,6,30,30
1650525040507,MATH 142A,A01,083219,Chow; Bennett,0,16,30,30
1650525040507,MATH 142A,A02,083220,Chow; Bennett,0,14,30,30
1650525040507,MATH 142A,B01,083221,Chow; Bennett,0,13,30,30
1650525040507,MATH 142A,B02,083222,Chow; Bennett,0,13,30,30
1650525046537,MATH 193A,A01,083224,Staff,0,6,30,30
1650525046537,MATH 193A,A02,083225,Staff,0,5,30,30
1650525046537,MATH 193A,A03,083781,Staff,0,5,30,30
1650525046537,MATH 193A,A04,083782,Staff,0,7,30,30
1650525052569,MATH 197,001,091859,McAuley; Julian John,9998,0,9999,1
1650525058620,COGS 9,A01,083615,Staff,0,16,60,60
1650525064649,COGS 11,A01,083617,Boyle; Mary E. T.,19,0,40,21
1650525070685,COGS 13,A01,083071,Staff,0,35,40,40
1650525076714,COGS 14A,A01,092681,Staff,0,25,100,100
1650525082739,COGS 14B,A01,083073,Cheng; Tzu-Han,0,12,50,50
1650525088767,COGS 17,A01,092677,Staff,19,0,75,56
1650525094798,COGS 100,A01,083619,Staff,0,26,60,60
1650525100829,COGS 101A,A01,083621,Davis; Joshua Daniel,0,26,60,60
1650525106856,COGS 101B,A01,091572,Staff,1,5,60,59
1650525112913,COGS 101C,A01,083625,Delgado; Tania,15,0,30,15
1650525118960,COGS 107A,A01,083627,Boyle; Mary E. T.,0,11,60,60
1650525124994,COGS 118A,A01,083075,Staff,0,3,60,60
1650525131035,CSE 3,A50,083646,Miranda; Gregory Joseph,20,0,38,18
1650525131035,CSE 3,A51,083647,Miranda; Gregory Joseph,36,0,37,1
1650525137060,CSE 8A,A50,083650,Miranda; Gregory Joseph,0,29,40,40
1650525143096,CSE 11,A01,083080,Cao; Yingjun,0,94,40,40
1650525149120,CSE 12,A01,083652,Staff,0,17,100,100
1650525155228,CSE 15L,A01,083654,Staff,0,1,50,50
1650525155228,CSE 15L,A02,083655,Staff,0,0,50,50
1650525161253,CSE 20,A01,083657,Staff,51,0,80,29
1650525167283,CSE 30,A01,083084,Eldon; John,0,77,40,40
1650525173308,CSE 100,A01,083659,Cao; Yingjun,0,66,50,50
1650525179332,CSE 134B,A01,083661,Powell; Thomas Allan,0,34,65,65
1650525185370,CSE 140,A01,083663,Staff,0,5,75,75
1650525191395,CSE 140L,A01,083088,Eldon; John,0,11,75,75
1650525197427,CSE 175,A01,083665,Kumar; Rakesh,7,0,25,18
1650525203452,CSE 190,A00,092507,Dubnov; Shlomo,10,0,20,10
1650525209488,ECE 45,A01,083139,Staff,0,0,60,60
1650525215517,ECE 65,A50,083695,Staff,0,6,30,30
1650525221553,ECE 109,A01,091882,Touri; Behrouz,34,0,70,36
1650525227577,ECE 180,A00,083140,Abi Samra; Nicholas Camill,21,0,30,9
1650525227577,ECE 180,B00,083141,Abi Samra; Nicholas Camill,0,0,30,30
1650525233602,MATH 10A,A01,083735,Patchell; Gregory David,5,0,30,25
1650525233602,MATH 10A,A02,083736,Patchell; Gregory David,27,0,30,3
1650525233602,MATH 10A,A03,083737,Patchell; Gregory David,24,0,30,6
1650525239633,MATH 10B,A01,083207,Staff,0,9,30,30
1650525239633,MATH 10B,A02,083208,Staff,0,7,30,30
1650525239633,MATH 10B,B01,083739,Staff,13,0,30,17
1650525239633,MATH 10B,B02,083740,Staff,28,0,30,2
1650525245657,MATH 18,A01,083743,Staff,1,0,30,29
1650525245657,MATH 18,A02,083744,Staff,27,0,30,3
1650525245657,MATH 18,A03,083745,Staff,22,0,30,8
1650525245657,MATH 18,A04,083746,Staff,26,0,30,4
1650525245657,MATH 18,B01,083748,Staff,0,12,30,30
1650525245657,MATH 18,B02,083749,Staff,0,12,30,30
1650525245657,MATH 18,B03,083750,Staff,0,11,30,30
1650525245657,MATH 18,B04,083751,Staff,0,12,30,30
1650525251694,MATH 20A,A01,083754,Staff,22,0,40,18
1650525257725,MATH 20B,A01,083756,Staff,0,11,30,30
1650525257725,MATH 20B,A02,083757,Staff,0,12,30,30
1650525263751,MATH 20C,A01,083760,Staff,0,16,30,30
1650525263751,MATH 20C,A02,083761,Staff,2,14,30,28
1650525263751,MATH 20C,B01,083762,Staff,12,0,30,18
1650525263751,MATH 20C,B02,083763,Staff,28,0,30,2
1650525269775,MATH 20D,A01,083765,Staff,0,1,30,30
1650525269775,MATH 20D,A02,083766,Staff,7,0,30,23
1650525269775,MATH 20D,A03,083767,Staff,25,0,30,5
1650525275801,MATH 20E,A01,083771,Staff,6,0,30,24
1650525275801,MATH 20E,A02,083772,Staff,18,0,30,12
1650525275801,MATH 20E,B01,083773,Staff,0,0,30,30
1650525275801,MATH 20E,B02,083774,Staff,10,0,30,20
1650525281833,MATH 103A,A01,083777,Staff,0,14,30,30
1650525281833,MATH 103A,A02,083778,Staff,0,14,30,30
1650525281833,MATH 103A,B01,083779,Staff,0,13,30,30
1650525281833,MATH 103A,B02,083780,Staff,0,13,30,30
1650525287864,MATH 105,A01,085443,Staff,0,21,30,30
1650525293896,MATH 109,A01,083213,Anzaldo; Leesa B,0,8,30,30
1650525293896,MATH 109,A02,083214,Anzaldo; Leesa B,0,7,30,30
1650525293896,MATH 109,B01,083215,Anzaldo; Leesa B,0,5,30,30
1650525293896,MATH 109,B02,083216,Anzaldo; Leesa B,0,6,30,30
1650525299928,MATH 142A,A01,083219,Chow; Bennett,0,16,30,30
1650525299928,MATH 142A,A02,083220,Chow; Bennett,0,14,30,30
1650525299928,MATH 142A,B01,083221,Chow; Bennett,0,13,30,30
1650525299928,MATH 142A,B02,083222,Chow; Bennett,0,13,30,30
1650525305954,MATH 193A,A01,083224,Staff,0,6,30,30
1650525305954,MATH 193A,A02,083225,Staff,0,5,30,30
1650525305954,MATH 193A,A03,083781,Staff,0,5,30,30
1650525305954,MATH 193A,A04,083782,Staff,0,7,30,30
1650525311978,MATH 197,001,091859,McAuley; Julian John,9998,0,9999,1
1650525318049,COGS 9,A01,083615,Staff,0,16,60,60
1650525324073,COGS 11,A01,083617,Boyle; Mary E. T.,19,0,40,21
1650525330101,COGS 13,A01,083071,Staff,0,35,40,40
1650525336127,COGS 14A,A01,092681,Staff,0,25,100,100
1650525342158,COGS 14B,A01,083073,Cheng; Tzu-Han,0,12,50,50
1650525348186,COGS 17,A01,092677,Staff,19,0,75,56
1650525354210,COGS 100,A01,083619,Staff,0,26,60,60
1650525360243,COGS 101A,A01,083621,Davis; Joshua Daniel,0,26,60,60
1650525366270,COGS 101B,A01,091572,Staff,1,5,60,59
1650525372299,COGS 101C,A01,083625,Delgado; Tania,15,0,30,15
1650525378326,COGS 107A,A01,083627,Boyle; Mary E. T.,0,11,60,60
1650525384350,COGS 118A,A01,083075,Staff,0,3,60,60
1650525390379,CSE 3,A50,083646,Miranda; Gregory Joseph,20,0,38,18
1650525390379,CSE 3,A51,083647,Miranda; Gregory Joseph,36,0,37,1
1650525396402,CSE 8A,A50,083650,Miranda; Gregory Joseph,0,29,40,40
1650525402430,CSE 11,A01,083080,Cao; Yingjun,0,94,40,40
1650525408454,CSE 12,A01,083652,Staff,0,17,100,100
1650525414479,CSE 15L,A01,083654,Staff,0,1,50,50
1650525414479,CSE 15L,A02,083655,Staff,0,0,50,50
1650525420513,CSE 20,A01,083657,Staff,51,0,80,29
1650525426537,CSE 30,A01,083084,Eldon; John,0,77,40,40
1650525432567,CSE 100,A01,083659,Cao; Yingjun,0,66,50,50
1650525438590,CSE 134B,A01,083661,Powell; Thomas Allan,0,34,65,65
1650525444615,CSE 140,A01,083663,Staff,0,5,75,75
1650525450647,CSE 140L,A01,083088,Eldon; John,0,11,75,75
1650525456676,CSE 175,A01,083665,Kumar; Rakesh,7,0,25,18
1650525462710,CSE 190,A00,092507,Dubnov; Shlomo,10,0,20,10
1650525468737,ECE 45,A01,083139,Staff,0,0,60,60
1650525474762,ECE 65,A50,083695,Staff,0,6,30,30
1650525480790,ECE 109,A01,091882,Touri; Behrouz,34,0,70,36
1650525486820,ECE 180,A00,083140,Abi Samra; Nicholas Camill,21,0,30,9
1650525486820,ECE 180,B00,083141,Abi Samra; Nicholas Camill,0,0,30,30
1650525492844,MATH 10A,A01,083735,Patchell; Gregory David,5,0,30,25
1650525492844,MATH 10A,A02,083736,Patchell; Gregory David,27,0,30,3
1650525492844,MATH 10A,A03,083737,Patchell; Gregory David,24,0,30,6
1650525498869,MATH 10B,A01,083207,Staff,0,9,30,30
1650525498869,MATH 10B,A02,083208,Staff,0,7,30,30
1650525498869,MATH 10B,B01,083739,Staff,13,0,30,17
1650525498869,MATH 10B,B02,083740,Staff,28,0,30,2
1650525504894,MATH 18,A01,083743,Staff,1,0,30,29
1650525504894,MATH 18,A02,083744,Staff,27,0,30,3
1650525504894,MATH 18,A03,083745,Staff,22,0,30,8
1650525504894,MATH 18,A04,083746,Staff,26,0,30,4
1650525504894,MATH 18,B01,083748,Staff,0,12,30,30
1650525504894,MATH 18,B02,083749,Staff,0,12,30,30
1650525504894,MATH 18,B03,083750,Staff,0,11,30,30
1650525504894,MATH 18,B04,083751,Staff,0,12,30,30
1650525510917,MATH 20A,A01,083754,Staff,22,0,40,18
1650525516947,MATH 20B,A01,083756,Staff,0,11,30,30
1650525516947,MATH 20B,A02,083757,Staff,0,12,30,30
1650525522976,MATH 20C,A01,083760,Staff,0,16,30,30
1650525522976,MATH 20C,A02,083761,Staff,2,14,30,28
1650525522976,MATH 20C,B01,083762,Staff,12,0,30,18
1650525522976,MATH 20C,B02,083763,Staff,28,0,30,2
1650525529001,MATH 20D,A01,083765,Staff,0,1,30,30
1650525529001,MATH 20D,A02,083766,Staff,7,0,30,23
1650525529001,MATH 20D,A03,083767,Staff,25,0,30,5
1650525535036,MATH 20E,A01,083771,Staff,6,0,30,24
1650525535036,MATH 20E,A02,083772,Staff,18,0,30,12
1650525535036,MATH 20E,B01,083773,Staff,0,0,30,30
1650525535036,MATH 20E,B02,083774,Staff,10,0,30,20
1650525541059,MATH 103A,A01,083777,Staff,0,14,30,30
1650525541059,MATH 103A,A02,083778,Staff,0,14,30,30
1650525541059,MATH 103A,B01,083779,Staff,0,13,30,30
1650525541059,MATH 103A,B02,083780,Staff,0,13,30,30
1650525547086,MATH 105,A01,085443,Staff,0,21,30,30
1650525553109,MATH 109,A01,083213,Anzaldo; Leesa B,0,8,30,30
1650525553109,MATH 109,A02,083214,Anzaldo; Leesa B,0,7,30,30
1650525553109,MATH 109,B01,083215,Anzaldo; Leesa B,0,5,30,30
1650525553109,MATH 109,B02,083216,Anzaldo; Leesa B,0,6,30,30
1650525559141,MATH 142A,A01,083219,Chow; Bennett,0,16,30,30
1650525559141,MATH 142A,A02,083220,Chow; Bennett,0,14,30,30
1650525559141,MATH 142A,B01,083221,Chow; Bennett,0,13,30,30
1650525559141,MATH 142A,B02,083222,Chow; Bennett,0,13,30,30
1650525565166,MATH 193A,A01,083224,Staff,0,6,30,30
1650525565166,MATH 193A,A02,083225,Staff,0,5,30,30
1650525565166,MATH 193A,A03,083781,Staff,0,5,30,30
1650525565166,MATH 193A,A04,083782,Staff,0,7,30,30
1650525571192,MATH 197,001,091859,McAuley; Julian John,9998,0,9999,1
1650525577248,COGS 9,A01,083615,Staff,0,16,60,60
1650525583272,COGS 11,A01,083617,Boyle; Mary E. T.,19,0,40,21
1650525589297,COGS 13,A01,083071,Staff,0,35,40,40
1650525595320,COGS 14A,A01,092681,Staff,0,25,100,100
1650525601346,COGS 14B,A01,083073,Cheng; Tzu-Han,0,12,50,50
1650525607374,COGS 17,A01,092677,Staff,19,0,75,56
1650525613398,COGS 100,A01,083619,Staff,0,26,60,60
1650525619438,COGS 101A,A01,083621,Davis; Joshua Daniel,0,26,60,60
1650525625464,COGS 101B,A01,091572,Staff,1,5,60,59
1650525631490,COGS 101C,A01,083625,Delgado; Tania,15,0,30,15
1650525637514,COGS 107A,A01,083627,Boyle; Mary E. T.,0,11,60,60
1650525643544,COGS 118A,A01,083075,Staff,0,3,60,60
1650525649579,CSE 3,A50,083646,Miranda; Gregory Joseph,20,0,38,18
1650525649579,CSE 3,A51,083647,Miranda; Gregory Joseph,36,0,37,1
1650525655608,CSE 8A,A50,083650,Miranda; Gregory Joseph,0,29,40,40
1650525661634,CSE 11,A01,083080,Cao; Yingjun,0,94,40,40
1650525667663,CSE 12,A01,083652,Staff,0,17,100,100
1650525673686,CSE 15L,A01,083654,Staff,0,1,50,50
1650525673686,CSE 15L,A02,083655,Staff,0,0,50,50
1650525679712,CSE 20,A01,083657,Staff,51,0,80,29
1650525685743,CSE 30,A01,083084,Eldon; John,0,77,40,40
1650525691769,CSE 100,A01,083659,Cao; Yingjun,0,66,50,50
1650525697798,CSE 134B,A01,083661,Powell; Thomas Allan,0,34,65,65
1650525703846,CSE 140,A01,083663,Staff,0,5,75,75
1650525709887,CSE 140L,A01,083088,Eldon; John,0,11,75,75
1650525715913,CSE 175,A01,083665,Kumar; Rakesh,7,0,25,18
1650525721939,CSE 190,A00,092507,Dubnov; Shlomo,10,0,20,10
1650525727963,ECE 45,A01,083139,Staff,0,0,60,60
1650525733987,ECE 65,A50,083695,Staff,0,6,30,30
1650525740012,ECE 109,A01,091882,Touri; Behrouz,34,0,70,36
1650525746041,ECE 180,A00,083140,Abi Samra; Nicholas Camill,21,0,30,9
1650525746041,ECE 180,B00,083141,Abi Samra; Nicholas Camill,0,0,30,30
1650525752146,MATH 10A,A01,083735,Patchell; Gregory David,5,0,30,25
1650525752146,MATH 10A,A02,083736,Patchell; Gregory David,27,0,30,3
1650525752146,MATH 10A,A03,083737,Patchell; Gregory David,24,0,30,6
1650525758174,MATH 10B,A01,083207,Staff,0,9,30,30
1650525758174,MATH 10B,A02,083208,Staff,0,7,30,30
1650525758174,MATH 10B,B01,083739,Staff,13,0,30,17
1650525758174,MATH 10B,B02,083740,Staff,28,0,30,2
1650525764200,MATH 18,A01,083743,Staff,1,0,30,29
1650525764200,MATH 18,A02,083744,Staff,27,0,30,3
1650525764200,MATH 18,A03,083745,Staff,22,0,30,8
1650525764200,MATH 18,A04,083746,Staff,26,0,30,4
1650525764200,MATH 18,B01,083748,Staff,0,12,30,30
1650525764200,MATH 18,B02,083749,Staff,0,12,30,30
1650525764200,MATH 18,B03,083750,Staff,0,11,30,30
1650525764200,MATH 18,B04,083751,Staff,0,12,30,30
1650525770229,MATH 20A,A01,083754,Staff,22,0,40,18
1650525776257,MATH 20B,A01,083756,Staff,0,11,30,30
1650525776257,MATH 20B,A02,083757,Staff,0,12,30,30
1650525782287,MATH 20C,A01,083760,Staff,0,16,30,30
1650525782287,MATH 20C,A02,083761,Staff,2,14,30,28
1650525782287,MATH 20C,B01,083762,Staff,12,0,30,18
1650525782287,MATH 20C,B02,083763,Staff,28,0,30,2
1650525788312,MATH 20D,A01,083765,Staff,0,1,30,30
1650525788312,MATH 20D,A02,083766,Staff,7,0,30,23
1650525788312,MATH 20D,A03,083767,Staff,25,0,30,5
1650525794337,MATH 20E,A01,083771,Staff,6,0,30,24
1650525794337,MATH 20E,A02,083772,Staff,18,0,30,12
1650525794337,MATH 20E,B01,083773,Staff,0,0,30,30
1650525794337,MATH 20E,B02,083774,Staff,10,0,30,20
1650525800369,MATH 103A,A01,083777,Staff,0,14,30,30
1650525800369,MATH 103A,A02,083778,Staff,0,14,30,30
1650525800369,MATH 103A,B01,083779,Staff,0,13,30,30
1650525800369,MATH 103A,B02,083780,Staff,0,13,30,30
1650525806397,MATH 105,A01,085443,Staff,0,21,30,30
1650525812437,MATH 109,A01,083213,Anzaldo; Leesa B,0,8,30,30
1650525812437,MATH 109,A02,083214,Anzaldo; Leesa B,0,7,30,30
1650525812437,MATH 109,B01,083215,Anzaldo; Leesa B,0,5,30,30
1650525812437,MATH 109,B02,083216,Anzaldo; Leesa B,0,6,30,30
1650525818471,MATH 142A,A01,083219,Chow; Bennett,0,16,30,30
1650525818471,MATH 142A,A02,083220,Chow; Bennett,0,14,30,30
1650525818471,MATH 142A,B01,083221,Chow; Bennett,0,13,30,30
1650525818471,MATH 142A,B02,083222,Chow; Bennett,0,13,30,30
1650525824500,MATH 193A,A01,083224,Staff,0,6,30,30
1650525824500,MATH 193A,A02,083225,Staff,0,5,30,30
1650525824500,MATH 193A,A03,083781,Staff,0,5,30,30
1650525824500,MATH 193A,A04,083782,Staff,0,7,30,30
1650525830525,MATH 197,001,091859,McAuley; Julian John,9998,0,9999,1
1650525836585,COGS 9,A01,083615,Staff,0,16,60,60
1650525842614,COGS 11,A01,083617,Boyle; Mary E. T.,19,0,40,21
1650525848641,COGS 13,A01,083071,Staff,0,35,40,40
1650525854665,COGS 14A,A01,092681,Staff,0,25,100,100
1650525860693,COGS 14B,A01,083073,Cheng; Tzu-Han,0,12,50,50
1650525866721,COGS 17,A01,092677,Staff,19,0,75,56
1650525872750,COGS 100,A01,083619,Staff,0,26,60,60
1650525878776,COGS 101A,A01,083621,Davis; Joshua Daniel,0,26,60,60
1650525884824,COGS 101B,A01,091572,Staff,1,5,60,59
1650525890864,COGS 101C,A01,083625,Delgado; Tania,15,0,30,15
1650525896901,COGS 107A,A01,083627,Boyle; Mary E. T.,0,11,60,60
1650525902927,COGS 118A,A01,083075,Staff,0,3,60,60
1650525908951,CSE 3,A50,083646,Miranda; Gregory Joseph,20,0,38,18
1650525908951,CSE 3,A51,083647,Miranda; Gregory Joseph,36,0,37,1
1650525914981,CSE 8A,A50,083650,Miranda; Gregory Joseph,0,29,40,40
1650525921009,CSE 11,A01,083080,Cao; Yingjun,0,94,40,40
1650525927038,CSE 12,A01,083652,Staff,0,17,100,100
1650525933063,CSE 15L,A01,083654,Staff,0,1,50,50
1650525933063,CSE 15L,A02,083655,Staff,0,0,50,50
1650525939088,CSE 20,A01,083657,Staff,51,0,80,29
1650525945115,CSE 30,A01,083084,Eldon; John,0,77,40,40
1650525951140,CSE 100,A01,083659,Cao; Yingjun,0,66,50,50
1650525957168,CSE 134B,A01,083661,Powell; Thomas Allan,0,34,65,65
1650525963196,CSE 140,A01,083663,Staff,0,5,75,75
1650525969219,CSE 140L,A01,083088,Eldon; John,0,11,75,75
1650525975243,CSE 175,A01,083665,Kumar; Rakesh,7,0,25,18
1650525981273,CSE 190,A00,092507,Dubnov; Shlomo,10,0,20,10
1650525987299,ECE 45,A01,083139,Staff,0,0,60,60
1650525993328,ECE 65,A50,083695,Staff,0,6,30,30
1650525999356,ECE 109,A01,091882,Touri; Behrouz,34,0,70,36
1650526005382,ECE 180,A00,083140,Abi Samra; Nicholas Camill,21,0,30,9
1650526005382,ECE 180,B00,083141,Abi Samra; Nicholas Camill,0,0,30,30
1650526011406,MATH 10A,A01,083735,Patchell; Gregory David,5,0,30,25
1650526011406,MATH 10A,A02,083736,Patchell; Gregory David,27,0,30,3
1650526011406,MATH 10A,A03,083737,Patchell; Gregory David,24,0,30,6
1650526017441,MATH 10B,A01,083207,Staff,0,9,30,30
1650526017441,MATH 10B,A02,083208,Staff,0,7,30,30
1650526017441,MATH 10B,B01,083739,Staff,13,0,30,17
1650526017441,MATH 10B,B02,083740,Staff,28,0,30,2
1650526023472,MATH 18,A01,083743,Staff,1,0,30,29
1650526023472,MATH 18,A02,083744,Staff,27,0,30,3
1650526023472,MATH 18,A03,083745,Staff,22,0,30,8
1650526023472,MATH 18,A04,083746,Staff,26,0,30,4
1650526023472,MATH 18,B01,083748,Staff,0,12,30,30
1650526023472,MATH 18,B02,083749,Staff,0,12,30,30
1650526023472,MATH 18,B03,083750,Staff,0,11,30,30
1650526023472,MATH 18,B04,083751,Staff,0,12,30,30
1650526029497,MATH 20A,A01,083754,Staff,22,0,40,18
1650526035528,MATH 20B,A01,083756,Staff,0,11,30,30
1650526035528,MATH 20B,A02,083757,Staff,0,12,30,30
1650526041556,MATH 20C,A01,083760,Staff,0,16,30,30
1650526041556,MATH 20C,A02,083761,Staff,2,14,30,28
1650526041556,MATH 20C,B01,083762,Staff,12,0,30,18
1650526041556,MATH 20C,B02,083763,Staff,28,0,30,2
1650526047580,MATH 20D,A01,083765,Staff,0,1,30,30
1650526047580,MATH 20D,A02,083766,Staff,7,0,30,23
1650526047580,MATH 20D,A03,083767,Staff,25,0,30,5
1650526053608,MATH 20E,A01,083771,Staff,6,0,30,24
1650526053608,MATH 20E,A02,083772,Staff,18,0,30,12
1650526053608,MATH 20E,B01,083773,Staff,0,0,30,30
1650526053608,MATH 20E,B02,083774,Staff,10,0,30,20
1650526059632,MATH 103A,A01,083777,Staff,0,14,30,30
1650526059632,MATH 103A,A02,083778,Staff,0,14,30,30
1650526059632,MATH 103A,B01,083779,Staff,0,13,30,30
1650526059632,MATH 103A,B02,083780,Staff,0,13,30,30
1650526065655,MATH 105,A01,085443,Staff,0,21,30,30
1650526071695,MATH 109,A01,083213,Anzaldo; Leesa B,0,8,30,30
1650526071695,MATH 109,A02,083214,Anzaldo; Leesa B,0,7,30,30
1650526071695,MATH 109,B01,083215,Anzaldo; Leesa B,0,5,30,30
1650526071695,MATH 109,B02,083216,Anzaldo; Leesa B,0,6,30,30
1650526077721,MATH 142A,A01,083219,Chow; Bennett,0,16,30,30
1650526077721,MATH 142A,A02,083220,Chow; Bennett,0,14,30,30
1650526077721,MATH 142A,B01,083221,Chow; Bennett,0,13,30,30
1650526077721,MATH 142A,B02,083222,Chow; Bennett,0,13,30,30
1650526083746,MATH 193A,A01,083224,Staff,0,6,30,30
1650526083746,MATH 193A,A02,083225,Staff,0,5,30,30
1650526083746,MATH 193A,A03,083781,Staff,0,5,30,30
1650526083746,MATH 193A,A04,083782,Staff,0,7,30,30
1650526089772,MATH 197,001,091859,McAuley; Julian John,9998,0,9999,1
1650526095851,COGS 9,A01,083615,Staff,0,16,60,60
1650526101875,COGS 11,A01,083617,Boyle; Mary E. T.,19,0,40,21
1650526107903,COGS 13,A01,083071,Staff,0,35,40,40
1650526113932,COGS 14A,A01,092681,Staff,0,25,100,100
1650526119959,COGS 14B,A01,083073,Cheng; Tzu-Han,0,12,50,50
1650526125985,COGS 17,A01,092677,Staff,19,0,75,56
1650526132009,COGS 100,A01,083619,Staff,0,26,60,60
1650526138038,COGS 101A,A01,083621,Davis; Joshua Daniel,0,26,60,60
1650526144065,COGS 101B,A01,091572,Staff,1,5,60,59
1650526150089,COGS 101C,A01,083625,Delgado; Tania,15,0,30,15
1650526156117,COGS 107A,A01,083627,Boyle; Mary E. T.,0,11,60,60
1650526162146,COGS 118A,A01,083075,Staff,0,3,60,60
1650526168175,CSE 3,A50,083646,Miranda; Gregory Joseph,20,0,38,18
1650526168175,CSE 3,A51,083647,Miranda; Gregory Joseph,36,0,37,1
1650526174206,CSE 8A,A50,083650,Miranda; Gregory Joseph,0,29,40,40
1650526180229,CSE 11,A01,083080,Cao; Yingjun,0,94,40,40
1650526186253,CSE 12,A01,083652,Staff,0,17,100,100
1650526192278,CSE 15L,A01,083654,Staff,0,1,50,50
1650526192278,CSE 15L,A02,083655,Staff,0,0,50,50
1650526198305,CSE 20,A01,083657,Staff,51,0,80,29
1650526204333,CSE 30,A01,083084,Eldon; John,0,77,40,40
1650526210359,CSE 100,A01,083659,Cao; Yingjun,0,66,50,50
1650526216383,CSE 134B,A01,083661,Powell; Thomas Allan,0,34,65,65
1650526222409,CSE 140,A01,083663,Staff,0,5,75,75
1650526228433,CSE 140L,A01,083088,Eldon; John,0,11,75,75
1650526234458,CSE 175,A01,083665,Kumar; Rakesh,7,0,25,18
1650526240485,CSE 190,A00,092507,Dubnov; Shlomo,10,0,20,10
1650526246515,ECE 45,A01,083139,Staff,0,0,60,60
1650526252540,ECE 65,A50,083695,Staff,0,6,30,30
1650526258564,ECE 109,A01,091882,Touri; Behrouz,34,0,70,36
1650526264594,ECE 180,A00,083140,Abi Samra; Nicholas Camill,21,0,30,9
1650526264594,ECE 180,B00,083141,Abi Samra; Nicholas Camill,0,0,30,30
1650526270621,MATH 10A,A01,083735,Patchell; Gregory David,5,0,30,25
1650526270621,MATH 10A,A02,083736,Patchell; Gregory David,27,0,30,3
1650526270621,MATH 10A,A03,083737,Patchell; Gregory David,24,0,30,6
1650526276650,MATH 10B,A01,083207,Staff,0,9,30,30
1650526276650,MATH 10B,A02,083208,Staff,0,7,30,30
1650526276650,MATH 10B,B01,083739,Staff,13,0,30,17
1650526276650,MATH 10B,B02,083740,Staff,28,0,30,2
1650526282681,MATH 18,A01,083743,Staff,1,0,30,29
1650526282681,MATH 18,A02,083744,Staff,27,0,30,3
1650526282681,MATH 18,A03,083745,Staff,22,0,30,8
1650526282681,MATH 18,A04,083746,Staff,26,0,30,4
1650526282681,MATH 18,B01,083748,Staff,0,12,30,30
1650526282681,MATH 18,B02,083749,Staff,0,12,30,30
1650526282681,MATH 18,B03,083750,Staff,0,11,30,30
1650526282681,MATH 18,B04,083751,Staff,0,12,30,30
1650526288707,MATH 20A,A01,083754,Staff,22,0,40,18
1650526294735,MATH 20B,A01,083756,Staff,0,11,30,30
1650526294735,MATH 20B,A02,083757,Staff,0,12,30,30
1650526300764,MATH 20C,A01,083760,Staff,0,16,30,30
1650526300764,MATH 20C,A02,083761,Staff,2,14,30,28
1650526300764,MATH 20C,B01,083762,Staff,12,0,30,18
1650526300764,MATH 20C,B02,083763,Staff,28,0,30,2
1650526306792,MATH 20D,A01,083765,Staff,0,1,30,30
1650526306792,MATH 20D,A02,083766,Staff,7,0,30,23
1650526306792,MATH 20D,A03,083767,Staff,25,0,30,5
1650526312818,MATH 20E,A01,083771,Staff,6,0,30,24
1650526312818,MATH 20E,A02,083772,Staff,18,0,30,12
1650526312818,MATH 20E,B01,083773,Staff,0,0,30,30
1650526312818,MATH 20E,B02,083774,Staff,10,0,30,20
1650526318848,MATH 103A,A01,083777,Staff,0,14,30,30
1650526318848,MATH 103A,A02,083778,Staff,0,14,30,30
1650526318848,MATH 103A,B01,083779,Staff,0,13,30,30
1650526318848,MATH 103A,B02,083780,Staff,0,13,30,30
1650526324872,MATH 105,A01,085443,Staff,0,21,30,30
1650526330896,MATH 109,A01,083213,Anzaldo; Leesa B,0,8,30,30
1650526330896,MATH 109,A02,083214,Anzaldo; Leesa B,0,7,30,30
1650526330896,MATH 109,B01,083215,Anzaldo; Leesa B,0,5,30,30
1650526330896,MATH 109,B02,083216,Anzaldo; Leesa B,0,6,30,30
1650526336932,MATH 142A,A01,083219,Chow; Bennett,0,16,30,30
1650526336932,MATH 142A,A02,083220,Chow; Bennett,0,14,30,30
1650526336932,MATH 142A,B01,083221,Chow; Bennett,0,13,30,30
1650526336932,MATH 142A,B02,083222,Chow; Bennett,0,13,30,30
1650526342958,MATH 193A,A01,083224,Staff,0,6,30,30
1650526342958,MATH 193A,A02,083225,Staff,0,5,30,30
1650526342958,MATH 193A,A03,083781,Staff,0,5,30,30
1650526342958,MATH 193A,A04,083782,Staff,0,7,30,30
1650526349054,MATH 197,001,091859,McAuley; Julian John,9998,0,9999,1
1650526355130,COGS 9,A01,083615,Staff,0,16,60,60
1650526361155,COGS 11,A01,083617,Boyle; Mary E. T.,19,0,40,21
1650526367180,COGS 13,A01,083071,Staff,0,35,40,40
1650526373204,COGS 14A,A01,092681,Staff,0,25,100,100
1650526379235,COGS 14B,A01,083073,Cheng; Tzu-Han,0,12,50,50
1650526385262,COGS 17,A01,092677,Staff,19,0,75,56
1650526391294,COGS 100,A01,083619,Staff,0,26,60,60
1650526397320,COGS 101A,A01,083621,Davis; Joshua Daniel,0,26,60,60
1650526403347,COGS 101B,A01,091572,Staff,1,5,60,59
1650526409372,COGS 101C,A01,083625,Delgado; Tania,15,0,30,15
1650526415396,COGS 107A,A01,083627,Boyle; Mary E. T.,0,11,60,60
1650526421424,COGS 118A,A01,083075,Staff,0,3,60,60
1650526427451,CSE 3,A50,083646,Miranda; Gregory Joseph,20,0,38,18
1650526427451,CSE 3,A51,083647,Miranda; Gregory Joseph,36,0,37,1
1650526433481,CSE 8A,A50,083650,Miranda; Gregory Joseph,0,29,40,40
1650526439506,CSE 11,A01,083080,Cao; Yingjun,0,94,40,40
1650526445543,CSE 12,A01,083652,Staff,0,17,100,100
1650526451568,CSE 15L,A01,083654,Staff,0,1,50,50
1650526451568,CSE 15L,A02,083655,Staff,0,0,50,50
1650526457594,CSE 20,A01,083657,Staff,51,0,80,29
1650526463621,CSE 30,A01,083084,Eldon; John,0,77,40,40
1650526469646,CSE 100,A01,083659,Cao; Yingjun,0,66,50,50
1650526475672,CSE 134B,A01,083661,Powell; Thomas Allan,0,34,65,65
1650526481705,CSE 140,A01,083663,Staff,0,5,75,75
1650526487733,CSE 140L,A01,083088,Eldon; John,0,11,75,75
1650526493757,CSE 175,A01,083665,Kumar; Rakesh,7,0,25,18
1650526499783,CSE 190,A00,092507,Dubnov; Shlomo,10,0,20,10
1650526505806,ECE 45,A01,083139,Staff,0,0,60,60
1650526511837,ECE 65,A50,083695,Staff,0,6,30,30
1650526517863,ECE 109,A01,091882,Touri; Behrouz,34,0,70,36
1650526523890,ECE 180,A00,083140,Abi Samra; Nicholas Camill,21,0,30,9
1650526523890,ECE 180,B00,083141,Abi Samra; Nicholas Camill,0,0,30,30
1650526529919,MATH 10A,A01,083735,Patchell; Gregory David,5,0,30,25
1650526529919,MATH 10A,A02,083736,Patchell; Gregory David,27,0,30,3
1650526529919,MATH 10A,A03,083737,Patchell; Gregory David,24,0,30,6
1650526535944,MATH 10B,A01,083207,Staff,0,9,30,30
1650526535944,MATH 10B,A02,083208,Staff,0,7,30,30
1650526535944,MATH 10B,B01,083739,Staff,13,0,30,17
1650526535944,MATH 10B,B02,083740,Staff,28,0,30,2
1650526541982,MATH 18,A01,083743,Staff,1,0,30,29
1650526541982,MATH 18,A02,083744,Staff,27,0,30,3
1650526541982,MATH 18,A03,083745,Staff,22,0,30,8
1650526541982,MATH 18,A04,083746,Staff,26,0,30,4
1650526541982,MATH 18,B01,083748,Staff,0,12,30,30
1650526541982,MATH 18,B02,083749,Staff,0,12,30,30
1650526541982,MATH 18,B03,083750,Staff,0,11,30,30
1650526541982,MATH 18,B04,083751,Staff,0,12,30,30
1650526548014,MATH 20A,A01,083754,Staff,22,0,40,18
1650526554040,MATH 20B,A01,083756,Staff,0,11,30,30
1650526554040,MATH 20B,A02,083757,Staff,0,12,30,30
1650526560072,MATH 20C,A01,083760,Staff,0,16,30,30
1650526560072,MATH 20C,A02,083761,Staff,2,14,30,28
1650526560072,MATH 20C,B01,083762,Staff,12,0,30,18
1650526560072,MATH 20C,B02,083763,Staff,28,0,30,2
1650526566101,MATH 20D,A01,083765,Staff,0,1,30,30
1650526566101,MATH 20D,A02,083766,Staff,7,0,30,23
1650526566101,MATH 20D,A03,083767,Staff,25,0,30,5
1650526572132,MATH 20E,A01,083771,Staff,6,0,30,24
1650526572132,MATH 20E,A02,083772,Staff,18,0,30,12
1650526572132,MATH 20E,B01,083773,Staff,0,0,30,30
1650526572132,MATH 20E,B02,083774,Staff,10,0,30,20
1650526578167,MATH 103A,A01,083777,Staff,0,14,30,30
1650526578167,MATH 103A,A02,083778,Staff,0,14,30,30
1650526578167,MATH 103A,B01,083779,Staff,0,13,30,30
1650526578167,MATH 103A,B02,083780,Staff,0,13,30,30
1650526584225,MATH 105,A01,085443,Staff,0,21,30,30
1650526590266,MATH 109,A01,083213,Anzaldo; Leesa B,0,8,30,30
1650526590266,MATH 109,A02,083214,Anzaldo; Leesa B,0,7,30,30
1650526590266,MATH 109,B01,083215,Anzaldo; Leesa B,0,5,30,30
1650526590266,MATH 109,B02,083216,Anzaldo; Leesa B,0,6,30,30
1650526596305,MATH 142A,A01,083219,Chow; Bennett,0,16,30,30
1650526596305,MATH 142A,A02,083220,Chow; Bennett,0,14,30,30
1650526596305,MATH 142A,B01,083221,Chow; Bennett,0,13,30,30
1650526596305,MATH 142A,B02,083222,Chow; Bennett,0,13,30,30
1650526602336,MATH 193A,A01,083224,Staff,0,6,30,30
1650526602336,MATH 193A,A02,083225,Staff,0,5,30,30
1650526602336,MATH 193A,A03,083781,Staff,0,5,30,30
1650526602336,MATH 193A,A04,083782,Staff,0,7,30,30
1650526608361,MATH 197,001,091859,McAuley; Julian John,9998,0,9999,1
1650526624333,COGS 9,A01,083615,Staff,0,16,60,60
1650526630371,COGS 11,A01,083617,Boyle; Mary E. T.,19,0,40,21
1650526636400,COGS 13,A01,083071,Staff,0,35,40,40
1650526642432,COGS 14A,A01,092681,Staff,0,25,100,100
1650526648457,COGS 14B,A01,083073,Cheng; Tzu-Han,0,12,50,50
1650526654481,COGS 17,A01,092677,Staff,19,0,75,56
1650526673604,COGS 100,A01,083619,Staff,0,26,60,60
1650526679636,COGS 101A,A01,083621,Davis; Joshua Daniel,0,26,60,60
1650526685662,COGS 101B,A01,091572,Staff,1,5,60,59
1650526691693,COGS 101C,A01,083625,Delgado; Tania,15,0,30,15
1650526697719,COGS 107A,A01,083627,Boyle; Mary E. T.,0,11,60,60
1650526703747,COGS 118A,A01,083075,Staff,0,3,60,60
1650526709780,CSE 3,A50,083646,Miranda; Gregory Joseph,20,0,38,18
1650526709780,CSE 3,A51,083647,Miranda; Gregory Joseph,36,0,37,1
1650526715814,CSE 8A,A50,083650,Miranda; Gregory Joseph,0,29,40,40
1650526721845,CSE 11,A01,083080,Cao; Yingjun,0,94,40,40
1650526727870,CSE 12,A01,083652,Staff,0,17,100,100
1650526733901,CSE 15L,A01,083654,Staff,0,1,50,50
1650526733901,CSE 15L,A02,083655,Staff,0,0,50,50
1650526739930,CSE 20,A01,083657,Staff,51,0,80,29
1650526745957,CSE 30,A01,083084,Eldon; John,0,77,40,40
1650526751993,CSE 100,A01,083659,Cao; Yingjun,0,66,50,50
1650526758019,CSE 134B,A01,083661,Powell; Thomas Allan,0,34,65,65
1650526764043,CSE 140,A01,083663,Staff,0,5,75,75
1650526770072,CSE 140L,A01,083088,Eldon; John,0,11,75,75
1650526776099,CSE 175,A01,083665,Kumar; Rakesh,7,0,25,18
1650526782129,CSE 190,A00,092507,Dubnov; Shlomo,10,0,20,10
1650526788161,ECE 45,A01,083139,Staff,0,0,60,60
1650526794187,ECE 65,A50,083695,Staff,0,6,30,30
1650526800217,ECE 109,A01,091882,Touri; Behrouz,34,0,70,36
1650526806242,ECE 180,A00,083140,Abi Samra; Nicholas Camill,21,0,30,9
1650526806242,ECE 180,B00,083141,Abi Samra; Nicholas Camill,0,0,30,30
1650526812276,MATH 10A,A01,083735,Patchell; Gregory David,5,0,30,25
1650526812276,MATH 10A,A02,083736,Patchell; Gregory David,27,0,30,3
1650526812276,MATH 10A,A03,083737,Patchell; Gregory David,24,0,30,6
1650526818307,MATH 10B,A01,083207,Staff,0,9,30,30
1650526818307,MATH 10B,A02,083208,Staff,0,7,30,30
1650526818307,MATH 10B,B01,083739,Staff,13,0,30,17
1650526818307,MATH 10B,B02,083740,Staff,28,0,30,2
1650526824340,MATH 18,A01,083743,Staff,1,0,30,29
1650526824340,MATH 18,A02,083744,Staff,27,0,30,3
1650526824340,MATH 18,A03,083745,Staff,22,0,30,8
1650526824340,MATH 18,A04,083746,Staff,26,0,30,4
1650526824340,MATH 18,B01,083748,Staff,0,12,30,30
1650526824340,MATH 18,B02,083749,Staff,0,12,30,30
1650526824340,MATH 18,B03,083750,Staff,0,11,30,30
1650526824340,MATH 18,B04,083751,Staff,0,12,30,30
1650526830369,MATH 20A,A01,083754,Staff,22,0,40,18
1650526836398,MATH 20B,A01,083756,Staff,0,11,30,30
1650526836398,MATH 20B,A02,083757,Staff,0,12,30,30
1650526842429,MATH 20C,A01,083760,Staff,0,16,30,30
1650526842429,MATH 20C,A02,083761,Staff,2,14,30,28
1650526842429,MATH 20C,B01,083762,Staff,12,0,30,18
1650526842429,MATH 20C,B02,083763,Staff,28,0,30,2
1650526848457,MATH 20D,A01,083765,Staff,0,1,30,30
1650526848457,MATH 20D,A02,083766,Staff,7,0,30,23
1650526848457,MATH 20D,A03,083767,Staff,25,0,30,5
1650526854490,MATH 20E,A01,083771,Staff,6,0,30,24
1650526854490,MATH 20E,A02,083772,Staff,18,0,30,12
1650526854490,MATH 20E,B01,083773,Staff,0,0,30,30
1650526854490,MATH 20E,B02,083774,Staff,10,0,30,20
1650526860538,MATH 103A,A01,083777,Staff,0,14,30,30
1650526860538,MATH 103A,A02,083778,Staff,0,14,30,30
1650526860538,MATH 103A,B01,083779,Staff,0,13,30,30
1650526860538,MATH 103A,B02,083780,Staff,0,13,30,30
1650526866578,MATH 105,A01,085443,Staff,0,21,30,30
1650526872603,MATH 109,A01,083213,Anzaldo; Leesa B,0,8,30,30
1650526872603,MATH 109,A02,083214,Anzaldo; Leesa B,0,7,30,30
1650526872603,MATH 109,B01,083215,Anzaldo; Leesa B,0,5,30,30
1650526872603,MATH 109,B02,083216,Anzaldo; Leesa B,0,6,30,30
1650526878628,MATH 142A,A01,083219,Chow; Bennett,0,16,30,30
1650526878628,MATH 142A,A02,083220,Chow; Bennett,0,14,30,30
1650526878628,MATH 142A,B01,083221,Chow; Bennett,0,13,30,30
1650526878628,MATH 142A,B02,083222,Chow; Bennett,0,13,30,30
1650526884654,MATH 193A,A01,083224,Staff,0,6,30,30
1650526884654,MATH 193A,A02,083225,Staff,0,5,30,30
1650526884654,MATH 193A,A03,083781,Staff,0,5,30,30
1650526884654,MATH 193A,A04,083782,Staff,0,7,30,30
1650526890683,MATH 197,001,091859,McAuley; Julian John,9998,0,9999,1
1650526896740,COGS 9,A01,083615,Staff,0,16,60,60
1650526902773,COGS 11,A01,083617,Boyle; Mary E. T.,19,0,40,21
1650526908799,COGS 13,A01,083071,Staff,0,35,40,40
1650526914823,COGS 14A,A01,092681,Staff,0,25,100,100
1650526920850,COGS 14B,A01,083073,Cheng; Tzu-Han,0,12,50,50
1650526926877,COGS 17,A01,092677,Staff,19,0,75,56
1650526932907,COGS 100,A01,083619,Staff,0,26,60,60
1650526938932,COGS 101A,A01,083621,Davis; Joshua Daniel,0,26,60,60
1650526944958,COGS 101B,A01,091572,Staff,1,5,60,59
1650526950985,COGS 101C,A01,083625,Delgado; Tania,15,0,30,15
1650526957015,COGS 107A,A01,083627,Boyle; Mary E. T.,0,11,60,60
1650526963130,COGS 118A,A01,083075,Staff,0,3,60,60
1650526969168,CSE 3,A50,083646,Miranda; Gregory Joseph,20,0,38,18
1650526969168,CSE 3,A51,083647,Miranda; Gregory Joseph,36,0,37,1
1650526975195,CSE 8A,A50,083650,Miranda; Gregory Joseph,0,29,40,40
1650526981228,CSE 11,A01,083080,Cao; Yingjun,0,94,40,40
1650526987253,CSE 12,A01,083652,Staff,0,17,100,100
1650526993277,CSE 15L,A01,083654,Staff,0,1,50,50
1650526993277,CSE 15L,A02,083655,Staff,0,0,50,50
1650526999301,CSE 20,A01,083657,Staff,51,0,80,29
1650527005329,CSE 30,A01,083084,Eldon; John,0,77,40,40
1650527011354,CSE 100,A01,083659,Cao; Yingjun,0,66,50,50
1650527017383,CSE 134B,A01,083661,Powell; Thomas Allan,0,34,65,65
1650527023408,CSE 140,A01,083663,Staff,0,5,75,75
1650527029435,CSE 140L,A01,083088,Eldon; John,0,11,75,75
1650527035465,CSE 175,A01,083665,Kumar; Rakesh,7,0,25,18
1650527041501,CSE 190,A00,092507,Dubnov; Shlomo,10,0,20,10
1650527047550,ECE 45,A01,083139,Staff,0,0,60,60
1650527053575,ECE 65,A50,083695,Staff,0,6,30,30
1650527059601,ECE 109,A01,091882,Touri; Behrouz,34,0,70,36
1650527065637,ECE 180,A00,083140,Abi Samra; Nicholas Camill,21,0,30,9
1650527065637,ECE 180,B00,083141,Abi Samra; Nicholas Camill,0,0,30,30
1650527071673,MATH 10A,A01,083735,Patchell; Gregory David,5,0,30,25
1650527071673,MATH 10A,A02,083736,Patchell; Gregory David,27,0,30,3
1650527071673,MATH 10A,A03,083737,Patchell; Gregory David,24,0,30,6
1650527077698,MATH 10B,A01,083207,Staff,0,9,30,30
1650527077698,MATH 10B,A02,083208,Staff,0,7,30,30
1650527077698,MATH 10B,B01,083739,Staff,13,0,30,17
1650527077698,MATH 10B,B02,083740,Staff,28,0,30,2
1650527083728,MATH 18,A01,083743,Staff,1,0,30,29
1650527083728,MATH 18,A02,083744,Staff,27,0,30,3
1650527083728,MATH 18,A03,083745,Staff,22,0,30,8
1650527083728,MATH 18,A04,083746,Staff,26,0,30,4
1650527083728,MATH 18,B01,083748,Staff,0,12,30,30
1650527083728,MATH 18,B02,083749,Staff,0,12,30,30
1650527083728,MATH 18,B03,083750,Staff,0,11,30,30
1650527083728,MATH 18,B04,083751,Staff,0,12,30,30
1650527089757,MATH 20A,A01,083754,Staff,22,0,40,18
1650527095788,MATH 20B,A01,083756,Staff,0,11,30,30
1650527095788,MATH 20B,A02,083757,Staff,0,12,30,30
1650527101814,MATH 20C,A01,083760,Staff,0,16,30,30
1650527101814,MATH 20C,A02,083761,Staff,2,14,30,28
1650527101814,MATH 20C,B01,083762,Staff,12,0,30,18
1650527101814,MATH 20C,B02,083763,Staff,28,0,30,2
1650527107839,MATH 20D,A01,083765,Staff,0,1,30,30
1650527107839,MATH 20D,A02,083766,Staff,7,0,30,23
1650527107839,MATH 20D,A03,083767,Staff,25,0,30,5
1650527113871,MATH 20E,A01,083771,Staff,6,0,30,24
1650527113871,MATH 20E,A02,083772,Staff,18,0,30,12
1650527113871,MATH 20E,B01,083773,Staff,0,0,30,30
1650527113871,MATH 20E,B02,083774,Staff,10,0,30,20
1650527119897,MATH 103A,A01,083777,Staff,0,14,30,30
1650527119897,MATH 103A,A02,083778,Staff,0,14,30,30
1650527119897,MATH 103A,B01,083779,Staff,0,13,30,30
1650527119897,MATH 103A,B02,083780,Staff,0,13,30,30
1650527125930,MATH 105,A01,085443,Staff,0,21,30,30
1650527131957,MATH 109,A01,083213,Anzaldo; Leesa B,0,8,30,30
1650527131957,MATH 109,A02,083214,Anzaldo; Leesa B,0,7,30,30
1650527131957,MATH 109,B01,083215,Anzaldo; Leesa B,0,5,30,30
1650527131957,MATH 109,B02,083216,Anzaldo; Leesa B,0,6,30,30
1650527137990,MATH 142A,A01,083219,Chow; Bennett,0,16,30,30
1650527137990,MATH 142A,A02,083220,Chow; Bennett,0,14,30,30
1650527137990,MATH 142A,B01,083221,Chow; Bennett,0,13,30,30
1650527137990,MATH 142A,B02,083222,Chow; Bennett,0,13,30,30
1650527144016,MATH 193A,A01,083224,Staff,0,6,30,30
1650527144016,MATH 193A,A02,083225,Staff,0,5,30,30
1650527144016,MATH 193A,A03,083781,Staff,0,5,30,30
1650527144016,MATH 193A,A04,083782,Staff,0,7,30,30
1650527150040,MATH 197,001,091859,McAuley; Julian John,9998,0,9999,1
1650527156116,COGS 9,A01,083615,Staff,0,16,60,60
1650527162145,COGS 11,A01,083617,Boyle; Mary E. T.,19,0,40,21
1650527168170,COGS 13,A01,083071,Staff,0,35,40,40
1650527174199,COGS 14A,A01,092681,Staff,0,25,100,100
1650527180225,COGS 14B,A01,083073,Cheng; Tzu-Han,0,12,50,50
1650527186253,COGS 17,A01,092677,Staff,19,0,75,56
1650527192279,COGS 100,A01,083619,Staff,0,26,60,60
1650527198305,COGS 101A,A01,083621,Davis; Joshua Daniel,0,26,60,60
1650527204336,COGS 101B,A01,091572,Staff,1,5,60,59
1650527210362,COGS 101C,A01,083625,Delgado; Tania,15,0,30,15
1650527216391,COGS 107A,A01,083627,Boyle; Mary E. T.,0,11,60,60
1650527222416,COGS 118A,A01,083075,Staff,0,3,60,60
1650527228442,CSE 3,A50,083646,Miranda; Gregory Joseph,20,0,38,18
1650527228442,CSE 3,A51,083647,Miranda; Gregory Joseph,36,0,37,1
1650527234470,CSE 8A,A50,083650,Miranda; Gregory Joseph,0,29,40,40
1650527240498,CSE 11,A01,083080,Cao; Yingjun,0,94,40,40
1650527246524,CSE 12,A01,083652,Staff,0,17,100,100
1650527252559,CSE 15L,A01,083654,Staff,0,1,50,50
1650527252559,CSE 15L,A02,083655,Staff,0,0,50,50
1650527258589,CSE 20,A01,083657,Staff,51,0,80,29
1650527264618,CSE 30,A01,083084,Eldon; John,0,77,40,40
1650527270645,CSE 100,A01,083659,Cao; Yingjun,0,66,50,50
1650527276669,CSE 134B,A01,083661,Powell; Thomas Allan,0,34,65,65
1650527282695,CSE 140,A01,083663,Staff,0,5,75,75
1650527288719,CSE 140L,A01,083088,Eldon; John,0,11,75,75
1650527294745,CSE 175,A01,083665,Kumar; Rakesh,7,0,25,18
1650527300775,CSE 190,A00,092507,Dubnov; Shlomo,10,0,20,10
1650527306801,ECE 45,A01,083139,Staff,0,0,60,60
1650527312827,ECE 65,A50,083695,Staff,0,6,30,30
1650527318856,ECE 109,A01,091882,Touri; Behrouz,34,0,70,36
1650527324884,ECE 180,A00,083140,Abi Samra; Nicholas Camill,21,0,30,9
1650527324884,ECE 180,B00,083141,Abi Samra; Nicholas Camill,0,0,30,30
1650527330913,MATH 10A,A01,083735,Patchell; Gregory David,5,0,30,25
1650527330913,MATH 10A,A02,083736,Patchell; Gregory David,27,0,30,3
1650527330913,MATH 10A,A03,083737,Patchell; Gregory David,24,0,30,6
1650527336944,MATH 10B,A01,083207,Staff,0,9,30,30
1650527336944,MATH 10B,A02,083208,Staff,0,7,30,30
1650527336944,MATH 10B,B01,083739,Staff,13,0,30,17
1650527336944,MATH 10B,B02,083740,Staff,28,0,30,2
1650527342972,MATH 18,A01,083743,Staff,1,0,30,29
1650527342972,MATH 18,A02,083744,Staff,27,0,30,3
1650527342972,MATH 18,A03,083745,Staff,22,0,30,8
1650527342972,MATH 18,A04,083746,Staff,26,0,30,4
1650527342972,MATH 18,B01,083748,Staff,0,12,30,30
1650527342972,MATH 18,B02,083749,Staff,0,12,30,30
1650527342972,MATH 18,B03,083750,Staff,0,11,30,30
1650527342972,MATH 18,B04,083751,Staff,0,12,30,30
1650527349000,MATH 20A,A01,083754,Staff,22,0,40,18
1650527355029,MATH 20B,A01,083756,Staff,0,11,30,30
1650527355029,MATH 20B,A02,083757,Staff,0,12,30,30
1650527361058,MATH 20C,A01,083760,Staff,0,16,30,30
1650527361058,MATH 20C,A02,083761,Staff,2,14,30,28
1650527361058,MATH 20C,B01,083762,Staff,12,0,30,18
1650527361058,MATH 20C,B02,083763,Staff,28,0,30,2
1650527367084,MATH 20D,A01,083765,Staff,0,1,30,30
1650527367084,MATH 20D,A02,083766,Staff,7,0,30,23
1650527367084,MATH 20D,A03,083767,Staff,25,0,30,5
1650527373112,MATH 20E,A01,083771,Staff,6,0,30,24
1650527373112,MATH 20E,A02,083772,Staff,18,0,30,12
1650527373112,MATH 20E,B01,083773,Staff,0,0,30,30
1650527373112,MATH 20E,B02,083774,Staff,10,0,30,20
1650527379142,MATH 103A,A01,083777,Staff,0,14,30,30
1650527379142,MATH 103A,A02,083778,Staff,0,14,30,30
1650527379142,MATH 103A,B01,083779,Staff,0,13,30,30
1650527379142,MATH 103A,B02,083780,Staff,0,13,30,30
1650527385172,MATH 105,A01,085443,Staff,0,21,30,30
1650527391197,MATH 109,A01,083213,Anzaldo; Leesa B,0,8,30,30
1650527391197,MATH 109,A02,083214,Anzaldo; Leesa B,0,7,30,30
1650527391197,MATH 109,B01,083215,Anzaldo; Leesa B,0,5,30,30
1650527391197,MATH 109,B02,083216,Anzaldo; Leesa B,0,6,30,30
1650527397228,MATH 142A,A01,083219,Chow; Bennett,0,16,30,30
1650527397228,MATH 142A,A02,083220,Chow; Bennett,0,14,30,30
1650527397228,MATH 142A,B01,083221,Chow; Bennett,0,13,30,30
1650527397228,MATH 142A,B02,083222,Chow; Bennett,0,13,30,30
1650527403254,MATH 193A,A01,083224,Staff,0,6,30,30
1650527403254,MATH 193A,A02,083225,Staff,0,5,30,30
1650527403254,MATH 193A,A03,083781,Staff,0,5,30,30
1650527403254,MATH 193A,A04,083782,Staff,0,7,30,30
1650527409283,MATH 197,001,091859,McAuley; Julian John,9998,0,9999,1
1650527415364,COGS 9,A01,083615,Staff,0,16,60,60
1650527421394,COGS 11,A01,083617,Boyle; Mary E. T.,19,0,40,21
1650527427425,COGS 13,A01,083071,Staff,0,35,40,40
1650527433449,COGS 14A,A01,092681,Staff,0,25,100,100
1650527439481,COGS 14B,A01,083073,Cheng; Tzu-Han,0,12,50,50
1650527445503,COGS 17,A01,092677,Staff,19,0,75,56
1650527451529,COGS 100,A01,083619,Staff,0,26,60,60
1650527457556,COGS 101A,A01,083621,Davis; Joshua Daniel,0,26,60,60
1650527463581,COGS 101B,A01,091572,Staff,1,5,60,59
1650527469614,COGS 101C,A01,083625,Delgado; Tania,15,0,30,15
1650527475639,COGS 107A,A01,083627,Boyle; Mary E. T.,0,11,60,60
1650527481664,COGS 118A,A01,083075,Staff,0,3,60,60
1650527487696,CSE 3,A50,083646,Miranda; Gregory Joseph,20,0,38,18
1650527487696,CSE 3,A51,083647,Miranda; Gregory Joseph,36,0,37,1
1650527493722,CSE 8A,A50,083650,Miranda; Gregory Joseph,0,29,40,40
1650527499747,CSE 11,A01,083080,Cao; Yingjun,0,94,40,40
1650527505785,CSE 12,A01,083652,Staff,0,17,100,100
1650527511810,CSE 15L,A01,083654,Staff,0,1,50,50
1650527511810,CSE 15L,A02,083655,Staff,0,0,50,50
1650527517843,CSE 20,A01,083657,Staff,51,0,80,29
1650527523870,CSE 30,A01,083084,Eldon; John,0,77,40,40
1650527529896,CSE 100,A01,083659,Cao; Yingjun,0,66,50,50
1650527535922,CSE 134B,A01,083661,Powell; Thomas Allan,0,34,65,65
1650527541951,CSE 140,A01,083663,Staff,0,5,75,75
1650527547980,CSE 140L,A01,083088,Eldon; John,0,11,75,75
1650527554014,CSE 175,A01,083665,Kumar; Rakesh,7,0,25,18
1650527560119,CSE 190,A00,092507,Dubnov; Shlomo,10,0,20,10
1650527566146,ECE 45,A01,083139,Staff,0,0,60,60
1650527572172,ECE 65,A50,083695,Staff,0,6,30,30
1650527578199,ECE 109,A01,091882,Touri; Behrouz,34,0,70,36
1650527584244,ECE 180,A00,083140,Abi Samra; Nicholas Camill,21,0,30,9
1650527584244,ECE 180,B00,083141,Abi Samra; Nicholas Camill,0,0,30,30
1650527590272,MATH 10A,A01,083735,Patchell; Gregory David,5,0,30,25
1650527590272,MATH 10A,A02,083736,Patchell; Gregory David,27,0,30,3
1650527590272,MATH 10A,A03,083737,Patchell; Gregory David,24,0,30,6
1650527596300,MATH 10B,A01,083207,Staff,0,9,30,30
1650527596300,MATH 10B,A02,083208,Staff,0,7,30,30
1650527596300,MATH 10B,B01,083739,Staff,13,0,30,17
1650527596300,MATH 10B,B02,083740,Staff,28,0,30,2
1650527602335,MATH 18,A01,083743,Staff,1,0,30,29
1650527602335,MATH 18,A02,083744,Staff,27,0,30,3
1650527602335,MATH 18,A03,083745,Staff,22,0,30,8
1650527602335,MATH 18,A04,083746,Staff,26,0,30,4
1650527602335,MATH 18,B01,083748,Staff,0,12,30,30
1650527602335,MATH 18,B02,083749,Staff,0,12,30,30
1650527602335,MATH 18,B03,083750,Staff,0,11,30,30
1650527602335,MATH 18,B04,083751,Staff,0,12,30,30
1650527608363,MATH 20A,A01,083754,Staff,22,0,40,18
1650527614391,MATH 20B,A01,083756,Staff,0,11,30,30
1650527614391,MATH 20B,A02,083757,Staff,0,12,30,30
1650527620417,MATH 20C,A01,083760,Staff,0,16,30,30
1650527620417,MATH 20C,A02,083761,Staff,2,14,30,28
1650527620417,MATH 20C,B01,083762,Staff,12,0,30,18
1650527620417,MATH 20C,B02,083763,Staff,28,0,30,2
1650527626450,MATH 20D,A01,083765,Staff,0,1,30,30
1650527626450,MATH 20D,A02,083766,Staff,7,0,30,23
1650527626450,MATH 20D,A03,083767,Staff,25,0,30,5
1650527632483,MATH 20E,A01,083771,Staff,6,0,30,24
1650527632483,MATH 20E,A02,083772,Staff,18,0,30,12
1650527632483,MATH 20E,B01,083773,Staff,0,0,30,30
1650527632483,MATH 20E,B02,083774,Staff,10,0,30,20
1650527638508,MATH 103A,A01,083777,Staff,0,15,30,30
1650527638508,MATH 103A,A02,083778,Staff,0,14,30,30
1650527638508,MATH 103A,B01,083779,Staff,0,13,30,30
1650527638508,MATH 103A,B02,083780,Staff,0,13,30,30
1650527644535,MATH 105,A01,085443,Staff,0,21,30,30
1650527650561,MATH 109,A01,083213,Anzaldo; Leesa B,0,8,30,30
1650527650561,MATH 109,A02,083214,Anzaldo; Leesa B,0,7,30,30
1650527650561,MATH 109,B01,083215,Anzaldo; Leesa B,0,5,30,30
1650527650561,MATH 109,B02,083216,Anzaldo; Leesa B,0,6,30,30
1650527656591,MATH 142A,A01,083219,Chow; Bennett,0,16,30,30
1650527656591,MATH 142A,A02,083220,Chow; Bennett,0,14,30,30
1650527656591,MATH 142A,B01,083221,Chow; Bennett,0,13,30,30
1650527656591,MATH 142A,B02,083222,Chow; Bennett,0,13,30,30
1650527662620,MATH 193A,A01,083224,Staff,0,6,30,30
1650527662620,MATH 193A,A02,083225,Staff,0,5,30,30
1650527662620,MATH 193A,A03,083781,Staff,0,5,30,30
1650527662620,MATH 193A,A04,083782,Staff,0,7,30,30
1650527668647,MATH 197,001,091859,McAuley; Julian John,9998,0,9999,1
1650527674720,COGS 9,A01,083615,Staff,0,16,60,60
1650527680749,COGS 11,A01,083617,Boyle; Mary E. T.,19,0,40,21
1650527686772,COGS 13,A01,083071,Staff,0,35,40,40
1650527692807,COGS 14A,A01,092681,Staff,0,25,100,100
1650527698832,COGS 14B,A01,083073,Cheng; Tzu-Han,0,12,50,50
1650527704856,COGS 17,A01,092677,Staff,19,0,75,56
1650527710880,COGS 100,A01,083619,Staff,0,26,60,60
1650527716910,COGS 101A,A01,083621,Davis; Joshua Daniel,0,26,60,60
1650527722937,COGS 101B,A01,091572,Staff,1,5,60,59
1650527728968,COGS 101C,A01,083625,Delgado; Tania,15,0,30,15
1650527734991,COGS 107A,A01,083627,Boyle; Mary E. T.,0,11,60,60
1650527741016,COGS 118A,A01,083075,Staff,0,3,60,60
1650527747041,CSE 3,A50,083646,Miranda; Gregory Joseph,20,0,38,18
1650527747041,CSE 3,A51,083647,Miranda; Gregory Joseph,36,0,37,1
1650527753066,CSE 8A,A50,083650,Miranda; Gregory Joseph,0,29,40,40
1650527759095,CSE 11,A01,083080,Cao; Yingjun,0,94,40,40
1650527765117,CSE 12,A01,083652,Staff,0,17,100,100
1650527771144,CSE 15L,A01,083654,Staff,0,1,50,50
1650527771144,CSE 15L,A02,083655,Staff,0,0,50,50
1650527777171,CSE 20,A01,083657,Staff,51,0,80,29
1650527783195,CSE 30,A01,083084,Eldon; John,0,77,40,40
1650527789222,CSE 100,A01,083659,Cao; Yingjun,0,66,50,50
1650527795247,CSE 134B,A01,083661,Powell; Thomas Allan,0,34,65,65
1650527801272,CSE 140,A01,083663,Staff,0,5,75,75
1650527807300,CSE 140L,A01,083088,Eldon; John,0,11,75,75
1650527813329,CSE 175,A01,083665,Kumar; Rakesh,7,0,25,18
1650527819357,CSE 190,A00,092507,Dubnov; Shlomo,10,0,20,10
1650527825384,ECE 45,A01,083139,Staff,0,0,60,60
1650527831411,ECE 65,A50,083695,Staff,0,6,30,30
1650527837439,ECE 109,A01,091882,Touri; Behrouz,34,0,70,36
1650527843461,ECE 180,A00,083140,Abi Samra; Nicholas Camill,21,0,30,9
1650527843461,ECE 180,B00,083141,Abi Samra; Nicholas Camill,0,0,30,30
1650527849491,MATH 10A,A01,083735,Patchell; Gregory David,5,0,30,25
1650527849491,MATH 10A,A02,083736,Patchell; Gregory David,27,0,30,3
1650527849491,MATH 10A,A03,083737,Patchell; Gregory David,24,0,30,6
1650527855520,MATH 10B,A01,083207,Staff,0,9,30,30
1650527855520,MATH 10B,A02,083208,Staff,0,7,30,30
1650527855520,MATH 10B,B01,083739,Staff,13,0,30,17
1650527855520,MATH 10B,B02,083740,Staff,28,0,30,2
1650527861554,MATH 18,A01,083743,Staff,1,0,30,29
1650527861554,MATH 18,A02,083744,Staff,27,0,30,3
1650527861554,MATH 18,A03,083745,Staff,22,0,30,8
1650527861554,MATH 18,A04,083746,Staff,26,0,30,4
1650527861554,MATH 18,B01,083748,Staff,0,12,30,30
1650527861554,MATH 18,B02,083749,Staff,0,12,30,30
1650527861554,MATH 18,B03,083750,Staff,0,11,30,30
1650527861554,MATH 18,B04,083751,Staff,0,12,30,30
1650527867581,MATH 20A,A01,083754,Staff,22,0,40,18
1650527873609,MATH 20B,A01,083756,Staff,0,11,30,30
1650527873609,MATH 20B,A02,083757,Staff,0,12,30,30
1650527879635,MATH 20C,A01,083760,Staff,0,16,30,30
1650527879635,MATH 20C,A02,083761,Staff,2,14,30,28
1650527879635,MATH 20C,B01,083762,Staff,12,0,30,18
1650527879635,MATH 20C,B02,083763,Staff,28,0,30,2
1650527885661,MATH 20D,A01,083765,Staff,0,1,30,30
1650527885661,MATH 20D,A02,083766,Staff,7,0,30,23
1650527885661,MATH 20D,A03,083767,Staff,25,0,30,5
1650527891690,MATH 20E,A01,083771,Staff,6,0,30,24
1650527891690,MATH 20E,A02,083772,Staff,18,0,30,12
1650527891690,MATH 20E,B01,083773,Staff,0,0,30,30
1650527891690,MATH 20E,B02,083774,Staff,10,0,30,20
1650527897719,MATH 103A,A01,083777,Staff,0,15,30,30
1650527897719,MATH 103A,A02,083778,Staff,0,14,30,30
1650527897719,MATH 103A,B01,083779,Staff,0,13,30,30
1650527897719,MATH 103A,B02,083780,Staff,0,13,30,30
1650527903744,MATH 105,A01,085443,Staff,0,21,30,30
1650527909781,MATH 109,A01,083213,Anzaldo; Leesa B,0,8,30,30
1650527909781,MATH 109,A02,083214,Anzaldo; Leesa B,0,7,30,30
1650527909781,MATH 109,B01,083215,Anzaldo; Leesa B,0,5,30,30
1650527909781,MATH 109,B02,083216,Anzaldo; Leesa B,0,6,30,30
1650527915811,MATH 142A,A01,083219,Chow; Bennett,0,16,30,30
1650527915811,MATH 142A,A02,083220,Chow; Bennett,0,14,30,30
1650527915811,MATH 142A,B01,083221,Chow; Bennett,0,13,30,30
1650527915811,MATH 142A,B02,083222,Chow; Bennett,0,13,30,30
1650527921839,MATH 193A,A01,083224,Staff,0,6,30,30
1650527921839,MATH 193A,A02,083225,Staff,0,5,30,30
1650527921839,MATH 193A,A03,083781,Staff,0,5,30,30
1650527921839,MATH 193A,A04,083782,Staff,0,7,30,30
1650527927862,MATH 197,001,091859,McAuley; Julian John,9998,0,9999,1
1650527933925,COGS 9,A01,083615,Staff,0,16,60,60
1650527939950,COGS 11,A01,083617,Boyle; Mary E. T.,19,0,40,21
1650527945982,COGS 13,A01,083071,Staff,0,35,40,40
1650527952010,COGS 14A,A01,092681,Staff,0,25,100,100
1650527958034,COGS 14B,A01,083073,Cheng; Tzu-Han,0,12,50,50
1650527964059,COGS 17,A01,092677,Staff,19,0,75,56
1650527970084,COGS 100,A01,083619,Staff,0,26,60,60
1650527976114,COGS 101A,A01,083621,Davis; Joshua Daniel,0,26,60,60
1650527982144,COGS 101B,A01,091572,Staff,1,5,60,59
1650527988170,COGS 101C,A01,083625,Delgado; Tania,15,0,30,15
1650527994195,COGS 107A,A01,083627,Boyle; Mary E. T.,0,11,60,60
1650528000223,COGS 118A,A01,083075,Staff,0,3,60,60
1650528006251,CSE 3,A50,083646,Miranda; Gregory Joseph,20,0,38,18
1650528006251,CSE 3,A51,083647,Miranda; Gregory Joseph,36,0,37,1
1650528012275,CSE 8A,A50,083650,Miranda; Gregory Joseph,0,29,40,40
1650528018297,CSE 11,A01,083080,Cao; Yingjun,0,94,40,40
1650528024325,CSE 12,A01,083652,Staff,0,17,100,100
1650528030351,CSE 15L,A01,083654,Staff,0,1,50,50
1650528030351,CSE 15L,A02,083655,Staff,0,0,50,50
1650528036375,CSE 20,A01,083657,Staff,51,0,80,29
1650528042401,CSE 30,A01,083084,Eldon; John,0,77,40,40
1650528048429,CSE 100,A01,083659,Cao; Yingjun,0,66,50,50
1650528054459,CSE 134B,A01,083661,Powell; Thomas Allan,0,34,65,65
1650528060486,CSE 140,A01,083663,Staff,0,5,75,75
1650528066514,CSE 140L,A01,083088,Eldon; John,0,11,75,75
1650528072537,CSE 175,A01,083665,Kumar; Rakesh,7,0,25,18
1650528078562,CSE 190,A00,092507,Dubnov; Shlomo,10,0,20,10
1650528084586,ECE 45,A01,083139,Staff,0,0,60,60
1650528090609,ECE 65,A50,083695,Staff,0,6,30,30
1650528096634,ECE 109,A01,091882,Touri; Behrouz,34,0,70,36
1650528102658,ECE 180,A00,083140,Abi Samra; Nicholas Camill,21,0,30,9
1650528102658,ECE 180,B00,083141,Abi Samra; Nicholas Camill,0,0,30,30
1650528108684,MATH 10A,A01,083735,Patchell; Gregory David,5,0,30,25
1650528108684,MATH 10A,A02,083736,Patchell; Gregory David,27,0,30,3
1650528108684,MATH 10A,A03,083737,Patchell; Gregory David,24,0,30,6
1650528114710,MATH 10B,A01,083207,Staff,0,9,30,30
1650528114710,MATH 10B,A02,083208,Staff,0,7,30,30
1650528114710,MATH 10B,B01,083739,Staff,13,0,30,17
1650528114710,MATH 10B,B02,083740,Staff,28,0,30,2
1650528120737,MATH 18,A01,083743,Staff,1,0,30,29
1650528120737,MATH 18,A02,083744,Staff,27,0,30,3
1650528120737,MATH 18,A03,083745,Staff,22,0,30,8
1650528120737,MATH 18,A04,083746,Staff,26,0,30,4
1650528120737,MATH 18,B01,083748,Staff,0,12,30,30
1650528120737,MATH 18,B02,083749,Staff,0,12,30,30
1650528120737,MATH 18,B03,083750,Staff,0,11,30,30
1650528120737,MATH 18,B04,083751,Staff,0,12,30,30
1650528126764,MATH 20A,A01,083754,Staff,22,0,40,18
1650528132789,MATH 20B,A01,083756,Staff,0,11,30,30
1650528132789,MATH 20B,A02,083757,Staff,0,12,30,30
1650528138816,MATH 20C,A01,083760,Staff,0,16,30,30
1650528138816,MATH 20C,A02,083761,Staff,2,14,30,28
1650528138816,MATH 20C,B01,083762,Staff,12,0,30,18
1650528138816,MATH 20C,B02,083763,Staff,28,0,30,2
1650528144849,MATH 20D,A01,083765,Staff,0,1,30,30
1650528144849,MATH 20D,A02,083766,Staff,7,0,30,23
1650528144849,MATH 20D,A03,083767,Staff,25,0,30,5
1650528150874,MATH 20E,A01,083771,Staff,6,0,30,24
1650528150874,MATH 20E,A02,083772,Staff,18,0,30,12
1650528150874,MATH 20E,B01,083773,Staff,0,0,30,30
1650528150874,MATH 20E,B02,083774,Staff,10,0,30,20
1650528156979,MATH 103A,A01,083777,Staff,0,15,30,30
1650528156979,MATH 103A,A02,083778,Staff,0,14,30,30
1650528156979,MATH 103A,B01,083779,Staff,0,13,30,30
1650528156979,MATH 103A,B02,083780,Staff,0,13,30,30
1650528163004,MATH 105,A01,085443,Staff,0,21,30,30
1650528169029,MATH 109,A01,083213,Anzaldo; Leesa B,0,8,30,30
1650528169029,MATH 109,A02,083214,Anzaldo; Leesa B,0,7,30,30
1650528169029,MATH 109,B01,083215,Anzaldo; Leesa B,0,5,30,30
1650528169029,MATH 109,B02,083216,Anzaldo; Leesa B,0,6,30,30
1650528175058,MATH 142A,A01,083219,Chow; Bennett,0,16,30,30
1650528175058,MATH 142A,A02,083220,Chow; Bennett,0,14,30,30
1650528175058,MATH 142A,B01,083221,Chow; Bennett,0,13,30,30
1650528175058,MATH 142A,B02,083222,Chow; Bennett,0,13,30,30
1650528181082,MATH 193A,A01,083224,Staff,0,6,30,30
1650528181082,MATH 193A,A02,083225,Staff,0,5,30,30
1650528181082,MATH 193A,A03,083781,Staff,0,5,30,30
1650528181082,MATH 193A,A04,083782,Staff,0,7,30,30
1650528187106,MATH 197,001,091859,McAuley; Julian John,9998,0,9999,1
1650528193163,COGS 9,A01,083615,Staff,0,16,60,60
1650528199193,COGS 11,A01,083617,Boyle; Mary E. T.,19,0,40,21
1650528205223,COGS 13,A01,083071,Staff,0,35,40,40
1650528211251,COGS 14A,A01,092681,Staff,0,25,100,100
1650528217286,COGS 14B,A01,083073,Cheng; Tzu-Han,0,12,50,50
1650528223309,COGS 17,A01,092677,Staff,19,0,75,56
1650528229339,COGS 100,A01,083619,Staff,0,26,60,60
1650528235369,COGS 101A,A01,083621,Davis; Joshua Daniel,0,26,60,60
1650528241395,COGS 101B,A01,091572,Staff,1,5,60,59
1650528247424,COGS 101C,A01,083625,Delgado; Tania,15,0,30,15
1650528253449,COGS 107A,A01,083627,Boyle; Mary E. T.,0,11,60,60
1650528259476,COGS 118A,A01,083075,Staff,0,3,60,60
1650528265501,CSE 3,A50,083646,Miranda; Gregory Joseph,20,0,38,18
1650528265501,CSE 3,A51,083647,Miranda; Gregory Joseph,36,0,37,1
1650528271538,CSE 8A,A50,083650,Miranda; Gregory Joseph,0,29,40,40
1650528277575,CSE 11,A01,083080,Cao; Yingjun,0,94,40,40
1650528283603,CSE 12,A01,083652,Staff,0,17,100,100
1650528289632,CSE 15L,A01,083654,Staff,0,1,50,50
1650528289632,CSE 15L,A02,083655,Staff,0,0,50,50
1650528295658,CSE 20,A01,083657,Staff,51,0,80,29
1650528301699,CSE 30,A01,083084,Eldon; John,0,77,40,40
1650528307728,CSE 100,A01,083659,Cao; Yingjun,0,66,50,50
1650528313751,CSE 134B,A01,083661,Powell; Thomas Allan,0,34,65,65
1650528319779,CSE 140,A01,083663,Staff,0,5,75,75
1650528325807,CSE 140L,A01,083088,Eldon; John,0,11,75,75
1650528331830,CSE 175,A01,083665,Kumar; Rakesh,7,0,25,18
1650528337874,CSE 190,A00,092507,Dubnov; Shlomo,10,0,20,10
1650528343907,ECE 45,A01,083139,Staff,0,0,60,60
1650528349934,ECE 65,A50,083695,Staff,0,6,30,30
1650528355964,ECE 109,A01,091882,Touri; Behrouz,34,0,70,36
1650528361990,ECE 180,A00,083140,Abi Samra; Nicholas Camill,21,0,30,9
1650528361990,ECE 180,B00,083141,Abi Samra; Nicholas Camill,0,0,30,30
1650528368019,MATH 10A,A01,083735,Patchell; Gregory David,5,0,30,25
1650528368019,MATH 10A,A02,083736,Patchell; Gregory David,27,0,30,3
1650528368019,MATH 10A,A03,083737,Patchell; Gregory David,24,0,30,6
1650528374042,MATH 10B,A01,083207,Staff,0,9,30,30
1650528374042,MATH 10B,A02,083208,Staff,0,7,30,30
1650528374042,MATH 10B,B01,083739,Staff,13,0,30,17
1650528374042,MATH 10B,B02,083740,Staff,28,0,30,2
1650528380080,MATH 18,A01,083743,Staff,1,0,30,29
1650528380080,MATH 18,A02,083744,Staff,27,0,30,3
1650528380080,MATH 18,A03,083745,Staff,22,0,30,8
1650528380080,MATH 18,A04,083746,Staff,26,0,30,4
1650528380080,MATH 18,B01,083748,Staff,0,12,30,30
1650528380080,MATH 18,B02,083749,Staff,0,12,30,30
1650528380080,MATH 18,B03,083750,Staff,0,11,30,30
1650528380080,MATH 18,B04,083751,Staff,0,12,30,30
1650528386105,MATH 20A,A01,083754,Staff,22,0,40,18
1650528392132,MATH 20B,A01,083756,Staff,0,11,30,30
1650528392132,MATH 20B,A02,083757,Staff,0,12,30,30
1650528398157,MATH 20C,A01,083760,Staff,0,16,30,30
1650528398157,MATH 20C,A02,083761,Staff,2,14,30,28
1650528398157,MATH 20C,B01,083762,Staff,12,0,30,18
1650528398157,MATH 20C,B02,083763,Staff,28,0,30,2
1650528404180,MATH 20D,A01,083765,Staff,0,1,30,30
1650528404180,MATH 20D,A02,083766,Staff,7,0,30,23
1650528404180,MATH 20D,A03,083767,Staff,25,0,30,5
1650528410211,MATH 20E,A01,083771,Staff,6,0,30,24
1650528410211,MATH 20E,A02,083772,Staff,18,0,30,12
1650528410211,MATH 20E,B01,083773,Staff,0,0,30,30
1650528410211,MATH 20E,B02,083774,Staff,10,0,30,20
1650528416240,MATH 103A,A01,083777,Staff,0,15,30,30
1650528416240,MATH 103A,A02,083778,Staff,0,14,30,30
1650528416240,MATH 103A,B01,083779,Staff,0,13,30,30
1650528416240,MATH 103A,B02,083780,Staff,0,13,30,30
1650528422264,MATH 105,A01,085443,Staff,0,21,30,30
1650528428289,MATH 109,A01,083213,Anzaldo; Leesa B,0,8,30,30
1650528428289,MATH 109,A02,083214,Anzaldo; Leesa B,0,7,30,30
1650528428289,MATH 109,B01,083215,Anzaldo; Leesa B,0,5,30,30
1650528428289,MATH 109,B02,083216,Anzaldo; Leesa B,0,6,30,30
1650528434313,MATH 142A,A01,083219,Chow; Bennett,0,16,30,30
1650528434313,MATH 142A,A02,083220,Chow; Bennett,0,14,30,30
1650528434313,MATH 142A,B01,083221,Chow; Bennett,0,13,30,30
1650528434313,MATH 142A,B02,083222,Chow; Bennett,0,13,30,30
1650528440348,MATH 193A,A01,083224,Staff,0,6,30,30
1650528440348,MATH 193A,A02,083225,Staff,0,5,30,30
1650528440348,MATH 193A,A03,083781,Staff,0,5,30,30
1650528440348,MATH 193A,A04,083782,Staff,0,7,30,30
1650528446372,MATH 197,001,091859,McAuley; Julian John,9998,0,9999,1
1650528452434,COGS 9,A01,083615,Staff,0,16,60,60
1650528458461,COGS 11,A01,083617,Boyle; Mary E. T.,19,0,40,21
1650528464493,COGS 13,A01,083071,Staff,0,35,40,40
1650528470520,COGS 14A,A01,092681,Staff,0,25,100,100
1650528476549,COGS 14B,A01,083073,Cheng; Tzu-Han,0,12,50,50
1650528482585,COGS 17,A01,092677,Staff,19,0,75,56
1650528488610,COGS 100,A01,083619,Staff,0,26,60,60
1650528494635,COGS 101A,A01,083621,Davis; Joshua Daniel,0,26,60,60
1650528500662,COGS 101B,A01,091572,Staff,1,5,60,59
1650528506687,COGS 101C,A01,083625,Delgado; Tania,15,0,30,15
1650528512715,COGS 107A,A01,083627,Boyle; Mary E. T.,0,11,60,60
1650528518744,COGS 118A,A01,083075,Staff,0,3,60,60
1650528524772,CSE 3,A50,083646,Miranda; Gregory Joseph,20,0,38,18
1650528524772,CSE 3,A51,083647,Miranda; Gregory Joseph,36,0,37,1
1650528530797,CSE 8A,A50,083650,Miranda; Gregory Joseph,0,29,40,40
1650528536821,CSE 11,A01,083080,Cao; Yingjun,0,94,40,40
1650528542849,CSE 12,A01,083652,Staff,0,17,100,100
1650528548873,CSE 15L,A01,083654,Staff,0,1,50,50
1650528548873,CSE 15L,A02,083655,Staff,0,0,50,50
1650528554899,CSE 20,A01,083657,Staff,51,0,80,29
1650528560924,CSE 30,A01,083084,Eldon; John,0,77,40,40
1650528566945,CSE 100,A01,083659,Cao; Yingjun,0,66,50,50
1650528572971,CSE 134B,A01,083661,Powell; Thomas Allan,0,34,65,65
1650528579002,CSE 140,A01,083663,Staff,0,5,75,75
1650528585030,CSE 140L,A01,083088,Eldon; John,0,11,75,75
1650528591056,CSE 175,A01,083665,Kumar; Rakesh,7,0,25,18
1650528597085,CSE 190,A00,092507,Dubnov; Shlomo,10,0,20,10
1650528603112,ECE 45,A01,083139,Staff,0,0,60,60
1650528609137,ECE 65,A50,083695,Staff,0,6,30,30
1650528615163,ECE 109,A01,091882,Touri; Behrouz,34,0,70,36
1650528621186,ECE 180,A00,083140,Abi Samra; Nicholas Camill,21,0,30,9
1650528621186,ECE 180,B00,083141,Abi Samra; Nicholas Camill,0,0,30,30
1650528627210,MATH 10A,A01,083735,Patchell; Gregory David,5,0,30,25
1650528627210,MATH 10A,A02,083736,Patchell; Gregory David,27,0,30,3
1650528627210,MATH 10A,A03,083737,Patchell; Gregory David,24,0,30,6
1650528633235,MATH 10B,A01,083207,Staff,0,9,30,30
1650528633235,MATH 10B,A02,083208,Staff,0,7,30,30
1650528633235,MATH 10B,B01,083739,Staff,13,0,30,17
1650528633235,MATH 10B,B02,083740,Staff,28,0,30,2
1650528639263,MATH 18,A01,083743,Staff,1,0,30,29
1650528639263,MATH 18,A02,083744,Staff,27,0,30,3
1650528639263,MATH 18,A03,083745,Staff,22,0,30,8
1650528639263,MATH 18,A04,083746,Staff,26,0,30,4
1650528639263,MATH 18,B01,083748,Staff,0,12,30,30
1650528639263,MATH 18,B02,083749,Staff,0,12,30,30
1650528639263,MATH 18,B03,083750,Staff,0,11,30,30
1650528639263,MATH 18,B04,083751,Staff,0,12,30,30
1650528645288,MATH 20A,A01,083754,Staff,22,0,40,18
1650528651315,MATH 20B,A01,083756,Staff,0,11,30,30
1650528651315,MATH 20B,A02,083757,Staff,0,12,30,30
1650528657343,MATH 20C,A01,083760,Staff,0,16,30,30
1650528657343,MATH 20C,A02,083761,Staff,2,14,30,28
1650528657343,MATH 20C,B01,083762,Staff,12,0,30,18
1650528657343,MATH 20C,B02,083763,Staff,28,0,30,2
1650528663366,MATH 20D,A01,083765,Staff,0,1,30,30
1650528663366,MATH 20D,A02,083766,Staff,7,0,30,23
1650528663366,MATH 20D,A03,083767,Staff,25,0,30,5
1650528669397,MATH 20E,A01,083771,Staff,6,0,30,24
1650528669397,MATH 20E,A02,083772,Staff,18,0,30,12
1650528669397,MATH 20E,B01,083773,Staff,0,0,30,30
1650528669397,MATH 20E,B02,083774,Staff,10,0,30,20
1650528675425,MATH 103A,A01,083777,Staff,0,15,30,30
1650528675425,MATH 103A,A02,083778,Staff,0,14,30,30
1650528675425,MATH 103A,B01,083779,Staff,0,13,30,30
1650528675425,MATH 103A,B02,083780,Staff,0,13,30,30
1650528681448,MATH 105,A01,085443,Staff,0,21,30,30
1650528687487,MATH 109,A01,083213,Anzaldo; Leesa B,0,8,30,30
1650528687487,MATH 109,A02,083214,Anzaldo; Leesa B,0,7,30,30
1650528687487,MATH 109,B01,083215,Anzaldo; Leesa B,0,5,30,30
1650528687487,MATH 109,B02,083216,Anzaldo; Leesa B,0,6,30,30
1650528693512,MATH 142A,A01,083219,Chow; Bennett,0,16,30,30
1650528693512,MATH 142A,A02,083220,Chow; Bennett,0,14,30,30
1650528693512,MATH 142A,B01,083221,Chow; Bennett,0,13,30,30
1650528693512,MATH 142A,B02,083222,Chow; Bennett,0,13,30,30
1650528699537,MATH 193A,A01,083224,Staff,0,6,30,30
1650528699537,MATH 193A,A02,083225,Staff,0,5,30,30
1650528699537,MATH 193A,A03,083781,Staff,0,5,30,30
1650528699537,MATH 193A,A04,083782,Staff,0,7,30,30
1650528705564,MATH 197,001,091859,McAuley; Julian John,9998,0,9999,1
1650528711645,COGS 9,A01,083615,Staff,0,16,60,60
1650528717671,COGS 11,A01,083617,Boyle; Mary E. T.,19,0,40,21
1650528723705,COGS 13,A01,083071,Staff,0,35,40,40
1650528729732,COGS 14A,A01,092681,Staff,0,25,100,100
1650528735762,COGS 14B,A01,083073,Cheng; Tzu-Han,0,12,50,50
1650528741790,COGS 17,A01,092677,Staff,19,0,75,56
1650528747892,COGS 100,A01,083619,Staff,0,26,60,60
1650528753929,COGS 101A,A01,083621,Davis; Joshua Daniel,0,26,60,60
1650528759962,COGS 101B,A01,091572,Staff,1,5,60,59
1650528765988,COGS 101C,A01,083625,Delgado; Tania,15,0,30,15
1650528772019,COGS 107A,A01,083627,Boyle; Mary E. T.,0,11,60,60
1650528778043,COGS 118A,A01,083075,Staff,0,3,60,60
1650528784068,CSE 3,A50,083646,Miranda; Gregory Joseph,20,0,38,18
1650528784068,CSE 3,A51,083647,Miranda; Gregory Joseph,36,0,37,1
1650528790093,CSE 8A,A50,083650,Miranda; Gregory Joseph,0,29,40,40
1650528796117,CSE 11,A01,083080,Cao; Yingjun,0,94,40,40
1650528802141,CSE 12,A01,083652,Staff,0,17,100,100
1650528808193,CSE 15L,A01,083654,Staff,0,1,50,50
1650528808193,CSE 15L,A02,083655,Staff,0,0,50,50
1650528814227,CSE 20,A01,083657,Staff,51,0,80,29
1650528820250,CSE 30,A01,083084,Eldon; John,0,77,40,40
1650528826273,CSE 100,A01,083659,Cao; Yingjun,0,66,50,50
1650528832301,CSE 134B,A01,083661,Powell; Thomas Allan,0,34,65,65
1650528838325,CSE 140,A01,083663,Staff,0,5,75,75
1650528844354,CSE 140L,A01,083088,Eldon; John,0,11,75,75
1650528850384,CSE 175,A01,083665,Kumar; Rakesh,7,0,25,18
1650528856414,CSE 190,A00,092507,Dubnov; Shlomo,10,0,20,10
1650528862442,ECE 45,A01,083139,Staff,0,0,60,60
1650528868472,ECE 65,A50,083695,Staff,0,6,30,30
1650528874497,ECE 109,A01,091882,Touri; Behrouz,34,0,70,36
1650528880522,ECE 180,A00,083140,Abi Samra; Nicholas Camill,21,0,30,9
1650528880522,ECE 180,B00,083141,Abi Samra; Nicholas Camill,0,0,30,30
1650528886549,MATH 10A,A01,083735,Patchell; Gregory David,5,0,30,25
1650528886549,MATH 10A,A02,083736,Patchell; Gregory David,27,0,30,3
1650528886549,MATH 10A,A03,083737,Patchell; Gregory David,24,0,30,6
1650528892582,MATH 10B,A01,083207,Staff,0,9,30,30
1650528892582,MATH 10B,A02,083208,Staff,0,7,30,30
1650528892582,MATH 10B,B01,083739,Staff,13,0,30,17
1650528892582,MATH 10B,B02,083740,Staff,28,0,30,2
1650528898609,MATH 18,A01,083743,Staff,1,0,30,29
1650528898609,MATH 18,A02,083744,Staff,27,0,30,3
1650528898609,MATH 18,A03,083745,Staff,22,0,30,8
1650528898609,MATH 18,A04,083746,Staff,26,0,30,4
1650528898609,MATH 18,B01,083748,Staff,0,12,30,30
1650528898609,MATH 18,B02,083749,Staff,0,12,30,30
1650528898609,MATH 18,B03,083750,Staff,0,11,30,30
1650528898609,MATH 18,B04,083751,Staff,0,12,30,30
1650528904634,MATH 20A,A01,083754,Staff,22,0,40,18
1650528910660,MATH 20B,A01,083756,Staff,0,11,30,30
1650528910660,MATH 20B,A02,083757,Staff,0,12,30,30
1650528916697,MATH 20C,A01,083760,Staff,0,16,30,30
1650528916697,MATH 20C,A02,083761,Staff,2,14,30,28
1650528916697,MATH 20C,B01,083762,Staff,12,0,30,18
1650528916697,MATH 20C,B02,083763,Staff,28,0,30,2
1650528922723,MATH 20D,A01,083765,Staff,0,1,30,30
1650528922723,MATH 20D,A02,083766,Staff,7,0,30,23
1650528922723,MATH 20D,A03,083767,Staff,25,0,30,5
1650528928749,MATH 20E,A01,083771,Staff,6,0,30,24
1650528928749,MATH 20E,A02,083772,Staff,18,0,30,12
1650528928749,MATH 20E,B01,083773,Staff,0,0,30,30
1650528928749,MATH 20E,B02,083774,Staff,10,0,30,20
1650528934783,MATH 103A,A01,083777,Staff,0,15,30,30
1650528934783,MATH 103A,A02,083778,Staff,0,14,30,30
1650528934783,MATH 103A,B01,083779,Staff,0,13,30,30
1650528934783,MATH 103A,B02,083780,Staff,0,13,30,30
1650528940811,MATH 105,A01,085443,Staff,0,21,30,30
1650528946853,MATH 109,A01,083213,Anzaldo; Leesa B,0,8,30,30
1650528946853,MATH 109,A02,083214,Anzaldo; Leesa B,0,7,30,30
1650528946853,MATH 109,B01,083215,Anzaldo; Leesa B,0,5,30,30
1650528946853,MATH 109,B02,083216,Anzaldo; Leesa B,0,6,30,30
1650528952884,MATH 142A,A01,083219,Chow; Bennett,0,16,30,30
1650528952884,MATH 142A,A02,083220,Chow; Bennett,0,14,30,30
1650528952884,MATH 142A,B01,083221,Chow; Bennett,0,13,30,30
1650528952884,MATH 142A,B02,083222,Chow; Bennett,0,13,30,30
1650528958909,MATH 193A,A01,083224,Staff,0,6,30,30
1650528958909,MATH 193A,A02,083225,Staff,0,5,30,30
1650528958909,MATH 193A,A03,083781,Staff,0,5,30,30
1650528958909,MATH 193A,A04,083782,Staff,0,7,30,30
1650528964932,MATH 197,001,091859,McAuley; Julian John,9998,0,9999,1
1650528970996,COGS 9,A01,083615,Staff,0,16,60,60
1650528977020,COGS 11,A01,083617,Boyle; Mary E. T.,19,0,40,21
1650528983046,COGS 13,A01,083071,Staff,0,35,40,40
1650528989070,COGS 14A,A01,092681,Staff,0,25,100,100
1650528995097,COGS 14B,A01,083073,Cheng; Tzu-Han,0,12,50,50
1650529001126,COGS 17,A01,092677,Staff,19,0,75,56
1650529007152,COGS 100,A01,083619,Staff,0,26,60,60
1650529013187,COGS 101A,A01,083621,Davis; Joshua Daniel,0,26,60,60
1650529019211,COGS 101B,A01,091572,Staff,1,5,60,59
1650529025236,COGS 101C,A01,083625,Delgado; Tania,15,0,30,15
1650529031261,COGS 107A,A01,083627,Boyle; Mary E. T.,0,11,60,60
1650529037285,COGS 118A,A01,083075,Staff,0,3,60,60
1650529043311,CSE 3,A50,083646,Miranda; Gregory Joseph,20,0,38,18
1650529043311,CSE 3,A51,083647,Miranda; Gregory Joseph,36,0,37,1
1650529049340,CSE 8A,A50,083650,Miranda; Gregory Joseph,0,29,40,40
1650529055363,CSE 11,A01,083080,Cao; Yingjun,0,94,40,40
1650529061388,CSE 12,A01,083652,Staff,0,17,100,100
1650529067411,CSE 15L,A01,083654,Staff,0,1,50,50
1650529067411,CSE 15L,A02,083655,Staff,0,0,50,50
1650529073436,CSE 20,A01,083657,Staff,51,0,80,29
1650529079460,CSE 30,A01,083084,Eldon; John,0,77,40,40
1650529085487,CSE 100,A01,083659,Cao; Yingjun,0,66,50,50
1650529091510,CSE 134B,A01,083661,Powell; Thomas Allan,0,34,65,65
1650529097537,CSE 140,A01,083663,Staff,0,5,75,75
1650529103561,CSE 140L,A01,083088,Eldon; John,0,11,75,75
1650529109589,CSE 175,A01,083665,Kumar; Rakesh,7,0,25,18
1650529115616,CSE 190,A00,092507,Dubnov; Shlomo,10,0,20,10
1650529121662,ECE 45,A01,083139,Staff,0,0,60,60
1650529127687,ECE 65,A50,083695,Staff,0,6,30,30
1650529133715,ECE 109,A01,091882,Touri; Behrouz,34,0,70,36
1650529139739,ECE 180,A00,083140,Abi Samra; Nicholas Camill,21,0,30,9
1650529139739,ECE 180,B00,083141,Abi Samra; Nicholas Camill,0,0,30,30
1650529145764,MATH 10A,A01,083735,Patchell; Gregory David,5,0,30,25
1650529145764,MATH 10A,A02,083736,Patchell; Gregory David,27,0,30,3
1650529145764,MATH 10A,A03,083737,Patchell; Gregory David,24,0,30,6
1650529151793,MATH 10B,A01,083207,Staff,0,9,30,30
1650529151793,MATH 10B,A02,083208,Staff,0,7,30,30
1650529151793,MATH 10B,B01,083739,Staff,13,0,30,17
1650529151793,MATH 10B,B02,083740,Staff,28,0,30,2
1650529157820,MATH 18,A01,083743,Staff,1,0,30,29
1650529157820,MATH 18,A02,083744,Staff,27,0,30,3
1650529157820,MATH 18,A03,083745,Staff,22,0,30,8
1650529157820,MATH 18,A04,083746,Staff,26,0,30,4
1650529157820,MATH 18,B01,083748,Staff,0,12,30,30
1650529157820,MATH 18,B02,083749,Staff,0,12,30,30
1650529157820,MATH 18,B03,083750,Staff,0,11,30,30
1650529157820,MATH 18,B04,083751,Staff,0,12,30,30
1650529163844,MATH 20A,A01,083754,Staff,22,0,40,18
1650529169871,MATH 20B,A01,083756,Staff,0,11,30,30
1650529169871,MATH 20B,A02,083757,Staff,0,12,30,30
1650529175900,MATH 20C,A01,083760,Staff,0,16,30,30
1650529175900,MATH 20C,A02,083761,Staff,2,14,30,28
1650529175900,MATH 20C,B01,083762,Staff,12,0,30,18
1650529175900,MATH 20C,B02,083763,Staff,28,0,30,2
1650529181924,MATH 20D,A01,083765,Staff,0,1,30,30
1650529181924,MATH 20D,A02,083766,Staff,7,0,30,23
1650529181924,MATH 20D,A03,083767,Staff,25,0,30,5
1650529187950,MATH 20E,A01,083771,Staff,6,0,30,24
1650529187950,MATH 20E,A02,083772,Staff,18,0,30,12
1650529187950,MATH 20E,B01,083773,Staff,0,0,30,30
1650529187950,MATH 20E,B02,083774,Staff,10,0,30,20
1650529193980,MATH 103A,A01,083777,Staff,0,15,30,30
1650529193980,MATH 103A,A02,083778,Staff,0,14,30,30
1650529193980,MATH 103A,B01,083779,Staff,0,13,30,30
1650529193980,MATH 103A,B02,083780,Staff,0,13,30,30
1650529200003,MATH 105,A01,085443,Staff,0,21,30,30
1650529206028,MATH 109,A01,083213,Anzaldo; Leesa B,0,8,30,30
1650529206028,MATH 109,A02,083214,Anzaldo; Leesa B,0,7,30,30
1650529206028,MATH 109,B01,083215,Anzaldo; Leesa B,0,5,30,30
1650529206028,MATH 109,B02,083216,Anzaldo; Leesa B,0,6,30,30
1650529212057,MATH 142A,A01,083219,Chow; Bennett,0,16,30,30
1650529212057,MATH 142A,A02,083220,Chow; Bennett,0,14,30,30
1650529212057,MATH 142A,B01,083221,Chow; Bennett,0,13,30,30
1650529212057,MATH 142A,B02,083222,Chow; Bennett,0,13,30,30
1650529218081,MATH 193A,A01,083224,Staff,0,6,30,30
1650529218081,MATH 193A,A02,083225,Staff,0,5,30,30
1650529218081,MATH 193A,A03,083781,Staff,0,5,30,30
1650529218081,MATH 193A,A04,083782,Staff,0,7,30,30
1650529224109,MATH 197,001,091859,McAuley; Julian John,9998,0,9999,1
1650529230165,COGS 9,A01,083615,Staff,0,16,60,60
1650529236192,COGS 11,A01,083617,Boyle; Mary E. T.,19,0,40,21
1650529242222,COGS 13,A01,083071,Staff,0,35,40,40
1650529248250,COGS 14A,A01,092681,Staff,0,25,100,100
1650529254273,COGS 14B,A01,083073,Cheng; Tzu-Han,0,12,50,50
1650529260297,COGS 17,A01,092677,Staff,19,0,75,56
1650529266324,COGS 100,A01,083619,Staff,0,26,60,60
1650529272345,COGS 101A,A01,083621,Davis; Joshua Daniel,0,26,60,60
1650529278373,COGS 101B,A01,091572,Staff,1,5,60,59
1650529284400,COGS 101C,A01,083625,Delgado; Tania,15,0,30,15
1650529290434,COGS 107A,A01,083627,Boyle; Mary E. T.,0,11,60,60
1650529296459,COGS 118A,A01,083075,Staff,0,3,60,60
1650529302488,CSE 3,A50,083646,Miranda; Gregory Joseph,20,0,38,18
1650529302488,CSE 3,A51,083647,Miranda; Gregory Joseph,36,0,37,1
1650529308510,CSE 8A,A50,083650,Miranda; Gregory Joseph,0,29,40,40
1650529314532,CSE 11,A01,083080,Cao; Yingjun,0,94,40,40
1650529320561,CSE 12,A01,083652,Staff,0,17,100,100
1650529326587,CSE 15L,A01,083654,Staff,0,1,50,50
1650529326587,CSE 15L,A02,083655,Staff,0,0,50,50
1650529332612,CSE 20,A01,083657,Staff,51,0,80,29
1650529338651,CSE 30,A01,083084,Eldon; John,0,77,40,40
1650529344747,CSE 100,A01,083659,Cao; Yingjun,0,66,50,50
1650529350777,CSE 134B,A01,083661,Powell; Thomas Allan,0,34,65,65
1650529356805,CSE 140,A01,083663,Staff,0,5,75,75
1650529362829,CSE 140L,A01,083088,Eldon; John,0,11,75,75
1650529368855,CSE 175,A01,083665,Kumar; Rakesh,7,0,25,18
1650529374882,CSE 190,A00,092507,Dubnov; Shlomo,10,0,20,10
1650529380910,ECE 45,A01,083139,Staff,0,1,60,60
1650529386937,ECE 65,A50,083695,Staff,0,6,30,30
1650529392960,ECE 109,A01,091882,Touri; Behrouz,34,0,70,36
1650529398984,ECE 180,A00,083140,Abi Samra; Nicholas Camill,21,0,30,9
1650529398984,ECE 180,B00,083141,Abi Samra; Nicholas Camill,0,0,30,30
1650529405012,MATH 10A,A01,083735,Patchell; Gregory David,5,0,30,25
1650529405012,MATH 10A,A02,083736,Patchell; Gregory David,27,0,30,3
1650529405012,MATH 10A,A03,083737,Patchell; Gregory David,24,0,30,6
1650529411039,MATH 10B,A01,083207,Staff,0,9,30,30
1650529411039,MATH 10B,A02,083208,Staff,0,7,30,30
1650529411039,MATH 10B,B01,083739,Staff,13,0,30,17
1650529411039,MATH 10B,B02,083740,Staff,28,0,30,2
1650529417068,MATH 18,A01,083743,Staff,1,0,30,29
1650529417068,MATH 18,A02,083744,Staff,27,0,30,3
1650529417068,MATH 18,A03,083745,Staff,22,0,30,8
1650529417068,MATH 18,A04,083746,Staff,26,0,30,4
1650529417068,MATH 18,B01,083748,Staff,0,12,30,30
1650529417068,MATH 18,B02,083749,Staff,0,12,30,30
1650529417068,MATH 18,B03,083750,Staff,0,11,30,30
1650529417068,MATH 18,B04,083751,Staff,0,12,30,30
1650529423093,MATH 20A,A01,083754,Staff,22,0,40,18
1650529429117,MATH 20B,A01,083756,Staff,0,11,30,30
1650529429117,MATH 20B,A02,083757,Staff,0,12,30,30
1650529435145,MATH 20C,A01,083760,Staff,0,16,30,30
1650529435145,MATH 20C,A02,083761,Staff,2,14,30,28
1650529435145,MATH 20C,B01,083762,Staff,12,0,30,18
1650529435145,MATH 20C,B02,083763,Staff,28,0,30,2
1650529441169,MATH 20D,A01,083765,Staff,0,1,30,30
1650529441169,MATH 20D,A02,083766,Staff,7,0,30,23
1650529441169,MATH 20D,A03,083767,Staff,25,0,30,5
1650529447198,MATH 20E,A01,083771,Staff,6,0,30,24
1650529447198,MATH 20E,A02,083772,Staff,18,0,30,12
1650529447198,MATH 20E,B01,083773,Staff,0,0,30,30
1650529447198,MATH 20E,B02,083774,Staff,10,0,30,20
1650529453227,MATH 103A,A01,083777,Staff,0,15,30,30
1650529453227,MATH 103A,A02,083778,Staff,0,14,30,30
1650529453227,MATH 103A,B01,083779,Staff,0,13,30,30
1650529453227,MATH 103A,B02,083780,Staff,0,13,30,30
1650529459253,MATH 105,A01,085443,Staff,0,21,30,30
1650529465279,MATH 109,A01,083213,Anzaldo; Leesa B,0,8,30,30
1650529465279,MATH 109,A02,083214,Anzaldo; Leesa B,0,7,30,30
1650529465279,MATH 109,B01,083215,Anzaldo; Leesa B,0,5,30,30
1650529465279,MATH 109,B02,083216,Anzaldo; Leesa B,0,6,30,30
1650529471305,MATH 142A,A01,083219,Chow; Bennett,0,16,30,30
1650529471305,MATH 142A,A02,083220,Chow; Bennett,0,14,30,30
1650529471305,MATH 142A,B01,083221,Chow; Bennett,0,13,30,30
1650529471305,MATH 142A,B02,083222,Chow; Bennett,0,13,30,30
1650529477330,MATH 193A,A01,083224,Staff,0,6,30,30
1650529477330,MATH 193A,A02,083225,Staff,0,5,30,30
1650529477330,MATH 193A,A03,083781,Staff,0,5,30,30
1650529477330,MATH 193A,A04,083782,Staff,0,7,30,30
1650529483353,MATH 197,001,091859,McAuley; Julian John,9998,0,9999,1
1650529489425,COGS 9,A01,083615,Staff,0,16,60,60
1650529495449,COGS 11,A01,083617,Boyle; Mary E. T.,19,0,40,21
1650529501474,COGS 13,A01,083071,Staff,0,35,40,40
1650529507502,COGS 14A,A01,092681,Staff,0,25,100,100
1650529513526,COGS 14B,A01,083073,Cheng; Tzu-Han,0,12,50,50
1650529519551,COGS 17,A01,092677,Staff,19,0,75,56
1650529525575,COGS 100,A01,083619,Staff,0,26,60,60
1650529531598,COGS 101A,A01,083621,Davis; Joshua Daniel,0,26,60,60
1650529537624,COGS 101B,A01,091572,Staff,1,5,60,59
1650529543652,COGS 101C,A01,083625,Delgado; Tania,15,0,30,15
1650529549680,COGS 107A,A01,083627,Boyle; Mary E. T.,0,11,60,60
1650529555705,COGS 118A,A01,083075,Staff,0,3,60,60
1650529561730,CSE 3,A50,083646,Miranda; Gregory Joseph,20,0,38,18
1650529561730,CSE 3,A51,083647,Miranda; Gregory Joseph,36,0,37,1
1650529567756,CSE 8A,A50,083650,Miranda; Gregory Joseph,0,29,40,40
1650529573783,CSE 11,A01,083080,Cao; Yingjun,0,94,40,40
1650529579808,CSE 12,A01,083652,Staff,0,17,100,100
1650529585840,CSE 15L,A01,083654,Staff,0,1,50,50
1650529585840,CSE 15L,A02,083655,Staff,0,0,50,50
1650529591871,CSE 20,A01,083657,Staff,51,0,80,29
1650529597895,CSE 30,A01,083084,Eldon; John,0,77,40,40
1650529603919,CSE 100,A01,083659,Cao; Yingjun,0,66,50,50
1650529609946,CSE 134B,A01,083661,Powell; Thomas Allan,0,34,65,65
1650529615969,CSE 140,A01,083663,Staff,0,5,75,75
1650529621996,CSE 140L,A01,083088,Eldon; John,0,11,75,75
1650529628020,CSE 175,A01,083665,Kumar; Rakesh,7,0,25,18
1650529634044,CSE 190,A00,092507,Dubnov; Shlomo,10,0,20,10
1650529640070,ECE 45,A01,083139,Staff,0,1,60,60
1650529646098,ECE 65,A50,083695,Staff,0,6,30,30
1650529652125,ECE 109,A01,091882,Touri; Behrouz,34,0,70,36
1650529658149,ECE 180,A00,083140,Abi Samra; Nicholas Camill,21,0,30,9
1650529658149,ECE 180,B00,083141,Abi Samra; Nicholas Camill,0,0,30,30
1650529664184,MATH 10A,A01,083735,Patchell; Gregory David,5,0,30,25
1650529664184,MATH 10A,A02,083736,Patchell; Gregory David,27,0,30,3
1650529664184,MATH 10A,A03,083737,Patchell; Gregory David,24,0,30,6
1650529670212,MATH 10B,A01,083207,Staff,0,9,30,30
1650529670212,MATH 10B,A02,083208,Staff,0,7,30,30
1650529670212,MATH 10B,B01,083739,Staff,13,0,30,17
1650529670212,MATH 10B,B02,083740,Staff,28,0,30,2
1650529676242,MATH 18,A01,083743,Staff,1,0,30,29
1650529676242,MATH 18,A02,083744,Staff,27,0,30,3
1650529676242,MATH 18,A03,083745,Staff,22,0,30,8
1650529676242,MATH 18,A04,083746,Staff,26,0,30,4
1650529676242,MATH 18,B01,083748,Staff,0,12,30,30
1650529676242,MATH 18,B02,083749,Staff,0,12,30,30
1650529676242,MATH 18,B03,083750,Staff,0,11,30,30
1650529676242,MATH 18,B04,083751,Staff,0,12,30,30
1650529682267,MATH 20A,A01,083754,Staff,22,0,40,18
1650529688291,MATH 20B,A01,083756,Staff,0,11,30,30
1650529688291,MATH 20B,A02,083757,Staff,0,12,30,30
1650529694316,MATH 20C,A01,083760,Staff,0,16,30,30
1650529694316,MATH 20C,A02,083761,Staff,2,14,30,28
1650529694316,MATH 20C,B01,083762,Staff,12,0,30,18
1650529694316,MATH 20C,B02,083763,Staff,28,0,30,2
1650529700341,MATH 20D,A01,083765,Staff,0,1,30,30
1650529700341,MATH 20D,A02,083766,Staff,7,0,30,23
1650529700341,MATH 20D,A03,083767,Staff,25,0,30,5
1650529706366,MATH 20E,A01,083771,Staff,6,0,30,24
1650529706366,MATH 20E,A02,083772,Staff,18,0,30,12
1650529706366,MATH 20E,B01,083773,Staff,0,0,30,30
1650529706366,MATH 20E,B02,083774,Staff,10,0,30,20
1650529712395,MATH 103A,A01,083777,Staff,0,15,30,30
1650529712395,MATH 103A,A02,083778,Staff,0,14,30,30
1650529712395,MATH 103A,B01,083779,Staff,0,13,30,30
1650529712395,MATH 103A,B02,083780,Staff,0,13,30,30
1650529718417,MATH 105,A01,085443,Staff,0,21,30,30
1650529724443,MATH 109,A01,083213,Anzaldo; Leesa B,0,8,30,30
1650529724443,MATH 109,A02,083214,Anzaldo; Leesa B,0,7,30,30
1650529724443,MATH 109,B01,083215,Anzaldo; Leesa B,0,5,30,30
1650529724443,MATH 109,B02,083216,Anzaldo; Leesa B,0,6,30,30
1650529730468,MATH 142A,A01,083219,Chow; Bennett,0,16,30,30
1650529730468,MATH 142A,A02,083220,Chow; Bennett,0,14,30,30
1650529730468,MATH 142A,B01,083221,Chow; Bennett,0,13,30,30
1650529730468,MATH 142A,B02,083222,Chow; Bennett,0,13,30,30
1650529736501,MATH 193A,A01,083224,Staff,0,6,30,30
1650529736501,MATH 193A,A02,083225,Staff,0,5,30,30
1650529736501,MATH 193A,A03,083781,Staff,0,5,30,30
1650529736501,MATH 193A,A04,083782,Staff,0,7,30,30
1650529742526,MATH 197,001,091859,McAuley; Julian John,9998,0,9999,1
1650529748587,COGS 9,A01,083615,Staff,0,16,60,60
1650529754615,COGS 11,A01,083617,Boyle; Mary E. T.,19,0,40,21
1650529760638,COGS 13,A01,083071,Staff,0,35,40,40
1650529766666,COGS 14A,A01,092681,Staff,0,25,100,100
1650529772691,COGS 14B,A01,083073,Cheng; Tzu-Han,0,12,50,50
1650529778718,COGS 17,A01,092677,Staff,19,0,75,56
1650529784747,COGS 100,A01,083619,Staff,0,26,60,60
1650529790777,COGS 101A,A01,083621,Davis; Joshua Daniel,0,26,60,60
1650529796803,COGS 101B,A01,091572,Staff,1,5,60,59
1650529802830,COGS 101C,A01,083625,Delgado; Tania,15,0,30,15
1650529808853,COGS 107A,A01,083627,Boyle; Mary E. T.,0,11,60,60
1650529814877,COGS 118A,A01,083075,Staff,0,3,60,60
1650529820904,CSE 3,A50,083646,Miranda; Gregory Joseph,20,0,38,18
1650529820904,CSE 3,A51,083647,Miranda; Gregory Joseph,36,0,37,1
1650529826927,CSE 8A,A50,083650,Miranda; Gregory Joseph,0,29,40,40
1650529832955,CSE 11,A01,083080,Cao; Yingjun,0,94,40,40
1650529838978,CSE 12,A01,083652,Staff,0,17,100,100
1650529845006,CSE 15L,A01,083654,Staff,0,1,50,50
1650529845006,CSE 15L,A02,083655,Staff,0,0,50,50
1650529851029,CSE 20,A01,083657,Staff,51,0,80,29
1650529857060,CSE 30,A01,083084,Eldon; John,0,77,40,40
1650529863085,CSE 100,A01,083659,Cao; Yingjun,0,66,50,50
1650529869109,CSE 134B,A01,083661,Powell; Thomas Allan,0,34,65,65
1650529875143,CSE 140,A01,083663,Staff,0,5,75,75
1650529881170,CSE 140L,A01,083088,Eldon; John,0,11,75,75
1650529887195,CSE 175,A01,083665,Kumar; Rakesh,7,0,25,18
1650529893223,CSE 190,A00,092507,Dubnov; Shlomo,10,0,20,10
1650529899247,ECE 45,A01,083139,Staff,0,1,60,60
1650529905276,ECE 65,A50,083695,Staff,0,6,30,30
1650529911302,ECE 109,A01,091882,Touri; Behrouz,34,0,70,36
1650529917328,ECE 180,A00,083140,Abi Samra; Nicholas Camill,21,0,30,9
1650529917328,ECE 180,B00,083141,Abi Samra; Nicholas Camill,0,0,30,30
1650529923359,MATH 10A,A01,083735,Patchell; Gregory David,5,0,30,25
1650529923359,MATH 10A,A02,083736,Patchell; Gregory David,27,0,30,3
1650529923359,MATH 10A,A03,083737,Patchell; Gregory David,24,0,30,6
1650529929389,MATH 10B,A01,083207,Staff,0,9,30,30
1650529929389,MATH 10B,A02,083208,Staff,0,7,30,30
1650529929389,MATH 10B,B01,083739,Staff,13,0,30,17
1650529929389,MATH 10B,B02,083740,Staff,28,0,30,2
1650529935422,MATH 18,A01,083743,Staff,1,0,30,29
1650529935422,MATH 18,A02,083744,Staff,27,0,30,3
1650529935422,MATH 18,A03,083745,Staff,22,0,30,8
1650529935422,MATH 18,A04,083746,Staff,26,0,30,4
1650529935422,MATH 18,B01,083748,Staff,0,12,30,30
1650529935422,MATH 18,B02,083749,Staff,0,12,30,30
1650529935422,MATH 18,B03,083750,Staff,0,11,30,30
1650529935422,MATH 18,B04,083751,Staff,0,12,30,30
1650529941538,MATH 20A,A01,083754,Staff,22,0,40,18
1650529947561,MATH 20B,A01,083756,Staff,0,11,30,30
1650529947561,MATH 20B,A02,083757,Staff,0,12,30,30
1650529953583,MATH 20C,A01,083760,Staff,0,16,30,30
1650529953583,MATH 20C,A02,083761,Staff,2,14,30,28
1650529953583,MATH 20C,B01,083762,Staff,12,0,30,18
1650529953583,MATH 20C,B02,083763,Staff,28,0,30,2
1650529959615,MATH 20D,A01,083765,Staff,0,1,30,30
1650529959615,MATH 20D,A02,083766,Staff,7,0,30,23
1650529959615,MATH 20D,A03,083767,Staff,25,0,30,5
1650529965638,MATH 20E,A01,083771,Staff,6,0,30,24
1650529965638,MATH 20E,A02,083772,Staff,18,0,30,12
1650529965638,MATH 20E,B01,083773,Staff,0,0,30,30
1650529965638,MATH 20E,B02,083774,Staff,10,0,30,20
1650529971666,MATH 103A,A01,083777,Staff,0,15,30,30
1650529971666,MATH 103A,A02,083778,Staff,0,14,30,30
1650529971666,MATH 103A,B01,083779,Staff,0,13,30,30
1650529971666,MATH 103A,B02,083780,Staff,0,13,30,30
1650529977691,MATH 105,A01,085443,Staff,0,21,30,30
1650529983721,MATH 109,A01,083213,Anzaldo; Leesa B,0,8,30,30
1650529983721,MATH 109,A02,083214,Anzaldo; Leesa B,0,7,30,30
1650529983721,MATH 109,B01,083215,Anzaldo; Leesa B,0,5,30,30
1650529983721,MATH 109,B02,083216,Anzaldo; Leesa B,0,6,30,30
1650529989747,MATH 142A,A01,083219,Chow; Bennett,0,16,30,30
1650529989747,MATH 142A,A02,083220,Chow; Bennett,0,14,30,30
1650529989747,MATH 142A,B01,083221,Chow; Bennett,0,13,30,30
1650529989747,MATH 142A,B02,083222,Chow; Bennett,0,13,30,30
1650529995769,MATH 193A,A01,083224,Staff,0,6,30,30
1650529995769,MATH 193A,A02,083225,Staff,0,5,30,30
1650529995769,MATH 193A,A03,083781,Staff,0,5,30,30
1650529995769,MATH 193A,A04,083782,Staff,0,7,30,30
1650530001793,MATH 197,001,091859,McAuley; Julian John,9998,0,9999,1
1650530007853,COGS 9,A01,083615,Staff,0,16,60,60
1650530013886,COGS 11,A01,083617,Boyle; Mary E. T.,19,0,40,21
1650530019910,COGS 13,A01,083071,Staff,0,35,40,40
1650530025941,COGS 14A,A01,092681,Staff,0,25,100,100
1650530031966,COGS 14B,A01,083073,Cheng; Tzu-Han,0,12,50,50
1650530037989,COGS 17,A01,092677,Staff,19,0,75,56
1650530044012,COGS 100,A01,083619,Staff,0,26,60,60
1650530050042,COGS 101A,A01,083621,Davis; Joshua Daniel,0,26,60,60
1650530056070,COGS 101B,A01,091572,Staff,1,5,60,59
1650530062099,COGS 101C,A01,083625,Delgado; Tania,15,0,30,15
1650530068122,COGS 107A,A01,083627,Boyle; Mary E. T.,0,11,60,60
1650530074149,COGS 118A,A01,083075,Staff,0,3,60,60
1650530080172,CSE 3,A50,083646,Miranda; Gregory Joseph,20,0,38,18
1650530080172,CSE 3,A51,083647,Miranda; Gregory Joseph,36,0,37,1
1650530086200,CSE 8A,A50,083650,Miranda; Gregory Joseph,0,29,40,40
1650530092227,CSE 11,A01,083080,Cao; Yingjun,0,94,40,40
1650530098250,CSE 12,A01,083652,Staff,0,17,100,100
1650530104273,CSE 15L,A01,083654,Staff,0,1,50,50
1650530104273,CSE 15L,A02,083655,Staff,0,0,50,50
1650530110304,CSE 20,A01,083657,Staff,51,0,80,29
1650530116329,CSE 30,A01,083084,Eldon; John,0,77,40,40
1650530122355,CSE 100,A01,083659,Cao; Yingjun,0,66,50,50
1650530128383,CSE 134B,A01,083661,Powell; Thomas Allan,0,34,65,65
1650530134410,CSE 140,A01,083663,Staff,0,5,75,75
1650530140434,CSE 140L,A01,083088,Eldon; John,0,11,75,75
1650530146469,CSE 175,A01,083665,Kumar; Rakesh,7,0,25,18
1650530152494,CSE 190,A00,092507,Dubnov; Shlomo,10,0,20,10
1650530158522,ECE 45,A01,083139,Staff,0,1,60,60
1650530164553,ECE 65,A50,083695,Staff,0,6,30,30
1650530170583,ECE 109,A01,091882,Touri; Behrouz,34,0,70,36
1650530176606,ECE 180,A00,083140,Abi Samra; Nicholas Camill,21,0,30,9
1650530176606,ECE 180,B00,083141,Abi Samra; Nicholas Camill,0,0,30,30
1650530182631,MATH 10A,A01,083735,Patchell; Gregory David,5,0,30,25
1650530182631,MATH 10A,A02,083736,Patchell; Gregory David,27,0,30,3
1650530182631,MATH 10A,A03,083737,Patchell; Gregory David,24,0,30,6
1650530188658,MATH 10B,A01,083207,Staff,0,9,30,30
1650530188658,MATH 10B,A02,083208,Staff,0,7,30,30
1650530188658,MATH 10B,B01,083739,Staff,13,0,30,17
1650530188658,MATH 10B,B02,083740,Staff,28,0,30,2
1650530194682,MATH 18,A01,083743,Staff,1,0,30,29
1650530194682,MATH 18,A02,083744,Staff,27,0,30,3
1650530194682,MATH 18,A03,083745,Staff,22,0,30,8
1650530194682,MATH 18,A04,083746,Staff,26,0,30,4
1650530194682,MATH 18,B01,083748,Staff,0,12,30,30
1650530194682,MATH 18,B02,083749,Staff,0,12,30,30
1650530194682,MATH 18,B03,083750,Staff,0,11,30,30
1650530194682,MATH 18,B04,083751,Staff,0,12,30,30
1650530200709,MATH 20A,A01,083754,Staff,22,0,40,18
1650530206737,MATH 20B,A01,083756,Staff,0,11,30,30
1650530206737,MATH 20B,A02,083757,Staff,0,12,30,30
1650530212761,MATH 20C,A01,083760,Staff,0,16,30,30
1650530212761,MATH 20C,A02,083761,Staff,2,14,30,28
1650530212761,MATH 20C,B01,083762,Staff,12,0,30,18
1650530212761,MATH 20C,B02,083763,Staff,28,0,30,2
1650530218785,MATH 20D,A01,083765,Staff,0,1,30,30
1650530218785,MATH 20D,A02,083766,Staff,7,0,30,23
1650530218785,MATH 20D,A03,083767,Staff,25,0,30,5
1650530224810,MATH 20E,A01,083771,Staff,6,0,30,24
1650530224810,MATH 20E,A02,083772,Staff,18,0,30,12
1650530224810,MATH 20E,B01,083773,Staff,0,0,30,30
1650530224810,MATH 20E,B02,083774,Staff,10,0,30,20
1650530230839,MATH 103A,A01,083777,Staff,0,15,30,30
1650530230839,MATH 103A,A02,083778,Staff,0,14,30,30
1650530230839,MATH 103A,B01,083779,Staff,0,13,30,30
1650530230839,MATH 103A,B02,083780,Staff,0,13,30,30
1650530236866,MATH 105,A01,085443,Staff,0,21,30,30
1650530242896,MATH 109,A01,083213,Anzaldo; Leesa B,0,8,30,30
1650530242896,MATH 109,A02,083214,Anzaldo; Leesa B,0,7,30,30
1650530242896,MATH 109,B01,083215,Anzaldo; Leesa B,0,5,30,30
1650530242896,MATH 109,B02,083216,Anzaldo; Leesa B,0,6,30,30
1650530248929,MATH 142A,A01,083219,Chow; Bennett,0,16,30,30
1650530248929,MATH 142A,A02,083220,Chow; Bennett,0,14,30,30
1650530248929,MATH 142A,B01,083221,Chow; Bennett,0,13,30,30
1650530248929,MATH 142A,B02,083222,Chow; Bennett,0,13,30,30
1650530254954,MATH 193A,A01,083224,Staff,0,6,30,30
1650530254954,MATH 193A,A02,083225,Staff,0,5,30,30
1650530254954,MATH 193A,A03,083781,Staff,0,5,30,30
1650530254954,MATH 193A,A04,083782,Staff,0,7,30,30
1650530260977,MATH 197,001,091859,McAuley; Julian John,9998,0,9999,1
1650530267042,COGS 9,A01,083615,Staff,0,16,60,60
1650530273064,COGS 11,A01,083617,Boyle; Mary E. T.,19,0,40,21
1650530279092,COGS 13,A01,083071,Staff,0,35,40,40
1650530285117,COGS 14A,A01,092681,Staff,0,25,100,100
1650530291155,COGS 14B,A01,083073,Cheng; Tzu-Han,0,12,50,50
1650530297181,COGS 17,A01,092677,Staff,19,0,75,56
1650530303205,COGS 100,A01,083619,Staff,0,26,60,60
1650530309229,COGS 101A,A01,083621,Davis; Joshua Daniel,0,26,60,60
1650530315252,COGS 101B,A01,091572,Staff,1,5,60,59
1650530321276,COGS 101C,A01,083625,Delgado; Tania,15,0,30,15
1650530327303,COGS 107A,A01,083627,Boyle; Mary E. T.,0,11,60,60
1650530333327,COGS 118A,A01,083075,Staff,0,3,60,60
1650530339354,CSE 3,A50,083646,Miranda; Gregory Joseph,20,0,38,18
1650530339354,CSE 3,A51,083647,Miranda; Gregory Joseph,36,0,37,1
1650530345379,CSE 8A,A50,083650,Miranda; Gregory Joseph,0,29,40,40
1650530351401,CSE 11,A01,083080,Cao; Yingjun,0,94,40,40
1650530357426,CSE 12,A01,083652,Staff,0,17,100,100
1650530363450,CSE 15L,A01,083654,Staff,0,1,50,50
1650530363450,CSE 15L,A02,083655,Staff,0,0,50,50
1650530369488,CSE 20,A01,083657,Staff,51,0,80,29
1650530375512,CSE 30,A01,083084,Eldon; John,0,77,40,40
1650530381538,CSE 100,A01,083659,Cao; Yingjun,0,66,50,50
1650530387565,CSE 134B,A01,083661,Powell; Thomas Allan,0,34,65,65
1650530393588,CSE 140,A01,083663,Staff,0,5,75,75
1650530399612,CSE 140L,A01,083088,Eldon; John,0,11,75,75
1650530405638,CSE 175,A01,083665,Kumar; Rakesh,7,0,25,18
1650530411665,CSE 190,A00,092507,Dubnov; Shlomo,10,0,20,10
1650530417692,ECE 45,A01,083139,Staff,0,1,60,60
1650530423719,ECE 65,A50,083695,Staff,0,6,30,30
1650530429743,ECE 109,A01,091882,Touri; Behrouz,33,0,70,37
1650530435768,ECE 180,A00,083140,Abi Samra; Nicholas Camill,21,0,30,9
1650530435768,ECE 180,B00,083141,Abi Samra; Nicholas Camill,0,0,30,30
1650530441793,MATH 10A,A01,083735,Patchell; Gregory David,5,0,30,25
1650530441793,MATH 10A,A02,083736,Patchell; Gregory David,27,0,30,3
1650530441793,MATH 10A,A03,083737,Patchell; Gregory David,24,0,30,6
1650530447818,MATH 10B,A01,083207,Staff,0,9,30,30
1650530447818,MATH 10B,A02,083208,Staff,0,7,30,30
1650530447818,MATH 10B,B01,083739,Staff,13,0,30,17
1650530447818,MATH 10B,B02,083740,Staff,28,0,30,2
1650530453871,MATH 18,A01,083743,Staff,1,0,30,29
1650530453871,MATH 18,A02,083744,Staff,27,0,30,3
1650530453871,MATH 18,A03,083745,Staff,22,0,30,8
1650530453871,MATH 18,A04,083746,Staff,26,0,30,4
1650530453871,MATH 18,B01,083748,Staff,0,12,30,30
1650530453871,MATH 18,B02,083749,Staff,0,12,30,30
1650530453871,MATH 18,B03,083750,Staff,0,11,30,30
1650530453871,MATH 18,B04,083751,Staff,0,12,30,30
1650530459900,MATH 20A,A01,083754,Staff,22,0,40,18
1650530465928,MATH 20B,A01,083756,Staff,0,11,30,30
1650530465928,MATH 20B,A02,083757,Staff,0,12,30,30
1650530471952,MATH 20C,A01,083760,Staff,0,16,30,30
1650530471952,MATH 20C,A02,083761,Staff,2,14,30,28
1650530471952,MATH 20C,B01,083762,Staff,12,0,30,18
1650530471952,MATH 20C,B02,083763,Staff,28,0,30,2
1650530477976,MATH 20D,A01,083765,Staff,0,1,30,30
1650530477976,MATH 20D,A02,083766,Staff,7,0,30,23
1650530477976,MATH 20D,A03,083767,Staff,25,0,30,5
1650530484001,MATH 20E,A01,083771,Staff,6,0,30,24
1650530484001,MATH 20E,A02,083772,Staff,18,0,30,12
1650530484001,MATH 20E,B01,083773,Staff,0,0,30,30
1650530484001,MATH 20E,B02,083774,Staff,10,0,30,20
1650530490026,MATH 103A,A01,083777,Staff,0,15,30,30
1650530490026,MATH 103A,A02,083778,Staff,0,14,30,30
1650530490026,MATH 103A,B01,083779,Staff,0,13,30,30
1650530490026,MATH 103A,B02,083780,Staff,0,13,30,30
1650530496052,MATH 105,A01,085443,Staff,0,21,30,30
1650530502077,MATH 109,A01,083213,Anzaldo; Leesa B,0,8,30,30
1650530502077,MATH 109,A02,083214,Anzaldo; Leesa B,0,7,30,30
1650530502077,MATH 109,B01,083215,Anzaldo; Leesa B,0,5,30,30
1650530502077,MATH 109,B02,083216,Anzaldo; Leesa B,0,6,30,30
1650530508103,MATH 142A,A01,083219,Chow; Bennett,0,16,30,30
1650530508103,MATH 142A,A02,083220,Chow; Bennett,0,14,30,30
1650530508103,MATH 142A,B01,083221,Chow; Bennett,0,13,30,30
1650530508103,MATH 142A,B02,083222,Chow; Bennett,0,13,30,30
1650530514127,MATH 193A,A01,083224,Staff,0,6,30,30
1650530514127,MATH 193A,A02,083225,Staff,0,5,30,30
1650530514127,MATH 193A,A03,083781,Staff,0,5,30,30
1650530514127,MATH 193A,A04,083782,Staff,0,7,30,30
1650530520155,MATH 197,001,091859,McAuley; Julian John,9998,0,9999,1
1650530526227,COGS 9,A01,083615,Staff,0,16,60,60
1650530532345,COGS 11,A01,083617,Boyle; Mary E. T.,19,0,40,21
1650530538369,COGS 13,A01,083071,Staff,0,35,40,40
1650530544395,COGS 14A,A01,092681,Staff,0,25,100,100
1650530550422,COGS 14B,A01,083073,Cheng; Tzu-Han,0,12,50,50
1650530556445,COGS 17,A01,092677,Staff,19,0,75,56
1650530562469,COGS 100,A01,083619,Staff,0,26,60,60
1650530568497,COGS 101A,A01,083621,Davis; Joshua Daniel,0,26,60,60
1650530574520,COGS 101B,A01,091572,Staff,1,5,60,59
1650530580549,COGS 101C,A01,083625,Delgado; Tania,15,0,30,15
1650530586580,COGS 107A,A01,083627,Boyle; Mary E. T.,0,11,60,60
1650530592606,COGS 118A,A01,083075,Staff,0,3,60,60
1650530598633,CSE 3,A50,083646,Miranda; Gregory Joseph,20,0,38,18
1650530598633,CSE 3,A51,083647,Miranda; Gregory Joseph,36,0,37,1
1650530604660,CSE 8A,A50,083650,Miranda; Gregory Joseph,0,29,40,40
1650530610689,CSE 11,A01,083080,Cao; Yingjun,0,94,40,40
1650530616717,CSE 12,A01,083652,Staff,0,17,100,100
1650530622746,CSE 15L,A01,083654,Staff,0,1,50,50
1650530622746,CSE 15L,A02,083655,Staff,0,0,50,50
1650530628770,CSE 20,A01,083657,Staff,51,0,80,29
1650530634796,CSE 30,A01,083084,Eldon; John,0,77,40,40
1650530640826,CSE 100,A01,083659,Cao; Yingjun,0,66,50,50
1650530646850,CSE 134B,A01,083661,Powell; Thomas Allan,0,34,65,65
1650530652874,CSE 140,A01,083663,Staff,0,5,75,75
1650530658903,CSE 140L,A01,083088,Eldon; John,0,11,75,75
1650530664932,CSE 175,A01,083665,Kumar; Rakesh,7,0,25,18
1650530670957,CSE 190,A00,092507,Dubnov; Shlomo,10,0,20,10
1650530676981,ECE 45,A01,083139,Staff,0,1,60,60
1650530683004,ECE 65,A50,083695,Staff,0,6,30,30
1650530689038,ECE 109,A01,091882,Touri; Behrouz,33,0,70,37
1650530695061,ECE 180,A00,083140,Abi Samra; Nicholas Camill,21,0,30,9
1650530695061,ECE 180,B00,083141,Abi Samra; Nicholas Camill,0,0,30,30
1650530701090,MATH 10A,A01,083735,Patchell; Gregory David,5,0,30,25
1650530701090,MATH 10A,A02,083736,Patchell; Gregory David,27,0,30,3
1650530701090,MATH 10A,A03,083737,Patchell; Gregory David,24,0,30,6
1650530707120,MATH 10B,A01,083207,Staff,0,9,30,30
1650530707120,MATH 10B,A02,083208,Staff,0,7,30,30
1650530707120,MATH 10B,B01,083739,Staff,13,0,30,17
1650530707120,MATH 10B,B02,083740,Staff,28,0,30,2
1650530713146,MATH 18,A01,083743,Staff,1,0,30,29
1650530713146,MATH 18,A02,083744,Staff,27,0,30,3
1650530713146,MATH 18,A03,083745,Staff,22,0,30,8
1650530713146,MATH 18,A04,083746,Staff,26,0,30,4
1650530713146,MATH 18,B01,083748,Staff,0,12,30,30
1650530713146,MATH 18,B02,083749,Staff,0,12,30,30
1650530713146,MATH 18,B03,083750,Staff,0,11,30,30
1650530713146,MATH 18,B04,083751,Staff,0,12,30,30
1650530719184,MATH 20A,A01,083754,Staff,22,0,40,18
1650530725211,MATH 20B,A01,083756,Staff,0,11,30,30
1650530725211,MATH 20B,A02,083757,Staff,0,12,30,30
1650530731236,MATH 20C,A01,083760,Staff,0,16,30,30
1650530731236,MATH 20C,A02,083761,Staff,2,14,30,28
1650530731236,MATH 20C,B01,083762,Staff,12,0,30,18
1650530731236,MATH 20C,B02,083763,Staff,28,0,30,2
1650530737259,MATH 20D,A01,083765,Staff,0,1,30,30
1650530737259,MATH 20D,A02,083766,Staff,7,0,30,23
1650530737259,MATH 20D,A03,083767,Staff,25,0,30,5
1650530743287,MATH 20E,A01,083771,Staff,6,0,30,24
1650530743287,MATH 20E,A02,083772,Staff,18,0,30,12
1650530743287,MATH 20E,B01,083773,Staff,0,0,30,30
1650530743287,MATH 20E,B02,083774,Staff,10,0,30,20
1650530749316,MATH 103A,A01,083777,Staff,0,15,30,30
1650530749316,MATH 103A,A02,083778,Staff,0,14,30,30
1650530749316,MATH 103A,B01,083779,Staff,0,13,30,30
1650530749316,MATH 103A,B02,083780,Staff,0,13,30,30
1650530755340,MATH 105,A01,085443,Staff,0,21,30,30
1650530761365,MATH 109,A01,083213,Anzaldo; Leesa B,0,8,30,30
1650530761365,MATH 109,A02,083214,Anzaldo; Leesa B,0,7,30,30
1650530761365,MATH 109,B01,083215,Anzaldo; Leesa B,0,5,30,30
1650530761365,MATH 109,B02,083216,Anzaldo; Leesa B,0,6,30,30
1650530767391,MATH 142A,A01,083219,Chow; Bennett,0,16,30,30
1650530767391,MATH 142A,A02,083220,Chow; Bennett,0,14,30,30
1650530767391,MATH 142A,B01,083221,Chow; Bennett,0,13,30,30
1650530767391,MATH 142A,B02,083222,Chow; Bennett,0,13,30,30
1650530773418,MATH 193A,A01,083224,Staff,0,6,30,30
1650530773418,MATH 193A,A02,083225,Staff,0,5,30,30
1650530773418,MATH 193A,A03,083781,Staff,0,5,30,30
1650530773418,MATH 193A,A04,083782,Staff,0,7,30,30
1650530779442,MATH 197,001,091859,McAuley; Julian John,9998,0,9999,1
1650530785514,COGS 9,A01,083615,Staff,0,16,60,60
1650530791539,COGS 11,A01,083617,Boyle; Mary E. T.,19,0,40,21
1650530797572,COGS 13,A01,083071,Staff,0,35,40,40
1650530803601,COGS 14A,A01,092681,Staff,0,25,100,100
1650530809637,COGS 14B,A01,083073,Cheng; Tzu-Han,0,12,50,50
1650530815660,COGS 17,A01,092677,Staff,19,0,75,56
1650530821683,COGS 100,A01,083619,Staff,0,26,60,60
1650530827707,COGS 101A,A01,083621,Davis; Joshua Daniel,0,26,60,60
1650530833735,COGS 101B,A01,091572,Staff,1,5,60,59
1650530839760,COGS 101C,A01,083625,Delgado; Tania,15,0,30,15
1650530845784,COGS 107A,A01,083627,Boyle; Mary E. T.,0,11,60,60
1650530851816,COGS 118A,A01,083075,Staff,0,3,60,60
1650530857844,CSE 3,A50,083646,Miranda; Gregory Joseph,20,0,38,18
1650530857844,CSE 3,A51,083647,Miranda; Gregory Joseph,36,0,37,1
1650530863871,CSE 8A,A50,083650,Miranda; Gregory Joseph,0,29,40,40
1650530869903,CSE 11,A01,083080,Cao; Yingjun,0,94,40,40
1650530875925,CSE 12,A01,083652,Staff,0,17,100,100
1650530881952,CSE 15L,A01,083654,Staff,0,1,50,50
1650530881952,CSE 15L,A02,083655,Staff,0,0,50,50
1650530887977,CSE 20,A01,083657,Staff,51,0,80,29
1650530894000,CSE 30,A01,083084,Eldon; John,0,77,40,40
1650530900029,CSE 100,A01,083659,Cao; Yingjun,0,66,50,50
1650530906055,CSE 134B,A01,083661,Powell; Thomas Allan,0,34,65,65
1650530912080,CSE 140,A01,083663,Staff,0,5,75,75
1650530918109,CSE 140L,A01,083088,Eldon; John,0,11,75,75
1650530924135,CSE 175,A01,083665,Kumar; Rakesh,7,0,25,18
1650530930165,CSE 190,A00,092507,Dubnov; Shlomo,10,0,20,10
1650530936189,ECE 45,A01,083139,Staff,0,1,60,60
1650530942217,ECE 65,A50,083695,Staff,0,6,30,30
1650530948250,ECE 109,A01,091882,Touri; Behrouz,33,0,70,37
1650530954274,ECE 180,A00,083140,Abi Samra; Nicholas Camill,21,0,30,9
1650530954274,ECE 180,B00,083141,Abi Samra; Nicholas Camill,0,0,30,30
1650530960305,MATH 10A,A01,083735,Patchell; Gregory David,5,0,30,25
1650530960305,MATH 10A,A02,083736,Patchell; Gregory David,27,0,30,3
1650530960305,MATH 10A,A03,083737,Patchell; Gregory David,24,0,30,6
1650530966333,MATH 10B,A01,083207,Staff,0,9,30,30
1650530966333,MATH 10B,A02,083208,Staff,0,7,30,30
1650530966333,MATH 10B,B01,083739,Staff,13,0,30,17
1650530966333,MATH 10B,B02,083740,Staff,28,0,30,2
1650530972360,MATH 18,A01,083743,Staff,1,0,30,29
1650530972360,MATH 18,A02,083744,Staff,27,0,30,3
1650530972360,MATH 18,A03,083745,Staff,22,0,30,8
1650530972360,MATH 18,A04,083746,Staff,26,0,30,4
1650530972360,MATH 18,B01,083748,Staff,0,12,30,30
1650530972360,MATH 18,B02,083749,Staff,0,12,30,30
1650530972360,MATH 18,B03,083750,Staff,0,11,30,30
1650530972360,MATH 18,B04,083751,Staff,0,12,30,30
1650530978383,MATH 20A,A01,083754,Staff,22,0,40,18
1650530984408,MATH 20B,A01,083756,Staff,0,11,30,30
1650530984408,MATH 20B,A02,083757,Staff,0,12,30,30
1650530990433,MATH 20C,A01,083760,Staff,0,16,30,30
1650530990433,MATH 20C,A02,083761,Staff,2,14,30,28
1650530990433,MATH 20C,B01,083762,Staff,12,0,30,18
1650530990433,MATH 20C,B02,083763,Staff,28,0,30,2
1650530996456,MATH 20D,A01,083765,Staff,0,1,30,30
1650530996456,MATH 20D,A02,083766,Staff,7,0,30,23
1650530996456,MATH 20D,A03,083767,Staff,25,0,30,5
1650531002485,MATH 20E,A01,083771,Staff,6,0,30,24
1650531002485,MATH 20E,A02,083772,Staff,18,0,30,12
1650531002485,MATH 20E,B01,083773,Staff,0,0,30,30
1650531002485,MATH 20E,B02,083774,Staff,10,0,30,20
1650531008542,MATH 103A,A01,083777,Staff,0,15,30,30
1650531008542,MATH 103A,A02,083778,Staff,0,14,30,30
1650531008542,MATH 103A,B01,083779,Staff,0,13,30,30
1650531008542,MATH 103A,B02,083780,Staff,0,13,30,30
1650531014569,MATH 105,A01,085443,Staff,0,21,30,30
1650531020592,MATH 109,A01,083213,Anzaldo; Leesa B,0,8,30,30
1650531020592,MATH 109,A02,083214,Anzaldo; Leesa B,0,7,30,30
1650531020592,MATH 109,B01,083215,Anzaldo; Leesa B,0,5,30,30
1650531020592,MATH 109,B02,083216,Anzaldo; Leesa B,0,6,30,30
1650531026618,MATH 142A,A01,083219,Chow; Bennett,0,16,30,30
1650531026618,MATH 142A,A02,083220,Chow; Bennett,0,14,30,30
1650531026618,MATH 142A,B01,083221,Chow; Bennett,0,13,30,30
1650531026618,MATH 142A,B02,083222,Chow; Bennett,0,13,30,30
1650531032643,MATH 193A,A01,083224,Staff,0,6,30,30
1650531032643,MATH 193A,A02,083225,Staff,0,5,30,30
1650531032643,MATH 193A,A03,083781,Staff,0,5,30,30
1650531032643,MATH 193A,A04,083782,Staff,0,7,30,30
1650531038664,MATH 197,001,091859,McAuley; Julian John,9998,0,9999,1
1650531044721,COGS 9,A01,083615,Staff,0,16,60,60
1650531050748,COGS 11,A01,083617,Boyle; Mary E. T.,19,0,40,21
1650531056773,COGS 13,A01,083071,Staff,0,35,40,40
1650531062801,COGS 14A,A01,092681,Staff,0,25,100,100
1650531068841,COGS 14B,A01,083073,Cheng; Tzu-Han,0,12,50,50
1650531074875,COGS 17,A01,092677,Staff,19,0,75,56
1650531080898,COGS 100,A01,083619,Staff,0,26,60,60
1650531086923,COGS 101A,A01,083621,Davis; Joshua Daniel,0,26,60,60
1650531092947,COGS 101B,A01,091572,Staff,1,5,60,59
1650531098976,COGS 101C,A01,083625,Delgado; Tania,15,0,30,15
1650531105001,COGS 107A,A01,083627,Boyle; Mary E. T.,0,11,60,60
1650531111041,COGS 118A,A01,083075,Staff,0,3,60,60
1650531117067,CSE 3,A50,083646,Miranda; Gregory Joseph,20,0,38,18
1650531117067,CSE 3,A51,083647,Miranda; Gregory Joseph,36,0,37,1
1650531123091,CSE 8A,A50,083650,Miranda; Gregory Joseph,0,29,40,40
1650531129206,CSE 11,A01,083080,Cao; Yingjun,0,94,40,40
1650531135231,CSE 12,A01,083652,Staff,0,17,100,100
1650531141255,CSE 15L,A01,083654,Staff,0,1,50,50
1650531141255,CSE 15L,A02,083655,Staff,0,0,50,50
1650531147279,CSE 20,A01,083657,Staff,51,0,80,29
1650531153305,CSE 30,A01,083084,Eldon; John,0,77,40,40
1650531159329,CSE 100,A01,083659,Cao; Yingjun,0,66,50,50
1650531165355,CSE 134B,A01,083661,Powell; Thomas Allan,0,34,65,65
1650531171380,CSE 140,A01,083663,Staff,0,5,75,75
1650531177411,CSE 140L,A01,083088,Eldon; John,0,11,75,75
1650531183433,CSE 175,A01,083665,Kumar; Rakesh,7,0,25,18
1650531189458,CSE 190,A00,092507,Dubnov; Shlomo,10,0,20,10
1650531195479,ECE 45,A01,083139,Staff,0,1,60,60
1650531201502,ECE 65,A50,083695,Staff,0,6,30,30
1650531207529,ECE 109,A01,091882,Touri; Behrouz,33,0,70,37
1650531213552,ECE 180,A00,083140,Abi Samra; Nicholas Camill,21,0,30,9
1650531213552,ECE 180,B00,083141,Abi Samra; Nicholas Camill,0,0,30,30
1650531219581,MATH 10A,A01,083735,Patchell; Gregory David,5,0,30,25
1650531219581,MATH 10A,A02,083736,Patchell; Gregory David,27,0,30,3
1650531219581,MATH 10A,A03,083737,Patchell; Gregory David,24,0,30,6
1650531225603,MATH 10B,A01,083207,Staff,0,9,30,30
1650531225603,MATH 10B,A02,083208,Staff,0,7,30,30
1650531225603,MATH 10B,B01,083739,Staff,13,0,30,17
1650531225603,MATH 10B,B02,083740,Staff,28,0,30,2
1650531231628,MATH 18,A01,083743,Staff,1,0,30,29
1650531231628,MATH 18,A02,083744,Staff,27,0,30,3
1650531231628,MATH 18,A03,083745,Staff,22,0,30,8
1650531231628,MATH 18,A04,083746,Staff,26,0,30,4
1650531231628,MATH 18,B01,083748,Staff,0,12,30,30
1650531231628,MATH 18,B02,083749,Staff,0,12,30,30
1650531231628,MATH 18,B03,083750,Staff,0,11,30,30
1650531231628,MATH 18,B04,083751,Staff,0,12,30,30
1650531237655,MATH 20A,A01,083754,Staff,22,0,40,18
1650531243683,MATH 20B,A01,083756,Staff,0,11,30,30
1650531243683,MATH 20B,A02,083757,Staff,0,12,30,30
1650531249709,MATH 20C,A01,083760,Staff,0,16,30,30
1650531249709,MATH 20C,A02,083761,Staff,2,14,30,28
1650531249709,MATH 20C,B01,083762,Staff,12,0,30,18
1650531249709,MATH 20C,B02,083763,Staff,28,0,30,2
1650531255737,MATH 20D,A01,083765,Staff,0,1,30,30
1650531255737,MATH 20D,A02,083766,Staff,7,0,30,23
1650531255737,MATH 20D,A03,083767,Staff,25,0,30,5
1650531261763,MATH 20E,A01,083771,Staff,6,0,30,24
1650531261763,MATH 20E,A02,083772,Staff,18,0,30,12
1650531261763,MATH 20E,B01,083773,Staff,0,0,30,30
1650531261763,MATH 20E,B02,083774,Staff,10,0,30,20
1650531267788,MATH 103A,A01,083777,Staff,0,15,30,30
1650531267788,MATH 103A,A02,083778,Staff,0,14,30,30
1650531267788,MATH 103A,B01,083779,Staff,0,13,30,30
1650531267788,MATH 103A,B02,083780,Staff,0,13,30,30
1650531273811,MATH 105,A01,085443,Staff,0,21,30,30
1650531279839,MATH 109,A01,083213,Anzaldo; Leesa B,0,8,30,30
1650531279839,MATH 109,A02,083214,Anzaldo; Leesa B,0,7,30,30
1650531279839,MATH 109,B01,083215,Anzaldo; Leesa B,0,5,30,30
1650531279839,MATH 109,B02,083216,Anzaldo; Leesa B,0,6,30,30
1650531285867,MATH 142A,A01,083219,Chow; Bennett,0,16,30,30
1650531285867,MATH 142A,A02,083220,Chow; Bennett,0,14,30,30
1650531285867,MATH 142A,B01,083221,Chow; Bennett,0,13,30,30
1650531285867,MATH 142A,B02,083222,Chow; Bennett,0,13,30,30
1650531291894,MATH 193A,A01,083224,Staff,0,6,30,30
1650531291894,MATH 193A,A02,083225,Staff,0,5,30,30
1650531291894,MATH 193A,A03,083781,Staff,0,5,30,30
1650531291894,MATH 193A,A04,083782,Staff,0,7,30,30
1650531297921,MATH 197,001,091859,McAuley; Julian John,9998,0,9999,1
1650531303984,COGS 9,A01,083615,Staff,0,16,60,60
1650531310009,COGS 11,A01,083617,Boyle; Mary E. T.,19,0,40,21
1650531316036,COGS 13,A01,083071,Staff,0,35,40,40
1650531322063,COGS 14A,A01,092681,Staff,0,25,100,100
1650531328087,COGS 14B,A01,083073,Cheng; Tzu-Han,0,12,50,50
1650531334118,COGS 17,A01,092677,Staff,19,0,75,56
1650531340140,COGS 100,A01,083619,Staff,0,26,60,60
1650531346169,COGS 101A,A01,083621,Davis; Joshua Daniel,0,26,60,60
1650531352194,COGS 101B,A01,091572,Staff,1,5,60,59
1650531358222,COGS 101C,A01,083625,Delgado; Tania,15,0,30,15
1650531364245,COGS 107A,A01,083627,Boyle; Mary E. T.,0,11,60,60
1650531370269,COGS 118A,A01,083075,Staff,0,3,60,60
1650531376300,CSE 3,A50,083646,Miranda; Gregory Joseph,20,0,38,18
1650531376300,CSE 3,A51,083647,Miranda; Gregory Joseph,36,0,37,1
1650531382327,CSE 8A,A50,083650,Miranda; Gregory Joseph,0,29,40,40
1650531388354,CSE 11,A01,083080,Cao; Yingjun,0,94,40,40
1650531394377,CSE 12,A01,083652,Staff,0,17,100,100
1650531400403,CSE 15L,A01,083654,Staff,0,1,50,50
1650531400403,CSE 15L,A02,083655,Staff,0,0,50,50
1650531406432,CSE 20,A01,083657,Staff,51,0,80,29
1650531412457,CSE 30,A01,083084,Eldon; John,0,77,40,40
1650531418481,CSE 100,A01,083659,Cao; Yingjun,0,66,50,50
1650531424505,CSE 134B,A01,083661,Powell; Thomas Allan,0,34,65,65
1650531430532,CSE 140,A01,083663,Staff,0,5,75,75
1650531436556,CSE 140L,A01,083088,Eldon; John,0,11,75,75
1650531442583,CSE 175,A01,083665,Kumar; Rakesh,7,0,25,18
1650531448607,CSE 190,A00,092507,Dubnov; Shlomo,10,0,20,10
1650531454632,ECE 45,A01,083139,Staff,0,1,60,60
1650531460656,ECE 65,A50,083695,Staff,0,6,30,30
1650531466683,ECE 109,A01,091882,Touri; Behrouz,33,0,70,37
1650531472705,ECE 180,A00,083140,Abi Samra; Nicholas Camill,21,0,30,9
1650531472705,ECE 180,B00,083141,Abi Samra; Nicholas Camill,0,0,30,30
1650531478732,MATH 10A,A01,083735,Patchell; Gregory David,5,0,30,25
1650531478732,MATH 10A,A02,083736,Patchell; Gregory David,27,0,30,3
1650531478732,MATH 10A,A03,083737,Patchell; Gregory David,24,0,30,6
1650531484761,MATH 10B,A01,083207,Staff,0,9,30,30
1650531484761,MATH 10B,A02,083208,Staff,0,7,30,30
1650531484761,MATH 10B,B01,083739,Staff,13,0,30,17
1650531484761,MATH 10B,B02,083740,Staff,28,0,30,2
1650531490790,MATH 18,A01,083743,Staff,1,0,30,29
1650531490790,MATH 18,A02,083744,Staff,27,0,30,3
1650531490790,MATH 18,A03,083745,Staff,22,0,30,8
1650531490790,MATH 18,A04,083746,Staff,26,0,30,4
1650531490790,MATH 18,B01,083748,Staff,0,12,30,30
1650531490790,MATH 18,B02,083749,Staff,0,12,30,30
1650531490790,MATH 18,B03,083750,Staff,0,11,30,30
1650531490790,MATH 18,B04,083751,Staff,0,12,30,30
1650531496814,MATH 20A,A01,083754,Staff,22,0,40,18
1650531502842,MATH 20B,A01,083756,Staff,0,11,30,30
1650531502842,MATH 20B,A02,083757,Staff,0,12,30,30
1650531508870,MATH 20C,A01,083760,Staff,0,16,30,30
1650531508870,MATH 20C,A02,083761,Staff,2,14,30,28
1650531508870,MATH 20C,B01,083762,Staff,12,0,30,18
1650531508870,MATH 20C,B02,083763,Staff,28,0,30,2
1650531514897,MATH 20D,A01,083765,Staff,0,1,30,30
1650531514897,MATH 20D,A02,083766,Staff,7,0,30,23
1650531514897,MATH 20D,A03,083767,Staff,25,0,30,5
1650531520925,MATH 20E,A01,083771,Staff,6,0,30,24
1650531520925,MATH 20E,A02,083772,Staff,18,0,30,12
1650531520925,MATH 20E,B01,083773,Staff,0,0,30,30
1650531520925,MATH 20E,B02,083774,Staff,10,0,30,20
1650531526955,MATH 103A,A01,083777,Staff,0,15,30,30
1650531526955,MATH 103A,A02,083778,Staff,0,14,30,30
1650531526955,MATH 103A,B01,083779,Staff,0,13,30,30
1650531526955,MATH 103A,B02,083780,Staff,0,13,30,30
1650531532977,MATH 105,A01,085443,Staff,0,21,30,30
1650531539000,MATH 109,A01,083213,Anzaldo; Leesa B,0,8,30,30
1650531539000,MATH 109,A02,083214,Anzaldo; Leesa B,0,7,30,30
1650531539000,MATH 109,B01,083215,Anzaldo; Leesa B,0,5,30,30
1650531539000,MATH 109,B02,083216,Anzaldo; Leesa B,0,6,30,30
1650531545024,MATH 142A,A01,083219,Chow; Bennett,0,16,30,30
1650531545024,MATH 142A,A02,083220,Chow; Bennett,0,14,30,30
1650531545024,MATH 142A,B01,083221,Chow; Bennett,0,13,30,30
1650531545024,MATH 142A,B02,083222,Chow; Bennett,0,13,30,30
1650531551056,MATH 193A,A01,083224,Staff,0,6,30,30
1650531551056,MATH 193A,A02,083225,Staff,0,5,30,30
1650531551056,MATH 193A,A03,083781,Staff,0,5,30,30
1650531551056,MATH 193A,A04,083782,Staff,0,7,30,30
1650531557079,MATH 197,001,091859,McAuley; Julian John,9998,0,9999,1
1650531563131,COGS 9,A01,083615,Staff,0,16,60,60
1650531569158,COGS 11,A01,083617,Boyle; Mary E. T.,19,0,40,21
1650531575184,COGS 13,A01,083071,Staff,0,35,40,40
1650531581208,COGS 14A,A01,092681,Staff,0,25,100,100
1650531587231,COGS 14B,A01,083073,Cheng; Tzu-Han,0,12,50,50
1650531593255,COGS 17,A01,092677,Staff,19,0,75,56
1650531599285,COGS 100,A01,083619,Staff,0,26,60,60
1650531605312,COGS 101A,A01,083621,Davis; Joshua Daniel,0,26,60,60
1650531611341,COGS 101B,A01,091572,Staff,1,5,60,59
1650531617368,COGS 101C,A01,083625,Delgado; Tania,15,0,30,15
1650531623395,COGS 107A,A01,083627,Boyle; Mary E. T.,0,11,60,60
1650531629430,COGS 118A,A01,083075,Staff,0,3,60,60
1650531635458,CSE 3,A50,083646,Miranda; Gregory Joseph,20,0,38,18
1650531635458,CSE 3,A51,083647,Miranda; Gregory Joseph,36,0,37,1
1650531641485,CSE 8A,A50,083650,Miranda; Gregory Joseph,0,29,40,40
1650531647509,CSE 11,A01,083080,Cao; Yingjun,0,94,40,40
1650531653534,CSE 12,A01,083652,Staff,0,17,100,100
1650531659561,CSE 15L,A01,083654,Staff,0,1,50,50
1650531659561,CSE 15L,A02,083655,Staff,0,0,50,50
1650531665593,CSE 20,A01,083657,Staff,51,0,80,29
1650531671620,CSE 30,A01,083084,Eldon; John,0,77,40,40
1650531677643,CSE 100,A01,083659,Cao; Yingjun,0,66,50,50
1650531683667,CSE 134B,A01,083661,Powell; Thomas Allan,0,34,65,65
1650531689695,CSE 140,A01,083663,Staff,0,5,75,75
1650531695719,CSE 140L,A01,083088,Eldon; John,0,11,75,75
1650531701749,CSE 175,A01,083665,Kumar; Rakesh,7,0,25,18
1650531707774,CSE 190,A00,092507,Dubnov; Shlomo,10,0,20,10
1650531713798,ECE 45,A01,083139,Staff,0,1,60,60
1650531719822,ECE 65,A50,083695,Staff,0,6,30,30
1650531725945,ECE 109,A01,091882,Touri; Behrouz,33,0,70,37
1650531731972,ECE 180,A00,083140,Abi Samra; Nicholas Camill,21,0,30,9
1650531731972,ECE 180,B00,083141,Abi Samra; Nicholas Camill,0,0,30,30
1650531738008,MATH 10A,A01,083735,Patchell; Gregory David,5,0,30,25
1650531738008,MATH 10A,A02,083736,Patchell; Gregory David,27,0,30,3
1650531738008,MATH 10A,A03,083737,Patchell; Gregory David,24,0,30,6
1650531744035,MATH 10B,A01,083207,Staff,0,9,30,30
1650531744035,MATH 10B,A02,083208,Staff,0,7,30,30
1650531744035,MATH 10B,B01,083739,Staff,13,0,30,17
1650531744035,MATH 10B,B02,083740,Staff,28,0,30,2
1650531750065,MATH 18,A01,083743,Staff,1,0,30,29
1650531750065,MATH 18,A02,083744,Staff,27,0,30,3
1650531750065,MATH 18,A03,083745,Staff,22,0,30,8
1650531750065,MATH 18,A04,083746,Staff,26,0,30,4
1650531750065,MATH 18,B01,083748,Staff,0,12,30,30
1650531750065,MATH 18,B02,083749,Staff,0,12,30,30
1650531750065,MATH 18,B03,083750,Staff,0,11,30,30
1650531750065,MATH 18,B04,083751,Staff,0,12,30,30
1650531756090,MATH 20A,A01,083754,Staff,22,0,40,18
1650531762116,MATH 20B,A01,083756,Staff,0,11,30,30
1650531762116,MATH 20B,A02,083757,Staff,0,12,30,30
1650531768139,MATH 20C,A01,083760,Staff,0,16,30,30
1650531768139,MATH 20C,A02,083761,Staff,2,14,30,28
1650531768139,MATH 20C,B01,083762,Staff,12,0,30,18
1650531768139,MATH 20C,B02,083763,Staff,28,0,30,2
1650531774163,MATH 20D,A01,083765,Staff,0,1,30,30
1650531774163,MATH 20D,A02,083766,Staff,7,0,30,23
1650531774163,MATH 20D,A03,083767,Staff,25,0,30,5
1650531780188,MATH 20E,A01,083771,Staff,6,0,30,24
1650531780188,MATH 20E,A02,083772,Staff,18,0,30,12
1650531780188,MATH 20E,B01,083773,Staff,0,0,30,30
1650531780188,MATH 20E,B02,083774,Staff,10,0,30,20
1650531786214,MATH 103A,A01,083777,Staff,0,15,30,30
1650531786214,MATH 103A,A02,083778,Staff,0,14,30,30
1650531786214,MATH 103A,B01,083779,Staff,0,13,30,30
1650531786214,MATH 103A,B02,083780,Staff,0,13,30,30
1650531792236,MATH 105,A01,085443,Staff,0,21,30,30
1650531798261,MATH 109,A01,083213,Anzaldo; Leesa B,0,8,30,30
1650531798261,MATH 109,A02,083214,Anzaldo; Leesa B,0,7,30,30
1650531798261,MATH 109,B01,083215,Anzaldo; Leesa B,0,5,30,30
1650531798261,MATH 109,B02,083216,Anzaldo; Leesa B,0,6,30,30
1650531804283,MATH 142A,A01,083219,Chow; Bennett,0,16,30,30
1650531804283,MATH 142A,A02,083220,Chow; Bennett,0,14,30,30
1650531804283,MATH 142A,B01,083221,Chow; Bennett,0,13,30,30
1650531804283,MATH 142A,B02,083222,Chow; Bennett,0,13,30,30
1650531810307,MATH 193A,A01,083224,Staff,0,6,30,30
1650531810307,MATH 193A,A02,083225,Staff,0,5,30,30
1650531810307,MATH 193A,A03,083781,Staff,0,5,30,30
1650531810307,MATH 193A,A04,083782,Staff,0,7,30,30
1650531816345,MATH 197,001,091859,McAuley; Julian John,9998,0,9999,1
1650531822433,COGS 9,A01,083615,Staff,0,16,60,60
1650531828460,COGS 11,A01,083617,Boyle; Mary E. T.,19,0,40,21
1650531834488,COGS 13,A01,083071,Staff,0,35,40,40
1650531840519,COGS 14A,A01,092681,Staff,0,25,100,100
1650531846550,COGS 14B,A01,083073,Cheng; Tzu-Han,0,12,50,50
1650531852574,COGS 17,A01,092677,Staff,19,0,75,56
1650531858599,COGS 100,A01,083619,Staff,0,26,60,60
1650531864622,COGS 101A,A01,083621,Davis; Joshua Daniel,0,26,60,60
1650531870648,COGS 101B,A01,091572,Staff,1,5,60,59
1650531876673,COGS 101C,A01,083625,Delgado; Tania,15,0,30,15
1650531882695,COGS 107A,A01,083627,Boyle; Mary E. T.,0,11,60,60
1650531888719,COGS 118A,A01,083075,Staff,0,3,60,60
1650531894745,CSE 3,A50,083646,Miranda; Gregory Joseph,20,0,38,18
1650531894745,CSE 3,A51,083647,Miranda; Gregory Joseph,36,0,37,1
1650531900770,CSE 8A,A50,083650,Miranda; Gregory Joseph,0,29,40,40
1650531906802,CSE 11,A01,083080,Cao; Yingjun,0,94,40,40
1650531912827,CSE 12,A01,083652,Staff,0,17,100,100
1650531918854,CSE 15L,A01,083654,Staff,0,1,50,50
1650531918854,CSE 15L,A02,083655,Staff,0,0,50,50
1650531924880,CSE 20,A01,083657,Staff,51,0,80,29
1650531930905,CSE 30,A01,083084,Eldon; John,0,77,40,40
1650531936931,CSE 100,A01,083659,Cao; Yingjun,0,66,50,50
1650531942958,CSE 134B,A01,083661,Powell; Thomas Allan,0,34,65,65
1650531948984,CSE 140,A01,083663,Staff,0,5,75,75
1650531955010,CSE 140L,A01,083088,Eldon; John,0,11,75,75
1650531961043,CSE 175,A01,083665,Kumar; Rakesh,7,0,25,18
1650531967069,CSE 190,A00,092507,Dubnov; Shlomo,10,0,20,10
1650531973098,ECE 45,A01,083139,Staff,0,1,60,60
1650531979121,ECE 65,A50,083695,Staff,0,6,30,30
1650531985145,ECE 109,A01,091882,Touri; Behrouz,33,0,70,37
1650531991171,ECE 180,A00,083140,Abi Samra; Nicholas Camill,21,0,30,9
1650531991171,ECE 180,B00,083141,Abi Samra; Nicholas Camill,0,0,30,30
1650531997198,MATH 10A,A01,083735,Patchell; Gregory David,5,0,30,25
1650531997198,MATH 10A,A02,083736,Patchell; Gregory David,27,0,30,3
1650531997198,MATH 10A,A03,083737,Patchell; Gregory David,24,0,30,6
1650532003225,MATH 10B,A01,083207,Staff,0,9,30,30
1650532003225,MATH 10B,A02,083208,Staff,0,7,30,30
1650532003225,MATH 10B,B01,083739,Staff,13,0,30,17
1650532003225,MATH 10B,B02,083740,Staff,28,0,30,2
1650532009252,MATH 18,A01,083743,Staff,1,0,30,29
1650532009252,MATH 18,A02,083744,Staff,27,0,30,3
1650532009252,MATH 18,A03,083745,Staff,22,0,30,8
1650532009252,MATH 18,A04,083746,Staff,26,0,30,4
1650532009252,MATH 18,B01,083748,Staff,0,12,30,30
1650532009252,MATH 18,B02,083749,Staff,0,12,30,30
1650532009252,MATH 18,B03,083750,Staff,0,11,30,30
1650532009252,MATH 18,B04,083751,Staff,0,12,30,30
1650532015280,MATH 20A,A01,083754,Staff,22,0,40,18
1650532021305,MATH 20B,A01,083756,Staff,0,11,30,30
1650532021305,MATH 20B,A02,083757,Staff,0,12,30,30
1650532027330,MATH 20C,A01,083760,Staff,0,16,30,30
1650532027330,MATH 20C,A02,083761,Staff,2,14,30,28
1650532027330,MATH 20C,B01,083762,Staff,12,0,30,18
1650532027330,MATH 20C,B02,083763,Staff,28,0,30,2
1650532033354,MATH 20D,A01,083765,Staff,0,1,30,30
1650532033354,MATH 20D,A02,083766,Staff,7,0,30,23
1650532033354,MATH 20D,A03,083767,Staff,25,0,30,5
1650532039383,MATH 20E,A01,083771,Staff,6,0,30,24
1650532039383,MATH 20E,A02,083772,Staff,18,0,30,12
1650532039383,MATH 20E,B01,083773,Staff,0,0,30,30
1650532039383,MATH 20E,B02,083774,Staff,10,0,30,20
1650532045412,MATH 103A,A01,083777,Staff,0,15,30,30
1650532045412,MATH 103A,A02,083778,Staff,0,14,30,30
1650532045412,MATH 103A,B01,083779,Staff,0,13,30,30
1650532045412,MATH 103A,B02,083780,Staff,0,13,30,30
1650532051436,MATH 105,A01,085443,Staff,0,21,30,30
1650532057465,MATH 109,A01,083213,Anzaldo; Leesa B,0,8,30,30
1650532057465,MATH 109,A02,083214,Anzaldo; Leesa B,0,7,30,30
1650532057465,MATH 109,B01,083215,Anzaldo; Leesa B,0,5,30,30
1650532057465,MATH 109,B02,083216,Anzaldo; Leesa B,0,6,30,30
1650532063495,MATH 142A,A01,083219,Chow; Bennett,0,16,30,30
1650532063495,MATH 142A,A02,083220,Chow; Bennett,0,14,30,30
1650532063495,MATH 142A,B01,083221,Chow; Bennett,0,13,30,30
1650532063495,MATH 142A,B02,083222,Chow; Bennett,0,13,30,30
1650532069519,MATH 193A,A01,083224,Staff,0,6,30,30
1650532069519,MATH 193A,A02,083225,Staff,0,5,30,30
1650532069519,MATH 193A,A03,083781,Staff,0,5,30,30
1650532069519,MATH 193A,A04,083782,Staff,0,7,30,30
1650532075546,MATH 197,001,091859,McAuley; Julian John,9998,0,9999,1
1650532081603,COGS 9,A01,083615,Staff,0,16,60,60
1650532087629,COGS 11,A01,083617,Boyle; Mary E. T.,19,0,40,21
1650532093655,COGS 13,A01,083071,Staff,0,35,40,40
1650532099677,COGS 14A,A01,092681,Staff,0,25,100,100
1650532105699,COGS 14B,A01,083073,Cheng; Tzu-Han,0,12,50,50
1650532111723,COGS 17,A01,092677,Staff,19,0,75,56
1650532117752,COGS 100,A01,083619,Staff,0,26,60,60
1650532123775,COGS 101A,A01,083621,Davis; Joshua Daniel,0,26,60,60
1650532129798,COGS 101B,A01,091572,Staff,1,5,60,59
1650532135825,COGS 101C,A01,083625,Delgado; Tania,15,0,30,15
1650532141849,COGS 107A,A01,083627,Boyle; Mary E. T.,0,11,60,60
1650532147872,COGS 118A,A01,083075,Staff,0,3,60,60
1650532153898,CSE 3,A50,083646,Miranda; Gregory Joseph,20,0,38,18
1650532153898,CSE 3,A51,083647,Miranda; Gregory Joseph,36,0,37,1
1650532159926,CSE 8A,A50,083650,Miranda; Gregory Joseph,0,29,40,40
1650532165962,CSE 11,A01,083080,Cao; Yingjun,0,94,40,40
1650532171988,CSE 12,A01,083652,Staff,0,17,100,100
1650532178013,CSE 15L,A01,083654,Staff,0,1,50,50
1650532178013,CSE 15L,A02,083655,Staff,0,0,50,50
1650532184037,CSE 20,A01,083657,Staff,51,0,80,29
1650532190074,CSE 30,A01,083084,Eldon; John,0,77,40,40
1650532196102,CSE 100,A01,083659,Cao; Yingjun,0,66,50,50
1650532202135,CSE 134B,A01,083661,Powell; Thomas Allan,0,34,65,65
1650532208159,CSE 140,A01,083663,Staff,0,5,75,75
1650532214181,CSE 140L,A01,083088,Eldon; John,0,11,75,75
1650532220204,CSE 175,A01,083665,Kumar; Rakesh,7,0,25,18
1650532226231,CSE 190,A00,092507,Dubnov; Shlomo,10,0,20,10
1650532232258,ECE 45,A01,083139,Staff,0,1,60,60
1650532238286,ECE 65,A50,083695,Staff,0,6,30,30
1650532244310,ECE 109,A01,091882,Touri; Behrouz,33,0,70,37
1650532250334,ECE 180,A00,083140,Abi Samra; Nicholas Camill,21,0,30,9
1650532250334,ECE 180,B00,083141,Abi Samra; Nicholas Camill,0,0,30,30
1650532256363,MATH 10A,A01,083735,Patchell; Gregory David,5,0,30,25
1650532256363,MATH 10A,A02,083736,Patchell; Gregory David,27,0,30,3
1650532256363,MATH 10A,A03,083737,Patchell; Gregory David,24,0,30,6
1650532262391,MATH 10B,A01,083207,Staff,0,9,30,30
1650532262391,MATH 10B,A02,083208,Staff,0,7,30,30
1650532262391,MATH 10B,B01,083739,Staff,13,0,30,17
1650532262391,MATH 10B,B02,083740,Staff,28,0,30,2
1650532268418,MATH 18,A01,083743,Staff,1,0,30,29
1650532268418,MATH 18,A02,083744,Staff,27,0,30,3
1650532268418,MATH 18,A03,083745,Staff,22,0,30,8
1650532268418,MATH 18,A04,083746,Staff,26,0,30,4
1650532268418,MATH 18,B01,083748,Staff,0,12,30,30
1650532268418,MATH 18,B02,083749,Staff,0,12,30,30
1650532268418,MATH 18,B03,083750,Staff,0,11,30,30
1650532268418,MATH 18,B04,083751,Staff,0,12,30,30
1650532274442,MATH 20A,A01,083754,Staff,22,0,40,18
1650532280474,MATH 20B,A01,083756,Staff,0,11,30,30
1650532280474,MATH 20B,A02,083757,Staff,0,12,30,30
1650532286499,MATH 20C,A01,083760,Staff,0,16,30,30
1650532286499,MATH 20C,A02,083761,Staff,2,14,30,28
1650532286499,MATH 20C,B01,083762,Staff,12,0,30,18
1650532286499,MATH 20C,B02,083763,Staff,28,0,30,2
1650532292523,MATH 20D,A01,083765,Staff,0,1,30,30
1650532292523,MATH 20D,A02,083766,Staff,7,0,30,23
1650532292523,MATH 20D,A03,083767,Staff,25,0,30,5
1650532298554,MATH 20E,A01,083771,Staff,6,0,30,24
1650532298554,MATH 20E,A02,083772,Staff,18,0,30,12
1650532298554,MATH 20E,B01,083773,Staff,0,0,30,30
1650532298554,MATH 20E,B02,083774,Staff,10,0,30,20
1650532304579,MATH 103A,A01,083777,Staff,0,15,30,30
1650532304579,MATH 103A,A02,083778,Staff,0,14,30,30
1650532304579,MATH 103A,B01,083779,Staff,0,13,30,30
1650532304579,MATH 103A,B02,083780,Staff,0,13,30,30
1650532310601,MATH 105,A01,085443,Staff,0,21,30,30
1650532316630,MATH 109,A01,083213,Anzaldo; Leesa B,0,8,30,30
1650532316630,MATH 109,A02,083214,Anzaldo; Leesa B,0,7,30,30
1650532316630,MATH 109,B01,083215,Anzaldo; Leesa B,0,5,30,30
1650532316630,MATH 109,B02,083216,Anzaldo; Leesa B,0,6,30,30
1650532322750,MATH 142A,A01,083219,Chow; Bennett,0,16,30,30
1650532322750,MATH 142A,A02,083220,Chow; Bennett,0,14,30,30
1650532322750,MATH 142A,B01,083221,Chow; Bennett,0,13,30,30
1650532322750,MATH 142A,B02,083222,Chow; Bennett,0,13,30,30
1650532328778,MATH 193A,A01,083224,Staff,0,6,30,30
1650532328778,MATH 193A,A02,083225,Staff,0,5,30,30
1650532328778,MATH 193A,A03,083781,Staff,0,5,30,30
1650532328778,MATH 193A,A04,083782,Staff,0,7,30,30
1650532334803,MATH 197,001,091859,McAuley; Julian John,9998,0,9999,1
1650532340863,COGS 9,A01,083615,Staff,0,16,60,60
1650532346898,COGS 11,A01,083617,Boyle; Mary E. T.,19,0,40,21
1650532352922,COGS 13,A01,083071,Staff,0,35,40,40
1650532358945,COGS 14A,A01,092681,Staff,0,25,100,100
1650532364969,COGS 14B,A01,083073,Cheng; Tzu-Han,0,12,50,50
1650532370992,COGS 17,A01,092677,Staff,19,0,75,56
1650532377016,COGS 100,A01,083619,Staff,0,26,60,60
1650532383041,COGS 101A,A01,083621,Davis; Joshua Daniel,0,26,60,60
1650532389066,COGS 101B,A01,091572,Staff,1,5,60,59
1650532395091,COGS 101C,A01,083625,Delgado; Tania,15,0,30,15
1650532401118,COGS 107A,A01,083627,Boyle; Mary E. T.,0,11,60,60
1650532407145,COGS 118A,A01,083075,Staff,0,3,60,60
1650532413172,CSE 3,A50,083646,Miranda; Gregory Joseph,20,0,38,18
1650532413172,CSE 3,A51,083647,Miranda; Gregory Joseph,36,0,37,1
1650532419196,CSE 8A,A50,083650,Miranda; Gregory Joseph,0,29,40,40
1650532425219,CSE 11,A01,083080,Cao; Yingjun,0,94,40,40
1650532431246,CSE 12,A01,083652,Staff,0,17,100,100
1650532437270,CSE 15L,A01,083654,Staff,0,1,50,50
1650532437270,CSE 15L,A02,083655,Staff,0,0,50,50
1650532443295,CSE 20,A01,083657,Staff,51,0,80,29
1650532449318,CSE 30,A01,083084,Eldon; John,0,77,40,40
1650532455342,CSE 100,A01,083659,Cao; Yingjun,0,66,50,50
1650532461367,CSE 134B,A01,083661,Powell; Thomas Allan,0,34,65,65
1650532467390,CSE 140,A01,083663,Staff,0,5,75,75
1650532473419,CSE 140L,A01,083088,Eldon; John,0,11,75,75
1650532479444,CSE 175,A01,083665,Kumar; Rakesh,7,0,25,18
1650532485466,CSE 190,A00,092507,Dubnov; Shlomo,10,0,20,10
1650532491488,ECE 45,A01,083139,Staff,0,1,60,60
1650532497510,ECE 65,A50,083695,Staff,0,6,30,30
1650532503534,ECE 109,A01,091882,Touri; Behrouz,33,0,70,37
1650532509556,ECE 180,A00,083140,Abi Samra; Nicholas Camill,21,0,30,9
1650532509556,ECE 180,B00,083141,Abi Samra; Nicholas Camill,0,0,30,30
1650532515580,MATH 10A,A01,083735,Patchell; Gregory David,5,0,30,25
1650532515580,MATH 10A,A02,083736,Patchell; Gregory David,27,0,30,3
1650532515580,MATH 10A,A03,083737,Patchell; Gregory David,24,0,30,6
1650532521607,MATH 10B,A01,083207,Staff,0,9,30,30
1650532521607,MATH 10B,A02,083208,Staff,0,7,30,30
1650532521607,MATH 10B,B01,083739,Staff,13,0,30,17
1650532521607,MATH 10B,B02,083740,Staff,28,0,30,2
1650532527633,MATH 18,A01,083743,Staff,1,0,30,29
1650532527633,MATH 18,A02,083744,Staff,27,0,30,3
1650532527633,MATH 18,A03,083745,Staff,22,0,30,8
1650532527633,MATH 18,A04,083746,Staff,26,0,30,4
1650532527633,MATH 18,B01,083748,Staff,0,12,30,30
1650532527633,MATH 18,B02,083749,Staff,0,12,30,30
1650532527633,MATH 18,B03,083750,Staff,0,11,30,30
1650532527633,MATH 18,B04,083751,Staff,0,12,30,30
1650532533659,MATH 20A,A01,083754,Staff,22,0,40,18
1650532539683,MATH 20B,A01,083756,Staff,0,11,30,30
1650532539683,MATH 20B,A02,083757,Staff,0,12,30,30
1650532545705,MATH 20C,A01,083760,Staff,0,16,30,30
1650532545705,MATH 20C,A02,083761,Staff,2,14,30,28
1650532545705,MATH 20C,B01,083762,Staff,12,0,30,18
1650532545705,MATH 20C,B02,083763,Staff,28,0,30,2
1650532551731,MATH 20D,A01,083765,Staff,0,1,30,30
1650532551731,MATH 20D,A02,083766,Staff,7,0,30,23
1650532551731,MATH 20D,A03,083767,Staff,25,0,30,5
1650532557761,MATH 20E,A01,083771,Staff,6,0,30,24
1650532557761,MATH 20E,A02,083772,Staff,18,0,30,12
1650532557761,MATH 20E,B01,083773,Staff,0,0,30,30
1650532557761,MATH 20E,B02,083774,Staff,10,0,30,20
1650532563789,MATH 103A,A01,083777,Staff,0,15,30,30
1650532563789,MATH 103A,A02,083778,Staff,0,14,30,30
1650532563789,MATH 103A,B01,083779,Staff,0,13,30,30
1650532563789,MATH 103A,B02,083780,Staff,0,13,30,30
1650532569811,MATH 105,A01,085443,Staff,0,21,30,30
1650532575839,MATH 109,A01,083213,Anzaldo; Leesa B,0,8,30,30
1650532575839,MATH 109,A02,083214,Anzaldo; Leesa B,0,7,30,30
1650532575839,MATH 109,B01,083215,Anzaldo; Leesa B,0,5,30,30
1650532575839,MATH 109,B02,083216,Anzaldo; Leesa B,0,6,30,30
1650532581862,MATH 142A,A01,083219,Chow; Bennett,0,16,30,30
1650532581862,MATH 142A,A02,083220,Chow; Bennett,0,14,30,30
1650532581862,MATH 142A,B01,083221,Chow; Bennett,0,13,30,30
1650532581862,MATH 142A,B02,083222,Chow; Bennett,0,13,30,30
1650532587886,MATH 193A,A01,083224,Staff,0,6,30,30
1650532587886,MATH 193A,A02,083225,Staff,0,5,30,30
1650532587886,MATH 193A,A03,083781,Staff,0,5,30,30
1650532587886,MATH 193A,A04,083782,Staff,0,7,30,30
1650532593910,MATH 197,001,091859,McAuley; Julian John,9998,0,9999,1
1650532599971,COGS 9,A01,083615,Staff,0,16,60,60
1650532606002,COGS 11,A01,083617,Boyle; Mary E. T.,19,0,40,21
1650532612026,COGS 13,A01,083071,Staff,0,35,40,40
1650532618053,COGS 14A,A01,092681,Staff,0,25,100,100
1650532624083,COGS 14B,A01,083073,Cheng; Tzu-Han,0,12,50,50
1650532630106,COGS 17,A01,092677,Staff,19,0,75,56
1650532636129,COGS 100,A01,083619,Staff,0,26,60,60
1650532642153,COGS 101A,A01,083621,Davis; Joshua Daniel,0,26,60,60
1650532648176,COGS 101B,A01,091572,Staff,1,5,60,59
1650532654200,COGS 101C,A01,083625,Delgado; Tania,15,0,30,15
1650532660228,COGS 107A,A01,083627,Boyle; Mary E. T.,0,11,60,60
1650532666252,COGS 118A,A01,083075,Staff,0,3,60,60
1650532672280,CSE 3,A50,083646,Miranda; Gregory Joseph,20,0,38,18
1650532672280,CSE 3,A51,083647,Miranda; Gregory Joseph,36,0,37,1
1650532678312,CSE 8A,A50,083650,Miranda; Gregory Joseph,0,29,40,40
1650532684339,CSE 11,A01,083080,Cao; Yingjun,0,94,40,40
1650532690365,CSE 12,A01,083652,Staff,0,17,100,100
1650532696393,CSE 15L,A01,083654,Staff,0,1,50,50
1650532696393,CSE 15L,A02,083655,Staff,0,0,50,50
1650532702417,CSE 20,A01,083657,Staff,51,0,80,29
1650532708446,CSE 30,A01,083084,Eldon; John,0,77,40,40
1650532714480,CSE 100,A01,083659,Cao; Yingjun,0,66,50,50
1650532720504,CSE 134B,A01,083661,Powell; Thomas Allan,0,34,65,65
1650532726533,CSE 140,A01,083663,Staff,0,5,75,75
1650532732560,CSE 140L,A01,083088,Eldon; John,0,11,75,75
1650532738584,CSE 175,A01,083665,Kumar; Rakesh,7,0,25,18
1650532744610,CSE 190,A00,092507,Dubnov; Shlomo,10,0,20,10
1650532750633,ECE 45,A01,083139,Staff,0,1,60,60
1650532756659,ECE 65,A50,083695,Staff,0,6,30,30
1650532762687,ECE 109,A01,091882,Touri; Behrouz,33,0,70,37
1650532768710,ECE 180,A00,083140,Abi Samra; Nicholas Camill,21,0,30,9
1650532768710,ECE 180,B00,083141,Abi Samra; Nicholas Camill,0,0,30,30
1650532774736,MATH 10A,A01,083735,Patchell; Gregory David,5,0,30,25
1650532774736,MATH 10A,A02,083736,Patchell; Gregory David,27,0,30,3
1650532774736,MATH 10A,A03,083737,Patchell; Gregory David,24,0,30,6
1650532780770,MATH 10B,A01,083207,Staff,0,9,30,30
1650532780770,MATH 10B,A02,083208,Staff,0,7,30,30
1650532780770,MATH 10B,B01,083739,Staff,13,0,30,17
1650532780770,MATH 10B,B02,083740,Staff,28,0,30,2
1650532786800,MATH 18,A01,083743,Staff,1,0,30,29
1650532786800,MATH 18,A02,083744,Staff,27,0,30,3
1650532786800,MATH 18,A03,083745,Staff,22,0,30,8
1650532786800,MATH 18,A04,083746,Staff,26,0,30,4
1650532786800,MATH 18,B01,083748,Staff,0,12,30,30
1650532786800,MATH 18,B02,083749,Staff,0,12,30,30
1650532786800,MATH 18,B03,083750,Staff,0,11,30,30
1650532786800,MATH 18,B04,083751,Staff,0,12,30,30
1650532792827,MATH 20A,A01,083754,Staff,22,0,40,18
1650532798851,MATH 20B,A01,083756,Staff,0,11,30,30
1650532798851,MATH 20B,A02,083757,Staff,0,12,30,30
1650532804875,MATH 20C,A01,083760,Staff,0,16,30,30
1650532804875,MATH 20C,A02,083761,Staff,2,14,30,28
1650532804875,MATH 20C,B01,083762,Staff,12,0,30,18
1650532804875,MATH 20C,B02,083763,Staff,28,0,30,2
1650532810903,MATH 20D,A01,083765,Staff,0,1,30,30
1650532810903,MATH 20D,A02,083766,Staff,7,0,30,23
1650532810903,MATH 20D,A03,083767,Staff,25,0,30,5
1650532816927,MATH 20E,A01,083771,Staff,6,0,30,24
1650532816927,MATH 20E,A02,083772,Staff,18,0,30,12
1650532816927,MATH 20E,B01,083773,Staff,0,0,30,30
1650532816927,MATH 20E,B02,083774,Staff,10,0,30,20
1650532822957,MATH 103A,A01,083777,Staff,0,15,30,30
1650532822957,MATH 103A,A02,083778,Staff,0,14,30,30
1650532822957,MATH 103A,B01,083779,Staff,0,13,30,30
1650532822957,MATH 103A,B02,083780,Staff,0,13,30,30
1650532828980,MATH 105,A01,085443,Staff,0,21,30,30
1650532835006,MATH 109,A01,083213,Anzaldo; Leesa B,0,8,30,30
1650532835006,MATH 109,A02,083214,Anzaldo; Leesa B,0,7,30,30
1650532835006,MATH 109,B01,083215,Anzaldo; Leesa B,0,5,30,30
1650532835006,MATH 109,B02,083216,Anzaldo; Leesa B,0,6,30,30
1650532841031,MATH 142A,A01,083219,Chow; Bennett,0,16,30,30
1650532841031,MATH 142A,A02,083220,Chow; Bennett,0,14,30,30
1650532841031,MATH 142A,B01,083221,Chow; Bennett,0,13,30,30
1650532841031,MATH 142A,B02,083222,Chow; Bennett,0,13,30,30
1650532847056,MATH 193A,A01,083224,Staff,0,6,30,30
1650532847056,MATH 193A,A02,083225,Staff,0,5,30,30
1650532847056,MATH 193A,A03,083781,Staff,0,5,30,30
1650532847056,MATH 193A,A04,083782,Staff,0,7,30,30
1650532853079,MATH 197,001,091859,McAuley; Julian John,9998,0,9999,1
1650532859129,COGS 9,A01,083615,Staff,0,16,60,60
1650532865154,COGS 11,A01,083617,Boyle; Mary E. T.,19,0,40,21
1650532871180,COGS 13,A01,083071,Staff,0,35,40,40
1650532877203,COGS 14A,A01,092681,Staff,0,25,100,100
1650532883230,COGS 14B,A01,083073,Cheng; Tzu-Han,0,12,50,50
1650532889259,COGS 17,A01,092677,Staff,19,0,75,56
1650532895289,COGS 100,A01,083619,Staff,0,26,60,60
1650532901312,COGS 101A,A01,083621,Davis; Joshua Daniel,0,26,60,60
1650532907336,COGS 101B,A01,091572,Staff,1,5,60,59
1650532913459,COGS 101C,A01,083625,Delgado; Tania,15,0,30,15
1650532919488,COGS 107A,A01,083627,Boyle; Mary E. T.,0,11,60,60
1650532925513,COGS 118A,A01,083075,Staff,0,3,60,60
1650532931544,CSE 3,A50,083646,Miranda; Gregory Joseph,20,0,38,18
1650532931544,CSE 3,A51,083647,Miranda; Gregory Joseph,36,0,37,1
1650532937571,CSE 8A,A50,083650,Miranda; Gregory Joseph,0,29,40,40
1650532943600,CSE 11,A01,083080,Cao; Yingjun,0,94,40,40
1650532949627,CSE 12,A01,083652,Staff,0,17,100,100
1650532955652,CSE 15L,A01,083654,Staff,0,1,50,50
1650532955652,CSE 15L,A02,083655,Staff,0,0,50,50
1650532961677,CSE 20,A01,083657,Staff,51,0,80,29
1650532967700,CSE 30,A01,083084,Eldon; John,0,77,40,40
1650532973726,CSE 100,A01,083659,Cao; Yingjun,0,66,50,50
1650532979753,CSE 134B,A01,083661,Powell; Thomas Allan,0,34,65,65
1650532985777,CSE 140,A01,083663,Staff,0,5,75,75
1650532991812,CSE 140L,A01,083088,Eldon; John,0,11,75,75
1650532997838,CSE 175,A01,083665,Kumar; Rakesh,7,0,25,18
1650533003865,CSE 190,A00,092507,Dubnov; Shlomo,10,0,20,10
1650533009890,ECE 45,A01,083139,Staff,0,1,60,60
1650533015917,ECE 65,A50,083695,Staff,0,6,30,30
1650533021944,ECE 109,A01,091882,Touri; Behrouz,33,0,70,37
1650533027970,ECE 180,A00,083140,Abi Samra; Nicholas Camill,21,0,30,9
1650533027970,ECE 180,B00,083141,Abi Samra; Nicholas Camill,0,0,30,30
1650533033997,MATH 10A,A01,083735,Patchell; Gregory David,5,0,30,25
1650533033997,MATH 10A,A02,083736,Patchell; Gregory David,27,0,30,3
1650533033997,MATH 10A,A03,083737,Patchell; Gregory David,24,0,30,6
1650533040021,MATH 10B,A01,083207,Staff,0,9,30,30
1650533040021,MATH 10B,A02,083208,Staff,0,7,30,30
1650533040021,MATH 10B,B01,083739,Staff,12,0,30,18
1650533040021,MATH 10B,B02,083740,Staff,28,0,30,2
1650533046063,MATH 18,A01,083743,Staff,1,0,30,29
1650533046063,MATH 18,A02,083744,Staff,27,0,30,3
1650533046063,MATH 18,A03,083745,Staff,22,0,30,8
1650533046063,MATH 18,A04,083746,Staff,26,0,30,4
1650533046063,MATH 18,B01,083748,Staff,0,12,30,30
1650533046063,MATH 18,B02,083749,Staff,0,12,30,30
1650533046063,MATH 18,B03,083750,Staff,0,11,30,30
1650533046063,MATH 18,B04,083751,Staff,0,12,30,30
1650533052089,MATH 20A,A01,083754,Staff,22,0,40,18
1650533058116,MATH 20B,A01,083756,Staff,0,11,30,30
1650533058116,MATH 20B,A02,083757,Staff,0,12,30,30
1650533064143,MATH 20C,A01,083760,Staff,0,16,30,30
1650533064143,MATH 20C,A02,083761,Staff,2,14,30,28
1650533064143,MATH 20C,B01,083762,Staff,12,0,30,18
1650533064143,MATH 20C,B02,083763,Staff,28,0,30,2
1650533070166,MATH 20D,A01,083765,Staff,0,1,30,30
1650533070166,MATH 20D,A02,083766,Staff,7,0,30,23
1650533070166,MATH 20D,A03,083767,Staff,25,0,30,5
1650533076194,MATH 20E,A01,083771,Staff,6,0,30,24
1650533076194,MATH 20E,A02,083772,Staff,18,0,30,12
1650533076194,MATH 20E,B01,083773,Staff,0,0,30,30
1650533076194,MATH 20E,B02,083774,Staff,10,0,30,20
1650533082218,MATH 103A,A01,083777,Staff,0,15,30,30
1650533082218,MATH 103A,A02,083778,Staff,0,14,30,30
1650533082218,MATH 103A,B01,083779,Staff,0,13,30,30
1650533082218,MATH 103A,B02,083780,Staff,0,13,30,30
1650533088242,MATH 105,A01,085443,Staff,0,21,30,30
1650533094267,MATH 109,A01,083213,Anzaldo; Leesa B,0,8,30,30
1650533094267,MATH 109,A02,083214,Anzaldo; Leesa B,0,7,30,30
1650533094267,MATH 109,B01,083215,Anzaldo; Leesa B,0,5,30,30
1650533094267,MATH 109,B02,083216,Anzaldo; Leesa B,0,6,30,30
1650533100297,MATH 142A,A01,083219,Chow; Bennett,0,16,30,30
1650533100297,MATH 142A,A02,083220,Chow; Bennett,0,14,30,30
1650533100297,MATH 142A,B01,083221,Chow; Bennett,0,13,30,30
1650533100297,MATH 142A,B02,083222,Chow; Bennett,0,13,30,30
1650533106322,MATH 193A,A01,083224,Staff,0,6,30,30
1650533106322,MATH 193A,A02,083225,Staff,0,5,30,30
1650533106322,MATH 193A,A03,083781,Staff,0,5,30,30
1650533106322,MATH 193A,A04,083782,Staff,0,7,30,30
1650533112349,MATH 197,001,091859,McAuley; Julian John,9998,0,9999,1
1650533118406,COGS 9,A01,083615,Staff,0,16,60,60
1650533124430,COGS 11,A01,083617,Boyle; Mary E. T.,19,0,40,21
1650533130454,COGS 13,A01,083071,Staff,0,35,40,40
1650533136477,COGS 14A,A01,092681,Staff,0,25,100,100
1650533142501,COGS 14B,A01,083073,Cheng; Tzu-Han,0,12,50,50
1650533148525,COGS 17,A01,092677,Staff,19,0,75,56
1650533154549,COGS 100,A01,083619,Staff,0,26,60,60
1650533160576,COGS 101A,A01,083621,Davis; Joshua Daniel,0,26,60,60
1650533166599,COGS 101B,A01,091572,Staff,1,5,60,59
1650533172625,COGS 101C,A01,083625,Delgado; Tania,15,0,30,15
1650533178654,COGS 107A,A01,083627,Boyle; Mary E. T.,0,11,60,60
1650533184683,COGS 118A,A01,083075,Staff,0,3,60,60
1650533190705,CSE 3,A50,083646,Miranda; Gregory Joseph,20,0,38,18
1650533190705,CSE 3,A51,083647,Miranda; Gregory Joseph,36,0,37,1
1650533196731,CSE 8A,A50,083650,Miranda; Gregory Joseph,0,29,40,40
1650533202758,CSE 11,A01,083080,Cao; Yingjun,0,94,40,40
1650533208784,CSE 12,A01,083652,Staff,0,17,100,100
1650533214810,CSE 15L,A01,083654,Staff,0,1,50,50
1650533214810,CSE 15L,A02,083655,Staff,0,0,50,50
1650533220834,CSE 20,A01,083657,Staff,51,0,80,29
1650533226859,CSE 30,A01,083084,Eldon; John,0,77,40,40
1650533232883,CSE 100,A01,083659,Cao; Yingjun,0,66,50,50
1650533238907,CSE 134B,A01,083661,Powell; Thomas Allan,0,34,65,65
1650533244934,CSE 140,A01,083663,Staff,0,5,75,75
1650533250962,CSE 140L,A01,083088,Eldon; John,0,11,75,75
1650533256987,CSE 175,A01,083665,Kumar; Rakesh,7,0,25,18
1650533263010,CSE 190,A00,092507,Dubnov; Shlomo,10,0,20,10
1650533269033,ECE 45,A01,083139,Staff,0,1,60,60
1650533275057,ECE 65,A50,083695,Staff,0,6,30,30
1650533281083,ECE 109,A01,091882,Touri; Behrouz,33,0,70,37
1650533287107,ECE 180,A00,083140,Abi Samra; Nicholas Camill,21,0,30,9
1650533287107,ECE 180,B00,083141,Abi Samra; Nicholas Camill,0,0,30,30
1650533293134,MATH 10A,A01,083735,Patchell; Gregory David,5,0,30,25
1650533293134,MATH 10A,A02,083736,Patchell; Gregory David,27,0,30,3
1650533293134,MATH 10A,A03,083737,Patchell; Gregory David,24,0,30,6
1650533299162,MATH 10B,A01,083207,Staff,0,9,30,30
1650533299162,MATH 10B,A02,083208,Staff,0,7,30,30
1650533299162,MATH 10B,B01,083739,Staff,12,0,30,18
1650533299162,MATH 10B,B02,083740,Staff,28,0,30,2
1650533305189,MATH 18,A01,083743,Staff,1,0,30,29
1650533305189,MATH 18,A02,083744,Staff,27,0,30,3
1650533305189,MATH 18,A03,083745,Staff,22,0,30,8
1650533305189,MATH 18,A04,083746,Staff,26,0,30,4
1650533305189,MATH 18,B01,083748,Staff,0,12,30,30
1650533305189,MATH 18,B02,083749,Staff,0,12,30,30
1650533305189,MATH 18,B03,083750,Staff,0,11,30,30
1650533305189,MATH 18,B04,083751,Staff,0,12,30,30
1650533311214,MATH 20A,A01,083754,Staff,22,0,40,18
1650533317237,MATH 20B,A01,083756,Staff,0,11,30,30
1650533317237,MATH 20B,A02,083757,Staff,0,12,30,30
1650533323262,MATH 20C,A01,083760,Staff,0,16,30,30
1650533323262,MATH 20C,A02,083761,Staff,2,14,30,28
1650533323262,MATH 20C,B01,083762,Staff,12,0,30,18
1650533323262,MATH 20C,B02,083763,Staff,28,0,30,2
1650533329290,MATH 20D,A01,083765,Staff,0,1,30,30
1650533329290,MATH 20D,A02,083766,Staff,7,0,30,23
1650533329290,MATH 20D,A03,083767,Staff,25,0,30,5
1650533335315,MATH 20E,A01,083771,Staff,6,0,30,24
1650533335315,MATH 20E,A02,083772,Staff,18,0,30,12
1650533335315,MATH 20E,B01,083773,Staff,0,0,30,30
1650533335315,MATH 20E,B02,083774,Staff,10,0,30,20
1650533341345,MATH 103A,A01,083777,Staff,0,15,30,30
1650533341345,MATH 103A,A02,083778,Staff,0,14,30,30
1650533341345,MATH 103A,B01,083779,Staff,0,13,30,30
1650533341345,MATH 103A,B02,083780,Staff,0,13,30,30
1650533347368,MATH 105,A01,085443,Staff,0,21,30,30
1650533353396,MATH 109,A01,083213,Anzaldo; Leesa B,0,8,30,30
1650533353396,MATH 109,A02,083214,Anzaldo; Leesa B,0,7,30,30
1650533353396,MATH 109,B01,083215,Anzaldo; Leesa B,0,5,30,30
1650533353396,MATH 109,B02,083216,Anzaldo; Leesa B,0,6,30,30
1650533359425,MATH 142A,A01,083219,Chow; Bennett,0,16,30,30
1650533359425,MATH 142A,A02,083220,Chow; Bennett,0,14,30,30
1650533359425,MATH 142A,B01,083221,Chow; Bennett,0,13,30,30
1650533359425,MATH 142A,B02,083222,Chow; Bennett,0,13,30,30
1650533365450,MATH 193A,A01,083224,Staff,0,6,30,30
1650533365450,MATH 193A,A02,083225,Staff,0,5,30,30
1650533365450,MATH 193A,A03,083781,Staff,0,5,30,30
1650533365450,MATH 193A,A04,083782,Staff,0,7,30,30
1650533371475,MATH 197,001,091859,McAuley; Julian John,9998,0,9999,1
1650533377529,COGS 9,A01,083615,Staff,0,16,60,60
1650533383552,COGS 11,A01,083617,Boyle; Mary E. T.,19,0,40,21
1650533389576,COGS 13,A01,083071,Staff,0,35,40,40
1650533395602,COGS 14A,A01,092681,Staff,0,25,100,100
1650533401626,COGS 14B,A01,083073,Cheng; Tzu-Han,0,12,50,50
1650533407649,COGS 17,A01,092677,Staff,19,0,75,56
1650533413672,COGS 100,A01,083619,Staff,0,26,60,60
1650533419699,COGS 101A,A01,083621,Davis; Joshua Daniel,0,26,60,60
1650533425726,COGS 101B,A01,091572,Staff,1,5,60,59
1650533431751,COGS 101C,A01,083625,Delgado; Tania,15,0,30,15
1650533437777,COGS 107A,A01,083627,Boyle; Mary E. T.,0,11,60,60
1650533443804,COGS 118A,A01,083075,Staff,0,3,60,60
1650533449828,CSE 3,A50,083646,Miranda; Gregory Joseph,20,0,38,18
1650533449828,CSE 3,A51,083647,Miranda; Gregory Joseph,36,0,37,1
1650533455858,CSE 8A,A50,083650,Miranda; Gregory Joseph,0,29,40,40
1650533461886,CSE 11,A01,083080,Cao; Yingjun,0,94,40,40
1650533467913,CSE 12,A01,083652,Staff,0,17,100,100
1650533473945,CSE 15L,A01,083654,Staff,0,1,50,50
1650533473945,CSE 15L,A02,083655,Staff,0,0,50,50
1650533479969,CSE 20,A01,083657,Staff,51,0,80,29
1650533485996,CSE 30,A01,083084,Eldon; John,0,77,40,40
1650533492019,CSE 100,A01,083659,Cao; Yingjun,0,66,50,50
1650533498042,CSE 134B,A01,083661,Powell; Thomas Allan,0,34,65,65
1650533504068,CSE 140,A01,083663,Staff,0,5,75,75
1650533510190,CSE 140L,A01,083088,Eldon; John,0,11,75,75
1650533516212,CSE 175,A01,083665,Kumar; Rakesh,7,0,25,18
1650533522236,CSE 190,A00,092507,Dubnov; Shlomo,10,0,20,10
1650533528262,ECE 45,A01,083139,Staff,0,1,60,60
1650533534285,ECE 65,A50,083695,Staff,0,6,30,30
1650533540312,ECE 109,A01,091882,Touri; Behrouz,33,0,70,37
1650533546339,ECE 180,A00,083140,Abi Samra; Nicholas Camill,21,0,30,9
1650533546339,ECE 180,B00,083141,Abi Samra; Nicholas Camill,0,0,30,30
1650533552378,MATH 10A,A01,083735,Patchell; Gregory David,5,0,30,25
1650533552378,MATH 10A,A02,083736,Patchell; Gregory David,27,0,30,3
1650533552378,MATH 10A,A03,083737,Patchell; Gregory David,24,0,30,6
1650533558406,MATH 10B,A01,083207,Staff,0,9,30,30
1650533558406,MATH 10B,A02,083208,Staff,0,7,30,30
1650533558406,MATH 10B,B01,083739,Staff,12,0,30,18
1650533558406,MATH 10B,B02,083740,Staff,28,0,30,2
1650533564436,MATH 18,A01,083743,Staff,1,0,30,29
1650533564436,MATH 18,A02,083744,Staff,27,0,30,3
1650533564436,MATH 18,A03,083745,Staff,22,0,30,8
1650533564436,MATH 18,A04,083746,Staff,26,0,30,4
1650533564436,MATH 18,B01,083748,Staff,0,12,30,30
1650533564436,MATH 18,B02,083749,Staff,0,12,30,30
1650533564436,MATH 18,B03,083750,Staff,0,11,30,30
1650533564436,MATH 18,B04,083751,Staff,0,12,30,30
1650533570464,MATH 20A,A01,083754,Staff,22,0,40,18
1650533576496,MATH 20B,A01,083756,Staff,0,11,30,30
1650533576496,MATH 20B,A02,083757,Staff,0,12,30,30
1650533582524,MATH 20C,A01,083760,Staff,0,16,30,30
1650533582524,MATH 20C,A02,083761,Staff,2,14,30,28
1650533582524,MATH 20C,B01,083762,Staff,12,0,30,18
1650533582524,MATH 20C,B02,083763,Staff,28,0,30,2
1650533588549,MATH 20D,A01,083765,Staff,0,1,30,30
1650533588549,MATH 20D,A02,083766,Staff,7,0,30,23
1650533588549,MATH 20D,A03,083767,Staff,25,0,30,5
1650533594572,MATH 20E,A01,083771,Staff,6,0,30,24
1650533594572,MATH 20E,A02,083772,Staff,18,0,30,12
1650533594572,MATH 20E,B01,083773,Staff,0,0,30,30
1650533594572,MATH 20E,B02,083774,Staff,10,0,30,20
1650533600596,MATH 103A,A01,083777,Staff,0,15,30,30
1650533600596,MATH 103A,A02,083778,Staff,0,14,30,30
1650533600596,MATH 103A,B01,083779,Staff,0,13,30,30
1650533600596,MATH 103A,B02,083780,Staff,0,13,30,30
1650533606631,MATH 105,A01,085443,Staff,0,21,30,30
1650533612656,MATH 109,A01,083213,Anzaldo; Leesa B,0,8,30,30
1650533612656,MATH 109,A02,083214,Anzaldo; Leesa B,0,7,30,30
1650533612656,MATH 109,B01,083215,Anzaldo; Leesa B,0,5,30,30
1650533612656,MATH 109,B02,083216,Anzaldo; Leesa B,0,6,30,30
1650533618681,MATH 142A,A01,083219,Chow; Bennett,0,16,30,30
1650533618681,MATH 142A,A02,083220,Chow; Bennett,0,14,30,30
1650533618681,MATH 142A,B01,083221,Chow; Bennett,0,13,30,30
1650533618681,MATH 142A,B02,083222,Chow; Bennett,0,13,30,30
1650533624705,MATH 193A,A01,083224,Staff,0,6,30,30
1650533624705,MATH 193A,A02,083225,Staff,0,5,30,30
1650533624705,MATH 193A,A03,083781,Staff,0,5,30,30
1650533624705,MATH 193A,A04,083782,Staff,0,7,30,30
1650533630729,MATH 197,001,091859,McAuley; Julian John,9998,0,9999,1
1650533636792,COGS 9,A01,083615,Staff,0,16,60,60
1650533642827,COGS 11,A01,083617,Boyle; Mary E. T.,19,0,40,21
1650533648851,COGS 13,A01,083071,Staff,0,35,40,40
1650533654875,COGS 14A,A01,092681,Staff,0,25,100,100
1650533660899,COGS 14B,A01,083073,Cheng; Tzu-Han,0,12,50,50
1650533666926,COGS 17,A01,092677,Staff,19,0,75,56
1650533672966,COGS 100,A01,083619,Staff,0,26,60,60
1650533678990,COGS 101A,A01,083621,Davis; Joshua Daniel,0,26,60,60
1650533685015,COGS 101B,A01,091572,Staff,1,5,60,59
1650533691036,COGS 101C,A01,083625,Delgado; Tania,15,0,30,15
1650533697060,COGS 107A,A01,083627,Boyle; Mary E. T.,0,11,60,60
1650533703085,COGS 118A,A01,083075,Staff,0,3,60,60
1650533709113,CSE 3,A50,083646,Miranda; Gregory Joseph,20,0,38,18
1650533709113,CSE 3,A51,083647,Miranda; Gregory Joseph,36,0,37,1
1650533715136,CSE 8A,A50,083650,Miranda; Gregory Joseph,0,29,40,40
1650533721162,CSE 11,A01,083080,Cao; Yingjun,0,94,40,40
1650533727186,CSE 12,A01,083652,Staff,0,17,100,100
1650533733211,CSE 15L,A01,083654,Staff,0,1,50,50
1650533733211,CSE 15L,A02,083655,Staff,0,0,50,50
1650533739235,CSE 20,A01,083657,Staff,51,0,80,29
1650533745259,CSE 30,A01,083084,Eldon; John,0,77,40,40
1650533751283,CSE 100,A01,083659,Cao; Yingjun,0,66,50,50
1650533757312,CSE 134B,A01,083661,Powell; Thomas Allan,0,34,65,65
1650533763334,CSE 140,A01,083663,Staff,0,5,75,75
1650533769358,CSE 140L,A01,083088,Eldon; John,0,11,75,75
1650533775382,CSE 175,A01,083665,Kumar; Rakesh,7,0,25,18
1650533781405,CSE 190,A00,092507,Dubnov; Shlomo,10,0,20,10
1650533787431,ECE 45,A01,083139,Staff,0,1,60,60
1650533793455,ECE 65,A50,083695,Staff,0,6,30,30
1650533799479,ECE 109,A01,091882,Touri; Behrouz,33,0,70,37
1650533805507,ECE 180,A00,083140,Abi Samra; Nicholas Camill,21,0,30,9
1650533805507,ECE 180,B00,083141,Abi Samra; Nicholas Camill,0,0,30,30
1650533811531,MATH 10A,A01,083735,Patchell; Gregory David,5,0,30,25
1650533811531,MATH 10A,A02,083736,Patchell; Gregory David,27,0,30,3
1650533811531,MATH 10A,A03,083737,Patchell; Gregory David,24,0,30,6
1650533817557,MATH 10B,A01,083207,Staff,0,9,30,30
1650533817557,MATH 10B,A02,083208,Staff,0,7,30,30
1650533817557,MATH 10B,B01,083739,Staff,12,0,30,18
1650533817557,MATH 10B,B02,083740,Staff,28,0,30,2
1650533823581,MATH 18,A01,083743,Staff,1,0,30,29
1650533823581,MATH 18,A02,083744,Staff,27,0,30,3
1650533823581,MATH 18,A03,083745,Staff,22,0,30,8
1650533823581,MATH 18,A04,083746,Staff,26,0,30,4
1650533823581,MATH 18,B01,083748,Staff,0,12,30,30
1650533823581,MATH 18,B02,083749,Staff,0,12,30,30
1650533823581,MATH 18,B03,083750,Staff,0,11,30,30
1650533823581,MATH 18,B04,083751,Staff,0,12,30,30
1650533829607,MATH 20A,A01,083754,Staff,22,0,40,18
1650533835634,MATH 20B,A01,083756,Staff,0,11,30,30
1650533835634,MATH 20B,A02,083757,Staff,0,12,30,30
1650533841662,MATH 20C,A01,083760,Staff,0,16,30,30
1650533841662,MATH 20C,A02,083761,Staff,2,14,30,28
1650533841662,MATH 20C,B01,083762,Staff,12,0,30,18
1650533841662,MATH 20C,B02,083763,Staff,28,0,30,2
1650533847689,MATH 20D,A01,083765,Staff,0,1,30,30
1650533847689,MATH 20D,A02,083766,Staff,7,0,30,23
1650533847689,MATH 20D,A03,083767,Staff,25,0,30,5
1650533853717,MATH 20E,A01,083771,Staff,6,0,30,24
1650533853717,MATH 20E,A02,083772,Staff,18,0,30,12
1650533853717,MATH 20E,B01,083773,Staff,0,0,30,30
1650533853717,MATH 20E,B02,083774,Staff,10,0,30,20
1650533859743,MATH 103A,A01,083777,Staff,0,15,30,30
1650533859743,MATH 103A,A02,083778,Staff,0,14,30,30
1650533859743,MATH 103A,B01,083779,Staff,0,13,30,30
1650533859743,MATH 103A,B02,083780,Staff,0,13,30,30
1650533865767,MATH 105,A01,085443,Staff,0,21,30,30
1650533871795,MATH 109,A01,083213,Anzaldo; Leesa B,0,8,30,30
1650533871795,MATH 109,A02,083214,Anzaldo; Leesa B,0,7,30,30
1650533871795,MATH 109,B01,083215,Anzaldo; Leesa B,0,5,30,30
1650533871795,MATH 109,B02,083216,Anzaldo; Leesa B,0,6,30,30
1650533877819,MATH 142A,A01,083219,Chow; Bennett,0,16,30,30
1650533877819,MATH 142A,A02,083220,Chow; Bennett,0,14,30,30
1650533877819,MATH 142A,B01,083221,Chow; Bennett,0,13,30,30
1650533877819,MATH 142A,B02,083222,Chow; Bennett,0,13,30,30
1650533883846,MATH 193A,A01,083224,Staff,0,6,30,30
1650533883846,MATH 193A,A02,083225,Staff,0,5,30,30
1650533883846,MATH 193A,A03,083781,Staff,0,5,30,30
1650533883846,MATH 193A,A04,083782,Staff,0,7,30,30
1650533889871,MATH 197,001,091859,McAuley; Julian John,9998,0,9999,1
1650533895931,COGS 9,A01,083615,Staff,0,16,60,60
1650533901956,COGS 11,A01,083617,Boyle; Mary E. T.,19,0,40,21
1650533907983,COGS 13,A01,083071,Staff,0,35,40,40
1650533914007,COGS 14A,A01,092681,Staff,0,25,100,100
1650533920031,COGS 14B,A01,083073,Cheng; Tzu-Han,0,12,50,50
1650533926057,COGS 17,A01,092677,Staff,19,0,75,56
1650533932080,COGS 100,A01,083619,Staff,0,26,60,60
1650533938105,COGS 101A,A01,083621,Davis; Joshua Daniel,0,26,60,60
1650533944131,COGS 101B,A01,091572,Staff,1,5,60,59
1650533950159,COGS 101C,A01,083625,Delgado; Tania,15,0,30,15
1650533956187,COGS 107A,A01,083627,Boyle; Mary E. T.,0,11,60,60
1650533962208,COGS 118A,A01,083075,Staff,0,3,60,60
1650533968233,CSE 3,A50,083646,Miranda; Gregory Joseph,20,0,38,18
1650533968233,CSE 3,A51,083647,Miranda; Gregory Joseph,36,0,37,1
1650533974260,CSE 8A,A50,083650,Miranda; Gregory Joseph,0,29,40,40
1650533980288,CSE 11,A01,083080,Cao; Yingjun,0,94,40,40
1650533986315,CSE 12,A01,083652,Staff,0,17,100,100
1650533992338,CSE 15L,A01,083654,Staff,0,1,50,50
1650533992338,CSE 15L,A02,083655,Staff,0,0,50,50
1650533998364,CSE 20,A01,083657,Staff,51,0,80,29
1650534004393,CSE 30,A01,083084,Eldon; John,0,77,40,40
1650534010424,CSE 100,A01,083659,Cao; Yingjun,0,66,50,50
1650534016455,CSE 134B,A01,083661,Powell; Thomas Allan,0,34,65,65
1650534022481,CSE 140,A01,083663,Staff,0,5,75,75
1650534028503,CSE 140L,A01,083088,Eldon; John,0,11,75,75
1650534034527,CSE 175,A01,083665,Kumar; Rakesh,7,0,25,18
1650534040552,CSE 190,A00,092507,Dubnov; Shlomo,10,0,20,10
1650534046576,ECE 45,A01,083139,Staff,0,1,60,60
1650534052608,ECE 65,A50,083695,Staff,0,6,30,30
1650534058632,ECE 109,A01,091882,Touri; Behrouz,33,0,70,37
1650534064657,ECE 180,A00,083140,Abi Samra; Nicholas Camill,21,0,30,9
1650534064657,ECE 180,B00,083141,Abi Samra; Nicholas Camill,0,0,30,30
1650534070680,MATH 10A,A01,083735,Patchell; Gregory David,5,0,30,25
1650534070680,MATH 10A,A02,083736,Patchell; Gregory David,27,0,30,3
1650534070680,MATH 10A,A03,083737,Patchell; Gregory David,24,0,30,6
1650534076708,MATH 10B,A01,083207,Staff,0,9,30,30
1650534076708,MATH 10B,A02,083208,Staff,0,7,30,30
1650534076708,MATH 10B,B01,083739,Staff,12,0,30,18
1650534076708,MATH 10B,B02,083740,Staff,28,0,30,2
1650534082733,MATH 18,A01,083743,Staff,1,0,30,29
1650534082733,MATH 18,A02,083744,Staff,27,0,30,3
1650534082733,MATH 18,A03,083745,Staff,22,0,30,8
1650534082733,MATH 18,A04,083746,Staff,26,0,30,4
1650534082733,MATH 18,B01,083748,Staff,0,12,30,30
1650534082733,MATH 18,B02,083749,Staff,0,12,30,30
1650534082733,MATH 18,B03,083750,Staff,0,11,30,30
1650534082733,MATH 18,B04,083751,Staff,0,12,30,30
1650534088756,MATH 20A,A01,083754,Staff,22,0,40,18
1650534094782,MATH 20B,A01,083756,Staff,0,11,30,30
1650534094782,MATH 20B,A02,083757,Staff,0,12,30,30
1650534100811,MATH 20C,A01,083760,Staff,0,16,30,30
1650534100811,MATH 20C,A02,083761,Staff,2,14,30,28
1650534100811,MATH 20C,B01,083762,Staff,12,0,30,18
1650534100811,MATH 20C,B02,083763,Staff,28,0,30,2
1650534106924,MATH 20D,A01,083765,Staff,0,1,30,30
1650534106924,MATH 20D,A02,083766,Staff,7,0,30,23
1650534106924,MATH 20D,A03,083767,Staff,25,0,30,5
1650534112950,MATH 20E,A01,083771,Staff,6,0,30,24
1650534112950,MATH 20E,A02,083772,Staff,18,0,30,12
1650534112950,MATH 20E,B01,083773,Staff,0,0,30,30
1650534112950,MATH 20E,B02,083774,Staff,10,0,30,20
1650534118987,MATH 103A,A01,083777,Staff,0,15,30,30
1650534118987,MATH 103A,A02,083778,Staff,0,14,30,30
1650534118987,MATH 103A,B01,083779,Staff,0,13,30,30
1650534118987,MATH 103A,B02,083780,Staff,0,13,30,30
1650534125021,MATH 105,A01,085443,Staff,0,21,30,30
1650534131050,MATH 109,A01,083213,Anzaldo; Leesa B,0,8,30,30
1650534131050,MATH 109,A02,083214,Anzaldo; Leesa B,0,7,30,30
1650534131050,MATH 109,B01,083215,Anzaldo; Leesa B,0,5,30,30
1650534131050,MATH 109,B02,083216,Anzaldo; Leesa B,0,6,30,30
1650534137073,MATH 142A,A01,083219,Chow; Bennett,0,16,30,30
1650534137073,MATH 142A,A02,083220,Chow; Bennett,0,14,30,30
1650534137073,MATH 142A,B01,083221,Chow; Bennett,0,13,30,30
1650534137073,MATH 142A,B02,083222,Chow; Bennett,0,13,30,30
1650534143098,MATH 193A,A01,083224,Staff,0,6,30,30
1650534143098,MATH 193A,A02,083225,Staff,0,5,30,30
1650534143098,MATH 193A,A03,083781,Staff,0,5,30,30
1650534143098,MATH 193A,A04,083782,Staff,0,7,30,30
1650534149125,MATH 197,001,091859,McAuley; Julian John,9998,0,9999,1
1650534155180,COGS 9,A01,083615,Staff,0,16,60,60
1650534161206,COGS 11,A01,083617,Boyle; Mary E. T.,19,0,40,21
1650534167228,COGS 13,A01,083071,Staff,0,35,40,40
1650534173255,COGS 14A,A01,092681,Staff,0,25,100,100
1650534179279,COGS 14B,A01,083073,Cheng; Tzu-Han,0,12,50,50
1650534185304,COGS 17,A01,092677,Staff,19,0,75,56
1650534191330,COGS 100,A01,083619,Staff,0,26,60,60
1650534197357,COGS 101A,A01,083621,Davis; Joshua Daniel,0,26,60,60
1650534203384,COGS 101B,A01,091572,Staff,1,5,60,59
1650534209410,COGS 101C,A01,083625,Delgado; Tania,15,0,30,15
1650534215434,COGS 107A,A01,083627,Boyle; Mary E. T.,0,11,60,60
1650534221458,COGS 118A,A01,083075,Staff,0,3,60,60
1650534227482,CSE 3,A50,083646,Miranda; Gregory Joseph,20,0,38,18
1650534227482,CSE 3,A51,083647,Miranda; Gregory Joseph,36,0,37,1
1650534233509,CSE 8A,A50,083650,Miranda; Gregory Joseph,0,29,40,40
1650534239533,CSE 11,A01,083080,Cao; Yingjun,0,94,40,40
1650534245560,CSE 12,A01,083652,Staff,0,17,100,100
1650534251585,CSE 15L,A01,083654,Staff,0,1,50,50
1650534251585,CSE 15L,A02,083655,Staff,0,0,50,50
1650534257609,CSE 20,A01,083657,Staff,51,0,80,29
1650534263631,CSE 30,A01,083084,Eldon; John,0,77,40,40
1650534269655,CSE 100,A01,083659,Cao; Yingjun,0,66,50,50
1650534275680,CSE 134B,A01,083661,Powell; Thomas Allan,0,34,65,65
1650534281708,CSE 140,A01,083663,Staff,0,5,75,75
1650534287731,CSE 140L,A01,083088,Eldon; John,0,11,75,75
1650534293758,CSE 175,A01,083665,Kumar; Rakesh,7,0,25,18
1650534299784,CSE 190,A00,092507,Dubnov; Shlomo,10,0,20,10
1650534305812,ECE 45,A01,083139,Staff,0,1,60,60
1650534311838,ECE 65,A50,083695,Staff,0,6,30,30
1650534317868,ECE 109,A01,091882,Touri; Behrouz,33,0,70,37
1650534323892,ECE 180,A00,083140,Abi Samra; Nicholas Camill,21,0,30,9
1650534323892,ECE 180,B00,083141,Abi Samra; Nicholas Camill,0,0,30,30
1650534329920,MATH 10A,A01,083735,Patchell; Gregory David,5,0,30,25
1650534329920,MATH 10A,A02,083736,Patchell; Gregory David,27,0,30,3
1650534329920,MATH 10A,A03,083737,Patchell; Gregory David,24,0,30,6
1650534335943,MATH 10B,A01,083207,Staff,0,9,30,30
1650534335943,MATH 10B,A02,083208,Staff,0,7,30,30
1650534335943,MATH 10B,B01,083739,Staff,12,0,30,18
1650534335943,MATH 10B,B02,083740,Staff,28,0,30,2
1650534341975,MATH 18,A01,083743,Staff,1,0,30,29
1650534341975,MATH 18,A02,083744,Staff,27,0,30,3
1650534341975,MATH 18,A03,083745,Staff,22,0,30,8
1650534341975,MATH 18,A04,083746,Staff,26,0,30,4
1650534341975,MATH 18,B01,083748,Staff,0,12,30,30
1650534341975,MATH 18,B02,083749,Staff,0,12,30,30
1650534341975,MATH 18,B03,083750,Staff,0,11,30,30
1650534341975,MATH 18,B04,083751,Staff,0,12,30,30
1650534347998,MATH 20A,A01,083754,Staff,22,0,40,18
1650534354024,MATH 20B,A01,083756,Staff,0,11,30,30
1650534354024,MATH 20B,A02,083757,Staff,0,12,30,30
1650534360046,MATH 20C,A01,083760,Staff,0,16,30,30
1650534360046,MATH 20C,A02,083761,Staff,2,14,30,28
1650534360046,MATH 20C,B01,083762,Staff,12,0,30,18
1650534360046,MATH 20C,B02,083763,Staff,28,0,30,2
1650534366071,MATH 20D,A01,083765,Staff,0,1,30,30
1650534366071,MATH 20D,A02,083766,Staff,7,0,30,23
1650534366071,MATH 20D,A03,083767,Staff,25,0,30,5
1650534372121,MATH 20E,A01,083771,Staff,6,0,30,24
1650534372121,MATH 20E,A02,083772,Staff,18,0,30,12
1650534372121,MATH 20E,B01,083773,Staff,0,0,30,30
1650534372121,MATH 20E,B02,083774,Staff,10,0,30,20
1650534378146,MATH 103A,A01,083777,Staff,0,15,30,30
1650534378146,MATH 103A,A02,083778,Staff,0,14,30,30
1650534378146,MATH 103A,B01,083779,Staff,0,13,30,30
1650534378146,MATH 103A,B02,083780,Staff,0,13,30,30
1650534384180,MATH 105,A01,085443,Staff,0,21,30,30
1650534390205,MATH 109,A01,083213,Anzaldo; Leesa B,0,8,30,30
1650534390205,MATH 109,A02,083214,Anzaldo; Leesa B,0,7,30,30
1650534390205,MATH 109,B01,083215,Anzaldo; Leesa B,0,5,30,30
1650534390205,MATH 109,B02,083216,Anzaldo; Leesa B,0,6,30,30
1650534396238,MATH 142A,A01,083219,Chow; Bennett,0,16,30,30
1650534396238,MATH 142A,A02,083220,Chow; Bennett,0,14,30,30
1650534396238,MATH 142A,B01,083221,Chow; Bennett,0,13,30,30
1650534396238,MATH 142A,B02,083222,Chow; Bennett,0,13,30,30
1650534402266,MATH 193A,A01,083224,Staff,0,6,30,30
1650534402266,MATH 193A,A02,083225,Staff,0,5,30,30
1650534402266,MATH 193A,A03,083781,Staff,0,5,30,30
1650534402266,MATH 193A,A04,083782,Staff,0,7,30,30
1650534408292,MATH 197,001,091859,McAuley; Julian John,9998,0,9999,1
1650534414355,COGS 9,A01,083615,Staff,0,16,60,60
1650534420379,COGS 11,A01,083617,Boyle; Mary E. T.,19,0,40,21
1650534426409,COGS 13,A01,083071,Staff,0,35,40,40
1650534432434,COGS 14A,A01,092681,Staff,0,25,100,100
1650534438455,COGS 14B,A01,083073,Cheng; Tzu-Han,0,12,50,50
1650534444481,COGS 17,A01,092677,Staff,19,0,75,56
1650534450503,COGS 100,A01,083619,Staff,0,26,60,60
1650534456525,COGS 101A,A01,083621,Davis; Joshua Daniel,0,26,60,60
1650534462551,COGS 101B,A01,091572,Staff,1,5,60,59
1650534468576,COGS 101C,A01,083625,Delgado; Tania,15,0,30,15
1650534474603,COGS 107A,A01,083627,Boyle; Mary E. T.,0,11,60,60
1650534480629,COGS 118A,A01,083075,Staff,0,3,60,60
1650534486653,CSE 3,A50,083646,Miranda; Gregory Joseph,20,0,38,18
1650534486653,CSE 3,A51,083647,Miranda; Gregory Joseph,36,0,37,1
1650534492676,CSE 8A,A50,083650,Miranda; Gregory Joseph,0,29,40,40
1650534498703,CSE 11,A01,083080,Cao; Yingjun,0,94,40,40
1650534504725,CSE 12,A01,083652,Staff,0,17,100,100
1650534510749,CSE 15L,A01,083654,Staff,0,1,50,50
1650534510749,CSE 15L,A02,083655,Staff,0,0,50,50
1650534516774,CSE 20,A01,083657,Staff,51,0,80,29
1650534522797,CSE 30,A01,083084,Eldon; John,0,77,40,40
1650534528820,CSE 100,A01,083659,Cao; Yingjun,0,66,50,50
1650534534843,CSE 134B,A01,083661,Powell; Thomas Allan,0,34,65,65
1650534540869,CSE 140,A01,083663,Staff,0,5,75,75
1650534546896,CSE 140L,A01,083088,Eldon; John,0,11,75,75
1650534552921,CSE 175,A01,083665,Kumar; Rakesh,7,0,25,18
1650534558946,CSE 190,A00,092507,Dubnov; Shlomo,10,0,20,10
1650534564973,ECE 45,A01,083139,Staff,0,1,60,60
1650534570996,ECE 65,A50,083695,Staff,0,6,30,30
1650534577022,ECE 109,A01,091882,Touri; Behrouz,33,0,70,37
1650534583045,ECE 180,A00,083140,Abi Samra; Nicholas Camill,21,0,30,9
1650534583045,ECE 180,B00,083141,Abi Samra; Nicholas Camill,0,0,30,30
1650534589077,MATH 10A,A01,083735,Patchell; Gregory David,5,0,30,25
1650534589077,MATH 10A,A02,083736,Patchell; Gregory David,27,0,30,3
1650534589077,MATH 10A,A03,083737,Patchell; Gregory David,24,0,30,6
1650534595102,MATH 10B,A01,083207,Staff,0,9,30,30
1650534595102,MATH 10B,A02,083208,Staff,0,7,30,30
1650534595102,MATH 10B,B01,083739,Staff,12,0,30,18
1650534595102,MATH 10B,B02,083740,Staff,28,0,30,2
1650534601128,MATH 18,A01,083743,Staff,1,0,30,29
1650534601128,MATH 18,A02,083744,Staff,27,0,30,3
1650534601128,MATH 18,A03,083745,Staff,22,0,30,8
1650534601128,MATH 18,A04,083746,Staff,26,0,30,4
1650534601128,MATH 18,B01,083748,Staff,0,12,30,30
1650534601128,MATH 18,B02,083749,Staff,0,12,30,30
1650534601128,MATH 18,B03,083750,Staff,0,11,30,30
1650534601128,MATH 18,B04,083751,Staff,0,12,30,30
1650534607161,MATH 20A,A01,083754,Staff,22,0,40,18
1650534613188,MATH 20B,A01,083756,Staff,0,11,30,30
1650534613188,MATH 20B,A02,083757,Staff,0,12,30,30
1650534619217,MATH 20C,A01,083760,Staff,0,16,30,30
1650534619217,MATH 20C,A02,083761,Staff,2,14,30,28
1650534619217,MATH 20C,B01,083762,Staff,12,0,30,18
1650534619217,MATH 20C,B02,083763,Staff,28,0,30,2
1650534625240,MATH 20D,A01,083765,Staff,0,1,30,30
1650534625240,MATH 20D,A02,083766,Staff,7,0,30,23
1650534625240,MATH 20D,A03,083767,Staff,25,0,30,5
1650534631269,MATH 20E,A01,083771,Staff,6,0,30,24
1650534631269,MATH 20E,A02,083772,Staff,18,0,30,12
1650534631269,MATH 20E,B01,083773,Staff,0,0,30,30
1650534631269,MATH 20E,B02,083774,Staff,10,0,30,20
1650534637294,MATH 103A,A01,083777,Staff,0,15,30,30
1650534637294,MATH 103A,A02,083778,Staff,0,14,30,30
1650534637294,MATH 103A,B01,083779,Staff,0,13,30,30
1650534637294,MATH 103A,B02,083780,Staff,0,13,30,30
1650534643318,MATH 105,A01,085443,Staff,0,21,30,30
1650534649341,MATH 109,A01,083213,Anzaldo; Leesa B,0,8,30,30
1650534649341,MATH 109,A02,083214,Anzaldo; Leesa B,0,7,30,30
1650534649341,MATH 109,B01,083215,Anzaldo; Leesa B,0,5,30,30
1650534649341,MATH 109,B02,083216,Anzaldo; Leesa B,0,6,30,30
1650534655365,MATH 142A,A01,083219,Chow; Bennett,0,16,30,30
1650534655365,MATH 142A,A02,083220,Chow; Bennett,0,14,30,30
1650534655365,MATH 142A,B01,083221,Chow; Bennett,0,13,30,30
1650534655365,MATH 142A,B02,083222,Chow; Bennett,0,13,30,30
1650534661396,MATH 193A,A01,083224,Staff,0,6,30,30
1650534661396,MATH 193A,A02,083225,Staff,0,5,30,30
1650534661396,MATH 193A,A03,083781,Staff,0,5,30,30
1650534661396,MATH 193A,A04,083782,Staff,0,7,30,30
1650534667419,MATH 197,001,091859,McAuley; Julian John,9998,0,9999,1
1650534673473,COGS 9,A01,083615,Staff,0,16,60,60
1650534679499,COGS 11,A01,083617,Boyle; Mary E. T.,19,0,40,21
1650534685526,COGS 13,A01,083071,Staff,0,35,40,40
1650534691552,COGS 14A,A01,092681,Staff,0,25,100,100
1650534697669,COGS 14B,A01,083073,Cheng; Tzu-Han,0,12,50,50
1650534703692,COGS 17,A01,092677,Staff,19,0,75,56
1650534709719,COGS 100,A01,083619,Staff,0,26,60,60
1650534715743,COGS 101A,A01,083621,Davis; Joshua Daniel,0,26,60,60
1650534721768,COGS 101B,A01,091572,Staff,1,5,60,59
1650534727796,COGS 101C,A01,083625,Delgado; Tania,15,0,30,15
1650534733823,COGS 107A,A01,083627,Boyle; Mary E. T.,0,11,60,60
1650534739847,COGS 118A,A01,083075,Staff,0,3,60,60
1650534745875,CSE 3,A50,083646,Miranda; Gregory Joseph,20,0,38,18
1650534745875,CSE 3,A51,083647,Miranda; Gregory Joseph,36,0,37,1
1650534751904,CSE 8A,A50,083650,Miranda; Gregory Joseph,0,29,40,40
1650534757929,CSE 11,A01,083080,Cao; Yingjun,0,94,40,40
1650534763962,CSE 12,A01,083652,Staff,0,17,100,100
1650534769988,CSE 15L,A01,083654,Staff,0,1,50,50
1650534769988,CSE 15L,A02,083655,Staff,0,0,50,50
1650534776011,CSE 20,A01,083657,Staff,51,0,80,29
1650534782051,CSE 30,A01,083084,Eldon; John,0,77,40,40
1650534788077,CSE 100,A01,083659,Cao; Yingjun,0,66,50,50
1650534794103,CSE 134B,A01,083661,Powell; Thomas Allan,0,34,65,65
1650534800126,CSE 140,A01,083663,Staff,0,5,75,75
1650534806153,CSE 140L,A01,083088,Eldon; John,0,11,75,75
1650534812187,CSE 175,A01,083665,Kumar; Rakesh,7,0,25,18
1650534818210,CSE 190,A00,092507,Dubnov; Shlomo,10,0,20,10
1650534824236,ECE 45,A01,083139,Staff,0,1,60,60
1650534830258,ECE 65,A50,083695,Staff,0,6,30,30
1650534836281,ECE 109,A01,091882,Touri; Behrouz,33,0,70,37
1650534842308,ECE 180,A00,083140,Abi Samra; Nicholas Camill,21,0,30,9
1650534842308,ECE 180,B00,083141,Abi Samra; Nicholas Camill,0,0,30,30
1650534848331,MATH 10A,A01,083735,Patchell; Gregory David,5,0,30,25
1650534848331,MATH 10A,A02,083736,Patchell; Gregory David,27,0,30,3
1650534848331,MATH 10A,A03,083737,Patchell; Gregory David,24,0,30,6
1650534854364,MATH 10B,A01,083207,Staff,0,9,30,30
1650534854364,MATH 10B,A02,083208,Staff,0,7,30,30
1650534854364,MATH 10B,B01,083739,Staff,12,0,30,18
1650534854364,MATH 10B,B02,083740,Staff,28,0,30,2
1650534860393,MATH 18,A01,083743,Staff,1,0,30,29
1650534860393,MATH 18,A02,083744,Staff,27,0,30,3
1650534860393,MATH 18,A03,083745,Staff,22,0,30,8
1650534860393,MATH 18,A04,083746,Staff,26,0,30,4
1650534860393,MATH 18,B01,083748,Staff,0,12,30,30
1650534860393,MATH 18,B02,083749,Staff,0,12,30,30
1650534860393,MATH 18,B03,083750,Staff,0,11,30,30
1650534860393,MATH 18,B04,083751,Staff,0,12,30,30
1650534866416,MATH 20A,A01,083754,Staff,22,0,40,18
1650534872443,MATH 20B,A01,083756,Staff,0,11,30,30
1650534872443,MATH 20B,A02,083757,Staff,0,12,30,30
1650534878472,MATH 20C,A01,083760,Staff,0,16,30,30
1650534878472,MATH 20C,A02,083761,Staff,2,14,30,28
1650534878472,MATH 20C,B01,083762,Staff,12,0,30,18
1650534878472,MATH 20C,B02,083763,Staff,28,0,30,2
1650534884501,MATH 20D,A01,083765,Staff,0,1,30,30
1650534884501,MATH 20D,A02,083766,Staff,7,0,30,23
1650534884501,MATH 20D,A03,083767,Staff,25,0,30,5
1650534890529,MATH 20E,A01,083771,Staff,6,0,30,24
1650534890529,MATH 20E,A02,083772,Staff,18,0,30,12
1650534890529,MATH 20E,B01,083773,Staff,0,0,30,30
1650534890529,MATH 20E,B02,083774,Staff,10,0,30,20
1650534896558,MATH 103A,A01,083777,Staff,0,15,30,30
1650534896558,MATH 103A,A02,083778,Staff,0,14,30,30
1650534896558,MATH 103A,B01,083779,Staff,0,13,30,30
1650534896558,MATH 103A,B02,083780,Staff,0,13,30,30
1650534902583,MATH 105,A01,085443,Staff,0,21,30,30
1650534908610,MATH 109,A01,083213,Anzaldo; Leesa B,0,8,30,30
1650534908610,MATH 109,A02,083214,Anzaldo; Leesa B,0,7,30,30
1650534908610,MATH 109,B01,083215,Anzaldo; Leesa B,0,5,30,30
1650534908610,MATH 109,B02,083216,Anzaldo; Leesa B,0,6,30,30
1650534914651,MATH 142A,A01,083219,Chow; Bennett,0,16,30,30
1650534914651,MATH 142A,A02,083220,Chow; Bennett,0,14,30,30
1650534914651,MATH 142A,B01,083221,Chow; Bennett,0,13,30,30
1650534914651,MATH 142A,B02,083222,Chow; Bennett,0,13,30,30
1650534920674,MATH 193A,A01,083224,Staff,0,6,30,30
1650534920674,MATH 193A,A02,083225,Staff,0,5,30,30
1650534920674,MATH 193A,A03,083781,Staff,0,5,30,30
1650534920674,MATH 193A,A04,083782,Staff,0,7,30,30
1650534926701,MATH 197,001,091859,McAuley; Julian John,9998,0,9999,1
1650534932752,COGS 9,A01,083615,Staff,0,16,60,60
1650534938775,COGS 11,A01,083617,Boyle; Mary E. T.,19,0,40,21
1650534944802,COGS 13,A01,083071,Staff,0,35,40,40
1650534950829,COGS 14A,A01,092681,Staff,0,25,100,100
1650534956853,COGS 14B,A01,083073,Cheng; Tzu-Han,0,12,50,50
1650534962880,COGS 17,A01,092677,Staff,19,0,75,56
1650534968913,COGS 100,A01,083619,Staff,0,26,60,60
1650534974941,COGS 101A,A01,083621,Davis; Joshua Daniel,0,26,60,60
1650534980968,COGS 101B,A01,091572,Staff,1,5,60,59
1650534986991,COGS 101C,A01,083625,Delgado; Tania,15,0,30,15
1650534993018,COGS 107A,A01,083627,Boyle; Mary E. T.,0,11,60,60
1650534999044,COGS 118A,A01,083075,Staff,0,3,60,60
1650535005074,CSE 3,A50,083646,Miranda; Gregory Joseph,20,0,38,18
1650535005074,CSE 3,A51,083647,Miranda; Gregory Joseph,36,0,37,1
1650535011102,CSE 8A,A50,083650,Miranda; Gregory Joseph,0,29,40,40
1650535017129,CSE 11,A01,083080,Cao; Yingjun,0,94,40,40
1650535023159,CSE 12,A01,083652,Staff,0,17,100,100
1650535029182,CSE 15L,A01,083654,Staff,0,1,50,50
1650535029182,CSE 15L,A02,083655,Staff,0,0,50,50
1650535035208,CSE 20,A01,083657,Staff,51,0,80,29
1650535041235,CSE 30,A01,083084,Eldon; John,0,77,40,40
1650535047261,CSE 100,A01,083659,Cao; Yingjun,0,66,50,50
1650535053288,CSE 134B,A01,083661,Powell; Thomas Allan,0,34,65,65
1650535059317,CSE 140,A01,083663,Staff,0,5,75,75
1650535065340,CSE 140L,A01,083088,Eldon; John,0,11,75,75
1650535071369,CSE 175,A01,083665,Kumar; Rakesh,7,0,25,18
1650535077395,CSE 190,A00,092507,Dubnov; Shlomo,10,0,20,10
1650535083426,ECE 45,A01,083139,Staff,0,1,60,60
1650535089450,ECE 65,A50,083695,Staff,0,6,30,30
1650535095477,ECE 109,A01,091882,Touri; Behrouz,33,0,70,37
1650535101501,ECE 180,A00,083140,Abi Samra; Nicholas Camill,21,0,30,9
1650535101501,ECE 180,B00,083141,Abi Samra; Nicholas Camill,0,0,30,30
1650535107534,MATH 10A,A01,083735,Patchell; Gregory David,5,0,30,25
1650535107534,MATH 10A,A02,083736,Patchell; Gregory David,27,0,30,3
1650535107534,MATH 10A,A03,083737,Patchell; Gregory David,24,0,30,6
1650535113563,MATH 10B,A01,083207,Staff,0,9,30,30
1650535113563,MATH 10B,A02,083208,Staff,0,7,30,30
1650535113563,MATH 10B,B01,083739,Staff,12,0,30,18
1650535113563,MATH 10B,B02,083740,Staff,28,0,30,2
1650535119588,MATH 18,A01,083743,Staff,1,0,30,29
1650535119588,MATH 18,A02,083744,Staff,27,0,30,3
1650535119588,MATH 18,A03,083745,Staff,22,0,30,8
1650535119588,MATH 18,A04,083746,Staff,26,0,30,4
1650535119588,MATH 18,B01,083748,Staff,0,12,30,30
1650535119588,MATH 18,B02,083749,Staff,0,12,30,30
1650535119588,MATH 18,B03,083750,Staff,0,11,30,30
1650535119588,MATH 18,B04,083751,Staff,0,12,30,30
1650535125623,MATH 20A,A01,083754,Staff,22,0,40,18
1650535131664,MATH 20B,A01,083756,Staff,0,11,30,30
1650535131664,MATH 20B,A02,083757,Staff,0,12,30,30
1650535137691,MATH 20C,A01,083760,Staff,0,16,30,30
1650535137691,MATH 20C,A02,083761,Staff,2,14,30,28
1650535137691,MATH 20C,B01,083762,Staff,12,0,30,18
1650535137691,MATH 20C,B02,083763,Staff,28,0,30,2
1650535143715,MATH 20D,A01,083765,Staff,0,1,30,30
1650535143715,MATH 20D,A02,083766,Staff,7,0,30,23
1650535143715,MATH 20D,A03,083767,Staff,25,0,30,5
1650535149743,MATH 20E,A01,083771,Staff,6,0,30,24
1650535149743,MATH 20E,A02,083772,Staff,18,0,30,12
1650535149743,MATH 20E,B01,083773,Staff,0,0,30,30
1650535149743,MATH 20E,B02,083774,Staff,10,0,30,20
1650535155766,MATH 103A,A01,083777,Staff,0,15,30,30
1650535155766,MATH 103A,A02,083778,Staff,0,14,30,30
1650535155766,MATH 103A,B01,083779,Staff,0,13,30,30
1650535155766,MATH 103A,B02,083780,Staff,0,13,30,30
1650535161803,MATH 105,A01,085443,Staff,0,21,30,30
1650535167830,MATH 109,A01,083213,Anzaldo; Leesa B,0,8,30,30
1650535167830,MATH 109,A02,083214,Anzaldo; Leesa B,0,7,30,30
1650535167830,MATH 109,B01,083215,Anzaldo; Leesa B,0,5,30,30
1650535167830,MATH 109,B02,083216,Anzaldo; Leesa B,0,6,30,30
1650535173865,MATH 142A,A01,083219,Chow; Bennett,0,16,30,30
1650535173865,MATH 142A,A02,083220,Chow; Bennett,0,14,30,30
1650535173865,MATH 142A,B01,083221,Chow; Bennett,0,13,30,30
1650535173865,MATH 142A,B02,083222,Chow; Bennett,0,13,30,30
1650535179889,MATH 193A,A01,083224,Staff,0,6,30,30
1650535179889,MATH 193A,A02,083225,Staff,0,5,30,30
1650535179889,MATH 193A,A03,083781,Staff,0,5,30,30
1650535179889,MATH 193A,A04,083782,Staff,0,7,30,30
1650535185914,MATH 197,001,091859,McAuley; Julian John,9998,0,9999,1
1650535191972,COGS 9,A01,083615,Staff,0,16,60,60
1650535198002,COGS 11,A01,083617,Boyle; Mary E. T.,19,0,40,21
1650535204030,COGS 13,A01,083071,Staff,0,35,40,40
1650535210054,COGS 14A,A01,092681,Staff,0,26,100,100
1650535216082,COGS 14B,A01,083073,Cheng; Tzu-Han,0,12,50,50
1650535222107,COGS 17,A01,092677,Staff,19,0,75,56
1650535228130,COGS 100,A01,083619,Staff,0,26,60,60
1650535234155,COGS 101A,A01,083621,Davis; Joshua Daniel,0,26,60,60
1650535240190,COGS 101B,A01,091572,Staff,1,5,60,59
1650535246214,COGS 101C,A01,083625,Delgado; Tania,15,0,30,15
1650535252239,COGS 107A,A01,083627,Boyle; Mary E. T.,0,11,60,60
1650535258262,COGS 118A,A01,083075,Staff,0,3,60,60
1650535264296,CSE 3,A50,083646,Miranda; Gregory Joseph,20,0,38,18
1650535264296,CSE 3,A51,083647,Miranda; Gregory Joseph,36,0,37,1
1650535270321,CSE 8A,A50,083650,Miranda; Gregory Joseph,0,29,40,40
1650535276352,CSE 11,A01,083080,Cao; Yingjun,0,94,40,40
1650535282376,CSE 12,A01,083652,Staff,0,17,100,100
1650535288404,CSE 15L,A01,083654,Staff,0,1,50,50
1650535288404,CSE 15L,A02,083655,Staff,0,0,50,50
1650535294515,CSE 20,A01,083657,Staff,51,0,80,29
1650535300538,CSE 30,A01,083084,Eldon; John,0,77,40,40
1650535306563,CSE 100,A01,083659,Cao; Yingjun,0,66,50,50
1650535312588,CSE 134B,A01,083661,Powell; Thomas Allan,0,34,65,65
1650535318614,CSE 140,A01,083663,Staff,0,5,75,75
1650535324647,CSE 140L,A01,083088,Eldon; John,0,11,75,75
1650535330674,CSE 175,A01,083665,Kumar; Rakesh,7,0,25,18
1650535336698,CSE 190,A00,092507,Dubnov; Shlomo,10,0,20,10
1650535342725,ECE 45,A01,083139,Staff,0,1,60,60
1650535348748,ECE 65,A50,083695,Staff,0,6,30,30
1650535354776,ECE 109,A01,091882,Touri; Behrouz,33,0,70,37
1650535360803,ECE 180,A00,083140,Abi Samra; Nicholas Camill,21,0,30,9
1650535360803,ECE 180,B00,083141,Abi Samra; Nicholas Camill,0,0,30,30
1650535366831,MATH 10A,A01,083735,Patchell; Gregory David,5,0,30,25
1650535366831,MATH 10A,A02,083736,Patchell; Gregory David,27,0,30,3
1650535366831,MATH 10A,A03,083737,Patchell; Gregory David,24,0,30,6
1650535372856,MATH 10B,A01,083207,Staff,0,9,30,30
1650535372856,MATH 10B,A02,083208,Staff,0,7,30,30
1650535372856,MATH 10B,B01,083739,Staff,12,0,30,18
1650535372856,MATH 10B,B02,083740,Staff,28,0,30,2
1650535378885,MATH 18,A01,083743,Staff,1,0,30,29
1650535378885,MATH 18,A02,083744,Staff,26,0,30,4
1650535378885,MATH 18,A03,083745,Staff,22,0,30,8
1650535378885,MATH 18,A04,083746,Staff,26,0,30,4
1650535378885,MATH 18,B01,083748,Staff,0,12,30,30
1650535378885,MATH 18,B02,083749,Staff,0,12,30,30
1650535378885,MATH 18,B03,083750,Staff,0,11,30,30
1650535378885,MATH 18,B04,083751,Staff,0,12,30,30
1650535384909,MATH 20A,A01,083754,Staff,22,0,40,18
1650535390933,MATH 20B,A01,083756,Staff,0,11,30,30
1650535390933,MATH 20B,A02,083757,Staff,0,12,30,30
1650535396958,MATH 20C,A01,083760,Staff,0,16,30,30
1650535396958,MATH 20C,A02,083761,Staff,2,14,30,28
1650535396958,MATH 20C,B01,083762,Staff,12,0,30,18
1650535396958,MATH 20C,B02,083763,Staff,28,0,30,2
1650535402988,MATH 20D,A01,083765,Staff,0,1,30,30
1650535402988,MATH 20D,A02,083766,Staff,7,0,30,23
1650535402988,MATH 20D,A03,083767,Staff,25,0,30,5
1650535409012,MATH 20E,A01,083771,Staff,6,0,30,24
1650535409012,MATH 20E,A02,083772,Staff,18,0,30,12
1650535409012,MATH 20E,B01,083773,Staff,0,0,30,30
1650535409012,MATH 20E,B02,083774,Staff,10,0,30,20
1650535415035,MATH 103A,A01,083777,Staff,0,15,30,30
1650535415035,MATH 103A,A02,083778,Staff,0,14,30,30
1650535415035,MATH 103A,B01,083779,Staff,0,13,30,30
1650535415035,MATH 103A,B02,083780,Staff,0,13,30,30
1650535421060,MATH 105,A01,085443,Staff,0,21,30,30
1650535427088,MATH 109,A01,083213,Anzaldo; Leesa B,0,8,30,30
1650535427088,MATH 109,A02,083214,Anzaldo; Leesa B,0,7,30,30
1650535427088,MATH 109,B01,083215,Anzaldo; Leesa B,0,5,30,30
1650535427088,MATH 109,B02,083216,Anzaldo; Leesa B,0,6,30,30
1650535433113,MATH 142A,A01,083219,Chow; Bennett,0,16,30,30
1650535433113,MATH 142A,A02,083220,Chow; Bennett,0,14,30,30
1650535433113,MATH 142A,B01,083221,Chow; Bennett,0,13,30,30
1650535433113,MATH 142A,B02,083222,Chow; Bennett,0,13,30,30
1650535439137,MATH 193A,A01,083224,Staff,0,6,30,30
1650535439137,MATH 193A,A02,083225,Staff,0,5,30,30
1650535439137,MATH 193A,A03,083781,Staff,0,5,30,30
1650535439137,MATH 193A,A04,083782,Staff,0,7,30,30
1650535445160,MATH 197,001,091859,McAuley; Julian John,9998,0,9999,1
1650535451213,COGS 9,A01,083615,Staff,0,16,60,60
1650535457238,COGS 11,A01,083617,Boyle; Mary E. T.,19,0,40,21
1650535463265,COGS 13,A01,083071,Staff,0,35,40,40
1650535469288,COGS 14A,A01,092681,Staff,0,26,100,100
1650535475312,COGS 14B,A01,083073,Cheng; Tzu-Han,0,12,50,50
1650535481341,COGS 17,A01,092677,Staff,19,0,75,56
1650535487375,COGS 100,A01,083619,Staff,0,26,60,60
1650535493400,COGS 101A,A01,083621,Davis; Joshua Daniel,0,26,60,60
1650535499426,COGS 101B,A01,091572,Staff,1,5,60,59
1650535505451,COGS 101C,A01,083625,Delgado; Tania,15,0,30,15
1650535511474,COGS 107A,A01,083627,Boyle; Mary E. T.,0,11,60,60
1650535517499,COGS 118A,A01,083075,Staff,0,3,60,60
1650535523528,CSE 3,A50,083646,Miranda; Gregory Joseph,20,0,38,18
1650535523528,CSE 3,A51,083647,Miranda; Gregory Joseph,36,0,37,1
1650535529564,CSE 8A,A50,083650,Miranda; Gregory Joseph,0,29,40,40
1650535535591,CSE 11,A01,083080,Cao; Yingjun,0,94,40,40
1650535541618,CSE 12,A01,083652,Staff,0,17,100,100
1650535547644,CSE 15L,A01,083654,Staff,0,1,50,50
1650535547644,CSE 15L,A02,083655,Staff,0,0,50,50
1650535553668,CSE 20,A01,083657,Staff,51,0,80,29
1650535559692,CSE 30,A01,083084,Eldon; John,0,77,40,40
1650535565721,CSE 100,A01,083659,Cao; Yingjun,0,66,50,50
1650535571745,CSE 134B,A01,083661,Powell; Thomas Allan,0,34,65,65
1650535577770,CSE 140,A01,083663,Staff,0,5,75,75
1650535583795,CSE 140L,A01,083088,Eldon; John,0,11,75,75
1650535589820,CSE 175,A01,083665,Kumar; Rakesh,7,0,25,18
1650535595844,CSE 190,A00,092507,Dubnov; Shlomo,10,0,20,10
1650535601868,ECE 45,A01,083139,Staff,0,1,60,60
1650535607890,ECE 65,A50,083695,Staff,0,6,30,30
1650535613915,ECE 109,A01,091882,Touri; Behrouz,33,0,70,37
1650535619937,ECE 180,A00,083140,Abi Samra; Nicholas Camill,21,0,30,9
1650535619937,ECE 180,B00,083141,Abi Samra; Nicholas Camill,0,0,30,30
1650535625963,MATH 10A,A01,083735,Patchell; Gregory David,5,0,30,25
1650535625963,MATH 10A,A02,083736,Patchell; Gregory David,27,0,30,3
1650535625963,MATH 10A,A03,083737,Patchell; Gregory David,24,0,30,6
1650535631991,MATH 10B,A01,083207,Staff,0,9,30,30
1650535631991,MATH 10B,A02,083208,Staff,0,7,30,30
1650535631991,MATH 10B,B01,083739,Staff,12,0,30,18
1650535631991,MATH 10B,B02,083740,Staff,28,0,30,2
1650535638021,MATH 18,A01,083743,Staff,1,0,30,29
1650535638021,MATH 18,A02,083744,Staff,26,0,30,4
1650535638021,MATH 18,A03,083745,Staff,22,0,30,8
1650535638021,MATH 18,A04,083746,Staff,26,0,30,4
1650535638021,MATH 18,B01,083748,Staff,0,12,30,30
1650535638021,MATH 18,B02,083749,Staff,0,12,30,30
1650535638021,MATH 18,B03,083750,Staff,0,11,30,30
1650535638021,MATH 18,B04,083751,Staff,0,12,30,30
1650535644048,MATH 20A,A01,083754,Staff,22,0,40,18
1650535650071,MATH 20B,A01,083756,Staff,0,11,30,30
1650535650071,MATH 20B,A02,083757,Staff,0,12,30,30
1650535656098,MATH 20C,A01,083760,Staff,0,16,30,30
1650535656098,MATH 20C,A02,083761,Staff,2,14,30,28
1650535656098,MATH 20C,B01,083762,Staff,12,0,30,18
1650535656098,MATH 20C,B02,083763,Staff,28,0,30,2
1650535662124,MATH 20D,A01,083765,Staff,0,1,30,30
1650535662124,MATH 20D,A02,083766,Staff,7,0,30,23
1650535662124,MATH 20D,A03,083767,Staff,25,0,30,5
1650535668148,MATH 20E,A01,083771,Staff,6,0,30,24
1650535668148,MATH 20E,A02,083772,Staff,18,0,30,12
1650535668148,MATH 20E,B01,083773,Staff,0,0,30,30
1650535668148,MATH 20E,B02,083774,Staff,10,0,30,20
1650535674171,MATH 103A,A01,083777,Staff,0,15,30,30
1650535674171,MATH 103A,A02,083778,Staff,0,14,30,30
1650535674171,MATH 103A,B01,083779,Staff,0,13,30,30
1650535674171,MATH 103A,B02,083780,Staff,0,13,30,30
1650535680195,MATH 105,A01,085443,Staff,0,21,30,30
1650535686219,MATH 109,A01,083213,Anzaldo; Leesa B,0,8,30,30
1650535686219,MATH 109,A02,083214,Anzaldo; Leesa B,0,7,30,30
1650535686219,MATH 109,B01,083215,Anzaldo; Leesa B,0,5,30,30
1650535686219,MATH 109,B02,083216,Anzaldo; Leesa B,0,6,30,30
1650535692249,MATH 142A,A01,083219,Chow; Bennett,0,16,30,30
1650535692249,MATH 142A,A02,083220,Chow; Bennett,0,14,30,30
1650535692249,MATH 142A,B01,083221,Chow; Bennett,0,13,30,30
1650535692249,MATH 142A,B02,083222,Chow; Bennett,0,13,30,30
1650535698278,MATH 193A,A01,083224,Staff,0,6,30,30
1650535698278,MATH 193A,A02,083225,Staff,0,5,30,30
1650535698278,MATH 193A,A03,083781,Staff,0,5,30,30
1650535698278,MATH 193A,A04,083782,Staff,0,7,30,30
1650535704303,MATH 197,001,091859,McAuley; Julian John,9998,0,9999,1
1650535710358,COGS 9,A01,083615,Staff,0,16,60,60
1650535716382,COGS 11,A01,083617,Boyle; Mary E. T.,19,0,40,21
1650535722409,COGS 13,A01,083071,Staff,0,35,40,40
1650535728435,COGS 14A,A01,092681,Staff,0,26,100,100
1650535734460,COGS 14B,A01,083073,Cheng; Tzu-Han,0,12,50,50
1650535740493,COGS 17,A01,092677,Staff,19,0,75,56
1650535746518,COGS 100,A01,083619,Staff,0,26,60,60
1650535752543,COGS 101A,A01,083621,Davis; Joshua Daniel,0,26,60,60
1650535758566,COGS 101B,A01,091572,Staff,1,5,60,59
1650535764589,COGS 101C,A01,083625,Delgado; Tania,15,0,30,15
1650535770616,COGS 107A,A01,083627,Boyle; Mary E. T.,0,11,60,60
1650535776640,COGS 118A,A01,083075,Staff,0,3,60,60
1650535782663,CSE 3,A50,083646,Miranda; Gregory Joseph,20,0,38,18
1650535782663,CSE 3,A51,083647,Miranda; Gregory Joseph,36,0,37,1
1650535788685,CSE 8A,A50,083650,Miranda; Gregory Joseph,0,29,40,40
1650535794712,CSE 11,A01,083080,Cao; Yingjun,0,94,40,40
1650535800736,CSE 12,A01,083652,Staff,0,17,100,100
1650535806761,CSE 15L,A01,083654,Staff,0,1,50,50
1650535806761,CSE 15L,A02,083655,Staff,0,0,50,50
1650535812791,CSE 20,A01,083657,Staff,51,0,80,29
1650535818815,CSE 30,A01,083084,Eldon; John,0,77,40,40
1650535824840,CSE 100,A01,083659,Cao; Yingjun,0,66,50,50
1650535830863,CSE 134B,A01,083661,Powell; Thomas Allan,0,34,65,65
1650535836886,CSE 140,A01,083663,Staff,0,5,75,75
1650535842922,CSE 140L,A01,083088,Eldon; John,0,11,75,75
1650535848951,CSE 175,A01,083665,Kumar; Rakesh,7,0,25,18
1650535854978,CSE 190,A00,092507,Dubnov; Shlomo,10,0,20,10
1650535861002,ECE 45,A01,083139,Staff,0,1,60,60
1650535867030,ECE 65,A50,083695,Staff,0,6,30,30
1650535873078,ECE 109,A01,091882,Touri; Behrouz,33,0,70,37
1650535879109,ECE 180,A00,083140,Abi Samra; Nicholas Camill,21,0,30,9
1650535879109,ECE 180,B00,083141,Abi Samra; Nicholas Camill,0,0,30,30
1650535885135,MATH 10A,A01,083735,Patchell; Gregory David,5,0,30,25
1650535885135,MATH 10A,A02,083736,Patchell; Gregory David,27,0,30,3
1650535885135,MATH 10A,A03,083737,Patchell; Gregory David,24,0,30,6
1650535891234,MATH 10B,A01,083207,Staff,0,9,30,30
1650535891234,MATH 10B,A02,083208,Staff,0,7,30,30
1650535891234,MATH 10B,B01,083739,Staff,12,0,30,18
1650535891234,MATH 10B,B02,083740,Staff,28,0,30,2
1650535897263,MATH 18,A01,083743,Staff,1,0,30,29
1650535897263,MATH 18,A02,083744,Staff,26,0,30,4
1650535897263,MATH 18,A03,083745,Staff,22,0,30,8
1650535897263,MATH 18,A04,083746,Staff,26,0,30,4
1650535897263,MATH 18,B01,083748,Staff,0,12,30,30
1650535897263,MATH 18,B02,083749,Staff,0,12,30,30
1650535897263,MATH 18,B03,083750,Staff,0,11,30,30
1650535897263,MATH 18,B04,083751,Staff,0,12,30,30
1650535903287,MATH 20A,A01,083754,Staff,22,0,40,18
1650535909310,MATH 20B,A01,083756,Staff,0,11,30,30
1650535909310,MATH 20B,A02,083757,Staff,0,12,30,30
1650535915333,MATH 20C,A01,083760,Staff,0,16,30,30
1650535915333,MATH 20C,A02,083761,Staff,2,14,30,28
1650535915333,MATH 20C,B01,083762,Staff,12,0,30,18
1650535915333,MATH 20C,B02,083763,Staff,28,0,30,2
1650535921358,MATH 20D,A01,083765,Staff,0,1,30,30
1650535921358,MATH 20D,A02,083766,Staff,7,0,30,23
1650535921358,MATH 20D,A03,083767,Staff,25,0,30,5
1650535927382,MATH 20E,A01,083771,Staff,6,0,30,24
1650535927382,MATH 20E,A02,083772,Staff,18,0,30,12
1650535927382,MATH 20E,B01,083773,Staff,0,0,30,30
1650535927382,MATH 20E,B02,083774,Staff,10,0,30,20
1650535933407,MATH 103A,A01,083777,Staff,0,15,30,30
1650535933407,MATH 103A,A02,083778,Staff,0,14,30,30
1650535933407,MATH 103A,B01,083779,Staff,0,13,30,30
1650535933407,MATH 103A,B02,083780,Staff,0,13,30,30
1650535939432,MATH 105,A01,085443,Staff,0,21,30,30
1650535945455,MATH 109,A01,083213,Anzaldo; Leesa B,0,8,30,30
1650535945455,MATH 109,A02,083214,Anzaldo; Leesa B,0,7,30,30
1650535945455,MATH 109,B01,083215,Anzaldo; Leesa B,0,5,30,30
1650535945455,MATH 109,B02,083216,Anzaldo; Leesa B,0,6,30,30
1650535951483,MATH 142A,A01,083219,Chow; Bennett,0,16,30,30
1650535951483,MATH 142A,A02,083220,Chow; Bennett,0,14,30,30
1650535951483,MATH 142A,B01,083221,Chow; Bennett,0,13,30,30
1650535951483,MATH 142A,B02,083222,Chow; Bennett,0,13,30,30
1650535957512,MATH 193A,A01,083224,Staff,0,6,30,30
1650535957512,MATH 193A,A02,083225,Staff,0,5,30,30
1650535957512,MATH 193A,A03,083781,Staff,0,5,30,30
1650535957512,MATH 193A,A04,083782,Staff,0,7,30,30
1650535963535,MATH 197,001,091859,McAuley; Julian John,9998,0,9999,1
1650535969596,COGS 9,A01,083615,Staff,0,16,60,60
1650535975617,COGS 11,A01,083617,Boyle; Mary E. T.,19,0,40,21
1650535981650,COGS 13,A01,083071,Staff,0,35,40,40
1650535987675,COGS 14A,A01,092681,Staff,0,26,100,100
1650535993698,COGS 14B,A01,083073,Cheng; Tzu-Han,0,12,50,50
1650535999722,COGS 17,A01,092677,Staff,19,0,75,56
1650536005747,COGS 100,A01,083619,Staff,0,26,60,60
1650536011770,COGS 101A,A01,083621,Davis; Joshua Daniel,0,26,60,60
1650536017804,COGS 101B,A01,091572,Staff,1,5,60,59
1650536023828,COGS 101C,A01,083625,Delgado; Tania,15,0,30,15
1650536029856,COGS 107A,A01,083627,Boyle; Mary E. T.,0,11,60,60
1650536035890,COGS 118A,A01,083075,Staff,0,3,60,60
1650536041917,CSE 3,A50,083646,Miranda; Gregory Joseph,20,0,38,18
1650536041917,CSE 3,A51,083647,Miranda; Gregory Joseph,36,0,37,1
1650536047940,CSE 8A,A50,083650,Miranda; Gregory Joseph,0,29,40,40
1650536053965,CSE 11,A01,083080,Cao; Yingjun,0,94,40,40
1650536059992,CSE 12,A01,083652,Staff,0,17,100,100
1650536066018,CSE 15L,A01,083654,Staff,0,1,50,50
1650536066018,CSE 15L,A02,083655,Staff,0,0,50,50
1650536072045,CSE 20,A01,083657,Staff,51,0,80,29
1650536078068,CSE 30,A01,083084,Eldon; John,0,77,40,40
1650536084093,CSE 100,A01,083659,Cao; Yingjun,0,66,50,50
1650536090117,CSE 134B,A01,083661,Powell; Thomas Allan,0,34,65,65
1650536096151,CSE 140,A01,083663,Staff,0,5,75,75
1650536102174,CSE 140L,A01,083088,Eldon; John,0,11,75,75
1650536108197,CSE 175,A01,083665,Kumar; Rakesh,7,0,25,18
1650536114221,CSE 190,A00,092507,Dubnov; Shlomo,10,0,20,10
1650536120250,ECE 45,A01,083139,Staff,0,1,60,60
1650536126273,ECE 65,A50,083695,Staff,0,6,30,30
1650536132306,ECE 109,A01,091882,Touri; Behrouz,33,0,70,37
1650536138338,ECE 180,A00,083140,Abi Samra; Nicholas Camill,21,0,30,9
1650536138338,ECE 180,B00,083141,Abi Samra; Nicholas Camill,0,0,30,30
1650536144370,MATH 10A,A01,083735,Patchell; Gregory David,5,0,30,25
1650536144370,MATH 10A,A02,083736,Patchell; Gregory David,27,0,30,3
1650536144370,MATH 10A,A03,083737,Patchell; Gregory David,24,0,30,6
1650536150406,MATH 10B,A01,083207,Staff,0,9,30,30
1650536150406,MATH 10B,A02,083208,Staff,0,7,30,30
1650536150406,MATH 10B,B01,083739,Staff,12,0,30,18
1650536150406,MATH 10B,B02,083740,Staff,28,0,30,2
1650536156438,MATH 18,A01,083743,Staff,1,0,30,29
1650536156438,MATH 18,A02,083744,Staff,26,0,30,4
1650536156438,MATH 18,A03,083745,Staff,22,0,30,8
1650536156438,MATH 18,A04,083746,Staff,26,0,30,4
1650536156438,MATH 18,B01,083748,Staff,0,12,30,30
1650536156438,MATH 18,B02,083749,Staff,0,12,30,30
1650536156438,MATH 18,B03,083750,Staff,0,11,30,30
1650536156438,MATH 18,B04,083751,Staff,0,12,30,30
1650536162463,MATH 20A,A01,083754,Staff,22,0,40,18
1650536168487,MATH 20B,A01,083756,Staff,0,11,30,30
1650536168487,MATH 20B,A02,083757,Staff,0,12,30,30
1650536174511,MATH 20C,A01,083760,Staff,0,16,30,30
1650536174511,MATH 20C,A02,083761,Staff,2,14,30,28
1650536174511,MATH 20C,B01,083762,Staff,12,0,30,18
1650536174511,MATH 20C,B02,083763,Staff,28,0,30,2
1650536180538,MATH 20D,A01,083765,Staff,0,1,30,30
1650536180538,MATH 20D,A02,083766,Staff,7,0,30,23
1650536180538,MATH 20D,A03,083767,Staff,25,0,30,5
1650536186563,MATH 20E,A01,083771,Staff,6,0,30,24
1650536186563,MATH 20E,A02,083772,Staff,18,0,30,12
1650536186563,MATH 20E,B01,083773,Staff,0,0,30,30
1650536186563,MATH 20E,B02,083774,Staff,10,0,30,20
1650536192589,MATH 103A,A01,083777,Staff,0,15,30,30
1650536192589,MATH 103A,A02,083778,Staff,0,14,30,30
1650536192589,MATH 103A,B01,083779,Staff,0,13,30,30
1650536192589,MATH 103A,B02,083780,Staff,0,13,30,30
1650536198617,MATH 105,A01,085443,Staff,0,21,30,30
1650536204643,MATH 109,A01,083213,Anzaldo; Leesa B,0,8,30,30
1650536204643,MATH 109,A02,083214,Anzaldo; Leesa B,0,7,30,30
1650536204643,MATH 109,B01,083215,Anzaldo; Leesa B,0,5,30,30
1650536204643,MATH 109,B02,083216,Anzaldo; Leesa B,0,6,30,30
1650536210673,MATH 142A,A01,083219,Chow; Bennett,0,16,30,30
1650536210673,MATH 142A,A02,083220,Chow; Bennett,0,14,30,30
1650536210673,MATH 142A,B01,083221,Chow; Bennett,0,13,30,30
1650536210673,MATH 142A,B02,083222,Chow; Bennett,0,13,30,30
1650536216698,MATH 193A,A01,083224,Staff,0,6,30,30
1650536216698,MATH 193A,A02,083225,Staff,0,5,30,30
1650536216698,MATH 193A,A03,083781,Staff,0,5,30,30
1650536216698,MATH 193A,A04,083782,Staff,0,7,30,30
1650536222723,MATH 197,001,091859,McAuley; Julian John,9998,0,9999,1
1650536228809,COGS 9,A01,083615,Staff,0,16,60,60
1650536234834,COGS 11,A01,083617,Boyle; Mary E. T.,19,0,40,21
1650536240859,COGS 13,A01,083071,Staff,0,35,40,40
1650536246913,COGS 14A,A01,092681,Staff,0,26,100,100
1650536252938,COGS 14B,A01,083073,Cheng; Tzu-Han,0,12,50,50
1650536258966,COGS 17,A01,092677,Staff,19,0,75,56
1650536264991,COGS 100,A01,083619,Staff,0,26,60,60
1650536271020,COGS 101A,A01,083621,Davis; Joshua Daniel,0,26,60,60
1650536277100,COGS 101B,A01,091572,Staff,1,5,60,59
1650536283128,COGS 101C,A01,083625,Delgado; Tania,15,0,30,15
1650536289155,COGS 107A,A01,083627,Boyle; Mary E. T.,0,11,60,60
1650536295182,COGS 118A,A01,083075,Staff,0,3,60,60
1650536301208,CSE 3,A50,083646,Miranda; Gregory Joseph,20,0,38,18
1650536301208,CSE 3,A51,083647,Miranda; Gregory Joseph,36,0,37,1
1650536307233,CSE 8A,A50,083650,Miranda; Gregory Joseph,0,29,40,40
1650536313257,CSE 11,A01,083080,Cao; Yingjun,0,94,40,40
1650536319285,CSE 12,A01,083652,Staff,0,17,100,100
1650536325312,CSE 15L,A01,083654,Staff,0,1,50,50
1650536325312,CSE 15L,A02,083655,Staff,0,0,50,50
1650536331340,CSE 20,A01,083657,Staff,51,0,80,29
1650536337373,CSE 30,A01,083084,Eldon; John,0,77,40,40
1650536343412,CSE 100,A01,083659,Cao; Yingjun,0,66,50,50
1650536349442,CSE 134B,A01,083661,Powell; Thomas Allan,0,34,65,65
1650536355468,CSE 140,A01,083663,Staff,0,5,75,75
1650536361496,CSE 140L,A01,083088,Eldon; John,0,11,75,75
1650536367526,CSE 175,A01,083665,Kumar; Rakesh,7,0,25,18
1650536373560,CSE 190,A00,092507,Dubnov; Shlomo,10,0,20,10
1650536379588,ECE 45,A01,083139,Staff,0,1,60,60
1650536385613,ECE 65,A50,083695,Staff,0,6,30,30
1650536391647,ECE 109,A01,091882,Touri; Behrouz,33,0,70,37
1650536397677,ECE 180,A00,083140,Abi Samra; Nicholas Camill,21,0,30,9
1650536397677,ECE 180,B00,083141,Abi Samra; Nicholas Camill,0,0,30,30
1650536403712,MATH 10A,A01,083735,Patchell; Gregory David,5,0,30,25
1650536403712,MATH 10A,A02,083736,Patchell; Gregory David,27,0,30,3
1650536403712,MATH 10A,A03,083737,Patchell; Gregory David,24,0,30,6
1650536409742,MATH 10B,A01,083207,Staff,0,9,30,30
1650536409742,MATH 10B,A02,083208,Staff,0,7,30,30
1650536409742,MATH 10B,B01,083739,Staff,12,0,30,18
1650536409742,MATH 10B,B02,083740,Staff,28,0,30,2
1650536415772,MATH 18,A01,083743,Staff,1,0,30,29
1650536415772,MATH 18,A02,083744,Staff,26,0,30,4
1650536415772,MATH 18,A03,083745,Staff,22,0,30,8
1650536415772,MATH 18,A04,083746,Staff,26,0,30,4
1650536415772,MATH 18,B01,083748,Staff,0,12,30,30
1650536415772,MATH 18,B02,083749,Staff,0,12,30,30
1650536415772,MATH 18,B03,083750,Staff,0,11,30,30
1650536415772,MATH 18,B04,083751,Staff,0,12,30,30
1650536421796,MATH 20A,A01,083754,Staff,22,0,40,18
1650536427821,MATH 20B,A01,083756,Staff,0,11,30,30
1650536427821,MATH 20B,A02,083757,Staff,0,12,30,30
1650536433855,MATH 20C,A01,083760,Staff,0,16,30,30
1650536433855,MATH 20C,A02,083761,Staff,2,14,30,28
1650536433855,MATH 20C,B01,083762,Staff,12,0,30,18
1650536433855,MATH 20C,B02,083763,Staff,28,0,30,2
1650536439883,MATH 20D,A01,083765,Staff,0,1,30,30
1650536439883,MATH 20D,A02,083766,Staff,7,0,30,23
1650536439883,MATH 20D,A03,083767,Staff,25,0,30,5
1650536445915,MATH 20E,A01,083771,Staff,6,0,30,24
1650536445915,MATH 20E,A02,083772,Staff,18,0,30,12
1650536445915,MATH 20E,B01,083773,Staff,0,0,30,30
1650536445915,MATH 20E,B02,083774,Staff,10,0,30,20
1650536451947,MATH 103A,A01,083777,Staff,0,15,30,30
1650536451947,MATH 103A,A02,083778,Staff,0,14,30,30
1650536451947,MATH 103A,B01,083779,Staff,0,13,30,30
1650536451947,MATH 103A,B02,083780,Staff,0,13,30,30
1650536457975,MATH 105,A01,085443,Staff,0,21,30,30
1650536464014,MATH 109,A01,083213,Anzaldo; Leesa B,0,8,30,30
1650536464014,MATH 109,A02,083214,Anzaldo; Leesa B,0,7,30,30
1650536464014,MATH 109,B01,083215,Anzaldo; Leesa B,0,5,30,30
1650536464014,MATH 109,B02,083216,Anzaldo; Leesa B,0,6,30,30
1650536470053,MATH 142A,A01,083219,Chow; Bennett,0,16,30,30
1650536470053,MATH 142A,A02,083220,Chow; Bennett,0,14,30,30
1650536470053,MATH 142A,B01,083221,Chow; Bennett,0,13,30,30
1650536470053,MATH 142A,B02,083222,Chow; Bennett,0,13,30,30
1650536476081,MATH 193A,A01,083224,Staff,0,6,30,30
1650536476081,MATH 193A,A02,083225,Staff,0,5,30,30
1650536476081,MATH 193A,A03,083781,Staff,0,5,30,30
1650536476081,MATH 193A,A04,083782,Staff,0,7,30,30
1650536482106,MATH 197,001,091859,McAuley; Julian John,9998,0,9999,1
1650536488272,COGS 9,A01,083615,Staff,0,16,60,60
1650536494298,COGS 11,A01,083617,Boyle; Mary E. T.,19,0,40,21
1650536500323,COGS 13,A01,083071,Staff,0,35,40,40
1650536506356,COGS 14A,A01,092681,Staff,0,26,100,100
1650536512381,COGS 14B,A01,083073,Cheng; Tzu-Han,0,12,50,50
1650536518422,COGS 17,A01,092677,Staff,19,0,75,56
1650536524446,COGS 100,A01,083619,Staff,0,26,60,60
1650536530479,COGS 101A,A01,083621,Davis; Joshua Daniel,0,26,60,60
1650536536512,COGS 101B,A01,091572,Staff,1,5,60,59
1650536542547,COGS 101C,A01,083625,Delgado; Tania,15,0,30,15
1650536548578,COGS 107A,A01,083627,Boyle; Mary E. T.,0,11,60,60
1650536554607,COGS 118A,A01,083075,Staff,0,3,60,60
1650536560636,CSE 3,A50,083646,Miranda; Gregory Joseph,20,0,38,18
1650536560636,CSE 3,A51,083647,Miranda; Gregory Joseph,36,0,37,1
1650536566662,CSE 8A,A50,083650,Miranda; Gregory Joseph,0,29,40,40
1650536572697,CSE 11,A01,083080,Cao; Yingjun,0,94,40,40
1650536578722,CSE 12,A01,083652,Staff,0,17,100,100
1650536584746,CSE 15L,A01,083654,Staff,0,1,50,50
1650536584746,CSE 15L,A02,083655,Staff,0,0,50,50
1650536590776,CSE 20,A01,083657,Staff,51,0,80,29
1650536596801,CSE 30,A01,083084,Eldon; John,0,77,40,40
1650536602833,CSE 100,A01,083659,Cao; Yingjun,0,66,50,50
1650536608857,CSE 134B,A01,083661,Powell; Thomas Allan,0,34,65,65
1650536614900,CSE 140,A01,083663,Staff,0,5,75,75
1650536620927,CSE 140L,A01,083088,Eldon; John,0,11,75,75
1650536626960,CSE 175,A01,083665,Kumar; Rakesh,7,0,25,18
1650536632989,CSE 190,A00,092507,Dubnov; Shlomo,10,0,20,10
1650536639020,ECE 45,A01,083139,Staff,0,1,60,60
1650536645047,ECE 65,A50,083695,Staff,0,6,30,30
1650536651078,ECE 109,A01,091882,Touri; Behrouz,33,0,70,37
1650536657109,ECE 180,A00,083140,Abi Samra; Nicholas Camill,21,0,30,9
1650536657109,ECE 180,B00,083141,Abi Samra; Nicholas Camill,0,0,30,30
1650536663144,MATH 10A,A01,083735,Patchell; Gregory David,5,0,30,25
1650536663144,MATH 10A,A02,083736,Patchell; Gregory David,27,0,30,3
1650536663144,MATH 10A,A03,083737,Patchell; Gregory David,24,0,30,6
1650536669171,MATH 10B,A01,083207,Staff,0,9,30,30
1650536669171,MATH 10B,A02,083208,Staff,0,7,30,30
1650536669171,MATH 10B,B01,083739,Staff,12,0,30,18
1650536669171,MATH 10B,B02,083740,Staff,28,0,30,2
1650536675208,MATH 18,A01,083743,Staff,1,0,30,29
1650536675208,MATH 18,A02,083744,Staff,26,0,30,4
1650536675208,MATH 18,A03,083745,Staff,22,0,30,8
1650536675208,MATH 18,A04,083746,Staff,26,0,30,4
1650536675208,MATH 18,B01,083748,Staff,0,12,30,30
1650536675208,MATH 18,B02,083749,Staff,0,12,30,30
1650536675208,MATH 18,B03,083750,Staff,0,11,30,30
1650536675208,MATH 18,B04,083751,Staff,0,12,30,30
1650536681232,MATH 20A,A01,083754,Staff,22,0,40,18
1650536687262,MATH 20B,A01,083756,Staff,0,11,30,30
1650536687262,MATH 20B,A02,083757,Staff,0,12,30,30
1650536693292,MATH 20C,A01,083760,Staff,0,16,30,30
1650536693292,MATH 20C,A02,083761,Staff,2,14,30,28
1650536693292,MATH 20C,B01,083762,Staff,12,0,30,18
1650536693292,MATH 20C,B02,083763,Staff,28,0,30,2
1650536699325,MATH 20D,A01,083765,Staff,0,1,30,30
1650536699325,MATH 20D,A02,083766,Staff,7,0,30,23
1650536699325,MATH 20D,A03,083767,Staff,25,0,30,5
1650536705353,MATH 20E,A01,083771,Staff,6,0,30,24
1650536705353,MATH 20E,A02,083772,Staff,18,0,30,12
1650536705353,MATH 20E,B01,083773,Staff,0,0,30,30
1650536705353,MATH 20E,B02,083774,Staff,10,0,30,20
1650536711388,MATH 103A,A01,083777,Staff,0,15,30,30
1650536711388,MATH 103A,A02,083778,Staff,0,14,30,30
1650536711388,MATH 103A,B01,083779,Staff,0,13,30,30
1650536711388,MATH 103A,B02,083780,Staff,0,13,30,30
1650536717412,MATH 105,A01,085443,Staff,0,21,30,30
1650536723439,MATH 109,A01,083213,Anzaldo; Leesa B,0,8,30,30
1650536723439,MATH 109,A02,083214,Anzaldo; Leesa B,0,7,30,30
1650536723439,MATH 109,B01,083215,Anzaldo; Leesa B,0,5,30,30
1650536723439,MATH 109,B02,083216,Anzaldo; Leesa B,0,6,30,30
1650536729465,MATH 142A,A01,083219,Chow; Bennett,0,16,30,30
1650536729465,MATH 142A,A02,083220,Chow; Bennett,0,14,30,30
1650536729465,MATH 142A,B01,083221,Chow; Bennett,0,13,30,30
1650536729465,MATH 142A,B02,083222,Chow; Bennett,0,13,30,30
1650536735490,MATH 193A,A01,083224,Staff,0,6,30,30
1650536735490,MATH 193A,A02,083225,Staff,0,5,30,30
1650536735490,MATH 193A,A03,083781,Staff,0,5,30,30
1650536735490,MATH 193A,A04,083782,Staff,0,7,30,30
1650536741516,MATH 197,001,091859,McAuley; Julian John,9998,0,9999,1
1650536747590,COGS 9,A01,083615,Staff,0,16,60,60
1650536753624,COGS 11,A01,083617,Boyle; Mary E. T.,19,0,40,21
1650536759659,COGS 13,A01,083071,Staff,0,35,40,40
1650536765685,COGS 14A,A01,092681,Staff,0,26,100,100
1650536771716,COGS 14B,A01,083073,Cheng; Tzu-Han,0,12,50,50
1650536777743,COGS 17,A01,092677,Staff,19,0,75,56
1650536783772,COGS 100,A01,083619,Staff,0,26,60,60
1650536789804,COGS 101A,A01,083621,Davis; Joshua Daniel,0,26,60,60
1650536795833,COGS 101B,A01,091572,Staff,1,5,60,59
1650536801858,COGS 101C,A01,083625,Delgado; Tania,15,0,30,15
1650536807880,COGS 107A,A01,083627,Boyle; Mary E. T.,0,11,60,60
1650536813907,COGS 118A,A01,083075,Staff,0,3,60,60
1650536819934,CSE 3,A50,083646,Miranda; Gregory Joseph,20,0,38,18
1650536819934,CSE 3,A51,083647,Miranda; Gregory Joseph,36,0,37,1
1650536825960,CSE 8A,A50,083650,Miranda; Gregory Joseph,0,29,40,40
1650536831992,CSE 11,A01,083080,Cao; Yingjun,0,94,40,40
1650536838019,CSE 12,A01,083652,Staff,0,17,100,100
1650536844052,CSE 15L,A01,083654,Staff,0,1,50,50
1650536844052,CSE 15L,A02,083655,Staff,0,0,50,50
1650536850078,CSE 20,A01,083657,Staff,51,0,80,29
1650536856106,CSE 30,A01,083084,Eldon; John,0,77,40,40
1650536862136,CSE 100,A01,083659,Cao; Yingjun,0,66,50,50
1650536868167,CSE 134B,A01,083661,Powell; Thomas Allan,0,34,65,65
1650536874191,CSE 140,A01,083663,Staff,0,5,75,75
1650536880226,CSE 140L,A01,083088,Eldon; John,0,11,75,75
1650536886251,CSE 175,A01,083665,Kumar; Rakesh,7,0,25,18
1650536892275,CSE 190,A00,092507,Dubnov; Shlomo,10,0,20,10
1650536898306,ECE 45,A01,083139,Staff,0,1,60,60
1650536904332,ECE 65,A50,083695,Staff,0,6,30,30
1650536910358,ECE 109,A01,091882,Touri; Behrouz,33,0,70,37
1650536916385,ECE 180,A00,083140,Abi Samra; Nicholas Camill,21,0,30,9
1650536916385,ECE 180,B00,083141,Abi Samra; Nicholas Camill,0,0,30,30
1650536922416,MATH 10A,A01,083735,Patchell; Gregory David,5,0,30,25
1650536922416,MATH 10A,A02,083736,Patchell; Gregory David,27,0,30,3
1650536922416,MATH 10A,A03,083737,Patchell; Gregory David,24,0,30,6
1650536928451,MATH 10B,A01,083207,Staff,0,9,30,30
1650536928451,MATH 10B,A02,083208,Staff,0,7,30,30
1650536928451,MATH 10B,B01,083739,Staff,12,0,30,18
1650536928451,MATH 10B,B02,083740,Staff,28,0,30,2
1650536934479,MATH 18,A01,083743,Staff,1,0,30,29
1650536934479,MATH 18,A02,083744,Staff,26,0,30,4
1650536934479,MATH 18,A03,083745,Staff,22,0,30,8
1650536934479,MATH 18,A04,083746,Staff,26,0,30,4
1650536934479,MATH 18,B01,083748,Staff,0,12,30,30
1650536934479,MATH 18,B02,083749,Staff,0,12,30,30
1650536934479,MATH 18,B03,083750,Staff,0,11,30,30
1650536934479,MATH 18,B04,083751,Staff,0,12,30,30
1650536940506,MATH 20A,A01,083754,Staff,22,0,40,18
1650536946539,MATH 20B,A01,083756,Staff,0,11,30,30
1650536946539,MATH 20B,A02,083757,Staff,0,12,30,30
1650536952569,MATH 20C,A01,083760,Staff,0,16,30,30
1650536952569,MATH 20C,A02,083761,Staff,2,14,30,28
1650536952569,MATH 20C,B01,083762,Staff,12,0,30,18
1650536952569,MATH 20C,B02,083763,Staff,28,0,30,2
1650536958597,MATH 20D,A01,083765,Staff,0,1,30,30
1650536958597,MATH 20D,A02,083766,Staff,7,0,30,23
1650536958597,MATH 20D,A03,083767,Staff,25,0,30,5
1650536964626,MATH 20E,A01,083771,Staff,6,0,30,24
1650536964626,MATH 20E,A02,083772,Staff,18,0,30,12
1650536964626,MATH 20E,B01,083773,Staff,0,0,30,30
1650536964626,MATH 20E,B02,083774,Staff,10,0,30,20
1650536970651,MATH 103A,A01,083777,Staff,0,15,30,30
1650536970651,MATH 103A,A02,083778,Staff,0,14,30,30
1650536970651,MATH 103A,B01,083779,Staff,0,13,30,30
1650536970651,MATH 103A,B02,083780,Staff,0,13,30,30
1650536976677,MATH 105,A01,085443,Staff,0,21,30,30
1650536982702,MATH 109,A01,083213,Anzaldo; Leesa B,0,8,30,30
1650536982702,MATH 109,A02,083214,Anzaldo; Leesa B,0,7,30,30
1650536982702,MATH 109,B01,083215,Anzaldo; Leesa B,0,5,30,30
1650536982702,MATH 109,B02,083216,Anzaldo; Leesa B,0,6,30,30
1650536988733,MATH 142A,A01,083219,Chow; Bennett,0,16,30,30
1650536988733,MATH 142A,A02,083220,Chow; Bennett,0,14,30,30
1650536988733,MATH 142A,B01,083221,Chow; Bennett,0,13,30,30
1650536988733,MATH 142A,B02,083222,Chow; Bennett,0,13,30,30
1650536994761,MATH 193A,A01,083224,Staff,0,6,30,30
1650536994761,MATH 193A,A02,083225,Staff,0,5,30,30
1650536994761,MATH 193A,A03,083781,Staff,0,5,30,30
1650536994761,MATH 193A,A04,083782,Staff,0,7,30,30
1650537000789,MATH 197,001,091859,McAuley; Julian John,9998,0,9999,1
1650537006871,COGS 9,A01,083615,Staff,0,16,60,60
1650537012896,COGS 11,A01,083617,Boyle; Mary E. T.,19,0,40,21
1650537018920,COGS 13,A01,083071,Staff,0,35,40,40
1650537024946,COGS 14A,A01,092681,Staff,0,26,100,100
1650537030969,COGS 14B,A01,083073,Cheng; Tzu-Han,0,12,50,50
1650537036994,COGS 17,A01,092677,Staff,19,0,75,56
1650537043026,COGS 100,A01,083619,Staff,0,26,60,60
1650537049055,COGS 101A,A01,083621,Davis; Joshua Daniel,0,26,60,60
1650537055085,COGS 101B,A01,091572,Staff,1,5,60,59
1650537061119,COGS 101C,A01,083625,Delgado; Tania,15,0,30,15
1650537067145,COGS 107A,A01,083627,Boyle; Mary E. T.,0,11,60,60
1650537073175,COGS 118A,A01,083075,Staff,0,3,60,60
1650537079288,CSE 3,A50,083646,Miranda; Gregory Joseph,20,0,38,18
1650537079288,CSE 3,A51,083647,Miranda; Gregory Joseph,36,0,37,1
1650537085314,CSE 8A,A50,083650,Miranda; Gregory Joseph,0,29,40,40
1650537091340,CSE 11,A01,083080,Cao; Yingjun,0,94,40,40
1650537097363,CSE 12,A01,083652,Staff,0,17,100,100
1650537103399,CSE 15L,A01,083654,Staff,0,1,50,50
1650537103399,CSE 15L,A02,083655,Staff,0,0,50,50
1650537109422,CSE 20,A01,083657,Staff,51,0,80,29
1650537115472,CSE 30,A01,083084,Eldon; John,0,77,40,40
1650537121507,CSE 100,A01,083659,Cao; Yingjun,0,66,50,50
1650537127534,CSE 134B,A01,083661,Powell; Thomas Allan,0,34,65,65
1650537133560,CSE 140,A01,083663,Staff,0,5,75,75
1650537139583,CSE 140L,A01,083088,Eldon; John,0,11,75,75
1650537145610,CSE 175,A01,083665,Kumar; Rakesh,7,0,25,18
1650537151633,CSE 190,A00,092507,Dubnov; Shlomo,10,0,20,10
1650537157662,ECE 45,A01,083139,Staff,0,1,60,60
1650537163685,ECE 65,A50,083695,Staff,0,6,30,30
1650537169717,ECE 109,A01,091882,Touri; Behrouz,33,0,70,37
1650537175742,ECE 180,A00,083140,Abi Samra; Nicholas Camill,21,0,30,9
1650537175742,ECE 180,B00,083141,Abi Samra; Nicholas Camill,0,0,30,30
1650537181776,MATH 10A,A01,083735,Patchell; Gregory David,5,0,30,25
1650537181776,MATH 10A,A02,083736,Patchell; Gregory David,27,0,30,3
1650537181776,MATH 10A,A03,083737,Patchell; Gregory David,24,0,30,6
1650537187807,MATH 10B,A01,083207,Staff,0,9,30,30
1650537187807,MATH 10B,A02,083208,Staff,0,7,30,30
1650537187807,MATH 10B,B01,083739,Staff,12,0,30,18
1650537187807,MATH 10B,B02,083740,Staff,28,0,30,2
1650537193840,MATH 18,A01,083743,Staff,1,0,30,29
1650537193840,MATH 18,A02,083744,Staff,26,0,30,4
1650537193840,MATH 18,A03,083745,Staff,22,0,30,8
1650537193840,MATH 18,A04,083746,Staff,26,0,30,4
1650537193840,MATH 18,B01,083748,Staff,0,12,30,30
1650537193840,MATH 18,B02,083749,Staff,0,12,30,30
1650537193840,MATH 18,B03,083750,Staff,0,11,30,30
1650537193840,MATH 18,B04,083751,Staff,0,12,30,30
1650537199865,MATH 20A,A01,083754,Staff,22,0,40,18
1650537205897,MATH 20B,A01,083756,Staff,0,11,30,30
1650537205897,MATH 20B,A02,083757,Staff,0,12,30,30
1650537211923,MATH 20C,A01,083760,Staff,0,16,30,30
1650537211923,MATH 20C,A02,083761,Staff,2,14,30,28
1650537211923,MATH 20C,B01,083762,Staff,12,0,30,18
1650537211923,MATH 20C,B02,083763,Staff,28,0,30,2
1650537217950,MATH 20D,A01,083765,Staff,0,1,30,30
1650537217950,MATH 20D,A02,083766,Staff,7,0,30,23
1650537217950,MATH 20D,A03,083767,Staff,25,0,30,5
1650537223981,MATH 20E,A01,083771,Staff,6,0,30,24
1650537223981,MATH 20E,A02,083772,Staff,18,0,30,12
1650537223981,MATH 20E,B01,083773,Staff,0,0,30,30
1650537223981,MATH 20E,B02,083774,Staff,10,0,30,20
1650537230012,MATH 103A,A01,083777,Staff,0,15,30,30
1650537230012,MATH 103A,A02,083778,Staff,0,14,30,30
1650537230012,MATH 103A,B01,083779,Staff,0,13,30,30
1650537230012,MATH 103A,B02,083780,Staff,0,13,30,30
1650537236035,MATH 105,A01,085443,Staff,0,21,30,30
1650537242061,MATH 109,A01,083213,Anzaldo; Leesa B,0,8,30,30
1650537242061,MATH 109,A02,083214,Anzaldo; Leesa B,0,7,30,30
1650537242061,MATH 109,B01,083215,Anzaldo; Leesa B,0,5,30,30
1650537242061,MATH 109,B02,083216,Anzaldo; Leesa B,0,6,30,30
1650537248092,MATH 142A,A01,083219,Chow; Bennett,0,16,30,30
1650537248092,MATH 142A,A02,083220,Chow; Bennett,0,14,30,30
1650537248092,MATH 142A,B01,083221,Chow; Bennett,0,13,30,30
1650537248092,MATH 142A,B02,083222,Chow; Bennett,0,13,30,30
1650537254123,MATH 193A,A01,083224,Staff,0,6,30,30
1650537254123,MATH 193A,A02,083225,Staff,0,5,30,30
1650537254123,MATH 193A,A03,083781,Staff,0,5,30,30
1650537254123,MATH 193A,A04,083782,Staff,0,7,30,30
1650537260147,MATH 197,001,091859,McAuley; Julian John,9998,0,9999,1
1650537266210,COGS 9,A01,083615,Staff,0,16,60,60
1650537272239,COGS 11,A01,083617,Boyle; Mary E. T.,19,0,40,21
1650537278264,COGS 13,A01,083071,Staff,0,35,40,40
1650537284290,COGS 14A,A01,092681,Staff,0,26,100,100
1650537290314,COGS 14B,A01,083073,Cheng; Tzu-Han,0,12,50,50
1650537296337,COGS 17,A01,092677,Staff,19,0,75,56
1650537302368,COGS 100,A01,083619,Staff,0,26,60,60
1650537308396,COGS 101A,A01,083621,Davis; Joshua Daniel,0,26,60,60
1650537314419,COGS 101B,A01,091572,Staff,1,5,60,59
1650537320445,COGS 101C,A01,083625,Delgado; Tania,15,0,30,15
1650537326494,COGS 107A,A01,083627,Boyle; Mary E. T.,0,11,60,60
1650537332524,COGS 118A,A01,083075,Staff,0,3,60,60
1650537338554,CSE 3,A50,083646,Miranda; Gregory Joseph,20,0,38,18
1650537338554,CSE 3,A51,083647,Miranda; Gregory Joseph,36,0,37,1
1650537344578,CSE 8A,A50,083650,Miranda; Gregory Joseph,0,29,40,40
1650537350607,CSE 11,A01,083080,Cao; Yingjun,0,94,40,40
1650537356649,CSE 12,A01,083652,Staff,0,17,100,100
1650537362675,CSE 15L,A01,083654,Staff,0,1,50,50
1650537362675,CSE 15L,A02,083655,Staff,0,0,50,50
1650537368706,CSE 20,A01,083657,Staff,51,0,80,29
1650537374749,CSE 30,A01,083084,Eldon; John,0,77,40,40
1650537380786,CSE 100,A01,083659,Cao; Yingjun,0,66,50,50
1650537386823,CSE 134B,A01,083661,Powell; Thomas Allan,0,34,65,65
1650537392847,CSE 140,A01,083663,Staff,0,5,75,75
1650537398870,CSE 140L,A01,083088,Eldon; John,0,11,75,75
1650537404895,CSE 175,A01,083665,Kumar; Rakesh,7,0,25,18
1650537410924,CSE 190,A00,092507,Dubnov; Shlomo,10,0,20,10
1650537416949,ECE 45,A01,083139,Staff,0,1,60,60
1650537422977,ECE 65,A50,083695,Staff,0,6,30,30
1650537429001,ECE 109,A01,091882,Touri; Behrouz,33,0,70,37
1650537435027,ECE 180,A00,083140,Abi Samra; Nicholas Camill,21,0,30,9
1650537435027,ECE 180,B00,083141,Abi Samra; Nicholas Camill,0,0,30,30
1650537441057,MATH 10A,A01,083735,Patchell; Gregory David,5,0,30,25
1650537441057,MATH 10A,A02,083736,Patchell; Gregory David,27,0,30,3
1650537441057,MATH 10A,A03,083737,Patchell; Gregory David,24,0,30,6
1650537447084,MATH 10B,A01,083207,Staff,0,9,30,30
1650537447084,MATH 10B,A02,083208,Staff,0,7,30,30
1650537447084,MATH 10B,B01,083739,Staff,12,0,30,18
1650537447084,MATH 10B,B02,083740,Staff,28,0,30,2
1650537453121,MATH 18,A01,083743,Staff,1,0,30,29
1650537453121,MATH 18,A02,083744,Staff,26,0,30,4
1650537453121,MATH 18,A03,083745,Staff,22,0,30,8
1650537453121,MATH 18,A04,083746,Staff,26,0,30,4
1650537453121,MATH 18,B01,083748,Staff,0,12,30,30
1650537453121,MATH 18,B02,083749,Staff,0,12,30,30
1650537453121,MATH 18,B03,083750,Staff,0,11,30,30
1650537453121,MATH 18,B04,083751,Staff,0,12,30,30
1650537459147,MATH 20A,A01,083754,Staff,22,0,40,18
1650537465183,MATH 20B,A01,083756,Staff,0,11,30,30
1650537465183,MATH 20B,A02,083757,Staff,0,12,30,30
1650537471212,MATH 20C,A01,083760,Staff,0,16,30,30
1650537471212,MATH 20C,A02,083761,Staff,2,14,30,28
1650537471212,MATH 20C,B01,083762,Staff,12,0,30,18
1650537471212,MATH 20C,B02,083763,Staff,28,0,30,2
1650537477249,MATH 20D,A01,083765,Staff,0,1,30,30
1650537477249,MATH 20D,A02,083766,Staff,7,0,30,23
1650537477249,MATH 20D,A03,083767,Staff,25,0,30,5
1650537483279,MATH 20E,A01,083771,Staff,6,0,30,24
1650537483279,MATH 20E,A02,083772,Staff,18,0,30,12
1650537483279,MATH 20E,B01,083773,Staff,0,0,30,30
1650537483279,MATH 20E,B02,083774,Staff,10,0,30,20
1650537489307,MATH 103A,A01,083777,Staff,0,15,30,30
1650537489307,MATH 103A,A02,083778,Staff,0,14,30,30
1650537489307,MATH 103A,B01,083779,Staff,0,13,30,30
1650537489307,MATH 103A,B02,083780,Staff,0,13,30,30
1650537495334,MATH 105,A01,085443,Staff,0,21,30,30
1650537501362,MATH 109,A01,083213,Anzaldo; Leesa B,0,8,30,30
1650537501362,MATH 109,A02,083214,Anzaldo; Leesa B,0,7,30,30
1650537501362,MATH 109,B01,083215,Anzaldo; Leesa B,0,5,30,30
1650537501362,MATH 109,B02,083216,Anzaldo; Leesa B,0,6,30,30
1650537507389,MATH 142A,A01,083219,Chow; Bennett,0,16,30,30
1650537507389,MATH 142A,A02,083220,Chow; Bennett,0,14,30,30
1650537507389,MATH 142A,B01,083221,Chow; Bennett,0,13,30,30
1650537507389,MATH 142A,B02,083222,Chow; Bennett,0,13,30,30
1650537513419,MATH 193A,A01,083224,Staff,0,6,30,30
1650537513419,MATH 193A,A02,083225,Staff,0,5,30,30
1650537513419,MATH 193A,A03,083781,Staff,0,5,30,30
1650537513419,MATH 193A,A04,083782,Staff,0,7,30,30
1650537519448,MATH 197,001,091859,McAuley; Julian John,9998,0,9999,1
1650537525531,COGS 9,A01,083615,Staff,0,16,60,60
1650537531569,COGS 11,A01,083617,Boyle; Mary E. T.,19,0,40,21
1650537537605,COGS 13,A01,083071,Staff,0,35,40,40
1650537543630,COGS 14A,A01,092681,Staff,0,26,100,100
1650537549657,COGS 14B,A01,083073,Cheng; Tzu-Han,0,12,50,50
1650537555689,COGS 17,A01,092677,Staff,19,0,75,56
1650537561720,COGS 100,A01,083619,Staff,0,26,60,60
1650537567754,COGS 101A,A01,083621,Davis; Joshua Daniel,0,26,60,60
1650537573781,COGS 101B,A01,091572,Staff,1,5,60,59
1650537579813,COGS 101C,A01,083625,Delgado; Tania,15,0,30,15
1650537585845,COGS 107A,A01,083627,Boyle; Mary E. T.,0,11,60,60
1650537591870,COGS 118A,A01,083075,Staff,0,3,60,60
1650537597902,CSE 3,A50,083646,Miranda; Gregory Joseph,20,0,38,18
1650537597902,CSE 3,A51,083647,Miranda; Gregory Joseph,36,0,37,1
1650537603928,CSE 8A,A50,083650,Miranda; Gregory Joseph,0,29,40,40
1650537609954,CSE 11,A01,083080,Cao; Yingjun,0,94,40,40
1650537615986,CSE 12,A01,083652,Staff,0,17,100,100
1650537622017,CSE 15L,A01,083654,Staff,0,1,50,50
1650537622017,CSE 15L,A02,083655,Staff,0,0,50,50
1650537628042,CSE 20,A01,083657,Staff,51,0,80,29
1650537634068,CSE 30,A01,083084,Eldon; John,0,77,40,40
1650537640093,CSE 100,A01,083659,Cao; Yingjun,0,66,50,50
1650537646118,CSE 134B,A01,083661,Powell; Thomas Allan,0,34,65,65
1650537652144,CSE 140,A01,083663,Staff,0,5,75,75
1650537658176,CSE 140L,A01,083088,Eldon; John,0,11,75,75
1650537664207,CSE 175,A01,083665,Kumar; Rakesh,7,0,25,18
1650537670232,CSE 190,A00,092507,Dubnov; Shlomo,10,0,20,10
1650537676347,ECE 45,A01,083139,Staff,0,1,60,60
1650537682376,ECE 65,A50,083695,Staff,0,6,30,30
1650537688403,ECE 109,A01,091882,Touri; Behrouz,33,0,70,37
1650537694429,ECE 180,A00,083140,Abi Samra; Nicholas Camill,21,0,30,9
1650537694429,ECE 180,B00,083141,Abi Samra; Nicholas Camill,0,0,30,30
1650537700469,MATH 10A,A01,083735,Patchell; Gregory David,5,0,30,25
1650537700469,MATH 10A,A02,083736,Patchell; Gregory David,27,0,30,3
1650537700469,MATH 10A,A03,083737,Patchell; Gregory David,24,0,30,6
1650537706497,MATH 10B,A01,083207,Staff,0,9,30,30
1650537706497,MATH 10B,A02,083208,Staff,0,7,30,30
1650537706497,MATH 10B,B01,083739,Staff,12,0,30,18
1650537706497,MATH 10B,B02,083740,Staff,28,0,30,2
1650537712532,MATH 18,A01,083743,Staff,1,0,30,29
1650537712532,MATH 18,A02,083744,Staff,26,0,30,4
1650537712532,MATH 18,A03,083745,Staff,22,0,30,8
1650537712532,MATH 18,A04,083746,Staff,26,0,30,4
1650537712532,MATH 18,B01,083748,Staff,0,12,30,30
1650537712532,MATH 18,B02,083749,Staff,0,12,30,30
1650537712532,MATH 18,B03,083750,Staff,0,11,30,30
1650537712532,MATH 18,B04,083751,Staff,0,12,30,30
1650537718557,MATH 20A,A01,083754,Staff,22,0,40,18
1650537724584,MATH 20B,A01,083756,Staff,0,11,30,30
1650537724584,MATH 20B,A02,083757,Staff,0,12,30,30
1650537730614,MATH 20C,A01,083760,Staff,0,16,30,30
1650537730614,MATH 20C,A02,083761,Staff,2,14,30,28
1650537730614,MATH 20C,B01,083762,Staff,12,0,30,18
1650537730614,MATH 20C,B02,083763,Staff,28,0,30,2
1650537736637,MATH 20D,A01,083765,Staff,0,1,30,30
1650537736637,MATH 20D,A02,083766,Staff,7,0,30,23
1650537736637,MATH 20D,A03,083767,Staff,25,0,30,5
1650537742668,MATH 20E,A01,083771,Staff,6,0,30,24
1650537742668,MATH 20E,A02,083772,Staff,18,0,30,12
1650537742668,MATH 20E,B01,083773,Staff,0,0,30,30
1650537742668,MATH 20E,B02,083774,Staff,10,0,30,20
1650537748700,MATH 103A,A01,083777,Staff,0,15,30,30
1650537748700,MATH 103A,A02,083778,Staff,0,14,30,30
1650537748700,MATH 103A,B01,083779,Staff,0,13,30,30
1650537748700,MATH 103A,B02,083780,Staff,0,13,30,30
1650537754726,MATH 105,A01,085443,Staff,0,21,30,30
1650537760753,MATH 109,A01,083213,Anzaldo; Leesa B,0,8,30,30
1650537760753,MATH 109,A02,083214,Anzaldo; Leesa B,0,7,30,30
1650537760753,MATH 109,B01,083215,Anzaldo; Leesa B,0,5,30,30
1650537760753,MATH 109,B02,083216,Anzaldo; Leesa B,0,6,30,30
1650537766779,MATH 142A,A01,083219,Chow; Bennett,0,16,30,30
1650537766779,MATH 142A,A02,083220,Chow; Bennett,0,14,30,30
1650537766779,MATH 142A,B01,083221,Chow; Bennett,0,13,30,30
1650537766779,MATH 142A,B02,083222,Chow; Bennett,0,13,30,30
1650537772818,MATH 193A,A01,083224,Staff,0,6,30,30
1650537772818,MATH 193A,A02,083225,Staff,0,5,30,30
1650537772818,MATH 193A,A03,083781,Staff,0,5,30,30
1650537772818,MATH 193A,A04,083782,Staff,0,7,30,30
1650537778850,MATH 197,001,091859,McAuley; Julian John,9998,0,9999,1
1650537784921,COGS 9,A01,083615,Staff,0,16,60,60
1650537790945,COGS 11,A01,083617,Boyle; Mary E. T.,19,0,40,21
1650537796970,COGS 13,A01,083071,Staff,0,35,40,40
1650537802996,COGS 14A,A01,092681,Staff,0,26,100,100
1650537809026,COGS 14B,A01,083073,Cheng; Tzu-Han,0,12,50,50
1650537815057,COGS 17,A01,092677,Staff,19,0,75,56
1650537821082,COGS 100,A01,083619,Staff,0,26,60,60
1650537827112,COGS 101A,A01,083621,Davis; Joshua Daniel,0,26,60,60
1650537833136,COGS 101B,A01,091572,Staff,1,5,60,59
1650537839167,COGS 101C,A01,083625,Delgado; Tania,15,0,30,15
1650537845192,COGS 107A,A01,083627,Boyle; Mary E. T.,0,11,60,60
1650537851218,COGS 118A,A01,083075,Staff,0,3,60,60
1650537857251,CSE 3,A50,083646,Miranda; Gregory Joseph,20,0,38,18
1650537857251,CSE 3,A51,083647,Miranda; Gregory Joseph,36,0,37,1
1650537863275,CSE 8A,A50,083650,Miranda; Gregory Joseph,0,29,40,40
1650537869300,CSE 11,A01,083080,Cao; Yingjun,0,94,40,40
1650537875327,CSE 12,A01,083652,Staff,0,17,100,100
1650537881354,CSE 15L,A01,083654,Staff,0,1,50,50
1650537881354,CSE 15L,A02,083655,Staff,0,0,50,50
1650537887378,CSE 20,A01,083657,Staff,51,0,80,29
1650537893402,CSE 30,A01,083084,Eldon; John,0,77,40,40
1650537899425,CSE 100,A01,083659,Cao; Yingjun,0,66,50,50
1650537905453,CSE 134B,A01,083661,Powell; Thomas Allan,0,34,65,65
1650537911478,CSE 140,A01,083663,Staff,0,5,75,75
1650537917512,CSE 140L,A01,083088,Eldon; John,0,11,75,75
1650537923543,CSE 175,A01,083665,Kumar; Rakesh,7,0,25,18
1650537929575,CSE 190,A00,092507,Dubnov; Shlomo,10,0,20,10
1650537935605,ECE 45,A01,083139,Staff,0,1,60,60
1650537941636,ECE 65,A50,083695,Staff,0,6,30,30
1650537947666,ECE 109,A01,091882,Touri; Behrouz,33,0,70,37
1650537953695,ECE 180,A00,083140,Abi Samra; Nicholas Camill,21,0,30,9
1650537953695,ECE 180,B00,083141,Abi Samra; Nicholas Camill,0,0,30,30
1650537959722,MATH 10A,A01,083735,Patchell; Gregory David,5,0,30,25
1650537959722,MATH 10A,A02,083736,Patchell; Gregory David,27,0,30,3
1650537959722,MATH 10A,A03,083737,Patchell; Gregory David,24,0,30,6
1650537965755,MATH 10B,A01,083207,Staff,0,9,30,30
1650537965755,MATH 10B,A02,083208,Staff,0,7,30,30
1650537965755,MATH 10B,B01,083739,Staff,12,0,30,18
1650537965755,MATH 10B,B02,083740,Staff,28,0,30,2
1650537971792,MATH 18,A01,083743,Staff,1,0,30,29
1650537971792,MATH 18,A02,083744,Staff,26,0,30,4
1650537971792,MATH 18,A03,083745,Staff,22,0,30,8
1650537971792,MATH 18,A04,083746,Staff,26,0,30,4
1650537971792,MATH 18,B01,083748,Staff,0,12,30,30
1650537971792,MATH 18,B02,083749,Staff,0,12,30,30
1650537971792,MATH 18,B03,083750,Staff,0,11,30,30
1650537971792,MATH 18,B04,083751,Staff,0,12,30,30
1650537977819,MATH 20A,A01,083754,Staff,22,0,40,18
1650537983845,MATH 20B,A01,083756,Staff,0,11,30,30
1650537983845,MATH 20B,A02,083757,Staff,0,12,30,30
1650537989868,MATH 20C,A01,083760,Staff,0,16,30,30
1650537989868,MATH 20C,A02,083761,Staff,2,14,30,28
1650537989868,MATH 20C,B01,083762,Staff,12,0,30,18
1650537989868,MATH 20C,B02,083763,Staff,28,0,30,2
1650537995894,MATH 20D,A01,083765,Staff,0,1,30,30
1650537995894,MATH 20D,A02,083766,Staff,7,0,30,23
1650537995894,MATH 20D,A03,083767,Staff,25,0,30,5
1650538001920,MATH 20E,A01,083771,Staff,6,0,30,24
1650538001920,MATH 20E,A02,083772,Staff,18,0,30,12
1650538001920,MATH 20E,B01,083773,Staff,0,0,30,30
1650538001920,MATH 20E,B02,083774,Staff,10,0,30,20
1650538007946,MATH 103A,A01,083777,Staff,0,15,30,30
1650538007946,MATH 103A,A02,083778,Staff,0,14,30,30
1650538007946,MATH 103A,B01,083779,Staff,0,13,30,30
1650538007946,MATH 103A,B02,083780,Staff,0,13,30,30
1650538013977,MATH 105,A01,085443,Staff,0,21,30,30
1650538020012,MATH 109,A01,083213,Anzaldo; Leesa B,0,8,30,30
1650538020012,MATH 109,A02,083214,Anzaldo; Leesa B,0,7,30,30
1650538020012,MATH 109,B01,083215,Anzaldo; Leesa B,0,5,30,30
1650538020012,MATH 109,B02,083216,Anzaldo; Leesa B,0,6,30,30
1650538026036,MATH 142A,A01,083219,Chow; Bennett,0,16,30,30
1650538026036,MATH 142A,A02,083220,Chow; Bennett,0,14,30,30
1650538026036,MATH 142A,B01,083221,Chow; Bennett,0,13,30,30
1650538026036,MATH 142A,B02,083222,Chow; Bennett,0,13,30,30
1650538032063,MATH 193A,A01,083224,Staff,0,6,30,30
1650538032063,MATH 193A,A02,083225,Staff,0,5,30,30
1650538032063,MATH 193A,A03,083781,Staff,0,5,30,30
1650538032063,MATH 193A,A04,083782,Staff,0,7,30,30
1650538038090,MATH 197,001,091859,McAuley; Julian John,9998,0,9999,1
1650538044177,COGS 9,A01,083615,Staff,0,16,60,60
1650538050209,COGS 11,A01,083617,Boyle; Mary E. T.,19,0,40,21
1650538056236,COGS 13,A01,083071,Staff,0,35,40,40
1650538062265,COGS 14A,A01,092681,Staff,0,26,100,100
1650538068291,COGS 14B,A01,083073,Cheng; Tzu-Han,0,12,50,50
1650538074314,COGS 17,A01,092677,Staff,19,0,75,56
1650538080339,COGS 100,A01,083619,Staff,0,26,60,60
1650538086370,COGS 101A,A01,083621,Davis; Joshua Daniel,0,26,60,60
1650538092397,COGS 101B,A01,091572,Staff,1,5,60,59
1650538098422,COGS 101C,A01,083625,Delgado; Tania,15,0,30,15
1650538104452,COGS 107A,A01,083627,Boyle; Mary E. T.,0,11,60,60
1650538110480,COGS 118A,A01,083075,Staff,0,3,60,60
1650538116511,CSE 3,A50,083646,Miranda; Gregory Joseph,20,0,38,18
1650538116511,CSE 3,A51,083647,Miranda; Gregory Joseph,36,0,37,1
1650538122541,CSE 8A,A50,083650,Miranda; Gregory Joseph,0,29,40,40
1650538128571,CSE 11,A01,083080,Cao; Yingjun,0,94,40,40
1650538134599,CSE 12,A01,083652,Staff,0,17,100,100
1650538140629,CSE 15L,A01,083654,Staff,0,1,50,50
1650538140629,CSE 15L,A02,083655,Staff,0,0,50,50
1650538146654,CSE 20,A01,083657,Staff,51,0,80,29
1650538152678,CSE 30,A01,083084,Eldon; John,0,77,40,40
1650538158710,CSE 100,A01,083659,Cao; Yingjun,0,66,50,50
1650538164736,CSE 134B,A01,083661,Powell; Thomas Allan,0,34,65,65
1650538170758,CSE 140,A01,083663,Staff,0,5,75,75
1650538176789,CSE 140L,A01,083088,Eldon; John,0,11,75,75
1650538182821,CSE 175,A01,083665,Kumar; Rakesh,7,0,25,18
1650538188855,CSE 190,A00,092507,Dubnov; Shlomo,10,0,20,10
1650538208158,ECE 45,A01,083139,Staff,0,1,60,60
1650538214186,ECE 65,A50,083695,Staff,0,6,30,30
1650538220214,ECE 109,A01,091882,Touri; Behrouz,33,0,70,37
1650538226243,ECE 180,A00,083140,Abi Samra; Nicholas Camill,21,0,30,9
1650538226243,ECE 180,B00,083141,Abi Samra; Nicholas Camill,0,0,30,30
1650538232272,MATH 10A,A01,083735,Patchell; Gregory David,5,0,30,25
1650538232272,MATH 10A,A02,083736,Patchell; Gregory David,27,0,30,3
1650538232272,MATH 10A,A03,083737,Patchell; Gregory David,24,0,30,6
1650538238299,MATH 10B,A01,083207,Staff,0,9,30,30
1650538238299,MATH 10B,A02,083208,Staff,0,7,30,30
1650538238299,MATH 10B,B01,083739,Staff,12,0,30,18
1650538238299,MATH 10B,B02,083740,Staff,28,0,30,2
1650538244335,MATH 18,A01,083743,Staff,1,0,30,29
1650538244335,MATH 18,A02,083744,Staff,26,0,30,4
1650538244335,MATH 18,A03,083745,Staff,22,0,30,8
1650538244335,MATH 18,A04,083746,Staff,26,0,30,4
1650538244335,MATH 18,B01,083748,Staff,0,12,30,30
1650538244335,MATH 18,B02,083749,Staff,0,12,30,30
1650538244335,MATH 18,B03,083750,Staff,0,11,30,30
1650538244335,MATH 18,B04,083751,Staff,0,12,30,30
1650538250362,MATH 20A,A01,083754,Staff,22,0,40,18
1650538256391,MATH 20B,A01,083756,Staff,0,11,30,30
1650538256391,MATH 20B,A02,083757,Staff,0,12,30,30
1650538262424,MATH 20C,A01,083760,Staff,0,16,30,30
1650538262424,MATH 20C,A02,083761,Staff,2,14,30,28
1650538262424,MATH 20C,B01,083762,Staff,12,0,30,18
1650538262424,MATH 20C,B02,083763,Staff,28,0,30,2
1650538268448,MATH 20D,A01,083765,Staff,0,1,30,30
1650538268448,MATH 20D,A02,083766,Staff,7,0,30,23
1650538268448,MATH 20D,A03,083767,Staff,25,0,30,5
1650538274484,MATH 20E,A01,083771,Staff,6,0,30,24
1650538274484,MATH 20E,A02,083772,Staff,18,0,30,12
1650538274484,MATH 20E,B01,083773,Staff,0,0,30,30
1650538274484,MATH 20E,B02,083774,Staff,10,0,30,20
1650538280522,MATH 103A,A01,083777,Staff,0,15,30,30
1650538280522,MATH 103A,A02,083778,Staff,0,14,30,30
1650538280522,MATH 103A,B01,083779,Staff,0,13,30,30
1650538280522,MATH 103A,B02,083780,Staff,0,13,30,30
1650538286650,MATH 105,A01,085443,Staff,0,21,30,30
1650538292683,MATH 109,A01,083213,Anzaldo; Leesa B,0,8,30,30
1650538292683,MATH 109,A02,083214,Anzaldo; Leesa B,0,7,30,30
1650538292683,MATH 109,B01,083215,Anzaldo; Leesa B,0,5,30,30
1650538292683,MATH 109,B02,083216,Anzaldo; Leesa B,0,6,30,30
1650538298717,MATH 142A,A01,083219,Chow; Bennett,0,16,30,30
1650538298717,MATH 142A,A02,083220,Chow; Bennett,0,14,30,30
1650538298717,MATH 142A,B01,083221,Chow; Bennett,0,13,30,30
1650538298717,MATH 142A,B02,083222,Chow; Bennett,0,13,30,30
1650538304750,MATH 193A,A01,083224,Staff,0,6,30,30
1650538304750,MATH 193A,A02,083225,Staff,0,5,30,30
1650538304750,MATH 193A,A03,083781,Staff,0,5,30,30
1650538304750,MATH 193A,A04,083782,Staff,0,7,30,30
1650538310776,MATH 197,001,091859,McAuley; Julian John,9998,0,9999,1
1650538316856,COGS 9,A01,083615,Staff,0,16,60,60
1650538322888,COGS 11,A01,083617,Boyle; Mary E. T.,19,0,40,21
1650538328919,COGS 13,A01,083071,Staff,0,35,40,40
1650538334950,COGS 14A,A01,092681,Staff,0,26,100,100
1650538340980,COGS 14B,A01,083073,Cheng; Tzu-Han,0,12,50,50
1650538347002,COGS 17,A01,092677,Staff,19,0,75,56
1650538353033,COGS 100,A01,083619,Staff,0,26,60,60
1650538359065,COGS 101A,A01,083621,Davis; Joshua Daniel,0,26,60,60
1650538365092,COGS 101B,A01,091572,Staff,1,5,60,59
1650538371117,COGS 101C,A01,083625,Delgado; Tania,15,0,30,15
1650538377142,COGS 107A,A01,083627,Boyle; Mary E. T.,0,11,60,60
1650538383175,COGS 118A,A01,083075,Staff,0,3,60,60
1650538389204,CSE 3,A50,083646,Miranda; Gregory Joseph,20,0,38,18
1650538389204,CSE 3,A51,083647,Miranda; Gregory Joseph,36,0,37,1
1650538395228,CSE 8A,A50,083650,Miranda; Gregory Joseph,0,29,40,40
1650538401255,CSE 11,A01,083080,Cao; Yingjun,0,94,40,40
1650538407281,CSE 12,A01,083652,Staff,0,17,100,100
1650538413305,CSE 15L,A01,083654,Staff,0,1,50,50
1650538413305,CSE 15L,A02,083655,Staff,0,0,50,50
1650538419333,CSE 20,A01,083657,Staff,51,0,80,29
1650538425362,CSE 30,A01,083084,Eldon; John,0,77,40,40
1650538431392,CSE 100,A01,083659,Cao; Yingjun,0,66,50,50
1650538437423,CSE 134B,A01,083661,Powell; Thomas Allan,0,34,65,65
1650538443450,CSE 140,A01,083663,Staff,0,5,75,75
1650538449476,CSE 140L,A01,083088,Eldon; John,0,11,75,75
1650538455506,CSE 175,A01,083665,Kumar; Rakesh,7,0,25,18
1650538461534,CSE 190,A00,092507,Dubnov; Shlomo,10,0,20,10
1650538467565,ECE 45,A01,083139,Staff,0,1,60,60
1650538473598,ECE 65,A50,083695,Staff,0,6,30,30
1650538479625,ECE 109,A01,091882,Touri; Behrouz,33,0,70,37
1650538485656,ECE 180,A00,083140,Abi Samra; Nicholas Camill,21,0,30,9
1650538485656,ECE 180,B00,083141,Abi Samra; Nicholas Camill,0,0,30,30
1650538491691,MATH 10A,A01,083735,Patchell; Gregory David,5,0,30,25
1650538491691,MATH 10A,A02,083736,Patchell; Gregory David,27,0,30,3
1650538491691,MATH 10A,A03,083737,Patchell; Gregory David,24,0,30,6
1650538497721,MATH 10B,A01,083207,Staff,0,9,30,30
1650538497721,MATH 10B,A02,083208,Staff,0,7,30,30
1650538497721,MATH 10B,B01,083739,Staff,12,0,30,18
1650538497721,MATH 10B,B02,083740,Staff,28,0,30,2
1650538503761,MATH 18,A01,083743,Staff,1,0,30,29
1650538503761,MATH 18,A02,083744,Staff,26,0,30,4
1650538503761,MATH 18,A03,083745,Staff,22,0,30,8
1650538503761,MATH 18,A04,083746,Staff,26,0,30,4
1650538503761,MATH 18,B01,083748,Staff,0,12,30,30
1650538503761,MATH 18,B02,083749,Staff,0,12,30,30
1650538503761,MATH 18,B03,083750,Staff,0,11,30,30
1650538503761,MATH 18,B04,083751,Staff,0,12,30,30
1650538509786,MATH 20A,A01,083754,Staff,22,0,40,18
1650538515812,MATH 20B,A01,083756,Staff,0,11,30,30
1650538515812,MATH 20B,A02,083757,Staff,0,12,30,30
1650538521838,MATH 20C,A01,083760,Staff,0,16,30,30
1650538521838,MATH 20C,A02,083761,Staff,2,14,30,28
1650538521838,MATH 20C,B01,083762,Staff,12,0,30,18
1650538521838,MATH 20C,B02,083763,Staff,28,0,30,2
1650538527867,MATH 20D,A01,083765,Staff,0,1,30,30
1650538527867,MATH 20D,A02,083766,Staff,7,0,30,23
1650538527867,MATH 20D,A03,083767,Staff,25,0,30,5
1650538533899,MATH 20E,A01,083771,Staff,6,0,30,24
1650538533899,MATH 20E,A02,083772,Staff,18,0,30,12
1650538533899,MATH 20E,B01,083773,Staff,0,0,30,30
1650538533899,MATH 20E,B02,083774,Staff,10,0,30,20
1650538539925,MATH 103A,A01,083777,Staff,0,15,30,30
1650538539925,MATH 103A,A02,083778,Staff,0,14,30,30
1650538539925,MATH 103A,B01,083779,Staff,0,13,30,30
1650538539925,MATH 103A,B02,083780,Staff,0,13,30,30
1650538545957,MATH 105,A01,085443,Staff,0,21,30,30
1650538551989,MATH 109,A01,083213,Anzaldo; Leesa B,0,8,30,30
1650538551989,MATH 109,A02,083214,Anzaldo; Leesa B,0,7,30,30
1650538551989,MATH 109,B01,083215,Anzaldo; Leesa B,0,5,30,30
1650538551989,MATH 109,B02,083216,Anzaldo; Leesa B,0,6,30,30
1650538558022,MATH 142A,A01,083219,Chow; Bennett,0,16,30,30
1650538558022,MATH 142A,A02,083220,Chow; Bennett,0,14,30,30
1650538558022,MATH 142A,B01,083221,Chow; Bennett,0,13,30,30
1650538558022,MATH 142A,B02,083222,Chow; Bennett,0,13,30,30
1650538564048,MATH 193A,A01,083224,Staff,0,6,30,30
1650538564048,MATH 193A,A02,083225,Staff,0,5,30,30
1650538564048,MATH 193A,A03,083781,Staff,0,5,30,30
1650538564048,MATH 193A,A04,083782,Staff,0,7,30,30
1650538570078,MATH 197,001,091859,McAuley; Julian John,9998,0,9999,1
1650538576159,COGS 9,A01,083615,Staff,0,16,60,60
1650538582186,COGS 11,A01,083617,Boyle; Mary E. T.,19,0,40,21
1650538588218,COGS 13,A01,083071,Staff,0,35,40,40
1650538594249,COGS 14A,A01,092681,Staff,0,26,100,100
1650538600284,COGS 14B,A01,083073,Cheng; Tzu-Han,0,12,50,50
1650538606308,COGS 17,A01,092677,Staff,19,0,75,56
1650538612336,COGS 100,A01,083619,Staff,0,26,60,60
1650538618365,COGS 101A,A01,083621,Davis; Joshua Daniel,0,26,60,60
1650538624396,COGS 101B,A01,091572,Staff,1,5,60,59
1650538630422,COGS 101C,A01,083625,Delgado; Tania,15,0,30,15
1650538636459,COGS 107A,A01,083627,Boyle; Mary E. T.,0,11,60,60
1650538642486,COGS 118A,A01,083075,Staff,0,3,60,60
1650538648539,CSE 3,A50,083646,Miranda; Gregory Joseph,20,0,38,18
1650538648539,CSE 3,A51,083647,Miranda; Gregory Joseph,36,0,37,1
1650538654570,CSE 8A,A50,083650,Miranda; Gregory Joseph,0,29,40,40
1650538660601,CSE 11,A01,083080,Cao; Yingjun,0,94,40,40
1650538666631,CSE 12,A01,083652,Staff,0,17,100,100
1650538672655,CSE 15L,A01,083654,Staff,0,1,50,50
1650538672655,CSE 15L,A02,083655,Staff,0,0,50,50
1650538678680,CSE 20,A01,083657,Staff,51,0,80,29
1650538684705,CSE 30,A01,083084,Eldon; John,0,77,40,40
1650538690737,CSE 100,A01,083659,Cao; Yingjun,0,66,50,50
1650538696765,CSE 134B,A01,083661,Powell; Thomas Allan,0,34,65,65
1650538702791,CSE 140,A01,083663,Staff,0,5,75,75
1650538708815,CSE 140L,A01,083088,Eldon; John,0,11,75,75
1650538714847,CSE 175,A01,083665,Kumar; Rakesh,7,0,25,18
1650538720885,CSE 190,A00,092507,Dubnov; Shlomo,10,0,20,10
1650538726910,ECE 45,A01,083139,Staff,0,1,60,60
1650538732936,ECE 65,A50,083695,Staff,0,6,30,30
1650538738962,ECE 109,A01,091882,Touri; Behrouz,33,0,70,37
1650538744991,ECE 180,A00,083140,Abi Samra; Nicholas Camill,21,0,30,9
1650538744991,ECE 180,B00,083141,Abi Samra; Nicholas Camill,0,0,30,30
1650538751024,MATH 10A,A01,083735,Patchell; Gregory David,5,0,30,25
1650538751024,MATH 10A,A02,083736,Patchell; Gregory David,27,0,30,3
1650538751024,MATH 10A,A03,083737,Patchell; Gregory David,24,0,30,6
1650538757050,MATH 10B,A01,083207,Staff,0,9,30,30
1650538757050,MATH 10B,A02,083208,Staff,0,7,30,30
1650538757050,MATH 10B,B01,083739,Staff,12,0,30,18
1650538757050,MATH 10B,B02,083740,Staff,28,0,30,2
1650538763085,MATH 18,A01,083743,Staff,1,0,30,29
1650538763085,MATH 18,A02,083744,Staff,26,0,30,4
1650538763085,MATH 18,A03,083745,Staff,22,0,30,8
1650538763085,MATH 18,A04,083746,Staff,26,0,30,4
1650538763085,MATH 18,B01,083748,Staff,0,12,30,30
1650538763085,MATH 18,B02,083749,Staff,0,12,30,30
1650538763085,MATH 18,B03,083750,Staff,0,11,30,30
1650538763085,MATH 18,B04,083751,Staff,0,12,30,30
1650538769109,MATH 20A,A01,083754,Staff,22,0,40,18
1650538775140,MATH 20B,A01,083756,Staff,0,11,30,30
1650538775140,MATH 20B,A02,083757,Staff,0,12,30,30
1650538781169,MATH 20C,A01,083760,Staff,0,16,30,30
1650538781169,MATH 20C,A02,083761,Staff,2,14,30,28
1650538781169,MATH 20C,B01,083762,Staff,12,0,30,18
1650538781169,MATH 20C,B02,083763,Staff,28,0,30,2
1650538787198,MATH 20D,A01,083765,Staff,0,1,30,30
1650538787198,MATH 20D,A02,083766,Staff,7,0,30,23
1650538787198,MATH 20D,A03,083767,Staff,25,0,30,5
1650538793229,MATH 20E,A01,083771,Staff,6,0,30,24
1650538793229,MATH 20E,A02,083772,Staff,18,0,30,12
1650538793229,MATH 20E,B01,083773,Staff,0,0,30,30
1650538793229,MATH 20E,B02,083774,Staff,10,0,30,20
1650538799260,MATH 103A,A01,083777,Staff,0,15,30,30
1650538799260,MATH 103A,A02,083778,Staff,0,14,30,30
1650538799260,MATH 103A,B01,083779,Staff,0,13,30,30
1650538799260,MATH 103A,B02,083780,Staff,0,13,30,30
1650538805295,MATH 105,A01,085443,Staff,0,21,30,30
1650538811319,MATH 109,A01,083213,Anzaldo; Leesa B,0,8,30,30
1650538811319,MATH 109,A02,083214,Anzaldo; Leesa B,0,7,30,30
1650538811319,MATH 109,B01,083215,Anzaldo; Leesa B,0,5,30,30
1650538811319,MATH 109,B02,083216,Anzaldo; Leesa B,0,6,30,30
1650538817355,MATH 142A,A01,083219,Chow; Bennett,0,16,30,30
1650538817355,MATH 142A,A02,083220,Chow; Bennett,0,14,30,30
1650538817355,MATH 142A,B01,083221,Chow; Bennett,0,13,30,30
1650538817355,MATH 142A,B02,083222,Chow; Bennett,0,13,30,30
1650538823382,MATH 193A,A01,083224,Staff,0,6,30,30
1650538823382,MATH 193A,A02,083225,Staff,0,5,30,30
1650538823382,MATH 193A,A03,083781,Staff,0,5,30,30
1650538823382,MATH 193A,A04,083782,Staff,0,7,30,30
1650538829411,MATH 197,001,091859,McAuley; Julian John,9998,0,9999,1
1650538835485,COGS 9,A01,083615,Staff,0,16,60,60
1650538841517,COGS 11,A01,083617,Boyle; Mary E. T.,19,0,40,21
1650538847542,COGS 13,A01,083071,Staff,0,35,40,40
1650538853566,COGS 14A,A01,092681,Staff,0,26,100,100
1650538859592,COGS 14B,A01,083073,Cheng; Tzu-Han,0,12,50,50
1650538865625,COGS 17,A01,092677,Staff,19,0,75,56
1650538871653,COGS 100,A01,083619,Staff,0,26,60,60
1650538877772,COGS 101A,A01,083621,Davis; Joshua Daniel,0,26,60,60
1650538883798,COGS 101B,A01,091572,Staff,1,5,60,59
1650538889829,COGS 101C,A01,083625,Delgado; Tania,15,0,30,15
1650538895858,COGS 107A,A01,083627,Boyle; Mary E. T.,0,11,60,60
1650538901893,COGS 118A,A01,083075,Staff,0,3,60,60
1650538907923,CSE 3,A50,083646,Miranda; Gregory Joseph,20,0,38,18
1650538907923,CSE 3,A51,083647,Miranda; Gregory Joseph,36,0,37,1
1650538913955,CSE 8A,A50,083650,Miranda; Gregory Joseph,0,29,40,40
1650538919980,CSE 11,A01,083080,Cao; Yingjun,0,94,40,40
1650538926005,CSE 12,A01,083652,Staff,0,17,100,100
1650538932034,CSE 15L,A01,083654,Staff,0,1,50,50
1650538932034,CSE 15L,A02,083655,Staff,0,0,50,50
1650538938064,CSE 20,A01,083657,Staff,51,0,80,29
1650538944088,CSE 30,A01,083084,Eldon; John,0,77,40,40
1650538950119,CSE 100,A01,083659,Cao; Yingjun,0,66,50,50
1650538956143,CSE 134B,A01,083661,Powell; Thomas Allan,0,34,65,65
1650538962174,CSE 140,A01,083663,Staff,0,5,75,75
1650538968205,CSE 140L,A01,083088,Eldon; John,0,11,75,75
1650538974232,CSE 175,A01,083665,Kumar; Rakesh,7,0,25,18
1650538980262,CSE 190,A00,092507,Dubnov; Shlomo,10,0,20,10
1650538986292,ECE 45,A01,083139,Staff,0,1,60,60
1650538992322,ECE 65,A50,083695,Staff,0,6,30,30
1650538998347,ECE 109,A01,091882,Touri; Behrouz,33,0,70,37
1650539004380,ECE 180,A00,083140,Abi Samra; Nicholas Camill,21,0,30,9
1650539004380,ECE 180,B00,083141,Abi Samra; Nicholas Camill,0,0,30,30
1650539010407,MATH 10A,A01,083735,Patchell; Gregory David,5,0,30,25
1650539010407,MATH 10A,A02,083736,Patchell; Gregory David,27,0,30,3
1650539010407,MATH 10A,A03,083737,Patchell; Gregory David,24,0,30,6
1650539016438,MATH 10B,A01,083207,Staff,0,9,30,30
1650539016438,MATH 10B,A02,083208,Staff,0,7,30,30
1650539016438,MATH 10B,B01,083739,Staff,12,0,30,18
1650539016438,MATH 10B,B02,083740,Staff,28,0,30,2
1650539022470,MATH 18,A01,083743,Staff,1,0,30,29
1650539022470,MATH 18,A02,083744,Staff,26,0,30,4
1650539022470,MATH 18,A03,083745,Staff,22,0,30,8
1650539022470,MATH 18,A04,083746,Staff,26,0,30,4
1650539022470,MATH 18,B01,083748,Staff,0,12,30,30
1650539022470,MATH 18,B02,083749,Staff,0,12,30,30
1650539022470,MATH 18,B03,083750,Staff,0,11,30,30
1650539022470,MATH 18,B04,083751,Staff,0,12,30,30
1650539028493,MATH 20A,A01,083754,Staff,22,0,40,18
1650539034596,MATH 20B,A01,083756,Staff,0,11,30,30
1650539034596,MATH 20B,A02,083757,Staff,0,12,30,30
1650539040643,MATH 20C,A01,083760,Staff,0,16,30,30
1650539040643,MATH 20C,A02,083761,Staff,2,14,30,28
1650539040643,MATH 20C,B01,083762,Staff,12,0,30,18
1650539040643,MATH 20C,B02,083763,Staff,28,0,30,2
1650539046671,MATH 20D,A01,083765,Staff,0,1,30,30
1650539046671,MATH 20D,A02,083766,Staff,7,0,30,23
1650539046671,MATH 20D,A03,083767,Staff,25,0,30,5
1650539052703,MATH 20E,A01,083771,Staff,6,0,30,24
1650539052703,MATH 20E,A02,083772,Staff,18,0,30,12
1650539052703,MATH 20E,B01,083773,Staff,0,0,30,30
1650539052703,MATH 20E,B02,083774,Staff,10,0,30,20
1650539058739,MATH 103A,A01,083777,Staff,0,15,30,30
1650539058739,MATH 103A,A02,083778,Staff,0,14,30,30
1650539058739,MATH 103A,B01,083779,Staff,0,13,30,30
1650539058739,MATH 103A,B02,083780,Staff,0,13,30,30
1650539064770,MATH 105,A01,085443,Staff,0,21,30,30
1650539070799,MATH 109,A01,083213,Anzaldo; Leesa B,0,8,30,30
1650539070799,MATH 109,A02,083214,Anzaldo; Leesa B,0,7,30,30
1650539070799,MATH 109,B01,083215,Anzaldo; Leesa B,0,5,30,30
1650539070799,MATH 109,B02,083216,Anzaldo; Leesa B,0,6,30,30
1650539076833,MATH 142A,A01,083219,Chow; Bennett,0,16,30,30
1650539076833,MATH 142A,A02,083220,Chow; Bennett,0,14,30,30
1650539076833,MATH 142A,B01,083221,Chow; Bennett,0,13,30,30
1650539076833,MATH 142A,B02,083222,Chow; Bennett,0,13,30,30
1650539082867,MATH 193A,A01,083224,Staff,0,6,30,30
1650539082867,MATH 193A,A02,083225,Staff,0,5,30,30
1650539082867,MATH 193A,A03,083781,Staff,0,5,30,30
1650539082867,MATH 193A,A04,083782,Staff,0,7,30,30
1650539088892,MATH 197,001,091859,McAuley; Julian John,9998,0,9999,1
1650539094960,COGS 9,A01,083615,Staff,0,16,60,60
