time,subj_course_id,sec_code,sec_id,prof,available,waitlist,total,enrolled_ct
1650194469236,COGS 9,A01,083615,Staff,0,14,60,60
1650194475269,COGS 11,A01,083617,Boyle; Mary E. T.,24,0,40,16
1650194481300,COGS 13,A01,083071,Staff,0,30,40,40
1650194487330,COGS 14A,A01,092681,Staff,0,12,100,100
1650194493361,COGS 14B,A01,083073,Cheng; Tzu-Han,0,7,50,50
1650194499390,COGS 17,A01,092677,Staff,35,0,75,40
1650194505420,COGS 100,A01,083619,Staff,0,20,60,60
1650194511454,COGS 101A,A01,083621,Davis; Joshua Daniel,0,21,60,60
1650194517484,COGS 101B,A01,091572,Staff,6,0,60,54
1650194523518,COGS 101C,A01,083625,Delgado; Tania,20,0,30,10
1650194529544,COGS 107A,A01,083627,Boyle; Mary E. T.,0,7,60,60
1650194535573,COGS 118A,A01,083075,Staff,16,0,60,44
1650194541602,CSE 3,A50,083646,Miranda; Gregory Joseph,22,0,38,16
1650194541602,CSE 3,A51,083647,Miranda; Gregory Joseph,37,0,37,0
1650194547629,CSE 8A,A50,083650,Miranda; Gregory Joseph,0,17,40,40
1650194553660,CSE 11,A01,083080,Cao; Yingjun,0,68,40,40
1650194559690,CSE 12,A01,083652,Staff,0,7,100,100
1650194565718,CSE 15L,A01,083654,Staff,0,0,50,50
1650194565718,CSE 15L,A02,083655,Staff,6,0,50,44
1650194571746,CSE 20,A01,083657,Staff,53,0,80,27
1650194577780,CSE 30,A01,083084,Eldon; John,0,69,40,40
1650194583814,CSE 100,A01,083659,Cao; Yingjun,0,63,50,50
1650194589847,CSE 134B,A01,083661,Powell; Thomas Allan,0,27,65,65
1650194595874,CSE 140,A01,083663,Staff,1,0,75,74
1650194601912,CSE 140L,A01,083088,Eldon; John,0,4,75,75
1650194607948,CSE 175,A01,083665,Kumar; Rakesh,8,0,25,17
1650194613985,CSE 190,A00,092507,Dubnov; Shlomo,14,0,20,6
1650194620013,ECE 45,A01,083139,Staff,0,13,40,40
1650194626046,ECE 65,A50,083695,Staff,0,5,30,30
1650194632075,ECE 109,A01,091882,Touri; Behrouz,47,0,70,23
1650194638118,ECE 180,A00,083140,Abi Samra; Nicholas Camill,24,0,30,6
1650194638118,ECE 180,B00,083141,Abi Samra; Nicholas Camill,8,0,30,22
1650194644150,MATH 10A,A01,083735,Patchell; Gregory David,11,0,30,19
1650194644150,MATH 10A,A02,083736,Patchell; Gregory David,28,0,30,2
1650194644150,MATH 10A,A03,083737,Patchell; Gregory David,26,0,30,4
1650194650177,MATH 10B,A01,083207,Staff,0,5,30,30
1650194650177,MATH 10B,A02,083208,Staff,0,5,30,30
1650194650177,MATH 10B,B01,083739,Staff,17,0,30,13
1650194650177,MATH 10B,B02,083740,Staff,29,0,30,1
1650194656218,MATH 18,A01,083743,Staff,8,0,30,22
1650194656218,MATH 18,A02,083744,Staff,28,0,30,2
1650194656218,MATH 18,A03,083745,Staff,23,0,30,7
1650194656218,MATH 18,A04,083746,Staff,27,0,30,3
1650194656218,MATH 18,B01,083748,Staff,0,10,30,30
1650194656218,MATH 18,B02,083749,Staff,0,7,30,30
1650194656218,MATH 18,B03,083750,Staff,0,7,30,30
1650194656218,MATH 18,B04,083751,Staff,0,8,30,30
1650194662245,MATH 20A,A01,083754,Staff,26,0,40,14
1650194668287,MATH 20B,A01,083756,Staff,0,6,30,30
1650194668287,MATH 20B,A02,083757,Staff,0,6,30,30
1650194674323,MATH 20C,A01,083760,Staff,0,12,30,30
1650194674323,MATH 20C,A02,083761,Staff,0,12,30,30
1650194674323,MATH 20C,B01,083762,Staff,14,0,30,16
1650194674323,MATH 20C,B02,083763,Staff,28,0,30,2
1650194680353,MATH 20D,A01,083765,Staff,1,2,30,29
1650194680353,MATH 20D,A02,083766,Staff,10,0,30,20
1650194680353,MATH 20D,A03,083767,Staff,28,0,30,2
1650194686383,MATH 20E,A01,083771,Staff,8,0,30,22
1650194686383,MATH 20E,A02,083772,Staff,20,0,30,10
1650194686383,MATH 20E,B01,083773,Staff,0,0,30,30
1650194686383,MATH 20E,B02,083774,Staff,12,0,30,18
1650194692414,MATH 103A,A01,083777,Staff,0,9,30,30
1650194692414,MATH 103A,A02,083778,Staff,0,10,30,30
1650194692414,MATH 103A,B01,083779,Staff,0,9,30,30
1650194692414,MATH 103A,B02,083780,Staff,0,9,30,30
1650194698443,MATH 105,A01,085443,Staff,0,17,30,30
1650194704477,MATH 109,A01,083213,Anzaldo; Leesa B,0,3,30,30
1650194704477,MATH 109,A02,083214,Anzaldo; Leesa B,0,6,30,30
1650194704477,MATH 109,B01,083215,Anzaldo; Leesa B,0,4,30,30
1650194704477,MATH 109,B02,083216,Anzaldo; Leesa B,0,4,30,30
1650194710508,MATH 142A,A01,083219,Chow; Bennett,0,12,30,30
1650194710508,MATH 142A,A02,083220,Chow; Bennett,0,11,30,30
1650194710508,MATH 142A,B01,083221,Chow; Bennett,0,11,30,30
1650194710508,MATH 142A,B02,083222,Chow; Bennett,0,12,30,30
1650194716541,MATH 193A,A01,083224,Staff,0,4,30,30
1650194716541,MATH 193A,A02,083225,Staff,0,4,30,30
1650194716541,MATH 193A,A03,083781,Staff,0,2,30,30
1650194716541,MATH 193A,A04,083782,Staff,0,1,30,30
1650194722572,MATH 197,001,091859,McAuley; Julian John,9998,0,9999,1
1650194728643,COGS 9,A01,083615,Staff,0,14,60,60
1650194734673,COGS 11,A01,083617,Boyle; Mary E. T.,24,0,40,16
1650194740706,COGS 13,A01,083071,Staff,0,30,40,40
1650194746737,COGS 14A,A01,092681,Staff,0,12,100,100
1650194752766,COGS 14B,A01,083073,Cheng; Tzu-Han,0,7,50,50
1650194758795,COGS 17,A01,092677,Staff,35,0,75,40
1650194764824,COGS 100,A01,083619,Staff,0,20,60,60
1650194770853,COGS 101A,A01,083621,Davis; Joshua Daniel,0,21,60,60
1650194776883,COGS 101B,A01,091572,Staff,6,0,60,54
1650194782920,COGS 101C,A01,083625,Delgado; Tania,20,0,30,10
1650194788949,COGS 107A,A01,083627,Boyle; Mary E. T.,0,7,60,60
1650194804408,COGS 118A,A01,083075,Staff,16,0,60,44
1650194810443,CSE 3,A50,083646,Miranda; Gregory Joseph,22,0,38,16
1650194810443,CSE 3,A51,083647,Miranda; Gregory Joseph,37,0,37,0
1650194825389,CSE 8A,A50,083650,Miranda; Gregory Joseph,0,17,40,40
1650194831424,CSE 11,A01,083080,Cao; Yingjun,0,68,40,40
1650194838013,CSE 12,A01,083652,Staff,0,7,100,100
1650194844042,CSE 15L,A01,083654,Staff,0,0,50,50
1650194844042,CSE 15L,A02,083655,Staff,6,0,50,44
1650194850069,CSE 20,A01,083657,Staff,53,0,80,27
1650194856103,CSE 30,A01,083084,Eldon; John,0,69,40,40
1650194862138,CSE 100,A01,083659,Cao; Yingjun,0,63,50,50
1650194868173,CSE 134B,A01,083661,Powell; Thomas Allan,0,27,65,65
1650194874200,CSE 140,A01,083663,Staff,1,0,75,74
1650194880234,CSE 140L,A01,083088,Eldon; John,0,4,75,75
1650194886271,CSE 175,A01,083665,Kumar; Rakesh,8,0,25,17
1650194892301,CSE 190,A00,092507,Dubnov; Shlomo,14,0,20,6
1650194898335,ECE 45,A01,083139,Staff,0,13,40,40
1650194904370,ECE 65,A50,083695,Staff,0,5,30,30
1650194910398,ECE 109,A01,091882,Touri; Behrouz,47,0,70,23
1650194916429,ECE 180,A00,083140,Abi Samra; Nicholas Camill,24,0,30,6
1650194916429,ECE 180,B00,083141,Abi Samra; Nicholas Camill,8,0,30,22
1650194922457,MATH 10A,A01,083735,Patchell; Gregory David,11,0,30,19
1650194922457,MATH 10A,A02,083736,Patchell; Gregory David,28,0,30,2
1650194922457,MATH 10A,A03,083737,Patchell; Gregory David,26,0,30,4
1650194928488,MATH 10B,A01,083207,Staff,0,5,30,30
1650194928488,MATH 10B,A02,083208,Staff,0,5,30,30
1650194928488,MATH 10B,B01,083739,Staff,17,0,30,13
1650194928488,MATH 10B,B02,083740,Staff,29,0,30,1
1650194934516,MATH 18,A01,083743,Staff,8,0,30,22
1650194934516,MATH 18,A02,083744,Staff,28,0,30,2
1650194934516,MATH 18,A03,083745,Staff,23,0,30,7
1650194934516,MATH 18,A04,083746,Staff,27,0,30,3
1650194934516,MATH 18,B01,083748,Staff,0,10,30,30
1650194934516,MATH 18,B02,083749,Staff,0,7,30,30
1650194934516,MATH 18,B03,083750,Staff,0,7,30,30
1650194934516,MATH 18,B04,083751,Staff,0,8,30,30
1650194940549,MATH 20A,A01,083754,Staff,26,0,40,14
1650194946578,MATH 20B,A01,083756,Staff,0,6,30,30
1650194946578,MATH 20B,A02,083757,Staff,0,6,30,30
1650194952613,MATH 20C,A01,083760,Staff,0,12,30,30
1650194952613,MATH 20C,A02,083761,Staff,0,12,30,30
1650194952613,MATH 20C,B01,083762,Staff,14,0,30,16
1650194952613,MATH 20C,B02,083763,Staff,28,0,30,2
1650194958642,MATH 20D,A01,083765,Staff,1,2,30,29
1650194958642,MATH 20D,A02,083766,Staff,10,0,30,20
1650194958642,MATH 20D,A03,083767,Staff,28,0,30,2
1650194964672,MATH 20E,A01,083771,Staff,8,0,30,22
1650194964672,MATH 20E,A02,083772,Staff,20,0,30,10
1650194964672,MATH 20E,B01,083773,Staff,0,0,30,30
1650194964672,MATH 20E,B02,083774,Staff,12,0,30,18
1650194970705,MATH 103A,A01,083777,Staff,0,9,30,30
1650194970705,MATH 103A,A02,083778,Staff,0,10,30,30
1650194970705,MATH 103A,B01,083779,Staff,0,9,30,30
1650194970705,MATH 103A,B02,083780,Staff,0,9,30,30
1650194976738,MATH 105,A01,085443,Staff,0,17,30,30
1650194982767,MATH 109,A01,083213,Anzaldo; Leesa B,0,3,30,30
1650194982767,MATH 109,A02,083214,Anzaldo; Leesa B,0,6,30,30
1650194982767,MATH 109,B01,083215,Anzaldo; Leesa B,0,4,30,30
1650194982767,MATH 109,B02,083216,Anzaldo; Leesa B,0,4,30,30
1650194988801,MATH 142A,A01,083219,Chow; Bennett,0,12,30,30
1650194988801,MATH 142A,A02,083220,Chow; Bennett,0,11,30,30
1650194988801,MATH 142A,B01,083221,Chow; Bennett,0,11,30,30
1650194988801,MATH 142A,B02,083222,Chow; Bennett,0,12,30,30
1650194994829,MATH 193A,A01,083224,Staff,0,4,30,30
1650194994829,MATH 193A,A02,083225,Staff,0,4,30,30
1650194994829,MATH 193A,A03,083781,Staff,0,2,30,30
1650194994829,MATH 193A,A04,083782,Staff,0,1,30,30
1650195000857,MATH 197,001,091859,McAuley; Julian John,9998,0,9999,1
1650195006929,COGS 9,A01,083615,Staff,0,14,60,60
1650195012958,COGS 11,A01,083617,Boyle; Mary E. T.,24,0,40,16
1650195018989,COGS 13,A01,083071,Staff,0,30,40,40
1650195025030,COGS 14A,A01,092681,Staff,0,12,100,100
1650195031067,COGS 14B,A01,083073,Cheng; Tzu-Han,0,7,50,50
1650195037098,COGS 17,A01,092677,Staff,35,0,75,40
1650195043128,COGS 100,A01,083619,Staff,0,20,60,60
1650195049156,COGS 101A,A01,083621,Davis; Joshua Daniel,0,21,60,60
1650195055183,COGS 101B,A01,091572,Staff,6,0,60,54
1650195061305,COGS 101C,A01,083625,Delgado; Tania,20,0,30,10
1650195067337,COGS 107A,A01,083627,Boyle; Mary E. T.,0,7,60,60
1650195073365,COGS 118A,A01,083075,Staff,16,0,60,44
1650195079396,CSE 3,A50,083646,Miranda; Gregory Joseph,22,0,38,16
1650195079396,CSE 3,A51,083647,Miranda; Gregory Joseph,37,0,37,0
1650195085428,CSE 8A,A50,083650,Miranda; Gregory Joseph,0,17,40,40
1650195091456,CSE 11,A01,083080,Cao; Yingjun,0,68,40,40
1650195097487,CSE 12,A01,083652,Staff,0,7,100,100
1650195103515,CSE 15L,A01,083654,Staff,0,0,50,50
1650195103515,CSE 15L,A02,083655,Staff,6,0,50,44
1650195109544,CSE 20,A01,083657,Staff,53,0,80,27
1650195115578,CSE 30,A01,083084,Eldon; John,0,69,40,40
1650195121611,CSE 100,A01,083659,Cao; Yingjun,0,63,50,50
1650195127641,CSE 134B,A01,083661,Powell; Thomas Allan,0,27,65,65
1650195133673,CSE 140,A01,083663,Staff,1,0,75,74
1650195139703,CSE 140L,A01,083088,Eldon; John,0,4,75,75
1650195145733,CSE 175,A01,083665,Kumar; Rakesh,8,0,25,17
1650195151763,CSE 190,A00,092507,Dubnov; Shlomo,14,0,20,6
1650195157796,ECE 45,A01,083139,Staff,0,13,40,40
1650195163828,ECE 65,A50,083695,Staff,0,5,30,30
1650195169862,ECE 109,A01,091882,Touri; Behrouz,47,0,70,23
1650195175902,ECE 180,A00,083140,Abi Samra; Nicholas Camill,24,0,30,6
1650195175902,ECE 180,B00,083141,Abi Samra; Nicholas Camill,8,0,30,22
1650195181933,MATH 10A,A01,083735,Patchell; Gregory David,11,0,30,19
1650195181933,MATH 10A,A02,083736,Patchell; Gregory David,28,0,30,2
1650195181933,MATH 10A,A03,083737,Patchell; Gregory David,26,0,30,4
1650195187963,MATH 10B,A01,083207,Staff,0,5,30,30
1650195187963,MATH 10B,A02,083208,Staff,0,5,30,30
1650195187963,MATH 10B,B01,083739,Staff,17,0,30,13
1650195187963,MATH 10B,B02,083740,Staff,29,0,30,1
1650195193998,MATH 18,A01,083743,Staff,8,0,30,22
1650195193998,MATH 18,A02,083744,Staff,28,0,30,2
1650195193998,MATH 18,A03,083745,Staff,23,0,30,7
1650195193998,MATH 18,A04,083746,Staff,27,0,30,3
1650195193998,MATH 18,B01,083748,Staff,0,10,30,30
1650195193998,MATH 18,B02,083749,Staff,0,7,30,30
1650195193998,MATH 18,B03,083750,Staff,0,7,30,30
1650195193998,MATH 18,B04,083751,Staff,0,8,30,30
1650195200026,MATH 20A,A01,083754,Staff,26,0,40,14
1650195206055,MATH 20B,A01,083756,Staff,0,6,30,30
1650195206055,MATH 20B,A02,083757,Staff,0,6,30,30
1650195212087,MATH 20C,A01,083760,Staff,0,12,30,30
1650195212087,MATH 20C,A02,083761,Staff,0,12,30,30
1650195212087,MATH 20C,B01,083762,Staff,14,0,30,16
1650195212087,MATH 20C,B02,083763,Staff,28,0,30,2
1650195218117,MATH 20D,A01,083765,Staff,1,2,30,29
1650195218117,MATH 20D,A02,083766,Staff,10,0,30,20
1650195218117,MATH 20D,A03,083767,Staff,28,0,30,2
1650195224149,MATH 20E,A01,083771,Staff,8,0,30,22
1650195224149,MATH 20E,A02,083772,Staff,20,0,30,10
1650195224149,MATH 20E,B01,083773,Staff,0,0,30,30
1650195224149,MATH 20E,B02,083774,Staff,12,0,30,18
1650195230178,MATH 103A,A01,083777,Staff,0,9,30,30
1650195230178,MATH 103A,A02,083778,Staff,0,10,30,30
1650195230178,MATH 103A,B01,083779,Staff,0,9,30,30
1650195230178,MATH 103A,B02,083780,Staff,0,9,30,30
1650195236206,MATH 105,A01,085443,Staff,0,17,30,30
1650195242240,MATH 109,A01,083213,Anzaldo; Leesa B,0,3,30,30
1650195242240,MATH 109,A02,083214,Anzaldo; Leesa B,0,6,30,30
1650195242240,MATH 109,B01,083215,Anzaldo; Leesa B,0,4,30,30
1650195242240,MATH 109,B02,083216,Anzaldo; Leesa B,0,4,30,30
1650195248275,MATH 142A,A01,083219,Chow; Bennett,0,12,30,30
1650195248275,MATH 142A,A02,083220,Chow; Bennett,0,11,30,30
1650195248275,MATH 142A,B01,083221,Chow; Bennett,0,11,30,30
1650195248275,MATH 142A,B02,083222,Chow; Bennett,0,12,30,30
1650195254304,MATH 193A,A01,083224,Staff,0,4,30,30
1650195254304,MATH 193A,A02,083225,Staff,0,4,30,30
1650195254304,MATH 193A,A03,083781,Staff,0,2,30,30
1650195254304,MATH 193A,A04,083782,Staff,0,1,30,30
1650195260334,MATH 197,001,091859,McAuley; Julian John,9998,0,9999,1
1650195266408,COGS 9,A01,083615,Staff,0,14,60,60
1650195272438,COGS 11,A01,083617,Boyle; Mary E. T.,24,0,40,16
1650195278467,COGS 13,A01,083071,Staff,0,30,40,40
1650195284492,COGS 14A,A01,092681,Staff,0,12,100,100
1650195290520,COGS 14B,A01,083073,Cheng; Tzu-Han,0,7,50,50
1650195296547,COGS 17,A01,092677,Staff,35,0,75,40
1650195302584,COGS 100,A01,083619,Staff,0,20,60,60
1650195308616,COGS 101A,A01,083621,Davis; Joshua Daniel,0,21,60,60
1650195314644,COGS 101B,A01,091572,Staff,6,0,60,54
1650195320677,COGS 101C,A01,083625,Delgado; Tania,20,0,30,10
1650195326704,COGS 107A,A01,083627,Boyle; Mary E. T.,0,7,60,60
1650195332731,COGS 118A,A01,083075,Staff,16,0,60,44
1650195338760,CSE 3,A50,083646,Miranda; Gregory Joseph,22,0,38,16
1650195338760,CSE 3,A51,083647,Miranda; Gregory Joseph,37,0,37,0
1650195344788,CSE 8A,A50,083650,Miranda; Gregory Joseph,0,17,40,40
1650195350828,CSE 11,A01,083080,Cao; Yingjun,0,68,40,40
1650195356860,CSE 12,A01,083652,Staff,0,7,100,100
1650195362885,CSE 15L,A01,083654,Staff,0,0,50,50
1650195362885,CSE 15L,A02,083655,Staff,6,0,50,44
1650195368916,CSE 20,A01,083657,Staff,53,0,80,27
1650195374949,CSE 30,A01,083084,Eldon; John,0,69,40,40
1650195380978,CSE 100,A01,083659,Cao; Yingjun,0,63,50,50
1650195387010,CSE 134B,A01,083661,Powell; Thomas Allan,0,27,65,65
1650195393037,CSE 140,A01,083663,Staff,1,0,75,74
1650195399067,CSE 140L,A01,083088,Eldon; John,0,4,75,75
1650195405101,CSE 175,A01,083665,Kumar; Rakesh,8,0,25,17
1650195411131,CSE 190,A00,092507,Dubnov; Shlomo,14,0,20,6
1650195417156,ECE 45,A01,083139,Staff,0,13,40,40
1650195423185,ECE 65,A50,083695,Staff,0,5,30,30
1650195429216,ECE 109,A01,091882,Touri; Behrouz,47,0,70,23
1650195435245,ECE 180,A00,083140,Abi Samra; Nicholas Camill,24,0,30,6
1650195435245,ECE 180,B00,083141,Abi Samra; Nicholas Camill,8,0,30,22
1650195441283,MATH 10A,A01,083735,Patchell; Gregory David,11,0,30,19
1650195441283,MATH 10A,A02,083736,Patchell; Gregory David,28,0,30,2
1650195441283,MATH 10A,A03,083737,Patchell; Gregory David,26,0,30,4
1650195447319,MATH 10B,A01,083207,Staff,0,5,30,30
1650195447319,MATH 10B,A02,083208,Staff,0,5,30,30
1650195447319,MATH 10B,B01,083739,Staff,17,0,30,13
1650195447319,MATH 10B,B02,083740,Staff,29,0,30,1
1650195453359,MATH 18,A01,083743,Staff,8,0,30,22
1650195453359,MATH 18,A02,083744,Staff,28,0,30,2
1650195453359,MATH 18,A03,083745,Staff,23,0,30,7
1650195453359,MATH 18,A04,083746,Staff,27,0,30,3
1650195453359,MATH 18,B01,083748,Staff,0,10,30,30
1650195453359,MATH 18,B02,083749,Staff,0,7,30,30
1650195453359,MATH 18,B03,083750,Staff,0,7,30,30
1650195453359,MATH 18,B04,083751,Staff,0,8,30,30
1650195459392,MATH 20A,A01,083754,Staff,26,0,40,14
1650195465434,MATH 20B,A01,083756,Staff,0,6,30,30
1650195465434,MATH 20B,A02,083757,Staff,0,6,30,30
1650195471463,MATH 20C,A01,083760,Staff,0,12,30,30
1650195471463,MATH 20C,A02,083761,Staff,0,12,30,30
1650195471463,MATH 20C,B01,083762,Staff,14,0,30,16
1650195471463,MATH 20C,B02,083763,Staff,28,0,30,2
1650195477492,MATH 20D,A01,083765,Staff,1,2,30,29
1650195477492,MATH 20D,A02,083766,Staff,10,0,30,20
1650195477492,MATH 20D,A03,083767,Staff,28,0,30,2
1650195483522,MATH 20E,A01,083771,Staff,8,0,30,22
1650195483522,MATH 20E,A02,083772,Staff,20,0,30,10
1650195483522,MATH 20E,B01,083773,Staff,0,0,30,30
1650195483522,MATH 20E,B02,083774,Staff,12,0,30,18
1650195489552,MATH 103A,A01,083777,Staff,0,9,30,30
1650195489552,MATH 103A,A02,083778,Staff,0,10,30,30
1650195489552,MATH 103A,B01,083779,Staff,0,9,30,30
1650195489552,MATH 103A,B02,083780,Staff,0,9,30,30
1650195495581,MATH 105,A01,085443,Staff,0,17,30,30
1650195501616,MATH 109,A01,083213,Anzaldo; Leesa B,0,3,30,30
1650195501616,MATH 109,A02,083214,Anzaldo; Leesa B,0,6,30,30
1650195501616,MATH 109,B01,083215,Anzaldo; Leesa B,0,4,30,30
1650195501616,MATH 109,B02,083216,Anzaldo; Leesa B,0,4,30,30
1650195507649,MATH 142A,A01,083219,Chow; Bennett,0,12,30,30
1650195507649,MATH 142A,A02,083220,Chow; Bennett,0,11,30,30
1650195507649,MATH 142A,B01,083221,Chow; Bennett,0,11,30,30
1650195507649,MATH 142A,B02,083222,Chow; Bennett,0,12,30,30
1650195513678,MATH 193A,A01,083224,Staff,0,4,30,30
1650195513678,MATH 193A,A02,083225,Staff,0,4,30,30
1650195513678,MATH 193A,A03,083781,Staff,0,2,30,30
1650195513678,MATH 193A,A04,083782,Staff,0,1,30,30
1650195519705,MATH 197,001,091859,McAuley; Julian John,9998,0,9999,1
1650195525783,COGS 9,A01,083615,Staff,0,14,60,60
1650195531815,COGS 11,A01,083617,Boyle; Mary E. T.,24,0,40,16
1650195537846,COGS 13,A01,083071,Staff,0,30,40,40
1650195543881,COGS 14A,A01,092681,Staff,0,12,100,100
1650195549916,COGS 14B,A01,083073,Cheng; Tzu-Han,0,7,50,50
1650195555948,COGS 17,A01,092677,Staff,35,0,75,40
1650195561976,COGS 100,A01,083619,Staff,0,20,60,60
1650195568006,COGS 101A,A01,083621,Davis; Joshua Daniel,0,21,60,60
1650195574048,COGS 101B,A01,091572,Staff,6,0,60,54
1650195580094,COGS 101C,A01,083625,Delgado; Tania,20,0,30,10
1650195586125,COGS 107A,A01,083627,Boyle; Mary E. T.,0,7,60,60
1650195592159,COGS 118A,A01,083075,Staff,16,0,60,44
1650195598189,CSE 3,A50,083646,Miranda; Gregory Joseph,22,0,38,16
1650195598189,CSE 3,A51,083647,Miranda; Gregory Joseph,37,0,37,0
1650195604217,CSE 8A,A50,083650,Miranda; Gregory Joseph,0,17,40,40
1650195610259,CSE 11,A01,083080,Cao; Yingjun,0,68,40,40
1650195616291,CSE 12,A01,083652,Staff,0,7,100,100
1650195622337,CSE 15L,A01,083654,Staff,0,0,50,50
1650195622337,CSE 15L,A02,083655,Staff,6,0,50,44
1650195628370,CSE 20,A01,083657,Staff,53,0,80,27
1650195634406,CSE 30,A01,083084,Eldon; John,0,69,40,40
1650195640435,CSE 100,A01,083659,Cao; Yingjun,0,63,50,50
1650195646465,CSE 134B,A01,083661,Powell; Thomas Allan,0,27,65,65
1650195652493,CSE 140,A01,083663,Staff,1,0,75,74
1650195658633,CSE 140L,A01,083088,Eldon; John,0,4,75,75
1650195664677,CSE 175,A01,083665,Kumar; Rakesh,8,0,25,17
1650195670719,CSE 190,A00,092507,Dubnov; Shlomo,14,0,20,6
1650195676753,ECE 45,A01,083139,Staff,0,13,40,40
1650195682789,ECE 65,A50,083695,Staff,0,5,30,30
1650195688821,ECE 109,A01,091882,Touri; Behrouz,47,0,70,23
1650195694855,ECE 180,A00,083140,Abi Samra; Nicholas Camill,24,0,30,6
1650195694855,ECE 180,B00,083141,Abi Samra; Nicholas Camill,8,0,30,22
1650195700911,MATH 10A,A01,083735,Patchell; Gregory David,11,0,30,19
1650195700911,MATH 10A,A02,083736,Patchell; Gregory David,28,0,30,2
1650195700911,MATH 10A,A03,083737,Patchell; Gregory David,26,0,30,4
1650195706942,MATH 10B,A01,083207,Staff,0,5,30,30
1650195706942,MATH 10B,A02,083208,Staff,0,5,30,30
1650195706942,MATH 10B,B01,083739,Staff,17,0,30,13
1650195706942,MATH 10B,B02,083740,Staff,29,0,30,1
1650195712973,MATH 18,A01,083743,Staff,8,0,30,22
1650195712973,MATH 18,A02,083744,Staff,28,0,30,2
1650195712973,MATH 18,A03,083745,Staff,23,0,30,7
1650195712973,MATH 18,A04,083746,Staff,27,0,30,3
1650195712973,MATH 18,B01,083748,Staff,0,10,30,30
1650195712973,MATH 18,B02,083749,Staff,0,7,30,30
1650195712973,MATH 18,B03,083750,Staff,0,7,30,30
1650195712973,MATH 18,B04,083751,Staff,0,8,30,30
1650195719001,MATH 20A,A01,083754,Staff,26,0,40,14
1650195725035,MATH 20B,A01,083756,Staff,0,6,30,30
1650195725035,MATH 20B,A02,083757,Staff,0,6,30,30
1650195731068,MATH 20C,A01,083760,Staff,0,12,30,30
1650195731068,MATH 20C,A02,083761,Staff,0,12,30,30
1650195731068,MATH 20C,B01,083762,Staff,14,0,30,16
1650195731068,MATH 20C,B02,083763,Staff,28,0,30,2
1650195737097,MATH 20D,A01,083765,Staff,1,2,30,29
1650195737097,MATH 20D,A02,083766,Staff,10,0,30,20
1650195737097,MATH 20D,A03,083767,Staff,28,0,30,2
1650195743130,MATH 20E,A01,083771,Staff,8,0,30,22
1650195743130,MATH 20E,A02,083772,Staff,20,0,30,10
1650195743130,MATH 20E,B01,083773,Staff,0,0,30,30
1650195743130,MATH 20E,B02,083774,Staff,12,0,30,18
1650195749164,MATH 103A,A01,083777,Staff,0,9,30,30
1650195749164,MATH 103A,A02,083778,Staff,0,10,30,30
1650195749164,MATH 103A,B01,083779,Staff,0,9,30,30
1650195749164,MATH 103A,B02,083780,Staff,0,9,30,30
1650195755191,MATH 105,A01,085443,Staff,0,17,30,30
1650195761229,MATH 109,A01,083213,Anzaldo; Leesa B,0,3,30,30
1650195761229,MATH 109,A02,083214,Anzaldo; Leesa B,0,6,30,30
1650195761229,MATH 109,B01,083215,Anzaldo; Leesa B,0,4,30,30
1650195761229,MATH 109,B02,083216,Anzaldo; Leesa B,0,4,30,30
1650195767264,MATH 142A,A01,083219,Chow; Bennett,0,12,30,30
1650195767264,MATH 142A,A02,083220,Chow; Bennett,0,11,30,30
1650195767264,MATH 142A,B01,083221,Chow; Bennett,0,11,30,30
1650195767264,MATH 142A,B02,083222,Chow; Bennett,0,12,30,30
1650195773293,MATH 193A,A01,083224,Staff,0,4,30,30
1650195773293,MATH 193A,A02,083225,Staff,0,4,30,30
1650195773293,MATH 193A,A03,083781,Staff,0,2,30,30
1650195773293,MATH 193A,A04,083782,Staff,0,1,30,30
1650195779321,MATH 197,001,091859,McAuley; Julian John,9998,0,9999,1
1650195785401,COGS 9,A01,083615,Staff,0,14,60,60
1650195791430,COGS 11,A01,083617,Boyle; Mary E. T.,24,0,40,16
1650195797461,COGS 13,A01,083071,Staff,0,30,40,40
1650195803488,COGS 14A,A01,092681,Staff,0,12,100,100
1650195809515,COGS 14B,A01,083073,Cheng; Tzu-Han,0,7,50,50
1650195815545,COGS 17,A01,092677,Staff,35,0,75,40
1650195821572,COGS 100,A01,083619,Staff,0,20,60,60
1650195827602,COGS 101A,A01,083621,Davis; Joshua Daniel,0,21,60,60
1650195833630,COGS 101B,A01,091572,Staff,6,0,60,54
1650195839659,COGS 101C,A01,083625,Delgado; Tania,20,0,30,10
1650195845693,COGS 107A,A01,083627,Boyle; Mary E. T.,0,7,60,60
1650195851774,COGS 118A,A01,083075,Staff,16,0,60,44
1650195857812,CSE 3,A50,083646,Miranda; Gregory Joseph,22,0,38,16
1650195857812,CSE 3,A51,083647,Miranda; Gregory Joseph,37,0,37,0
1650195863839,CSE 8A,A50,083650,Miranda; Gregory Joseph,0,17,40,40
1650195869869,CSE 11,A01,083080,Cao; Yingjun,0,68,40,40
1650195875903,CSE 12,A01,083652,Staff,0,7,100,100
1650195881930,CSE 15L,A01,083654,Staff,0,0,50,50
1650195881930,CSE 15L,A02,083655,Staff,6,0,50,44
1650195887965,CSE 20,A01,083657,Staff,53,0,80,27
1650195893995,CSE 30,A01,083084,Eldon; John,0,69,40,40
1650195900026,CSE 100,A01,083659,Cao; Yingjun,0,63,50,50
1650195906057,CSE 134B,A01,083661,Powell; Thomas Allan,0,27,65,65
1650195912083,CSE 140,A01,083663,Staff,1,0,75,74
1650195918110,CSE 140L,A01,083088,Eldon; John,0,4,75,75
1650195924139,CSE 175,A01,083665,Kumar; Rakesh,8,0,25,17
1650195930167,CSE 190,A00,092507,Dubnov; Shlomo,14,0,20,6
1650195936204,ECE 45,A01,083139,Staff,0,13,40,40
1650195942236,ECE 65,A50,083695,Staff,0,5,30,30
1650195948263,ECE 109,A01,091882,Touri; Behrouz,47,0,70,23
1650195954292,ECE 180,A00,083140,Abi Samra; Nicholas Camill,24,0,30,6
1650195954292,ECE 180,B00,083141,Abi Samra; Nicholas Camill,8,0,30,22
1650195960333,MATH 10A,A01,083735,Patchell; Gregory David,11,0,30,19
1650195960333,MATH 10A,A02,083736,Patchell; Gregory David,28,0,30,2
1650195960333,MATH 10A,A03,083737,Patchell; Gregory David,26,0,30,4
1650195966364,MATH 10B,A01,083207,Staff,0,5,30,30
1650195966364,MATH 10B,A02,083208,Staff,0,5,30,30
1650195966364,MATH 10B,B01,083739,Staff,17,0,30,13
1650195966364,MATH 10B,B02,083740,Staff,29,0,30,1
1650195972410,MATH 18,A01,083743,Staff,8,0,30,22
1650195972410,MATH 18,A02,083744,Staff,28,0,30,2
1650195972410,MATH 18,A03,083745,Staff,23,0,30,7
1650195972410,MATH 18,A04,083746,Staff,27,0,30,3
1650195972410,MATH 18,B01,083748,Staff,0,10,30,30
1650195972410,MATH 18,B02,083749,Staff,0,7,30,30
1650195972410,MATH 18,B03,083750,Staff,0,7,30,30
1650195972410,MATH 18,B04,083751,Staff,0,8,30,30
1650195978443,MATH 20A,A01,083754,Staff,26,0,40,14
1650195984470,MATH 20B,A01,083756,Staff,0,6,30,30
1650195984470,MATH 20B,A02,083757,Staff,0,6,30,30
1650195990496,MATH 20C,A01,083760,Staff,0,12,30,30
1650195990496,MATH 20C,A02,083761,Staff,0,12,30,30
1650195990496,MATH 20C,B01,083762,Staff,14,0,30,16
1650195990496,MATH 20C,B02,083763,Staff,28,0,30,2
1650195996522,MATH 20D,A01,083765,Staff,1,2,30,29
1650195996522,MATH 20D,A02,083766,Staff,10,0,30,20
1650195996522,MATH 20D,A03,083767,Staff,28,0,30,2
1650196002549,MATH 20E,A01,083771,Staff,8,0,30,22
1650196002549,MATH 20E,A02,083772,Staff,20,0,30,10
1650196002549,MATH 20E,B01,083773,Staff,0,0,30,30
1650196002549,MATH 20E,B02,083774,Staff,12,0,30,18
1650196008579,MATH 103A,A01,083777,Staff,0,9,30,30
1650196008579,MATH 103A,A02,083778,Staff,0,10,30,30
1650196008579,MATH 103A,B01,083779,Staff,0,9,30,30
1650196008579,MATH 103A,B02,083780,Staff,0,9,30,30
1650196014604,MATH 105,A01,085443,Staff,0,17,30,30
1650196020633,MATH 109,A01,083213,Anzaldo; Leesa B,0,3,30,30
1650196020633,MATH 109,A02,083214,Anzaldo; Leesa B,0,6,30,30
1650196020633,MATH 109,B01,083215,Anzaldo; Leesa B,0,4,30,30
1650196020633,MATH 109,B02,083216,Anzaldo; Leesa B,0,4,30,30
1650196026667,MATH 142A,A01,083219,Chow; Bennett,0,12,30,30
1650196026667,MATH 142A,A02,083220,Chow; Bennett,0,11,30,30
1650196026667,MATH 142A,B01,083221,Chow; Bennett,0,11,30,30
1650196026667,MATH 142A,B02,083222,Chow; Bennett,0,12,30,30
1650196032692,MATH 193A,A01,083224,Staff,0,4,30,30
1650196032692,MATH 193A,A02,083225,Staff,0,4,30,30
1650196032692,MATH 193A,A03,083781,Staff,0,2,30,30
1650196032692,MATH 193A,A04,083782,Staff,0,1,30,30
1650196038744,MATH 197,001,091859,McAuley; Julian John,9998,0,9999,1
1650196044835,COGS 9,A01,083615,Staff,0,14,60,60
1650196050865,COGS 11,A01,083617,Boyle; Mary E. T.,24,0,40,16
1650196056892,COGS 13,A01,083071,Staff,0,30,40,40
1650196062921,COGS 14A,A01,092681,Staff,0,12,100,100
1650196068959,COGS 14B,A01,083073,Cheng; Tzu-Han,0,7,50,50
1650196074987,COGS 17,A01,092677,Staff,35,0,75,40
1650196081018,COGS 100,A01,083619,Staff,0,20,60,60
1650196087044,COGS 101A,A01,083621,Davis; Joshua Daniel,0,21,60,60
1650196093072,COGS 101B,A01,091572,Staff,6,0,60,54
1650196099097,COGS 101C,A01,083625,Delgado; Tania,20,0,30,10
1650196105122,COGS 107A,A01,083627,Boyle; Mary E. T.,0,7,60,60
1650196111151,COGS 118A,A01,083075,Staff,16,0,60,44
1650196117183,CSE 3,A50,083646,Miranda; Gregory Joseph,22,0,38,16
1650196117183,CSE 3,A51,083647,Miranda; Gregory Joseph,37,0,37,0
1650196123207,CSE 8A,A50,083650,Miranda; Gregory Joseph,0,17,40,40
1650196129237,CSE 11,A01,083080,Cao; Yingjun,0,68,40,40
1650196135270,CSE 12,A01,083652,Staff,0,7,100,100
1650196141298,CSE 15L,A01,083654,Staff,0,0,50,50
1650196141298,CSE 15L,A02,083655,Staff,6,0,50,44
1650196147327,CSE 20,A01,083657,Staff,53,0,80,27
1650196153364,CSE 30,A01,083084,Eldon; John,0,69,40,40
1650196159394,CSE 100,A01,083659,Cao; Yingjun,0,63,50,50
1650196165421,CSE 134B,A01,083661,Powell; Thomas Allan,0,27,65,65
1650196171449,CSE 140,A01,083663,Staff,1,0,75,74
1650196177476,CSE 140L,A01,083088,Eldon; John,0,4,75,75
1650196183507,CSE 175,A01,083665,Kumar; Rakesh,8,0,25,17
1650196189537,CSE 190,A00,092507,Dubnov; Shlomo,14,0,20,6
1650196195564,ECE 45,A01,083139,Staff,0,13,40,40
1650196201595,ECE 65,A50,083695,Staff,0,5,30,30
1650196207625,ECE 109,A01,091882,Touri; Behrouz,47,0,70,23
1650196213655,ECE 180,A00,083140,Abi Samra; Nicholas Camill,24,0,30,6
1650196213655,ECE 180,B00,083141,Abi Samra; Nicholas Camill,8,0,30,22
1650196219684,MATH 10A,A01,083735,Patchell; Gregory David,11,0,30,19
1650196219684,MATH 10A,A02,083736,Patchell; Gregory David,28,0,30,2
1650196219684,MATH 10A,A03,083737,Patchell; Gregory David,26,0,30,4
1650196225712,MATH 10B,A01,083207,Staff,0,5,30,30
1650196225712,MATH 10B,A02,083208,Staff,0,5,30,30
1650196225712,MATH 10B,B01,083739,Staff,17,0,30,13
1650196225712,MATH 10B,B02,083740,Staff,29,0,30,1
1650196231749,MATH 18,A01,083743,Staff,8,0,30,22
1650196231749,MATH 18,A02,083744,Staff,28,0,30,2
1650196231749,MATH 18,A03,083745,Staff,23,0,30,7
1650196231749,MATH 18,A04,083746,Staff,27,0,30,3
1650196231749,MATH 18,B01,083748,Staff,0,10,30,30
1650196231749,MATH 18,B02,083749,Staff,0,7,30,30
1650196231749,MATH 18,B03,083750,Staff,0,7,30,30
1650196231749,MATH 18,B04,083751,Staff,0,8,30,30
1650196237782,MATH 20A,A01,083754,Staff,26,0,40,14
1650196243808,MATH 20B,A01,083756,Staff,0,6,30,30
1650196243808,MATH 20B,A02,083757,Staff,0,6,30,30
1650196249837,MATH 20C,A01,083760,Staff,0,12,30,30
1650196249837,MATH 20C,A02,083761,Staff,0,12,30,30
1650196249837,MATH 20C,B01,083762,Staff,14,0,30,16
1650196249837,MATH 20C,B02,083763,Staff,28,0,30,2
1650196255962,MATH 20D,A01,083765,Staff,1,2,30,29
1650196255962,MATH 20D,A02,083766,Staff,10,0,30,20
1650196255962,MATH 20D,A03,083767,Staff,28,0,30,2
1650196261991,MATH 20E,A01,083771,Staff,8,0,30,22
1650196261991,MATH 20E,A02,083772,Staff,20,0,30,10
1650196261991,MATH 20E,B01,083773,Staff,0,0,30,30
1650196261991,MATH 20E,B02,083774,Staff,12,0,30,18
1650196268019,MATH 103A,A01,083777,Staff,0,9,30,30
1650196268019,MATH 103A,A02,083778,Staff,0,10,30,30
1650196268019,MATH 103A,B01,083779,Staff,0,9,30,30
1650196268019,MATH 103A,B02,083780,Staff,0,9,30,30
1650196274048,MATH 105,A01,085443,Staff,0,17,30,30
1650196280076,MATH 109,A01,083213,Anzaldo; Leesa B,0,3,30,30
1650196280076,MATH 109,A02,083214,Anzaldo; Leesa B,0,6,30,30
1650196280076,MATH 109,B01,083215,Anzaldo; Leesa B,0,4,30,30
1650196280076,MATH 109,B02,083216,Anzaldo; Leesa B,0,4,30,30
1650196286109,MATH 142A,A01,083219,Chow; Bennett,0,12,30,30
1650196286109,MATH 142A,A02,083220,Chow; Bennett,0,11,30,30
1650196286109,MATH 142A,B01,083221,Chow; Bennett,0,11,30,30
1650196286109,MATH 142A,B02,083222,Chow; Bennett,0,12,30,30
1650196292139,MATH 193A,A01,083224,Staff,0,4,30,30
1650196292139,MATH 193A,A02,083225,Staff,0,4,30,30
1650196292139,MATH 193A,A03,083781,Staff,0,2,30,30
1650196292139,MATH 193A,A04,083782,Staff,0,1,30,30
1650196298167,MATH 197,001,091859,McAuley; Julian John,9998,0,9999,1
1650196304243,COGS 9,A01,083615,Staff,0,14,60,60
1650196310273,COGS 11,A01,083617,Boyle; Mary E. T.,24,0,40,16
1650196316300,COGS 13,A01,083071,Staff,0,30,40,40
1650196322326,COGS 14A,A01,092681,Staff,0,12,100,100
1650196328360,COGS 14B,A01,083073,Cheng; Tzu-Han,0,7,50,50
1650196334391,COGS 17,A01,092677,Staff,35,0,75,40
1650196340422,COGS 100,A01,083619,Staff,0,20,60,60
1650196346457,COGS 101A,A01,083621,Davis; Joshua Daniel,0,21,60,60
1650196352488,COGS 101B,A01,091572,Staff,6,0,60,54
1650196358522,COGS 101C,A01,083625,Delgado; Tania,20,0,30,10
1650196364550,COGS 107A,A01,083627,Boyle; Mary E. T.,0,7,60,60
1650196370575,COGS 118A,A01,083075,Staff,16,0,60,44
1650196376604,CSE 3,A50,083646,Miranda; Gregory Joseph,22,0,38,16
1650196376604,CSE 3,A51,083647,Miranda; Gregory Joseph,37,0,37,0
1650196382637,CSE 8A,A50,083650,Miranda; Gregory Joseph,0,17,40,40
1650196388667,CSE 11,A01,083080,Cao; Yingjun,0,68,40,40
1650196394696,CSE 12,A01,083652,Staff,0,7,100,100
1650196400731,CSE 15L,A01,083654,Staff,0,0,50,50
1650196400731,CSE 15L,A02,083655,Staff,6,0,50,44
1650196406773,CSE 20,A01,083657,Staff,53,0,80,27
1650196412803,CSE 30,A01,083084,Eldon; John,0,69,40,40
1650196418828,CSE 100,A01,083659,Cao; Yingjun,0,63,50,50
1650196424856,CSE 134B,A01,083661,Powell; Thomas Allan,0,27,65,65
1650196430882,CSE 140,A01,083663,Staff,1,0,75,74
1650196436908,CSE 140L,A01,083088,Eldon; John,0,4,75,75
1650196442938,CSE 175,A01,083665,Kumar; Rakesh,8,0,25,17
1650196448968,CSE 190,A00,092507,Dubnov; Shlomo,14,0,20,6
1650196455010,ECE 45,A01,083139,Staff,0,13,40,40
1650196461040,ECE 65,A50,083695,Staff,0,5,30,30
1650196467068,ECE 109,A01,091882,Touri; Behrouz,47,0,70,23
1650196473095,ECE 180,A00,083140,Abi Samra; Nicholas Camill,24,0,30,6
1650196473095,ECE 180,B00,083141,Abi Samra; Nicholas Camill,8,0,30,22
1650196479123,MATH 10A,A01,083735,Patchell; Gregory David,11,0,30,19
1650196479123,MATH 10A,A02,083736,Patchell; Gregory David,28,0,30,2
1650196479123,MATH 10A,A03,083737,Patchell; Gregory David,26,0,30,4
1650196485158,MATH 10B,A01,083207,Staff,0,5,30,30
1650196485158,MATH 10B,A02,083208,Staff,0,5,30,30
1650196485158,MATH 10B,B01,083739,Staff,17,0,30,13
1650196485158,MATH 10B,B02,083740,Staff,29,0,30,1
1650196491188,MATH 18,A01,083743,Staff,8,0,30,22
1650196491188,MATH 18,A02,083744,Staff,28,0,30,2
1650196491188,MATH 18,A03,083745,Staff,23,0,30,7
1650196491188,MATH 18,A04,083746,Staff,27,0,30,3
1650196491188,MATH 18,B01,083748,Staff,0,10,30,30
1650196491188,MATH 18,B02,083749,Staff,0,7,30,30
1650196491188,MATH 18,B03,083750,Staff,0,7,30,30
1650196491188,MATH 18,B04,083751,Staff,0,8,30,30
1650196497213,MATH 20A,A01,083754,Staff,26,0,40,14
1650196503243,MATH 20B,A01,083756,Staff,0,6,30,30
1650196503243,MATH 20B,A02,083757,Staff,0,6,30,30
1650196509274,MATH 20C,A01,083760,Staff,0,12,30,30
1650196509274,MATH 20C,A02,083761,Staff,0,12,30,30
1650196509274,MATH 20C,B01,083762,Staff,14,0,30,16
1650196509274,MATH 20C,B02,083763,Staff,28,0,30,2
1650196515301,MATH 20D,A01,083765,Staff,1,2,30,29
1650196515301,MATH 20D,A02,083766,Staff,10,0,30,20
1650196515301,MATH 20D,A03,083767,Staff,28,0,30,2
1650196521333,MATH 20E,A01,083771,Staff,8,0,30,22
1650196521333,MATH 20E,A02,083772,Staff,20,0,30,10
1650196521333,MATH 20E,B01,083773,Staff,0,0,30,30
1650196521333,MATH 20E,B02,083774,Staff,12,0,30,18
1650196527364,MATH 103A,A01,083777,Staff,0,9,30,30
1650196527364,MATH 103A,A02,083778,Staff,0,10,30,30
1650196527364,MATH 103A,B01,083779,Staff,0,9,30,30
1650196527364,MATH 103A,B02,083780,Staff,0,9,30,30
1650196533394,MATH 105,A01,085443,Staff,0,17,30,30
1650196539425,MATH 109,A01,083213,Anzaldo; Leesa B,0,3,30,30
1650196539425,MATH 109,A02,083214,Anzaldo; Leesa B,0,6,30,30
1650196539425,MATH 109,B01,083215,Anzaldo; Leesa B,0,4,30,30
1650196539425,MATH 109,B02,083216,Anzaldo; Leesa B,0,4,30,30
1650196545449,MATH 142A,A01,083219,Chow; Bennett,0,12,30,30
1650196545449,MATH 142A,A02,083220,Chow; Bennett,0,11,30,30
1650196545449,MATH 142A,B01,083221,Chow; Bennett,0,11,30,30
1650196545449,MATH 142A,B02,083222,Chow; Bennett,0,12,30,30
1650196551477,MATH 193A,A01,083224,Staff,0,4,30,30
1650196551477,MATH 193A,A02,083225,Staff,0,4,30,30
1650196551477,MATH 193A,A03,083781,Staff,0,2,30,30
1650196551477,MATH 193A,A04,083782,Staff,0,1,30,30
1650196557507,MATH 197,001,091859,McAuley; Julian John,9998,0,9999,1
1650196563565,COGS 9,A01,083615,Staff,0,14,60,60
1650196569590,COGS 11,A01,083617,Boyle; Mary E. T.,24,0,40,16
1650196575617,COGS 13,A01,083071,Staff,0,30,40,40
1650196581642,COGS 14A,A01,092681,Staff,0,12,100,100
1650196587681,COGS 14B,A01,083073,Cheng; Tzu-Han,0,7,50,50
1650196593707,COGS 17,A01,092677,Staff,35,0,75,40
1650196599741,COGS 100,A01,083619,Staff,0,20,60,60
1650196605777,COGS 101A,A01,083621,Davis; Joshua Daniel,0,21,60,60
1650196611804,COGS 101B,A01,091572,Staff,6,0,60,54
1650196617829,COGS 101C,A01,083625,Delgado; Tania,20,0,30,10
1650196623854,COGS 107A,A01,083627,Boyle; Mary E. T.,0,7,60,60
1650196629879,COGS 118A,A01,083075,Staff,16,0,60,44
1650196635905,CSE 3,A50,083646,Miranda; Gregory Joseph,22,0,38,16
1650196635905,CSE 3,A51,083647,Miranda; Gregory Joseph,37,0,37,0
1650196641936,CSE 8A,A50,083650,Miranda; Gregory Joseph,0,17,40,40
1650196647960,CSE 11,A01,083080,Cao; Yingjun,0,68,40,40
1650196653988,CSE 12,A01,083652,Staff,0,7,100,100
1650196660015,CSE 15L,A01,083654,Staff,0,0,50,50
1650196660015,CSE 15L,A02,083655,Staff,6,0,50,44
1650196666040,CSE 20,A01,083657,Staff,53,0,80,27
1650196672070,CSE 30,A01,083084,Eldon; John,0,69,40,40
1650196678097,CSE 100,A01,083659,Cao; Yingjun,0,63,50,50
1650196684128,CSE 134B,A01,083661,Powell; Thomas Allan,0,27,65,65
1650196690151,CSE 140,A01,083663,Staff,1,0,75,74
1650196696175,CSE 140L,A01,083088,Eldon; John,0,4,75,75
1650196702201,CSE 175,A01,083665,Kumar; Rakesh,8,0,25,17
1650196708229,CSE 190,A00,092507,Dubnov; Shlomo,14,0,20,6
1650196714253,ECE 45,A01,083139,Staff,0,13,40,40
1650196720281,ECE 65,A50,083695,Staff,0,5,30,30
1650196726307,ECE 109,A01,091882,Touri; Behrouz,47,0,70,23
1650196732337,ECE 180,A00,083140,Abi Samra; Nicholas Camill,24,0,30,6
1650196732337,ECE 180,B00,083141,Abi Samra; Nicholas Camill,8,0,30,22
1650196738366,MATH 10A,A01,083735,Patchell; Gregory David,11,0,30,19
1650196738366,MATH 10A,A02,083736,Patchell; Gregory David,28,0,30,2
1650196738366,MATH 10A,A03,083737,Patchell; Gregory David,26,0,30,4
1650196744399,MATH 10B,A01,083207,Staff,0,5,30,30
1650196744399,MATH 10B,A02,083208,Staff,0,5,30,30
1650196744399,MATH 10B,B01,083739,Staff,17,0,30,13
1650196744399,MATH 10B,B02,083740,Staff,29,0,30,1
1650196750433,MATH 18,A01,083743,Staff,8,0,30,22
1650196750433,MATH 18,A02,083744,Staff,28,0,30,2
1650196750433,MATH 18,A03,083745,Staff,23,0,30,7
1650196750433,MATH 18,A04,083746,Staff,27,0,30,3
1650196750433,MATH 18,B01,083748,Staff,0,10,30,30
1650196750433,MATH 18,B02,083749,Staff,0,7,30,30
1650196750433,MATH 18,B03,083750,Staff,0,7,30,30
1650196750433,MATH 18,B04,083751,Staff,0,8,30,30
1650196756462,MATH 20A,A01,083754,Staff,26,0,40,14
1650196762493,MATH 20B,A01,083756,Staff,0,6,30,30
1650196762493,MATH 20B,A02,083757,Staff,0,6,30,30
1650196768521,MATH 20C,A01,083760,Staff,0,12,30,30
1650196768521,MATH 20C,A02,083761,Staff,0,12,30,30
1650196768521,MATH 20C,B01,083762,Staff,14,0,30,16
1650196768521,MATH 20C,B02,083763,Staff,28,0,30,2
1650196774551,MATH 20D,A01,083765,Staff,1,2,30,29
1650196774551,MATH 20D,A02,083766,Staff,10,0,30,20
1650196774551,MATH 20D,A03,083767,Staff,28,0,30,2
1650196780578,MATH 20E,A01,083771,Staff,8,0,30,22
1650196780578,MATH 20E,A02,083772,Staff,20,0,30,10
1650196780578,MATH 20E,B01,083773,Staff,0,0,30,30
1650196780578,MATH 20E,B02,083774,Staff,12,0,30,18
1650196786606,MATH 103A,A01,083777,Staff,0,9,30,30
1650196786606,MATH 103A,A02,083778,Staff,0,10,30,30
1650196786606,MATH 103A,B01,083779,Staff,0,9,30,30
1650196786606,MATH 103A,B02,083780,Staff,0,9,30,30
1650196792632,MATH 105,A01,085443,Staff,0,17,30,30
1650196798660,MATH 109,A01,083213,Anzaldo; Leesa B,0,3,30,30
1650196798660,MATH 109,A02,083214,Anzaldo; Leesa B,0,6,30,30
1650196798660,MATH 109,B01,083215,Anzaldo; Leesa B,0,4,30,30
1650196798660,MATH 109,B02,083216,Anzaldo; Leesa B,0,4,30,30
1650196804687,MATH 142A,A01,083219,Chow; Bennett,0,12,30,30
1650196804687,MATH 142A,A02,083220,Chow; Bennett,0,11,30,30
1650196804687,MATH 142A,B01,083221,Chow; Bennett,0,11,30,30
1650196804687,MATH 142A,B02,083222,Chow; Bennett,0,12,30,30
1650196810716,MATH 193A,A01,083224,Staff,0,4,30,30
1650196810716,MATH 193A,A02,083225,Staff,0,4,30,30
1650196810716,MATH 193A,A03,083781,Staff,0,2,30,30
1650196810716,MATH 193A,A04,083782,Staff,0,1,30,30
1650196816740,MATH 197,001,091859,McAuley; Julian John,9998,0,9999,1
1650196822811,COGS 9,A01,083615,Staff,0,14,60,60
1650196828840,COGS 11,A01,083617,Boyle; Mary E. T.,24,0,40,16
1650196834877,COGS 13,A01,083071,Staff,0,30,40,40
1650196840903,COGS 14A,A01,092681,Staff,0,12,100,100
1650196847016,COGS 14B,A01,083073,Cheng; Tzu-Han,0,7,50,50
1650196853044,COGS 17,A01,092677,Staff,35,0,75,40
1650196859073,COGS 100,A01,083619,Staff,0,20,60,60
1650196865100,COGS 101A,A01,083621,Davis; Joshua Daniel,0,21,60,60
1650196871124,COGS 101B,A01,091572,Staff,6,0,60,54
1650196877151,COGS 101C,A01,083625,Delgado; Tania,20,0,30,10
1650196883178,COGS 107A,A01,083627,Boyle; Mary E. T.,0,7,60,60
1650196889205,COGS 118A,A01,083075,Staff,16,0,60,44
1650196895231,CSE 3,A50,083646,Miranda; Gregory Joseph,22,0,38,16
1650196895231,CSE 3,A51,083647,Miranda; Gregory Joseph,37,0,37,0
1650196901259,CSE 8A,A50,083650,Miranda; Gregory Joseph,0,17,40,40
1650196907288,CSE 11,A01,083080,Cao; Yingjun,0,68,40,40
1650196913315,CSE 12,A01,083652,Staff,0,7,100,100
1650196919345,CSE 15L,A01,083654,Staff,0,0,50,50
1650196919345,CSE 15L,A02,083655,Staff,6,0,50,44
1650196925369,CSE 20,A01,083657,Staff,53,0,80,27
1650196931396,CSE 30,A01,083084,Eldon; John,0,69,40,40
1650196937427,CSE 100,A01,083659,Cao; Yingjun,0,63,50,50
1650196943455,CSE 134B,A01,083661,Powell; Thomas Allan,0,27,65,65
1650196949484,CSE 140,A01,083663,Staff,1,0,75,74
1650196955512,CSE 140L,A01,083088,Eldon; John,0,4,75,75
1650196961541,CSE 175,A01,083665,Kumar; Rakesh,8,0,25,17
1650196967571,CSE 190,A00,092507,Dubnov; Shlomo,14,0,20,6
1650196973597,ECE 45,A01,083139,Staff,0,13,40,40
1650196979622,ECE 65,A50,083695,Staff,0,5,30,30
1650196985648,ECE 109,A01,091882,Touri; Behrouz,47,0,70,23
1650196991674,ECE 180,A00,083140,Abi Samra; Nicholas Camill,24,0,30,6
1650196991674,ECE 180,B00,083141,Abi Samra; Nicholas Camill,8,0,30,22
1650196997704,MATH 10A,A01,083735,Patchell; Gregory David,11,0,30,19
1650196997704,MATH 10A,A02,083736,Patchell; Gregory David,28,0,30,2
1650196997704,MATH 10A,A03,083737,Patchell; Gregory David,26,0,30,4
1650197003731,MATH 10B,A01,083207,Staff,0,5,30,30
1650197003731,MATH 10B,A02,083208,Staff,0,5,30,30
1650197003731,MATH 10B,B01,083739,Staff,17,0,30,13
1650197003731,MATH 10B,B02,083740,Staff,29,0,30,1
1650197009763,MATH 18,A01,083743,Staff,8,0,30,22
1650197009763,MATH 18,A02,083744,Staff,28,0,30,2
1650197009763,MATH 18,A03,083745,Staff,23,0,30,7
1650197009763,MATH 18,A04,083746,Staff,27,0,30,3
1650197009763,MATH 18,B01,083748,Staff,0,10,30,30
1650197009763,MATH 18,B02,083749,Staff,0,7,30,30
1650197009763,MATH 18,B03,083750,Staff,0,7,30,30
1650197009763,MATH 18,B04,083751,Staff,0,8,30,30
1650197015794,MATH 20A,A01,083754,Staff,26,0,40,14
1650197021821,MATH 20B,A01,083756,Staff,0,6,30,30
1650197021821,MATH 20B,A02,083757,Staff,0,6,30,30
1650197027851,MATH 20C,A01,083760,Staff,0,12,30,30
1650197027851,MATH 20C,A02,083761,Staff,0,12,30,30
1650197027851,MATH 20C,B01,083762,Staff,14,0,30,16
1650197027851,MATH 20C,B02,083763,Staff,28,0,30,2
1650197033896,MATH 20D,A01,083765,Staff,1,2,30,29
1650197033896,MATH 20D,A02,083766,Staff,10,0,30,20
1650197033896,MATH 20D,A03,083767,Staff,28,0,30,2
1650197039925,MATH 20E,A01,083771,Staff,8,0,30,22
1650197039925,MATH 20E,A02,083772,Staff,20,0,30,10
1650197039925,MATH 20E,B01,083773,Staff,0,0,30,30
1650197039925,MATH 20E,B02,083774,Staff,12,0,30,18
1650197045954,MATH 103A,A01,083777,Staff,0,9,30,30
1650197045954,MATH 103A,A02,083778,Staff,0,10,30,30
1650197045954,MATH 103A,B01,083779,Staff,0,9,30,30
1650197045954,MATH 103A,B02,083780,Staff,0,9,30,30
1650197051981,MATH 105,A01,085443,Staff,0,17,30,30
1650197058006,MATH 109,A01,083213,Anzaldo; Leesa B,0,3,30,30
1650197058006,MATH 109,A02,083214,Anzaldo; Leesa B,0,6,30,30
1650197058006,MATH 109,B01,083215,Anzaldo; Leesa B,0,4,30,30
1650197058006,MATH 109,B02,083216,Anzaldo; Leesa B,0,4,30,30
1650197064033,MATH 142A,A01,083219,Chow; Bennett,0,12,30,30
1650197064033,MATH 142A,A02,083220,Chow; Bennett,0,11,30,30
1650197064033,MATH 142A,B01,083221,Chow; Bennett,0,11,30,30
1650197064033,MATH 142A,B02,083222,Chow; Bennett,0,12,30,30
1650197070057,MATH 193A,A01,083224,Staff,0,4,30,30
1650197070057,MATH 193A,A02,083225,Staff,0,4,30,30
1650197070057,MATH 193A,A03,083781,Staff,0,2,30,30
1650197070057,MATH 193A,A04,083782,Staff,0,1,30,30
1650197076089,MATH 197,001,091859,McAuley; Julian John,9998,0,9999,1
1650197082159,COGS 9,A01,083615,Staff,0,14,60,60
1650197088189,COGS 11,A01,083617,Boyle; Mary E. T.,24,0,40,16
1650197094217,COGS 13,A01,083071,Staff,0,30,40,40
1650197100249,COGS 14A,A01,092681,Staff,0,12,100,100
1650197106275,COGS 14B,A01,083073,Cheng; Tzu-Han,0,7,50,50
1650197112301,COGS 17,A01,092677,Staff,35,0,75,40
1650197118329,COGS 100,A01,083619,Staff,0,20,60,60
1650197124355,COGS 101A,A01,083621,Davis; Joshua Daniel,0,21,60,60
1650197130379,COGS 101B,A01,091572,Staff,6,0,60,54
1650197136408,COGS 101C,A01,083625,Delgado; Tania,20,0,30,10
1650197142434,COGS 107A,A01,083627,Boyle; Mary E. T.,0,7,60,60
1650197148464,COGS 118A,A01,083075,Staff,16,0,60,44
1650197154492,CSE 3,A50,083646,Miranda; Gregory Joseph,22,0,38,16
1650197154492,CSE 3,A51,083647,Miranda; Gregory Joseph,37,0,37,0
1650197160526,CSE 8A,A50,083650,Miranda; Gregory Joseph,0,17,40,40
1650197166550,CSE 11,A01,083080,Cao; Yingjun,0,68,40,40
1650197172573,CSE 12,A01,083652,Staff,0,7,100,100
1650197178597,CSE 15L,A01,083654,Staff,0,0,50,50
1650197178597,CSE 15L,A02,083655,Staff,6,0,50,44
1650197184622,CSE 20,A01,083657,Staff,53,0,80,27
1650197190649,CSE 30,A01,083084,Eldon; John,0,69,40,40
1650197196673,CSE 100,A01,083659,Cao; Yingjun,0,63,50,50
1650197202697,CSE 134B,A01,083661,Powell; Thomas Allan,0,27,65,65
1650197208725,CSE 140,A01,083663,Staff,1,0,75,74
1650197214761,CSE 140L,A01,083088,Eldon; John,0,4,75,75
1650197220792,CSE 175,A01,083665,Kumar; Rakesh,8,0,25,17
1650197226817,CSE 190,A00,092507,Dubnov; Shlomo,14,0,20,6
1650197232844,ECE 45,A01,083139,Staff,0,13,40,40
1650197238873,ECE 65,A50,083695,Staff,0,5,30,30
1650197244899,ECE 109,A01,091882,Touri; Behrouz,47,0,70,23
1650197250927,ECE 180,A00,083140,Abi Samra; Nicholas Camill,24,0,30,6
1650197250927,ECE 180,B00,083141,Abi Samra; Nicholas Camill,8,0,30,22
1650197256966,MATH 10A,A01,083735,Patchell; Gregory David,11,0,30,19
1650197256966,MATH 10A,A02,083736,Patchell; Gregory David,28,0,30,2
1650197256966,MATH 10A,A03,083737,Patchell; Gregory David,26,0,30,4
1650197262993,MATH 10B,A01,083207,Staff,0,5,30,30
1650197262993,MATH 10B,A02,083208,Staff,0,5,30,30
1650197262993,MATH 10B,B01,083739,Staff,17,0,30,13
1650197262993,MATH 10B,B02,083740,Staff,29,0,30,1
1650197269026,MATH 18,A01,083743,Staff,8,0,30,22
1650197269026,MATH 18,A02,083744,Staff,28,0,30,2
1650197269026,MATH 18,A03,083745,Staff,23,0,30,7
1650197269026,MATH 18,A04,083746,Staff,27,0,30,3
1650197269026,MATH 18,B01,083748,Staff,0,10,30,30
1650197269026,MATH 18,B02,083749,Staff,0,7,30,30
1650197269026,MATH 18,B03,083750,Staff,0,7,30,30
1650197269026,MATH 18,B04,083751,Staff,0,8,30,30
1650197275053,MATH 20A,A01,083754,Staff,26,0,40,14
1650197281080,MATH 20B,A01,083756,Staff,0,6,30,30
1650197281080,MATH 20B,A02,083757,Staff,0,6,30,30
1650197287108,MATH 20C,A01,083760,Staff,0,12,30,30
1650197287108,MATH 20C,A02,083761,Staff,0,12,30,30
1650197287108,MATH 20C,B01,083762,Staff,14,0,30,16
1650197287108,MATH 20C,B02,083763,Staff,28,0,30,2
1650197293133,MATH 20D,A01,083765,Staff,1,2,30,29
1650197293133,MATH 20D,A02,083766,Staff,10,0,30,20
1650197293133,MATH 20D,A03,083767,Staff,28,0,30,2
1650197299168,MATH 20E,A01,083771,Staff,8,0,30,22
1650197299168,MATH 20E,A02,083772,Staff,20,0,30,10
1650197299168,MATH 20E,B01,083773,Staff,0,0,30,30
1650197299168,MATH 20E,B02,083774,Staff,12,0,30,18
1650197305197,MATH 103A,A01,083777,Staff,0,9,30,30
1650197305197,MATH 103A,A02,083778,Staff,0,10,30,30
1650197305197,MATH 103A,B01,083779,Staff,0,9,30,30
1650197305197,MATH 103A,B02,083780,Staff,0,9,30,30
1650197311224,MATH 105,A01,085443,Staff,0,17,30,30
1650197317248,MATH 109,A01,083213,Anzaldo; Leesa B,0,3,30,30
1650197317248,MATH 109,A02,083214,Anzaldo; Leesa B,0,6,30,30
1650197317248,MATH 109,B01,083215,Anzaldo; Leesa B,0,4,30,30
1650197317248,MATH 109,B02,083216,Anzaldo; Leesa B,0,4,30,30
1650197323272,MATH 142A,A01,083219,Chow; Bennett,0,12,30,30
1650197323272,MATH 142A,A02,083220,Chow; Bennett,0,11,30,30
1650197323272,MATH 142A,B01,083221,Chow; Bennett,0,11,30,30
1650197323272,MATH 142A,B02,083222,Chow; Bennett,0,12,30,30
1650197329298,MATH 193A,A01,083224,Staff,0,4,30,30
1650197329298,MATH 193A,A02,083225,Staff,0,4,30,30
1650197329298,MATH 193A,A03,083781,Staff,0,2,30,30
1650197329298,MATH 193A,A04,083782,Staff,0,1,30,30
1650197335323,MATH 197,001,091859,McAuley; Julian John,9998,0,9999,1
1650197341386,COGS 9,A01,083615,Staff,0,14,60,60
1650197347411,COGS 11,A01,083617,Boyle; Mary E. T.,24,0,40,16
1650197353446,COGS 13,A01,083071,Staff,0,30,40,40
1650197359474,COGS 14A,A01,092681,Staff,0,12,100,100
1650197365504,COGS 14B,A01,083073,Cheng; Tzu-Han,0,7,50,50
1650197371530,COGS 17,A01,092677,Staff,35,0,75,40
1650197377559,COGS 100,A01,083619,Staff,0,20,60,60
1650197383588,COGS 101A,A01,083621,Davis; Joshua Daniel,0,21,60,60
1650197389614,COGS 101B,A01,091572,Staff,6,0,60,54
1650197395642,COGS 101C,A01,083625,Delgado; Tania,20,0,30,10
1650197401673,COGS 107A,A01,083627,Boyle; Mary E. T.,0,7,60,60
1650197407697,COGS 118A,A01,083075,Staff,16,0,60,44
1650197413727,CSE 3,A50,083646,Miranda; Gregory Joseph,22,0,38,16
1650197413727,CSE 3,A51,083647,Miranda; Gregory Joseph,37,0,37,0
1650197419753,CSE 8A,A50,083650,Miranda; Gregory Joseph,0,17,40,40
1650197425781,CSE 11,A01,083080,Cao; Yingjun,0,68,40,40
1650197431811,CSE 12,A01,083652,Staff,0,7,100,100
1650197437837,CSE 15L,A01,083654,Staff,0,0,50,50
1650197437837,CSE 15L,A02,083655,Staff,6,0,50,44
1650197443951,CSE 20,A01,083657,Staff,53,0,80,27
1650197449983,CSE 30,A01,083084,Eldon; John,0,69,40,40
1650197456009,CSE 100,A01,083659,Cao; Yingjun,0,63,50,50
1650197462034,CSE 134B,A01,083661,Powell; Thomas Allan,0,27,65,65
1650197468059,CSE 140,A01,083663,Staff,1,0,75,74
1650197474088,CSE 140L,A01,083088,Eldon; John,0,4,75,75
1650197480114,CSE 175,A01,083665,Kumar; Rakesh,8,0,25,17
1650197486143,CSE 190,A00,092507,Dubnov; Shlomo,14,0,20,6
1650197492168,ECE 45,A01,083139,Staff,0,13,40,40
1650197498191,ECE 65,A50,083695,Staff,0,5,30,30
1650197504216,ECE 109,A01,091882,Touri; Behrouz,47,0,70,23
1650197510241,ECE 180,A00,083140,Abi Samra; Nicholas Camill,24,0,30,6
1650197510241,ECE 180,B00,083141,Abi Samra; Nicholas Camill,8,0,30,22
1650197516270,MATH 10A,A01,083735,Patchell; Gregory David,11,0,30,19
1650197516270,MATH 10A,A02,083736,Patchell; Gregory David,28,0,30,2
1650197516270,MATH 10A,A03,083737,Patchell; Gregory David,26,0,30,4
1650197522298,MATH 10B,A01,083207,Staff,0,5,30,30
1650197522298,MATH 10B,A02,083208,Staff,0,5,30,30
1650197522298,MATH 10B,B01,083739,Staff,17,0,30,13
1650197522298,MATH 10B,B02,083740,Staff,29,0,30,1
1650197528330,MATH 18,A01,083743,Staff,8,0,30,22
1650197528330,MATH 18,A02,083744,Staff,28,0,30,2
1650197528330,MATH 18,A03,083745,Staff,23,0,30,7
1650197528330,MATH 18,A04,083746,Staff,27,0,30,3
1650197528330,MATH 18,B01,083748,Staff,0,10,30,30
1650197528330,MATH 18,B02,083749,Staff,0,7,30,30
1650197528330,MATH 18,B03,083750,Staff,0,7,30,30
1650197528330,MATH 18,B04,083751,Staff,0,8,30,30
1650197534354,MATH 20A,A01,083754,Staff,26,0,40,14
1650197540379,MATH 20B,A01,083756,Staff,0,6,30,30
1650197540379,MATH 20B,A02,083757,Staff,0,6,30,30
1650197546404,MATH 20C,A01,083760,Staff,0,12,30,30
1650197546404,MATH 20C,A02,083761,Staff,0,12,30,30
1650197546404,MATH 20C,B01,083762,Staff,14,0,30,16
1650197546404,MATH 20C,B02,083763,Staff,28,0,30,2
1650197552429,MATH 20D,A01,083765,Staff,1,2,30,29
1650197552429,MATH 20D,A02,083766,Staff,10,0,30,20
1650197552429,MATH 20D,A03,083767,Staff,28,0,30,2
1650197558455,MATH 20E,A01,083771,Staff,8,0,30,22
1650197558455,MATH 20E,A02,083772,Staff,20,0,30,10
1650197558455,MATH 20E,B01,083773,Staff,0,0,30,30
1650197558455,MATH 20E,B02,083774,Staff,12,0,30,18
1650197564483,MATH 103A,A01,083777,Staff,0,9,30,30
1650197564483,MATH 103A,A02,083778,Staff,0,10,30,30
1650197564483,MATH 103A,B01,083779,Staff,0,9,30,30
1650197564483,MATH 103A,B02,083780,Staff,0,9,30,30
1650197570516,MATH 105,A01,085443,Staff,0,17,30,30
1650197576546,MATH 109,A01,083213,Anzaldo; Leesa B,0,3,30,30
1650197576546,MATH 109,A02,083214,Anzaldo; Leesa B,0,6,30,30
1650197576546,MATH 109,B01,083215,Anzaldo; Leesa B,0,4,30,30
1650197576546,MATH 109,B02,083216,Anzaldo; Leesa B,0,4,30,30
1650197582573,MATH 142A,A01,083219,Chow; Bennett,0,12,30,30
1650197582573,MATH 142A,A02,083220,Chow; Bennett,0,11,30,30
1650197582573,MATH 142A,B01,083221,Chow; Bennett,0,11,30,30
1650197582573,MATH 142A,B02,083222,Chow; Bennett,0,12,30,30
1650197588620,MATH 193A,A01,083224,Staff,0,4,30,30
1650197588620,MATH 193A,A02,083225,Staff,0,4,30,30
1650197588620,MATH 193A,A03,083781,Staff,0,2,30,30
1650197588620,MATH 193A,A04,083782,Staff,0,1,30,30
1650197594644,MATH 197,001,091859,McAuley; Julian John,9998,0,9999,1
1650197600703,COGS 9,A01,083615,Staff,0,14,60,60
1650197606729,COGS 11,A01,083617,Boyle; Mary E. T.,24,0,40,16
1650197612753,COGS 13,A01,083071,Staff,0,30,40,40
1650197618790,COGS 14A,A01,092681,Staff,0,12,100,100
1650197624814,COGS 14B,A01,083073,Cheng; Tzu-Han,0,7,50,50
1650197630840,COGS 17,A01,092677,Staff,35,0,75,40
1650197636872,COGS 100,A01,083619,Staff,0,20,60,60
1650197642896,COGS 101A,A01,083621,Davis; Joshua Daniel,0,21,60,60
1650197648922,COGS 101B,A01,091572,Staff,6,0,60,54
1650197654951,COGS 101C,A01,083625,Delgado; Tania,20,0,30,10
1650197660979,COGS 107A,A01,083627,Boyle; Mary E. T.,0,7,60,60
1650197667002,COGS 118A,A01,083075,Staff,16,0,60,44
1650197673030,CSE 3,A50,083646,Miranda; Gregory Joseph,22,0,38,16
1650197673030,CSE 3,A51,083647,Miranda; Gregory Joseph,37,0,37,0
1650197679058,CSE 8A,A50,083650,Miranda; Gregory Joseph,0,17,40,40
1650197685086,CSE 11,A01,083080,Cao; Yingjun,0,68,40,40
1650197691114,CSE 12,A01,083652,Staff,0,7,100,100
1650197697144,CSE 15L,A01,083654,Staff,0,0,50,50
1650197697144,CSE 15L,A02,083655,Staff,6,0,50,44
1650197703167,CSE 20,A01,083657,Staff,53,0,80,27
1650197709200,CSE 30,A01,083084,Eldon; John,0,69,40,40
1650197715226,CSE 100,A01,083659,Cao; Yingjun,0,63,50,50
1650197721253,CSE 134B,A01,083661,Powell; Thomas Allan,0,27,65,65
1650197727281,CSE 140,A01,083663,Staff,1,0,75,74
1650197733309,CSE 140L,A01,083088,Eldon; John,0,4,75,75
1650197739333,CSE 175,A01,083665,Kumar; Rakesh,8,0,25,17
1650197745360,CSE 190,A00,092507,Dubnov; Shlomo,14,0,20,6
1650197751397,ECE 45,A01,083139,Staff,0,13,40,40
1650197757425,ECE 65,A50,083695,Staff,0,5,30,30
1650197763450,ECE 109,A01,091882,Touri; Behrouz,47,0,70,23
1650197769473,ECE 180,A00,083140,Abi Samra; Nicholas Camill,24,0,30,6
1650197769473,ECE 180,B00,083141,Abi Samra; Nicholas Camill,8,0,30,22
1650197775502,MATH 10A,A01,083735,Patchell; Gregory David,11,0,30,19
1650197775502,MATH 10A,A02,083736,Patchell; Gregory David,28,0,30,2
1650197775502,MATH 10A,A03,083737,Patchell; Gregory David,26,0,30,4
1650197781529,MATH 10B,A01,083207,Staff,0,5,30,30
1650197781529,MATH 10B,A02,083208,Staff,0,5,30,30
1650197781529,MATH 10B,B01,083739,Staff,17,0,30,13
1650197781529,MATH 10B,B02,083740,Staff,29,0,30,1
1650197787560,MATH 18,A01,083743,Staff,8,0,30,22
1650197787560,MATH 18,A02,083744,Staff,28,0,30,2
1650197787560,MATH 18,A03,083745,Staff,23,0,30,7
1650197787560,MATH 18,A04,083746,Staff,27,0,30,3
1650197787560,MATH 18,B01,083748,Staff,0,10,30,30
1650197787560,MATH 18,B02,083749,Staff,0,7,30,30
1650197787560,MATH 18,B03,083750,Staff,0,7,30,30
1650197787560,MATH 18,B04,083751,Staff,0,8,30,30
1650197793583,MATH 20A,A01,083754,Staff,26,0,40,14
1650197799609,MATH 20B,A01,083756,Staff,0,6,30,30
1650197799609,MATH 20B,A02,083757,Staff,0,6,30,30
1650197805641,MATH 20C,A01,083760,Staff,0,12,30,30
1650197805641,MATH 20C,A02,083761,Staff,0,12,30,30
1650197805641,MATH 20C,B01,083762,Staff,14,0,30,16
1650197805641,MATH 20C,B02,083763,Staff,28,0,30,2
1650197811670,MATH 20D,A01,083765,Staff,1,2,30,29
1650197811670,MATH 20D,A02,083766,Staff,10,0,30,20
1650197811670,MATH 20D,A03,083767,Staff,28,0,30,2
1650197817696,MATH 20E,A01,083771,Staff,8,0,30,22
1650197817696,MATH 20E,A02,083772,Staff,20,0,30,10
1650197817696,MATH 20E,B01,083773,Staff,0,0,30,30
1650197817696,MATH 20E,B02,083774,Staff,12,0,30,18
1650197823723,MATH 103A,A01,083777,Staff,0,9,30,30
1650197823723,MATH 103A,A02,083778,Staff,0,10,30,30
1650197823723,MATH 103A,B01,083779,Staff,0,9,30,30
1650197823723,MATH 103A,B02,083780,Staff,0,9,30,30
1650197829751,MATH 105,A01,085443,Staff,0,17,30,30
1650197835778,MATH 109,A01,083213,Anzaldo; Leesa B,0,3,30,30
1650197835778,MATH 109,A02,083214,Anzaldo; Leesa B,0,6,30,30
1650197835778,MATH 109,B01,083215,Anzaldo; Leesa B,0,4,30,30
1650197835778,MATH 109,B02,083216,Anzaldo; Leesa B,0,4,30,30
1650197841803,MATH 142A,A01,083219,Chow; Bennett,0,12,30,30
1650197841803,MATH 142A,A02,083220,Chow; Bennett,0,11,30,30
1650197841803,MATH 142A,B01,083221,Chow; Bennett,0,11,30,30
1650197841803,MATH 142A,B02,083222,Chow; Bennett,0,12,30,30
1650197847835,MATH 193A,A01,083224,Staff,0,4,30,30
1650197847835,MATH 193A,A02,083225,Staff,0,4,30,30
1650197847835,MATH 193A,A03,083781,Staff,0,2,30,30
1650197847835,MATH 193A,A04,083782,Staff,0,1,30,30
1650197853862,MATH 197,001,091859,McAuley; Julian John,9998,0,9999,1
1650197859925,COGS 9,A01,083615,Staff,0,14,60,60
1650197865949,COGS 11,A01,083617,Boyle; Mary E. T.,24,0,40,16
1650197871976,COGS 13,A01,083071,Staff,0,30,40,40
1650197878005,COGS 14A,A01,092681,Staff,0,12,100,100
1650197884034,COGS 14B,A01,083073,Cheng; Tzu-Han,0,7,50,50
1650197890060,COGS 17,A01,092677,Staff,35,0,75,40
1650197896084,COGS 100,A01,083619,Staff,0,20,60,60
1650197902109,COGS 101A,A01,083621,Davis; Joshua Daniel,0,21,60,60
1650197908137,COGS 101B,A01,091572,Staff,6,0,60,54
1650197914162,COGS 101C,A01,083625,Delgado; Tania,20,0,30,10
1650197920186,COGS 107A,A01,083627,Boyle; Mary E. T.,0,7,60,60
1650197926210,COGS 118A,A01,083075,Staff,16,0,60,44
1650197932235,CSE 3,A50,083646,Miranda; Gregory Joseph,22,0,38,16
1650197932235,CSE 3,A51,083647,Miranda; Gregory Joseph,37,0,37,0
1650197938261,CSE 8A,A50,083650,Miranda; Gregory Joseph,0,17,40,40
1650197944286,CSE 11,A01,083080,Cao; Yingjun,0,68,40,40
1650197950310,CSE 12,A01,083652,Staff,0,7,100,100
1650197956337,CSE 15L,A01,083654,Staff,0,0,50,50
1650197956337,CSE 15L,A02,083655,Staff,6,0,50,44
1650197962365,CSE 20,A01,083657,Staff,53,0,80,27
1650197968396,CSE 30,A01,083084,Eldon; John,0,69,40,40
1650197974427,CSE 100,A01,083659,Cao; Yingjun,0,63,50,50
1650197980454,CSE 134B,A01,083661,Powell; Thomas Allan,0,27,65,65
1650197986480,CSE 140,A01,083663,Staff,1,0,75,74
1650197992509,CSE 140L,A01,083088,Eldon; John,0,4,75,75
1650197998532,CSE 175,A01,083665,Kumar; Rakesh,8,0,25,17
1650198004560,CSE 190,A00,092507,Dubnov; Shlomo,14,0,20,6
1650198010586,ECE 45,A01,083139,Staff,0,13,40,40
1650198016611,ECE 65,A50,083695,Staff,0,5,30,30
1650198022648,ECE 109,A01,091882,Touri; Behrouz,47,0,70,23
1650198028672,ECE 180,A00,083140,Abi Samra; Nicholas Camill,24,0,30,6
1650198028672,ECE 180,B00,083141,Abi Samra; Nicholas Camill,8,0,30,22
1650198034698,MATH 10A,A01,083735,Patchell; Gregory David,11,0,30,19
1650198034698,MATH 10A,A02,083736,Patchell; Gregory David,28,0,30,2
1650198034698,MATH 10A,A03,083737,Patchell; Gregory David,26,0,30,4
1650198040798,MATH 10B,A01,083207,Staff,0,5,30,30
1650198040798,MATH 10B,A02,083208,Staff,0,5,30,30
1650198040798,MATH 10B,B01,083739,Staff,17,0,30,13
1650198040798,MATH 10B,B02,083740,Staff,29,0,30,1
1650198046830,MATH 18,A01,083743,Staff,8,0,30,22
1650198046830,MATH 18,A02,083744,Staff,28,0,30,2
1650198046830,MATH 18,A03,083745,Staff,23,0,30,7
1650198046830,MATH 18,A04,083746,Staff,27,0,30,3
1650198046830,MATH 18,B01,083748,Staff,0,10,30,30
1650198046830,MATH 18,B02,083749,Staff,0,7,30,30
1650198046830,MATH 18,B03,083750,Staff,0,7,30,30
1650198046830,MATH 18,B04,083751,Staff,0,8,30,30
1650198052856,MATH 20A,A01,083754,Staff,26,0,40,14
1650198058879,MATH 20B,A01,083756,Staff,0,6,30,30
1650198058879,MATH 20B,A02,083757,Staff,0,6,30,30
1650198064909,MATH 20C,A01,083760,Staff,0,12,30,30
1650198064909,MATH 20C,A02,083761,Staff,0,12,30,30
1650198064909,MATH 20C,B01,083762,Staff,14,0,30,16
1650198064909,MATH 20C,B02,083763,Staff,28,0,30,2
1650198070933,MATH 20D,A01,083765,Staff,1,2,30,29
1650198070933,MATH 20D,A02,083766,Staff,10,0,30,20
1650198070933,MATH 20D,A03,083767,Staff,28,0,30,2
1650198076958,MATH 20E,A01,083771,Staff,8,0,30,22
1650198076958,MATH 20E,A02,083772,Staff,20,0,30,10
1650198076958,MATH 20E,B01,083773,Staff,0,0,30,30
1650198076958,MATH 20E,B02,083774,Staff,12,0,30,18
1650198082988,MATH 103A,A01,083777,Staff,0,9,30,30
1650198082988,MATH 103A,A02,083778,Staff,0,10,30,30
1650198082988,MATH 103A,B01,083779,Staff,0,9,30,30
1650198082988,MATH 103A,B02,083780,Staff,0,9,30,30
1650198089022,MATH 105,A01,085443,Staff,0,17,30,30
1650198095052,MATH 109,A01,083213,Anzaldo; Leesa B,0,3,30,30
1650198095052,MATH 109,A02,083214,Anzaldo; Leesa B,0,6,30,30
1650198095052,MATH 109,B01,083215,Anzaldo; Leesa B,0,4,30,30
1650198095052,MATH 109,B02,083216,Anzaldo; Leesa B,0,4,30,30
1650198101079,MATH 142A,A01,083219,Chow; Bennett,0,12,30,30
1650198101079,MATH 142A,A02,083220,Chow; Bennett,0,11,30,30
1650198101079,MATH 142A,B01,083221,Chow; Bennett,0,11,30,30
1650198101079,MATH 142A,B02,083222,Chow; Bennett,0,12,30,30
1650198107105,MATH 193A,A01,083224,Staff,0,4,30,30
1650198107105,MATH 193A,A02,083225,Staff,0,4,30,30
1650198107105,MATH 193A,A03,083781,Staff,0,2,30,30
1650198107105,MATH 193A,A04,083782,Staff,0,1,30,30
1650198113133,MATH 197,001,091859,McAuley; Julian John,9998,0,9999,1
1650198119190,COGS 9,A01,083615,Staff,0,14,60,60
1650198125214,COGS 11,A01,083617,Boyle; Mary E. T.,24,0,40,16
1650198131245,COGS 13,A01,083071,Staff,0,30,40,40
1650198137273,COGS 14A,A01,092681,Staff,0,12,100,100
1650198143306,COGS 14B,A01,083073,Cheng; Tzu-Han,0,7,50,50
1650198149338,COGS 17,A01,092677,Staff,35,0,75,40
1650198155362,COGS 100,A01,083619,Staff,0,20,60,60
1650198161390,COGS 101A,A01,083621,Davis; Joshua Daniel,0,21,60,60
1650198167417,COGS 101B,A01,091572,Staff,6,0,60,54
1650198173442,COGS 101C,A01,083625,Delgado; Tania,20,0,30,10
1650198179467,COGS 107A,A01,083627,Boyle; Mary E. T.,0,7,60,60
1650198185493,COGS 118A,A01,083075,Staff,16,0,60,44
1650198191516,CSE 3,A50,083646,Miranda; Gregory Joseph,22,0,38,16
1650198191516,CSE 3,A51,083647,Miranda; Gregory Joseph,37,0,37,0
1650198197541,CSE 8A,A50,083650,Miranda; Gregory Joseph,0,17,40,40
1650198203567,CSE 11,A01,083080,Cao; Yingjun,0,68,40,40
1650198209597,CSE 12,A01,083652,Staff,0,7,100,100
1650198215621,CSE 15L,A01,083654,Staff,0,0,50,50
1650198215621,CSE 15L,A02,083655,Staff,6,0,50,44
1650198221650,CSE 20,A01,083657,Staff,53,0,80,27
1650198227678,CSE 30,A01,083084,Eldon; John,0,69,40,40
1650198233705,CSE 100,A01,083659,Cao; Yingjun,0,63,50,50
1650198239731,CSE 134B,A01,083661,Powell; Thomas Allan,0,27,65,65
1650198245756,CSE 140,A01,083663,Staff,1,0,75,74
1650198251789,CSE 140L,A01,083088,Eldon; John,0,4,75,75
1650198257822,CSE 175,A01,083665,Kumar; Rakesh,8,0,25,17
1650198263849,CSE 190,A00,092507,Dubnov; Shlomo,14,0,20,6
1650198269876,ECE 45,A01,083139,Staff,0,13,40,40
1650198275904,ECE 65,A50,083695,Staff,0,5,30,30
1650198281929,ECE 109,A01,091882,Touri; Behrouz,47,0,70,23
1650198287955,ECE 180,A00,083140,Abi Samra; Nicholas Camill,24,0,30,6
1650198287955,ECE 180,B00,083141,Abi Samra; Nicholas Camill,8,0,30,22
1650198293978,MATH 10A,A01,083735,Patchell; Gregory David,11,0,30,19
1650198293978,MATH 10A,A02,083736,Patchell; Gregory David,28,0,30,2
1650198293978,MATH 10A,A03,083737,Patchell; Gregory David,26,0,30,4
1650198300004,MATH 10B,A01,083207,Staff,0,5,30,30
1650198300004,MATH 10B,A02,083208,Staff,0,5,30,30
1650198300004,MATH 10B,B01,083739,Staff,17,0,30,13
1650198300004,MATH 10B,B02,083740,Staff,29,0,30,1
1650198306029,MATH 18,A01,083743,Staff,8,0,30,22
1650198306029,MATH 18,A02,083744,Staff,28,0,30,2
1650198306029,MATH 18,A03,083745,Staff,23,0,30,7
1650198306029,MATH 18,A04,083746,Staff,27,0,30,3
1650198306029,MATH 18,B01,083748,Staff,0,10,30,30
1650198306029,MATH 18,B02,083749,Staff,0,7,30,30
1650198306029,MATH 18,B03,083750,Staff,0,7,30,30
1650198306029,MATH 18,B04,083751,Staff,0,8,30,30
1650198312058,MATH 20A,A01,083754,Staff,26,0,40,14
1650198318084,MATH 20B,A01,083756,Staff,0,6,30,30
1650198318084,MATH 20B,A02,083757,Staff,0,6,30,30
1650198324108,MATH 20C,A01,083760,Staff,0,12,30,30
1650198324108,MATH 20C,A02,083761,Staff,0,12,30,30
1650198324108,MATH 20C,B01,083762,Staff,14,0,30,16
1650198324108,MATH 20C,B02,083763,Staff,28,0,30,2
1650198330134,MATH 20D,A01,083765,Staff,1,2,30,29
1650198330134,MATH 20D,A02,083766,Staff,10,0,30,20
1650198330134,MATH 20D,A03,083767,Staff,28,0,30,2
1650198336169,MATH 20E,A01,083771,Staff,8,0,30,22
1650198336169,MATH 20E,A02,083772,Staff,20,0,30,10
1650198336169,MATH 20E,B01,083773,Staff,0,0,30,30
1650198336169,MATH 20E,B02,083774,Staff,12,0,30,18
1650198342199,MATH 103A,A01,083777,Staff,0,9,30,30
1650198342199,MATH 103A,A02,083778,Staff,0,10,30,30
1650198342199,MATH 103A,B01,083779,Staff,0,9,30,30
1650198342199,MATH 103A,B02,083780,Staff,0,9,30,30
1650198348225,MATH 105,A01,085443,Staff,0,17,30,30
1650198354250,MATH 109,A01,083213,Anzaldo; Leesa B,0,3,30,30
1650198354250,MATH 109,A02,083214,Anzaldo; Leesa B,0,6,30,30
1650198354250,MATH 109,B01,083215,Anzaldo; Leesa B,0,4,30,30
1650198354250,MATH 109,B02,083216,Anzaldo; Leesa B,0,4,30,30
1650198360274,MATH 142A,A01,083219,Chow; Bennett,0,12,30,30
1650198360274,MATH 142A,A02,083220,Chow; Bennett,0,11,30,30
1650198360274,MATH 142A,B01,083221,Chow; Bennett,0,11,30,30
1650198360274,MATH 142A,B02,083222,Chow; Bennett,0,12,30,30
1650198366302,MATH 193A,A01,083224,Staff,0,4,30,30
1650198366302,MATH 193A,A02,083225,Staff,0,4,30,30
1650198366302,MATH 193A,A03,083781,Staff,0,2,30,30
1650198366302,MATH 193A,A04,083782,Staff,0,1,30,30
1650198372329,MATH 197,001,091859,McAuley; Julian John,9998,0,9999,1
1650198378378,COGS 9,A01,083615,Staff,0,14,60,60
1650198384405,COGS 11,A01,083617,Boyle; Mary E. T.,24,0,40,16
1650198390430,COGS 13,A01,083071,Staff,0,30,40,40
1650198396458,COGS 14A,A01,092681,Staff,0,12,100,100
1650198402480,COGS 14B,A01,083073,Cheng; Tzu-Han,0,7,50,50
1650198408508,COGS 17,A01,092677,Staff,35,0,75,40
1650198414534,COGS 100,A01,083619,Staff,0,20,60,60
1650198420574,COGS 101A,A01,083621,Davis; Joshua Daniel,0,21,60,60
1650198426597,COGS 101B,A01,091572,Staff,6,0,60,54
1650198432624,COGS 101C,A01,083625,Delgado; Tania,20,0,30,10
1650198438650,COGS 107A,A01,083627,Boyle; Mary E. T.,0,7,60,60
1650198444676,COGS 118A,A01,083075,Staff,16,0,60,44
1650198450704,CSE 3,A50,083646,Miranda; Gregory Joseph,22,0,38,16
1650198450704,CSE 3,A51,083647,Miranda; Gregory Joseph,37,0,37,0
1650198456729,CSE 8A,A50,083650,Miranda; Gregory Joseph,0,17,40,40
1650198462754,CSE 11,A01,083080,Cao; Yingjun,0,68,40,40
1650198468782,CSE 12,A01,083652,Staff,0,7,100,100
1650198474813,CSE 15L,A01,083654,Staff,0,0,50,50
1650198474813,CSE 15L,A02,083655,Staff,6,0,50,44
1650198480841,CSE 20,A01,083657,Staff,53,0,80,27
1650198486867,CSE 30,A01,083084,Eldon; John,0,69,40,40
1650198492893,CSE 100,A01,083659,Cao; Yingjun,0,63,50,50
1650198498916,CSE 134B,A01,083661,Powell; Thomas Allan,0,27,65,65
1650198504942,CSE 140,A01,083663,Staff,1,0,75,74
1650198510976,CSE 140L,A01,083088,Eldon; John,0,4,75,75
1650198517013,CSE 175,A01,083665,Kumar; Rakesh,8,0,25,17
1650198523040,CSE 190,A00,092507,Dubnov; Shlomo,14,0,20,6
1650198529063,ECE 45,A01,083139,Staff,0,13,40,40
1650198535092,ECE 65,A50,083695,Staff,0,5,30,30
1650198541117,ECE 109,A01,091882,Touri; Behrouz,47,0,70,23
1650198547145,ECE 180,A00,083140,Abi Samra; Nicholas Camill,24,0,30,6
1650198547145,ECE 180,B00,083141,Abi Samra; Nicholas Camill,8,0,30,22
1650198553174,MATH 10A,A01,083735,Patchell; Gregory David,11,0,30,19
1650198553174,MATH 10A,A02,083736,Patchell; Gregory David,28,0,30,2
1650198553174,MATH 10A,A03,083737,Patchell; Gregory David,26,0,30,4
1650198559202,MATH 10B,A01,083207,Staff,0,5,30,30
1650198559202,MATH 10B,A02,083208,Staff,0,5,30,30
1650198559202,MATH 10B,B01,083739,Staff,17,0,30,13
1650198559202,MATH 10B,B02,083740,Staff,29,0,30,1
1650198565227,MATH 18,A01,083743,Staff,8,0,30,22
1650198565227,MATH 18,A02,083744,Staff,28,0,30,2
1650198565227,MATH 18,A03,083745,Staff,23,0,30,7
1650198565227,MATH 18,A04,083746,Staff,27,0,30,3
1650198565227,MATH 18,B01,083748,Staff,0,10,30,30
1650198565227,MATH 18,B02,083749,Staff,0,7,30,30
1650198565227,MATH 18,B03,083750,Staff,0,7,30,30
1650198565227,MATH 18,B04,083751,Staff,0,8,30,30
1650198571257,MATH 20A,A01,083754,Staff,26,0,40,14
1650198577282,MATH 20B,A01,083756,Staff,0,6,30,30
1650198577282,MATH 20B,A02,083757,Staff,0,6,30,30
1650198583304,MATH 20C,A01,083760,Staff,0,12,30,30
1650198583304,MATH 20C,A02,083761,Staff,0,12,30,30
1650198583304,MATH 20C,B01,083762,Staff,14,0,30,16
1650198583304,MATH 20C,B02,083763,Staff,28,0,30,2
1650198589331,MATH 20D,A01,083765,Staff,1,2,30,29
1650198589331,MATH 20D,A02,083766,Staff,10,0,30,20
1650198589331,MATH 20D,A03,083767,Staff,28,0,30,2
1650198595359,MATH 20E,A01,083771,Staff,8,0,30,22
1650198595359,MATH 20E,A02,083772,Staff,20,0,30,10
1650198595359,MATH 20E,B01,083773,Staff,0,0,30,30
1650198595359,MATH 20E,B02,083774,Staff,12,0,30,18
1650198601391,MATH 103A,A01,083777,Staff,0,9,30,30
1650198601391,MATH 103A,A02,083778,Staff,0,10,30,30
1650198601391,MATH 103A,B01,083779,Staff,0,9,30,30
1650198601391,MATH 103A,B02,083780,Staff,0,9,30,30
1650198607417,MATH 105,A01,085443,Staff,0,17,30,30
1650198613440,MATH 109,A01,083213,Anzaldo; Leesa B,0,3,30,30
1650198613440,MATH 109,A02,083214,Anzaldo; Leesa B,0,6,30,30
1650198613440,MATH 109,B01,083215,Anzaldo; Leesa B,0,4,30,30
1650198613440,MATH 109,B02,083216,Anzaldo; Leesa B,0,4,30,30
1650198619470,MATH 142A,A01,083219,Chow; Bennett,0,12,30,30
1650198619470,MATH 142A,A02,083220,Chow; Bennett,0,11,30,30
1650198619470,MATH 142A,B01,083221,Chow; Bennett,0,11,30,30
1650198619470,MATH 142A,B02,083222,Chow; Bennett,0,12,30,30
1650198625495,MATH 193A,A01,083224,Staff,0,4,30,30
1650198625495,MATH 193A,A02,083225,Staff,0,4,30,30
1650198625495,MATH 193A,A03,083781,Staff,0,2,30,30
1650198625495,MATH 193A,A04,083782,Staff,0,1,30,30
1650198631527,MATH 197,001,091859,McAuley; Julian John,9998,0,9999,1
1650198637664,COGS 9,A01,083615,Staff,0,14,60,60
1650198643688,COGS 11,A01,083617,Boyle; Mary E. T.,24,0,40,16
1650198649720,COGS 13,A01,083071,Staff,0,30,40,40
1650198655745,COGS 14A,A01,092681,Staff,0,12,100,100
1650198661775,COGS 14B,A01,083073,Cheng; Tzu-Han,0,7,50,50
1650198667800,COGS 17,A01,092677,Staff,35,0,75,40
1650198673825,COGS 100,A01,083619,Staff,0,20,60,60
1650198679853,COGS 101A,A01,083621,Davis; Joshua Daniel,0,21,60,60
1650198685875,COGS 101B,A01,091572,Staff,6,0,60,54
1650198691901,COGS 101C,A01,083625,Delgado; Tania,20,0,30,10
1650198697930,COGS 107A,A01,083627,Boyle; Mary E. T.,0,7,60,60
1650198703966,COGS 118A,A01,083075,Staff,16,0,60,44
1650198709991,CSE 3,A50,083646,Miranda; Gregory Joseph,22,0,38,16
1650198709991,CSE 3,A51,083647,Miranda; Gregory Joseph,37,0,37,0
1650198716018,CSE 8A,A50,083650,Miranda; Gregory Joseph,0,17,40,40
1650198722044,CSE 11,A01,083080,Cao; Yingjun,0,68,40,40
1650198728070,CSE 12,A01,083652,Staff,0,7,100,100
1650198734106,CSE 15L,A01,083654,Staff,0,0,50,50
1650198734106,CSE 15L,A02,083655,Staff,6,0,50,44
1650198740135,CSE 20,A01,083657,Staff,53,0,80,27
1650198746159,CSE 30,A01,083084,Eldon; John,0,69,40,40
1650198752197,CSE 100,A01,083659,Cao; Yingjun,0,63,50,50
1650198758236,CSE 134B,A01,083661,Powell; Thomas Allan,0,27,65,65
1650198764260,CSE 140,A01,083663,Staff,1,0,75,74
1650198770286,CSE 140L,A01,083088,Eldon; John,0,4,75,75
1650198776310,CSE 175,A01,083665,Kumar; Rakesh,8,0,25,17
1650198782340,CSE 190,A00,092507,Dubnov; Shlomo,14,0,20,6
1650198788369,ECE 45,A01,083139,Staff,0,13,40,40
1650198794394,ECE 65,A50,083695,Staff,0,5,30,30
1650198800422,ECE 109,A01,091882,Touri; Behrouz,47,0,70,23
1650198806451,ECE 180,A00,083140,Abi Samra; Nicholas Camill,24,0,30,6
1650198806451,ECE 180,B00,083141,Abi Samra; Nicholas Camill,8,0,30,22
1650198812480,MATH 10A,A01,083735,Patchell; Gregory David,11,0,30,19
1650198812480,MATH 10A,A02,083736,Patchell; Gregory David,28,0,30,2
1650198812480,MATH 10A,A03,083737,Patchell; Gregory David,26,0,30,4
1650198818516,MATH 10B,A01,083207,Staff,0,5,30,30
1650198818516,MATH 10B,A02,083208,Staff,0,5,30,30
1650198818516,MATH 10B,B01,083739,Staff,17,0,30,13
1650198818516,MATH 10B,B02,083740,Staff,29,0,30,1
1650198824548,MATH 18,A01,083743,Staff,8,0,30,22
1650198824548,MATH 18,A02,083744,Staff,28,0,30,2
1650198824548,MATH 18,A03,083745,Staff,23,0,30,7
1650198824548,MATH 18,A04,083746,Staff,27,0,30,3
1650198824548,MATH 18,B01,083748,Staff,0,10,30,30
1650198824548,MATH 18,B02,083749,Staff,0,7,30,30
1650198824548,MATH 18,B03,083750,Staff,0,7,30,30
1650198824548,MATH 18,B04,083751,Staff,0,8,30,30
1650198830574,MATH 20A,A01,083754,Staff,26,0,40,14
1650198836600,MATH 20B,A01,083756,Staff,0,6,30,30
1650198836600,MATH 20B,A02,083757,Staff,0,6,30,30
1650198842631,MATH 20C,A01,083760,Staff,0,12,30,30
1650198842631,MATH 20C,A02,083761,Staff,0,12,30,30
1650198842631,MATH 20C,B01,083762,Staff,14,0,30,16
1650198842631,MATH 20C,B02,083763,Staff,28,0,30,2
1650198848660,MATH 20D,A01,083765,Staff,1,2,30,29
1650198848660,MATH 20D,A02,083766,Staff,10,0,30,20
1650198848660,MATH 20D,A03,083767,Staff,28,0,30,2
1650198854687,MATH 20E,A01,083771,Staff,8,0,30,22
1650198854687,MATH 20E,A02,083772,Staff,20,0,30,10
1650198854687,MATH 20E,B01,083773,Staff,0,0,30,30
1650198854687,MATH 20E,B02,083774,Staff,12,0,30,18
1650198860724,MATH 103A,A01,083777,Staff,0,9,30,30
1650198860724,MATH 103A,A02,083778,Staff,0,10,30,30
1650198860724,MATH 103A,B01,083779,Staff,0,9,30,30
1650198860724,MATH 103A,B02,083780,Staff,0,9,30,30
1650198866757,MATH 105,A01,085443,Staff,0,17,30,30
1650198872785,MATH 109,A01,083213,Anzaldo; Leesa B,0,3,30,30
1650198872785,MATH 109,A02,083214,Anzaldo; Leesa B,0,6,30,30
1650198872785,MATH 109,B01,083215,Anzaldo; Leesa B,0,4,30,30
1650198872785,MATH 109,B02,083216,Anzaldo; Leesa B,0,4,30,30
1650198878814,MATH 142A,A01,083219,Chow; Bennett,0,12,30,30
1650198878814,MATH 142A,A02,083220,Chow; Bennett,0,11,30,30
1650198878814,MATH 142A,B01,083221,Chow; Bennett,0,11,30,30
1650198878814,MATH 142A,B02,083222,Chow; Bennett,0,12,30,30
1650198884843,MATH 193A,A01,083224,Staff,0,4,30,30
1650198884843,MATH 193A,A02,083225,Staff,0,4,30,30
1650198884843,MATH 193A,A03,083781,Staff,0,2,30,30
1650198884843,MATH 193A,A04,083782,Staff,0,1,30,30
1650198890877,MATH 197,001,091859,McAuley; Julian John,9998,0,9999,1
1650198896944,COGS 9,A01,083615,Staff,0,14,60,60
1650198902972,COGS 11,A01,083617,Boyle; Mary E. T.,24,0,40,16
1650198908996,COGS 13,A01,083071,Staff,0,30,40,40
1650198915023,COGS 14A,A01,092681,Staff,0,12,100,100
1650198921050,COGS 14B,A01,083073,Cheng; Tzu-Han,0,7,50,50
1650198927075,COGS 17,A01,092677,Staff,35,0,75,40
1650198933103,COGS 100,A01,083619,Staff,0,20,60,60
1650198939127,COGS 101A,A01,083621,Davis; Joshua Daniel,0,21,60,60
1650198945152,COGS 101B,A01,091572,Staff,6,0,60,54
1650198951180,COGS 101C,A01,083625,Delgado; Tania,20,0,30,10
1650198957204,COGS 107A,A01,083627,Boyle; Mary E. T.,0,7,60,60
1650198963227,COGS 118A,A01,083075,Staff,16,0,60,44
1650198969251,CSE 3,A50,083646,Miranda; Gregory Joseph,22,0,38,16
1650198969251,CSE 3,A51,083647,Miranda; Gregory Joseph,37,0,37,0
1650198975277,CSE 8A,A50,083650,Miranda; Gregory Joseph,0,17,40,40
1650198981305,CSE 11,A01,083080,Cao; Yingjun,0,68,40,40
1650198987338,CSE 12,A01,083652,Staff,0,7,100,100
1650198993364,CSE 15L,A01,083654,Staff,0,0,50,50
1650198993364,CSE 15L,A02,083655,Staff,6,0,50,44
1650198999391,CSE 20,A01,083657,Staff,53,0,80,27
1650199005421,CSE 30,A01,083084,Eldon; John,0,69,40,40
1650199011446,CSE 100,A01,083659,Cao; Yingjun,0,63,50,50
1650199017477,CSE 134B,A01,083661,Powell; Thomas Allan,0,27,65,65
1650199023504,CSE 140,A01,083663,Staff,1,0,75,74
1650199029530,CSE 140L,A01,083088,Eldon; John,0,4,75,75
1650199035558,CSE 175,A01,083665,Kumar; Rakesh,8,0,25,17
1650199041582,CSE 190,A00,092507,Dubnov; Shlomo,14,0,20,6
1650199047608,ECE 45,A01,083139,Staff,0,13,40,40
1650199053633,ECE 65,A50,083695,Staff,0,5,30,30
1650199059656,ECE 109,A01,091882,Touri; Behrouz,47,0,70,23
1650199065681,ECE 180,A00,083140,Abi Samra; Nicholas Camill,24,0,30,6
1650199065681,ECE 180,B00,083141,Abi Samra; Nicholas Camill,8,0,30,22
1650199071711,MATH 10A,A01,083735,Patchell; Gregory David,11,0,30,19
1650199071711,MATH 10A,A02,083736,Patchell; Gregory David,28,0,30,2
1650199071711,MATH 10A,A03,083737,Patchell; Gregory David,26,0,30,4
1650199077737,MATH 10B,A01,083207,Staff,0,5,30,30
1650199077737,MATH 10B,A02,083208,Staff,0,5,30,30
1650199077737,MATH 10B,B01,083739,Staff,17,0,30,13
1650199077737,MATH 10B,B02,083740,Staff,29,0,30,1
1650199083768,MATH 18,A01,083743,Staff,8,0,30,22
1650199083768,MATH 18,A02,083744,Staff,28,0,30,2
1650199083768,MATH 18,A03,083745,Staff,23,0,30,7
1650199083768,MATH 18,A04,083746,Staff,27,0,30,3
1650199083768,MATH 18,B01,083748,Staff,0,10,30,30
1650199083768,MATH 18,B02,083749,Staff,0,7,30,30
1650199083768,MATH 18,B03,083750,Staff,0,7,30,30
1650199083768,MATH 18,B04,083751,Staff,0,8,30,30
1650199089795,MATH 20A,A01,083754,Staff,26,0,40,14
1650199095824,MATH 20B,A01,083756,Staff,0,6,30,30
1650199095824,MATH 20B,A02,083757,Staff,0,6,30,30
1650199101850,MATH 20C,A01,083760,Staff,0,12,30,30
1650199101850,MATH 20C,A02,083761,Staff,0,12,30,30
1650199101850,MATH 20C,B01,083762,Staff,14,0,30,16
1650199101850,MATH 20C,B02,083763,Staff,28,0,30,2
1650199107880,MATH 20D,A01,083765,Staff,1,2,30,29
1650199107880,MATH 20D,A02,083766,Staff,10,0,30,20
1650199107880,MATH 20D,A03,083767,Staff,28,0,30,2
1650199113911,MATH 20E,A01,083771,Staff,8,0,30,22
1650199113911,MATH 20E,A02,083772,Staff,20,0,30,10
1650199113911,MATH 20E,B01,083773,Staff,0,0,30,30
1650199113911,MATH 20E,B02,083774,Staff,12,0,30,18
1650199119936,MATH 103A,A01,083777,Staff,0,9,30,30
1650199119936,MATH 103A,A02,083778,Staff,0,10,30,30
1650199119936,MATH 103A,B01,083779,Staff,0,9,30,30
1650199119936,MATH 103A,B02,083780,Staff,0,9,30,30
1650199125961,MATH 105,A01,085443,Staff,0,17,30,30
1650199131992,MATH 109,A01,083213,Anzaldo; Leesa B,0,3,30,30
1650199131992,MATH 109,A02,083214,Anzaldo; Leesa B,0,6,30,30
1650199131992,MATH 109,B01,083215,Anzaldo; Leesa B,0,4,30,30
1650199131992,MATH 109,B02,083216,Anzaldo; Leesa B,0,4,30,30
1650199138024,MATH 142A,A01,083219,Chow; Bennett,0,12,30,30
1650199138024,MATH 142A,A02,083220,Chow; Bennett,0,11,30,30
1650199138024,MATH 142A,B01,083221,Chow; Bennett,0,11,30,30
1650199138024,MATH 142A,B02,083222,Chow; Bennett,0,12,30,30
1650199144051,MATH 193A,A01,083224,Staff,0,4,30,30
1650199144051,MATH 193A,A02,083225,Staff,0,4,30,30
1650199144051,MATH 193A,A03,083781,Staff,0,2,30,30
1650199144051,MATH 193A,A04,083782,Staff,0,1,30,30
1650199150074,MATH 197,001,091859,McAuley; Julian John,9998,0,9999,1
1650199156139,COGS 9,A01,083615,Staff,0,14,60,60
1650199162164,COGS 11,A01,083617,Boyle; Mary E. T.,24,0,40,16
1650199168194,COGS 13,A01,083071,Staff,0,30,40,40
1650199174222,COGS 14A,A01,092681,Staff,0,12,100,100
1650199180249,COGS 14B,A01,083073,Cheng; Tzu-Han,0,7,50,50
1650199186277,COGS 17,A01,092677,Staff,35,0,75,40
1650199192305,COGS 100,A01,083619,Staff,0,20,60,60
1650199198333,COGS 101A,A01,083621,Davis; Joshua Daniel,0,21,60,60
1650199204361,COGS 101B,A01,091572,Staff,6,0,60,54
1650199210392,COGS 101C,A01,083625,Delgado; Tania,20,0,30,10
1650199216419,COGS 107A,A01,083627,Boyle; Mary E. T.,0,7,60,60
1650199222444,COGS 118A,A01,083075,Staff,16,0,60,44
1650199228542,CSE 3,A50,083646,Miranda; Gregory Joseph,22,0,38,16
1650199228542,CSE 3,A51,083647,Miranda; Gregory Joseph,37,0,37,0
1650199234567,CSE 8A,A50,083650,Miranda; Gregory Joseph,0,17,40,40
1650199240593,CSE 11,A01,083080,Cao; Yingjun,0,68,40,40
1650199246621,CSE 12,A01,083652,Staff,0,7,100,100
1650199252649,CSE 15L,A01,083654,Staff,0,0,50,50
1650199252649,CSE 15L,A02,083655,Staff,6,0,50,44
1650199258676,CSE 20,A01,083657,Staff,53,0,80,27
1650199264701,CSE 30,A01,083084,Eldon; John,0,69,40,40
1650199270726,CSE 100,A01,083659,Cao; Yingjun,0,63,50,50
1650199276750,CSE 134B,A01,083661,Powell; Thomas Allan,0,27,65,65
1650199282779,CSE 140,A01,083663,Staff,1,0,75,74
1650199288808,CSE 140L,A01,083088,Eldon; John,0,4,75,75
1650199294833,CSE 175,A01,083665,Kumar; Rakesh,8,0,25,17
1650199300858,CSE 190,A00,092507,Dubnov; Shlomo,14,0,20,6
1650199306884,ECE 45,A01,083139,Staff,0,13,40,40
1650199312909,ECE 65,A50,083695,Staff,0,5,30,30
1650199318933,ECE 109,A01,091882,Touri; Behrouz,47,0,70,23
1650199324959,ECE 180,A00,083140,Abi Samra; Nicholas Camill,24,0,30,6
1650199324959,ECE 180,B00,083141,Abi Samra; Nicholas Camill,8,0,30,22
1650199330994,MATH 10A,A01,083735,Patchell; Gregory David,11,0,30,19
1650199330994,MATH 10A,A02,083736,Patchell; Gregory David,28,0,30,2
1650199330994,MATH 10A,A03,083737,Patchell; Gregory David,26,0,30,4
1650199337022,MATH 10B,A01,083207,Staff,0,5,30,30
1650199337022,MATH 10B,A02,083208,Staff,0,5,30,30
1650199337022,MATH 10B,B01,083739,Staff,17,0,30,13
1650199337022,MATH 10B,B02,083740,Staff,29,0,30,1
1650199343049,MATH 18,A01,083743,Staff,8,0,30,22
1650199343049,MATH 18,A02,083744,Staff,28,0,30,2
1650199343049,MATH 18,A03,083745,Staff,23,0,30,7
1650199343049,MATH 18,A04,083746,Staff,27,0,30,3
1650199343049,MATH 18,B01,083748,Staff,0,10,30,30
1650199343049,MATH 18,B02,083749,Staff,0,7,30,30
1650199343049,MATH 18,B03,083750,Staff,0,7,30,30
1650199343049,MATH 18,B04,083751,Staff,0,8,30,30
1650199349075,MATH 20A,A01,083754,Staff,26,0,40,14
1650199355100,MATH 20B,A01,083756,Staff,0,6,30,30
1650199355100,MATH 20B,A02,083757,Staff,0,6,30,30
1650199361127,MATH 20C,A01,083760,Staff,0,12,30,30
1650199361127,MATH 20C,A02,083761,Staff,0,12,30,30
1650199361127,MATH 20C,B01,083762,Staff,14,0,30,16
1650199361127,MATH 20C,B02,083763,Staff,28,0,30,2
1650199367153,MATH 20D,A01,083765,Staff,1,2,30,29
1650199367153,MATH 20D,A02,083766,Staff,10,0,30,20
1650199367153,MATH 20D,A03,083767,Staff,28,0,30,2
1650199373179,MATH 20E,A01,083771,Staff,8,0,30,22
1650199373179,MATH 20E,A02,083772,Staff,20,0,30,10
1650199373179,MATH 20E,B01,083773,Staff,0,0,30,30
1650199373179,MATH 20E,B02,083774,Staff,12,0,30,18
1650199379205,MATH 103A,A01,083777,Staff,0,9,30,30
1650199379205,MATH 103A,A02,083778,Staff,0,10,30,30
1650199379205,MATH 103A,B01,083779,Staff,0,9,30,30
1650199379205,MATH 103A,B02,083780,Staff,0,9,30,30
1650199385230,MATH 105,A01,085443,Staff,0,17,30,30
1650199391253,MATH 109,A01,083213,Anzaldo; Leesa B,0,3,30,30
1650199391253,MATH 109,A02,083214,Anzaldo; Leesa B,0,6,30,30
1650199391253,MATH 109,B01,083215,Anzaldo; Leesa B,0,4,30,30
1650199391253,MATH 109,B02,083216,Anzaldo; Leesa B,0,4,30,30
1650199397287,MATH 142A,A01,083219,Chow; Bennett,0,12,30,30
1650199397287,MATH 142A,A02,083220,Chow; Bennett,0,11,30,30
1650199397287,MATH 142A,B01,083221,Chow; Bennett,0,11,30,30
1650199397287,MATH 142A,B02,083222,Chow; Bennett,0,12,30,30
1650199403312,MATH 193A,A01,083224,Staff,0,4,30,30
1650199403312,MATH 193A,A02,083225,Staff,0,4,30,30
1650199403312,MATH 193A,A03,083781,Staff,0,2,30,30
1650199403312,MATH 193A,A04,083782,Staff,0,1,30,30
1650199409338,MATH 197,001,091859,McAuley; Julian John,9998,0,9999,1
1650199415393,COGS 9,A01,083615,Staff,0,14,60,60
1650199421419,COGS 11,A01,083617,Boyle; Mary E. T.,24,0,40,16
1650199427445,COGS 13,A01,083071,Staff,0,30,40,40
1650199433471,COGS 14A,A01,092681,Staff,0,12,100,100
1650199439506,COGS 14B,A01,083073,Cheng; Tzu-Han,0,7,50,50
1650199445534,COGS 17,A01,092677,Staff,35,0,75,40
1650199451562,COGS 100,A01,083619,Staff,0,20,60,60
1650199457591,COGS 101A,A01,083621,Davis; Joshua Daniel,0,21,60,60
1650199463616,COGS 101B,A01,091572,Staff,6,0,60,54
1650199469642,COGS 101C,A01,083625,Delgado; Tania,20,0,30,10
1650199475666,COGS 107A,A01,083627,Boyle; Mary E. T.,0,7,60,60
1650199481693,COGS 118A,A01,083075,Staff,16,0,60,44
1650199487723,CSE 3,A50,083646,Miranda; Gregory Joseph,22,0,38,16
1650199487723,CSE 3,A51,083647,Miranda; Gregory Joseph,37,0,37,0
1650199493753,CSE 8A,A50,083650,Miranda; Gregory Joseph,0,17,40,40
1650199499779,CSE 11,A01,083080,Cao; Yingjun,0,68,40,40
1650199505806,CSE 12,A01,083652,Staff,0,7,100,100
1650199511831,CSE 15L,A01,083654,Staff,0,0,50,50
1650199511831,CSE 15L,A02,083655,Staff,6,0,50,44
1650199517859,CSE 20,A01,083657,Staff,53,0,80,27
1650199523884,CSE 30,A01,083084,Eldon; John,0,69,40,40
1650199529911,CSE 100,A01,083659,Cao; Yingjun,0,63,50,50
1650199535937,CSE 134B,A01,083661,Powell; Thomas Allan,0,27,65,65
1650199541963,CSE 140,A01,083663,Staff,1,0,75,74
1650199547988,CSE 140L,A01,083088,Eldon; John,0,4,75,75
1650199554024,CSE 175,A01,083665,Kumar; Rakesh,8,0,25,17
1650199560052,CSE 190,A00,092507,Dubnov; Shlomo,14,0,20,6
1650199566077,ECE 45,A01,083139,Staff,0,13,40,40
1650199572101,ECE 65,A50,083695,Staff,0,5,30,30
1650199578125,ECE 109,A01,091882,Touri; Behrouz,47,0,70,23
1650199584150,ECE 180,A00,083140,Abi Samra; Nicholas Camill,24,0,30,6
1650199584150,ECE 180,B00,083141,Abi Samra; Nicholas Camill,8,0,30,22
1650199590175,MATH 10A,A01,083735,Patchell; Gregory David,11,0,30,19
1650199590175,MATH 10A,A02,083736,Patchell; Gregory David,28,0,30,2
1650199590175,MATH 10A,A03,083737,Patchell; Gregory David,26,0,30,4
1650199596209,MATH 10B,A01,083207,Staff,0,5,30,30
1650199596209,MATH 10B,A02,083208,Staff,0,5,30,30
1650199596209,MATH 10B,B01,083739,Staff,17,0,30,13
1650199596209,MATH 10B,B02,083740,Staff,29,0,30,1
1650199602234,MATH 18,A01,083743,Staff,8,0,30,22
1650199602234,MATH 18,A02,083744,Staff,28,0,30,2
1650199602234,MATH 18,A03,083745,Staff,23,0,30,7
1650199602234,MATH 18,A04,083746,Staff,27,0,30,3
1650199602234,MATH 18,B01,083748,Staff,0,10,30,30
1650199602234,MATH 18,B02,083749,Staff,0,7,30,30
1650199602234,MATH 18,B03,083750,Staff,0,7,30,30
1650199602234,MATH 18,B04,083751,Staff,0,8,30,30
1650199608261,MATH 20A,A01,083754,Staff,26,0,40,14
1650199614289,MATH 20B,A01,083756,Staff,0,6,30,30
1650199614289,MATH 20B,A02,083757,Staff,0,6,30,30
1650199620315,MATH 20C,A01,083760,Staff,0,12,30,30
1650199620315,MATH 20C,A02,083761,Staff,0,12,30,30
1650199620315,MATH 20C,B01,083762,Staff,14,0,30,16
1650199620315,MATH 20C,B02,083763,Staff,28,0,30,2
1650199626341,MATH 20D,A01,083765,Staff,1,2,30,29
1650199626341,MATH 20D,A02,083766,Staff,10,0,30,20
1650199626341,MATH 20D,A03,083767,Staff,28,0,30,2
1650199632368,MATH 20E,A01,083771,Staff,8,0,30,22
1650199632368,MATH 20E,A02,083772,Staff,20,0,30,10
1650199632368,MATH 20E,B01,083773,Staff,0,0,30,30
1650199632368,MATH 20E,B02,083774,Staff,12,0,30,18
1650199638394,MATH 103A,A01,083777,Staff,0,9,30,30
1650199638394,MATH 103A,A02,083778,Staff,0,10,30,30
1650199638394,MATH 103A,B01,083779,Staff,0,9,30,30
1650199638394,MATH 103A,B02,083780,Staff,0,9,30,30
1650199644422,MATH 105,A01,085443,Staff,0,17,30,30
1650199650450,MATH 109,A01,083213,Anzaldo; Leesa B,0,3,30,30
1650199650450,MATH 109,A02,083214,Anzaldo; Leesa B,0,6,30,30
1650199650450,MATH 109,B01,083215,Anzaldo; Leesa B,0,4,30,30
1650199650450,MATH 109,B02,083216,Anzaldo; Leesa B,0,4,30,30
1650199656475,MATH 142A,A01,083219,Chow; Bennett,0,12,30,30
1650199656475,MATH 142A,A02,083220,Chow; Bennett,0,11,30,30
1650199656475,MATH 142A,B01,083221,Chow; Bennett,0,11,30,30
1650199656475,MATH 142A,B02,083222,Chow; Bennett,0,12,30,30
1650199662503,MATH 193A,A01,083224,Staff,0,4,30,30
1650199662503,MATH 193A,A02,083225,Staff,0,4,30,30
1650199662503,MATH 193A,A03,083781,Staff,0,2,30,30
1650199662503,MATH 193A,A04,083782,Staff,0,1,30,30
1650199668526,MATH 197,001,091859,McAuley; Julian John,9998,0,9999,1
1650199674590,COGS 9,A01,083615,Staff,0,14,60,60
1650199680630,COGS 11,A01,083617,Boyle; Mary E. T.,24,0,40,16
1650199686654,COGS 13,A01,083071,Staff,0,30,40,40
1650199692679,COGS 14A,A01,092681,Staff,0,12,100,100
1650199698704,COGS 14B,A01,083073,Cheng; Tzu-Han,0,7,50,50
1650199704733,COGS 17,A01,092677,Staff,35,0,75,40
1650199710760,COGS 100,A01,083619,Staff,0,20,60,60
1650199716786,COGS 101A,A01,083621,Davis; Joshua Daniel,0,21,60,60
1650199722810,COGS 101B,A01,091572,Staff,6,0,60,54
1650199728836,COGS 101C,A01,083625,Delgado; Tania,20,0,30,10
1650199734864,COGS 107A,A01,083627,Boyle; Mary E. T.,0,7,60,60
1650199740893,COGS 118A,A01,083075,Staff,16,0,60,44
1650199746919,CSE 3,A50,083646,Miranda; Gregory Joseph,22,0,38,16
1650199746919,CSE 3,A51,083647,Miranda; Gregory Joseph,37,0,37,0
1650199752945,CSE 8A,A50,083650,Miranda; Gregory Joseph,0,17,40,40
1650199758974,CSE 11,A01,083080,Cao; Yingjun,0,68,40,40
1650199765001,CSE 12,A01,083652,Staff,0,7,100,100
1650199771031,CSE 15L,A01,083654,Staff,0,0,50,50
1650199771031,CSE 15L,A02,083655,Staff,6,0,50,44
1650199777061,CSE 20,A01,083657,Staff,53,0,80,27
1650199783092,CSE 30,A01,083084,Eldon; John,0,69,40,40
1650199789120,CSE 100,A01,083659,Cao; Yingjun,0,63,50,50
1650199795149,CSE 134B,A01,083661,Powell; Thomas Allan,0,27,65,65
1650199801192,CSE 140,A01,083663,Staff,1,0,75,74
1650199807216,CSE 140L,A01,083088,Eldon; John,0,4,75,75
1650199813241,CSE 175,A01,083665,Kumar; Rakesh,8,0,25,17
1650199819268,CSE 190,A00,092507,Dubnov; Shlomo,14,0,20,6
1650199825371,ECE 45,A01,083139,Staff,0,13,40,40
1650199831412,ECE 65,A50,083695,Staff,0,5,30,30
1650199837439,ECE 109,A01,091882,Touri; Behrouz,47,0,70,23
1650199843464,ECE 180,A00,083140,Abi Samra; Nicholas Camill,24,0,30,6
1650199843464,ECE 180,B00,083141,Abi Samra; Nicholas Camill,8,0,30,22
1650199849490,MATH 10A,A01,083735,Patchell; Gregory David,11,0,30,19
1650199849490,MATH 10A,A02,083736,Patchell; Gregory David,28,0,30,2
1650199849490,MATH 10A,A03,083737,Patchell; Gregory David,26,0,30,4
1650199855519,MATH 10B,A01,083207,Staff,0,5,30,30
1650199855519,MATH 10B,A02,083208,Staff,0,5,30,30
1650199855519,MATH 10B,B01,083739,Staff,17,0,30,13
1650199855519,MATH 10B,B02,083740,Staff,29,0,30,1
1650199861546,MATH 18,A01,083743,Staff,8,0,30,22
1650199861546,MATH 18,A02,083744,Staff,28,0,30,2
1650199861546,MATH 18,A03,083745,Staff,23,0,30,7
1650199861546,MATH 18,A04,083746,Staff,27,0,30,3
1650199861546,MATH 18,B01,083748,Staff,0,10,30,30
1650199861546,MATH 18,B02,083749,Staff,0,7,30,30
1650199861546,MATH 18,B03,083750,Staff,0,7,30,30
1650199861546,MATH 18,B04,083751,Staff,0,8,30,30
1650199867576,MATH 20A,A01,083754,Staff,26,0,40,14
1650199873605,MATH 20B,A01,083756,Staff,0,6,30,30
1650199873605,MATH 20B,A02,083757,Staff,0,6,30,30
1650199879631,MATH 20C,A01,083760,Staff,0,12,30,30
1650199879631,MATH 20C,A02,083761,Staff,0,12,30,30
1650199879631,MATH 20C,B01,083762,Staff,14,0,30,16
1650199879631,MATH 20C,B02,083763,Staff,28,0,30,2
1650199885661,MATH 20D,A01,083765,Staff,1,2,30,29
1650199885661,MATH 20D,A02,083766,Staff,10,0,30,20
1650199885661,MATH 20D,A03,083767,Staff,28,0,30,2
1650199891693,MATH 20E,A01,083771,Staff,8,0,30,22
1650199891693,MATH 20E,A02,083772,Staff,20,0,30,10
1650199891693,MATH 20E,B01,083773,Staff,0,0,30,30
1650199891693,MATH 20E,B02,083774,Staff,12,0,30,18
1650199897724,MATH 103A,A01,083777,Staff,0,9,30,30
1650199897724,MATH 103A,A02,083778,Staff,0,10,30,30
1650199897724,MATH 103A,B01,083779,Staff,0,9,30,30
1650199897724,MATH 103A,B02,083780,Staff,0,9,30,30
1650199903749,MATH 105,A01,085443,Staff,0,17,30,30
1650199909778,MATH 109,A01,083213,Anzaldo; Leesa B,0,3,30,30
1650199909778,MATH 109,A02,083214,Anzaldo; Leesa B,0,6,30,30
1650199909778,MATH 109,B01,083215,Anzaldo; Leesa B,0,4,30,30
1650199909778,MATH 109,B02,083216,Anzaldo; Leesa B,0,4,30,30
1650199915810,MATH 142A,A01,083219,Chow; Bennett,0,12,30,30
1650199915810,MATH 142A,A02,083220,Chow; Bennett,0,11,30,30
1650199915810,MATH 142A,B01,083221,Chow; Bennett,0,11,30,30
1650199915810,MATH 142A,B02,083222,Chow; Bennett,0,12,30,30
1650199921843,MATH 193A,A01,083224,Staff,0,4,30,30
1650199921843,MATH 193A,A02,083225,Staff,0,4,30,30
1650199921843,MATH 193A,A03,083781,Staff,0,2,30,30
1650199921843,MATH 193A,A04,083782,Staff,0,1,30,30
1650199927873,MATH 197,001,091859,McAuley; Julian John,9998,0,9999,1
1650199933935,COGS 9,A01,083615,Staff,0,14,60,60
1650199939964,COGS 11,A01,083617,Boyle; Mary E. T.,24,0,40,16
1650199945989,COGS 13,A01,083071,Staff,0,30,40,40
1650199952019,COGS 14A,A01,092681,Staff,0,12,100,100
1650199958044,COGS 14B,A01,083073,Cheng; Tzu-Han,0,7,50,50
1650199964075,COGS 17,A01,092677,Staff,35,0,75,40
1650199970100,COGS 100,A01,083619,Staff,0,20,60,60
1650199976128,COGS 101A,A01,083621,Davis; Joshua Daniel,0,21,60,60
1650199982158,COGS 101B,A01,091572,Staff,6,0,60,54
1650199988187,COGS 101C,A01,083625,Delgado; Tania,20,0,30,10
1650199994215,COGS 107A,A01,083627,Boyle; Mary E. T.,0,7,60,60
1650200000241,COGS 118A,A01,083075,Staff,16,0,60,44
1650200006270,CSE 3,A50,083646,Miranda; Gregory Joseph,22,0,38,16
1650200006270,CSE 3,A51,083647,Miranda; Gregory Joseph,37,0,37,0
1650200012299,CSE 8A,A50,083650,Miranda; Gregory Joseph,0,17,40,40
1650200018325,CSE 11,A01,083080,Cao; Yingjun,0,68,40,40
1650200024351,CSE 12,A01,083652,Staff,0,7,100,100
1650200030376,CSE 15L,A01,083654,Staff,0,0,50,50
1650200030376,CSE 15L,A02,083655,Staff,6,0,50,44
1650200036404,CSE 20,A01,083657,Staff,53,0,80,27
1650200042427,CSE 30,A01,083084,Eldon; John,0,69,40,40
1650200048458,CSE 100,A01,083659,Cao; Yingjun,0,63,50,50
1650200054490,CSE 134B,A01,083661,Powell; Thomas Allan,0,27,65,65
1650200060514,CSE 140,A01,083663,Staff,1,0,75,74
1650200066542,CSE 140L,A01,083088,Eldon; John,0,4,75,75
1650200072573,CSE 175,A01,083665,Kumar; Rakesh,8,0,25,17
1650200078599,CSE 190,A00,092507,Dubnov; Shlomo,14,0,20,6
1650200084628,ECE 45,A01,083139,Staff,0,13,40,40
1650200090657,ECE 65,A50,083695,Staff,0,5,30,30
1650200096682,ECE 109,A01,091882,Touri; Behrouz,47,0,70,23
1650200102713,ECE 180,A00,083140,Abi Samra; Nicholas Camill,24,0,30,6
1650200102713,ECE 180,B00,083141,Abi Samra; Nicholas Camill,8,0,30,22
1650200108738,MATH 10A,A01,083735,Patchell; Gregory David,11,0,30,19
1650200108738,MATH 10A,A02,083736,Patchell; Gregory David,28,0,30,2
1650200108738,MATH 10A,A03,083737,Patchell; Gregory David,26,0,30,4
1650200114763,MATH 10B,A01,083207,Staff,0,5,30,30
1650200114763,MATH 10B,A02,083208,Staff,0,5,30,30
1650200114763,MATH 10B,B01,083739,Staff,17,0,30,13
1650200114763,MATH 10B,B02,083740,Staff,29,0,30,1
1650200120795,MATH 18,A01,083743,Staff,8,0,30,22
1650200120795,MATH 18,A02,083744,Staff,28,0,30,2
1650200120795,MATH 18,A03,083745,Staff,23,0,30,7
1650200120795,MATH 18,A04,083746,Staff,27,0,30,3
1650200120795,MATH 18,B01,083748,Staff,0,10,30,30
1650200120795,MATH 18,B02,083749,Staff,0,7,30,30
1650200120795,MATH 18,B03,083750,Staff,0,7,30,30
1650200120795,MATH 18,B04,083751,Staff,0,8,30,30
1650200126823,MATH 20A,A01,083754,Staff,26,0,40,14
1650200132848,MATH 20B,A01,083756,Staff,0,6,30,30
1650200132848,MATH 20B,A02,083757,Staff,0,6,30,30
1650200138876,MATH 20C,A01,083760,Staff,0,12,30,30
1650200138876,MATH 20C,A02,083761,Staff,0,12,30,30
1650200138876,MATH 20C,B01,083762,Staff,14,0,30,16
1650200138876,MATH 20C,B02,083763,Staff,28,0,30,2
1650200144902,MATH 20D,A01,083765,Staff,1,2,30,29
1650200144902,MATH 20D,A02,083766,Staff,10,0,30,20
1650200144902,MATH 20D,A03,083767,Staff,28,0,30,2
1650200150927,MATH 20E,A01,083771,Staff,8,0,30,22
1650200150927,MATH 20E,A02,083772,Staff,20,0,30,10
1650200150927,MATH 20E,B01,083773,Staff,0,0,30,30
1650200150927,MATH 20E,B02,083774,Staff,12,0,30,18
1650200156954,MATH 103A,A01,083777,Staff,0,9,30,30
1650200156954,MATH 103A,A02,083778,Staff,0,10,30,30
1650200156954,MATH 103A,B01,083779,Staff,0,9,30,30
1650200156954,MATH 103A,B02,083780,Staff,0,9,30,30
1650200162981,MATH 105,A01,085443,Staff,0,17,30,30
1650200169010,MATH 109,A01,083213,Anzaldo; Leesa B,0,3,30,30
1650200169010,MATH 109,A02,083214,Anzaldo; Leesa B,0,6,30,30
1650200169010,MATH 109,B01,083215,Anzaldo; Leesa B,0,4,30,30
1650200169010,MATH 109,B02,083216,Anzaldo; Leesa B,0,4,30,30
1650200175037,MATH 142A,A01,083219,Chow; Bennett,0,12,30,30
1650200175037,MATH 142A,A02,083220,Chow; Bennett,0,11,30,30
1650200175037,MATH 142A,B01,083221,Chow; Bennett,0,11,30,30
1650200175037,MATH 142A,B02,083222,Chow; Bennett,0,12,30,30
1650200181062,MATH 193A,A01,083224,Staff,0,4,30,30
1650200181062,MATH 193A,A02,083225,Staff,0,4,30,30
1650200181062,MATH 193A,A03,083781,Staff,0,2,30,30
1650200181062,MATH 193A,A04,083782,Staff,0,1,30,30
1650200187092,MATH 197,001,091859,McAuley; Julian John,9998,0,9999,1
1650200193162,COGS 9,A01,083615,Staff,0,14,60,60
1650200199188,COGS 11,A01,083617,Boyle; Mary E. T.,24,0,40,16
1650200205219,COGS 13,A01,083071,Staff,0,30,40,40
1650200211245,COGS 14A,A01,092681,Staff,0,12,100,100
1650200217277,COGS 14B,A01,083073,Cheng; Tzu-Han,0,7,50,50
1650200223307,COGS 17,A01,092677,Staff,35,0,75,40
1650200229333,COGS 100,A01,083619,Staff,0,20,60,60
1650200235359,COGS 101A,A01,083621,Davis; Joshua Daniel,0,21,60,60
1650200241385,COGS 101B,A01,091572,Staff,6,0,60,54
1650200247417,COGS 101C,A01,083625,Delgado; Tania,20,0,30,10
1650200253443,COGS 107A,A01,083627,Boyle; Mary E. T.,0,7,60,60
1650200259466,COGS 118A,A01,083075,Staff,16,0,60,44
1650200265490,CSE 3,A50,083646,Miranda; Gregory Joseph,22,0,38,16
1650200265490,CSE 3,A51,083647,Miranda; Gregory Joseph,37,0,37,0
1650200271513,CSE 8A,A50,083650,Miranda; Gregory Joseph,0,17,40,40
1650200277541,CSE 11,A01,083080,Cao; Yingjun,0,68,40,40
1650200283572,CSE 12,A01,083652,Staff,0,7,100,100
1650200289600,CSE 15L,A01,083654,Staff,0,0,50,50
1650200289600,CSE 15L,A02,083655,Staff,6,0,50,44
1650200295627,CSE 20,A01,083657,Staff,53,0,80,27
1650200301658,CSE 30,A01,083084,Eldon; John,0,69,40,40
1650200307684,CSE 100,A01,083659,Cao; Yingjun,0,63,50,50
1650200313711,CSE 134B,A01,083661,Powell; Thomas Allan,0,27,65,65
1650200319738,CSE 140,A01,083663,Staff,1,0,75,74
1650200325762,CSE 140L,A01,083088,Eldon; John,0,4,75,75
1650200331790,CSE 175,A01,083665,Kumar; Rakesh,8,0,25,17
1650200337819,CSE 190,A00,092507,Dubnov; Shlomo,14,0,20,6
1650200343860,ECE 45,A01,083139,Staff,0,13,40,40
1650200349886,ECE 65,A50,083695,Staff,0,5,30,30
1650200355916,ECE 109,A01,091882,Touri; Behrouz,47,0,70,23
1650200361946,ECE 180,A00,083140,Abi Samra; Nicholas Camill,24,0,30,6
1650200361946,ECE 180,B00,083141,Abi Samra; Nicholas Camill,8,0,30,22
1650200367972,MATH 10A,A01,083735,Patchell; Gregory David,11,0,30,19
1650200367972,MATH 10A,A02,083736,Patchell; Gregory David,28,0,30,2
1650200367972,MATH 10A,A03,083737,Patchell; Gregory David,26,0,30,4
1650200374000,MATH 10B,A01,083207,Staff,0,5,30,30
1650200374000,MATH 10B,A02,083208,Staff,0,5,30,30
1650200374000,MATH 10B,B01,083739,Staff,17,0,30,13
1650200374000,MATH 10B,B02,083740,Staff,29,0,30,1
1650200380028,MATH 18,A01,083743,Staff,8,0,30,22
1650200380028,MATH 18,A02,083744,Staff,28,0,30,2
1650200380028,MATH 18,A03,083745,Staff,23,0,30,7
1650200380028,MATH 18,A04,083746,Staff,27,0,30,3
1650200380028,MATH 18,B01,083748,Staff,0,10,30,30
1650200380028,MATH 18,B02,083749,Staff,0,7,30,30
1650200380028,MATH 18,B03,083750,Staff,0,7,30,30
1650200380028,MATH 18,B04,083751,Staff,0,8,30,30
1650200386055,MATH 20A,A01,083754,Staff,26,0,40,14
1650200392089,MATH 20B,A01,083756,Staff,0,6,30,30
1650200392089,MATH 20B,A02,083757,Staff,0,6,30,30
1650200398119,MATH 20C,A01,083760,Staff,0,12,30,30
1650200398119,MATH 20C,A02,083761,Staff,0,12,30,30
1650200398119,MATH 20C,B01,083762,Staff,14,0,30,16
1650200398119,MATH 20C,B02,083763,Staff,28,0,30,2
1650200404153,MATH 20D,A01,083765,Staff,1,2,30,29
1650200404153,MATH 20D,A02,083766,Staff,10,0,30,20
1650200404153,MATH 20D,A03,083767,Staff,28,0,30,2
1650200410177,MATH 20E,A01,083771,Staff,8,0,30,22
1650200410177,MATH 20E,A02,083772,Staff,20,0,30,10
1650200410177,MATH 20E,B01,083773,Staff,0,0,30,30
1650200410177,MATH 20E,B02,083774,Staff,12,0,30,18
1650200416210,MATH 103A,A01,083777,Staff,0,9,30,30
1650200416210,MATH 103A,A02,083778,Staff,0,10,30,30
1650200416210,MATH 103A,B01,083779,Staff,0,9,30,30
1650200416210,MATH 103A,B02,083780,Staff,0,9,30,30
1650200422308,MATH 105,A01,085443,Staff,0,17,30,30
1650200428333,MATH 109,A01,083213,Anzaldo; Leesa B,0,3,30,30
1650200428333,MATH 109,A02,083214,Anzaldo; Leesa B,0,6,30,30
1650200428333,MATH 109,B01,083215,Anzaldo; Leesa B,0,4,30,30
1650200428333,MATH 109,B02,083216,Anzaldo; Leesa B,0,4,30,30
1650200434360,MATH 142A,A01,083219,Chow; Bennett,0,12,30,30
1650200434360,MATH 142A,A02,083220,Chow; Bennett,0,11,30,30
1650200434360,MATH 142A,B01,083221,Chow; Bennett,0,11,30,30
1650200434360,MATH 142A,B02,083222,Chow; Bennett,0,12,30,30
1650200440388,MATH 193A,A01,083224,Staff,0,4,30,30
1650200440388,MATH 193A,A02,083225,Staff,0,4,30,30
1650200440388,MATH 193A,A03,083781,Staff,0,2,30,30
1650200440388,MATH 193A,A04,083782,Staff,0,1,30,30
1650200446413,MATH 197,001,091859,McAuley; Julian John,9998,0,9999,1
1650200452481,COGS 9,A01,083615,Staff,0,14,60,60
1650200458506,COGS 11,A01,083617,Boyle; Mary E. T.,24,0,40,16
1650200464531,COGS 13,A01,083071,Staff,0,30,40,40
1650200470556,COGS 14A,A01,092681,Staff,0,12,100,100
1650200476580,COGS 14B,A01,083073,Cheng; Tzu-Han,0,7,50,50
1650200482607,COGS 17,A01,092677,Staff,35,0,75,40
1650200488635,COGS 100,A01,083619,Staff,0,20,60,60
1650200494673,COGS 101A,A01,083621,Davis; Joshua Daniel,0,21,60,60
1650200500706,COGS 101B,A01,091572,Staff,6,0,60,54
1650200506731,COGS 101C,A01,083625,Delgado; Tania,20,0,30,10
1650200512758,COGS 107A,A01,083627,Boyle; Mary E. T.,0,7,60,60
1650200518787,COGS 118A,A01,083075,Staff,16,0,60,44
1650200524815,CSE 3,A50,083646,Miranda; Gregory Joseph,22,0,38,16
1650200524815,CSE 3,A51,083647,Miranda; Gregory Joseph,37,0,37,0
1650200530846,CSE 8A,A50,083650,Miranda; Gregory Joseph,0,17,40,40
1650200536874,CSE 11,A01,083080,Cao; Yingjun,0,68,40,40
1650200542902,CSE 12,A01,083652,Staff,0,7,100,100
1650200548931,CSE 15L,A01,083654,Staff,0,0,50,50
1650200548931,CSE 15L,A02,083655,Staff,6,0,50,44
1650200554957,CSE 20,A01,083657,Staff,53,0,80,27
1650200560983,CSE 30,A01,083084,Eldon; John,0,69,40,40
1650200567008,CSE 100,A01,083659,Cao; Yingjun,0,63,50,50
1650200573038,CSE 134B,A01,083661,Powell; Thomas Allan,0,27,65,65
1650200579064,CSE 140,A01,083663,Staff,1,0,75,74
1650200585099,CSE 140L,A01,083088,Eldon; John,0,4,75,75
1650200591131,CSE 175,A01,083665,Kumar; Rakesh,8,0,25,17
1650200597157,CSE 190,A00,092507,Dubnov; Shlomo,14,0,20,6
1650200603183,ECE 45,A01,083139,Staff,0,13,40,40
1650200609211,ECE 65,A50,083695,Staff,0,5,30,30
1650200615237,ECE 109,A01,091882,Touri; Behrouz,47,0,70,23
1650200621265,ECE 180,A00,083140,Abi Samra; Nicholas Camill,24,0,30,6
1650200621265,ECE 180,B00,083141,Abi Samra; Nicholas Camill,8,0,30,22
1650200627296,MATH 10A,A01,083735,Patchell; Gregory David,11,0,30,19
1650200627296,MATH 10A,A02,083736,Patchell; Gregory David,28,0,30,2
1650200627296,MATH 10A,A03,083737,Patchell; Gregory David,26,0,30,4
1650200633319,MATH 10B,A01,083207,Staff,0,5,30,30
1650200633319,MATH 10B,A02,083208,Staff,0,5,30,30
1650200633319,MATH 10B,B01,083739,Staff,17,0,30,13
1650200633319,MATH 10B,B02,083740,Staff,29,0,30,1
1650200639353,MATH 18,A01,083743,Staff,8,0,30,22
1650200639353,MATH 18,A02,083744,Staff,28,0,30,2
1650200639353,MATH 18,A03,083745,Staff,23,0,30,7
1650200639353,MATH 18,A04,083746,Staff,27,0,30,3
1650200639353,MATH 18,B01,083748,Staff,0,10,30,30
1650200639353,MATH 18,B02,083749,Staff,0,7,30,30
1650200639353,MATH 18,B03,083750,Staff,0,7,30,30
1650200639353,MATH 18,B04,083751,Staff,0,8,30,30
1650200645378,MATH 20A,A01,083754,Staff,26,0,40,14
1650200651408,MATH 20B,A01,083756,Staff,0,6,30,30
1650200651408,MATH 20B,A02,083757,Staff,0,6,30,30
1650200657434,MATH 20C,A01,083760,Staff,0,12,30,30
1650200657434,MATH 20C,A02,083761,Staff,0,12,30,30
1650200657434,MATH 20C,B01,083762,Staff,14,0,30,16
1650200657434,MATH 20C,B02,083763,Staff,28,0,30,2
1650200663458,MATH 20D,A01,083765,Staff,1,2,30,29
1650200663458,MATH 20D,A02,083766,Staff,10,0,30,20
1650200663458,MATH 20D,A03,083767,Staff,28,0,30,2
1650200669484,MATH 20E,A01,083771,Staff,8,0,30,22
1650200669484,MATH 20E,A02,083772,Staff,20,0,30,10
1650200669484,MATH 20E,B01,083773,Staff,0,0,30,30
1650200669484,MATH 20E,B02,083774,Staff,12,0,30,18
1650200675513,MATH 103A,A01,083777,Staff,0,9,30,30
1650200675513,MATH 103A,A02,083778,Staff,0,10,30,30
1650200675513,MATH 103A,B01,083779,Staff,0,9,30,30
1650200675513,MATH 103A,B02,083780,Staff,0,9,30,30
1650200681543,MATH 105,A01,085443,Staff,0,17,30,30
1650200687573,MATH 109,A01,083213,Anzaldo; Leesa B,0,3,30,30
1650200687573,MATH 109,A02,083214,Anzaldo; Leesa B,0,6,30,30
1650200687573,MATH 109,B01,083215,Anzaldo; Leesa B,0,4,30,30
1650200687573,MATH 109,B02,083216,Anzaldo; Leesa B,0,4,30,30
1650200693597,MATH 142A,A01,083219,Chow; Bennett,0,12,30,30
1650200693597,MATH 142A,A02,083220,Chow; Bennett,0,11,30,30
1650200693597,MATH 142A,B01,083221,Chow; Bennett,0,11,30,30
1650200693597,MATH 142A,B02,083222,Chow; Bennett,0,12,30,30
1650200699623,MATH 193A,A01,083224,Staff,0,4,30,30
1650200699623,MATH 193A,A02,083225,Staff,0,4,30,30
1650200699623,MATH 193A,A03,083781,Staff,0,2,30,30
1650200699623,MATH 193A,A04,083782,Staff,0,1,30,30
1650200705655,MATH 197,001,091859,McAuley; Julian John,9998,0,9999,1
1650200711724,COGS 9,A01,083615,Staff,0,14,60,60
1650200717749,COGS 11,A01,083617,Boyle; Mary E. T.,24,0,40,16
1650200723781,COGS 13,A01,083071,Staff,0,30,40,40
1650200729807,COGS 14A,A01,092681,Staff,0,12,100,100
1650200735833,COGS 14B,A01,083073,Cheng; Tzu-Han,0,7,50,50
1650200741862,COGS 17,A01,092677,Staff,35,0,75,40
1650200747886,COGS 100,A01,083619,Staff,0,20,60,60
1650200753913,COGS 101A,A01,083621,Davis; Joshua Daniel,0,21,60,60
1650200759939,COGS 101B,A01,091572,Staff,6,0,60,54
1650200765981,COGS 101C,A01,083625,Delgado; Tania,20,0,30,10
1650200772008,COGS 107A,A01,083627,Boyle; Mary E. T.,0,7,60,60
1650200778036,COGS 118A,A01,083075,Staff,16,0,60,44
1650200784065,CSE 3,A50,083646,Miranda; Gregory Joseph,22,0,38,16
1650200784065,CSE 3,A51,083647,Miranda; Gregory Joseph,37,0,37,0
1650200790090,CSE 8A,A50,083650,Miranda; Gregory Joseph,0,17,40,40
1650200796115,CSE 11,A01,083080,Cao; Yingjun,0,68,40,40
1650200802141,CSE 12,A01,083652,Staff,0,7,100,100
1650200808169,CSE 15L,A01,083654,Staff,0,0,50,50
1650200808169,CSE 15L,A02,083655,Staff,6,0,50,44
1650200814196,CSE 20,A01,083657,Staff,53,0,80,27
1650200820223,CSE 30,A01,083084,Eldon; John,0,69,40,40
1650200826247,CSE 100,A01,083659,Cao; Yingjun,0,63,50,50
1650200832274,CSE 134B,A01,083661,Powell; Thomas Allan,0,27,65,65
1650200838314,CSE 140,A01,083663,Staff,1,0,75,74
1650200844342,CSE 140L,A01,083088,Eldon; John,0,4,75,75
1650200850367,CSE 175,A01,083665,Kumar; Rakesh,8,0,25,17
1650200856413,CSE 190,A00,092507,Dubnov; Shlomo,14,0,20,6
1650200862440,ECE 45,A01,083139,Staff,0,13,40,40
1650200868466,ECE 65,A50,083695,Staff,0,5,30,30
1650200874490,ECE 109,A01,091882,Touri; Behrouz,47,0,70,23
1650200880519,ECE 180,A00,083140,Abi Samra; Nicholas Camill,24,0,30,6
1650200880519,ECE 180,B00,083141,Abi Samra; Nicholas Camill,8,0,30,22
1650200886556,MATH 10A,A01,083735,Patchell; Gregory David,11,0,30,19
1650200886556,MATH 10A,A02,083736,Patchell; Gregory David,28,0,30,2
1650200886556,MATH 10A,A03,083737,Patchell; Gregory David,26,0,30,4
1650200892581,MATH 10B,A01,083207,Staff,0,5,30,30
1650200892581,MATH 10B,A02,083208,Staff,0,5,30,30
1650200892581,MATH 10B,B01,083739,Staff,17,0,30,13
1650200892581,MATH 10B,B02,083740,Staff,29,0,30,1
1650200898609,MATH 18,A01,083743,Staff,8,0,30,22
1650200898609,MATH 18,A02,083744,Staff,28,0,30,2
1650200898609,MATH 18,A03,083745,Staff,23,0,30,7
1650200898609,MATH 18,A04,083746,Staff,27,0,30,3
1650200898609,MATH 18,B01,083748,Staff,0,10,30,30
1650200898609,MATH 18,B02,083749,Staff,0,7,30,30
1650200898609,MATH 18,B03,083750,Staff,0,7,30,30
1650200898609,MATH 18,B04,083751,Staff,0,8,30,30
1650200904634,MATH 20A,A01,083754,Staff,26,0,40,14
1650200910664,MATH 20B,A01,083756,Staff,0,6,30,30
1650200910664,MATH 20B,A02,083757,Staff,0,6,30,30
1650200916690,MATH 20C,A01,083760,Staff,0,12,30,30
1650200916690,MATH 20C,A02,083761,Staff,0,12,30,30
1650200916690,MATH 20C,B01,083762,Staff,14,0,30,16
1650200916690,MATH 20C,B02,083763,Staff,28,0,30,2
1650200922715,MATH 20D,A01,083765,Staff,1,2,30,29
1650200922715,MATH 20D,A02,083766,Staff,10,0,30,20
1650200922715,MATH 20D,A03,083767,Staff,28,0,30,2
1650200928741,MATH 20E,A01,083771,Staff,8,0,30,22
1650200928741,MATH 20E,A02,083772,Staff,20,0,30,10
1650200928741,MATH 20E,B01,083773,Staff,0,0,30,30
1650200928741,MATH 20E,B02,083774,Staff,12,0,30,18
1650200934767,MATH 103A,A01,083777,Staff,0,9,30,30
1650200934767,MATH 103A,A02,083778,Staff,0,10,30,30
1650200934767,MATH 103A,B01,083779,Staff,0,9,30,30
1650200934767,MATH 103A,B02,083780,Staff,0,9,30,30
1650200940792,MATH 105,A01,085443,Staff,0,17,30,30
1650200946818,MATH 109,A01,083213,Anzaldo; Leesa B,0,3,30,30
1650200946818,MATH 109,A02,083214,Anzaldo; Leesa B,0,6,30,30
1650200946818,MATH 109,B01,083215,Anzaldo; Leesa B,0,4,30,30
1650200946818,MATH 109,B02,083216,Anzaldo; Leesa B,0,4,30,30
1650200952845,MATH 142A,A01,083219,Chow; Bennett,0,12,30,30
1650200952845,MATH 142A,A02,083220,Chow; Bennett,0,11,30,30
1650200952845,MATH 142A,B01,083221,Chow; Bennett,0,11,30,30
1650200952845,MATH 142A,B02,083222,Chow; Bennett,0,12,30,30
1650200958873,MATH 193A,A01,083224,Staff,0,4,30,30
1650200958873,MATH 193A,A02,083225,Staff,0,4,30,30
1650200958873,MATH 193A,A03,083781,Staff,0,2,30,30
1650200958873,MATH 193A,A04,083782,Staff,0,1,30,30
1650200964902,MATH 197,001,091859,McAuley; Julian John,9998,0,9999,1
1650200970969,COGS 9,A01,083615,Staff,0,14,60,60
1650200977013,COGS 11,A01,083617,Boyle; Mary E. T.,24,0,40,16
1650200983047,COGS 13,A01,083071,Staff,0,30,40,40
1650200989076,COGS 14A,A01,092681,Staff,0,12,100,100
1650200995102,COGS 14B,A01,083073,Cheng; Tzu-Han,0,7,50,50
1650201001128,COGS 17,A01,092677,Staff,35,0,75,40
1650201007153,COGS 100,A01,083619,Staff,0,20,60,60
1650201013267,COGS 101A,A01,083621,Davis; Joshua Daniel,0,21,60,60
1650201019292,COGS 101B,A01,091572,Staff,6,0,60,54
1650201025321,COGS 101C,A01,083625,Delgado; Tania,20,0,30,10
1650201031347,COGS 107A,A01,083627,Boyle; Mary E. T.,0,7,60,60
1650201037374,COGS 118A,A01,083075,Staff,16,0,60,44
1650201043408,CSE 3,A50,083646,Miranda; Gregory Joseph,22,0,38,16
1650201043408,CSE 3,A51,083647,Miranda; Gregory Joseph,37,0,37,0
1650201049435,CSE 8A,A50,083650,Miranda; Gregory Joseph,0,17,40,40
1650201055464,CSE 11,A01,083080,Cao; Yingjun,0,68,40,40
1650201061491,CSE 12,A01,083652,Staff,0,7,100,100
1650201067516,CSE 15L,A01,083654,Staff,0,0,50,50
1650201067516,CSE 15L,A02,083655,Staff,6,0,50,44
1650201073543,CSE 20,A01,083657,Staff,53,0,80,27
1650201079572,CSE 30,A01,083084,Eldon; John,0,69,40,40
1650201085600,CSE 100,A01,083659,Cao; Yingjun,0,63,50,50
1650201091627,CSE 134B,A01,083661,Powell; Thomas Allan,0,27,65,65
1650201097651,CSE 140,A01,083663,Staff,1,0,75,74
1650201103678,CSE 140L,A01,083088,Eldon; John,0,4,75,75
1650201109707,CSE 175,A01,083665,Kumar; Rakesh,8,0,25,17
1650201115733,CSE 190,A00,092507,Dubnov; Shlomo,14,0,20,6
1650201121769,ECE 45,A01,083139,Staff,0,13,40,40
1650201127794,ECE 65,A50,083695,Staff,0,5,30,30
1650201133829,ECE 109,A01,091882,Touri; Behrouz,47,0,70,23
1650201139863,ECE 180,A00,083140,Abi Samra; Nicholas Camill,24,0,30,6
1650201139863,ECE 180,B00,083141,Abi Samra; Nicholas Camill,8,0,30,22
1650201145898,MATH 10A,A01,083735,Patchell; Gregory David,11,0,30,19
1650201145898,MATH 10A,A02,083736,Patchell; Gregory David,28,0,30,2
1650201145898,MATH 10A,A03,083737,Patchell; Gregory David,26,0,30,4
1650201151928,MATH 10B,A01,083207,Staff,0,5,30,30
1650201151928,MATH 10B,A02,083208,Staff,0,5,30,30
1650201151928,MATH 10B,B01,083739,Staff,17,0,30,13
1650201151928,MATH 10B,B02,083740,Staff,29,0,30,1
1650201157960,MATH 18,A01,083743,Staff,8,0,30,22
1650201157960,MATH 18,A02,083744,Staff,28,0,30,2
1650201157960,MATH 18,A03,083745,Staff,23,0,30,7
1650201157960,MATH 18,A04,083746,Staff,27,0,30,3
1650201157960,MATH 18,B01,083748,Staff,0,10,30,30
1650201157960,MATH 18,B02,083749,Staff,0,7,30,30
1650201157960,MATH 18,B03,083750,Staff,0,7,30,30
1650201157960,MATH 18,B04,083751,Staff,0,8,30,30
1650201163991,MATH 20A,A01,083754,Staff,26,0,40,14
1650201170018,MATH 20B,A01,083756,Staff,0,6,30,30
1650201170018,MATH 20B,A02,083757,Staff,0,6,30,30
1650201176049,MATH 20C,A01,083760,Staff,0,12,30,30
1650201176049,MATH 20C,A02,083761,Staff,0,12,30,30
1650201176049,MATH 20C,B01,083762,Staff,14,0,30,16
1650201176049,MATH 20C,B02,083763,Staff,28,0,30,2
1650201182079,MATH 20D,A01,083765,Staff,1,2,30,29
1650201182079,MATH 20D,A02,083766,Staff,10,0,30,20
1650201182079,MATH 20D,A03,083767,Staff,28,0,30,2
1650201188108,MATH 20E,A01,083771,Staff,8,0,30,22
1650201188108,MATH 20E,A02,083772,Staff,20,0,30,10
1650201188108,MATH 20E,B01,083773,Staff,0,0,30,30
1650201188108,MATH 20E,B02,083774,Staff,12,0,30,18
1650201194140,MATH 103A,A01,083777,Staff,0,9,30,30
1650201194140,MATH 103A,A02,083778,Staff,0,10,30,30
1650201194140,MATH 103A,B01,083779,Staff,0,9,30,30
1650201194140,MATH 103A,B02,083780,Staff,0,9,30,30
1650201200165,MATH 105,A01,085443,Staff,0,17,30,30
1650201206197,MATH 109,A01,083213,Anzaldo; Leesa B,0,3,30,30
1650201206197,MATH 109,A02,083214,Anzaldo; Leesa B,0,6,30,30
1650201206197,MATH 109,B01,083215,Anzaldo; Leesa B,0,4,30,30
1650201206197,MATH 109,B02,083216,Anzaldo; Leesa B,0,4,30,30
1650201212223,MATH 142A,A01,083219,Chow; Bennett,0,12,30,30
1650201212223,MATH 142A,A02,083220,Chow; Bennett,0,11,30,30
1650201212223,MATH 142A,B01,083221,Chow; Bennett,0,11,30,30
1650201212223,MATH 142A,B02,083222,Chow; Bennett,0,12,30,30
1650201218247,MATH 193A,A01,083224,Staff,0,4,30,30
1650201218247,MATH 193A,A02,083225,Staff,0,4,30,30
1650201218247,MATH 193A,A03,083781,Staff,0,2,30,30
1650201218247,MATH 193A,A04,083782,Staff,0,1,30,30
1650201224274,MATH 197,001,091859,McAuley; Julian John,9998,0,9999,1
1650201230338,COGS 9,A01,083615,Staff,0,14,60,60
1650201236366,COGS 11,A01,083617,Boyle; Mary E. T.,24,0,40,16
1650201242396,COGS 13,A01,083071,Staff,0,30,40,40
1650201248422,COGS 14A,A01,092681,Staff,0,12,100,100
1650201254446,COGS 14B,A01,083073,Cheng; Tzu-Han,0,7,50,50
1650201260471,COGS 17,A01,092677,Staff,35,0,75,40
1650201266500,COGS 100,A01,083619,Staff,0,20,60,60
1650201272524,COGS 101A,A01,083621,Davis; Joshua Daniel,0,21,60,60
1650201278563,COGS 101B,A01,091572,Staff,6,0,60,54
1650201284591,COGS 101C,A01,083625,Delgado; Tania,20,0,30,10
1650201290615,COGS 107A,A01,083627,Boyle; Mary E. T.,0,7,60,60
1650201296643,COGS 118A,A01,083075,Staff,16,0,60,44
1650201302670,CSE 3,A50,083646,Miranda; Gregory Joseph,22,0,38,16
1650201302670,CSE 3,A51,083647,Miranda; Gregory Joseph,37,0,37,0
1650201308699,CSE 8A,A50,083650,Miranda; Gregory Joseph,0,17,40,40
1650201314730,CSE 11,A01,083080,Cao; Yingjun,0,68,40,40
1650201320756,CSE 12,A01,083652,Staff,0,7,100,100
1650201326793,CSE 15L,A01,083654,Staff,0,0,50,50
1650201326793,CSE 15L,A02,083655,Staff,6,0,50,44
1650201332816,CSE 20,A01,083657,Staff,53,0,80,27
1650201338843,CSE 30,A01,083084,Eldon; John,0,69,40,40
1650201344876,CSE 100,A01,083659,Cao; Yingjun,0,63,50,50
1650201350902,CSE 134B,A01,083661,Powell; Thomas Allan,0,27,65,65
1650201356927,CSE 140,A01,083663,Staff,1,0,75,74
1650201362953,CSE 140L,A01,083088,Eldon; John,0,4,75,75
1650201368987,CSE 175,A01,083665,Kumar; Rakesh,8,0,25,17
1650201375030,CSE 190,A00,092507,Dubnov; Shlomo,14,0,20,6
1650201381058,ECE 45,A01,083139,Staff,0,13,40,40
1650201387083,ECE 65,A50,083695,Staff,0,5,30,30
1650201393114,ECE 109,A01,091882,Touri; Behrouz,47,0,70,23
1650201399140,ECE 180,A00,083140,Abi Samra; Nicholas Camill,24,0,30,6
1650201399140,ECE 180,B00,083141,Abi Samra; Nicholas Camill,8,0,30,22
1650201405171,MATH 10A,A01,083735,Patchell; Gregory David,11,0,30,19
1650201405171,MATH 10A,A02,083736,Patchell; Gregory David,28,0,30,2
1650201405171,MATH 10A,A03,083737,Patchell; Gregory David,26,0,30,4
1650201411195,MATH 10B,A01,083207,Staff,0,5,30,30
1650201411195,MATH 10B,A02,083208,Staff,0,5,30,30
1650201411195,MATH 10B,B01,083739,Staff,17,0,30,13
1650201411195,MATH 10B,B02,083740,Staff,29,0,30,1
1650201417224,MATH 18,A01,083743,Staff,8,0,30,22
1650201417224,MATH 18,A02,083744,Staff,28,0,30,2
1650201417224,MATH 18,A03,083745,Staff,23,0,30,7
1650201417224,MATH 18,A04,083746,Staff,27,0,30,3
1650201417224,MATH 18,B01,083748,Staff,0,10,30,30
1650201417224,MATH 18,B02,083749,Staff,0,7,30,30
1650201417224,MATH 18,B03,083750,Staff,0,7,30,30
1650201417224,MATH 18,B04,083751,Staff,0,8,30,30
1650201423257,MATH 20A,A01,083754,Staff,26,0,40,14
1650201429289,MATH 20B,A01,083756,Staff,0,6,30,30
1650201429289,MATH 20B,A02,083757,Staff,0,6,30,30
1650201435314,MATH 20C,A01,083760,Staff,0,12,30,30
1650201435314,MATH 20C,A02,083761,Staff,0,12,30,30
1650201435314,MATH 20C,B01,083762,Staff,14,0,30,16
1650201435314,MATH 20C,B02,083763,Staff,28,0,30,2
1650201441342,MATH 20D,A01,083765,Staff,1,2,30,29
1650201441342,MATH 20D,A02,083766,Staff,10,0,30,20
1650201441342,MATH 20D,A03,083767,Staff,28,0,30,2
1650201447370,MATH 20E,A01,083771,Staff,8,0,30,22
1650201447370,MATH 20E,A02,083772,Staff,20,0,30,10
1650201447370,MATH 20E,B01,083773,Staff,0,0,30,30
1650201447370,MATH 20E,B02,083774,Staff,12,0,30,18
1650201453395,MATH 103A,A01,083777,Staff,0,9,30,30
1650201453395,MATH 103A,A02,083778,Staff,0,10,30,30
1650201453395,MATH 103A,B01,083779,Staff,0,9,30,30
1650201453395,MATH 103A,B02,083780,Staff,0,9,30,30
1650201459422,MATH 105,A01,085443,Staff,0,17,30,30
1650201465445,MATH 109,A01,083213,Anzaldo; Leesa B,0,3,30,30
1650201465445,MATH 109,A02,083214,Anzaldo; Leesa B,0,6,30,30
1650201465445,MATH 109,B01,083215,Anzaldo; Leesa B,0,4,30,30
1650201465445,MATH 109,B02,083216,Anzaldo; Leesa B,0,4,30,30
1650201471470,MATH 142A,A01,083219,Chow; Bennett,0,12,30,30
1650201471470,MATH 142A,A02,083220,Chow; Bennett,0,11,30,30
1650201471470,MATH 142A,B01,083221,Chow; Bennett,0,11,30,30
1650201471470,MATH 142A,B02,083222,Chow; Bennett,0,12,30,30
1650201477499,MATH 193A,A01,083224,Staff,0,4,30,30
1650201477499,MATH 193A,A02,083225,Staff,0,4,30,30
1650201477499,MATH 193A,A03,083781,Staff,0,2,30,30
1650201477499,MATH 193A,A04,083782,Staff,0,1,30,30
1650201483525,MATH 197,001,091859,McAuley; Julian John,9998,0,9999,1
1650201489594,COGS 9,A01,083615,Staff,0,14,60,60
1650201495620,COGS 11,A01,083617,Boyle; Mary E. T.,24,0,40,16
1650201501645,COGS 13,A01,083071,Staff,0,30,40,40
1650201507670,COGS 14A,A01,092681,Staff,0,12,100,100
1650201513697,COGS 14B,A01,083073,Cheng; Tzu-Han,0,7,50,50
1650201519722,COGS 17,A01,092677,Staff,35,0,75,40
1650201525746,COGS 100,A01,083619,Staff,0,20,60,60
1650201531775,COGS 101A,A01,083621,Davis; Joshua Daniel,0,21,60,60
1650201537798,COGS 101B,A01,091572,Staff,6,0,60,54
1650201543840,COGS 101C,A01,083625,Delgado; Tania,20,0,30,10
1650201549869,COGS 107A,A01,083627,Boyle; Mary E. T.,0,7,60,60
1650201555899,COGS 118A,A01,083075,Staff,16,0,60,44
1650201561926,CSE 3,A50,083646,Miranda; Gregory Joseph,22,0,38,16
1650201561926,CSE 3,A51,083647,Miranda; Gregory Joseph,37,0,37,0
1650201567960,CSE 8A,A50,083650,Miranda; Gregory Joseph,0,17,40,40
1650201573984,CSE 11,A01,083080,Cao; Yingjun,0,68,40,40
1650201580028,CSE 12,A01,083652,Staff,0,7,100,100
1650201586059,CSE 15L,A01,083654,Staff,0,0,50,50
1650201586059,CSE 15L,A02,083655,Staff,6,0,50,44
1650201592085,CSE 20,A01,083657,Staff,53,0,80,27
1650201598111,CSE 30,A01,083084,Eldon; John,0,69,40,40
1650201604140,CSE 100,A01,083659,Cao; Yingjun,0,63,50,50
1650201610253,CSE 134B,A01,083661,Powell; Thomas Allan,0,27,65,65
1650201616281,CSE 140,A01,083663,Staff,1,0,75,74
1650201622306,CSE 140L,A01,083088,Eldon; John,0,4,75,75
1650201628333,CSE 175,A01,083665,Kumar; Rakesh,8,0,25,17
1650201634357,CSE 190,A00,092507,Dubnov; Shlomo,14,0,20,6
1650201640387,ECE 45,A01,083139,Staff,0,13,40,40
1650201646416,ECE 65,A50,083695,Staff,0,5,30,30
1650201652442,ECE 109,A01,091882,Touri; Behrouz,47,0,70,23
1650201658469,ECE 180,A00,083140,Abi Samra; Nicholas Camill,24,0,30,6
1650201658469,ECE 180,B00,083141,Abi Samra; Nicholas Camill,8,0,30,22
1650201664500,MATH 10A,A01,083735,Patchell; Gregory David,11,0,30,19
1650201664500,MATH 10A,A02,083736,Patchell; Gregory David,28,0,30,2
1650201664500,MATH 10A,A03,083737,Patchell; Gregory David,26,0,30,4
1650201670527,MATH 10B,A01,083207,Staff,0,5,30,30
1650201670527,MATH 10B,A02,083208,Staff,0,5,30,30
1650201670527,MATH 10B,B01,083739,Staff,17,0,30,13
1650201670527,MATH 10B,B02,083740,Staff,29,0,30,1
1650201676561,MATH 18,A01,083743,Staff,8,0,30,22
1650201676561,MATH 18,A02,083744,Staff,28,0,30,2
1650201676561,MATH 18,A03,083745,Staff,23,0,30,7
1650201676561,MATH 18,A04,083746,Staff,27,0,30,3
1650201676561,MATH 18,B01,083748,Staff,0,10,30,30
1650201676561,MATH 18,B02,083749,Staff,0,7,30,30
1650201676561,MATH 18,B03,083750,Staff,0,7,30,30
1650201676561,MATH 18,B04,083751,Staff,0,8,30,30
1650201682586,MATH 20A,A01,083754,Staff,26,0,40,14
1650201688610,MATH 20B,A01,083756,Staff,0,6,30,30
1650201688610,MATH 20B,A02,083757,Staff,0,6,30,30
1650201694636,MATH 20C,A01,083760,Staff,0,12,30,30
1650201694636,MATH 20C,A02,083761,Staff,0,12,30,30
1650201694636,MATH 20C,B01,083762,Staff,14,0,30,16
1650201694636,MATH 20C,B02,083763,Staff,28,0,30,2
1650201700663,MATH 20D,A01,083765,Staff,1,2,30,29
1650201700663,MATH 20D,A02,083766,Staff,10,0,30,20
1650201700663,MATH 20D,A03,083767,Staff,28,0,30,2
1650201706692,MATH 20E,A01,083771,Staff,8,0,30,22
1650201706692,MATH 20E,A02,083772,Staff,20,0,30,10
1650201706692,MATH 20E,B01,083773,Staff,0,0,30,30
1650201706692,MATH 20E,B02,083774,Staff,12,0,30,18
1650201712721,MATH 103A,A01,083777,Staff,0,9,30,30
1650201712721,MATH 103A,A02,083778,Staff,0,10,30,30
1650201712721,MATH 103A,B01,083779,Staff,0,9,30,30
1650201712721,MATH 103A,B02,083780,Staff,0,9,30,30
1650201718748,MATH 105,A01,085443,Staff,0,17,30,30
1650201724801,MATH 109,A01,083213,Anzaldo; Leesa B,0,3,30,30
1650201724801,MATH 109,A02,083214,Anzaldo; Leesa B,0,6,30,30
1650201724801,MATH 109,B01,083215,Anzaldo; Leesa B,0,4,30,30
1650201724801,MATH 109,B02,083216,Anzaldo; Leesa B,0,4,30,30
1650201730831,MATH 142A,A01,083219,Chow; Bennett,0,12,30,30
1650201730831,MATH 142A,A02,083220,Chow; Bennett,0,11,30,30
1650201730831,MATH 142A,B01,083221,Chow; Bennett,0,11,30,30
1650201730831,MATH 142A,B02,083222,Chow; Bennett,0,12,30,30
1650201736856,MATH 193A,A01,083224,Staff,0,4,30,30
1650201736856,MATH 193A,A02,083225,Staff,0,4,30,30
1650201736856,MATH 193A,A03,083781,Staff,0,2,30,30
1650201736856,MATH 193A,A04,083782,Staff,0,1,30,30
1650201742883,MATH 197,001,091859,McAuley; Julian John,9998,0,9999,1
1650201748949,COGS 9,A01,083615,Staff,0,14,60,60
1650201754975,COGS 11,A01,083617,Boyle; Mary E. T.,24,0,40,16
1650201760999,COGS 13,A01,083071,Staff,0,30,40,40
1650201767028,COGS 14A,A01,092681,Staff,0,12,100,100
1650201773055,COGS 14B,A01,083073,Cheng; Tzu-Han,0,7,50,50
1650201779079,COGS 17,A01,092677,Staff,35,0,75,40
1650201785105,COGS 100,A01,083619,Staff,0,20,60,60
1650201791130,COGS 101A,A01,083621,Davis; Joshua Daniel,0,21,60,60
1650201797153,COGS 101B,A01,091572,Staff,6,0,60,54
1650201803180,COGS 101C,A01,083625,Delgado; Tania,20,0,30,10
1650201809204,COGS 107A,A01,083627,Boyle; Mary E. T.,0,7,60,60
1650201815228,COGS 118A,A01,083075,Staff,16,0,60,44
1650201821253,CSE 3,A50,083646,Miranda; Gregory Joseph,22,0,38,16
1650201821253,CSE 3,A51,083647,Miranda; Gregory Joseph,37,0,37,0
1650201827281,CSE 8A,A50,083650,Miranda; Gregory Joseph,0,17,40,40
1650201833309,CSE 11,A01,083080,Cao; Yingjun,0,68,40,40
1650201839336,CSE 12,A01,083652,Staff,0,7,100,100
1650201845362,CSE 15L,A01,083654,Staff,0,0,50,50
1650201845362,CSE 15L,A02,083655,Staff,6,0,50,44
1650201851390,CSE 20,A01,083657,Staff,53,0,80,27
1650201857415,CSE 30,A01,083084,Eldon; John,0,69,40,40
1650201863438,CSE 100,A01,083659,Cao; Yingjun,0,63,50,50
1650201869462,CSE 134B,A01,083661,Powell; Thomas Allan,0,27,65,65
1650201875485,CSE 140,A01,083663,Staff,1,0,75,74
1650201881509,CSE 140L,A01,083088,Eldon; John,0,4,75,75
1650201887533,CSE 175,A01,083665,Kumar; Rakesh,8,0,25,17
1650201893555,CSE 190,A00,092507,Dubnov; Shlomo,14,0,20,6
1650201899582,ECE 45,A01,083139,Staff,0,13,40,40
1650201905608,ECE 65,A50,083695,Staff,0,5,30,30
1650201911648,ECE 109,A01,091882,Touri; Behrouz,47,0,70,23
1650201917674,ECE 180,A00,083140,Abi Samra; Nicholas Camill,24,0,30,6
1650201917674,ECE 180,B00,083141,Abi Samra; Nicholas Camill,8,0,30,22
1650201923717,MATH 10A,A01,083735,Patchell; Gregory David,11,0,30,19
1650201923717,MATH 10A,A02,083736,Patchell; Gregory David,28,0,30,2
1650201923717,MATH 10A,A03,083737,Patchell; Gregory David,26,0,30,4
1650201929747,MATH 10B,A01,083207,Staff,0,5,30,30
1650201929747,MATH 10B,A02,083208,Staff,0,5,30,30
1650201929747,MATH 10B,B01,083739,Staff,17,0,30,13
1650201929747,MATH 10B,B02,083740,Staff,29,0,30,1
1650201935773,MATH 18,A01,083743,Staff,8,0,30,22
1650201935773,MATH 18,A02,083744,Staff,28,0,30,2
1650201935773,MATH 18,A03,083745,Staff,23,0,30,7
1650201935773,MATH 18,A04,083746,Staff,27,0,30,3
1650201935773,MATH 18,B01,083748,Staff,0,10,30,30
1650201935773,MATH 18,B02,083749,Staff,0,7,30,30
1650201935773,MATH 18,B03,083750,Staff,0,7,30,30
1650201935773,MATH 18,B04,083751,Staff,0,8,30,30
1650201941796,MATH 20A,A01,083754,Staff,26,0,40,14
1650201947824,MATH 20B,A01,083756,Staff,0,6,30,30
1650201947824,MATH 20B,A02,083757,Staff,0,6,30,30
1650201953850,MATH 20C,A01,083760,Staff,0,12,30,30
1650201953850,MATH 20C,A02,083761,Staff,0,12,30,30
1650201953850,MATH 20C,B01,083762,Staff,14,0,30,16
1650201953850,MATH 20C,B02,083763,Staff,28,0,30,2
1650201959874,MATH 20D,A01,083765,Staff,1,2,30,29
1650201959874,MATH 20D,A02,083766,Staff,10,0,30,20
1650201959874,MATH 20D,A03,083767,Staff,28,0,30,2
1650201965899,MATH 20E,A01,083771,Staff,8,0,30,22
1650201965899,MATH 20E,A02,083772,Staff,20,0,30,10
1650201965899,MATH 20E,B01,083773,Staff,0,0,30,30
1650201965899,MATH 20E,B02,083774,Staff,12,0,30,18
1650201971925,MATH 103A,A01,083777,Staff,0,9,30,30
1650201971925,MATH 103A,A02,083778,Staff,0,10,30,30
1650201971925,MATH 103A,B01,083779,Staff,0,9,30,30
1650201971925,MATH 103A,B02,083780,Staff,0,9,30,30
1650201977950,MATH 105,A01,085443,Staff,0,17,30,30
1650201983978,MATH 109,A01,083213,Anzaldo; Leesa B,0,3,30,30
1650201983978,MATH 109,A02,083214,Anzaldo; Leesa B,0,6,30,30
1650201983978,MATH 109,B01,083215,Anzaldo; Leesa B,0,4,30,30
1650201983978,MATH 109,B02,083216,Anzaldo; Leesa B,0,4,30,30
1650201990002,MATH 142A,A01,083219,Chow; Bennett,0,12,30,30
1650201990002,MATH 142A,A02,083220,Chow; Bennett,0,11,30,30
1650201990002,MATH 142A,B01,083221,Chow; Bennett,0,11,30,30
1650201990002,MATH 142A,B02,083222,Chow; Bennett,0,12,30,30
1650201996042,MATH 193A,A01,083224,Staff,0,4,30,30
1650201996042,MATH 193A,A02,083225,Staff,0,4,30,30
1650201996042,MATH 193A,A03,083781,Staff,0,2,30,30
1650201996042,MATH 193A,A04,083782,Staff,0,1,30,30
1650202002075,MATH 197,001,091859,McAuley; Julian John,9998,0,9999,1
1650202008141,COGS 9,A01,083615,Staff,0,14,60,60
1650202014169,COGS 11,A01,083617,Boyle; Mary E. T.,24,0,40,16
1650202020196,COGS 13,A01,083071,Staff,0,30,40,40
1650202026223,COGS 14A,A01,092681,Staff,0,12,100,100
1650202032247,COGS 14B,A01,083073,Cheng; Tzu-Han,0,7,50,50
1650202038274,COGS 17,A01,092677,Staff,35,0,75,40
1650202044297,COGS 100,A01,083619,Staff,0,20,60,60
1650202050321,COGS 101A,A01,083621,Davis; Joshua Daniel,0,21,60,60
1650202056351,COGS 101B,A01,091572,Staff,6,0,60,54
1650202062378,COGS 101C,A01,083625,Delgado; Tania,20,0,30,10
1650202068406,COGS 107A,A01,083627,Boyle; Mary E. T.,0,7,60,60
1650202074435,COGS 118A,A01,083075,Staff,16,0,60,44
1650202080463,CSE 3,A50,083646,Miranda; Gregory Joseph,22,0,38,16
1650202080463,CSE 3,A51,083647,Miranda; Gregory Joseph,37,0,37,0
1650202086496,CSE 8A,A50,083650,Miranda; Gregory Joseph,0,17,40,40
1650202092518,CSE 11,A01,083080,Cao; Yingjun,0,68,40,40
1650202098558,CSE 12,A01,083652,Staff,0,7,100,100
1650202104585,CSE 15L,A01,083654,Staff,0,0,50,50
1650202104585,CSE 15L,A02,083655,Staff,6,0,50,44
1650202110614,CSE 20,A01,083657,Staff,53,0,80,27
1650202116638,CSE 30,A01,083084,Eldon; John,0,69,40,40
1650202122670,CSE 100,A01,083659,Cao; Yingjun,0,63,50,50
1650202128697,CSE 134B,A01,083661,Powell; Thomas Allan,0,27,65,65
1650202134731,CSE 140,A01,083663,Staff,1,0,75,74
1650202140758,CSE 140L,A01,083088,Eldon; John,0,4,75,75
1650202146785,CSE 175,A01,083665,Kumar; Rakesh,8,0,25,17
1650202152809,CSE 190,A00,092507,Dubnov; Shlomo,14,0,20,6
1650202158833,ECE 45,A01,083139,Staff,0,13,40,40
1650202164856,ECE 65,A50,083695,Staff,0,5,30,30
1650202170882,ECE 109,A01,091882,Touri; Behrouz,47,0,70,23
1650202176912,ECE 180,A00,083140,Abi Samra; Nicholas Camill,24,0,30,6
1650202176912,ECE 180,B00,083141,Abi Samra; Nicholas Camill,8,0,30,22
1650202182937,MATH 10A,A01,083735,Patchell; Gregory David,11,0,30,19
1650202182937,MATH 10A,A02,083736,Patchell; Gregory David,28,0,30,2
1650202182937,MATH 10A,A03,083737,Patchell; Gregory David,26,0,30,4
1650202188974,MATH 10B,A01,083207,Staff,0,5,30,30
1650202188974,MATH 10B,A02,083208,Staff,0,5,30,30
1650202188974,MATH 10B,B01,083739,Staff,17,0,30,13
1650202188974,MATH 10B,B02,083740,Staff,29,0,30,1
1650202195012,MATH 18,A01,083743,Staff,8,0,30,22
1650202195012,MATH 18,A02,083744,Staff,28,0,30,2
1650202195012,MATH 18,A03,083745,Staff,23,0,30,7
1650202195012,MATH 18,A04,083746,Staff,27,0,30,3
1650202195012,MATH 18,B01,083748,Staff,0,10,30,30
1650202195012,MATH 18,B02,083749,Staff,0,7,30,30
1650202195012,MATH 18,B03,083750,Staff,0,7,30,30
1650202195012,MATH 18,B04,083751,Staff,0,8,30,30
1650202201038,MATH 20A,A01,083754,Staff,26,0,40,14
1650202207153,MATH 20B,A01,083756,Staff,0,6,30,30
1650202207153,MATH 20B,A02,083757,Staff,0,6,30,30
1650202213183,MATH 20C,A01,083760,Staff,0,12,30,30
1650202213183,MATH 20C,A02,083761,Staff,0,12,30,30
1650202213183,MATH 20C,B01,083762,Staff,14,0,30,16
1650202213183,MATH 20C,B02,083763,Staff,28,0,30,2
1650202219206,MATH 20D,A01,083765,Staff,1,2,30,29
1650202219206,MATH 20D,A02,083766,Staff,10,0,30,20
1650202219206,MATH 20D,A03,083767,Staff,28,0,30,2
1650202225233,MATH 20E,A01,083771,Staff,8,0,30,22
1650202225233,MATH 20E,A02,083772,Staff,20,0,30,10
1650202225233,MATH 20E,B01,083773,Staff,0,0,30,30
1650202225233,MATH 20E,B02,083774,Staff,12,0,30,18
1650202231260,MATH 103A,A01,083777,Staff,0,9,30,30
1650202231260,MATH 103A,A02,083778,Staff,0,10,30,30
1650202231260,MATH 103A,B01,083779,Staff,0,9,30,30
1650202231260,MATH 103A,B02,083780,Staff,0,9,30,30
1650202237288,MATH 105,A01,085443,Staff,0,17,30,30
1650202243317,MATH 109,A01,083213,Anzaldo; Leesa B,0,3,30,30
1650202243317,MATH 109,A02,083214,Anzaldo; Leesa B,0,6,30,30
1650202243317,MATH 109,B01,083215,Anzaldo; Leesa B,0,4,30,30
1650202243317,MATH 109,B02,083216,Anzaldo; Leesa B,0,4,30,30
1650202249344,MATH 142A,A01,083219,Chow; Bennett,0,12,30,30
1650202249344,MATH 142A,A02,083220,Chow; Bennett,0,11,30,30
1650202249344,MATH 142A,B01,083221,Chow; Bennett,0,11,30,30
1650202249344,MATH 142A,B02,083222,Chow; Bennett,0,12,30,30
1650202255373,MATH 193A,A01,083224,Staff,0,4,30,30
1650202255373,MATH 193A,A02,083225,Staff,0,4,30,30
1650202255373,MATH 193A,A03,083781,Staff,0,2,30,30
1650202255373,MATH 193A,A04,083782,Staff,0,1,30,30
1650202261401,MATH 197,001,091859,McAuley; Julian John,9998,0,9999,1
1650202267459,COGS 9,A01,083615,Staff,0,14,60,60
1650202273481,COGS 11,A01,083617,Boyle; Mary E. T.,24,0,40,16
1650202279515,COGS 13,A01,083071,Staff,0,30,40,40
1650202285539,COGS 14A,A01,092681,Staff,0,12,100,100
1650202291566,COGS 14B,A01,083073,Cheng; Tzu-Han,0,7,50,50
1650202297589,COGS 17,A01,092677,Staff,35,0,75,40
1650202303613,COGS 100,A01,083619,Staff,0,20,60,60
1650202309644,COGS 101A,A01,083621,Davis; Joshua Daniel,0,21,60,60
1650202315670,COGS 101B,A01,091572,Staff,6,0,60,54
1650202321699,COGS 101C,A01,083625,Delgado; Tania,20,0,30,10
1650202327723,COGS 107A,A01,083627,Boyle; Mary E. T.,0,7,60,60
1650202333748,COGS 118A,A01,083075,Staff,16,0,60,44
1650202339775,CSE 3,A50,083646,Miranda; Gregory Joseph,22,0,38,16
1650202339775,CSE 3,A51,083647,Miranda; Gregory Joseph,37,0,37,0
1650202345806,CSE 8A,A50,083650,Miranda; Gregory Joseph,0,17,40,40
1650202351834,CSE 11,A01,083080,Cao; Yingjun,0,68,40,40
1650202357859,CSE 12,A01,083652,Staff,0,7,100,100
1650202363884,CSE 15L,A01,083654,Staff,0,0,50,50
1650202363884,CSE 15L,A02,083655,Staff,6,0,50,44
1650202369922,CSE 20,A01,083657,Staff,53,0,80,27
1650202375951,CSE 30,A01,083084,Eldon; John,0,69,40,40
1650202381975,CSE 100,A01,083659,Cao; Yingjun,0,63,50,50
1650202388005,CSE 134B,A01,083661,Powell; Thomas Allan,0,27,65,65
1650202394032,CSE 140,A01,083663,Staff,1,0,75,74
1650202400061,CSE 140L,A01,083088,Eldon; John,0,4,75,75
1650202406088,CSE 175,A01,083665,Kumar; Rakesh,8,0,25,17
1650202412120,CSE 190,A00,092507,Dubnov; Shlomo,14,0,20,6
1650202418147,ECE 45,A01,083139,Staff,0,13,40,40
1650202424176,ECE 65,A50,083695,Staff,0,5,30,30
1650202430205,ECE 109,A01,091882,Touri; Behrouz,47,0,70,23
1650202436234,ECE 180,A00,083140,Abi Samra; Nicholas Camill,24,0,30,6
1650202436234,ECE 180,B00,083141,Abi Samra; Nicholas Camill,8,0,30,22
1650202442264,MATH 10A,A01,083735,Patchell; Gregory David,11,0,30,19
1650202442264,MATH 10A,A02,083736,Patchell; Gregory David,28,0,30,2
1650202442264,MATH 10A,A03,083737,Patchell; Gregory David,26,0,30,4
1650202448290,MATH 10B,A01,083207,Staff,0,5,30,30
1650202448290,MATH 10B,A02,083208,Staff,0,5,30,30
1650202448290,MATH 10B,B01,083739,Staff,17,0,30,13
1650202448290,MATH 10B,B02,083740,Staff,29,0,30,1
1650202454315,MATH 18,A01,083743,Staff,8,0,30,22
1650202454315,MATH 18,A02,083744,Staff,28,0,30,2
1650202454315,MATH 18,A03,083745,Staff,23,0,30,7
1650202454315,MATH 18,A04,083746,Staff,27,0,30,3
1650202454315,MATH 18,B01,083748,Staff,0,10,30,30
1650202454315,MATH 18,B02,083749,Staff,0,7,30,30
1650202454315,MATH 18,B03,083750,Staff,0,7,30,30
1650202454315,MATH 18,B04,083751,Staff,0,8,30,30
1650202460344,MATH 20A,A01,083754,Staff,26,0,40,14
1650202466373,MATH 20B,A01,083756,Staff,0,6,30,30
1650202466373,MATH 20B,A02,083757,Staff,0,6,30,30
1650202472398,MATH 20C,A01,083760,Staff,0,12,30,30
1650202472398,MATH 20C,A02,083761,Staff,0,12,30,30
1650202472398,MATH 20C,B01,083762,Staff,14,0,30,16
1650202472398,MATH 20C,B02,083763,Staff,28,0,30,2
1650202478425,MATH 20D,A01,083765,Staff,1,2,30,29
1650202478425,MATH 20D,A02,083766,Staff,10,0,30,20
1650202478425,MATH 20D,A03,083767,Staff,28,0,30,2
1650202484458,MATH 20E,A01,083771,Staff,8,0,30,22
1650202484458,MATH 20E,A02,083772,Staff,20,0,30,10
1650202484458,MATH 20E,B01,083773,Staff,0,0,30,30
1650202484458,MATH 20E,B02,083774,Staff,12,0,30,18
1650202490482,MATH 103A,A01,083777,Staff,0,9,30,30
1650202490482,MATH 103A,A02,083778,Staff,0,10,30,30
1650202490482,MATH 103A,B01,083779,Staff,0,9,30,30
1650202490482,MATH 103A,B02,083780,Staff,0,9,30,30
1650202496511,MATH 105,A01,085443,Staff,0,17,30,30
1650202502537,MATH 109,A01,083213,Anzaldo; Leesa B,0,3,30,30
1650202502537,MATH 109,A02,083214,Anzaldo; Leesa B,0,6,30,30
1650202502537,MATH 109,B01,083215,Anzaldo; Leesa B,0,4,30,30
1650202502537,MATH 109,B02,083216,Anzaldo; Leesa B,0,4,30,30
1650202508563,MATH 142A,A01,083219,Chow; Bennett,0,12,30,30
1650202508563,MATH 142A,A02,083220,Chow; Bennett,0,11,30,30
1650202508563,MATH 142A,B01,083221,Chow; Bennett,0,11,30,30
1650202508563,MATH 142A,B02,083222,Chow; Bennett,0,12,30,30
1650202514588,MATH 193A,A01,083224,Staff,0,4,30,30
1650202514588,MATH 193A,A02,083225,Staff,0,4,30,30
1650202514588,MATH 193A,A03,083781,Staff,0,2,30,30
1650202514588,MATH 193A,A04,083782,Staff,0,1,30,30
1650202520613,MATH 197,001,091859,McAuley; Julian John,9998,0,9999,1
1650202526667,COGS 9,A01,083615,Staff,0,14,60,60
1650202532692,COGS 11,A01,083617,Boyle; Mary E. T.,24,0,40,16
1650202538714,COGS 13,A01,083071,Staff,0,30,40,40
1650202544740,COGS 14A,A01,092681,Staff,0,12,100,100
1650202550766,COGS 14B,A01,083073,Cheng; Tzu-Han,0,7,50,50
1650202556795,COGS 17,A01,092677,Staff,35,0,75,40
1650202562825,COGS 100,A01,083619,Staff,0,20,60,60
1650202568851,COGS 101A,A01,083621,Davis; Joshua Daniel,0,21,60,60
1650202574875,COGS 101B,A01,091572,Staff,6,0,60,54
1650202580901,COGS 101C,A01,083625,Delgado; Tania,20,0,30,10
1650202586926,COGS 107A,A01,083627,Boyle; Mary E. T.,0,7,60,60
1650202592949,COGS 118A,A01,083075,Staff,16,0,60,44
1650202598975,CSE 3,A50,083646,Miranda; Gregory Joseph,22,0,38,16
1650202598975,CSE 3,A51,083647,Miranda; Gregory Joseph,37,0,37,0
1650202605001,CSE 8A,A50,083650,Miranda; Gregory Joseph,0,17,40,40
1650202611027,CSE 11,A01,083080,Cao; Yingjun,0,68,40,40
1650202617053,CSE 12,A01,083652,Staff,0,7,100,100
1650202623077,CSE 15L,A01,083654,Staff,0,0,50,50
1650202623077,CSE 15L,A02,083655,Staff,6,0,50,44
1650202629104,CSE 20,A01,083657,Staff,53,0,80,27
1650202635130,CSE 30,A01,083084,Eldon; John,0,69,40,40
1650202641155,CSE 100,A01,083659,Cao; Yingjun,0,63,50,50
1650202647180,CSE 134B,A01,083661,Powell; Thomas Allan,0,27,65,65
1650202653204,CSE 140,A01,083663,Staff,1,0,75,74
1650202659229,CSE 140L,A01,083088,Eldon; John,0,4,75,75
1650202665253,CSE 175,A01,083665,Kumar; Rakesh,8,0,25,17
1650202671279,CSE 190,A00,092507,Dubnov; Shlomo,14,0,20,6
1650202677307,ECE 45,A01,083139,Staff,0,13,40,40
1650202683332,ECE 65,A50,083695,Staff,0,5,30,30
1650202689358,ECE 109,A01,091882,Touri; Behrouz,47,0,70,23
1650202695383,ECE 180,A00,083140,Abi Samra; Nicholas Camill,24,0,30,6
1650202695383,ECE 180,B00,083141,Abi Samra; Nicholas Camill,8,0,30,22
1650202701408,MATH 10A,A01,083735,Patchell; Gregory David,11,0,30,19
1650202701408,MATH 10A,A02,083736,Patchell; Gregory David,28,0,30,2
1650202701408,MATH 10A,A03,083737,Patchell; Gregory David,26,0,30,4
1650202707431,MATH 10B,A01,083207,Staff,0,5,30,30
1650202707431,MATH 10B,A02,083208,Staff,0,5,30,30
1650202707431,MATH 10B,B01,083739,Staff,17,0,30,13
1650202707431,MATH 10B,B02,083740,Staff,29,0,30,1
1650202713458,MATH 18,A01,083743,Staff,8,0,30,22
1650202713458,MATH 18,A02,083744,Staff,28,0,30,2
1650202713458,MATH 18,A03,083745,Staff,23,0,30,7
1650202713458,MATH 18,A04,083746,Staff,27,0,30,3
1650202713458,MATH 18,B01,083748,Staff,0,10,30,30
1650202713458,MATH 18,B02,083749,Staff,0,7,30,30
1650202713458,MATH 18,B03,083750,Staff,0,7,30,30
1650202713458,MATH 18,B04,083751,Staff,0,8,30,30
1650202719482,MATH 20A,A01,083754,Staff,26,0,40,14
1650202725505,MATH 20B,A01,083756,Staff,0,6,30,30
1650202725505,MATH 20B,A02,083757,Staff,0,6,30,30
1650202731534,MATH 20C,A01,083760,Staff,0,12,30,30
1650202731534,MATH 20C,A02,083761,Staff,0,12,30,30
1650202731534,MATH 20C,B01,083762,Staff,14,0,30,16
1650202731534,MATH 20C,B02,083763,Staff,28,0,30,2
1650202737560,MATH 20D,A01,083765,Staff,1,2,30,29
1650202737560,MATH 20D,A02,083766,Staff,10,0,30,20
1650202737560,MATH 20D,A03,083767,Staff,28,0,30,2
1650202743586,MATH 20E,A01,083771,Staff,8,0,30,22
1650202743586,MATH 20E,A02,083772,Staff,20,0,30,10
1650202743586,MATH 20E,B01,083773,Staff,0,0,30,30
1650202743586,MATH 20E,B02,083774,Staff,12,0,30,18
1650202750221,MATH 103A,A01,083777,Staff,0,9,30,30
1650202750221,MATH 103A,A02,083778,Staff,0,10,30,30
1650202750221,MATH 103A,B01,083779,Staff,0,9,30,30
1650202750221,MATH 103A,B02,083780,Staff,0,9,30,30
1650202756244,MATH 105,A01,085443,Staff,0,17,30,30
1650202762268,MATH 109,A01,083213,Anzaldo; Leesa B,0,3,30,30
1650202762268,MATH 109,A02,083214,Anzaldo; Leesa B,0,6,30,30
1650202762268,MATH 109,B01,083215,Anzaldo; Leesa B,0,4,30,30
1650202762268,MATH 109,B02,083216,Anzaldo; Leesa B,0,4,30,30
1650202768297,MATH 142A,A01,083219,Chow; Bennett,0,12,30,30
1650202768297,MATH 142A,A02,083220,Chow; Bennett,0,11,30,30
1650202768297,MATH 142A,B01,083221,Chow; Bennett,0,11,30,30
1650202768297,MATH 142A,B02,083222,Chow; Bennett,0,12,30,30
1650202774323,MATH 193A,A01,083224,Staff,0,4,30,30
1650202774323,MATH 193A,A02,083225,Staff,0,4,30,30
1650202774323,MATH 193A,A03,083781,Staff,0,2,30,30
1650202774323,MATH 193A,A04,083782,Staff,0,1,30,30
1650202780349,MATH 197,001,091859,McAuley; Julian John,9998,0,9999,1
1650202786414,COGS 9,A01,083615,Staff,0,14,60,60
1650202792437,COGS 11,A01,083617,Boyle; Mary E. T.,24,0,40,16
1650202798548,COGS 13,A01,083071,Staff,0,30,40,40
1650202804580,COGS 14A,A01,092681,Staff,0,12,100,100
1650202810605,COGS 14B,A01,083073,Cheng; Tzu-Han,0,7,50,50
1650202816633,COGS 17,A01,092677,Staff,35,0,75,40
1650202822657,COGS 100,A01,083619,Staff,0,20,60,60
1650202828681,COGS 101A,A01,083621,Davis; Joshua Daniel,0,21,60,60
1650202834708,COGS 101B,A01,091572,Staff,6,0,60,54
1650202840732,COGS 101C,A01,083625,Delgado; Tania,20,0,30,10
1650202846763,COGS 107A,A01,083627,Boyle; Mary E. T.,0,7,60,60
1650202852791,COGS 118A,A01,083075,Staff,16,0,60,44
1650202858817,CSE 3,A50,083646,Miranda; Gregory Joseph,22,0,38,16
1650202858817,CSE 3,A51,083647,Miranda; Gregory Joseph,37,0,37,0
1650202864845,CSE 8A,A50,083650,Miranda; Gregory Joseph,0,17,40,40
1650202870871,CSE 11,A01,083080,Cao; Yingjun,0,68,40,40
1650202876896,CSE 12,A01,083652,Staff,0,7,100,100
1650202882920,CSE 15L,A01,083654,Staff,0,0,50,50
1650202882920,CSE 15L,A02,083655,Staff,6,0,50,44
1650202888945,CSE 20,A01,083657,Staff,53,0,80,27
1650202894970,CSE 30,A01,083084,Eldon; John,0,69,40,40
1650202901003,CSE 100,A01,083659,Cao; Yingjun,0,63,50,50
1650202907037,CSE 134B,A01,083661,Powell; Thomas Allan,0,27,65,65
1650202913064,CSE 140,A01,083663,Staff,1,0,75,74
1650202919093,CSE 140L,A01,083088,Eldon; John,0,4,75,75
1650202925117,CSE 175,A01,083665,Kumar; Rakesh,8,0,25,17
1650202931141,CSE 190,A00,092507,Dubnov; Shlomo,14,0,20,6
1650202937168,ECE 45,A01,083139,Staff,0,13,40,40
1650202943192,ECE 65,A50,083695,Staff,0,5,30,30
1650202949220,ECE 109,A01,091882,Touri; Behrouz,47,0,70,23
1650202955259,ECE 180,A00,083140,Abi Samra; Nicholas Camill,24,0,30,6
1650202955259,ECE 180,B00,083141,Abi Samra; Nicholas Camill,8,0,30,22
1650202961285,MATH 10A,A01,083735,Patchell; Gregory David,11,0,30,19
1650202961285,MATH 10A,A02,083736,Patchell; Gregory David,28,0,30,2
1650202961285,MATH 10A,A03,083737,Patchell; Gregory David,26,0,30,4
1650202967308,MATH 10B,A01,083207,Staff,0,5,30,30
1650202967308,MATH 10B,A02,083208,Staff,0,5,30,30
1650202967308,MATH 10B,B01,083739,Staff,17,0,30,13
1650202967308,MATH 10B,B02,083740,Staff,29,0,30,1
1650202973338,MATH 18,A01,083743,Staff,8,0,30,22
1650202973338,MATH 18,A02,083744,Staff,28,0,30,2
1650202973338,MATH 18,A03,083745,Staff,23,0,30,7
1650202973338,MATH 18,A04,083746,Staff,27,0,30,3
1650202973338,MATH 18,B01,083748,Staff,0,10,30,30
1650202973338,MATH 18,B02,083749,Staff,0,7,30,30
1650202973338,MATH 18,B03,083750,Staff,0,7,30,30
1650202973338,MATH 18,B04,083751,Staff,0,8,30,30
1650202979361,MATH 20A,A01,083754,Staff,26,0,40,14
1650202985386,MATH 20B,A01,083756,Staff,0,6,30,30
1650202985386,MATH 20B,A02,083757,Staff,0,6,30,30
1650202991412,MATH 20C,A01,083760,Staff,0,12,30,30
1650202991412,MATH 20C,A02,083761,Staff,0,12,30,30
1650202991412,MATH 20C,B01,083762,Staff,14,0,30,16
1650202991412,MATH 20C,B02,083763,Staff,28,0,30,2
1650202997437,MATH 20D,A01,083765,Staff,1,2,30,29
1650202997437,MATH 20D,A02,083766,Staff,10,0,30,20
1650202997437,MATH 20D,A03,083767,Staff,28,0,30,2
1650203003470,MATH 20E,A01,083771,Staff,8,0,30,22
1650203003470,MATH 20E,A02,083772,Staff,20,0,30,10
1650203003470,MATH 20E,B01,083773,Staff,0,0,30,30
1650203003470,MATH 20E,B02,083774,Staff,12,0,30,18
1650203009495,MATH 103A,A01,083777,Staff,0,9,30,30
1650203009495,MATH 103A,A02,083778,Staff,0,10,30,30
1650203009495,MATH 103A,B01,083779,Staff,0,9,30,30
1650203009495,MATH 103A,B02,083780,Staff,0,9,30,30
1650203015520,MATH 105,A01,085443,Staff,0,17,30,30
1650203021544,MATH 109,A01,083213,Anzaldo; Leesa B,0,3,30,30
1650203021544,MATH 109,A02,083214,Anzaldo; Leesa B,0,6,30,30
1650203021544,MATH 109,B01,083215,Anzaldo; Leesa B,0,4,30,30
1650203021544,MATH 109,B02,083216,Anzaldo; Leesa B,0,4,30,30
1650203027570,MATH 142A,A01,083219,Chow; Bennett,0,12,30,30
1650203027570,MATH 142A,A02,083220,Chow; Bennett,0,11,30,30
1650203027570,MATH 142A,B01,083221,Chow; Bennett,0,11,30,30
1650203027570,MATH 142A,B02,083222,Chow; Bennett,0,12,30,30
1650203033597,MATH 193A,A01,083224,Staff,0,4,30,30
1650203033597,MATH 193A,A02,083225,Staff,0,4,30,30
1650203033597,MATH 193A,A03,083781,Staff,0,2,30,30
1650203033597,MATH 193A,A04,083782,Staff,0,1,30,30
1650203039621,MATH 197,001,091859,McAuley; Julian John,9998,0,9999,1
1650203045673,COGS 9,A01,083615,Staff,0,14,60,60
1650203051700,COGS 11,A01,083617,Boyle; Mary E. T.,24,0,40,16
1650203057727,COGS 13,A01,083071,Staff,0,30,40,40
1650203063751,COGS 14A,A01,092681,Staff,0,12,100,100
1650203069774,COGS 14B,A01,083073,Cheng; Tzu-Han,0,7,50,50
1650203075802,COGS 17,A01,092677,Staff,35,0,75,40
1650203081828,COGS 100,A01,083619,Staff,0,20,60,60
1650203087856,COGS 101A,A01,083621,Davis; Joshua Daniel,0,21,60,60
1650203093881,COGS 101B,A01,091572,Staff,6,0,60,54
1650203099905,COGS 101C,A01,083625,Delgado; Tania,20,0,30,10
1650203105929,COGS 107A,A01,083627,Boyle; Mary E. T.,0,7,60,60
1650203111951,COGS 118A,A01,083075,Staff,16,0,60,44
1650203117980,CSE 3,A50,083646,Miranda; Gregory Joseph,22,0,38,16
1650203117980,CSE 3,A51,083647,Miranda; Gregory Joseph,37,0,37,0
1650203124007,CSE 8A,A50,083650,Miranda; Gregory Joseph,0,17,40,40
1650203130031,CSE 11,A01,083080,Cao; Yingjun,0,68,40,40
1650203136054,CSE 12,A01,083652,Staff,0,7,100,100
1650203142080,CSE 15L,A01,083654,Staff,0,0,50,50
1650203142080,CSE 15L,A02,083655,Staff,6,0,50,44
1650203148104,CSE 20,A01,083657,Staff,53,0,80,27
1650203154132,CSE 30,A01,083084,Eldon; John,0,69,40,40
1650203160162,CSE 100,A01,083659,Cao; Yingjun,0,63,50,50
1650203166187,CSE 134B,A01,083661,Powell; Thomas Allan,0,27,65,65
1650203172211,CSE 140,A01,083663,Staff,1,0,75,74
1650203178234,CSE 140L,A01,083088,Eldon; John,0,4,75,75
1650203184259,CSE 175,A01,083665,Kumar; Rakesh,8,0,25,17
1650203190283,CSE 190,A00,092507,Dubnov; Shlomo,14,0,20,6
1650203196311,ECE 45,A01,083139,Staff,0,13,40,40
1650203202334,ECE 65,A50,083695,Staff,0,5,30,30
1650203208362,ECE 109,A01,091882,Touri; Behrouz,47,0,70,23
1650203214391,ECE 180,A00,083140,Abi Samra; Nicholas Camill,24,0,30,6
1650203214391,ECE 180,B00,083141,Abi Samra; Nicholas Camill,8,0,30,22
1650203220420,MATH 10A,A01,083735,Patchell; Gregory David,11,0,30,19
1650203220420,MATH 10A,A02,083736,Patchell; Gregory David,28,0,30,2
1650203220420,MATH 10A,A03,083737,Patchell; Gregory David,26,0,30,4
1650203226442,MATH 10B,A01,083207,Staff,0,5,30,30
1650203226442,MATH 10B,A02,083208,Staff,0,5,30,30
1650203226442,MATH 10B,B01,083739,Staff,17,0,30,13
1650203226442,MATH 10B,B02,083740,Staff,29,0,30,1
1650203232478,MATH 18,A01,083743,Staff,8,0,30,22
1650203232478,MATH 18,A02,083744,Staff,28,0,30,2
1650203232478,MATH 18,A03,083745,Staff,23,0,30,7
1650203232478,MATH 18,A04,083746,Staff,27,0,30,3
1650203232478,MATH 18,B01,083748,Staff,0,10,30,30
1650203232478,MATH 18,B02,083749,Staff,0,7,30,30
1650203232478,MATH 18,B03,083750,Staff,0,7,30,30
1650203232478,MATH 18,B04,083751,Staff,0,8,30,30
1650203238505,MATH 20A,A01,083754,Staff,26,0,40,14
1650203244529,MATH 20B,A01,083756,Staff,0,6,30,30
1650203244529,MATH 20B,A02,083757,Staff,0,6,30,30
1650203250557,MATH 20C,A01,083760,Staff,0,12,30,30
1650203250557,MATH 20C,A02,083761,Staff,0,12,30,30
1650203250557,MATH 20C,B01,083762,Staff,14,0,30,16
1650203250557,MATH 20C,B02,083763,Staff,28,0,30,2
1650203256584,MATH 20D,A01,083765,Staff,1,2,30,29
1650203256584,MATH 20D,A02,083766,Staff,10,0,30,20
1650203256584,MATH 20D,A03,083767,Staff,28,0,30,2
1650203262610,MATH 20E,A01,083771,Staff,8,0,30,22
1650203262610,MATH 20E,A02,083772,Staff,20,0,30,10
1650203262610,MATH 20E,B01,083773,Staff,0,0,30,30
1650203262610,MATH 20E,B02,083774,Staff,12,0,30,18
1650203268634,MATH 103A,A01,083777,Staff,0,9,30,30
1650203268634,MATH 103A,A02,083778,Staff,0,10,30,30
1650203268634,MATH 103A,B01,083779,Staff,0,9,30,30
1650203268634,MATH 103A,B02,083780,Staff,0,9,30,30
1650203274658,MATH 105,A01,085443,Staff,0,17,30,30
1650203280687,MATH 109,A01,083213,Anzaldo; Leesa B,0,3,30,30
1650203280687,MATH 109,A02,083214,Anzaldo; Leesa B,0,6,30,30
1650203280687,MATH 109,B01,083215,Anzaldo; Leesa B,0,4,30,30
1650203280687,MATH 109,B02,083216,Anzaldo; Leesa B,0,4,30,30
1650203286715,MATH 142A,A01,083219,Chow; Bennett,0,12,30,30
1650203286715,MATH 142A,A02,083220,Chow; Bennett,0,11,30,30
1650203286715,MATH 142A,B01,083221,Chow; Bennett,0,11,30,30
1650203286715,MATH 142A,B02,083222,Chow; Bennett,0,12,30,30
1650203292738,MATH 193A,A01,083224,Staff,0,4,30,30
1650203292738,MATH 193A,A02,083225,Staff,0,4,30,30
1650203292738,MATH 193A,A03,083781,Staff,0,2,30,30
1650203292738,MATH 193A,A04,083782,Staff,0,1,30,30
1650203298762,MATH 197,001,091859,McAuley; Julian John,9998,0,9999,1
1650203304824,COGS 9,A01,083615,Staff,0,14,60,60
1650203310850,COGS 11,A01,083617,Boyle; Mary E. T.,24,0,40,16
1650203316875,COGS 13,A01,083071,Staff,0,30,40,40
1650203322900,COGS 14A,A01,092681,Staff,0,12,100,100
1650203328922,COGS 14B,A01,083073,Cheng; Tzu-Han,0,7,50,50
1650203334950,COGS 17,A01,092677,Staff,35,0,75,40
1650203340978,COGS 100,A01,083619,Staff,0,20,60,60
1650203347003,COGS 101A,A01,083621,Davis; Joshua Daniel,0,21,60,60
1650203353029,COGS 101B,A01,091572,Staff,6,0,60,54
1650203359056,COGS 101C,A01,083625,Delgado; Tania,20,0,30,10
1650203365085,COGS 107A,A01,083627,Boyle; Mary E. T.,0,7,60,60
1650203371108,COGS 118A,A01,083075,Staff,16,0,60,44
1650203377138,CSE 3,A50,083646,Miranda; Gregory Joseph,22,0,38,16
1650203377138,CSE 3,A51,083647,Miranda; Gregory Joseph,37,0,37,0
1650203383165,CSE 8A,A50,083650,Miranda; Gregory Joseph,0,17,40,40
1650203389192,CSE 11,A01,083080,Cao; Yingjun,0,68,40,40
1650203395295,CSE 12,A01,083652,Staff,0,7,100,100
1650203401320,CSE 15L,A01,083654,Staff,0,0,50,50
1650203401320,CSE 15L,A02,083655,Staff,6,0,50,44
1650203407354,CSE 20,A01,083657,Staff,53,0,80,27
1650203413380,CSE 30,A01,083084,Eldon; John,0,69,40,40
1650203419406,CSE 100,A01,083659,Cao; Yingjun,0,63,50,50
1650203425431,CSE 134B,A01,083661,Powell; Thomas Allan,0,27,65,65
1650203431457,CSE 140,A01,083663,Staff,1,0,75,74
1650203437482,CSE 140L,A01,083088,Eldon; John,0,4,75,75
1650203443509,CSE 175,A01,083665,Kumar; Rakesh,8,0,25,17
1650203449537,CSE 190,A00,092507,Dubnov; Shlomo,14,0,20,6
1650203455562,ECE 45,A01,083139,Staff,0,13,40,40
1650203461587,ECE 65,A50,083695,Staff,0,5,30,30
1650203467611,ECE 109,A01,091882,Touri; Behrouz,47,0,70,23
1650203473635,ECE 180,A00,083140,Abi Samra; Nicholas Camill,24,0,30,6
1650203473635,ECE 180,B00,083141,Abi Samra; Nicholas Camill,8,0,30,22
1650203479660,MATH 10A,A01,083735,Patchell; Gregory David,11,0,30,19
1650203479660,MATH 10A,A02,083736,Patchell; Gregory David,28,0,30,2
1650203479660,MATH 10A,A03,083737,Patchell; Gregory David,26,0,30,4
1650203485684,MATH 10B,A01,083207,Staff,0,5,30,30
1650203485684,MATH 10B,A02,083208,Staff,0,5,30,30
1650203485684,MATH 10B,B01,083739,Staff,17,0,30,13
1650203485684,MATH 10B,B02,083740,Staff,29,0,30,1
1650203491716,MATH 18,A01,083743,Staff,8,0,30,22
1650203491716,MATH 18,A02,083744,Staff,28,0,30,2
1650203491716,MATH 18,A03,083745,Staff,23,0,30,7
1650203491716,MATH 18,A04,083746,Staff,27,0,30,3
1650203491716,MATH 18,B01,083748,Staff,0,10,30,30
1650203491716,MATH 18,B02,083749,Staff,0,7,30,30
1650203491716,MATH 18,B03,083750,Staff,0,7,30,30
1650203491716,MATH 18,B04,083751,Staff,0,8,30,30
1650203497739,MATH 20A,A01,083754,Staff,26,0,40,14
1650203503768,MATH 20B,A01,083756,Staff,0,6,30,30
1650203503768,MATH 20B,A02,083757,Staff,0,6,30,30
1650203509792,MATH 20C,A01,083760,Staff,0,12,30,30
1650203509792,MATH 20C,A02,083761,Staff,0,12,30,30
1650203509792,MATH 20C,B01,083762,Staff,14,0,30,16
1650203509792,MATH 20C,B02,083763,Staff,28,0,30,2
1650203515818,MATH 20D,A01,083765,Staff,1,2,30,29
1650203515818,MATH 20D,A02,083766,Staff,10,0,30,20
1650203515818,MATH 20D,A03,083767,Staff,28,0,30,2
1650203521844,MATH 20E,A01,083771,Staff,8,0,30,22
1650203521844,MATH 20E,A02,083772,Staff,20,0,30,10
1650203521844,MATH 20E,B01,083773,Staff,0,0,30,30
1650203521844,MATH 20E,B02,083774,Staff,12,0,30,18
1650203527872,MATH 103A,A01,083777,Staff,0,9,30,30
1650203527872,MATH 103A,A02,083778,Staff,0,10,30,30
1650203527872,MATH 103A,B01,083779,Staff,0,9,30,30
1650203527872,MATH 103A,B02,083780,Staff,0,9,30,30
1650203533901,MATH 105,A01,085443,Staff,0,17,30,30
1650203539931,MATH 109,A01,083213,Anzaldo; Leesa B,0,3,30,30
1650203539931,MATH 109,A02,083214,Anzaldo; Leesa B,0,6,30,30
1650203539931,MATH 109,B01,083215,Anzaldo; Leesa B,0,4,30,30
1650203539931,MATH 109,B02,083216,Anzaldo; Leesa B,0,4,30,30
1650203545961,MATH 142A,A01,083219,Chow; Bennett,0,12,30,30
1650203545961,MATH 142A,A02,083220,Chow; Bennett,0,11,30,30
1650203545961,MATH 142A,B01,083221,Chow; Bennett,0,11,30,30
1650203545961,MATH 142A,B02,083222,Chow; Bennett,0,12,30,30
1650203551989,MATH 193A,A01,083224,Staff,0,4,30,30
1650203551989,MATH 193A,A02,083225,Staff,0,4,30,30
1650203551989,MATH 193A,A03,083781,Staff,0,2,30,30
1650203551989,MATH 193A,A04,083782,Staff,0,1,30,30
1650203558016,MATH 197,001,091859,McAuley; Julian John,9998,0,9999,1
1650203564082,COGS 9,A01,083615,Staff,0,14,60,60
1650203570107,COGS 11,A01,083617,Boyle; Mary E. T.,24,0,40,16
1650203576137,COGS 13,A01,083071,Staff,0,30,40,40
1650203582162,COGS 14A,A01,092681,Staff,0,12,100,100
1650203588186,COGS 14B,A01,083073,Cheng; Tzu-Han,0,7,50,50
1650203594226,COGS 17,A01,092677,Staff,35,0,75,40
1650203600250,COGS 100,A01,083619,Staff,0,20,60,60
1650203606278,COGS 101A,A01,083621,Davis; Joshua Daniel,0,21,60,60
1650203612303,COGS 101B,A01,091572,Staff,6,0,60,54
1650203618328,COGS 101C,A01,083625,Delgado; Tania,20,0,30,10
1650203624354,COGS 107A,A01,083627,Boyle; Mary E. T.,0,7,60,60
1650203630376,COGS 118A,A01,083075,Staff,16,0,60,44
1650203636399,CSE 3,A50,083646,Miranda; Gregory Joseph,22,0,38,16
1650203636399,CSE 3,A51,083647,Miranda; Gregory Joseph,37,0,37,0
1650203642429,CSE 8A,A50,083650,Miranda; Gregory Joseph,0,17,40,40
1650203648457,CSE 11,A01,083080,Cao; Yingjun,0,68,40,40
1650203654480,CSE 12,A01,083652,Staff,0,7,100,100
1650203660504,CSE 15L,A01,083654,Staff,0,0,50,50
1650203660504,CSE 15L,A02,083655,Staff,6,0,50,44
1650203666529,CSE 20,A01,083657,Staff,53,0,80,27
1650203672556,CSE 30,A01,083084,Eldon; John,0,69,40,40
1650203678583,CSE 100,A01,083659,Cao; Yingjun,0,63,50,50
1650203684607,CSE 134B,A01,083661,Powell; Thomas Allan,0,27,65,65
1650203690636,CSE 140,A01,083663,Staff,1,0,75,74
1650203696668,CSE 140L,A01,083088,Eldon; John,0,4,75,75
1650203702695,CSE 175,A01,083665,Kumar; Rakesh,8,0,25,17
1650203708719,CSE 190,A00,092507,Dubnov; Shlomo,14,0,20,6
1650203714742,ECE 45,A01,083139,Staff,0,13,40,40
1650203720770,ECE 65,A50,083695,Staff,0,5,30,30
1650203726795,ECE 109,A01,091882,Touri; Behrouz,47,0,70,23
1650203732818,ECE 180,A00,083140,Abi Samra; Nicholas Camill,24,0,30,6
1650203732818,ECE 180,B00,083141,Abi Samra; Nicholas Camill,8,0,30,22
1650203738843,MATH 10A,A01,083735,Patchell; Gregory David,11,0,30,19
1650203738843,MATH 10A,A02,083736,Patchell; Gregory David,28,0,30,2
1650203738843,MATH 10A,A03,083737,Patchell; Gregory David,26,0,30,4
1650203744872,MATH 10B,A01,083207,Staff,0,5,30,30
1650203744872,MATH 10B,A02,083208,Staff,0,5,30,30
1650203744872,MATH 10B,B01,083739,Staff,17,0,30,13
1650203744872,MATH 10B,B02,083740,Staff,29,0,30,1
1650203750904,MATH 18,A01,083743,Staff,8,0,30,22
1650203750904,MATH 18,A02,083744,Staff,28,0,30,2
1650203750904,MATH 18,A03,083745,Staff,23,0,30,7
1650203750904,MATH 18,A04,083746,Staff,27,0,30,3
1650203750904,MATH 18,B01,083748,Staff,0,10,30,30
1650203750904,MATH 18,B02,083749,Staff,0,7,30,30
1650203750904,MATH 18,B03,083750,Staff,0,7,30,30
1650203750904,MATH 18,B04,083751,Staff,0,8,30,30
1650203756929,MATH 20A,A01,083754,Staff,26,0,40,14
1650203762956,MATH 20B,A01,083756,Staff,0,6,30,30
1650203762956,MATH 20B,A02,083757,Staff,0,6,30,30
1650203768985,MATH 20C,A01,083760,Staff,0,12,30,30
1650203768985,MATH 20C,A02,083761,Staff,0,12,30,30
1650203768985,MATH 20C,B01,083762,Staff,14,0,30,16
1650203768985,MATH 20C,B02,083763,Staff,28,0,30,2
1650203775011,MATH 20D,A01,083765,Staff,1,2,30,29
1650203775011,MATH 20D,A02,083766,Staff,10,0,30,20
1650203775011,MATH 20D,A03,083767,Staff,28,0,30,2
1650203781036,MATH 20E,A01,083771,Staff,8,0,30,22
1650203781036,MATH 20E,A02,083772,Staff,20,0,30,10
1650203781036,MATH 20E,B01,083773,Staff,0,0,30,30
1650203781036,MATH 20E,B02,083774,Staff,12,0,30,18
1650203787062,MATH 103A,A01,083777,Staff,0,9,30,30
1650203787062,MATH 103A,A02,083778,Staff,0,10,30,30
1650203787062,MATH 103A,B01,083779,Staff,0,9,30,30
1650203787062,MATH 103A,B02,083780,Staff,0,9,30,30
1650203793085,MATH 105,A01,085443,Staff,0,17,30,30
1650203799115,MATH 109,A01,083213,Anzaldo; Leesa B,0,3,30,30
1650203799115,MATH 109,A02,083214,Anzaldo; Leesa B,0,6,30,30
1650203799115,MATH 109,B01,083215,Anzaldo; Leesa B,0,4,30,30
1650203799115,MATH 109,B02,083216,Anzaldo; Leesa B,0,4,30,30
1650203805140,MATH 142A,A01,083219,Chow; Bennett,0,12,30,30
1650203805140,MATH 142A,A02,083220,Chow; Bennett,0,11,30,30
1650203805140,MATH 142A,B01,083221,Chow; Bennett,0,11,30,30
1650203805140,MATH 142A,B02,083222,Chow; Bennett,0,12,30,30
1650203811166,MATH 193A,A01,083224,Staff,0,4,30,30
1650203811166,MATH 193A,A02,083225,Staff,0,4,30,30
1650203811166,MATH 193A,A03,083781,Staff,0,2,30,30
1650203811166,MATH 193A,A04,083782,Staff,0,1,30,30
1650203817189,MATH 197,001,091859,McAuley; Julian John,9998,0,9999,1
1650203823248,COGS 9,A01,083615,Staff,0,14,60,60
1650203829272,COGS 11,A01,083617,Boyle; Mary E. T.,24,0,40,16
1650203835296,COGS 13,A01,083071,Staff,0,30,40,40
1650203841321,COGS 14A,A01,092681,Staff,0,12,100,100
1650203847343,COGS 14B,A01,083073,Cheng; Tzu-Han,0,7,50,50
1650203853369,COGS 17,A01,092677,Staff,35,0,75,40
1650203859396,COGS 100,A01,083619,Staff,0,20,60,60
1650203865421,COGS 101A,A01,083621,Davis; Joshua Daniel,0,21,60,60
1650203871446,COGS 101B,A01,091572,Staff,6,0,60,54
1650203877471,COGS 101C,A01,083625,Delgado; Tania,20,0,30,10
1650203883494,COGS 107A,A01,083627,Boyle; Mary E. T.,0,7,60,60
1650203889533,COGS 118A,A01,083075,Staff,16,0,60,44
1650203895561,CSE 3,A50,083646,Miranda; Gregory Joseph,22,0,38,16
1650203895561,CSE 3,A51,083647,Miranda; Gregory Joseph,37,0,37,0
1650203901588,CSE 8A,A50,083650,Miranda; Gregory Joseph,0,17,40,40
1650203907614,CSE 11,A01,083080,Cao; Yingjun,0,68,40,40
1650203913644,CSE 12,A01,083652,Staff,0,7,100,100
1650203919668,CSE 15L,A01,083654,Staff,0,0,50,50
1650203919668,CSE 15L,A02,083655,Staff,6,0,50,44
1650203925691,CSE 20,A01,083657,Staff,53,0,80,27
1650203931714,CSE 30,A01,083084,Eldon; John,0,69,40,40
1650203937740,CSE 100,A01,083659,Cao; Yingjun,0,63,50,50
1650203943767,CSE 134B,A01,083661,Powell; Thomas Allan,0,27,65,65
1650203949789,CSE 140,A01,083663,Staff,1,0,75,74
1650203955813,CSE 140L,A01,083088,Eldon; John,0,4,75,75
1650203961840,CSE 175,A01,083665,Kumar; Rakesh,8,0,25,17
1650203967865,CSE 190,A00,092507,Dubnov; Shlomo,14,0,20,6
1650203973893,ECE 45,A01,083139,Staff,0,13,40,40
1650203979917,ECE 65,A50,083695,Staff,0,5,30,30
1650203985944,ECE 109,A01,091882,Touri; Behrouz,47,0,70,23
1650203992060,ECE 180,A00,083140,Abi Samra; Nicholas Camill,24,0,30,6
1650203992060,ECE 180,B00,083141,Abi Samra; Nicholas Camill,8,0,30,22
1650203998090,MATH 10A,A01,083735,Patchell; Gregory David,11,0,30,19
1650203998090,MATH 10A,A02,083736,Patchell; Gregory David,28,0,30,2
1650203998090,MATH 10A,A03,083737,Patchell; Gregory David,26,0,30,4
1650204004115,MATH 10B,A01,083207,Staff,0,5,30,30
1650204004115,MATH 10B,A02,083208,Staff,0,5,30,30
1650204004115,MATH 10B,B01,083739,Staff,17,0,30,13
1650204004115,MATH 10B,B02,083740,Staff,29,0,30,1
1650204010146,MATH 18,A01,083743,Staff,8,0,30,22
1650204010146,MATH 18,A02,083744,Staff,28,0,30,2
1650204010146,MATH 18,A03,083745,Staff,23,0,30,7
1650204010146,MATH 18,A04,083746,Staff,27,0,30,3
1650204010146,MATH 18,B01,083748,Staff,0,10,30,30
1650204010146,MATH 18,B02,083749,Staff,0,7,30,30
1650204010146,MATH 18,B03,083750,Staff,0,7,30,30
1650204010146,MATH 18,B04,083751,Staff,0,8,30,30
1650204016172,MATH 20A,A01,083754,Staff,26,0,40,14
1650204022200,MATH 20B,A01,083756,Staff,0,6,30,30
1650204022200,MATH 20B,A02,083757,Staff,0,6,30,30
1650204028228,MATH 20C,A01,083760,Staff,0,12,30,30
1650204028228,MATH 20C,A02,083761,Staff,0,12,30,30
1650204028228,MATH 20C,B01,083762,Staff,14,0,30,16
1650204028228,MATH 20C,B02,083763,Staff,28,0,30,2
1650204034256,MATH 20D,A01,083765,Staff,1,2,30,29
1650204034256,MATH 20D,A02,083766,Staff,10,0,30,20
1650204034256,MATH 20D,A03,083767,Staff,28,0,30,2
1650204040281,MATH 20E,A01,083771,Staff,8,0,30,22
1650204040281,MATH 20E,A02,083772,Staff,20,0,30,10
1650204040281,MATH 20E,B01,083773,Staff,0,0,30,30
1650204040281,MATH 20E,B02,083774,Staff,12,0,30,18
1650204046305,MATH 103A,A01,083777,Staff,0,9,30,30
1650204046305,MATH 103A,A02,083778,Staff,0,10,30,30
1650204046305,MATH 103A,B01,083779,Staff,0,9,30,30
1650204046305,MATH 103A,B02,083780,Staff,0,9,30,30
1650204052332,MATH 105,A01,085443,Staff,0,17,30,30
1650204058361,MATH 109,A01,083213,Anzaldo; Leesa B,0,3,30,30
1650204058361,MATH 109,A02,083214,Anzaldo; Leesa B,0,6,30,30
1650204058361,MATH 109,B01,083215,Anzaldo; Leesa B,0,4,30,30
1650204058361,MATH 109,B02,083216,Anzaldo; Leesa B,0,4,30,30
1650204064388,MATH 142A,A01,083219,Chow; Bennett,0,12,30,30
1650204064388,MATH 142A,A02,083220,Chow; Bennett,0,11,30,30
1650204064388,MATH 142A,B01,083221,Chow; Bennett,0,11,30,30
1650204064388,MATH 142A,B02,083222,Chow; Bennett,0,12,30,30
1650204070414,MATH 193A,A01,083224,Staff,0,4,30,30
1650204070414,MATH 193A,A02,083225,Staff,0,4,30,30
1650204070414,MATH 193A,A03,083781,Staff,0,2,30,30
1650204070414,MATH 193A,A04,083782,Staff,0,1,30,30
1650204076442,MATH 197,001,091859,McAuley; Julian John,9998,0,9999,1
1650204082503,COGS 9,A01,083615,Staff,0,14,60,60
1650204088527,COGS 11,A01,083617,Boyle; Mary E. T.,24,0,40,16
1650204094551,COGS 13,A01,083071,Staff,0,30,40,40
1650204100575,COGS 14A,A01,092681,Staff,0,12,100,100
1650204106603,COGS 14B,A01,083073,Cheng; Tzu-Han,0,7,50,50
1650204112628,COGS 17,A01,092677,Staff,35,0,75,40
1650204118653,COGS 100,A01,083619,Staff,0,20,60,60
1650204124679,COGS 101A,A01,083621,Davis; Joshua Daniel,0,21,60,60
1650204130703,COGS 101B,A01,091572,Staff,6,0,60,54
1650204136730,COGS 101C,A01,083625,Delgado; Tania,20,0,30,10
1650204142759,COGS 107A,A01,083627,Boyle; Mary E. T.,0,7,60,60
1650204148786,COGS 118A,A01,083075,Staff,16,0,60,44
1650204154811,CSE 3,A50,083646,Miranda; Gregory Joseph,22,0,38,16
1650204154811,CSE 3,A51,083647,Miranda; Gregory Joseph,37,0,37,0
1650204160835,CSE 8A,A50,083650,Miranda; Gregory Joseph,0,17,40,40
1650204166859,CSE 11,A01,083080,Cao; Yingjun,0,68,40,40
1650204172886,CSE 12,A01,083652,Staff,0,7,100,100
1650204178915,CSE 15L,A01,083654,Staff,0,0,50,50
1650204178915,CSE 15L,A02,083655,Staff,6,0,50,44
1650204184945,CSE 20,A01,083657,Staff,53,0,80,27
1650204190970,CSE 30,A01,083084,Eldon; John,0,69,40,40
1650204196994,CSE 100,A01,083659,Cao; Yingjun,0,63,50,50
1650204203020,CSE 134B,A01,083661,Powell; Thomas Allan,0,27,65,65
1650204209053,CSE 140,A01,083663,Staff,1,0,75,74
1650204215081,CSE 140L,A01,083088,Eldon; John,0,4,75,75
1650204221124,CSE 175,A01,083665,Kumar; Rakesh,8,0,25,17
1650204227153,CSE 190,A00,092507,Dubnov; Shlomo,14,0,20,6
1650204233179,ECE 45,A01,083139,Staff,0,13,40,40
1650204239204,ECE 65,A50,083695,Staff,0,5,30,30
1650204245227,ECE 109,A01,091882,Touri; Behrouz,47,0,70,23
1650204251256,ECE 180,A00,083140,Abi Samra; Nicholas Camill,24,0,30,6
1650204251256,ECE 180,B00,083141,Abi Samra; Nicholas Camill,8,0,30,22
1650204257282,MATH 10A,A01,083735,Patchell; Gregory David,11,0,30,19
1650204257282,MATH 10A,A02,083736,Patchell; Gregory David,28,0,30,2
1650204257282,MATH 10A,A03,083737,Patchell; Gregory David,26,0,30,4
1650204263311,MATH 10B,A01,083207,Staff,0,5,30,30
1650204263311,MATH 10B,A02,083208,Staff,0,5,30,30
1650204263311,MATH 10B,B01,083739,Staff,17,0,30,13
1650204263311,MATH 10B,B02,083740,Staff,29,0,30,1
1650204269343,MATH 18,A01,083743,Staff,8,0,30,22
1650204269343,MATH 18,A02,083744,Staff,28,0,30,2
1650204269343,MATH 18,A03,083745,Staff,23,0,30,7
1650204269343,MATH 18,A04,083746,Staff,27,0,30,3
1650204269343,MATH 18,B01,083748,Staff,0,10,30,30
1650204269343,MATH 18,B02,083749,Staff,0,7,30,30
1650204269343,MATH 18,B03,083750,Staff,0,7,30,30
1650204269343,MATH 18,B04,083751,Staff,0,8,30,30
1650204275370,MATH 20A,A01,083754,Staff,26,0,40,14
1650204281396,MATH 20B,A01,083756,Staff,0,6,30,30
1650204281396,MATH 20B,A02,083757,Staff,0,6,30,30
1650204287421,MATH 20C,A01,083760,Staff,0,12,30,30
1650204287421,MATH 20C,A02,083761,Staff,0,12,30,30
1650204287421,MATH 20C,B01,083762,Staff,14,0,30,16
1650204287421,MATH 20C,B02,083763,Staff,28,0,30,2
1650204293446,MATH 20D,A01,083765,Staff,1,2,30,29
1650204293446,MATH 20D,A02,083766,Staff,10,0,30,20
1650204293446,MATH 20D,A03,083767,Staff,28,0,30,2
1650204299476,MATH 20E,A01,083771,Staff,8,0,30,22
1650204299476,MATH 20E,A02,083772,Staff,20,0,30,10
1650204299476,MATH 20E,B01,083773,Staff,0,0,30,30
1650204299476,MATH 20E,B02,083774,Staff,12,0,30,18
1650204305500,MATH 103A,A01,083777,Staff,0,9,30,30
1650204305500,MATH 103A,A02,083778,Staff,0,10,30,30
1650204305500,MATH 103A,B01,083779,Staff,0,9,30,30
1650204305500,MATH 103A,B02,083780,Staff,0,9,30,30
1650204311523,MATH 105,A01,085443,Staff,0,17,30,30
1650204317554,MATH 109,A01,083213,Anzaldo; Leesa B,0,3,30,30
1650204317554,MATH 109,A02,083214,Anzaldo; Leesa B,0,6,30,30
1650204317554,MATH 109,B01,083215,Anzaldo; Leesa B,0,4,30,30
1650204317554,MATH 109,B02,083216,Anzaldo; Leesa B,0,4,30,30
1650204323579,MATH 142A,A01,083219,Chow; Bennett,0,12,30,30
1650204323579,MATH 142A,A02,083220,Chow; Bennett,0,11,30,30
1650204323579,MATH 142A,B01,083221,Chow; Bennett,0,11,30,30
1650204323579,MATH 142A,B02,083222,Chow; Bennett,0,12,30,30
1650204329610,MATH 193A,A01,083224,Staff,0,4,30,30
1650204329610,MATH 193A,A02,083225,Staff,0,4,30,30
1650204329610,MATH 193A,A03,083781,Staff,0,2,30,30
1650204329610,MATH 193A,A04,083782,Staff,0,1,30,30
1650204335635,MATH 197,001,091859,McAuley; Julian John,9998,0,9999,1
1650204341696,COGS 9,A01,083615,Staff,0,14,60,60
1650204347722,COGS 11,A01,083617,Boyle; Mary E. T.,24,0,40,16
1650204353749,COGS 13,A01,083071,Staff,0,30,40,40
1650204359775,COGS 14A,A01,092681,Staff,0,12,100,100
1650204365803,COGS 14B,A01,083073,Cheng; Tzu-Han,0,7,50,50
1650204371834,COGS 17,A01,092677,Staff,35,0,75,40
1650204377858,COGS 100,A01,083619,Staff,0,20,60,60
1650204383884,COGS 101A,A01,083621,Davis; Joshua Daniel,0,21,60,60
1650204389907,COGS 101B,A01,091572,Staff,6,0,60,54
1650204395932,COGS 101C,A01,083625,Delgado; Tania,20,0,30,10
1650204401959,COGS 107A,A01,083627,Boyle; Mary E. T.,0,7,60,60
1650204407986,COGS 118A,A01,083075,Staff,16,0,60,44
1650204414024,CSE 3,A50,083646,Miranda; Gregory Joseph,22,0,38,16
1650204414024,CSE 3,A51,083647,Miranda; Gregory Joseph,37,0,37,0
1650204420050,CSE 8A,A50,083650,Miranda; Gregory Joseph,0,17,40,40
1650204426073,CSE 11,A01,083080,Cao; Yingjun,0,68,40,40
1650204432098,CSE 12,A01,083652,Staff,0,7,100,100
1650204438124,CSE 15L,A01,083654,Staff,0,0,50,50
1650204438124,CSE 15L,A02,083655,Staff,6,0,50,44
1650204444151,CSE 20,A01,083657,Staff,53,0,80,27
1650204450177,CSE 30,A01,083084,Eldon; John,0,69,40,40
1650204456202,CSE 100,A01,083659,Cao; Yingjun,0,63,50,50
1650204462230,CSE 134B,A01,083661,Powell; Thomas Allan,0,27,65,65
1650204468255,CSE 140,A01,083663,Staff,1,0,75,74
1650204474293,CSE 140L,A01,083088,Eldon; John,0,4,75,75
1650204480324,CSE 175,A01,083665,Kumar; Rakesh,8,0,25,17
1650204486347,CSE 190,A00,092507,Dubnov; Shlomo,14,0,20,6
1650204492372,ECE 45,A01,083139,Staff,0,13,40,40
1650204498397,ECE 65,A50,083695,Staff,0,5,30,30
1650204504422,ECE 109,A01,091882,Touri; Behrouz,47,0,70,23
1650204510447,ECE 180,A00,083140,Abi Samra; Nicholas Camill,24,0,30,6
1650204510447,ECE 180,B00,083141,Abi Samra; Nicholas Camill,8,0,30,22
1650204516475,MATH 10A,A01,083735,Patchell; Gregory David,11,0,30,19
1650204516475,MATH 10A,A02,083736,Patchell; Gregory David,28,0,30,2
1650204516475,MATH 10A,A03,083737,Patchell; Gregory David,26,0,30,4
1650204522502,MATH 10B,A01,083207,Staff,0,5,30,30
1650204522502,MATH 10B,A02,083208,Staff,0,5,30,30
1650204522502,MATH 10B,B01,083739,Staff,17,0,30,13
1650204522502,MATH 10B,B02,083740,Staff,29,0,30,1
1650204528531,MATH 18,A01,083743,Staff,8,0,30,22
1650204528531,MATH 18,A02,083744,Staff,28,0,30,2
1650204528531,MATH 18,A03,083745,Staff,23,0,30,7
1650204528531,MATH 18,A04,083746,Staff,27,0,30,3
1650204528531,MATH 18,B01,083748,Staff,0,10,30,30
1650204528531,MATH 18,B02,083749,Staff,0,7,30,30
1650204528531,MATH 18,B03,083750,Staff,0,7,30,30
1650204528531,MATH 18,B04,083751,Staff,0,8,30,30
1650204534558,MATH 20A,A01,083754,Staff,26,0,40,14
1650204540591,MATH 20B,A01,083756,Staff,0,6,30,30
1650204540591,MATH 20B,A02,083757,Staff,0,6,30,30
1650204546618,MATH 20C,A01,083760,Staff,0,12,30,30
1650204546618,MATH 20C,A02,083761,Staff,0,12,30,30
1650204546618,MATH 20C,B01,083762,Staff,14,0,30,16
1650204546618,MATH 20C,B02,083763,Staff,28,0,30,2
1650204552641,MATH 20D,A01,083765,Staff,1,2,30,29
1650204552641,MATH 20D,A02,083766,Staff,10,0,30,20
1650204552641,MATH 20D,A03,083767,Staff,28,0,30,2
1650204558666,MATH 20E,A01,083771,Staff,8,0,30,22
1650204558666,MATH 20E,A02,083772,Staff,20,0,30,10
1650204558666,MATH 20E,B01,083773,Staff,0,0,30,30
1650204558666,MATH 20E,B02,083774,Staff,12,0,30,18
1650204564696,MATH 103A,A01,083777,Staff,0,9,30,30
1650204564696,MATH 103A,A02,083778,Staff,0,10,30,30
1650204564696,MATH 103A,B01,083779,Staff,0,9,30,30
1650204564696,MATH 103A,B02,083780,Staff,0,9,30,30
1650204570723,MATH 105,A01,085443,Staff,0,17,30,30
1650204576751,MATH 109,A01,083213,Anzaldo; Leesa B,0,3,30,30
1650204576751,MATH 109,A02,083214,Anzaldo; Leesa B,0,6,30,30
1650204576751,MATH 109,B01,083215,Anzaldo; Leesa B,0,4,30,30
1650204576751,MATH 109,B02,083216,Anzaldo; Leesa B,0,4,30,30
1650204582777,MATH 142A,A01,083219,Chow; Bennett,0,12,30,30
1650204582777,MATH 142A,A02,083220,Chow; Bennett,0,11,30,30
1650204582777,MATH 142A,B01,083221,Chow; Bennett,0,11,30,30
1650204582777,MATH 142A,B02,083222,Chow; Bennett,0,12,30,30
1650204588893,MATH 193A,A01,083224,Staff,0,4,30,30
1650204588893,MATH 193A,A02,083225,Staff,0,4,30,30
1650204588893,MATH 193A,A03,083781,Staff,0,2,30,30
1650204588893,MATH 193A,A04,083782,Staff,0,1,30,30
1650204594921,MATH 197,001,091859,McAuley; Julian John,9998,0,9999,1
1650204600978,COGS 9,A01,083615,Staff,0,14,60,60
1650204607007,COGS 11,A01,083617,Boyle; Mary E. T.,24,0,40,16
1650204613035,COGS 13,A01,083071,Staff,0,30,40,40
1650204619065,COGS 14A,A01,092681,Staff,0,12,100,100
1650204625093,COGS 14B,A01,083073,Cheng; Tzu-Han,0,7,50,50
1650204631118,COGS 17,A01,092677,Staff,35,0,75,40
1650204637144,COGS 100,A01,083619,Staff,0,20,60,60
1650204643169,COGS 101A,A01,083621,Davis; Joshua Daniel,0,21,60,60
1650204649192,COGS 101B,A01,091572,Staff,6,0,60,54
1650204655217,COGS 101C,A01,083625,Delgado; Tania,20,0,30,10
1650204661241,COGS 107A,A01,083627,Boyle; Mary E. T.,0,7,60,60
1650204667275,COGS 118A,A01,083075,Staff,16,0,60,44
1650204673300,CSE 3,A50,083646,Miranda; Gregory Joseph,22,0,38,16
1650204673300,CSE 3,A51,083647,Miranda; Gregory Joseph,37,0,37,0
1650204679323,CSE 8A,A50,083650,Miranda; Gregory Joseph,0,17,40,40
1650204685352,CSE 11,A01,083080,Cao; Yingjun,0,68,40,40
1650204691380,CSE 12,A01,083652,Staff,0,7,100,100
1650204697406,CSE 15L,A01,083654,Staff,0,0,50,50
1650204697406,CSE 15L,A02,083655,Staff,6,0,50,44
1650204703433,CSE 20,A01,083657,Staff,53,0,80,27
1650204709459,CSE 30,A01,083084,Eldon; John,0,69,40,40
1650204715485,CSE 100,A01,083659,Cao; Yingjun,0,63,50,50
1650204721515,CSE 134B,A01,083661,Powell; Thomas Allan,0,27,65,65
1650204727540,CSE 140,A01,083663,Staff,1,0,75,74
1650204733579,CSE 140L,A01,083088,Eldon; John,0,4,75,75
1650204739607,CSE 175,A01,083665,Kumar; Rakesh,8,0,25,17
1650204745637,CSE 190,A00,092507,Dubnov; Shlomo,14,0,20,6
1650204751663,ECE 45,A01,083139,Staff,0,13,40,40
1650204757690,ECE 65,A50,083695,Staff,0,5,30,30
1650204763719,ECE 109,A01,091882,Touri; Behrouz,47,0,70,23
1650204769745,ECE 180,A00,083140,Abi Samra; Nicholas Camill,24,0,30,6
1650204769745,ECE 180,B00,083141,Abi Samra; Nicholas Camill,8,0,30,22
1650204775771,MATH 10A,A01,083735,Patchell; Gregory David,11,0,30,19
1650204775771,MATH 10A,A02,083736,Patchell; Gregory David,28,0,30,2
1650204775771,MATH 10A,A03,083737,Patchell; Gregory David,26,0,30,4
1650204781799,MATH 10B,A01,083207,Staff,0,5,30,30
1650204781799,MATH 10B,A02,083208,Staff,0,5,30,30
1650204781799,MATH 10B,B01,083739,Staff,17,0,30,13
1650204781799,MATH 10B,B02,083740,Staff,29,0,30,1
1650204787834,MATH 18,A01,083743,Staff,8,0,30,22
1650204787834,MATH 18,A02,083744,Staff,28,0,30,2
1650204787834,MATH 18,A03,083745,Staff,23,0,30,7
1650204787834,MATH 18,A04,083746,Staff,27,0,30,3
1650204787834,MATH 18,B01,083748,Staff,0,10,30,30
1650204787834,MATH 18,B02,083749,Staff,0,7,30,30
1650204787834,MATH 18,B03,083750,Staff,0,7,30,30
1650204787834,MATH 18,B04,083751,Staff,0,8,30,30
1650204793859,MATH 20A,A01,083754,Staff,26,0,40,14
1650204799885,MATH 20B,A01,083756,Staff,0,6,30,30
1650204799885,MATH 20B,A02,083757,Staff,0,6,30,30
1650204805917,MATH 20C,A01,083760,Staff,0,12,30,30
1650204805917,MATH 20C,A02,083761,Staff,0,12,30,30
1650204805917,MATH 20C,B01,083762,Staff,14,0,30,16
1650204805917,MATH 20C,B02,083763,Staff,28,0,30,2
1650204811945,MATH 20D,A01,083765,Staff,1,2,30,29
1650204811945,MATH 20D,A02,083766,Staff,10,0,30,20
1650204811945,MATH 20D,A03,083767,Staff,28,0,30,2
1650204817972,MATH 20E,A01,083771,Staff,8,0,30,22
1650204817972,MATH 20E,A02,083772,Staff,20,0,30,10
1650204817972,MATH 20E,B01,083773,Staff,0,0,30,30
1650204817972,MATH 20E,B02,083774,Staff,12,0,30,18
1650204824000,MATH 103A,A01,083777,Staff,0,9,30,30
1650204824000,MATH 103A,A02,083778,Staff,0,10,30,30
1650204824000,MATH 103A,B01,083779,Staff,0,9,30,30
1650204824000,MATH 103A,B02,083780,Staff,0,9,30,30
1650204830025,MATH 105,A01,085443,Staff,0,17,30,30
1650204836050,MATH 109,A01,083213,Anzaldo; Leesa B,0,3,30,30
1650204836050,MATH 109,A02,083214,Anzaldo; Leesa B,0,6,30,30
1650204836050,MATH 109,B01,083215,Anzaldo; Leesa B,0,4,30,30
1650204836050,MATH 109,B02,083216,Anzaldo; Leesa B,0,4,30,30
1650204842090,MATH 142A,A01,083219,Chow; Bennett,0,12,30,30
1650204842090,MATH 142A,A02,083220,Chow; Bennett,0,11,30,30
1650204842090,MATH 142A,B01,083221,Chow; Bennett,0,11,30,30
1650204842090,MATH 142A,B02,083222,Chow; Bennett,0,12,30,30
1650204848114,MATH 193A,A01,083224,Staff,0,4,30,30
1650204848114,MATH 193A,A02,083225,Staff,0,4,30,30
1650204848114,MATH 193A,A03,083781,Staff,0,2,30,30
1650204848114,MATH 193A,A04,083782,Staff,0,1,30,30
1650204854142,MATH 197,001,091859,McAuley; Julian John,9998,0,9999,1
1650204860199,COGS 9,A01,083615,Staff,0,14,60,60
1650204866222,COGS 11,A01,083617,Boyle; Mary E. T.,24,0,40,16
1650204872250,COGS 13,A01,083071,Staff,0,30,40,40
1650204878275,COGS 14A,A01,092681,Staff,0,12,100,100
1650204884304,COGS 14B,A01,083073,Cheng; Tzu-Han,0,7,50,50
1650204890331,COGS 17,A01,092677,Staff,35,0,75,40
1650204896358,COGS 100,A01,083619,Staff,0,20,60,60
1650204902383,COGS 101A,A01,083621,Davis; Joshua Daniel,0,21,60,60
1650204908408,COGS 101B,A01,091572,Staff,6,0,60,54
1650204914455,COGS 101C,A01,083625,Delgado; Tania,20,0,30,10
1650204920485,COGS 107A,A01,083627,Boyle; Mary E. T.,0,7,60,60
1650204926514,COGS 118A,A01,083075,Staff,16,0,60,44
1650204932545,CSE 3,A50,083646,Miranda; Gregory Joseph,22,0,38,16
1650204932545,CSE 3,A51,083647,Miranda; Gregory Joseph,37,0,37,0
1650204938574,CSE 8A,A50,083650,Miranda; Gregory Joseph,0,17,40,40
1650204944602,CSE 11,A01,083080,Cao; Yingjun,0,68,40,40
1650204950645,CSE 12,A01,083652,Staff,0,7,100,100
1650204956672,CSE 15L,A01,083654,Staff,0,0,50,50
1650204956672,CSE 15L,A02,083655,Staff,6,0,50,44
1650204962698,CSE 20,A01,083657,Staff,53,0,80,27
1650204968724,CSE 30,A01,083084,Eldon; John,0,69,40,40
1650204974753,CSE 100,A01,083659,Cao; Yingjun,0,63,50,50
1650204980787,CSE 134B,A01,083661,Powell; Thomas Allan,0,27,65,65
1650204986827,CSE 140,A01,083663,Staff,1,0,75,74
1650204992852,CSE 140L,A01,083088,Eldon; John,0,4,75,75
1650204998876,CSE 175,A01,083665,Kumar; Rakesh,8,0,25,17
1650205004902,CSE 190,A00,092507,Dubnov; Shlomo,14,0,20,6
1650205010926,ECE 45,A01,083139,Staff,0,13,40,40
1650205016952,ECE 65,A50,083695,Staff,0,5,30,30
1650205022979,ECE 109,A01,091882,Touri; Behrouz,47,0,70,23
1650205029005,ECE 180,A00,083140,Abi Samra; Nicholas Camill,24,0,30,6
1650205029005,ECE 180,B00,083141,Abi Samra; Nicholas Camill,8,0,30,22
1650205035035,MATH 10A,A01,083735,Patchell; Gregory David,11,0,30,19
1650205035035,MATH 10A,A02,083736,Patchell; Gregory David,28,0,30,2
1650205035035,MATH 10A,A03,083737,Patchell; Gregory David,26,0,30,4
1650205041065,MATH 10B,A01,083207,Staff,0,5,30,30
1650205041065,MATH 10B,A02,083208,Staff,0,5,30,30
1650205041065,MATH 10B,B01,083739,Staff,17,0,30,13
1650205041065,MATH 10B,B02,083740,Staff,29,0,30,1
1650205047096,MATH 18,A01,083743,Staff,8,0,30,22
1650205047096,MATH 18,A02,083744,Staff,28,0,30,2
1650205047096,MATH 18,A03,083745,Staff,23,0,30,7
1650205047096,MATH 18,A04,083746,Staff,27,0,30,3
1650205047096,MATH 18,B01,083748,Staff,0,10,30,30
1650205047096,MATH 18,B02,083749,Staff,0,7,30,30
1650205047096,MATH 18,B03,083750,Staff,0,7,30,30
1650205047096,MATH 18,B04,083751,Staff,0,8,30,30
1650205053122,MATH 20A,A01,083754,Staff,26,0,40,14
1650205059151,MATH 20B,A01,083756,Staff,0,6,30,30
1650205059151,MATH 20B,A02,083757,Staff,0,6,30,30
1650205065177,MATH 20C,A01,083760,Staff,0,12,30,30
1650205065177,MATH 20C,A02,083761,Staff,0,12,30,30
1650205065177,MATH 20C,B01,083762,Staff,14,0,30,16
1650205065177,MATH 20C,B02,083763,Staff,28,0,30,2
1650205071217,MATH 20D,A01,083765,Staff,1,2,30,29
1650205071217,MATH 20D,A02,083766,Staff,10,0,30,20
1650205071217,MATH 20D,A03,083767,Staff,28,0,30,2
1650205077244,MATH 20E,A01,083771,Staff,8,0,30,22
1650205077244,MATH 20E,A02,083772,Staff,20,0,30,10
1650205077244,MATH 20E,B01,083773,Staff,0,0,30,30
1650205077244,MATH 20E,B02,083774,Staff,12,0,30,18
1650205083270,MATH 103A,A01,083777,Staff,0,9,30,30
1650205083270,MATH 103A,A02,083778,Staff,0,10,30,30
1650205083270,MATH 103A,B01,083779,Staff,0,9,30,30
1650205083270,MATH 103A,B02,083780,Staff,0,9,30,30
1650205089296,MATH 105,A01,085443,Staff,0,17,30,30
1650205095320,MATH 109,A01,083213,Anzaldo; Leesa B,0,3,30,30
1650205095320,MATH 109,A02,083214,Anzaldo; Leesa B,0,6,30,30
1650205095320,MATH 109,B01,083215,Anzaldo; Leesa B,0,4,30,30
1650205095320,MATH 109,B02,083216,Anzaldo; Leesa B,0,4,30,30
1650205101344,MATH 142A,A01,083219,Chow; Bennett,0,12,30,30
1650205101344,MATH 142A,A02,083220,Chow; Bennett,0,11,30,30
1650205101344,MATH 142A,B01,083221,Chow; Bennett,0,11,30,30
1650205101344,MATH 142A,B02,083222,Chow; Bennett,0,12,30,30
1650205107371,MATH 193A,A01,083224,Staff,0,4,30,30
1650205107371,MATH 193A,A02,083225,Staff,0,4,30,30
1650205107371,MATH 193A,A03,083781,Staff,0,2,30,30
1650205107371,MATH 193A,A04,083782,Staff,0,1,30,30
1650205113402,MATH 197,001,091859,McAuley; Julian John,9998,0,9999,1
1650205119467,COGS 9,A01,083615,Staff,0,14,60,60
1650205125492,COGS 11,A01,083617,Boyle; Mary E. T.,24,0,40,16
1650205131518,COGS 13,A01,083071,Staff,0,30,40,40
1650205137544,COGS 14A,A01,092681,Staff,0,12,100,100
1650205143569,COGS 14B,A01,083073,Cheng; Tzu-Han,0,7,50,50
1650205149592,COGS 17,A01,092677,Staff,35,0,75,40
1650205155622,COGS 100,A01,083619,Staff,0,20,60,60
1650205161647,COGS 101A,A01,083621,Davis; Joshua Daniel,0,21,60,60
1650205167675,COGS 101B,A01,091572,Staff,6,0,60,54
1650205173701,COGS 101C,A01,083625,Delgado; Tania,20,0,30,10
1650205179816,COGS 107A,A01,083627,Boyle; Mary E. T.,0,7,60,60
1650205185848,COGS 118A,A01,083075,Staff,16,0,60,44
1650205191874,CSE 3,A50,083646,Miranda; Gregory Joseph,22,0,38,16
1650205191874,CSE 3,A51,083647,Miranda; Gregory Joseph,37,0,37,0
1650205197899,CSE 8A,A50,083650,Miranda; Gregory Joseph,0,17,40,40
1650205203938,CSE 11,A01,083080,Cao; Yingjun,0,68,40,40
1650205209974,CSE 12,A01,083652,Staff,0,7,100,100
1650205216006,CSE 15L,A01,083654,Staff,0,0,50,50
1650205216006,CSE 15L,A02,083655,Staff,6,0,50,44
1650205222032,CSE 20,A01,083657,Staff,53,0,80,27
1650205228056,CSE 30,A01,083084,Eldon; John,0,69,40,40
1650205234085,CSE 100,A01,083659,Cao; Yingjun,0,63,50,50
1650205240111,CSE 134B,A01,083661,Powell; Thomas Allan,0,27,65,65
1650205246140,CSE 140,A01,083663,Staff,1,0,75,74
1650205252166,CSE 140L,A01,083088,Eldon; John,0,4,75,75
1650205258195,CSE 175,A01,083665,Kumar; Rakesh,8,0,25,17
1650205264222,CSE 190,A00,092507,Dubnov; Shlomo,14,0,20,6
1650205270251,ECE 45,A01,083139,Staff,0,13,40,40
1650205276279,ECE 65,A50,083695,Staff,0,5,30,30
1650205282304,ECE 109,A01,091882,Touri; Behrouz,47,0,70,23
1650205288332,ECE 180,A00,083140,Abi Samra; Nicholas Camill,24,0,30,6
1650205288332,ECE 180,B00,083141,Abi Samra; Nicholas Camill,8,0,30,22
1650205294361,MATH 10A,A01,083735,Patchell; Gregory David,11,0,30,19
1650205294361,MATH 10A,A02,083736,Patchell; Gregory David,28,0,30,2
1650205294361,MATH 10A,A03,083737,Patchell; Gregory David,26,0,30,4
1650205300391,MATH 10B,A01,083207,Staff,0,5,30,30
1650205300391,MATH 10B,A02,083208,Staff,0,5,30,30
1650205300391,MATH 10B,B01,083739,Staff,17,0,30,13
1650205300391,MATH 10B,B02,083740,Staff,29,0,30,1
1650205306418,MATH 18,A01,083743,Staff,8,0,30,22
1650205306418,MATH 18,A02,083744,Staff,28,0,30,2
1650205306418,MATH 18,A03,083745,Staff,23,0,30,7
1650205306418,MATH 18,A04,083746,Staff,27,0,30,3
1650205306418,MATH 18,B01,083748,Staff,0,10,30,30
1650205306418,MATH 18,B02,083749,Staff,0,7,30,30
1650205306418,MATH 18,B03,083750,Staff,0,7,30,30
1650205306418,MATH 18,B04,083751,Staff,0,8,30,30
1650205312456,MATH 20A,A01,083754,Staff,26,0,40,14
1650205318481,MATH 20B,A01,083756,Staff,0,6,30,30
1650205318481,MATH 20B,A02,083757,Staff,0,6,30,30
1650205324505,MATH 20C,A01,083760,Staff,0,12,30,30
1650205324505,MATH 20C,A02,083761,Staff,0,12,30,30
1650205324505,MATH 20C,B01,083762,Staff,14,0,30,16
1650205324505,MATH 20C,B02,083763,Staff,28,0,30,2
1650205330530,MATH 20D,A01,083765,Staff,1,2,30,29
1650205330530,MATH 20D,A02,083766,Staff,10,0,30,20
1650205330530,MATH 20D,A03,083767,Staff,28,0,30,2
1650205336560,MATH 20E,A01,083771,Staff,8,0,30,22
1650205336560,MATH 20E,A02,083772,Staff,20,0,30,10
1650205336560,MATH 20E,B01,083773,Staff,0,0,30,30
1650205336560,MATH 20E,B02,083774,Staff,12,0,30,18
1650205342588,MATH 103A,A01,083777,Staff,0,9,30,30
1650205342588,MATH 103A,A02,083778,Staff,0,10,30,30
1650205342588,MATH 103A,B01,083779,Staff,0,9,30,30
1650205342588,MATH 103A,B02,083780,Staff,0,9,30,30
1650205348611,MATH 105,A01,085443,Staff,0,17,30,30
1650205354640,MATH 109,A01,083213,Anzaldo; Leesa B,0,3,30,30
1650205354640,MATH 109,A02,083214,Anzaldo; Leesa B,0,6,30,30
1650205354640,MATH 109,B01,083215,Anzaldo; Leesa B,0,4,30,30
1650205354640,MATH 109,B02,083216,Anzaldo; Leesa B,0,4,30,30
1650205360671,MATH 142A,A01,083219,Chow; Bennett,0,12,30,30
1650205360671,MATH 142A,A02,083220,Chow; Bennett,0,11,30,30
1650205360671,MATH 142A,B01,083221,Chow; Bennett,0,11,30,30
1650205360671,MATH 142A,B02,083222,Chow; Bennett,0,12,30,30
1650205366704,MATH 193A,A01,083224,Staff,0,4,30,30
1650205366704,MATH 193A,A02,083225,Staff,0,4,30,30
1650205366704,MATH 193A,A03,083781,Staff,0,2,30,30
1650205366704,MATH 193A,A04,083782,Staff,0,1,30,30
1650205372729,MATH 197,001,091859,McAuley; Julian John,9998,0,9999,1
1650205378793,COGS 9,A01,083615,Staff,0,14,60,60
1650205384818,COGS 11,A01,083617,Boyle; Mary E. T.,24,0,40,16
1650205390844,COGS 13,A01,083071,Staff,0,30,40,40
1650205396869,COGS 14A,A01,092681,Staff,0,12,100,100
1650205402900,COGS 14B,A01,083073,Cheng; Tzu-Han,0,7,50,50
1650205408926,COGS 17,A01,092677,Staff,35,0,75,40
1650205414954,COGS 100,A01,083619,Staff,0,20,60,60
1650205420979,COGS 101A,A01,083621,Davis; Joshua Daniel,0,21,60,60
1650205427009,COGS 101B,A01,091572,Staff,6,0,60,54
1650205433034,COGS 101C,A01,083625,Delgado; Tania,20,0,30,10
1650205439062,COGS 107A,A01,083627,Boyle; Mary E. T.,0,7,60,60
1650205445089,COGS 118A,A01,083075,Staff,16,0,60,44
1650205451120,CSE 3,A50,083646,Miranda; Gregory Joseph,22,0,38,16
1650205451120,CSE 3,A51,083647,Miranda; Gregory Joseph,37,0,37,0
1650205457150,CSE 8A,A50,083650,Miranda; Gregory Joseph,0,17,40,40
1650205463178,CSE 11,A01,083080,Cao; Yingjun,0,68,40,40
1650205469203,CSE 12,A01,083652,Staff,0,7,100,100
1650205475228,CSE 15L,A01,083654,Staff,0,0,50,50
1650205475228,CSE 15L,A02,083655,Staff,6,0,50,44
1650205481256,CSE 20,A01,083657,Staff,53,0,80,27
1650205487280,CSE 30,A01,083084,Eldon; John,0,69,40,40
1650205493313,CSE 100,A01,083659,Cao; Yingjun,0,63,50,50
1650205499343,CSE 134B,A01,083661,Powell; Thomas Allan,0,27,65,65
1650205505369,CSE 140,A01,083663,Staff,1,0,75,74
1650205511394,CSE 140L,A01,083088,Eldon; John,0,4,75,75
1650205517427,CSE 175,A01,083665,Kumar; Rakesh,8,0,25,17
1650205523454,CSE 190,A00,092507,Dubnov; Shlomo,14,0,20,6
1650205529491,ECE 45,A01,083139,Staff,0,13,40,40
1650205535519,ECE 65,A50,083695,Staff,0,5,30,30
1650205541559,ECE 109,A01,091882,Touri; Behrouz,47,0,70,23
1650205547587,ECE 180,A00,083140,Abi Samra; Nicholas Camill,24,0,30,6
1650205547587,ECE 180,B00,083141,Abi Samra; Nicholas Camill,8,0,30,22
1650205553613,MATH 10A,A01,083735,Patchell; Gregory David,11,0,30,19
1650205553613,MATH 10A,A02,083736,Patchell; Gregory David,28,0,30,2
1650205553613,MATH 10A,A03,083737,Patchell; Gregory David,26,0,30,4
1650205559641,MATH 10B,A01,083207,Staff,0,5,30,30
1650205559641,MATH 10B,A02,083208,Staff,0,5,30,30
1650205559641,MATH 10B,B01,083739,Staff,17,0,30,13
1650205559641,MATH 10B,B02,083740,Staff,29,0,30,1
1650205565667,MATH 18,A01,083743,Staff,8,0,30,22
1650205565667,MATH 18,A02,083744,Staff,28,0,30,2
1650205565667,MATH 18,A03,083745,Staff,23,0,30,7
1650205565667,MATH 18,A04,083746,Staff,27,0,30,3
1650205565667,MATH 18,B01,083748,Staff,0,10,30,30
1650205565667,MATH 18,B02,083749,Staff,0,7,30,30
1650205565667,MATH 18,B03,083750,Staff,0,7,30,30
1650205565667,MATH 18,B04,083751,Staff,0,8,30,30
1650205571692,MATH 20A,A01,083754,Staff,26,0,40,14
1650205577721,MATH 20B,A01,083756,Staff,0,6,30,30
1650205577721,MATH 20B,A02,083757,Staff,0,6,30,30
1650205583751,MATH 20C,A01,083760,Staff,0,12,30,30
1650205583751,MATH 20C,A02,083761,Staff,0,12,30,30
1650205583751,MATH 20C,B01,083762,Staff,14,0,30,16
1650205583751,MATH 20C,B02,083763,Staff,28,0,30,2
1650205589776,MATH 20D,A01,083765,Staff,1,2,30,29
1650205589776,MATH 20D,A02,083766,Staff,10,0,30,20
1650205589776,MATH 20D,A03,083767,Staff,28,0,30,2
1650205595804,MATH 20E,A01,083771,Staff,8,0,30,22
1650205595804,MATH 20E,A02,083772,Staff,20,0,30,10
1650205595804,MATH 20E,B01,083773,Staff,0,0,30,30
1650205595804,MATH 20E,B02,083774,Staff,12,0,30,18
1650205601834,MATH 103A,A01,083777,Staff,0,9,30,30
1650205601834,MATH 103A,A02,083778,Staff,0,10,30,30
1650205601834,MATH 103A,B01,083779,Staff,0,9,30,30
1650205601834,MATH 103A,B02,083780,Staff,0,9,30,30
1650205607876,MATH 105,A01,085443,Staff,0,17,30,30
1650205613901,MATH 109,A01,083213,Anzaldo; Leesa B,0,3,30,30
1650205613901,MATH 109,A02,083214,Anzaldo; Leesa B,0,6,30,30
1650205613901,MATH 109,B01,083215,Anzaldo; Leesa B,0,4,30,30
1650205613901,MATH 109,B02,083216,Anzaldo; Leesa B,0,4,30,30
1650205619937,MATH 142A,A01,083219,Chow; Bennett,0,12,30,30
1650205619937,MATH 142A,A02,083220,Chow; Bennett,0,11,30,30
1650205619937,MATH 142A,B01,083221,Chow; Bennett,0,11,30,30
1650205619937,MATH 142A,B02,083222,Chow; Bennett,0,12,30,30
1650205625960,MATH 193A,A01,083224,Staff,0,4,30,30
1650205625960,MATH 193A,A02,083225,Staff,0,4,30,30
1650205625960,MATH 193A,A03,083781,Staff,0,2,30,30
1650205625960,MATH 193A,A04,083782,Staff,0,1,30,30
1650205631992,MATH 197,001,091859,McAuley; Julian John,9998,0,9999,1
1650205638052,COGS 9,A01,083615,Staff,0,14,60,60
1650205644079,COGS 11,A01,083617,Boyle; Mary E. T.,24,0,40,16
1650205650121,COGS 13,A01,083071,Staff,0,30,40,40
1650205656148,COGS 14A,A01,092681,Staff,0,12,100,100
1650205662173,COGS 14B,A01,083073,Cheng; Tzu-Han,0,7,50,50
1650205668197,COGS 17,A01,092677,Staff,35,0,75,40
1650205674228,COGS 100,A01,083619,Staff,0,20,60,60
1650205680251,COGS 101A,A01,083621,Davis; Joshua Daniel,0,21,60,60
1650205686277,COGS 101B,A01,091572,Staff,6,0,60,54
1650205692302,COGS 101C,A01,083625,Delgado; Tania,20,0,30,10
1650205698326,COGS 107A,A01,083627,Boyle; Mary E. T.,0,7,60,60
1650205704354,COGS 118A,A01,083075,Staff,16,0,60,44
1650205710377,CSE 3,A50,083646,Miranda; Gregory Joseph,22,0,38,16
1650205710377,CSE 3,A51,083647,Miranda; Gregory Joseph,37,0,37,0
1650205716406,CSE 8A,A50,083650,Miranda; Gregory Joseph,0,17,40,40
1650205722433,CSE 11,A01,083080,Cao; Yingjun,0,68,40,40
1650205728462,CSE 12,A01,083652,Staff,0,7,100,100
1650205734490,CSE 15L,A01,083654,Staff,0,0,50,50
1650205734490,CSE 15L,A02,083655,Staff,6,0,50,44
1650205740514,CSE 20,A01,083657,Staff,53,0,80,27
1650205746540,CSE 30,A01,083084,Eldon; John,0,69,40,40
1650205752562,CSE 100,A01,083659,Cao; Yingjun,0,63,50,50
1650205758590,CSE 134B,A01,083661,Powell; Thomas Allan,0,27,65,65
1650205764614,CSE 140,A01,083663,Staff,1,0,75,74
1650205770640,CSE 140L,A01,083088,Eldon; John,0,4,75,75
1650205776752,CSE 175,A01,083665,Kumar; Rakesh,8,0,25,17
1650205782780,CSE 190,A00,092507,Dubnov; Shlomo,14,0,20,6
1650205788803,ECE 45,A01,083139,Staff,0,13,40,40
1650205794829,ECE 65,A50,083695,Staff,0,5,30,30
1650205800857,ECE 109,A01,091882,Touri; Behrouz,47,0,70,23
1650205806882,ECE 180,A00,083140,Abi Samra; Nicholas Camill,24,0,30,6
1650205806882,ECE 180,B00,083141,Abi Samra; Nicholas Camill,8,0,30,22
1650205812912,MATH 10A,A01,083735,Patchell; Gregory David,11,0,30,19
1650205812912,MATH 10A,A02,083736,Patchell; Gregory David,28,0,30,2
1650205812912,MATH 10A,A03,083737,Patchell; Gregory David,26,0,30,4
1650205818941,MATH 10B,A01,083207,Staff,0,5,30,30
1650205818941,MATH 10B,A02,083208,Staff,0,5,30,30
1650205818941,MATH 10B,B01,083739,Staff,17,0,30,13
1650205818941,MATH 10B,B02,083740,Staff,29,0,30,1
1650205824967,MATH 18,A01,083743,Staff,8,0,30,22
1650205824967,MATH 18,A02,083744,Staff,28,0,30,2
1650205824967,MATH 18,A03,083745,Staff,23,0,30,7
1650205824967,MATH 18,A04,083746,Staff,27,0,30,3
1650205824967,MATH 18,B01,083748,Staff,0,10,30,30
1650205824967,MATH 18,B02,083749,Staff,0,7,30,30
1650205824967,MATH 18,B03,083750,Staff,0,7,30,30
1650205824967,MATH 18,B04,083751,Staff,0,8,30,30
1650205830993,MATH 20A,A01,083754,Staff,26,0,40,14
1650205837021,MATH 20B,A01,083756,Staff,0,6,30,30
1650205837021,MATH 20B,A02,083757,Staff,0,6,30,30
1650205843046,MATH 20C,A01,083760,Staff,0,12,30,30
1650205843046,MATH 20C,A02,083761,Staff,0,12,30,30
1650205843046,MATH 20C,B01,083762,Staff,14,0,30,16
1650205843046,MATH 20C,B02,083763,Staff,28,0,30,2
1650205849075,MATH 20D,A01,083765,Staff,1,2,30,29
1650205849075,MATH 20D,A02,083766,Staff,10,0,30,20
1650205849075,MATH 20D,A03,083767,Staff,28,0,30,2
1650205855099,MATH 20E,A01,083771,Staff,8,0,30,22
1650205855099,MATH 20E,A02,083772,Staff,20,0,30,10
1650205855099,MATH 20E,B01,083773,Staff,0,0,30,30
1650205855099,MATH 20E,B02,083774,Staff,12,0,30,18
1650205861124,MATH 103A,A01,083777,Staff,0,9,30,30
1650205861124,MATH 103A,A02,083778,Staff,0,10,30,30
1650205861124,MATH 103A,B01,083779,Staff,0,9,30,30
1650205861124,MATH 103A,B02,083780,Staff,0,9,30,30
1650205867150,MATH 105,A01,085443,Staff,0,17,30,30
1650205873179,MATH 109,A01,083213,Anzaldo; Leesa B,0,3,30,30
1650205873179,MATH 109,A02,083214,Anzaldo; Leesa B,0,6,30,30
1650205873179,MATH 109,B01,083215,Anzaldo; Leesa B,0,4,30,30
1650205873179,MATH 109,B02,083216,Anzaldo; Leesa B,0,4,30,30
1650205879212,MATH 142A,A01,083219,Chow; Bennett,0,12,30,30
1650205879212,MATH 142A,A02,083220,Chow; Bennett,0,11,30,30
1650205879212,MATH 142A,B01,083221,Chow; Bennett,0,11,30,30
1650205879212,MATH 142A,B02,083222,Chow; Bennett,0,12,30,30
1650205885236,MATH 193A,A01,083224,Staff,0,4,30,30
1650205885236,MATH 193A,A02,083225,Staff,0,4,30,30
1650205885236,MATH 193A,A03,083781,Staff,0,2,30,30
1650205885236,MATH 193A,A04,083782,Staff,0,1,30,30
1650205891263,MATH 197,001,091859,McAuley; Julian John,9998,0,9999,1
1650205897319,COGS 9,A01,083615,Staff,0,14,60,60
1650205903349,COGS 11,A01,083617,Boyle; Mary E. T.,24,0,40,16
1650205909373,COGS 13,A01,083071,Staff,0,30,40,40
1650205915399,COGS 14A,A01,092681,Staff,0,12,100,100
1650205921428,COGS 14B,A01,083073,Cheng; Tzu-Han,0,7,50,50
1650205927457,COGS 17,A01,092677,Staff,35,0,75,40
1650205933489,COGS 100,A01,083619,Staff,0,20,60,60
1650205939514,COGS 101A,A01,083621,Davis; Joshua Daniel,0,21,60,60
1650205945536,COGS 101B,A01,091572,Staff,6,0,60,54
1650205951562,COGS 101C,A01,083625,Delgado; Tania,20,0,30,10
1650205957587,COGS 107A,A01,083627,Boyle; Mary E. T.,0,7,60,60
1650205963611,COGS 118A,A01,083075,Staff,16,0,60,44
1650205969641,CSE 3,A50,083646,Miranda; Gregory Joseph,22,0,38,16
1650205969641,CSE 3,A51,083647,Miranda; Gregory Joseph,37,0,37,0
1650205975671,CSE 8A,A50,083650,Miranda; Gregory Joseph,0,17,40,40
1650205981697,CSE 11,A01,083080,Cao; Yingjun,0,68,40,40
1650205987725,CSE 12,A01,083652,Staff,0,7,100,100
1650205993749,CSE 15L,A01,083654,Staff,0,0,50,50
1650205993749,CSE 15L,A02,083655,Staff,6,0,50,44
1650205999777,CSE 20,A01,083657,Staff,53,0,80,27
1650206005801,CSE 30,A01,083084,Eldon; John,0,69,40,40
1650206011839,CSE 100,A01,083659,Cao; Yingjun,0,63,50,50
1650206017876,CSE 134B,A01,083661,Powell; Thomas Allan,0,27,65,65
1650206023900,CSE 140,A01,083663,Staff,1,0,75,74
1650206029929,CSE 140L,A01,083088,Eldon; John,0,4,75,75
1650206035957,CSE 175,A01,083665,Kumar; Rakesh,8,0,25,17
1650206041985,CSE 190,A00,092507,Dubnov; Shlomo,14,0,20,6
1650206048012,ECE 45,A01,083139,Staff,0,13,40,40
1650206054038,ECE 65,A50,083695,Staff,0,5,30,30
1650206060070,ECE 109,A01,091882,Touri; Behrouz,47,0,70,23
1650206066101,ECE 180,A00,083140,Abi Samra; Nicholas Camill,24,0,30,6
1650206066101,ECE 180,B00,083141,Abi Samra; Nicholas Camill,8,0,30,22
1650206072126,MATH 10A,A01,083735,Patchell; Gregory David,11,0,30,19
1650206072126,MATH 10A,A02,083736,Patchell; Gregory David,28,0,30,2
1650206072126,MATH 10A,A03,083737,Patchell; Gregory David,26,0,30,4
1650206078160,MATH 10B,A01,083207,Staff,0,5,30,30
1650206078160,MATH 10B,A02,083208,Staff,0,5,30,30
1650206078160,MATH 10B,B01,083739,Staff,17,0,30,13
1650206078160,MATH 10B,B02,083740,Staff,29,0,30,1
1650206084194,MATH 18,A01,083743,Staff,8,0,30,22
1650206084194,MATH 18,A02,083744,Staff,28,0,30,2
1650206084194,MATH 18,A03,083745,Staff,23,0,30,7
1650206084194,MATH 18,A04,083746,Staff,27,0,30,3
1650206084194,MATH 18,B01,083748,Staff,0,10,30,30
1650206084194,MATH 18,B02,083749,Staff,0,7,30,30
1650206084194,MATH 18,B03,083750,Staff,0,7,30,30
1650206084194,MATH 18,B04,083751,Staff,0,8,30,30
1650206090221,MATH 20A,A01,083754,Staff,26,0,40,14
1650206096249,MATH 20B,A01,083756,Staff,0,6,30,30
1650206096249,MATH 20B,A02,083757,Staff,0,6,30,30
1650206102278,MATH 20C,A01,083760,Staff,0,12,30,30
1650206102278,MATH 20C,A02,083761,Staff,0,12,30,30
1650206102278,MATH 20C,B01,083762,Staff,14,0,30,16
1650206102278,MATH 20C,B02,083763,Staff,28,0,30,2
1650206108304,MATH 20D,A01,083765,Staff,1,2,30,29
1650206108304,MATH 20D,A02,083766,Staff,10,0,30,20
1650206108304,MATH 20D,A03,083767,Staff,28,0,30,2
1650206114330,MATH 20E,A01,083771,Staff,8,0,30,22
1650206114330,MATH 20E,A02,083772,Staff,20,0,30,10
1650206114330,MATH 20E,B01,083773,Staff,0,0,30,30
1650206114330,MATH 20E,B02,083774,Staff,12,0,30,18
1650206120355,MATH 103A,A01,083777,Staff,0,9,30,30
1650206120355,MATH 103A,A02,083778,Staff,0,10,30,30
1650206120355,MATH 103A,B01,083779,Staff,0,9,30,30
1650206120355,MATH 103A,B02,083780,Staff,0,9,30,30
1650206126381,MATH 105,A01,085443,Staff,0,17,30,30
1650206132407,MATH 109,A01,083213,Anzaldo; Leesa B,0,3,30,30
1650206132407,MATH 109,A02,083214,Anzaldo; Leesa B,0,6,30,30
1650206132407,MATH 109,B01,083215,Anzaldo; Leesa B,0,4,30,30
1650206132407,MATH 109,B02,083216,Anzaldo; Leesa B,0,4,30,30
1650206138431,MATH 142A,A01,083219,Chow; Bennett,0,12,30,30
1650206138431,MATH 142A,A02,083220,Chow; Bennett,0,11,30,30
1650206138431,MATH 142A,B01,083221,Chow; Bennett,0,11,30,30
1650206138431,MATH 142A,B02,083222,Chow; Bennett,0,12,30,30
1650206144455,MATH 193A,A01,083224,Staff,0,4,30,30
1650206144455,MATH 193A,A02,083225,Staff,0,4,30,30
1650206144455,MATH 193A,A03,083781,Staff,0,2,30,30
1650206144455,MATH 193A,A04,083782,Staff,0,1,30,30
1650206150480,MATH 197,001,091859,McAuley; Julian John,9998,0,9999,1
1650206156535,COGS 9,A01,083615,Staff,0,14,60,60
1650206162560,COGS 11,A01,083617,Boyle; Mary E. T.,24,0,40,16
1650206168585,COGS 13,A01,083071,Staff,0,30,40,40
1650206174613,COGS 14A,A01,092681,Staff,0,12,100,100
1650206180641,COGS 14B,A01,083073,Cheng; Tzu-Han,0,7,50,50
1650206186669,COGS 17,A01,092677,Staff,35,0,75,40
1650206192697,COGS 100,A01,083619,Staff,0,20,60,60
1650206198724,COGS 101A,A01,083621,Davis; Joshua Daniel,0,21,60,60
1650206204747,COGS 101B,A01,091572,Staff,6,0,60,54
1650206210775,COGS 101C,A01,083625,Delgado; Tania,20,0,30,10
1650206216805,COGS 107A,A01,083627,Boyle; Mary E. T.,0,7,60,60
1650206222831,COGS 118A,A01,083075,Staff,16,0,60,44
1650206228856,CSE 3,A50,083646,Miranda; Gregory Joseph,22,0,38,16
1650206228856,CSE 3,A51,083647,Miranda; Gregory Joseph,37,0,37,0
1650206234886,CSE 8A,A50,083650,Miranda; Gregory Joseph,0,17,40,40
1650206240911,CSE 11,A01,083080,Cao; Yingjun,0,68,40,40
1650206246937,CSE 12,A01,083652,Staff,0,7,100,100
1650206252965,CSE 15L,A01,083654,Staff,0,0,50,50
1650206252965,CSE 15L,A02,083655,Staff,6,0,50,44
1650206258993,CSE 20,A01,083657,Staff,53,0,80,27
1650206265022,CSE 30,A01,083084,Eldon; John,0,69,40,40
1650206271048,CSE 100,A01,083659,Cao; Yingjun,0,63,50,50
1650206277076,CSE 134B,A01,083661,Powell; Thomas Allan,0,27,65,65
1650206283103,CSE 140,A01,083663,Staff,1,0,75,74
1650206289132,CSE 140L,A01,083088,Eldon; John,0,4,75,75
1650206295162,CSE 175,A01,083665,Kumar; Rakesh,8,0,25,17
1650206301190,CSE 190,A00,092507,Dubnov; Shlomo,14,0,20,6
1650206307217,ECE 45,A01,083139,Staff,0,13,40,40
1650206313245,ECE 65,A50,083695,Staff,0,5,30,30
1650206319273,ECE 109,A01,091882,Touri; Behrouz,47,0,70,23
1650206325300,ECE 180,A00,083140,Abi Samra; Nicholas Camill,24,0,30,6
1650206325300,ECE 180,B00,083141,Abi Samra; Nicholas Camill,8,0,30,22
1650206331330,MATH 10A,A01,083735,Patchell; Gregory David,11,0,30,19
1650206331330,MATH 10A,A02,083736,Patchell; Gregory David,28,0,30,2
1650206331330,MATH 10A,A03,083737,Patchell; Gregory David,26,0,30,4
1650206337357,MATH 10B,A01,083207,Staff,0,5,30,30
1650206337357,MATH 10B,A02,083208,Staff,0,5,30,30
1650206337357,MATH 10B,B01,083739,Staff,17,0,30,13
1650206337357,MATH 10B,B02,083740,Staff,29,0,30,1
1650206343392,MATH 18,A01,083743,Staff,8,0,30,22
1650206343392,MATH 18,A02,083744,Staff,28,0,30,2
1650206343392,MATH 18,A03,083745,Staff,23,0,30,7
1650206343392,MATH 18,A04,083746,Staff,27,0,30,3
1650206343392,MATH 18,B01,083748,Staff,0,10,30,30
1650206343392,MATH 18,B02,083749,Staff,0,7,30,30
1650206343392,MATH 18,B03,083750,Staff,0,7,30,30
1650206343392,MATH 18,B04,083751,Staff,0,8,30,30
1650206349416,MATH 20A,A01,083754,Staff,26,0,40,14
1650206355445,MATH 20B,A01,083756,Staff,0,6,30,30
1650206355445,MATH 20B,A02,083757,Staff,0,6,30,30
1650206361470,MATH 20C,A01,083760,Staff,0,12,30,30
1650206361470,MATH 20C,A02,083761,Staff,0,12,30,30
1650206361470,MATH 20C,B01,083762,Staff,14,0,30,16
1650206361470,MATH 20C,B02,083763,Staff,28,0,30,2
1650206367494,MATH 20D,A01,083765,Staff,1,2,30,29
1650206367494,MATH 20D,A02,083766,Staff,10,0,30,20
1650206367494,MATH 20D,A03,083767,Staff,28,0,30,2
1650206373609,MATH 20E,A01,083771,Staff,8,0,30,22
1650206373609,MATH 20E,A02,083772,Staff,20,0,30,10
1650206373609,MATH 20E,B01,083773,Staff,0,0,30,30
1650206373609,MATH 20E,B02,083774,Staff,12,0,30,18
1650206379638,MATH 103A,A01,083777,Staff,0,9,30,30
1650206379638,MATH 103A,A02,083778,Staff,0,10,30,30
1650206379638,MATH 103A,B01,083779,Staff,0,9,30,30
1650206379638,MATH 103A,B02,083780,Staff,0,9,30,30
1650206385666,MATH 105,A01,085443,Staff,0,17,30,30
1650206391691,MATH 109,A01,083213,Anzaldo; Leesa B,0,3,30,30
1650206391691,MATH 109,A02,083214,Anzaldo; Leesa B,0,6,30,30
1650206391691,MATH 109,B01,083215,Anzaldo; Leesa B,0,4,30,30
1650206391691,MATH 109,B02,083216,Anzaldo; Leesa B,0,4,30,30
1650206397724,MATH 142A,A01,083219,Chow; Bennett,0,12,30,30
1650206397724,MATH 142A,A02,083220,Chow; Bennett,0,11,30,30
1650206397724,MATH 142A,B01,083221,Chow; Bennett,0,11,30,30
1650206397724,MATH 142A,B02,083222,Chow; Bennett,0,12,30,30
1650206403747,MATH 193A,A01,083224,Staff,0,4,30,30
1650206403747,MATH 193A,A02,083225,Staff,0,4,30,30
1650206403747,MATH 193A,A03,083781,Staff,0,2,30,30
1650206403747,MATH 193A,A04,083782,Staff,0,1,30,30
1650206409776,MATH 197,001,091859,McAuley; Julian John,9998,0,9999,1
1650206415831,COGS 9,A01,083615,Staff,0,14,60,60
1650206421868,COGS 11,A01,083617,Boyle; Mary E. T.,24,0,40,16
1650206427895,COGS 13,A01,083071,Staff,0,30,40,40
1650206433923,COGS 14A,A01,092681,Staff,0,12,100,100
1650206439947,COGS 14B,A01,083073,Cheng; Tzu-Han,0,7,50,50
1650206445972,COGS 17,A01,092677,Staff,35,0,75,40
1650206451998,COGS 100,A01,083619,Staff,0,20,60,60
1650206458027,COGS 101A,A01,083621,Davis; Joshua Daniel,0,21,60,60
1650206464054,COGS 101B,A01,091572,Staff,6,0,60,54
1650206470079,COGS 101C,A01,083625,Delgado; Tania,20,0,30,10
1650206476104,COGS 107A,A01,083627,Boyle; Mary E. T.,0,7,60,60
1650206482129,COGS 118A,A01,083075,Staff,16,0,60,44
1650206488158,CSE 3,A50,083646,Miranda; Gregory Joseph,22,0,38,16
1650206488158,CSE 3,A51,083647,Miranda; Gregory Joseph,37,0,37,0
1650206494188,CSE 8A,A50,083650,Miranda; Gregory Joseph,0,17,40,40
1650206500214,CSE 11,A01,083080,Cao; Yingjun,0,68,40,40
1650206506242,CSE 12,A01,083652,Staff,0,7,100,100
1650206512267,CSE 15L,A01,083654,Staff,0,0,50,50
1650206512267,CSE 15L,A02,083655,Staff,6,0,50,44
1650206518293,CSE 20,A01,083657,Staff,53,0,80,27
1650206524321,CSE 30,A01,083084,Eldon; John,0,69,40,40
1650206530347,CSE 100,A01,083659,Cao; Yingjun,0,63,50,50
1650206536375,CSE 134B,A01,083661,Powell; Thomas Allan,0,27,65,65
1650206542401,CSE 140,A01,083663,Staff,1,0,75,74
1650206548425,CSE 140L,A01,083088,Eldon; John,0,4,75,75
1650206554451,CSE 175,A01,083665,Kumar; Rakesh,8,0,25,17
1650206560476,CSE 190,A00,092507,Dubnov; Shlomo,14,0,20,6
1650206566500,ECE 45,A01,083139,Staff,0,13,40,40
1650206572524,ECE 65,A50,083695,Staff,0,5,30,30
1650206578551,ECE 109,A01,091882,Touri; Behrouz,47,0,70,23
1650206584578,ECE 180,A00,083140,Abi Samra; Nicholas Camill,24,0,30,6
1650206584578,ECE 180,B00,083141,Abi Samra; Nicholas Camill,8,0,30,22
1650206590604,MATH 10A,A01,083735,Patchell; Gregory David,11,0,30,19
1650206590604,MATH 10A,A02,083736,Patchell; Gregory David,28,0,30,2
1650206590604,MATH 10A,A03,083737,Patchell; Gregory David,26,0,30,4
1650206596635,MATH 10B,A01,083207,Staff,0,5,30,30
1650206596635,MATH 10B,A02,083208,Staff,0,5,30,30
1650206596635,MATH 10B,B01,083739,Staff,17,0,30,13
1650206596635,MATH 10B,B02,083740,Staff,29,0,30,1
1650206602665,MATH 18,A01,083743,Staff,8,0,30,22
1650206602665,MATH 18,A02,083744,Staff,28,0,30,2
1650206602665,MATH 18,A03,083745,Staff,23,0,30,7
1650206602665,MATH 18,A04,083746,Staff,27,0,30,3
1650206602665,MATH 18,B01,083748,Staff,0,10,30,30
1650206602665,MATH 18,B02,083749,Staff,0,7,30,30
1650206602665,MATH 18,B03,083750,Staff,0,7,30,30
1650206602665,MATH 18,B04,083751,Staff,0,8,30,30
1650206608693,MATH 20A,A01,083754,Staff,26,0,40,14
1650206614717,MATH 20B,A01,083756,Staff,0,6,30,30
1650206614717,MATH 20B,A02,083757,Staff,0,6,30,30
1650206620743,MATH 20C,A01,083760,Staff,0,12,30,30
1650206620743,MATH 20C,A02,083761,Staff,0,12,30,30
1650206620743,MATH 20C,B01,083762,Staff,14,0,30,16
1650206620743,MATH 20C,B02,083763,Staff,28,0,30,2
1650206626768,MATH 20D,A01,083765,Staff,1,2,30,29
1650206626768,MATH 20D,A02,083766,Staff,10,0,30,20
1650206626768,MATH 20D,A03,083767,Staff,28,0,30,2
1650206632797,MATH 20E,A01,083771,Staff,8,0,30,22
1650206632797,MATH 20E,A02,083772,Staff,20,0,30,10
1650206632797,MATH 20E,B01,083773,Staff,0,0,30,30
1650206632797,MATH 20E,B02,083774,Staff,12,0,30,18
1650206638821,MATH 103A,A01,083777,Staff,0,9,30,30
1650206638821,MATH 103A,A02,083778,Staff,0,10,30,30
1650206638821,MATH 103A,B01,083779,Staff,0,9,30,30
1650206638821,MATH 103A,B02,083780,Staff,0,9,30,30
1650206644850,MATH 105,A01,085443,Staff,0,17,30,30
1650206650875,MATH 109,A01,083213,Anzaldo; Leesa B,0,3,30,30
1650206650875,MATH 109,A02,083214,Anzaldo; Leesa B,0,6,30,30
1650206650875,MATH 109,B01,083215,Anzaldo; Leesa B,0,4,30,30
1650206650875,MATH 109,B02,083216,Anzaldo; Leesa B,0,4,30,30
1650206656904,MATH 142A,A01,083219,Chow; Bennett,0,12,30,30
1650206656904,MATH 142A,A02,083220,Chow; Bennett,0,11,30,30
1650206656904,MATH 142A,B01,083221,Chow; Bennett,0,11,30,30
1650206656904,MATH 142A,B02,083222,Chow; Bennett,0,12,30,30
1650206662930,MATH 193A,A01,083224,Staff,0,4,30,30
1650206662930,MATH 193A,A02,083225,Staff,0,4,30,30
1650206662930,MATH 193A,A03,083781,Staff,0,2,30,30
1650206662930,MATH 193A,A04,083782,Staff,0,1,30,30
1650206668953,MATH 197,001,091859,McAuley; Julian John,9998,0,9999,1
1650206675003,COGS 9,A01,083615,Staff,0,14,60,60
1650206681028,COGS 11,A01,083617,Boyle; Mary E. T.,24,0,40,16
1650206687052,COGS 13,A01,083071,Staff,0,30,40,40
1650206693081,COGS 14A,A01,092681,Staff,0,12,100,100
1650206699105,COGS 14B,A01,083073,Cheng; Tzu-Han,0,7,50,50
1650206705130,COGS 17,A01,092677,Staff,35,0,75,40
1650206711157,COGS 100,A01,083619,Staff,0,20,60,60
1650206717183,COGS 101A,A01,083621,Davis; Joshua Daniel,0,21,60,60
1650206723210,COGS 101B,A01,091572,Staff,6,0,60,54
1650206729234,COGS 101C,A01,083625,Delgado; Tania,20,0,30,10
1650206735262,COGS 107A,A01,083627,Boyle; Mary E. T.,0,7,60,60
1650206741289,COGS 118A,A01,083075,Staff,16,0,60,44
1650206747313,CSE 3,A50,083646,Miranda; Gregory Joseph,22,0,38,16
1650206747313,CSE 3,A51,083647,Miranda; Gregory Joseph,37,0,37,0
1650206753337,CSE 8A,A50,083650,Miranda; Gregory Joseph,0,17,40,40
1650206759364,CSE 11,A01,083080,Cao; Yingjun,0,68,40,40
1650206765390,CSE 12,A01,083652,Staff,0,7,100,100
1650206771418,CSE 15L,A01,083654,Staff,0,0,50,50
1650206771418,CSE 15L,A02,083655,Staff,6,0,50,44
1650206777446,CSE 20,A01,083657,Staff,53,0,80,27
1650206783470,CSE 30,A01,083084,Eldon; John,0,69,40,40
1650206789494,CSE 100,A01,083659,Cao; Yingjun,0,63,50,50
1650206795519,CSE 134B,A01,083661,Powell; Thomas Allan,0,27,65,65
1650206801545,CSE 140,A01,083663,Staff,1,0,75,74
1650206807570,CSE 140L,A01,083088,Eldon; John,0,4,75,75
1650206813596,CSE 175,A01,083665,Kumar; Rakesh,8,0,25,17
1650206819622,CSE 190,A00,092507,Dubnov; Shlomo,14,0,20,6
1650206825650,ECE 45,A01,083139,Staff,0,13,40,40
1650206831679,ECE 65,A50,083695,Staff,0,5,30,30
1650206837704,ECE 109,A01,091882,Touri; Behrouz,47,0,70,23
1650206843727,ECE 180,A00,083140,Abi Samra; Nicholas Camill,24,0,30,6
1650206843727,ECE 180,B00,083141,Abi Samra; Nicholas Camill,8,0,30,22
1650206849751,MATH 10A,A01,083735,Patchell; Gregory David,11,0,30,19
1650206849751,MATH 10A,A02,083736,Patchell; Gregory David,28,0,30,2
1650206849751,MATH 10A,A03,083737,Patchell; Gregory David,26,0,30,4
1650206855776,MATH 10B,A01,083207,Staff,0,5,30,30
1650206855776,MATH 10B,A02,083208,Staff,0,5,30,30
1650206855776,MATH 10B,B01,083739,Staff,17,0,30,13
1650206855776,MATH 10B,B02,083740,Staff,29,0,30,1
1650206861802,MATH 18,A01,083743,Staff,8,0,30,22
1650206861802,MATH 18,A02,083744,Staff,28,0,30,2
1650206861802,MATH 18,A03,083745,Staff,23,0,30,7
1650206861802,MATH 18,A04,083746,Staff,27,0,30,3
1650206861802,MATH 18,B01,083748,Staff,0,10,30,30
1650206861802,MATH 18,B02,083749,Staff,0,7,30,30
1650206861802,MATH 18,B03,083750,Staff,0,7,30,30
1650206861802,MATH 18,B04,083751,Staff,0,8,30,30
1650206867837,MATH 20A,A01,083754,Staff,26,0,40,14
1650206873862,MATH 20B,A01,083756,Staff,0,6,30,30
1650206873862,MATH 20B,A02,083757,Staff,0,6,30,30
1650206879887,MATH 20C,A01,083760,Staff,0,12,30,30
1650206879887,MATH 20C,A02,083761,Staff,0,12,30,30
1650206879887,MATH 20C,B01,083762,Staff,14,0,30,16
1650206879887,MATH 20C,B02,083763,Staff,28,0,30,2
1650206885914,MATH 20D,A01,083765,Staff,1,2,30,29
1650206885914,MATH 20D,A02,083766,Staff,10,0,30,20
1650206885914,MATH 20D,A03,083767,Staff,28,0,30,2
1650206891939,MATH 20E,A01,083771,Staff,8,0,30,22
1650206891939,MATH 20E,A02,083772,Staff,20,0,30,10
1650206891939,MATH 20E,B01,083773,Staff,0,0,30,30
1650206891939,MATH 20E,B02,083774,Staff,12,0,30,18
1650206897965,MATH 103A,A01,083777,Staff,0,9,30,30
1650206897965,MATH 103A,A02,083778,Staff,0,10,30,30
1650206897965,MATH 103A,B01,083779,Staff,0,9,30,30
1650206897965,MATH 103A,B02,083780,Staff,0,9,30,30
1650206903993,MATH 105,A01,085443,Staff,0,17,30,30
1650206910020,MATH 109,A01,083213,Anzaldo; Leesa B,0,3,30,30
1650206910020,MATH 109,A02,083214,Anzaldo; Leesa B,0,6,30,30
1650206910020,MATH 109,B01,083215,Anzaldo; Leesa B,0,4,30,30
1650206910020,MATH 109,B02,083216,Anzaldo; Leesa B,0,4,30,30
1650206916046,MATH 142A,A01,083219,Chow; Bennett,0,12,30,30
1650206916046,MATH 142A,A02,083220,Chow; Bennett,0,11,30,30
1650206916046,MATH 142A,B01,083221,Chow; Bennett,0,11,30,30
1650206916046,MATH 142A,B02,083222,Chow; Bennett,0,12,30,30
1650206922074,MATH 193A,A01,083224,Staff,0,4,30,30
1650206922074,MATH 193A,A02,083225,Staff,0,4,30,30
1650206922074,MATH 193A,A03,083781,Staff,0,2,30,30
1650206922074,MATH 193A,A04,083782,Staff,0,1,30,30
1650206928101,MATH 197,001,091859,McAuley; Julian John,9998,0,9999,1
1650206934158,COGS 9,A01,083615,Staff,0,14,60,60
1650206940191,COGS 11,A01,083617,Boyle; Mary E. T.,24,0,40,16
1650206946217,COGS 13,A01,083071,Staff,0,30,40,40
1650206952245,COGS 14A,A01,092681,Staff,0,12,100,100
1650206958271,COGS 14B,A01,083073,Cheng; Tzu-Han,0,7,50,50
1650206964391,COGS 17,A01,092677,Staff,35,0,75,40
1650206970416,COGS 100,A01,083619,Staff,0,20,60,60
1650206976440,COGS 101A,A01,083621,Davis; Joshua Daniel,0,21,60,60
1650206982467,COGS 101B,A01,091572,Staff,6,0,60,54
1650206988490,COGS 101C,A01,083625,Delgado; Tania,20,0,30,10
1650206994515,COGS 107A,A01,083627,Boyle; Mary E. T.,0,7,60,60
1650207000544,COGS 118A,A01,083075,Staff,16,0,60,44
1650207006575,CSE 3,A50,083646,Miranda; Gregory Joseph,22,0,38,16
1650207006575,CSE 3,A51,083647,Miranda; Gregory Joseph,37,0,37,0
1650207012608,CSE 8A,A50,083650,Miranda; Gregory Joseph,0,17,40,40
1650207018638,CSE 11,A01,083080,Cao; Yingjun,0,68,40,40
1650207024662,CSE 12,A01,083652,Staff,0,7,100,100
1650207030689,CSE 15L,A01,083654,Staff,0,0,50,50
1650207030689,CSE 15L,A02,083655,Staff,6,0,50,44
1650207036717,CSE 20,A01,083657,Staff,53,0,80,27
1650207042743,CSE 30,A01,083084,Eldon; John,0,69,40,40
1650207048768,CSE 100,A01,083659,Cao; Yingjun,0,63,50,50
1650207054797,CSE 134B,A01,083661,Powell; Thomas Allan,0,27,65,65
1650207060821,CSE 140,A01,083663,Staff,1,0,75,74
1650207066843,CSE 140L,A01,083088,Eldon; John,0,4,75,75
1650207072868,CSE 175,A01,083665,Kumar; Rakesh,8,0,25,17
1650207078894,CSE 190,A00,092507,Dubnov; Shlomo,14,0,20,6
1650207084921,ECE 45,A01,083139,Staff,0,13,40,40
1650207090948,ECE 65,A50,083695,Staff,0,5,30,30
1650207096972,ECE 109,A01,091882,Touri; Behrouz,47,0,70,23
1650207102998,ECE 180,A00,083140,Abi Samra; Nicholas Camill,24,0,30,6
1650207102998,ECE 180,B00,083141,Abi Samra; Nicholas Camill,8,0,30,22
1650207109024,MATH 10A,A01,083735,Patchell; Gregory David,11,0,30,19
1650207109024,MATH 10A,A02,083736,Patchell; Gregory David,28,0,30,2
1650207109024,MATH 10A,A03,083737,Patchell; Gregory David,26,0,30,4
1650207115053,MATH 10B,A01,083207,Staff,0,5,30,30
1650207115053,MATH 10B,A02,083208,Staff,0,5,30,30
1650207115053,MATH 10B,B01,083739,Staff,17,0,30,13
1650207115053,MATH 10B,B02,083740,Staff,29,0,30,1
1650207121085,MATH 18,A01,083743,Staff,8,0,30,22
1650207121085,MATH 18,A02,083744,Staff,28,0,30,2
1650207121085,MATH 18,A03,083745,Staff,23,0,30,7
1650207121085,MATH 18,A04,083746,Staff,27,0,30,3
1650207121085,MATH 18,B01,083748,Staff,0,10,30,30
1650207121085,MATH 18,B02,083749,Staff,0,7,30,30
1650207121085,MATH 18,B03,083750,Staff,0,7,30,30
1650207121085,MATH 18,B04,083751,Staff,0,8,30,30
1650207127117,MATH 20A,A01,083754,Staff,26,0,40,14
1650207133144,MATH 20B,A01,083756,Staff,0,6,30,30
1650207133144,MATH 20B,A02,083757,Staff,0,6,30,30
1650207139173,MATH 20C,A01,083760,Staff,0,12,30,30
1650207139173,MATH 20C,A02,083761,Staff,0,12,30,30
1650207139173,MATH 20C,B01,083762,Staff,14,0,30,16
1650207139173,MATH 20C,B02,083763,Staff,28,0,30,2
1650207145203,MATH 20D,A01,083765,Staff,1,2,30,29
1650207145203,MATH 20D,A02,083766,Staff,10,0,30,20
1650207145203,MATH 20D,A03,083767,Staff,28,0,30,2
1650207151226,MATH 20E,A01,083771,Staff,8,0,30,22
1650207151226,MATH 20E,A02,083772,Staff,20,0,30,10
1650207151226,MATH 20E,B01,083773,Staff,0,0,30,30
1650207151226,MATH 20E,B02,083774,Staff,12,0,30,18
1650207157255,MATH 103A,A01,083777,Staff,0,9,30,30
1650207157255,MATH 103A,A02,083778,Staff,0,10,30,30
1650207157255,MATH 103A,B01,083779,Staff,0,9,30,30
1650207157255,MATH 103A,B02,083780,Staff,0,9,30,30
1650207163283,MATH 105,A01,085443,Staff,0,17,30,30
1650207169313,MATH 109,A01,083213,Anzaldo; Leesa B,0,3,30,30
1650207169313,MATH 109,A02,083214,Anzaldo; Leesa B,0,6,30,30
1650207169313,MATH 109,B01,083215,Anzaldo; Leesa B,0,4,30,30
1650207169313,MATH 109,B02,083216,Anzaldo; Leesa B,0,4,30,30
1650207175344,MATH 142A,A01,083219,Chow; Bennett,0,12,30,30
1650207175344,MATH 142A,A02,083220,Chow; Bennett,0,11,30,30
1650207175344,MATH 142A,B01,083221,Chow; Bennett,0,11,30,30
1650207175344,MATH 142A,B02,083222,Chow; Bennett,0,12,30,30
1650207181371,MATH 193A,A01,083224,Staff,0,4,30,30
1650207181371,MATH 193A,A02,083225,Staff,0,4,30,30
1650207181371,MATH 193A,A03,083781,Staff,0,2,30,30
1650207181371,MATH 193A,A04,083782,Staff,0,1,30,30
1650207187395,MATH 197,001,091859,McAuley; Julian John,9998,0,9999,1
1650207193458,COGS 9,A01,083615,Staff,0,14,60,60
1650207199480,COGS 11,A01,083617,Boyle; Mary E. T.,24,0,40,16
1650207205507,COGS 13,A01,083071,Staff,0,30,40,40
1650207211530,COGS 14A,A01,092681,Staff,0,12,100,100
1650207217559,COGS 14B,A01,083073,Cheng; Tzu-Han,0,7,50,50
1650207223585,COGS 17,A01,092677,Staff,35,0,75,40
1650207229609,COGS 100,A01,083619,Staff,0,20,60,60
1650207235634,COGS 101A,A01,083621,Davis; Joshua Daniel,0,21,60,60
1650207241660,COGS 101B,A01,091572,Staff,6,0,60,54
1650207247688,COGS 101C,A01,083625,Delgado; Tania,20,0,30,10
1650207253718,COGS 107A,A01,083627,Boyle; Mary E. T.,0,7,60,60
1650207259745,COGS 118A,A01,083075,Staff,16,0,60,44
1650207265770,CSE 3,A50,083646,Miranda; Gregory Joseph,22,0,38,16
1650207265770,CSE 3,A51,083647,Miranda; Gregory Joseph,37,0,37,0
1650207271794,CSE 8A,A50,083650,Miranda; Gregory Joseph,0,17,40,40
1650207277822,CSE 11,A01,083080,Cao; Yingjun,0,68,40,40
1650207283847,CSE 12,A01,083652,Staff,0,7,100,100
1650207289872,CSE 15L,A01,083654,Staff,0,0,50,50
1650207289872,CSE 15L,A02,083655,Staff,6,0,50,44
1650207295897,CSE 20,A01,083657,Staff,53,0,80,27
1650207301925,CSE 30,A01,083084,Eldon; John,0,69,40,40
1650207307963,CSE 100,A01,083659,Cao; Yingjun,0,63,50,50
1650207313992,CSE 134B,A01,083661,Powell; Thomas Allan,0,27,65,65
1650207320015,CSE 140,A01,083663,Staff,1,0,75,74
1650207326043,CSE 140L,A01,083088,Eldon; John,0,4,75,75
1650207332071,CSE 175,A01,083665,Kumar; Rakesh,8,0,25,17
1650207338097,CSE 190,A00,092507,Dubnov; Shlomo,14,0,20,6
1650207344123,ECE 45,A01,083139,Staff,0,13,40,40
1650207350148,ECE 65,A50,083695,Staff,0,5,30,30
1650207356173,ECE 109,A01,091882,Touri; Behrouz,47,0,70,23
1650207362205,ECE 180,A00,083140,Abi Samra; Nicholas Camill,24,0,30,6
1650207362205,ECE 180,B00,083141,Abi Samra; Nicholas Camill,8,0,30,22
1650207368235,MATH 10A,A01,083735,Patchell; Gregory David,11,0,30,19
1650207368235,MATH 10A,A02,083736,Patchell; Gregory David,28,0,30,2
1650207368235,MATH 10A,A03,083737,Patchell; Gregory David,26,0,30,4
1650207374258,MATH 10B,A01,083207,Staff,0,5,30,30
1650207374258,MATH 10B,A02,083208,Staff,0,5,30,30
1650207374258,MATH 10B,B01,083739,Staff,17,0,30,13
1650207374258,MATH 10B,B02,083740,Staff,29,0,30,1
1650207380289,MATH 18,A01,083743,Staff,8,0,30,22
1650207380289,MATH 18,A02,083744,Staff,28,0,30,2
1650207380289,MATH 18,A03,083745,Staff,23,0,30,7
1650207380289,MATH 18,A04,083746,Staff,27,0,30,3
1650207380289,MATH 18,B01,083748,Staff,0,10,30,30
1650207380289,MATH 18,B02,083749,Staff,0,7,30,30
1650207380289,MATH 18,B03,083750,Staff,0,7,30,30
1650207380289,MATH 18,B04,083751,Staff,0,8,30,30
1650207386315,MATH 20A,A01,083754,Staff,26,0,40,14
1650207392338,MATH 20B,A01,083756,Staff,0,6,30,30
1650207392338,MATH 20B,A02,083757,Staff,0,6,30,30
1650207398365,MATH 20C,A01,083760,Staff,0,12,30,30
1650207398365,MATH 20C,A02,083761,Staff,0,12,30,30
1650207398365,MATH 20C,B01,083762,Staff,14,0,30,16
1650207398365,MATH 20C,B02,083763,Staff,28,0,30,2
1650207404395,MATH 20D,A01,083765,Staff,1,2,30,29
1650207404395,MATH 20D,A02,083766,Staff,10,0,30,20
1650207404395,MATH 20D,A03,083767,Staff,28,0,30,2
1650207410424,MATH 20E,A01,083771,Staff,8,0,30,22
1650207410424,MATH 20E,A02,083772,Staff,20,0,30,10
1650207410424,MATH 20E,B01,083773,Staff,0,0,30,30
1650207410424,MATH 20E,B02,083774,Staff,12,0,30,18
1650207416450,MATH 103A,A01,083777,Staff,0,9,30,30
1650207416450,MATH 103A,A02,083778,Staff,0,10,30,30
1650207416450,MATH 103A,B01,083779,Staff,0,9,30,30
1650207416450,MATH 103A,B02,083780,Staff,0,9,30,30
1650207422474,MATH 105,A01,085443,Staff,0,17,30,30
1650207428498,MATH 109,A01,083213,Anzaldo; Leesa B,0,3,30,30
1650207428498,MATH 109,A02,083214,Anzaldo; Leesa B,0,6,30,30
1650207428498,MATH 109,B01,083215,Anzaldo; Leesa B,0,4,30,30
1650207428498,MATH 109,B02,083216,Anzaldo; Leesa B,0,4,30,30
1650207434536,MATH 142A,A01,083219,Chow; Bennett,0,12,30,30
1650207434536,MATH 142A,A02,083220,Chow; Bennett,0,11,30,30
1650207434536,MATH 142A,B01,083221,Chow; Bennett,0,11,30,30
1650207434536,MATH 142A,B02,083222,Chow; Bennett,0,12,30,30
1650207440565,MATH 193A,A01,083224,Staff,0,4,30,30
1650207440565,MATH 193A,A02,083225,Staff,0,4,30,30
1650207440565,MATH 193A,A03,083781,Staff,0,2,30,30
1650207440565,MATH 193A,A04,083782,Staff,0,1,30,30
1650207446590,MATH 197,001,091859,McAuley; Julian John,9998,0,9999,1
1650207452647,COGS 9,A01,083615,Staff,0,14,60,60
1650207458673,COGS 11,A01,083617,Boyle; Mary E. T.,24,0,40,16
1650207464701,COGS 13,A01,083071,Staff,0,30,40,40
1650207470730,COGS 14A,A01,092681,Staff,0,12,100,100
1650207476755,COGS 14B,A01,083073,Cheng; Tzu-Han,0,7,50,50
1650207482779,COGS 17,A01,092677,Staff,35,0,75,40
1650207488803,COGS 100,A01,083619,Staff,0,20,60,60
1650207494827,COGS 101A,A01,083621,Davis; Joshua Daniel,0,21,60,60
1650207500850,COGS 101B,A01,091572,Staff,6,0,60,54
1650207506875,COGS 101C,A01,083625,Delgado; Tania,20,0,30,10
1650207512902,COGS 107A,A01,083627,Boyle; Mary E. T.,0,7,60,60
1650207518926,COGS 118A,A01,083075,Staff,16,0,60,44
1650207524951,CSE 3,A50,083646,Miranda; Gregory Joseph,22,0,38,16
1650207524951,CSE 3,A51,083647,Miranda; Gregory Joseph,37,0,37,0
1650207530987,CSE 8A,A50,083650,Miranda; Gregory Joseph,0,17,40,40
1650207537011,CSE 11,A01,083080,Cao; Yingjun,0,68,40,40
1650207543036,CSE 12,A01,083652,Staff,0,7,100,100
1650207549060,CSE 15L,A01,083654,Staff,0,0,50,50
1650207549060,CSE 15L,A02,083655,Staff,6,0,50,44
1650207555090,CSE 20,A01,083657,Staff,53,0,80,27
1650207561218,CSE 30,A01,083084,Eldon; John,0,69,40,40
1650207567244,CSE 100,A01,083659,Cao; Yingjun,0,63,50,50
1650207573279,CSE 134B,A01,083661,Powell; Thomas Allan,0,27,65,65
1650207579301,CSE 140,A01,083663,Staff,1,0,75,74
1650207585326,CSE 140L,A01,083088,Eldon; John,0,4,75,75
1650207591353,CSE 175,A01,083665,Kumar; Rakesh,8,0,25,17
1650207597378,CSE 190,A00,092507,Dubnov; Shlomo,14,0,20,6
1650207603405,ECE 45,A01,083139,Staff,0,13,40,40
1650207609429,ECE 65,A50,083695,Staff,0,5,30,30
1650207615459,ECE 109,A01,091882,Touri; Behrouz,47,0,70,23
1650207621486,ECE 180,A00,083140,Abi Samra; Nicholas Camill,24,0,30,6
1650207621486,ECE 180,B00,083141,Abi Samra; Nicholas Camill,8,0,30,22
1650207627512,MATH 10A,A01,083735,Patchell; Gregory David,11,0,30,19
1650207627512,MATH 10A,A02,083736,Patchell; Gregory David,28,0,30,2
1650207627512,MATH 10A,A03,083737,Patchell; Gregory David,26,0,30,4
1650207633537,MATH 10B,A01,083207,Staff,0,5,30,30
1650207633537,MATH 10B,A02,083208,Staff,0,5,30,30
1650207633537,MATH 10B,B01,083739,Staff,17,0,30,13
1650207633537,MATH 10B,B02,083740,Staff,29,0,30,1
1650207639564,MATH 18,A01,083743,Staff,8,0,30,22
1650207639564,MATH 18,A02,083744,Staff,28,0,30,2
1650207639564,MATH 18,A03,083745,Staff,23,0,30,7
1650207639564,MATH 18,A04,083746,Staff,27,0,30,3
1650207639564,MATH 18,B01,083748,Staff,0,10,30,30
1650207639564,MATH 18,B02,083749,Staff,0,7,30,30
1650207639564,MATH 18,B03,083750,Staff,0,7,30,30
1650207639564,MATH 18,B04,083751,Staff,0,8,30,30
1650207645591,MATH 20A,A01,083754,Staff,26,0,40,14
1650207651615,MATH 20B,A01,083756,Staff,0,6,30,30
1650207651615,MATH 20B,A02,083757,Staff,0,6,30,30
1650207657667,MATH 20C,A01,083760,Staff,0,12,30,30
1650207657667,MATH 20C,A02,083761,Staff,0,12,30,30
1650207657667,MATH 20C,B01,083762,Staff,14,0,30,16
1650207657667,MATH 20C,B02,083763,Staff,28,0,30,2
1650207663692,MATH 20D,A01,083765,Staff,1,2,30,29
1650207663692,MATH 20D,A02,083766,Staff,10,0,30,20
1650207663692,MATH 20D,A03,083767,Staff,28,0,30,2
1650207669717,MATH 20E,A01,083771,Staff,8,0,30,22
1650207669717,MATH 20E,A02,083772,Staff,20,0,30,10
1650207669717,MATH 20E,B01,083773,Staff,0,0,30,30
1650207669717,MATH 20E,B02,083774,Staff,12,0,30,18
1650207675742,MATH 103A,A01,083777,Staff,0,9,30,30
1650207675742,MATH 103A,A02,083778,Staff,0,10,30,30
1650207675742,MATH 103A,B01,083779,Staff,0,9,30,30
1650207675742,MATH 103A,B02,083780,Staff,0,9,30,30
1650207681769,MATH 105,A01,085443,Staff,0,17,30,30
1650207687795,MATH 109,A01,083213,Anzaldo; Leesa B,0,3,30,30
1650207687795,MATH 109,A02,083214,Anzaldo; Leesa B,0,6,30,30
1650207687795,MATH 109,B01,083215,Anzaldo; Leesa B,0,4,30,30
1650207687795,MATH 109,B02,083216,Anzaldo; Leesa B,0,4,30,30
1650207693820,MATH 142A,A01,083219,Chow; Bennett,0,12,30,30
1650207693820,MATH 142A,A02,083220,Chow; Bennett,0,11,30,30
1650207693820,MATH 142A,B01,083221,Chow; Bennett,0,11,30,30
1650207693820,MATH 142A,B02,083222,Chow; Bennett,0,12,30,30
1650207699845,MATH 193A,A01,083224,Staff,0,4,30,30
1650207699845,MATH 193A,A02,083225,Staff,0,4,30,30
1650207699845,MATH 193A,A03,083781,Staff,0,2,30,30
1650207699845,MATH 193A,A04,083782,Staff,0,1,30,30
1650207705868,MATH 197,001,091859,McAuley; Julian John,9998,0,9999,1
1650207711924,COGS 9,A01,083615,Staff,0,14,60,60
1650207717955,COGS 11,A01,083617,Boyle; Mary E. T.,24,0,40,16
1650207723980,COGS 13,A01,083071,Staff,0,30,40,40
1650207730010,COGS 14A,A01,092681,Staff,0,12,100,100
1650207736053,COGS 14B,A01,083073,Cheng; Tzu-Han,0,7,50,50
1650207742078,COGS 17,A01,092677,Staff,35,0,75,40
1650207748102,COGS 100,A01,083619,Staff,0,20,60,60
1650207754134,COGS 101A,A01,083621,Davis; Joshua Daniel,0,21,60,60
1650207760163,COGS 101B,A01,091572,Staff,6,0,60,54
1650207766190,COGS 101C,A01,083625,Delgado; Tania,20,0,30,10
1650207772213,COGS 107A,A01,083627,Boyle; Mary E. T.,0,7,60,60
1650207778240,COGS 118A,A01,083075,Staff,16,0,60,44
1650207784265,CSE 3,A50,083646,Miranda; Gregory Joseph,22,0,38,16
1650207784265,CSE 3,A51,083647,Miranda; Gregory Joseph,37,0,37,0
1650207790289,CSE 8A,A50,083650,Miranda; Gregory Joseph,0,17,40,40
1650207796313,CSE 11,A01,083080,Cao; Yingjun,0,68,40,40
1650207802338,CSE 12,A01,083652,Staff,0,7,100,100
1650207808363,CSE 15L,A01,083654,Staff,0,0,50,50
1650207808363,CSE 15L,A02,083655,Staff,6,0,50,44
1650207814390,CSE 20,A01,083657,Staff,53,0,80,27
1650207820413,CSE 30,A01,083084,Eldon; John,0,69,40,40
1650207826437,CSE 100,A01,083659,Cao; Yingjun,0,63,50,50
1650207832470,CSE 134B,A01,083661,Powell; Thomas Allan,0,27,65,65
1650207838493,CSE 140,A01,083663,Staff,1,0,75,74
1650207844518,CSE 140L,A01,083088,Eldon; John,0,4,75,75
1650207850542,CSE 175,A01,083665,Kumar; Rakesh,8,0,25,17
1650207856574,CSE 190,A00,092507,Dubnov; Shlomo,14,0,20,6
1650207862601,ECE 45,A01,083139,Staff,0,13,40,40
1650207868630,ECE 65,A50,083695,Staff,0,5,30,30
1650207874660,ECE 109,A01,091882,Touri; Behrouz,47,0,70,23
1650207880689,ECE 180,A00,083140,Abi Samra; Nicholas Camill,24,0,30,6
1650207880689,ECE 180,B00,083141,Abi Samra; Nicholas Camill,8,0,30,22
1650207886715,MATH 10A,A01,083735,Patchell; Gregory David,11,0,30,19
1650207886715,MATH 10A,A02,083736,Patchell; Gregory David,28,0,30,2
1650207886715,MATH 10A,A03,083737,Patchell; Gregory David,26,0,30,4
1650207892741,MATH 10B,A01,083207,Staff,0,5,30,30
1650207892741,MATH 10B,A02,083208,Staff,0,5,30,30
1650207892741,MATH 10B,B01,083739,Staff,17,0,30,13
1650207892741,MATH 10B,B02,083740,Staff,29,0,30,1
1650207898772,MATH 18,A01,083743,Staff,8,0,30,22
1650207898772,MATH 18,A02,083744,Staff,28,0,30,2
1650207898772,MATH 18,A03,083745,Staff,23,0,30,7
1650207898772,MATH 18,A04,083746,Staff,27,0,30,3
1650207898772,MATH 18,B01,083748,Staff,0,10,30,30
1650207898772,MATH 18,B02,083749,Staff,0,7,30,30
1650207898772,MATH 18,B03,083750,Staff,0,7,30,30
1650207898772,MATH 18,B04,083751,Staff,0,8,30,30
1650207904810,MATH 20A,A01,083754,Staff,26,0,40,14
1650207910834,MATH 20B,A01,083756,Staff,0,6,30,30
1650207910834,MATH 20B,A02,083757,Staff,0,6,30,30
1650207916872,MATH 20C,A01,083760,Staff,0,12,30,30
1650207916872,MATH 20C,A02,083761,Staff,0,12,30,30
1650207916872,MATH 20C,B01,083762,Staff,14,0,30,16
1650207916872,MATH 20C,B02,083763,Staff,28,0,30,2
1650207922898,MATH 20D,A01,083765,Staff,1,2,30,29
1650207922898,MATH 20D,A02,083766,Staff,10,0,30,20
1650207922898,MATH 20D,A03,083767,Staff,28,0,30,2
1650207928924,MATH 20E,A01,083771,Staff,8,0,30,22
1650207928924,MATH 20E,A02,083772,Staff,20,0,30,10
1650207928924,MATH 20E,B01,083773,Staff,0,0,30,30
1650207928924,MATH 20E,B02,083774,Staff,12,0,30,18
1650207934953,MATH 103A,A01,083777,Staff,0,9,30,30
1650207934953,MATH 103A,A02,083778,Staff,0,10,30,30
1650207934953,MATH 103A,B01,083779,Staff,0,9,30,30
1650207934953,MATH 103A,B02,083780,Staff,0,9,30,30
1650207940982,MATH 105,A01,085443,Staff,0,17,30,30
1650207947008,MATH 109,A01,083213,Anzaldo; Leesa B,0,3,30,30
1650207947008,MATH 109,A02,083214,Anzaldo; Leesa B,0,6,30,30
1650207947008,MATH 109,B01,083215,Anzaldo; Leesa B,0,4,30,30
1650207947008,MATH 109,B02,083216,Anzaldo; Leesa B,0,4,30,30
1650207953033,MATH 142A,A01,083219,Chow; Bennett,0,12,30,30
1650207953033,MATH 142A,A02,083220,Chow; Bennett,0,11,30,30
1650207953033,MATH 142A,B01,083221,Chow; Bennett,0,11,30,30
1650207953033,MATH 142A,B02,083222,Chow; Bennett,0,12,30,30
1650207959059,MATH 193A,A01,083224,Staff,0,4,30,30
1650207959059,MATH 193A,A02,083225,Staff,0,4,30,30
1650207959059,MATH 193A,A03,083781,Staff,0,2,30,30
1650207959059,MATH 193A,A04,083782,Staff,0,1,30,30
1650207965086,MATH 197,001,091859,McAuley; Julian John,9998,0,9999,1
1650207971150,COGS 9,A01,083615,Staff,0,14,60,60
1650207977176,COGS 11,A01,083617,Boyle; Mary E. T.,24,0,40,16
1650207983199,COGS 13,A01,083071,Staff,0,30,40,40
1650207989221,COGS 14A,A01,092681,Staff,0,12,100,100
1650207995248,COGS 14B,A01,083073,Cheng; Tzu-Han,0,7,50,50
1650208001274,COGS 17,A01,092677,Staff,35,0,75,40
1650208007298,COGS 100,A01,083619,Staff,0,20,60,60
1650208013324,COGS 101A,A01,083621,Davis; Joshua Daniel,0,21,60,60
1650208019350,COGS 101B,A01,091572,Staff,6,0,60,54
1650208025374,COGS 101C,A01,083625,Delgado; Tania,20,0,30,10
1650208031400,COGS 107A,A01,083627,Boyle; Mary E. T.,0,7,60,60
1650208037426,COGS 118A,A01,083075,Staff,16,0,60,44
1650208043455,CSE 3,A50,083646,Miranda; Gregory Joseph,22,0,38,16
1650208043455,CSE 3,A51,083647,Miranda; Gregory Joseph,37,0,37,0
1650208049486,CSE 8A,A50,083650,Miranda; Gregory Joseph,0,17,40,40
1650208055513,CSE 11,A01,083080,Cao; Yingjun,0,68,40,40
1650208061541,CSE 12,A01,083652,Staff,0,7,100,100
1650208067565,CSE 15L,A01,083654,Staff,0,0,50,50
1650208067565,CSE 15L,A02,083655,Staff,6,0,50,44
1650208073590,CSE 20,A01,083657,Staff,53,0,80,27
1650208079618,CSE 30,A01,083084,Eldon; John,0,69,40,40
1650208085643,CSE 100,A01,083659,Cao; Yingjun,0,63,50,50
1650208091677,CSE 134B,A01,083661,Powell; Thomas Allan,0,27,65,65
1650208097707,CSE 140,A01,083663,Staff,1,0,75,74
1650208103730,CSE 140L,A01,083088,Eldon; John,0,4,75,75
1650208109753,CSE 175,A01,083665,Kumar; Rakesh,8,0,25,17
1650208115785,CSE 190,A00,092507,Dubnov; Shlomo,14,0,20,6
1650208121813,ECE 45,A01,083139,Staff,0,13,40,40
1650208127842,ECE 65,A50,083695,Staff,0,5,30,30
1650208133870,ECE 109,A01,091882,Touri; Behrouz,47,0,70,23
1650208139894,ECE 180,A00,083140,Abi Samra; Nicholas Camill,24,0,30,6
1650208139894,ECE 180,B00,083141,Abi Samra; Nicholas Camill,8,0,30,22
1650208145918,MATH 10A,A01,083735,Patchell; Gregory David,11,0,30,19
1650208145918,MATH 10A,A02,083736,Patchell; Gregory David,28,0,30,2
1650208145918,MATH 10A,A03,083737,Patchell; Gregory David,26,0,30,4
1650208151943,MATH 10B,A01,083207,Staff,0,5,30,30
1650208151943,MATH 10B,A02,083208,Staff,0,5,30,30
1650208151943,MATH 10B,B01,083739,Staff,17,0,30,13
1650208151943,MATH 10B,B02,083740,Staff,29,0,30,1
1650208158076,MATH 18,A01,083743,Staff,8,0,30,22
1650208158076,MATH 18,A02,083744,Staff,28,0,30,2
1650208158076,MATH 18,A03,083745,Staff,23,0,30,7
1650208158076,MATH 18,A04,083746,Staff,27,0,30,3
1650208158076,MATH 18,B01,083748,Staff,0,10,30,30
1650208158076,MATH 18,B02,083749,Staff,0,7,30,30
1650208158076,MATH 18,B03,083750,Staff,0,7,30,30
1650208158076,MATH 18,B04,083751,Staff,0,8,30,30
1650208164104,MATH 20A,A01,083754,Staff,26,0,40,14
1650208170129,MATH 20B,A01,083756,Staff,0,6,30,30
1650208170129,MATH 20B,A02,083757,Staff,0,6,30,30
1650208176154,MATH 20C,A01,083760,Staff,0,12,30,30
1650208176154,MATH 20C,A02,083761,Staff,0,12,30,30
1650208176154,MATH 20C,B01,083762,Staff,14,0,30,16
1650208176154,MATH 20C,B02,083763,Staff,28,0,30,2
1650208182182,MATH 20D,A01,083765,Staff,1,2,30,29
1650208182182,MATH 20D,A02,083766,Staff,10,0,30,20
1650208182182,MATH 20D,A03,083767,Staff,28,0,30,2
1650208188209,MATH 20E,A01,083771,Staff,8,0,30,22
1650208188209,MATH 20E,A02,083772,Staff,20,0,30,10
1650208188209,MATH 20E,B01,083773,Staff,0,0,30,30
1650208188209,MATH 20E,B02,083774,Staff,12,0,30,18
1650208194233,MATH 103A,A01,083777,Staff,0,9,30,30
1650208194233,MATH 103A,A02,083778,Staff,0,10,30,30
1650208194233,MATH 103A,B01,083779,Staff,0,9,30,30
1650208194233,MATH 103A,B02,083780,Staff,0,9,30,30
1650208200257,MATH 105,A01,085443,Staff,0,17,30,30
1650208206285,MATH 109,A01,083213,Anzaldo; Leesa B,0,3,30,30
1650208206285,MATH 109,A02,083214,Anzaldo; Leesa B,0,6,30,30
1650208206285,MATH 109,B01,083215,Anzaldo; Leesa B,0,4,30,30
1650208206285,MATH 109,B02,083216,Anzaldo; Leesa B,0,4,30,30
1650208212312,MATH 142A,A01,083219,Chow; Bennett,0,12,30,30
1650208212312,MATH 142A,A02,083220,Chow; Bennett,0,11,30,30
1650208212312,MATH 142A,B01,083221,Chow; Bennett,0,11,30,30
1650208212312,MATH 142A,B02,083222,Chow; Bennett,0,12,30,30
1650208218343,MATH 193A,A01,083224,Staff,0,4,30,30
1650208218343,MATH 193A,A02,083225,Staff,0,4,30,30
1650208218343,MATH 193A,A03,083781,Staff,0,2,30,30
1650208218343,MATH 193A,A04,083782,Staff,0,1,30,30
1650208224366,MATH 197,001,091859,McAuley; Julian John,9998,0,9999,1
1650208230430,COGS 9,A01,083615,Staff,0,14,60,60
1650208236454,COGS 11,A01,083617,Boyle; Mary E. T.,24,0,40,16
1650208242477,COGS 13,A01,083071,Staff,0,30,40,40
1650208248504,COGS 14A,A01,092681,Staff,0,12,100,100
1650208254543,COGS 14B,A01,083073,Cheng; Tzu-Han,0,7,50,50
1650208260579,COGS 17,A01,092677,Staff,35,0,75,40
1650208266604,COGS 100,A01,083619,Staff,0,20,60,60
1650208272627,COGS 101A,A01,083621,Davis; Joshua Daniel,0,21,60,60
1650208278651,COGS 101B,A01,091572,Staff,6,0,60,54
1650208284701,COGS 101C,A01,083625,Delgado; Tania,20,0,30,10
1650208290724,COGS 107A,A01,083627,Boyle; Mary E. T.,0,7,60,60
1650208296749,COGS 118A,A01,083075,Staff,16,0,60,44
1650208302773,CSE 3,A50,083646,Miranda; Gregory Joseph,22,0,38,16
1650208302773,CSE 3,A51,083647,Miranda; Gregory Joseph,37,0,37,0
1650208308796,CSE 8A,A50,083650,Miranda; Gregory Joseph,0,17,40,40
1650208314820,CSE 11,A01,083080,Cao; Yingjun,0,68,40,40
1650208320844,CSE 12,A01,083652,Staff,0,7,100,100
1650208326869,CSE 15L,A01,083654,Staff,0,0,50,50
1650208326869,CSE 15L,A02,083655,Staff,6,0,50,44
1650208332897,CSE 20,A01,083657,Staff,53,0,80,27
1650208338921,CSE 30,A01,083084,Eldon; John,0,69,40,40
1650208344946,CSE 100,A01,083659,Cao; Yingjun,0,63,50,50
1650208350970,CSE 134B,A01,083661,Powell; Thomas Allan,0,27,65,65
1650208356996,CSE 140,A01,083663,Staff,1,0,75,74
1650208363020,CSE 140L,A01,083088,Eldon; John,0,4,75,75
1650208369045,CSE 175,A01,083665,Kumar; Rakesh,8,0,25,17
1650208375069,CSE 190,A00,092507,Dubnov; Shlomo,14,0,20,6
1650208381092,ECE 45,A01,083139,Staff,0,13,40,40
1650208387117,ECE 65,A50,083695,Staff,0,5,30,30
1650208393142,ECE 109,A01,091882,Touri; Behrouz,47,0,70,23
1650208399169,ECE 180,A00,083140,Abi Samra; Nicholas Camill,24,0,30,6
1650208399169,ECE 180,B00,083141,Abi Samra; Nicholas Camill,8,0,30,22
1650208405194,MATH 10A,A01,083735,Patchell; Gregory David,11,0,30,19
1650208405194,MATH 10A,A02,083736,Patchell; Gregory David,28,0,30,2
1650208405194,MATH 10A,A03,083737,Patchell; Gregory David,26,0,30,4
1650208411222,MATH 10B,A01,083207,Staff,0,5,30,30
1650208411222,MATH 10B,A02,083208,Staff,0,5,30,30
1650208411222,MATH 10B,B01,083739,Staff,17,0,30,13
1650208411222,MATH 10B,B02,083740,Staff,29,0,30,1
1650208417251,MATH 18,A01,083743,Staff,8,0,30,22
1650208417251,MATH 18,A02,083744,Staff,28,0,30,2
1650208417251,MATH 18,A03,083745,Staff,23,0,30,7
1650208417251,MATH 18,A04,083746,Staff,27,0,30,3
1650208417251,MATH 18,B01,083748,Staff,0,10,30,30
1650208417251,MATH 18,B02,083749,Staff,0,7,30,30
1650208417251,MATH 18,B03,083750,Staff,0,7,30,30
1650208417251,MATH 18,B04,083751,Staff,0,8,30,30
1650208423276,MATH 20A,A01,083754,Staff,26,0,40,14
1650208429300,MATH 20B,A01,083756,Staff,0,6,30,30
1650208429300,MATH 20B,A02,083757,Staff,0,6,30,30
1650208435330,MATH 20C,A01,083760,Staff,0,12,30,30
1650208435330,MATH 20C,A02,083761,Staff,0,12,30,30
1650208435330,MATH 20C,B01,083762,Staff,14,0,30,16
1650208435330,MATH 20C,B02,083763,Staff,28,0,30,2
1650208441358,MATH 20D,A01,083765,Staff,1,2,30,29
1650208441358,MATH 20D,A02,083766,Staff,10,0,30,20
1650208441358,MATH 20D,A03,083767,Staff,28,0,30,2
1650208447389,MATH 20E,A01,083771,Staff,8,0,30,22
1650208447389,MATH 20E,A02,083772,Staff,20,0,30,10
1650208447389,MATH 20E,B01,083773,Staff,0,0,30,30
1650208447389,MATH 20E,B02,083774,Staff,12,0,30,18
1650208453413,MATH 103A,A01,083777,Staff,0,9,30,30
1650208453413,MATH 103A,A02,083778,Staff,0,10,30,30
1650208453413,MATH 103A,B01,083779,Staff,0,9,30,30
1650208453413,MATH 103A,B02,083780,Staff,0,9,30,30
1650208459438,MATH 105,A01,085443,Staff,0,17,30,30
1650208465468,MATH 109,A01,083213,Anzaldo; Leesa B,0,3,30,30
1650208465468,MATH 109,A02,083214,Anzaldo; Leesa B,0,6,30,30
1650208465468,MATH 109,B01,083215,Anzaldo; Leesa B,0,4,30,30
1650208465468,MATH 109,B02,083216,Anzaldo; Leesa B,0,4,30,30
1650208471498,MATH 142A,A01,083219,Chow; Bennett,0,12,30,30
1650208471498,MATH 142A,A02,083220,Chow; Bennett,0,11,30,30
1650208471498,MATH 142A,B01,083221,Chow; Bennett,0,11,30,30
1650208471498,MATH 142A,B02,083222,Chow; Bennett,0,12,30,30
1650208477522,MATH 193A,A01,083224,Staff,0,4,30,30
1650208477522,MATH 193A,A02,083225,Staff,0,4,30,30
1650208477522,MATH 193A,A03,083781,Staff,0,2,30,30
1650208477522,MATH 193A,A04,083782,Staff,0,1,30,30
1650208483549,MATH 197,001,091859,McAuley; Julian John,9998,0,9999,1
1650208489611,COGS 9,A01,083615,Staff,0,14,60,60
1650208495638,COGS 11,A01,083617,Boyle; Mary E. T.,24,0,40,16
1650208501662,COGS 13,A01,083071,Staff,0,30,40,40
1650208507687,COGS 14A,A01,092681,Staff,0,12,100,100
1650208513716,COGS 14B,A01,083073,Cheng; Tzu-Han,0,7,50,50
1650208519743,COGS 17,A01,092677,Staff,35,0,75,40
1650208525768,COGS 100,A01,083619,Staff,0,20,60,60
1650208531793,COGS 101A,A01,083621,Davis; Joshua Daniel,0,21,60,60
1650208537815,COGS 101B,A01,091572,Staff,6,0,60,54
1650208543844,COGS 101C,A01,083625,Delgado; Tania,20,0,30,10
1650208549870,COGS 107A,A01,083627,Boyle; Mary E. T.,0,7,60,60
1650208555897,COGS 118A,A01,083075,Staff,16,0,60,44
1650208561924,CSE 3,A50,083646,Miranda; Gregory Joseph,22,0,38,16
1650208561924,CSE 3,A51,083647,Miranda; Gregory Joseph,37,0,37,0
1650208567952,CSE 8A,A50,083650,Miranda; Gregory Joseph,0,17,40,40
1650208573980,CSE 11,A01,083080,Cao; Yingjun,0,68,40,40
1650208580005,CSE 12,A01,083652,Staff,0,7,100,100
1650208586033,CSE 15L,A01,083654,Staff,0,0,50,50
1650208586033,CSE 15L,A02,083655,Staff,6,0,50,44
1650208592057,CSE 20,A01,083657,Staff,53,0,80,27
1650208598082,CSE 30,A01,083084,Eldon; John,0,69,40,40
1650208604118,CSE 100,A01,083659,Cao; Yingjun,0,63,50,50
1650208610161,CSE 134B,A01,083661,Powell; Thomas Allan,0,27,65,65
1650208616188,CSE 140,A01,083663,Staff,1,0,75,74
1650208622216,CSE 140L,A01,083088,Eldon; John,0,4,75,75
1650208628239,CSE 175,A01,083665,Kumar; Rakesh,8,0,25,17
1650208634275,CSE 190,A00,092507,Dubnov; Shlomo,14,0,20,6
1650208640297,ECE 45,A01,083139,Staff,0,13,40,40
1650208646322,ECE 65,A50,083695,Staff,0,5,30,30
1650208652347,ECE 109,A01,091882,Touri; Behrouz,47,0,70,23
1650208658377,ECE 180,A00,083140,Abi Samra; Nicholas Camill,24,0,30,6
1650208658377,ECE 180,B00,083141,Abi Samra; Nicholas Camill,8,0,30,22
1650208664406,MATH 10A,A01,083735,Patchell; Gregory David,11,0,30,19
1650208664406,MATH 10A,A02,083736,Patchell; Gregory David,28,0,30,2
1650208664406,MATH 10A,A03,083737,Patchell; Gregory David,26,0,30,4
1650208670440,MATH 10B,A01,083207,Staff,0,5,30,30
1650208670440,MATH 10B,A02,083208,Staff,0,5,30,30
1650208670440,MATH 10B,B01,083739,Staff,17,0,30,13
1650208670440,MATH 10B,B02,083740,Staff,29,0,30,1
1650208676479,MATH 18,A01,083743,Staff,8,0,30,22
1650208676479,MATH 18,A02,083744,Staff,28,0,30,2
1650208676479,MATH 18,A03,083745,Staff,23,0,30,7
1650208676479,MATH 18,A04,083746,Staff,27,0,30,3
1650208676479,MATH 18,B01,083748,Staff,0,10,30,30
1650208676479,MATH 18,B02,083749,Staff,0,7,30,30
1650208676479,MATH 18,B03,083750,Staff,0,7,30,30
1650208676479,MATH 18,B04,083751,Staff,0,8,30,30
1650208682508,MATH 20A,A01,083754,Staff,26,0,40,14
1650208688538,MATH 20B,A01,083756,Staff,0,6,30,30
1650208688538,MATH 20B,A02,083757,Staff,0,6,30,30
1650208694563,MATH 20C,A01,083760,Staff,0,12,30,30
1650208694563,MATH 20C,A02,083761,Staff,0,12,30,30
1650208694563,MATH 20C,B01,083762,Staff,14,0,30,16
1650208694563,MATH 20C,B02,083763,Staff,28,0,30,2
1650208700591,MATH 20D,A01,083765,Staff,1,2,30,29
1650208700591,MATH 20D,A02,083766,Staff,10,0,30,20
1650208700591,MATH 20D,A03,083767,Staff,28,0,30,2
1650208706617,MATH 20E,A01,083771,Staff,8,0,30,22
1650208706617,MATH 20E,A02,083772,Staff,20,0,30,10
1650208706617,MATH 20E,B01,083773,Staff,0,0,30,30
1650208706617,MATH 20E,B02,083774,Staff,12,0,30,18
1650208712642,MATH 103A,A01,083777,Staff,0,9,30,30
1650208712642,MATH 103A,A02,083778,Staff,0,10,30,30
1650208712642,MATH 103A,B01,083779,Staff,0,9,30,30
1650208712642,MATH 103A,B02,083780,Staff,0,9,30,30
1650208718680,MATH 105,A01,085443,Staff,0,17,30,30
1650208724704,MATH 109,A01,083213,Anzaldo; Leesa B,0,3,30,30
1650208724704,MATH 109,A02,083214,Anzaldo; Leesa B,0,6,30,30
1650208724704,MATH 109,B01,083215,Anzaldo; Leesa B,0,4,30,30
1650208724704,MATH 109,B02,083216,Anzaldo; Leesa B,0,4,30,30
1650208730730,MATH 142A,A01,083219,Chow; Bennett,0,12,30,30
1650208730730,MATH 142A,A02,083220,Chow; Bennett,0,11,30,30
1650208730730,MATH 142A,B01,083221,Chow; Bennett,0,11,30,30
1650208730730,MATH 142A,B02,083222,Chow; Bennett,0,12,30,30
1650208736755,MATH 193A,A01,083224,Staff,0,4,30,30
1650208736755,MATH 193A,A02,083225,Staff,0,4,30,30
1650208736755,MATH 193A,A03,083781,Staff,0,2,30,30
1650208736755,MATH 193A,A04,083782,Staff,0,1,30,30
1650208742789,MATH 197,001,091859,McAuley; Julian John,9998,0,9999,1
1650208748912,COGS 9,A01,083615,Staff,0,14,60,60
1650208754935,COGS 11,A01,083617,Boyle; Mary E. T.,24,0,40,16
1650208760958,COGS 13,A01,083071,Staff,0,30,40,40
1650208766990,COGS 14A,A01,092681,Staff,0,12,100,100
1650208773016,COGS 14B,A01,083073,Cheng; Tzu-Han,0,7,50,50
1650208779040,COGS 17,A01,092677,Staff,35,0,75,40
1650208785065,COGS 100,A01,083619,Staff,0,20,60,60
1650208791088,COGS 101A,A01,083621,Davis; Joshua Daniel,0,21,60,60
1650208797115,COGS 101B,A01,091572,Staff,6,0,60,54
1650208803140,COGS 101C,A01,083625,Delgado; Tania,20,0,30,10
1650208809163,COGS 107A,A01,083627,Boyle; Mary E. T.,0,7,60,60
1650208815187,COGS 118A,A01,083075,Staff,16,0,60,44
1650208821217,CSE 3,A50,083646,Miranda; Gregory Joseph,22,0,38,16
1650208821217,CSE 3,A51,083647,Miranda; Gregory Joseph,37,0,37,0
1650208827242,CSE 8A,A50,083650,Miranda; Gregory Joseph,0,17,40,40
1650208833264,CSE 11,A01,083080,Cao; Yingjun,0,68,40,40
1650208839288,CSE 12,A01,083652,Staff,0,7,100,100
1650208845315,CSE 15L,A01,083654,Staff,0,0,50,50
1650208845315,CSE 15L,A02,083655,Staff,6,0,50,44
1650208851342,CSE 20,A01,083657,Staff,53,0,80,27
1650208857367,CSE 30,A01,083084,Eldon; John,0,69,40,40
1650208863393,CSE 100,A01,083659,Cao; Yingjun,0,63,50,50
1650208869421,CSE 134B,A01,083661,Powell; Thomas Allan,0,27,65,65
1650208875446,CSE 140,A01,083663,Staff,1,0,75,74
1650208881469,CSE 140L,A01,083088,Eldon; John,0,4,75,75
1650208887497,CSE 175,A01,083665,Kumar; Rakesh,8,0,25,17
1650208893524,CSE 190,A00,092507,Dubnov; Shlomo,14,0,20,6
1650208899549,ECE 45,A01,083139,Staff,0,13,40,40
1650208905576,ECE 65,A50,083695,Staff,0,5,30,30
1650208911599,ECE 109,A01,091882,Touri; Behrouz,47,0,70,23
1650208917623,ECE 180,A00,083140,Abi Samra; Nicholas Camill,24,0,30,6
1650208917623,ECE 180,B00,083141,Abi Samra; Nicholas Camill,8,0,30,22
1650208923649,MATH 10A,A01,083735,Patchell; Gregory David,11,0,30,19
1650208923649,MATH 10A,A02,083736,Patchell; Gregory David,28,0,30,2
1650208923649,MATH 10A,A03,083737,Patchell; Gregory David,26,0,30,4
1650208929682,MATH 10B,A01,083207,Staff,0,5,30,30
1650208929682,MATH 10B,A02,083208,Staff,0,5,30,30
1650208929682,MATH 10B,B01,083739,Staff,17,0,30,13
1650208929682,MATH 10B,B02,083740,Staff,29,0,30,1
1650208935711,MATH 18,A01,083743,Staff,8,0,30,22
1650208935711,MATH 18,A02,083744,Staff,28,0,30,2
1650208935711,MATH 18,A03,083745,Staff,23,0,30,7
1650208935711,MATH 18,A04,083746,Staff,27,0,30,3
1650208935711,MATH 18,B01,083748,Staff,0,10,30,30
1650208935711,MATH 18,B02,083749,Staff,0,7,30,30
1650208935711,MATH 18,B03,083750,Staff,0,7,30,30
1650208935711,MATH 18,B04,083751,Staff,0,8,30,30
1650208941737,MATH 20A,A01,083754,Staff,26,0,40,14
1650208947763,MATH 20B,A01,083756,Staff,0,6,30,30
1650208947763,MATH 20B,A02,083757,Staff,0,6,30,30
1650208953787,MATH 20C,A01,083760,Staff,0,12,30,30
1650208953787,MATH 20C,A02,083761,Staff,0,12,30,30
1650208953787,MATH 20C,B01,083762,Staff,14,0,30,16
1650208953787,MATH 20C,B02,083763,Staff,28,0,30,2
1650208959815,MATH 20D,A01,083765,Staff,1,2,30,29
1650208959815,MATH 20D,A02,083766,Staff,10,0,30,20
1650208959815,MATH 20D,A03,083767,Staff,28,0,30,2
1650208965844,MATH 20E,A01,083771,Staff,8,0,30,22
1650208965844,MATH 20E,A02,083772,Staff,20,0,30,10
1650208965844,MATH 20E,B01,083773,Staff,0,0,30,30
1650208965844,MATH 20E,B02,083774,Staff,12,0,30,18
1650208971869,MATH 103A,A01,083777,Staff,0,9,30,30
1650208971869,MATH 103A,A02,083778,Staff,0,10,30,30
1650208971869,MATH 103A,B01,083779,Staff,0,9,30,30
1650208971869,MATH 103A,B02,083780,Staff,0,9,30,30
1650208977903,MATH 105,A01,085443,Staff,0,17,30,30
1650208983930,MATH 109,A01,083213,Anzaldo; Leesa B,0,3,30,30
1650208983930,MATH 109,A02,083214,Anzaldo; Leesa B,0,6,30,30
1650208983930,MATH 109,B01,083215,Anzaldo; Leesa B,0,4,30,30
1650208983930,MATH 109,B02,083216,Anzaldo; Leesa B,0,4,30,30
1650208989955,MATH 142A,A01,083219,Chow; Bennett,0,12,30,30
1650208989955,MATH 142A,A02,083220,Chow; Bennett,0,11,30,30
1650208989955,MATH 142A,B01,083221,Chow; Bennett,0,11,30,30
1650208989955,MATH 142A,B02,083222,Chow; Bennett,0,12,30,30
1650208996013,MATH 193A,A01,083224,Staff,0,4,30,30
1650208996013,MATH 193A,A02,083225,Staff,0,4,30,30
1650208996013,MATH 193A,A03,083781,Staff,0,2,30,30
1650208996013,MATH 193A,A04,083782,Staff,0,1,30,30
1650209002044,MATH 197,001,091859,McAuley; Julian John,9998,0,9999,1
1650209008147,COGS 9,A01,083615,Staff,0,14,60,60
1650209014174,COGS 11,A01,083617,Boyle; Mary E. T.,24,0,40,16
1650209020220,COGS 13,A01,083071,Staff,0,30,40,40
1650209026247,COGS 14A,A01,092681,Staff,0,12,100,100
1650209032273,COGS 14B,A01,083073,Cheng; Tzu-Han,0,7,50,50
1650209038297,COGS 17,A01,092677,Staff,35,0,75,40
1650209044338,COGS 100,A01,083619,Staff,0,20,60,60
1650209050362,COGS 101A,A01,083621,Davis; Joshua Daniel,0,21,60,60
1650209056388,COGS 101B,A01,091572,Staff,6,0,60,54
1650209062416,COGS 101C,A01,083625,Delgado; Tania,20,0,30,10
1650209068441,COGS 107A,A01,083627,Boyle; Mary E. T.,0,7,60,60
1650209074464,COGS 118A,A01,083075,Staff,16,0,60,44
1650209080505,CSE 3,A50,083646,Miranda; Gregory Joseph,22,0,38,16
1650209080505,CSE 3,A51,083647,Miranda; Gregory Joseph,37,0,37,0
1650209086538,CSE 8A,A50,083650,Miranda; Gregory Joseph,0,17,40,40
1650209092563,CSE 11,A01,083080,Cao; Yingjun,0,68,40,40
1650209098587,CSE 12,A01,083652,Staff,0,7,100,100
1650209104628,CSE 15L,A01,083654,Staff,0,0,50,50
1650209104628,CSE 15L,A02,083655,Staff,6,0,50,44
1650209110666,CSE 20,A01,083657,Staff,53,0,80,27
1650209116692,CSE 30,A01,083084,Eldon; John,0,69,40,40
1650209122724,CSE 100,A01,083659,Cao; Yingjun,0,63,50,50
1650209128748,CSE 134B,A01,083661,Powell; Thomas Allan,0,27,65,65
1650209134780,CSE 140,A01,083663,Staff,1,0,75,74
1650209140806,CSE 140L,A01,083088,Eldon; John,0,4,75,75
1650209146831,CSE 175,A01,083665,Kumar; Rakesh,8,0,25,17
1650209152856,CSE 190,A00,092507,Dubnov; Shlomo,14,0,20,6
1650209158882,ECE 45,A01,083139,Staff,0,13,40,40
1650209164906,ECE 65,A50,083695,Staff,0,5,30,30
1650209170931,ECE 109,A01,091882,Touri; Behrouz,47,0,70,23
1650209176960,ECE 180,A00,083140,Abi Samra; Nicholas Camill,24,0,30,6
1650209176960,ECE 180,B00,083141,Abi Samra; Nicholas Camill,8,0,30,22
1650209182992,MATH 10A,A01,083735,Patchell; Gregory David,11,0,30,19
1650209182992,MATH 10A,A02,083736,Patchell; Gregory David,28,0,30,2
1650209182992,MATH 10A,A03,083737,Patchell; Gregory David,26,0,30,4
1650209189018,MATH 10B,A01,083207,Staff,0,5,30,30
1650209189018,MATH 10B,A02,083208,Staff,0,5,30,30
1650209189018,MATH 10B,B01,083739,Staff,17,0,30,13
1650209189018,MATH 10B,B02,083740,Staff,29,0,30,1
1650209195045,MATH 18,A01,083743,Staff,8,0,30,22
1650209195045,MATH 18,A02,083744,Staff,28,0,30,2
1650209195045,MATH 18,A03,083745,Staff,23,0,30,7
1650209195045,MATH 18,A04,083746,Staff,27,0,30,3
1650209195045,MATH 18,B01,083748,Staff,0,10,30,30
1650209195045,MATH 18,B02,083749,Staff,0,7,30,30
1650209195045,MATH 18,B03,083750,Staff,0,7,30,30
1650209195045,MATH 18,B04,083751,Staff,0,8,30,30
1650209201069,MATH 20A,A01,083754,Staff,26,0,40,14
1650209207095,MATH 20B,A01,083756,Staff,0,6,30,30
1650209207095,MATH 20B,A02,083757,Staff,0,6,30,30
1650209213119,MATH 20C,A01,083760,Staff,0,12,30,30
1650209213119,MATH 20C,A02,083761,Staff,0,12,30,30
1650209213119,MATH 20C,B01,083762,Staff,14,0,30,16
1650209213119,MATH 20C,B02,083763,Staff,28,0,30,2
1650209219147,MATH 20D,A01,083765,Staff,1,2,30,29
1650209219147,MATH 20D,A02,083766,Staff,10,0,30,20
1650209219147,MATH 20D,A03,083767,Staff,28,0,30,2
1650209225176,MATH 20E,A01,083771,Staff,8,0,30,22
1650209225176,MATH 20E,A02,083772,Staff,20,0,30,10
1650209225176,MATH 20E,B01,083773,Staff,0,0,30,30
1650209225176,MATH 20E,B02,083774,Staff,12,0,30,18
1650209231201,MATH 103A,A01,083777,Staff,0,9,30,30
1650209231201,MATH 103A,A02,083778,Staff,0,10,30,30
1650209231201,MATH 103A,B01,083779,Staff,0,9,30,30
1650209231201,MATH 103A,B02,083780,Staff,0,9,30,30
1650209237224,MATH 105,A01,085443,Staff,0,17,30,30
1650209243252,MATH 109,A01,083213,Anzaldo; Leesa B,0,3,30,30
1650209243252,MATH 109,A02,083214,Anzaldo; Leesa B,0,6,30,30
1650209243252,MATH 109,B01,083215,Anzaldo; Leesa B,0,4,30,30
1650209243252,MATH 109,B02,083216,Anzaldo; Leesa B,0,4,30,30
1650209249275,MATH 142A,A01,083219,Chow; Bennett,0,12,30,30
1650209249275,MATH 142A,A02,083220,Chow; Bennett,0,11,30,30
1650209249275,MATH 142A,B01,083221,Chow; Bennett,0,11,30,30
1650209249275,MATH 142A,B02,083222,Chow; Bennett,0,12,30,30
1650209255304,MATH 193A,A01,083224,Staff,0,4,30,30
1650209255304,MATH 193A,A02,083225,Staff,0,4,30,30
1650209255304,MATH 193A,A03,083781,Staff,0,2,30,30
1650209255304,MATH 193A,A04,083782,Staff,0,1,30,30
1650209261330,MATH 197,001,091859,McAuley; Julian John,9998,0,9999,1
1650209267413,COGS 9,A01,083615,Staff,0,14,60,60
1650209273438,COGS 11,A01,083617,Boyle; Mary E. T.,24,0,40,16
1650209279464,COGS 13,A01,083071,Staff,0,30,40,40
1650209285491,COGS 14A,A01,092681,Staff,0,12,100,100
1650209291519,COGS 14B,A01,083073,Cheng; Tzu-Han,0,7,50,50
1650209297551,COGS 17,A01,092677,Staff,35,0,75,40
1650209303577,COGS 100,A01,083619,Staff,0,20,60,60
1650209309604,COGS 101A,A01,083621,Davis; Joshua Daniel,0,21,60,60
1650209315627,COGS 101B,A01,091572,Staff,6,0,60,54
1650209321652,COGS 101C,A01,083625,Delgado; Tania,20,0,30,10
1650209327677,COGS 107A,A01,083627,Boyle; Mary E. T.,0,7,60,60
1650209333702,COGS 118A,A01,083075,Staff,16,0,60,44
1650209339726,CSE 3,A50,083646,Miranda; Gregory Joseph,22,0,38,16
1650209339726,CSE 3,A51,083647,Miranda; Gregory Joseph,37,0,37,0
1650209345842,CSE 8A,A50,083650,Miranda; Gregory Joseph,0,17,40,40
1650209351867,CSE 11,A01,083080,Cao; Yingjun,0,68,40,40
1650209357890,CSE 12,A01,083652,Staff,0,7,100,100
1650209363917,CSE 15L,A01,083654,Staff,0,0,50,50
1650209363917,CSE 15L,A02,083655,Staff,6,0,50,44
1650209369942,CSE 20,A01,083657,Staff,53,0,80,27
1650209375969,CSE 30,A01,083084,Eldon; John,0,69,40,40
1650209381997,CSE 100,A01,083659,Cao; Yingjun,0,63,50,50
1650209388024,CSE 134B,A01,083661,Powell; Thomas Allan,0,27,65,65
1650209394049,CSE 140,A01,083663,Staff,1,0,75,74
1650209400073,CSE 140L,A01,083088,Eldon; John,0,4,75,75
1650209406105,CSE 175,A01,083665,Kumar; Rakesh,8,0,25,17
1650209412128,CSE 190,A00,092507,Dubnov; Shlomo,14,0,20,6
1650209418154,ECE 45,A01,083139,Staff,0,13,40,40
1650209424185,ECE 65,A50,083695,Staff,0,5,30,30
1650209430208,ECE 109,A01,091882,Touri; Behrouz,47,0,70,23
1650209436232,ECE 180,A00,083140,Abi Samra; Nicholas Camill,24,0,30,6
1650209436232,ECE 180,B00,083141,Abi Samra; Nicholas Camill,8,0,30,22
1650209442259,MATH 10A,A01,083735,Patchell; Gregory David,11,0,30,19
1650209442259,MATH 10A,A02,083736,Patchell; Gregory David,28,0,30,2
1650209442259,MATH 10A,A03,083737,Patchell; Gregory David,26,0,30,4
1650209448286,MATH 10B,A01,083207,Staff,0,5,30,30
1650209448286,MATH 10B,A02,083208,Staff,0,5,30,30
1650209448286,MATH 10B,B01,083739,Staff,17,0,30,13
1650209448286,MATH 10B,B02,083740,Staff,29,0,30,1
1650209454317,MATH 18,A01,083743,Staff,8,0,30,22
1650209454317,MATH 18,A02,083744,Staff,28,0,30,2
1650209454317,MATH 18,A03,083745,Staff,23,0,30,7
1650209454317,MATH 18,A04,083746,Staff,27,0,30,3
1650209454317,MATH 18,B01,083748,Staff,0,10,30,30
1650209454317,MATH 18,B02,083749,Staff,0,7,30,30
1650209454317,MATH 18,B03,083750,Staff,0,7,30,30
1650209454317,MATH 18,B04,083751,Staff,0,8,30,30
1650209460346,MATH 20A,A01,083754,Staff,26,0,40,14
1650209466375,MATH 20B,A01,083756,Staff,0,6,30,30
1650209466375,MATH 20B,A02,083757,Staff,0,6,30,30
1650209472401,MATH 20C,A01,083760,Staff,0,12,30,30
1650209472401,MATH 20C,A02,083761,Staff,0,12,30,30
1650209472401,MATH 20C,B01,083762,Staff,14,0,30,16
1650209472401,MATH 20C,B02,083763,Staff,28,0,30,2
1650209478430,MATH 20D,A01,083765,Staff,1,2,30,29
1650209478430,MATH 20D,A02,083766,Staff,10,0,30,20
1650209478430,MATH 20D,A03,083767,Staff,28,0,30,2
1650209484456,MATH 20E,A01,083771,Staff,8,0,30,22
1650209484456,MATH 20E,A02,083772,Staff,20,0,30,10
1650209484456,MATH 20E,B01,083773,Staff,0,0,30,30
1650209484456,MATH 20E,B02,083774,Staff,12,0,30,18
1650209490483,MATH 103A,A01,083777,Staff,0,9,30,30
1650209490483,MATH 103A,A02,083778,Staff,0,10,30,30
1650209490483,MATH 103A,B01,083779,Staff,0,9,30,30
1650209490483,MATH 103A,B02,083780,Staff,0,9,30,30
1650209496527,MATH 105,A01,085443,Staff,0,17,30,30
1650209502553,MATH 109,A01,083213,Anzaldo; Leesa B,0,3,30,30
1650209502553,MATH 109,A02,083214,Anzaldo; Leesa B,0,6,30,30
1650209502553,MATH 109,B01,083215,Anzaldo; Leesa B,0,4,30,30
1650209502553,MATH 109,B02,083216,Anzaldo; Leesa B,0,4,30,30
1650209508580,MATH 142A,A01,083219,Chow; Bennett,0,12,30,30
1650209508580,MATH 142A,A02,083220,Chow; Bennett,0,11,30,30
1650209508580,MATH 142A,B01,083221,Chow; Bennett,0,11,30,30
1650209508580,MATH 142A,B02,083222,Chow; Bennett,0,12,30,30
1650209514608,MATH 193A,A01,083224,Staff,0,4,30,30
1650209514608,MATH 193A,A02,083225,Staff,0,4,30,30
1650209514608,MATH 193A,A03,083781,Staff,0,2,30,30
1650209514608,MATH 193A,A04,083782,Staff,0,1,30,30
1650209520640,MATH 197,001,091859,McAuley; Julian John,9998,0,9999,1
1650209526695,COGS 9,A01,083615,Staff,0,14,60,60
1650209532722,COGS 11,A01,083617,Boyle; Mary E. T.,24,0,40,16
1650209538750,COGS 13,A01,083071,Staff,0,30,40,40
1650209544778,COGS 14A,A01,092681,Staff,0,12,100,100
1650209550803,COGS 14B,A01,083073,Cheng; Tzu-Han,0,7,50,50
1650209556831,COGS 17,A01,092677,Staff,35,0,75,40
1650209562861,COGS 100,A01,083619,Staff,0,20,60,60
1650209568890,COGS 101A,A01,083621,Davis; Joshua Daniel,0,21,60,60
1650209574916,COGS 101B,A01,091572,Staff,6,0,60,54
1650209580949,COGS 101C,A01,083625,Delgado; Tania,20,0,30,10
1650209586975,COGS 107A,A01,083627,Boyle; Mary E. T.,0,7,60,60
1650209593002,COGS 118A,A01,083075,Staff,16,0,60,44
1650209599028,CSE 3,A50,083646,Miranda; Gregory Joseph,22,0,38,16
1650209599028,CSE 3,A51,083647,Miranda; Gregory Joseph,37,0,37,0
1650209605058,CSE 8A,A50,083650,Miranda; Gregory Joseph,0,17,40,40
1650209611083,CSE 11,A01,083080,Cao; Yingjun,0,68,40,40
1650209617112,CSE 12,A01,083652,Staff,0,7,100,100
1650209623137,CSE 15L,A01,083654,Staff,0,0,50,50
1650209623137,CSE 15L,A02,083655,Staff,6,0,50,44
1650209629162,CSE 20,A01,083657,Staff,53,0,80,27
1650209635189,CSE 30,A01,083084,Eldon; John,0,69,40,40
1650209641221,CSE 100,A01,083659,Cao; Yingjun,0,63,50,50
1650209647247,CSE 134B,A01,083661,Powell; Thomas Allan,0,27,65,65
1650209653274,CSE 140,A01,083663,Staff,1,0,75,74
1650209659300,CSE 140L,A01,083088,Eldon; John,0,4,75,75
1650209665336,CSE 175,A01,083665,Kumar; Rakesh,8,0,25,17
1650209671365,CSE 190,A00,092507,Dubnov; Shlomo,14,0,20,6
1650209677391,ECE 45,A01,083139,Staff,0,13,40,40
1650209683423,ECE 65,A50,083695,Staff,0,5,30,30
1650209689450,ECE 109,A01,091882,Touri; Behrouz,47,0,70,23
1650209695473,ECE 180,A00,083140,Abi Samra; Nicholas Camill,24,0,30,6
1650209695473,ECE 180,B00,083141,Abi Samra; Nicholas Camill,8,0,30,22
1650209701503,MATH 10A,A01,083735,Patchell; Gregory David,11,0,30,19
1650209701503,MATH 10A,A02,083736,Patchell; Gregory David,28,0,30,2
1650209701503,MATH 10A,A03,083737,Patchell; Gregory David,26,0,30,4
1650209707528,MATH 10B,A01,083207,Staff,0,5,30,30
1650209707528,MATH 10B,A02,083208,Staff,0,5,30,30
1650209707528,MATH 10B,B01,083739,Staff,17,0,30,13
1650209707528,MATH 10B,B02,083740,Staff,29,0,30,1
1650209713554,MATH 18,A01,083743,Staff,8,0,30,22
1650209713554,MATH 18,A02,083744,Staff,28,0,30,2
1650209713554,MATH 18,A03,083745,Staff,23,0,30,7
1650209713554,MATH 18,A04,083746,Staff,27,0,30,3
1650209713554,MATH 18,B01,083748,Staff,0,10,30,30
1650209713554,MATH 18,B02,083749,Staff,0,7,30,30
1650209713554,MATH 18,B03,083750,Staff,0,7,30,30
1650209713554,MATH 18,B04,083751,Staff,0,8,30,30
1650209719581,MATH 20A,A01,083754,Staff,26,0,40,14
1650209725606,MATH 20B,A01,083756,Staff,0,6,30,30
1650209725606,MATH 20B,A02,083757,Staff,0,6,30,30
1650209731634,MATH 20C,A01,083760,Staff,0,12,30,30
1650209731634,MATH 20C,A02,083761,Staff,0,12,30,30
1650209731634,MATH 20C,B01,083762,Staff,14,0,30,16
1650209731634,MATH 20C,B02,083763,Staff,28,0,30,2
1650209737660,MATH 20D,A01,083765,Staff,1,2,30,29
1650209737660,MATH 20D,A02,083766,Staff,10,0,30,20
1650209737660,MATH 20D,A03,083767,Staff,28,0,30,2
1650209743686,MATH 20E,A01,083771,Staff,8,0,30,22
1650209743686,MATH 20E,A02,083772,Staff,20,0,30,10
1650209743686,MATH 20E,B01,083773,Staff,0,0,30,30
1650209743686,MATH 20E,B02,083774,Staff,12,0,30,18
1650209749716,MATH 103A,A01,083777,Staff,0,9,30,30
1650209749716,MATH 103A,A02,083778,Staff,0,10,30,30
1650209749716,MATH 103A,B01,083779,Staff,0,9,30,30
1650209749716,MATH 103A,B02,083780,Staff,0,9,30,30
1650209755751,MATH 105,A01,085443,Staff,0,17,30,30
1650209761787,MATH 109,A01,083213,Anzaldo; Leesa B,0,3,30,30
1650209761787,MATH 109,A02,083214,Anzaldo; Leesa B,0,6,30,30
1650209761787,MATH 109,B01,083215,Anzaldo; Leesa B,0,4,30,30
1650209761787,MATH 109,B02,083216,Anzaldo; Leesa B,0,4,30,30
1650209767813,MATH 142A,A01,083219,Chow; Bennett,0,12,30,30
1650209767813,MATH 142A,A02,083220,Chow; Bennett,0,11,30,30
1650209767813,MATH 142A,B01,083221,Chow; Bennett,0,11,30,30
1650209767813,MATH 142A,B02,083222,Chow; Bennett,0,12,30,30
1650209773841,MATH 193A,A01,083224,Staff,0,4,30,30
1650209773841,MATH 193A,A02,083225,Staff,0,4,30,30
1650209773841,MATH 193A,A03,083781,Staff,0,2,30,30
1650209773841,MATH 193A,A04,083782,Staff,0,1,30,30
1650209779867,MATH 197,001,091859,McAuley; Julian John,9998,0,9999,1
1650209785929,COGS 9,A01,083615,Staff,0,14,60,60
1650209791952,COGS 11,A01,083617,Boyle; Mary E. T.,24,0,40,16
1650209797978,COGS 13,A01,083071,Staff,0,30,40,40
1650209804006,COGS 14A,A01,092681,Staff,0,12,100,100
1650209810032,COGS 14B,A01,083073,Cheng; Tzu-Han,0,7,50,50
1650209816058,COGS 17,A01,092677,Staff,35,0,75,40
1650209822081,COGS 100,A01,083619,Staff,0,20,60,60
1650209828107,COGS 101A,A01,083621,Davis; Joshua Daniel,0,21,60,60
1650209834134,COGS 101B,A01,091572,Staff,6,0,60,54
1650209840158,COGS 101C,A01,083625,Delgado; Tania,20,0,30,10
1650209846184,COGS 107A,A01,083627,Boyle; Mary E. T.,0,7,60,60
1650209852208,COGS 118A,A01,083075,Staff,16,0,60,44
1650209858235,CSE 3,A50,083646,Miranda; Gregory Joseph,22,0,38,16
1650209858235,CSE 3,A51,083647,Miranda; Gregory Joseph,37,0,37,0
1650209864261,CSE 8A,A50,083650,Miranda; Gregory Joseph,0,17,40,40
1650209870285,CSE 11,A01,083080,Cao; Yingjun,0,68,40,40
1650209876311,CSE 12,A01,083652,Staff,0,7,100,100
1650209882336,CSE 15L,A01,083654,Staff,0,0,50,50
1650209882336,CSE 15L,A02,083655,Staff,6,0,50,44
1650209888362,CSE 20,A01,083657,Staff,53,0,80,27
1650209894385,CSE 30,A01,083084,Eldon; John,0,69,40,40
1650209900421,CSE 100,A01,083659,Cao; Yingjun,0,63,50,50
1650209906445,CSE 134B,A01,083661,Powell; Thomas Allan,0,27,65,65
1650209912469,CSE 140,A01,083663,Staff,1,0,75,74
1650209918494,CSE 140L,A01,083088,Eldon; John,0,4,75,75
1650209924521,CSE 175,A01,083665,Kumar; Rakesh,8,0,25,17
1650209930546,CSE 190,A00,092507,Dubnov; Shlomo,14,0,20,6
1650209936573,ECE 45,A01,083139,Staff,0,13,40,40
1650209942687,ECE 65,A50,083695,Staff,0,5,30,30
1650209948715,ECE 109,A01,091882,Touri; Behrouz,47,0,70,23
1650209954737,ECE 180,A00,083140,Abi Samra; Nicholas Camill,24,0,30,6
1650209954737,ECE 180,B00,083141,Abi Samra; Nicholas Camill,8,0,30,22
1650209960771,MATH 10A,A01,083735,Patchell; Gregory David,11,0,30,19
1650209960771,MATH 10A,A02,083736,Patchell; Gregory David,28,0,30,2
1650209960771,MATH 10A,A03,083737,Patchell; Gregory David,26,0,30,4
1650209966795,MATH 10B,A01,083207,Staff,0,5,30,30
1650209966795,MATH 10B,A02,083208,Staff,0,5,30,30
1650209966795,MATH 10B,B01,083739,Staff,17,0,30,13
1650209966795,MATH 10B,B02,083740,Staff,29,0,30,1
1650209972820,MATH 18,A01,083743,Staff,8,0,30,22
1650209972820,MATH 18,A02,083744,Staff,28,0,30,2
1650209972820,MATH 18,A03,083745,Staff,23,0,30,7
1650209972820,MATH 18,A04,083746,Staff,27,0,30,3
1650209972820,MATH 18,B01,083748,Staff,0,10,30,30
1650209972820,MATH 18,B02,083749,Staff,0,7,30,30
1650209972820,MATH 18,B03,083750,Staff,0,7,30,30
1650209972820,MATH 18,B04,083751,Staff,0,8,30,30
1650209978844,MATH 20A,A01,083754,Staff,26,0,40,14
1650209984871,MATH 20B,A01,083756,Staff,0,6,30,30
1650209984871,MATH 20B,A02,083757,Staff,0,6,30,30
1650209990897,MATH 20C,A01,083760,Staff,0,12,30,30
1650209990897,MATH 20C,A02,083761,Staff,0,12,30,30
1650209990897,MATH 20C,B01,083762,Staff,14,0,30,16
1650209990897,MATH 20C,B02,083763,Staff,28,0,30,2
1650209996922,MATH 20D,A01,083765,Staff,1,2,30,29
1650209996922,MATH 20D,A02,083766,Staff,10,0,30,20
1650209996922,MATH 20D,A03,083767,Staff,28,0,30,2
1650210002951,MATH 20E,A01,083771,Staff,8,0,30,22
1650210002951,MATH 20E,A02,083772,Staff,20,0,30,10
1650210002951,MATH 20E,B01,083773,Staff,0,0,30,30
1650210002951,MATH 20E,B02,083774,Staff,12,0,30,18
1650210008979,MATH 103A,A01,083777,Staff,0,9,30,30
1650210008979,MATH 103A,A02,083778,Staff,0,10,30,30
1650210008979,MATH 103A,B01,083779,Staff,0,9,30,30
1650210008979,MATH 103A,B02,083780,Staff,0,9,30,30
1650210015003,MATH 105,A01,085443,Staff,0,17,30,30
1650210021027,MATH 109,A01,083213,Anzaldo; Leesa B,0,3,30,30
1650210021027,MATH 109,A02,083214,Anzaldo; Leesa B,0,6,30,30
1650210021027,MATH 109,B01,083215,Anzaldo; Leesa B,0,4,30,30
1650210021027,MATH 109,B02,083216,Anzaldo; Leesa B,0,4,30,30
1650210027059,MATH 142A,A01,083219,Chow; Bennett,0,12,30,30
1650210027059,MATH 142A,A02,083220,Chow; Bennett,0,11,30,30
1650210027059,MATH 142A,B01,083221,Chow; Bennett,0,11,30,30
1650210027059,MATH 142A,B02,083222,Chow; Bennett,0,12,30,30
1650210033089,MATH 193A,A01,083224,Staff,0,4,30,30
1650210033089,MATH 193A,A02,083225,Staff,0,4,30,30
1650210033089,MATH 193A,A03,083781,Staff,0,2,30,30
1650210033089,MATH 193A,A04,083782,Staff,0,1,30,30
1650210039119,MATH 197,001,091859,McAuley; Julian John,9998,0,9999,1
1650210045172,COGS 9,A01,083615,Staff,0,14,60,60
1650210051200,COGS 11,A01,083617,Boyle; Mary E. T.,24,0,40,16
1650210057225,COGS 13,A01,083071,Staff,0,30,40,40
1650210063248,COGS 14A,A01,092681,Staff,0,12,100,100
1650210069279,COGS 14B,A01,083073,Cheng; Tzu-Han,0,7,50,50
1650210075305,COGS 17,A01,092677,Staff,35,0,75,40
1650210081330,COGS 100,A01,083619,Staff,0,20,60,60
1650210087355,COGS 101A,A01,083621,Davis; Joshua Daniel,0,21,60,60
1650210093380,COGS 101B,A01,091572,Staff,6,0,60,54
1650210099404,COGS 101C,A01,083625,Delgado; Tania,20,0,30,10
1650210105428,COGS 107A,A01,083627,Boyle; Mary E. T.,0,7,60,60
1650210111454,COGS 118A,A01,083075,Staff,16,0,60,44
1650210117477,CSE 3,A50,083646,Miranda; Gregory Joseph,22,0,38,16
1650210117477,CSE 3,A51,083647,Miranda; Gregory Joseph,37,0,37,0
1650210123504,CSE 8A,A50,083650,Miranda; Gregory Joseph,0,17,40,40
1650210129532,CSE 11,A01,083080,Cao; Yingjun,0,68,40,40
1650210135559,CSE 12,A01,083652,Staff,0,7,100,100
1650210141584,CSE 15L,A01,083654,Staff,0,0,50,50
1650210141584,CSE 15L,A02,083655,Staff,6,0,50,44
1650210147606,CSE 20,A01,083657,Staff,53,0,80,27
1650210153630,CSE 30,A01,083084,Eldon; John,0,69,40,40
1650210159657,CSE 100,A01,083659,Cao; Yingjun,0,63,50,50
1650210165695,CSE 134B,A01,083661,Powell; Thomas Allan,0,27,65,65
1650210171722,CSE 140,A01,083663,Staff,1,0,75,74
1650210177747,CSE 140L,A01,083088,Eldon; John,0,4,75,75
1650210183772,CSE 175,A01,083665,Kumar; Rakesh,8,0,25,17
1650210189799,CSE 190,A00,092507,Dubnov; Shlomo,14,0,20,6
1650210195839,ECE 45,A01,083139,Staff,0,13,40,40
1650210201862,ECE 65,A50,083695,Staff,0,5,30,30
1650210207886,ECE 109,A01,091882,Touri; Behrouz,47,0,70,23
1650210213920,ECE 180,A00,083140,Abi Samra; Nicholas Camill,24,0,30,6
1650210213920,ECE 180,B00,083141,Abi Samra; Nicholas Camill,8,0,30,22
1650210219954,MATH 10A,A01,083735,Patchell; Gregory David,11,0,30,19
1650210219954,MATH 10A,A02,083736,Patchell; Gregory David,28,0,30,2
1650210219954,MATH 10A,A03,083737,Patchell; Gregory David,26,0,30,4
1650210225978,MATH 10B,A01,083207,Staff,0,5,30,30
1650210225978,MATH 10B,A02,083208,Staff,0,5,30,30
1650210225978,MATH 10B,B01,083739,Staff,17,0,30,13
1650210225978,MATH 10B,B02,083740,Staff,29,0,30,1
1650210232011,MATH 18,A01,083743,Staff,8,0,30,22
1650210232011,MATH 18,A02,083744,Staff,28,0,30,2
1650210232011,MATH 18,A03,083745,Staff,23,0,30,7
1650210232011,MATH 18,A04,083746,Staff,27,0,30,3
1650210232011,MATH 18,B01,083748,Staff,0,10,30,30
1650210232011,MATH 18,B02,083749,Staff,0,7,30,30
1650210232011,MATH 18,B03,083750,Staff,0,7,30,30
1650210232011,MATH 18,B04,083751,Staff,0,8,30,30
1650210238039,MATH 20A,A01,083754,Staff,26,0,40,14
1650210244063,MATH 20B,A01,083756,Staff,0,6,30,30
1650210244063,MATH 20B,A02,083757,Staff,0,6,30,30
1650210250087,MATH 20C,A01,083760,Staff,0,12,30,30
1650210250087,MATH 20C,A02,083761,Staff,0,12,30,30
1650210250087,MATH 20C,B01,083762,Staff,14,0,30,16
1650210250087,MATH 20C,B02,083763,Staff,28,0,30,2
1650210256117,MATH 20D,A01,083765,Staff,1,2,30,29
1650210256117,MATH 20D,A02,083766,Staff,10,0,30,20
1650210256117,MATH 20D,A03,083767,Staff,28,0,30,2
1650210262146,MATH 20E,A01,083771,Staff,8,0,30,22
1650210262146,MATH 20E,A02,083772,Staff,20,0,30,10
1650210262146,MATH 20E,B01,083773,Staff,0,0,30,30
1650210262146,MATH 20E,B02,083774,Staff,12,0,30,18
1650210268171,MATH 103A,A01,083777,Staff,0,9,30,30
1650210268171,MATH 103A,A02,083778,Staff,0,10,30,30
1650210268171,MATH 103A,B01,083779,Staff,0,9,30,30
1650210268171,MATH 103A,B02,083780,Staff,0,9,30,30
1650210274198,MATH 105,A01,085443,Staff,0,17,30,30
1650210280227,MATH 109,A01,083213,Anzaldo; Leesa B,0,3,30,30
1650210280227,MATH 109,A02,083214,Anzaldo; Leesa B,0,6,30,30
1650210280227,MATH 109,B01,083215,Anzaldo; Leesa B,0,4,30,30
1650210280227,MATH 109,B02,083216,Anzaldo; Leesa B,0,4,30,30
1650210286251,MATH 142A,A01,083219,Chow; Bennett,0,12,30,30
1650210286251,MATH 142A,A02,083220,Chow; Bennett,0,11,30,30
1650210286251,MATH 142A,B01,083221,Chow; Bennett,0,11,30,30
1650210286251,MATH 142A,B02,083222,Chow; Bennett,0,12,30,30
1650210292276,MATH 193A,A01,083224,Staff,0,4,30,30
1650210292276,MATH 193A,A02,083225,Staff,0,4,30,30
1650210292276,MATH 193A,A03,083781,Staff,0,2,30,30
1650210292276,MATH 193A,A04,083782,Staff,0,1,30,30
1650210298305,MATH 197,001,091859,McAuley; Julian John,9998,0,9999,1
1650210304375,COGS 9,A01,083615,Staff,0,14,60,60
1650210310401,COGS 11,A01,083617,Boyle; Mary E. T.,24,0,40,16
1650210316429,COGS 13,A01,083071,Staff,0,30,40,40
1650210322456,COGS 14A,A01,092681,Staff,0,12,100,100
1650210328483,COGS 14B,A01,083073,Cheng; Tzu-Han,0,7,50,50
1650210334514,COGS 17,A01,092677,Staff,35,0,75,40
1650210340537,COGS 100,A01,083619,Staff,0,20,60,60
1650210346562,COGS 101A,A01,083621,Davis; Joshua Daniel,0,21,60,60
1650210352590,COGS 101B,A01,091572,Staff,6,0,60,54
1650210358618,COGS 101C,A01,083625,Delgado; Tania,20,0,30,10
1650210364645,COGS 107A,A01,083627,Boyle; Mary E. T.,0,7,60,60
1650210370668,COGS 118A,A01,083075,Staff,16,0,60,44
1650210376698,CSE 3,A50,083646,Miranda; Gregory Joseph,22,0,38,16
1650210376698,CSE 3,A51,083647,Miranda; Gregory Joseph,37,0,37,0
1650210382722,CSE 8A,A50,083650,Miranda; Gregory Joseph,0,17,40,40
1650210388747,CSE 11,A01,083080,Cao; Yingjun,0,68,40,40
1650210394774,CSE 12,A01,083652,Staff,0,7,100,100
1650210400799,CSE 15L,A01,083654,Staff,0,0,50,50
1650210400799,CSE 15L,A02,083655,Staff,6,0,50,44
1650210406826,CSE 20,A01,083657,Staff,53,0,80,27
1650210412850,CSE 30,A01,083084,Eldon; John,0,69,40,40
1650210418893,CSE 100,A01,083659,Cao; Yingjun,0,63,50,50
1650210424920,CSE 134B,A01,083661,Powell; Thomas Allan,0,27,65,65
1650210430945,CSE 140,A01,083663,Staff,1,0,75,74
1650210436976,CSE 140L,A01,083088,Eldon; John,0,4,75,75
1650210443003,CSE 175,A01,083665,Kumar; Rakesh,8,0,25,17
1650210449029,CSE 190,A00,092507,Dubnov; Shlomo,14,0,20,6
1650210455054,ECE 45,A01,083139,Staff,0,13,40,40
1650210461079,ECE 65,A50,083695,Staff,0,5,30,30
1650210467106,ECE 109,A01,091882,Touri; Behrouz,47,0,70,23
1650210473140,ECE 180,A00,083140,Abi Samra; Nicholas Camill,24,0,30,6
1650210473140,ECE 180,B00,083141,Abi Samra; Nicholas Camill,8,0,30,22
1650210479167,MATH 10A,A01,083735,Patchell; Gregory David,11,0,30,19
1650210479167,MATH 10A,A02,083736,Patchell; Gregory David,28,0,30,2
1650210479167,MATH 10A,A03,083737,Patchell; Gregory David,26,0,30,4
1650210485193,MATH 10B,A01,083207,Staff,0,5,30,30
1650210485193,MATH 10B,A02,083208,Staff,0,5,30,30
1650210485193,MATH 10B,B01,083739,Staff,17,0,30,13
1650210485193,MATH 10B,B02,083740,Staff,29,0,30,1
1650210491220,MATH 18,A01,083743,Staff,8,0,30,22
1650210491220,MATH 18,A02,083744,Staff,28,0,30,2
1650210491220,MATH 18,A03,083745,Staff,23,0,30,7
1650210491220,MATH 18,A04,083746,Staff,27,0,30,3
1650210491220,MATH 18,B01,083748,Staff,0,10,30,30
1650210491220,MATH 18,B02,083749,Staff,0,7,30,30
1650210491220,MATH 18,B03,083750,Staff,0,7,30,30
1650210491220,MATH 18,B04,083751,Staff,0,8,30,30
1650210497247,MATH 20A,A01,083754,Staff,26,0,40,14
1650210503274,MATH 20B,A01,083756,Staff,0,6,30,30
1650210503274,MATH 20B,A02,083757,Staff,0,6,30,30
1650210509304,MATH 20C,A01,083760,Staff,0,12,30,30
1650210509304,MATH 20C,A02,083761,Staff,0,12,30,30
1650210509304,MATH 20C,B01,083762,Staff,14,0,30,16
1650210509304,MATH 20C,B02,083763,Staff,28,0,30,2
1650210515332,MATH 20D,A01,083765,Staff,1,2,30,29
1650210515332,MATH 20D,A02,083766,Staff,10,0,30,20
1650210515332,MATH 20D,A03,083767,Staff,28,0,30,2
1650210521358,MATH 20E,A01,083771,Staff,8,0,30,22
1650210521358,MATH 20E,A02,083772,Staff,20,0,30,10
1650210521358,MATH 20E,B01,083773,Staff,0,0,30,30
1650210521358,MATH 20E,B02,083774,Staff,12,0,30,18
1650210527388,MATH 103A,A01,083777,Staff,0,9,30,30
1650210527388,MATH 103A,A02,083778,Staff,0,10,30,30
1650210527388,MATH 103A,B01,083779,Staff,0,9,30,30
1650210527388,MATH 103A,B02,083780,Staff,0,9,30,30
1650210533419,MATH 105,A01,085443,Staff,0,17,30,30
1650210539536,MATH 109,A01,083213,Anzaldo; Leesa B,0,3,30,30
1650210539536,MATH 109,A02,083214,Anzaldo; Leesa B,0,6,30,30
1650210539536,MATH 109,B01,083215,Anzaldo; Leesa B,0,4,30,30
1650210539536,MATH 109,B02,083216,Anzaldo; Leesa B,0,4,30,30
1650210545560,MATH 142A,A01,083219,Chow; Bennett,0,12,30,30
1650210545560,MATH 142A,A02,083220,Chow; Bennett,0,11,30,30
1650210545560,MATH 142A,B01,083221,Chow; Bennett,0,11,30,30
1650210545560,MATH 142A,B02,083222,Chow; Bennett,0,12,30,30
1650210551611,MATH 193A,A01,083224,Staff,0,4,30,30
1650210551611,MATH 193A,A02,083225,Staff,0,4,30,30
1650210551611,MATH 193A,A03,083781,Staff,0,2,30,30
1650210551611,MATH 193A,A04,083782,Staff,0,1,30,30
1650210557652,MATH 197,001,091859,McAuley; Julian John,9998,0,9999,1
1650210563714,COGS 9,A01,083615,Staff,0,14,60,60
1650210569742,COGS 11,A01,083617,Boyle; Mary E. T.,24,0,40,16
1650210575777,COGS 13,A01,083071,Staff,0,30,40,40
1650210581808,COGS 14A,A01,092681,Staff,0,12,100,100
1650210587836,COGS 14B,A01,083073,Cheng; Tzu-Han,0,7,50,50
1650210593861,COGS 17,A01,092677,Staff,35,0,75,40
1650210599889,COGS 100,A01,083619,Staff,0,20,60,60
1650210605923,COGS 101A,A01,083621,Davis; Joshua Daniel,0,21,60,60
1650210611957,COGS 101B,A01,091572,Staff,6,0,60,54
1650210617984,COGS 101C,A01,083625,Delgado; Tania,20,0,30,10
1650210624012,COGS 107A,A01,083627,Boyle; Mary E. T.,0,7,60,60
1650210630048,COGS 118A,A01,083075,Staff,16,0,60,44
1650210636078,CSE 3,A50,083646,Miranda; Gregory Joseph,22,0,38,16
1650210636078,CSE 3,A51,083647,Miranda; Gregory Joseph,37,0,37,0
1650210642111,CSE 8A,A50,083650,Miranda; Gregory Joseph,0,17,40,40
1650210648144,CSE 11,A01,083080,Cao; Yingjun,0,68,40,40
1650210654172,CSE 12,A01,083652,Staff,0,7,100,100
1650210660198,CSE 15L,A01,083654,Staff,0,0,50,50
1650210660198,CSE 15L,A02,083655,Staff,6,0,50,44
1650210666234,CSE 20,A01,083657,Staff,53,0,80,27
1650210672259,CSE 30,A01,083084,Eldon; John,0,69,40,40
1650210678287,CSE 100,A01,083659,Cao; Yingjun,0,63,50,50
1650210684311,CSE 134B,A01,083661,Powell; Thomas Allan,0,27,65,65
1650210690345,CSE 140,A01,083663,Staff,1,0,75,74
1650210696372,CSE 140L,A01,083088,Eldon; John,0,4,75,75
1650210702400,CSE 175,A01,083665,Kumar; Rakesh,8,0,25,17
1650210708430,CSE 190,A00,092507,Dubnov; Shlomo,14,0,20,6
1650210714465,ECE 45,A01,083139,Staff,0,13,40,40
1650210720487,ECE 65,A50,083695,Staff,0,5,30,30
1650210726512,ECE 109,A01,091882,Touri; Behrouz,47,0,70,23
1650210732536,ECE 180,A00,083140,Abi Samra; Nicholas Camill,24,0,30,6
1650210732536,ECE 180,B00,083141,Abi Samra; Nicholas Camill,8,0,30,22
1650210738559,MATH 10A,A01,083735,Patchell; Gregory David,11,0,30,19
1650210738559,MATH 10A,A02,083736,Patchell; Gregory David,28,0,30,2
1650210738559,MATH 10A,A03,083737,Patchell; Gregory David,26,0,30,4
1650210744585,MATH 10B,A01,083207,Staff,0,5,30,30
1650210744585,MATH 10B,A02,083208,Staff,0,5,30,30
1650210744585,MATH 10B,B01,083739,Staff,17,0,30,13
1650210744585,MATH 10B,B02,083740,Staff,29,0,30,1
1650210750613,MATH 18,A01,083743,Staff,8,0,30,22
1650210750613,MATH 18,A02,083744,Staff,28,0,30,2
1650210750613,MATH 18,A03,083745,Staff,23,0,30,7
1650210750613,MATH 18,A04,083746,Staff,27,0,30,3
1650210750613,MATH 18,B01,083748,Staff,0,10,30,30
1650210750613,MATH 18,B02,083749,Staff,0,7,30,30
1650210750613,MATH 18,B03,083750,Staff,0,7,30,30
1650210750613,MATH 18,B04,083751,Staff,0,8,30,30
1650210756637,MATH 20A,A01,083754,Staff,26,0,40,14
1650210762667,MATH 20B,A01,083756,Staff,0,6,30,30
1650210762667,MATH 20B,A02,083757,Staff,0,6,30,30
1650210768690,MATH 20C,A01,083760,Staff,0,12,30,30
1650210768690,MATH 20C,A02,083761,Staff,0,12,30,30
1650210768690,MATH 20C,B01,083762,Staff,14,0,30,16
1650210768690,MATH 20C,B02,083763,Staff,28,0,30,2
1650210774715,MATH 20D,A01,083765,Staff,1,2,30,29
1650210774715,MATH 20D,A02,083766,Staff,10,0,30,20
1650210774715,MATH 20D,A03,083767,Staff,28,0,30,2
1650210780739,MATH 20E,A01,083771,Staff,8,0,30,22
1650210780739,MATH 20E,A02,083772,Staff,20,0,30,10
1650210780739,MATH 20E,B01,083773,Staff,0,0,30,30
1650210780739,MATH 20E,B02,083774,Staff,12,0,30,18
1650210786765,MATH 103A,A01,083777,Staff,0,9,30,30
1650210786765,MATH 103A,A02,083778,Staff,0,10,30,30
1650210786765,MATH 103A,B01,083779,Staff,0,9,30,30
1650210786765,MATH 103A,B02,083780,Staff,0,9,30,30
1650210792792,MATH 105,A01,085443,Staff,0,17,30,30
1650210798824,MATH 109,A01,083213,Anzaldo; Leesa B,0,3,30,30
1650210798824,MATH 109,A02,083214,Anzaldo; Leesa B,0,6,30,30
1650210798824,MATH 109,B01,083215,Anzaldo; Leesa B,0,4,30,30
1650210798824,MATH 109,B02,083216,Anzaldo; Leesa B,0,4,30,30
1650210804848,MATH 142A,A01,083219,Chow; Bennett,0,12,30,30
1650210804848,MATH 142A,A02,083220,Chow; Bennett,0,11,30,30
1650210804848,MATH 142A,B01,083221,Chow; Bennett,0,11,30,30
1650210804848,MATH 142A,B02,083222,Chow; Bennett,0,12,30,30
1650210810872,MATH 193A,A01,083224,Staff,0,4,30,30
1650210810872,MATH 193A,A02,083225,Staff,0,4,30,30
1650210810872,MATH 193A,A03,083781,Staff,0,2,30,30
1650210810872,MATH 193A,A04,083782,Staff,0,1,30,30
1650210816899,MATH 197,001,091859,McAuley; Julian John,9998,0,9999,1
1650210822962,COGS 9,A01,083615,Staff,0,14,60,60
1650210828987,COGS 11,A01,083617,Boyle; Mary E. T.,24,0,40,16
1650210835012,COGS 13,A01,083071,Staff,0,30,40,40
1650210841040,COGS 14A,A01,092681,Staff,0,12,100,100
1650210847065,COGS 14B,A01,083073,Cheng; Tzu-Han,0,7,50,50
1650210853098,COGS 17,A01,092677,Staff,35,0,75,40
1650210859123,COGS 100,A01,083619,Staff,0,20,60,60
1650210865151,COGS 101A,A01,083621,Davis; Joshua Daniel,0,21,60,60
1650210871175,COGS 101B,A01,091572,Staff,6,0,60,54
1650210877200,COGS 101C,A01,083625,Delgado; Tania,20,0,30,10
1650210883238,COGS 107A,A01,083627,Boyle; Mary E. T.,0,7,60,60
1650210889268,COGS 118A,A01,083075,Staff,16,0,60,44
1650210895294,CSE 3,A50,083646,Miranda; Gregory Joseph,22,0,38,16
1650210895294,CSE 3,A51,083647,Miranda; Gregory Joseph,37,0,37,0
1650210901323,CSE 8A,A50,083650,Miranda; Gregory Joseph,0,17,40,40
1650210907347,CSE 11,A01,083080,Cao; Yingjun,0,68,40,40
1650210913371,CSE 12,A01,083652,Staff,0,7,100,100
1650210919395,CSE 15L,A01,083654,Staff,0,0,50,50
1650210919395,CSE 15L,A02,083655,Staff,6,0,50,44
1650210925424,CSE 20,A01,083657,Staff,53,0,80,27
1650210931448,CSE 30,A01,083084,Eldon; John,0,69,40,40
1650210937470,CSE 100,A01,083659,Cao; Yingjun,0,63,50,50
1650210943495,CSE 134B,A01,083661,Powell; Thomas Allan,0,27,65,65
1650210949518,CSE 140,A01,083663,Staff,1,0,75,74
1650210955543,CSE 140L,A01,083088,Eldon; John,0,4,75,75
1650210961572,CSE 175,A01,083665,Kumar; Rakesh,8,0,25,17
1650210967600,CSE 190,A00,092507,Dubnov; Shlomo,14,0,20,6
1650210973627,ECE 45,A01,083139,Staff,0,13,40,40
1650210979651,ECE 65,A50,083695,Staff,0,5,30,30
1650210985675,ECE 109,A01,091882,Touri; Behrouz,47,0,70,23
1650210991701,ECE 180,A00,083140,Abi Samra; Nicholas Camill,24,0,30,6
1650210991701,ECE 180,B00,083141,Abi Samra; Nicholas Camill,8,0,30,22
1650210997729,MATH 10A,A01,083735,Patchell; Gregory David,11,0,30,19
1650210997729,MATH 10A,A02,083736,Patchell; Gregory David,28,0,30,2
1650210997729,MATH 10A,A03,083737,Patchell; Gregory David,26,0,30,4
1650211003753,MATH 10B,A01,083207,Staff,0,5,30,30
1650211003753,MATH 10B,A02,083208,Staff,0,5,30,30
1650211003753,MATH 10B,B01,083739,Staff,17,0,30,13
1650211003753,MATH 10B,B02,083740,Staff,29,0,30,1
1650211009781,MATH 18,A01,083743,Staff,8,0,30,22
1650211009781,MATH 18,A02,083744,Staff,28,0,30,2
1650211009781,MATH 18,A03,083745,Staff,23,0,30,7
1650211009781,MATH 18,A04,083746,Staff,27,0,30,3
1650211009781,MATH 18,B01,083748,Staff,0,10,30,30
1650211009781,MATH 18,B02,083749,Staff,0,7,30,30
1650211009781,MATH 18,B03,083750,Staff,0,7,30,30
1650211009781,MATH 18,B04,083751,Staff,0,8,30,30
1650211015806,MATH 20A,A01,083754,Staff,26,0,40,14
1650211021834,MATH 20B,A01,083756,Staff,0,6,30,30
1650211021834,MATH 20B,A02,083757,Staff,0,6,30,30
1650211027863,MATH 20C,A01,083760,Staff,0,12,30,30
1650211027863,MATH 20C,A02,083761,Staff,0,12,30,30
1650211027863,MATH 20C,B01,083762,Staff,14,0,30,16
1650211027863,MATH 20C,B02,083763,Staff,28,0,30,2
1650211033888,MATH 20D,A01,083765,Staff,1,2,30,29
1650211033888,MATH 20D,A02,083766,Staff,10,0,30,20
1650211033888,MATH 20D,A03,083767,Staff,28,0,30,2
1650211039914,MATH 20E,A01,083771,Staff,8,0,30,22
1650211039914,MATH 20E,A02,083772,Staff,20,0,30,10
1650211039914,MATH 20E,B01,083773,Staff,0,0,30,30
1650211039914,MATH 20E,B02,083774,Staff,12,0,30,18
1650211045938,MATH 103A,A01,083777,Staff,0,9,30,30
1650211045938,MATH 103A,A02,083778,Staff,0,10,30,30
1650211045938,MATH 103A,B01,083779,Staff,0,9,30,30
1650211045938,MATH 103A,B02,083780,Staff,0,9,30,30
1650211051962,MATH 105,A01,085443,Staff,0,17,30,30
1650211057991,MATH 109,A01,083213,Anzaldo; Leesa B,0,3,30,30
1650211057991,MATH 109,A02,083214,Anzaldo; Leesa B,0,6,30,30
1650211057991,MATH 109,B01,083215,Anzaldo; Leesa B,0,4,30,30
1650211057991,MATH 109,B02,083216,Anzaldo; Leesa B,0,4,30,30
1650211064022,MATH 142A,A01,083219,Chow; Bennett,0,12,30,30
1650211064022,MATH 142A,A02,083220,Chow; Bennett,0,11,30,30
1650211064022,MATH 142A,B01,083221,Chow; Bennett,0,11,30,30
1650211064022,MATH 142A,B02,083222,Chow; Bennett,0,12,30,30
1650211070051,MATH 193A,A01,083224,Staff,0,4,30,30
1650211070051,MATH 193A,A02,083225,Staff,0,4,30,30
1650211070051,MATH 193A,A03,083781,Staff,0,2,30,30
1650211070051,MATH 193A,A04,083782,Staff,0,1,30,30
1650211076076,MATH 197,001,091859,McAuley; Julian John,9998,0,9999,1
1650211082139,COGS 9,A01,083615,Staff,0,14,60,60
1650211088163,COGS 11,A01,083617,Boyle; Mary E. T.,24,0,40,16
1650211094196,COGS 13,A01,083071,Staff,0,30,40,40
1650211100220,COGS 14A,A01,092681,Staff,0,12,100,100
1650211106243,COGS 14B,A01,083073,Cheng; Tzu-Han,0,7,50,50
1650211112267,COGS 17,A01,092677,Staff,35,0,75,40
1650211118290,COGS 100,A01,083619,Staff,0,20,60,60
1650211124322,COGS 101A,A01,083621,Davis; Joshua Daniel,0,21,60,60
1650211130435,COGS 101B,A01,091572,Staff,6,0,60,54
1650211136465,COGS 101C,A01,083625,Delgado; Tania,20,0,30,10
1650211142490,COGS 107A,A01,083627,Boyle; Mary E. T.,0,7,60,60
1650211148514,COGS 118A,A01,083075,Staff,16,0,60,44
1650211154540,CSE 3,A50,083646,Miranda; Gregory Joseph,22,0,38,16
1650211154540,CSE 3,A51,083647,Miranda; Gregory Joseph,37,0,37,0
1650211160563,CSE 8A,A50,083650,Miranda; Gregory Joseph,0,17,40,40
1650211166587,CSE 11,A01,083080,Cao; Yingjun,0,68,40,40
1650211172612,CSE 12,A01,083652,Staff,0,7,100,100
1650211178637,CSE 15L,A01,083654,Staff,0,0,50,50
1650211178637,CSE 15L,A02,083655,Staff,6,0,50,44
1650211184667,CSE 20,A01,083657,Staff,53,0,80,27
1650211190692,CSE 30,A01,083084,Eldon; John,0,69,40,40
1650211196721,CSE 100,A01,083659,Cao; Yingjun,0,63,50,50
1650211202753,CSE 134B,A01,083661,Powell; Thomas Allan,0,27,65,65
1650211208780,CSE 140,A01,083663,Staff,1,0,75,74
1650211214808,CSE 140L,A01,083088,Eldon; John,0,4,75,75
1650211220840,CSE 175,A01,083665,Kumar; Rakesh,8,0,25,17
1650211226863,CSE 190,A00,092507,Dubnov; Shlomo,14,0,20,6
1650211232893,ECE 45,A01,083139,Staff,0,13,40,40
1650211238924,ECE 65,A50,083695,Staff,0,5,30,30
1650211244950,ECE 109,A01,091882,Touri; Behrouz,47,0,70,23
1650211250978,ECE 180,A00,083140,Abi Samra; Nicholas Camill,24,0,30,6
1650211250978,ECE 180,B00,083141,Abi Samra; Nicholas Camill,8,0,30,22
1650211257006,MATH 10A,A01,083735,Patchell; Gregory David,11,0,30,19
1650211257006,MATH 10A,A02,083736,Patchell; Gregory David,28,0,30,2
1650211257006,MATH 10A,A03,083737,Patchell; Gregory David,26,0,30,4
1650211263031,MATH 10B,A01,083207,Staff,0,5,30,30
1650211263031,MATH 10B,A02,083208,Staff,0,5,30,30
1650211263031,MATH 10B,B01,083739,Staff,17,0,30,13
1650211263031,MATH 10B,B02,083740,Staff,29,0,30,1
1650211269070,MATH 18,A01,083743,Staff,8,0,30,22
1650211269070,MATH 18,A02,083744,Staff,28,0,30,2
1650211269070,MATH 18,A03,083745,Staff,23,0,30,7
1650211269070,MATH 18,A04,083746,Staff,27,0,30,3
1650211269070,MATH 18,B01,083748,Staff,0,10,30,30
1650211269070,MATH 18,B02,083749,Staff,0,7,30,30
1650211269070,MATH 18,B03,083750,Staff,0,7,30,30
1650211269070,MATH 18,B04,083751,Staff,0,8,30,30
1650211275095,MATH 20A,A01,083754,Staff,26,0,40,14
1650211281123,MATH 20B,A01,083756,Staff,0,6,30,30
1650211281123,MATH 20B,A02,083757,Staff,0,6,30,30
1650211287146,MATH 20C,A01,083760,Staff,0,12,30,30
1650211287146,MATH 20C,A02,083761,Staff,0,12,30,30
1650211287146,MATH 20C,B01,083762,Staff,14,0,30,16
1650211287146,MATH 20C,B02,083763,Staff,28,0,30,2
1650211293182,MATH 20D,A01,083765,Staff,1,2,30,29
1650211293182,MATH 20D,A02,083766,Staff,10,0,30,20
1650211293182,MATH 20D,A03,083767,Staff,28,0,30,2
1650211299210,MATH 20E,A01,083771,Staff,8,0,30,22
1650211299210,MATH 20E,A02,083772,Staff,20,0,30,10
1650211299210,MATH 20E,B01,083773,Staff,0,0,30,30
1650211299210,MATH 20E,B02,083774,Staff,12,0,30,18
1650211305235,MATH 103A,A01,083777,Staff,0,9,30,30
1650211305235,MATH 103A,A02,083778,Staff,0,10,30,30
1650211305235,MATH 103A,B01,083779,Staff,0,9,30,30
1650211305235,MATH 103A,B02,083780,Staff,0,9,30,30
1650211311260,MATH 105,A01,085443,Staff,0,17,30,30
1650211317284,MATH 109,A01,083213,Anzaldo; Leesa B,0,3,30,30
1650211317284,MATH 109,A02,083214,Anzaldo; Leesa B,0,6,30,30
1650211317284,MATH 109,B01,083215,Anzaldo; Leesa B,0,4,30,30
1650211317284,MATH 109,B02,083216,Anzaldo; Leesa B,0,4,30,30
1650211323309,MATH 142A,A01,083219,Chow; Bennett,0,12,30,30
1650211323309,MATH 142A,A02,083220,Chow; Bennett,0,11,30,30
1650211323309,MATH 142A,B01,083221,Chow; Bennett,0,11,30,30
1650211323309,MATH 142A,B02,083222,Chow; Bennett,0,12,30,30
1650211329334,MATH 193A,A01,083224,Staff,0,4,30,30
1650211329334,MATH 193A,A02,083225,Staff,0,4,30,30
1650211329334,MATH 193A,A03,083781,Staff,0,2,30,30
1650211329334,MATH 193A,A04,083782,Staff,0,1,30,30
1650211335362,MATH 197,001,091859,McAuley; Julian John,9998,0,9999,1
1650211341425,COGS 9,A01,083615,Staff,0,14,60,60
1650211347449,COGS 11,A01,083617,Boyle; Mary E. T.,24,0,40,16
1650211353472,COGS 13,A01,083071,Staff,0,30,40,40
1650211359496,COGS 14A,A01,092681,Staff,0,12,100,100
1650211365519,COGS 14B,A01,083073,Cheng; Tzu-Han,0,7,50,50
1650211371544,COGS 17,A01,092677,Staff,35,0,75,40
1650211377567,COGS 100,A01,083619,Staff,0,20,60,60
1650211383591,COGS 101A,A01,083621,Davis; Joshua Daniel,0,21,60,60
1650211389614,COGS 101B,A01,091572,Staff,6,0,60,54
1650211395642,COGS 101C,A01,083625,Delgado; Tania,20,0,30,10
1650211401667,COGS 107A,A01,083627,Boyle; Mary E. T.,0,7,60,60
1650211407692,COGS 118A,A01,083075,Staff,16,0,60,44
1650211413720,CSE 3,A50,083646,Miranda; Gregory Joseph,22,0,38,16
1650211413720,CSE 3,A51,083647,Miranda; Gregory Joseph,37,0,37,0
1650211419746,CSE 8A,A50,083650,Miranda; Gregory Joseph,0,17,40,40
1650211425769,CSE 11,A01,083080,Cao; Yingjun,0,68,40,40
1650211431795,CSE 12,A01,083652,Staff,0,7,100,100
1650211437824,CSE 15L,A01,083654,Staff,0,0,50,50
1650211437824,CSE 15L,A02,083655,Staff,6,0,50,44
1650211443850,CSE 20,A01,083657,Staff,53,0,80,27
1650211449875,CSE 30,A01,083084,Eldon; John,0,69,40,40
1650211455900,CSE 100,A01,083659,Cao; Yingjun,0,63,50,50
1650211461925,CSE 134B,A01,083661,Powell; Thomas Allan,0,27,65,65
1650211467949,CSE 140,A01,083663,Staff,1,0,75,74
1650211473973,CSE 140L,A01,083088,Eldon; John,0,4,75,75
1650211480000,CSE 175,A01,083665,Kumar; Rakesh,8,0,25,17
1650211486035,CSE 190,A00,092507,Dubnov; Shlomo,14,0,20,6
1650211492059,ECE 45,A01,083139,Staff,0,13,40,40
1650211498088,ECE 65,A50,083695,Staff,0,5,30,30
1650211504116,ECE 109,A01,091882,Touri; Behrouz,47,0,70,23
1650211510141,ECE 180,A00,083140,Abi Samra; Nicholas Camill,24,0,30,6
1650211510141,ECE 180,B00,083141,Abi Samra; Nicholas Camill,8,0,30,22
1650211516166,MATH 10A,A01,083735,Patchell; Gregory David,11,0,30,19
1650211516166,MATH 10A,A02,083736,Patchell; Gregory David,28,0,30,2
1650211516166,MATH 10A,A03,083737,Patchell; Gregory David,26,0,30,4
1650211522194,MATH 10B,A01,083207,Staff,0,5,30,30
1650211522194,MATH 10B,A02,083208,Staff,0,5,30,30
1650211522194,MATH 10B,B01,083739,Staff,17,0,30,13
1650211522194,MATH 10B,B02,083740,Staff,29,0,30,1
1650211528218,MATH 18,A01,083743,Staff,8,0,30,22
1650211528218,MATH 18,A02,083744,Staff,28,0,30,2
1650211528218,MATH 18,A03,083745,Staff,23,0,30,7
1650211528218,MATH 18,A04,083746,Staff,27,0,30,3
1650211528218,MATH 18,B01,083748,Staff,0,10,30,30
1650211528218,MATH 18,B02,083749,Staff,0,7,30,30
1650211528218,MATH 18,B03,083750,Staff,0,7,30,30
1650211528218,MATH 18,B04,083751,Staff,0,8,30,30
1650211534241,MATH 20A,A01,083754,Staff,26,0,40,14
1650211540269,MATH 20B,A01,083756,Staff,0,6,30,30
1650211540269,MATH 20B,A02,083757,Staff,0,6,30,30
1650211546296,MATH 20C,A01,083760,Staff,0,12,30,30
1650211546296,MATH 20C,A02,083761,Staff,0,12,30,30
1650211546296,MATH 20C,B01,083762,Staff,14,0,30,16
1650211546296,MATH 20C,B02,083763,Staff,28,0,30,2
1650211552321,MATH 20D,A01,083765,Staff,1,2,30,29
1650211552321,MATH 20D,A02,083766,Staff,10,0,30,20
1650211552321,MATH 20D,A03,083767,Staff,28,0,30,2
1650211558347,MATH 20E,A01,083771,Staff,8,0,30,22
1650211558347,MATH 20E,A02,083772,Staff,20,0,30,10
1650211558347,MATH 20E,B01,083773,Staff,0,0,30,30
1650211558347,MATH 20E,B02,083774,Staff,12,0,30,18
1650211564378,MATH 103A,A01,083777,Staff,0,9,30,30
1650211564378,MATH 103A,A02,083778,Staff,0,10,30,30
1650211564378,MATH 103A,B01,083779,Staff,0,9,30,30
1650211564378,MATH 103A,B02,083780,Staff,0,9,30,30
1650211570401,MATH 105,A01,085443,Staff,0,17,30,30
1650211576430,MATH 109,A01,083213,Anzaldo; Leesa B,0,3,30,30
1650211576430,MATH 109,A02,083214,Anzaldo; Leesa B,0,6,30,30
1650211576430,MATH 109,B01,083215,Anzaldo; Leesa B,0,4,30,30
1650211576430,MATH 109,B02,083216,Anzaldo; Leesa B,0,4,30,30
1650211582455,MATH 142A,A01,083219,Chow; Bennett,0,12,30,30
1650211582455,MATH 142A,A02,083220,Chow; Bennett,0,11,30,30
1650211582455,MATH 142A,B01,083221,Chow; Bennett,0,11,30,30
1650211582455,MATH 142A,B02,083222,Chow; Bennett,0,12,30,30
1650211588484,MATH 193A,A01,083224,Staff,0,4,30,30
1650211588484,MATH 193A,A02,083225,Staff,0,4,30,30
1650211588484,MATH 193A,A03,083781,Staff,0,2,30,30
1650211588484,MATH 193A,A04,083782,Staff,0,1,30,30
1650211594514,MATH 197,001,091859,McAuley; Julian John,9998,0,9999,1
1650211600566,COGS 9,A01,083615,Staff,0,14,60,60
1650211606592,COGS 11,A01,083617,Boyle; Mary E. T.,24,0,40,16
1650211612621,COGS 13,A01,083071,Staff,0,30,40,40
1650211618645,COGS 14A,A01,092681,Staff,0,12,100,100
1650211624673,COGS 14B,A01,083073,Cheng; Tzu-Han,0,7,50,50
1650211630697,COGS 17,A01,092677,Staff,35,0,75,40
1650211636719,COGS 100,A01,083619,Staff,0,20,60,60
1650211642744,COGS 101A,A01,083621,Davis; Joshua Daniel,0,21,60,60
1650211648767,COGS 101B,A01,091572,Staff,6,0,60,54
1650211654792,COGS 101C,A01,083625,Delgado; Tania,20,0,30,10
1650211660818,COGS 107A,A01,083627,Boyle; Mary E. T.,0,7,60,60
1650211666844,COGS 118A,A01,083075,Staff,16,0,60,44
1650211672873,CSE 3,A50,083646,Miranda; Gregory Joseph,22,0,38,16
1650211672873,CSE 3,A51,083647,Miranda; Gregory Joseph,37,0,37,0
1650211678901,CSE 8A,A50,083650,Miranda; Gregory Joseph,0,17,40,40
1650211684927,CSE 11,A01,083080,Cao; Yingjun,0,68,40,40
1650211690964,CSE 12,A01,083652,Staff,0,7,100,100
1650211696988,CSE 15L,A01,083654,Staff,0,0,50,50
1650211696988,CSE 15L,A02,083655,Staff,6,0,50,44
1650211703020,CSE 20,A01,083657,Staff,53,0,80,27
1650211709044,CSE 30,A01,083084,Eldon; John,0,69,40,40
1650211715071,CSE 100,A01,083659,Cao; Yingjun,0,63,50,50
1650211721094,CSE 134B,A01,083661,Powell; Thomas Allan,0,27,65,65
1650211727206,CSE 140,A01,083663,Staff,1,0,75,74
1650211733235,CSE 140L,A01,083088,Eldon; John,0,4,75,75
1650211739260,CSE 175,A01,083665,Kumar; Rakesh,8,0,25,17
1650211745282,CSE 190,A00,092507,Dubnov; Shlomo,14,0,20,6
1650211751306,ECE 45,A01,083139,Staff,0,13,40,40
1650211757335,ECE 65,A50,083695,Staff,0,5,30,30
1650211763357,ECE 109,A01,091882,Touri; Behrouz,47,0,70,23
1650211769385,ECE 180,A00,083140,Abi Samra; Nicholas Camill,24,0,30,6
1650211769385,ECE 180,B00,083141,Abi Samra; Nicholas Camill,8,0,30,22
1650211775412,MATH 10A,A01,083735,Patchell; Gregory David,11,0,30,19
1650211775412,MATH 10A,A02,083736,Patchell; Gregory David,28,0,30,2
1650211775412,MATH 10A,A03,083737,Patchell; Gregory David,26,0,30,4
1650211781437,MATH 10B,A01,083207,Staff,0,5,30,30
1650211781437,MATH 10B,A02,083208,Staff,0,5,30,30
1650211781437,MATH 10B,B01,083739,Staff,17,0,30,13
1650211781437,MATH 10B,B02,083740,Staff,29,0,30,1
1650211787464,MATH 18,A01,083743,Staff,8,0,30,22
1650211787464,MATH 18,A02,083744,Staff,28,0,30,2
1650211787464,MATH 18,A03,083745,Staff,23,0,30,7
1650211787464,MATH 18,A04,083746,Staff,27,0,30,3
1650211787464,MATH 18,B01,083748,Staff,0,10,30,30
1650211787464,MATH 18,B02,083749,Staff,0,7,30,30
1650211787464,MATH 18,B03,083750,Staff,0,7,30,30
1650211787464,MATH 18,B04,083751,Staff,0,8,30,30
1650211793489,MATH 20A,A01,083754,Staff,26,0,40,14
1650211799514,MATH 20B,A01,083756,Staff,0,6,30,30
1650211799514,MATH 20B,A02,083757,Staff,0,6,30,30
1650211805542,MATH 20C,A01,083760,Staff,0,12,30,30
1650211805542,MATH 20C,A02,083761,Staff,0,12,30,30
1650211805542,MATH 20C,B01,083762,Staff,14,0,30,16
1650211805542,MATH 20C,B02,083763,Staff,28,0,30,2
1650211811567,MATH 20D,A01,083765,Staff,1,2,30,29
1650211811567,MATH 20D,A02,083766,Staff,10,0,30,20
1650211811567,MATH 20D,A03,083767,Staff,28,0,30,2
1650211817597,MATH 20E,A01,083771,Staff,8,0,30,22
1650211817597,MATH 20E,A02,083772,Staff,20,0,30,10
1650211817597,MATH 20E,B01,083773,Staff,0,0,30,30
1650211817597,MATH 20E,B02,083774,Staff,12,0,30,18
1650211823625,MATH 103A,A01,083777,Staff,0,9,30,30
1650211823625,MATH 103A,A02,083778,Staff,0,10,30,30
1650211823625,MATH 103A,B01,083779,Staff,0,9,30,30
1650211823625,MATH 103A,B02,083780,Staff,0,9,30,30
1650211829655,MATH 105,A01,085443,Staff,0,17,30,30
1650211835683,MATH 109,A01,083213,Anzaldo; Leesa B,0,3,30,30
1650211835683,MATH 109,A02,083214,Anzaldo; Leesa B,0,6,30,30
1650211835683,MATH 109,B01,083215,Anzaldo; Leesa B,0,4,30,30
1650211835683,MATH 109,B02,083216,Anzaldo; Leesa B,0,4,30,30
1650211841708,MATH 142A,A01,083219,Chow; Bennett,0,12,30,30
1650211841708,MATH 142A,A02,083220,Chow; Bennett,0,11,30,30
1650211841708,MATH 142A,B01,083221,Chow; Bennett,0,11,30,30
1650211841708,MATH 142A,B02,083222,Chow; Bennett,0,12,30,30
1650211847731,MATH 193A,A01,083224,Staff,0,4,30,30
1650211847731,MATH 193A,A02,083225,Staff,0,4,30,30
1650211847731,MATH 193A,A03,083781,Staff,0,2,30,30
1650211847731,MATH 193A,A04,083782,Staff,0,1,30,30
1650211853755,MATH 197,001,091859,McAuley; Julian John,9998,0,9999,1
1650211859819,COGS 9,A01,083615,Staff,0,14,60,60
1650211865842,COGS 11,A01,083617,Boyle; Mary E. T.,24,0,40,16
1650211871869,COGS 13,A01,083071,Staff,0,30,40,40
1650211877895,COGS 14A,A01,092681,Staff,0,12,100,100
1650211883922,COGS 14B,A01,083073,Cheng; Tzu-Han,0,7,50,50
1650211889945,COGS 17,A01,092677,Staff,35,0,75,40
1650211895972,COGS 100,A01,083619,Staff,0,20,60,60
1650211901997,COGS 101A,A01,083621,Davis; Joshua Daniel,0,21,60,60
1650211908024,COGS 101B,A01,091572,Staff,6,0,60,54
1650211914054,COGS 101C,A01,083625,Delgado; Tania,20,0,30,10
1650211920081,COGS 107A,A01,083627,Boyle; Mary E. T.,0,7,60,60
1650211926106,COGS 118A,A01,083075,Staff,16,0,60,44
1650211932131,CSE 3,A50,083646,Miranda; Gregory Joseph,22,0,38,16
1650211932131,CSE 3,A51,083647,Miranda; Gregory Joseph,37,0,37,0
1650211938156,CSE 8A,A50,083650,Miranda; Gregory Joseph,0,17,40,40
1650211944182,CSE 11,A01,083080,Cao; Yingjun,0,68,40,40
1650211950205,CSE 12,A01,083652,Staff,0,7,100,100
1650211956231,CSE 15L,A01,083654,Staff,0,0,50,50
1650211956231,CSE 15L,A02,083655,Staff,6,0,50,44
1650211962253,CSE 20,A01,083657,Staff,53,0,80,27
1650211968277,CSE 30,A01,083084,Eldon; John,0,69,40,40
1650211974304,CSE 100,A01,083659,Cao; Yingjun,0,63,50,50
1650211980328,CSE 134B,A01,083661,Powell; Thomas Allan,0,27,65,65
1650211986351,CSE 140,A01,083663,Staff,1,0,75,74
1650211992376,CSE 140L,A01,083088,Eldon; John,0,4,75,75
1650211998401,CSE 175,A01,083665,Kumar; Rakesh,8,0,25,17
1650212004424,CSE 190,A00,092507,Dubnov; Shlomo,14,0,20,6
1650212010447,ECE 45,A01,083139,Staff,0,13,40,40
1650212016470,ECE 65,A50,083695,Staff,0,5,30,30
1650212022495,ECE 109,A01,091882,Touri; Behrouz,47,0,70,23
1650212028522,ECE 180,A00,083140,Abi Samra; Nicholas Camill,24,0,30,6
1650212028522,ECE 180,B00,083141,Abi Samra; Nicholas Camill,8,0,30,22
1650212034546,MATH 10A,A01,083735,Patchell; Gregory David,11,0,30,19
1650212034546,MATH 10A,A02,083736,Patchell; Gregory David,28,0,30,2
1650212034546,MATH 10A,A03,083737,Patchell; Gregory David,26,0,30,4
1650212040574,MATH 10B,A01,083207,Staff,0,6,30,30
1650212040574,MATH 10B,A02,083208,Staff,0,5,30,30
1650212040574,MATH 10B,B01,083739,Staff,17,0,30,13
1650212040574,MATH 10B,B02,083740,Staff,29,0,30,1
1650212046601,MATH 18,A01,083743,Staff,8,0,30,22
1650212046601,MATH 18,A02,083744,Staff,28,0,30,2
1650212046601,MATH 18,A03,083745,Staff,23,0,30,7
1650212046601,MATH 18,A04,083746,Staff,27,0,30,3
1650212046601,MATH 18,B01,083748,Staff,0,10,30,30
1650212046601,MATH 18,B02,083749,Staff,0,7,30,30
1650212046601,MATH 18,B03,083750,Staff,0,7,30,30
1650212046601,MATH 18,B04,083751,Staff,0,8,30,30
1650212052623,MATH 20A,A01,083754,Staff,26,0,40,14
1650212058648,MATH 20B,A01,083756,Staff,0,6,30,30
1650212058648,MATH 20B,A02,083757,Staff,0,6,30,30
1650212064673,MATH 20C,A01,083760,Staff,0,12,30,30
1650212064673,MATH 20C,A02,083761,Staff,0,12,30,30
1650212064673,MATH 20C,B01,083762,Staff,14,0,30,16
1650212064673,MATH 20C,B02,083763,Staff,28,0,30,2
1650212070695,MATH 20D,A01,083765,Staff,1,2,30,29
1650212070695,MATH 20D,A02,083766,Staff,10,0,30,20
1650212070695,MATH 20D,A03,083767,Staff,28,0,30,2
1650212076718,MATH 20E,A01,083771,Staff,8,0,30,22
1650212076718,MATH 20E,A02,083772,Staff,20,0,30,10
1650212076718,MATH 20E,B01,083773,Staff,0,0,30,30
1650212076718,MATH 20E,B02,083774,Staff,12,0,30,18
1650212082745,MATH 103A,A01,083777,Staff,0,9,30,30
1650212082745,MATH 103A,A02,083778,Staff,0,10,30,30
1650212082745,MATH 103A,B01,083779,Staff,0,9,30,30
1650212082745,MATH 103A,B02,083780,Staff,0,9,30,30
1650212088768,MATH 105,A01,085443,Staff,0,17,30,30
1650212094798,MATH 109,A01,083213,Anzaldo; Leesa B,0,3,30,30
1650212094798,MATH 109,A02,083214,Anzaldo; Leesa B,0,6,30,30
1650212094798,MATH 109,B01,083215,Anzaldo; Leesa B,0,4,30,30
1650212094798,MATH 109,B02,083216,Anzaldo; Leesa B,0,4,30,30
1650212100822,MATH 142A,A01,083219,Chow; Bennett,0,12,30,30
1650212100822,MATH 142A,A02,083220,Chow; Bennett,0,11,30,30
1650212100822,MATH 142A,B01,083221,Chow; Bennett,0,11,30,30
1650212100822,MATH 142A,B02,083222,Chow; Bennett,0,12,30,30
1650212106845,MATH 193A,A01,083224,Staff,0,4,30,30
1650212106845,MATH 193A,A02,083225,Staff,0,4,30,30
1650212106845,MATH 193A,A03,083781,Staff,0,2,30,30
1650212106845,MATH 193A,A04,083782,Staff,0,1,30,30
1650212112873,MATH 197,001,091859,McAuley; Julian John,9998,0,9999,1
1650212118951,COGS 9,A01,083615,Staff,0,14,60,60
1650212124979,COGS 11,A01,083617,Boyle; Mary E. T.,24,0,40,16
1650212131005,COGS 13,A01,083071,Staff,0,30,40,40
1650212137032,COGS 14A,A01,092681,Staff,0,12,100,100
1650212143060,COGS 14B,A01,083073,Cheng; Tzu-Han,0,7,50,50
1650212149087,COGS 17,A01,092677,Staff,35,0,75,40
1650212155112,COGS 100,A01,083619,Staff,0,20,60,60
1650212161141,COGS 101A,A01,083621,Davis; Joshua Daniel,0,21,60,60
1650212167166,COGS 101B,A01,091572,Staff,6,0,60,54
1650212173193,COGS 101C,A01,083625,Delgado; Tania,20,0,30,10
1650212179218,COGS 107A,A01,083627,Boyle; Mary E. T.,0,7,60,60
1650212185243,COGS 118A,A01,083075,Staff,16,0,60,44
1650212191271,CSE 3,A50,083646,Miranda; Gregory Joseph,22,0,38,16
1650212191271,CSE 3,A51,083647,Miranda; Gregory Joseph,37,0,37,0
1650212197298,CSE 8A,A50,083650,Miranda; Gregory Joseph,0,17,40,40
1650212203322,CSE 11,A01,083080,Cao; Yingjun,0,68,40,40
1650212209349,CSE 12,A01,083652,Staff,0,7,100,100
1650212215373,CSE 15L,A01,083654,Staff,0,0,50,50
1650212215373,CSE 15L,A02,083655,Staff,6,0,50,44
1650212221397,CSE 20,A01,083657,Staff,53,0,80,27
1650212227422,CSE 30,A01,083084,Eldon; John,0,69,40,40
1650212233449,CSE 100,A01,083659,Cao; Yingjun,0,63,50,50
1650212239479,CSE 134B,A01,083661,Powell; Thomas Allan,0,27,65,65
1650212245507,CSE 140,A01,083663,Staff,1,0,75,74
1650212251530,CSE 140L,A01,083088,Eldon; John,0,4,75,75
1650212257554,CSE 175,A01,083665,Kumar; Rakesh,8,0,25,17
1650212263592,CSE 190,A00,092507,Dubnov; Shlomo,14,0,20,6
1650212269625,ECE 45,A01,083139,Staff,0,13,40,40
1650212275653,ECE 65,A50,083695,Staff,0,5,30,30
1650212281679,ECE 109,A01,091882,Touri; Behrouz,47,0,70,23
1650212287702,ECE 180,A00,083140,Abi Samra; Nicholas Camill,24,0,30,6
1650212287702,ECE 180,B00,083141,Abi Samra; Nicholas Camill,8,0,30,22
1650212293728,MATH 10A,A01,083735,Patchell; Gregory David,11,0,30,19
1650212293728,MATH 10A,A02,083736,Patchell; Gregory David,28,0,30,2
1650212293728,MATH 10A,A03,083737,Patchell; Gregory David,26,0,30,4
1650212299757,MATH 10B,A01,083207,Staff,0,6,30,30
1650212299757,MATH 10B,A02,083208,Staff,0,5,30,30
1650212299757,MATH 10B,B01,083739,Staff,17,0,30,13
1650212299757,MATH 10B,B02,083740,Staff,29,0,30,1
1650212305785,MATH 18,A01,083743,Staff,8,0,30,22
1650212305785,MATH 18,A02,083744,Staff,28,0,30,2
1650212305785,MATH 18,A03,083745,Staff,23,0,30,7
1650212305785,MATH 18,A04,083746,Staff,27,0,30,3
1650212305785,MATH 18,B01,083748,Staff,0,10,30,30
1650212305785,MATH 18,B02,083749,Staff,0,7,30,30
1650212305785,MATH 18,B03,083750,Staff,0,7,30,30
1650212305785,MATH 18,B04,083751,Staff,0,8,30,30
1650212311812,MATH 20A,A01,083754,Staff,26,0,40,14
1650212317836,MATH 20B,A01,083756,Staff,0,6,30,30
1650212317836,MATH 20B,A02,083757,Staff,0,6,30,30
1650212323954,MATH 20C,A01,083760,Staff,0,12,30,30
1650212323954,MATH 20C,A02,083761,Staff,0,12,30,30
1650212323954,MATH 20C,B01,083762,Staff,14,0,30,16
1650212323954,MATH 20C,B02,083763,Staff,28,0,30,2
1650212329979,MATH 20D,A01,083765,Staff,1,2,30,29
1650212329979,MATH 20D,A02,083766,Staff,10,0,30,20
1650212329979,MATH 20D,A03,083767,Staff,28,0,30,2
1650212336002,MATH 20E,A01,083771,Staff,8,0,30,22
1650212336002,MATH 20E,A02,083772,Staff,20,0,30,10
1650212336002,MATH 20E,B01,083773,Staff,0,0,30,30
1650212336002,MATH 20E,B02,083774,Staff,12,0,30,18
1650212342026,MATH 103A,A01,083777,Staff,0,9,30,30
1650212342026,MATH 103A,A02,083778,Staff,0,10,30,30
1650212342026,MATH 103A,B01,083779,Staff,0,9,30,30
1650212342026,MATH 103A,B02,083780,Staff,0,9,30,30
1650212348054,MATH 105,A01,085443,Staff,0,17,30,30
1650212354083,MATH 109,A01,083213,Anzaldo; Leesa B,0,3,30,30
1650212354083,MATH 109,A02,083214,Anzaldo; Leesa B,0,6,30,30
1650212354083,MATH 109,B01,083215,Anzaldo; Leesa B,0,4,30,30
1650212354083,MATH 109,B02,083216,Anzaldo; Leesa B,0,4,30,30
1650212360116,MATH 142A,A01,083219,Chow; Bennett,0,12,30,30
1650212360116,MATH 142A,A02,083220,Chow; Bennett,0,11,30,30
1650212360116,MATH 142A,B01,083221,Chow; Bennett,0,11,30,30
1650212360116,MATH 142A,B02,083222,Chow; Bennett,0,12,30,30
1650212366143,MATH 193A,A01,083224,Staff,0,4,30,30
1650212366143,MATH 193A,A02,083225,Staff,0,4,30,30
1650212366143,MATH 193A,A03,083781,Staff,0,2,30,30
1650212366143,MATH 193A,A04,083782,Staff,0,1,30,30
1650212372168,MATH 197,001,091859,McAuley; Julian John,9998,0,9999,1
1650212378227,COGS 9,A01,083615,Staff,0,14,60,60
1650212384254,COGS 11,A01,083617,Boyle; Mary E. T.,24,0,40,16
1650212390283,COGS 13,A01,083071,Staff,0,30,40,40
1650212396307,COGS 14A,A01,092681,Staff,0,12,100,100
1650212402331,COGS 14B,A01,083073,Cheng; Tzu-Han,0,7,50,50
1650212408358,COGS 17,A01,092677,Staff,35,0,75,40
1650212414382,COGS 100,A01,083619,Staff,0,20,60,60
1650212420407,COGS 101A,A01,083621,Davis; Joshua Daniel,0,21,60,60
1650212426433,COGS 101B,A01,091572,Staff,6,0,60,54
1650212432458,COGS 101C,A01,083625,Delgado; Tania,20,0,30,10
1650212438490,COGS 107A,A01,083627,Boyle; Mary E. T.,0,7,60,60
1650212444526,COGS 118A,A01,083075,Staff,16,0,60,44
1650212450551,CSE 3,A50,083646,Miranda; Gregory Joseph,22,0,38,16
1650212450551,CSE 3,A51,083647,Miranda; Gregory Joseph,37,0,37,0
1650212456576,CSE 8A,A50,083650,Miranda; Gregory Joseph,0,17,40,40
1650212462604,CSE 11,A01,083080,Cao; Yingjun,0,68,40,40
1650212468632,CSE 12,A01,083652,Staff,0,7,100,100
1650212474656,CSE 15L,A01,083654,Staff,0,0,50,50
1650212474656,CSE 15L,A02,083655,Staff,6,0,50,44
1650212480682,CSE 20,A01,083657,Staff,53,0,80,27
1650212486707,CSE 30,A01,083084,Eldon; John,0,69,40,40
1650212492732,CSE 100,A01,083659,Cao; Yingjun,0,63,50,50
1650212498762,CSE 134B,A01,083661,Powell; Thomas Allan,0,27,65,65
1650212504790,CSE 140,A01,083663,Staff,1,0,75,74
1650212510813,CSE 140L,A01,083088,Eldon; John,0,4,75,75
1650212516839,CSE 175,A01,083665,Kumar; Rakesh,8,0,25,17
1650212522862,CSE 190,A00,092507,Dubnov; Shlomo,14,0,20,6
1650212528889,ECE 45,A01,083139,Staff,0,13,40,40
1650212534916,ECE 65,A50,083695,Staff,0,5,30,30
1650212540944,ECE 109,A01,091882,Touri; Behrouz,47,0,70,23
1650212546968,ECE 180,A00,083140,Abi Samra; Nicholas Camill,24,0,30,6
1650212546968,ECE 180,B00,083141,Abi Samra; Nicholas Camill,8,0,30,22
1650212552994,MATH 10A,A01,083735,Patchell; Gregory David,11,0,30,19
1650212552994,MATH 10A,A02,083736,Patchell; Gregory David,28,0,30,2
1650212552994,MATH 10A,A03,083737,Patchell; Gregory David,26,0,30,4
1650212559019,MATH 10B,A01,083207,Staff,0,6,30,30
1650212559019,MATH 10B,A02,083208,Staff,0,5,30,30
1650212559019,MATH 10B,B01,083739,Staff,17,0,30,13
1650212559019,MATH 10B,B02,083740,Staff,29,0,30,1
1650212565049,MATH 18,A01,083743,Staff,8,0,30,22
1650212565049,MATH 18,A02,083744,Staff,28,0,30,2
1650212565049,MATH 18,A03,083745,Staff,23,0,30,7
1650212565049,MATH 18,A04,083746,Staff,27,0,30,3
1650212565049,MATH 18,B01,083748,Staff,0,10,30,30
1650212565049,MATH 18,B02,083749,Staff,0,7,30,30
1650212565049,MATH 18,B03,083750,Staff,0,7,30,30
1650212565049,MATH 18,B04,083751,Staff,0,8,30,30
1650212571075,MATH 20A,A01,083754,Staff,26,0,40,14
1650212577100,MATH 20B,A01,083756,Staff,0,6,30,30
1650212577100,MATH 20B,A02,083757,Staff,0,6,30,30
1650212583128,MATH 20C,A01,083760,Staff,0,12,30,30
1650212583128,MATH 20C,A02,083761,Staff,0,12,30,30
1650212583128,MATH 20C,B01,083762,Staff,14,0,30,16
1650212583128,MATH 20C,B02,083763,Staff,28,0,30,2
1650212589158,MATH 20D,A01,083765,Staff,1,2,30,29
1650212589158,MATH 20D,A02,083766,Staff,10,0,30,20
1650212589158,MATH 20D,A03,083767,Staff,28,0,30,2
1650212595185,MATH 20E,A01,083771,Staff,8,0,30,22
1650212595185,MATH 20E,A02,083772,Staff,20,0,30,10
1650212595185,MATH 20E,B01,083773,Staff,0,0,30,30
1650212595185,MATH 20E,B02,083774,Staff,12,0,30,18
1650212601210,MATH 103A,A01,083777,Staff,0,9,30,30
1650212601210,MATH 103A,A02,083778,Staff,0,10,30,30
1650212601210,MATH 103A,B01,083779,Staff,0,9,30,30
1650212601210,MATH 103A,B02,083780,Staff,0,9,30,30
1650212607232,MATH 105,A01,085443,Staff,0,17,30,30
1650212613259,MATH 109,A01,083213,Anzaldo; Leesa B,0,3,30,30
1650212613259,MATH 109,A02,083214,Anzaldo; Leesa B,0,6,30,30
1650212613259,MATH 109,B01,083215,Anzaldo; Leesa B,0,4,30,30
1650212613259,MATH 109,B02,083216,Anzaldo; Leesa B,0,4,30,30
1650212619283,MATH 142A,A01,083219,Chow; Bennett,0,12,30,30
1650212619283,MATH 142A,A02,083220,Chow; Bennett,0,11,30,30
1650212619283,MATH 142A,B01,083221,Chow; Bennett,0,11,30,30
1650212619283,MATH 142A,B02,083222,Chow; Bennett,0,12,30,30
1650212625316,MATH 193A,A01,083224,Staff,0,4,30,30
1650212625316,MATH 193A,A02,083225,Staff,0,4,30,30
1650212625316,MATH 193A,A03,083781,Staff,0,2,30,30
1650212625316,MATH 193A,A04,083782,Staff,0,1,30,30
1650212631340,MATH 197,001,091859,McAuley; Julian John,9998,0,9999,1
1650212637401,COGS 9,A01,083615,Staff,0,14,60,60
1650212643429,COGS 11,A01,083617,Boyle; Mary E. T.,24,0,40,16
1650212649459,COGS 13,A01,083071,Staff,0,30,40,40
1650212655482,COGS 14A,A01,092681,Staff,0,12,100,100
1650212661508,COGS 14B,A01,083073,Cheng; Tzu-Han,0,7,50,50
1650212667532,COGS 17,A01,092677,Staff,35,0,75,40
1650212673559,COGS 100,A01,083619,Staff,0,20,60,60
1650212679583,COGS 101A,A01,083621,Davis; Joshua Daniel,0,21,60,60
1650212685608,COGS 101B,A01,091572,Staff,6,0,60,54
1650212691632,COGS 101C,A01,083625,Delgado; Tania,20,0,30,10
1650212697656,COGS 107A,A01,083627,Boyle; Mary E. T.,0,7,60,60
1650212703682,COGS 118A,A01,083075,Staff,16,0,60,44
1650212709712,CSE 3,A50,083646,Miranda; Gregory Joseph,22,0,38,16
1650212709712,CSE 3,A51,083647,Miranda; Gregory Joseph,37,0,37,0
1650212715738,CSE 8A,A50,083650,Miranda; Gregory Joseph,0,17,40,40
1650212721763,CSE 11,A01,083080,Cao; Yingjun,0,68,40,40
1650212727798,CSE 12,A01,083652,Staff,0,7,100,100
1650212733822,CSE 15L,A01,083654,Staff,0,0,50,50
1650212733822,CSE 15L,A02,083655,Staff,6,0,50,44
1650212739846,CSE 20,A01,083657,Staff,53,0,80,27
1650212745869,CSE 30,A01,083084,Eldon; John,0,69,40,40
1650212751892,CSE 100,A01,083659,Cao; Yingjun,0,63,50,50
1650212757915,CSE 134B,A01,083661,Powell; Thomas Allan,0,27,65,65
1650212763940,CSE 140,A01,083663,Staff,1,0,75,74
1650212769972,CSE 140L,A01,083088,Eldon; John,0,4,75,75
1650212776000,CSE 175,A01,083665,Kumar; Rakesh,8,0,25,17
1650212782028,CSE 190,A00,092507,Dubnov; Shlomo,14,0,20,6
1650212788053,ECE 45,A01,083139,Staff,0,13,40,40
1650212794078,ECE 65,A50,083695,Staff,0,5,30,30
1650212800103,ECE 109,A01,091882,Touri; Behrouz,47,0,70,23
1650212806131,ECE 180,A00,083140,Abi Samra; Nicholas Camill,24,0,30,6
1650212806131,ECE 180,B00,083141,Abi Samra; Nicholas Camill,8,0,30,22
1650212812160,MATH 10A,A01,083735,Patchell; Gregory David,11,0,30,19
1650212812160,MATH 10A,A02,083736,Patchell; Gregory David,28,0,30,2
1650212812160,MATH 10A,A03,083737,Patchell; Gregory David,26,0,30,4
1650212818187,MATH 10B,A01,083207,Staff,0,6,30,30
1650212818187,MATH 10B,A02,083208,Staff,0,5,30,30
1650212818187,MATH 10B,B01,083739,Staff,17,0,30,13
1650212818187,MATH 10B,B02,083740,Staff,29,0,30,1
1650212824213,MATH 18,A01,083743,Staff,8,0,30,22
1650212824213,MATH 18,A02,083744,Staff,28,0,30,2
1650212824213,MATH 18,A03,083745,Staff,23,0,30,7
1650212824213,MATH 18,A04,083746,Staff,27,0,30,3
1650212824213,MATH 18,B01,083748,Staff,0,10,30,30
1650212824213,MATH 18,B02,083749,Staff,0,7,30,30
1650212824213,MATH 18,B03,083750,Staff,0,7,30,30
1650212824213,MATH 18,B04,083751,Staff,0,8,30,30
1650212830238,MATH 20A,A01,083754,Staff,26,0,40,14
1650212836266,MATH 20B,A01,083756,Staff,0,6,30,30
1650212836266,MATH 20B,A02,083757,Staff,0,6,30,30
1650212842288,MATH 20C,A01,083760,Staff,0,12,30,30
1650212842288,MATH 20C,A02,083761,Staff,0,12,30,30
1650212842288,MATH 20C,B01,083762,Staff,14,0,30,16
1650212842288,MATH 20C,B02,083763,Staff,28,0,30,2
1650212848312,MATH 20D,A01,083765,Staff,1,2,30,29
1650212848312,MATH 20D,A02,083766,Staff,10,0,30,20
1650212848312,MATH 20D,A03,083767,Staff,28,0,30,2
1650212854338,MATH 20E,A01,083771,Staff,8,0,30,22
1650212854338,MATH 20E,A02,083772,Staff,20,0,30,10
1650212854338,MATH 20E,B01,083773,Staff,0,0,30,30
1650212854338,MATH 20E,B02,083774,Staff,12,0,30,18
1650212860367,MATH 103A,A01,083777,Staff,0,9,30,30
1650212860367,MATH 103A,A02,083778,Staff,0,10,30,30
1650212860367,MATH 103A,B01,083779,Staff,0,9,30,30
1650212860367,MATH 103A,B02,083780,Staff,0,9,30,30
1650212866395,MATH 105,A01,085443,Staff,0,17,30,30
1650212872423,MATH 109,A01,083213,Anzaldo; Leesa B,0,3,30,30
1650212872423,MATH 109,A02,083214,Anzaldo; Leesa B,0,6,30,30
1650212872423,MATH 109,B01,083215,Anzaldo; Leesa B,0,4,30,30
1650212872423,MATH 109,B02,083216,Anzaldo; Leesa B,0,4,30,30
1650212878448,MATH 142A,A01,083219,Chow; Bennett,0,12,30,30
1650212878448,MATH 142A,A02,083220,Chow; Bennett,0,11,30,30
1650212878448,MATH 142A,B01,083221,Chow; Bennett,0,11,30,30
1650212878448,MATH 142A,B02,083222,Chow; Bennett,0,12,30,30
1650212884474,MATH 193A,A01,083224,Staff,0,4,30,30
1650212884474,MATH 193A,A02,083225,Staff,0,4,30,30
1650212884474,MATH 193A,A03,083781,Staff,0,2,30,30
1650212884474,MATH 193A,A04,083782,Staff,0,1,30,30
1650212890499,MATH 197,001,091859,McAuley; Julian John,9998,0,9999,1
1650212896559,COGS 9,A01,083615,Staff,0,14,60,60
1650212902586,COGS 11,A01,083617,Boyle; Mary E. T.,24,0,40,16
1650212908611,COGS 13,A01,083071,Staff,0,30,40,40
1650212914727,COGS 14A,A01,092681,Staff,0,12,100,100
1650212920750,COGS 14B,A01,083073,Cheng; Tzu-Han,0,7,50,50
1650212926773,COGS 17,A01,092677,Staff,35,0,75,40
1650212932798,COGS 100,A01,083619,Staff,0,20,60,60
1650212938829,COGS 101A,A01,083621,Davis; Joshua Daniel,0,21,60,60
1650212944853,COGS 101B,A01,091572,Staff,6,0,60,54
1650212950889,COGS 101C,A01,083625,Delgado; Tania,20,0,30,10
1650212956911,COGS 107A,A01,083627,Boyle; Mary E. T.,0,7,60,60
1650212962935,COGS 118A,A01,083075,Staff,16,0,60,44
1650212968960,CSE 3,A50,083646,Miranda; Gregory Joseph,22,0,38,16
1650212968960,CSE 3,A51,083647,Miranda; Gregory Joseph,37,0,37,0
1650212974985,CSE 8A,A50,083650,Miranda; Gregory Joseph,0,17,40,40
1650212981017,CSE 11,A01,083080,Cao; Yingjun,0,68,40,40
1650212987045,CSE 12,A01,083652,Staff,0,7,100,100
1650212993070,CSE 15L,A01,083654,Staff,0,0,50,50
1650212993070,CSE 15L,A02,083655,Staff,6,0,50,44
1650212999095,CSE 20,A01,083657,Staff,53,0,80,27
1650213005131,CSE 30,A01,083084,Eldon; John,0,69,40,40
1650213011153,CSE 100,A01,083659,Cao; Yingjun,0,63,50,50
1650213017186,CSE 134B,A01,083661,Powell; Thomas Allan,0,27,65,65
1650213023213,CSE 140,A01,083663,Staff,1,0,75,74
1650213029236,CSE 140L,A01,083088,Eldon; John,0,4,75,75
1650213035259,CSE 175,A01,083665,Kumar; Rakesh,8,0,25,17
1650213041288,CSE 190,A00,092507,Dubnov; Shlomo,14,0,20,6
1650213047315,ECE 45,A01,083139,Staff,0,13,40,40
1650213053342,ECE 65,A50,083695,Staff,0,5,30,30
1650213059368,ECE 109,A01,091882,Touri; Behrouz,47,0,70,23
1650213065392,ECE 180,A00,083140,Abi Samra; Nicholas Camill,24,0,30,6
1650213065392,ECE 180,B00,083141,Abi Samra; Nicholas Camill,8,0,30,22
1650213071417,MATH 10A,A01,083735,Patchell; Gregory David,11,0,30,19
1650213071417,MATH 10A,A02,083736,Patchell; Gregory David,28,0,30,2
1650213071417,MATH 10A,A03,083737,Patchell; Gregory David,26,0,30,4
1650213077442,MATH 10B,A01,083207,Staff,0,6,30,30
1650213077442,MATH 10B,A02,083208,Staff,0,5,30,30
1650213077442,MATH 10B,B01,083739,Staff,17,0,30,13
1650213077442,MATH 10B,B02,083740,Staff,29,0,30,1
1650213083475,MATH 18,A01,083743,Staff,8,0,30,22
1650213083475,MATH 18,A02,083744,Staff,28,0,30,2
1650213083475,MATH 18,A03,083745,Staff,23,0,30,7
1650213083475,MATH 18,A04,083746,Staff,27,0,30,3
1650213083475,MATH 18,B01,083748,Staff,0,10,30,30
1650213083475,MATH 18,B02,083749,Staff,0,7,30,30
1650213083475,MATH 18,B03,083750,Staff,0,7,30,30
1650213083475,MATH 18,B04,083751,Staff,0,8,30,30
1650213089501,MATH 20A,A01,083754,Staff,26,0,40,14
1650213095529,MATH 20B,A01,083756,Staff,0,6,30,30
1650213095529,MATH 20B,A02,083757,Staff,0,6,30,30
1650213101552,MATH 20C,A01,083760,Staff,0,12,30,30
1650213101552,MATH 20C,A02,083761,Staff,0,12,30,30
1650213101552,MATH 20C,B01,083762,Staff,14,0,30,16
1650213101552,MATH 20C,B02,083763,Staff,28,0,30,2
1650213107578,MATH 20D,A01,083765,Staff,1,2,30,29
1650213107578,MATH 20D,A02,083766,Staff,10,0,30,20
1650213107578,MATH 20D,A03,083767,Staff,28,0,30,2
1650213113602,MATH 20E,A01,083771,Staff,8,0,30,22
1650213113602,MATH 20E,A02,083772,Staff,20,0,30,10
1650213113602,MATH 20E,B01,083773,Staff,0,0,30,30
1650213113602,MATH 20E,B02,083774,Staff,12,0,30,18
1650213119630,MATH 103A,A01,083777,Staff,0,9,30,30
1650213119630,MATH 103A,A02,083778,Staff,0,10,30,30
1650213119630,MATH 103A,B01,083779,Staff,0,9,30,30
1650213119630,MATH 103A,B02,083780,Staff,0,9,30,30
1650213125659,MATH 105,A01,085443,Staff,0,17,30,30
1650213131685,MATH 109,A01,083213,Anzaldo; Leesa B,0,3,30,30
1650213131685,MATH 109,A02,083214,Anzaldo; Leesa B,0,6,30,30
1650213131685,MATH 109,B01,083215,Anzaldo; Leesa B,0,4,30,30
1650213131685,MATH 109,B02,083216,Anzaldo; Leesa B,0,4,30,30
1650213137721,MATH 142A,A01,083219,Chow; Bennett,0,12,30,30
1650213137721,MATH 142A,A02,083220,Chow; Bennett,0,11,30,30
1650213137721,MATH 142A,B01,083221,Chow; Bennett,0,11,30,30
1650213137721,MATH 142A,B02,083222,Chow; Bennett,0,12,30,30
1650213143744,MATH 193A,A01,083224,Staff,0,4,30,30
1650213143744,MATH 193A,A02,083225,Staff,0,4,30,30
1650213143744,MATH 193A,A03,083781,Staff,0,2,30,30
1650213143744,MATH 193A,A04,083782,Staff,0,1,30,30
1650213149766,MATH 197,001,091859,McAuley; Julian John,9998,0,9999,1
1650213155827,COGS 9,A01,083615,Staff,0,14,60,60
1650213161852,COGS 11,A01,083617,Boyle; Mary E. T.,24,0,40,16
1650213167877,COGS 13,A01,083071,Staff,0,30,40,40
1650213173901,COGS 14A,A01,092681,Staff,0,12,100,100
1650213179931,COGS 14B,A01,083073,Cheng; Tzu-Han,0,7,50,50
1650213185957,COGS 17,A01,092677,Staff,35,0,75,40
1650213191983,COGS 100,A01,083619,Staff,0,20,60,60
1650213198008,COGS 101A,A01,083621,Davis; Joshua Daniel,0,21,60,60
1650213204032,COGS 101B,A01,091572,Staff,6,0,60,54
1650213210056,COGS 101C,A01,083625,Delgado; Tania,20,0,30,10
1650213216084,COGS 107A,A01,083627,Boyle; Mary E. T.,0,7,60,60
1650213222107,COGS 118A,A01,083075,Staff,16,0,60,44
1650213228138,CSE 3,A50,083646,Miranda; Gregory Joseph,22,0,38,16
1650213228138,CSE 3,A51,083647,Miranda; Gregory Joseph,37,0,37,0
1650213234161,CSE 8A,A50,083650,Miranda; Gregory Joseph,0,17,40,40
1650213240187,CSE 11,A01,083080,Cao; Yingjun,0,68,40,40
1650213246209,CSE 12,A01,083652,Staff,0,7,100,100
1650213252235,CSE 15L,A01,083654,Staff,0,0,50,50
1650213252235,CSE 15L,A02,083655,Staff,6,0,50,44
1650213258262,CSE 20,A01,083657,Staff,53,0,80,27
1650213264290,CSE 30,A01,083084,Eldon; John,0,69,40,40
1650213270316,CSE 100,A01,083659,Cao; Yingjun,0,63,50,50
1650213276339,CSE 134B,A01,083661,Powell; Thomas Allan,0,27,65,65
1650213282373,CSE 140,A01,083663,Staff,1,0,75,74
1650213288397,CSE 140L,A01,083088,Eldon; John,0,4,75,75
1650213294422,CSE 175,A01,083665,Kumar; Rakesh,8,0,25,17
1650213300446,CSE 190,A00,092507,Dubnov; Shlomo,14,0,20,6
1650213306474,ECE 45,A01,083139,Staff,0,13,40,40
1650213312500,ECE 65,A50,083695,Staff,0,5,30,30
1650213318528,ECE 109,A01,091882,Touri; Behrouz,47,0,70,23
1650213324562,ECE 180,A00,083140,Abi Samra; Nicholas Camill,24,0,30,6
1650213324562,ECE 180,B00,083141,Abi Samra; Nicholas Camill,8,0,30,22
1650213330601,MATH 10A,A01,083735,Patchell; Gregory David,11,0,30,19
1650213330601,MATH 10A,A02,083736,Patchell; Gregory David,28,0,30,2
1650213330601,MATH 10A,A03,083737,Patchell; Gregory David,26,0,30,4
1650213336624,MATH 10B,A01,083207,Staff,0,6,30,30
1650213336624,MATH 10B,A02,083208,Staff,0,5,30,30
1650213336624,MATH 10B,B01,083739,Staff,17,0,30,13
1650213336624,MATH 10B,B02,083740,Staff,29,0,30,1
1650213342647,MATH 18,A01,083743,Staff,8,0,30,22
1650213342647,MATH 18,A02,083744,Staff,28,0,30,2
1650213342647,MATH 18,A03,083745,Staff,23,0,30,7
1650213342647,MATH 18,A04,083746,Staff,27,0,30,3
1650213342647,MATH 18,B01,083748,Staff,0,10,30,30
1650213342647,MATH 18,B02,083749,Staff,0,7,30,30
1650213342647,MATH 18,B03,083750,Staff,0,7,30,30
1650213342647,MATH 18,B04,083751,Staff,0,8,30,30
1650213348674,MATH 20A,A01,083754,Staff,26,0,40,14
1650213354700,MATH 20B,A01,083756,Staff,0,6,30,30
1650213354700,MATH 20B,A02,083757,Staff,0,6,30,30
1650213360725,MATH 20C,A01,083760,Staff,0,12,30,30
1650213360725,MATH 20C,A02,083761,Staff,0,12,30,30
1650213360725,MATH 20C,B01,083762,Staff,14,0,30,16
1650213360725,MATH 20C,B02,083763,Staff,28,0,30,2
1650213366753,MATH 20D,A01,083765,Staff,1,2,30,29
1650213366753,MATH 20D,A02,083766,Staff,10,0,30,20
1650213366753,MATH 20D,A03,083767,Staff,28,0,30,2
1650213372786,MATH 20E,A01,083771,Staff,8,0,30,22
1650213372786,MATH 20E,A02,083772,Staff,20,0,30,10
1650213372786,MATH 20E,B01,083773,Staff,0,0,30,30
1650213372786,MATH 20E,B02,083774,Staff,12,0,30,18
1650213378809,MATH 103A,A01,083777,Staff,0,9,30,30
1650213378809,MATH 103A,A02,083778,Staff,0,10,30,30
1650213378809,MATH 103A,B01,083779,Staff,0,9,30,30
1650213378809,MATH 103A,B02,083780,Staff,0,9,30,30
1650213384834,MATH 105,A01,085443,Staff,0,17,30,30
1650213390857,MATH 109,A01,083213,Anzaldo; Leesa B,0,3,30,30
1650213390857,MATH 109,A02,083214,Anzaldo; Leesa B,0,6,30,30
1650213390857,MATH 109,B01,083215,Anzaldo; Leesa B,0,4,30,30
1650213390857,MATH 109,B02,083216,Anzaldo; Leesa B,0,4,30,30
1650213396880,MATH 142A,A01,083219,Chow; Bennett,0,12,30,30
1650213396880,MATH 142A,A02,083220,Chow; Bennett,0,11,30,30
1650213396880,MATH 142A,B01,083221,Chow; Bennett,0,11,30,30
1650213396880,MATH 142A,B02,083222,Chow; Bennett,0,12,30,30
1650213402909,MATH 193A,A01,083224,Staff,0,4,30,30
1650213402909,MATH 193A,A02,083225,Staff,0,4,30,30
1650213402909,MATH 193A,A03,083781,Staff,0,2,30,30
1650213402909,MATH 193A,A04,083782,Staff,0,1,30,30
1650213408932,MATH 197,001,091859,McAuley; Julian John,9998,0,9999,1
1650213414992,COGS 9,A01,083615,Staff,0,14,60,60
1650213421019,COGS 11,A01,083617,Boyle; Mary E. T.,24,0,40,16
1650213427047,COGS 13,A01,083071,Staff,0,30,40,40
1650213433075,COGS 14A,A01,092681,Staff,0,12,100,100
1650213439104,COGS 14B,A01,083073,Cheng; Tzu-Han,0,7,50,50
1650213445132,COGS 17,A01,092677,Staff,35,0,75,40
1650213451156,COGS 100,A01,083619,Staff,0,20,60,60
1650213457184,COGS 101A,A01,083621,Davis; Joshua Daniel,0,21,60,60
1650213463209,COGS 101B,A01,091572,Staff,6,0,60,54
1650213469234,COGS 101C,A01,083625,Delgado; Tania,20,0,30,10
1650213475267,COGS 107A,A01,083627,Boyle; Mary E. T.,0,7,60,60
1650213481292,COGS 118A,A01,083075,Staff,16,0,60,44
1650213487317,CSE 3,A50,083646,Miranda; Gregory Joseph,22,0,38,16
1650213487317,CSE 3,A51,083647,Miranda; Gregory Joseph,37,0,37,0
1650213493345,CSE 8A,A50,083650,Miranda; Gregory Joseph,0,17,40,40
1650213499372,CSE 11,A01,083080,Cao; Yingjun,0,68,40,40
1650213505413,CSE 12,A01,083652,Staff,0,7,100,100
1650213511536,CSE 15L,A01,083654,Staff,0,0,50,50
1650213511536,CSE 15L,A02,083655,Staff,6,0,50,44
1650213517563,CSE 20,A01,083657,Staff,53,0,80,27
1650213523587,CSE 30,A01,083084,Eldon; John,0,69,40,40
1650213529612,CSE 100,A01,083659,Cao; Yingjun,0,63,50,50
1650213535640,CSE 134B,A01,083661,Powell; Thomas Allan,0,27,65,65
1650213541669,CSE 140,A01,083663,Staff,1,0,75,74
1650213547698,CSE 140L,A01,083088,Eldon; John,0,4,75,75
1650213553723,CSE 175,A01,083665,Kumar; Rakesh,8,0,25,17
1650213559747,CSE 190,A00,092507,Dubnov; Shlomo,14,0,20,6
1650213565772,ECE 45,A01,083139,Staff,0,13,40,40
1650213571798,ECE 65,A50,083695,Staff,0,5,30,30
1650213577822,ECE 109,A01,091882,Touri; Behrouz,47,0,70,23
1650213583846,ECE 180,A00,083140,Abi Samra; Nicholas Camill,24,0,30,6
1650213583846,ECE 180,B00,083141,Abi Samra; Nicholas Camill,8,0,30,22
1650213589875,MATH 10A,A01,083735,Patchell; Gregory David,11,0,30,19
1650213589875,MATH 10A,A02,083736,Patchell; Gregory David,28,0,30,2
1650213589875,MATH 10A,A03,083737,Patchell; Gregory David,26,0,30,4
1650213595908,MATH 10B,A01,083207,Staff,0,6,30,30
1650213595908,MATH 10B,A02,083208,Staff,0,5,30,30
1650213595908,MATH 10B,B01,083739,Staff,17,0,30,13
1650213595908,MATH 10B,B02,083740,Staff,29,0,30,1
1650213601935,MATH 18,A01,083743,Staff,8,0,30,22
1650213601935,MATH 18,A02,083744,Staff,28,0,30,2
1650213601935,MATH 18,A03,083745,Staff,23,0,30,7
1650213601935,MATH 18,A04,083746,Staff,27,0,30,3
1650213601935,MATH 18,B01,083748,Staff,0,10,30,30
1650213601935,MATH 18,B02,083749,Staff,0,7,30,30
1650213601935,MATH 18,B03,083750,Staff,0,7,30,30
1650213601935,MATH 18,B04,083751,Staff,0,8,30,30
1650213607959,MATH 20A,A01,083754,Staff,26,0,40,14
1650213613983,MATH 20B,A01,083756,Staff,0,6,30,30
1650213613983,MATH 20B,A02,083757,Staff,0,6,30,30
1650213620013,MATH 20C,A01,083760,Staff,0,12,30,30
1650213620013,MATH 20C,A02,083761,Staff,0,12,30,30
1650213620013,MATH 20C,B01,083762,Staff,14,0,30,16
1650213620013,MATH 20C,B02,083763,Staff,28,0,30,2
1650213626040,MATH 20D,A01,083765,Staff,1,2,30,29
1650213626040,MATH 20D,A02,083766,Staff,10,0,30,20
1650213626040,MATH 20D,A03,083767,Staff,28,0,30,2
1650213632066,MATH 20E,A01,083771,Staff,8,0,30,22
1650213632066,MATH 20E,A02,083772,Staff,20,0,30,10
1650213632066,MATH 20E,B01,083773,Staff,0,0,30,30
1650213632066,MATH 20E,B02,083774,Staff,12,0,30,18
1650213638105,MATH 103A,A01,083777,Staff,0,9,30,30
1650213638105,MATH 103A,A02,083778,Staff,0,10,30,30
1650213638105,MATH 103A,B01,083779,Staff,0,9,30,30
1650213638105,MATH 103A,B02,083780,Staff,0,9,30,30
1650213644135,MATH 105,A01,085443,Staff,0,17,30,30
1650213650164,MATH 109,A01,083213,Anzaldo; Leesa B,0,3,30,30
1650213650164,MATH 109,A02,083214,Anzaldo; Leesa B,0,6,30,30
1650213650164,MATH 109,B01,083215,Anzaldo; Leesa B,0,4,30,30
1650213650164,MATH 109,B02,083216,Anzaldo; Leesa B,0,4,30,30
1650213656189,MATH 142A,A01,083219,Chow; Bennett,0,12,30,30
1650213656189,MATH 142A,A02,083220,Chow; Bennett,0,11,30,30
1650213656189,MATH 142A,B01,083221,Chow; Bennett,0,11,30,30
1650213656189,MATH 142A,B02,083222,Chow; Bennett,0,12,30,30
1650213662221,MATH 193A,A01,083224,Staff,0,4,30,30
1650213662221,MATH 193A,A02,083225,Staff,0,4,30,30
1650213662221,MATH 193A,A03,083781,Staff,0,2,30,30
1650213662221,MATH 193A,A04,083782,Staff,0,1,30,30
1650213668245,MATH 197,001,091859,McAuley; Julian John,9998,0,9999,1
1650213674308,COGS 9,A01,083615,Staff,0,14,60,60
1650213680336,COGS 11,A01,083617,Boyle; Mary E. T.,24,0,40,16
1650213686361,COGS 13,A01,083071,Staff,0,30,40,40
1650213692390,COGS 14A,A01,092681,Staff,0,12,100,100
1650213698415,COGS 14B,A01,083073,Cheng; Tzu-Han,0,7,50,50
1650213704440,COGS 17,A01,092677,Staff,35,0,75,40
1650213710468,COGS 100,A01,083619,Staff,0,20,60,60
1650213716512,COGS 101A,A01,083621,Davis; Joshua Daniel,0,21,60,60
1650213722537,COGS 101B,A01,091572,Staff,6,0,60,54
1650213728564,COGS 101C,A01,083625,Delgado; Tania,20,0,30,10
1650213734590,COGS 107A,A01,083627,Boyle; Mary E. T.,0,7,60,60
1650213740615,COGS 118A,A01,083075,Staff,16,0,60,44
1650213746641,CSE 3,A50,083646,Miranda; Gregory Joseph,22,0,38,16
1650213746641,CSE 3,A51,083647,Miranda; Gregory Joseph,37,0,37,0
1650213752669,CSE 8A,A50,083650,Miranda; Gregory Joseph,0,17,40,40
1650213758696,CSE 11,A01,083080,Cao; Yingjun,0,68,40,40
1650213764723,CSE 12,A01,083652,Staff,0,7,100,100
1650213770748,CSE 15L,A01,083654,Staff,0,0,50,50
1650213770748,CSE 15L,A02,083655,Staff,6,0,50,44
1650213776774,CSE 20,A01,083657,Staff,53,0,80,27
1650213782802,CSE 30,A01,083084,Eldon; John,0,69,40,40
1650213788827,CSE 100,A01,083659,Cao; Yingjun,0,63,50,50
1650213794852,CSE 134B,A01,083661,Powell; Thomas Allan,0,27,65,65
1650213800880,CSE 140,A01,083663,Staff,1,0,75,74
1650213806904,CSE 140L,A01,083088,Eldon; John,0,4,75,75
1650213812928,CSE 175,A01,083665,Kumar; Rakesh,8,0,25,17
1650213818955,CSE 190,A00,092507,Dubnov; Shlomo,14,0,20,6
1650213824978,ECE 45,A01,083139,Staff,0,13,40,40
1650213831006,ECE 65,A50,083695,Staff,0,5,30,30
1650213837031,ECE 109,A01,091882,Touri; Behrouz,47,0,70,23
1650213843058,ECE 180,A00,083140,Abi Samra; Nicholas Camill,24,0,30,6
1650213843058,ECE 180,B00,083141,Abi Samra; Nicholas Camill,8,0,30,22
1650213849114,MATH 10A,A01,083735,Patchell; Gregory David,11,0,30,19
1650213849114,MATH 10A,A02,083736,Patchell; Gregory David,28,0,30,2
1650213849114,MATH 10A,A03,083737,Patchell; Gregory David,26,0,30,4
1650213855139,MATH 10B,A01,083207,Staff,0,6,30,30
1650213855139,MATH 10B,A02,083208,Staff,0,5,30,30
1650213855139,MATH 10B,B01,083739,Staff,17,0,30,13
1650213855139,MATH 10B,B02,083740,Staff,29,0,30,1
1650213861165,MATH 18,A01,083743,Staff,8,0,30,22
1650213861165,MATH 18,A02,083744,Staff,28,0,30,2
1650213861165,MATH 18,A03,083745,Staff,23,0,30,7
1650213861165,MATH 18,A04,083746,Staff,27,0,30,3
1650213861165,MATH 18,B01,083748,Staff,0,10,30,30
1650213861165,MATH 18,B02,083749,Staff,0,7,30,30
1650213861165,MATH 18,B03,083750,Staff,0,7,30,30
1650213861165,MATH 18,B04,083751,Staff,0,8,30,30
1650213867189,MATH 20A,A01,083754,Staff,26,0,40,14
1650213873217,MATH 20B,A01,083756,Staff,0,6,30,30
1650213873217,MATH 20B,A02,083757,Staff,0,6,30,30
1650213879265,MATH 20C,A01,083760,Staff,0,12,30,30
1650213879265,MATH 20C,A02,083761,Staff,0,12,30,30
1650213879265,MATH 20C,B01,083762,Staff,14,0,30,16
1650213879265,MATH 20C,B02,083763,Staff,28,0,30,2
1650213885292,MATH 20D,A01,083765,Staff,1,2,30,29
1650213885292,MATH 20D,A02,083766,Staff,10,0,30,20
1650213885292,MATH 20D,A03,083767,Staff,28,0,30,2
1650213891317,MATH 20E,A01,083771,Staff,8,0,30,22
1650213891317,MATH 20E,A02,083772,Staff,20,0,30,10
1650213891317,MATH 20E,B01,083773,Staff,0,0,30,30
1650213891317,MATH 20E,B02,083774,Staff,12,0,30,18
1650213897343,MATH 103A,A01,083777,Staff,0,9,30,30
1650213897343,MATH 103A,A02,083778,Staff,0,10,30,30
1650213897343,MATH 103A,B01,083779,Staff,0,9,30,30
1650213897343,MATH 103A,B02,083780,Staff,0,9,30,30
1650213903377,MATH 105,A01,085443,Staff,0,17,30,30
1650213909401,MATH 109,A01,083213,Anzaldo; Leesa B,0,3,30,30
1650213909401,MATH 109,A02,083214,Anzaldo; Leesa B,0,6,30,30
1650213909401,MATH 109,B01,083215,Anzaldo; Leesa B,0,4,30,30
1650213909401,MATH 109,B02,083216,Anzaldo; Leesa B,0,4,30,30
1650213915435,MATH 142A,A01,083219,Chow; Bennett,0,12,30,30
1650213915435,MATH 142A,A02,083220,Chow; Bennett,0,11,30,30
1650213915435,MATH 142A,B01,083221,Chow; Bennett,0,11,30,30
1650213915435,MATH 142A,B02,083222,Chow; Bennett,0,12,30,30
1650213921462,MATH 193A,A01,083224,Staff,0,4,30,30
1650213921462,MATH 193A,A02,083225,Staff,0,4,30,30
1650213921462,MATH 193A,A03,083781,Staff,0,2,30,30
1650213921462,MATH 193A,A04,083782,Staff,0,1,30,30
1650213927486,MATH 197,001,091859,McAuley; Julian John,9998,0,9999,1
1650213933545,COGS 9,A01,083615,Staff,0,14,60,60
1650213939571,COGS 11,A01,083617,Boyle; Mary E. T.,24,0,40,16
1650213945593,COGS 13,A01,083071,Staff,0,30,40,40
1650213951616,COGS 14A,A01,092681,Staff,0,12,100,100
1650213957642,COGS 14B,A01,083073,Cheng; Tzu-Han,0,7,50,50
1650213963675,COGS 17,A01,092677,Staff,35,0,75,40
1650213969702,COGS 100,A01,083619,Staff,0,20,60,60
1650213975724,COGS 101A,A01,083621,Davis; Joshua Daniel,0,21,60,60
1650213981750,COGS 101B,A01,091572,Staff,6,0,60,54
1650213987775,COGS 101C,A01,083625,Delgado; Tania,20,0,30,10
1650213993798,COGS 107A,A01,083627,Boyle; Mary E. T.,0,7,60,60
1650213999821,COGS 118A,A01,083075,Staff,16,0,60,44
1650214005849,CSE 3,A50,083646,Miranda; Gregory Joseph,22,0,38,16
1650214005849,CSE 3,A51,083647,Miranda; Gregory Joseph,37,0,37,0
1650214011879,CSE 8A,A50,083650,Miranda; Gregory Joseph,0,17,40,40
1650214017905,CSE 11,A01,083080,Cao; Yingjun,0,68,40,40
1650214023930,CSE 12,A01,083652,Staff,0,7,100,100
1650214029973,CSE 15L,A01,083654,Staff,0,0,50,50
1650214029973,CSE 15L,A02,083655,Staff,6,0,50,44
1650214035996,CSE 20,A01,083657,Staff,53,0,80,27
1650214042024,CSE 30,A01,083084,Eldon; John,0,69,40,40
1650214048048,CSE 100,A01,083659,Cao; Yingjun,0,63,50,50
1650214054073,CSE 134B,A01,083661,Powell; Thomas Allan,0,27,65,65
1650214060098,CSE 140,A01,083663,Staff,1,0,75,74
1650214066123,CSE 140L,A01,083088,Eldon; John,0,4,75,75
1650214072155,CSE 175,A01,083665,Kumar; Rakesh,8,0,25,17
1650214078180,CSE 190,A00,092507,Dubnov; Shlomo,14,0,20,6
1650214084205,ECE 45,A01,083139,Staff,0,13,40,40
1650214090229,ECE 65,A50,083695,Staff,0,5,30,30
1650214096262,ECE 109,A01,091882,Touri; Behrouz,47,0,70,23
1650214102292,ECE 180,A00,083140,Abi Samra; Nicholas Camill,24,0,30,6
1650214102292,ECE 180,B00,083141,Abi Samra; Nicholas Camill,8,0,30,22
1650214108407,MATH 10A,A01,083735,Patchell; Gregory David,11,0,30,19
1650214108407,MATH 10A,A02,083736,Patchell; Gregory David,28,0,30,2
1650214108407,MATH 10A,A03,083737,Patchell; Gregory David,26,0,30,4
1650214114431,MATH 10B,A01,083207,Staff,0,6,30,30
1650214114431,MATH 10B,A02,083208,Staff,0,5,30,30
1650214114431,MATH 10B,B01,083739,Staff,17,0,30,13
1650214114431,MATH 10B,B02,083740,Staff,29,0,30,1
1650214120461,MATH 18,A01,083743,Staff,8,0,30,22
1650214120461,MATH 18,A02,083744,Staff,28,0,30,2
1650214120461,MATH 18,A03,083745,Staff,23,0,30,7
1650214120461,MATH 18,A04,083746,Staff,27,0,30,3
1650214120461,MATH 18,B01,083748,Staff,0,10,30,30
1650214120461,MATH 18,B02,083749,Staff,0,7,30,30
1650214120461,MATH 18,B03,083750,Staff,0,7,30,30
1650214120461,MATH 18,B04,083751,Staff,0,8,30,30
1650214126485,MATH 20A,A01,083754,Staff,26,0,40,14
1650214132509,MATH 20B,A01,083756,Staff,0,6,30,30
1650214132509,MATH 20B,A02,083757,Staff,0,6,30,30
1650214138538,MATH 20C,A01,083760,Staff,0,12,30,30
1650214138538,MATH 20C,A02,083761,Staff,0,12,30,30
1650214138538,MATH 20C,B01,083762,Staff,14,0,30,16
1650214138538,MATH 20C,B02,083763,Staff,28,0,30,2
1650214144566,MATH 20D,A01,083765,Staff,1,2,30,29
1650214144566,MATH 20D,A02,083766,Staff,10,0,30,20
1650214144566,MATH 20D,A03,083767,Staff,28,0,30,2
1650214150591,MATH 20E,A01,083771,Staff,8,0,30,22
1650214150591,MATH 20E,A02,083772,Staff,20,0,30,10
1650214150591,MATH 20E,B01,083773,Staff,0,0,30,30
1650214150591,MATH 20E,B02,083774,Staff,12,0,30,18
1650214156627,MATH 103A,A01,083777,Staff,0,9,30,30
1650214156627,MATH 103A,A02,083778,Staff,0,10,30,30
1650214156627,MATH 103A,B01,083779,Staff,0,9,30,30
1650214156627,MATH 103A,B02,083780,Staff,0,9,30,30
1650214162655,MATH 105,A01,085443,Staff,0,17,30,30
1650214168678,MATH 109,A01,083213,Anzaldo; Leesa B,0,3,30,30
1650214168678,MATH 109,A02,083214,Anzaldo; Leesa B,0,6,30,30
1650214168678,MATH 109,B01,083215,Anzaldo; Leesa B,0,4,30,30
1650214168678,MATH 109,B02,083216,Anzaldo; Leesa B,0,4,30,30
1650214174705,MATH 142A,A01,083219,Chow; Bennett,0,12,30,30
1650214174705,MATH 142A,A02,083220,Chow; Bennett,0,11,30,30
1650214174705,MATH 142A,B01,083221,Chow; Bennett,0,11,30,30
1650214174705,MATH 142A,B02,083222,Chow; Bennett,0,12,30,30
1650214180731,MATH 193A,A01,083224,Staff,0,4,30,30
1650214180731,MATH 193A,A02,083225,Staff,0,4,30,30
1650214180731,MATH 193A,A03,083781,Staff,0,2,30,30
1650214180731,MATH 193A,A04,083782,Staff,0,1,30,30
1650214186758,MATH 197,001,091859,McAuley; Julian John,9998,0,9999,1
1650214192821,COGS 9,A01,083615,Staff,0,14,60,60
1650214198845,COGS 11,A01,083617,Boyle; Mary E. T.,24,0,40,16
1650214204870,COGS 13,A01,083071,Staff,0,30,40,40
1650214210894,COGS 14A,A01,092681,Staff,0,12,100,100
1650214216920,COGS 14B,A01,083073,Cheng; Tzu-Han,0,7,50,50
1650214222943,COGS 17,A01,092677,Staff,35,0,75,40
1650214228972,COGS 100,A01,083619,Staff,0,20,60,60
1650214235000,COGS 101A,A01,083621,Davis; Joshua Daniel,0,21,60,60
1650214241025,COGS 101B,A01,091572,Staff,6,0,60,54
1650214247052,COGS 101C,A01,083625,Delgado; Tania,20,0,30,10
1650214253079,COGS 107A,A01,083627,Boyle; Mary E. T.,0,7,60,60
1650214259104,COGS 118A,A01,083075,Staff,16,0,60,44
1650214265139,CSE 3,A50,083646,Miranda; Gregory Joseph,22,0,38,16
1650214265139,CSE 3,A51,083647,Miranda; Gregory Joseph,37,0,37,0
1650214271168,CSE 8A,A50,083650,Miranda; Gregory Joseph,0,17,40,40
1650214277192,CSE 11,A01,083080,Cao; Yingjun,0,68,40,40
1650214283216,CSE 12,A01,083652,Staff,0,7,100,100
1650214289239,CSE 15L,A01,083654,Staff,0,0,50,50
1650214289239,CSE 15L,A02,083655,Staff,6,0,50,44
1650214295266,CSE 20,A01,083657,Staff,53,0,80,27
1650214301294,CSE 30,A01,083084,Eldon; John,0,69,40,40
1650214307318,CSE 100,A01,083659,Cao; Yingjun,0,63,50,50
1650214313347,CSE 134B,A01,083661,Powell; Thomas Allan,0,27,65,65
1650214319370,CSE 140,A01,083663,Staff,1,0,75,74
1650214325393,CSE 140L,A01,083088,Eldon; John,0,4,75,75
1650214331419,CSE 175,A01,083665,Kumar; Rakesh,8,0,25,17
1650214337444,CSE 190,A00,092507,Dubnov; Shlomo,14,0,20,6
1650214343471,ECE 45,A01,083139,Staff,0,13,40,40
1650214349497,ECE 65,A50,083695,Staff,0,5,30,30
1650214355521,ECE 109,A01,091882,Touri; Behrouz,47,0,70,23
1650214361551,ECE 180,A00,083140,Abi Samra; Nicholas Camill,24,0,30,6
1650214361551,ECE 180,B00,083141,Abi Samra; Nicholas Camill,8,0,30,22
1650214367583,MATH 10A,A01,083735,Patchell; Gregory David,11,0,30,19
1650214367583,MATH 10A,A02,083736,Patchell; Gregory David,28,0,30,2
1650214367583,MATH 10A,A03,083737,Patchell; Gregory David,26,0,30,4
1650214373608,MATH 10B,A01,083207,Staff,0,6,30,30
1650214373608,MATH 10B,A02,083208,Staff,0,5,30,30
1650214373608,MATH 10B,B01,083739,Staff,17,0,30,13
1650214373608,MATH 10B,B02,083740,Staff,29,0,30,1
1650214379637,MATH 18,A01,083743,Staff,8,0,30,22
1650214379637,MATH 18,A02,083744,Staff,28,0,30,2
1650214379637,MATH 18,A03,083745,Staff,23,0,30,7
1650214379637,MATH 18,A04,083746,Staff,27,0,30,3
1650214379637,MATH 18,B01,083748,Staff,0,10,30,30
1650214379637,MATH 18,B02,083749,Staff,0,7,30,30
1650214379637,MATH 18,B03,083750,Staff,0,7,30,30
1650214379637,MATH 18,B04,083751,Staff,0,8,30,30
1650214385662,MATH 20A,A01,083754,Staff,26,0,40,14
1650214391689,MATH 20B,A01,083756,Staff,0,6,30,30
1650214391689,MATH 20B,A02,083757,Staff,0,6,30,30
1650214397717,MATH 20C,A01,083760,Staff,0,12,30,30
1650214397717,MATH 20C,A02,083761,Staff,0,12,30,30
1650214397717,MATH 20C,B01,083762,Staff,14,0,30,16
1650214397717,MATH 20C,B02,083763,Staff,28,0,30,2
1650214403744,MATH 20D,A01,083765,Staff,1,2,30,29
1650214403744,MATH 20D,A02,083766,Staff,10,0,30,20
1650214403744,MATH 20D,A03,083767,Staff,28,0,30,2
1650214409770,MATH 20E,A01,083771,Staff,8,0,30,22
1650214409770,MATH 20E,A02,083772,Staff,20,0,30,10
1650214409770,MATH 20E,B01,083773,Staff,0,0,30,30
1650214409770,MATH 20E,B02,083774,Staff,12,0,30,18
1650214415794,MATH 103A,A01,083777,Staff,0,9,30,30
1650214415794,MATH 103A,A02,083778,Staff,0,10,30,30
1650214415794,MATH 103A,B01,083779,Staff,0,9,30,30
1650214415794,MATH 103A,B02,083780,Staff,0,9,30,30
1650214421818,MATH 105,A01,085443,Staff,0,17,30,30
1650214427844,MATH 109,A01,083213,Anzaldo; Leesa B,0,3,30,30
1650214427844,MATH 109,A02,083214,Anzaldo; Leesa B,0,6,30,30
1650214427844,MATH 109,B01,083215,Anzaldo; Leesa B,0,4,30,30
1650214427844,MATH 109,B02,083216,Anzaldo; Leesa B,0,4,30,30
1650214433872,MATH 142A,A01,083219,Chow; Bennett,0,12,30,30
1650214433872,MATH 142A,A02,083220,Chow; Bennett,0,11,30,30
1650214433872,MATH 142A,B01,083221,Chow; Bennett,0,11,30,30
1650214433872,MATH 142A,B02,083222,Chow; Bennett,0,12,30,30
1650214439900,MATH 193A,A01,083224,Staff,0,4,30,30
1650214439900,MATH 193A,A02,083225,Staff,0,4,30,30
1650214439900,MATH 193A,A03,083781,Staff,0,2,30,30
1650214439900,MATH 193A,A04,083782,Staff,0,1,30,30
1650214445925,MATH 197,001,091859,McAuley; Julian John,9998,0,9999,1
1650214451991,COGS 9,A01,083615,Staff,0,14,60,60
1650214458019,COGS 11,A01,083617,Boyle; Mary E. T.,24,0,40,16
1650214464043,COGS 13,A01,083071,Staff,0,30,40,40
1650214470069,COGS 14A,A01,092681,Staff,0,12,100,100
1650214476092,COGS 14B,A01,083073,Cheng; Tzu-Han,0,7,50,50
1650214482116,COGS 17,A01,092677,Staff,35,0,75,40
1650214488147,COGS 100,A01,083619,Staff,0,20,60,60
1650214494171,COGS 101A,A01,083621,Davis; Joshua Daniel,0,21,60,60
1650214500197,COGS 101B,A01,091572,Staff,6,0,60,54
1650214506221,COGS 101C,A01,083625,Delgado; Tania,20,0,30,10
1650214512249,COGS 107A,A01,083627,Boyle; Mary E. T.,0,7,60,60
1650214518275,COGS 118A,A01,083075,Staff,16,0,60,44
1650214524300,CSE 3,A50,083646,Miranda; Gregory Joseph,22,0,38,16
1650214524300,CSE 3,A51,083647,Miranda; Gregory Joseph,37,0,37,0
1650214530328,CSE 8A,A50,083650,Miranda; Gregory Joseph,0,17,40,40
1650214536352,CSE 11,A01,083080,Cao; Yingjun,0,68,40,40
1650214542377,CSE 12,A01,083652,Staff,0,7,100,100
1650214548402,CSE 15L,A01,083654,Staff,0,0,50,50
1650214548402,CSE 15L,A02,083655,Staff,6,0,50,44
1650214554439,CSE 20,A01,083657,Staff,53,0,80,27
1650214560470,CSE 30,A01,083084,Eldon; John,0,69,40,40
1650214566496,CSE 100,A01,083659,Cao; Yingjun,0,63,50,50
1650214572521,CSE 134B,A01,083661,Powell; Thomas Allan,0,27,65,65
1650214578546,CSE 140,A01,083663,Staff,1,0,75,74
1650214584568,CSE 140L,A01,083088,Eldon; John,0,4,75,75
1650214590593,CSE 175,A01,083665,Kumar; Rakesh,8,0,25,17
1650214596617,CSE 190,A00,092507,Dubnov; Shlomo,14,0,20,6
1650214602642,ECE 45,A01,083139,Staff,0,13,40,40
1650214608669,ECE 65,A50,083695,Staff,0,5,30,30
1650214614693,ECE 109,A01,091882,Touri; Behrouz,47,0,70,23
1650214620716,ECE 180,A00,083140,Abi Samra; Nicholas Camill,24,0,30,6
1650214620716,ECE 180,B00,083141,Abi Samra; Nicholas Camill,8,0,30,22
1650214626739,MATH 10A,A01,083735,Patchell; Gregory David,11,0,30,19
1650214626739,MATH 10A,A02,083736,Patchell; Gregory David,28,0,30,2
1650214626739,MATH 10A,A03,083737,Patchell; Gregory David,26,0,30,4
1650214632764,MATH 10B,A01,083207,Staff,0,6,30,30
1650214632764,MATH 10B,A02,083208,Staff,0,5,30,30
1650214632764,MATH 10B,B01,083739,Staff,17,0,30,13
1650214632764,MATH 10B,B02,083740,Staff,29,0,30,1
1650214638789,MATH 18,A01,083743,Staff,8,0,30,22
1650214638789,MATH 18,A02,083744,Staff,28,0,30,2
1650214638789,MATH 18,A03,083745,Staff,23,0,30,7
1650214638789,MATH 18,A04,083746,Staff,27,0,30,3
1650214638789,MATH 18,B01,083748,Staff,0,10,30,30
1650214638789,MATH 18,B02,083749,Staff,0,7,30,30
1650214638789,MATH 18,B03,083750,Staff,0,7,30,30
1650214638789,MATH 18,B04,083751,Staff,0,8,30,30
1650214644815,MATH 20A,A01,083754,Staff,26,0,40,14
1650214650840,MATH 20B,A01,083756,Staff,0,6,30,30
1650214650840,MATH 20B,A02,083757,Staff,0,6,30,30
1650214656869,MATH 20C,A01,083760,Staff,0,12,30,30
1650214656869,MATH 20C,A02,083761,Staff,0,12,30,30
1650214656869,MATH 20C,B01,083762,Staff,14,0,30,16
1650214656869,MATH 20C,B02,083763,Staff,28,0,30,2
1650214662894,MATH 20D,A01,083765,Staff,1,2,30,29
1650214662894,MATH 20D,A02,083766,Staff,10,0,30,20
1650214662894,MATH 20D,A03,083767,Staff,28,0,30,2
1650214668923,MATH 20E,A01,083771,Staff,8,0,30,22
1650214668923,MATH 20E,A02,083772,Staff,20,0,30,10
1650214668923,MATH 20E,B01,083773,Staff,0,0,30,30
1650214668923,MATH 20E,B02,083774,Staff,12,0,30,18
1650214674946,MATH 103A,A01,083777,Staff,0,9,30,30
1650214674946,MATH 103A,A02,083778,Staff,0,10,30,30
1650214674946,MATH 103A,B01,083779,Staff,0,9,30,30
1650214674946,MATH 103A,B02,083780,Staff,0,9,30,30
1650214680971,MATH 105,A01,085443,Staff,0,17,30,30
1650214686997,MATH 109,A01,083213,Anzaldo; Leesa B,0,3,30,30
1650214686997,MATH 109,A02,083214,Anzaldo; Leesa B,0,6,30,30
1650214686997,MATH 109,B01,083215,Anzaldo; Leesa B,0,4,30,30
1650214686997,MATH 109,B02,083216,Anzaldo; Leesa B,0,4,30,30
1650214693025,MATH 142A,A01,083219,Chow; Bennett,0,12,30,30
1650214693025,MATH 142A,A02,083220,Chow; Bennett,0,11,30,30
1650214693025,MATH 142A,B01,083221,Chow; Bennett,0,11,30,30
1650214693025,MATH 142A,B02,083222,Chow; Bennett,0,12,30,30
1650214699057,MATH 193A,A01,083224,Staff,0,4,30,30
1650214699057,MATH 193A,A02,083225,Staff,0,4,30,30
1650214699057,MATH 193A,A03,083781,Staff,0,2,30,30
1650214699057,MATH 193A,A04,083782,Staff,0,1,30,30
1650214705183,MATH 197,001,091859,McAuley; Julian John,9998,0,9999,1
1650214711234,COGS 9,A01,083615,Staff,0,14,60,60
1650214717260,COGS 11,A01,083617,Boyle; Mary E. T.,24,0,40,16
1650214723288,COGS 13,A01,083071,Staff,0,30,40,40
1650214729314,COGS 14A,A01,092681,Staff,0,12,100,100
1650214735339,COGS 14B,A01,083073,Cheng; Tzu-Han,0,7,50,50
1650214741364,COGS 17,A01,092677,Staff,35,0,75,40
1650214747389,COGS 100,A01,083619,Staff,0,20,60,60
1650214753414,COGS 101A,A01,083621,Davis; Joshua Daniel,0,21,60,60
1650214759442,COGS 101B,A01,091572,Staff,6,0,60,54
1650214765467,COGS 101C,A01,083625,Delgado; Tania,20,0,30,10
1650214771504,COGS 107A,A01,083627,Boyle; Mary E. T.,0,7,60,60
1650214777531,COGS 118A,A01,083075,Staff,16,0,60,44
1650214783556,CSE 3,A50,083646,Miranda; Gregory Joseph,22,0,38,16
1650214783556,CSE 3,A51,083647,Miranda; Gregory Joseph,37,0,37,0
1650214789594,CSE 8A,A50,083650,Miranda; Gregory Joseph,0,17,40,40
1650214795619,CSE 11,A01,083080,Cao; Yingjun,0,68,40,40
1650214801647,CSE 12,A01,083652,Staff,0,7,100,100
1650214807685,CSE 15L,A01,083654,Staff,0,0,50,50
1650214807685,CSE 15L,A02,083655,Staff,6,0,50,44
1650214813718,CSE 20,A01,083657,Staff,53,0,80,27
1650214819744,CSE 30,A01,083084,Eldon; John,0,69,40,40
1650214825778,CSE 100,A01,083659,Cao; Yingjun,0,63,50,50
1650214831803,CSE 134B,A01,083661,Powell; Thomas Allan,0,27,65,65
1650214837831,CSE 140,A01,083663,Staff,1,0,75,74
1650214843872,CSE 140L,A01,083088,Eldon; John,0,4,75,75
1650214849899,CSE 175,A01,083665,Kumar; Rakesh,8,0,25,17
1650214855926,CSE 190,A00,092507,Dubnov; Shlomo,14,0,20,6
1650214861960,ECE 45,A01,083139,Staff,0,13,40,40
1650214867988,ECE 65,A50,083695,Staff,0,5,30,30
1650214874022,ECE 109,A01,091882,Touri; Behrouz,47,0,70,23
1650214880047,ECE 180,A00,083140,Abi Samra; Nicholas Camill,24,0,30,6
1650214880047,ECE 180,B00,083141,Abi Samra; Nicholas Camill,8,0,30,22
1650214886082,MATH 10A,A01,083735,Patchell; Gregory David,11,0,30,19
1650214886082,MATH 10A,A02,083736,Patchell; Gregory David,28,0,30,2
1650214886082,MATH 10A,A03,083737,Patchell; Gregory David,26,0,30,4
1650214892121,MATH 10B,A01,083207,Staff,0,6,30,30
1650214892121,MATH 10B,A02,083208,Staff,0,5,30,30
1650214892121,MATH 10B,B01,083739,Staff,17,0,30,13
1650214892121,MATH 10B,B02,083740,Staff,29,0,30,1
1650214898147,MATH 18,A01,083743,Staff,8,0,30,22
1650214898147,MATH 18,A02,083744,Staff,28,0,30,2
1650214898147,MATH 18,A03,083745,Staff,23,0,30,7
1650214898147,MATH 18,A04,083746,Staff,27,0,30,3
1650214898147,MATH 18,B01,083748,Staff,0,10,30,30
1650214898147,MATH 18,B02,083749,Staff,0,7,30,30
1650214898147,MATH 18,B03,083750,Staff,0,7,30,30
1650214898147,MATH 18,B04,083751,Staff,0,8,30,30
1650214904172,MATH 20A,A01,083754,Staff,26,0,40,14
1650214910197,MATH 20B,A01,083756,Staff,0,6,30,30
1650214910197,MATH 20B,A02,083757,Staff,0,6,30,30
1650214916220,MATH 20C,A01,083760,Staff,0,12,30,30
1650214916220,MATH 20C,A02,083761,Staff,0,12,30,30
1650214916220,MATH 20C,B01,083762,Staff,14,0,30,16
1650214916220,MATH 20C,B02,083763,Staff,28,0,30,2
1650214922245,MATH 20D,A01,083765,Staff,1,2,30,29
1650214922245,MATH 20D,A02,083766,Staff,10,0,30,20
1650214922245,MATH 20D,A03,083767,Staff,28,0,30,2
1650214928273,MATH 20E,A01,083771,Staff,8,0,30,22
1650214928273,MATH 20E,A02,083772,Staff,20,0,30,10
1650214928273,MATH 20E,B01,083773,Staff,0,0,30,30
1650214928273,MATH 20E,B02,083774,Staff,12,0,30,18
1650214934299,MATH 103A,A01,083777,Staff,0,9,30,30
1650214934299,MATH 103A,A02,083778,Staff,0,10,30,30
1650214934299,MATH 103A,B01,083779,Staff,0,9,30,30
1650214934299,MATH 103A,B02,083780,Staff,0,9,30,30
1650214940320,MATH 105,A01,085443,Staff,0,17,30,30
1650214946350,MATH 109,A01,083213,Anzaldo; Leesa B,0,3,30,30
1650214946350,MATH 109,A02,083214,Anzaldo; Leesa B,0,6,30,30
1650214946350,MATH 109,B01,083215,Anzaldo; Leesa B,0,4,30,30
1650214946350,MATH 109,B02,083216,Anzaldo; Leesa B,0,4,30,30
1650214952378,MATH 142A,A01,083219,Chow; Bennett,0,12,30,30
1650214952378,MATH 142A,A02,083220,Chow; Bennett,0,11,30,30
1650214952378,MATH 142A,B01,083221,Chow; Bennett,0,11,30,30
1650214952378,MATH 142A,B02,083222,Chow; Bennett,0,12,30,30
1650214958403,MATH 193A,A01,083224,Staff,0,4,30,30
1650214958403,MATH 193A,A02,083225,Staff,0,4,30,30
1650214958403,MATH 193A,A03,083781,Staff,0,2,30,30
1650214958403,MATH 193A,A04,083782,Staff,0,1,30,30
1650214964428,MATH 197,001,091859,McAuley; Julian John,9998,0,9999,1
1650214970502,COGS 9,A01,083615,Staff,0,14,60,60
1650214976527,COGS 11,A01,083617,Boyle; Mary E. T.,24,0,40,16
1650214982552,COGS 13,A01,083071,Staff,0,30,40,40
1650214988577,COGS 14A,A01,092681,Staff,0,12,100,100
1650214994601,COGS 14B,A01,083073,Cheng; Tzu-Han,0,7,50,50
1650215000626,COGS 17,A01,092677,Staff,35,0,75,40
1650215006650,COGS 100,A01,083619,Staff,0,20,60,60
1650215012681,COGS 101A,A01,083621,Davis; Joshua Daniel,0,21,60,60
1650215018713,COGS 101B,A01,091572,Staff,6,0,60,54
1650215024737,COGS 101C,A01,083625,Delgado; Tania,20,0,30,10
1650215030760,COGS 107A,A01,083627,Boyle; Mary E. T.,0,7,60,60
1650215036785,COGS 118A,A01,083075,Staff,16,0,60,44
1650215042814,CSE 3,A50,083646,Miranda; Gregory Joseph,22,0,38,16
1650215042814,CSE 3,A51,083647,Miranda; Gregory Joseph,37,0,37,0
1650215048844,CSE 8A,A50,083650,Miranda; Gregory Joseph,0,17,40,40
1650215054870,CSE 11,A01,083080,Cao; Yingjun,0,68,40,40
1650215060893,CSE 12,A01,083652,Staff,0,7,100,100
1650215066917,CSE 15L,A01,083654,Staff,0,0,50,50
1650215066917,CSE 15L,A02,083655,Staff,6,0,50,44
1650215072942,CSE 20,A01,083657,Staff,53,0,80,27
1650215078966,CSE 30,A01,083084,Eldon; John,0,69,40,40
1650215084993,CSE 100,A01,083659,Cao; Yingjun,0,63,50,50
1650215091021,CSE 134B,A01,083661,Powell; Thomas Allan,0,27,65,65
1650215097049,CSE 140,A01,083663,Staff,1,0,75,74
1650215103072,CSE 140L,A01,083088,Eldon; John,0,4,75,75
1650215109099,CSE 175,A01,083665,Kumar; Rakesh,8,0,25,17
1650215115126,CSE 190,A00,092507,Dubnov; Shlomo,14,0,20,6
1650215121149,ECE 45,A01,083139,Staff,0,13,40,40
1650215127178,ECE 65,A50,083695,Staff,0,5,30,30
1650215133201,ECE 109,A01,091882,Touri; Behrouz,47,0,70,23
1650215139231,ECE 180,A00,083140,Abi Samra; Nicholas Camill,24,0,30,6
1650215139231,ECE 180,B00,083141,Abi Samra; Nicholas Camill,8,0,30,22
1650215145259,MATH 10A,A01,083735,Patchell; Gregory David,11,0,30,19
1650215145259,MATH 10A,A02,083736,Patchell; Gregory David,28,0,30,2
1650215145259,MATH 10A,A03,083737,Patchell; Gregory David,26,0,30,4
1650215151289,MATH 10B,A01,083207,Staff,0,6,30,30
1650215151289,MATH 10B,A02,083208,Staff,0,5,30,30
1650215151289,MATH 10B,B01,083739,Staff,17,0,30,13
1650215151289,MATH 10B,B02,083740,Staff,29,0,30,1
1650215157326,MATH 18,A01,083743,Staff,8,0,30,22
1650215157326,MATH 18,A02,083744,Staff,28,0,30,2
1650215157326,MATH 18,A03,083745,Staff,23,0,30,7
1650215157326,MATH 18,A04,083746,Staff,27,0,30,3
1650215157326,MATH 18,B01,083748,Staff,0,10,30,30
1650215157326,MATH 18,B02,083749,Staff,0,7,30,30
1650215157326,MATH 18,B03,083750,Staff,0,7,30,30
1650215157326,MATH 18,B04,083751,Staff,0,8,30,30
1650215163358,MATH 20A,A01,083754,Staff,26,0,40,14
1650215169389,MATH 20B,A01,083756,Staff,0,6,30,30
1650215169389,MATH 20B,A02,083757,Staff,0,6,30,30
1650215175422,MATH 20C,A01,083760,Staff,0,12,30,30
1650215175422,MATH 20C,A02,083761,Staff,0,12,30,30
1650215175422,MATH 20C,B01,083762,Staff,14,0,30,16
1650215175422,MATH 20C,B02,083763,Staff,28,0,30,2
1650215181451,MATH 20D,A01,083765,Staff,1,2,30,29
1650215181451,MATH 20D,A02,083766,Staff,10,0,30,20
1650215181451,MATH 20D,A03,083767,Staff,28,0,30,2
1650215187474,MATH 20E,A01,083771,Staff,8,0,30,22
1650215187474,MATH 20E,A02,083772,Staff,20,0,30,10
1650215187474,MATH 20E,B01,083773,Staff,0,0,30,30
1650215187474,MATH 20E,B02,083774,Staff,12,0,30,18
1650215193505,MATH 103A,A01,083777,Staff,0,9,30,30
1650215193505,MATH 103A,A02,083778,Staff,0,10,30,30
1650215193505,MATH 103A,B01,083779,Staff,0,9,30,30
1650215193505,MATH 103A,B02,083780,Staff,0,9,30,30
1650215199528,MATH 105,A01,085443,Staff,0,17,30,30
1650215205550,MATH 109,A01,083213,Anzaldo; Leesa B,0,3,30,30
1650215205550,MATH 109,A02,083214,Anzaldo; Leesa B,0,6,30,30
1650215205550,MATH 109,B01,083215,Anzaldo; Leesa B,0,4,30,30
1650215205550,MATH 109,B02,083216,Anzaldo; Leesa B,0,4,30,30
1650215211588,MATH 142A,A01,083219,Chow; Bennett,0,12,30,30
1650215211588,MATH 142A,A02,083220,Chow; Bennett,0,11,30,30
1650215211588,MATH 142A,B01,083221,Chow; Bennett,0,11,30,30
1650215211588,MATH 142A,B02,083222,Chow; Bennett,0,12,30,30
1650215217622,MATH 193A,A01,083224,Staff,0,4,30,30
1650215217622,MATH 193A,A02,083225,Staff,0,4,30,30
1650215217622,MATH 193A,A03,083781,Staff,0,2,30,30
1650215217622,MATH 193A,A04,083782,Staff,0,1,30,30
1650215223649,MATH 197,001,091859,McAuley; Julian John,9998,0,9999,1
1650215229704,COGS 9,A01,083615,Staff,0,14,60,60
1650215235728,COGS 11,A01,083617,Boyle; Mary E. T.,24,0,40,16
1650215241752,COGS 13,A01,083071,Staff,0,30,40,40
1650215247776,COGS 14A,A01,092681,Staff,0,12,100,100
1650215253810,COGS 14B,A01,083073,Cheng; Tzu-Han,0,7,50,50
1650215259836,COGS 17,A01,092677,Staff,35,0,75,40
1650215265863,COGS 100,A01,083619,Staff,0,20,60,60
1650215271897,COGS 101A,A01,083621,Davis; Joshua Daniel,0,21,60,60
1650215277932,COGS 101B,A01,091572,Staff,6,0,60,54
1650215283956,COGS 101C,A01,083625,Delgado; Tania,20,0,30,10
1650215289997,COGS 107A,A01,083627,Boyle; Mary E. T.,0,7,60,60
1650215296112,COGS 118A,A01,083075,Staff,16,0,60,44
1650215302142,CSE 3,A50,083646,Miranda; Gregory Joseph,22,0,38,16
1650215302142,CSE 3,A51,083647,Miranda; Gregory Joseph,37,0,37,0
1650215308166,CSE 8A,A50,083650,Miranda; Gregory Joseph,0,17,40,40
1650215314188,CSE 11,A01,083080,Cao; Yingjun,0,68,40,40
1650215320214,CSE 12,A01,083652,Staff,0,7,100,100
1650215326236,CSE 15L,A01,083654,Staff,0,0,50,50
1650215326236,CSE 15L,A02,083655,Staff,6,0,50,44
1650215332263,CSE 20,A01,083657,Staff,53,0,80,27
1650215338288,CSE 30,A01,083084,Eldon; John,0,69,40,40
1650215344314,CSE 100,A01,083659,Cao; Yingjun,0,63,50,50
1650215350340,CSE 134B,A01,083661,Powell; Thomas Allan,0,27,65,65
1650215356364,CSE 140,A01,083663,Staff,1,0,75,74
1650215362389,CSE 140L,A01,083088,Eldon; John,0,4,75,75
1650215368421,CSE 175,A01,083665,Kumar; Rakesh,8,0,25,17
1650215374446,CSE 190,A00,092507,Dubnov; Shlomo,14,0,20,6
1650215380473,ECE 45,A01,083139,Staff,0,13,40,40
1650215386497,ECE 65,A50,083695,Staff,0,5,30,30
1650215392531,ECE 109,A01,091882,Touri; Behrouz,47,0,70,23
1650215398561,ECE 180,A00,083140,Abi Samra; Nicholas Camill,24,0,30,6
1650215398561,ECE 180,B00,083141,Abi Samra; Nicholas Camill,8,0,30,22
1650215404586,MATH 10A,A01,083735,Patchell; Gregory David,11,0,30,19
1650215404586,MATH 10A,A02,083736,Patchell; Gregory David,28,0,30,2
1650215404586,MATH 10A,A03,083737,Patchell; Gregory David,26,0,30,4
1650215410612,MATH 10B,A01,083207,Staff,0,6,30,30
1650215410612,MATH 10B,A02,083208,Staff,0,5,30,30
1650215410612,MATH 10B,B01,083739,Staff,17,0,30,13
1650215410612,MATH 10B,B02,083740,Staff,29,0,30,1
1650215416639,MATH 18,A01,083743,Staff,8,0,30,22
1650215416639,MATH 18,A02,083744,Staff,28,0,30,2
1650215416639,MATH 18,A03,083745,Staff,23,0,30,7
1650215416639,MATH 18,A04,083746,Staff,27,0,30,3
1650215416639,MATH 18,B01,083748,Staff,0,10,30,30
1650215416639,MATH 18,B02,083749,Staff,0,7,30,30
1650215416639,MATH 18,B03,083750,Staff,0,7,30,30
1650215416639,MATH 18,B04,083751,Staff,0,8,30,30
1650215422664,MATH 20A,A01,083754,Staff,26,0,40,14
1650215428688,MATH 20B,A01,083756,Staff,0,6,30,30
1650215428688,MATH 20B,A02,083757,Staff,0,6,30,30
1650215434717,MATH 20C,A01,083760,Staff,0,12,30,30
1650215434717,MATH 20C,A02,083761,Staff,0,12,30,30
1650215434717,MATH 20C,B01,083762,Staff,14,0,30,16
1650215434717,MATH 20C,B02,083763,Staff,28,0,30,2
1650215440747,MATH 20D,A01,083765,Staff,1,2,30,29
1650215440747,MATH 20D,A02,083766,Staff,10,0,30,20
1650215440747,MATH 20D,A03,083767,Staff,28,0,30,2
1650215446777,MATH 20E,A01,083771,Staff,8,0,30,22
1650215446777,MATH 20E,A02,083772,Staff,20,0,30,10
1650215446777,MATH 20E,B01,083773,Staff,0,0,30,30
1650215446777,MATH 20E,B02,083774,Staff,12,0,30,18
1650215452805,MATH 103A,A01,083777,Staff,0,9,30,30
1650215452805,MATH 103A,A02,083778,Staff,0,10,30,30
1650215452805,MATH 103A,B01,083779,Staff,0,9,30,30
1650215452805,MATH 103A,B02,083780,Staff,0,9,30,30
1650215458830,MATH 105,A01,085443,Staff,0,17,30,30
1650215464855,MATH 109,A01,083213,Anzaldo; Leesa B,0,3,30,30
1650215464855,MATH 109,A02,083214,Anzaldo; Leesa B,0,6,30,30
1650215464855,MATH 109,B01,083215,Anzaldo; Leesa B,0,4,30,30
1650215464855,MATH 109,B02,083216,Anzaldo; Leesa B,0,4,30,30
1650215470878,MATH 142A,A01,083219,Chow; Bennett,0,12,30,30
1650215470878,MATH 142A,A02,083220,Chow; Bennett,0,11,30,30
1650215470878,MATH 142A,B01,083221,Chow; Bennett,0,11,30,30
1650215470878,MATH 142A,B02,083222,Chow; Bennett,0,12,30,30
1650215476902,MATH 193A,A01,083224,Staff,0,4,30,30
1650215476902,MATH 193A,A02,083225,Staff,0,4,30,30
1650215476902,MATH 193A,A03,083781,Staff,0,2,30,30
1650215476902,MATH 193A,A04,083782,Staff,0,1,30,30
1650215482934,MATH 197,001,091859,McAuley; Julian John,9998,0,9999,1
1650215489015,COGS 9,A01,083615,Staff,0,14,60,60
1650215495038,COGS 11,A01,083617,Boyle; Mary E. T.,24,0,40,16
1650215501066,COGS 13,A01,083071,Staff,0,30,40,40
1650215507089,COGS 14A,A01,092681,Staff,0,12,100,100
1650215513113,COGS 14B,A01,083073,Cheng; Tzu-Han,0,7,50,50
1650215519140,COGS 17,A01,092677,Staff,35,0,75,40
1650215525165,COGS 100,A01,083619,Staff,0,20,60,60
1650215531190,COGS 101A,A01,083621,Davis; Joshua Daniel,0,21,60,60
1650215537216,COGS 101B,A01,091572,Staff,6,0,60,54
1650215543243,COGS 101C,A01,083625,Delgado; Tania,20,0,30,10
1650215549270,COGS 107A,A01,083627,Boyle; Mary E. T.,0,7,60,60
1650215555292,COGS 118A,A01,083075,Staff,16,0,60,44
1650215561322,CSE 3,A50,083646,Miranda; Gregory Joseph,22,0,38,16
1650215561322,CSE 3,A51,083647,Miranda; Gregory Joseph,37,0,37,0
1650215567346,CSE 8A,A50,083650,Miranda; Gregory Joseph,0,17,40,40
1650215573373,CSE 11,A01,083080,Cao; Yingjun,0,68,40,40
1650215579400,CSE 12,A01,083652,Staff,0,7,100,100
1650215585429,CSE 15L,A01,083654,Staff,0,0,50,50
1650215585429,CSE 15L,A02,083655,Staff,6,0,50,44
1650215591454,CSE 20,A01,083657,Staff,53,0,80,27
1650215597483,CSE 30,A01,083084,Eldon; John,0,69,40,40
1650215603510,CSE 100,A01,083659,Cao; Yingjun,0,63,50,50
1650215609533,CSE 134B,A01,083661,Powell; Thomas Allan,0,27,65,65
1650215615562,CSE 140,A01,083663,Staff,1,0,75,74
1650215621589,CSE 140L,A01,083088,Eldon; John,0,4,75,75
1650215627615,CSE 175,A01,083665,Kumar; Rakesh,8,0,25,17
1650215633642,CSE 190,A00,092507,Dubnov; Shlomo,14,0,20,6
1650215639668,ECE 45,A01,083139,Staff,0,13,40,40
1650215645694,ECE 65,A50,083695,Staff,0,5,30,30
1650215651725,ECE 109,A01,091882,Touri; Behrouz,47,0,70,23
1650215657749,ECE 180,A00,083140,Abi Samra; Nicholas Camill,24,0,30,6
1650215657749,ECE 180,B00,083141,Abi Samra; Nicholas Camill,8,0,30,22
1650215663786,MATH 10A,A01,083735,Patchell; Gregory David,11,0,30,19
1650215663786,MATH 10A,A02,083736,Patchell; Gregory David,28,0,30,2
1650215663786,MATH 10A,A03,083737,Patchell; Gregory David,26,0,30,4
1650215669814,MATH 10B,A01,083207,Staff,0,6,30,30
1650215669814,MATH 10B,A02,083208,Staff,0,5,30,30
1650215669814,MATH 10B,B01,083739,Staff,17,0,30,13
1650215669814,MATH 10B,B02,083740,Staff,29,0,30,1
1650215675843,MATH 18,A01,083743,Staff,8,0,30,22
1650215675843,MATH 18,A02,083744,Staff,28,0,30,2
1650215675843,MATH 18,A03,083745,Staff,23,0,30,7
1650215675843,MATH 18,A04,083746,Staff,27,0,30,3
1650215675843,MATH 18,B01,083748,Staff,0,10,30,30
1650215675843,MATH 18,B02,083749,Staff,0,7,30,30
1650215675843,MATH 18,B03,083750,Staff,0,7,30,30
1650215675843,MATH 18,B04,083751,Staff,0,8,30,30
1650215681866,MATH 20A,A01,083754,Staff,26,0,40,14
1650215687893,MATH 20B,A01,083756,Staff,0,6,30,30
1650215687893,MATH 20B,A02,083757,Staff,0,6,30,30
1650215693922,MATH 20C,A01,083760,Staff,0,12,30,30
1650215693922,MATH 20C,A02,083761,Staff,0,12,30,30
1650215693922,MATH 20C,B01,083762,Staff,14,0,30,16
1650215693922,MATH 20C,B02,083763,Staff,28,0,30,2
1650215699951,MATH 20D,A01,083765,Staff,1,2,30,29
1650215699951,MATH 20D,A02,083766,Staff,10,0,30,20
1650215699951,MATH 20D,A03,083767,Staff,28,0,30,2
1650215705981,MATH 20E,A01,083771,Staff,8,0,30,22
1650215705981,MATH 20E,A02,083772,Staff,20,0,30,10
1650215705981,MATH 20E,B01,083773,Staff,0,0,30,30
1650215705981,MATH 20E,B02,083774,Staff,12,0,30,18
1650215712004,MATH 103A,A01,083777,Staff,0,9,30,30
1650215712004,MATH 103A,A02,083778,Staff,0,10,30,30
1650215712004,MATH 103A,B01,083779,Staff,0,9,30,30
1650215712004,MATH 103A,B02,083780,Staff,0,9,30,30
1650215718033,MATH 105,A01,085443,Staff,0,17,30,30
1650215724061,MATH 109,A01,083213,Anzaldo; Leesa B,0,3,30,30
1650215724061,MATH 109,A02,083214,Anzaldo; Leesa B,0,6,30,30
1650215724061,MATH 109,B01,083215,Anzaldo; Leesa B,0,4,30,30
1650215724061,MATH 109,B02,083216,Anzaldo; Leesa B,0,4,30,30
1650215730083,MATH 142A,A01,083219,Chow; Bennett,0,12,30,30
1650215730083,MATH 142A,A02,083220,Chow; Bennett,0,11,30,30
1650215730083,MATH 142A,B01,083221,Chow; Bennett,0,11,30,30
1650215730083,MATH 142A,B02,083222,Chow; Bennett,0,12,30,30
1650215736107,MATH 193A,A01,083224,Staff,0,4,30,30
1650215736107,MATH 193A,A02,083225,Staff,0,4,30,30
1650215736107,MATH 193A,A03,083781,Staff,0,2,30,30
1650215736107,MATH 193A,A04,083782,Staff,0,1,30,30
1650215742133,MATH 197,001,091859,McAuley; Julian John,9998,0,9999,1
1650215748186,COGS 9,A01,083615,Staff,0,14,60,60
1650215754209,COGS 11,A01,083617,Boyle; Mary E. T.,24,0,40,16
1650215760233,COGS 13,A01,083071,Staff,0,30,40,40
1650215766260,COGS 14A,A01,092681,Staff,0,12,100,100
1650215772283,COGS 14B,A01,083073,Cheng; Tzu-Han,0,7,50,50
1650215778311,COGS 17,A01,092677,Staff,35,0,75,40
1650215784339,COGS 100,A01,083619,Staff,0,20,60,60
1650215790366,COGS 101A,A01,083621,Davis; Joshua Daniel,0,21,60,60
1650215796393,COGS 101B,A01,091572,Staff,6,0,60,54
1650215802418,COGS 101C,A01,083625,Delgado; Tania,20,0,30,10
1650215808446,COGS 107A,A01,083627,Boyle; Mary E. T.,0,7,60,60
1650215814469,COGS 118A,A01,083075,Staff,16,0,60,44
1650215820494,CSE 3,A50,083646,Miranda; Gregory Joseph,22,0,38,16
1650215820494,CSE 3,A51,083647,Miranda; Gregory Joseph,37,0,37,0
1650215826517,CSE 8A,A50,083650,Miranda; Gregory Joseph,0,17,40,40
1650215832540,CSE 11,A01,083080,Cao; Yingjun,0,68,40,40
1650215838563,CSE 12,A01,083652,Staff,0,7,100,100
1650215844591,CSE 15L,A01,083654,Staff,0,0,50,50
1650215844591,CSE 15L,A02,083655,Staff,6,0,50,44
1650215850615,CSE 20,A01,083657,Staff,53,0,80,27
1650215856641,CSE 30,A01,083084,Eldon; John,0,69,40,40
1650215862666,CSE 100,A01,083659,Cao; Yingjun,0,63,50,50
1650215868695,CSE 134B,A01,083661,Powell; Thomas Allan,0,27,65,65
1650215874718,CSE 140,A01,083663,Staff,1,0,75,74
1650215880741,CSE 140L,A01,083088,Eldon; John,0,4,75,75
1650215886772,CSE 175,A01,083665,Kumar; Rakesh,8,0,25,17
1650215892885,CSE 190,A00,092507,Dubnov; Shlomo,14,0,20,6
1650215898912,ECE 45,A01,083139,Staff,0,13,40,40
1650215904936,ECE 65,A50,083695,Staff,0,5,30,30
1650215910959,ECE 109,A01,091882,Touri; Behrouz,47,0,70,23
1650215916987,ECE 180,A00,083140,Abi Samra; Nicholas Camill,24,0,30,6
1650215916987,ECE 180,B00,083141,Abi Samra; Nicholas Camill,8,0,30,22
1650215923015,MATH 10A,A01,083735,Patchell; Gregory David,11,0,30,19
1650215923015,MATH 10A,A02,083736,Patchell; Gregory David,28,0,30,2
1650215923015,MATH 10A,A03,083737,Patchell; Gregory David,26,0,30,4
1650215929042,MATH 10B,A01,083207,Staff,0,6,30,30
1650215929042,MATH 10B,A02,083208,Staff,0,5,30,30
1650215929042,MATH 10B,B01,083739,Staff,17,0,30,13
1650215929042,MATH 10B,B02,083740,Staff,29,0,30,1
1650215935074,MATH 18,A01,083743,Staff,8,0,30,22
1650215935074,MATH 18,A02,083744,Staff,28,0,30,2
1650215935074,MATH 18,A03,083745,Staff,23,0,30,7
1650215935074,MATH 18,A04,083746,Staff,27,0,30,3
1650215935074,MATH 18,B01,083748,Staff,0,10,30,30
1650215935074,MATH 18,B02,083749,Staff,0,7,30,30
1650215935074,MATH 18,B03,083750,Staff,0,7,30,30
1650215935074,MATH 18,B04,083751,Staff,0,8,30,30
1650215941097,MATH 20A,A01,083754,Staff,26,0,40,14
1650215947126,MATH 20B,A01,083756,Staff,0,6,30,30
1650215947126,MATH 20B,A02,083757,Staff,0,6,30,30
1650215953150,MATH 20C,A01,083760,Staff,0,12,30,30
1650215953150,MATH 20C,A02,083761,Staff,0,12,30,30
1650215953150,MATH 20C,B01,083762,Staff,14,0,30,16
1650215953150,MATH 20C,B02,083763,Staff,28,0,30,2
1650215959187,MATH 20D,A01,083765,Staff,1,2,30,29
1650215959187,MATH 20D,A02,083766,Staff,10,0,30,20
1650215959187,MATH 20D,A03,083767,Staff,28,0,30,2
1650215965214,MATH 20E,A01,083771,Staff,8,0,30,22
1650215965214,MATH 20E,A02,083772,Staff,20,0,30,10
1650215965214,MATH 20E,B01,083773,Staff,0,0,30,30
1650215965214,MATH 20E,B02,083774,Staff,12,0,30,18
1650215971239,MATH 103A,A01,083777,Staff,0,9,30,30
1650215971239,MATH 103A,A02,083778,Staff,0,10,30,30
1650215971239,MATH 103A,B01,083779,Staff,0,9,30,30
1650215971239,MATH 103A,B02,083780,Staff,0,9,30,30
1650215977263,MATH 105,A01,085443,Staff,0,17,30,30
1650215983290,MATH 109,A01,083213,Anzaldo; Leesa B,0,3,30,30
1650215983290,MATH 109,A02,083214,Anzaldo; Leesa B,0,6,30,30
1650215983290,MATH 109,B01,083215,Anzaldo; Leesa B,0,4,30,30
1650215983290,MATH 109,B02,083216,Anzaldo; Leesa B,0,4,30,30
1650215989319,MATH 142A,A01,083219,Chow; Bennett,0,12,30,30
1650215989319,MATH 142A,A02,083220,Chow; Bennett,0,11,30,30
1650215989319,MATH 142A,B01,083221,Chow; Bennett,0,11,30,30
1650215989319,MATH 142A,B02,083222,Chow; Bennett,0,12,30,30
1650215995346,MATH 193A,A01,083224,Staff,0,4,30,30
1650215995346,MATH 193A,A02,083225,Staff,0,4,30,30
1650215995346,MATH 193A,A03,083781,Staff,0,2,30,30
1650215995346,MATH 193A,A04,083782,Staff,0,1,30,30
1650216001370,MATH 197,001,091859,McAuley; Julian John,9998,0,9999,1
1650216007429,COGS 9,A01,083615,Staff,0,14,60,60
1650216013454,COGS 11,A01,083617,Boyle; Mary E. T.,24,0,40,16
1650216019482,COGS 13,A01,083071,Staff,0,30,40,40
1650216025509,COGS 14A,A01,092681,Staff,0,12,100,100
1650216031533,COGS 14B,A01,083073,Cheng; Tzu-Han,0,7,50,50
1650216037557,COGS 17,A01,092677,Staff,35,0,75,40
1650216043582,COGS 100,A01,083619,Staff,0,20,60,60
1650216049615,COGS 101A,A01,083621,Davis; Joshua Daniel,0,21,60,60
1650216055640,COGS 101B,A01,091572,Staff,6,0,60,54
1650216061664,COGS 101C,A01,083625,Delgado; Tania,20,0,30,10
1650216067689,COGS 107A,A01,083627,Boyle; Mary E. T.,0,7,60,60
1650216073716,COGS 118A,A01,083075,Staff,16,0,60,44
1650216079746,CSE 3,A50,083646,Miranda; Gregory Joseph,22,0,38,16
1650216079746,CSE 3,A51,083647,Miranda; Gregory Joseph,37,0,37,0
1650216085769,CSE 8A,A50,083650,Miranda; Gregory Joseph,0,17,40,40
1650216091795,CSE 11,A01,083080,Cao; Yingjun,0,68,40,40
1650216097818,CSE 12,A01,083652,Staff,0,7,100,100
1650216103843,CSE 15L,A01,083654,Staff,0,0,50,50
1650216103843,CSE 15L,A02,083655,Staff,6,0,50,44
1650216109868,CSE 20,A01,083657,Staff,53,0,80,27
1650216115898,CSE 30,A01,083084,Eldon; John,0,69,40,40
1650216121922,CSE 100,A01,083659,Cao; Yingjun,0,63,50,50
1650216127949,CSE 134B,A01,083661,Powell; Thomas Allan,0,27,65,65
1650216133972,CSE 140,A01,083663,Staff,1,0,75,74
1650216139996,CSE 140L,A01,083088,Eldon; John,0,4,75,75
1650216146021,CSE 175,A01,083665,Kumar; Rakesh,8,0,25,17
1650216152043,CSE 190,A00,092507,Dubnov; Shlomo,14,0,20,6
1650216158071,ECE 45,A01,083139,Staff,0,13,40,40
1650216164099,ECE 65,A50,083695,Staff,0,5,30,30
1650216170124,ECE 109,A01,091882,Touri; Behrouz,47,0,70,23
1650216176152,ECE 180,A00,083140,Abi Samra; Nicholas Camill,24,0,30,6
1650216176152,ECE 180,B00,083141,Abi Samra; Nicholas Camill,8,0,30,22
1650216182181,MATH 10A,A01,083735,Patchell; Gregory David,11,0,30,19
1650216182181,MATH 10A,A02,083736,Patchell; Gregory David,28,0,30,2
1650216182181,MATH 10A,A03,083737,Patchell; Gregory David,26,0,30,4
1650216188205,MATH 10B,A01,083207,Staff,0,6,30,30
1650216188205,MATH 10B,A02,083208,Staff,0,5,30,30
1650216188205,MATH 10B,B01,083739,Staff,17,0,30,13
1650216188205,MATH 10B,B02,083740,Staff,29,0,30,1
1650216194228,MATH 18,A01,083743,Staff,8,0,30,22
1650216194228,MATH 18,A02,083744,Staff,28,0,30,2
1650216194228,MATH 18,A03,083745,Staff,23,0,30,7
1650216194228,MATH 18,A04,083746,Staff,27,0,30,3
1650216194228,MATH 18,B01,083748,Staff,0,10,30,30
1650216194228,MATH 18,B02,083749,Staff,0,7,30,30
1650216194228,MATH 18,B03,083750,Staff,0,7,30,30
1650216194228,MATH 18,B04,083751,Staff,0,8,30,30
1650216200255,MATH 20A,A01,083754,Staff,26,0,40,14
1650216206279,MATH 20B,A01,083756,Staff,0,6,30,30
1650216206279,MATH 20B,A02,083757,Staff,0,6,30,30
1650216212307,MATH 20C,A01,083760,Staff,0,12,30,30
1650216212307,MATH 20C,A02,083761,Staff,0,12,30,30
1650216212307,MATH 20C,B01,083762,Staff,14,0,30,16
1650216212307,MATH 20C,B02,083763,Staff,28,0,30,2
1650216218334,MATH 20D,A01,083765,Staff,1,2,30,29
1650216218334,MATH 20D,A02,083766,Staff,10,0,30,20
1650216218334,MATH 20D,A03,083767,Staff,28,0,30,2
1650216224359,MATH 20E,A01,083771,Staff,8,0,30,22
1650216224359,MATH 20E,A02,083772,Staff,20,0,30,10
1650216224359,MATH 20E,B01,083773,Staff,0,0,30,30
1650216224359,MATH 20E,B02,083774,Staff,12,0,30,18
1650216230388,MATH 103A,A01,083777,Staff,0,9,30,30
1650216230388,MATH 103A,A02,083778,Staff,0,10,30,30
1650216230388,MATH 103A,B01,083779,Staff,0,9,30,30
1650216230388,MATH 103A,B02,083780,Staff,0,9,30,30
1650216236414,MATH 105,A01,085443,Staff,0,17,30,30
1650216242442,MATH 109,A01,083213,Anzaldo; Leesa B,0,3,30,30
1650216242442,MATH 109,A02,083214,Anzaldo; Leesa B,0,6,30,30
1650216242442,MATH 109,B01,083215,Anzaldo; Leesa B,0,4,30,30
1650216242442,MATH 109,B02,083216,Anzaldo; Leesa B,0,4,30,30
1650216248466,MATH 142A,A01,083219,Chow; Bennett,0,12,30,30
1650216248466,MATH 142A,A02,083220,Chow; Bennett,0,11,30,30
1650216248466,MATH 142A,B01,083221,Chow; Bennett,0,11,30,30
1650216248466,MATH 142A,B02,083222,Chow; Bennett,0,12,30,30
1650216254489,MATH 193A,A01,083224,Staff,0,4,30,30
1650216254489,MATH 193A,A02,083225,Staff,0,4,30,30
1650216254489,MATH 193A,A03,083781,Staff,0,2,30,30
1650216254489,MATH 193A,A04,083782,Staff,0,1,30,30
1650216260516,MATH 197,001,091859,McAuley; Julian John,9998,0,9999,1
1650216266587,COGS 9,A01,083615,Staff,0,14,60,60
1650216272612,COGS 11,A01,083617,Boyle; Mary E. T.,24,0,40,16
1650216278639,COGS 13,A01,083071,Staff,0,30,40,40
1650216284663,COGS 14A,A01,092681,Staff,0,12,100,100
1650216290698,COGS 14B,A01,083073,Cheng; Tzu-Han,0,7,50,50
1650216296728,COGS 17,A01,092677,Staff,35,0,75,40
1650216302750,COGS 100,A01,083619,Staff,0,20,60,60
1650216308772,COGS 101A,A01,083621,Davis; Joshua Daniel,0,21,60,60
1650216314799,COGS 101B,A01,091572,Staff,6,0,60,54
1650216320824,COGS 101C,A01,083625,Delgado; Tania,20,0,30,10
1650216326849,COGS 107A,A01,083627,Boyle; Mary E. T.,0,7,60,60
1650216332881,COGS 118A,A01,083075,Staff,16,0,60,44
1650216338919,CSE 3,A50,083646,Miranda; Gregory Joseph,22,0,38,16
1650216338919,CSE 3,A51,083647,Miranda; Gregory Joseph,37,0,37,0
1650216344958,CSE 8A,A50,083650,Miranda; Gregory Joseph,0,17,40,40
1650216350992,CSE 11,A01,083080,Cao; Yingjun,0,68,40,40
1650216357027,CSE 12,A01,083652,Staff,0,7,100,100
1650216363055,CSE 15L,A01,083654,Staff,0,0,50,50
1650216363055,CSE 15L,A02,083655,Staff,6,0,50,44
1650216369077,CSE 20,A01,083657,Staff,53,0,80,27
1650216375105,CSE 30,A01,083084,Eldon; John,0,69,40,40
1650216381130,CSE 100,A01,083659,Cao; Yingjun,0,63,50,50
1650216387154,CSE 134B,A01,083661,Powell; Thomas Allan,0,27,65,65
1650216393176,CSE 140,A01,083663,Staff,1,0,75,74
1650216399199,CSE 140L,A01,083088,Eldon; John,0,4,75,75
1650216405223,CSE 175,A01,083665,Kumar; Rakesh,8,0,25,17
1650216411247,CSE 190,A00,092507,Dubnov; Shlomo,14,0,20,6
1650216417273,ECE 45,A01,083139,Staff,0,13,40,40
1650216423297,ECE 65,A50,083695,Staff,0,5,30,30
1650216429320,ECE 109,A01,091882,Touri; Behrouz,47,0,70,23
1650216435344,ECE 180,A00,083140,Abi Samra; Nicholas Camill,24,0,30,6
1650216435344,ECE 180,B00,083141,Abi Samra; Nicholas Camill,8,0,30,22
1650216441374,MATH 10A,A01,083735,Patchell; Gregory David,11,0,30,19
1650216441374,MATH 10A,A02,083736,Patchell; Gregory David,28,0,30,2
1650216441374,MATH 10A,A03,083737,Patchell; Gregory David,26,0,30,4
1650216447401,MATH 10B,A01,083207,Staff,0,6,30,30
1650216447401,MATH 10B,A02,083208,Staff,0,5,30,30
1650216447401,MATH 10B,B01,083739,Staff,17,0,30,13
1650216447401,MATH 10B,B02,083740,Staff,29,0,30,1
1650216453433,MATH 18,A01,083743,Staff,8,0,30,22
1650216453433,MATH 18,A02,083744,Staff,28,0,30,2
1650216453433,MATH 18,A03,083745,Staff,23,0,30,7
1650216453433,MATH 18,A04,083746,Staff,27,0,30,3
1650216453433,MATH 18,B01,083748,Staff,0,10,30,30
1650216453433,MATH 18,B02,083749,Staff,0,7,30,30
1650216453433,MATH 18,B03,083750,Staff,0,7,30,30
1650216453433,MATH 18,B04,083751,Staff,0,8,30,30
1650216459461,MATH 20A,A01,083754,Staff,26,0,40,14
1650216465488,MATH 20B,A01,083756,Staff,0,6,30,30
1650216465488,MATH 20B,A02,083757,Staff,0,6,30,30
1650216471522,MATH 20C,A01,083760,Staff,0,12,30,30
1650216471522,MATH 20C,A02,083761,Staff,0,12,30,30
1650216471522,MATH 20C,B01,083762,Staff,14,0,30,16
1650216471522,MATH 20C,B02,083763,Staff,28,0,30,2
1650216477547,MATH 20D,A01,083765,Staff,1,2,30,29
1650216477547,MATH 20D,A02,083766,Staff,10,0,30,20
1650216477547,MATH 20D,A03,083767,Staff,28,0,30,2
1650216483572,MATH 20E,A01,083771,Staff,8,0,30,22
1650216483572,MATH 20E,A02,083772,Staff,20,0,30,10
1650216483572,MATH 20E,B01,083773,Staff,0,0,30,30
1650216483572,MATH 20E,B02,083774,Staff,12,0,30,18
1650216489689,MATH 103A,A01,083777,Staff,0,9,30,30
1650216489689,MATH 103A,A02,083778,Staff,0,10,30,30
1650216489689,MATH 103A,B01,083779,Staff,0,9,30,30
1650216489689,MATH 103A,B02,083780,Staff,0,9,30,30
1650216495717,MATH 105,A01,085443,Staff,0,17,30,30
1650216501746,MATH 109,A01,083213,Anzaldo; Leesa B,0,3,30,30
1650216501746,MATH 109,A02,083214,Anzaldo; Leesa B,0,6,30,30
1650216501746,MATH 109,B01,083215,Anzaldo; Leesa B,0,4,30,30
1650216501746,MATH 109,B02,083216,Anzaldo; Leesa B,0,4,30,30
1650216507772,MATH 142A,A01,083219,Chow; Bennett,0,12,30,30
1650216507772,MATH 142A,A02,083220,Chow; Bennett,0,11,30,30
1650216507772,MATH 142A,B01,083221,Chow; Bennett,0,11,30,30
1650216507772,MATH 142A,B02,083222,Chow; Bennett,0,12,30,30
1650216513800,MATH 193A,A01,083224,Staff,0,4,30,30
1650216513800,MATH 193A,A02,083225,Staff,0,4,30,30
1650216513800,MATH 193A,A03,083781,Staff,0,2,30,30
1650216513800,MATH 193A,A04,083782,Staff,0,1,30,30
1650216519826,MATH 197,001,091859,McAuley; Julian John,9998,0,9999,1
1650216525880,COGS 9,A01,083615,Staff,0,14,60,60
1650216531904,COGS 11,A01,083617,Boyle; Mary E. T.,24,0,40,16
1650216537931,COGS 13,A01,083071,Staff,0,30,40,40
1650216543966,COGS 14A,A01,092681,Staff,0,12,100,100
1650216549994,COGS 14B,A01,083073,Cheng; Tzu-Han,0,7,50,50
1650216556023,COGS 17,A01,092677,Staff,35,0,75,40
1650216562061,COGS 100,A01,083619,Staff,0,20,60,60
1650216568085,COGS 101A,A01,083621,Davis; Joshua Daniel,0,21,60,60
1650216574108,COGS 101B,A01,091572,Staff,6,0,60,54
1650216580131,COGS 101C,A01,083625,Delgado; Tania,20,0,30,10
1650216586155,COGS 107A,A01,083627,Boyle; Mary E. T.,0,7,60,60
1650216592180,COGS 118A,A01,083075,Staff,16,0,60,44
1650216598203,CSE 3,A50,083646,Miranda; Gregory Joseph,22,0,38,16
1650216598203,CSE 3,A51,083647,Miranda; Gregory Joseph,37,0,37,0
1650216604230,CSE 8A,A50,083650,Miranda; Gregory Joseph,0,17,40,40
1650216610254,CSE 11,A01,083080,Cao; Yingjun,0,68,40,40
1650216616277,CSE 12,A01,083652,Staff,0,7,100,100
1650216622301,CSE 15L,A01,083654,Staff,0,0,50,50
1650216622301,CSE 15L,A02,083655,Staff,6,0,50,44
1650216628336,CSE 20,A01,083657,Staff,53,0,80,27
1650216634361,CSE 30,A01,083084,Eldon; John,0,69,40,40
1650216640388,CSE 100,A01,083659,Cao; Yingjun,0,63,50,50
1650216646411,CSE 134B,A01,083661,Powell; Thomas Allan,0,27,65,65
1650216652439,CSE 140,A01,083663,Staff,1,0,75,74
1650216658466,CSE 140L,A01,083088,Eldon; John,0,4,75,75
1650216664493,CSE 175,A01,083665,Kumar; Rakesh,8,0,25,17
1650216670529,CSE 190,A00,092507,Dubnov; Shlomo,14,0,20,6
1650216676555,ECE 45,A01,083139,Staff,0,13,40,40
1650216682579,ECE 65,A50,083695,Staff,0,5,30,30
1650216688608,ECE 109,A01,091882,Touri; Behrouz,47,0,70,23
1650216694632,ECE 180,A00,083140,Abi Samra; Nicholas Camill,24,0,30,6
1650216694632,ECE 180,B00,083141,Abi Samra; Nicholas Camill,8,0,30,22
1650216700656,MATH 10A,A01,083735,Patchell; Gregory David,11,0,30,19
1650216700656,MATH 10A,A02,083736,Patchell; Gregory David,28,0,30,2
1650216700656,MATH 10A,A03,083737,Patchell; Gregory David,26,0,30,4
1650216706682,MATH 10B,A01,083207,Staff,0,6,30,30
1650216706682,MATH 10B,A02,083208,Staff,0,5,30,30
1650216706682,MATH 10B,B01,083739,Staff,17,0,30,13
1650216706682,MATH 10B,B02,083740,Staff,29,0,30,1
1650216712728,MATH 18,A01,083743,Staff,8,0,30,22
1650216712728,MATH 18,A02,083744,Staff,28,0,30,2
1650216712728,MATH 18,A03,083745,Staff,23,0,30,7
1650216712728,MATH 18,A04,083746,Staff,27,0,30,3
1650216712728,MATH 18,B01,083748,Staff,0,10,30,30
1650216712728,MATH 18,B02,083749,Staff,0,7,30,30
1650216712728,MATH 18,B03,083750,Staff,0,7,30,30
1650216712728,MATH 18,B04,083751,Staff,0,8,30,30
1650216718754,MATH 20A,A01,083754,Staff,26,0,40,14
1650216724790,MATH 20B,A01,083756,Staff,0,6,30,30
1650216724790,MATH 20B,A02,083757,Staff,0,6,30,30
1650216730814,MATH 20C,A01,083760,Staff,0,12,30,30
1650216730814,MATH 20C,A02,083761,Staff,0,12,30,30
1650216730814,MATH 20C,B01,083762,Staff,14,0,30,16
1650216730814,MATH 20C,B02,083763,Staff,28,0,30,2
1650216736842,MATH 20D,A01,083765,Staff,1,2,30,29
1650216736842,MATH 20D,A02,083766,Staff,10,0,30,20
1650216736842,MATH 20D,A03,083767,Staff,28,0,30,2
1650216742877,MATH 20E,A01,083771,Staff,8,0,30,22
1650216742877,MATH 20E,A02,083772,Staff,20,0,30,10
1650216742877,MATH 20E,B01,083773,Staff,0,0,30,30
1650216742877,MATH 20E,B02,083774,Staff,12,0,30,18
1650216748901,MATH 103A,A01,083777,Staff,0,9,30,30
1650216748901,MATH 103A,A02,083778,Staff,0,10,30,30
1650216748901,MATH 103A,B01,083779,Staff,0,9,30,30
1650216748901,MATH 103A,B02,083780,Staff,0,9,30,30
1650216754926,MATH 105,A01,085443,Staff,0,17,30,30
1650216760955,MATH 109,A01,083213,Anzaldo; Leesa B,0,3,30,30
1650216760955,MATH 109,A02,083214,Anzaldo; Leesa B,0,6,30,30
1650216760955,MATH 109,B01,083215,Anzaldo; Leesa B,0,4,30,30
1650216760955,MATH 109,B02,083216,Anzaldo; Leesa B,0,4,30,30
1650216766979,MATH 142A,A01,083219,Chow; Bennett,0,12,30,30
1650216766979,MATH 142A,A02,083220,Chow; Bennett,0,11,30,30
1650216766979,MATH 142A,B01,083221,Chow; Bennett,0,11,30,30
1650216766979,MATH 142A,B02,083222,Chow; Bennett,0,12,30,30
1650216773003,MATH 193A,A01,083224,Staff,0,4,30,30
1650216773003,MATH 193A,A02,083225,Staff,0,4,30,30
1650216773003,MATH 193A,A03,083781,Staff,0,2,30,30
1650216773003,MATH 193A,A04,083782,Staff,0,1,30,30
1650216779027,MATH 197,001,091859,McAuley; Julian John,9998,0,9999,1
1650216785091,COGS 9,A01,083615,Staff,0,14,60,60
1650216791114,COGS 11,A01,083617,Boyle; Mary E. T.,24,0,40,16
1650216797139,COGS 13,A01,083071,Staff,0,30,40,40
1650216803164,COGS 14A,A01,092681,Staff,0,12,100,100
1650216809188,COGS 14B,A01,083073,Cheng; Tzu-Han,0,7,50,50
1650216815212,COGS 17,A01,092677,Staff,35,0,75,40
1650216821238,COGS 100,A01,083619,Staff,0,20,60,60
1650216827264,COGS 101A,A01,083621,Davis; Joshua Daniel,0,21,60,60
1650216833294,COGS 101B,A01,091572,Staff,6,0,60,54
1650216839324,COGS 101C,A01,083625,Delgado; Tania,20,0,30,10
1650216845352,COGS 107A,A01,083627,Boyle; Mary E. T.,0,7,60,60
1650216851376,COGS 118A,A01,083075,Staff,16,0,60,44
1650216857399,CSE 3,A50,083646,Miranda; Gregory Joseph,22,0,38,16
1650216857399,CSE 3,A51,083647,Miranda; Gregory Joseph,37,0,37,0
1650216863423,CSE 8A,A50,083650,Miranda; Gregory Joseph,0,17,40,40
1650216869445,CSE 11,A01,083080,Cao; Yingjun,0,68,40,40
1650216875470,CSE 12,A01,083652,Staff,0,7,100,100
1650216881494,CSE 15L,A01,083654,Staff,0,0,50,50
1650216881494,CSE 15L,A02,083655,Staff,6,0,50,44
1650216887520,CSE 20,A01,083657,Staff,53,0,80,27
1650216893543,CSE 30,A01,083084,Eldon; John,0,69,40,40
1650216899567,CSE 100,A01,083659,Cao; Yingjun,0,63,50,50
1650216905591,CSE 134B,A01,083661,Powell; Thomas Allan,0,27,65,65
1650216911616,CSE 140,A01,083663,Staff,1,0,75,74
1650216917639,CSE 140L,A01,083088,Eldon; John,0,4,75,75
1650216923661,CSE 175,A01,083665,Kumar; Rakesh,8,0,25,17
1650216929688,CSE 190,A00,092507,Dubnov; Shlomo,14,0,20,6
1650216935715,ECE 45,A01,083139,Staff,0,13,40,40
1650216941739,ECE 65,A50,083695,Staff,0,5,30,30
1650216947766,ECE 109,A01,091882,Touri; Behrouz,47,0,70,23
1650216953804,ECE 180,A00,083140,Abi Samra; Nicholas Camill,24,0,30,6
1650216953804,ECE 180,B00,083141,Abi Samra; Nicholas Camill,8,0,30,22
1650216959827,MATH 10A,A01,083735,Patchell; Gregory David,11,0,30,19
1650216959827,MATH 10A,A02,083736,Patchell; Gregory David,28,0,30,2
1650216959827,MATH 10A,A03,083737,Patchell; Gregory David,26,0,30,4
1650216965863,MATH 10B,A01,083207,Staff,0,6,30,30
1650216965863,MATH 10B,A02,083208,Staff,0,5,30,30
1650216965863,MATH 10B,B01,083739,Staff,17,0,30,13
1650216965863,MATH 10B,B02,083740,Staff,29,0,30,1
1650216971891,MATH 18,A01,083743,Staff,8,0,30,22
1650216971891,MATH 18,A02,083744,Staff,28,0,30,2
1650216971891,MATH 18,A03,083745,Staff,23,0,30,7
1650216971891,MATH 18,A04,083746,Staff,27,0,30,3
1650216971891,MATH 18,B01,083748,Staff,0,10,30,30
1650216971891,MATH 18,B02,083749,Staff,0,7,30,30
1650216971891,MATH 18,B03,083750,Staff,0,7,30,30
1650216971891,MATH 18,B04,083751,Staff,0,8,30,30
1650216977919,MATH 20A,A01,083754,Staff,26,0,40,14
1650216983943,MATH 20B,A01,083756,Staff,0,6,30,30
1650216983943,MATH 20B,A02,083757,Staff,0,6,30,30
1650216989967,MATH 20C,A01,083760,Staff,0,12,30,30
1650216989967,MATH 20C,A02,083761,Staff,0,12,30,30
1650216989967,MATH 20C,B01,083762,Staff,14,0,30,16
1650216989967,MATH 20C,B02,083763,Staff,28,0,30,2
1650216995994,MATH 20D,A01,083765,Staff,1,2,30,29
1650216995994,MATH 20D,A02,083766,Staff,10,0,30,20
1650216995994,MATH 20D,A03,083767,Staff,28,0,30,2
1650217002021,MATH 20E,A01,083771,Staff,8,0,30,22
1650217002021,MATH 20E,A02,083772,Staff,20,0,30,10
1650217002021,MATH 20E,B01,083773,Staff,0,0,30,30
1650217002021,MATH 20E,B02,083774,Staff,12,0,30,18
1650217008050,MATH 103A,A01,083777,Staff,0,9,30,30
1650217008050,MATH 103A,A02,083778,Staff,0,10,30,30
1650217008050,MATH 103A,B01,083779,Staff,0,9,30,30
1650217008050,MATH 103A,B02,083780,Staff,0,9,30,30
1650217014090,MATH 105,A01,085443,Staff,0,17,30,30
1650217020119,MATH 109,A01,083213,Anzaldo; Leesa B,0,3,30,30
1650217020119,MATH 109,A02,083214,Anzaldo; Leesa B,0,6,30,30
1650217020119,MATH 109,B01,083215,Anzaldo; Leesa B,0,4,30,30
1650217020119,MATH 109,B02,083216,Anzaldo; Leesa B,0,4,30,30
1650217026143,MATH 142A,A01,083219,Chow; Bennett,0,12,30,30
1650217026143,MATH 142A,A02,083220,Chow; Bennett,0,11,30,30
1650217026143,MATH 142A,B01,083221,Chow; Bennett,0,11,30,30
1650217026143,MATH 142A,B02,083222,Chow; Bennett,0,12,30,30
1650217032167,MATH 193A,A01,083224,Staff,0,4,30,30
1650217032167,MATH 193A,A02,083225,Staff,0,4,30,30
1650217032167,MATH 193A,A03,083781,Staff,0,2,30,30
1650217032167,MATH 193A,A04,083782,Staff,0,1,30,30
1650217038191,MATH 197,001,091859,McAuley; Julian John,9998,0,9999,1
1650217044242,COGS 9,A01,083615,Staff,0,14,60,60
1650217050265,COGS 11,A01,083617,Boyle; Mary E. T.,24,0,40,16
1650217056291,COGS 13,A01,083071,Staff,0,30,40,40
1650217062319,COGS 14A,A01,092681,Staff,0,12,100,100
1650217068348,COGS 14B,A01,083073,Cheng; Tzu-Han,0,7,50,50
1650217074372,COGS 17,A01,092677,Staff,35,0,75,40
1650217080495,COGS 100,A01,083619,Staff,0,20,60,60
1650217086523,COGS 101A,A01,083621,Davis; Joshua Daniel,0,21,60,60
1650217092546,COGS 101B,A01,091572,Staff,6,0,60,54
1650217098567,COGS 101C,A01,083625,Delgado; Tania,20,0,30,10
1650217104590,COGS 107A,A01,083627,Boyle; Mary E. T.,0,7,60,60
1650217110612,COGS 118A,A01,083075,Staff,16,0,60,44
1650217116644,CSE 3,A50,083646,Miranda; Gregory Joseph,22,0,38,16
1650217116644,CSE 3,A51,083647,Miranda; Gregory Joseph,37,0,37,0
1650217122670,CSE 8A,A50,083650,Miranda; Gregory Joseph,0,17,40,40
1650217128697,CSE 11,A01,083080,Cao; Yingjun,0,68,40,40
1650217134726,CSE 12,A01,083652,Staff,0,7,100,100
1650217140750,CSE 15L,A01,083654,Staff,0,0,50,50
1650217140750,CSE 15L,A02,083655,Staff,6,0,50,44
1650217146774,CSE 20,A01,083657,Staff,53,0,80,27
1650217152802,CSE 30,A01,083084,Eldon; John,0,69,40,40
1650217158828,CSE 100,A01,083659,Cao; Yingjun,0,63,50,50
1650217164861,CSE 134B,A01,083661,Powell; Thomas Allan,0,27,65,65
1650217170885,CSE 140,A01,083663,Staff,1,0,75,74
1650217176908,CSE 140L,A01,083088,Eldon; John,0,4,75,75
1650217182936,CSE 175,A01,083665,Kumar; Rakesh,8,0,25,17
1650217188967,CSE 190,A00,092507,Dubnov; Shlomo,14,0,20,6
1650217194990,ECE 45,A01,083139,Staff,0,13,40,40
1650217201024,ECE 65,A50,083695,Staff,0,5,30,30
1650217207046,ECE 109,A01,091882,Touri; Behrouz,47,0,70,23
1650217213073,ECE 180,A00,083140,Abi Samra; Nicholas Camill,24,0,30,6
1650217213073,ECE 180,B00,083141,Abi Samra; Nicholas Camill,8,0,30,22
1650217219096,MATH 10A,A01,083735,Patchell; Gregory David,11,0,30,19
1650217219096,MATH 10A,A02,083736,Patchell; Gregory David,28,0,30,2
1650217219096,MATH 10A,A03,083737,Patchell; Gregory David,26,0,30,4
1650217225145,MATH 10B,A01,083207,Staff,0,6,30,30
1650217225145,MATH 10B,A02,083208,Staff,0,5,30,30
1650217225145,MATH 10B,B01,083739,Staff,17,0,30,13
1650217225145,MATH 10B,B02,083740,Staff,29,0,30,1
1650217231181,MATH 18,A01,083743,Staff,8,0,30,22
1650217231181,MATH 18,A02,083744,Staff,28,0,30,2
1650217231181,MATH 18,A03,083745,Staff,23,0,30,7
1650217231181,MATH 18,A04,083746,Staff,27,0,30,3
1650217231181,MATH 18,B01,083748,Staff,0,10,30,30
1650217231181,MATH 18,B02,083749,Staff,0,7,30,30
1650217231181,MATH 18,B03,083750,Staff,0,7,30,30
1650217231181,MATH 18,B04,083751,Staff,0,8,30,30
1650217237205,MATH 20A,A01,083754,Staff,26,0,40,14
1650217243238,MATH 20B,A01,083756,Staff,0,6,30,30
1650217243238,MATH 20B,A02,083757,Staff,0,6,30,30
1650217249269,MATH 20C,A01,083760,Staff,0,12,30,30
1650217249269,MATH 20C,A02,083761,Staff,0,12,30,30
1650217249269,MATH 20C,B01,083762,Staff,14,0,30,16
1650217249269,MATH 20C,B02,083763,Staff,28,0,30,2
1650217255300,MATH 20D,A01,083765,Staff,1,2,30,29
1650217255300,MATH 20D,A02,083766,Staff,10,0,30,20
1650217255300,MATH 20D,A03,083767,Staff,28,0,30,2
1650217261329,MATH 20E,A01,083771,Staff,8,0,30,22
1650217261329,MATH 20E,A02,083772,Staff,20,0,30,10
1650217261329,MATH 20E,B01,083773,Staff,0,0,30,30
1650217261329,MATH 20E,B02,083774,Staff,12,0,30,18
1650217267354,MATH 103A,A01,083777,Staff,0,9,30,30
1650217267354,MATH 103A,A02,083778,Staff,0,10,30,30
1650217267354,MATH 103A,B01,083779,Staff,0,9,30,30
1650217267354,MATH 103A,B02,083780,Staff,0,9,30,30
1650217273380,MATH 105,A01,085443,Staff,0,17,30,30
1650217279408,MATH 109,A01,083213,Anzaldo; Leesa B,0,3,30,30
1650217279408,MATH 109,A02,083214,Anzaldo; Leesa B,0,6,30,30
1650217279408,MATH 109,B01,083215,Anzaldo; Leesa B,0,4,30,30
1650217279408,MATH 109,B02,083216,Anzaldo; Leesa B,0,4,30,30
1650217285437,MATH 142A,A01,083219,Chow; Bennett,0,12,30,30
1650217285437,MATH 142A,A02,083220,Chow; Bennett,0,11,30,30
1650217285437,MATH 142A,B01,083221,Chow; Bennett,0,11,30,30
1650217285437,MATH 142A,B02,083222,Chow; Bennett,0,12,30,30
1650217291465,MATH 193A,A01,083224,Staff,0,4,30,30
1650217291465,MATH 193A,A02,083225,Staff,0,4,30,30
1650217291465,MATH 193A,A03,083781,Staff,0,2,30,30
1650217291465,MATH 193A,A04,083782,Staff,0,1,30,30
1650217297489,MATH 197,001,091859,McAuley; Julian John,9998,0,9999,1
1650217303548,COGS 9,A01,083615,Staff,0,14,60,60
1650217309573,COGS 11,A01,083617,Boyle; Mary E. T.,24,0,40,16
1650217315608,COGS 13,A01,083071,Staff,0,30,40,40
1650217321634,COGS 14A,A01,092681,Staff,0,12,100,100
1650217327658,COGS 14B,A01,083073,Cheng; Tzu-Han,0,7,50,50
1650217333683,COGS 17,A01,092677,Staff,35,0,75,40
1650217339709,COGS 100,A01,083619,Staff,0,20,60,60
1650217345732,COGS 101A,A01,083621,Davis; Joshua Daniel,0,21,60,60
1650217351758,COGS 101B,A01,091572,Staff,6,0,60,54
1650217357786,COGS 101C,A01,083625,Delgado; Tania,20,0,30,10
1650217363821,COGS 107A,A01,083627,Boyle; Mary E. T.,0,7,60,60
1650217369844,COGS 118A,A01,083075,Staff,16,0,60,44
1650217375869,CSE 3,A50,083646,Miranda; Gregory Joseph,22,0,38,16
1650217375869,CSE 3,A51,083647,Miranda; Gregory Joseph,37,0,37,0
1650217381896,CSE 8A,A50,083650,Miranda; Gregory Joseph,0,17,40,40
1650217387922,CSE 11,A01,083080,Cao; Yingjun,0,68,40,40
1650217393949,CSE 12,A01,083652,Staff,0,7,100,100
1650217399976,CSE 15L,A01,083654,Staff,0,0,50,50
1650217399976,CSE 15L,A02,083655,Staff,6,0,50,44
1650217406002,CSE 20,A01,083657,Staff,53,0,80,27
1650217412029,CSE 30,A01,083084,Eldon; John,0,69,40,40
1650217418057,CSE 100,A01,083659,Cao; Yingjun,0,63,50,50
1650217424091,CSE 134B,A01,083661,Powell; Thomas Allan,0,27,65,65
1650217430115,CSE 140,A01,083663,Staff,1,0,75,74
1650217436139,CSE 140L,A01,083088,Eldon; John,0,4,75,75
1650217442166,CSE 175,A01,083665,Kumar; Rakesh,8,0,25,17
1650217448199,CSE 190,A00,092507,Dubnov; Shlomo,14,0,20,6
1650217454223,ECE 45,A01,083139,Staff,0,13,40,40
1650217460249,ECE 65,A50,083695,Staff,0,5,30,30
1650217466276,ECE 109,A01,091882,Touri; Behrouz,47,0,70,23
1650217472299,ECE 180,A00,083140,Abi Samra; Nicholas Camill,24,0,30,6
1650217472299,ECE 180,B00,083141,Abi Samra; Nicholas Camill,8,0,30,22
1650217478323,MATH 10A,A01,083735,Patchell; Gregory David,11,0,30,19
1650217478323,MATH 10A,A02,083736,Patchell; Gregory David,28,0,30,2
1650217478323,MATH 10A,A03,083737,Patchell; Gregory David,26,0,30,4
1650217484352,MATH 10B,A01,083207,Staff,0,6,30,30
1650217484352,MATH 10B,A02,083208,Staff,0,5,30,30
1650217484352,MATH 10B,B01,083739,Staff,17,0,30,13
1650217484352,MATH 10B,B02,083740,Staff,29,0,30,1
1650217490379,MATH 18,A01,083743,Staff,8,0,30,22
1650217490379,MATH 18,A02,083744,Staff,28,0,30,2
1650217490379,MATH 18,A03,083745,Staff,23,0,30,7
1650217490379,MATH 18,A04,083746,Staff,27,0,30,3
1650217490379,MATH 18,B01,083748,Staff,0,10,30,30
1650217490379,MATH 18,B02,083749,Staff,0,7,30,30
1650217490379,MATH 18,B03,083750,Staff,0,7,30,30
1650217490379,MATH 18,B04,083751,Staff,0,8,30,30
1650217496405,MATH 20A,A01,083754,Staff,26,0,40,14
1650217502429,MATH 20B,A01,083756,Staff,0,6,30,30
1650217502429,MATH 20B,A02,083757,Staff,0,6,30,30
1650217508453,MATH 20C,A01,083760,Staff,0,12,30,30
1650217508453,MATH 20C,A02,083761,Staff,0,12,30,30
1650217508453,MATH 20C,B01,083762,Staff,14,0,30,16
1650217508453,MATH 20C,B02,083763,Staff,28,0,30,2
1650217514481,MATH 20D,A01,083765,Staff,1,2,30,29
1650217514481,MATH 20D,A02,083766,Staff,10,0,30,20
1650217514481,MATH 20D,A03,083767,Staff,28,0,30,2
1650217520509,MATH 20E,A01,083771,Staff,8,0,30,22
1650217520509,MATH 20E,A02,083772,Staff,20,0,30,10
1650217520509,MATH 20E,B01,083773,Staff,0,0,30,30
1650217520509,MATH 20E,B02,083774,Staff,12,0,30,18
1650217526537,MATH 103A,A01,083777,Staff,0,9,30,30
1650217526537,MATH 103A,A02,083778,Staff,0,10,30,30
1650217526537,MATH 103A,B01,083779,Staff,0,9,30,30
1650217526537,MATH 103A,B02,083780,Staff,0,9,30,30
1650217532562,MATH 105,A01,085443,Staff,0,17,30,30
1650217538586,MATH 109,A01,083213,Anzaldo; Leesa B,0,3,30,30
1650217538586,MATH 109,A02,083214,Anzaldo; Leesa B,0,6,30,30
1650217538586,MATH 109,B01,083215,Anzaldo; Leesa B,0,4,30,30
1650217538586,MATH 109,B02,083216,Anzaldo; Leesa B,0,4,30,30
1650217544614,MATH 142A,A01,083219,Chow; Bennett,0,12,30,30
1650217544614,MATH 142A,A02,083220,Chow; Bennett,0,11,30,30
1650217544614,MATH 142A,B01,083221,Chow; Bennett,0,11,30,30
1650217544614,MATH 142A,B02,083222,Chow; Bennett,0,12,30,30
1650217550642,MATH 193A,A01,083224,Staff,0,4,30,30
1650217550642,MATH 193A,A02,083225,Staff,0,4,30,30
1650217550642,MATH 193A,A03,083781,Staff,0,2,30,30
1650217550642,MATH 193A,A04,083782,Staff,0,1,30,30
1650217556670,MATH 197,001,091859,McAuley; Julian John,9998,0,9999,1
1650217562726,COGS 9,A01,083615,Staff,0,14,60,60
1650217568751,COGS 11,A01,083617,Boyle; Mary E. T.,24,0,40,16
1650217574774,COGS 13,A01,083071,Staff,0,30,40,40
1650217580798,COGS 14A,A01,092681,Staff,0,12,100,100
1650217586823,COGS 14B,A01,083073,Cheng; Tzu-Han,0,7,50,50
1650217592851,COGS 17,A01,092677,Staff,35,0,75,40
1650217598874,COGS 100,A01,083619,Staff,0,20,60,60
1650217604903,COGS 101A,A01,083621,Davis; Joshua Daniel,0,21,60,60
1650217610930,COGS 101B,A01,091572,Staff,6,0,60,54
1650217616951,COGS 101C,A01,083625,Delgado; Tania,20,0,30,10
1650217622975,COGS 107A,A01,083627,Boyle; Mary E. T.,0,7,60,60
1650217629004,COGS 118A,A01,083075,Staff,16,0,60,44
1650217635042,CSE 3,A50,083646,Miranda; Gregory Joseph,22,0,38,16
1650217635042,CSE 3,A51,083647,Miranda; Gregory Joseph,37,0,37,0
1650217641069,CSE 8A,A50,083650,Miranda; Gregory Joseph,0,17,40,40
1650217647093,CSE 11,A01,083080,Cao; Yingjun,0,68,40,40
1650217653122,CSE 12,A01,083652,Staff,0,7,100,100
1650217659149,CSE 15L,A01,083654,Staff,0,0,50,50
1650217659149,CSE 15L,A02,083655,Staff,6,0,50,44
1650217665174,CSE 20,A01,083657,Staff,53,0,80,27
1650217671201,CSE 30,A01,083084,Eldon; John,0,69,40,40
1650217677312,CSE 100,A01,083659,Cao; Yingjun,0,63,50,50
1650217683335,CSE 134B,A01,083661,Powell; Thomas Allan,0,27,65,65
1650217689358,CSE 140,A01,083663,Staff,1,0,75,74
1650217695382,CSE 140L,A01,083088,Eldon; John,0,4,75,75
1650217701406,CSE 175,A01,083665,Kumar; Rakesh,8,0,25,17
1650217707434,CSE 190,A00,092507,Dubnov; Shlomo,14,0,20,6
1650217713456,ECE 45,A01,083139,Staff,0,13,40,40
1650217719482,ECE 65,A50,083695,Staff,0,5,30,30
1650217725507,ECE 109,A01,091882,Touri; Behrouz,47,0,70,23
1650217731532,ECE 180,A00,083140,Abi Samra; Nicholas Camill,24,0,30,6
1650217731532,ECE 180,B00,083141,Abi Samra; Nicholas Camill,8,0,30,22
1650217737554,MATH 10A,A01,083735,Patchell; Gregory David,11,0,30,19
1650217737554,MATH 10A,A02,083736,Patchell; Gregory David,28,0,30,2
1650217737554,MATH 10A,A03,083737,Patchell; Gregory David,26,0,30,4
1650217743582,MATH 10B,A01,083207,Staff,0,6,30,30
1650217743582,MATH 10B,A02,083208,Staff,0,5,30,30
1650217743582,MATH 10B,B01,083739,Staff,17,0,30,13
1650217743582,MATH 10B,B02,083740,Staff,29,0,30,1
1650217749604,MATH 18,A01,083743,Staff,8,0,30,22
1650217749604,MATH 18,A02,083744,Staff,28,0,30,2
1650217749604,MATH 18,A03,083745,Staff,23,0,30,7
1650217749604,MATH 18,A04,083746,Staff,27,0,30,3
1650217749604,MATH 18,B01,083748,Staff,0,10,30,30
1650217749604,MATH 18,B02,083749,Staff,0,7,30,30
1650217749604,MATH 18,B03,083750,Staff,0,7,30,30
1650217749604,MATH 18,B04,083751,Staff,0,8,30,30
1650217755630,MATH 20A,A01,083754,Staff,26,0,40,14
1650217761659,MATH 20B,A01,083756,Staff,0,6,30,30
1650217761659,MATH 20B,A02,083757,Staff,0,6,30,30
1650217767683,MATH 20C,A01,083760,Staff,0,12,30,30
1650217767683,MATH 20C,A02,083761,Staff,0,12,30,30
1650217767683,MATH 20C,B01,083762,Staff,14,0,30,16
1650217767683,MATH 20C,B02,083763,Staff,28,0,30,2
1650217773711,MATH 20D,A01,083765,Staff,1,2,30,29
1650217773711,MATH 20D,A02,083766,Staff,10,0,30,20
1650217773711,MATH 20D,A03,083767,Staff,28,0,30,2
1650217779734,MATH 20E,A01,083771,Staff,8,0,30,22
1650217779734,MATH 20E,A02,083772,Staff,20,0,30,10
1650217779734,MATH 20E,B01,083773,Staff,0,0,30,30
1650217779734,MATH 20E,B02,083774,Staff,12,0,30,18
1650217785757,MATH 103A,A01,083777,Staff,0,9,30,30
1650217785757,MATH 103A,A02,083778,Staff,0,10,30,30
1650217785757,MATH 103A,B01,083779,Staff,0,9,30,30
1650217785757,MATH 103A,B02,083780,Staff,0,9,30,30
1650217791784,MATH 105,A01,085443,Staff,0,17,30,30
1650217797806,MATH 109,A01,083213,Anzaldo; Leesa B,0,3,30,30
1650217797806,MATH 109,A02,083214,Anzaldo; Leesa B,0,6,30,30
1650217797806,MATH 109,B01,083215,Anzaldo; Leesa B,0,4,30,30
1650217797806,MATH 109,B02,083216,Anzaldo; Leesa B,0,4,30,30
1650217803831,MATH 142A,A01,083219,Chow; Bennett,0,12,30,30
1650217803831,MATH 142A,A02,083220,Chow; Bennett,0,11,30,30
1650217803831,MATH 142A,B01,083221,Chow; Bennett,0,11,30,30
1650217803831,MATH 142A,B02,083222,Chow; Bennett,0,12,30,30
1650217809858,MATH 193A,A01,083224,Staff,0,4,30,30
1650217809858,MATH 193A,A02,083225,Staff,0,4,30,30
1650217809858,MATH 193A,A03,083781,Staff,0,2,30,30
1650217809858,MATH 193A,A04,083782,Staff,0,1,30,30
1650217815881,MATH 197,001,091859,McAuley; Julian John,9998,0,9999,1
1650217821937,COGS 9,A01,083615,Staff,0,14,60,60
1650217827960,COGS 11,A01,083617,Boyle; Mary E. T.,24,0,40,16
1650217833986,COGS 13,A01,083071,Staff,0,30,40,40
1650217840011,COGS 14A,A01,092681,Staff,0,12,100,100
1650217846034,COGS 14B,A01,083073,Cheng; Tzu-Han,0,7,50,50
1650217852058,COGS 17,A01,092677,Staff,35,0,75,40
1650217858087,COGS 100,A01,083619,Staff,0,20,60,60
1650217864113,COGS 101A,A01,083621,Davis; Joshua Daniel,0,21,60,60
1650217870136,COGS 101B,A01,091572,Staff,6,0,60,54
1650217876160,COGS 101C,A01,083625,Delgado; Tania,20,0,30,10
1650217882185,COGS 107A,A01,083627,Boyle; Mary E. T.,0,7,60,60
1650217888207,COGS 118A,A01,083075,Staff,16,0,60,44
1650217894231,CSE 3,A50,083646,Miranda; Gregory Joseph,22,0,38,16
1650217894231,CSE 3,A51,083647,Miranda; Gregory Joseph,37,0,37,0
1650217900258,CSE 8A,A50,083650,Miranda; Gregory Joseph,0,17,40,40
1650217906282,CSE 11,A01,083080,Cao; Yingjun,0,68,40,40
1650217912309,CSE 12,A01,083652,Staff,0,7,100,100
1650217918333,CSE 15L,A01,083654,Staff,0,0,50,50
1650217918333,CSE 15L,A02,083655,Staff,6,0,50,44
1650217924361,CSE 20,A01,083657,Staff,53,0,80,27
1650217930386,CSE 30,A01,083084,Eldon; John,0,70,40,40
1650217936410,CSE 100,A01,083659,Cao; Yingjun,0,63,50,50
1650217942433,CSE 134B,A01,083661,Powell; Thomas Allan,0,27,65,65
1650217948468,CSE 140,A01,083663,Staff,1,0,75,74
1650217954495,CSE 140L,A01,083088,Eldon; John,0,4,75,75
1650217960521,CSE 175,A01,083665,Kumar; Rakesh,8,0,25,17
1650217966543,CSE 190,A00,092507,Dubnov; Shlomo,14,0,20,6
1650217972571,ECE 45,A01,083139,Staff,0,13,40,40
1650217978605,ECE 65,A50,083695,Staff,0,5,30,30
1650217984631,ECE 109,A01,091882,Touri; Behrouz,47,0,70,23
1650217990664,ECE 180,A00,083140,Abi Samra; Nicholas Camill,24,0,30,6
1650217990664,ECE 180,B00,083141,Abi Samra; Nicholas Camill,8,0,30,22
1650217996688,MATH 10A,A01,083735,Patchell; Gregory David,11,0,30,19
1650217996688,MATH 10A,A02,083736,Patchell; Gregory David,28,0,30,2
1650217996688,MATH 10A,A03,083737,Patchell; Gregory David,26,0,30,4
1650218002716,MATH 10B,A01,083207,Staff,0,6,30,30
1650218002716,MATH 10B,A02,083208,Staff,0,5,30,30
1650218002716,MATH 10B,B01,083739,Staff,17,0,30,13
1650218002716,MATH 10B,B02,083740,Staff,29,0,30,1
1650218008745,MATH 18,A01,083743,Staff,8,0,30,22
1650218008745,MATH 18,A02,083744,Staff,28,0,30,2
1650218008745,MATH 18,A03,083745,Staff,23,0,30,7
1650218008745,MATH 18,A04,083746,Staff,27,0,30,3
1650218008745,MATH 18,B01,083748,Staff,0,10,30,30
1650218008745,MATH 18,B02,083749,Staff,0,7,30,30
1650218008745,MATH 18,B03,083750,Staff,0,7,30,30
1650218008745,MATH 18,B04,083751,Staff,0,8,30,30
1650218014771,MATH 20A,A01,083754,Staff,26,0,40,14
1650218020794,MATH 20B,A01,083756,Staff,0,6,30,30
1650218020794,MATH 20B,A02,083757,Staff,0,6,30,30
1650218026816,MATH 20C,A01,083760,Staff,0,12,30,30
1650218026816,MATH 20C,A02,083761,Staff,0,12,30,30
1650218026816,MATH 20C,B01,083762,Staff,14,0,30,16
1650218026816,MATH 20C,B02,083763,Staff,28,0,30,2
1650218032842,MATH 20D,A01,083765,Staff,1,2,30,29
1650218032842,MATH 20D,A02,083766,Staff,10,0,30,20
1650218032842,MATH 20D,A03,083767,Staff,28,0,30,2
1650218038865,MATH 20E,A01,083771,Staff,8,0,30,22
1650218038865,MATH 20E,A02,083772,Staff,20,0,30,10
1650218038865,MATH 20E,B01,083773,Staff,0,0,30,30
1650218038865,MATH 20E,B02,083774,Staff,12,0,30,18
1650218044888,MATH 103A,A01,083777,Staff,0,9,30,30
1650218044888,MATH 103A,A02,083778,Staff,0,10,30,30
1650218044888,MATH 103A,B01,083779,Staff,0,9,30,30
1650218044888,MATH 103A,B02,083780,Staff,0,9,30,30
1650218050911,MATH 105,A01,085443,Staff,0,17,30,30
1650218056940,MATH 109,A01,083213,Anzaldo; Leesa B,0,3,30,30
1650218056940,MATH 109,A02,083214,Anzaldo; Leesa B,0,6,30,30
1650218056940,MATH 109,B01,083215,Anzaldo; Leesa B,0,4,30,30
1650218056940,MATH 109,B02,083216,Anzaldo; Leesa B,0,4,30,30
1650218062965,MATH 142A,A01,083219,Chow; Bennett,0,12,30,30
1650218062965,MATH 142A,A02,083220,Chow; Bennett,0,11,30,30
1650218062965,MATH 142A,B01,083221,Chow; Bennett,0,11,30,30
1650218062965,MATH 142A,B02,083222,Chow; Bennett,0,12,30,30
1650218068988,MATH 193A,A01,083224,Staff,0,4,30,30
1650218068988,MATH 193A,A02,083225,Staff,0,4,30,30
1650218068988,MATH 193A,A03,083781,Staff,0,2,30,30
1650218068988,MATH 193A,A04,083782,Staff,0,1,30,30
1650218075012,MATH 197,001,091859,McAuley; Julian John,9998,0,9999,1
1650218081063,COGS 9,A01,083615,Staff,0,14,60,60
1650218087098,COGS 11,A01,083617,Boyle; Mary E. T.,24,0,40,16
1650218093123,COGS 13,A01,083071,Staff,0,30,40,40
1650218099147,COGS 14A,A01,092681,Staff,0,12,100,100
1650218105171,COGS 14B,A01,083073,Cheng; Tzu-Han,0,7,50,50
1650218111194,COGS 17,A01,092677,Staff,35,0,75,40
1650218117220,COGS 100,A01,083619,Staff,0,20,60,60
1650218123251,COGS 101A,A01,083621,Davis; Joshua Daniel,0,21,60,60
1650218129277,COGS 101B,A01,091572,Staff,6,0,60,54
1650218135302,COGS 101C,A01,083625,Delgado; Tania,20,0,30,10
1650218141329,COGS 107A,A01,083627,Boyle; Mary E. T.,0,7,60,60
1650218147352,COGS 118A,A01,083075,Staff,16,0,60,44
1650218153384,CSE 3,A50,083646,Miranda; Gregory Joseph,22,0,38,16
1650218153384,CSE 3,A51,083647,Miranda; Gregory Joseph,37,0,37,0
1650218159408,CSE 8A,A50,083650,Miranda; Gregory Joseph,0,17,40,40
1650218165432,CSE 11,A01,083080,Cao; Yingjun,0,68,40,40
1650218171458,CSE 12,A01,083652,Staff,0,7,100,100
1650218177489,CSE 15L,A01,083654,Staff,0,0,50,50
1650218177489,CSE 15L,A02,083655,Staff,6,0,50,44
1650218183516,CSE 20,A01,083657,Staff,53,0,80,27
1650218189540,CSE 30,A01,083084,Eldon; John,0,70,40,40
1650218195567,CSE 100,A01,083659,Cao; Yingjun,0,63,50,50
1650218201594,CSE 134B,A01,083661,Powell; Thomas Allan,0,27,65,65
1650218207618,CSE 140,A01,083663,Staff,1,0,75,74
1650218213645,CSE 140L,A01,083088,Eldon; John,0,4,75,75
1650218219674,CSE 175,A01,083665,Kumar; Rakesh,8,0,25,17
1650218225702,CSE 190,A00,092507,Dubnov; Shlomo,14,0,20,6
1650218231734,ECE 45,A01,083139,Staff,0,13,40,40
1650218237757,ECE 65,A50,083695,Staff,0,5,30,30
1650218243786,ECE 109,A01,091882,Touri; Behrouz,47,0,70,23
1650218249813,ECE 180,A00,083140,Abi Samra; Nicholas Camill,24,0,30,6
1650218249813,ECE 180,B00,083141,Abi Samra; Nicholas Camill,8,0,30,22
1650218255842,MATH 10A,A01,083735,Patchell; Gregory David,11,0,30,19
1650218255842,MATH 10A,A02,083736,Patchell; Gregory David,28,0,30,2
1650218255842,MATH 10A,A03,083737,Patchell; Gregory David,26,0,30,4
1650218261871,MATH 10B,A01,083207,Staff,0,6,30,30
1650218261871,MATH 10B,A02,083208,Staff,0,5,30,30
1650218261871,MATH 10B,B01,083739,Staff,17,0,30,13
1650218261871,MATH 10B,B02,083740,Staff,29,0,30,1
1650218267902,MATH 18,A01,083743,Staff,8,0,30,22
1650218267902,MATH 18,A02,083744,Staff,28,0,30,2
1650218267902,MATH 18,A03,083745,Staff,23,0,30,7
1650218267902,MATH 18,A04,083746,Staff,27,0,30,3
1650218267902,MATH 18,B01,083748,Staff,0,10,30,30
1650218267902,MATH 18,B02,083749,Staff,0,7,30,30
1650218267902,MATH 18,B03,083750,Staff,0,7,30,30
1650218267902,MATH 18,B04,083751,Staff,0,8,30,30
1650218274013,MATH 20A,A01,083754,Staff,26,0,40,14
1650218280037,MATH 20B,A01,083756,Staff,0,6,30,30
1650218280037,MATH 20B,A02,083757,Staff,0,6,30,30
1650218286061,MATH 20C,A01,083760,Staff,0,12,30,30
1650218286061,MATH 20C,A02,083761,Staff,0,12,30,30
1650218286061,MATH 20C,B01,083762,Staff,14,0,30,16
1650218286061,MATH 20C,B02,083763,Staff,28,0,30,2
1650218292089,MATH 20D,A01,083765,Staff,1,2,30,29
1650218292089,MATH 20D,A02,083766,Staff,10,0,30,20
1650218292089,MATH 20D,A03,083767,Staff,28,0,30,2
1650218298113,MATH 20E,A01,083771,Staff,8,0,30,22
1650218298113,MATH 20E,A02,083772,Staff,20,0,30,10
1650218298113,MATH 20E,B01,083773,Staff,0,0,30,30
1650218298113,MATH 20E,B02,083774,Staff,12,0,30,18
1650218304138,MATH 103A,A01,083777,Staff,0,9,30,30
1650218304138,MATH 103A,A02,083778,Staff,0,10,30,30
1650218304138,MATH 103A,B01,083779,Staff,0,9,30,30
1650218304138,MATH 103A,B02,083780,Staff,0,9,30,30
1650218310163,MATH 105,A01,085443,Staff,0,17,30,30
1650218316192,MATH 109,A01,083213,Anzaldo; Leesa B,0,3,30,30
1650218316192,MATH 109,A02,083214,Anzaldo; Leesa B,0,6,30,30
1650218316192,MATH 109,B01,083215,Anzaldo; Leesa B,0,4,30,30
1650218316192,MATH 109,B02,083216,Anzaldo; Leesa B,0,4,30,30
1650218322238,MATH 142A,A01,083219,Chow; Bennett,0,12,30,30
1650218322238,MATH 142A,A02,083220,Chow; Bennett,0,11,30,30
1650218322238,MATH 142A,B01,083221,Chow; Bennett,0,11,30,30
1650218322238,MATH 142A,B02,083222,Chow; Bennett,0,12,30,30
1650218328265,MATH 193A,A01,083224,Staff,0,4,30,30
1650218328265,MATH 193A,A02,083225,Staff,0,4,30,30
1650218328265,MATH 193A,A03,083781,Staff,0,2,30,30
1650218328265,MATH 193A,A04,083782,Staff,0,1,30,30
1650218334290,MATH 197,001,091859,McAuley; Julian John,9998,0,9999,1
1650218340358,COGS 9,A01,083615,Staff,0,14,60,60
1650218346382,COGS 11,A01,083617,Boyle; Mary E. T.,24,0,40,16
1650218352405,COGS 13,A01,083071,Staff,0,30,40,40
1650218358428,COGS 14A,A01,092681,Staff,0,12,100,100
1650218364462,COGS 14B,A01,083073,Cheng; Tzu-Han,0,7,50,50
1650218370485,COGS 17,A01,092677,Staff,35,0,75,40
1650218376513,COGS 100,A01,083619,Staff,0,20,60,60
1650218382535,COGS 101A,A01,083621,Davis; Joshua Daniel,0,21,60,60
1650218388562,COGS 101B,A01,091572,Staff,6,0,60,54
1650218394585,COGS 101C,A01,083625,Delgado; Tania,20,0,30,10
1650218400608,COGS 107A,A01,083627,Boyle; Mary E. T.,0,7,60,60
1650218406633,COGS 118A,A01,083075,Staff,16,0,60,44
1650218412660,CSE 3,A50,083646,Miranda; Gregory Joseph,22,0,38,16
1650218412660,CSE 3,A51,083647,Miranda; Gregory Joseph,37,0,37,0
1650218418687,CSE 8A,A50,083650,Miranda; Gregory Joseph,0,17,40,40
1650218424710,CSE 11,A01,083080,Cao; Yingjun,0,68,40,40
1650218430733,CSE 12,A01,083652,Staff,0,7,100,100
1650218436762,CSE 15L,A01,083654,Staff,0,0,50,50
1650218436762,CSE 15L,A02,083655,Staff,6,0,50,44
1650218442787,CSE 20,A01,083657,Staff,53,0,80,27
1650218448816,CSE 30,A01,083084,Eldon; John,0,70,40,40
1650218454841,CSE 100,A01,083659,Cao; Yingjun,0,63,50,50
1650218460870,CSE 134B,A01,083661,Powell; Thomas Allan,0,27,65,65
1650218466896,CSE 140,A01,083663,Staff,1,0,75,74
1650218472920,CSE 140L,A01,083088,Eldon; John,0,4,75,75
1650218478948,CSE 175,A01,083665,Kumar; Rakesh,8,0,25,17
1650218484973,CSE 190,A00,092507,Dubnov; Shlomo,14,0,20,6
1650218491000,ECE 45,A01,083139,Staff,0,13,40,40
1650218497028,ECE 65,A50,083695,Staff,0,5,30,30
1650218503056,ECE 109,A01,091882,Touri; Behrouz,47,0,70,23
1650218509080,ECE 180,A00,083140,Abi Samra; Nicholas Camill,24,0,30,6
1650218509080,ECE 180,B00,083141,Abi Samra; Nicholas Camill,8,0,30,22
1650218515110,MATH 10A,A01,083735,Patchell; Gregory David,11,0,30,19
1650218515110,MATH 10A,A02,083736,Patchell; Gregory David,28,0,30,2
1650218515110,MATH 10A,A03,083737,Patchell; Gregory David,26,0,30,4
1650218521135,MATH 10B,A01,083207,Staff,0,6,30,30
1650218521135,MATH 10B,A02,083208,Staff,0,5,30,30
1650218521135,MATH 10B,B01,083739,Staff,17,0,30,13
1650218521135,MATH 10B,B02,083740,Staff,29,0,30,1
1650218527160,MATH 18,A01,083743,Staff,8,0,30,22
1650218527160,MATH 18,A02,083744,Staff,28,0,30,2
1650218527160,MATH 18,A03,083745,Staff,23,0,30,7
1650218527160,MATH 18,A04,083746,Staff,27,0,30,3
1650218527160,MATH 18,B01,083748,Staff,0,10,30,30
1650218527160,MATH 18,B02,083749,Staff,0,7,30,30
1650218527160,MATH 18,B03,083750,Staff,0,7,30,30
1650218527160,MATH 18,B04,083751,Staff,0,8,30,30
1650218533197,MATH 20A,A01,083754,Staff,26,0,40,14
1650218539224,MATH 20B,A01,083756,Staff,0,6,30,30
1650218539224,MATH 20B,A02,083757,Staff,0,6,30,30
1650218545249,MATH 20C,A01,083760,Staff,0,12,30,30
1650218545249,MATH 20C,A02,083761,Staff,0,12,30,30
1650218545249,MATH 20C,B01,083762,Staff,14,0,30,16
1650218545249,MATH 20C,B02,083763,Staff,28,0,30,2
1650218551277,MATH 20D,A01,083765,Staff,1,2,30,29
1650218551277,MATH 20D,A02,083766,Staff,10,0,30,20
1650218551277,MATH 20D,A03,083767,Staff,28,0,30,2
1650218557302,MATH 20E,A01,083771,Staff,8,0,30,22
1650218557302,MATH 20E,A02,083772,Staff,20,0,30,10
1650218557302,MATH 20E,B01,083773,Staff,0,0,30,30
1650218557302,MATH 20E,B02,083774,Staff,12,0,30,18
1650218563356,MATH 103A,A01,083777,Staff,0,9,30,30
1650218563356,MATH 103A,A02,083778,Staff,0,10,30,30
1650218563356,MATH 103A,B01,083779,Staff,0,9,30,30
1650218563356,MATH 103A,B02,083780,Staff,0,9,30,30
1650218569377,MATH 105,A01,085443,Staff,0,17,30,30
1650218575402,MATH 109,A01,083213,Anzaldo; Leesa B,0,3,30,30
1650218575402,MATH 109,A02,083214,Anzaldo; Leesa B,0,6,30,30
1650218575402,MATH 109,B01,083215,Anzaldo; Leesa B,0,4,30,30
1650218575402,MATH 109,B02,083216,Anzaldo; Leesa B,0,4,30,30
1650218581427,MATH 142A,A01,083219,Chow; Bennett,0,12,30,30
1650218581427,MATH 142A,A02,083220,Chow; Bennett,0,11,30,30
1650218581427,MATH 142A,B01,083221,Chow; Bennett,0,11,30,30
1650218581427,MATH 142A,B02,083222,Chow; Bennett,0,12,30,30
1650218587451,MATH 193A,A01,083224,Staff,0,4,30,30
1650218587451,MATH 193A,A02,083225,Staff,0,4,30,30
1650218587451,MATH 193A,A03,083781,Staff,0,2,30,30
1650218587451,MATH 193A,A04,083782,Staff,0,1,30,30
1650218593478,MATH 197,001,091859,McAuley; Julian John,9998,0,9999,1
1650218599554,COGS 9,A01,083615,Staff,0,14,60,60
1650218605578,COGS 11,A01,083617,Boyle; Mary E. T.,24,0,40,16
1650218611606,COGS 13,A01,083071,Staff,0,30,40,40
1650218617634,COGS 14A,A01,092681,Staff,0,12,100,100
1650218623661,COGS 14B,A01,083073,Cheng; Tzu-Han,0,7,50,50
1650218629685,COGS 17,A01,092677,Staff,35,0,75,40
1650218635724,COGS 100,A01,083619,Staff,0,20,60,60
1650218641759,COGS 101A,A01,083621,Davis; Joshua Daniel,0,21,60,60
1650218647786,COGS 101B,A01,091572,Staff,6,0,60,54
1650218653811,COGS 101C,A01,083625,Delgado; Tania,20,0,30,10
1650218659837,COGS 107A,A01,083627,Boyle; Mary E. T.,1,7,60,59
1650218665861,COGS 118A,A01,083075,Staff,16,0,60,44
1650218671887,CSE 3,A50,083646,Miranda; Gregory Joseph,22,0,38,16
1650218671887,CSE 3,A51,083647,Miranda; Gregory Joseph,37,0,37,0
1650218677920,CSE 8A,A50,083650,Miranda; Gregory Joseph,0,17,40,40
1650218683943,CSE 11,A01,083080,Cao; Yingjun,0,68,40,40
1650218689967,CSE 12,A01,083652,Staff,0,7,100,100
1650218695996,CSE 15L,A01,083654,Staff,0,0,50,50
1650218695996,CSE 15L,A02,083655,Staff,6,0,50,44
1650218702023,CSE 20,A01,083657,Staff,53,0,80,27
1650218708050,CSE 30,A01,083084,Eldon; John,0,70,40,40
1650218714075,CSE 100,A01,083659,Cao; Yingjun,0,63,50,50
1650218720100,CSE 134B,A01,083661,Powell; Thomas Allan,0,27,65,65
1650218726126,CSE 140,A01,083663,Staff,1,0,75,74
1650218732152,CSE 140L,A01,083088,Eldon; John,0,4,75,75
1650218738174,CSE 175,A01,083665,Kumar; Rakesh,8,0,25,17
1650218744196,CSE 190,A00,092507,Dubnov; Shlomo,14,0,20,6
1650218750232,ECE 45,A01,083139,Staff,0,13,40,40
1650218756259,ECE 65,A50,083695,Staff,0,5,30,30
1650218762283,ECE 109,A01,091882,Touri; Behrouz,47,0,70,23
1650218768307,ECE 180,A00,083140,Abi Samra; Nicholas Camill,24,0,30,6
1650218768307,ECE 180,B00,083141,Abi Samra; Nicholas Camill,8,0,30,22
1650218774332,MATH 10A,A01,083735,Patchell; Gregory David,11,0,30,19
1650218774332,MATH 10A,A02,083736,Patchell; Gregory David,28,0,30,2
1650218774332,MATH 10A,A03,083737,Patchell; Gregory David,26,0,30,4
1650218780361,MATH 10B,A01,083207,Staff,0,6,30,30
1650218780361,MATH 10B,A02,083208,Staff,0,5,30,30
1650218780361,MATH 10B,B01,083739,Staff,17,0,30,13
1650218780361,MATH 10B,B02,083740,Staff,29,0,30,1
1650218786386,MATH 18,A01,083743,Staff,8,0,30,22
1650218786386,MATH 18,A02,083744,Staff,28,0,30,2
1650218786386,MATH 18,A03,083745,Staff,23,0,30,7
1650218786386,MATH 18,A04,083746,Staff,27,0,30,3
1650218786386,MATH 18,B01,083748,Staff,0,10,30,30
1650218786386,MATH 18,B02,083749,Staff,0,7,30,30
1650218786386,MATH 18,B03,083750,Staff,0,7,30,30
1650218786386,MATH 18,B04,083751,Staff,0,8,30,30
1650218792413,MATH 20A,A01,083754,Staff,26,0,40,14
1650218798439,MATH 20B,A01,083756,Staff,0,6,30,30
1650218798439,MATH 20B,A02,083757,Staff,0,6,30,30
1650218804471,MATH 20C,A01,083760,Staff,0,12,30,30
1650218804471,MATH 20C,A02,083761,Staff,0,12,30,30
1650218804471,MATH 20C,B01,083762,Staff,14,0,30,16
1650218804471,MATH 20C,B02,083763,Staff,28,0,30,2
1650218810500,MATH 20D,A01,083765,Staff,1,2,30,29
1650218810500,MATH 20D,A02,083766,Staff,10,0,30,20
1650218810500,MATH 20D,A03,083767,Staff,28,0,30,2
1650218816529,MATH 20E,A01,083771,Staff,8,0,30,22
1650218816529,MATH 20E,A02,083772,Staff,20,0,30,10
1650218816529,MATH 20E,B01,083773,Staff,0,0,30,30
1650218816529,MATH 20E,B02,083774,Staff,12,0,30,18
1650218822553,MATH 103A,A01,083777,Staff,0,9,30,30
1650218822553,MATH 103A,A02,083778,Staff,0,10,30,30
1650218822553,MATH 103A,B01,083779,Staff,0,9,30,30
1650218822553,MATH 103A,B02,083780,Staff,0,9,30,30
1650218828577,MATH 105,A01,085443,Staff,0,17,30,30
1650218834604,MATH 109,A01,083213,Anzaldo; Leesa B,0,3,30,30
1650218834604,MATH 109,A02,083214,Anzaldo; Leesa B,0,6,30,30
1650218834604,MATH 109,B01,083215,Anzaldo; Leesa B,0,4,30,30
1650218834604,MATH 109,B02,083216,Anzaldo; Leesa B,0,4,30,30
1650218840629,MATH 142A,A01,083219,Chow; Bennett,0,12,30,30
1650218840629,MATH 142A,A02,083220,Chow; Bennett,0,11,30,30
1650218840629,MATH 142A,B01,083221,Chow; Bennett,0,11,30,30
1650218840629,MATH 142A,B02,083222,Chow; Bennett,0,12,30,30
1650218846653,MATH 193A,A01,083224,Staff,0,4,30,30
1650218846653,MATH 193A,A02,083225,Staff,0,4,30,30
1650218846653,MATH 193A,A03,083781,Staff,0,2,30,30
1650218846653,MATH 193A,A04,083782,Staff,0,1,30,30
1650218852677,MATH 197,001,091859,McAuley; Julian John,9998,0,9999,1
1650218858736,COGS 9,A01,083615,Staff,0,14,60,60
1650218864862,COGS 11,A01,083617,Boyle; Mary E. T.,24,0,40,16
1650218870890,COGS 13,A01,083071,Staff,0,30,40,40
1650218876914,COGS 14A,A01,092681,Staff,0,12,100,100
1650218882939,COGS 14B,A01,083073,Cheng; Tzu-Han,0,7,50,50
1650218888961,COGS 17,A01,092677,Staff,35,0,75,40
1650218894985,COGS 100,A01,083619,Staff,0,20,60,60
1650218901009,COGS 101A,A01,083621,Davis; Joshua Daniel,0,21,60,60
1650218907033,COGS 101B,A01,091572,Staff,6,0,60,54
1650218913059,COGS 101C,A01,083625,Delgado; Tania,20,0,30,10
1650218919088,COGS 107A,A01,083627,Boyle; Mary E. T.,1,7,60,59
1650218925111,COGS 118A,A01,083075,Staff,16,0,60,44
1650218931135,CSE 3,A50,083646,Miranda; Gregory Joseph,22,0,38,16
1650218931135,CSE 3,A51,083647,Miranda; Gregory Joseph,37,0,37,0
1650218937164,CSE 8A,A50,083650,Miranda; Gregory Joseph,0,17,40,40
1650218943190,CSE 11,A01,083080,Cao; Yingjun,0,68,40,40
1650218949213,CSE 12,A01,083652,Staff,0,7,100,100
1650218955240,CSE 15L,A01,083654,Staff,0,0,50,50
1650218955240,CSE 15L,A02,083655,Staff,6,0,50,44
1650218961263,CSE 20,A01,083657,Staff,53,0,80,27
1650218967286,CSE 30,A01,083084,Eldon; John,0,70,40,40
1650218973310,CSE 100,A01,083659,Cao; Yingjun,0,63,50,50
1650218979337,CSE 134B,A01,083661,Powell; Thomas Allan,0,27,65,65
1650218985368,CSE 140,A01,083663,Staff,1,0,75,74
1650218991403,CSE 140L,A01,083088,Eldon; John,0,4,75,75
1650218997428,CSE 175,A01,083665,Kumar; Rakesh,8,0,25,17
1650219003458,CSE 190,A00,092507,Dubnov; Shlomo,14,0,20,6
1650219009485,ECE 45,A01,083139,Staff,0,13,40,40
1650219015507,ECE 65,A50,083695,Staff,0,5,30,30
1650219021529,ECE 109,A01,091882,Touri; Behrouz,47,0,70,23
1650219027553,ECE 180,A00,083140,Abi Samra; Nicholas Camill,24,0,30,6
1650219027553,ECE 180,B00,083141,Abi Samra; Nicholas Camill,8,0,30,22
1650219033575,MATH 10A,A01,083735,Patchell; Gregory David,11,0,30,19
1650219033575,MATH 10A,A02,083736,Patchell; Gregory David,28,0,30,2
1650219033575,MATH 10A,A03,083737,Patchell; Gregory David,26,0,30,4
1650219039601,MATH 10B,A01,083207,Staff,0,6,30,30
1650219039601,MATH 10B,A02,083208,Staff,0,5,30,30
1650219039601,MATH 10B,B01,083739,Staff,17,0,30,13
1650219039601,MATH 10B,B02,083740,Staff,29,0,30,1
1650219045625,MATH 18,A01,083743,Staff,8,0,30,22
1650219045625,MATH 18,A02,083744,Staff,28,0,30,2
1650219045625,MATH 18,A03,083745,Staff,23,0,30,7
1650219045625,MATH 18,A04,083746,Staff,27,0,30,3
1650219045625,MATH 18,B01,083748,Staff,0,10,30,30
1650219045625,MATH 18,B02,083749,Staff,0,7,30,30
1650219045625,MATH 18,B03,083750,Staff,0,7,30,30
1650219045625,MATH 18,B04,083751,Staff,0,8,30,30
1650219051651,MATH 20A,A01,083754,Staff,26,0,40,14
1650219057681,MATH 20B,A01,083756,Staff,0,6,30,30
1650219057681,MATH 20B,A02,083757,Staff,0,6,30,30
1650219063725,MATH 20C,A01,083760,Staff,0,12,30,30
1650219063725,MATH 20C,A02,083761,Staff,0,12,30,30
1650219063725,MATH 20C,B01,083762,Staff,14,0,30,16
1650219063725,MATH 20C,B02,083763,Staff,28,0,30,2
1650219069752,MATH 20D,A01,083765,Staff,1,2,30,29
1650219069752,MATH 20D,A02,083766,Staff,10,0,30,20
1650219069752,MATH 20D,A03,083767,Staff,28,0,30,2
1650219075782,MATH 20E,A01,083771,Staff,8,0,30,22
1650219075782,MATH 20E,A02,083772,Staff,20,0,30,10
1650219075782,MATH 20E,B01,083773,Staff,0,0,30,30
1650219075782,MATH 20E,B02,083774,Staff,12,0,30,18
1650219081811,MATH 103A,A01,083777,Staff,0,9,30,30
1650219081811,MATH 103A,A02,083778,Staff,0,10,30,30
1650219081811,MATH 103A,B01,083779,Staff,0,9,30,30
1650219081811,MATH 103A,B02,083780,Staff,0,9,30,30
1650219087839,MATH 105,A01,085443,Staff,0,17,30,30
1650219093868,MATH 109,A01,083213,Anzaldo; Leesa B,0,3,30,30
1650219093868,MATH 109,A02,083214,Anzaldo; Leesa B,0,6,30,30
1650219093868,MATH 109,B01,083215,Anzaldo; Leesa B,0,4,30,30
1650219093868,MATH 109,B02,083216,Anzaldo; Leesa B,0,4,30,30
1650219099894,MATH 142A,A01,083219,Chow; Bennett,0,12,30,30
1650219099894,MATH 142A,A02,083220,Chow; Bennett,0,11,30,30
1650219099894,MATH 142A,B01,083221,Chow; Bennett,0,11,30,30
1650219099894,MATH 142A,B02,083222,Chow; Bennett,0,12,30,30
1650219105919,MATH 193A,A01,083224,Staff,0,4,30,30
1650219105919,MATH 193A,A02,083225,Staff,0,4,30,30
1650219105919,MATH 193A,A03,083781,Staff,0,2,30,30
1650219105919,MATH 193A,A04,083782,Staff,0,1,30,30
1650219111954,MATH 197,001,091859,McAuley; Julian John,9998,0,9999,1
1650219118029,COGS 9,A01,083615,Staff,0,14,60,60
1650219124052,COGS 11,A01,083617,Boyle; Mary E. T.,24,0,40,16
1650219130075,COGS 13,A01,083071,Staff,0,30,40,40
1650219136098,COGS 14A,A01,092681,Staff,0,12,100,100
1650219142126,COGS 14B,A01,083073,Cheng; Tzu-Han,0,7,50,50
1650219148153,COGS 17,A01,092677,Staff,35,0,75,40
1650219154179,COGS 100,A01,083619,Staff,0,20,60,60
1650219160203,COGS 101A,A01,083621,Davis; Joshua Daniel,0,21,60,60
1650219166230,COGS 101B,A01,091572,Staff,6,0,60,54
1650219172258,COGS 101C,A01,083625,Delgado; Tania,20,0,30,10
1650219178285,COGS 107A,A01,083627,Boyle; Mary E. T.,1,7,60,59
1650219184311,COGS 118A,A01,083075,Staff,16,0,60,44
1650219190340,CSE 3,A50,083646,Miranda; Gregory Joseph,22,0,38,16
1650219190340,CSE 3,A51,083647,Miranda; Gregory Joseph,37,0,37,0
1650219196364,CSE 8A,A50,083650,Miranda; Gregory Joseph,0,17,40,40
1650219202387,CSE 11,A01,083080,Cao; Yingjun,0,68,40,40
1650219208414,CSE 12,A01,083652,Staff,0,7,100,100
1650219214441,CSE 15L,A01,083654,Staff,0,0,50,50
1650219214441,CSE 15L,A02,083655,Staff,6,0,50,44
1650219220473,CSE 20,A01,083657,Staff,53,0,80,27
1650219226499,CSE 30,A01,083084,Eldon; John,0,70,40,40
1650219232522,CSE 100,A01,083659,Cao; Yingjun,0,63,50,50
1650219238546,CSE 134B,A01,083661,Powell; Thomas Allan,0,27,65,65
1650219244571,CSE 140,A01,083663,Staff,1,0,75,74
1650219250593,CSE 140L,A01,083088,Eldon; John,0,4,75,75
1650219256618,CSE 175,A01,083665,Kumar; Rakesh,8,0,25,17
1650219262641,CSE 190,A00,092507,Dubnov; Shlomo,14,0,20,6
1650219268675,ECE 45,A01,083139,Staff,0,13,40,40
1650219274700,ECE 65,A50,083695,Staff,0,5,30,30
1650219280727,ECE 109,A01,091882,Touri; Behrouz,47,0,70,23
1650219286756,ECE 180,A00,083140,Abi Samra; Nicholas Camill,24,0,30,6
1650219286756,ECE 180,B00,083141,Abi Samra; Nicholas Camill,8,0,30,22
1650219292784,MATH 10A,A01,083735,Patchell; Gregory David,11,0,30,19
1650219292784,MATH 10A,A02,083736,Patchell; Gregory David,28,0,30,2
1650219292784,MATH 10A,A03,083737,Patchell; Gregory David,26,0,30,4
1650219298809,MATH 10B,A01,083207,Staff,0,6,30,30
1650219298809,MATH 10B,A02,083208,Staff,0,5,30,30
1650219298809,MATH 10B,B01,083739,Staff,17,0,30,13
1650219298809,MATH 10B,B02,083740,Staff,29,0,30,1
1650219304836,MATH 18,A01,083743,Staff,8,0,30,22
1650219304836,MATH 18,A02,083744,Staff,28,0,30,2
1650219304836,MATH 18,A03,083745,Staff,23,0,30,7
1650219304836,MATH 18,A04,083746,Staff,27,0,30,3
1650219304836,MATH 18,B01,083748,Staff,0,10,30,30
1650219304836,MATH 18,B02,083749,Staff,0,7,30,30
1650219304836,MATH 18,B03,083750,Staff,0,7,30,30
1650219304836,MATH 18,B04,083751,Staff,0,8,30,30
1650219310862,MATH 20A,A01,083754,Staff,26,0,40,14
1650219316884,MATH 20B,A01,083756,Staff,1,6,30,29
1650219316884,MATH 20B,A02,083757,Staff,0,6,30,30
1650219322915,MATH 20C,A01,083760,Staff,0,12,30,30
1650219322915,MATH 20C,A02,083761,Staff,0,12,30,30
1650219322915,MATH 20C,B01,083762,Staff,14,0,30,16
1650219322915,MATH 20C,B02,083763,Staff,28,0,30,2
1650219328946,MATH 20D,A01,083765,Staff,1,2,30,29
1650219328946,MATH 20D,A02,083766,Staff,10,0,30,20
1650219328946,MATH 20D,A03,083767,Staff,28,0,30,2
1650219334975,MATH 20E,A01,083771,Staff,8,0,30,22
1650219334975,MATH 20E,A02,083772,Staff,20,0,30,10
1650219334975,MATH 20E,B01,083773,Staff,0,0,30,30
1650219334975,MATH 20E,B02,083774,Staff,12,0,30,18
1650219340998,MATH 103A,A01,083777,Staff,0,9,30,30
1650219340998,MATH 103A,A02,083778,Staff,0,10,30,30
1650219340998,MATH 103A,B01,083779,Staff,0,9,30,30
1650219340998,MATH 103A,B02,083780,Staff,0,9,30,30
1650219347025,MATH 105,A01,085443,Staff,0,17,30,30
1650219353049,MATH 109,A01,083213,Anzaldo; Leesa B,0,3,30,30
1650219353049,MATH 109,A02,083214,Anzaldo; Leesa B,0,6,30,30
1650219353049,MATH 109,B01,083215,Anzaldo; Leesa B,0,4,30,30
1650219353049,MATH 109,B02,083216,Anzaldo; Leesa B,0,4,30,30
1650219359077,MATH 142A,A01,083219,Chow; Bennett,0,12,30,30
1650219359077,MATH 142A,A02,083220,Chow; Bennett,0,11,30,30
1650219359077,MATH 142A,B01,083221,Chow; Bennett,0,11,30,30
1650219359077,MATH 142A,B02,083222,Chow; Bennett,0,12,30,30
1650219365105,MATH 193A,A01,083224,Staff,0,4,30,30
1650219365105,MATH 193A,A02,083225,Staff,0,4,30,30
1650219365105,MATH 193A,A03,083781,Staff,0,2,30,30
1650219365105,MATH 193A,A04,083782,Staff,0,1,30,30
1650219371131,MATH 197,001,091859,McAuley; Julian John,9998,0,9999,1
1650219377192,COGS 9,A01,083615,Staff,0,14,60,60
1650219383220,COGS 11,A01,083617,Boyle; Mary E. T.,24,0,40,16
1650219389242,COGS 13,A01,083071,Staff,0,30,40,40
1650219395274,COGS 14A,A01,092681,Staff,0,12,100,100
1650219401302,COGS 14B,A01,083073,Cheng; Tzu-Han,0,7,50,50
1650219407327,COGS 17,A01,092677,Staff,35,0,75,40
1650219413351,COGS 100,A01,083619,Staff,0,20,60,60
1650219419379,COGS 101A,A01,083621,Davis; Joshua Daniel,0,21,60,60
1650219425406,COGS 101B,A01,091572,Staff,6,0,60,54
1650219431437,COGS 101C,A01,083625,Delgado; Tania,20,0,30,10
1650219437461,COGS 107A,A01,083627,Boyle; Mary E. T.,1,7,60,59
1650219443494,COGS 118A,A01,083075,Staff,16,0,60,44
1650219449518,CSE 3,A50,083646,Miranda; Gregory Joseph,22,0,38,16
1650219449518,CSE 3,A51,083647,Miranda; Gregory Joseph,37,0,37,0
1650219455552,CSE 8A,A50,083650,Miranda; Gregory Joseph,0,17,40,40
1650219461650,CSE 11,A01,083080,Cao; Yingjun,0,68,40,40
1650219467680,CSE 12,A01,083652,Staff,0,7,100,100
1650219473707,CSE 15L,A01,083654,Staff,0,0,50,50
1650219473707,CSE 15L,A02,083655,Staff,6,0,50,44
1650219479735,CSE 20,A01,083657,Staff,53,0,80,27
1650219485760,CSE 30,A01,083084,Eldon; John,0,70,40,40
1650219491786,CSE 100,A01,083659,Cao; Yingjun,0,63,50,50
1650219497810,CSE 134B,A01,083661,Powell; Thomas Allan,0,27,65,65
1650219503837,CSE 140,A01,083663,Staff,1,0,75,74
1650219509861,CSE 140L,A01,083088,Eldon; John,0,4,75,75
1650219515888,CSE 175,A01,083665,Kumar; Rakesh,8,0,25,17
1650219521911,CSE 190,A00,092507,Dubnov; Shlomo,14,0,20,6
1650219527943,ECE 45,A01,083139,Staff,0,13,40,40
1650219533967,ECE 65,A50,083695,Staff,0,5,30,30
1650219539991,ECE 109,A01,091882,Touri; Behrouz,47,0,70,23
1650219546014,ECE 180,A00,083140,Abi Samra; Nicholas Camill,24,0,30,6
1650219546014,ECE 180,B00,083141,Abi Samra; Nicholas Camill,8,0,30,22
1650219552037,MATH 10A,A01,083735,Patchell; Gregory David,11,0,30,19
1650219552037,MATH 10A,A02,083736,Patchell; Gregory David,28,0,30,2
1650219552037,MATH 10A,A03,083737,Patchell; Gregory David,26,0,30,4
1650219558064,MATH 10B,A01,083207,Staff,0,6,30,30
1650219558064,MATH 10B,A02,083208,Staff,0,5,30,30
1650219558064,MATH 10B,B01,083739,Staff,17,0,30,13
1650219558064,MATH 10B,B02,083740,Staff,29,0,30,1
1650219564090,MATH 18,A01,083743,Staff,8,0,30,22
1650219564090,MATH 18,A02,083744,Staff,28,0,30,2
1650219564090,MATH 18,A03,083745,Staff,23,0,30,7
1650219564090,MATH 18,A04,083746,Staff,27,0,30,3
1650219564090,MATH 18,B01,083748,Staff,0,10,30,30
1650219564090,MATH 18,B02,083749,Staff,0,7,30,30
1650219564090,MATH 18,B03,083750,Staff,0,7,30,30
1650219564090,MATH 18,B04,083751,Staff,0,8,30,30
1650219570114,MATH 20A,A01,083754,Staff,26,0,40,14
1650219576139,MATH 20B,A01,083756,Staff,1,6,30,29
1650219576139,MATH 20B,A02,083757,Staff,0,6,30,30
1650219582163,MATH 20C,A01,083760,Staff,0,12,30,30
1650219582163,MATH 20C,A02,083761,Staff,0,12,30,30
1650219582163,MATH 20C,B01,083762,Staff,14,0,30,16
1650219582163,MATH 20C,B02,083763,Staff,28,0,30,2
1650219588191,MATH 20D,A01,083765,Staff,1,2,30,29
1650219588191,MATH 20D,A02,083766,Staff,10,0,30,20
1650219588191,MATH 20D,A03,083767,Staff,28,0,30,2
1650219594217,MATH 20E,A01,083771,Staff,8,0,30,22
1650219594217,MATH 20E,A02,083772,Staff,20,0,30,10
1650219594217,MATH 20E,B01,083773,Staff,0,0,30,30
1650219594217,MATH 20E,B02,083774,Staff,12,0,30,18
1650219600248,MATH 103A,A01,083777,Staff,0,9,30,30
1650219600248,MATH 103A,A02,083778,Staff,0,10,30,30
1650219600248,MATH 103A,B01,083779,Staff,0,9,30,30
1650219600248,MATH 103A,B02,083780,Staff,0,9,30,30
1650219606270,MATH 105,A01,085443,Staff,0,17,30,30
1650219612306,MATH 109,A01,083213,Anzaldo; Leesa B,0,3,30,30
1650219612306,MATH 109,A02,083214,Anzaldo; Leesa B,0,6,30,30
1650219612306,MATH 109,B01,083215,Anzaldo; Leesa B,0,4,30,30
1650219612306,MATH 109,B02,083216,Anzaldo; Leesa B,0,4,30,30
1650219618335,MATH 142A,A01,083219,Chow; Bennett,0,12,30,30
1650219618335,MATH 142A,A02,083220,Chow; Bennett,0,11,30,30
1650219618335,MATH 142A,B01,083221,Chow; Bennett,0,11,30,30
1650219618335,MATH 142A,B02,083222,Chow; Bennett,0,12,30,30
1650219624359,MATH 193A,A01,083224,Staff,0,4,30,30
1650219624359,MATH 193A,A02,083225,Staff,0,4,30,30
1650219624359,MATH 193A,A03,083781,Staff,0,2,30,30
1650219624359,MATH 193A,A04,083782,Staff,0,1,30,30
1650219630384,MATH 197,001,091859,McAuley; Julian John,9998,0,9999,1
1650219636447,COGS 9,A01,083615,Staff,0,14,60,60
1650219642475,COGS 11,A01,083617,Boyle; Mary E. T.,24,0,40,16
1650219648501,COGS 13,A01,083071,Staff,0,30,40,40
1650219654527,COGS 14A,A01,092681,Staff,0,12,100,100
1650219660555,COGS 14B,A01,083073,Cheng; Tzu-Han,0,7,50,50
1650219666579,COGS 17,A01,092677,Staff,35,0,75,40
1650219672603,COGS 100,A01,083619,Staff,0,20,60,60
1650219678628,COGS 101A,A01,083621,Davis; Joshua Daniel,0,21,60,60
1650219684653,COGS 101B,A01,091572,Staff,6,0,60,54
1650219690676,COGS 101C,A01,083625,Delgado; Tania,20,0,30,10
1650219696700,COGS 107A,A01,083627,Boyle; Mary E. T.,1,7,60,59
1650219702722,COGS 118A,A01,083075,Staff,16,0,60,44
1650219708747,CSE 3,A50,083646,Miranda; Gregory Joseph,22,0,38,16
1650219708747,CSE 3,A51,083647,Miranda; Gregory Joseph,37,0,37,0
1650219714770,CSE 8A,A50,083650,Miranda; Gregory Joseph,0,17,40,40
1650219720793,CSE 11,A01,083080,Cao; Yingjun,0,68,40,40
1650219726820,CSE 12,A01,083652,Staff,0,7,100,100
1650219732846,CSE 15L,A01,083654,Staff,0,0,50,50
1650219732846,CSE 15L,A02,083655,Staff,6,0,50,44
1650219738868,CSE 20,A01,083657,Staff,53,0,80,27
1650219744893,CSE 30,A01,083084,Eldon; John,0,70,40,40
1650219750919,CSE 100,A01,083659,Cao; Yingjun,0,63,50,50
1650219756942,CSE 134B,A01,083661,Powell; Thomas Allan,0,27,65,65
1650219762967,CSE 140,A01,083663,Staff,1,0,75,74
1650219768992,CSE 140L,A01,083088,Eldon; John,0,4,75,75
1650219775014,CSE 175,A01,083665,Kumar; Rakesh,8,0,25,17
1650219781040,CSE 190,A00,092507,Dubnov; Shlomo,14,0,20,6
1650219787065,ECE 45,A01,083139,Staff,0,13,40,40
1650219793093,ECE 65,A50,083695,Staff,0,5,30,30
1650219799117,ECE 109,A01,091882,Touri; Behrouz,47,0,70,23
1650219805143,ECE 180,A00,083140,Abi Samra; Nicholas Camill,24,0,30,6
1650219805143,ECE 180,B00,083141,Abi Samra; Nicholas Camill,8,0,30,22
1650219811178,MATH 10A,A01,083735,Patchell; Gregory David,11,0,30,19
1650219811178,MATH 10A,A02,083736,Patchell; Gregory David,28,0,30,2
1650219811178,MATH 10A,A03,083737,Patchell; Gregory David,26,0,30,4
1650219817206,MATH 10B,A01,083207,Staff,0,6,30,30
1650219817206,MATH 10B,A02,083208,Staff,0,5,30,30
1650219817206,MATH 10B,B01,083739,Staff,17,0,30,13
1650219817206,MATH 10B,B02,083740,Staff,29,0,30,1
1650219823234,MATH 18,A01,083743,Staff,8,0,30,22
1650219823234,MATH 18,A02,083744,Staff,28,0,30,2
1650219823234,MATH 18,A03,083745,Staff,23,0,30,7
1650219823234,MATH 18,A04,083746,Staff,27,0,30,3
1650219823234,MATH 18,B01,083748,Staff,0,10,30,30
1650219823234,MATH 18,B02,083749,Staff,0,7,30,30
1650219823234,MATH 18,B03,083750,Staff,0,7,30,30
1650219823234,MATH 18,B04,083751,Staff,0,8,30,30
1650219829255,MATH 20A,A01,083754,Staff,26,0,40,14
1650219835279,MATH 20B,A01,083756,Staff,1,6,30,29
1650219835279,MATH 20B,A02,083757,Staff,0,6,30,30
1650219841307,MATH 20C,A01,083760,Staff,0,12,30,30
1650219841307,MATH 20C,A02,083761,Staff,0,12,30,30
1650219841307,MATH 20C,B01,083762,Staff,14,0,30,16
1650219841307,MATH 20C,B02,083763,Staff,28,0,30,2
1650219847335,MATH 20D,A01,083765,Staff,1,2,30,29
1650219847335,MATH 20D,A02,083766,Staff,10,0,30,20
1650219847335,MATH 20D,A03,083767,Staff,28,0,30,2
1650219853368,MATH 20E,A01,083771,Staff,8,0,30,22
1650219853368,MATH 20E,A02,083772,Staff,20,0,30,10
1650219853368,MATH 20E,B01,083773,Staff,0,0,30,30
1650219853368,MATH 20E,B02,083774,Staff,12,0,30,18
1650219859392,MATH 103A,A01,083777,Staff,0,9,30,30
1650219859392,MATH 103A,A02,083778,Staff,0,10,30,30
1650219859392,MATH 103A,B01,083779,Staff,0,9,30,30
1650219859392,MATH 103A,B02,083780,Staff,0,9,30,30
1650219865417,MATH 105,A01,085443,Staff,0,17,30,30
1650219871440,MATH 109,A01,083213,Anzaldo; Leesa B,0,3,30,30
1650219871440,MATH 109,A02,083214,Anzaldo; Leesa B,0,6,30,30
1650219871440,MATH 109,B01,083215,Anzaldo; Leesa B,0,4,30,30
1650219871440,MATH 109,B02,083216,Anzaldo; Leesa B,0,4,30,30
1650219877469,MATH 142A,A01,083219,Chow; Bennett,0,12,30,30
1650219877469,MATH 142A,A02,083220,Chow; Bennett,0,11,30,30
1650219877469,MATH 142A,B01,083221,Chow; Bennett,0,11,30,30
1650219877469,MATH 142A,B02,083222,Chow; Bennett,0,12,30,30
1650219883497,MATH 193A,A01,083224,Staff,0,4,30,30
1650219883497,MATH 193A,A02,083225,Staff,0,4,30,30
1650219883497,MATH 193A,A03,083781,Staff,0,2,30,30
1650219883497,MATH 193A,A04,083782,Staff,0,1,30,30
1650219889528,MATH 197,001,091859,McAuley; Julian John,9998,0,9999,1
1650219895594,COGS 9,A01,083615,Staff,0,14,60,60
1650219901619,COGS 11,A01,083617,Boyle; Mary E. T.,24,0,40,16
1650219907644,COGS 13,A01,083071,Staff,0,30,40,40
1650219913673,COGS 14A,A01,092681,Staff,0,12,100,100
1650219919697,COGS 14B,A01,083073,Cheng; Tzu-Han,0,7,50,50
1650219925721,COGS 17,A01,092677,Staff,35,0,75,40
1650219931747,COGS 100,A01,083619,Staff,0,20,60,60
1650219937771,COGS 101A,A01,083621,Davis; Joshua Daniel,0,21,60,60
1650219943797,COGS 101B,A01,091572,Staff,6,0,60,54
1650219949820,COGS 101C,A01,083625,Delgado; Tania,20,0,30,10
1650219955844,COGS 107A,A01,083627,Boyle; Mary E. T.,1,7,60,59
1650219961869,COGS 118A,A01,083075,Staff,16,0,60,44
1650219967906,CSE 3,A50,083646,Miranda; Gregory Joseph,22,0,38,16
1650219967906,CSE 3,A51,083647,Miranda; Gregory Joseph,37,0,37,0
1650219973929,CSE 8A,A50,083650,Miranda; Gregory Joseph,0,17,40,40
1650219979964,CSE 11,A01,083080,Cao; Yingjun,0,68,40,40
1650219985988,CSE 12,A01,083652,Staff,0,7,100,100
1650219992014,CSE 15L,A01,083654,Staff,0,0,50,50
1650219992014,CSE 15L,A02,083655,Staff,6,0,50,44
1650219998039,CSE 20,A01,083657,Staff,53,0,80,27
1650220004066,CSE 30,A01,083084,Eldon; John,0,70,40,40
1650220010094,CSE 100,A01,083659,Cao; Yingjun,0,63,50,50
1650220016121,CSE 134B,A01,083661,Powell; Thomas Allan,0,27,65,65
1650220022148,CSE 140,A01,083663,Staff,1,0,75,74
1650220028171,CSE 140L,A01,083088,Eldon; John,0,4,75,75
1650220034196,CSE 175,A01,083665,Kumar; Rakesh,8,0,25,17
1650220040223,CSE 190,A00,092507,Dubnov; Shlomo,14,0,20,6
1650220046247,ECE 45,A01,083139,Staff,0,13,40,40
1650220052274,ECE 65,A50,083695,Staff,0,5,30,30
1650220058391,ECE 109,A01,091882,Touri; Behrouz,47,0,70,23
1650220064418,ECE 180,A00,083140,Abi Samra; Nicholas Camill,24,0,30,6
1650220064418,ECE 180,B00,083141,Abi Samra; Nicholas Camill,8,0,30,22
1650220070442,MATH 10A,A01,083735,Patchell; Gregory David,11,0,30,19
1650220070442,MATH 10A,A02,083736,Patchell; Gregory David,28,0,30,2
1650220070442,MATH 10A,A03,083737,Patchell; Gregory David,26,0,30,4
1650220076467,MATH 10B,A01,083207,Staff,0,6,30,30
1650220076467,MATH 10B,A02,083208,Staff,0,5,30,30
1650220076467,MATH 10B,B01,083739,Staff,17,0,30,13
1650220076467,MATH 10B,B02,083740,Staff,29,0,30,1
1650220082498,MATH 18,A01,083743,Staff,8,0,30,22
1650220082498,MATH 18,A02,083744,Staff,28,0,30,2
1650220082498,MATH 18,A03,083745,Staff,23,0,30,7
1650220082498,MATH 18,A04,083746,Staff,27,0,30,3
1650220082498,MATH 18,B01,083748,Staff,0,10,30,30
1650220082498,MATH 18,B02,083749,Staff,0,7,30,30
1650220082498,MATH 18,B03,083750,Staff,0,7,30,30
1650220082498,MATH 18,B04,083751,Staff,0,8,30,30
1650220088532,MATH 20A,A01,083754,Staff,26,0,40,14
1650220094560,MATH 20B,A01,083756,Staff,1,6,30,29
1650220094560,MATH 20B,A02,083757,Staff,0,6,30,30
1650220100585,MATH 20C,A01,083760,Staff,0,12,30,30
1650220100585,MATH 20C,A02,083761,Staff,0,12,30,30
1650220100585,MATH 20C,B01,083762,Staff,14,0,30,16
1650220100585,MATH 20C,B02,083763,Staff,28,0,30,2
1650220106608,MATH 20D,A01,083765,Staff,1,2,30,29
1650220106608,MATH 20D,A02,083766,Staff,10,0,30,20
1650220106608,MATH 20D,A03,083767,Staff,28,0,30,2
1650220112637,MATH 20E,A01,083771,Staff,8,0,30,22
1650220112637,MATH 20E,A02,083772,Staff,20,0,30,10
1650220112637,MATH 20E,B01,083773,Staff,0,0,30,30
1650220112637,MATH 20E,B02,083774,Staff,12,0,30,18
1650220118668,MATH 103A,A01,083777,Staff,0,9,30,30
1650220118668,MATH 103A,A02,083778,Staff,0,10,30,30
1650220118668,MATH 103A,B01,083779,Staff,0,9,30,30
1650220118668,MATH 103A,B02,083780,Staff,0,9,30,30
1650220124690,MATH 105,A01,085443,Staff,0,17,30,30
1650220130713,MATH 109,A01,083213,Anzaldo; Leesa B,0,3,30,30
1650220130713,MATH 109,A02,083214,Anzaldo; Leesa B,0,6,30,30
1650220130713,MATH 109,B01,083215,Anzaldo; Leesa B,0,4,30,30
1650220130713,MATH 109,B02,083216,Anzaldo; Leesa B,0,4,30,30
1650220136740,MATH 142A,A01,083219,Chow; Bennett,0,12,30,30
1650220136740,MATH 142A,A02,083220,Chow; Bennett,0,11,30,30
1650220136740,MATH 142A,B01,083221,Chow; Bennett,0,11,30,30
1650220136740,MATH 142A,B02,083222,Chow; Bennett,0,12,30,30
1650220142767,MATH 193A,A01,083224,Staff,0,4,30,30
1650220142767,MATH 193A,A02,083225,Staff,0,4,30,30
1650220142767,MATH 193A,A03,083781,Staff,0,2,30,30
1650220142767,MATH 193A,A04,083782,Staff,0,1,30,30
1650220148790,MATH 197,001,091859,McAuley; Julian John,9998,0,9999,1
1650220154844,COGS 9,A01,083615,Staff,0,14,60,60
1650220160867,COGS 11,A01,083617,Boyle; Mary E. T.,24,0,40,16
1650220166891,COGS 13,A01,083071,Staff,0,30,40,40
1650220172914,COGS 14A,A01,092681,Staff,0,12,100,100
1650220178939,COGS 14B,A01,083073,Cheng; Tzu-Han,0,7,50,50
1650220184964,COGS 17,A01,092677,Staff,35,0,75,40
1650220190999,COGS 100,A01,083619,Staff,0,20,60,60
1650220197025,COGS 101A,A01,083621,Davis; Joshua Daniel,0,21,60,60
1650220203051,COGS 101B,A01,091572,Staff,6,0,60,54
1650220209081,COGS 101C,A01,083625,Delgado; Tania,20,0,30,10
1650220215108,COGS 107A,A01,083627,Boyle; Mary E. T.,1,7,60,59
1650220221135,COGS 118A,A01,083075,Staff,16,0,60,44
1650220227162,CSE 3,A50,083646,Miranda; Gregory Joseph,22,0,38,16
1650220227162,CSE 3,A51,083647,Miranda; Gregory Joseph,37,0,37,0
1650220233190,CSE 8A,A50,083650,Miranda; Gregory Joseph,0,17,40,40
1650220239212,CSE 11,A01,083080,Cao; Yingjun,0,68,40,40
1650220245246,CSE 12,A01,083652,Staff,0,7,100,100
1650220251271,CSE 15L,A01,083654,Staff,0,0,50,50
1650220251271,CSE 15L,A02,083655,Staff,6,0,50,44
1650220257295,CSE 20,A01,083657,Staff,53,0,80,27
1650220263324,CSE 30,A01,083084,Eldon; John,0,70,40,40
1650220269351,CSE 100,A01,083659,Cao; Yingjun,0,63,50,50
1650220275382,CSE 134B,A01,083661,Powell; Thomas Allan,0,27,65,65
1650220281416,CSE 140,A01,083663,Staff,1,0,75,74
1650220287445,CSE 140L,A01,083088,Eldon; John,0,4,75,75
1650220293468,CSE 175,A01,083665,Kumar; Rakesh,8,0,25,17
1650220299494,CSE 190,A00,092507,Dubnov; Shlomo,14,0,20,6
1650220305517,ECE 45,A01,083139,Staff,0,13,40,40
1650220311543,ECE 65,A50,083695,Staff,0,5,30,30
1650220317567,ECE 109,A01,091882,Touri; Behrouz,47,0,70,23
1650220323590,ECE 180,A00,083140,Abi Samra; Nicholas Camill,24,0,30,6
1650220323590,ECE 180,B00,083141,Abi Samra; Nicholas Camill,8,0,30,22
1650220329616,MATH 10A,A01,083735,Patchell; Gregory David,11,0,30,19
1650220329616,MATH 10A,A02,083736,Patchell; Gregory David,28,0,30,2
1650220329616,MATH 10A,A03,083737,Patchell; Gregory David,26,0,30,4
1650220335645,MATH 10B,A01,083207,Staff,0,6,30,30
1650220335645,MATH 10B,A02,083208,Staff,0,5,30,30
1650220335645,MATH 10B,B01,083739,Staff,17,0,30,13
1650220335645,MATH 10B,B02,083740,Staff,29,0,30,1
1650220341671,MATH 18,A01,083743,Staff,8,0,30,22
1650220341671,MATH 18,A02,083744,Staff,28,0,30,2
1650220341671,MATH 18,A03,083745,Staff,23,0,30,7
1650220341671,MATH 18,A04,083746,Staff,27,0,30,3
1650220341671,MATH 18,B01,083748,Staff,0,10,30,30
1650220341671,MATH 18,B02,083749,Staff,0,7,30,30
1650220341671,MATH 18,B03,083750,Staff,0,7,30,30
1650220341671,MATH 18,B04,083751,Staff,0,8,30,30
1650220347695,MATH 20A,A01,083754,Staff,26,0,40,14
1650220353722,MATH 20B,A01,083756,Staff,1,6,30,29
1650220353722,MATH 20B,A02,083757,Staff,0,6,30,30
1650220359750,MATH 20C,A01,083760,Staff,0,12,30,30
1650220359750,MATH 20C,A02,083761,Staff,0,12,30,30
1650220359750,MATH 20C,B01,083762,Staff,14,0,30,16
1650220359750,MATH 20C,B02,083763,Staff,28,0,30,2
1650220365776,MATH 20D,A01,083765,Staff,1,2,30,29
1650220365776,MATH 20D,A02,083766,Staff,10,0,30,20
1650220365776,MATH 20D,A03,083767,Staff,28,0,30,2
1650220371799,MATH 20E,A01,083771,Staff,8,0,30,22
1650220371799,MATH 20E,A02,083772,Staff,20,0,30,10
1650220371799,MATH 20E,B01,083773,Staff,0,0,30,30
1650220371799,MATH 20E,B02,083774,Staff,12,0,30,18
1650220377823,MATH 103A,A01,083777,Staff,0,9,30,30
1650220377823,MATH 103A,A02,083778,Staff,0,10,30,30
1650220377823,MATH 103A,B01,083779,Staff,0,9,30,30
1650220377823,MATH 103A,B02,083780,Staff,0,9,30,30
1650220383848,MATH 105,A01,085443,Staff,0,17,30,30
1650220389871,MATH 109,A01,083213,Anzaldo; Leesa B,0,3,30,30
1650220389871,MATH 109,A02,083214,Anzaldo; Leesa B,0,6,30,30
1650220389871,MATH 109,B01,083215,Anzaldo; Leesa B,0,4,30,30
1650220389871,MATH 109,B02,083216,Anzaldo; Leesa B,0,4,30,30
1650220395895,MATH 142A,A01,083219,Chow; Bennett,0,12,30,30
1650220395895,MATH 142A,A02,083220,Chow; Bennett,0,11,30,30
1650220395895,MATH 142A,B01,083221,Chow; Bennett,0,11,30,30
1650220395895,MATH 142A,B02,083222,Chow; Bennett,0,12,30,30
1650220401922,MATH 193A,A01,083224,Staff,0,4,30,30
1650220401922,MATH 193A,A02,083225,Staff,0,4,30,30
1650220401922,MATH 193A,A03,083781,Staff,0,2,30,30
1650220401922,MATH 193A,A04,083782,Staff,0,1,30,30
1650220407945,MATH 197,001,091859,McAuley; Julian John,9998,0,9999,1
1650220414004,COGS 9,A01,083615,Staff,0,14,60,60
1650220420033,COGS 11,A01,083617,Boyle; Mary E. T.,24,0,40,16
1650220426061,COGS 13,A01,083071,Staff,0,30,40,40
1650220432088,COGS 14A,A01,092681,Staff,0,12,100,100
1650220438112,COGS 14B,A01,083073,Cheng; Tzu-Han,0,7,50,50
1650220444139,COGS 17,A01,092677,Staff,35,0,75,40
1650220450163,COGS 100,A01,083619,Staff,0,20,60,60
1650220456188,COGS 101A,A01,083621,Davis; Joshua Daniel,0,21,60,60
1650220462212,COGS 101B,A01,091572,Staff,6,0,60,54
1650220468244,COGS 101C,A01,083625,Delgado; Tania,20,0,30,10
1650220474268,COGS 107A,A01,083627,Boyle; Mary E. T.,1,7,60,59
1650220480294,COGS 118A,A01,083075,Staff,16,0,60,44
1650220486319,CSE 3,A50,083646,Miranda; Gregory Joseph,22,0,38,16
1650220486319,CSE 3,A51,083647,Miranda; Gregory Joseph,37,0,37,0
1650220492344,CSE 8A,A50,083650,Miranda; Gregory Joseph,0,17,40,40
1650220498370,CSE 11,A01,083080,Cao; Yingjun,0,68,40,40
1650220504406,CSE 12,A01,083652,Staff,0,7,100,100
1650220510430,CSE 15L,A01,083654,Staff,0,0,50,50
1650220510430,CSE 15L,A02,083655,Staff,6,0,50,44
1650220516459,CSE 20,A01,083657,Staff,53,0,80,27
1650220522486,CSE 30,A01,083084,Eldon; John,0,70,40,40
1650220528510,CSE 100,A01,083659,Cao; Yingjun,0,63,50,50
1650220534538,CSE 134B,A01,083661,Powell; Thomas Allan,0,27,65,65
1650220540560,CSE 140,A01,083663,Staff,1,0,75,74
1650220546586,CSE 140L,A01,083088,Eldon; John,0,4,75,75
1650220552612,CSE 175,A01,083665,Kumar; Rakesh,8,0,25,17
1650220558635,CSE 190,A00,092507,Dubnov; Shlomo,14,0,20,6
1650220564660,ECE 45,A01,083139,Staff,0,13,40,40
1650220570687,ECE 65,A50,083695,Staff,0,5,30,30
1650220576714,ECE 109,A01,091882,Touri; Behrouz,47,0,70,23
1650220582741,ECE 180,A00,083140,Abi Samra; Nicholas Camill,24,0,30,6
1650220582741,ECE 180,B00,083141,Abi Samra; Nicholas Camill,8,0,30,22
1650220588765,MATH 10A,A01,083735,Patchell; Gregory David,11,0,30,19
1650220588765,MATH 10A,A02,083736,Patchell; Gregory David,28,0,30,2
1650220588765,MATH 10A,A03,083737,Patchell; Gregory David,26,0,30,4
1650220594797,MATH 10B,A01,083207,Staff,0,6,30,30
1650220594797,MATH 10B,A02,083208,Staff,0,5,30,30
1650220594797,MATH 10B,B01,083739,Staff,17,0,30,13
1650220594797,MATH 10B,B02,083740,Staff,29,0,30,1
1650220600825,MATH 18,A01,083743,Staff,8,0,30,22
1650220600825,MATH 18,A02,083744,Staff,28,0,30,2
1650220600825,MATH 18,A03,083745,Staff,23,0,30,7
1650220600825,MATH 18,A04,083746,Staff,27,0,30,3
1650220600825,MATH 18,B01,083748,Staff,0,10,30,30
1650220600825,MATH 18,B02,083749,Staff,0,7,30,30
1650220600825,MATH 18,B03,083750,Staff,0,7,30,30
1650220600825,MATH 18,B04,083751,Staff,0,8,30,30
1650220606849,MATH 20A,A01,083754,Staff,26,0,40,14
1650220612871,MATH 20B,A01,083756,Staff,1,6,30,29
1650220612871,MATH 20B,A02,083757,Staff,0,6,30,30
1650220618893,MATH 20C,A01,083760,Staff,0,12,30,30
1650220618893,MATH 20C,A02,083761,Staff,0,12,30,30
1650220618893,MATH 20C,B01,083762,Staff,14,0,30,16
1650220618893,MATH 20C,B02,083763,Staff,28,0,30,2
1650220624921,MATH 20D,A01,083765,Staff,1,2,30,29
1650220624921,MATH 20D,A02,083766,Staff,10,0,30,20
1650220624921,MATH 20D,A03,083767,Staff,28,0,30,2
1650220630946,MATH 20E,A01,083771,Staff,8,0,30,22
1650220630946,MATH 20E,A02,083772,Staff,20,0,30,10
1650220630946,MATH 20E,B01,083773,Staff,0,0,30,30
1650220630946,MATH 20E,B02,083774,Staff,12,0,30,18
1650220636970,MATH 103A,A01,083777,Staff,0,9,30,30
1650220636970,MATH 103A,A02,083778,Staff,0,10,30,30
1650220636970,MATH 103A,B01,083779,Staff,0,9,30,30
1650220636970,MATH 103A,B02,083780,Staff,0,9,30,30
1650220642995,MATH 105,A01,085443,Staff,0,17,30,30
1650220649017,MATH 109,A01,083213,Anzaldo; Leesa B,0,3,30,30
1650220649017,MATH 109,A02,083214,Anzaldo; Leesa B,0,6,30,30
1650220649017,MATH 109,B01,083215,Anzaldo; Leesa B,0,4,30,30
1650220649017,MATH 109,B02,083216,Anzaldo; Leesa B,0,4,30,30
1650220655135,MATH 142A,A01,083219,Chow; Bennett,0,12,30,30
1650220655135,MATH 142A,A02,083220,Chow; Bennett,0,11,30,30
1650220655135,MATH 142A,B01,083221,Chow; Bennett,0,11,30,30
1650220655135,MATH 142A,B02,083222,Chow; Bennett,0,12,30,30
1650220661159,MATH 193A,A01,083224,Staff,0,4,30,30
1650220661159,MATH 193A,A02,083225,Staff,0,4,30,30
1650220661159,MATH 193A,A03,083781,Staff,0,2,30,30
1650220661159,MATH 193A,A04,083782,Staff,0,1,30,30
1650220667184,MATH 197,001,091859,McAuley; Julian John,9998,0,9999,1
1650220673236,COGS 9,A01,083615,Staff,0,14,60,60
1650220679260,COGS 11,A01,083617,Boyle; Mary E. T.,24,0,40,16
1650220685287,COGS 13,A01,083071,Staff,0,30,40,40
1650220691313,COGS 14A,A01,092681,Staff,0,12,100,100
1650220697337,COGS 14B,A01,083073,Cheng; Tzu-Han,0,7,50,50
1650220703364,COGS 17,A01,092677,Staff,35,0,75,40
1650220709389,COGS 100,A01,083619,Staff,0,20,60,60
1650220715413,COGS 101A,A01,083621,Davis; Joshua Daniel,0,21,60,60
1650220721437,COGS 101B,A01,091572,Staff,6,0,60,54
1650220727459,COGS 101C,A01,083625,Delgado; Tania,20,0,30,10
1650220733486,COGS 107A,A01,083627,Boyle; Mary E. T.,1,7,60,59
1650220739513,COGS 118A,A01,083075,Staff,16,0,60,44
1650220745562,CSE 3,A50,083646,Miranda; Gregory Joseph,22,0,38,16
1650220745562,CSE 3,A51,083647,Miranda; Gregory Joseph,37,0,37,0
1650220751586,CSE 8A,A50,083650,Miranda; Gregory Joseph,0,17,40,40
1650220757609,CSE 11,A01,083080,Cao; Yingjun,0,68,40,40
1650220763638,CSE 12,A01,083652,Staff,0,8,100,100
1650220769670,CSE 15L,A01,083654,Staff,0,1,50,50
1650220769670,CSE 15L,A02,083655,Staff,6,0,50,44
1650220775694,CSE 20,A01,083657,Staff,53,0,80,27
1650220781717,CSE 30,A01,083084,Eldon; John,0,70,40,40
1650220787748,CSE 100,A01,083659,Cao; Yingjun,0,63,50,50
1650220793775,CSE 134B,A01,083661,Powell; Thomas Allan,0,27,65,65
1650220799802,CSE 140,A01,083663,Staff,1,0,75,74
1650220805828,CSE 140L,A01,083088,Eldon; John,0,4,75,75
1650220811863,CSE 175,A01,083665,Kumar; Rakesh,8,0,25,17
1650220817890,CSE 190,A00,092507,Dubnov; Shlomo,14,0,20,6
1650220823916,ECE 45,A01,083139,Staff,0,13,40,40
1650220829943,ECE 65,A50,083695,Staff,0,5,30,30
1650220835971,ECE 109,A01,091882,Touri; Behrouz,47,0,70,23
1650220841995,ECE 180,A00,083140,Abi Samra; Nicholas Camill,24,0,30,6
1650220841995,ECE 180,B00,083141,Abi Samra; Nicholas Camill,8,0,30,22
1650220848019,MATH 10A,A01,083735,Patchell; Gregory David,11,0,30,19
1650220848019,MATH 10A,A02,083736,Patchell; Gregory David,28,0,30,2
1650220848019,MATH 10A,A03,083737,Patchell; Gregory David,26,0,30,4
1650220854042,MATH 10B,A01,083207,Staff,0,6,30,30
1650220854042,MATH 10B,A02,083208,Staff,0,5,30,30
1650220854042,MATH 10B,B01,083739,Staff,17,0,30,13
1650220854042,MATH 10B,B02,083740,Staff,29,0,30,1
1650220860071,MATH 18,A01,083743,Staff,8,0,30,22
1650220860071,MATH 18,A02,083744,Staff,28,0,30,2
1650220860071,MATH 18,A03,083745,Staff,23,0,30,7
1650220860071,MATH 18,A04,083746,Staff,27,0,30,3
1650220860071,MATH 18,B01,083748,Staff,0,10,30,30
1650220860071,MATH 18,B02,083749,Staff,0,7,30,30
1650220860071,MATH 18,B03,083750,Staff,0,7,30,30
1650220860071,MATH 18,B04,083751,Staff,0,8,30,30
1650220866094,MATH 20A,A01,083754,Staff,26,0,40,14
1650220872117,MATH 20B,A01,083756,Staff,1,6,30,29
1650220872117,MATH 20B,A02,083757,Staff,0,6,30,30
1650220878140,MATH 20C,A01,083760,Staff,0,12,30,30
1650220878140,MATH 20C,A02,083761,Staff,0,12,30,30
1650220878140,MATH 20C,B01,083762,Staff,14,0,30,16
1650220878140,MATH 20C,B02,083763,Staff,28,0,30,2
1650220884181,MATH 20D,A01,083765,Staff,1,2,30,29
1650220884181,MATH 20D,A02,083766,Staff,10,0,30,20
1650220884181,MATH 20D,A03,083767,Staff,28,0,30,2
1650220890204,MATH 20E,A01,083771,Staff,8,0,30,22
1650220890204,MATH 20E,A02,083772,Staff,20,0,30,10
1650220890204,MATH 20E,B01,083773,Staff,0,0,30,30
1650220890204,MATH 20E,B02,083774,Staff,12,0,30,18
1650220896226,MATH 103A,A01,083777,Staff,0,9,30,30
1650220896226,MATH 103A,A02,083778,Staff,0,10,30,30
1650220896226,MATH 103A,B01,083779,Staff,0,9,30,30
1650220896226,MATH 103A,B02,083780,Staff,0,9,30,30
1650220902248,MATH 105,A01,085443,Staff,0,17,30,30
1650220908276,MATH 109,A01,083213,Anzaldo; Leesa B,0,3,30,30
1650220908276,MATH 109,A02,083214,Anzaldo; Leesa B,0,6,30,30
1650220908276,MATH 109,B01,083215,Anzaldo; Leesa B,0,4,30,30
1650220908276,MATH 109,B02,083216,Anzaldo; Leesa B,0,4,30,30
1650220914299,MATH 142A,A01,083219,Chow; Bennett,0,12,30,30
1650220914299,MATH 142A,A02,083220,Chow; Bennett,0,11,30,30
1650220914299,MATH 142A,B01,083221,Chow; Bennett,0,11,30,30
1650220914299,MATH 142A,B02,083222,Chow; Bennett,0,12,30,30
1650220920322,MATH 193A,A01,083224,Staff,0,4,30,30
1650220920322,MATH 193A,A02,083225,Staff,0,4,30,30
1650220920322,MATH 193A,A03,083781,Staff,0,2,30,30
1650220920322,MATH 193A,A04,083782,Staff,0,1,30,30
1650220926346,MATH 197,001,091859,McAuley; Julian John,9998,0,9999,1
1650220932397,COGS 9,A01,083615,Staff,0,14,60,60
1650220938419,COGS 11,A01,083617,Boyle; Mary E. T.,24,0,40,16
1650220944444,COGS 13,A01,083071,Staff,0,30,40,40
1650220950468,COGS 14A,A01,092681,Staff,0,12,100,100
1650220956491,COGS 14B,A01,083073,Cheng; Tzu-Han,0,7,50,50
1650220962518,COGS 17,A01,092677,Staff,35,0,75,40
1650220968547,COGS 100,A01,083619,Staff,0,20,60,60
1650220974572,COGS 101A,A01,083621,Davis; Joshua Daniel,0,21,60,60
1650220980598,COGS 101B,A01,091572,Staff,6,0,60,54
1650220986619,COGS 101C,A01,083625,Delgado; Tania,20,0,30,10
1650220992641,COGS 107A,A01,083627,Boyle; Mary E. T.,1,7,60,59
1650220998664,COGS 118A,A01,083075,Staff,16,0,60,44
1650221004685,CSE 3,A50,083646,Miranda; Gregory Joseph,22,0,38,16
1650221004685,CSE 3,A51,083647,Miranda; Gregory Joseph,37,0,37,0
1650221010707,CSE 8A,A50,083650,Miranda; Gregory Joseph,0,17,40,40
1650221016730,CSE 11,A01,083080,Cao; Yingjun,0,68,40,40
1650221022762,CSE 12,A01,083652,Staff,0,8,100,100
1650221028783,CSE 15L,A01,083654,Staff,0,1,50,50
1650221028783,CSE 15L,A02,083655,Staff,6,0,50,44
1650221034806,CSE 20,A01,083657,Staff,53,0,80,27
1650221040832,CSE 30,A01,083084,Eldon; John,0,70,40,40
1650221046858,CSE 100,A01,083659,Cao; Yingjun,0,63,50,50
1650221052881,CSE 134B,A01,083661,Powell; Thomas Allan,0,27,65,65
1650221058908,CSE 140,A01,083663,Staff,1,0,75,74
1650221064933,CSE 140L,A01,083088,Eldon; John,0,4,75,75
1650221070956,CSE 175,A01,083665,Kumar; Rakesh,8,0,25,17
1650221076982,CSE 190,A00,092507,Dubnov; Shlomo,14,0,20,6
1650221083006,ECE 45,A01,083139,Staff,0,13,40,40
1650221089033,ECE 65,A50,083695,Staff,0,5,30,30
1650221095056,ECE 109,A01,091882,Touri; Behrouz,47,0,70,23
1650221101083,ECE 180,A00,083140,Abi Samra; Nicholas Camill,24,0,30,6
1650221101083,ECE 180,B00,083141,Abi Samra; Nicholas Camill,8,0,30,22
1650221107112,MATH 10A,A01,083735,Patchell; Gregory David,11,0,30,19
1650221107112,MATH 10A,A02,083736,Patchell; Gregory David,28,0,30,2
1650221107112,MATH 10A,A03,083737,Patchell; Gregory David,26,0,30,4
1650221113136,MATH 10B,A01,083207,Staff,0,6,30,30
1650221113136,MATH 10B,A02,083208,Staff,0,5,30,30
1650221113136,MATH 10B,B01,083739,Staff,17,0,30,13
1650221113136,MATH 10B,B02,083740,Staff,29,0,30,1
1650221119168,MATH 18,A01,083743,Staff,8,0,30,22
1650221119168,MATH 18,A02,083744,Staff,28,0,30,2
1650221119168,MATH 18,A03,083745,Staff,23,0,30,7
1650221119168,MATH 18,A04,083746,Staff,27,0,30,3
1650221119168,MATH 18,B01,083748,Staff,0,10,30,30
1650221119168,MATH 18,B02,083749,Staff,0,7,30,30
1650221119168,MATH 18,B03,083750,Staff,0,7,30,30
1650221119168,MATH 18,B04,083751,Staff,0,8,30,30
1650221125192,MATH 20A,A01,083754,Staff,26,0,40,14
1650221131214,MATH 20B,A01,083756,Staff,1,6,30,29
1650221131214,MATH 20B,A02,083757,Staff,0,6,30,30
1650221137240,MATH 20C,A01,083760,Staff,0,12,30,30
1650221137240,MATH 20C,A02,083761,Staff,0,12,30,30
1650221137240,MATH 20C,B01,083762,Staff,14,0,30,16
1650221137240,MATH 20C,B02,083763,Staff,28,0,30,2
1650221143266,MATH 20D,A01,083765,Staff,1,2,30,29
1650221143266,MATH 20D,A02,083766,Staff,10,0,30,20
1650221143266,MATH 20D,A03,083767,Staff,28,0,30,2
1650221149289,MATH 20E,A01,083771,Staff,8,0,30,22
1650221149289,MATH 20E,A02,083772,Staff,20,0,30,10
1650221149289,MATH 20E,B01,083773,Staff,0,0,30,30
1650221149289,MATH 20E,B02,083774,Staff,12,0,30,18
1650221155321,MATH 103A,A01,083777,Staff,0,9,30,30
1650221155321,MATH 103A,A02,083778,Staff,0,10,30,30
1650221155321,MATH 103A,B01,083779,Staff,0,9,30,30
1650221155321,MATH 103A,B02,083780,Staff,0,9,30,30
1650221161344,MATH 105,A01,085443,Staff,0,17,30,30
1650221167370,MATH 109,A01,083213,Anzaldo; Leesa B,0,3,30,30
1650221167370,MATH 109,A02,083214,Anzaldo; Leesa B,0,6,30,30
1650221167370,MATH 109,B01,083215,Anzaldo; Leesa B,0,4,30,30
1650221167370,MATH 109,B02,083216,Anzaldo; Leesa B,0,4,30,30
1650221173398,MATH 142A,A01,083219,Chow; Bennett,0,12,30,30
1650221173398,MATH 142A,A02,083220,Chow; Bennett,0,11,30,30
1650221173398,MATH 142A,B01,083221,Chow; Bennett,0,11,30,30
1650221173398,MATH 142A,B02,083222,Chow; Bennett,0,12,30,30
1650221179426,MATH 193A,A01,083224,Staff,0,4,30,30
1650221179426,MATH 193A,A02,083225,Staff,0,4,30,30
1650221179426,MATH 193A,A03,083781,Staff,0,2,30,30
1650221179426,MATH 193A,A04,083782,Staff,0,1,30,30
1650221185453,MATH 197,001,091859,McAuley; Julian John,9998,0,9999,1
1650221191511,COGS 9,A01,083615,Staff,0,14,60,60
1650221197553,COGS 11,A01,083617,Boyle; Mary E. T.,24,0,40,16
1650221203575,COGS 13,A01,083071,Staff,0,30,40,40
1650221209602,COGS 14A,A01,092681,Staff,0,12,100,100
1650221215628,COGS 14B,A01,083073,Cheng; Tzu-Han,0,7,50,50
1650221221650,COGS 17,A01,092677,Staff,35,0,75,40
1650221227673,COGS 100,A01,083619,Staff,0,20,60,60
1650221233695,COGS 101A,A01,083621,Davis; Joshua Daniel,0,21,60,60
1650221239720,COGS 101B,A01,091572,Staff,6,0,60,54
1650221245833,COGS 101C,A01,083625,Delgado; Tania,20,0,30,10
1650221251862,COGS 107A,A01,083627,Boyle; Mary E. T.,1,7,60,59
1650221257884,COGS 118A,A01,083075,Staff,16,0,60,44
1650221263907,CSE 3,A50,083646,Miranda; Gregory Joseph,22,0,38,16
1650221263907,CSE 3,A51,083647,Miranda; Gregory Joseph,37,0,37,0
1650221269933,CSE 8A,A50,083650,Miranda; Gregory Joseph,0,17,40,40
1650221275956,CSE 11,A01,083080,Cao; Yingjun,0,68,40,40
1650221281979,CSE 12,A01,083652,Staff,0,8,100,100
1650221288003,CSE 15L,A01,083654,Staff,0,1,50,50
1650221288003,CSE 15L,A02,083655,Staff,6,0,50,44
1650221294027,CSE 20,A01,083657,Staff,53,0,80,27
1650221300051,CSE 30,A01,083084,Eldon; John,0,70,40,40
1650221306073,CSE 100,A01,083659,Cao; Yingjun,0,63,50,50
1650221312101,CSE 134B,A01,083661,Powell; Thomas Allan,0,27,65,65
1650221318127,CSE 140,A01,083663,Staff,1,0,75,74
1650221324151,CSE 140L,A01,083088,Eldon; John,0,4,75,75
1650221330173,CSE 175,A01,083665,Kumar; Rakesh,8,0,25,17
1650221336200,CSE 190,A00,092507,Dubnov; Shlomo,14,0,20,6
1650221342232,ECE 45,A01,083139,Staff,0,13,40,40
1650221348254,ECE 65,A50,083695,Staff,0,5,30,30
1650221354278,ECE 109,A01,091882,Touri; Behrouz,47,0,70,23
1650221360306,ECE 180,A00,083140,Abi Samra; Nicholas Camill,24,0,30,6
1650221360306,ECE 180,B00,083141,Abi Samra; Nicholas Camill,8,0,30,22
1650221366334,MATH 10A,A01,083735,Patchell; Gregory David,11,0,30,19
1650221366334,MATH 10A,A02,083736,Patchell; Gregory David,28,0,30,2
1650221366334,MATH 10A,A03,083737,Patchell; Gregory David,26,0,30,4
1650221372357,MATH 10B,A01,083207,Staff,0,6,30,30
1650221372357,MATH 10B,A02,083208,Staff,0,5,30,30
1650221372357,MATH 10B,B01,083739,Staff,17,0,30,13
1650221372357,MATH 10B,B02,083740,Staff,29,0,30,1
1650221378391,MATH 18,A01,083743,Staff,8,0,30,22
1650221378391,MATH 18,A02,083744,Staff,28,0,30,2
1650221378391,MATH 18,A03,083745,Staff,23,0,30,7
1650221378391,MATH 18,A04,083746,Staff,27,0,30,3
1650221378391,MATH 18,B01,083748,Staff,0,10,30,30
1650221378391,MATH 18,B02,083749,Staff,0,7,30,30
1650221378391,MATH 18,B03,083750,Staff,0,7,30,30
1650221378391,MATH 18,B04,083751,Staff,0,8,30,30
1650221384413,MATH 20A,A01,083754,Staff,26,0,40,14
1650221390435,MATH 20B,A01,083756,Staff,1,6,30,29
1650221390435,MATH 20B,A02,083757,Staff,0,6,30,30
1650221396463,MATH 20C,A01,083760,Staff,0,12,30,30
1650221396463,MATH 20C,A02,083761,Staff,0,12,30,30
1650221396463,MATH 20C,B01,083762,Staff,14,0,30,16
1650221396463,MATH 20C,B02,083763,Staff,28,0,30,2
1650221402491,MATH 20D,A01,083765,Staff,1,2,30,29
1650221402491,MATH 20D,A02,083766,Staff,10,0,30,20
1650221402491,MATH 20D,A03,083767,Staff,28,0,30,2
1650221408517,MATH 20E,A01,083771,Staff,8,0,30,22
1650221408517,MATH 20E,A02,083772,Staff,20,0,30,10
1650221408517,MATH 20E,B01,083773,Staff,0,0,30,30
1650221408517,MATH 20E,B02,083774,Staff,12,0,30,18
1650221414548,MATH 103A,A01,083777,Staff,0,9,30,30
1650221414548,MATH 103A,A02,083778,Staff,0,10,30,30
1650221414548,MATH 103A,B01,083779,Staff,0,9,30,30
1650221414548,MATH 103A,B02,083780,Staff,0,9,30,30
1650221420579,MATH 105,A01,085443,Staff,0,17,30,30
1650221426603,MATH 109,A01,083213,Anzaldo; Leesa B,0,3,30,30
1650221426603,MATH 109,A02,083214,Anzaldo; Leesa B,0,6,30,30
1650221426603,MATH 109,B01,083215,Anzaldo; Leesa B,0,4,30,30
1650221426603,MATH 109,B02,083216,Anzaldo; Leesa B,0,4,30,30
1650221432626,MATH 142A,A01,083219,Chow; Bennett,0,12,30,30
1650221432626,MATH 142A,A02,083220,Chow; Bennett,0,11,30,30
1650221432626,MATH 142A,B01,083221,Chow; Bennett,0,11,30,30
1650221432626,MATH 142A,B02,083222,Chow; Bennett,0,12,30,30
1650221438658,MATH 193A,A01,083224,Staff,0,4,30,30
1650221438658,MATH 193A,A02,083225,Staff,0,4,30,30
1650221438658,MATH 193A,A03,083781,Staff,0,2,30,30
1650221438658,MATH 193A,A04,083782,Staff,0,1,30,30
1650221444678,MATH 197,001,091859,McAuley; Julian John,9998,0,9999,1
1650221450736,COGS 9,A01,083615,Staff,0,14,60,60
1650221456760,COGS 11,A01,083617,Boyle; Mary E. T.,24,0,40,16
1650221462784,COGS 13,A01,083071,Staff,0,30,40,40
1650221468809,COGS 14A,A01,092681,Staff,0,12,100,100
1650221474841,COGS 14B,A01,083073,Cheng; Tzu-Han,0,7,50,50
1650221480865,COGS 17,A01,092677,Staff,35,0,75,40
1650221486888,COGS 100,A01,083619,Staff,0,20,60,60
1650221492914,COGS 101A,A01,083621,Davis; Joshua Daniel,0,21,60,60
1650221498938,COGS 101B,A01,091572,Staff,6,0,60,54
1650221504963,COGS 101C,A01,083625,Delgado; Tania,20,0,30,10
1650221510991,COGS 107A,A01,083627,Boyle; Mary E. T.,1,7,60,59
1650221517018,COGS 118A,A01,083075,Staff,16,0,60,44
1650221523048,CSE 3,A50,083646,Miranda; Gregory Joseph,22,0,38,16
1650221523048,CSE 3,A51,083647,Miranda; Gregory Joseph,37,0,37,0
1650221529077,CSE 8A,A50,083650,Miranda; Gregory Joseph,0,17,40,40
1650221535103,CSE 11,A01,083080,Cao; Yingjun,0,68,40,40
1650221541129,CSE 12,A01,083652,Staff,0,8,100,100
1650221547152,CSE 15L,A01,083654,Staff,0,1,50,50
1650221547152,CSE 15L,A02,083655,Staff,6,0,50,44
1650221553179,CSE 20,A01,083657,Staff,53,0,80,27
1650221559205,CSE 30,A01,083084,Eldon; John,0,70,40,40
1650221565228,CSE 100,A01,083659,Cao; Yingjun,0,63,50,50
1650221571252,CSE 134B,A01,083661,Powell; Thomas Allan,0,27,65,65
1650221577285,CSE 140,A01,083663,Staff,1,0,75,74
1650221583307,CSE 140L,A01,083088,Eldon; John,0,4,75,75
1650221589328,CSE 175,A01,083665,Kumar; Rakesh,8,0,25,17
1650221595354,CSE 190,A00,092507,Dubnov; Shlomo,14,0,20,6
1650221601377,ECE 45,A01,083139,Staff,0,13,40,40
1650221607401,ECE 65,A50,083695,Staff,0,5,30,30
1650221613423,ECE 109,A01,091882,Touri; Behrouz,47,0,70,23
1650221619450,ECE 180,A00,083140,Abi Samra; Nicholas Camill,24,0,30,6
1650221619450,ECE 180,B00,083141,Abi Samra; Nicholas Camill,8,0,30,22
1650221625481,MATH 10A,A01,083735,Patchell; Gregory David,11,0,30,19
1650221625481,MATH 10A,A02,083736,Patchell; Gregory David,28,0,30,2
1650221625481,MATH 10A,A03,083737,Patchell; Gregory David,26,0,30,4
1650221631505,MATH 10B,A01,083207,Staff,0,6,30,30
1650221631505,MATH 10B,A02,083208,Staff,0,5,30,30
1650221631505,MATH 10B,B01,083739,Staff,17,0,30,13
1650221631505,MATH 10B,B02,083740,Staff,29,0,30,1
1650221637532,MATH 18,A01,083743,Staff,8,0,30,22
1650221637532,MATH 18,A02,083744,Staff,28,0,30,2
1650221637532,MATH 18,A03,083745,Staff,23,0,30,7
1650221637532,MATH 18,A04,083746,Staff,27,0,30,3
1650221637532,MATH 18,B01,083748,Staff,0,10,30,30
1650221637532,MATH 18,B02,083749,Staff,0,7,30,30
1650221637532,MATH 18,B03,083750,Staff,0,7,30,30
1650221637532,MATH 18,B04,083751,Staff,0,8,30,30
1650221643555,MATH 20A,A01,083754,Staff,26,0,40,14
1650221649578,MATH 20B,A01,083756,Staff,1,6,30,29
1650221649578,MATH 20B,A02,083757,Staff,0,6,30,30
1650221655601,MATH 20C,A01,083760,Staff,0,12,30,30
1650221655601,MATH 20C,A02,083761,Staff,0,12,30,30
1650221655601,MATH 20C,B01,083762,Staff,14,0,30,16
1650221655601,MATH 20C,B02,083763,Staff,28,0,30,2
1650221661629,MATH 20D,A01,083765,Staff,1,2,30,29
1650221661629,MATH 20D,A02,083766,Staff,10,0,30,20
1650221661629,MATH 20D,A03,083767,Staff,28,0,30,2
1650221667651,MATH 20E,A01,083771,Staff,8,0,30,22
1650221667651,MATH 20E,A02,083772,Staff,20,0,30,10
1650221667651,MATH 20E,B01,083773,Staff,0,0,30,30
1650221667651,MATH 20E,B02,083774,Staff,12,0,30,18
1650221673679,MATH 103A,A01,083777,Staff,0,9,30,30
1650221673679,MATH 103A,A02,083778,Staff,0,10,30,30
1650221673679,MATH 103A,B01,083779,Staff,0,9,30,30
1650221673679,MATH 103A,B02,083780,Staff,0,9,30,30
1650221679701,MATH 105,A01,085443,Staff,0,17,30,30
1650221685723,MATH 109,A01,083213,Anzaldo; Leesa B,0,3,30,30
1650221685723,MATH 109,A02,083214,Anzaldo; Leesa B,0,6,30,30
1650221685723,MATH 109,B01,083215,Anzaldo; Leesa B,0,4,30,30
1650221685723,MATH 109,B02,083216,Anzaldo; Leesa B,0,4,30,30
1650221691747,MATH 142A,A01,083219,Chow; Bennett,0,12,30,30
1650221691747,MATH 142A,A02,083220,Chow; Bennett,0,11,30,30
1650221691747,MATH 142A,B01,083221,Chow; Bennett,0,11,30,30
1650221691747,MATH 142A,B02,083222,Chow; Bennett,0,12,30,30
1650221697771,MATH 193A,A01,083224,Staff,0,4,30,30
1650221697771,MATH 193A,A02,083225,Staff,0,4,30,30
1650221697771,MATH 193A,A03,083781,Staff,0,2,30,30
1650221697771,MATH 193A,A04,083782,Staff,0,1,30,30
1650221703794,MATH 197,001,091859,McAuley; Julian John,9998,0,9999,1
1650221709845,COGS 9,A01,083615,Staff,0,14,60,60
1650221715872,COGS 11,A01,083617,Boyle; Mary E. T.,24,0,40,16
1650221721896,COGS 13,A01,083071,Staff,0,30,40,40
1650221727922,COGS 14A,A01,092681,Staff,0,12,100,100
1650221733949,COGS 14B,A01,083073,Cheng; Tzu-Han,0,7,50,50
1650221739973,COGS 17,A01,092677,Staff,35,0,75,40
1650221746000,COGS 100,A01,083619,Staff,0,20,60,60
1650221752022,COGS 101A,A01,083621,Davis; Joshua Daniel,0,21,60,60
1650221758049,COGS 101B,A01,091572,Staff,6,0,60,54
1650221764071,COGS 101C,A01,083625,Delgado; Tania,20,0,30,10
1650221770094,COGS 107A,A01,083627,Boyle; Mary E. T.,1,7,60,59
1650221776120,COGS 118A,A01,083075,Staff,16,0,60,44
1650221782144,CSE 3,A50,083646,Miranda; Gregory Joseph,22,0,38,16
1650221782144,CSE 3,A51,083647,Miranda; Gregory Joseph,37,0,37,0
1650221788172,CSE 8A,A50,083650,Miranda; Gregory Joseph,0,17,40,40
1650221794195,CSE 11,A01,083080,Cao; Yingjun,0,68,40,40
1650221800220,CSE 12,A01,083652,Staff,0,8,100,100
1650221806243,CSE 15L,A01,083654,Staff,0,1,50,50
1650221806243,CSE 15L,A02,083655,Staff,6,0,50,44
1650221812267,CSE 20,A01,083657,Staff,53,0,80,27
1650221818291,CSE 30,A01,083084,Eldon; John,0,70,40,40
1650221824326,CSE 100,A01,083659,Cao; Yingjun,0,63,50,50
1650221830358,CSE 134B,A01,083661,Powell; Thomas Allan,0,27,65,65
1650221836394,CSE 140,A01,083663,Staff,1,0,75,74
1650221842507,CSE 140L,A01,083088,Eldon; John,0,4,75,75
1650221848542,CSE 175,A01,083665,Kumar; Rakesh,8,0,25,17
1650221854570,CSE 190,A00,092507,Dubnov; Shlomo,14,0,20,6
1650221860595,ECE 45,A01,083139,Staff,0,13,40,40
1650221866625,ECE 65,A50,083695,Staff,0,5,30,30
1650221872649,ECE 109,A01,091882,Touri; Behrouz,47,0,70,23
1650221878673,ECE 180,A00,083140,Abi Samra; Nicholas Camill,24,0,30,6
1650221878673,ECE 180,B00,083141,Abi Samra; Nicholas Camill,8,0,30,22
1650221884697,MATH 10A,A01,083735,Patchell; Gregory David,11,0,30,19
1650221884697,MATH 10A,A02,083736,Patchell; Gregory David,28,0,30,2
1650221884697,MATH 10A,A03,083737,Patchell; Gregory David,26,0,30,4
1650221890721,MATH 10B,A01,083207,Staff,0,6,30,30
1650221890721,MATH 10B,A02,083208,Staff,0,5,30,30
1650221890721,MATH 10B,B01,083739,Staff,17,0,30,13
1650221890721,MATH 10B,B02,083740,Staff,29,0,30,1
1650221896744,MATH 18,A01,083743,Staff,8,0,30,22
1650221896744,MATH 18,A02,083744,Staff,28,0,30,2
1650221896744,MATH 18,A03,083745,Staff,23,0,30,7
1650221896744,MATH 18,A04,083746,Staff,27,0,30,3
1650221896744,MATH 18,B01,083748,Staff,0,10,30,30
1650221896744,MATH 18,B02,083749,Staff,0,7,30,30
1650221896744,MATH 18,B03,083750,Staff,0,7,30,30
1650221896744,MATH 18,B04,083751,Staff,0,8,30,30
1650221902767,MATH 20A,A01,083754,Staff,26,0,40,14
1650221908790,MATH 20B,A01,083756,Staff,1,6,30,29
1650221908790,MATH 20B,A02,083757,Staff,0,6,30,30
1650221914828,MATH 20C,A01,083760,Staff,0,12,30,30
1650221914828,MATH 20C,A02,083761,Staff,0,12,30,30
1650221914828,MATH 20C,B01,083762,Staff,14,0,30,16
1650221914828,MATH 20C,B02,083763,Staff,28,0,30,2
1650221920854,MATH 20D,A01,083765,Staff,1,2,30,29
1650221920854,MATH 20D,A02,083766,Staff,10,0,30,20
1650221920854,MATH 20D,A03,083767,Staff,28,0,30,2
1650221926878,MATH 20E,A01,083771,Staff,8,0,30,22
1650221926878,MATH 20E,A02,083772,Staff,20,0,30,10
1650221926878,MATH 20E,B01,083773,Staff,0,0,30,30
1650221926878,MATH 20E,B02,083774,Staff,12,0,30,18
1650221932904,MATH 103A,A01,083777,Staff,0,9,30,30
1650221932904,MATH 103A,A02,083778,Staff,0,10,30,30
1650221932904,MATH 103A,B01,083779,Staff,0,9,30,30
1650221932904,MATH 103A,B02,083780,Staff,0,9,30,30
1650221938929,MATH 105,A01,085443,Staff,0,17,30,30
1650221944953,MATH 109,A01,083213,Anzaldo; Leesa B,0,3,30,30
1650221944953,MATH 109,A02,083214,Anzaldo; Leesa B,0,6,30,30
1650221944953,MATH 109,B01,083215,Anzaldo; Leesa B,0,4,30,30
1650221944953,MATH 109,B02,083216,Anzaldo; Leesa B,0,4,30,30
1650221950981,MATH 142A,A01,083219,Chow; Bennett,0,12,30,30
1650221950981,MATH 142A,A02,083220,Chow; Bennett,0,11,30,30
1650221950981,MATH 142A,B01,083221,Chow; Bennett,0,11,30,30
1650221950981,MATH 142A,B02,083222,Chow; Bennett,0,12,30,30
1650221957004,MATH 193A,A01,083224,Staff,0,4,30,30
1650221957004,MATH 193A,A02,083225,Staff,0,4,30,30
1650221957004,MATH 193A,A03,083781,Staff,0,2,30,30
1650221957004,MATH 193A,A04,083782,Staff,0,1,30,30
1650221963027,MATH 197,001,091859,McAuley; Julian John,9998,0,9999,1
1650221969092,COGS 9,A01,083615,Staff,0,14,60,60
1650221975118,COGS 11,A01,083617,Boyle; Mary E. T.,24,0,40,16
1650221981142,COGS 13,A01,083071,Staff,0,30,40,40
1650221987169,COGS 14A,A01,092681,Staff,0,12,100,100
1650221993193,COGS 14B,A01,083073,Cheng; Tzu-Han,0,7,50,50
1650221999215,COGS 17,A01,092677,Staff,35,0,75,40
1650222005238,COGS 100,A01,083619,Staff,0,20,60,60
1650222011264,COGS 101A,A01,083621,Davis; Joshua Daniel,0,21,60,60
1650222017287,COGS 101B,A01,091572,Staff,6,0,60,54
1650222023311,COGS 101C,A01,083625,Delgado; Tania,20,0,30,10
1650222029337,COGS 107A,A01,083627,Boyle; Mary E. T.,1,7,60,59
1650222035362,COGS 118A,A01,083075,Staff,16,0,60,44
1650222041386,CSE 3,A50,083646,Miranda; Gregory Joseph,22,0,38,16
1650222041386,CSE 3,A51,083647,Miranda; Gregory Joseph,37,0,37,0
1650222047410,CSE 8A,A50,083650,Miranda; Gregory Joseph,0,17,40,40
1650222053438,CSE 11,A01,083080,Cao; Yingjun,0,68,40,40
1650222059463,CSE 12,A01,083652,Staff,0,8,100,100
1650222065495,CSE 15L,A01,083654,Staff,0,1,50,50
1650222065495,CSE 15L,A02,083655,Staff,6,0,50,44
1650222071534,CSE 20,A01,083657,Staff,53,0,80,27
1650222077565,CSE 30,A01,083084,Eldon; John,0,70,40,40
1650222083591,CSE 100,A01,083659,Cao; Yingjun,0,63,50,50
1650222089615,CSE 134B,A01,083661,Powell; Thomas Allan,0,27,65,65
1650222095638,CSE 140,A01,083663,Staff,1,0,75,74
1650222101664,CSE 140L,A01,083088,Eldon; John,0,4,75,75
1650222107687,CSE 175,A01,083665,Kumar; Rakesh,8,0,25,17
1650222113716,CSE 190,A00,092507,Dubnov; Shlomo,14,0,20,6
1650222119741,ECE 45,A01,083139,Staff,0,13,40,40
1650222125763,ECE 65,A50,083695,Staff,0,5,30,30
1650222131787,ECE 109,A01,091882,Touri; Behrouz,47,0,70,23
1650222137811,ECE 180,A00,083140,Abi Samra; Nicholas Camill,24,0,30,6
1650222137811,ECE 180,B00,083141,Abi Samra; Nicholas Camill,8,0,30,22
1650222143836,MATH 10A,A01,083735,Patchell; Gregory David,11,0,30,19
1650222143836,MATH 10A,A02,083736,Patchell; Gregory David,28,0,30,2
1650222143836,MATH 10A,A03,083737,Patchell; Gregory David,26,0,30,4
1650222149865,MATH 10B,A01,083207,Staff,0,6,30,30
1650222149865,MATH 10B,A02,083208,Staff,0,5,30,30
1650222149865,MATH 10B,B01,083739,Staff,17,0,30,13
1650222149865,MATH 10B,B02,083740,Staff,29,0,30,1
1650222155889,MATH 18,A01,083743,Staff,8,0,30,22
1650222155889,MATH 18,A02,083744,Staff,28,0,30,2
1650222155889,MATH 18,A03,083745,Staff,23,0,30,7
1650222155889,MATH 18,A04,083746,Staff,27,0,30,3
1650222155889,MATH 18,B01,083748,Staff,0,10,30,30
1650222155889,MATH 18,B02,083749,Staff,0,7,30,30
1650222155889,MATH 18,B03,083750,Staff,0,7,30,30
1650222155889,MATH 18,B04,083751,Staff,0,8,30,30
1650222161912,MATH 20A,A01,083754,Staff,26,0,40,14
1650222167937,MATH 20B,A01,083756,Staff,1,6,30,29
1650222167937,MATH 20B,A02,083757,Staff,0,6,30,30
1650222173967,MATH 20C,A01,083760,Staff,0,12,30,30
1650222173967,MATH 20C,A02,083761,Staff,0,12,30,30
1650222173967,MATH 20C,B01,083762,Staff,14,0,30,16
1650222173967,MATH 20C,B02,083763,Staff,28,0,30,2
1650222179991,MATH 20D,A01,083765,Staff,1,2,30,29
1650222179991,MATH 20D,A02,083766,Staff,10,0,30,20
1650222179991,MATH 20D,A03,083767,Staff,28,0,30,2
1650222186020,MATH 20E,A01,083771,Staff,8,0,30,22
1650222186020,MATH 20E,A02,083772,Staff,20,0,30,10
1650222186020,MATH 20E,B01,083773,Staff,0,0,30,30
1650222186020,MATH 20E,B02,083774,Staff,12,0,30,18
1650222192056,MATH 103A,A01,083777,Staff,0,9,30,30
1650222192056,MATH 103A,A02,083778,Staff,0,10,30,30
1650222192056,MATH 103A,B01,083779,Staff,0,9,30,30
1650222192056,MATH 103A,B02,083780,Staff,0,9,30,30
1650222198086,MATH 105,A01,085443,Staff,0,17,30,30
1650222204117,MATH 109,A01,083213,Anzaldo; Leesa B,0,3,30,30
1650222204117,MATH 109,A02,083214,Anzaldo; Leesa B,0,6,30,30
1650222204117,MATH 109,B01,083215,Anzaldo; Leesa B,0,4,30,30
1650222204117,MATH 109,B02,083216,Anzaldo; Leesa B,0,4,30,30
1650222210145,MATH 142A,A01,083219,Chow; Bennett,0,12,30,30
1650222210145,MATH 142A,A02,083220,Chow; Bennett,0,11,30,30
1650222210145,MATH 142A,B01,083221,Chow; Bennett,0,11,30,30
1650222210145,MATH 142A,B02,083222,Chow; Bennett,0,12,30,30
1650222216172,MATH 193A,A01,083224,Staff,0,4,30,30
1650222216172,MATH 193A,A02,083225,Staff,0,4,30,30
1650222216172,MATH 193A,A03,083781,Staff,0,2,30,30
1650222216172,MATH 193A,A04,083782,Staff,0,1,30,30
1650222222195,MATH 197,001,091859,McAuley; Julian John,9998,0,9999,1
1650222228245,COGS 9,A01,083615,Staff,0,14,60,60
1650222234274,COGS 11,A01,083617,Boyle; Mary E. T.,24,0,40,16
1650222240306,COGS 13,A01,083071,Staff,0,30,40,40
1650222246340,COGS 14A,A01,092681,Staff,0,12,100,100
1650222252364,COGS 14B,A01,083073,Cheng; Tzu-Han,0,7,50,50
1650222258401,COGS 17,A01,092677,Staff,35,0,75,40
1650222264424,COGS 100,A01,083619,Staff,0,20,60,60
1650222270465,COGS 101A,A01,083621,Davis; Joshua Daniel,0,21,60,60
1650222276492,COGS 101B,A01,091572,Staff,6,0,60,54
1650222282517,COGS 101C,A01,083625,Delgado; Tania,20,0,30,10
1650222288541,COGS 107A,A01,083627,Boyle; Mary E. T.,1,7,60,59
1650222294566,COGS 118A,A01,083075,Staff,16,0,60,44
1650222300600,CSE 3,A50,083646,Miranda; Gregory Joseph,22,0,38,16
1650222300600,CSE 3,A51,083647,Miranda; Gregory Joseph,37,0,37,0
1650222306627,CSE 8A,A50,083650,Miranda; Gregory Joseph,0,17,40,40
1650222312652,CSE 11,A01,083080,Cao; Yingjun,0,68,40,40
1650222318676,CSE 12,A01,083652,Staff,0,8,100,100
1650222324702,CSE 15L,A01,083654,Staff,0,1,50,50
1650222324702,CSE 15L,A02,083655,Staff,6,0,50,44
1650222330725,CSE 20,A01,083657,Staff,53,0,80,27
1650222336749,CSE 30,A01,083084,Eldon; John,0,70,40,40
1650222342774,CSE 100,A01,083659,Cao; Yingjun,0,63,50,50
1650222348800,CSE 134B,A01,083661,Powell; Thomas Allan,0,27,65,65
1650222354822,CSE 140,A01,083663,Staff,1,0,75,74
1650222360846,CSE 140L,A01,083088,Eldon; John,0,4,75,75
1650222366870,CSE 175,A01,083665,Kumar; Rakesh,8,0,25,17
1650222372896,CSE 190,A00,092507,Dubnov; Shlomo,14,0,20,6
1650222378928,ECE 45,A01,083139,Staff,0,13,40,40
1650222384971,ECE 65,A50,083695,Staff,0,5,30,30
1650222391001,ECE 109,A01,091882,Touri; Behrouz,47,0,70,23
1650222397028,ECE 180,A00,083140,Abi Samra; Nicholas Camill,24,0,30,6
1650222397028,ECE 180,B00,083141,Abi Samra; Nicholas Camill,8,0,30,22
1650222403053,MATH 10A,A01,083735,Patchell; Gregory David,11,0,30,19
1650222403053,MATH 10A,A02,083736,Patchell; Gregory David,28,0,30,2
1650222403053,MATH 10A,A03,083737,Patchell; Gregory David,26,0,30,4
1650222409081,MATH 10B,A01,083207,Staff,0,6,30,30
1650222409081,MATH 10B,A02,083208,Staff,0,5,30,30
1650222409081,MATH 10B,B01,083739,Staff,17,0,30,13
1650222409081,MATH 10B,B02,083740,Staff,29,0,30,1
1650222415111,MATH 18,A01,083743,Staff,8,0,30,22
1650222415111,MATH 18,A02,083744,Staff,28,0,30,2
1650222415111,MATH 18,A03,083745,Staff,23,0,30,7
1650222415111,MATH 18,A04,083746,Staff,27,0,30,3
1650222415111,MATH 18,B01,083748,Staff,0,10,30,30
1650222415111,MATH 18,B02,083749,Staff,0,7,30,30
1650222415111,MATH 18,B03,083750,Staff,0,7,30,30
1650222415111,MATH 18,B04,083751,Staff,0,8,30,30
1650222421135,MATH 20A,A01,083754,Staff,26,0,40,14
1650222427158,MATH 20B,A01,083756,Staff,1,6,30,29
1650222427158,MATH 20B,A02,083757,Staff,0,6,30,30
1650222433183,MATH 20C,A01,083760,Staff,0,12,30,30
1650222433183,MATH 20C,A02,083761,Staff,0,12,30,30
1650222433183,MATH 20C,B01,083762,Staff,14,0,30,16
1650222433183,MATH 20C,B02,083763,Staff,28,0,30,2
1650222439292,MATH 20D,A01,083765,Staff,1,2,30,29
1650222439292,MATH 20D,A02,083766,Staff,10,0,30,20
1650222439292,MATH 20D,A03,083767,Staff,28,0,30,2
1650222445320,MATH 20E,A01,083771,Staff,8,0,30,22
1650222445320,MATH 20E,A02,083772,Staff,20,0,30,10
1650222445320,MATH 20E,B01,083773,Staff,0,0,30,30
1650222445320,MATH 20E,B02,083774,Staff,12,0,30,18
1650222451344,MATH 103A,A01,083777,Staff,0,9,30,30
1650222451344,MATH 103A,A02,083778,Staff,0,10,30,30
1650222451344,MATH 103A,B01,083779,Staff,0,9,30,30
1650222451344,MATH 103A,B02,083780,Staff,0,9,30,30
1650222457368,MATH 105,A01,085443,Staff,0,17,30,30
1650222463393,MATH 109,A01,083213,Anzaldo; Leesa B,0,3,30,30
1650222463393,MATH 109,A02,083214,Anzaldo; Leesa B,0,6,30,30
1650222463393,MATH 109,B01,083215,Anzaldo; Leesa B,0,4,30,30
1650222463393,MATH 109,B02,083216,Anzaldo; Leesa B,0,4,30,30
1650222469417,MATH 142A,A01,083219,Chow; Bennett,0,12,30,30
1650222469417,MATH 142A,A02,083220,Chow; Bennett,0,11,30,30
1650222469417,MATH 142A,B01,083221,Chow; Bennett,0,11,30,30
1650222469417,MATH 142A,B02,083222,Chow; Bennett,0,12,30,30
1650222475441,MATH 193A,A01,083224,Staff,0,4,30,30
1650222475441,MATH 193A,A02,083225,Staff,0,4,30,30
1650222475441,MATH 193A,A03,083781,Staff,0,2,30,30
1650222475441,MATH 193A,A04,083782,Staff,0,1,30,30
1650222481466,MATH 197,001,091859,McAuley; Julian John,9998,0,9999,1
1650222487515,COGS 9,A01,083615,Staff,0,14,60,60
1650222493539,COGS 11,A01,083617,Boyle; Mary E. T.,24,0,40,16
1650222499565,COGS 13,A01,083071,Staff,0,30,40,40
1650222505589,COGS 14A,A01,092681,Staff,0,12,100,100
1650222511613,COGS 14B,A01,083073,Cheng; Tzu-Han,0,7,50,50
1650222517646,COGS 17,A01,092677,Staff,35,0,75,40
1650222523672,COGS 100,A01,083619,Staff,0,20,60,60
1650222529696,COGS 101A,A01,083621,Davis; Joshua Daniel,0,21,60,60
1650222535721,COGS 101B,A01,091572,Staff,6,0,60,54
1650222541748,COGS 101C,A01,083625,Delgado; Tania,20,0,30,10
1650222547772,COGS 107A,A01,083627,Boyle; Mary E. T.,1,7,60,59
1650222553803,COGS 118A,A01,083075,Staff,16,0,60,44
1650222559826,CSE 3,A50,083646,Miranda; Gregory Joseph,22,0,38,16
1650222559826,CSE 3,A51,083647,Miranda; Gregory Joseph,37,0,37,0
1650222565850,CSE 8A,A50,083650,Miranda; Gregory Joseph,0,17,40,40
1650222571876,CSE 11,A01,083080,Cao; Yingjun,0,68,40,40
1650222577903,CSE 12,A01,083652,Staff,0,8,100,100
1650222583931,CSE 15L,A01,083654,Staff,0,1,50,50
1650222583931,CSE 15L,A02,083655,Staff,6,0,50,44
1650222589954,CSE 20,A01,083657,Staff,53,0,80,27
1650222595981,CSE 30,A01,083084,Eldon; John,0,70,40,40
1650222602011,CSE 100,A01,083659,Cao; Yingjun,0,63,50,50
1650222608043,CSE 134B,A01,083661,Powell; Thomas Allan,0,27,65,65
1650222614067,CSE 140,A01,083663,Staff,1,0,75,74
1650222620091,CSE 140L,A01,083088,Eldon; John,0,4,75,75
1650222626123,CSE 175,A01,083665,Kumar; Rakesh,8,0,25,17
1650222632145,CSE 190,A00,092507,Dubnov; Shlomo,14,0,20,6
1650222638173,ECE 45,A01,083139,Staff,0,13,40,40
1650222644199,ECE 65,A50,083695,Staff,0,5,30,30
1650222650222,ECE 109,A01,091882,Touri; Behrouz,47,0,70,23
1650222656249,ECE 180,A00,083140,Abi Samra; Nicholas Camill,24,0,30,6
1650222656249,ECE 180,B00,083141,Abi Samra; Nicholas Camill,8,0,30,22
1650222662273,MATH 10A,A01,083735,Patchell; Gregory David,11,0,30,19
1650222662273,MATH 10A,A02,083736,Patchell; Gregory David,28,0,30,2
1650222662273,MATH 10A,A03,083737,Patchell; Gregory David,26,0,30,4
1650222668299,MATH 10B,A01,083207,Staff,0,6,30,30
1650222668299,MATH 10B,A02,083208,Staff,0,5,30,30
1650222668299,MATH 10B,B01,083739,Staff,17,0,30,13
1650222668299,MATH 10B,B02,083740,Staff,29,0,30,1
1650222674341,MATH 18,A01,083743,Staff,8,0,30,22
1650222674341,MATH 18,A02,083744,Staff,28,0,30,2
1650222674341,MATH 18,A03,083745,Staff,23,0,30,7
1650222674341,MATH 18,A04,083746,Staff,27,0,30,3
1650222674341,MATH 18,B01,083748,Staff,0,10,30,30
1650222674341,MATH 18,B02,083749,Staff,0,7,30,30
1650222674341,MATH 18,B03,083750,Staff,0,7,30,30
1650222674341,MATH 18,B04,083751,Staff,0,8,30,30
1650222680368,MATH 20A,A01,083754,Staff,26,0,40,14
1650222686397,MATH 20B,A01,083756,Staff,1,6,30,29
1650222686397,MATH 20B,A02,083757,Staff,0,6,30,30
1650222692434,MATH 20C,A01,083760,Staff,0,12,30,30
1650222692434,MATH 20C,A02,083761,Staff,0,12,30,30
1650222692434,MATH 20C,B01,083762,Staff,14,0,30,16
1650222692434,MATH 20C,B02,083763,Staff,28,0,30,2
1650222698461,MATH 20D,A01,083765,Staff,1,2,30,29
1650222698461,MATH 20D,A02,083766,Staff,10,0,30,20
1650222698461,MATH 20D,A03,083767,Staff,28,0,30,2
1650222704489,MATH 20E,A01,083771,Staff,8,0,30,22
1650222704489,MATH 20E,A02,083772,Staff,20,0,30,10
1650222704489,MATH 20E,B01,083773,Staff,0,0,30,30
1650222704489,MATH 20E,B02,083774,Staff,12,0,30,18
1650222710514,MATH 103A,A01,083777,Staff,0,9,30,30
1650222710514,MATH 103A,A02,083778,Staff,0,10,30,30
1650222710514,MATH 103A,B01,083779,Staff,0,9,30,30
1650222710514,MATH 103A,B02,083780,Staff,0,9,30,30
1650222716553,MATH 105,A01,085443,Staff,0,17,30,30
1650222722576,MATH 109,A01,083213,Anzaldo; Leesa B,0,3,30,30
1650222722576,MATH 109,A02,083214,Anzaldo; Leesa B,0,6,30,30
1650222722576,MATH 109,B01,083215,Anzaldo; Leesa B,0,4,30,30
1650222722576,MATH 109,B02,083216,Anzaldo; Leesa B,0,4,30,30
1650222728602,MATH 142A,A01,083219,Chow; Bennett,0,12,30,30
1650222728602,MATH 142A,A02,083220,Chow; Bennett,0,11,30,30
1650222728602,MATH 142A,B01,083221,Chow; Bennett,0,11,30,30
1650222728602,MATH 142A,B02,083222,Chow; Bennett,0,12,30,30
1650222734627,MATH 193A,A01,083224,Staff,0,4,30,30
1650222734627,MATH 193A,A02,083225,Staff,0,4,30,30
1650222734627,MATH 193A,A03,083781,Staff,0,2,30,30
1650222734627,MATH 193A,A04,083782,Staff,0,1,30,30
1650222740653,MATH 197,001,091859,McAuley; Julian John,9998,0,9999,1
1650222746703,COGS 9,A01,083615,Staff,0,14,60,60
1650222752729,COGS 11,A01,083617,Boyle; Mary E. T.,24,0,40,16
1650222758782,COGS 13,A01,083071,Staff,0,30,40,40
1650222764809,COGS 14A,A01,092681,Staff,0,12,100,100
1650222770836,COGS 14B,A01,083073,Cheng; Tzu-Han,0,7,50,50
1650222776862,COGS 17,A01,092677,Staff,35,0,75,40
1650222782888,COGS 100,A01,083619,Staff,0,20,60,60
1650222788911,COGS 101A,A01,083621,Davis; Joshua Daniel,0,21,60,60
1650222794937,COGS 101B,A01,091572,Staff,6,0,60,54
1650222800965,COGS 101C,A01,083625,Delgado; Tania,20,0,30,10
1650222806994,COGS 107A,A01,083627,Boyle; Mary E. T.,1,7,60,59
1650222813017,COGS 118A,A01,083075,Staff,16,0,60,44
1650222819044,CSE 3,A50,083646,Miranda; Gregory Joseph,22,0,38,16
1650222819044,CSE 3,A51,083647,Miranda; Gregory Joseph,37,0,37,0
1650222825068,CSE 8A,A50,083650,Miranda; Gregory Joseph,0,17,40,40
1650222831092,CSE 11,A01,083080,Cao; Yingjun,0,68,40,40
1650222837118,CSE 12,A01,083652,Staff,0,8,100,100
1650222843140,CSE 15L,A01,083654,Staff,0,1,50,50
1650222843140,CSE 15L,A02,083655,Staff,6,0,50,44
1650222849166,CSE 20,A01,083657,Staff,53,0,80,27
1650222855192,CSE 30,A01,083084,Eldon; John,0,70,40,40
1650222861214,CSE 100,A01,083659,Cao; Yingjun,0,63,50,50
1650222867239,CSE 134B,A01,083661,Powell; Thomas Allan,0,27,65,65
1650222873264,CSE 140,A01,083663,Staff,1,0,75,74
1650222879287,CSE 140L,A01,083088,Eldon; John,0,4,75,75
1650222885310,CSE 175,A01,083665,Kumar; Rakesh,8,0,25,17
1650222891337,CSE 190,A00,092507,Dubnov; Shlomo,14,0,20,6
1650222897363,ECE 45,A01,083139,Staff,0,13,40,40
1650222903390,ECE 65,A50,083695,Staff,0,5,30,30
1650222909414,ECE 109,A01,091882,Touri; Behrouz,47,0,70,23
1650222915440,ECE 180,A00,083140,Abi Samra; Nicholas Camill,24,0,30,6
1650222915440,ECE 180,B00,083141,Abi Samra; Nicholas Camill,8,0,30,22
1650222921462,MATH 10A,A01,083735,Patchell; Gregory David,11,0,30,19
1650222921462,MATH 10A,A02,083736,Patchell; Gregory David,28,0,30,2
1650222921462,MATH 10A,A03,083737,Patchell; Gregory David,26,0,30,4
1650222927488,MATH 10B,A01,083207,Staff,0,6,30,30
1650222927488,MATH 10B,A02,083208,Staff,0,5,30,30
1650222927488,MATH 10B,B01,083739,Staff,17,0,30,13
1650222927488,MATH 10B,B02,083740,Staff,29,0,30,1
1650222933511,MATH 18,A01,083743,Staff,8,0,30,22
1650222933511,MATH 18,A02,083744,Staff,28,0,30,2
1650222933511,MATH 18,A03,083745,Staff,23,0,30,7
1650222933511,MATH 18,A04,083746,Staff,27,0,30,3
1650222933511,MATH 18,B01,083748,Staff,0,10,30,30
1650222933511,MATH 18,B02,083749,Staff,0,7,30,30
1650222933511,MATH 18,B03,083750,Staff,0,7,30,30
1650222933511,MATH 18,B04,083751,Staff,0,8,30,30
1650222939533,MATH 20A,A01,083754,Staff,26,0,40,14
1650222945558,MATH 20B,A01,083756,Staff,1,6,30,29
1650222945558,MATH 20B,A02,083757,Staff,0,6,30,30
1650222951585,MATH 20C,A01,083760,Staff,0,12,30,30
1650222951585,MATH 20C,A02,083761,Staff,0,12,30,30
1650222951585,MATH 20C,B01,083762,Staff,14,0,30,16
1650222951585,MATH 20C,B02,083763,Staff,28,0,30,2
1650222957610,MATH 20D,A01,083765,Staff,1,2,30,29
1650222957610,MATH 20D,A02,083766,Staff,10,0,30,20
1650222957610,MATH 20D,A03,083767,Staff,28,0,30,2
1650222963637,MATH 20E,A01,083771,Staff,8,0,30,22
1650222963637,MATH 20E,A02,083772,Staff,20,0,30,10
1650222963637,MATH 20E,B01,083773,Staff,0,0,30,30
1650222963637,MATH 20E,B02,083774,Staff,12,0,30,18
1650222969665,MATH 103A,A01,083777,Staff,0,9,30,30
1650222969665,MATH 103A,A02,083778,Staff,0,10,30,30
1650222969665,MATH 103A,B01,083779,Staff,0,9,30,30
1650222969665,MATH 103A,B02,083780,Staff,0,9,30,30
1650222975688,MATH 105,A01,085443,Staff,0,17,30,30
1650222981711,MATH 109,A01,083213,Anzaldo; Leesa B,0,3,30,30
1650222981711,MATH 109,A02,083214,Anzaldo; Leesa B,0,6,30,30
1650222981711,MATH 109,B01,083215,Anzaldo; Leesa B,0,4,30,30
1650222981711,MATH 109,B02,083216,Anzaldo; Leesa B,0,4,30,30
1650222987739,MATH 142A,A01,083219,Chow; Bennett,0,12,30,30
1650222987739,MATH 142A,A02,083220,Chow; Bennett,0,11,30,30
1650222987739,MATH 142A,B01,083221,Chow; Bennett,0,11,30,30
1650222987739,MATH 142A,B02,083222,Chow; Bennett,0,12,30,30
1650222993765,MATH 193A,A01,083224,Staff,0,4,30,30
1650222993765,MATH 193A,A02,083225,Staff,0,4,30,30
1650222993765,MATH 193A,A03,083781,Staff,0,2,30,30
1650222993765,MATH 193A,A04,083782,Staff,0,1,30,30
1650222999788,MATH 197,001,091859,McAuley; Julian John,9998,0,9999,1
1650223005836,COGS 9,A01,083615,Staff,0,14,60,60
1650223011863,COGS 11,A01,083617,Boyle; Mary E. T.,24,0,40,16
1650223017886,COGS 13,A01,083071,Staff,0,30,40,40
1650223023912,COGS 14A,A01,092681,Staff,0,12,100,100
1650223030034,COGS 14B,A01,083073,Cheng; Tzu-Han,0,7,50,50
1650223036061,COGS 17,A01,092677,Staff,35,0,75,40
1650223042091,COGS 100,A01,083619,Staff,0,20,60,60
1650223048114,COGS 101A,A01,083621,Davis; Joshua Daniel,0,21,60,60
1650223054142,COGS 101B,A01,091572,Staff,6,0,60,54
1650223060172,COGS 101C,A01,083625,Delgado; Tania,20,0,30,10
1650223066200,COGS 107A,A01,083627,Boyle; Mary E. T.,1,7,60,59
1650223072234,COGS 118A,A01,083075,Staff,16,0,60,44
1650223078260,CSE 3,A50,083646,Miranda; Gregory Joseph,22,0,38,16
1650223078260,CSE 3,A51,083647,Miranda; Gregory Joseph,37,0,37,0
1650223084288,CSE 8A,A50,083650,Miranda; Gregory Joseph,0,17,40,40
1650223090311,CSE 11,A01,083080,Cao; Yingjun,0,68,40,40
1650223096335,CSE 12,A01,083652,Staff,0,8,100,100
1650223102368,CSE 15L,A01,083654,Staff,0,1,50,50
1650223102368,CSE 15L,A02,083655,Staff,6,0,50,44
1650223108390,CSE 20,A01,083657,Staff,53,0,80,27
1650223114413,CSE 30,A01,083084,Eldon; John,0,70,40,40
1650223120436,CSE 100,A01,083659,Cao; Yingjun,0,63,50,50
1650223126460,CSE 134B,A01,083661,Powell; Thomas Allan,0,27,65,65
1650223132489,CSE 140,A01,083663,Staff,1,0,75,74
1650223138511,CSE 140L,A01,083088,Eldon; John,0,4,75,75
1650223144535,CSE 175,A01,083665,Kumar; Rakesh,8,0,25,17
1650223150561,CSE 190,A00,092507,Dubnov; Shlomo,14,0,20,6
1650223156592,ECE 45,A01,083139,Staff,0,13,40,40
1650223162622,ECE 65,A50,083695,Staff,0,5,30,30
1650223168647,ECE 109,A01,091882,Touri; Behrouz,47,0,70,23
1650223174672,ECE 180,A00,083140,Abi Samra; Nicholas Camill,24,0,30,6
1650223174672,ECE 180,B00,083141,Abi Samra; Nicholas Camill,8,0,30,22
1650223180695,MATH 10A,A01,083735,Patchell; Gregory David,11,0,30,19
1650223180695,MATH 10A,A02,083736,Patchell; Gregory David,28,0,30,2
1650223180695,MATH 10A,A03,083737,Patchell; Gregory David,26,0,30,4
1650223186719,MATH 10B,A01,083207,Staff,0,6,30,30
1650223186719,MATH 10B,A02,083208,Staff,0,5,30,30
1650223186719,MATH 10B,B01,083739,Staff,17,0,30,13
1650223186719,MATH 10B,B02,083740,Staff,29,0,30,1
1650223192750,MATH 18,A01,083743,Staff,8,0,30,22
1650223192750,MATH 18,A02,083744,Staff,28,0,30,2
1650223192750,MATH 18,A03,083745,Staff,23,0,30,7
1650223192750,MATH 18,A04,083746,Staff,27,0,30,3
1650223192750,MATH 18,B01,083748,Staff,0,10,30,30
1650223192750,MATH 18,B02,083749,Staff,0,7,30,30
1650223192750,MATH 18,B03,083750,Staff,0,7,30,30
1650223192750,MATH 18,B04,083751,Staff,0,8,30,30
1650223198774,MATH 20A,A01,083754,Staff,26,0,40,14
1650223204801,MATH 20B,A01,083756,Staff,1,6,30,29
1650223204801,MATH 20B,A02,083757,Staff,0,6,30,30
1650223210824,MATH 20C,A01,083760,Staff,0,12,30,30
1650223210824,MATH 20C,A02,083761,Staff,0,12,30,30
1650223210824,MATH 20C,B01,083762,Staff,14,0,30,16
1650223210824,MATH 20C,B02,083763,Staff,28,0,30,2
1650223216848,MATH 20D,A01,083765,Staff,1,2,30,29
1650223216848,MATH 20D,A02,083766,Staff,10,0,30,20
1650223216848,MATH 20D,A03,083767,Staff,28,0,30,2
1650223222873,MATH 20E,A01,083771,Staff,8,0,30,22
1650223222873,MATH 20E,A02,083772,Staff,20,0,30,10
1650223222873,MATH 20E,B01,083773,Staff,0,0,30,30
1650223222873,MATH 20E,B02,083774,Staff,12,0,30,18
1650223228897,MATH 103A,A01,083777,Staff,0,9,30,30
1650223228897,MATH 103A,A02,083778,Staff,0,10,30,30
1650223228897,MATH 103A,B01,083779,Staff,0,9,30,30
1650223228897,MATH 103A,B02,083780,Staff,0,9,30,30
1650223234919,MATH 105,A01,085443,Staff,0,17,30,30
1650223240942,MATH 109,A01,083213,Anzaldo; Leesa B,0,3,30,30
1650223240942,MATH 109,A02,083214,Anzaldo; Leesa B,0,6,30,30
1650223240942,MATH 109,B01,083215,Anzaldo; Leesa B,0,4,30,30
1650223240942,MATH 109,B02,083216,Anzaldo; Leesa B,0,4,30,30
1650223246965,MATH 142A,A01,083219,Chow; Bennett,0,12,30,30
1650223246965,MATH 142A,A02,083220,Chow; Bennett,0,11,30,30
1650223246965,MATH 142A,B01,083221,Chow; Bennett,0,11,30,30
1650223246965,MATH 142A,B02,083222,Chow; Bennett,0,12,30,30
1650223253016,MATH 193A,A01,083224,Staff,0,4,30,30
1650223253016,MATH 193A,A02,083225,Staff,0,4,30,30
1650223253016,MATH 193A,A03,083781,Staff,0,2,30,30
1650223253016,MATH 193A,A04,083782,Staff,0,1,30,30
1650223259042,MATH 197,001,091859,McAuley; Julian John,9998,0,9999,1
1650223265117,COGS 9,A01,083615,Staff,0,14,60,60
1650223271144,COGS 11,A01,083617,Boyle; Mary E. T.,24,0,40,16
1650223277169,COGS 13,A01,083071,Staff,0,30,40,40
1650223283194,COGS 14A,A01,092681,Staff,0,12,100,100
1650223289220,COGS 14B,A01,083073,Cheng; Tzu-Han,0,7,50,50
1650223295244,COGS 17,A01,092677,Staff,35,0,75,40
1650223301271,COGS 100,A01,083619,Staff,0,21,60,60
1650223307293,COGS 101A,A01,083621,Davis; Joshua Daniel,0,21,60,60
1650223313317,COGS 101B,A01,091572,Staff,6,0,60,54
1650223319347,COGS 101C,A01,083625,Delgado; Tania,20,0,30,10
1650223325376,COGS 107A,A01,083627,Boyle; Mary E. T.,1,7,60,59
1650223331401,COGS 118A,A01,083075,Staff,16,0,60,44
1650223337438,CSE 3,A50,083646,Miranda; Gregory Joseph,22,0,38,16
1650223337438,CSE 3,A51,083647,Miranda; Gregory Joseph,37,0,37,0
1650223343463,CSE 8A,A50,083650,Miranda; Gregory Joseph,0,17,40,40
1650223349487,CSE 11,A01,083080,Cao; Yingjun,0,68,40,40
1650223355512,CSE 12,A01,083652,Staff,0,8,100,100
1650223361540,CSE 15L,A01,083654,Staff,0,1,50,50
1650223361540,CSE 15L,A02,083655,Staff,6,0,50,44
1650223367563,CSE 20,A01,083657,Staff,53,0,80,27
1650223373590,CSE 30,A01,083084,Eldon; John,0,70,40,40
1650223379613,CSE 100,A01,083659,Cao; Yingjun,0,63,50,50
1650223385639,CSE 134B,A01,083661,Powell; Thomas Allan,0,27,65,65
1650223391662,CSE 140,A01,083663,Staff,1,0,75,74
1650223397700,CSE 140L,A01,083088,Eldon; John,0,4,75,75
1650223403723,CSE 175,A01,083665,Kumar; Rakesh,8,0,25,17
1650223409747,CSE 190,A00,092507,Dubnov; Shlomo,14,0,20,6
1650223415771,ECE 45,A01,083139,Staff,0,13,40,40
1650223421796,ECE 65,A50,083695,Staff,0,5,30,30
1650223427820,ECE 109,A01,091882,Touri; Behrouz,47,0,70,23
1650223433842,ECE 180,A00,083140,Abi Samra; Nicholas Camill,24,0,30,6
1650223433842,ECE 180,B00,083141,Abi Samra; Nicholas Camill,8,0,30,22
1650223439866,MATH 10A,A01,083735,Patchell; Gregory David,11,0,30,19
1650223439866,MATH 10A,A02,083736,Patchell; Gregory David,28,0,30,2
1650223439866,MATH 10A,A03,083737,Patchell; Gregory David,26,0,30,4
1650223445902,MATH 10B,A01,083207,Staff,0,6,30,30
1650223445902,MATH 10B,A02,083208,Staff,0,5,30,30
1650223445902,MATH 10B,B01,083739,Staff,17,0,30,13
1650223445902,MATH 10B,B02,083740,Staff,29,0,30,1
1650223451931,MATH 18,A01,083743,Staff,8,0,30,22
1650223451931,MATH 18,A02,083744,Staff,28,0,30,2
1650223451931,MATH 18,A03,083745,Staff,23,0,30,7
1650223451931,MATH 18,A04,083746,Staff,27,0,30,3
1650223451931,MATH 18,B01,083748,Staff,0,10,30,30
1650223451931,MATH 18,B02,083749,Staff,0,7,30,30
1650223451931,MATH 18,B03,083750,Staff,0,7,30,30
1650223451931,MATH 18,B04,083751,Staff,0,8,30,30
1650223457954,MATH 20A,A01,083754,Staff,26,0,40,14
1650223463981,MATH 20B,A01,083756,Staff,1,6,30,29
1650223463981,MATH 20B,A02,083757,Staff,0,6,30,30
1650223470005,MATH 20C,A01,083760,Staff,0,12,30,30
1650223470005,MATH 20C,A02,083761,Staff,0,12,30,30
1650223470005,MATH 20C,B01,083762,Staff,14,0,30,16
1650223470005,MATH 20C,B02,083763,Staff,28,0,30,2
1650223476030,MATH 20D,A01,083765,Staff,1,2,30,29
1650223476030,MATH 20D,A02,083766,Staff,10,0,30,20
1650223476030,MATH 20D,A03,083767,Staff,28,0,30,2
1650223482053,MATH 20E,A01,083771,Staff,8,0,30,22
1650223482053,MATH 20E,A02,083772,Staff,20,0,30,10
1650223482053,MATH 20E,B01,083773,Staff,0,0,30,30
1650223482053,MATH 20E,B02,083774,Staff,12,0,30,18
1650223488081,MATH 103A,A01,083777,Staff,0,9,30,30
1650223488081,MATH 103A,A02,083778,Staff,0,10,30,30
1650223488081,MATH 103A,B01,083779,Staff,0,9,30,30
1650223488081,MATH 103A,B02,083780,Staff,0,9,30,30
1650223494103,MATH 105,A01,085443,Staff,0,17,30,30
1650223500128,MATH 109,A01,083213,Anzaldo; Leesa B,0,3,30,30
1650223500128,MATH 109,A02,083214,Anzaldo; Leesa B,0,6,30,30
1650223500128,MATH 109,B01,083215,Anzaldo; Leesa B,0,4,30,30
1650223500128,MATH 109,B02,083216,Anzaldo; Leesa B,0,4,30,30
1650223506152,MATH 142A,A01,083219,Chow; Bennett,0,12,30,30
1650223506152,MATH 142A,A02,083220,Chow; Bennett,0,11,30,30
1650223506152,MATH 142A,B01,083221,Chow; Bennett,0,11,30,30
1650223506152,MATH 142A,B02,083222,Chow; Bennett,0,12,30,30
1650223512177,MATH 193A,A01,083224,Staff,0,5,30,30
1650223512177,MATH 193A,A02,083225,Staff,0,4,30,30
1650223512177,MATH 193A,A03,083781,Staff,0,2,30,30
1650223512177,MATH 193A,A04,083782,Staff,0,1,30,30
1650223518205,MATH 197,001,091859,McAuley; Julian John,9998,0,9999,1
1650223524260,COGS 9,A01,083615,Staff,0,14,60,60
1650223530286,COGS 11,A01,083617,Boyle; Mary E. T.,24,0,40,16
1650223536311,COGS 13,A01,083071,Staff,0,30,40,40
1650223542335,COGS 14A,A01,092681,Staff,0,12,100,100
1650223548362,COGS 14B,A01,083073,Cheng; Tzu-Han,0,7,50,50
1650223554387,COGS 17,A01,092677,Staff,35,0,75,40
1650223560414,COGS 100,A01,083619,Staff,0,21,60,60
1650223566436,COGS 101A,A01,083621,Davis; Joshua Daniel,0,21,60,60
1650223572461,COGS 101B,A01,091572,Staff,6,0,60,54
1650223578483,COGS 101C,A01,083625,Delgado; Tania,20,0,30,10
1650223584507,COGS 107A,A01,083627,Boyle; Mary E. T.,1,7,60,59
1650223590528,COGS 118A,A01,083075,Staff,16,0,60,44
1650223596556,CSE 3,A50,083646,Miranda; Gregory Joseph,22,0,38,16
1650223596556,CSE 3,A51,083647,Miranda; Gregory Joseph,37,0,37,0
1650223602577,CSE 8A,A50,083650,Miranda; Gregory Joseph,0,17,40,40
1650223608599,CSE 11,A01,083080,Cao; Yingjun,0,68,40,40
1650223614622,CSE 12,A01,083652,Staff,0,8,100,100
1650223620646,CSE 15L,A01,083654,Staff,0,1,50,50
1650223620646,CSE 15L,A02,083655,Staff,6,0,50,44
1650223626757,CSE 20,A01,083657,Staff,53,0,80,27
1650223632780,CSE 30,A01,083084,Eldon; John,0,70,40,40
1650223638806,CSE 100,A01,083659,Cao; Yingjun,0,63,50,50
1650223644828,CSE 134B,A01,083661,Powell; Thomas Allan,0,27,65,65
1650223650854,CSE 140,A01,083663,Staff,1,0,75,74
1650223656882,CSE 140L,A01,083088,Eldon; John,0,4,75,75
1650223662906,CSE 175,A01,083665,Kumar; Rakesh,8,0,25,17
1650223668933,CSE 190,A00,092507,Dubnov; Shlomo,14,0,20,6
1650223674960,ECE 45,A01,083139,Staff,0,13,40,40
1650223680987,ECE 65,A50,083695,Staff,0,5,30,30
1650223687009,ECE 109,A01,091882,Touri; Behrouz,47,0,70,23
1650223693033,ECE 180,A00,083140,Abi Samra; Nicholas Camill,24,0,30,6
1650223693033,ECE 180,B00,083141,Abi Samra; Nicholas Camill,8,0,30,22
1650223699058,MATH 10A,A01,083735,Patchell; Gregory David,11,0,30,19
1650223699058,MATH 10A,A02,083736,Patchell; Gregory David,28,0,30,2
1650223699058,MATH 10A,A03,083737,Patchell; Gregory David,26,0,30,4
1650223705090,MATH 10B,A01,083207,Staff,0,6,30,30
1650223705090,MATH 10B,A02,083208,Staff,0,5,30,30
1650223705090,MATH 10B,B01,083739,Staff,17,0,30,13
1650223705090,MATH 10B,B02,083740,Staff,29,0,30,1
1650223711113,MATH 18,A01,083743,Staff,8,0,30,22
1650223711113,MATH 18,A02,083744,Staff,28,0,30,2
1650223711113,MATH 18,A03,083745,Staff,23,0,30,7
1650223711113,MATH 18,A04,083746,Staff,27,0,30,3
1650223711113,MATH 18,B01,083748,Staff,0,10,30,30
1650223711113,MATH 18,B02,083749,Staff,0,7,30,30
1650223711113,MATH 18,B03,083750,Staff,0,7,30,30
1650223711113,MATH 18,B04,083751,Staff,0,8,30,30
1650223717139,MATH 20A,A01,083754,Staff,26,0,40,14
1650223723167,MATH 20B,A01,083756,Staff,1,6,30,29
1650223723167,MATH 20B,A02,083757,Staff,0,6,30,30
1650223729190,MATH 20C,A01,083760,Staff,0,12,30,30
1650223729190,MATH 20C,A02,083761,Staff,0,12,30,30
1650223729190,MATH 20C,B01,083762,Staff,14,0,30,16
1650223729190,MATH 20C,B02,083763,Staff,28,0,30,2
1650223735217,MATH 20D,A01,083765,Staff,1,2,30,29
1650223735217,MATH 20D,A02,083766,Staff,10,0,30,20
1650223735217,MATH 20D,A03,083767,Staff,28,0,30,2
1650223741240,MATH 20E,A01,083771,Staff,8,0,30,22
1650223741240,MATH 20E,A02,083772,Staff,20,0,30,10
1650223741240,MATH 20E,B01,083773,Staff,0,0,30,30
1650223741240,MATH 20E,B02,083774,Staff,12,0,30,18
1650223747263,MATH 103A,A01,083777,Staff,0,9,30,30
1650223747263,MATH 103A,A02,083778,Staff,0,10,30,30
1650223747263,MATH 103A,B01,083779,Staff,0,9,30,30
1650223747263,MATH 103A,B02,083780,Staff,0,9,30,30
1650223753288,MATH 105,A01,085443,Staff,0,17,30,30
1650223759312,MATH 109,A01,083213,Anzaldo; Leesa B,0,3,30,30
1650223759312,MATH 109,A02,083214,Anzaldo; Leesa B,0,6,30,30
1650223759312,MATH 109,B01,083215,Anzaldo; Leesa B,0,4,30,30
1650223759312,MATH 109,B02,083216,Anzaldo; Leesa B,0,4,30,30
1650223765335,MATH 142A,A01,083219,Chow; Bennett,0,12,30,30
1650223765335,MATH 142A,A02,083220,Chow; Bennett,0,11,30,30
1650223765335,MATH 142A,B01,083221,Chow; Bennett,0,11,30,30
1650223765335,MATH 142A,B02,083222,Chow; Bennett,0,12,30,30
1650223771363,MATH 193A,A01,083224,Staff,0,5,30,30
1650223771363,MATH 193A,A02,083225,Staff,0,4,30,30
1650223771363,MATH 193A,A03,083781,Staff,0,2,30,30
1650223771363,MATH 193A,A04,083782,Staff,0,1,30,30
1650223777386,MATH 197,001,091859,McAuley; Julian John,9998,0,9999,1
1650223783441,COGS 9,A01,083615,Staff,0,14,60,60
1650223789465,COGS 11,A01,083617,Boyle; Mary E. T.,24,0,40,16
1650223795489,COGS 13,A01,083071,Staff,0,30,40,40
1650223801516,COGS 14A,A01,092681,Staff,0,12,100,100
1650223807539,COGS 14B,A01,083073,Cheng; Tzu-Han,0,7,50,50
1650223813565,COGS 17,A01,092677,Staff,35,0,75,40
1650223819589,COGS 100,A01,083619,Staff,0,21,60,60
1650223825617,COGS 101A,A01,083621,Davis; Joshua Daniel,0,21,60,60
1650223831642,COGS 101B,A01,091572,Staff,6,0,60,54
1650223837666,COGS 101C,A01,083625,Delgado; Tania,20,0,30,10
1650223843688,COGS 107A,A01,083627,Boyle; Mary E. T.,1,7,60,59
1650223849713,COGS 118A,A01,083075,Staff,16,0,60,44
1650223855745,CSE 3,A50,083646,Miranda; Gregory Joseph,22,0,38,16
1650223855745,CSE 3,A51,083647,Miranda; Gregory Joseph,37,0,37,0
1650223861771,CSE 8A,A50,083650,Miranda; Gregory Joseph,0,17,40,40
1650223867794,CSE 11,A01,083080,Cao; Yingjun,0,68,40,40
1650223873821,CSE 12,A01,083652,Staff,0,8,100,100
1650223879846,CSE 15L,A01,083654,Staff,0,1,50,50
1650223879846,CSE 15L,A02,083655,Staff,6,0,50,44
1650223885873,CSE 20,A01,083657,Staff,53,0,80,27
1650223891901,CSE 30,A01,083084,Eldon; John,0,70,40,40
1650223897924,CSE 100,A01,083659,Cao; Yingjun,0,63,50,50
1650223903951,CSE 134B,A01,083661,Powell; Thomas Allan,0,27,65,65
1650223909979,CSE 140,A01,083663,Staff,1,0,75,74
1650223916003,CSE 140L,A01,083088,Eldon; John,0,4,75,75
1650223922026,CSE 175,A01,083665,Kumar; Rakesh,8,0,25,17
1650223928048,CSE 190,A00,092507,Dubnov; Shlomo,14,0,20,6
1650223934073,ECE 45,A01,083139,Staff,0,13,40,40
1650223940106,ECE 65,A50,083695,Staff,0,5,30,30
1650223946129,ECE 109,A01,091882,Touri; Behrouz,47,0,70,23
1650223952156,ECE 180,A00,083140,Abi Samra; Nicholas Camill,24,0,30,6
1650223952156,ECE 180,B00,083141,Abi Samra; Nicholas Camill,8,0,30,22
1650223958181,MATH 10A,A01,083735,Patchell; Gregory David,11,0,30,19
1650223958181,MATH 10A,A02,083736,Patchell; Gregory David,28,0,30,2
1650223958181,MATH 10A,A03,083737,Patchell; Gregory David,26,0,30,4
1650223964204,MATH 10B,A01,083207,Staff,0,6,30,30
1650223964204,MATH 10B,A02,083208,Staff,0,5,30,30
1650223964204,MATH 10B,B01,083739,Staff,17,0,30,13
1650223964204,MATH 10B,B02,083740,Staff,29,0,30,1
1650223970234,MATH 18,A01,083743,Staff,8,0,30,22
1650223970234,MATH 18,A02,083744,Staff,28,0,30,2
1650223970234,MATH 18,A03,083745,Staff,23,0,30,7
1650223970234,MATH 18,A04,083746,Staff,27,0,30,3
1650223970234,MATH 18,B01,083748,Staff,0,10,30,30
1650223970234,MATH 18,B02,083749,Staff,0,7,30,30
1650223970234,MATH 18,B03,083750,Staff,0,7,30,30
1650223970234,MATH 18,B04,083751,Staff,0,8,30,30
1650223976258,MATH 20A,A01,083754,Staff,26,0,40,14
1650223982278,MATH 20B,A01,083756,Staff,1,6,30,29
1650223982278,MATH 20B,A02,083757,Staff,0,6,30,30
1650223988306,MATH 20C,A01,083760,Staff,0,12,30,30
1650223988306,MATH 20C,A02,083761,Staff,0,12,30,30
1650223988306,MATH 20C,B01,083762,Staff,14,0,30,16
1650223988306,MATH 20C,B02,083763,Staff,28,0,30,2
1650223994332,MATH 20D,A01,083765,Staff,1,2,30,29
1650223994332,MATH 20D,A02,083766,Staff,10,0,30,20
1650223994332,MATH 20D,A03,083767,Staff,28,0,30,2
1650224000354,MATH 20E,A01,083771,Staff,8,0,30,22
1650224000354,MATH 20E,A02,083772,Staff,20,0,30,10
1650224000354,MATH 20E,B01,083773,Staff,0,0,30,30
1650224000354,MATH 20E,B02,083774,Staff,12,0,30,18
1650224006379,MATH 103A,A01,083777,Staff,0,9,30,30
1650224006379,MATH 103A,A02,083778,Staff,0,10,30,30
1650224006379,MATH 103A,B01,083779,Staff,0,9,30,30
1650224006379,MATH 103A,B02,083780,Staff,0,9,30,30
1650224012401,MATH 105,A01,085443,Staff,0,17,30,30
1650224018425,MATH 109,A01,083213,Anzaldo; Leesa B,0,3,30,30
1650224018425,MATH 109,A02,083214,Anzaldo; Leesa B,0,6,30,30
1650224018425,MATH 109,B01,083215,Anzaldo; Leesa B,0,4,30,30
1650224018425,MATH 109,B02,083216,Anzaldo; Leesa B,0,4,30,30
1650224024449,MATH 142A,A01,083219,Chow; Bennett,0,12,30,30
1650224024449,MATH 142A,A02,083220,Chow; Bennett,0,11,30,30
1650224024449,MATH 142A,B01,083221,Chow; Bennett,0,11,30,30
1650224024449,MATH 142A,B02,083222,Chow; Bennett,0,12,30,30
1650224030472,MATH 193A,A01,083224,Staff,0,5,30,30
1650224030472,MATH 193A,A02,083225,Staff,0,4,30,30
1650224030472,MATH 193A,A03,083781,Staff,0,2,30,30
1650224030472,MATH 193A,A04,083782,Staff,0,1,30,30
1650224036503,MATH 197,001,091859,McAuley; Julian John,9998,0,9999,1
1650224042559,COGS 9,A01,083615,Staff,0,14,60,60
1650224048590,COGS 11,A01,083617,Boyle; Mary E. T.,24,0,40,16
1650224054616,COGS 13,A01,083071,Staff,0,30,40,40
1650224060642,COGS 14A,A01,092681,Staff,0,12,100,100
1650224066665,COGS 14B,A01,083073,Cheng; Tzu-Han,0,7,50,50
1650224072689,COGS 17,A01,092677,Staff,35,0,75,40
1650224078714,COGS 100,A01,083619,Staff,0,21,60,60
1650224084739,COGS 101A,A01,083621,Davis; Joshua Daniel,0,21,60,60
1650224090763,COGS 101B,A01,091572,Staff,6,0,60,54
1650224096788,COGS 101C,A01,083625,Delgado; Tania,20,0,30,10
1650224102814,COGS 107A,A01,083627,Boyle; Mary E. T.,1,7,60,59
1650224108835,COGS 118A,A01,083075,Staff,16,0,60,44
1650224114863,CSE 3,A50,083646,Miranda; Gregory Joseph,22,0,38,16
1650224114863,CSE 3,A51,083647,Miranda; Gregory Joseph,37,0,37,0
1650224120890,CSE 8A,A50,083650,Miranda; Gregory Joseph,0,17,40,40
1650224126924,CSE 11,A01,083080,Cao; Yingjun,0,68,40,40
1650224132948,CSE 12,A01,083652,Staff,0,8,100,100
1650224138971,CSE 15L,A01,083654,Staff,0,1,50,50
1650224138971,CSE 15L,A02,083655,Staff,6,0,50,44
1650224144996,CSE 20,A01,083657,Staff,53,0,80,27
1650224151020,CSE 30,A01,083084,Eldon; John,0,70,40,40
1650224157043,CSE 100,A01,083659,Cao; Yingjun,0,63,50,50
1650224163068,CSE 134B,A01,083661,Powell; Thomas Allan,0,27,65,65
1650224169093,CSE 140,A01,083663,Staff,1,0,75,74
1650224175118,CSE 140L,A01,083088,Eldon; John,0,4,75,75
1650224181145,CSE 175,A01,083665,Kumar; Rakesh,8,0,25,17
1650224187173,CSE 190,A00,092507,Dubnov; Shlomo,14,0,20,6
1650224193201,ECE 45,A01,083139,Staff,0,13,40,40
1650224199229,ECE 65,A50,083695,Staff,0,5,30,30
1650224205256,ECE 109,A01,091882,Touri; Behrouz,47,0,70,23
1650224211280,ECE 180,A00,083140,Abi Samra; Nicholas Camill,24,0,30,6
1650224211280,ECE 180,B00,083141,Abi Samra; Nicholas Camill,8,0,30,22
1650224217306,MATH 10A,A01,083735,Patchell; Gregory David,11,0,30,19
1650224217306,MATH 10A,A02,083736,Patchell; Gregory David,28,0,30,2
1650224217306,MATH 10A,A03,083737,Patchell; Gregory David,26,0,30,4
1650224223422,MATH 10B,A01,083207,Staff,0,6,30,30
1650224223422,MATH 10B,A02,083208,Staff,0,5,30,30
1650224223422,MATH 10B,B01,083739,Staff,17,0,30,13
1650224223422,MATH 10B,B02,083740,Staff,29,0,30,1
1650224229452,MATH 18,A01,083743,Staff,8,0,30,22
1650224229452,MATH 18,A02,083744,Staff,28,0,30,2
1650224229452,MATH 18,A03,083745,Staff,23,0,30,7
1650224229452,MATH 18,A04,083746,Staff,27,0,30,3
1650224229452,MATH 18,B01,083748,Staff,0,10,30,30
1650224229452,MATH 18,B02,083749,Staff,0,7,30,30
1650224229452,MATH 18,B03,083750,Staff,0,7,30,30
1650224229452,MATH 18,B04,083751,Staff,0,8,30,30
1650224235479,MATH 20A,A01,083754,Staff,26,0,40,14
1650224241509,MATH 20B,A01,083756,Staff,1,6,30,29
1650224241509,MATH 20B,A02,083757,Staff,0,6,30,30
1650224247533,MATH 20C,A01,083760,Staff,0,12,30,30
1650224247533,MATH 20C,A02,083761,Staff,0,12,30,30
1650224247533,MATH 20C,B01,083762,Staff,14,0,30,16
1650224247533,MATH 20C,B02,083763,Staff,28,0,30,2
1650224253558,MATH 20D,A01,083765,Staff,1,2,30,29
1650224253558,MATH 20D,A02,083766,Staff,10,0,30,20
1650224253558,MATH 20D,A03,083767,Staff,28,0,30,2
1650224259587,MATH 20E,A01,083771,Staff,8,0,30,22
1650224259587,MATH 20E,A02,083772,Staff,20,0,30,10
1650224259587,MATH 20E,B01,083773,Staff,0,0,30,30
1650224259587,MATH 20E,B02,083774,Staff,12,0,30,18
1650224265611,MATH 103A,A01,083777,Staff,0,9,30,30
1650224265611,MATH 103A,A02,083778,Staff,0,10,30,30
1650224265611,MATH 103A,B01,083779,Staff,0,9,30,30
1650224265611,MATH 103A,B02,083780,Staff,0,9,30,30
1650224271638,MATH 105,A01,085443,Staff,0,17,30,30
1650224277668,MATH 109,A01,083213,Anzaldo; Leesa B,0,3,30,30
1650224277668,MATH 109,A02,083214,Anzaldo; Leesa B,0,6,30,30
1650224277668,MATH 109,B01,083215,Anzaldo; Leesa B,0,4,30,30
1650224277668,MATH 109,B02,083216,Anzaldo; Leesa B,0,4,30,30
1650224283699,MATH 142A,A01,083219,Chow; Bennett,0,12,30,30
1650224283699,MATH 142A,A02,083220,Chow; Bennett,0,11,30,30
1650224283699,MATH 142A,B01,083221,Chow; Bennett,0,11,30,30
1650224283699,MATH 142A,B02,083222,Chow; Bennett,0,12,30,30
1650224289729,MATH 193A,A01,083224,Staff,0,5,30,30
1650224289729,MATH 193A,A02,083225,Staff,0,4,30,30
1650224289729,MATH 193A,A03,083781,Staff,0,2,30,30
1650224289729,MATH 193A,A04,083782,Staff,0,1,30,30
1650224295750,MATH 197,001,091859,McAuley; Julian John,9998,0,9999,1
1650224301811,COGS 9,A01,083615,Staff,0,14,60,60
1650224307841,COGS 11,A01,083617,Boyle; Mary E. T.,24,0,40,16
1650224313887,COGS 13,A01,083071,Staff,0,30,40,40
1650224319912,COGS 14A,A01,092681,Staff,0,12,100,100
1650224325958,COGS 14B,A01,083073,Cheng; Tzu-Han,0,7,50,50
1650224331982,COGS 17,A01,092677,Staff,35,0,75,40
1650224338006,COGS 100,A01,083619,Staff,0,21,60,60
1650224344035,COGS 101A,A01,083621,Davis; Joshua Daniel,0,21,60,60
1650224350058,COGS 101B,A01,091572,Staff,6,0,60,54
1650224356086,COGS 101C,A01,083625,Delgado; Tania,20,0,30,10
1650224362113,COGS 107A,A01,083627,Boyle; Mary E. T.,1,7,60,59
1650224368140,COGS 118A,A01,083075,Staff,16,0,60,44
1650224374165,CSE 3,A50,083646,Miranda; Gregory Joseph,22,0,38,16
1650224374165,CSE 3,A51,083647,Miranda; Gregory Joseph,37,0,37,0
1650224380192,CSE 8A,A50,083650,Miranda; Gregory Joseph,0,17,40,40
1650224386217,CSE 11,A01,083080,Cao; Yingjun,0,68,40,40
1650224392244,CSE 12,A01,083652,Staff,0,8,100,100
1650224398271,CSE 15L,A01,083654,Staff,0,1,50,50
1650224398271,CSE 15L,A02,083655,Staff,6,0,50,44
1650224404304,CSE 20,A01,083657,Staff,53,0,80,27
1650224410328,CSE 30,A01,083084,Eldon; John,0,70,40,40
1650224416355,CSE 100,A01,083659,Cao; Yingjun,0,63,50,50
1650224422379,CSE 134B,A01,083661,Powell; Thomas Allan,0,27,65,65
1650224428403,CSE 140,A01,083663,Staff,1,0,75,74
1650224434429,CSE 140L,A01,083088,Eldon; John,0,4,75,75
1650224440461,CSE 175,A01,083665,Kumar; Rakesh,8,0,25,17
1650224446497,CSE 190,A00,092507,Dubnov; Shlomo,14,0,20,6
1650224452520,ECE 45,A01,083139,Staff,0,13,40,40
1650224458544,ECE 65,A50,083695,Staff,0,5,30,30
1650224464570,ECE 109,A01,091882,Touri; Behrouz,47,0,70,23
1650224470594,ECE 180,A00,083140,Abi Samra; Nicholas Camill,24,0,30,6
1650224470594,ECE 180,B00,083141,Abi Samra; Nicholas Camill,8,0,30,22
1650224476617,MATH 10A,A01,083735,Patchell; Gregory David,11,0,30,19
1650224476617,MATH 10A,A02,083736,Patchell; Gregory David,28,0,30,2
1650224476617,MATH 10A,A03,083737,Patchell; Gregory David,26,0,30,4
1650224482644,MATH 10B,A01,083207,Staff,0,6,30,30
1650224482644,MATH 10B,A02,083208,Staff,0,5,30,30
1650224482644,MATH 10B,B01,083739,Staff,17,0,30,13
1650224482644,MATH 10B,B02,083740,Staff,29,0,30,1
1650224488674,MATH 18,A01,083743,Staff,8,0,30,22
1650224488674,MATH 18,A02,083744,Staff,28,0,30,2
1650224488674,MATH 18,A03,083745,Staff,23,0,30,7
1650224488674,MATH 18,A04,083746,Staff,27,0,30,3
1650224488674,MATH 18,B01,083748,Staff,0,10,30,30
1650224488674,MATH 18,B02,083749,Staff,0,7,30,30
1650224488674,MATH 18,B03,083750,Staff,0,7,30,30
1650224488674,MATH 18,B04,083751,Staff,0,8,30,30
1650224494709,MATH 20A,A01,083754,Staff,26,0,40,14
1650224500735,MATH 20B,A01,083756,Staff,1,6,30,29
1650224500735,MATH 20B,A02,083757,Staff,0,6,30,30
1650224506760,MATH 20C,A01,083760,Staff,0,12,30,30
1650224506760,MATH 20C,A02,083761,Staff,0,12,30,30
1650224506760,MATH 20C,B01,083762,Staff,14,0,30,16
1650224506760,MATH 20C,B02,083763,Staff,28,0,30,2
1650224512788,MATH 20D,A01,083765,Staff,1,2,30,29
1650224512788,MATH 20D,A02,083766,Staff,10,0,30,20
1650224512788,MATH 20D,A03,083767,Staff,28,0,30,2
1650224518815,MATH 20E,A01,083771,Staff,8,0,30,22
1650224518815,MATH 20E,A02,083772,Staff,20,0,30,10
1650224518815,MATH 20E,B01,083773,Staff,0,0,30,30
1650224518815,MATH 20E,B02,083774,Staff,12,0,30,18
1650224524840,MATH 103A,A01,083777,Staff,0,9,30,30
1650224524840,MATH 103A,A02,083778,Staff,0,10,30,30
1650224524840,MATH 103A,B01,083779,Staff,0,9,30,30
1650224524840,MATH 103A,B02,083780,Staff,0,9,30,30
1650224530863,MATH 105,A01,085443,Staff,0,17,30,30
1650224536887,MATH 109,A01,083213,Anzaldo; Leesa B,0,3,30,30
1650224536887,MATH 109,A02,083214,Anzaldo; Leesa B,0,6,30,30
1650224536887,MATH 109,B01,083215,Anzaldo; Leesa B,0,4,30,30
1650224536887,MATH 109,B02,083216,Anzaldo; Leesa B,0,4,30,30
1650224542917,MATH 142A,A01,083219,Chow; Bennett,0,12,30,30
1650224542917,MATH 142A,A02,083220,Chow; Bennett,0,11,30,30
1650224542917,MATH 142A,B01,083221,Chow; Bennett,0,11,30,30
1650224542917,MATH 142A,B02,083222,Chow; Bennett,0,12,30,30
1650224548942,MATH 193A,A01,083224,Staff,0,5,30,30
1650224548942,MATH 193A,A02,083225,Staff,0,4,30,30
1650224548942,MATH 193A,A03,083781,Staff,0,2,30,30
1650224548942,MATH 193A,A04,083782,Staff,0,1,30,30
1650224554966,MATH 197,001,091859,McAuley; Julian John,9998,0,9999,1
1650224561031,COGS 9,A01,083615,Staff,0,14,60,60
1650224567056,COGS 11,A01,083617,Boyle; Mary E. T.,24,0,40,16
1650224573079,COGS 13,A01,083071,Staff,0,30,40,40
1650224579102,COGS 14A,A01,092681,Staff,0,12,100,100
1650224585126,COGS 14B,A01,083073,Cheng; Tzu-Han,0,7,50,50
1650224591156,COGS 17,A01,092677,Staff,35,0,75,40
1650224597184,COGS 100,A01,083619,Staff,0,21,60,60
1650224603207,COGS 101A,A01,083621,Davis; Joshua Daniel,0,21,60,60
1650224609230,COGS 101B,A01,091572,Staff,6,0,60,54
1650224615254,COGS 101C,A01,083625,Delgado; Tania,20,0,30,10
1650224621285,COGS 107A,A01,083627,Boyle; Mary E. T.,1,7,60,59
1650224627308,COGS 118A,A01,083075,Staff,15,0,60,45
1650224633334,CSE 3,A50,083646,Miranda; Gregory Joseph,22,0,38,16
1650224633334,CSE 3,A51,083647,Miranda; Gregory Joseph,37,0,37,0
1650224639358,CSE 8A,A50,083650,Miranda; Gregory Joseph,0,17,40,40
1650224645384,CSE 11,A01,083080,Cao; Yingjun,0,68,40,40
1650224651419,CSE 12,A01,083652,Staff,0,8,100,100
1650224657448,CSE 15L,A01,083654,Staff,0,1,50,50
1650224657448,CSE 15L,A02,083655,Staff,6,0,50,44
1650224663477,CSE 20,A01,083657,Staff,53,0,80,27
1650224669503,CSE 30,A01,083084,Eldon; John,0,70,40,40
1650224675529,CSE 100,A01,083659,Cao; Yingjun,0,63,50,50
1650224681551,CSE 134B,A01,083661,Powell; Thomas Allan,0,27,65,65
1650224687572,CSE 140,A01,083663,Staff,1,0,75,74
1650224693599,CSE 140L,A01,083088,Eldon; John,0,4,75,75
1650224699628,CSE 175,A01,083665,Kumar; Rakesh,8,0,25,17
1650224705650,CSE 190,A00,092507,Dubnov; Shlomo,14,0,20,6
1650224711674,ECE 45,A01,083139,Staff,0,13,40,40
1650224717701,ECE 65,A50,083695,Staff,0,5,30,30
1650224723724,ECE 109,A01,091882,Touri; Behrouz,47,0,70,23
1650224729751,ECE 180,A00,083140,Abi Samra; Nicholas Camill,24,0,30,6
1650224729751,ECE 180,B00,083141,Abi Samra; Nicholas Camill,8,0,30,22
1650224735777,MATH 10A,A01,083735,Patchell; Gregory David,11,0,30,19
1650224735777,MATH 10A,A02,083736,Patchell; Gregory David,28,0,30,2
1650224735777,MATH 10A,A03,083737,Patchell; Gregory David,26,0,30,4
1650224741805,MATH 10B,A01,083207,Staff,0,6,30,30
1650224741805,MATH 10B,A02,083208,Staff,0,5,30,30
1650224741805,MATH 10B,B01,083739,Staff,17,0,30,13
1650224741805,MATH 10B,B02,083740,Staff,29,0,30,1
1650224747837,MATH 18,A01,083743,Staff,8,0,30,22
1650224747837,MATH 18,A02,083744,Staff,28,0,30,2
1650224747837,MATH 18,A03,083745,Staff,23,0,30,7
1650224747837,MATH 18,A04,083746,Staff,27,0,30,3
1650224747837,MATH 18,B01,083748,Staff,0,10,30,30
1650224747837,MATH 18,B02,083749,Staff,0,7,30,30
1650224747837,MATH 18,B03,083750,Staff,0,7,30,30
1650224747837,MATH 18,B04,083751,Staff,0,8,30,30
1650224753864,MATH 20A,A01,083754,Staff,26,0,40,14
1650224759888,MATH 20B,A01,083756,Staff,1,6,30,29
1650224759888,MATH 20B,A02,083757,Staff,0,6,30,30
1650224765912,MATH 20C,A01,083760,Staff,0,12,30,30
1650224765912,MATH 20C,A02,083761,Staff,0,12,30,30
1650224765912,MATH 20C,B01,083762,Staff,14,0,30,16
1650224765912,MATH 20C,B02,083763,Staff,28,0,30,2
1650224771936,MATH 20D,A01,083765,Staff,1,2,30,29
1650224771936,MATH 20D,A02,083766,Staff,10,0,30,20
1650224771936,MATH 20D,A03,083767,Staff,28,0,30,2
1650224777959,MATH 20E,A01,083771,Staff,8,0,30,22
1650224777959,MATH 20E,A02,083772,Staff,20,0,30,10
1650224777959,MATH 20E,B01,083773,Staff,0,0,30,30
1650224777959,MATH 20E,B02,083774,Staff,12,0,30,18
1650224783984,MATH 103A,A01,083777,Staff,0,9,30,30
1650224783984,MATH 103A,A02,083778,Staff,0,10,30,30
1650224783984,MATH 103A,B01,083779,Staff,0,9,30,30
1650224783984,MATH 103A,B02,083780,Staff,0,9,30,30
1650224790009,MATH 105,A01,085443,Staff,0,17,30,30
1650224796034,MATH 109,A01,083213,Anzaldo; Leesa B,0,3,30,30
1650224796034,MATH 109,A02,083214,Anzaldo; Leesa B,0,6,30,30
1650224796034,MATH 109,B01,083215,Anzaldo; Leesa B,0,4,30,30
1650224796034,MATH 109,B02,083216,Anzaldo; Leesa B,0,4,30,30
1650224802057,MATH 142A,A01,083219,Chow; Bennett,0,12,30,30
1650224802057,MATH 142A,A02,083220,Chow; Bennett,0,11,30,30
1650224802057,MATH 142A,B01,083221,Chow; Bennett,0,11,30,30
1650224802057,MATH 142A,B02,083222,Chow; Bennett,0,12,30,30
1650224808081,MATH 193A,A01,083224,Staff,0,5,30,30
1650224808081,MATH 193A,A02,083225,Staff,0,4,30,30
1650224808081,MATH 193A,A03,083781,Staff,0,2,30,30
1650224808081,MATH 193A,A04,083782,Staff,0,1,30,30
1650224814108,MATH 197,001,091859,McAuley; Julian John,9998,0,9999,1
1650224820258,COGS 9,A01,083615,Staff,0,14,60,60
1650224826288,COGS 11,A01,083617,Boyle; Mary E. T.,24,0,40,16
1650224832311,COGS 13,A01,083071,Staff,0,30,40,40
1650224838334,COGS 14A,A01,092681,Staff,0,12,100,100
1650224844356,COGS 14B,A01,083073,Cheng; Tzu-Han,0,7,50,50
1650224850383,COGS 17,A01,092677,Staff,35,0,75,40
1650224856406,COGS 100,A01,083619,Staff,0,21,60,60
1650224862429,COGS 101A,A01,083621,Davis; Joshua Daniel,0,21,60,60
1650224868454,COGS 101B,A01,091572,Staff,6,0,60,54
1650224874476,COGS 101C,A01,083625,Delgado; Tania,20,0,30,10
1650224880501,COGS 107A,A01,083627,Boyle; Mary E. T.,1,7,60,59
1650224886525,COGS 118A,A01,083075,Staff,15,0,60,45
1650224892548,CSE 3,A50,083646,Miranda; Gregory Joseph,22,0,38,16
1650224892548,CSE 3,A51,083647,Miranda; Gregory Joseph,37,0,37,0
1650224898573,CSE 8A,A50,083650,Miranda; Gregory Joseph,0,17,40,40
1650224904597,CSE 11,A01,083080,Cao; Yingjun,0,68,40,40
1650224910623,CSE 12,A01,083652,Staff,0,8,100,100
1650224916649,CSE 15L,A01,083654,Staff,0,1,50,50
1650224916649,CSE 15L,A02,083655,Staff,6,0,50,44
1650224922673,CSE 20,A01,083657,Staff,53,0,80,27
1650224928700,CSE 30,A01,083084,Eldon; John,0,70,40,40
1650224934726,CSE 100,A01,083659,Cao; Yingjun,0,63,50,50
1650224940757,CSE 134B,A01,083661,Powell; Thomas Allan,0,27,65,65
1650224946783,CSE 140,A01,083663,Staff,1,0,75,74
1650224952805,CSE 140L,A01,083088,Eldon; John,0,4,75,75
1650224958831,CSE 175,A01,083665,Kumar; Rakesh,8,0,25,17
1650224964852,CSE 190,A00,092507,Dubnov; Shlomo,14,0,20,6
1650224970875,ECE 45,A01,083139,Staff,0,13,40,40
1650224976904,ECE 65,A50,083695,Staff,0,5,30,30
1650224982942,ECE 109,A01,091882,Touri; Behrouz,47,0,70,23
1650224988970,ECE 180,A00,083140,Abi Samra; Nicholas Camill,24,0,30,6
1650224988970,ECE 180,B00,083141,Abi Samra; Nicholas Camill,8,0,30,22
1650224995002,MATH 10A,A01,083735,Patchell; Gregory David,11,0,30,19
1650224995002,MATH 10A,A02,083736,Patchell; Gregory David,28,0,30,2
1650224995002,MATH 10A,A03,083737,Patchell; Gregory David,26,0,30,4
1650225001030,MATH 10B,A01,083207,Staff,0,6,30,30
1650225001030,MATH 10B,A02,083208,Staff,0,5,30,30
1650225001030,MATH 10B,B01,083739,Staff,17,0,30,13
1650225001030,MATH 10B,B02,083740,Staff,29,0,30,1
1650225007053,MATH 18,A01,083743,Staff,8,0,30,22
1650225007053,MATH 18,A02,083744,Staff,28,0,30,2
1650225007053,MATH 18,A03,083745,Staff,23,0,30,7
1650225007053,MATH 18,A04,083746,Staff,27,0,30,3
1650225007053,MATH 18,B01,083748,Staff,0,10,30,30
1650225007053,MATH 18,B02,083749,Staff,0,7,30,30
1650225007053,MATH 18,B03,083750,Staff,0,7,30,30
1650225007053,MATH 18,B04,083751,Staff,0,8,30,30
1650225013076,MATH 20A,A01,083754,Staff,26,0,40,14
1650225019110,MATH 20B,A01,083756,Staff,1,6,30,29
1650225019110,MATH 20B,A02,083757,Staff,0,6,30,30
1650225025140,MATH 20C,A01,083760,Staff,0,12,30,30
1650225025140,MATH 20C,A02,083761,Staff,0,12,30,30
1650225025140,MATH 20C,B01,083762,Staff,14,0,30,16
1650225025140,MATH 20C,B02,083763,Staff,28,0,30,2
1650225031163,MATH 20D,A01,083765,Staff,1,2,30,29
1650225031163,MATH 20D,A02,083766,Staff,10,0,30,20
1650225031163,MATH 20D,A03,083767,Staff,28,0,30,2
1650225037193,MATH 20E,A01,083771,Staff,8,0,30,22
1650225037193,MATH 20E,A02,083772,Staff,20,0,30,10
1650225037193,MATH 20E,B01,083773,Staff,0,0,30,30
1650225037193,MATH 20E,B02,083774,Staff,12,0,30,18
1650225043222,MATH 103A,A01,083777,Staff,0,9,30,30
1650225043222,MATH 103A,A02,083778,Staff,0,10,30,30
1650225043222,MATH 103A,B01,083779,Staff,0,9,30,30
1650225043222,MATH 103A,B02,083780,Staff,0,9,30,30
1650225049244,MATH 105,A01,085443,Staff,0,17,30,30
1650225055271,MATH 109,A01,083213,Anzaldo; Leesa B,0,3,30,30
1650225055271,MATH 109,A02,083214,Anzaldo; Leesa B,0,6,30,30
1650225055271,MATH 109,B01,083215,Anzaldo; Leesa B,0,4,30,30
1650225055271,MATH 109,B02,083216,Anzaldo; Leesa B,0,4,30,30
1650225061299,MATH 142A,A01,083219,Chow; Bennett,0,12,30,30
1650225061299,MATH 142A,A02,083220,Chow; Bennett,0,11,30,30
1650225061299,MATH 142A,B01,083221,Chow; Bennett,0,11,30,30
1650225061299,MATH 142A,B02,083222,Chow; Bennett,0,12,30,30
1650225067322,MATH 193A,A01,083224,Staff,0,5,30,30
1650225067322,MATH 193A,A02,083225,Staff,0,4,30,30
1650225067322,MATH 193A,A03,083781,Staff,0,2,30,30
1650225067322,MATH 193A,A04,083782,Staff,0,1,30,30
1650225073347,MATH 197,001,091859,McAuley; Julian John,9998,0,9999,1
1650225079397,COGS 9,A01,083615,Staff,0,14,60,60
1650225085427,COGS 11,A01,083617,Boyle; Mary E. T.,24,0,40,16
1650225091451,COGS 13,A01,083071,Staff,0,30,40,40
1650225097481,COGS 14A,A01,092681,Staff,0,12,100,100
1650225103516,COGS 14B,A01,083073,Cheng; Tzu-Han,0,7,50,50
1650225109540,COGS 17,A01,092677,Staff,35,0,75,40
1650225115563,COGS 100,A01,083619,Staff,0,21,60,60
1650225121595,COGS 101A,A01,083621,Davis; Joshua Daniel,0,21,60,60
1650225127619,COGS 101B,A01,091572,Staff,6,0,60,54
1650225133644,COGS 101C,A01,083625,Delgado; Tania,20,0,30,10
1650225139673,COGS 107A,A01,083627,Boyle; Mary E. T.,1,7,60,59
1650225145697,COGS 118A,A01,083075,Staff,15,0,60,45
1650225151719,CSE 3,A50,083646,Miranda; Gregory Joseph,22,0,38,16
1650225151719,CSE 3,A51,083647,Miranda; Gregory Joseph,37,0,37,0
1650225157744,CSE 8A,A50,083650,Miranda; Gregory Joseph,0,17,40,40
1650225163770,CSE 11,A01,083080,Cao; Yingjun,0,68,40,40
1650225169793,CSE 12,A01,083652,Staff,0,8,100,100
1650225175818,CSE 15L,A01,083654,Staff,0,1,50,50
1650225175818,CSE 15L,A02,083655,Staff,6,0,50,44
1650225181847,CSE 20,A01,083657,Staff,53,0,80,27
1650225187871,CSE 30,A01,083084,Eldon; John,0,70,40,40
1650225193897,CSE 100,A01,083659,Cao; Yingjun,0,63,50,50
1650225199921,CSE 134B,A01,083661,Powell; Thomas Allan,0,27,65,65
1650225205947,CSE 140,A01,083663,Staff,1,0,75,74
1650225211973,CSE 140L,A01,083088,Eldon; John,0,4,75,75
1650225218000,CSE 175,A01,083665,Kumar; Rakesh,8,0,25,17
1650225224022,CSE 190,A00,092507,Dubnov; Shlomo,14,0,20,6
1650225230053,ECE 45,A01,083139,Staff,0,13,40,40
1650225236076,ECE 65,A50,083695,Staff,0,5,30,30
1650225242098,ECE 109,A01,091882,Touri; Behrouz,47,0,70,23
1650225248122,ECE 180,A00,083140,Abi Samra; Nicholas Camill,24,0,30,6
1650225248122,ECE 180,B00,083141,Abi Samra; Nicholas Camill,8,0,30,22
1650225254149,MATH 10A,A01,083735,Patchell; Gregory David,11,0,30,19
1650225254149,MATH 10A,A02,083736,Patchell; Gregory David,28,0,30,2
1650225254149,MATH 10A,A03,083737,Patchell; Gregory David,26,0,30,4
1650225260174,MATH 10B,A01,083207,Staff,0,6,30,30
1650225260174,MATH 10B,A02,083208,Staff,0,5,30,30
1650225260174,MATH 10B,B01,083739,Staff,17,0,30,13
1650225260174,MATH 10B,B02,083740,Staff,29,0,30,1
1650225266198,MATH 18,A01,083743,Staff,8,0,30,22
1650225266198,MATH 18,A02,083744,Staff,28,0,30,2
1650225266198,MATH 18,A03,083745,Staff,23,0,30,7
1650225266198,MATH 18,A04,083746,Staff,27,0,30,3
1650225266198,MATH 18,B01,083748,Staff,0,10,30,30
1650225266198,MATH 18,B02,083749,Staff,0,7,30,30
1650225266198,MATH 18,B03,083750,Staff,0,7,30,30
1650225266198,MATH 18,B04,083751,Staff,0,8,30,30
1650225272224,MATH 20A,A01,083754,Staff,26,0,40,14
1650225278246,MATH 20B,A01,083756,Staff,1,6,30,29
1650225278246,MATH 20B,A02,083757,Staff,0,6,30,30
1650225284276,MATH 20C,A01,083760,Staff,0,12,30,30
1650225284276,MATH 20C,A02,083761,Staff,0,12,30,30
1650225284276,MATH 20C,B01,083762,Staff,14,0,30,16
1650225284276,MATH 20C,B02,083763,Staff,28,0,30,2
1650225290302,MATH 20D,A01,083765,Staff,1,2,30,29
1650225290302,MATH 20D,A02,083766,Staff,10,0,30,20
1650225290302,MATH 20D,A03,083767,Staff,28,0,30,2
1650225296327,MATH 20E,A01,083771,Staff,8,0,30,22
1650225296327,MATH 20E,A02,083772,Staff,20,0,30,10
1650225296327,MATH 20E,B01,083773,Staff,0,0,30,30
1650225296327,MATH 20E,B02,083774,Staff,12,0,30,18
1650225302350,MATH 103A,A01,083777,Staff,0,9,30,30
1650225302350,MATH 103A,A02,083778,Staff,0,10,30,30
1650225302350,MATH 103A,B01,083779,Staff,0,9,30,30
1650225302350,MATH 103A,B02,083780,Staff,0,9,30,30
1650225308373,MATH 105,A01,085443,Staff,0,17,30,30
1650225314407,MATH 109,A01,083213,Anzaldo; Leesa B,0,3,30,30
1650225314407,MATH 109,A02,083214,Anzaldo; Leesa B,0,6,30,30
1650225314407,MATH 109,B01,083215,Anzaldo; Leesa B,0,4,30,30
1650225314407,MATH 109,B02,083216,Anzaldo; Leesa B,0,4,30,30
1650225320434,MATH 142A,A01,083219,Chow; Bennett,0,12,30,30
1650225320434,MATH 142A,A02,083220,Chow; Bennett,0,11,30,30
1650225320434,MATH 142A,B01,083221,Chow; Bennett,0,11,30,30
1650225320434,MATH 142A,B02,083222,Chow; Bennett,0,12,30,30
1650225326456,MATH 193A,A01,083224,Staff,0,5,30,30
1650225326456,MATH 193A,A02,083225,Staff,0,4,30,30
1650225326456,MATH 193A,A03,083781,Staff,0,2,30,30
1650225326456,MATH 193A,A04,083782,Staff,0,1,30,30
1650225332486,MATH 197,001,091859,McAuley; Julian John,9998,0,9999,1
1650225338535,COGS 9,A01,083615,Staff,0,14,60,60
1650225344558,COGS 11,A01,083617,Boyle; Mary E. T.,24,0,40,16
1650225350582,COGS 13,A01,083071,Staff,0,30,40,40
1650225356606,COGS 14A,A01,092681,Staff,0,12,100,100
1650225362636,COGS 14B,A01,083073,Cheng; Tzu-Han,0,7,50,50
1650225368659,COGS 17,A01,092677,Staff,35,0,75,40
1650225374682,COGS 100,A01,083619,Staff,0,21,60,60
1650225380706,COGS 101A,A01,083621,Davis; Joshua Daniel,0,21,60,60
1650225386736,COGS 101B,A01,091572,Staff,6,0,60,54
1650225392760,COGS 101C,A01,083625,Delgado; Tania,20,0,30,10
1650225398788,COGS 107A,A01,083627,Boyle; Mary E. T.,1,7,60,59
1650225404820,COGS 118A,A01,083075,Staff,15,0,60,45
1650225410935,CSE 3,A50,083646,Miranda; Gregory Joseph,22,0,38,16
1650225410935,CSE 3,A51,083647,Miranda; Gregory Joseph,37,0,37,0
1650225416958,CSE 8A,A50,083650,Miranda; Gregory Joseph,0,17,40,40
1650225422988,CSE 11,A01,083080,Cao; Yingjun,0,68,40,40
1650225429015,CSE 12,A01,083652,Staff,0,8,100,100
1650225435043,CSE 15L,A01,083654,Staff,0,1,50,50
1650225435043,CSE 15L,A02,083655,Staff,6,0,50,44
1650225441069,CSE 20,A01,083657,Staff,53,0,80,27
1650225447093,CSE 30,A01,083084,Eldon; John,0,70,40,40
1650225453116,CSE 100,A01,083659,Cao; Yingjun,0,63,50,50
1650225459140,CSE 134B,A01,083661,Powell; Thomas Allan,0,27,65,65
1650225465162,CSE 140,A01,083663,Staff,1,0,75,74
1650225471188,CSE 140L,A01,083088,Eldon; John,0,4,75,75
1650225477211,CSE 175,A01,083665,Kumar; Rakesh,8,0,25,17
1650225483237,CSE 190,A00,092507,Dubnov; Shlomo,14,0,20,6
1650225489264,ECE 45,A01,083139,Staff,0,13,40,40
1650225495286,ECE 65,A50,083695,Staff,0,5,30,30
1650225501311,ECE 109,A01,091882,Touri; Behrouz,47,0,70,23
1650225507334,ECE 180,A00,083140,Abi Samra; Nicholas Camill,24,0,30,6
1650225507334,ECE 180,B00,083141,Abi Samra; Nicholas Camill,8,0,30,22
1650225513361,MATH 10A,A01,083735,Patchell; Gregory David,11,0,30,19
1650225513361,MATH 10A,A02,083736,Patchell; Gregory David,28,0,30,2
1650225513361,MATH 10A,A03,083737,Patchell; Gregory David,26,0,30,4
1650225519389,MATH 10B,A01,083207,Staff,0,6,30,30
1650225519389,MATH 10B,A02,083208,Staff,0,5,30,30
1650225519389,MATH 10B,B01,083739,Staff,17,0,30,13
1650225519389,MATH 10B,B02,083740,Staff,29,0,30,1
1650225525417,MATH 18,A01,083743,Staff,8,0,30,22
1650225525417,MATH 18,A02,083744,Staff,28,0,30,2
1650225525417,MATH 18,A03,083745,Staff,23,0,30,7
1650225525417,MATH 18,A04,083746,Staff,27,0,30,3
1650225525417,MATH 18,B01,083748,Staff,0,10,30,30
1650225525417,MATH 18,B02,083749,Staff,0,7,30,30
1650225525417,MATH 18,B03,083750,Staff,0,7,30,30
1650225525417,MATH 18,B04,083751,Staff,0,8,30,30
1650225531441,MATH 20A,A01,083754,Staff,26,0,40,14
1650225537471,MATH 20B,A01,083756,Staff,1,6,30,29
1650225537471,MATH 20B,A02,083757,Staff,0,6,30,30
1650225543501,MATH 20C,A01,083760,Staff,0,12,30,30
1650225543501,MATH 20C,A02,083761,Staff,0,12,30,30
1650225543501,MATH 20C,B01,083762,Staff,14,0,30,16
1650225543501,MATH 20C,B02,083763,Staff,28,0,30,2
1650225549525,MATH 20D,A01,083765,Staff,1,2,30,29
1650225549525,MATH 20D,A02,083766,Staff,10,0,30,20
1650225549525,MATH 20D,A03,083767,Staff,28,0,30,2
1650225555553,MATH 20E,A01,083771,Staff,8,0,30,22
1650225555553,MATH 20E,A02,083772,Staff,20,0,30,10
1650225555553,MATH 20E,B01,083773,Staff,0,0,30,30
1650225555553,MATH 20E,B02,083774,Staff,12,0,30,18
1650225561576,MATH 103A,A01,083777,Staff,0,9,30,30
1650225561576,MATH 103A,A02,083778,Staff,0,10,30,30
1650225561576,MATH 103A,B01,083779,Staff,0,9,30,30
1650225561576,MATH 103A,B02,083780,Staff,0,9,30,30
1650225567602,MATH 105,A01,085443,Staff,0,17,30,30
1650225573630,MATH 109,A01,083213,Anzaldo; Leesa B,0,3,30,30
1650225573630,MATH 109,A02,083214,Anzaldo; Leesa B,0,6,30,30
1650225573630,MATH 109,B01,083215,Anzaldo; Leesa B,0,4,30,30
1650225573630,MATH 109,B02,083216,Anzaldo; Leesa B,0,4,30,30
1650225579660,MATH 142A,A01,083219,Chow; Bennett,0,12,30,30
1650225579660,MATH 142A,A02,083220,Chow; Bennett,0,11,30,30
1650225579660,MATH 142A,B01,083221,Chow; Bennett,0,11,30,30
1650225579660,MATH 142A,B02,083222,Chow; Bennett,0,12,30,30
1650225585692,MATH 193A,A01,083224,Staff,0,5,30,30
1650225585692,MATH 193A,A02,083225,Staff,0,4,30,30
1650225585692,MATH 193A,A03,083781,Staff,0,2,30,30
1650225585692,MATH 193A,A04,083782,Staff,0,1,30,30
1650225591718,MATH 197,001,091859,McAuley; Julian John,9998,0,9999,1
1650225597776,COGS 9,A01,083615,Staff,0,14,60,60
1650225603799,COGS 11,A01,083617,Boyle; Mary E. T.,24,0,40,16
1650225609824,COGS 13,A01,083071,Staff,0,30,40,40
1650225615847,COGS 14A,A01,092681,Staff,0,12,100,100
1650225621874,COGS 14B,A01,083073,Cheng; Tzu-Han,0,7,50,50
1650225627900,COGS 17,A01,092677,Staff,35,0,75,40
1650225633924,COGS 100,A01,083619,Staff,0,21,60,60
1650225639951,COGS 101A,A01,083621,Davis; Joshua Daniel,0,21,60,60
1650225645978,COGS 101B,A01,091572,Staff,6,0,60,54
1650225652002,COGS 101C,A01,083625,Delgado; Tania,20,0,30,10
1650225658026,COGS 107A,A01,083627,Boyle; Mary E. T.,1,7,60,59
1650225664057,COGS 118A,A01,083075,Staff,15,0,60,45
1650225670080,CSE 3,A50,083646,Miranda; Gregory Joseph,22,0,38,16
1650225670080,CSE 3,A51,083647,Miranda; Gregory Joseph,37,0,37,0
1650225676111,CSE 8A,A50,083650,Miranda; Gregory Joseph,0,17,40,40
1650225682137,CSE 11,A01,083080,Cao; Yingjun,0,68,40,40
1650225688161,CSE 12,A01,083652,Staff,0,8,100,100
1650225694189,CSE 15L,A01,083654,Staff,0,1,50,50
1650225694189,CSE 15L,A02,083655,Staff,6,0,50,44
1650225700215,CSE 20,A01,083657,Staff,53,0,80,27
1650225706237,CSE 30,A01,083084,Eldon; John,0,70,40,40
1650225712260,CSE 100,A01,083659,Cao; Yingjun,0,63,50,50
1650225718287,CSE 134B,A01,083661,Powell; Thomas Allan,0,27,65,65
1650225724311,CSE 140,A01,083663,Staff,1,0,75,74
1650225730339,CSE 140L,A01,083088,Eldon; John,0,4,75,75
1650225736365,CSE 175,A01,083665,Kumar; Rakesh,8,0,25,17
1650225742388,CSE 190,A00,092507,Dubnov; Shlomo,14,0,20,6
1650225748420,ECE 45,A01,083139,Staff,0,13,40,40
1650225754444,ECE 65,A50,083695,Staff,0,5,30,30
1650225760478,ECE 109,A01,091882,Touri; Behrouz,47,0,70,23
1650225766504,ECE 180,A00,083140,Abi Samra; Nicholas Camill,24,0,30,6
1650225766504,ECE 180,B00,083141,Abi Samra; Nicholas Camill,8,0,30,22
1650225772526,MATH 10A,A01,083735,Patchell; Gregory David,11,0,30,19
1650225772526,MATH 10A,A02,083736,Patchell; Gregory David,28,0,30,2
1650225772526,MATH 10A,A03,083737,Patchell; Gregory David,26,0,30,4
1650225778557,MATH 10B,A01,083207,Staff,0,6,30,30
1650225778557,MATH 10B,A02,083208,Staff,0,5,30,30
1650225778557,MATH 10B,B01,083739,Staff,17,0,30,13
1650225778557,MATH 10B,B02,083740,Staff,29,0,30,1
1650225784585,MATH 18,A01,083743,Staff,8,0,30,22
1650225784585,MATH 18,A02,083744,Staff,28,0,30,2
1650225784585,MATH 18,A03,083745,Staff,23,0,30,7
1650225784585,MATH 18,A04,083746,Staff,27,0,30,3
1650225784585,MATH 18,B01,083748,Staff,0,10,30,30
1650225784585,MATH 18,B02,083749,Staff,0,7,30,30
1650225784585,MATH 18,B03,083750,Staff,0,7,30,30
1650225784585,MATH 18,B04,083751,Staff,0,8,30,30
1650225790607,MATH 20A,A01,083754,Staff,26,0,40,14
1650225796632,MATH 20B,A01,083756,Staff,1,6,30,29
1650225796632,MATH 20B,A02,083757,Staff,0,6,30,30
1650225802656,MATH 20C,A01,083760,Staff,0,12,30,30
1650225802656,MATH 20C,A02,083761,Staff,0,12,30,30
1650225802656,MATH 20C,B01,083762,Staff,14,0,30,16
1650225802656,MATH 20C,B02,083763,Staff,28,0,30,2
1650225808680,MATH 20D,A01,083765,Staff,1,2,30,29
1650225808680,MATH 20D,A02,083766,Staff,10,0,30,20
1650225808680,MATH 20D,A03,083767,Staff,28,0,30,2
1650225814703,MATH 20E,A01,083771,Staff,8,0,30,22
1650225814703,MATH 20E,A02,083772,Staff,20,0,30,10
1650225814703,MATH 20E,B01,083773,Staff,0,0,30,30
1650225814703,MATH 20E,B02,083774,Staff,12,0,30,18
1650225820729,MATH 103A,A01,083777,Staff,0,9,30,30
1650225820729,MATH 103A,A02,083778,Staff,0,10,30,30
1650225820729,MATH 103A,B01,083779,Staff,0,9,30,30
1650225820729,MATH 103A,B02,083780,Staff,0,9,30,30
1650225826767,MATH 105,A01,085443,Staff,0,17,30,30
1650225832792,MATH 109,A01,083213,Anzaldo; Leesa B,0,3,30,30
1650225832792,MATH 109,A02,083214,Anzaldo; Leesa B,0,6,30,30
1650225832792,MATH 109,B01,083215,Anzaldo; Leesa B,0,4,30,30
1650225832792,MATH 109,B02,083216,Anzaldo; Leesa B,0,4,30,30
1650225838820,MATH 142A,A01,083219,Chow; Bennett,0,12,30,30
1650225838820,MATH 142A,A02,083220,Chow; Bennett,0,11,30,30
1650225838820,MATH 142A,B01,083221,Chow; Bennett,0,11,30,30
1650225838820,MATH 142A,B02,083222,Chow; Bennett,0,12,30,30
1650225844842,MATH 193A,A01,083224,Staff,0,5,30,30
1650225844842,MATH 193A,A02,083225,Staff,0,4,30,30
1650225844842,MATH 193A,A03,083781,Staff,0,2,30,30
1650225844842,MATH 193A,A04,083782,Staff,0,1,30,30
1650225850867,MATH 197,001,091859,McAuley; Julian John,9998,0,9999,1
1650225856920,COGS 9,A01,083615,Staff,0,14,60,60
1650225862948,COGS 11,A01,083617,Boyle; Mary E. T.,24,0,40,16
1650225868972,COGS 13,A01,083071,Staff,0,30,40,40
1650225874995,COGS 14A,A01,092681,Staff,0,12,100,100
1650225881020,COGS 14B,A01,083073,Cheng; Tzu-Han,0,7,50,50
1650225887044,COGS 17,A01,092677,Staff,35,0,75,40
1650225893069,COGS 100,A01,083619,Staff,0,21,60,60
1650225899093,COGS 101A,A01,083621,Davis; Joshua Daniel,0,21,60,60
1650225905118,COGS 101B,A01,091572,Staff,6,0,60,54
1650225911141,COGS 101C,A01,083625,Delgado; Tania,20,0,30,10
1650225917168,COGS 107A,A01,083627,Boyle; Mary E. T.,1,7,60,59
1650225923192,COGS 118A,A01,083075,Staff,15,0,60,45
1650225929218,CSE 3,A50,083646,Miranda; Gregory Joseph,22,0,38,16
1650225929218,CSE 3,A51,083647,Miranda; Gregory Joseph,37,0,37,0
1650225935241,CSE 8A,A50,083650,Miranda; Gregory Joseph,0,18,40,40
1650225941265,CSE 11,A01,083080,Cao; Yingjun,0,68,40,40
1650225947292,CSE 12,A01,083652,Staff,0,8,100,100
1650225953316,CSE 15L,A01,083654,Staff,0,1,50,50
1650225953316,CSE 15L,A02,083655,Staff,6,0,50,44
1650225959341,CSE 20,A01,083657,Staff,53,0,80,27
1650225965365,CSE 30,A01,083084,Eldon; John,0,70,40,40
1650225971391,CSE 100,A01,083659,Cao; Yingjun,0,63,50,50
1650225977414,CSE 134B,A01,083661,Powell; Thomas Allan,0,27,65,65
1650225983437,CSE 140,A01,083663,Staff,1,0,75,74
1650225989463,CSE 140L,A01,083088,Eldon; John,0,4,75,75
1650225995491,CSE 175,A01,083665,Kumar; Rakesh,8,0,25,17
1650226001513,CSE 190,A00,092507,Dubnov; Shlomo,14,0,20,6
1650226007631,ECE 45,A01,083139,Staff,0,13,40,40
1650226013655,ECE 65,A50,083695,Staff,0,5,30,30
1650226019679,ECE 109,A01,091882,Touri; Behrouz,47,0,70,23
1650226025705,ECE 180,A00,083140,Abi Samra; Nicholas Camill,24,0,30,6
1650226025705,ECE 180,B00,083141,Abi Samra; Nicholas Camill,8,0,30,22
1650226031733,MATH 10A,A01,083735,Patchell; Gregory David,11,0,30,19
1650226031733,MATH 10A,A02,083736,Patchell; Gregory David,28,0,30,2
1650226031733,MATH 10A,A03,083737,Patchell; Gregory David,26,0,30,4
1650226037760,MATH 10B,A01,083207,Staff,0,6,30,30
1650226037760,MATH 10B,A02,083208,Staff,0,5,30,30
1650226037760,MATH 10B,B01,083739,Staff,17,0,30,13
1650226037760,MATH 10B,B02,083740,Staff,29,0,30,1
1650226043790,MATH 18,A01,083743,Staff,8,0,30,22
1650226043790,MATH 18,A02,083744,Staff,28,0,30,2
1650226043790,MATH 18,A03,083745,Staff,23,0,30,7
1650226043790,MATH 18,A04,083746,Staff,27,0,30,3
1650226043790,MATH 18,B01,083748,Staff,0,10,30,30
1650226043790,MATH 18,B02,083749,Staff,0,7,30,30
1650226043790,MATH 18,B03,083750,Staff,0,7,30,30
1650226043790,MATH 18,B04,083751,Staff,0,8,30,30
1650226049813,MATH 20A,A01,083754,Staff,26,0,40,14
1650226055836,MATH 20B,A01,083756,Staff,1,6,30,29
1650226055836,MATH 20B,A02,083757,Staff,0,6,30,30
1650226061860,MATH 20C,A01,083760,Staff,0,12,30,30
1650226061860,MATH 20C,A02,083761,Staff,0,12,30,30
1650226061860,MATH 20C,B01,083762,Staff,14,0,30,16
1650226061860,MATH 20C,B02,083763,Staff,28,0,30,2
1650226067886,MATH 20D,A01,083765,Staff,1,2,30,29
1650226067886,MATH 20D,A02,083766,Staff,10,0,30,20
1650226067886,MATH 20D,A03,083767,Staff,28,0,30,2
1650226073909,MATH 20E,A01,083771,Staff,8,0,30,22
1650226073909,MATH 20E,A02,083772,Staff,21,0,30,9
1650226073909,MATH 20E,B01,083773,Staff,0,0,30,30
1650226073909,MATH 20E,B02,083774,Staff,12,0,30,18
1650226079937,MATH 103A,A01,083777,Staff,0,9,30,30
1650226079937,MATH 103A,A02,083778,Staff,0,10,30,30
1650226079937,MATH 103A,B01,083779,Staff,0,9,30,30
1650226079937,MATH 103A,B02,083780,Staff,0,9,30,30
1650226085959,MATH 105,A01,085443,Staff,0,17,30,30
1650226091983,MATH 109,A01,083213,Anzaldo; Leesa B,0,3,30,30
1650226091983,MATH 109,A02,083214,Anzaldo; Leesa B,0,6,30,30
1650226091983,MATH 109,B01,083215,Anzaldo; Leesa B,0,4,30,30
1650226091983,MATH 109,B02,083216,Anzaldo; Leesa B,0,4,30,30
1650226098007,MATH 142A,A01,083219,Chow; Bennett,0,12,30,30
1650226098007,MATH 142A,A02,083220,Chow; Bennett,0,11,30,30
1650226098007,MATH 142A,B01,083221,Chow; Bennett,0,11,30,30
1650226098007,MATH 142A,B02,083222,Chow; Bennett,0,12,30,30
1650226104029,MATH 193A,A01,083224,Staff,0,5,30,30
1650226104029,MATH 193A,A02,083225,Staff,0,4,30,30
1650226104029,MATH 193A,A03,083781,Staff,0,2,30,30
1650226104029,MATH 193A,A04,083782,Staff,0,1,30,30
1650226110052,MATH 197,001,091859,McAuley; Julian John,9998,0,9999,1
1650226116117,COGS 9,A01,083615,Staff,0,14,60,60
1650226122141,COGS 11,A01,083617,Boyle; Mary E. T.,24,0,40,16
1650226128164,COGS 13,A01,083071,Staff,0,30,40,40
1650226134210,COGS 14A,A01,092681,Staff,0,12,100,100
1650226140238,COGS 14B,A01,083073,Cheng; Tzu-Han,0,7,50,50
1650226146261,COGS 17,A01,092677,Staff,35,0,75,40
1650226152288,COGS 100,A01,083619,Staff,0,21,60,60
1650226158311,COGS 101A,A01,083621,Davis; Joshua Daniel,0,21,60,60
1650226164339,COGS 101B,A01,091572,Staff,6,0,60,54
1650226170362,COGS 101C,A01,083625,Delgado; Tania,20,0,30,10
1650226176385,COGS 107A,A01,083627,Boyle; Mary E. T.,1,7,60,59
1650226182411,COGS 118A,A01,083075,Staff,15,0,60,45
1650226188444,CSE 3,A50,083646,Miranda; Gregory Joseph,22,0,38,16
1650226188444,CSE 3,A51,083647,Miranda; Gregory Joseph,37,0,37,0
1650226194468,CSE 8A,A50,083650,Miranda; Gregory Joseph,0,18,40,40
1650226200493,CSE 11,A01,083080,Cao; Yingjun,0,68,40,40
1650226206519,CSE 12,A01,083652,Staff,0,8,100,100
1650226212541,CSE 15L,A01,083654,Staff,0,1,50,50
1650226212541,CSE 15L,A02,083655,Staff,6,0,50,44
1650226218564,CSE 20,A01,083657,Staff,53,0,80,27
1650226224589,CSE 30,A01,083084,Eldon; John,0,70,40,40
1650226230615,CSE 100,A01,083659,Cao; Yingjun,0,63,50,50
1650226236641,CSE 134B,A01,083661,Powell; Thomas Allan,0,27,65,65
1650226242665,CSE 140,A01,083663,Staff,1,0,75,74
1650226248689,CSE 140L,A01,083088,Eldon; John,0,4,75,75
1650226254713,CSE 175,A01,083665,Kumar; Rakesh,8,0,25,17
1650226260739,CSE 190,A00,092507,Dubnov; Shlomo,14,0,20,6
1650226266763,ECE 45,A01,083139,Staff,0,13,40,40
1650226272787,ECE 65,A50,083695,Staff,0,5,30,30
1650226278819,ECE 109,A01,091882,Touri; Behrouz,47,0,70,23
1650226284842,ECE 180,A00,083140,Abi Samra; Nicholas Camill,24,0,30,6
1650226284842,ECE 180,B00,083141,Abi Samra; Nicholas Camill,8,0,30,22
1650226290865,MATH 10A,A01,083735,Patchell; Gregory David,11,0,30,19
1650226290865,MATH 10A,A02,083736,Patchell; Gregory David,28,0,30,2
1650226290865,MATH 10A,A03,083737,Patchell; Gregory David,26,0,30,4
1650226296889,MATH 10B,A01,083207,Staff,0,6,30,30
1650226296889,MATH 10B,A02,083208,Staff,0,5,30,30
1650226296889,MATH 10B,B01,083739,Staff,17,0,30,13
1650226296889,MATH 10B,B02,083740,Staff,29,0,30,1
1650226302929,MATH 18,A01,083743,Staff,8,0,30,22
1650226302929,MATH 18,A02,083744,Staff,28,0,30,2
1650226302929,MATH 18,A03,083745,Staff,23,0,30,7
1650226302929,MATH 18,A04,083746,Staff,27,0,30,3
1650226302929,MATH 18,B01,083748,Staff,0,10,30,30
1650226302929,MATH 18,B02,083749,Staff,0,7,30,30
1650226302929,MATH 18,B03,083750,Staff,0,7,30,30
1650226302929,MATH 18,B04,083751,Staff,0,8,30,30
1650226308956,MATH 20A,A01,083754,Staff,26,0,40,14
1650226314982,MATH 20B,A01,083756,Staff,1,6,30,29
1650226314982,MATH 20B,A02,083757,Staff,0,6,30,30
1650226321006,MATH 20C,A01,083760,Staff,0,12,30,30
1650226321006,MATH 20C,A02,083761,Staff,0,12,30,30
1650226321006,MATH 20C,B01,083762,Staff,14,0,30,16
1650226321006,MATH 20C,B02,083763,Staff,28,0,30,2
1650226327034,MATH 20D,A01,083765,Staff,1,2,30,29
1650226327034,MATH 20D,A02,083766,Staff,10,0,30,20
1650226327034,MATH 20D,A03,083767,Staff,28,0,30,2
1650226333060,MATH 20E,A01,083771,Staff,8,0,30,22
1650226333060,MATH 20E,A02,083772,Staff,21,0,30,9
1650226333060,MATH 20E,B01,083773,Staff,0,0,30,30
1650226333060,MATH 20E,B02,083774,Staff,12,0,30,18
1650226339084,MATH 103A,A01,083777,Staff,0,9,30,30
1650226339084,MATH 103A,A02,083778,Staff,0,10,30,30
1650226339084,MATH 103A,B01,083779,Staff,0,9,30,30
1650226339084,MATH 103A,B02,083780,Staff,0,9,30,30
1650226345110,MATH 105,A01,085443,Staff,0,17,30,30
1650226351132,MATH 109,A01,083213,Anzaldo; Leesa B,0,3,30,30
1650226351132,MATH 109,A02,083214,Anzaldo; Leesa B,0,6,30,30
1650226351132,MATH 109,B01,083215,Anzaldo; Leesa B,0,4,30,30
1650226351132,MATH 109,B02,083216,Anzaldo; Leesa B,0,4,30,30
1650226357156,MATH 142A,A01,083219,Chow; Bennett,0,12,30,30
1650226357156,MATH 142A,A02,083220,Chow; Bennett,0,11,30,30
1650226357156,MATH 142A,B01,083221,Chow; Bennett,0,11,30,30
1650226357156,MATH 142A,B02,083222,Chow; Bennett,0,12,30,30
1650226363182,MATH 193A,A01,083224,Staff,0,5,30,30
1650226363182,MATH 193A,A02,083225,Staff,0,4,30,30
1650226363182,MATH 193A,A03,083781,Staff,0,2,30,30
1650226363182,MATH 193A,A04,083782,Staff,0,1,30,30
1650226369204,MATH 197,001,091859,McAuley; Julian John,9998,0,9999,1
1650226375254,COGS 9,A01,083615,Staff,0,14,60,60
1650226381280,COGS 11,A01,083617,Boyle; Mary E. T.,24,0,40,16
1650226387305,COGS 13,A01,083071,Staff,0,30,40,40
1650226393331,COGS 14A,A01,092681,Staff,0,12,100,100
1650226399355,COGS 14B,A01,083073,Cheng; Tzu-Han,0,7,50,50
1650226405378,COGS 17,A01,092677,Staff,35,0,75,40
1650226411406,COGS 100,A01,083619,Staff,0,21,60,60
1650226417430,COGS 101A,A01,083621,Davis; Joshua Daniel,0,21,60,60
1650226423452,COGS 101B,A01,091572,Staff,6,0,60,54
1650226429474,COGS 101C,A01,083625,Delgado; Tania,20,0,30,10
1650226435501,COGS 107A,A01,083627,Boyle; Mary E. T.,1,7,60,59
1650226441524,COGS 118A,A01,083075,Staff,15,0,60,45
1650226447551,CSE 3,A50,083646,Miranda; Gregory Joseph,22,0,38,16
1650226447551,CSE 3,A51,083647,Miranda; Gregory Joseph,37,0,37,0
1650226453579,CSE 8A,A50,083650,Miranda; Gregory Joseph,0,18,40,40
1650226459606,CSE 11,A01,083080,Cao; Yingjun,0,68,40,40
1650226465649,CSE 12,A01,083652,Staff,0,8,100,100
1650226471671,CSE 15L,A01,083654,Staff,0,1,50,50
1650226471671,CSE 15L,A02,083655,Staff,6,0,50,44
1650226477696,CSE 20,A01,083657,Staff,53,0,80,27
1650226483719,CSE 30,A01,083084,Eldon; John,0,70,40,40
1650226489744,CSE 100,A01,083659,Cao; Yingjun,0,63,50,50
1650226495771,CSE 134B,A01,083661,Powell; Thomas Allan,0,27,65,65
1650226501798,CSE 140,A01,083663,Staff,1,0,75,74
1650226507823,CSE 140L,A01,083088,Eldon; John,0,4,75,75
1650226513849,CSE 175,A01,083665,Kumar; Rakesh,8,0,25,17
1650226519873,CSE 190,A00,092507,Dubnov; Shlomo,14,0,20,6
1650226525900,ECE 45,A01,083139,Staff,0,13,40,40
1650226531926,ECE 65,A50,083695,Staff,0,5,30,30
1650226537950,ECE 109,A01,091882,Touri; Behrouz,47,0,70,23
1650226543976,ECE 180,A00,083140,Abi Samra; Nicholas Camill,24,0,30,6
1650226543976,ECE 180,B00,083141,Abi Samra; Nicholas Camill,8,0,30,22
1650226556572,MATH 10A,A01,083735,Patchell; Gregory David,11,0,30,19
1650226556572,MATH 10A,A02,083736,Patchell; Gregory David,28,0,30,2
1650226556572,MATH 10A,A03,083737,Patchell; Gregory David,26,0,30,4
1650226562601,MATH 10B,A01,083207,Staff,0,6,30,30
1650226562601,MATH 10B,A02,083208,Staff,0,5,30,30
1650226562601,MATH 10B,B01,083739,Staff,17,0,30,13
1650226562601,MATH 10B,B02,083740,Staff,29,0,30,1
1650226568630,MATH 18,A01,083743,Staff,8,0,30,22
1650226568630,MATH 18,A02,083744,Staff,28,0,30,2
1650226568630,MATH 18,A03,083745,Staff,23,0,30,7
1650226568630,MATH 18,A04,083746,Staff,27,0,30,3
1650226568630,MATH 18,B01,083748,Staff,0,10,30,30
1650226568630,MATH 18,B02,083749,Staff,0,7,30,30
1650226568630,MATH 18,B03,083750,Staff,0,7,30,30
1650226568630,MATH 18,B04,083751,Staff,0,8,30,30
1650226574662,MATH 20A,A01,083754,Staff,26,0,40,14
1650226580687,MATH 20B,A01,083756,Staff,1,6,30,29
1650226580687,MATH 20B,A02,083757,Staff,0,6,30,30
1650226586712,MATH 20C,A01,083760,Staff,0,12,30,30
1650226586712,MATH 20C,A02,083761,Staff,0,12,30,30
1650226586712,MATH 20C,B01,083762,Staff,14,0,30,16
1650226586712,MATH 20C,B02,083763,Staff,28,0,30,2
1650226592738,MATH 20D,A01,083765,Staff,1,2,30,29
1650226592738,MATH 20D,A02,083766,Staff,10,0,30,20
1650226592738,MATH 20D,A03,083767,Staff,28,0,30,2
1650226598766,MATH 20E,A01,083771,Staff,8,0,30,22
1650226598766,MATH 20E,A02,083772,Staff,21,0,30,9
1650226598766,MATH 20E,B01,083773,Staff,0,0,30,30
1650226598766,MATH 20E,B02,083774,Staff,12,0,30,18
1650226604789,MATH 103A,A01,083777,Staff,0,9,30,30
1650226604789,MATH 103A,A02,083778,Staff,0,10,30,30
1650226604789,MATH 103A,B01,083779,Staff,0,9,30,30
1650226604789,MATH 103A,B02,083780,Staff,0,9,30,30
1650226610906,MATH 105,A01,085443,Staff,0,17,30,30
1650226616934,MATH 109,A01,083213,Anzaldo; Leesa B,0,3,30,30
1650226616934,MATH 109,A02,083214,Anzaldo; Leesa B,0,6,30,30
1650226616934,MATH 109,B01,083215,Anzaldo; Leesa B,0,4,30,30
1650226616934,MATH 109,B02,083216,Anzaldo; Leesa B,0,4,30,30
1650226622962,MATH 142A,A01,083219,Chow; Bennett,0,12,30,30
1650226622962,MATH 142A,A02,083220,Chow; Bennett,0,11,30,30
1650226622962,MATH 142A,B01,083221,Chow; Bennett,0,11,30,30
1650226622962,MATH 142A,B02,083222,Chow; Bennett,0,12,30,30
1650226628989,MATH 193A,A01,083224,Staff,0,5,30,30
1650226628989,MATH 193A,A02,083225,Staff,0,4,30,30
1650226628989,MATH 193A,A03,083781,Staff,0,2,30,30
1650226628989,MATH 193A,A04,083782,Staff,0,1,30,30
1650226635014,MATH 197,001,091859,McAuley; Julian John,9998,0,9999,1
1650226641070,COGS 9,A01,083615,Staff,0,14,60,60
1650226647094,COGS 11,A01,083617,Boyle; Mary E. T.,24,0,40,16
1650226653123,COGS 13,A01,083071,Staff,0,30,40,40
1650226659147,COGS 14A,A01,092681,Staff,0,12,100,100
1650226665171,COGS 14B,A01,083073,Cheng; Tzu-Han,0,7,50,50
1650226671195,COGS 17,A01,092677,Staff,35,0,75,40
1650226677221,COGS 100,A01,083619,Staff,0,21,60,60
1650226683248,COGS 101A,A01,083621,Davis; Joshua Daniel,0,21,60,60
1650226689271,COGS 101B,A01,091572,Staff,6,0,60,54
1650226695295,COGS 101C,A01,083625,Delgado; Tania,20,0,30,10
1650226701320,COGS 107A,A01,083627,Boyle; Mary E. T.,1,7,60,59
1650226707342,COGS 118A,A01,083075,Staff,15,0,60,45
1650226713364,CSE 3,A50,083646,Miranda; Gregory Joseph,22,0,38,16
1650226713364,CSE 3,A51,083647,Miranda; Gregory Joseph,37,0,37,0
1650226719388,CSE 8A,A50,083650,Miranda; Gregory Joseph,0,18,40,40
1650226725411,CSE 11,A01,083080,Cao; Yingjun,0,68,40,40
1650226731433,CSE 12,A01,083652,Staff,0,8,100,100
1650226737460,CSE 15L,A01,083654,Staff,0,1,50,50
1650226737460,CSE 15L,A02,083655,Staff,6,0,50,44
1650226743483,CSE 20,A01,083657,Staff,53,0,80,27
1650226749509,CSE 30,A01,083084,Eldon; John,0,70,40,40
1650226755542,CSE 100,A01,083659,Cao; Yingjun,0,63,50,50
1650226761568,CSE 134B,A01,083661,Powell; Thomas Allan,0,27,65,65
1650226767591,CSE 140,A01,083663,Staff,1,0,75,74
1650226773613,CSE 140L,A01,083088,Eldon; John,0,4,75,75
1650226779640,CSE 175,A01,083665,Kumar; Rakesh,8,0,25,17
1650226785665,CSE 190,A00,092507,Dubnov; Shlomo,14,0,20,6
1650226791691,ECE 45,A01,083139,Staff,0,13,40,40
1650226797715,ECE 65,A50,083695,Staff,0,5,30,30
1650226803747,ECE 109,A01,091882,Touri; Behrouz,47,0,70,23
1650226809770,ECE 180,A00,083140,Abi Samra; Nicholas Camill,24,0,30,6
1650226809770,ECE 180,B00,083141,Abi Samra; Nicholas Camill,8,0,30,22
1650226815794,MATH 10A,A01,083735,Patchell; Gregory David,11,0,30,19
1650226815794,MATH 10A,A02,083736,Patchell; Gregory David,28,0,30,2
1650226815794,MATH 10A,A03,083737,Patchell; Gregory David,26,0,30,4
1650226821821,MATH 10B,A01,083207,Staff,0,6,30,30
1650226821821,MATH 10B,A02,083208,Staff,0,5,30,30
1650226821821,MATH 10B,B01,083739,Staff,17,0,30,13
1650226821821,MATH 10B,B02,083740,Staff,29,0,30,1
1650226827847,MATH 18,A01,083743,Staff,8,0,30,22
1650226827847,MATH 18,A02,083744,Staff,28,0,30,2
1650226827847,MATH 18,A03,083745,Staff,23,0,30,7
1650226827847,MATH 18,A04,083746,Staff,27,0,30,3
1650226827847,MATH 18,B01,083748,Staff,0,10,30,30
1650226827847,MATH 18,B02,083749,Staff,0,7,30,30
1650226827847,MATH 18,B03,083750,Staff,0,7,30,30
1650226827847,MATH 18,B04,083751,Staff,0,8,30,30
1650226833871,MATH 20A,A01,083754,Staff,26,0,40,14
1650226839895,MATH 20B,A01,083756,Staff,1,6,30,29
1650226839895,MATH 20B,A02,083757,Staff,0,6,30,30
1650226845919,MATH 20C,A01,083760,Staff,0,12,30,30
1650226845919,MATH 20C,A02,083761,Staff,0,12,30,30
1650226845919,MATH 20C,B01,083762,Staff,14,0,30,16
1650226845919,MATH 20C,B02,083763,Staff,28,0,30,2
1650226851942,MATH 20D,A01,083765,Staff,1,2,30,29
1650226851942,MATH 20D,A02,083766,Staff,10,0,30,20
1650226851942,MATH 20D,A03,083767,Staff,28,0,30,2
1650226857967,MATH 20E,A01,083771,Staff,8,0,30,22
1650226857967,MATH 20E,A02,083772,Staff,21,0,30,9
1650226857967,MATH 20E,B01,083773,Staff,0,0,30,30
1650226857967,MATH 20E,B02,083774,Staff,12,0,30,18
1650226863996,MATH 103A,A01,083777,Staff,0,9,30,30
1650226863996,MATH 103A,A02,083778,Staff,0,10,30,30
1650226863996,MATH 103A,B01,083779,Staff,0,9,30,30
1650226863996,MATH 103A,B02,083780,Staff,0,9,30,30
1650226870033,MATH 105,A01,085443,Staff,0,17,30,30
1650226876058,MATH 109,A01,083213,Anzaldo; Leesa B,0,3,30,30
1650226876058,MATH 109,A02,083214,Anzaldo; Leesa B,0,6,30,30
1650226876058,MATH 109,B01,083215,Anzaldo; Leesa B,0,4,30,30
1650226876058,MATH 109,B02,083216,Anzaldo; Leesa B,0,4,30,30
1650226882083,MATH 142A,A01,083219,Chow; Bennett,0,12,30,30
1650226882083,MATH 142A,A02,083220,Chow; Bennett,0,11,30,30
1650226882083,MATH 142A,B01,083221,Chow; Bennett,0,11,30,30
1650226882083,MATH 142A,B02,083222,Chow; Bennett,0,12,30,30
1650226888105,MATH 193A,A01,083224,Staff,0,5,30,30
1650226888105,MATH 193A,A02,083225,Staff,0,4,30,30
1650226888105,MATH 193A,A03,083781,Staff,0,2,30,30
1650226888105,MATH 193A,A04,083782,Staff,0,1,30,30
1650226894128,MATH 197,001,091859,McAuley; Julian John,9998,0,9999,1
1650226900185,COGS 9,A01,083615,Staff,0,14,60,60
1650226906212,COGS 11,A01,083617,Boyle; Mary E. T.,24,0,40,16
1650226912239,COGS 13,A01,083071,Staff,0,30,40,40
1650226918264,COGS 14A,A01,092681,Staff,0,12,100,100
1650226924289,COGS 14B,A01,083073,Cheng; Tzu-Han,0,7,50,50
1650226930313,COGS 17,A01,092677,Staff,35,0,75,40
1650226936336,COGS 100,A01,083619,Staff,0,21,60,60
1650226942359,COGS 101A,A01,083621,Davis; Joshua Daniel,0,21,60,60
1650226948385,COGS 101B,A01,091572,Staff,6,0,60,54
1650226954409,COGS 101C,A01,083625,Delgado; Tania,20,0,30,10
1650226960432,COGS 107A,A01,083627,Boyle; Mary E. T.,1,7,60,59
1650226966456,COGS 118A,A01,083075,Staff,15,0,60,45
1650226972480,CSE 3,A50,083646,Miranda; Gregory Joseph,22,0,38,16
1650226972480,CSE 3,A51,083647,Miranda; Gregory Joseph,37,0,37,0
1650226978504,CSE 8A,A50,083650,Miranda; Gregory Joseph,0,18,40,40
1650226984528,CSE 11,A01,083080,Cao; Yingjun,0,68,40,40
1650226990552,CSE 12,A01,083652,Staff,0,8,100,100
1650226996573,CSE 15L,A01,083654,Staff,0,1,50,50
1650226996573,CSE 15L,A02,083655,Staff,6,0,50,44
1650227002596,CSE 20,A01,083657,Staff,53,0,80,27
1650227008618,CSE 30,A01,083084,Eldon; John,0,70,40,40
1650227014642,CSE 100,A01,083659,Cao; Yingjun,0,63,50,50
1650227020673,CSE 134B,A01,083661,Powell; Thomas Allan,0,27,65,65
1650227026696,CSE 140,A01,083663,Staff,1,0,75,74
1650227032719,CSE 140L,A01,083088,Eldon; John,0,4,75,75
1650227038743,CSE 175,A01,083665,Kumar; Rakesh,8,0,25,17
1650227044769,CSE 190,A00,092507,Dubnov; Shlomo,14,0,20,6
1650227050795,ECE 45,A01,083139,Staff,0,13,40,40
1650227056819,ECE 65,A50,083695,Staff,0,5,30,30
1650227062849,ECE 109,A01,091882,Touri; Behrouz,47,0,70,23
1650227068873,ECE 180,A00,083140,Abi Samra; Nicholas Camill,24,0,30,6
1650227068873,ECE 180,B00,083141,Abi Samra; Nicholas Camill,8,0,30,22
1650227074903,MATH 10A,A01,083735,Patchell; Gregory David,11,0,30,19
1650227074903,MATH 10A,A02,083736,Patchell; Gregory David,28,0,30,2
1650227074903,MATH 10A,A03,083737,Patchell; Gregory David,26,0,30,4
1650227080927,MATH 10B,A01,083207,Staff,0,6,30,30
1650227080927,MATH 10B,A02,083208,Staff,0,5,30,30
1650227080927,MATH 10B,B01,083739,Staff,17,0,30,13
1650227080927,MATH 10B,B02,083740,Staff,29,0,30,1
1650227086956,MATH 18,A01,083743,Staff,8,0,30,22
1650227086956,MATH 18,A02,083744,Staff,28,0,30,2
1650227086956,MATH 18,A03,083745,Staff,23,0,30,7
1650227086956,MATH 18,A04,083746,Staff,27,0,30,3
1650227086956,MATH 18,B01,083748,Staff,0,10,30,30
1650227086956,MATH 18,B02,083749,Staff,0,7,30,30
1650227086956,MATH 18,B03,083750,Staff,0,7,30,30
1650227086956,MATH 18,B04,083751,Staff,0,8,30,30
1650227092979,MATH 20A,A01,083754,Staff,26,0,40,14
1650227099003,MATH 20B,A01,083756,Staff,1,6,30,29
1650227099003,MATH 20B,A02,083757,Staff,0,6,30,30
1650227105028,MATH 20C,A01,083760,Staff,0,12,30,30
1650227105028,MATH 20C,A02,083761,Staff,0,12,30,30
1650227105028,MATH 20C,B01,083762,Staff,14,0,30,16
1650227105028,MATH 20C,B02,083763,Staff,28,0,30,2
1650227111051,MATH 20D,A01,083765,Staff,1,2,30,29
1650227111051,MATH 20D,A02,083766,Staff,10,0,30,20
1650227111051,MATH 20D,A03,083767,Staff,28,0,30,2
1650227117077,MATH 20E,A01,083771,Staff,8,0,30,22
1650227117077,MATH 20E,A02,083772,Staff,21,0,30,9
1650227117077,MATH 20E,B01,083773,Staff,0,0,30,30
1650227117077,MATH 20E,B02,083774,Staff,12,0,30,18
1650227123101,MATH 103A,A01,083777,Staff,0,9,30,30
1650227123101,MATH 103A,A02,083778,Staff,0,10,30,30
1650227123101,MATH 103A,B01,083779,Staff,0,9,30,30
1650227123101,MATH 103A,B02,083780,Staff,0,9,30,30
1650227129124,MATH 105,A01,085443,Staff,0,17,30,30
1650227135159,MATH 109,A01,083213,Anzaldo; Leesa B,0,3,30,30
1650227135159,MATH 109,A02,083214,Anzaldo; Leesa B,0,6,30,30
1650227135159,MATH 109,B01,083215,Anzaldo; Leesa B,0,4,30,30
1650227135159,MATH 109,B02,083216,Anzaldo; Leesa B,0,4,30,30
1650227141187,MATH 142A,A01,083219,Chow; Bennett,0,12,30,30
1650227141187,MATH 142A,A02,083220,Chow; Bennett,0,11,30,30
1650227141187,MATH 142A,B01,083221,Chow; Bennett,0,11,30,30
1650227141187,MATH 142A,B02,083222,Chow; Bennett,0,12,30,30
1650227147211,MATH 193A,A01,083224,Staff,0,5,30,30
1650227147211,MATH 193A,A02,083225,Staff,0,4,30,30
1650227147211,MATH 193A,A03,083781,Staff,0,2,30,30
1650227147211,MATH 193A,A04,083782,Staff,0,1,30,30
1650227153246,MATH 197,001,091859,McAuley; Julian John,9998,0,9999,1
1650227159299,COGS 9,A01,083615,Staff,0,14,60,60
1650227165323,COGS 11,A01,083617,Boyle; Mary E. T.,24,0,40,16
1650227171347,COGS 13,A01,083071,Staff,0,30,40,40
1650227177371,COGS 14A,A01,092681,Staff,0,12,100,100
1650227183394,COGS 14B,A01,083073,Cheng; Tzu-Han,0,7,50,50
1650227189417,COGS 17,A01,092677,Staff,35,0,75,40
1650227195445,COGS 100,A01,083619,Staff,0,21,60,60
1650227201569,COGS 101A,A01,083621,Davis; Joshua Daniel,0,21,60,60
1650227207595,COGS 101B,A01,091572,Staff,6,0,60,54
1650227213623,COGS 101C,A01,083625,Delgado; Tania,20,0,30,10
1650227219647,COGS 107A,A01,083627,Boyle; Mary E. T.,1,7,60,59
1650227225685,COGS 118A,A01,083075,Staff,15,0,60,45
1650227231719,CSE 3,A50,083646,Miranda; Gregory Joseph,22,0,38,16
1650227231719,CSE 3,A51,083647,Miranda; Gregory Joseph,37,0,37,0
1650227237747,CSE 8A,A50,083650,Miranda; Gregory Joseph,0,18,40,40
1650227243773,CSE 11,A01,083080,Cao; Yingjun,0,68,40,40
1650227249800,CSE 12,A01,083652,Staff,0,8,100,100
1650227255824,CSE 15L,A01,083654,Staff,0,1,50,50
1650227255824,CSE 15L,A02,083655,Staff,6,0,50,44
1650227261848,CSE 20,A01,083657,Staff,53,0,80,27
1650227267872,CSE 30,A01,083084,Eldon; John,0,70,40,40
1650227273898,CSE 100,A01,083659,Cao; Yingjun,0,63,50,50
1650227279921,CSE 134B,A01,083661,Powell; Thomas Allan,0,27,65,65
1650227285947,CSE 140,A01,083663,Staff,1,0,75,74
1650227291970,CSE 140L,A01,083088,Eldon; John,0,4,75,75
1650227297997,CSE 175,A01,083665,Kumar; Rakesh,8,0,25,17
1650227304021,CSE 190,A00,092507,Dubnov; Shlomo,14,0,20,6
1650227310047,ECE 45,A01,083139,Staff,0,13,40,40
1650227316069,ECE 65,A50,083695,Staff,0,5,30,30
1650227322092,ECE 109,A01,091882,Touri; Behrouz,47,0,70,23
1650227328117,ECE 180,A00,083140,Abi Samra; Nicholas Camill,24,0,30,6
1650227328117,ECE 180,B00,083141,Abi Samra; Nicholas Camill,8,0,30,22
1650227334154,MATH 10A,A01,083735,Patchell; Gregory David,11,0,30,19
1650227334154,MATH 10A,A02,083736,Patchell; Gregory David,28,0,30,2
1650227334154,MATH 10A,A03,083737,Patchell; Gregory David,26,0,30,4
1650227340179,MATH 10B,A01,083207,Staff,0,6,30,30
1650227340179,MATH 10B,A02,083208,Staff,0,5,30,30
1650227340179,MATH 10B,B01,083739,Staff,17,0,30,13
1650227340179,MATH 10B,B02,083740,Staff,29,0,30,1
1650227346204,MATH 18,A01,083743,Staff,8,0,30,22
1650227346204,MATH 18,A02,083744,Staff,28,0,30,2
1650227346204,MATH 18,A03,083745,Staff,23,0,30,7
1650227346204,MATH 18,A04,083746,Staff,27,0,30,3
1650227346204,MATH 18,B01,083748,Staff,0,10,30,30
1650227346204,MATH 18,B02,083749,Staff,0,7,30,30
1650227346204,MATH 18,B03,083750,Staff,0,7,30,30
1650227346204,MATH 18,B04,083751,Staff,0,8,30,30
1650227352230,MATH 20A,A01,083754,Staff,26,0,40,14
1650227358251,MATH 20B,A01,083756,Staff,1,6,30,29
1650227358251,MATH 20B,A02,083757,Staff,0,6,30,30
1650227364276,MATH 20C,A01,083760,Staff,0,12,30,30
1650227364276,MATH 20C,A02,083761,Staff,0,12,30,30
1650227364276,MATH 20C,B01,083762,Staff,14,0,30,16
1650227364276,MATH 20C,B02,083763,Staff,28,0,30,2
1650227370309,MATH 20D,A01,083765,Staff,1,2,30,29
1650227370309,MATH 20D,A02,083766,Staff,10,0,30,20
1650227370309,MATH 20D,A03,083767,Staff,28,0,30,2
1650227376334,MATH 20E,A01,083771,Staff,8,0,30,22
1650227376334,MATH 20E,A02,083772,Staff,21,0,30,9
1650227376334,MATH 20E,B01,083773,Staff,0,0,30,30
1650227376334,MATH 20E,B02,083774,Staff,12,0,30,18
1650227382363,MATH 103A,A01,083777,Staff,0,9,30,30
1650227382363,MATH 103A,A02,083778,Staff,0,10,30,30
1650227382363,MATH 103A,B01,083779,Staff,0,9,30,30
1650227382363,MATH 103A,B02,083780,Staff,0,9,30,30
1650227388388,MATH 105,A01,085443,Staff,0,17,30,30
1650227394411,MATH 109,A01,083213,Anzaldo; Leesa B,0,3,30,30
1650227394411,MATH 109,A02,083214,Anzaldo; Leesa B,0,6,30,30
1650227394411,MATH 109,B01,083215,Anzaldo; Leesa B,0,4,30,30
1650227394411,MATH 109,B02,083216,Anzaldo; Leesa B,0,4,30,30
1650227400439,MATH 142A,A01,083219,Chow; Bennett,0,12,30,30
1650227400439,MATH 142A,A02,083220,Chow; Bennett,0,11,30,30
1650227400439,MATH 142A,B01,083221,Chow; Bennett,0,11,30,30
1650227400439,MATH 142A,B02,083222,Chow; Bennett,0,12,30,30
1650227406465,MATH 193A,A01,083224,Staff,0,5,30,30
1650227406465,MATH 193A,A02,083225,Staff,0,4,30,30
1650227406465,MATH 193A,A03,083781,Staff,0,2,30,30
1650227406465,MATH 193A,A04,083782,Staff,0,1,30,30
1650227412488,MATH 197,001,091859,McAuley; Julian John,9998,0,9999,1
1650227418542,COGS 9,A01,083615,Staff,0,14,60,60
1650227424568,COGS 11,A01,083617,Boyle; Mary E. T.,24,0,40,16
1650227430597,COGS 13,A01,083071,Staff,0,30,40,40
1650227436624,COGS 14A,A01,092681,Staff,0,12,100,100
1650227442646,COGS 14B,A01,083073,Cheng; Tzu-Han,0,7,50,50
1650227448670,COGS 17,A01,092677,Staff,35,0,75,40
1650227454698,COGS 100,A01,083619,Staff,0,21,60,60
1650227460725,COGS 101A,A01,083621,Davis; Joshua Daniel,0,21,60,60
1650227466750,COGS 101B,A01,091572,Staff,6,0,60,54
1650227472776,COGS 101C,A01,083625,Delgado; Tania,20,0,30,10
1650227478800,COGS 107A,A01,083627,Boyle; Mary E. T.,1,7,60,59
1650227484827,COGS 118A,A01,083075,Staff,15,0,60,45
1650227490864,CSE 3,A50,083646,Miranda; Gregory Joseph,22,0,38,16
1650227490864,CSE 3,A51,083647,Miranda; Gregory Joseph,37,0,37,0
1650227496890,CSE 8A,A50,083650,Miranda; Gregory Joseph,0,18,40,40
1650227502915,CSE 11,A01,083080,Cao; Yingjun,0,68,40,40
1650227508950,CSE 12,A01,083652,Staff,0,8,100,100
1650227514976,CSE 15L,A01,083654,Staff,0,1,50,50
1650227514976,CSE 15L,A02,083655,Staff,6,0,50,44
1650227521003,CSE 20,A01,083657,Staff,53,0,80,27
1650227527027,CSE 30,A01,083084,Eldon; John,0,70,40,40
1650227533053,CSE 100,A01,083659,Cao; Yingjun,0,63,50,50
1650227539078,CSE 134B,A01,083661,Powell; Thomas Allan,0,27,65,65
1650227545103,CSE 140,A01,083663,Staff,1,0,75,74
1650227551127,CSE 140L,A01,083088,Eldon; John,0,4,75,75
1650227557187,CSE 175,A01,083665,Kumar; Rakesh,8,0,25,17
1650227563211,CSE 190,A00,092507,Dubnov; Shlomo,14,0,20,6
1650227569237,ECE 45,A01,083139,Staff,0,13,40,40
1650227575262,ECE 65,A50,083695,Staff,0,5,30,30
1650227581288,ECE 109,A01,091882,Touri; Behrouz,47,0,70,23
1650227587316,ECE 180,A00,083140,Abi Samra; Nicholas Camill,24,0,30,6
1650227587316,ECE 180,B00,083141,Abi Samra; Nicholas Camill,8,0,30,22
1650227593340,MATH 10A,A01,083735,Patchell; Gregory David,11,0,30,19
1650227593340,MATH 10A,A02,083736,Patchell; Gregory David,28,0,30,2
1650227593340,MATH 10A,A03,083737,Patchell; Gregory David,26,0,30,4
1650227599373,MATH 10B,A01,083207,Staff,0,6,30,30
1650227599373,MATH 10B,A02,083208,Staff,0,5,30,30
1650227599373,MATH 10B,B01,083739,Staff,17,0,30,13
1650227599373,MATH 10B,B02,083740,Staff,29,0,30,1
1650227605399,MATH 18,A01,083743,Staff,8,0,30,22
1650227605399,MATH 18,A02,083744,Staff,28,0,30,2
1650227605399,MATH 18,A03,083745,Staff,23,0,30,7
1650227605399,MATH 18,A04,083746,Staff,27,0,30,3
1650227605399,MATH 18,B01,083748,Staff,0,10,30,30
1650227605399,MATH 18,B02,083749,Staff,0,7,30,30
1650227605399,MATH 18,B03,083750,Staff,0,7,30,30
1650227605399,MATH 18,B04,083751,Staff,0,8,30,30
1650227611428,MATH 20A,A01,083754,Staff,26,0,40,14
1650227617458,MATH 20B,A01,083756,Staff,1,6,30,29
1650227617458,MATH 20B,A02,083757,Staff,0,6,30,30
1650227623481,MATH 20C,A01,083760,Staff,0,12,30,30
1650227623481,MATH 20C,A02,083761,Staff,0,12,30,30
1650227623481,MATH 20C,B01,083762,Staff,14,0,30,16
1650227623481,MATH 20C,B02,083763,Staff,28,0,30,2
1650227629505,MATH 20D,A01,083765,Staff,1,2,30,29
1650227629505,MATH 20D,A02,083766,Staff,10,0,30,20
1650227629505,MATH 20D,A03,083767,Staff,28,0,30,2
1650227635530,MATH 20E,A01,083771,Staff,8,0,30,22
1650227635530,MATH 20E,A02,083772,Staff,21,0,30,9
1650227635530,MATH 20E,B01,083773,Staff,0,0,30,30
1650227635530,MATH 20E,B02,083774,Staff,12,0,30,18
1650227641556,MATH 103A,A01,083777,Staff,0,9,30,30
1650227641556,MATH 103A,A02,083778,Staff,0,10,30,30
1650227641556,MATH 103A,B01,083779,Staff,0,9,30,30
1650227641556,MATH 103A,B02,083780,Staff,0,9,30,30
1650227647581,MATH 105,A01,085443,Staff,0,17,30,30
1650227653606,MATH 109,A01,083213,Anzaldo; Leesa B,0,3,30,30
1650227653606,MATH 109,A02,083214,Anzaldo; Leesa B,0,6,30,30
1650227653606,MATH 109,B01,083215,Anzaldo; Leesa B,0,4,30,30
1650227653606,MATH 109,B02,083216,Anzaldo; Leesa B,0,4,30,30
1650227659630,MATH 142A,A01,083219,Chow; Bennett,0,12,30,30
1650227659630,MATH 142A,A02,083220,Chow; Bennett,0,11,30,30
1650227659630,MATH 142A,B01,083221,Chow; Bennett,0,11,30,30
1650227659630,MATH 142A,B02,083222,Chow; Bennett,0,12,30,30
1650227665654,MATH 193A,A01,083224,Staff,0,5,30,30
1650227665654,MATH 193A,A02,083225,Staff,0,4,30,30
1650227665654,MATH 193A,A03,083781,Staff,0,2,30,30
1650227665654,MATH 193A,A04,083782,Staff,0,1,30,30
1650227671679,MATH 197,001,091859,McAuley; Julian John,9998,0,9999,1
1650227677739,COGS 9,A01,083615,Staff,0,14,60,60
1650227683761,COGS 11,A01,083617,Boyle; Mary E. T.,24,0,40,16
1650227689794,COGS 13,A01,083071,Staff,0,30,40,40
1650227695821,COGS 14A,A01,092681,Staff,0,12,100,100
1650227701852,COGS 14B,A01,083073,Cheng; Tzu-Han,0,7,50,50
1650227707886,COGS 17,A01,092677,Staff,35,0,75,40
1650227713909,COGS 100,A01,083619,Staff,0,21,60,60
1650227719934,COGS 101A,A01,083621,Davis; Joshua Daniel,0,21,60,60
1650227725958,COGS 101B,A01,091572,Staff,6,0,60,54
1650227731984,COGS 101C,A01,083625,Delgado; Tania,20,0,30,10
1650227738008,COGS 107A,A01,083627,Boyle; Mary E. T.,1,7,60,59
1650227744036,COGS 118A,A01,083075,Staff,15,0,60,45
1650227750065,CSE 3,A50,083646,Miranda; Gregory Joseph,22,0,38,16
1650227750065,CSE 3,A51,083647,Miranda; Gregory Joseph,37,0,37,0
1650227756095,CSE 8A,A50,083650,Miranda; Gregory Joseph,0,18,40,40
1650227762120,CSE 11,A01,083080,Cao; Yingjun,0,68,40,40
1650227768144,CSE 12,A01,083652,Staff,0,8,100,100
1650227774202,CSE 15L,A01,083654,Staff,0,1,50,50
1650227774202,CSE 15L,A02,083655,Staff,6,0,50,44
1650227780226,CSE 20,A01,083657,Staff,53,0,80,27
1650227786257,CSE 30,A01,083084,Eldon; John,0,70,40,40
1650227792287,CSE 100,A01,083659,Cao; Yingjun,0,63,50,50
1650227798390,CSE 134B,A01,083661,Powell; Thomas Allan,0,27,65,65
1650227804416,CSE 140,A01,083663,Staff,1,0,75,74
1650227810443,CSE 140L,A01,083088,Eldon; John,0,4,75,75
1650227816468,CSE 175,A01,083665,Kumar; Rakesh,8,0,25,17
1650227822493,CSE 190,A00,092507,Dubnov; Shlomo,14,0,20,6
1650227828520,ECE 45,A01,083139,Staff,0,13,40,40
1650227834543,ECE 65,A50,083695,Staff,0,5,30,30
1650227840568,ECE 109,A01,091882,Touri; Behrouz,47,0,70,23
1650227846592,ECE 180,A00,083140,Abi Samra; Nicholas Camill,24,0,30,6
1650227846592,ECE 180,B00,083141,Abi Samra; Nicholas Camill,8,0,30,22
1650227852617,MATH 10A,A01,083735,Patchell; Gregory David,11,0,30,19
1650227852617,MATH 10A,A02,083736,Patchell; Gregory David,28,0,30,2
1650227852617,MATH 10A,A03,083737,Patchell; Gregory David,26,0,30,4
1650227858646,MATH 10B,A01,083207,Staff,0,6,30,30
1650227858646,MATH 10B,A02,083208,Staff,0,5,30,30
1650227858646,MATH 10B,B01,083739,Staff,17,0,30,13
1650227858646,MATH 10B,B02,083740,Staff,29,0,30,1
1650227864685,MATH 18,A01,083743,Staff,8,0,30,22
1650227864685,MATH 18,A02,083744,Staff,28,0,30,2
1650227864685,MATH 18,A03,083745,Staff,23,0,30,7
1650227864685,MATH 18,A04,083746,Staff,27,0,30,3
1650227864685,MATH 18,B01,083748,Staff,0,10,30,30
1650227864685,MATH 18,B02,083749,Staff,0,7,30,30
1650227864685,MATH 18,B03,083750,Staff,0,7,30,30
1650227864685,MATH 18,B04,083751,Staff,0,8,30,30
1650227870710,MATH 20A,A01,083754,Staff,26,0,40,14
1650227876733,MATH 20B,A01,083756,Staff,1,6,30,29
1650227876733,MATH 20B,A02,083757,Staff,0,6,30,30
1650227882764,MATH 20C,A01,083760,Staff,0,12,30,30
1650227882764,MATH 20C,A02,083761,Staff,0,12,30,30
1650227882764,MATH 20C,B01,083762,Staff,14,0,30,16
1650227882764,MATH 20C,B02,083763,Staff,28,0,30,2
1650227888789,MATH 20D,A01,083765,Staff,1,2,30,29
1650227888789,MATH 20D,A02,083766,Staff,10,0,30,20
1650227888789,MATH 20D,A03,083767,Staff,28,0,30,2
1650227894816,MATH 20E,A01,083771,Staff,8,0,30,22
1650227894816,MATH 20E,A02,083772,Staff,21,0,30,9
1650227894816,MATH 20E,B01,083773,Staff,0,0,30,30
1650227894816,MATH 20E,B02,083774,Staff,12,0,30,18
1650227900841,MATH 103A,A01,083777,Staff,0,9,30,30
1650227900841,MATH 103A,A02,083778,Staff,0,10,30,30
1650227900841,MATH 103A,B01,083779,Staff,0,9,30,30
1650227900841,MATH 103A,B02,083780,Staff,0,9,30,30
1650227906866,MATH 105,A01,085443,Staff,0,17,30,30
1650227912892,MATH 109,A01,083213,Anzaldo; Leesa B,0,3,30,30
1650227912892,MATH 109,A02,083214,Anzaldo; Leesa B,0,6,30,30
1650227912892,MATH 109,B01,083215,Anzaldo; Leesa B,0,4,30,30
1650227912892,MATH 109,B02,083216,Anzaldo; Leesa B,0,4,30,30
1650227918919,MATH 142A,A01,083219,Chow; Bennett,0,12,30,30
1650227918919,MATH 142A,A02,083220,Chow; Bennett,0,11,30,30
1650227918919,MATH 142A,B01,083221,Chow; Bennett,0,11,30,30
1650227918919,MATH 142A,B02,083222,Chow; Bennett,0,12,30,30
1650227924949,MATH 193A,A01,083224,Staff,0,5,30,30
1650227924949,MATH 193A,A02,083225,Staff,0,4,30,30
1650227924949,MATH 193A,A03,083781,Staff,0,2,30,30
1650227924949,MATH 193A,A04,083782,Staff,0,1,30,30
1650227930973,MATH 197,001,091859,McAuley; Julian John,9998,0,9999,1
1650227937037,COGS 9,A01,083615,Staff,0,14,60,60
1650227943063,COGS 11,A01,083617,Boyle; Mary E. T.,24,0,40,16
1650227949090,COGS 13,A01,083071,Staff,0,30,40,40
1650227955115,COGS 14A,A01,092681,Staff,0,12,100,100
1650227961143,COGS 14B,A01,083073,Cheng; Tzu-Han,0,7,50,50
1650227967168,COGS 17,A01,092677,Staff,35,0,75,40
1650227973200,COGS 100,A01,083619,Staff,0,21,60,60
1650227979223,COGS 101A,A01,083621,Davis; Joshua Daniel,0,21,60,60
1650227985247,COGS 101B,A01,091572,Staff,6,0,60,54
1650227991276,COGS 101C,A01,083625,Delgado; Tania,20,0,30,10
1650227997301,COGS 107A,A01,083627,Boyle; Mary E. T.,1,7,60,59
1650228003326,COGS 118A,A01,083075,Staff,15,0,60,45
1650228009356,CSE 3,A50,083646,Miranda; Gregory Joseph,22,0,38,16
1650228009356,CSE 3,A51,083647,Miranda; Gregory Joseph,37,0,37,0
1650228015384,CSE 8A,A50,083650,Miranda; Gregory Joseph,0,18,40,40
1650228021409,CSE 11,A01,083080,Cao; Yingjun,0,68,40,40
1650228027433,CSE 12,A01,083652,Staff,0,8,100,100
1650228033457,CSE 15L,A01,083654,Staff,0,1,50,50
1650228033457,CSE 15L,A02,083655,Staff,6,0,50,44
1650228039485,CSE 20,A01,083657,Staff,53,0,80,27
1650228045508,CSE 30,A01,083084,Eldon; John,0,70,40,40
1650228051530,CSE 100,A01,083659,Cao; Yingjun,0,63,50,50
1650228057557,CSE 134B,A01,083661,Powell; Thomas Allan,0,27,65,65
1650228063583,CSE 140,A01,083663,Staff,1,0,75,74
1650228069608,CSE 140L,A01,083088,Eldon; John,0,4,75,75
1650228075632,CSE 175,A01,083665,Kumar; Rakesh,8,0,25,17
1650228081657,CSE 190,A00,092507,Dubnov; Shlomo,14,0,20,6
1650228087681,ECE 45,A01,083139,Staff,0,13,40,40
1650228093705,ECE 65,A50,083695,Staff,0,5,30,30
1650228099729,ECE 109,A01,091882,Touri; Behrouz,47,0,70,23
1650228105762,ECE 180,A00,083140,Abi Samra; Nicholas Camill,24,0,30,6
1650228105762,ECE 180,B00,083141,Abi Samra; Nicholas Camill,8,0,30,22
1650228111787,MATH 10A,A01,083735,Patchell; Gregory David,11,0,30,19
1650228111787,MATH 10A,A02,083736,Patchell; Gregory David,28,0,30,2
1650228111787,MATH 10A,A03,083737,Patchell; Gregory David,26,0,30,4
1650228117810,MATH 10B,A01,083207,Staff,0,6,30,30
1650228117810,MATH 10B,A02,083208,Staff,0,5,30,30
1650228117810,MATH 10B,B01,083739,Staff,17,0,30,13
1650228117810,MATH 10B,B02,083740,Staff,29,0,30,1
1650228123840,MATH 18,A01,083743,Staff,8,0,30,22
1650228123840,MATH 18,A02,083744,Staff,28,0,30,2
1650228123840,MATH 18,A03,083745,Staff,23,0,30,7
1650228123840,MATH 18,A04,083746,Staff,27,0,30,3
1650228123840,MATH 18,B01,083748,Staff,0,10,30,30
1650228123840,MATH 18,B02,083749,Staff,0,7,30,30
1650228123840,MATH 18,B03,083750,Staff,0,7,30,30
1650228123840,MATH 18,B04,083751,Staff,0,8,30,30
1650228129864,MATH 20A,A01,083754,Staff,26,0,40,14
1650228135887,MATH 20B,A01,083756,Staff,1,6,30,29
1650228135887,MATH 20B,A02,083757,Staff,0,6,30,30
1650228141911,MATH 20C,A01,083760,Staff,0,12,30,30
1650228141911,MATH 20C,A02,083761,Staff,0,12,30,30
1650228141911,MATH 20C,B01,083762,Staff,14,0,30,16
1650228141911,MATH 20C,B02,083763,Staff,28,0,30,2
1650228147934,MATH 20D,A01,083765,Staff,1,2,30,29
1650228147934,MATH 20D,A02,083766,Staff,10,0,30,20
1650228147934,MATH 20D,A03,083767,Staff,28,0,30,2
1650228153964,MATH 20E,A01,083771,Staff,8,0,30,22
1650228153964,MATH 20E,A02,083772,Staff,21,0,30,9
1650228153964,MATH 20E,B01,083773,Staff,0,0,30,30
1650228153964,MATH 20E,B02,083774,Staff,12,0,30,18
1650228159993,MATH 103A,A01,083777,Staff,0,9,30,30
1650228159993,MATH 103A,A02,083778,Staff,0,10,30,30
1650228159993,MATH 103A,B01,083779,Staff,0,9,30,30
1650228159993,MATH 103A,B02,083780,Staff,0,9,30,30
1650228166021,MATH 105,A01,085443,Staff,0,17,30,30
1650228172044,MATH 109,A01,083213,Anzaldo; Leesa B,0,3,30,30
1650228172044,MATH 109,A02,083214,Anzaldo; Leesa B,0,6,30,30
1650228172044,MATH 109,B01,083215,Anzaldo; Leesa B,0,4,30,30
1650228172044,MATH 109,B02,083216,Anzaldo; Leesa B,0,4,30,30
1650228178082,MATH 142A,A01,083219,Chow; Bennett,0,12,30,30
1650228178082,MATH 142A,A02,083220,Chow; Bennett,0,11,30,30
1650228178082,MATH 142A,B01,083221,Chow; Bennett,0,11,30,30
1650228178082,MATH 142A,B02,083222,Chow; Bennett,0,12,30,30
1650228184106,MATH 193A,A01,083224,Staff,0,5,30,30
1650228184106,MATH 193A,A02,083225,Staff,0,4,30,30
1650228184106,MATH 193A,A03,083781,Staff,0,2,30,30
1650228184106,MATH 193A,A04,083782,Staff,0,1,30,30
1650228190132,MATH 197,001,091859,McAuley; Julian John,9998,0,9999,1
1650228196195,COGS 9,A01,083615,Staff,0,14,60,60
1650228202218,COGS 11,A01,083617,Boyle; Mary E. T.,24,0,40,16
1650228208245,COGS 13,A01,083071,Staff,0,30,40,40
1650228214271,COGS 14A,A01,092681,Staff,0,12,100,100
1650228220295,COGS 14B,A01,083073,Cheng; Tzu-Han,0,7,50,50
1650228226318,COGS 17,A01,092677,Staff,35,0,75,40
1650228232341,COGS 100,A01,083619,Staff,0,21,60,60
1650228238364,COGS 101A,A01,083621,Davis; Joshua Daniel,0,21,60,60
1650228244392,COGS 101B,A01,091572,Staff,6,0,60,54
1650228250421,COGS 101C,A01,083625,Delgado; Tania,20,0,30,10
1650228256448,COGS 107A,A01,083627,Boyle; Mary E. T.,1,7,60,59
1650228262475,COGS 118A,A01,083075,Staff,15,0,60,45
1650228268508,CSE 3,A50,083646,Miranda; Gregory Joseph,22,0,38,16
1650228268508,CSE 3,A51,083647,Miranda; Gregory Joseph,37,0,37,0
1650228274533,CSE 8A,A50,083650,Miranda; Gregory Joseph,0,18,40,40
1650228280555,CSE 11,A01,083080,Cao; Yingjun,0,68,40,40
1650228286583,CSE 12,A01,083652,Staff,0,8,100,100
1650228292610,CSE 15L,A01,083654,Staff,0,1,50,50
1650228292610,CSE 15L,A02,083655,Staff,6,0,50,44
1650228298643,CSE 20,A01,083657,Staff,53,0,80,27
1650228304670,CSE 30,A01,083084,Eldon; John,0,70,40,40
1650228310698,CSE 100,A01,083659,Cao; Yingjun,0,63,50,50
1650228316724,CSE 134B,A01,083661,Powell; Thomas Allan,0,27,65,65
1650228322750,CSE 140,A01,083663,Staff,1,0,75,74
1650228328775,CSE 140L,A01,083088,Eldon; John,0,4,75,75
1650228334804,CSE 175,A01,083665,Kumar; Rakesh,8,0,25,17
1650228340830,CSE 190,A00,092507,Dubnov; Shlomo,14,0,20,6
1650228346859,ECE 45,A01,083139,Staff,0,13,40,40
1650228352886,ECE 65,A50,083695,Staff,0,5,30,30
1650228358911,ECE 109,A01,091882,Touri; Behrouz,47,0,70,23
1650228364937,ECE 180,A00,083140,Abi Samra; Nicholas Camill,24,0,30,6
1650228364937,ECE 180,B00,083141,Abi Samra; Nicholas Camill,8,0,30,22
1650228370964,MATH 10A,A01,083735,Patchell; Gregory David,11,0,30,19
1650228370964,MATH 10A,A02,083736,Patchell; Gregory David,28,0,30,2
1650228370964,MATH 10A,A03,083737,Patchell; Gregory David,26,0,30,4
1650228376991,MATH 10B,A01,083207,Staff,0,6,30,30
1650228376991,MATH 10B,A02,083208,Staff,0,5,30,30
1650228376991,MATH 10B,B01,083739,Staff,17,0,30,13
1650228376991,MATH 10B,B02,083740,Staff,29,0,30,1
1650228383024,MATH 18,A01,083743,Staff,8,0,30,22
1650228383024,MATH 18,A02,083744,Staff,28,0,30,2
1650228383024,MATH 18,A03,083745,Staff,23,0,30,7
1650228383024,MATH 18,A04,083746,Staff,27,0,30,3
1650228383024,MATH 18,B01,083748,Staff,0,10,30,30
1650228383024,MATH 18,B02,083749,Staff,0,7,30,30
1650228383024,MATH 18,B03,083750,Staff,0,7,30,30
1650228383024,MATH 18,B04,083751,Staff,0,8,30,30
1650228389047,MATH 20A,A01,083754,Staff,26,0,40,14
1650228395163,MATH 20B,A01,083756,Staff,1,6,30,29
1650228395163,MATH 20B,A02,083757,Staff,0,6,30,30
1650228401188,MATH 20C,A01,083760,Staff,0,12,30,30
1650228401188,MATH 20C,A02,083761,Staff,0,12,30,30
1650228401188,MATH 20C,B01,083762,Staff,14,0,30,16
1650228401188,MATH 20C,B02,083763,Staff,28,0,30,2
1650228407213,MATH 20D,A01,083765,Staff,1,2,30,29
1650228407213,MATH 20D,A02,083766,Staff,10,0,30,20
1650228407213,MATH 20D,A03,083767,Staff,28,0,30,2
1650228413237,MATH 20E,A01,083771,Staff,8,0,30,22
1650228413237,MATH 20E,A02,083772,Staff,21,0,30,9
1650228413237,MATH 20E,B01,083773,Staff,0,0,30,30
1650228413237,MATH 20E,B02,083774,Staff,12,0,30,18
1650228419265,MATH 103A,A01,083777,Staff,0,9,30,30
1650228419265,MATH 103A,A02,083778,Staff,0,10,30,30
1650228419265,MATH 103A,B01,083779,Staff,0,9,30,30
1650228419265,MATH 103A,B02,083780,Staff,0,9,30,30
1650228425288,MATH 105,A01,085443,Staff,0,17,30,30
1650228431323,MATH 109,A01,083213,Anzaldo; Leesa B,0,3,30,30
1650228431323,MATH 109,A02,083214,Anzaldo; Leesa B,0,6,30,30
1650228431323,MATH 109,B01,083215,Anzaldo; Leesa B,0,4,30,30
1650228431323,MATH 109,B02,083216,Anzaldo; Leesa B,0,4,30,30
1650228437377,MATH 142A,A01,083219,Chow; Bennett,0,12,30,30
1650228437377,MATH 142A,A02,083220,Chow; Bennett,0,11,30,30
1650228437377,MATH 142A,B01,083221,Chow; Bennett,0,11,30,30
1650228437377,MATH 142A,B02,083222,Chow; Bennett,0,12,30,30
1650228443402,MATH 193A,A01,083224,Staff,0,5,30,30
1650228443402,MATH 193A,A02,083225,Staff,0,4,30,30
1650228443402,MATH 193A,A03,083781,Staff,0,2,30,30
1650228443402,MATH 193A,A04,083782,Staff,0,1,30,30
1650228449428,MATH 197,001,091859,McAuley; Julian John,9998,0,9999,1
1650228455481,COGS 9,A01,083615,Staff,0,14,60,60
1650228461506,COGS 11,A01,083617,Boyle; Mary E. T.,24,0,40,16
1650228467538,COGS 13,A01,083071,Staff,0,30,40,40
1650228473566,COGS 14A,A01,092681,Staff,0,12,100,100
1650228479593,COGS 14B,A01,083073,Cheng; Tzu-Han,0,7,50,50
1650228485617,COGS 17,A01,092677,Staff,35,0,75,40
1650228491649,COGS 100,A01,083619,Staff,0,21,60,60
1650228497672,COGS 101A,A01,083621,Davis; Joshua Daniel,0,21,60,60
1650228503698,COGS 101B,A01,091572,Staff,6,0,60,54
1650228509722,COGS 101C,A01,083625,Delgado; Tania,20,0,30,10
1650228515746,COGS 107A,A01,083627,Boyle; Mary E. T.,1,7,60,59
1650228521775,COGS 118A,A01,083075,Staff,15,0,60,45
1650228527798,CSE 3,A50,083646,Miranda; Gregory Joseph,22,0,38,16
1650228527798,CSE 3,A51,083647,Miranda; Gregory Joseph,37,0,37,0
1650228533825,CSE 8A,A50,083650,Miranda; Gregory Joseph,0,18,40,40
1650228539850,CSE 11,A01,083080,Cao; Yingjun,0,68,40,40
1650228545874,CSE 12,A01,083652,Staff,0,8,100,100
1650228551899,CSE 15L,A01,083654,Staff,0,1,50,50
1650228551899,CSE 15L,A02,083655,Staff,6,0,50,44
1650228557922,CSE 20,A01,083657,Staff,53,0,80,27
1650228563946,CSE 30,A01,083084,Eldon; John,0,70,40,40
1650228569969,CSE 100,A01,083659,Cao; Yingjun,0,63,50,50
1650228575993,CSE 134B,A01,083661,Powell; Thomas Allan,0,27,65,65
1650228582017,CSE 140,A01,083663,Staff,1,0,75,74
1650228588043,CSE 140L,A01,083088,Eldon; John,0,4,75,75
1650228594067,CSE 175,A01,083665,Kumar; Rakesh,8,0,25,17
1650228600091,CSE 190,A00,092507,Dubnov; Shlomo,14,0,20,6
1650228606117,ECE 45,A01,083139,Staff,0,13,40,40
1650228612141,ECE 65,A50,083695,Staff,0,5,30,30
1650228618168,ECE 109,A01,091882,Touri; Behrouz,47,0,70,23
1650228624191,ECE 180,A00,083140,Abi Samra; Nicholas Camill,24,0,30,6
1650228624191,ECE 180,B00,083141,Abi Samra; Nicholas Camill,8,0,30,22
1650228630218,MATH 10A,A01,083735,Patchell; Gregory David,11,0,30,19
1650228630218,MATH 10A,A02,083736,Patchell; Gregory David,28,0,30,2
1650228630218,MATH 10A,A03,083737,Patchell; Gregory David,26,0,30,4
1650228636241,MATH 10B,A01,083207,Staff,0,6,30,30
1650228636241,MATH 10B,A02,083208,Staff,0,5,30,30
1650228636241,MATH 10B,B01,083739,Staff,17,0,30,13
1650228636241,MATH 10B,B02,083740,Staff,29,0,30,1
1650228642267,MATH 18,A01,083743,Staff,8,0,30,22
1650228642267,MATH 18,A02,083744,Staff,28,0,30,2
1650228642267,MATH 18,A03,083745,Staff,23,0,30,7
1650228642267,MATH 18,A04,083746,Staff,27,0,30,3
1650228642267,MATH 18,B01,083748,Staff,0,10,30,30
1650228642267,MATH 18,B02,083749,Staff,0,7,30,30
1650228642267,MATH 18,B03,083750,Staff,0,7,30,30
1650228642267,MATH 18,B04,083751,Staff,0,8,30,30
1650228648290,MATH 20A,A01,083754,Staff,26,0,40,14
1650228654313,MATH 20B,A01,083756,Staff,1,6,30,29
1650228654313,MATH 20B,A02,083757,Staff,0,6,30,30
1650228660338,MATH 20C,A01,083760,Staff,0,12,30,30
1650228660338,MATH 20C,A02,083761,Staff,0,12,30,30
1650228660338,MATH 20C,B01,083762,Staff,14,0,30,16
1650228660338,MATH 20C,B02,083763,Staff,28,0,30,2
1650228666364,MATH 20D,A01,083765,Staff,1,2,30,29
1650228666364,MATH 20D,A02,083766,Staff,10,0,30,20
1650228666364,MATH 20D,A03,083767,Staff,28,0,30,2
1650228672388,MATH 20E,A01,083771,Staff,8,0,30,22
1650228672388,MATH 20E,A02,083772,Staff,21,0,30,9
1650228672388,MATH 20E,B01,083773,Staff,0,0,30,30
1650228672388,MATH 20E,B02,083774,Staff,12,0,30,18
1650228678414,MATH 103A,A01,083777,Staff,0,9,30,30
1650228678414,MATH 103A,A02,083778,Staff,0,10,30,30
1650228678414,MATH 103A,B01,083779,Staff,0,9,30,30
1650228678414,MATH 103A,B02,083780,Staff,0,9,30,30
1650228684437,MATH 105,A01,085443,Staff,0,17,30,30
1650228690461,MATH 109,A01,083213,Anzaldo; Leesa B,0,3,30,30
1650228690461,MATH 109,A02,083214,Anzaldo; Leesa B,0,6,30,30
1650228690461,MATH 109,B01,083215,Anzaldo; Leesa B,0,4,30,30
1650228690461,MATH 109,B02,083216,Anzaldo; Leesa B,0,4,30,30
1650228696487,MATH 142A,A01,083219,Chow; Bennett,0,12,30,30
1650228696487,MATH 142A,A02,083220,Chow; Bennett,0,11,30,30
1650228696487,MATH 142A,B01,083221,Chow; Bennett,0,11,30,30
1650228696487,MATH 142A,B02,083222,Chow; Bennett,0,12,30,30
1650228702515,MATH 193A,A01,083224,Staff,0,5,30,30
1650228702515,MATH 193A,A02,083225,Staff,0,4,30,30
1650228702515,MATH 193A,A03,083781,Staff,0,2,30,30
1650228702515,MATH 193A,A04,083782,Staff,0,1,30,30
1650228708539,MATH 197,001,091859,McAuley; Julian John,9998,0,9999,1
1650228714594,COGS 9,A01,083615,Staff,0,14,60,60
1650228720621,COGS 11,A01,083617,Boyle; Mary E. T.,24,0,40,16
1650228726646,COGS 13,A01,083071,Staff,0,30,40,40
1650228732675,COGS 14A,A01,092681,Staff,0,12,100,100
1650228738702,COGS 14B,A01,083073,Cheng; Tzu-Han,0,7,50,50
1650228744727,COGS 17,A01,092677,Staff,34,0,75,41
1650228750751,COGS 100,A01,083619,Staff,0,21,60,60
1650228756775,COGS 101A,A01,083621,Davis; Joshua Daniel,0,21,60,60
1650228762798,COGS 101B,A01,091572,Staff,6,0,60,54
1650228768823,COGS 101C,A01,083625,Delgado; Tania,20,0,30,10
1650228774847,COGS 107A,A01,083627,Boyle; Mary E. T.,1,7,60,59
1650228780871,COGS 118A,A01,083075,Staff,15,0,60,45
1650228786907,CSE 3,A50,083646,Miranda; Gregory Joseph,22,0,38,16
1650228786907,CSE 3,A51,083647,Miranda; Gregory Joseph,37,0,37,0
1650228792934,CSE 8A,A50,083650,Miranda; Gregory Joseph,0,18,40,40
1650228798959,CSE 11,A01,083080,Cao; Yingjun,0,68,40,40
1650228804983,CSE 12,A01,083652,Staff,0,8,100,100
1650228811006,CSE 15L,A01,083654,Staff,0,1,50,50
1650228811006,CSE 15L,A02,083655,Staff,5,0,50,45
1650228817034,CSE 20,A01,083657,Staff,53,0,80,27
1650228823057,CSE 30,A01,083084,Eldon; John,0,70,40,40
1650228829084,CSE 100,A01,083659,Cao; Yingjun,0,63,50,50
1650228835114,CSE 134B,A01,083661,Powell; Thomas Allan,0,27,65,65
1650228841142,CSE 140,A01,083663,Staff,1,0,75,74
1650228847164,CSE 140L,A01,083088,Eldon; John,0,4,75,75
1650228853194,CSE 175,A01,083665,Kumar; Rakesh,8,0,25,17
1650228859216,CSE 190,A00,092507,Dubnov; Shlomo,14,0,20,6
1650228865241,ECE 45,A01,083139,Staff,0,13,40,40
1650228871264,ECE 65,A50,083695,Staff,0,5,30,30
1650228877290,ECE 109,A01,091882,Touri; Behrouz,47,0,70,23
1650228883314,ECE 180,A00,083140,Abi Samra; Nicholas Camill,24,0,30,6
1650228883314,ECE 180,B00,083141,Abi Samra; Nicholas Camill,8,0,30,22
1650228889349,MATH 10A,A01,083735,Patchell; Gregory David,11,0,30,19
1650228889349,MATH 10A,A02,083736,Patchell; Gregory David,28,0,30,2
1650228889349,MATH 10A,A03,083737,Patchell; Gregory David,26,0,30,4
1650228895377,MATH 10B,A01,083207,Staff,0,6,30,30
1650228895377,MATH 10B,A02,083208,Staff,0,5,30,30
1650228895377,MATH 10B,B01,083739,Staff,17,0,30,13
1650228895377,MATH 10B,B02,083740,Staff,29,0,30,1
1650228901410,MATH 18,A01,083743,Staff,8,0,30,22
1650228901410,MATH 18,A02,083744,Staff,28,0,30,2
1650228901410,MATH 18,A03,083745,Staff,23,0,30,7
1650228901410,MATH 18,A04,083746,Staff,27,0,30,3
1650228901410,MATH 18,B01,083748,Staff,0,10,30,30
1650228901410,MATH 18,B02,083749,Staff,0,7,30,30
1650228901410,MATH 18,B03,083750,Staff,0,7,30,30
1650228901410,MATH 18,B04,083751,Staff,0,8,30,30
1650228907436,MATH 20A,A01,083754,Staff,26,0,40,14
1650228913465,MATH 20B,A01,083756,Staff,1,6,30,29
1650228913465,MATH 20B,A02,083757,Staff,0,6,30,30
1650228919497,MATH 20C,A01,083760,Staff,0,12,30,30
1650228919497,MATH 20C,A02,083761,Staff,0,12,30,30
1650228919497,MATH 20C,B01,083762,Staff,14,0,30,16
1650228919497,MATH 20C,B02,083763,Staff,28,0,30,2
1650228925522,MATH 20D,A01,083765,Staff,1,2,30,29
1650228925522,MATH 20D,A02,083766,Staff,10,0,30,20
1650228925522,MATH 20D,A03,083767,Staff,28,0,30,2
1650228931552,MATH 20E,A01,083771,Staff,8,0,30,22
1650228931552,MATH 20E,A02,083772,Staff,21,0,30,9
1650228931552,MATH 20E,B01,083773,Staff,0,0,30,30
1650228931552,MATH 20E,B02,083774,Staff,12,0,30,18
1650228937576,MATH 103A,A01,083777,Staff,0,9,30,30
1650228937576,MATH 103A,A02,083778,Staff,0,10,30,30
1650228937576,MATH 103A,B01,083779,Staff,0,9,30,30
1650228937576,MATH 103A,B02,083780,Staff,0,9,30,30
1650228943598,MATH 105,A01,085443,Staff,0,17,30,30
1650228949627,MATH 109,A01,083213,Anzaldo; Leesa B,0,3,30,30
1650228949627,MATH 109,A02,083214,Anzaldo; Leesa B,0,6,30,30
1650228949627,MATH 109,B01,083215,Anzaldo; Leesa B,0,4,30,30
1650228949627,MATH 109,B02,083216,Anzaldo; Leesa B,0,4,30,30
1650228955652,MATH 142A,A01,083219,Chow; Bennett,0,12,30,30
1650228955652,MATH 142A,A02,083220,Chow; Bennett,0,11,30,30
1650228955652,MATH 142A,B01,083221,Chow; Bennett,0,11,30,30
1650228955652,MATH 142A,B02,083222,Chow; Bennett,0,12,30,30
1650228961677,MATH 193A,A01,083224,Staff,0,5,30,30
1650228961677,MATH 193A,A02,083225,Staff,0,4,30,30
1650228961677,MATH 193A,A03,083781,Staff,0,2,30,30
1650228961677,MATH 193A,A04,083782,Staff,0,1,30,30
1650228967701,MATH 197,001,091859,McAuley; Julian John,9998,0,9999,1
1650228973764,COGS 9,A01,083615,Staff,0,14,60,60
1650228979787,COGS 11,A01,083617,Boyle; Mary E. T.,24,0,40,16
1650228985899,COGS 13,A01,083071,Staff,0,30,40,40
1650228991930,COGS 14A,A01,092681,Staff,0,12,100,100
1650228997952,COGS 14B,A01,083073,Cheng; Tzu-Han,0,7,50,50
1650229003976,COGS 17,A01,092677,Staff,34,0,75,41
1650229010003,COGS 100,A01,083619,Staff,0,21,60,60
1650229016031,COGS 101A,A01,083621,Davis; Joshua Daniel,0,21,60,60
1650229022054,COGS 101B,A01,091572,Staff,6,0,60,54
1650229028080,COGS 101C,A01,083625,Delgado; Tania,20,0,30,10
1650229034107,COGS 107A,A01,083627,Boyle; Mary E. T.,1,7,60,59
1650229040130,COGS 118A,A01,083075,Staff,15,0,60,45
1650229046152,CSE 3,A50,083646,Miranda; Gregory Joseph,22,0,38,16
1650229046152,CSE 3,A51,083647,Miranda; Gregory Joseph,37,0,37,0
1650229052175,CSE 8A,A50,083650,Miranda; Gregory Joseph,0,18,40,40
1650229058201,CSE 11,A01,083080,Cao; Yingjun,0,68,40,40
1650229064222,CSE 12,A01,083652,Staff,0,8,100,100
1650229070245,CSE 15L,A01,083654,Staff,0,1,50,50
1650229070245,CSE 15L,A02,083655,Staff,5,0,50,45
1650229076271,CSE 20,A01,083657,Staff,53,0,80,27
1650229082298,CSE 30,A01,083084,Eldon; John,0,70,40,40
1650229088322,CSE 100,A01,083659,Cao; Yingjun,0,63,50,50
1650229094354,CSE 134B,A01,083661,Powell; Thomas Allan,0,27,65,65
1650229100380,CSE 140,A01,083663,Staff,1,0,75,74
1650229106403,CSE 140L,A01,083088,Eldon; John,0,4,75,75
1650229112427,CSE 175,A01,083665,Kumar; Rakesh,8,0,25,17
1650229118457,CSE 190,A00,092507,Dubnov; Shlomo,14,0,20,6
1650229124479,ECE 45,A01,083139,Staff,0,13,40,40
1650229130529,ECE 65,A50,083695,Staff,0,5,30,30
1650229136555,ECE 109,A01,091882,Touri; Behrouz,47,0,70,23
1650229142579,ECE 180,A00,083140,Abi Samra; Nicholas Camill,24,0,30,6
1650229142579,ECE 180,B00,083141,Abi Samra; Nicholas Camill,8,0,30,22
1650229148606,MATH 10A,A01,083735,Patchell; Gregory David,11,0,30,19
1650229148606,MATH 10A,A02,083736,Patchell; Gregory David,28,0,30,2
1650229148606,MATH 10A,A03,083737,Patchell; Gregory David,26,0,30,4
1650229154635,MATH 10B,A01,083207,Staff,0,6,30,30
1650229154635,MATH 10B,A02,083208,Staff,0,5,30,30
1650229154635,MATH 10B,B01,083739,Staff,17,0,30,13
1650229154635,MATH 10B,B02,083740,Staff,29,0,30,1
1650229160661,MATH 18,A01,083743,Staff,8,0,30,22
1650229160661,MATH 18,A02,083744,Staff,28,0,30,2
1650229160661,MATH 18,A03,083745,Staff,23,0,30,7
1650229160661,MATH 18,A04,083746,Staff,27,0,30,3
1650229160661,MATH 18,B01,083748,Staff,0,10,30,30
1650229160661,MATH 18,B02,083749,Staff,0,7,30,30
1650229160661,MATH 18,B03,083750,Staff,0,7,30,30
1650229160661,MATH 18,B04,083751,Staff,0,8,30,30
1650229166688,MATH 20A,A01,083754,Staff,26,0,40,14
1650229172715,MATH 20B,A01,083756,Staff,1,6,30,29
1650229172715,MATH 20B,A02,083757,Staff,0,6,30,30
1650229178738,MATH 20C,A01,083760,Staff,0,12,30,30
1650229178738,MATH 20C,A02,083761,Staff,0,12,30,30
1650229178738,MATH 20C,B01,083762,Staff,14,0,30,16
1650229178738,MATH 20C,B02,083763,Staff,28,0,30,2
1650229184774,MATH 20D,A01,083765,Staff,1,2,30,29
1650229184774,MATH 20D,A02,083766,Staff,10,0,30,20
1650229184774,MATH 20D,A03,083767,Staff,28,0,30,2
1650229190798,MATH 20E,A01,083771,Staff,8,0,30,22
1650229190798,MATH 20E,A02,083772,Staff,21,0,30,9
1650229190798,MATH 20E,B01,083773,Staff,0,0,30,30
1650229190798,MATH 20E,B02,083774,Staff,12,0,30,18
1650229196821,MATH 103A,A01,083777,Staff,0,9,30,30
1650229196821,MATH 103A,A02,083778,Staff,0,10,30,30
1650229196821,MATH 103A,B01,083779,Staff,0,9,30,30
1650229196821,MATH 103A,B02,083780,Staff,0,9,30,30
1650229202845,MATH 105,A01,085443,Staff,0,17,30,30
1650229208872,MATH 109,A01,083213,Anzaldo; Leesa B,0,3,30,30
1650229208872,MATH 109,A02,083214,Anzaldo; Leesa B,0,6,30,30
1650229208872,MATH 109,B01,083215,Anzaldo; Leesa B,0,4,30,30
1650229208872,MATH 109,B02,083216,Anzaldo; Leesa B,0,4,30,30
1650229214899,MATH 142A,A01,083219,Chow; Bennett,0,12,30,30
1650229214899,MATH 142A,A02,083220,Chow; Bennett,0,11,30,30
1650229214899,MATH 142A,B01,083221,Chow; Bennett,0,11,30,30
1650229214899,MATH 142A,B02,083222,Chow; Bennett,0,12,30,30
1650229220927,MATH 193A,A01,083224,Staff,0,5,30,30
1650229220927,MATH 193A,A02,083225,Staff,0,4,30,30
1650229220927,MATH 193A,A03,083781,Staff,0,2,30,30
1650229220927,MATH 193A,A04,083782,Staff,0,1,30,30
1650229226950,MATH 197,001,091859,McAuley; Julian John,9998,0,9999,1
1650229233011,COGS 9,A01,083615,Staff,0,14,60,60
1650229239034,COGS 11,A01,083617,Boyle; Mary E. T.,24,0,40,16
1650229245056,COGS 13,A01,083071,Staff,0,30,40,40
1650229251082,COGS 14A,A01,092681,Staff,0,12,100,100
1650229257107,COGS 14B,A01,083073,Cheng; Tzu-Han,0,7,50,50
1650229263130,COGS 17,A01,092677,Staff,34,0,75,41
1650229269153,COGS 100,A01,083619,Staff,0,21,60,60
1650229275178,COGS 101A,A01,083621,Davis; Joshua Daniel,0,21,60,60
1650229281200,COGS 101B,A01,091572,Staff,6,0,60,54
1650229287227,COGS 101C,A01,083625,Delgado; Tania,20,0,30,10
1650229293257,COGS 107A,A01,083627,Boyle; Mary E. T.,1,7,60,59
1650229299281,COGS 118A,A01,083075,Staff,15,0,60,45
1650229305309,CSE 3,A50,083646,Miranda; Gregory Joseph,22,0,38,16
1650229305309,CSE 3,A51,083647,Miranda; Gregory Joseph,37,0,37,0
1650229311336,CSE 8A,A50,083650,Miranda; Gregory Joseph,0,18,40,40
1650229317365,CSE 11,A01,083080,Cao; Yingjun,0,68,40,40
1650229323388,CSE 12,A01,083652,Staff,0,8,100,100
1650229329415,CSE 15L,A01,083654,Staff,0,1,50,50
1650229329415,CSE 15L,A02,083655,Staff,5,0,50,45
1650229335441,CSE 20,A01,083657,Staff,53,0,80,27
1650229341465,CSE 30,A01,083084,Eldon; John,0,70,40,40
1650229347488,CSE 100,A01,083659,Cao; Yingjun,0,63,50,50
1650229353521,CSE 134B,A01,083661,Powell; Thomas Allan,0,27,65,65
1650229359546,CSE 140,A01,083663,Staff,1,0,75,74
1650229365569,CSE 140L,A01,083088,Eldon; John,0,4,75,75
1650229371593,CSE 175,A01,083665,Kumar; Rakesh,8,0,25,17
1650229377619,CSE 190,A00,092507,Dubnov; Shlomo,14,0,20,6
1650229383645,ECE 45,A01,083139,Staff,0,13,40,40
1650229389669,ECE 65,A50,083695,Staff,0,5,30,30
1650229395694,ECE 109,A01,091882,Touri; Behrouz,47,0,70,23
1650229401718,ECE 180,A00,083140,Abi Samra; Nicholas Camill,24,0,30,6
1650229401718,ECE 180,B00,083141,Abi Samra; Nicholas Camill,8,0,30,22
1650229407741,MATH 10A,A01,083735,Patchell; Gregory David,11,0,30,19
1650229407741,MATH 10A,A02,083736,Patchell; Gregory David,28,0,30,2
1650229407741,MATH 10A,A03,083737,Patchell; Gregory David,26,0,30,4
1650229413769,MATH 10B,A01,083207,Staff,0,6,30,30
1650229413769,MATH 10B,A02,083208,Staff,0,5,30,30
1650229413769,MATH 10B,B01,083739,Staff,17,0,30,13
1650229413769,MATH 10B,B02,083740,Staff,29,0,30,1
1650229419796,MATH 18,A01,083743,Staff,8,0,30,22
1650229419796,MATH 18,A02,083744,Staff,28,0,30,2
1650229419796,MATH 18,A03,083745,Staff,23,0,30,7
1650229419796,MATH 18,A04,083746,Staff,27,0,30,3
1650229419796,MATH 18,B01,083748,Staff,0,10,30,30
1650229419796,MATH 18,B02,083749,Staff,0,7,30,30
1650229419796,MATH 18,B03,083750,Staff,0,7,30,30
1650229419796,MATH 18,B04,083751,Staff,0,8,30,30
1650229425822,MATH 20A,A01,083754,Staff,26,0,40,14
1650229431844,MATH 20B,A01,083756,Staff,1,6,30,29
1650229431844,MATH 20B,A02,083757,Staff,0,6,30,30
1650229437869,MATH 20C,A01,083760,Staff,0,12,30,30
1650229437869,MATH 20C,A02,083761,Staff,0,12,30,30
1650229437869,MATH 20C,B01,083762,Staff,14,0,30,16
1650229437869,MATH 20C,B02,083763,Staff,28,0,30,2
1650229443896,MATH 20D,A01,083765,Staff,1,2,30,29
1650229443896,MATH 20D,A02,083766,Staff,10,0,30,20
1650229443896,MATH 20D,A03,083767,Staff,28,0,30,2
1650229449920,MATH 20E,A01,083771,Staff,8,0,30,22
1650229449920,MATH 20E,A02,083772,Staff,21,0,30,9
1650229449920,MATH 20E,B01,083773,Staff,0,0,30,30
1650229449920,MATH 20E,B02,083774,Staff,12,0,30,18
1650229455948,MATH 103A,A01,083777,Staff,0,9,30,30
1650229455948,MATH 103A,A02,083778,Staff,0,10,30,30
1650229455948,MATH 103A,B01,083779,Staff,0,9,30,30
1650229455948,MATH 103A,B02,083780,Staff,0,9,30,30
1650229461974,MATH 105,A01,085443,Staff,0,17,30,30
1650229468001,MATH 109,A01,083213,Anzaldo; Leesa B,0,3,30,30
1650229468001,MATH 109,A02,083214,Anzaldo; Leesa B,0,6,30,30
1650229468001,MATH 109,B01,083215,Anzaldo; Leesa B,0,4,30,30
1650229468001,MATH 109,B02,083216,Anzaldo; Leesa B,0,4,30,30
1650229474030,MATH 142A,A01,083219,Chow; Bennett,0,12,30,30
1650229474030,MATH 142A,A02,083220,Chow; Bennett,0,11,30,30
1650229474030,MATH 142A,B01,083221,Chow; Bennett,0,11,30,30
1650229474030,MATH 142A,B02,083222,Chow; Bennett,0,12,30,30
1650229480053,MATH 193A,A01,083224,Staff,0,5,30,30
1650229480053,MATH 193A,A02,083225,Staff,0,4,30,30
1650229480053,MATH 193A,A03,083781,Staff,0,2,30,30
1650229480053,MATH 193A,A04,083782,Staff,0,1,30,30
1650229486075,MATH 197,001,091859,McAuley; Julian John,9998,0,9999,1
1650229492133,COGS 9,A01,083615,Staff,0,14,60,60
1650229498156,COGS 11,A01,083617,Boyle; Mary E. T.,24,0,40,16
1650229504181,COGS 13,A01,083071,Staff,0,30,40,40
1650229510207,COGS 14A,A01,092681,Staff,0,12,100,100
1650229516232,COGS 14B,A01,083073,Cheng; Tzu-Han,0,7,50,50
1650229522256,COGS 17,A01,092677,Staff,34,0,75,41
1650229528279,COGS 100,A01,083619,Staff,0,21,60,60
1650229534313,COGS 101A,A01,083621,Davis; Joshua Daniel,0,21,60,60
1650229540337,COGS 101B,A01,091572,Staff,6,0,60,54
1650229546360,COGS 101C,A01,083625,Delgado; Tania,20,0,30,10
1650229552383,COGS 107A,A01,083627,Boyle; Mary E. T.,1,7,60,59
1650229558411,COGS 118A,A01,083075,Staff,15,0,60,45
1650229564433,CSE 3,A50,083646,Miranda; Gregory Joseph,22,0,38,16
1650229564433,CSE 3,A51,083647,Miranda; Gregory Joseph,37,0,37,0
1650229570457,CSE 8A,A50,083650,Miranda; Gregory Joseph,0,18,40,40
1650229576483,CSE 11,A01,083080,Cao; Yingjun,0,68,40,40
1650229582598,CSE 12,A01,083652,Staff,0,8,100,100
1650229588621,CSE 15L,A01,083654,Staff,0,1,50,50
1650229588621,CSE 15L,A02,083655,Staff,5,0,50,45
1650229594644,CSE 20,A01,083657,Staff,53,0,80,27
1650229600675,CSE 30,A01,083084,Eldon; John,0,70,40,40
1650229606700,CSE 100,A01,083659,Cao; Yingjun,0,63,50,50
1650229612727,CSE 134B,A01,083661,Powell; Thomas Allan,0,27,65,65
1650229618751,CSE 140,A01,083663,Staff,1,0,75,74
1650229624775,CSE 140L,A01,083088,Eldon; John,0,4,75,75
1650229630799,CSE 175,A01,083665,Kumar; Rakesh,8,0,25,17
1650229636822,CSE 190,A00,092507,Dubnov; Shlomo,14,0,20,6
1650229642846,ECE 45,A01,083139,Staff,0,13,40,40
1650229648871,ECE 65,A50,083695,Staff,0,5,30,30
1650229654895,ECE 109,A01,091882,Touri; Behrouz,47,0,70,23
1650229660919,ECE 180,A00,083140,Abi Samra; Nicholas Camill,24,0,30,6
1650229660919,ECE 180,B00,083141,Abi Samra; Nicholas Camill,8,0,30,22
1650229666952,MATH 10A,A01,083735,Patchell; Gregory David,11,0,30,19
1650229666952,MATH 10A,A02,083736,Patchell; Gregory David,28,0,30,2
1650229666952,MATH 10A,A03,083737,Patchell; Gregory David,26,0,30,4
1650229672976,MATH 10B,A01,083207,Staff,0,6,30,30
1650229672976,MATH 10B,A02,083208,Staff,0,5,30,30
1650229672976,MATH 10B,B01,083739,Staff,17,0,30,13
1650229672976,MATH 10B,B02,083740,Staff,29,0,30,1
1650229679009,MATH 18,A01,083743,Staff,8,0,30,22
1650229679009,MATH 18,A02,083744,Staff,28,0,30,2
1650229679009,MATH 18,A03,083745,Staff,23,0,30,7
1650229679009,MATH 18,A04,083746,Staff,27,0,30,3
1650229679009,MATH 18,B01,083748,Staff,0,10,30,30
1650229679009,MATH 18,B02,083749,Staff,0,7,30,30
1650229679009,MATH 18,B03,083750,Staff,0,7,30,30
1650229679009,MATH 18,B04,083751,Staff,0,8,30,30
1650229685047,MATH 20A,A01,083754,Staff,26,0,40,14
1650229691082,MATH 20B,A01,083756,Staff,1,6,30,29
1650229691082,MATH 20B,A02,083757,Staff,0,6,30,30
1650229697108,MATH 20C,A01,083760,Staff,0,12,30,30
1650229697108,MATH 20C,A02,083761,Staff,0,12,30,30
1650229697108,MATH 20C,B01,083762,Staff,14,0,30,16
1650229697108,MATH 20C,B02,083763,Staff,28,0,30,2
1650229703130,MATH 20D,A01,083765,Staff,1,2,30,29
1650229703130,MATH 20D,A02,083766,Staff,10,0,30,20
1650229703130,MATH 20D,A03,083767,Staff,28,0,30,2
1650229709154,MATH 20E,A01,083771,Staff,8,0,30,22
1650229709154,MATH 20E,A02,083772,Staff,21,0,30,9
1650229709154,MATH 20E,B01,083773,Staff,0,0,30,30
1650229709154,MATH 20E,B02,083774,Staff,12,0,30,18
1650229715180,MATH 103A,A01,083777,Staff,0,9,30,30
1650229715180,MATH 103A,A02,083778,Staff,0,10,30,30
1650229715180,MATH 103A,B01,083779,Staff,0,9,30,30
1650229715180,MATH 103A,B02,083780,Staff,0,9,30,30
1650229721207,MATH 105,A01,085443,Staff,0,17,30,30
1650229727234,MATH 109,A01,083213,Anzaldo; Leesa B,0,3,30,30
1650229727234,MATH 109,A02,083214,Anzaldo; Leesa B,0,6,30,30
1650229727234,MATH 109,B01,083215,Anzaldo; Leesa B,0,4,30,30
1650229727234,MATH 109,B02,083216,Anzaldo; Leesa B,0,4,30,30
1650229733260,MATH 142A,A01,083219,Chow; Bennett,0,12,30,30
1650229733260,MATH 142A,A02,083220,Chow; Bennett,0,11,30,30
1650229733260,MATH 142A,B01,083221,Chow; Bennett,0,11,30,30
1650229733260,MATH 142A,B02,083222,Chow; Bennett,0,12,30,30
1650229739286,MATH 193A,A01,083224,Staff,0,5,30,30
1650229739286,MATH 193A,A02,083225,Staff,0,4,30,30
1650229739286,MATH 193A,A03,083781,Staff,0,2,30,30
1650229739286,MATH 193A,A04,083782,Staff,0,1,30,30
1650229745310,MATH 197,001,091859,McAuley; Julian John,9998,0,9999,1
1650229751364,COGS 9,A01,083615,Staff,0,14,60,60
1650229757387,COGS 11,A01,083617,Boyle; Mary E. T.,24,0,40,16
1650229763420,COGS 13,A01,083071,Staff,0,30,40,40
1650229769443,COGS 14A,A01,092681,Staff,0,12,100,100
1650229775465,COGS 14B,A01,083073,Cheng; Tzu-Han,0,7,50,50
1650229781496,COGS 17,A01,092677,Staff,34,0,75,41
1650229787523,COGS 100,A01,083619,Staff,0,21,60,60
1650229793546,COGS 101A,A01,083621,Davis; Joshua Daniel,0,21,60,60
1650229799570,COGS 101B,A01,091572,Staff,6,0,60,54
1650229805593,COGS 101C,A01,083625,Delgado; Tania,20,0,30,10
1650229811617,COGS 107A,A01,083627,Boyle; Mary E. T.,1,7,60,59
1650229817640,COGS 118A,A01,083075,Staff,15,0,60,45
1650229823664,CSE 3,A50,083646,Miranda; Gregory Joseph,22,0,38,16
1650229823664,CSE 3,A51,083647,Miranda; Gregory Joseph,37,0,37,0
1650229829689,CSE 8A,A50,083650,Miranda; Gregory Joseph,0,18,40,40
1650229835715,CSE 11,A01,083080,Cao; Yingjun,0,68,40,40
1650229841738,CSE 12,A01,083652,Staff,0,8,100,100
1650229847762,CSE 15L,A01,083654,Staff,0,1,50,50
1650229847762,CSE 15L,A02,083655,Staff,5,0,50,45
1650229853788,CSE 20,A01,083657,Staff,53,0,80,27
1650229859814,CSE 30,A01,083084,Eldon; John,0,70,40,40
1650229865862,CSE 100,A01,083659,Cao; Yingjun,0,63,50,50
1650229871886,CSE 134B,A01,083661,Powell; Thomas Allan,0,27,65,65
1650229877912,CSE 140,A01,083663,Staff,1,0,75,74
1650229883933,CSE 140L,A01,083088,Eldon; John,0,4,75,75
1650229889960,CSE 175,A01,083665,Kumar; Rakesh,8,0,25,17
1650229895985,CSE 190,A00,092507,Dubnov; Shlomo,14,0,20,6
1650229902011,ECE 45,A01,083139,Staff,0,13,40,40
1650229908034,ECE 65,A50,083695,Staff,0,5,30,30
1650229914068,ECE 109,A01,091882,Touri; Behrouz,47,0,70,23
1650229920099,ECE 180,A00,083140,Abi Samra; Nicholas Camill,24,0,30,6
1650229920099,ECE 180,B00,083141,Abi Samra; Nicholas Camill,8,0,30,22
1650229926121,MATH 10A,A01,083735,Patchell; Gregory David,11,0,30,19
1650229926121,MATH 10A,A02,083736,Patchell; Gregory David,28,0,30,2
1650229926121,MATH 10A,A03,083737,Patchell; Gregory David,26,0,30,4
1650229932145,MATH 10B,A01,083207,Staff,0,6,30,30
1650229932145,MATH 10B,A02,083208,Staff,0,5,30,30
1650229932145,MATH 10B,B01,083739,Staff,17,0,30,13
1650229932145,MATH 10B,B02,083740,Staff,29,0,30,1
1650229938176,MATH 18,A01,083743,Staff,8,0,30,22
1650229938176,MATH 18,A02,083744,Staff,28,0,30,2
1650229938176,MATH 18,A03,083745,Staff,23,0,30,7
1650229938176,MATH 18,A04,083746,Staff,27,0,30,3
1650229938176,MATH 18,B01,083748,Staff,0,10,30,30
1650229938176,MATH 18,B02,083749,Staff,0,7,30,30
1650229938176,MATH 18,B03,083750,Staff,0,7,30,30
1650229938176,MATH 18,B04,083751,Staff,0,8,30,30
1650229944198,MATH 20A,A01,083754,Staff,26,0,40,14
1650229950221,MATH 20B,A01,083756,Staff,1,6,30,29
1650229950221,MATH 20B,A02,083757,Staff,0,6,30,30
1650229956243,MATH 20C,A01,083760,Staff,0,12,30,30
1650229956243,MATH 20C,A02,083761,Staff,0,12,30,30
1650229956243,MATH 20C,B01,083762,Staff,14,0,30,16
1650229956243,MATH 20C,B02,083763,Staff,28,0,30,2
1650229962273,MATH 20D,A01,083765,Staff,1,2,30,29
1650229962273,MATH 20D,A02,083766,Staff,10,0,30,20
1650229962273,MATH 20D,A03,083767,Staff,28,0,30,2
1650229968304,MATH 20E,A01,083771,Staff,8,0,30,22
1650229968304,MATH 20E,A02,083772,Staff,21,0,30,9
1650229968304,MATH 20E,B01,083773,Staff,0,0,30,30
1650229968304,MATH 20E,B02,083774,Staff,12,0,30,18
1650229974336,MATH 103A,A01,083777,Staff,0,9,30,30
1650229974336,MATH 103A,A02,083778,Staff,0,10,30,30
1650229974336,MATH 103A,B01,083779,Staff,0,9,30,30
1650229974336,MATH 103A,B02,083780,Staff,0,9,30,30
1650229980363,MATH 105,A01,085443,Staff,0,17,30,30
1650229986389,MATH 109,A01,083213,Anzaldo; Leesa B,0,3,30,30
1650229986389,MATH 109,A02,083214,Anzaldo; Leesa B,0,6,30,30
1650229986389,MATH 109,B01,083215,Anzaldo; Leesa B,0,4,30,30
1650229986389,MATH 109,B02,083216,Anzaldo; Leesa B,0,4,30,30
1650229992413,MATH 142A,A01,083219,Chow; Bennett,0,12,30,30
1650229992413,MATH 142A,A02,083220,Chow; Bennett,0,11,30,30
1650229992413,MATH 142A,B01,083221,Chow; Bennett,0,11,30,30
1650229992413,MATH 142A,B02,083222,Chow; Bennett,0,12,30,30
1650229998443,MATH 193A,A01,083224,Staff,0,5,30,30
1650229998443,MATH 193A,A02,083225,Staff,0,4,30,30
1650229998443,MATH 193A,A03,083781,Staff,0,2,30,30
1650229998443,MATH 193A,A04,083782,Staff,0,1,30,30
1650230004466,MATH 197,001,091859,McAuley; Julian John,9998,0,9999,1
1650230010516,COGS 9,A01,083615,Staff,0,14,60,60
1650230016540,COGS 11,A01,083617,Boyle; Mary E. T.,24,0,40,16
1650230022566,COGS 13,A01,083071,Staff,0,30,40,40
1650230028588,COGS 14A,A01,092681,Staff,0,12,100,100
1650230034623,COGS 14B,A01,083073,Cheng; Tzu-Han,0,7,50,50
1650230040646,COGS 17,A01,092677,Staff,34,0,75,41
1650230046669,COGS 100,A01,083619,Staff,0,21,60,60
1650230052692,COGS 101A,A01,083621,Davis; Joshua Daniel,0,21,60,60
1650230058717,COGS 101B,A01,091572,Staff,6,0,60,54
1650230064748,COGS 101C,A01,083625,Delgado; Tania,20,0,30,10
1650230070775,COGS 107A,A01,083627,Boyle; Mary E. T.,1,7,60,59
1650230076801,COGS 118A,A01,083075,Staff,15,0,60,45
1650230082827,CSE 3,A50,083646,Miranda; Gregory Joseph,22,0,38,16
1650230082827,CSE 3,A51,083647,Miranda; Gregory Joseph,37,0,37,0
1650230088855,CSE 8A,A50,083650,Miranda; Gregory Joseph,0,18,40,40
1650230094877,CSE 11,A01,083080,Cao; Yingjun,0,68,40,40
1650230100910,CSE 12,A01,083652,Staff,0,8,100,100
1650230106933,CSE 15L,A01,083654,Staff,0,1,50,50
1650230106933,CSE 15L,A02,083655,Staff,5,0,50,45
1650230112955,CSE 20,A01,083657,Staff,53,0,80,27
1650230118982,CSE 30,A01,083084,Eldon; John,0,70,40,40
1650230125006,CSE 100,A01,083659,Cao; Yingjun,0,63,50,50
1650230131031,CSE 134B,A01,083661,Powell; Thomas Allan,0,27,65,65
1650230137054,CSE 140,A01,083663,Staff,1,0,75,74
1650230143078,CSE 140L,A01,083088,Eldon; John,0,4,75,75
1650230149100,CSE 175,A01,083665,Kumar; Rakesh,8,0,25,17
1650230155128,CSE 190,A00,092507,Dubnov; Shlomo,14,0,20,6
1650230161157,ECE 45,A01,083139,Staff,0,13,40,40
1650230167180,ECE 65,A50,083695,Staff,0,5,30,30
1650230173204,ECE 109,A01,091882,Touri; Behrouz,47,0,70,23
1650230179315,ECE 180,A00,083140,Abi Samra; Nicholas Camill,24,0,30,6
1650230179315,ECE 180,B00,083141,Abi Samra; Nicholas Camill,8,0,30,22
1650230185339,MATH 10A,A01,083735,Patchell; Gregory David,11,0,30,19
1650230185339,MATH 10A,A02,083736,Patchell; Gregory David,28,0,30,2
1650230185339,MATH 10A,A03,083737,Patchell; Gregory David,26,0,30,4
1650230191365,MATH 10B,A01,083207,Staff,0,6,30,30
1650230191365,MATH 10B,A02,083208,Staff,0,5,30,30
1650230191365,MATH 10B,B01,083739,Staff,17,0,30,13
1650230191365,MATH 10B,B02,083740,Staff,29,0,30,1
1650230197394,MATH 18,A01,083743,Staff,8,0,30,22
1650230197394,MATH 18,A02,083744,Staff,28,0,30,2
1650230197394,MATH 18,A03,083745,Staff,23,0,30,7
1650230197394,MATH 18,A04,083746,Staff,27,0,30,3
1650230197394,MATH 18,B01,083748,Staff,0,10,30,30
1650230197394,MATH 18,B02,083749,Staff,0,7,30,30
1650230197394,MATH 18,B03,083750,Staff,0,7,30,30
1650230197394,MATH 18,B04,083751,Staff,0,8,30,30
1650230203417,MATH 20A,A01,083754,Staff,26,0,40,14
1650230209439,MATH 20B,A01,083756,Staff,1,6,30,29
1650230209439,MATH 20B,A02,083757,Staff,0,6,30,30
1650230215463,MATH 20C,A01,083760,Staff,0,12,30,30
1650230215463,MATH 20C,A02,083761,Staff,0,12,30,30
1650230215463,MATH 20C,B01,083762,Staff,14,0,30,16
1650230215463,MATH 20C,B02,083763,Staff,28,0,30,2
1650230221488,MATH 20D,A01,083765,Staff,1,2,30,29
1650230221488,MATH 20D,A02,083766,Staff,10,0,30,20
1650230221488,MATH 20D,A03,083767,Staff,28,0,30,2
1650230227509,MATH 20E,A01,083771,Staff,8,0,30,22
1650230227509,MATH 20E,A02,083772,Staff,21,0,30,9
1650230227509,MATH 20E,B01,083773,Staff,0,0,30,30
1650230227509,MATH 20E,B02,083774,Staff,12,0,30,18
1650230233532,MATH 103A,A01,083777,Staff,0,9,30,30
1650230233532,MATH 103A,A02,083778,Staff,0,10,30,30
1650230233532,MATH 103A,B01,083779,Staff,0,9,30,30
1650230233532,MATH 103A,B02,083780,Staff,0,9,30,30
1650230239556,MATH 105,A01,085443,Staff,0,17,30,30
1650230245582,MATH 109,A01,083213,Anzaldo; Leesa B,0,3,30,30
1650230245582,MATH 109,A02,083214,Anzaldo; Leesa B,0,6,30,30
1650230245582,MATH 109,B01,083215,Anzaldo; Leesa B,0,4,30,30
1650230245582,MATH 109,B02,083216,Anzaldo; Leesa B,0,4,30,30
1650230251610,MATH 142A,A01,083219,Chow; Bennett,0,12,30,30
1650230251610,MATH 142A,A02,083220,Chow; Bennett,0,11,30,30
1650230251610,MATH 142A,B01,083221,Chow; Bennett,0,11,30,30
1650230251610,MATH 142A,B02,083222,Chow; Bennett,0,12,30,30
1650230257634,MATH 193A,A01,083224,Staff,0,5,30,30
1650230257634,MATH 193A,A02,083225,Staff,0,4,30,30
1650230257634,MATH 193A,A03,083781,Staff,0,2,30,30
1650230257634,MATH 193A,A04,083782,Staff,0,1,30,30
1650230263658,MATH 197,001,091859,McAuley; Julian John,9998,0,9999,1
1650230269708,COGS 9,A01,083615,Staff,0,14,60,60
1650230275734,COGS 11,A01,083617,Boyle; Mary E. T.,24,0,40,16
1650230281757,COGS 13,A01,083071,Staff,0,30,40,40
1650230287781,COGS 14A,A01,092681,Staff,0,12,100,100
1650230293806,COGS 14B,A01,083073,Cheng; Tzu-Han,0,7,50,50
1650230299829,COGS 17,A01,092677,Staff,34,0,75,41
1650230305854,COGS 100,A01,083619,Staff,0,21,60,60
1650230311880,COGS 101A,A01,083621,Davis; Joshua Daniel,0,21,60,60
1650230317904,COGS 101B,A01,091572,Staff,6,0,60,54
1650230323926,COGS 101C,A01,083625,Delgado; Tania,20,0,30,10
1650230329948,COGS 107A,A01,083627,Boyle; Mary E. T.,1,7,60,59
1650230335970,COGS 118A,A01,083075,Staff,15,0,60,45
1650230341994,CSE 3,A50,083646,Miranda; Gregory Joseph,22,0,38,16
1650230341994,CSE 3,A51,083647,Miranda; Gregory Joseph,37,0,37,0
1650230348021,CSE 8A,A50,083650,Miranda; Gregory Joseph,0,18,40,40
1650230354051,CSE 11,A01,083080,Cao; Yingjun,0,68,40,40
1650230360079,CSE 12,A01,083652,Staff,0,8,100,100
1650230366106,CSE 15L,A01,083654,Staff,0,1,50,50
1650230366106,CSE 15L,A02,083655,Staff,5,0,50,45
1650230372128,CSE 20,A01,083657,Staff,53,0,80,27
1650230378150,CSE 30,A01,083084,Eldon; John,0,70,40,40
1650230384174,CSE 100,A01,083659,Cao; Yingjun,0,63,50,50
1650230390198,CSE 134B,A01,083661,Powell; Thomas Allan,0,27,65,65
1650230396221,CSE 140,A01,083663,Staff,1,0,75,74
1650230402245,CSE 140L,A01,083088,Eldon; John,0,4,75,75
1650230408273,CSE 175,A01,083665,Kumar; Rakesh,8,0,25,17
1650230414299,CSE 190,A00,092507,Dubnov; Shlomo,14,0,20,6
1650230420323,ECE 45,A01,083139,Staff,0,13,40,40
1650230426352,ECE 65,A50,083695,Staff,0,5,30,30
1650230432375,ECE 109,A01,091882,Touri; Behrouz,47,0,70,23
1650230438402,ECE 180,A00,083140,Abi Samra; Nicholas Camill,24,0,30,6
1650230438402,ECE 180,B00,083141,Abi Samra; Nicholas Camill,8,0,30,22
1650230444424,MATH 10A,A01,083735,Patchell; Gregory David,11,0,30,19
1650230444424,MATH 10A,A02,083736,Patchell; Gregory David,28,0,30,2
1650230444424,MATH 10A,A03,083737,Patchell; Gregory David,26,0,30,4
1650230450460,MATH 10B,A01,083207,Staff,0,6,30,30
1650230450460,MATH 10B,A02,083208,Staff,0,5,30,30
1650230450460,MATH 10B,B01,083739,Staff,17,0,30,13
1650230450460,MATH 10B,B02,083740,Staff,29,0,30,1
1650230456490,MATH 18,A01,083743,Staff,8,0,30,22
1650230456490,MATH 18,A02,083744,Staff,28,0,30,2
1650230456490,MATH 18,A03,083745,Staff,23,0,30,7
1650230456490,MATH 18,A04,083746,Staff,27,0,30,3
1650230456490,MATH 18,B01,083748,Staff,0,10,30,30
1650230456490,MATH 18,B02,083749,Staff,0,7,30,30
1650230456490,MATH 18,B03,083750,Staff,0,7,30,30
1650230456490,MATH 18,B04,083751,Staff,0,8,30,30
1650230462515,MATH 20A,A01,083754,Staff,26,0,40,14
1650230468538,MATH 20B,A01,083756,Staff,1,6,30,29
1650230468538,MATH 20B,A02,083757,Staff,0,6,30,30
1650230474566,MATH 20C,A01,083760,Staff,0,12,30,30
1650230474566,MATH 20C,A02,083761,Staff,0,12,30,30
1650230474566,MATH 20C,B01,083762,Staff,14,0,30,16
1650230474566,MATH 20C,B02,083763,Staff,28,0,30,2
1650230480591,MATH 20D,A01,083765,Staff,1,2,30,29
1650230480591,MATH 20D,A02,083766,Staff,10,0,30,20
1650230480591,MATH 20D,A03,083767,Staff,28,0,30,2
1650230486616,MATH 20E,A01,083771,Staff,8,0,30,22
1650230486616,MATH 20E,A02,083772,Staff,21,0,30,9
1650230486616,MATH 20E,B01,083773,Staff,0,0,30,30
1650230486616,MATH 20E,B02,083774,Staff,12,0,30,18
1650230492638,MATH 103A,A01,083777,Staff,0,9,30,30
1650230492638,MATH 103A,A02,083778,Staff,0,10,30,30
1650230492638,MATH 103A,B01,083779,Staff,0,9,30,30
1650230492638,MATH 103A,B02,083780,Staff,0,9,30,30
1650230498666,MATH 105,A01,085443,Staff,0,17,30,30
1650230504700,MATH 109,A01,083213,Anzaldo; Leesa B,0,3,30,30
1650230504700,MATH 109,A02,083214,Anzaldo; Leesa B,0,6,30,30
1650230504700,MATH 109,B01,083215,Anzaldo; Leesa B,0,4,30,30
1650230504700,MATH 109,B02,083216,Anzaldo; Leesa B,0,4,30,30
1650230510731,MATH 142A,A01,083219,Chow; Bennett,0,12,30,30
1650230510731,MATH 142A,A02,083220,Chow; Bennett,0,11,30,30
1650230510731,MATH 142A,B01,083221,Chow; Bennett,0,11,30,30
1650230510731,MATH 142A,B02,083222,Chow; Bennett,0,12,30,30
1650230516759,MATH 193A,A01,083224,Staff,0,5,30,30
1650230516759,MATH 193A,A02,083225,Staff,0,4,30,30
1650230516759,MATH 193A,A03,083781,Staff,0,2,30,30
1650230516759,MATH 193A,A04,083782,Staff,0,1,30,30
1650230522785,MATH 197,001,091859,McAuley; Julian John,9998,0,9999,1
1650230528852,COGS 9,A01,083615,Staff,0,14,60,60
1650230534883,COGS 11,A01,083617,Boyle; Mary E. T.,24,0,40,16
1650230540907,COGS 13,A01,083071,Staff,0,30,40,40
1650230546936,COGS 14A,A01,092681,Staff,0,12,100,100
1650230552960,COGS 14B,A01,083073,Cheng; Tzu-Han,0,7,50,50
1650230558985,COGS 17,A01,092677,Staff,34,0,75,41
1650230565009,COGS 100,A01,083619,Staff,0,21,60,60
1650230571033,COGS 101A,A01,083621,Davis; Joshua Daniel,0,21,60,60
1650230577058,COGS 101B,A01,091572,Staff,6,0,60,54
1650230583085,COGS 101C,A01,083625,Delgado; Tania,20,0,30,10
1650230589107,COGS 107A,A01,083627,Boyle; Mary E. T.,1,7,60,59
1650230595131,COGS 118A,A01,083075,Staff,15,0,60,45
1650230601168,CSE 3,A50,083646,Miranda; Gregory Joseph,22,0,38,16
1650230601168,CSE 3,A51,083647,Miranda; Gregory Joseph,37,0,37,0
1650230607191,CSE 8A,A50,083650,Miranda; Gregory Joseph,0,18,40,40
1650230613215,CSE 11,A01,083080,Cao; Yingjun,0,68,40,40
1650230619237,CSE 12,A01,083652,Staff,0,9,100,100
1650230625260,CSE 15L,A01,083654,Staff,0,1,50,50
1650230625260,CSE 15L,A02,083655,Staff,5,0,50,45
1650230631287,CSE 20,A01,083657,Staff,53,0,80,27
1650230637310,CSE 30,A01,083084,Eldon; John,0,70,40,40
1650230643335,CSE 100,A01,083659,Cao; Yingjun,0,63,50,50
1650230649359,CSE 134B,A01,083661,Powell; Thomas Allan,0,27,65,65
1650230655386,CSE 140,A01,083663,Staff,1,0,75,74
1650230661410,CSE 140L,A01,083088,Eldon; John,0,4,75,75
1650230667435,CSE 175,A01,083665,Kumar; Rakesh,8,0,25,17
1650230673457,CSE 190,A00,092507,Dubnov; Shlomo,14,0,20,6
1650230679489,ECE 45,A01,083139,Staff,0,13,40,40
1650230685517,ECE 65,A50,083695,Staff,0,5,30,30
1650230691539,ECE 109,A01,091882,Touri; Behrouz,47,0,70,23
1650230697564,ECE 180,A00,083140,Abi Samra; Nicholas Camill,24,0,30,6
1650230697564,ECE 180,B00,083141,Abi Samra; Nicholas Camill,8,0,30,22
1650230703587,MATH 10A,A01,083735,Patchell; Gregory David,11,0,30,19
1650230703587,MATH 10A,A02,083736,Patchell; Gregory David,28,0,30,2
1650230703587,MATH 10A,A03,083737,Patchell; Gregory David,26,0,30,4
1650230709619,MATH 10B,A01,083207,Staff,0,6,30,30
1650230709619,MATH 10B,A02,083208,Staff,0,5,30,30
1650230709619,MATH 10B,B01,083739,Staff,17,0,30,13
1650230709619,MATH 10B,B02,083740,Staff,29,0,30,1
1650230715643,MATH 18,A01,083743,Staff,8,0,30,22
1650230715643,MATH 18,A02,083744,Staff,28,0,30,2
1650230715643,MATH 18,A03,083745,Staff,23,0,30,7
1650230715643,MATH 18,A04,083746,Staff,27,0,30,3
1650230715643,MATH 18,B01,083748,Staff,0,10,30,30
1650230715643,MATH 18,B02,083749,Staff,0,7,30,30
1650230715643,MATH 18,B03,083750,Staff,0,7,30,30
1650230715643,MATH 18,B04,083751,Staff,0,8,30,30
1650230721667,MATH 20A,A01,083754,Staff,26,0,40,14
1650230727691,MATH 20B,A01,083756,Staff,1,6,30,29
1650230727691,MATH 20B,A02,083757,Staff,0,6,30,30
1650230733714,MATH 20C,A01,083760,Staff,0,12,30,30
1650230733714,MATH 20C,A02,083761,Staff,0,12,30,30
1650230733714,MATH 20C,B01,083762,Staff,14,0,30,16
1650230733714,MATH 20C,B02,083763,Staff,28,0,30,2
1650230739739,MATH 20D,A01,083765,Staff,1,2,30,29
1650230739739,MATH 20D,A02,083766,Staff,10,0,30,20
1650230739739,MATH 20D,A03,083767,Staff,28,0,30,2
1650230745763,MATH 20E,A01,083771,Staff,8,0,30,22
1650230745763,MATH 20E,A02,083772,Staff,21,0,30,9
1650230745763,MATH 20E,B01,083773,Staff,0,0,30,30
1650230745763,MATH 20E,B02,083774,Staff,12,0,30,18
1650230751790,MATH 103A,A01,083777,Staff,0,9,30,30
1650230751790,MATH 103A,A02,083778,Staff,0,10,30,30
1650230751790,MATH 103A,B01,083779,Staff,0,9,30,30
1650230751790,MATH 103A,B02,083780,Staff,0,9,30,30
1650230757813,MATH 105,A01,085443,Staff,0,17,30,30
1650230763840,MATH 109,A01,083213,Anzaldo; Leesa B,0,3,30,30
1650230763840,MATH 109,A02,083214,Anzaldo; Leesa B,0,6,30,30
1650230763840,MATH 109,B01,083215,Anzaldo; Leesa B,0,4,30,30
1650230763840,MATH 109,B02,083216,Anzaldo; Leesa B,0,4,30,30
1650230769872,MATH 142A,A01,083219,Chow; Bennett,0,12,30,30
1650230769872,MATH 142A,A02,083220,Chow; Bennett,0,11,30,30
1650230769872,MATH 142A,B01,083221,Chow; Bennett,0,11,30,30
1650230769872,MATH 142A,B02,083222,Chow; Bennett,0,12,30,30
1650230775988,MATH 193A,A01,083224,Staff,0,5,30,30
1650230775988,MATH 193A,A02,083225,Staff,0,4,30,30
1650230775988,MATH 193A,A03,083781,Staff,0,2,30,30
1650230775988,MATH 193A,A04,083782,Staff,0,1,30,30
1650230782013,MATH 197,001,091859,McAuley; Julian John,9998,0,9999,1
1650230788066,COGS 9,A01,083615,Staff,0,14,60,60
1650230794088,COGS 11,A01,083617,Boyle; Mary E. T.,24,0,40,16
1650230800114,COGS 13,A01,083071,Staff,0,30,40,40
1650230806136,COGS 14A,A01,092681,Staff,0,12,100,100
1650230812159,COGS 14B,A01,083073,Cheng; Tzu-Han,0,7,50,50
1650230818186,COGS 17,A01,092677,Staff,34,0,75,41
1650230824208,COGS 100,A01,083619,Staff,0,21,60,60
1650230830230,COGS 101A,A01,083621,Davis; Joshua Daniel,0,21,60,60
1650230836255,COGS 101B,A01,091572,Staff,6,0,60,54
1650230842283,COGS 101C,A01,083625,Delgado; Tania,20,0,30,10
1650230848308,COGS 107A,A01,083627,Boyle; Mary E. T.,1,7,60,59
1650230854333,COGS 118A,A01,083075,Staff,15,0,60,45
1650230860358,CSE 3,A50,083646,Miranda; Gregory Joseph,22,0,38,16
1650230860358,CSE 3,A51,083647,Miranda; Gregory Joseph,37,0,37,0
1650230866386,CSE 8A,A50,083650,Miranda; Gregory Joseph,0,18,40,40
1650230872422,CSE 11,A01,083080,Cao; Yingjun,0,68,40,40
1650230878445,CSE 12,A01,083652,Staff,0,9,100,100
1650230884467,CSE 15L,A01,083654,Staff,0,1,50,50
1650230884467,CSE 15L,A02,083655,Staff,5,0,50,45
1650230890493,CSE 20,A01,083657,Staff,53,0,80,27
1650230896515,CSE 30,A01,083084,Eldon; John,0,70,40,40
1650230902539,CSE 100,A01,083659,Cao; Yingjun,0,63,50,50
1650230908563,CSE 134B,A01,083661,Powell; Thomas Allan,0,27,65,65
1650230914587,CSE 140,A01,083663,Staff,1,0,75,74
1650230920610,CSE 140L,A01,083088,Eldon; John,0,4,75,75
1650230926636,CSE 175,A01,083665,Kumar; Rakesh,8,0,25,17
1650230932661,CSE 190,A00,092507,Dubnov; Shlomo,14,0,20,6
1650230938687,ECE 45,A01,083139,Staff,0,13,40,40
1650230944710,ECE 65,A50,083695,Staff,0,5,30,30
1650230950737,ECE 109,A01,091882,Touri; Behrouz,47,0,70,23
1650230956765,ECE 180,A00,083140,Abi Samra; Nicholas Camill,24,0,30,6
1650230956765,ECE 180,B00,083141,Abi Samra; Nicholas Camill,8,0,30,22
1650230962789,MATH 10A,A01,083735,Patchell; Gregory David,11,0,30,19
1650230962789,MATH 10A,A02,083736,Patchell; Gregory David,28,0,30,2
1650230962789,MATH 10A,A03,083737,Patchell; Gregory David,26,0,30,4
1650230968814,MATH 10B,A01,083207,Staff,0,6,30,30
1650230968814,MATH 10B,A02,083208,Staff,0,5,30,30
1650230968814,MATH 10B,B01,083739,Staff,17,0,30,13
1650230968814,MATH 10B,B02,083740,Staff,29,0,30,1
1650230974844,MATH 18,A01,083743,Staff,8,0,30,22
1650230974844,MATH 18,A02,083744,Staff,28,0,30,2
1650230974844,MATH 18,A03,083745,Staff,23,0,30,7
1650230974844,MATH 18,A04,083746,Staff,27,0,30,3
1650230974844,MATH 18,B01,083748,Staff,0,10,30,30
1650230974844,MATH 18,B02,083749,Staff,0,7,30,30
1650230974844,MATH 18,B03,083750,Staff,0,7,30,30
1650230974844,MATH 18,B04,083751,Staff,0,8,30,30
1650230980867,MATH 20A,A01,083754,Staff,26,0,40,14
1650230986894,MATH 20B,A01,083756,Staff,1,6,30,29
1650230986894,MATH 20B,A02,083757,Staff,0,6,30,30
1650230992919,MATH 20C,A01,083760,Staff,0,12,30,30
1650230992919,MATH 20C,A02,083761,Staff,0,12,30,30
1650230992919,MATH 20C,B01,083762,Staff,14,0,30,16
1650230992919,MATH 20C,B02,083763,Staff,28,0,30,2
1650230998946,MATH 20D,A01,083765,Staff,1,2,30,29
1650230998946,MATH 20D,A02,083766,Staff,10,0,30,20
1650230998946,MATH 20D,A03,083767,Staff,28,0,30,2
1650231004982,MATH 20E,A01,083771,Staff,8,0,30,22
1650231004982,MATH 20E,A02,083772,Staff,21,0,30,9
1650231004982,MATH 20E,B01,083773,Staff,0,0,30,30
1650231004982,MATH 20E,B02,083774,Staff,12,0,30,18
1650231011009,MATH 103A,A01,083777,Staff,0,9,30,30
1650231011009,MATH 103A,A02,083778,Staff,0,10,30,30
1650231011009,MATH 103A,B01,083779,Staff,0,9,30,30
1650231011009,MATH 103A,B02,083780,Staff,0,9,30,30
1650231017036,MATH 105,A01,085443,Staff,0,17,30,30
1650231023062,MATH 109,A01,083213,Anzaldo; Leesa B,0,3,30,30
1650231023062,MATH 109,A02,083214,Anzaldo; Leesa B,0,6,30,30
1650231023062,MATH 109,B01,083215,Anzaldo; Leesa B,0,4,30,30
1650231023062,MATH 109,B02,083216,Anzaldo; Leesa B,1,4,30,29
1650231029089,MATH 142A,A01,083219,Chow; Bennett,0,12,30,30
1650231029089,MATH 142A,A02,083220,Chow; Bennett,0,11,30,30
1650231029089,MATH 142A,B01,083221,Chow; Bennett,0,11,30,30
1650231029089,MATH 142A,B02,083222,Chow; Bennett,0,12,30,30
1650231035113,MATH 193A,A01,083224,Staff,0,5,30,30
1650231035113,MATH 193A,A02,083225,Staff,0,4,30,30
1650231035113,MATH 193A,A03,083781,Staff,0,2,30,30
1650231035113,MATH 193A,A04,083782,Staff,0,1,30,30
1650231041136,MATH 197,001,091859,McAuley; Julian John,9998,0,9999,1
1650231047187,COGS 9,A01,083615,Staff,0,14,60,60
1650231053214,COGS 11,A01,083617,Boyle; Mary E. T.,24,0,40,16
1650231059237,COGS 13,A01,083071,Staff,0,30,40,40
1650231065262,COGS 14A,A01,092681,Staff,0,12,100,100
1650231071294,COGS 14B,A01,083073,Cheng; Tzu-Han,0,7,50,50
1650231077319,COGS 17,A01,092677,Staff,34,0,75,41
1650231083344,COGS 100,A01,083619,Staff,1,21,60,59
1650231089371,COGS 101A,A01,083621,Davis; Joshua Daniel,0,21,60,60
1650231095398,COGS 101B,A01,091572,Staff,6,0,60,54
1650231101424,COGS 101C,A01,083625,Delgado; Tania,20,0,30,10
1650231107452,COGS 107A,A01,083627,Boyle; Mary E. T.,1,7,60,59
1650231113476,COGS 118A,A01,083075,Staff,15,0,60,45
1650231119499,CSE 3,A50,083646,Miranda; Gregory Joseph,22,0,38,16
1650231119499,CSE 3,A51,083647,Miranda; Gregory Joseph,37,0,37,0
1650231125528,CSE 8A,A50,083650,Miranda; Gregory Joseph,0,18,40,40
1650231131552,CSE 11,A01,083080,Cao; Yingjun,0,68,40,40
1650231137578,CSE 12,A01,083652,Staff,0,9,100,100
1650231143601,CSE 15L,A01,083654,Staff,0,1,50,50
1650231143601,CSE 15L,A02,083655,Staff,5,0,50,45
1650231149627,CSE 20,A01,083657,Staff,53,0,80,27
1650231155660,CSE 30,A01,083084,Eldon; John,0,70,40,40
1650231161687,CSE 100,A01,083659,Cao; Yingjun,0,63,50,50
1650231167709,CSE 134B,A01,083661,Powell; Thomas Allan,0,27,65,65
1650231173736,CSE 140,A01,083663,Staff,1,0,75,74
1650231179761,CSE 140L,A01,083088,Eldon; John,0,4,75,75
1650231185787,CSE 175,A01,083665,Kumar; Rakesh,8,0,25,17
1650231191809,CSE 190,A00,092507,Dubnov; Shlomo,14,0,20,6
1650231197832,ECE 45,A01,083139,Staff,0,13,40,40
1650231203858,ECE 65,A50,083695,Staff,0,5,30,30
1650231209884,ECE 109,A01,091882,Touri; Behrouz,47,0,70,23
1650231215908,ECE 180,A00,083140,Abi Samra; Nicholas Camill,24,0,30,6
1650231215908,ECE 180,B00,083141,Abi Samra; Nicholas Camill,8,0,30,22
1650231221931,MATH 10A,A01,083735,Patchell; Gregory David,11,0,30,19
1650231221931,MATH 10A,A02,083736,Patchell; Gregory David,28,0,30,2
1650231221931,MATH 10A,A03,083737,Patchell; Gregory David,26,0,30,4
1650231227953,MATH 10B,A01,083207,Staff,0,6,30,30
1650231227953,MATH 10B,A02,083208,Staff,0,5,30,30
1650231227953,MATH 10B,B01,083739,Staff,17,0,30,13
1650231227953,MATH 10B,B02,083740,Staff,29,0,30,1
1650231233979,MATH 18,A01,083743,Staff,8,0,30,22
1650231233979,MATH 18,A02,083744,Staff,28,0,30,2
1650231233979,MATH 18,A03,083745,Staff,23,0,30,7
1650231233979,MATH 18,A04,083746,Staff,27,0,30,3
1650231233979,MATH 18,B01,083748,Staff,0,10,30,30
1650231233979,MATH 18,B02,083749,Staff,0,7,30,30
1650231233979,MATH 18,B03,083750,Staff,0,7,30,30
1650231233979,MATH 18,B04,083751,Staff,0,8,30,30
1650231240006,MATH 20A,A01,083754,Staff,26,0,40,14
1650231246029,MATH 20B,A01,083756,Staff,1,6,30,29
1650231246029,MATH 20B,A02,083757,Staff,0,6,30,30
1650231252057,MATH 20C,A01,083760,Staff,0,12,30,30
1650231252057,MATH 20C,A02,083761,Staff,0,12,30,30
1650231252057,MATH 20C,B01,083762,Staff,14,0,30,16
1650231252057,MATH 20C,B02,083763,Staff,28,0,30,2
1650231258087,MATH 20D,A01,083765,Staff,1,2,30,29
1650231258087,MATH 20D,A02,083766,Staff,10,0,30,20
1650231258087,MATH 20D,A03,083767,Staff,28,0,30,2
1650231264112,MATH 20E,A01,083771,Staff,8,0,30,22
1650231264112,MATH 20E,A02,083772,Staff,21,0,30,9
1650231264112,MATH 20E,B01,083773,Staff,0,0,30,30
1650231264112,MATH 20E,B02,083774,Staff,12,0,30,18
1650231270136,MATH 103A,A01,083777,Staff,0,9,30,30
1650231270136,MATH 103A,A02,083778,Staff,0,10,30,30
1650231270136,MATH 103A,B01,083779,Staff,0,9,30,30
1650231270136,MATH 103A,B02,083780,Staff,0,9,30,30
1650231276162,MATH 105,A01,085443,Staff,0,17,30,30
1650231282186,MATH 109,A01,083213,Anzaldo; Leesa B,0,3,30,30
1650231282186,MATH 109,A02,083214,Anzaldo; Leesa B,0,6,30,30
1650231282186,MATH 109,B01,083215,Anzaldo; Leesa B,0,4,30,30
1650231282186,MATH 109,B02,083216,Anzaldo; Leesa B,1,4,30,29
1650231288210,MATH 142A,A01,083219,Chow; Bennett,0,12,30,30
1650231288210,MATH 142A,A02,083220,Chow; Bennett,0,11,30,30
1650231288210,MATH 142A,B01,083221,Chow; Bennett,0,11,30,30
1650231288210,MATH 142A,B02,083222,Chow; Bennett,0,12,30,30
1650231294234,MATH 193A,A01,083224,Staff,0,5,30,30
1650231294234,MATH 193A,A02,083225,Staff,0,4,30,30
1650231294234,MATH 193A,A03,083781,Staff,0,2,30,30
1650231294234,MATH 193A,A04,083782,Staff,0,1,30,30
1650231300257,MATH 197,001,091859,McAuley; Julian John,9998,0,9999,1
1650231306305,COGS 9,A01,083615,Staff,0,14,60,60
1650231312332,COGS 11,A01,083617,Boyle; Mary E. T.,24,0,40,16
1650231318359,COGS 13,A01,083071,Staff,0,30,40,40
1650231324386,COGS 14A,A01,092681,Staff,0,12,100,100
1650231330408,COGS 14B,A01,083073,Cheng; Tzu-Han,0,7,50,50
1650231336430,COGS 17,A01,092677,Staff,34,0,75,41
1650231342454,COGS 100,A01,083619,Staff,1,21,60,59
1650231348480,COGS 101A,A01,083621,Davis; Joshua Daniel,0,21,60,60
1650231354506,COGS 101B,A01,091572,Staff,6,0,60,54
1650231360535,COGS 101C,A01,083625,Delgado; Tania,20,0,30,10
1650231366652,COGS 107A,A01,083627,Boyle; Mary E. T.,1,7,60,59
1650231372674,COGS 118A,A01,083075,Staff,15,0,60,45
1650231378700,CSE 3,A50,083646,Miranda; Gregory Joseph,22,0,38,16
1650231378700,CSE 3,A51,083647,Miranda; Gregory Joseph,37,0,37,0
1650231384724,CSE 8A,A50,083650,Miranda; Gregory Joseph,0,18,40,40
1650231390755,CSE 11,A01,083080,Cao; Yingjun,0,68,40,40
1650231396777,CSE 12,A01,083652,Staff,0,9,100,100
1650231402804,CSE 15L,A01,083654,Staff,0,1,50,50
1650231402804,CSE 15L,A02,083655,Staff,5,0,50,45
1650231408828,CSE 20,A01,083657,Staff,53,0,80,27
1650231414861,CSE 30,A01,083084,Eldon; John,0,70,40,40
1650231420886,CSE 100,A01,083659,Cao; Yingjun,0,63,50,50
1650231426910,CSE 134B,A01,083661,Powell; Thomas Allan,0,27,65,65
1650231432933,CSE 140,A01,083663,Staff,1,0,75,74
1650231438956,CSE 140L,A01,083088,Eldon; John,0,4,75,75
1650231444981,CSE 175,A01,083665,Kumar; Rakesh,8,0,25,17
1650231451004,CSE 190,A00,092507,Dubnov; Shlomo,14,0,20,6
1650231457026,ECE 45,A01,083139,Staff,0,13,40,40
1650231463052,ECE 65,A50,083695,Staff,0,5,30,30
1650231469086,ECE 109,A01,091882,Touri; Behrouz,47,0,70,23
1650231475113,ECE 180,A00,083140,Abi Samra; Nicholas Camill,24,0,30,6
1650231475113,ECE 180,B00,083141,Abi Samra; Nicholas Camill,8,0,30,22
1650231481136,MATH 10A,A01,083735,Patchell; Gregory David,11,0,30,19
1650231481136,MATH 10A,A02,083736,Patchell; Gregory David,28,0,30,2
1650231481136,MATH 10A,A03,083737,Patchell; Gregory David,26,0,30,4
1650231487165,MATH 10B,A01,083207,Staff,0,6,30,30
1650231487165,MATH 10B,A02,083208,Staff,0,5,30,30
1650231487165,MATH 10B,B01,083739,Staff,17,0,30,13
1650231487165,MATH 10B,B02,083740,Staff,29,0,30,1
1650231493199,MATH 18,A01,083743,Staff,8,0,30,22
1650231493199,MATH 18,A02,083744,Staff,28,0,30,2
1650231493199,MATH 18,A03,083745,Staff,23,0,30,7
1650231493199,MATH 18,A04,083746,Staff,27,0,30,3
1650231493199,MATH 18,B01,083748,Staff,0,10,30,30
1650231493199,MATH 18,B02,083749,Staff,0,7,30,30
1650231493199,MATH 18,B03,083750,Staff,0,7,30,30
1650231493199,MATH 18,B04,083751,Staff,0,8,30,30
1650231499231,MATH 20A,A01,083754,Staff,26,0,40,14
1650231505254,MATH 20B,A01,083756,Staff,1,6,30,29
1650231505254,MATH 20B,A02,083757,Staff,0,6,30,30
1650231511278,MATH 20C,A01,083760,Staff,0,12,30,30
1650231511278,MATH 20C,A02,083761,Staff,0,12,30,30
1650231511278,MATH 20C,B01,083762,Staff,14,0,30,16
1650231511278,MATH 20C,B02,083763,Staff,28,0,30,2
1650231517305,MATH 20D,A01,083765,Staff,1,2,30,29
1650231517305,MATH 20D,A02,083766,Staff,10,0,30,20
1650231517305,MATH 20D,A03,083767,Staff,28,0,30,2
1650231523332,MATH 20E,A01,083771,Staff,8,0,30,22
1650231523332,MATH 20E,A02,083772,Staff,21,0,30,9
1650231523332,MATH 20E,B01,083773,Staff,0,0,30,30
1650231523332,MATH 20E,B02,083774,Staff,12,0,30,18
1650231529357,MATH 103A,A01,083777,Staff,0,9,30,30
1650231529357,MATH 103A,A02,083778,Staff,0,10,30,30
1650231529357,MATH 103A,B01,083779,Staff,0,9,30,30
1650231529357,MATH 103A,B02,083780,Staff,0,9,30,30
1650231535380,MATH 105,A01,085443,Staff,0,17,30,30
1650231541408,MATH 109,A01,083213,Anzaldo; Leesa B,0,3,30,30
1650231541408,MATH 109,A02,083214,Anzaldo; Leesa B,0,6,30,30
1650231541408,MATH 109,B01,083215,Anzaldo; Leesa B,0,4,30,30
1650231541408,MATH 109,B02,083216,Anzaldo; Leesa B,1,4,30,29
1650231547436,MATH 142A,A01,083219,Chow; Bennett,0,12,30,30
1650231547436,MATH 142A,A02,083220,Chow; Bennett,0,11,30,30
1650231547436,MATH 142A,B01,083221,Chow; Bennett,0,11,30,30
1650231547436,MATH 142A,B02,083222,Chow; Bennett,0,12,30,30
1650231553461,MATH 193A,A01,083224,Staff,0,5,30,30
1650231553461,MATH 193A,A02,083225,Staff,0,4,30,30
1650231553461,MATH 193A,A03,083781,Staff,0,2,30,30
1650231553461,MATH 193A,A04,083782,Staff,0,1,30,30
1650231559487,MATH 197,001,091859,McAuley; Julian John,9998,0,9999,1
1650231565554,COGS 9,A01,083615,Staff,0,14,60,60
1650231571578,COGS 11,A01,083617,Boyle; Mary E. T.,24,0,40,16
1650231577601,COGS 13,A01,083071,Staff,0,30,40,40
1650231583625,COGS 14A,A01,092681,Staff,0,12,100,100
1650231589658,COGS 14B,A01,083073,Cheng; Tzu-Han,0,7,50,50
1650231595684,COGS 17,A01,092677,Staff,34,0,75,41
1650231601712,COGS 100,A01,083619,Staff,1,21,60,59
1650231607736,COGS 101A,A01,083621,Davis; Joshua Daniel,0,21,60,60
1650231613761,COGS 101B,A01,091572,Staff,6,0,60,54
1650231619784,COGS 101C,A01,083625,Delgado; Tania,20,0,30,10
1650231625821,COGS 107A,A01,083627,Boyle; Mary E. T.,1,7,60,59
1650231631847,COGS 118A,A01,083075,Staff,15,0,60,45
1650231637871,CSE 3,A50,083646,Miranda; Gregory Joseph,22,0,38,16
1650231637871,CSE 3,A51,083647,Miranda; Gregory Joseph,37,0,37,0
1650231643901,CSE 8A,A50,083650,Miranda; Gregory Joseph,0,18,40,40
1650231649928,CSE 11,A01,083080,Cao; Yingjun,0,68,40,40
1650231655951,CSE 12,A01,083652,Staff,0,9,100,100
1650231661982,CSE 15L,A01,083654,Staff,0,1,50,50
1650231661982,CSE 15L,A02,083655,Staff,5,0,50,45
1650231668005,CSE 20,A01,083657,Staff,53,0,80,27
1650231674030,CSE 30,A01,083084,Eldon; John,0,70,40,40
1650231680053,CSE 100,A01,083659,Cao; Yingjun,0,63,50,50
1650231686075,CSE 134B,A01,083661,Powell; Thomas Allan,0,27,65,65
1650231692097,CSE 140,A01,083663,Staff,1,0,75,74
1650231698126,CSE 140L,A01,083088,Eldon; John,0,4,75,75
1650231704148,CSE 175,A01,083665,Kumar; Rakesh,8,0,25,17
1650231710174,CSE 190,A00,092507,Dubnov; Shlomo,14,0,20,6
1650231716199,ECE 45,A01,083139,Staff,0,13,40,40
1650231722223,ECE 65,A50,083695,Staff,0,5,30,30
1650231728245,ECE 109,A01,091882,Touri; Behrouz,47,0,70,23
1650231734273,ECE 180,A00,083140,Abi Samra; Nicholas Camill,24,0,30,6
1650231734273,ECE 180,B00,083141,Abi Samra; Nicholas Camill,8,0,30,22
1650231740295,MATH 10A,A01,083735,Patchell; Gregory David,11,0,30,19
1650231740295,MATH 10A,A02,083736,Patchell; Gregory David,28,0,30,2
1650231740295,MATH 10A,A03,083737,Patchell; Gregory David,26,0,30,4
1650231746321,MATH 10B,A01,083207,Staff,0,6,30,30
1650231746321,MATH 10B,A02,083208,Staff,0,5,30,30
1650231746321,MATH 10B,B01,083739,Staff,17,0,30,13
1650231746321,MATH 10B,B02,083740,Staff,29,0,30,1
1650231752353,MATH 18,A01,083743,Staff,8,0,30,22
1650231752353,MATH 18,A02,083744,Staff,28,0,30,2
1650231752353,MATH 18,A03,083745,Staff,23,0,30,7
1650231752353,MATH 18,A04,083746,Staff,27,0,30,3
1650231752353,MATH 18,B01,083748,Staff,0,10,30,30
1650231752353,MATH 18,B02,083749,Staff,0,7,30,30
1650231752353,MATH 18,B03,083750,Staff,0,7,30,30
1650231752353,MATH 18,B04,083751,Staff,0,8,30,30
1650231758377,MATH 20A,A01,083754,Staff,26,0,40,14
1650231764402,MATH 20B,A01,083756,Staff,1,6,30,29
1650231764402,MATH 20B,A02,083757,Staff,0,6,30,30
1650231770425,MATH 20C,A01,083760,Staff,0,12,30,30
1650231770425,MATH 20C,A02,083761,Staff,0,12,30,30
1650231770425,MATH 20C,B01,083762,Staff,14,0,30,16
1650231770425,MATH 20C,B02,083763,Staff,28,0,30,2
1650231776446,MATH 20D,A01,083765,Staff,1,2,30,29
1650231776446,MATH 20D,A02,083766,Staff,10,0,30,20
1650231776446,MATH 20D,A03,083767,Staff,28,0,30,2
1650231782472,MATH 20E,A01,083771,Staff,8,0,30,22
1650231782472,MATH 20E,A02,083772,Staff,21,0,30,9
1650231782472,MATH 20E,B01,083773,Staff,0,0,30,30
1650231782472,MATH 20E,B02,083774,Staff,12,0,30,18
1650231788495,MATH 103A,A01,083777,Staff,0,9,30,30
1650231788495,MATH 103A,A02,083778,Staff,0,10,30,30
1650231788495,MATH 103A,B01,083779,Staff,0,9,30,30
1650231788495,MATH 103A,B02,083780,Staff,0,9,30,30
1650231794520,MATH 105,A01,085443,Staff,0,17,30,30
1650231800547,MATH 109,A01,083213,Anzaldo; Leesa B,0,3,30,30
1650231800547,MATH 109,A02,083214,Anzaldo; Leesa B,0,6,30,30
1650231800547,MATH 109,B01,083215,Anzaldo; Leesa B,0,4,30,30
1650231800547,MATH 109,B02,083216,Anzaldo; Leesa B,1,4,30,29
1650231806576,MATH 142A,A01,083219,Chow; Bennett,0,12,30,30
1650231806576,MATH 142A,A02,083220,Chow; Bennett,0,11,30,30
1650231806576,MATH 142A,B01,083221,Chow; Bennett,0,11,30,30
1650231806576,MATH 142A,B02,083222,Chow; Bennett,0,12,30,30
1650231812602,MATH 193A,A01,083224,Staff,0,5,30,30
1650231812602,MATH 193A,A02,083225,Staff,0,4,30,30
1650231812602,MATH 193A,A03,083781,Staff,0,2,30,30
1650231812602,MATH 193A,A04,083782,Staff,0,1,30,30
1650231818623,MATH 197,001,091859,McAuley; Julian John,9998,0,9999,1
1650231824680,COGS 9,A01,083615,Staff,0,14,60,60
1650231830702,COGS 11,A01,083617,Boyle; Mary E. T.,24,0,40,16
1650231836724,COGS 13,A01,083071,Staff,0,30,40,40
1650231842746,COGS 14A,A01,092681,Staff,0,12,100,100
1650231848775,COGS 14B,A01,083073,Cheng; Tzu-Han,0,7,50,50
1650231854798,COGS 17,A01,092677,Staff,34,0,75,41
1650231860823,COGS 100,A01,083619,Staff,1,21,60,59
1650231866846,COGS 101A,A01,083621,Davis; Joshua Daniel,0,21,60,60
1650231872887,COGS 101B,A01,091572,Staff,6,0,60,54
1650231878910,COGS 101C,A01,083625,Delgado; Tania,20,0,30,10
1650231884935,COGS 107A,A01,083627,Boyle; Mary E. T.,1,7,60,59
1650231890958,COGS 118A,A01,083075,Staff,15,0,60,45
1650231896983,CSE 3,A50,083646,Miranda; Gregory Joseph,22,0,38,16
1650231896983,CSE 3,A51,083647,Miranda; Gregory Joseph,37,0,37,0
1650231903015,CSE 8A,A50,083650,Miranda; Gregory Joseph,0,18,40,40
1650231909042,CSE 11,A01,083080,Cao; Yingjun,0,68,40,40
1650231915066,CSE 12,A01,083652,Staff,0,9,100,100
1650231921087,CSE 15L,A01,083654,Staff,0,1,50,50
1650231921087,CSE 15L,A02,083655,Staff,5,0,50,45
1650231927113,CSE 20,A01,083657,Staff,53,0,80,27
1650231933144,CSE 30,A01,083084,Eldon; John,0,70,40,40
1650231939176,CSE 100,A01,083659,Cao; Yingjun,0,63,50,50
1650231945202,CSE 134B,A01,083661,Powell; Thomas Allan,0,27,65,65
1650231951224,CSE 140,A01,083663,Staff,1,0,75,74
1650231957249,CSE 140L,A01,083088,Eldon; John,0,4,75,75
1650231963372,CSE 175,A01,083665,Kumar; Rakesh,8,0,25,17
1650231969395,CSE 190,A00,092507,Dubnov; Shlomo,14,0,20,6
1650231975420,ECE 45,A01,083139,Staff,0,13,40,40
1650231981442,ECE 65,A50,083695,Staff,0,5,30,30
1650231987474,ECE 109,A01,091882,Touri; Behrouz,47,0,70,23
1650231993499,ECE 180,A00,083140,Abi Samra; Nicholas Camill,24,0,30,6
1650231993499,ECE 180,B00,083141,Abi Samra; Nicholas Camill,8,0,30,22
1650231999527,MATH 10A,A01,083735,Patchell; Gregory David,11,0,30,19
1650231999527,MATH 10A,A02,083736,Patchell; Gregory David,28,0,30,2
1650231999527,MATH 10A,A03,083737,Patchell; Gregory David,26,0,30,4
1650232005551,MATH 10B,A01,083207,Staff,0,6,30,30
1650232005551,MATH 10B,A02,083208,Staff,0,5,30,30
1650232005551,MATH 10B,B01,083739,Staff,17,0,30,13
1650232005551,MATH 10B,B02,083740,Staff,29,0,30,1
1650232011580,MATH 18,A01,083743,Staff,8,0,30,22
1650232011580,MATH 18,A02,083744,Staff,28,0,30,2
1650232011580,MATH 18,A03,083745,Staff,23,0,30,7
1650232011580,MATH 18,A04,083746,Staff,27,0,30,3
1650232011580,MATH 18,B01,083748,Staff,0,10,30,30
1650232011580,MATH 18,B02,083749,Staff,0,7,30,30
1650232011580,MATH 18,B03,083750,Staff,0,7,30,30
1650232011580,MATH 18,B04,083751,Staff,0,8,30,30
1650232017600,MATH 20A,A01,083754,Staff,26,0,40,14
1650232023631,MATH 20B,A01,083756,Staff,1,6,30,29
1650232023631,MATH 20B,A02,083757,Staff,0,6,30,30
1650232029656,MATH 20C,A01,083760,Staff,0,12,30,30
1650232029656,MATH 20C,A02,083761,Staff,0,12,30,30
1650232029656,MATH 20C,B01,083762,Staff,14,0,30,16
1650232029656,MATH 20C,B02,083763,Staff,28,0,30,2
1650232035679,MATH 20D,A01,083765,Staff,1,2,30,29
1650232035679,MATH 20D,A02,083766,Staff,10,0,30,20
1650232035679,MATH 20D,A03,083767,Staff,28,0,30,2
1650232041704,MATH 20E,A01,083771,Staff,8,0,30,22
1650232041704,MATH 20E,A02,083772,Staff,21,0,30,9
1650232041704,MATH 20E,B01,083773,Staff,0,0,30,30
1650232041704,MATH 20E,B02,083774,Staff,12,0,30,18
1650232047729,MATH 103A,A01,083777,Staff,0,9,30,30
1650232047729,MATH 103A,A02,083778,Staff,0,10,30,30
1650232047729,MATH 103A,B01,083779,Staff,0,9,30,30
1650232047729,MATH 103A,B02,083780,Staff,0,9,30,30
1650232053751,MATH 105,A01,085443,Staff,0,17,30,30
1650232059781,MATH 109,A01,083213,Anzaldo; Leesa B,0,3,30,30
1650232059781,MATH 109,A02,083214,Anzaldo; Leesa B,0,6,30,30
1650232059781,MATH 109,B01,083215,Anzaldo; Leesa B,0,4,30,30
1650232059781,MATH 109,B02,083216,Anzaldo; Leesa B,1,4,30,29
1650232065808,MATH 142A,A01,083219,Chow; Bennett,0,12,30,30
1650232065808,MATH 142A,A02,083220,Chow; Bennett,0,11,30,30
1650232065808,MATH 142A,B01,083221,Chow; Bennett,0,11,30,30
1650232065808,MATH 142A,B02,083222,Chow; Bennett,0,12,30,30
1650232071830,MATH 193A,A01,083224,Staff,0,5,30,30
1650232071830,MATH 193A,A02,083225,Staff,0,4,30,30
1650232071830,MATH 193A,A03,083781,Staff,0,2,30,30
1650232071830,MATH 193A,A04,083782,Staff,0,1,30,30
1650232077854,MATH 197,001,091859,McAuley; Julian John,9998,0,9999,1
1650232083905,COGS 9,A01,083615,Staff,0,14,60,60
1650232089928,COGS 11,A01,083617,Boyle; Mary E. T.,24,0,40,16
1650232095951,COGS 13,A01,083071,Staff,0,30,40,40
1650232101976,COGS 14A,A01,092681,Staff,0,12,100,100
1650232108001,COGS 14B,A01,083073,Cheng; Tzu-Han,0,7,50,50
1650232114023,COGS 17,A01,092677,Staff,34,0,75,41
1650232120048,COGS 100,A01,083619,Staff,1,21,60,59
1650232126077,COGS 101A,A01,083621,Davis; Joshua Daniel,0,21,60,60
1650232132103,COGS 101B,A01,091572,Staff,6,0,60,54
1650232138127,COGS 101C,A01,083625,Delgado; Tania,20,0,30,10
1650232144173,COGS 107A,A01,083627,Boyle; Mary E. T.,1,7,60,59
1650232150199,COGS 118A,A01,083075,Staff,15,0,60,45
1650232156224,CSE 3,A50,083646,Miranda; Gregory Joseph,22,0,38,16
1650232156224,CSE 3,A51,083647,Miranda; Gregory Joseph,37,0,37,0
1650232162249,CSE 8A,A50,083650,Miranda; Gregory Joseph,0,18,40,40
1650232168278,CSE 11,A01,083080,Cao; Yingjun,0,68,40,40
1650232174304,CSE 12,A01,083652,Staff,0,9,100,100
1650232180329,CSE 15L,A01,083654,Staff,0,1,50,50
1650232180329,CSE 15L,A02,083655,Staff,5,0,50,45
1650232186351,CSE 20,A01,083657,Staff,53,0,80,27
1650232192376,CSE 30,A01,083084,Eldon; John,0,70,40,40
1650232198401,CSE 100,A01,083659,Cao; Yingjun,0,63,50,50
1650232204425,CSE 134B,A01,083661,Powell; Thomas Allan,0,27,65,65
1650232210457,CSE 140,A01,083663,Staff,1,0,75,74
1650232216492,CSE 140L,A01,083088,Eldon; John,0,4,75,75
1650232222517,CSE 175,A01,083665,Kumar; Rakesh,8,0,25,17
1650232228539,CSE 190,A00,092507,Dubnov; Shlomo,14,0,20,6
1650232234566,ECE 45,A01,083139,Staff,0,13,40,40
1650232240590,ECE 65,A50,083695,Staff,0,5,30,30
1650232246613,ECE 109,A01,091882,Touri; Behrouz,47,0,70,23
1650232252640,ECE 180,A00,083140,Abi Samra; Nicholas Camill,24,0,30,6
1650232252640,ECE 180,B00,083141,Abi Samra; Nicholas Camill,8,0,30,22
1650232258673,MATH 10A,A01,083735,Patchell; Gregory David,11,0,30,19
1650232258673,MATH 10A,A02,083736,Patchell; Gregory David,28,0,30,2
1650232258673,MATH 10A,A03,083737,Patchell; Gregory David,26,0,30,4
1650232264699,MATH 10B,A01,083207,Staff,0,6,30,30
1650232264699,MATH 10B,A02,083208,Staff,0,5,30,30
1650232264699,MATH 10B,B01,083739,Staff,17,0,30,13
1650232264699,MATH 10B,B02,083740,Staff,29,0,30,1
1650232270725,MATH 18,A01,083743,Staff,8,0,30,22
1650232270725,MATH 18,A02,083744,Staff,28,0,30,2
1650232270725,MATH 18,A03,083745,Staff,23,0,30,7
1650232270725,MATH 18,A04,083746,Staff,27,0,30,3
1650232270725,MATH 18,B01,083748,Staff,0,10,30,30
1650232270725,MATH 18,B02,083749,Staff,0,7,30,30
1650232270725,MATH 18,B03,083750,Staff,0,7,30,30
1650232270725,MATH 18,B04,083751,Staff,0,8,30,30
1650232276748,MATH 20A,A01,083754,Staff,26,0,40,14
1650232282778,MATH 20B,A01,083756,Staff,1,6,30,29
1650232282778,MATH 20B,A02,083757,Staff,0,6,30,30
1650232288802,MATH 20C,A01,083760,Staff,0,12,30,30
1650232288802,MATH 20C,A02,083761,Staff,0,12,30,30
1650232288802,MATH 20C,B01,083762,Staff,14,0,30,16
1650232288802,MATH 20C,B02,083763,Staff,28,0,30,2
1650232294825,MATH 20D,A01,083765,Staff,1,2,30,29
1650232294825,MATH 20D,A02,083766,Staff,10,0,30,20
1650232294825,MATH 20D,A03,083767,Staff,28,0,30,2
1650232300849,MATH 20E,A01,083771,Staff,8,0,30,22
1650232300849,MATH 20E,A02,083772,Staff,21,0,30,9
1650232300849,MATH 20E,B01,083773,Staff,0,0,30,30
1650232300849,MATH 20E,B02,083774,Staff,12,0,30,18
1650232306873,MATH 103A,A01,083777,Staff,0,9,30,30
1650232306873,MATH 103A,A02,083778,Staff,0,10,30,30
1650232306873,MATH 103A,B01,083779,Staff,0,9,30,30
1650232306873,MATH 103A,B02,083780,Staff,0,9,30,30
1650232312896,MATH 105,A01,085443,Staff,0,17,30,30
1650232318919,MATH 109,A01,083213,Anzaldo; Leesa B,0,3,30,30
1650232318919,MATH 109,A02,083214,Anzaldo; Leesa B,0,6,30,30
1650232318919,MATH 109,B01,083215,Anzaldo; Leesa B,0,4,30,30
1650232318919,MATH 109,B02,083216,Anzaldo; Leesa B,1,4,30,29
1650232324943,MATH 142A,A01,083219,Chow; Bennett,0,12,30,30
1650232324943,MATH 142A,A02,083220,Chow; Bennett,0,11,30,30
1650232324943,MATH 142A,B01,083221,Chow; Bennett,0,11,30,30
1650232324943,MATH 142A,B02,083222,Chow; Bennett,0,12,30,30
1650232330969,MATH 193A,A01,083224,Staff,0,5,30,30
1650232330969,MATH 193A,A02,083225,Staff,0,4,30,30
1650232330969,MATH 193A,A03,083781,Staff,0,2,30,30
1650232330969,MATH 193A,A04,083782,Staff,0,1,30,30
1650232336992,MATH 197,001,091859,McAuley; Julian John,9998,0,9999,1
1650232343051,COGS 9,A01,083615,Staff,0,14,60,60
1650232349075,COGS 11,A01,083617,Boyle; Mary E. T.,24,0,40,16
1650232355098,COGS 13,A01,083071,Staff,0,30,40,40
1650232361132,COGS 14A,A01,092681,Staff,0,12,100,100
1650232367156,COGS 14B,A01,083073,Cheng; Tzu-Han,0,7,50,50
1650232373183,COGS 17,A01,092677,Staff,34,0,75,41
1650232379208,COGS 100,A01,083619,Staff,1,21,60,59
1650232385232,COGS 101A,A01,083621,Davis; Joshua Daniel,0,21,60,60
1650232391256,COGS 101B,A01,091572,Staff,6,0,60,54
1650232397280,COGS 101C,A01,083625,Delgado; Tania,20,0,30,10
1650232403305,COGS 107A,A01,083627,Boyle; Mary E. T.,1,7,60,59
1650232409327,COGS 118A,A01,083075,Staff,15,0,60,45
1650232415349,CSE 3,A50,083646,Miranda; Gregory Joseph,22,0,38,16
1650232415349,CSE 3,A51,083647,Miranda; Gregory Joseph,37,0,37,0
1650232421375,CSE 8A,A50,083650,Miranda; Gregory Joseph,0,18,40,40
1650232427404,CSE 11,A01,083080,Cao; Yingjun,0,68,40,40
1650232433428,CSE 12,A01,083652,Staff,0,9,100,100
1650232439461,CSE 15L,A01,083654,Staff,0,1,50,50
1650232439461,CSE 15L,A02,083655,Staff,5,0,50,45
1650232445494,CSE 20,A01,083657,Staff,53,0,80,27
1650232451520,CSE 30,A01,083084,Eldon; John,0,70,40,40
1650232457556,CSE 100,A01,083659,Cao; Yingjun,0,63,50,50
1650232463584,CSE 134B,A01,083661,Powell; Thomas Allan,0,27,65,65
1650232469608,CSE 140,A01,083663,Staff,1,0,75,74
1650232475638,CSE 140L,A01,083088,Eldon; John,0,4,75,75
1650232481668,CSE 175,A01,083665,Kumar; Rakesh,8,0,25,17
1650232487691,CSE 190,A00,092507,Dubnov; Shlomo,14,0,20,6
1650232493717,ECE 45,A01,083139,Staff,0,13,40,40
1650232499739,ECE 65,A50,083695,Staff,0,5,30,30
1650232505765,ECE 109,A01,091882,Touri; Behrouz,47,0,70,23
1650232511791,ECE 180,A00,083140,Abi Samra; Nicholas Camill,24,0,30,6
1650232511791,ECE 180,B00,083141,Abi Samra; Nicholas Camill,8,0,30,22
1650232517814,MATH 10A,A01,083735,Patchell; Gregory David,11,0,30,19
1650232517814,MATH 10A,A02,083736,Patchell; Gregory David,28,0,30,2
1650232517814,MATH 10A,A03,083737,Patchell; Gregory David,26,0,30,4
1650232523839,MATH 10B,A01,083207,Staff,0,6,30,30
1650232523839,MATH 10B,A02,083208,Staff,0,5,30,30
1650232523839,MATH 10B,B01,083739,Staff,17,0,30,13
1650232523839,MATH 10B,B02,083740,Staff,29,0,30,1
1650232529870,MATH 18,A01,083743,Staff,8,0,30,22
1650232529870,MATH 18,A02,083744,Staff,28,0,30,2
1650232529870,MATH 18,A03,083745,Staff,23,0,30,7
1650232529870,MATH 18,A04,083746,Staff,27,0,30,3
1650232529870,MATH 18,B01,083748,Staff,0,10,30,30
1650232529870,MATH 18,B02,083749,Staff,0,7,30,30
1650232529870,MATH 18,B03,083750,Staff,0,7,30,30
1650232529870,MATH 18,B04,083751,Staff,0,8,30,30
1650232535893,MATH 20A,A01,083754,Staff,26,0,40,14
1650232541920,MATH 20B,A01,083756,Staff,1,6,30,29
1650232541920,MATH 20B,A02,083757,Staff,0,6,30,30
1650232547947,MATH 20C,A01,083760,Staff,0,12,30,30
1650232547947,MATH 20C,A02,083761,Staff,0,12,30,30
1650232547947,MATH 20C,B01,083762,Staff,14,0,30,16
1650232547947,MATH 20C,B02,083763,Staff,28,0,30,2
1650232553979,MATH 20D,A01,083765,Staff,1,2,30,29
1650232553979,MATH 20D,A02,083766,Staff,10,0,30,20
1650232553979,MATH 20D,A03,083767,Staff,28,0,30,2
1650232560076,MATH 20E,A01,083771,Staff,8,0,30,22
1650232560076,MATH 20E,A02,083772,Staff,21,0,30,9
1650232560076,MATH 20E,B01,083773,Staff,0,0,30,30
1650232560076,MATH 20E,B02,083774,Staff,12,0,30,18
1650232566103,MATH 103A,A01,083777,Staff,0,9,30,30
1650232566103,MATH 103A,A02,083778,Staff,0,10,30,30
1650232566103,MATH 103A,B01,083779,Staff,0,9,30,30
1650232566103,MATH 103A,B02,083780,Staff,0,9,30,30
1650232572130,MATH 105,A01,085443,Staff,0,17,30,30
1650232578155,MATH 109,A01,083213,Anzaldo; Leesa B,0,3,30,30
1650232578155,MATH 109,A02,083214,Anzaldo; Leesa B,0,6,30,30
1650232578155,MATH 109,B01,083215,Anzaldo; Leesa B,0,4,30,30
1650232578155,MATH 109,B02,083216,Anzaldo; Leesa B,1,4,30,29
1650232584180,MATH 142A,A01,083219,Chow; Bennett,0,12,30,30
1650232584180,MATH 142A,A02,083220,Chow; Bennett,0,11,30,30
1650232584180,MATH 142A,B01,083221,Chow; Bennett,0,11,30,30
1650232584180,MATH 142A,B02,083222,Chow; Bennett,0,12,30,30
1650232590215,MATH 193A,A01,083224,Staff,0,5,30,30
1650232590215,MATH 193A,A02,083225,Staff,0,4,30,30
1650232590215,MATH 193A,A03,083781,Staff,0,2,30,30
1650232590215,MATH 193A,A04,083782,Staff,0,1,30,30
1650232596237,MATH 197,001,091859,McAuley; Julian John,9998,0,9999,1
1650232602294,COGS 9,A01,083615,Staff,0,14,60,60
1650232608318,COGS 11,A01,083617,Boyle; Mary E. T.,24,0,40,16
1650232614342,COGS 13,A01,083071,Staff,0,30,40,40
1650232620366,COGS 14A,A01,092681,Staff,0,12,100,100
1650232626389,COGS 14B,A01,083073,Cheng; Tzu-Han,0,7,50,50
1650232632413,COGS 17,A01,092677,Staff,34,0,75,41
1650232638440,COGS 100,A01,083619,Staff,1,21,60,59
1650232644468,COGS 101A,A01,083621,Davis; Joshua Daniel,0,21,60,60
1650232650508,COGS 101B,A01,091572,Staff,6,0,60,54
1650232656536,COGS 101C,A01,083625,Delgado; Tania,20,0,30,10
1650232662563,COGS 107A,A01,083627,Boyle; Mary E. T.,1,7,60,59
1650232668588,COGS 118A,A01,083075,Staff,15,0,60,45
1650232674611,CSE 3,A50,083646,Miranda; Gregory Joseph,22,0,38,16
1650232674611,CSE 3,A51,083647,Miranda; Gregory Joseph,37,0,37,0
1650232680639,CSE 8A,A50,083650,Miranda; Gregory Joseph,0,18,40,40
1650232686662,CSE 11,A01,083080,Cao; Yingjun,0,68,40,40
1650232692684,CSE 12,A01,083652,Staff,0,9,100,100
1650232698707,CSE 15L,A01,083654,Staff,0,1,50,50
1650232698707,CSE 15L,A02,083655,Staff,5,0,50,45
1650232704734,CSE 20,A01,083657,Staff,53,0,80,27
1650232710766,CSE 30,A01,083084,Eldon; John,0,70,40,40
1650232716788,CSE 100,A01,083659,Cao; Yingjun,0,63,50,50
1650232722813,CSE 134B,A01,083661,Powell; Thomas Allan,0,27,65,65
1650232728838,CSE 140,A01,083663,Staff,1,0,75,74
1650232734861,CSE 140L,A01,083088,Eldon; John,0,4,75,75
1650232740885,CSE 175,A01,083665,Kumar; Rakesh,8,0,25,17
1650232746909,CSE 190,A00,092507,Dubnov; Shlomo,14,0,20,6
1650232752935,ECE 45,A01,083139,Staff,0,13,40,40
1650232758963,ECE 65,A50,083695,Staff,0,5,30,30
1650232764986,ECE 109,A01,091882,Touri; Behrouz,47,0,70,23
1650232771016,ECE 180,A00,083140,Abi Samra; Nicholas Camill,24,0,30,6
1650232771016,ECE 180,B00,083141,Abi Samra; Nicholas Camill,8,0,30,22
1650232777044,MATH 10A,A01,083735,Patchell; Gregory David,11,0,30,19
1650232777044,MATH 10A,A02,083736,Patchell; Gregory David,28,0,30,2
1650232777044,MATH 10A,A03,083737,Patchell; Gregory David,26,0,30,4
1650232783074,MATH 10B,A01,083207,Staff,0,6,30,30
1650232783074,MATH 10B,A02,083208,Staff,0,5,30,30
1650232783074,MATH 10B,B01,083739,Staff,17,0,30,13
1650232783074,MATH 10B,B02,083740,Staff,29,0,30,1
1650232789103,MATH 18,A01,083743,Staff,8,0,30,22
1650232789103,MATH 18,A02,083744,Staff,28,0,30,2
1650232789103,MATH 18,A03,083745,Staff,23,0,30,7
1650232789103,MATH 18,A04,083746,Staff,27,0,30,3
1650232789103,MATH 18,B01,083748,Staff,0,10,30,30
1650232789103,MATH 18,B02,083749,Staff,0,7,30,30
1650232789103,MATH 18,B03,083750,Staff,0,7,30,30
1650232789103,MATH 18,B04,083751,Staff,0,8,30,30
1650232795126,MATH 20A,A01,083754,Staff,26,0,40,14
1650232801152,MATH 20B,A01,083756,Staff,1,6,30,29
1650232801152,MATH 20B,A02,083757,Staff,0,6,30,30
1650232807175,MATH 20C,A01,083760,Staff,0,12,30,30
1650232807175,MATH 20C,A02,083761,Staff,0,12,30,30
1650232807175,MATH 20C,B01,083762,Staff,14,0,30,16
1650232807175,MATH 20C,B02,083763,Staff,28,0,30,2
1650232813197,MATH 20D,A01,083765,Staff,1,2,30,29
1650232813197,MATH 20D,A02,083766,Staff,10,0,30,20
1650232813197,MATH 20D,A03,083767,Staff,28,0,30,2
1650232819221,MATH 20E,A01,083771,Staff,8,0,30,22
1650232819221,MATH 20E,A02,083772,Staff,21,0,30,9
1650232819221,MATH 20E,B01,083773,Staff,0,0,30,30
1650232819221,MATH 20E,B02,083774,Staff,12,0,30,18
1650232825243,MATH 103A,A01,083777,Staff,0,9,30,30
1650232825243,MATH 103A,A02,083778,Staff,0,10,30,30
1650232825243,MATH 103A,B01,083779,Staff,0,9,30,30
1650232825243,MATH 103A,B02,083780,Staff,0,9,30,30
1650232831266,MATH 105,A01,085443,Staff,0,17,30,30
1650232837294,MATH 109,A01,083213,Anzaldo; Leesa B,0,3,30,30
1650232837294,MATH 109,A02,083214,Anzaldo; Leesa B,0,6,30,30
1650232837294,MATH 109,B01,083215,Anzaldo; Leesa B,0,4,30,30
1650232837294,MATH 109,B02,083216,Anzaldo; Leesa B,1,4,30,29
1650232843321,MATH 142A,A01,083219,Chow; Bennett,0,12,30,30
1650232843321,MATH 142A,A02,083220,Chow; Bennett,0,11,30,30
1650232843321,MATH 142A,B01,083221,Chow; Bennett,0,11,30,30
1650232843321,MATH 142A,B02,083222,Chow; Bennett,0,12,30,30
1650232849347,MATH 193A,A01,083224,Staff,0,5,30,30
1650232849347,MATH 193A,A02,083225,Staff,0,4,30,30
1650232849347,MATH 193A,A03,083781,Staff,0,2,30,30
1650232849347,MATH 193A,A04,083782,Staff,0,1,30,30
1650232855375,MATH 197,001,091859,McAuley; Julian John,9998,0,9999,1
1650232861449,COGS 9,A01,083615,Staff,0,14,60,60
1650232867471,COGS 11,A01,083617,Boyle; Mary E. T.,24,0,40,16
1650232873495,COGS 13,A01,083071,Staff,0,30,40,40
1650232879518,COGS 14A,A01,092681,Staff,0,12,100,100
1650232885544,COGS 14B,A01,083073,Cheng; Tzu-Han,0,7,50,50
1650232891567,COGS 17,A01,092677,Staff,34,0,75,41
1650232897610,COGS 100,A01,083619,Staff,1,21,60,59
1650232903634,COGS 101A,A01,083621,Davis; Joshua Daniel,0,21,60,60
1650232909656,COGS 101B,A01,091572,Staff,6,0,60,54
1650232915695,COGS 101C,A01,083625,Delgado; Tania,20,0,30,10
1650232921721,COGS 107A,A01,083627,Boyle; Mary E. T.,1,7,60,59
1650232927748,COGS 118A,A01,083075,Staff,15,0,60,45
1650232933776,CSE 3,A50,083646,Miranda; Gregory Joseph,22,0,38,16
1650232933776,CSE 3,A51,083647,Miranda; Gregory Joseph,37,0,37,0
1650232939804,CSE 8A,A50,083650,Miranda; Gregory Joseph,0,18,40,40
1650232945837,CSE 11,A01,083080,Cao; Yingjun,0,68,40,40
1650232951861,CSE 12,A01,083652,Staff,0,9,100,100
1650232957884,CSE 15L,A01,083654,Staff,0,1,50,50
1650232957884,CSE 15L,A02,083655,Staff,5,0,50,45
1650232963908,CSE 20,A01,083657,Staff,53,0,80,27
1650232969929,CSE 30,A01,083084,Eldon; John,0,70,40,40
1650232975953,CSE 100,A01,083659,Cao; Yingjun,0,63,50,50
1650232981979,CSE 134B,A01,083661,Powell; Thomas Allan,0,27,65,65
1650232988002,CSE 140,A01,083663,Staff,1,0,75,74
1650232994026,CSE 140L,A01,083088,Eldon; John,0,4,75,75
1650233000050,CSE 175,A01,083665,Kumar; Rakesh,8,0,25,17
1650233006073,CSE 190,A00,092507,Dubnov; Shlomo,14,0,20,6
1650233012096,ECE 45,A01,083139,Staff,0,13,40,40
1650233018132,ECE 65,A50,083695,Staff,0,5,30,30
1650233024156,ECE 109,A01,091882,Touri; Behrouz,47,0,70,23
1650233030183,ECE 180,A00,083140,Abi Samra; Nicholas Camill,24,0,30,6
1650233030183,ECE 180,B00,083141,Abi Samra; Nicholas Camill,8,0,30,22
1650233036210,MATH 10A,A01,083735,Patchell; Gregory David,11,0,30,19
1650233036210,MATH 10A,A02,083736,Patchell; Gregory David,28,0,30,2
1650233036210,MATH 10A,A03,083737,Patchell; Gregory David,26,0,30,4
1650233042234,MATH 10B,A01,083207,Staff,0,6,30,30
1650233042234,MATH 10B,A02,083208,Staff,0,5,30,30
1650233042234,MATH 10B,B01,083739,Staff,17,0,30,13
1650233042234,MATH 10B,B02,083740,Staff,29,0,30,1
1650233048261,MATH 18,A01,083743,Staff,8,0,30,22
1650233048261,MATH 18,A02,083744,Staff,28,0,30,2
1650233048261,MATH 18,A03,083745,Staff,23,0,30,7
1650233048261,MATH 18,A04,083746,Staff,27,0,30,3
1650233048261,MATH 18,B01,083748,Staff,0,10,30,30
1650233048261,MATH 18,B02,083749,Staff,0,7,30,30
1650233048261,MATH 18,B03,083750,Staff,0,7,30,30
1650233048261,MATH 18,B04,083751,Staff,0,8,30,30
1650233054287,MATH 20A,A01,083754,Staff,26,0,40,14
1650233060311,MATH 20B,A01,083756,Staff,1,6,30,29
1650233060311,MATH 20B,A02,083757,Staff,0,6,30,30
1650233066339,MATH 20C,A01,083760,Staff,0,12,30,30
1650233066339,MATH 20C,A02,083761,Staff,0,12,30,30
1650233066339,MATH 20C,B01,083762,Staff,14,0,30,16
1650233066339,MATH 20C,B02,083763,Staff,28,0,30,2
1650233072367,MATH 20D,A01,083765,Staff,1,2,30,29
1650233072367,MATH 20D,A02,083766,Staff,10,0,30,20
1650233072367,MATH 20D,A03,083767,Staff,28,0,30,2
1650233078394,MATH 20E,A01,083771,Staff,8,0,30,22
1650233078394,MATH 20E,A02,083772,Staff,21,0,30,9
1650233078394,MATH 20E,B01,083773,Staff,0,0,30,30
1650233078394,MATH 20E,B02,083774,Staff,12,0,30,18
1650233084417,MATH 103A,A01,083777,Staff,0,9,30,30
1650233084417,MATH 103A,A02,083778,Staff,0,10,30,30
1650233084417,MATH 103A,B01,083779,Staff,0,9,30,30
1650233084417,MATH 103A,B02,083780,Staff,0,9,30,30
1650233090441,MATH 105,A01,085443,Staff,0,17,30,30
1650233096472,MATH 109,A01,083213,Anzaldo; Leesa B,0,3,30,30
1650233096472,MATH 109,A02,083214,Anzaldo; Leesa B,0,6,30,30
1650233096472,MATH 109,B01,083215,Anzaldo; Leesa B,0,4,30,30
1650233096472,MATH 109,B02,083216,Anzaldo; Leesa B,1,4,30,29
1650233102494,MATH 142A,A01,083219,Chow; Bennett,0,12,30,30
1650233102494,MATH 142A,A02,083220,Chow; Bennett,0,11,30,30
1650233102494,MATH 142A,B01,083221,Chow; Bennett,0,11,30,30
1650233102494,MATH 142A,B02,083222,Chow; Bennett,0,12,30,30
1650233108520,MATH 193A,A01,083224,Staff,0,5,30,30
1650233108520,MATH 193A,A02,083225,Staff,0,4,30,30
1650233108520,MATH 193A,A03,083781,Staff,0,2,30,30
1650233108520,MATH 193A,A04,083782,Staff,0,1,30,30
1650233114544,MATH 197,001,091859,McAuley; Julian John,9998,0,9999,1
1650233120594,COGS 9,A01,083615,Staff,0,14,60,60
1650233126620,COGS 11,A01,083617,Boyle; Mary E. T.,24,0,40,16
1650233132646,COGS 13,A01,083071,Staff,0,30,40,40
1650233138670,COGS 14A,A01,092681,Staff,0,12,100,100
1650233144691,COGS 14B,A01,083073,Cheng; Tzu-Han,0,7,50,50
1650233150789,COGS 17,A01,092677,Staff,34,0,75,41
1650233156813,COGS 100,A01,083619,Staff,1,21,60,59
1650233162839,COGS 101A,A01,083621,Davis; Joshua Daniel,0,21,60,60
1650233168866,COGS 101B,A01,091572,Staff,6,0,60,54
1650233174889,COGS 101C,A01,083625,Delgado; Tania,20,0,30,10
1650233180915,COGS 107A,A01,083627,Boyle; Mary E. T.,1,7,60,59
1650233186941,COGS 118A,A01,083075,Staff,15,0,60,45
1650233192970,CSE 3,A50,083646,Miranda; Gregory Joseph,22,0,38,16
1650233192970,CSE 3,A51,083647,Miranda; Gregory Joseph,37,0,37,0
1650233199003,CSE 8A,A50,083650,Miranda; Gregory Joseph,0,18,40,40
1650233205028,CSE 11,A01,083080,Cao; Yingjun,0,68,40,40
1650233211050,CSE 12,A01,083652,Staff,0,9,100,100
1650233217076,CSE 15L,A01,083654,Staff,0,1,50,50
1650233217076,CSE 15L,A02,083655,Staff,5,0,50,45
1650233223102,CSE 20,A01,083657,Staff,53,0,80,27
1650233229127,CSE 30,A01,083084,Eldon; John,0,70,40,40
1650233235152,CSE 100,A01,083659,Cao; Yingjun,0,63,50,50
1650233241176,CSE 134B,A01,083661,Powell; Thomas Allan,0,27,65,65
1650233247202,CSE 140,A01,083663,Staff,1,0,75,74
1650233253224,CSE 140L,A01,083088,Eldon; John,0,4,75,75
1650233259250,CSE 175,A01,083665,Kumar; Rakesh,8,0,25,17
1650233265273,CSE 190,A00,092507,Dubnov; Shlomo,14,0,20,6
1650233271297,ECE 45,A01,083139,Staff,0,13,40,40
1650233277321,ECE 65,A50,083695,Staff,0,5,30,30
1650233283344,ECE 109,A01,091882,Touri; Behrouz,47,0,70,23
1650233289372,ECE 180,A00,083140,Abi Samra; Nicholas Camill,24,0,30,6
1650233289372,ECE 180,B00,083141,Abi Samra; Nicholas Camill,8,0,30,22
1650233295396,MATH 10A,A01,083735,Patchell; Gregory David,11,0,30,19
1650233295396,MATH 10A,A02,083736,Patchell; Gregory David,28,0,30,2
1650233295396,MATH 10A,A03,083737,Patchell; Gregory David,26,0,30,4
1650233301429,MATH 10B,A01,083207,Staff,0,6,30,30
1650233301429,MATH 10B,A02,083208,Staff,0,5,30,30
1650233301429,MATH 10B,B01,083739,Staff,17,0,30,13
1650233301429,MATH 10B,B02,083740,Staff,29,0,30,1
1650233307453,MATH 18,A01,083743,Staff,8,0,30,22
1650233307453,MATH 18,A02,083744,Staff,28,0,30,2
1650233307453,MATH 18,A03,083745,Staff,23,0,30,7
1650233307453,MATH 18,A04,083746,Staff,27,0,30,3
1650233307453,MATH 18,B01,083748,Staff,0,10,30,30
1650233307453,MATH 18,B02,083749,Staff,0,7,30,30
1650233307453,MATH 18,B03,083750,Staff,0,7,30,30
1650233307453,MATH 18,B04,083751,Staff,0,8,30,30
1650233313476,MATH 20A,A01,083754,Staff,26,0,40,14
1650233319499,MATH 20B,A01,083756,Staff,1,6,30,29
1650233319499,MATH 20B,A02,083757,Staff,0,6,30,30
1650233325523,MATH 20C,A01,083760,Staff,0,12,30,30
1650233325523,MATH 20C,A02,083761,Staff,0,12,30,30
1650233325523,MATH 20C,B01,083762,Staff,14,0,30,16
1650233325523,MATH 20C,B02,083763,Staff,28,0,30,2
1650233331546,MATH 20D,A01,083765,Staff,1,2,30,29
1650233331546,MATH 20D,A02,083766,Staff,10,0,30,20
1650233331546,MATH 20D,A03,083767,Staff,28,0,30,2
1650233337569,MATH 20E,A01,083771,Staff,8,0,30,22
1650233337569,MATH 20E,A02,083772,Staff,21,0,30,9
1650233337569,MATH 20E,B01,083773,Staff,0,0,30,30
1650233337569,MATH 20E,B02,083774,Staff,12,0,30,18
1650233343590,MATH 103A,A01,083777,Staff,0,9,30,30
1650233343590,MATH 103A,A02,083778,Staff,0,10,30,30
1650233343590,MATH 103A,B01,083779,Staff,0,9,30,30
1650233343590,MATH 103A,B02,083780,Staff,0,9,30,30
1650233349613,MATH 105,A01,085443,Staff,0,17,30,30
1650233355637,MATH 109,A01,083213,Anzaldo; Leesa B,0,3,30,30
1650233355637,MATH 109,A02,083214,Anzaldo; Leesa B,0,6,30,30
1650233355637,MATH 109,B01,083215,Anzaldo; Leesa B,0,4,30,30
1650233355637,MATH 109,B02,083216,Anzaldo; Leesa B,1,4,30,29
1650233361664,MATH 142A,A01,083219,Chow; Bennett,0,12,30,30
1650233361664,MATH 142A,A02,083220,Chow; Bennett,0,11,30,30
1650233361664,MATH 142A,B01,083221,Chow; Bennett,0,11,30,30
1650233361664,MATH 142A,B02,083222,Chow; Bennett,0,12,30,30
1650233367687,MATH 193A,A01,083224,Staff,0,5,30,30
1650233367687,MATH 193A,A02,083225,Staff,0,4,30,30
1650233367687,MATH 193A,A03,083781,Staff,0,2,30,30
1650233367687,MATH 193A,A04,083782,Staff,0,1,30,30
1650233373710,MATH 197,001,091859,McAuley; Julian John,9998,0,9999,1
1650233379774,COGS 9,A01,083615,Staff,0,14,60,60
1650233385799,COGS 11,A01,083617,Boyle; Mary E. T.,24,0,40,16
1650233391823,COGS 13,A01,083071,Staff,0,30,40,40
1650233397851,COGS 14A,A01,092681,Staff,0,12,100,100
1650233403876,COGS 14B,A01,083073,Cheng; Tzu-Han,0,7,50,50
1650233409904,COGS 17,A01,092677,Staff,34,0,75,41
1650233415932,COGS 100,A01,083619,Staff,1,21,60,59
1650233421958,COGS 101A,A01,083621,Davis; Joshua Daniel,0,21,60,60
1650233427983,COGS 101B,A01,091572,Staff,6,0,60,54
1650233434007,COGS 101C,A01,083625,Delgado; Tania,20,0,30,10
1650233440046,COGS 107A,A01,083627,Boyle; Mary E. T.,1,7,60,59
1650233446072,COGS 118A,A01,083075,Staff,15,0,60,45
1650233452099,CSE 3,A50,083646,Miranda; Gregory Joseph,22,0,38,16
1650233452099,CSE 3,A51,083647,Miranda; Gregory Joseph,37,0,37,0
1650233458127,CSE 8A,A50,083650,Miranda; Gregory Joseph,0,18,40,40
1650233464150,CSE 11,A01,083080,Cao; Yingjun,0,68,40,40
1650233470176,CSE 12,A01,083652,Staff,0,9,100,100
1650233476199,CSE 15L,A01,083654,Staff,0,1,50,50
1650233476199,CSE 15L,A02,083655,Staff,5,0,50,45
1650233482221,CSE 20,A01,083657,Staff,53,0,80,27
1650233488252,CSE 30,A01,083084,Eldon; John,0,70,40,40
1650233494285,CSE 100,A01,083659,Cao; Yingjun,0,63,50,50
1650233500311,CSE 134B,A01,083661,Powell; Thomas Allan,0,27,65,65
1650233506344,CSE 140,A01,083663,Staff,1,0,75,74
1650233512366,CSE 140L,A01,083088,Eldon; John,0,4,75,75
1650233518393,CSE 175,A01,083665,Kumar; Rakesh,8,0,25,17
1650233524419,CSE 190,A00,092507,Dubnov; Shlomo,14,0,20,6
1650233530448,ECE 45,A01,083139,Staff,0,13,40,40
1650233536475,ECE 65,A50,083695,Staff,0,5,30,30
1650233542503,ECE 109,A01,091882,Touri; Behrouz,47,0,70,23
1650233548529,ECE 180,A00,083140,Abi Samra; Nicholas Camill,24,0,30,6
1650233548529,ECE 180,B00,083141,Abi Samra; Nicholas Camill,8,0,30,22
1650233554556,MATH 10A,A01,083735,Patchell; Gregory David,11,0,30,19
1650233554556,MATH 10A,A02,083736,Patchell; Gregory David,28,0,30,2
1650233554556,MATH 10A,A03,083737,Patchell; Gregory David,26,0,30,4
1650233560584,MATH 10B,A01,083207,Staff,0,6,30,30
1650233560584,MATH 10B,A02,083208,Staff,0,5,30,30
1650233560584,MATH 10B,B01,083739,Staff,17,0,30,13
1650233560584,MATH 10B,B02,083740,Staff,29,0,30,1
1650233566614,MATH 18,A01,083743,Staff,8,0,30,22
1650233566614,MATH 18,A02,083744,Staff,28,0,30,2
1650233566614,MATH 18,A03,083745,Staff,23,0,30,7
1650233566614,MATH 18,A04,083746,Staff,27,0,30,3
1650233566614,MATH 18,B01,083748,Staff,0,10,30,30
1650233566614,MATH 18,B02,083749,Staff,0,7,30,30
1650233566614,MATH 18,B03,083750,Staff,0,7,30,30
1650233566614,MATH 18,B04,083751,Staff,0,8,30,30
1650233572640,MATH 20A,A01,083754,Staff,26,0,40,14
1650233578663,MATH 20B,A01,083756,Staff,1,6,30,29
1650233578663,MATH 20B,A02,083757,Staff,0,6,30,30
1650233584690,MATH 20C,A01,083760,Staff,0,12,30,30
1650233584690,MATH 20C,A02,083761,Staff,0,12,30,30
1650233584690,MATH 20C,B01,083762,Staff,14,0,30,16
1650233584690,MATH 20C,B02,083763,Staff,28,0,30,2
1650233590715,MATH 20D,A01,083765,Staff,1,2,30,29
1650233590715,MATH 20D,A02,083766,Staff,10,0,30,20
1650233590715,MATH 20D,A03,083767,Staff,28,0,30,2
1650233596741,MATH 20E,A01,083771,Staff,8,0,30,22
1650233596741,MATH 20E,A02,083772,Staff,21,0,30,9
1650233596741,MATH 20E,B01,083773,Staff,0,0,30,30
1650233596741,MATH 20E,B02,083774,Staff,12,0,30,18
1650233602765,MATH 103A,A01,083777,Staff,0,9,30,30
1650233602765,MATH 103A,A02,083778,Staff,0,10,30,30
1650233602765,MATH 103A,B01,083779,Staff,0,9,30,30
1650233602765,MATH 103A,B02,083780,Staff,0,9,30,30
1650233608791,MATH 105,A01,085443,Staff,0,17,30,30
1650233614818,MATH 109,A01,083213,Anzaldo; Leesa B,0,3,30,30
1650233614818,MATH 109,A02,083214,Anzaldo; Leesa B,0,6,30,30
1650233614818,MATH 109,B01,083215,Anzaldo; Leesa B,0,4,30,30
1650233614818,MATH 109,B02,083216,Anzaldo; Leesa B,1,4,30,29
1650233620841,MATH 142A,A01,083219,Chow; Bennett,0,12,30,30
1650233620841,MATH 142A,A02,083220,Chow; Bennett,0,11,30,30
1650233620841,MATH 142A,B01,083221,Chow; Bennett,0,11,30,30
1650233620841,MATH 142A,B02,083222,Chow; Bennett,0,12,30,30
1650233626864,MATH 193A,A01,083224,Staff,0,5,30,30
1650233626864,MATH 193A,A02,083225,Staff,0,4,30,30
1650233626864,MATH 193A,A03,083781,Staff,0,2,30,30
1650233626864,MATH 193A,A04,083782,Staff,0,1,30,30
1650233632887,MATH 197,001,091859,McAuley; Julian John,9998,0,9999,1
1650233638943,COGS 9,A01,083615,Staff,0,14,60,60
1650233644967,COGS 11,A01,083617,Boyle; Mary E. T.,24,0,40,16
1650233650996,COGS 13,A01,083071,Staff,0,30,40,40
1650233657021,COGS 14A,A01,092681,Staff,1,12,100,99
1650233663045,COGS 14B,A01,083073,Cheng; Tzu-Han,0,7,50,50
1650233669070,COGS 17,A01,092677,Staff,34,0,75,41
1650233675095,COGS 100,A01,083619,Staff,1,21,60,59
1650233681122,COGS 101A,A01,083621,Davis; Joshua Daniel,0,21,60,60
1650233687151,COGS 101B,A01,091572,Staff,6,0,60,54
1650233693175,COGS 101C,A01,083625,Delgado; Tania,20,0,30,10
1650233699201,COGS 107A,A01,083627,Boyle; Mary E. T.,1,7,60,59
1650233705223,COGS 118A,A01,083075,Staff,15,0,60,45
1650233711250,CSE 3,A50,083646,Miranda; Gregory Joseph,22,0,38,16
1650233711250,CSE 3,A51,083647,Miranda; Gregory Joseph,37,0,37,0
1650233717274,CSE 8A,A50,083650,Miranda; Gregory Joseph,0,18,40,40
1650233723304,CSE 11,A01,083080,Cao; Yingjun,0,68,40,40
1650233729339,CSE 12,A01,083652,Staff,0,9,100,100
1650233735364,CSE 15L,A01,083654,Staff,0,1,50,50
1650233735364,CSE 15L,A02,083655,Staff,5,0,50,45
1650233741388,CSE 20,A01,083657,Staff,53,0,80,27
1650233747490,CSE 30,A01,083084,Eldon; John,0,70,40,40
1650233753515,CSE 100,A01,083659,Cao; Yingjun,0,63,50,50
1650233759545,CSE 134B,A01,083661,Powell; Thomas Allan,0,27,65,65
1650233765568,CSE 140,A01,083663,Staff,1,0,75,74
1650233771595,CSE 140L,A01,083088,Eldon; John,0,4,75,75
1650233777618,CSE 175,A01,083665,Kumar; Rakesh,8,0,25,17
1650233783651,CSE 190,A00,092507,Dubnov; Shlomo,14,0,20,6
1650233789677,ECE 45,A01,083139,Staff,0,13,40,40
1650233795700,ECE 65,A50,083695,Staff,0,5,30,30
1650233801724,ECE 109,A01,091882,Touri; Behrouz,47,0,70,23
1650233807747,ECE 180,A00,083140,Abi Samra; Nicholas Camill,24,0,30,6
1650233807747,ECE 180,B00,083141,Abi Samra; Nicholas Camill,8,0,30,22
1650233813770,MATH 10A,A01,083735,Patchell; Gregory David,11,0,30,19
1650233813770,MATH 10A,A02,083736,Patchell; Gregory David,28,0,30,2
1650233813770,MATH 10A,A03,083737,Patchell; Gregory David,26,0,30,4
1650233819794,MATH 10B,A01,083207,Staff,0,6,30,30
1650233819794,MATH 10B,A02,083208,Staff,0,5,30,30
1650233819794,MATH 10B,B01,083739,Staff,17,0,30,13
1650233819794,MATH 10B,B02,083740,Staff,29,0,30,1
1650233825824,MATH 18,A01,083743,Staff,8,0,30,22
1650233825824,MATH 18,A02,083744,Staff,28,0,30,2
1650233825824,MATH 18,A03,083745,Staff,23,0,30,7
1650233825824,MATH 18,A04,083746,Staff,27,0,30,3
1650233825824,MATH 18,B01,083748,Staff,0,10,30,30
1650233825824,MATH 18,B02,083749,Staff,0,7,30,30
1650233825824,MATH 18,B03,083750,Staff,0,7,30,30
1650233825824,MATH 18,B04,083751,Staff,0,8,30,30
1650233831851,MATH 20A,A01,083754,Staff,26,0,40,14
1650233837874,MATH 20B,A01,083756,Staff,1,6,30,29
1650233837874,MATH 20B,A02,083757,Staff,0,6,30,30
1650233843908,MATH 20C,A01,083760,Staff,0,12,30,30
1650233843908,MATH 20C,A02,083761,Staff,0,12,30,30
1650233843908,MATH 20C,B01,083762,Staff,14,0,30,16
1650233843908,MATH 20C,B02,083763,Staff,28,0,30,2
1650233849934,MATH 20D,A01,083765,Staff,1,2,30,29
1650233849934,MATH 20D,A02,083766,Staff,10,0,30,20
1650233849934,MATH 20D,A03,083767,Staff,28,0,30,2
1650233855963,MATH 20E,A01,083771,Staff,8,0,30,22
1650233855963,MATH 20E,A02,083772,Staff,21,0,30,9
1650233855963,MATH 20E,B01,083773,Staff,0,0,30,30
1650233855963,MATH 20E,B02,083774,Staff,12,0,30,18
1650233861991,MATH 103A,A01,083777,Staff,0,9,30,30
1650233861991,MATH 103A,A02,083778,Staff,0,10,30,30
1650233861991,MATH 103A,B01,083779,Staff,0,9,30,30
1650233861991,MATH 103A,B02,083780,Staff,0,9,30,30
1650233868014,MATH 105,A01,085443,Staff,0,17,30,30
1650233874037,MATH 109,A01,083213,Anzaldo; Leesa B,0,3,30,30
1650233874037,MATH 109,A02,083214,Anzaldo; Leesa B,0,6,30,30
1650233874037,MATH 109,B01,083215,Anzaldo; Leesa B,0,4,30,30
1650233874037,MATH 109,B02,083216,Anzaldo; Leesa B,1,4,30,29
1650233880060,MATH 142A,A01,083219,Chow; Bennett,0,12,30,30
1650233880060,MATH 142A,A02,083220,Chow; Bennett,0,11,30,30
1650233880060,MATH 142A,B01,083221,Chow; Bennett,0,11,30,30
1650233880060,MATH 142A,B02,083222,Chow; Bennett,0,12,30,30
1650233886083,MATH 193A,A01,083224,Staff,0,5,30,30
1650233886083,MATH 193A,A02,083225,Staff,0,4,30,30
1650233886083,MATH 193A,A03,083781,Staff,0,2,30,30
1650233886083,MATH 193A,A04,083782,Staff,0,1,30,30
1650233892107,MATH 197,001,091859,McAuley; Julian John,9998,0,9999,1
1650233898168,COGS 9,A01,083615,Staff,0,14,60,60
1650233904195,COGS 11,A01,083617,Boyle; Mary E. T.,24,0,40,16
1650233910222,COGS 13,A01,083071,Staff,0,30,40,40
1650233916247,COGS 14A,A01,092681,Staff,1,12,100,99
1650233922270,COGS 14B,A01,083073,Cheng; Tzu-Han,0,7,50,50
1650233928294,COGS 17,A01,092677,Staff,33,0,75,42
1650233934329,COGS 100,A01,083619,Staff,1,21,60,59
1650233940359,COGS 101A,A01,083621,Davis; Joshua Daniel,0,21,60,60
1650233946386,COGS 101B,A01,091572,Staff,6,0,60,54
1650233952412,COGS 101C,A01,083625,Delgado; Tania,20,0,30,10
1650233958439,COGS 107A,A01,083627,Boyle; Mary E. T.,1,7,60,59
1650233964464,COGS 118A,A01,083075,Staff,15,0,60,45
1650233970487,CSE 3,A50,083646,Miranda; Gregory Joseph,22,0,38,16
1650233970487,CSE 3,A51,083647,Miranda; Gregory Joseph,37,0,37,0
1650233976513,CSE 8A,A50,083650,Miranda; Gregory Joseph,0,18,40,40
1650233982538,CSE 11,A01,083080,Cao; Yingjun,0,68,40,40
1650233988569,CSE 12,A01,083652,Staff,0,9,100,100
1650233994591,CSE 15L,A01,083654,Staff,0,1,50,50
1650233994591,CSE 15L,A02,083655,Staff,5,0,50,45
1650234000615,CSE 20,A01,083657,Staff,53,0,80,27
1650234006641,CSE 30,A01,083084,Eldon; John,0,70,40,40
1650234012665,CSE 100,A01,083659,Cao; Yingjun,0,63,50,50
1650234018687,CSE 134B,A01,083661,Powell; Thomas Allan,0,27,65,65
1650234024715,CSE 140,A01,083663,Staff,1,0,75,74
1650234030737,CSE 140L,A01,083088,Eldon; John,0,4,75,75
1650234036767,CSE 175,A01,083665,Kumar; Rakesh,8,0,25,17
1650234042793,CSE 190,A00,092507,Dubnov; Shlomo,14,0,20,6
1650234048821,ECE 45,A01,083139,Staff,0,13,40,40
1650234054842,ECE 65,A50,083695,Staff,0,5,30,30
1650234060868,ECE 109,A01,091882,Touri; Behrouz,47,0,70,23
1650234066895,ECE 180,A00,083140,Abi Samra; Nicholas Camill,24,0,30,6
1650234066895,ECE 180,B00,083141,Abi Samra; Nicholas Camill,8,0,30,22
1650234072922,MATH 10A,A01,083735,Patchell; Gregory David,11,0,30,19
1650234072922,MATH 10A,A02,083736,Patchell; Gregory David,28,0,30,2
1650234072922,MATH 10A,A03,083737,Patchell; Gregory David,26,0,30,4
1650234078947,MATH 10B,A01,083207,Staff,0,6,30,30
1650234078947,MATH 10B,A02,083208,Staff,0,5,30,30
1650234078947,MATH 10B,B01,083739,Staff,17,0,30,13
1650234078947,MATH 10B,B02,083740,Staff,29,0,30,1
1650234084972,MATH 18,A01,083743,Staff,8,0,30,22
1650234084972,MATH 18,A02,083744,Staff,28,0,30,2
1650234084972,MATH 18,A03,083745,Staff,23,0,30,7
1650234084972,MATH 18,A04,083746,Staff,27,0,30,3
1650234084972,MATH 18,B01,083748,Staff,0,10,30,30
1650234084972,MATH 18,B02,083749,Staff,0,7,30,30
1650234084972,MATH 18,B03,083750,Staff,0,7,30,30
1650234084972,MATH 18,B04,083751,Staff,0,8,30,30
1650234090996,MATH 20A,A01,083754,Staff,26,0,40,14
1650234097027,MATH 20B,A01,083756,Staff,1,6,30,29
1650234097027,MATH 20B,A02,083757,Staff,0,6,30,30
1650234103066,MATH 20C,A01,083760,Staff,0,12,30,30
1650234103066,MATH 20C,A02,083761,Staff,0,12,30,30
1650234103066,MATH 20C,B01,083762,Staff,14,0,30,16
1650234103066,MATH 20C,B02,083763,Staff,28,0,30,2
1650234109094,MATH 20D,A01,083765,Staff,1,2,30,29
1650234109094,MATH 20D,A02,083766,Staff,10,0,30,20
1650234109094,MATH 20D,A03,083767,Staff,28,0,30,2
1650234115116,MATH 20E,A01,083771,Staff,8,0,30,22
1650234115116,MATH 20E,A02,083772,Staff,21,0,30,9
1650234115116,MATH 20E,B01,083773,Staff,0,0,30,30
1650234115116,MATH 20E,B02,083774,Staff,12,0,30,18
1650234121141,MATH 103A,A01,083777,Staff,0,9,30,30
1650234121141,MATH 103A,A02,083778,Staff,0,10,30,30
1650234121141,MATH 103A,B01,083779,Staff,0,9,30,30
1650234121141,MATH 103A,B02,083780,Staff,0,9,30,30
1650234127168,MATH 105,A01,085443,Staff,0,17,30,30
1650234133199,MATH 109,A01,083213,Anzaldo; Leesa B,0,3,30,30
1650234133199,MATH 109,A02,083214,Anzaldo; Leesa B,0,6,30,30
1650234133199,MATH 109,B01,083215,Anzaldo; Leesa B,0,4,30,30
1650234133199,MATH 109,B02,083216,Anzaldo; Leesa B,1,4,30,29
1650234139231,MATH 142A,A01,083219,Chow; Bennett,0,12,30,30
1650234139231,MATH 142A,A02,083220,Chow; Bennett,0,11,30,30
1650234139231,MATH 142A,B01,083221,Chow; Bennett,0,11,30,30
1650234139231,MATH 142A,B02,083222,Chow; Bennett,0,12,30,30
1650234145257,MATH 193A,A01,083224,Staff,0,5,30,30
1650234145257,MATH 193A,A02,083225,Staff,0,4,30,30
1650234145257,MATH 193A,A03,083781,Staff,0,2,30,30
1650234145257,MATH 193A,A04,083782,Staff,0,1,30,30
1650234151279,MATH 197,001,091859,McAuley; Julian John,9998,0,9999,1
1650234157332,COGS 9,A01,083615,Staff,0,14,60,60
1650234163356,COGS 11,A01,083617,Boyle; Mary E. T.,24,0,40,16
1650234169383,COGS 13,A01,083071,Staff,0,30,40,40
1650234175404,COGS 14A,A01,092681,Staff,1,12,100,99
1650234181426,COGS 14B,A01,083073,Cheng; Tzu-Han,0,7,50,50
1650234187450,COGS 17,A01,092677,Staff,33,0,75,42
1650234193472,COGS 100,A01,083619,Staff,1,21,60,59
1650234199502,COGS 101A,A01,083621,Davis; Joshua Daniel,0,21,60,60
1650234205524,COGS 101B,A01,091572,Staff,6,0,60,54
1650234211550,COGS 101C,A01,083625,Delgado; Tania,20,0,30,10
1650234217577,COGS 107A,A01,083627,Boyle; Mary E. T.,1,7,60,59
1650234223604,COGS 118A,A01,083075,Staff,15,0,60,45
1650234229628,CSE 3,A50,083646,Miranda; Gregory Joseph,22,0,38,16
1650234229628,CSE 3,A51,083647,Miranda; Gregory Joseph,37,0,37,0
1650234235666,CSE 8A,A50,083650,Miranda; Gregory Joseph,0,18,40,40
1650234241692,CSE 11,A01,083080,Cao; Yingjun,0,68,40,40
1650234247715,CSE 12,A01,083652,Staff,0,9,100,100
1650234253740,CSE 15L,A01,083654,Staff,0,1,50,50
1650234253740,CSE 15L,A02,083655,Staff,5,0,50,45
1650234259767,CSE 20,A01,083657,Staff,53,0,80,27
1650234265793,CSE 30,A01,083084,Eldon; John,0,70,40,40
1650234271816,CSE 100,A01,083659,Cao; Yingjun,0,63,50,50
1650234277839,CSE 134B,A01,083661,Powell; Thomas Allan,0,27,65,65
1650234283865,CSE 140,A01,083663,Staff,1,0,75,74
1650234289891,CSE 140L,A01,083088,Eldon; John,0,4,75,75
1650234295920,CSE 175,A01,083665,Kumar; Rakesh,8,0,25,17
1650234301947,CSE 190,A00,092507,Dubnov; Shlomo,14,0,20,6
1650234307973,ECE 45,A01,083139,Staff,0,13,40,40
1650234313996,ECE 65,A50,083695,Staff,0,5,30,30
1650234320020,ECE 109,A01,091882,Touri; Behrouz,47,0,70,23
1650234326044,ECE 180,A00,083140,Abi Samra; Nicholas Camill,24,0,30,6
1650234326044,ECE 180,B00,083141,Abi Samra; Nicholas Camill,8,0,30,22
1650234332067,MATH 10A,A01,083735,Patchell; Gregory David,11,0,30,19
1650234332067,MATH 10A,A02,083736,Patchell; Gregory David,28,0,30,2
1650234332067,MATH 10A,A03,083737,Patchell; Gregory David,26,0,30,4
1650234338091,MATH 10B,A01,083207,Staff,0,6,30,30
1650234338091,MATH 10B,A02,083208,Staff,0,5,30,30
1650234338091,MATH 10B,B01,083739,Staff,17,0,30,13
1650234338091,MATH 10B,B02,083740,Staff,29,0,30,1
1650234344191,MATH 18,A01,083743,Staff,7,0,30,23
1650234344191,MATH 18,A02,083744,Staff,28,0,30,2
1650234344191,MATH 18,A03,083745,Staff,23,0,30,7
1650234344191,MATH 18,A04,083746,Staff,27,0,30,3
1650234344191,MATH 18,B01,083748,Staff,0,10,30,30
1650234344191,MATH 18,B02,083749,Staff,0,7,30,30
1650234344191,MATH 18,B03,083750,Staff,0,7,30,30
1650234344191,MATH 18,B04,083751,Staff,0,8,30,30
1650234350213,MATH 20A,A01,083754,Staff,26,0,40,14
1650234356238,MATH 20B,A01,083756,Staff,1,6,30,29
1650234356238,MATH 20B,A02,083757,Staff,0,6,30,30
1650234362265,MATH 20C,A01,083760,Staff,0,12,30,30
1650234362265,MATH 20C,A02,083761,Staff,0,12,30,30
1650234362265,MATH 20C,B01,083762,Staff,14,0,30,16
1650234362265,MATH 20C,B02,083763,Staff,28,0,30,2
1650234368292,MATH 20D,A01,083765,Staff,1,2,30,29
1650234368292,MATH 20D,A02,083766,Staff,10,0,30,20
1650234368292,MATH 20D,A03,083767,Staff,28,0,30,2
1650234374316,MATH 20E,A01,083771,Staff,8,0,30,22
1650234374316,MATH 20E,A02,083772,Staff,21,0,30,9
1650234374316,MATH 20E,B01,083773,Staff,0,0,30,30
1650234374316,MATH 20E,B02,083774,Staff,12,0,30,18
1650234380351,MATH 103A,A01,083777,Staff,0,9,30,30
1650234380351,MATH 103A,A02,083778,Staff,0,10,30,30
1650234380351,MATH 103A,B01,083779,Staff,0,9,30,30
1650234380351,MATH 103A,B02,083780,Staff,0,9,30,30
1650234386382,MATH 105,A01,085443,Staff,0,17,30,30
1650234392406,MATH 109,A01,083213,Anzaldo; Leesa B,0,3,30,30
1650234392406,MATH 109,A02,083214,Anzaldo; Leesa B,0,6,30,30
1650234392406,MATH 109,B01,083215,Anzaldo; Leesa B,0,4,30,30
1650234392406,MATH 109,B02,083216,Anzaldo; Leesa B,1,4,30,29
1650234398433,MATH 142A,A01,083219,Chow; Bennett,0,12,30,30
1650234398433,MATH 142A,A02,083220,Chow; Bennett,0,11,30,30
1650234398433,MATH 142A,B01,083221,Chow; Bennett,0,11,30,30
1650234398433,MATH 142A,B02,083222,Chow; Bennett,0,12,30,30
1650234404462,MATH 193A,A01,083224,Staff,0,5,30,30
1650234404462,MATH 193A,A02,083225,Staff,0,4,30,30
1650234404462,MATH 193A,A03,083781,Staff,0,2,30,30
1650234404462,MATH 193A,A04,083782,Staff,0,1,30,30
1650234410487,MATH 197,001,091859,McAuley; Julian John,9998,0,9999,1
1650234416537,COGS 9,A01,083615,Staff,0,14,60,60
1650234422565,COGS 11,A01,083617,Boyle; Mary E. T.,24,0,40,16
1650234428592,COGS 13,A01,083071,Staff,0,30,40,40
1650234434615,COGS 14A,A01,092681,Staff,1,12,100,99
1650234440641,COGS 14B,A01,083073,Cheng; Tzu-Han,0,7,50,50
1650234446667,COGS 17,A01,092677,Staff,33,0,75,42
1650234452696,COGS 100,A01,083619,Staff,1,21,60,59
1650234458719,COGS 101A,A01,083621,Davis; Joshua Daniel,0,21,60,60
1650234464741,COGS 101B,A01,091572,Staff,6,0,60,54
1650234470765,COGS 101C,A01,083625,Delgado; Tania,20,0,30,10
1650234476788,COGS 107A,A01,083627,Boyle; Mary E. T.,1,7,60,59
1650234482812,COGS 118A,A01,083075,Staff,15,0,60,45
1650234488835,CSE 3,A50,083646,Miranda; Gregory Joseph,22,0,38,16
1650234488835,CSE 3,A51,083647,Miranda; Gregory Joseph,37,0,37,0
1650234494863,CSE 8A,A50,083650,Miranda; Gregory Joseph,0,18,40,40
1650234500885,CSE 11,A01,083080,Cao; Yingjun,0,68,40,40
1650234506913,CSE 12,A01,083652,Staff,0,9,100,100
1650234512935,CSE 15L,A01,083654,Staff,0,1,50,50
1650234512935,CSE 15L,A02,083655,Staff,5,0,50,45
1650234518959,CSE 20,A01,083657,Staff,53,0,80,27
1650234524985,CSE 30,A01,083084,Eldon; John,0,70,40,40
1650234531011,CSE 100,A01,083659,Cao; Yingjun,0,63,50,50
1650234537038,CSE 134B,A01,083661,Powell; Thomas Allan,0,27,65,65
1650234543061,CSE 140,A01,083663,Staff,1,0,75,74
1650234549084,CSE 140L,A01,083088,Eldon; John,0,4,75,75
1650234555111,CSE 175,A01,083665,Kumar; Rakesh,8,0,25,17
1650234561134,CSE 190,A00,092507,Dubnov; Shlomo,14,0,20,6
1650234567158,ECE 45,A01,083139,Staff,0,13,40,40
1650234573180,ECE 65,A50,083695,Staff,0,5,30,30
1650234579205,ECE 109,A01,091882,Touri; Behrouz,47,0,70,23
1650234585227,ECE 180,A00,083140,Abi Samra; Nicholas Camill,24,0,30,6
1650234585227,ECE 180,B00,083141,Abi Samra; Nicholas Camill,8,0,30,22
1650234591250,MATH 10A,A01,083735,Patchell; Gregory David,11,0,30,19
1650234591250,MATH 10A,A02,083736,Patchell; Gregory David,28,0,30,2
1650234591250,MATH 10A,A03,083737,Patchell; Gregory David,26,0,30,4
1650234597279,MATH 10B,A01,083207,Staff,0,6,30,30
1650234597279,MATH 10B,A02,083208,Staff,0,5,30,30
1650234597279,MATH 10B,B01,083739,Staff,17,0,30,13
1650234597279,MATH 10B,B02,083740,Staff,29,0,30,1
1650234603311,MATH 18,A01,083743,Staff,7,0,30,23
1650234603311,MATH 18,A02,083744,Staff,28,0,30,2
1650234603311,MATH 18,A03,083745,Staff,23,0,30,7
1650234603311,MATH 18,A04,083746,Staff,27,0,30,3
1650234603311,MATH 18,B01,083748,Staff,0,10,30,30
1650234603311,MATH 18,B02,083749,Staff,0,7,30,30
1650234603311,MATH 18,B03,083750,Staff,0,7,30,30
1650234603311,MATH 18,B04,083751,Staff,0,8,30,30
1650234609336,MATH 20A,A01,083754,Staff,26,0,40,14
1650234615371,MATH 20B,A01,083756,Staff,1,6,30,29
1650234615371,MATH 20B,A02,083757,Staff,0,6,30,30
1650234621397,MATH 20C,A01,083760,Staff,0,12,30,30
1650234621397,MATH 20C,A02,083761,Staff,0,12,30,30
1650234621397,MATH 20C,B01,083762,Staff,14,0,30,16
1650234621397,MATH 20C,B02,083763,Staff,28,0,30,2
1650234627419,MATH 20D,A01,083765,Staff,1,2,30,29
1650234627419,MATH 20D,A02,083766,Staff,10,0,30,20
1650234627419,MATH 20D,A03,083767,Staff,28,0,30,2
1650234633448,MATH 20E,A01,083771,Staff,8,0,30,22
1650234633448,MATH 20E,A02,083772,Staff,21,0,30,9
1650234633448,MATH 20E,B01,083773,Staff,0,0,30,30
1650234633448,MATH 20E,B02,083774,Staff,12,0,30,18
1650234639470,MATH 103A,A01,083777,Staff,0,9,30,30
1650234639470,MATH 103A,A02,083778,Staff,0,10,30,30
1650234639470,MATH 103A,B01,083779,Staff,0,9,30,30
1650234639470,MATH 103A,B02,083780,Staff,0,9,30,30
1650234645497,MATH 105,A01,085443,Staff,0,17,30,30
1650234651524,MATH 109,A01,083213,Anzaldo; Leesa B,0,3,30,30
1650234651524,MATH 109,A02,083214,Anzaldo; Leesa B,0,6,30,30
1650234651524,MATH 109,B01,083215,Anzaldo; Leesa B,0,4,30,30
1650234651524,MATH 109,B02,083216,Anzaldo; Leesa B,1,4,30,29
1650234657550,MATH 142A,A01,083219,Chow; Bennett,0,12,30,30
1650234657550,MATH 142A,A02,083220,Chow; Bennett,0,11,30,30
1650234657550,MATH 142A,B01,083221,Chow; Bennett,0,11,30,30
1650234657550,MATH 142A,B02,083222,Chow; Bennett,0,12,30,30
1650234663573,MATH 193A,A01,083224,Staff,0,5,30,30
1650234663573,MATH 193A,A02,083225,Staff,0,4,30,30
1650234663573,MATH 193A,A03,083781,Staff,0,2,30,30
1650234663573,MATH 193A,A04,083782,Staff,0,1,30,30
1650234669594,MATH 197,001,091859,McAuley; Julian John,9998,0,9999,1
1650234675645,COGS 9,A01,083615,Staff,0,14,60,60
1650234681667,COGS 11,A01,083617,Boyle; Mary E. T.,24,0,40,16
1650234687691,COGS 13,A01,083071,Staff,0,30,40,40
1650234693713,COGS 14A,A01,092681,Staff,1,12,100,99
1650234699742,COGS 14B,A01,083073,Cheng; Tzu-Han,0,7,50,50
1650234705767,COGS 17,A01,092677,Staff,33,0,75,42
1650234711791,COGS 100,A01,083619,Staff,1,21,60,59
1650234717816,COGS 101A,A01,083621,Davis; Joshua Daniel,0,21,60,60
1650234723839,COGS 101B,A01,091572,Staff,6,0,60,54
1650234729865,COGS 101C,A01,083625,Delgado; Tania,20,0,30,10
1650234735890,COGS 107A,A01,083627,Boyle; Mary E. T.,1,7,60,59
1650234741930,COGS 118A,A01,083075,Staff,15,0,60,45
1650234747959,CSE 3,A50,083646,Miranda; Gregory Joseph,22,0,38,16
1650234747959,CSE 3,A51,083647,Miranda; Gregory Joseph,37,0,37,0
1650234753984,CSE 8A,A50,083650,Miranda; Gregory Joseph,0,18,40,40
1650234760009,CSE 11,A01,083080,Cao; Yingjun,0,68,40,40
1650234766032,CSE 12,A01,083652,Staff,0,9,100,100
1650234772057,CSE 15L,A01,083654,Staff,0,1,50,50
1650234772057,CSE 15L,A02,083655,Staff,5,0,50,45
1650234778084,CSE 20,A01,083657,Staff,53,0,80,27
1650234784108,CSE 30,A01,083084,Eldon; John,0,70,40,40
1650234790130,CSE 100,A01,083659,Cao; Yingjun,0,63,50,50
1650234796152,CSE 134B,A01,083661,Powell; Thomas Allan,0,27,65,65
1650234802186,CSE 140,A01,083663,Staff,1,0,75,74
1650234808209,CSE 140L,A01,083088,Eldon; John,0,4,75,75
1650234814233,CSE 175,A01,083665,Kumar; Rakesh,8,0,25,17
1650234820259,CSE 190,A00,092507,Dubnov; Shlomo,14,0,20,6
1650234826281,ECE 45,A01,083139,Staff,0,13,40,40
1650234832305,ECE 65,A50,083695,Staff,0,5,30,30
1650234838330,ECE 109,A01,091882,Touri; Behrouz,47,0,70,23
1650234844356,ECE 180,A00,083140,Abi Samra; Nicholas Camill,24,0,30,6
1650234844356,ECE 180,B00,083141,Abi Samra; Nicholas Camill,8,0,30,22
1650234850379,MATH 10A,A01,083735,Patchell; Gregory David,11,0,30,19
1650234850379,MATH 10A,A02,083736,Patchell; Gregory David,28,0,30,2
1650234850379,MATH 10A,A03,083737,Patchell; Gregory David,26,0,30,4
1650234856405,MATH 10B,A01,083207,Staff,0,6,30,30
1650234856405,MATH 10B,A02,083208,Staff,0,5,30,30
1650234856405,MATH 10B,B01,083739,Staff,17,0,30,13
1650234856405,MATH 10B,B02,083740,Staff,29,0,30,1
1650234862434,MATH 18,A01,083743,Staff,7,0,30,23
1650234862434,MATH 18,A02,083744,Staff,28,0,30,2
1650234862434,MATH 18,A03,083745,Staff,23,0,30,7
1650234862434,MATH 18,A04,083746,Staff,27,0,30,3
1650234862434,MATH 18,B01,083748,Staff,0,10,30,30
1650234862434,MATH 18,B02,083749,Staff,0,7,30,30
1650234862434,MATH 18,B03,083750,Staff,0,7,30,30
1650234862434,MATH 18,B04,083751,Staff,0,8,30,30
1650234868459,MATH 20A,A01,083754,Staff,26,0,40,14
1650234874482,MATH 20B,A01,083756,Staff,1,6,30,29
1650234874482,MATH 20B,A02,083757,Staff,0,6,30,30
1650234880504,MATH 20C,A01,083760,Staff,0,12,30,30
1650234880504,MATH 20C,A02,083761,Staff,0,13,30,30
1650234880504,MATH 20C,B01,083762,Staff,14,0,30,16
1650234880504,MATH 20C,B02,083763,Staff,28,0,30,2
1650234886527,MATH 20D,A01,083765,Staff,1,2,30,29
1650234886527,MATH 20D,A02,083766,Staff,10,0,30,20
1650234886527,MATH 20D,A03,083767,Staff,28,0,30,2
1650234892550,MATH 20E,A01,083771,Staff,8,0,30,22
1650234892550,MATH 20E,A02,083772,Staff,21,0,30,9
1650234892550,MATH 20E,B01,083773,Staff,0,0,30,30
1650234892550,MATH 20E,B02,083774,Staff,12,0,30,18
1650234898573,MATH 103A,A01,083777,Staff,0,9,30,30
1650234898573,MATH 103A,A02,083778,Staff,0,10,30,30
1650234898573,MATH 103A,B01,083779,Staff,0,9,30,30
1650234898573,MATH 103A,B02,083780,Staff,0,9,30,30
1650234904598,MATH 105,A01,085443,Staff,0,17,30,30
1650234910625,MATH 109,A01,083213,Anzaldo; Leesa B,0,3,30,30
1650234910625,MATH 109,A02,083214,Anzaldo; Leesa B,0,6,30,30
1650234910625,MATH 109,B01,083215,Anzaldo; Leesa B,0,4,30,30
1650234910625,MATH 109,B02,083216,Anzaldo; Leesa B,1,4,30,29
1650234916653,MATH 142A,A01,083219,Chow; Bennett,0,12,30,30
1650234916653,MATH 142A,A02,083220,Chow; Bennett,0,11,30,30
1650234916653,MATH 142A,B01,083221,Chow; Bennett,0,11,30,30
1650234916653,MATH 142A,B02,083222,Chow; Bennett,0,12,30,30
1650234922689,MATH 193A,A01,083224,Staff,0,5,30,30
1650234922689,MATH 193A,A02,083225,Staff,0,4,30,30
1650234922689,MATH 193A,A03,083781,Staff,0,2,30,30
1650234922689,MATH 193A,A04,083782,Staff,0,1,30,30
1650234928713,MATH 197,001,091859,McAuley; Julian John,9998,0,9999,1
1650234934948,COGS 9,A01,083615,Staff,0,14,60,60
1650234940971,COGS 11,A01,083617,Boyle; Mary E. T.,24,0,40,16
1650234946996,COGS 13,A01,083071,Staff,0,30,40,40
1650234953029,COGS 14A,A01,092681,Staff,1,12,100,99
1650234959051,COGS 14B,A01,083073,Cheng; Tzu-Han,0,7,50,50
1650234965073,COGS 17,A01,092677,Staff,33,0,75,42
1650234971107,COGS 100,A01,083619,Staff,1,21,60,59
1650234977130,COGS 101A,A01,083621,Davis; Joshua Daniel,0,21,60,60
1650234983156,COGS 101B,A01,091572,Staff,6,0,60,54
1650234989180,COGS 101C,A01,083625,Delgado; Tania,20,0,30,10
1650234995201,COGS 107A,A01,083627,Boyle; Mary E. T.,1,7,60,59
1650235001223,COGS 118A,A01,083075,Staff,15,0,60,45
1650235007254,CSE 3,A50,083646,Miranda; Gregory Joseph,22,0,38,16
1650235007254,CSE 3,A51,083647,Miranda; Gregory Joseph,37,0,37,0
1650235013281,CSE 8A,A50,083650,Miranda; Gregory Joseph,0,18,40,40
1650235019304,CSE 11,A01,083080,Cao; Yingjun,0,68,40,40
1650235025336,CSE 12,A01,083652,Staff,0,9,100,100
1650235031359,CSE 15L,A01,083654,Staff,0,1,50,50
1650235031359,CSE 15L,A02,083655,Staff,5,0,50,45
1650235037385,CSE 20,A01,083657,Staff,53,0,80,27
1650235043412,CSE 30,A01,083084,Eldon; John,0,70,40,40
1650235049435,CSE 100,A01,083659,Cao; Yingjun,0,63,50,50
1650235055458,CSE 134B,A01,083661,Powell; Thomas Allan,0,27,65,65
1650235061483,CSE 140,A01,083663,Staff,1,0,75,74
1650235067514,CSE 140L,A01,083088,Eldon; John,0,4,75,75
1650235073538,CSE 175,A01,083665,Kumar; Rakesh,8,0,25,17
1650235079561,CSE 190,A00,092507,Dubnov; Shlomo,14,0,20,6
1650235085588,ECE 45,A01,083139,Staff,0,13,40,40
1650235091611,ECE 65,A50,083695,Staff,0,5,30,30
1650235097635,ECE 109,A01,091882,Touri; Behrouz,47,0,70,23
1650235103658,ECE 180,A00,083140,Abi Samra; Nicholas Camill,24,0,30,6
1650235103658,ECE 180,B00,083141,Abi Samra; Nicholas Camill,8,0,30,22
1650235109684,MATH 10A,A01,083735,Patchell; Gregory David,11,0,30,19
1650235109684,MATH 10A,A02,083736,Patchell; Gregory David,28,0,30,2
1650235109684,MATH 10A,A03,083737,Patchell; Gregory David,26,0,30,4
1650235115712,MATH 10B,A01,083207,Staff,0,6,30,30
1650235115712,MATH 10B,A02,083208,Staff,0,5,30,30
1650235115712,MATH 10B,B01,083739,Staff,17,0,30,13
1650235115712,MATH 10B,B02,083740,Staff,29,0,30,1
1650235121738,MATH 18,A01,083743,Staff,7,0,30,23
1650235121738,MATH 18,A02,083744,Staff,28,0,30,2
1650235121738,MATH 18,A03,083745,Staff,23,0,30,7
1650235121738,MATH 18,A04,083746,Staff,27,0,30,3
1650235121738,MATH 18,B01,083748,Staff,0,10,30,30
1650235121738,MATH 18,B02,083749,Staff,0,7,30,30
1650235121738,MATH 18,B03,083750,Staff,0,7,30,30
1650235121738,MATH 18,B04,083751,Staff,0,8,30,30
1650235127763,MATH 20A,A01,083754,Staff,26,0,40,14
1650235133790,MATH 20B,A01,083756,Staff,1,6,30,29
1650235133790,MATH 20B,A02,083757,Staff,0,6,30,30
1650235139824,MATH 20C,A01,083760,Staff,0,12,30,30
1650235139824,MATH 20C,A02,083761,Staff,0,13,30,30
1650235139824,MATH 20C,B01,083762,Staff,14,0,30,16
1650235139824,MATH 20C,B02,083763,Staff,28,0,30,2
1650235145846,MATH 20D,A01,083765,Staff,1,2,30,29
1650235145846,MATH 20D,A02,083766,Staff,10,0,30,20
1650235145846,MATH 20D,A03,083767,Staff,28,0,30,2
1650235151872,MATH 20E,A01,083771,Staff,8,0,30,22
1650235151872,MATH 20E,A02,083772,Staff,21,0,30,9
1650235151872,MATH 20E,B01,083773,Staff,0,0,30,30
1650235151872,MATH 20E,B02,083774,Staff,12,0,30,18
1650235157908,MATH 103A,A01,083777,Staff,0,9,30,30
1650235157908,MATH 103A,A02,083778,Staff,0,10,30,30
1650235157908,MATH 103A,B01,083779,Staff,0,9,30,30
1650235157908,MATH 103A,B02,083780,Staff,0,9,30,30
1650235163933,MATH 105,A01,085443,Staff,0,17,30,30
1650235169957,MATH 109,A01,083213,Anzaldo; Leesa B,0,3,30,30
1650235169957,MATH 109,A02,083214,Anzaldo; Leesa B,0,6,30,30
1650235169957,MATH 109,B01,083215,Anzaldo; Leesa B,0,4,30,30
1650235169957,MATH 109,B02,083216,Anzaldo; Leesa B,1,4,30,29
1650235175981,MATH 142A,A01,083219,Chow; Bennett,0,12,30,30
1650235175981,MATH 142A,A02,083220,Chow; Bennett,0,11,30,30
1650235175981,MATH 142A,B01,083221,Chow; Bennett,0,11,30,30
1650235175981,MATH 142A,B02,083222,Chow; Bennett,0,12,30,30
1650235182007,MATH 193A,A01,083224,Staff,0,5,30,30
1650235182007,MATH 193A,A02,083225,Staff,0,4,30,30
1650235182007,MATH 193A,A03,083781,Staff,0,2,30,30
1650235182007,MATH 193A,A04,083782,Staff,0,1,30,30
1650235188033,MATH 197,001,091859,McAuley; Julian John,9998,0,9999,1
1650235194085,COGS 9,A01,083615,Staff,0,14,60,60
1650235200109,COGS 11,A01,083617,Boyle; Mary E. T.,24,0,40,16
1650235206135,COGS 13,A01,083071,Staff,0,30,40,40
1650235212162,COGS 14A,A01,092681,Staff,1,12,100,99
1650235218189,COGS 14B,A01,083073,Cheng; Tzu-Han,0,7,50,50
1650235224211,COGS 17,A01,092677,Staff,33,0,75,42
1650235230245,COGS 100,A01,083619,Staff,1,21,60,59
1650235236269,COGS 101A,A01,083621,Davis; Joshua Daniel,0,21,60,60
1650235242293,COGS 101B,A01,091572,Staff,6,0,60,54
1650235248316,COGS 101C,A01,083625,Delgado; Tania,20,0,30,10
1650235254340,COGS 107A,A01,083627,Boyle; Mary E. T.,1,7,60,59
1650235260374,COGS 118A,A01,083075,Staff,15,0,60,45
1650235266396,CSE 3,A50,083646,Miranda; Gregory Joseph,22,0,38,16
1650235266396,CSE 3,A51,083647,Miranda; Gregory Joseph,37,0,37,0
1650235272424,CSE 8A,A50,083650,Miranda; Gregory Joseph,0,18,40,40
1650235278450,CSE 11,A01,083080,Cao; Yingjun,0,68,40,40
1650235284474,CSE 12,A01,083652,Staff,0,9,100,100
1650235290498,CSE 15L,A01,083654,Staff,0,1,50,50
1650235290498,CSE 15L,A02,083655,Staff,5,0,50,45
1650235296522,CSE 20,A01,083657,Staff,53,0,80,27
1650235302543,CSE 30,A01,083084,Eldon; John,0,70,40,40
1650235308566,CSE 100,A01,083659,Cao; Yingjun,0,63,50,50
1650235314589,CSE 134B,A01,083661,Powell; Thomas Allan,0,27,65,65
1650235320617,CSE 140,A01,083663,Staff,1,0,75,74
1650235326645,CSE 140L,A01,083088,Eldon; John,0,4,75,75
1650235332669,CSE 175,A01,083665,Kumar; Rakesh,8,0,25,17
1650235338692,CSE 190,A00,092507,Dubnov; Shlomo,14,0,20,6
1650235344717,ECE 45,A01,083139,Staff,0,13,40,40
1650235350741,ECE 65,A50,083695,Staff,0,5,30,30
1650235356767,ECE 109,A01,091882,Touri; Behrouz,47,0,70,23
1650235362791,ECE 180,A00,083140,Abi Samra; Nicholas Camill,24,0,30,6
1650235362791,ECE 180,B00,083141,Abi Samra; Nicholas Camill,8,0,30,22
1650235368814,MATH 10A,A01,083735,Patchell; Gregory David,11,0,30,19
1650235368814,MATH 10A,A02,083736,Patchell; Gregory David,28,0,30,2
1650235368814,MATH 10A,A03,083737,Patchell; Gregory David,26,0,30,4
1650235374838,MATH 10B,A01,083207,Staff,0,6,30,30
1650235374838,MATH 10B,A02,083208,Staff,0,5,30,30
1650235374838,MATH 10B,B01,083739,Staff,17,0,30,13
1650235374838,MATH 10B,B02,083740,Staff,29,0,30,1
1650235380863,MATH 18,A01,083743,Staff,7,0,30,23
1650235380863,MATH 18,A02,083744,Staff,28,0,30,2
1650235380863,MATH 18,A03,083745,Staff,23,0,30,7
1650235380863,MATH 18,A04,083746,Staff,27,0,30,3
1650235380863,MATH 18,B01,083748,Staff,0,10,30,30
1650235380863,MATH 18,B02,083749,Staff,0,7,30,30
1650235380863,MATH 18,B03,083750,Staff,0,7,30,30
1650235380863,MATH 18,B04,083751,Staff,0,8,30,30
1650235386888,MATH 20A,A01,083754,Staff,26,0,40,14
1650235392912,MATH 20B,A01,083756,Staff,1,6,30,29
1650235392912,MATH 20B,A02,083757,Staff,0,6,30,30
1650235398939,MATH 20C,A01,083760,Staff,0,12,30,30
1650235398939,MATH 20C,A02,083761,Staff,0,13,30,30
1650235398939,MATH 20C,B01,083762,Staff,14,0,30,16
1650235398939,MATH 20C,B02,083763,Staff,28,0,30,2
1650235404962,MATH 20D,A01,083765,Staff,1,2,30,29
1650235404962,MATH 20D,A02,083766,Staff,9,0,30,21
1650235404962,MATH 20D,A03,083767,Staff,28,0,30,2
1650235410985,MATH 20E,A01,083771,Staff,8,0,30,22
1650235410985,MATH 20E,A02,083772,Staff,21,0,30,9
1650235410985,MATH 20E,B01,083773,Staff,0,0,30,30
1650235410985,MATH 20E,B02,083774,Staff,12,0,30,18
1650235417013,MATH 103A,A01,083777,Staff,0,9,30,30
1650235417013,MATH 103A,A02,083778,Staff,0,10,30,30
1650235417013,MATH 103A,B01,083779,Staff,0,9,30,30
1650235417013,MATH 103A,B02,083780,Staff,0,9,30,30
1650235423036,MATH 105,A01,085443,Staff,0,17,30,30
1650235429059,MATH 109,A01,083213,Anzaldo; Leesa B,0,3,30,30
1650235429059,MATH 109,A02,083214,Anzaldo; Leesa B,0,6,30,30
1650235429059,MATH 109,B01,083215,Anzaldo; Leesa B,0,4,30,30
1650235429059,MATH 109,B02,083216,Anzaldo; Leesa B,1,4,30,29
1650235435086,MATH 142A,A01,083219,Chow; Bennett,0,12,30,30
1650235435086,MATH 142A,A02,083220,Chow; Bennett,0,11,30,30
1650235435086,MATH 142A,B01,083221,Chow; Bennett,0,11,30,30
1650235435086,MATH 142A,B02,083222,Chow; Bennett,0,12,30,30
1650235457479,MATH 193A,A01,083224,Staff,0,5,30,30
1650235457479,MATH 193A,A02,083225,Staff,0,4,30,30
1650235457479,MATH 193A,A03,083781,Staff,0,2,30,30
1650235457479,MATH 193A,A04,083782,Staff,0,1,30,30
1650235463505,MATH 197,001,091859,McAuley; Julian John,9998,0,9999,1
1650235469559,COGS 9,A01,083615,Staff,0,14,60,60
1650235475582,COGS 11,A01,083617,Boyle; Mary E. T.,24,0,40,16
1650235481633,COGS 13,A01,083071,Staff,0,30,40,40
1650235487659,COGS 14A,A01,092681,Staff,1,12,100,99
1650235493682,COGS 14B,A01,083073,Cheng; Tzu-Han,0,7,50,50
1650235499711,COGS 17,A01,092677,Staff,33,0,75,42
1650235505740,COGS 100,A01,083619,Staff,1,21,60,59
1650235511766,COGS 101A,A01,083621,Davis; Joshua Daniel,0,21,60,60
1650235517789,COGS 101B,A01,091572,Staff,6,0,60,54
1650235523815,COGS 101C,A01,083625,Delgado; Tania,20,0,30,10
1650235529839,COGS 107A,A01,083627,Boyle; Mary E. T.,1,7,60,59
1650235535865,COGS 118A,A01,083075,Staff,15,0,60,45
1650235541891,CSE 3,A50,083646,Miranda; Gregory Joseph,22,0,38,16
1650235541891,CSE 3,A51,083647,Miranda; Gregory Joseph,37,0,37,0
1650235547982,CSE 8A,A50,083650,Miranda; Gregory Joseph,0,18,40,40
1650235554006,CSE 11,A01,083080,Cao; Yingjun,0,68,40,40
1650235560031,CSE 12,A01,083652,Staff,0,9,100,100
1650235566057,CSE 15L,A01,083654,Staff,0,1,50,50
1650235566057,CSE 15L,A02,083655,Staff,5,0,50,45
1650235572082,CSE 20,A01,083657,Staff,53,0,80,27
1650235578108,CSE 30,A01,083084,Eldon; John,0,70,40,40
1650235584134,CSE 100,A01,083659,Cao; Yingjun,0,63,50,50
1650235590159,CSE 134B,A01,083661,Powell; Thomas Allan,0,27,65,65
1650235596184,CSE 140,A01,083663,Staff,1,0,75,74
1650235602208,CSE 140L,A01,083088,Eldon; John,0,4,75,75
1650235608230,CSE 175,A01,083665,Kumar; Rakesh,8,0,25,17
1650235614254,CSE 190,A00,092507,Dubnov; Shlomo,14,0,20,6
1650235620280,ECE 45,A01,083139,Staff,0,13,40,40
1650235626307,ECE 65,A50,083695,Staff,0,5,30,30
1650235632331,ECE 109,A01,091882,Touri; Behrouz,47,0,70,23
1650235638352,ECE 180,A00,083140,Abi Samra; Nicholas Camill,24,0,30,6
1650235638352,ECE 180,B00,083141,Abi Samra; Nicholas Camill,8,0,30,22
1650235644376,MATH 10A,A01,083735,Patchell; Gregory David,11,0,30,19
1650235644376,MATH 10A,A02,083736,Patchell; Gregory David,28,0,30,2
1650235644376,MATH 10A,A03,083737,Patchell; Gregory David,26,0,30,4
1650235650400,MATH 10B,A01,083207,Staff,0,6,30,30
1650235650400,MATH 10B,A02,083208,Staff,0,5,30,30
1650235650400,MATH 10B,B01,083739,Staff,17,0,30,13
1650235650400,MATH 10B,B02,083740,Staff,29,0,30,1
1650235656431,MATH 18,A01,083743,Staff,7,0,30,23
1650235656431,MATH 18,A02,083744,Staff,28,0,30,2
1650235656431,MATH 18,A03,083745,Staff,23,0,30,7
1650235656431,MATH 18,A04,083746,Staff,27,0,30,3
1650235656431,MATH 18,B01,083748,Staff,0,10,30,30
1650235656431,MATH 18,B02,083749,Staff,0,7,30,30
1650235656431,MATH 18,B03,083750,Staff,0,7,30,30
1650235656431,MATH 18,B04,083751,Staff,0,8,30,30
1650235662452,MATH 20A,A01,083754,Staff,26,0,40,14
1650235668479,MATH 20B,A01,083756,Staff,1,6,30,29
1650235668479,MATH 20B,A02,083757,Staff,0,6,30,30
1650235674504,MATH 20C,A01,083760,Staff,0,12,30,30
1650235674504,MATH 20C,A02,083761,Staff,0,13,30,30
1650235674504,MATH 20C,B01,083762,Staff,14,0,30,16
1650235674504,MATH 20C,B02,083763,Staff,28,0,30,2
1650235680531,MATH 20D,A01,083765,Staff,1,2,30,29
1650235680531,MATH 20D,A02,083766,Staff,9,0,30,21
1650235680531,MATH 20D,A03,083767,Staff,28,0,30,2
1650235686559,MATH 20E,A01,083771,Staff,8,0,30,22
1650235686559,MATH 20E,A02,083772,Staff,21,0,30,9
1650235686559,MATH 20E,B01,083773,Staff,0,0,30,30
1650235686559,MATH 20E,B02,083774,Staff,12,0,30,18
1650235692586,MATH 103A,A01,083777,Staff,0,9,30,30
1650235692586,MATH 103A,A02,083778,Staff,0,10,30,30
1650235692586,MATH 103A,B01,083779,Staff,0,9,30,30
1650235692586,MATH 103A,B02,083780,Staff,0,9,30,30
1650235698609,MATH 105,A01,085443,Staff,0,17,30,30
1650235704636,MATH 109,A01,083213,Anzaldo; Leesa B,0,3,30,30
1650235704636,MATH 109,A02,083214,Anzaldo; Leesa B,0,6,30,30
1650235704636,MATH 109,B01,083215,Anzaldo; Leesa B,0,4,30,30
1650235704636,MATH 109,B02,083216,Anzaldo; Leesa B,1,4,30,29
1650235710660,MATH 142A,A01,083219,Chow; Bennett,0,12,30,30
1650235710660,MATH 142A,A02,083220,Chow; Bennett,0,11,30,30
1650235710660,MATH 142A,B01,083221,Chow; Bennett,0,11,30,30
1650235710660,MATH 142A,B02,083222,Chow; Bennett,0,12,30,30
1650235716682,MATH 193A,A01,083224,Staff,0,5,30,30
1650235716682,MATH 193A,A02,083225,Staff,0,4,30,30
1650235716682,MATH 193A,A03,083781,Staff,0,2,30,30
1650235716682,MATH 193A,A04,083782,Staff,0,1,30,30
1650235722703,MATH 197,001,091859,McAuley; Julian John,9998,0,9999,1
1650235728759,COGS 9,A01,083615,Staff,0,14,60,60
1650235734782,COGS 11,A01,083617,Boyle; Mary E. T.,24,0,40,16
1650235740808,COGS 13,A01,083071,Staff,0,30,40,40
1650235746831,COGS 14A,A01,092681,Staff,1,12,100,99
1650235752868,COGS 14B,A01,083073,Cheng; Tzu-Han,0,7,50,50
1650235758894,COGS 17,A01,092677,Staff,33,0,75,42
1650235764921,COGS 100,A01,083619,Staff,1,21,60,59
1650235770949,COGS 101A,A01,083621,Davis; Joshua Daniel,0,21,60,60
1650235776970,COGS 101B,A01,091572,Staff,6,0,60,54
1650235783000,COGS 101C,A01,083625,Delgado; Tania,20,0,30,10
1650235789023,COGS 107A,A01,083627,Boyle; Mary E. T.,1,7,60,59
1650235795050,COGS 118A,A01,083075,Staff,15,0,60,45
1650235801073,CSE 3,A50,083646,Miranda; Gregory Joseph,22,0,38,16
1650235801073,CSE 3,A51,083647,Miranda; Gregory Joseph,37,0,37,0
1650235807097,CSE 8A,A50,083650,Miranda; Gregory Joseph,0,18,40,40
1650235813121,CSE 11,A01,083080,Cao; Yingjun,0,68,40,40
1650235819143,CSE 12,A01,083652,Staff,0,9,100,100
1650235825166,CSE 15L,A01,083654,Staff,0,1,50,50
1650235825166,CSE 15L,A02,083655,Staff,5,0,50,45
1650235831204,CSE 20,A01,083657,Staff,53,0,80,27
1650235837226,CSE 30,A01,083084,Eldon; John,0,70,40,40
1650235843249,CSE 100,A01,083659,Cao; Yingjun,0,63,50,50
1650235849280,CSE 134B,A01,083661,Powell; Thomas Allan,0,27,65,65
1650235855302,CSE 140,A01,083663,Staff,1,0,75,74
1650235861327,CSE 140L,A01,083088,Eldon; John,0,4,75,75
1650235867354,CSE 175,A01,083665,Kumar; Rakesh,8,0,25,17
1650235873376,CSE 190,A00,092507,Dubnov; Shlomo,14,0,20,6
1650235879404,ECE 45,A01,083139,Staff,0,13,40,40
1650235885428,ECE 65,A50,083695,Staff,0,5,30,30
1650235891450,ECE 109,A01,091882,Touri; Behrouz,47,0,70,23
1650235897473,ECE 180,A00,083140,Abi Samra; Nicholas Camill,24,0,30,6
1650235897473,ECE 180,B00,083141,Abi Samra; Nicholas Camill,8,0,30,22
1650235903500,MATH 10A,A01,083735,Patchell; Gregory David,11,0,30,19
1650235903500,MATH 10A,A02,083736,Patchell; Gregory David,28,0,30,2
1650235903500,MATH 10A,A03,083737,Patchell; Gregory David,26,0,30,4
1650235909523,MATH 10B,A01,083207,Staff,0,6,30,30
1650235909523,MATH 10B,A02,083208,Staff,0,5,30,30
1650235909523,MATH 10B,B01,083739,Staff,17,0,30,13
1650235909523,MATH 10B,B02,083740,Staff,29,0,30,1
1650235915548,MATH 18,A01,083743,Staff,7,0,30,23
1650235915548,MATH 18,A02,083744,Staff,28,0,30,2
1650235915548,MATH 18,A03,083745,Staff,23,0,30,7
1650235915548,MATH 18,A04,083746,Staff,27,0,30,3
1650235915548,MATH 18,B01,083748,Staff,0,10,30,30
1650235915548,MATH 18,B02,083749,Staff,0,7,30,30
1650235915548,MATH 18,B03,083750,Staff,0,7,30,30
1650235915548,MATH 18,B04,083751,Staff,0,8,30,30
1650235921575,MATH 20A,A01,083754,Staff,26,0,40,14
1650235927602,MATH 20B,A01,083756,Staff,1,6,30,29
1650235927602,MATH 20B,A02,083757,Staff,0,6,30,30
1650235933625,MATH 20C,A01,083760,Staff,0,12,30,30
1650235933625,MATH 20C,A02,083761,Staff,0,13,30,30
1650235933625,MATH 20C,B01,083762,Staff,14,0,30,16
1650235933625,MATH 20C,B02,083763,Staff,28,0,30,2
1650235939650,MATH 20D,A01,083765,Staff,1,2,30,29
1650235939650,MATH 20D,A02,083766,Staff,9,0,30,21
1650235939650,MATH 20D,A03,083767,Staff,28,0,30,2
1650235945679,MATH 20E,A01,083771,Staff,8,0,30,22
1650235945679,MATH 20E,A02,083772,Staff,21,0,30,9
1650235945679,MATH 20E,B01,083773,Staff,0,0,30,30
1650235945679,MATH 20E,B02,083774,Staff,12,0,30,18
1650235951714,MATH 103A,A01,083777,Staff,0,9,30,30
1650235951714,MATH 103A,A02,083778,Staff,0,10,30,30
1650235951714,MATH 103A,B01,083779,Staff,0,9,30,30
1650235951714,MATH 103A,B02,083780,Staff,0,9,30,30
1650235957741,MATH 105,A01,085443,Staff,0,17,30,30
1650235963764,MATH 109,A01,083213,Anzaldo; Leesa B,0,3,30,30
1650235963764,MATH 109,A02,083214,Anzaldo; Leesa B,0,6,30,30
1650235963764,MATH 109,B01,083215,Anzaldo; Leesa B,0,4,30,30
1650235963764,MATH 109,B02,083216,Anzaldo; Leesa B,1,4,30,29
1650235969791,MATH 142A,A01,083219,Chow; Bennett,0,12,30,30
1650235969791,MATH 142A,A02,083220,Chow; Bennett,0,11,30,30
1650235969791,MATH 142A,B01,083221,Chow; Bennett,0,11,30,30
1650235969791,MATH 142A,B02,083222,Chow; Bennett,0,12,30,30
1650235975815,MATH 193A,A01,083224,Staff,0,5,30,30
1650235975815,MATH 193A,A02,083225,Staff,0,4,30,30
1650235975815,MATH 193A,A03,083781,Staff,0,2,30,30
1650235975815,MATH 193A,A04,083782,Staff,0,1,30,30
1650235981840,MATH 197,001,091859,McAuley; Julian John,9998,0,9999,1
1650235987902,COGS 9,A01,083615,Staff,0,14,60,60
1650235993927,COGS 11,A01,083617,Boyle; Mary E. T.,24,0,40,16
1650235999954,COGS 13,A01,083071,Staff,0,30,40,40
1650236005994,COGS 14A,A01,092681,Staff,1,12,100,99
1650236012026,COGS 14B,A01,083073,Cheng; Tzu-Han,0,7,50,50
1650236018051,COGS 17,A01,092677,Staff,33,0,75,42
1650236024074,COGS 100,A01,083619,Staff,1,21,60,59
1650236030096,COGS 101A,A01,083621,Davis; Joshua Daniel,0,21,60,60
1650236036120,COGS 101B,A01,091572,Staff,5,0,60,55
1650236042144,COGS 101C,A01,083625,Delgado; Tania,20,0,30,10
1650236048171,COGS 107A,A01,083627,Boyle; Mary E. T.,1,7,60,59
1650236054193,COGS 118A,A01,083075,Staff,15,0,60,45
1650236060221,CSE 3,A50,083646,Miranda; Gregory Joseph,22,0,38,16
1650236060221,CSE 3,A51,083647,Miranda; Gregory Joseph,37,0,37,0
1650236066252,CSE 8A,A50,083650,Miranda; Gregory Joseph,0,18,40,40
1650236072278,CSE 11,A01,083080,Cao; Yingjun,0,68,40,40
1650236078302,CSE 12,A01,083652,Staff,0,9,100,100
1650236084325,CSE 15L,A01,083654,Staff,0,1,50,50
1650236084325,CSE 15L,A02,083655,Staff,5,0,50,45
1650236090351,CSE 20,A01,083657,Staff,53,0,80,27
1650236096388,CSE 30,A01,083084,Eldon; John,0,70,40,40
1650236102413,CSE 100,A01,083659,Cao; Yingjun,0,63,50,50
1650236108436,CSE 134B,A01,083661,Powell; Thomas Allan,0,27,65,65
1650236114461,CSE 140,A01,083663,Staff,1,0,75,74
1650236120493,CSE 140L,A01,083088,Eldon; John,0,4,75,75
1650236126522,CSE 175,A01,083665,Kumar; Rakesh,8,0,25,17
1650236132548,CSE 190,A00,092507,Dubnov; Shlomo,14,0,20,6
1650236138572,ECE 45,A01,083139,Staff,0,13,40,40
1650236144682,ECE 65,A50,083695,Staff,0,5,30,30
1650236150704,ECE 109,A01,091882,Touri; Behrouz,47,0,70,23
1650236156728,ECE 180,A00,083140,Abi Samra; Nicholas Camill,24,0,30,6
1650236156728,ECE 180,B00,083141,Abi Samra; Nicholas Camill,8,0,30,22
1650236162752,MATH 10A,A01,083735,Patchell; Gregory David,11,0,30,19
1650236162752,MATH 10A,A02,083736,Patchell; Gregory David,28,0,30,2
1650236162752,MATH 10A,A03,083737,Patchell; Gregory David,26,0,30,4
1650236168789,MATH 10B,A01,083207,Staff,0,6,30,30
1650236168789,MATH 10B,A02,083208,Staff,0,5,30,30
1650236168789,MATH 10B,B01,083739,Staff,17,0,30,13
1650236168789,MATH 10B,B02,083740,Staff,29,0,30,1
1650236174817,MATH 18,A01,083743,Staff,7,0,30,23
1650236174817,MATH 18,A02,083744,Staff,28,0,30,2
1650236174817,MATH 18,A03,083745,Staff,23,0,30,7
1650236174817,MATH 18,A04,083746,Staff,27,0,30,3
1650236174817,MATH 18,B01,083748,Staff,0,10,30,30
1650236174817,MATH 18,B02,083749,Staff,0,7,30,30
1650236174817,MATH 18,B03,083750,Staff,0,7,30,30
1650236174817,MATH 18,B04,083751,Staff,0,8,30,30
1650236180846,MATH 20A,A01,083754,Staff,26,0,40,14
1650236186870,MATH 20B,A01,083756,Staff,1,6,30,29
1650236186870,MATH 20B,A02,083757,Staff,0,6,30,30
1650236192893,MATH 20C,A01,083760,Staff,0,12,30,30
1650236192893,MATH 20C,A02,083761,Staff,0,13,30,30
1650236192893,MATH 20C,B01,083762,Staff,14,0,30,16
1650236192893,MATH 20C,B02,083763,Staff,28,0,30,2
1650236198914,MATH 20D,A01,083765,Staff,1,2,30,29
1650236198914,MATH 20D,A02,083766,Staff,9,0,30,21
1650236198914,MATH 20D,A03,083767,Staff,28,0,30,2
1650236204938,MATH 20E,A01,083771,Staff,8,0,30,22
1650236204938,MATH 20E,A02,083772,Staff,21,0,30,9
1650236204938,MATH 20E,B01,083773,Staff,0,0,30,30
1650236204938,MATH 20E,B02,083774,Staff,12,0,30,18
1650236210976,MATH 103A,A01,083777,Staff,0,9,30,30
1650236210976,MATH 103A,A02,083778,Staff,0,10,30,30
1650236210976,MATH 103A,B01,083779,Staff,0,9,30,30
1650236210976,MATH 103A,B02,083780,Staff,0,9,30,30
1650236216999,MATH 105,A01,085443,Staff,0,17,30,30
1650236223030,MATH 109,A01,083213,Anzaldo; Leesa B,0,3,30,30
1650236223030,MATH 109,A02,083214,Anzaldo; Leesa B,0,6,30,30
1650236223030,MATH 109,B01,083215,Anzaldo; Leesa B,0,4,30,30
1650236223030,MATH 109,B02,083216,Anzaldo; Leesa B,1,4,30,29
1650236229055,MATH 142A,A01,083219,Chow; Bennett,0,12,30,30
1650236229055,MATH 142A,A02,083220,Chow; Bennett,0,11,30,30
1650236229055,MATH 142A,B01,083221,Chow; Bennett,0,11,30,30
1650236229055,MATH 142A,B02,083222,Chow; Bennett,0,12,30,30
1650236235078,MATH 193A,A01,083224,Staff,0,5,30,30
1650236235078,MATH 193A,A02,083225,Staff,0,4,30,30
1650236235078,MATH 193A,A03,083781,Staff,0,2,30,30
1650236235078,MATH 193A,A04,083782,Staff,0,1,30,30
1650236241102,MATH 197,001,091859,McAuley; Julian John,9998,0,9999,1
1650236247158,COGS 9,A01,083615,Staff,0,14,60,60
1650236253187,COGS 11,A01,083617,Boyle; Mary E. T.,24,0,40,16
1650236259211,COGS 13,A01,083071,Staff,0,30,40,40
1650236265234,COGS 14A,A01,092681,Staff,1,12,100,99
1650236271257,COGS 14B,A01,083073,Cheng; Tzu-Han,0,7,50,50
1650236277280,COGS 17,A01,092677,Staff,33,0,75,42
1650236283309,COGS 100,A01,083619,Staff,1,21,60,59
1650236289340,COGS 101A,A01,083621,Davis; Joshua Daniel,0,21,60,60
1650236295370,COGS 101B,A01,091572,Staff,5,0,60,55
1650236301397,COGS 101C,A01,083625,Delgado; Tania,20,0,30,10
1650236307423,COGS 107A,A01,083627,Boyle; Mary E. T.,1,7,60,59
1650236313447,COGS 118A,A01,083075,Staff,15,0,60,45
1650236319469,CSE 3,A50,083646,Miranda; Gregory Joseph,22,0,38,16
1650236319469,CSE 3,A51,083647,Miranda; Gregory Joseph,37,0,37,0
1650236325491,CSE 8A,A50,083650,Miranda; Gregory Joseph,0,18,40,40
1650236331516,CSE 11,A01,083080,Cao; Yingjun,0,68,40,40
1650236337541,CSE 12,A01,083652,Staff,0,9,100,100
1650236343563,CSE 15L,A01,083654,Staff,0,1,50,50
1650236343563,CSE 15L,A02,083655,Staff,5,0,50,45
1650236349586,CSE 20,A01,083657,Staff,53,0,80,27
1650236355623,CSE 30,A01,083084,Eldon; John,0,70,40,40
1650236361649,CSE 100,A01,083659,Cao; Yingjun,0,63,50,50
1650236367675,CSE 134B,A01,083661,Powell; Thomas Allan,0,27,65,65
1650236373698,CSE 140,A01,083663,Staff,1,0,75,74
1650236379723,CSE 140L,A01,083088,Eldon; John,0,4,75,75
1650236385754,CSE 175,A01,083665,Kumar; Rakesh,8,0,25,17
1650236391778,CSE 190,A00,092507,Dubnov; Shlomo,14,0,20,6
1650236397802,ECE 45,A01,083139,Staff,0,13,40,40
1650236403833,ECE 65,A50,083695,Staff,0,5,30,30
1650236409856,ECE 109,A01,091882,Touri; Behrouz,47,0,70,23
1650236415879,ECE 180,A00,083140,Abi Samra; Nicholas Camill,24,0,30,6
1650236415879,ECE 180,B00,083141,Abi Samra; Nicholas Camill,8,0,30,22
1650236421906,MATH 10A,A01,083735,Patchell; Gregory David,11,0,30,19
1650236421906,MATH 10A,A02,083736,Patchell; Gregory David,28,0,30,2
1650236421906,MATH 10A,A03,083737,Patchell; Gregory David,26,0,30,4
1650236427930,MATH 10B,A01,083207,Staff,0,6,30,30
1650236427930,MATH 10B,A02,083208,Staff,0,5,30,30
1650236427930,MATH 10B,B01,083739,Staff,17,0,30,13
1650236427930,MATH 10B,B02,083740,Staff,29,0,30,1
1650236433954,MATH 18,A01,083743,Staff,7,0,30,23
1650236433954,MATH 18,A02,083744,Staff,28,0,30,2
1650236433954,MATH 18,A03,083745,Staff,23,0,30,7
1650236433954,MATH 18,A04,083746,Staff,27,0,30,3
1650236433954,MATH 18,B01,083748,Staff,0,10,30,30
1650236433954,MATH 18,B02,083749,Staff,0,7,30,30
1650236433954,MATH 18,B03,083750,Staff,0,7,30,30
1650236433954,MATH 18,B04,083751,Staff,0,8,30,30
1650236439976,MATH 20A,A01,083754,Staff,26,0,40,14
1650236445998,MATH 20B,A01,083756,Staff,1,6,30,29
1650236445998,MATH 20B,A02,083757,Staff,0,6,30,30
1650236452024,MATH 20C,A01,083760,Staff,0,12,30,30
1650236452024,MATH 20C,A02,083761,Staff,0,13,30,30
1650236452024,MATH 20C,B01,083762,Staff,14,0,30,16
1650236452024,MATH 20C,B02,083763,Staff,28,0,30,2
1650236458047,MATH 20D,A01,083765,Staff,1,2,30,29
1650236458047,MATH 20D,A02,083766,Staff,9,0,30,21
1650236458047,MATH 20D,A03,083767,Staff,28,0,30,2
1650236464071,MATH 20E,A01,083771,Staff,8,0,30,22
1650236464071,MATH 20E,A02,083772,Staff,21,0,30,9
1650236464071,MATH 20E,B01,083773,Staff,0,0,30,30
1650236464071,MATH 20E,B02,083774,Staff,12,0,30,18
1650236470099,MATH 103A,A01,083777,Staff,0,9,30,30
1650236470099,MATH 103A,A02,083778,Staff,0,10,30,30
1650236470099,MATH 103A,B01,083779,Staff,0,10,30,30
1650236470099,MATH 103A,B02,083780,Staff,0,9,30,30
1650236476142,MATH 105,A01,085443,Staff,0,17,30,30
1650236482169,MATH 109,A01,083213,Anzaldo; Leesa B,0,3,30,30
1650236482169,MATH 109,A02,083214,Anzaldo; Leesa B,0,6,30,30
1650236482169,MATH 109,B01,083215,Anzaldo; Leesa B,0,4,30,30
1650236482169,MATH 109,B02,083216,Anzaldo; Leesa B,1,4,30,29
1650236488196,MATH 142A,A01,083219,Chow; Bennett,0,12,30,30
1650236488196,MATH 142A,A02,083220,Chow; Bennett,0,11,30,30
1650236488196,MATH 142A,B01,083221,Chow; Bennett,0,11,30,30
1650236488196,MATH 142A,B02,083222,Chow; Bennett,0,12,30,30
1650236494223,MATH 193A,A01,083224,Staff,0,5,30,30
1650236494223,MATH 193A,A02,083225,Staff,0,4,30,30
1650236494223,MATH 193A,A03,083781,Staff,0,2,30,30
1650236494223,MATH 193A,A04,083782,Staff,0,1,30,30
1650236500247,MATH 197,001,091859,McAuley; Julian John,9998,0,9999,1
1650236506306,COGS 9,A01,083615,Staff,0,14,60,60
1650236512327,COGS 11,A01,083617,Boyle; Mary E. T.,24,0,40,16
1650236518351,COGS 13,A01,083071,Staff,0,30,40,40
1650236524384,COGS 14A,A01,092681,Staff,1,12,100,99
1650236530413,COGS 14B,A01,083073,Cheng; Tzu-Han,0,7,50,50
1650236536438,COGS 17,A01,092677,Staff,33,0,75,42
1650236542466,COGS 100,A01,083619,Staff,1,21,60,59
1650236548500,COGS 101A,A01,083621,Davis; Joshua Daniel,0,21,60,60
1650236554522,COGS 101B,A01,091572,Staff,5,0,60,55
1650236560545,COGS 101C,A01,083625,Delgado; Tania,20,0,30,10
1650236566573,COGS 107A,A01,083627,Boyle; Mary E. T.,1,7,60,59
1650236572596,COGS 118A,A01,083075,Staff,15,0,60,45
1650236578620,CSE 3,A50,083646,Miranda; Gregory Joseph,22,0,38,16
1650236578620,CSE 3,A51,083647,Miranda; Gregory Joseph,37,0,37,0
1650236584649,CSE 8A,A50,083650,Miranda; Gregory Joseph,0,18,40,40
1650236590675,CSE 11,A01,083080,Cao; Yingjun,0,68,40,40
1650236596705,CSE 12,A01,083652,Staff,0,9,100,100
1650236602727,CSE 15L,A01,083654,Staff,0,1,50,50
1650236602727,CSE 15L,A02,083655,Staff,5,0,50,45
1650236608752,CSE 20,A01,083657,Staff,53,0,80,27
1650236614776,CSE 30,A01,083084,Eldon; John,0,70,40,40
1650236620800,CSE 100,A01,083659,Cao; Yingjun,0,63,50,50
1650236626823,CSE 134B,A01,083661,Powell; Thomas Allan,0,27,65,65
1650236632852,CSE 140,A01,083663,Staff,1,0,75,74
1650236638876,CSE 140L,A01,083088,Eldon; John,0,4,75,75
1650236644901,CSE 175,A01,083665,Kumar; Rakesh,8,0,25,17
1650236650931,CSE 190,A00,092507,Dubnov; Shlomo,14,0,20,6
1650236656954,ECE 45,A01,083139,Staff,0,13,40,40
1650236662987,ECE 65,A50,083695,Staff,0,5,30,30
1650236669010,ECE 109,A01,091882,Touri; Behrouz,47,0,70,23
1650236675032,ECE 180,A00,083140,Abi Samra; Nicholas Camill,24,0,30,6
1650236675032,ECE 180,B00,083141,Abi Samra; Nicholas Camill,8,0,30,22
1650236681060,MATH 10A,A01,083735,Patchell; Gregory David,11,0,30,19
1650236681060,MATH 10A,A02,083736,Patchell; Gregory David,28,0,30,2
1650236681060,MATH 10A,A03,083737,Patchell; Gregory David,26,0,30,4
1650236687087,MATH 10B,A01,083207,Staff,0,6,30,30
1650236687087,MATH 10B,A02,083208,Staff,0,5,30,30
1650236687087,MATH 10B,B01,083739,Staff,17,0,30,13
1650236687087,MATH 10B,B02,083740,Staff,29,0,30,1
1650236693116,MATH 18,A01,083743,Staff,7,0,30,23
1650236693116,MATH 18,A02,083744,Staff,28,0,30,2
1650236693116,MATH 18,A03,083745,Staff,23,0,30,7
1650236693116,MATH 18,A04,083746,Staff,27,0,30,3
1650236693116,MATH 18,B01,083748,Staff,0,10,30,30
1650236693116,MATH 18,B02,083749,Staff,0,7,30,30
1650236693116,MATH 18,B03,083750,Staff,0,7,30,30
1650236693116,MATH 18,B04,083751,Staff,0,8,30,30
1650236699143,MATH 20A,A01,083754,Staff,26,0,40,14
1650236705167,MATH 20B,A01,083756,Staff,1,6,30,29
1650236705167,MATH 20B,A02,083757,Staff,0,6,30,30
1650236711191,MATH 20C,A01,083760,Staff,0,12,30,30
1650236711191,MATH 20C,A02,083761,Staff,0,13,30,30
1650236711191,MATH 20C,B01,083762,Staff,14,0,30,16
1650236711191,MATH 20C,B02,083763,Staff,28,0,30,2
1650236717215,MATH 20D,A01,083765,Staff,1,2,30,29
1650236717215,MATH 20D,A02,083766,Staff,9,0,30,21
1650236717215,MATH 20D,A03,083767,Staff,28,0,30,2
1650236723239,MATH 20E,A01,083771,Staff,8,0,30,22
1650236723239,MATH 20E,A02,083772,Staff,21,0,30,9
1650236723239,MATH 20E,B01,083773,Staff,0,0,30,30
1650236723239,MATH 20E,B02,083774,Staff,12,0,30,18
1650236729267,MATH 103A,A01,083777,Staff,0,9,30,30
1650236729267,MATH 103A,A02,083778,Staff,0,10,30,30
1650236729267,MATH 103A,B01,083779,Staff,0,10,30,30
1650236729267,MATH 103A,B02,083780,Staff,0,9,30,30
1650236735290,MATH 105,A01,085443,Staff,0,17,30,30
1650236741402,MATH 109,A01,083213,Anzaldo; Leesa B,0,3,30,30
1650236741402,MATH 109,A02,083214,Anzaldo; Leesa B,0,6,30,30
1650236741402,MATH 109,B01,083215,Anzaldo; Leesa B,0,4,30,30
1650236741402,MATH 109,B02,083216,Anzaldo; Leesa B,1,4,30,29
1650236747428,MATH 142A,A01,083219,Chow; Bennett,0,12,30,30
1650236747428,MATH 142A,A02,083220,Chow; Bennett,0,11,30,30
1650236747428,MATH 142A,B01,083221,Chow; Bennett,0,11,30,30
1650236747428,MATH 142A,B02,083222,Chow; Bennett,0,12,30,30
1650236753460,MATH 193A,A01,083224,Staff,0,5,30,30
1650236753460,MATH 193A,A02,083225,Staff,0,4,30,30
1650236753460,MATH 193A,A03,083781,Staff,0,2,30,30
1650236753460,MATH 193A,A04,083782,Staff,0,1,30,30
1650236759484,MATH 197,001,091859,McAuley; Julian John,9998,0,9999,1
1650236765542,COGS 9,A01,083615,Staff,0,14,60,60
1650236771566,COGS 11,A01,083617,Boyle; Mary E. T.,24,0,40,16
1650236777592,COGS 13,A01,083071,Staff,0,31,40,40
1650236783615,COGS 14A,A01,092681,Staff,1,12,100,99
1650236789643,COGS 14B,A01,083073,Cheng; Tzu-Han,0,7,50,50
1650236795669,COGS 17,A01,092677,Staff,33,0,75,42
1650236801694,COGS 100,A01,083619,Staff,1,21,60,59
1650236807729,COGS 101A,A01,083621,Davis; Joshua Daniel,0,21,60,60
1650236813753,COGS 101B,A01,091572,Staff,5,0,60,55
1650236819779,COGS 101C,A01,083625,Delgado; Tania,20,0,30,10
1650236825832,COGS 107A,A01,083627,Boyle; Mary E. T.,1,7,60,59
1650236831859,COGS 118A,A01,083075,Staff,15,0,60,45
1650236837883,CSE 3,A50,083646,Miranda; Gregory Joseph,22,0,38,16
1650236837883,CSE 3,A51,083647,Miranda; Gregory Joseph,37,0,37,0
1650236843907,CSE 8A,A50,083650,Miranda; Gregory Joseph,0,18,40,40
1650236849936,CSE 11,A01,083080,Cao; Yingjun,0,68,40,40
1650236855979,CSE 12,A01,083652,Staff,0,9,100,100
1650236862005,CSE 15L,A01,083654,Staff,0,1,50,50
1650236862005,CSE 15L,A02,083655,Staff,5,0,50,45
1650236868029,CSE 20,A01,083657,Staff,53,0,80,27
1650236874053,CSE 30,A01,083084,Eldon; John,0,70,40,40
1650236880076,CSE 100,A01,083659,Cao; Yingjun,0,63,50,50
1650236886101,CSE 134B,A01,083661,Powell; Thomas Allan,0,27,65,65
1650236892128,CSE 140,A01,083663,Staff,1,0,75,74
1650236898157,CSE 140L,A01,083088,Eldon; John,0,4,75,75
1650236904183,CSE 175,A01,083665,Kumar; Rakesh,8,0,25,17
1650236910210,CSE 190,A00,092507,Dubnov; Shlomo,14,0,20,6
1650236916237,ECE 45,A01,083139,Staff,0,13,40,40
1650236922273,ECE 65,A50,083695,Staff,0,5,30,30
1650236928301,ECE 109,A01,091882,Touri; Behrouz,47,0,70,23
1650236934327,ECE 180,A00,083140,Abi Samra; Nicholas Camill,24,0,30,6
1650236934327,ECE 180,B00,083141,Abi Samra; Nicholas Camill,8,0,30,22
1650236940351,MATH 10A,A01,083735,Patchell; Gregory David,11,0,30,19
1650236940351,MATH 10A,A02,083736,Patchell; Gregory David,28,0,30,2
1650236940351,MATH 10A,A03,083737,Patchell; Gregory David,26,0,30,4
1650236946375,MATH 10B,A01,083207,Staff,0,6,30,30
1650236946375,MATH 10B,A02,083208,Staff,0,5,30,30
1650236946375,MATH 10B,B01,083739,Staff,17,0,30,13
1650236946375,MATH 10B,B02,083740,Staff,29,0,30,1
1650236952406,MATH 18,A01,083743,Staff,7,0,30,23
1650236952406,MATH 18,A02,083744,Staff,28,0,30,2
1650236952406,MATH 18,A03,083745,Staff,23,0,30,7
1650236952406,MATH 18,A04,083746,Staff,27,0,30,3
1650236952406,MATH 18,B01,083748,Staff,0,10,30,30
1650236952406,MATH 18,B02,083749,Staff,0,7,30,30
1650236952406,MATH 18,B03,083750,Staff,0,7,30,30
1650236952406,MATH 18,B04,083751,Staff,0,8,30,30
1650236958430,MATH 20A,A01,083754,Staff,26,0,40,14
1650236964457,MATH 20B,A01,083756,Staff,1,6,30,29
1650236964457,MATH 20B,A02,083757,Staff,0,6,30,30
1650236970482,MATH 20C,A01,083760,Staff,0,12,30,30
1650236970482,MATH 20C,A02,083761,Staff,0,13,30,30
1650236970482,MATH 20C,B01,083762,Staff,14,0,30,16
1650236970482,MATH 20C,B02,083763,Staff,28,0,30,2
1650236976510,MATH 20D,A01,083765,Staff,1,2,30,29
1650236976510,MATH 20D,A02,083766,Staff,9,0,30,21
1650236976510,MATH 20D,A03,083767,Staff,28,0,30,2
1650236982536,MATH 20E,A01,083771,Staff,8,0,30,22
1650236982536,MATH 20E,A02,083772,Staff,21,0,30,9
1650236982536,MATH 20E,B01,083773,Staff,0,0,30,30
1650236982536,MATH 20E,B02,083774,Staff,12,0,30,18
1650236988565,MATH 103A,A01,083777,Staff,0,9,30,30
1650236988565,MATH 103A,A02,083778,Staff,0,10,30,30
1650236988565,MATH 103A,B01,083779,Staff,0,10,30,30
1650236988565,MATH 103A,B02,083780,Staff,0,9,30,30
1650236994589,MATH 105,A01,085443,Staff,0,17,30,30
1650237000613,MATH 109,A01,083213,Anzaldo; Leesa B,0,3,30,30
1650237000613,MATH 109,A02,083214,Anzaldo; Leesa B,0,6,30,30
1650237000613,MATH 109,B01,083215,Anzaldo; Leesa B,0,4,30,30
1650237000613,MATH 109,B02,083216,Anzaldo; Leesa B,1,4,30,29
1650237006643,MATH 142A,A01,083219,Chow; Bennett,0,12,30,30
1650237006643,MATH 142A,A02,083220,Chow; Bennett,0,11,30,30
1650237006643,MATH 142A,B01,083221,Chow; Bennett,0,11,30,30
1650237006643,MATH 142A,B02,083222,Chow; Bennett,0,12,30,30
1650237012668,MATH 193A,A01,083224,Staff,0,5,30,30
1650237012668,MATH 193A,A02,083225,Staff,0,4,30,30
1650237012668,MATH 193A,A03,083781,Staff,0,2,30,30
1650237012668,MATH 193A,A04,083782,Staff,0,1,30,30
1650237018697,MATH 197,001,091859,McAuley; Julian John,9998,0,9999,1
1650237024750,COGS 9,A01,083615,Staff,0,14,60,60
1650237030774,COGS 11,A01,083617,Boyle; Mary E. T.,24,0,40,16
1650237036797,COGS 13,A01,083071,Staff,0,30,40,40
1650237042821,COGS 14A,A01,092681,Staff,1,12,100,99
1650237048845,COGS 14B,A01,083073,Cheng; Tzu-Han,0,7,50,50
1650237054870,COGS 17,A01,092677,Staff,32,0,75,43
1650237060898,COGS 100,A01,083619,Staff,1,21,60,59
1650237066921,COGS 101A,A01,083621,Davis; Joshua Daniel,0,21,60,60
1650237072945,COGS 101B,A01,091572,Staff,5,0,60,55
1650237078977,COGS 101C,A01,083625,Delgado; Tania,20,0,30,10
1650237084999,COGS 107A,A01,083627,Boyle; Mary E. T.,1,7,60,59
1650237091022,COGS 118A,A01,083075,Staff,15,0,60,45
1650237097045,CSE 3,A50,083646,Miranda; Gregory Joseph,22,0,38,16
1650237097045,CSE 3,A51,083647,Miranda; Gregory Joseph,37,0,37,0
1650237103070,CSE 8A,A50,083650,Miranda; Gregory Joseph,0,18,40,40
1650237109098,CSE 11,A01,083080,Cao; Yingjun,0,68,40,40
1650237115122,CSE 12,A01,083652,Staff,0,9,100,100
1650237121147,CSE 15L,A01,083654,Staff,0,1,50,50
1650237121147,CSE 15L,A02,083655,Staff,5,0,50,45
1650237127171,CSE 20,A01,083657,Staff,53,0,80,27
1650237133195,CSE 30,A01,083084,Eldon; John,0,70,40,40
1650237139220,CSE 100,A01,083659,Cao; Yingjun,0,63,50,50
1650237145244,CSE 134B,A01,083661,Powell; Thomas Allan,0,27,65,65
1650237151268,CSE 140,A01,083663,Staff,1,0,75,74
1650237157295,CSE 140L,A01,083088,Eldon; John,0,4,75,75
1650237163321,CSE 175,A01,083665,Kumar; Rakesh,8,0,25,17
1650237169346,CSE 190,A00,092507,Dubnov; Shlomo,14,0,20,6
1650237175371,ECE 45,A01,083139,Staff,0,13,40,40
1650237181395,ECE 65,A50,083695,Staff,0,5,30,30
1650237187430,ECE 109,A01,091882,Touri; Behrouz,47,0,70,23
1650237193453,ECE 180,A00,083140,Abi Samra; Nicholas Camill,24,0,30,6
1650237193453,ECE 180,B00,083141,Abi Samra; Nicholas Camill,8,0,30,22
1650237199481,MATH 10A,A01,083735,Patchell; Gregory David,11,0,30,19
1650237199481,MATH 10A,A02,083736,Patchell; Gregory David,28,0,30,2
1650237199481,MATH 10A,A03,083737,Patchell; Gregory David,26,0,30,4
1650237205504,MATH 10B,A01,083207,Staff,0,6,30,30
1650237205504,MATH 10B,A02,083208,Staff,0,5,30,30
1650237205504,MATH 10B,B01,083739,Staff,17,0,30,13
1650237205504,MATH 10B,B02,083740,Staff,29,0,30,1
1650237211543,MATH 18,A01,083743,Staff,7,0,30,23
1650237211543,MATH 18,A02,083744,Staff,28,0,30,2
1650237211543,MATH 18,A03,083745,Staff,23,0,30,7
1650237211543,MATH 18,A04,083746,Staff,27,0,30,3
1650237211543,MATH 18,B01,083748,Staff,0,10,30,30
1650237211543,MATH 18,B02,083749,Staff,0,7,30,30
1650237211543,MATH 18,B03,083750,Staff,0,7,30,30
1650237211543,MATH 18,B04,083751,Staff,0,8,30,30
1650237217569,MATH 20A,A01,083754,Staff,26,0,40,14
1650237223591,MATH 20B,A01,083756,Staff,1,6,30,29
1650237223591,MATH 20B,A02,083757,Staff,0,6,30,30
1650237229622,MATH 20C,A01,083760,Staff,0,12,30,30
1650237229622,MATH 20C,A02,083761,Staff,0,13,30,30
1650237229622,MATH 20C,B01,083762,Staff,14,0,30,16
1650237229622,MATH 20C,B02,083763,Staff,28,0,30,2
1650237235648,MATH 20D,A01,083765,Staff,1,2,30,29
1650237235648,MATH 20D,A02,083766,Staff,8,0,30,22
1650237235648,MATH 20D,A03,083767,Staff,28,0,30,2
1650237241675,MATH 20E,A01,083771,Staff,8,0,30,22
1650237241675,MATH 20E,A02,083772,Staff,21,0,30,9
1650237241675,MATH 20E,B01,083773,Staff,0,0,30,30
1650237241675,MATH 20E,B02,083774,Staff,12,0,30,18
1650237247704,MATH 103A,A01,083777,Staff,0,9,30,30
1650237247704,MATH 103A,A02,083778,Staff,0,10,30,30
1650237247704,MATH 103A,B01,083779,Staff,0,10,30,30
1650237247704,MATH 103A,B02,083780,Staff,0,9,30,30
1650237253730,MATH 105,A01,085443,Staff,0,17,30,30
1650237259756,MATH 109,A01,083213,Anzaldo; Leesa B,0,3,30,30
1650237259756,MATH 109,A02,083214,Anzaldo; Leesa B,0,6,30,30
1650237259756,MATH 109,B01,083215,Anzaldo; Leesa B,0,4,30,30
1650237259756,MATH 109,B02,083216,Anzaldo; Leesa B,1,4,30,29
1650237265783,MATH 142A,A01,083219,Chow; Bennett,0,12,30,30
1650237265783,MATH 142A,A02,083220,Chow; Bennett,0,11,30,30
1650237265783,MATH 142A,B01,083221,Chow; Bennett,0,11,30,30
1650237265783,MATH 142A,B02,083222,Chow; Bennett,0,12,30,30
1650237271806,MATH 193A,A01,083224,Staff,0,5,30,30
1650237271806,MATH 193A,A02,083225,Staff,0,4,30,30
1650237271806,MATH 193A,A03,083781,Staff,0,2,30,30
1650237271806,MATH 193A,A04,083782,Staff,0,1,30,30
1650237277830,MATH 197,001,091859,McAuley; Julian John,9998,0,9999,1
1650237283889,COGS 9,A01,083615,Staff,0,14,60,60
1650237289913,COGS 11,A01,083617,Boyle; Mary E. T.,24,0,40,16
1650237295941,COGS 13,A01,083071,Staff,0,30,40,40
1650237301964,COGS 14A,A01,092681,Staff,1,12,100,99
1650237307988,COGS 14B,A01,083073,Cheng; Tzu-Han,0,7,50,50
1650237314013,COGS 17,A01,092677,Staff,32,0,75,43
1650237320042,COGS 100,A01,083619,Staff,1,21,60,59
1650237326066,COGS 101A,A01,083621,Davis; Joshua Daniel,0,21,60,60
1650237332191,COGS 101B,A01,091572,Staff,5,0,60,55
1650237338215,COGS 101C,A01,083625,Delgado; Tania,20,0,30,10
1650237344239,COGS 107A,A01,083627,Boyle; Mary E. T.,1,7,60,59
1650237350265,COGS 118A,A01,083075,Staff,15,0,60,45
1650237356287,CSE 3,A50,083646,Miranda; Gregory Joseph,22,0,38,16
1650237356287,CSE 3,A51,083647,Miranda; Gregory Joseph,37,0,37,0
1650237362313,CSE 8A,A50,083650,Miranda; Gregory Joseph,0,18,40,40
1650237368340,CSE 11,A01,083080,Cao; Yingjun,0,68,40,40
1650237374365,CSE 12,A01,083652,Staff,0,9,100,100
1650237380392,CSE 15L,A01,083654,Staff,0,1,50,50
1650237380392,CSE 15L,A02,083655,Staff,5,0,50,45
1650237386416,CSE 20,A01,083657,Staff,53,0,80,27
1650237392450,CSE 30,A01,083084,Eldon; John,0,70,40,40
1650237398477,CSE 100,A01,083659,Cao; Yingjun,0,63,50,50
1650237404504,CSE 134B,A01,083661,Powell; Thomas Allan,0,27,65,65
1650237410533,CSE 140,A01,083663,Staff,1,0,75,74
1650237416557,CSE 140L,A01,083088,Eldon; John,0,4,75,75
1650237422579,CSE 175,A01,083665,Kumar; Rakesh,8,0,25,17
1650237428611,CSE 190,A00,092507,Dubnov; Shlomo,14,0,20,6
1650237434637,ECE 45,A01,083139,Staff,0,13,40,40
1650237440661,ECE 65,A50,083695,Staff,0,5,30,30
1650237446683,ECE 109,A01,091882,Touri; Behrouz,47,0,70,23
1650237452710,ECE 180,A00,083140,Abi Samra; Nicholas Camill,24,0,30,6
1650237452710,ECE 180,B00,083141,Abi Samra; Nicholas Camill,8,0,30,22
1650237458734,MATH 10A,A01,083735,Patchell; Gregory David,11,0,30,19
1650237458734,MATH 10A,A02,083736,Patchell; Gregory David,28,0,30,2
1650237458734,MATH 10A,A03,083737,Patchell; Gregory David,26,0,30,4
1650237464759,MATH 10B,A01,083207,Staff,0,6,30,30
1650237464759,MATH 10B,A02,083208,Staff,0,5,30,30
1650237464759,MATH 10B,B01,083739,Staff,17,0,30,13
1650237464759,MATH 10B,B02,083740,Staff,29,0,30,1
1650237470784,MATH 18,A01,083743,Staff,7,0,30,23
1650237470784,MATH 18,A02,083744,Staff,28,0,30,2
1650237470784,MATH 18,A03,083745,Staff,23,0,30,7
1650237470784,MATH 18,A04,083746,Staff,27,0,30,3
1650237470784,MATH 18,B01,083748,Staff,0,10,30,30
1650237470784,MATH 18,B02,083749,Staff,0,8,30,30
1650237470784,MATH 18,B03,083750,Staff,0,7,30,30
1650237470784,MATH 18,B04,083751,Staff,0,8,30,30
1650237476809,MATH 20A,A01,083754,Staff,26,0,40,14
1650237482837,MATH 20B,A01,083756,Staff,1,6,30,29
1650237482837,MATH 20B,A02,083757,Staff,0,6,30,30
1650237488865,MATH 20C,A01,083760,Staff,0,12,30,30
1650237488865,MATH 20C,A02,083761,Staff,0,13,30,30
1650237488865,MATH 20C,B01,083762,Staff,14,0,30,16
1650237488865,MATH 20C,B02,083763,Staff,28,0,30,2
1650237494889,MATH 20D,A01,083765,Staff,1,2,30,29
1650237494889,MATH 20D,A02,083766,Staff,8,0,30,22
1650237494889,MATH 20D,A03,083767,Staff,28,0,30,2
1650237500915,MATH 20E,A01,083771,Staff,8,0,30,22
1650237500915,MATH 20E,A02,083772,Staff,21,0,30,9
1650237500915,MATH 20E,B01,083773,Staff,0,0,30,30
1650237500915,MATH 20E,B02,083774,Staff,12,0,30,18
1650237506943,MATH 103A,A01,083777,Staff,0,9,30,30
1650237506943,MATH 103A,A02,083778,Staff,0,10,30,30
1650237506943,MATH 103A,B01,083779,Staff,0,10,30,30
1650237506943,MATH 103A,B02,083780,Staff,0,9,30,30
1650237512967,MATH 105,A01,085443,Staff,0,17,30,30
1650237518995,MATH 109,A01,083213,Anzaldo; Leesa B,0,3,30,30
1650237518995,MATH 109,A02,083214,Anzaldo; Leesa B,0,6,30,30
1650237518995,MATH 109,B01,083215,Anzaldo; Leesa B,0,4,30,30
1650237518995,MATH 109,B02,083216,Anzaldo; Leesa B,1,4,30,29
1650237525023,MATH 142A,A01,083219,Chow; Bennett,0,12,30,30
1650237525023,MATH 142A,A02,083220,Chow; Bennett,0,11,30,30
1650237525023,MATH 142A,B01,083221,Chow; Bennett,0,11,30,30
1650237525023,MATH 142A,B02,083222,Chow; Bennett,0,12,30,30
1650237531055,MATH 193A,A01,083224,Staff,0,5,30,30
1650237531055,MATH 193A,A02,083225,Staff,0,4,30,30
1650237531055,MATH 193A,A03,083781,Staff,0,2,30,30
1650237531055,MATH 193A,A04,083782,Staff,0,1,30,30
1650237537080,MATH 197,001,091859,McAuley; Julian John,9998,0,9999,1
1650237543148,COGS 9,A01,083615,Staff,0,14,60,60
1650237549175,COGS 11,A01,083617,Boyle; Mary E. T.,24,0,40,16
1650237555209,COGS 13,A01,083071,Staff,0,30,40,40
1650237561244,COGS 14A,A01,092681,Staff,1,13,100,99
1650237567267,COGS 14B,A01,083073,Cheng; Tzu-Han,0,7,50,50
1650237573294,COGS 17,A01,092677,Staff,33,0,75,42
1650237579319,COGS 100,A01,083619,Staff,1,21,60,59
1650237585344,COGS 101A,A01,083621,Davis; Joshua Daniel,0,21,60,60
1650237591371,COGS 101B,A01,091572,Staff,5,0,60,55
1650237597398,COGS 101C,A01,083625,Delgado; Tania,20,0,30,10
1650237603428,COGS 107A,A01,083627,Boyle; Mary E. T.,1,7,60,59
1650237609453,COGS 118A,A01,083075,Staff,15,0,60,45
1650237615481,CSE 3,A50,083646,Miranda; Gregory Joseph,22,0,38,16
1650237615481,CSE 3,A51,083647,Miranda; Gregory Joseph,37,0,37,0
1650237621507,CSE 8A,A50,083650,Miranda; Gregory Joseph,0,18,40,40
1650237627538,CSE 11,A01,083080,Cao; Yingjun,0,68,40,40
1650237633562,CSE 12,A01,083652,Staff,0,9,100,100
1650237639584,CSE 15L,A01,083654,Staff,0,1,50,50
1650237639584,CSE 15L,A02,083655,Staff,5,0,50,45
1650237645606,CSE 20,A01,083657,Staff,53,0,80,27
1650237651629,CSE 30,A01,083084,Eldon; John,0,70,40,40
1650237657656,CSE 100,A01,083659,Cao; Yingjun,0,63,50,50
1650237663689,CSE 134B,A01,083661,Powell; Thomas Allan,0,27,65,65
1650237669716,CSE 140,A01,083663,Staff,1,0,75,74
1650237675747,CSE 140L,A01,083088,Eldon; John,0,4,75,75
1650237681771,CSE 175,A01,083665,Kumar; Rakesh,8,0,25,17
1650237687800,CSE 190,A00,092507,Dubnov; Shlomo,14,0,20,6
1650237693826,ECE 45,A01,083139,Staff,0,13,40,40
1650237699853,ECE 65,A50,083695,Staff,0,5,30,30
1650237705882,ECE 109,A01,091882,Touri; Behrouz,47,0,70,23
1650237711907,ECE 180,A00,083140,Abi Samra; Nicholas Camill,24,0,30,6
1650237711907,ECE 180,B00,083141,Abi Samra; Nicholas Camill,8,0,30,22
1650237717933,MATH 10A,A01,083735,Patchell; Gregory David,11,0,30,19
1650237717933,MATH 10A,A02,083736,Patchell; Gregory David,28,0,30,2
1650237717933,MATH 10A,A03,083737,Patchell; Gregory David,26,0,30,4
1650237723958,MATH 10B,A01,083207,Staff,0,6,30,30
1650237723958,MATH 10B,A02,083208,Staff,0,5,30,30
1650237723958,MATH 10B,B01,083739,Staff,17,0,30,13
1650237723958,MATH 10B,B02,083740,Staff,29,0,30,1
1650237729995,MATH 18,A01,083743,Staff,7,0,30,23
1650237729995,MATH 18,A02,083744,Staff,28,0,30,2
1650237729995,MATH 18,A03,083745,Staff,23,0,30,7
1650237729995,MATH 18,A04,083746,Staff,27,0,30,3
1650237729995,MATH 18,B01,083748,Staff,0,10,30,30
1650237729995,MATH 18,B02,083749,Staff,0,8,30,30
1650237729995,MATH 18,B03,083750,Staff,0,7,30,30
1650237729995,MATH 18,B04,083751,Staff,0,8,30,30
1650237736018,MATH 20A,A01,083754,Staff,26,0,40,14
1650237742040,MATH 20B,A01,083756,Staff,1,6,30,29
1650237742040,MATH 20B,A02,083757,Staff,0,6,30,30
1650237748068,MATH 20C,A01,083760,Staff,0,12,30,30
1650237748068,MATH 20C,A02,083761,Staff,0,13,30,30
1650237748068,MATH 20C,B01,083762,Staff,14,0,30,16
1650237748068,MATH 20C,B02,083763,Staff,28,0,30,2
1650237754097,MATH 20D,A01,083765,Staff,1,2,30,29
1650237754097,MATH 20D,A02,083766,Staff,8,0,30,22
1650237754097,MATH 20D,A03,083767,Staff,28,0,30,2
1650237760125,MATH 20E,A01,083771,Staff,8,0,30,22
1650237760125,MATH 20E,A02,083772,Staff,21,0,30,9
1650237760125,MATH 20E,B01,083773,Staff,0,0,30,30
1650237760125,MATH 20E,B02,083774,Staff,12,0,30,18
1650237766155,MATH 103A,A01,083777,Staff,0,9,30,30
1650237766155,MATH 103A,A02,083778,Staff,0,10,30,30
1650237766155,MATH 103A,B01,083779,Staff,0,10,30,30
1650237766155,MATH 103A,B02,083780,Staff,0,9,30,30
1650237772178,MATH 105,A01,085443,Staff,0,17,30,30
1650237778201,MATH 109,A01,083213,Anzaldo; Leesa B,0,3,30,30
1650237778201,MATH 109,A02,083214,Anzaldo; Leesa B,0,6,30,30
1650237778201,MATH 109,B01,083215,Anzaldo; Leesa B,0,4,30,30
1650237778201,MATH 109,B02,083216,Anzaldo; Leesa B,1,4,30,29
1650237784229,MATH 142A,A01,083219,Chow; Bennett,0,12,30,30
1650237784229,MATH 142A,A02,083220,Chow; Bennett,0,11,30,30
1650237784229,MATH 142A,B01,083221,Chow; Bennett,0,11,30,30
1650237784229,MATH 142A,B02,083222,Chow; Bennett,0,12,30,30
1650237790287,MATH 193A,A01,083224,Staff,0,5,30,30
1650237790287,MATH 193A,A02,083225,Staff,0,4,30,30
1650237790287,MATH 193A,A03,083781,Staff,0,2,30,30
1650237790287,MATH 193A,A04,083782,Staff,0,1,30,30
1650237796312,MATH 197,001,091859,McAuley; Julian John,9998,0,9999,1
1650237802362,COGS 9,A01,083615,Staff,0,14,60,60
1650237808389,COGS 11,A01,083617,Boyle; Mary E. T.,24,0,40,16
1650237814414,COGS 13,A01,083071,Staff,0,30,40,40
1650237820440,COGS 14A,A01,092681,Staff,1,13,100,99
1650237826463,COGS 14B,A01,083073,Cheng; Tzu-Han,0,7,50,50
1650237832486,COGS 17,A01,092677,Staff,33,0,75,42
1650237838520,COGS 100,A01,083619,Staff,1,21,60,59
1650237844550,COGS 101A,A01,083621,Davis; Joshua Daniel,0,21,60,60
1650237850587,COGS 101B,A01,091572,Staff,5,0,60,55
1650237856614,COGS 101C,A01,083625,Delgado; Tania,20,0,30,10
1650237862636,COGS 107A,A01,083627,Boyle; Mary E. T.,1,7,60,59
1650237868659,COGS 118A,A01,083075,Staff,15,0,60,45
1650237874687,CSE 3,A50,083646,Miranda; Gregory Joseph,22,0,38,16
1650237874687,CSE 3,A51,083647,Miranda; Gregory Joseph,37,0,37,0
1650237880715,CSE 8A,A50,083650,Miranda; Gregory Joseph,0,18,40,40
1650237886738,CSE 11,A01,083080,Cao; Yingjun,0,68,40,40
1650237892770,CSE 12,A01,083652,Staff,0,9,100,100
1650237898794,CSE 15L,A01,083654,Staff,0,1,50,50
1650237898794,CSE 15L,A02,083655,Staff,5,0,50,45
1650237904821,CSE 20,A01,083657,Staff,53,0,80,27
1650237910844,CSE 30,A01,083084,Eldon; John,0,70,40,40
1650237916869,CSE 100,A01,083659,Cao; Yingjun,0,63,50,50
1650237922896,CSE 134B,A01,083661,Powell; Thomas Allan,0,27,65,65
1650237929008,CSE 140,A01,083663,Staff,1,0,75,74
1650237935032,CSE 140L,A01,083088,Eldon; John,0,4,75,75
1650237941056,CSE 175,A01,083665,Kumar; Rakesh,8,0,25,17
1650237947080,CSE 190,A00,092507,Dubnov; Shlomo,14,0,20,6
1650237953107,ECE 45,A01,083139,Staff,0,13,40,40
1650237959143,ECE 65,A50,083695,Staff,0,5,30,30
1650237965166,ECE 109,A01,091882,Touri; Behrouz,47,0,70,23
1650237971192,ECE 180,A00,083140,Abi Samra; Nicholas Camill,24,0,30,6
1650237971192,ECE 180,B00,083141,Abi Samra; Nicholas Camill,7,0,30,23
1650237977222,MATH 10A,A01,083735,Patchell; Gregory David,11,0,30,19
1650237977222,MATH 10A,A02,083736,Patchell; Gregory David,28,0,30,2
1650237977222,MATH 10A,A03,083737,Patchell; Gregory David,26,0,30,4
1650237983246,MATH 10B,A01,083207,Staff,0,6,30,30
1650237983246,MATH 10B,A02,083208,Staff,0,5,30,30
1650237983246,MATH 10B,B01,083739,Staff,17,0,30,13
1650237983246,MATH 10B,B02,083740,Staff,29,0,30,1
1650237989271,MATH 18,A01,083743,Staff,7,0,30,23
1650237989271,MATH 18,A02,083744,Staff,28,0,30,2
1650237989271,MATH 18,A03,083745,Staff,23,0,30,7
1650237989271,MATH 18,A04,083746,Staff,27,0,30,3
1650237989271,MATH 18,B01,083748,Staff,0,10,30,30
1650237989271,MATH 18,B02,083749,Staff,0,8,30,30
1650237989271,MATH 18,B03,083750,Staff,0,7,30,30
1650237989271,MATH 18,B04,083751,Staff,0,8,30,30
1650237995299,MATH 20A,A01,083754,Staff,26,0,40,14
1650238001334,MATH 20B,A01,083756,Staff,1,6,30,29
1650238001334,MATH 20B,A02,083757,Staff,0,6,30,30
1650238007367,MATH 20C,A01,083760,Staff,0,12,30,30
1650238007367,MATH 20C,A02,083761,Staff,0,13,30,30
1650238007367,MATH 20C,B01,083762,Staff,14,0,30,16
1650238007367,MATH 20C,B02,083763,Staff,28,0,30,2
1650238013390,MATH 20D,A01,083765,Staff,1,2,30,29
1650238013390,MATH 20D,A02,083766,Staff,8,0,30,22
1650238013390,MATH 20D,A03,083767,Staff,28,0,30,2
1650238019430,MATH 20E,A01,083771,Staff,8,0,30,22
1650238019430,MATH 20E,A02,083772,Staff,21,0,30,9
1650238019430,MATH 20E,B01,083773,Staff,0,0,30,30
1650238019430,MATH 20E,B02,083774,Staff,12,0,30,18
1650238025455,MATH 103A,A01,083777,Staff,0,9,30,30
1650238025455,MATH 103A,A02,083778,Staff,0,10,30,30
1650238025455,MATH 103A,B01,083779,Staff,0,10,30,30
1650238025455,MATH 103A,B02,083780,Staff,0,9,30,30
1650238031496,MATH 105,A01,085443,Staff,0,17,30,30
1650238037522,MATH 109,A01,083213,Anzaldo; Leesa B,0,3,30,30
1650238037522,MATH 109,A02,083214,Anzaldo; Leesa B,0,6,30,30
1650238037522,MATH 109,B01,083215,Anzaldo; Leesa B,0,4,30,30
1650238037522,MATH 109,B02,083216,Anzaldo; Leesa B,1,4,30,29
1650238043547,MATH 142A,A01,083219,Chow; Bennett,0,12,30,30
1650238043547,MATH 142A,A02,083220,Chow; Bennett,0,11,30,30
1650238043547,MATH 142A,B01,083221,Chow; Bennett,0,11,30,30
1650238043547,MATH 142A,B02,083222,Chow; Bennett,0,12,30,30
1650238049580,MATH 193A,A01,083224,Staff,0,5,30,30
1650238049580,MATH 193A,A02,083225,Staff,0,4,30,30
1650238049580,MATH 193A,A03,083781,Staff,0,2,30,30
1650238049580,MATH 193A,A04,083782,Staff,0,1,30,30
1650238055604,MATH 197,001,091859,McAuley; Julian John,9998,0,9999,1
1650238061655,COGS 9,A01,083615,Staff,0,14,60,60
1650238067686,COGS 11,A01,083617,Boyle; Mary E. T.,24,0,40,16
1650238073712,COGS 13,A01,083071,Staff,0,30,40,40
1650238079737,COGS 14A,A01,092681,Staff,1,13,100,99
1650238085761,COGS 14B,A01,083073,Cheng; Tzu-Han,0,7,50,50
1650238091788,COGS 17,A01,092677,Staff,33,0,75,42
1650238097812,COGS 100,A01,083619,Staff,1,21,60,59
1650238103840,COGS 101A,A01,083621,Davis; Joshua Daniel,0,21,60,60
1650238109866,COGS 101B,A01,091572,Staff,5,0,60,55
1650238115888,COGS 101C,A01,083625,Delgado; Tania,20,0,30,10
1650238121912,COGS 107A,A01,083627,Boyle; Mary E. T.,1,7,60,59
1650238127939,COGS 118A,A01,083075,Staff,15,0,60,45
1650238133966,CSE 3,A50,083646,Miranda; Gregory Joseph,22,0,38,16
1650238133966,CSE 3,A51,083647,Miranda; Gregory Joseph,37,0,37,0
1650238139993,CSE 8A,A50,083650,Miranda; Gregory Joseph,0,18,40,40
1650238146031,CSE 11,A01,083080,Cao; Yingjun,0,68,40,40
1650238152055,CSE 12,A01,083652,Staff,0,9,100,100
1650238158079,CSE 15L,A01,083654,Staff,0,1,50,50
1650238158079,CSE 15L,A02,083655,Staff,5,0,50,45
1650238164106,CSE 20,A01,083657,Staff,53,0,80,27
1650238170134,CSE 30,A01,083084,Eldon; John,0,70,40,40
1650238176162,CSE 100,A01,083659,Cao; Yingjun,0,63,50,50
1650238182186,CSE 134B,A01,083661,Powell; Thomas Allan,0,27,65,65
1650238188213,CSE 140,A01,083663,Staff,1,0,75,74
1650238194237,CSE 140L,A01,083088,Eldon; John,0,4,75,75
1650238200260,CSE 175,A01,083665,Kumar; Rakesh,8,0,25,17
1650238206282,CSE 190,A00,092507,Dubnov; Shlomo,14,0,20,6
1650238212304,ECE 45,A01,083139,Staff,0,13,40,40
1650238218327,ECE 65,A50,083695,Staff,0,5,30,30
1650238224354,ECE 109,A01,091882,Touri; Behrouz,47,0,70,23
1650238230379,ECE 180,A00,083140,Abi Samra; Nicholas Camill,24,0,30,6
1650238230379,ECE 180,B00,083141,Abi Samra; Nicholas Camill,7,0,30,23
1650238236402,MATH 10A,A01,083735,Patchell; Gregory David,11,0,30,19
1650238236402,MATH 10A,A02,083736,Patchell; Gregory David,28,0,30,2
1650238236402,MATH 10A,A03,083737,Patchell; Gregory David,26,0,30,4
1650238242428,MATH 10B,A01,083207,Staff,0,6,30,30
1650238242428,MATH 10B,A02,083208,Staff,0,5,30,30
1650238242428,MATH 10B,B01,083739,Staff,17,0,30,13
1650238242428,MATH 10B,B02,083740,Staff,29,0,30,1
1650238248452,MATH 18,A01,083743,Staff,7,0,30,23
1650238248452,MATH 18,A02,083744,Staff,28,0,30,2
1650238248452,MATH 18,A03,083745,Staff,23,0,30,7
1650238248452,MATH 18,A04,083746,Staff,27,0,30,3
1650238248452,MATH 18,B01,083748,Staff,0,10,30,30
1650238248452,MATH 18,B02,083749,Staff,0,8,30,30
1650238248452,MATH 18,B03,083750,Staff,0,7,30,30
1650238248452,MATH 18,B04,083751,Staff,0,8,30,30
1650238254477,MATH 20A,A01,083754,Staff,26,0,40,14
1650238260501,MATH 20B,A01,083756,Staff,1,6,30,29
1650238260501,MATH 20B,A02,083757,Staff,0,6,30,30
1650238266529,MATH 20C,A01,083760,Staff,0,12,30,30
1650238266529,MATH 20C,A02,083761,Staff,0,13,30,30
1650238266529,MATH 20C,B01,083762,Staff,14,0,30,16
1650238266529,MATH 20C,B02,083763,Staff,28,0,30,2
1650238272557,MATH 20D,A01,083765,Staff,1,2,30,29
1650238272557,MATH 20D,A02,083766,Staff,8,0,30,22
1650238272557,MATH 20D,A03,083767,Staff,28,0,30,2
1650238278583,MATH 20E,A01,083771,Staff,8,0,30,22
1650238278583,MATH 20E,A02,083772,Staff,21,0,30,9
1650238278583,MATH 20E,B01,083773,Staff,0,0,30,30
1650238278583,MATH 20E,B02,083774,Staff,12,0,30,18
1650238284607,MATH 103A,A01,083777,Staff,0,9,30,30
1650238284607,MATH 103A,A02,083778,Staff,0,10,30,30
1650238284607,MATH 103A,B01,083779,Staff,0,10,30,30
1650238284607,MATH 103A,B02,083780,Staff,0,9,30,30
1650238290631,MATH 105,A01,085443,Staff,0,17,30,30
1650238296655,MATH 109,A01,083213,Anzaldo; Leesa B,0,3,30,30
1650238296655,MATH 109,A02,083214,Anzaldo; Leesa B,0,6,30,30
1650238296655,MATH 109,B01,083215,Anzaldo; Leesa B,0,4,30,30
1650238296655,MATH 109,B02,083216,Anzaldo; Leesa B,1,4,30,29
1650238302682,MATH 142A,A01,083219,Chow; Bennett,0,12,30,30
1650238302682,MATH 142A,A02,083220,Chow; Bennett,0,11,30,30
1650238302682,MATH 142A,B01,083221,Chow; Bennett,0,11,30,30
1650238302682,MATH 142A,B02,083222,Chow; Bennett,0,12,30,30
1650238308707,MATH 193A,A01,083224,Staff,0,5,30,30
1650238308707,MATH 193A,A02,083225,Staff,0,4,30,30
1650238308707,MATH 193A,A03,083781,Staff,0,2,30,30
1650238308707,MATH 193A,A04,083782,Staff,0,1,30,30
1650238314730,MATH 197,001,091859,McAuley; Julian John,9998,0,9999,1
1650238320804,COGS 9,A01,083615,Staff,0,14,60,60
1650238326826,COGS 11,A01,083617,Boyle; Mary E. T.,24,0,40,16
1650238332851,COGS 13,A01,083071,Staff,0,30,40,40
1650238338876,COGS 14A,A01,092681,Staff,1,13,100,99
1650238344898,COGS 14B,A01,083073,Cheng; Tzu-Han,0,7,50,50
1650238350923,COGS 17,A01,092677,Staff,33,0,75,42
1650238356951,COGS 100,A01,083619,Staff,1,21,60,59
1650238362979,COGS 101A,A01,083621,Davis; Joshua Daniel,0,21,60,60
1650238369002,COGS 101B,A01,091572,Staff,5,0,60,55
1650238375037,COGS 101C,A01,083625,Delgado; Tania,20,0,30,10
1650238381061,COGS 107A,A01,083627,Boyle; Mary E. T.,1,7,60,59
1650238387095,COGS 118A,A01,083075,Staff,15,0,60,45
1650238393121,CSE 3,A50,083646,Miranda; Gregory Joseph,22,0,38,16
1650238393121,CSE 3,A51,083647,Miranda; Gregory Joseph,37,0,37,0
1650238399145,CSE 8A,A50,083650,Miranda; Gregory Joseph,0,18,40,40
1650238405169,CSE 11,A01,083080,Cao; Yingjun,0,68,40,40
1650238411195,CSE 12,A01,083652,Staff,0,9,100,100
1650238417219,CSE 15L,A01,083654,Staff,0,1,50,50
1650238417219,CSE 15L,A02,083655,Staff,5,0,50,45
1650238423245,CSE 20,A01,083657,Staff,53,0,80,27
1650238429270,CSE 30,A01,083084,Eldon; John,0,70,40,40
1650238435291,CSE 100,A01,083659,Cao; Yingjun,0,63,50,50
1650238441315,CSE 134B,A01,083661,Powell; Thomas Allan,0,27,65,65
1650238447340,CSE 140,A01,083663,Staff,1,0,75,74
1650238453363,CSE 140L,A01,083088,Eldon; John,0,4,75,75
1650238459388,CSE 175,A01,083665,Kumar; Rakesh,8,0,25,17
1650238465413,CSE 190,A00,092507,Dubnov; Shlomo,14,0,20,6
1650238471437,ECE 45,A01,083139,Staff,0,13,40,40
1650238477462,ECE 65,A50,083695,Staff,0,5,30,30
1650238483487,ECE 109,A01,091882,Touri; Behrouz,47,0,70,23
1650238489521,ECE 180,A00,083140,Abi Samra; Nicholas Camill,24,0,30,6
1650238489521,ECE 180,B00,083141,Abi Samra; Nicholas Camill,7,0,30,23
1650238495545,MATH 10A,A01,083735,Patchell; Gregory David,11,0,30,19
1650238495545,MATH 10A,A02,083736,Patchell; Gregory David,28,0,30,2
1650238495545,MATH 10A,A03,083737,Patchell; Gregory David,26,0,30,4
1650238501569,MATH 10B,A01,083207,Staff,0,6,30,30
1650238501569,MATH 10B,A02,083208,Staff,0,5,30,30
1650238501569,MATH 10B,B01,083739,Staff,17,0,30,13
1650238501569,MATH 10B,B02,083740,Staff,29,0,30,1
1650238507598,MATH 18,A01,083743,Staff,7,0,30,23
1650238507598,MATH 18,A02,083744,Staff,28,0,30,2
1650238507598,MATH 18,A03,083745,Staff,23,0,30,7
1650238507598,MATH 18,A04,083746,Staff,27,0,30,3
1650238507598,MATH 18,B01,083748,Staff,0,10,30,30
1650238507598,MATH 18,B02,083749,Staff,0,8,30,30
1650238507598,MATH 18,B03,083750,Staff,0,7,30,30
1650238507598,MATH 18,B04,083751,Staff,0,8,30,30
1650238513624,MATH 20A,A01,083754,Staff,26,0,40,14
1650238519646,MATH 20B,A01,083756,Staff,1,6,30,29
1650238519646,MATH 20B,A02,083757,Staff,0,6,30,30
1650238525745,MATH 20C,A01,083760,Staff,0,12,30,30
1650238525745,MATH 20C,A02,083761,Staff,0,13,30,30
1650238525745,MATH 20C,B01,083762,Staff,14,0,30,16
1650238525745,MATH 20C,B02,083763,Staff,28,0,30,2
1650238531769,MATH 20D,A01,083765,Staff,1,2,30,29
1650238531769,MATH 20D,A02,083766,Staff,8,0,30,22
1650238531769,MATH 20D,A03,083767,Staff,28,0,30,2
1650238537795,MATH 20E,A01,083771,Staff,8,0,30,22
1650238537795,MATH 20E,A02,083772,Staff,21,0,30,9
1650238537795,MATH 20E,B01,083773,Staff,0,0,30,30
1650238537795,MATH 20E,B02,083774,Staff,12,0,30,18
1650238543819,MATH 103A,A01,083777,Staff,0,9,30,30
1650238543819,MATH 103A,A02,083778,Staff,0,10,30,30
1650238543819,MATH 103A,B01,083779,Staff,0,10,30,30
1650238543819,MATH 103A,B02,083780,Staff,0,9,30,30
1650238549842,MATH 105,A01,085443,Staff,0,17,30,30
1650238555866,MATH 109,A01,083213,Anzaldo; Leesa B,0,3,30,30
1650238555866,MATH 109,A02,083214,Anzaldo; Leesa B,0,6,30,30
1650238555866,MATH 109,B01,083215,Anzaldo; Leesa B,0,4,30,30
1650238555866,MATH 109,B02,083216,Anzaldo; Leesa B,1,4,30,29
1650238561892,MATH 142A,A01,083219,Chow; Bennett,0,12,30,30
1650238561892,MATH 142A,A02,083220,Chow; Bennett,0,11,30,30
1650238561892,MATH 142A,B01,083221,Chow; Bennett,0,11,30,30
1650238561892,MATH 142A,B02,083222,Chow; Bennett,0,12,30,30
1650238567922,MATH 193A,A01,083224,Staff,0,5,30,30
1650238567922,MATH 193A,A02,083225,Staff,0,4,30,30
1650238567922,MATH 193A,A03,083781,Staff,0,2,30,30
1650238567922,MATH 193A,A04,083782,Staff,0,1,30,30
1650238573948,MATH 197,001,091859,McAuley; Julian John,9998,0,9999,1
1650238579998,COGS 9,A01,083615,Staff,0,14,60,60
1650238586026,COGS 11,A01,083617,Boyle; Mary E. T.,24,0,40,16
1650238592052,COGS 13,A01,083071,Staff,0,30,40,40
1650238598077,COGS 14A,A01,092681,Staff,1,13,100,99
1650238604105,COGS 14B,A01,083073,Cheng; Tzu-Han,0,8,50,50
1650238610131,COGS 17,A01,092677,Staff,33,0,75,42
1650238616159,COGS 100,A01,083619,Staff,1,21,60,59
1650238622181,COGS 101A,A01,083621,Davis; Joshua Daniel,0,21,60,60
1650238628204,COGS 101B,A01,091572,Staff,5,0,60,55
1650238634233,COGS 101C,A01,083625,Delgado; Tania,20,0,30,10
1650238640256,COGS 107A,A01,083627,Boyle; Mary E. T.,1,7,60,59
1650238646278,COGS 118A,A01,083075,Staff,15,0,60,45
1650238652307,CSE 3,A50,083646,Miranda; Gregory Joseph,22,0,38,16
1650238652307,CSE 3,A51,083647,Miranda; Gregory Joseph,37,0,37,0
1650238658332,CSE 8A,A50,083650,Miranda; Gregory Joseph,0,18,40,40
1650238664355,CSE 11,A01,083080,Cao; Yingjun,0,68,40,40
1650238670377,CSE 12,A01,083652,Staff,0,9,100,100
1650238676404,CSE 15L,A01,083654,Staff,0,1,50,50
1650238676404,CSE 15L,A02,083655,Staff,5,0,50,45
1650238682428,CSE 20,A01,083657,Staff,53,0,80,27
1650238688450,CSE 30,A01,083084,Eldon; John,0,70,40,40
1650238694472,CSE 100,A01,083659,Cao; Yingjun,0,63,50,50
1650238700499,CSE 134B,A01,083661,Powell; Thomas Allan,0,27,65,65
1650238706522,CSE 140,A01,083663,Staff,1,0,75,74
1650238712549,CSE 140L,A01,083088,Eldon; John,0,4,75,75
1650238718572,CSE 175,A01,083665,Kumar; Rakesh,8,0,25,17
1650238724594,CSE 190,A00,092507,Dubnov; Shlomo,14,0,20,6
1650238730620,ECE 45,A01,083139,Staff,0,13,40,40
1650238736654,ECE 65,A50,083695,Staff,0,5,30,30
1650238742677,ECE 109,A01,091882,Touri; Behrouz,47,0,70,23
1650238748713,ECE 180,A00,083140,Abi Samra; Nicholas Camill,24,0,30,6
1650238748713,ECE 180,B00,083141,Abi Samra; Nicholas Camill,7,0,30,23
1650238754737,MATH 10A,A01,083735,Patchell; Gregory David,11,0,30,19
1650238754737,MATH 10A,A02,083736,Patchell; Gregory David,28,0,30,2
1650238754737,MATH 10A,A03,083737,Patchell; Gregory David,26,0,30,4
1650238760768,MATH 10B,A01,083207,Staff,0,6,30,30
1650238760768,MATH 10B,A02,083208,Staff,0,5,30,30
1650238760768,MATH 10B,B01,083739,Staff,17,0,30,13
1650238760768,MATH 10B,B02,083740,Staff,29,0,30,1
1650238766796,MATH 18,A01,083743,Staff,7,0,30,23
1650238766796,MATH 18,A02,083744,Staff,28,0,30,2
1650238766796,MATH 18,A03,083745,Staff,23,0,30,7
1650238766796,MATH 18,A04,083746,Staff,27,0,30,3
1650238766796,MATH 18,B01,083748,Staff,0,10,30,30
1650238766796,MATH 18,B02,083749,Staff,0,8,30,30
1650238766796,MATH 18,B03,083750,Staff,0,7,30,30
1650238766796,MATH 18,B04,083751,Staff,0,8,30,30
1650238772821,MATH 20A,A01,083754,Staff,26,0,40,14
1650238778854,MATH 20B,A01,083756,Staff,1,6,30,29
1650238778854,MATH 20B,A02,083757,Staff,0,6,30,30
1650238784879,MATH 20C,A01,083760,Staff,0,12,30,30
1650238784879,MATH 20C,A02,083761,Staff,0,13,30,30
1650238784879,MATH 20C,B01,083762,Staff,14,0,30,16
1650238784879,MATH 20C,B02,083763,Staff,28,0,30,2
1650238790905,MATH 20D,A01,083765,Staff,1,2,30,29
1650238790905,MATH 20D,A02,083766,Staff,8,0,30,22
1650238790905,MATH 20D,A03,083767,Staff,28,0,30,2
1650238796931,MATH 20E,A01,083771,Staff,8,0,30,22
1650238796931,MATH 20E,A02,083772,Staff,21,0,30,9
1650238796931,MATH 20E,B01,083773,Staff,0,0,30,30
1650238796931,MATH 20E,B02,083774,Staff,12,0,30,18
1650238802958,MATH 103A,A01,083777,Staff,0,9,30,30
1650238802958,MATH 103A,A02,083778,Staff,0,10,30,30
1650238802958,MATH 103A,B01,083779,Staff,0,10,30,30
1650238802958,MATH 103A,B02,083780,Staff,0,9,30,30
1650238808983,MATH 105,A01,085443,Staff,0,17,30,30
1650238815007,MATH 109,A01,083213,Anzaldo; Leesa B,0,3,30,30
1650238815007,MATH 109,A02,083214,Anzaldo; Leesa B,0,6,30,30
1650238815007,MATH 109,B01,083215,Anzaldo; Leesa B,0,4,30,30
1650238815007,MATH 109,B02,083216,Anzaldo; Leesa B,1,4,30,29
1650238821032,MATH 142A,A01,083219,Chow; Bennett,0,12,30,30
1650238821032,MATH 142A,A02,083220,Chow; Bennett,0,11,30,30
1650238821032,MATH 142A,B01,083221,Chow; Bennett,0,11,30,30
1650238821032,MATH 142A,B02,083222,Chow; Bennett,0,12,30,30
1650238827070,MATH 193A,A01,083224,Staff,0,5,30,30
1650238827070,MATH 193A,A02,083225,Staff,0,4,30,30
1650238827070,MATH 193A,A03,083781,Staff,0,2,30,30
1650238827070,MATH 193A,A04,083782,Staff,0,1,30,30
1650238833093,MATH 197,001,091859,McAuley; Julian John,9998,0,9999,1
1650238839152,COGS 9,A01,083615,Staff,0,14,60,60
1650238845179,COGS 11,A01,083617,Boyle; Mary E. T.,24,0,40,16
1650238851213,COGS 13,A01,083071,Staff,0,30,40,40
1650238857236,COGS 14A,A01,092681,Staff,1,13,100,99
1650238863262,COGS 14B,A01,083073,Cheng; Tzu-Han,0,8,50,50
1650238869289,COGS 17,A01,092677,Staff,33,0,75,42
1650238875312,COGS 100,A01,083619,Staff,1,21,60,59
1650238881336,COGS 101A,A01,083621,Davis; Joshua Daniel,0,21,60,60
1650238887360,COGS 101B,A01,091572,Staff,5,0,60,55
1650238893391,COGS 101C,A01,083625,Delgado; Tania,20,0,30,10
1650238899422,COGS 107A,A01,083627,Boyle; Mary E. T.,1,7,60,59
1650238905447,COGS 118A,A01,083075,Staff,15,0,60,45
1650238911470,CSE 3,A50,083646,Miranda; Gregory Joseph,22,0,38,16
1650238911470,CSE 3,A51,083647,Miranda; Gregory Joseph,37,0,37,0
1650238917493,CSE 8A,A50,083650,Miranda; Gregory Joseph,0,18,40,40
1650238923514,CSE 11,A01,083080,Cao; Yingjun,0,68,40,40
1650238929540,CSE 12,A01,083652,Staff,0,9,100,100
1650238935571,CSE 15L,A01,083654,Staff,0,1,50,50
1650238935571,CSE 15L,A02,083655,Staff,5,0,50,45
1650238941603,CSE 20,A01,083657,Staff,53,0,80,27
1650238947626,CSE 30,A01,083084,Eldon; John,0,70,40,40
1650238953649,CSE 100,A01,083659,Cao; Yingjun,0,63,50,50
1650238959676,CSE 134B,A01,083661,Powell; Thomas Allan,0,27,65,65
1650238965700,CSE 140,A01,083663,Staff,1,0,75,74
1650238971724,CSE 140L,A01,083088,Eldon; John,0,4,75,75
1650238977751,CSE 175,A01,083665,Kumar; Rakesh,8,0,25,17
1650238983783,CSE 190,A00,092507,Dubnov; Shlomo,14,0,20,6
1650238989806,ECE 45,A01,083139,Staff,0,13,40,40
1650238995829,ECE 65,A50,083695,Staff,0,5,30,30
1650239001855,ECE 109,A01,091882,Touri; Behrouz,47,0,70,23
1650239007879,ECE 180,A00,083140,Abi Samra; Nicholas Camill,24,0,30,6
1650239007879,ECE 180,B00,083141,Abi Samra; Nicholas Camill,7,0,30,23
1650239013903,MATH 10A,A01,083735,Patchell; Gregory David,11,0,30,19
1650239013903,MATH 10A,A02,083736,Patchell; Gregory David,28,0,30,2
1650239013903,MATH 10A,A03,083737,Patchell; Gregory David,26,0,30,4
1650239019931,MATH 10B,A01,083207,Staff,0,6,30,30
1650239019931,MATH 10B,A02,083208,Staff,0,5,30,30
1650239019931,MATH 10B,B01,083739,Staff,17,0,30,13
1650239019931,MATH 10B,B02,083740,Staff,29,0,30,1
1650239025955,MATH 18,A01,083743,Staff,7,0,30,23
1650239025955,MATH 18,A02,083744,Staff,28,0,30,2
1650239025955,MATH 18,A03,083745,Staff,23,0,30,7
1650239025955,MATH 18,A04,083746,Staff,27,0,30,3
1650239025955,MATH 18,B01,083748,Staff,0,10,30,30
1650239025955,MATH 18,B02,083749,Staff,0,8,30,30
1650239025955,MATH 18,B03,083750,Staff,0,7,30,30
1650239025955,MATH 18,B04,083751,Staff,0,8,30,30
1650239031978,MATH 20A,A01,083754,Staff,26,0,40,14
1650239038004,MATH 20B,A01,083756,Staff,1,6,30,29
1650239038004,MATH 20B,A02,083757,Staff,0,6,30,30
1650239044036,MATH 20C,A01,083760,Staff,0,12,30,30
1650239044036,MATH 20C,A02,083761,Staff,0,13,30,30
1650239044036,MATH 20C,B01,083762,Staff,14,0,30,16
1650239044036,MATH 20C,B02,083763,Staff,28,0,30,2
1650239050071,MATH 20D,A01,083765,Staff,1,2,30,29
1650239050071,MATH 20D,A02,083766,Staff,8,0,30,22
1650239050071,MATH 20D,A03,083767,Staff,28,0,30,2
1650239056097,MATH 20E,A01,083771,Staff,8,0,30,22
1650239056097,MATH 20E,A02,083772,Staff,21,0,30,9
1650239056097,MATH 20E,B01,083773,Staff,0,0,30,30
1650239056097,MATH 20E,B02,083774,Staff,12,0,30,18
1650239062122,MATH 103A,A01,083777,Staff,0,9,30,30
1650239062122,MATH 103A,A02,083778,Staff,0,10,30,30
1650239062122,MATH 103A,B01,083779,Staff,0,10,30,30
1650239062122,MATH 103A,B02,083780,Staff,0,9,30,30
1650239068147,MATH 105,A01,085443,Staff,0,17,30,30
1650239074178,MATH 109,A01,083213,Anzaldo; Leesa B,0,3,30,30
1650239074178,MATH 109,A02,083214,Anzaldo; Leesa B,0,6,30,30
1650239074178,MATH 109,B01,083215,Anzaldo; Leesa B,0,4,30,30
1650239074178,MATH 109,B02,083216,Anzaldo; Leesa B,1,4,30,29
1650239080207,MATH 142A,A01,083219,Chow; Bennett,0,12,30,30
1650239080207,MATH 142A,A02,083220,Chow; Bennett,0,11,30,30
1650239080207,MATH 142A,B01,083221,Chow; Bennett,0,11,30,30
1650239080207,MATH 142A,B02,083222,Chow; Bennett,0,12,30,30
1650239086230,MATH 193A,A01,083224,Staff,0,5,30,30
1650239086230,MATH 193A,A02,083225,Staff,0,4,30,30
1650239086230,MATH 193A,A03,083781,Staff,0,2,30,30
1650239086230,MATH 193A,A04,083782,Staff,0,1,30,30
1650239092262,MATH 197,001,091859,McAuley; Julian John,9998,0,9999,1
1650239098322,COGS 9,A01,083615,Staff,0,14,60,60
1650239104355,COGS 11,A01,083617,Boyle; Mary E. T.,24,0,40,16
1650239110378,COGS 13,A01,083071,Staff,0,30,40,40
1650239116494,COGS 14A,A01,092681,Staff,1,13,100,99
1650239122520,COGS 14B,A01,083073,Cheng; Tzu-Han,0,8,50,50
1650239128548,COGS 17,A01,092677,Staff,33,0,75,42
1650239134571,COGS 100,A01,083619,Staff,1,21,60,59
1650239140594,COGS 101A,A01,083621,Davis; Joshua Daniel,0,21,60,60
1650239146617,COGS 101B,A01,091572,Staff,5,0,60,55
1650239152643,COGS 101C,A01,083625,Delgado; Tania,20,0,30,10
1650239158667,COGS 107A,A01,083627,Boyle; Mary E. T.,1,7,60,59
1650239164699,COGS 118A,A01,083075,Staff,15,0,60,45
1650239170726,CSE 3,A50,083646,Miranda; Gregory Joseph,22,0,38,16
1650239170726,CSE 3,A51,083647,Miranda; Gregory Joseph,37,0,37,0
1650239176752,CSE 8A,A50,083650,Miranda; Gregory Joseph,0,18,40,40
1650239182775,CSE 11,A01,083080,Cao; Yingjun,0,68,40,40
1650239188806,CSE 12,A01,083652,Staff,0,9,100,100
1650239194830,CSE 15L,A01,083654,Staff,0,1,50,50
1650239194830,CSE 15L,A02,083655,Staff,5,0,50,45
1650239200854,CSE 20,A01,083657,Staff,53,0,80,27
1650239206880,CSE 30,A01,083084,Eldon; John,0,70,40,40
1650239212902,CSE 100,A01,083659,Cao; Yingjun,0,63,50,50
1650239218929,CSE 134B,A01,083661,Powell; Thomas Allan,0,27,65,65
1650239224954,CSE 140,A01,083663,Staff,1,0,75,74
1650239230982,CSE 140L,A01,083088,Eldon; John,0,4,75,75
1650239237005,CSE 175,A01,083665,Kumar; Rakesh,8,0,25,17
1650239243032,CSE 190,A00,092507,Dubnov; Shlomo,14,0,20,6
1650239249055,ECE 45,A01,083139,Staff,0,13,40,40
1650239255079,ECE 65,A50,083695,Staff,0,5,30,30
1650239261105,ECE 109,A01,091882,Touri; Behrouz,47,0,70,23
1650239267137,ECE 180,A00,083140,Abi Samra; Nicholas Camill,24,0,30,6
1650239267137,ECE 180,B00,083141,Abi Samra; Nicholas Camill,7,0,30,23
1650239273160,MATH 10A,A01,083735,Patchell; Gregory David,11,0,30,19
1650239273160,MATH 10A,A02,083736,Patchell; Gregory David,28,0,30,2
1650239273160,MATH 10A,A03,083737,Patchell; Gregory David,26,0,30,4
1650239279187,MATH 10B,A01,083207,Staff,0,6,30,30
1650239279187,MATH 10B,A02,083208,Staff,0,5,30,30
1650239279187,MATH 10B,B01,083739,Staff,17,0,30,13
1650239279187,MATH 10B,B02,083740,Staff,29,0,30,1
1650239285212,MATH 18,A01,083743,Staff,7,0,30,23
1650239285212,MATH 18,A02,083744,Staff,28,0,30,2
1650239285212,MATH 18,A03,083745,Staff,23,0,30,7
1650239285212,MATH 18,A04,083746,Staff,27,0,30,3
1650239285212,MATH 18,B01,083748,Staff,0,10,30,30
1650239285212,MATH 18,B02,083749,Staff,0,8,30,30
1650239285212,MATH 18,B03,083750,Staff,0,7,30,30
1650239285212,MATH 18,B04,083751,Staff,0,8,30,30
1650239291234,MATH 20A,A01,083754,Staff,26,0,40,14
1650239297261,MATH 20B,A01,083756,Staff,1,6,30,29
1650239297261,MATH 20B,A02,083757,Staff,0,6,30,30
1650239303283,MATH 20C,A01,083760,Staff,0,12,30,30
1650239303283,MATH 20C,A02,083761,Staff,0,13,30,30
1650239303283,MATH 20C,B01,083762,Staff,14,0,30,16
1650239303283,MATH 20C,B02,083763,Staff,28,0,30,2
1650239309309,MATH 20D,A01,083765,Staff,1,2,30,29
1650239309309,MATH 20D,A02,083766,Staff,8,0,30,22
1650239309309,MATH 20D,A03,083767,Staff,28,0,30,2
1650239315344,MATH 20E,A01,083771,Staff,8,0,30,22
1650239315344,MATH 20E,A02,083772,Staff,21,0,30,9
1650239315344,MATH 20E,B01,083773,Staff,0,0,30,30
1650239315344,MATH 20E,B02,083774,Staff,12,0,30,18
1650239321366,MATH 103A,A01,083777,Staff,0,9,30,30
1650239321366,MATH 103A,A02,083778,Staff,0,10,30,30
1650239321366,MATH 103A,B01,083779,Staff,0,10,30,30
1650239321366,MATH 103A,B02,083780,Staff,0,9,30,30
1650239327392,MATH 105,A01,085443,Staff,0,17,30,30
1650239333417,MATH 109,A01,083213,Anzaldo; Leesa B,0,3,30,30
1650239333417,MATH 109,A02,083214,Anzaldo; Leesa B,0,6,30,30
1650239333417,MATH 109,B01,083215,Anzaldo; Leesa B,0,4,30,30
1650239333417,MATH 109,B02,083216,Anzaldo; Leesa B,1,4,30,29
1650239339440,MATH 142A,A01,083219,Chow; Bennett,0,12,30,30
1650239339440,MATH 142A,A02,083220,Chow; Bennett,0,11,30,30
1650239339440,MATH 142A,B01,083221,Chow; Bennett,0,11,30,30
1650239339440,MATH 142A,B02,083222,Chow; Bennett,0,12,30,30
1650239345472,MATH 193A,A01,083224,Staff,0,5,30,30
1650239345472,MATH 193A,A02,083225,Staff,0,4,30,30
1650239345472,MATH 193A,A03,083781,Staff,0,2,30,30
1650239345472,MATH 193A,A04,083782,Staff,0,1,30,30
1650239351495,MATH 197,001,091859,McAuley; Julian John,9998,0,9999,1
1650239357559,COGS 9,A01,083615,Staff,0,14,60,60
1650239363594,COGS 11,A01,083617,Boyle; Mary E. T.,24,0,40,16
1650239369619,COGS 13,A01,083071,Staff,0,30,40,40
1650239375645,COGS 14A,A01,092681,Staff,1,13,100,99
1650239381670,COGS 14B,A01,083073,Cheng; Tzu-Han,0,8,50,50
1650239387697,COGS 17,A01,092677,Staff,33,0,75,42
1650239393720,COGS 100,A01,083619,Staff,1,21,60,59
1650239399742,COGS 101A,A01,083621,Davis; Joshua Daniel,0,21,60,60
1650239405766,COGS 101B,A01,091572,Staff,5,0,60,55
1650239411790,COGS 101C,A01,083625,Delgado; Tania,20,0,30,10
1650239417813,COGS 107A,A01,083627,Boyle; Mary E. T.,1,7,60,59
1650239423836,COGS 118A,A01,083075,Staff,15,0,60,45
1650239429863,CSE 3,A50,083646,Miranda; Gregory Joseph,22,0,38,16
1650239429863,CSE 3,A51,083647,Miranda; Gregory Joseph,37,0,37,0
1650239435885,CSE 8A,A50,083650,Miranda; Gregory Joseph,0,18,40,40
1650239441910,CSE 11,A01,083080,Cao; Yingjun,0,68,40,40
1650239447933,CSE 12,A01,083652,Staff,0,9,100,100
1650239453954,CSE 15L,A01,083654,Staff,0,1,50,50
1650239453954,CSE 15L,A02,083655,Staff,5,0,50,45
1650239459977,CSE 20,A01,083657,Staff,53,0,80,27
1650239466000,CSE 30,A01,083084,Eldon; John,0,70,40,40
1650239472026,CSE 100,A01,083659,Cao; Yingjun,0,63,50,50
1650239478048,CSE 134B,A01,083661,Powell; Thomas Allan,0,27,65,65
1650239484071,CSE 140,A01,083663,Staff,1,0,75,74
1650239490105,CSE 140L,A01,083088,Eldon; John,0,4,75,75
1650239496135,CSE 175,A01,083665,Kumar; Rakesh,8,0,25,17
1650239502172,CSE 190,A00,092507,Dubnov; Shlomo,14,0,20,6
1650239508200,ECE 45,A01,083139,Staff,0,13,40,40
1650239514222,ECE 65,A50,083695,Staff,0,5,30,30
1650239520246,ECE 109,A01,091882,Touri; Behrouz,47,0,70,23
1650239526273,ECE 180,A00,083140,Abi Samra; Nicholas Camill,24,0,30,6
1650239526273,ECE 180,B00,083141,Abi Samra; Nicholas Camill,7,0,30,23
1650239532296,MATH 10A,A01,083735,Patchell; Gregory David,11,0,30,19
1650239532296,MATH 10A,A02,083736,Patchell; Gregory David,28,0,30,2
1650239532296,MATH 10A,A03,083737,Patchell; Gregory David,26,0,30,4
1650239538335,MATH 10B,A01,083207,Staff,0,6,30,30
1650239538335,MATH 10B,A02,083208,Staff,0,5,30,30
1650239538335,MATH 10B,B01,083739,Staff,17,0,30,13
1650239538335,MATH 10B,B02,083740,Staff,29,0,30,1
1650239544379,MATH 18,A01,083743,Staff,7,0,30,23
1650239544379,MATH 18,A02,083744,Staff,28,0,30,2
1650239544379,MATH 18,A03,083745,Staff,23,0,30,7
1650239544379,MATH 18,A04,083746,Staff,27,0,30,3
1650239544379,MATH 18,B01,083748,Staff,0,10,30,30
1650239544379,MATH 18,B02,083749,Staff,0,8,30,30
1650239544379,MATH 18,B03,083750,Staff,0,7,30,30
1650239544379,MATH 18,B04,083751,Staff,0,8,30,30
1650239550401,MATH 20A,A01,083754,Staff,26,0,40,14
1650239556422,MATH 20B,A01,083756,Staff,1,6,30,29
1650239556422,MATH 20B,A02,083757,Staff,0,6,30,30
1650239562456,MATH 20C,A01,083760,Staff,0,12,30,30
1650239562456,MATH 20C,A02,083761,Staff,0,13,30,30
1650239562456,MATH 20C,B01,083762,Staff,14,0,30,16
1650239562456,MATH 20C,B02,083763,Staff,28,0,30,2
1650239568488,MATH 20D,A01,083765,Staff,1,2,30,29
1650239568488,MATH 20D,A02,083766,Staff,8,0,30,22
1650239568488,MATH 20D,A03,083767,Staff,28,0,30,2
1650239574513,MATH 20E,A01,083771,Staff,8,0,30,22
1650239574513,MATH 20E,A02,083772,Staff,21,0,30,9
1650239574513,MATH 20E,B01,083773,Staff,0,0,30,30
1650239574513,MATH 20E,B02,083774,Staff,12,0,30,18
1650239580536,MATH 103A,A01,083777,Staff,0,9,30,30
1650239580536,MATH 103A,A02,083778,Staff,0,10,30,30
1650239580536,MATH 103A,B01,083779,Staff,0,10,30,30
1650239580536,MATH 103A,B02,083780,Staff,0,9,30,30
1650239586560,MATH 105,A01,085443,Staff,0,17,30,30
1650239592590,MATH 109,A01,083213,Anzaldo; Leesa B,0,3,30,30
1650239592590,MATH 109,A02,083214,Anzaldo; Leesa B,0,6,30,30
1650239592590,MATH 109,B01,083215,Anzaldo; Leesa B,0,4,30,30
1650239592590,MATH 109,B02,083216,Anzaldo; Leesa B,1,4,30,29
1650239598632,MATH 142A,A01,083219,Chow; Bennett,0,12,30,30
1650239598632,MATH 142A,A02,083220,Chow; Bennett,0,11,30,30
1650239598632,MATH 142A,B01,083221,Chow; Bennett,0,11,30,30
1650239598632,MATH 142A,B02,083222,Chow; Bennett,0,12,30,30
1650239604655,MATH 193A,A01,083224,Staff,0,5,30,30
1650239604655,MATH 193A,A02,083225,Staff,0,4,30,30
1650239604655,MATH 193A,A03,083781,Staff,0,2,30,30
1650239604655,MATH 193A,A04,083782,Staff,0,1,30,30
1650239610688,MATH 197,001,091859,McAuley; Julian John,9998,0,9999,1
1650239616742,COGS 9,A01,083615,Staff,0,14,60,60
1650239622773,COGS 11,A01,083617,Boyle; Mary E. T.,24,0,40,16
1650239628797,COGS 13,A01,083071,Staff,0,30,40,40
1650239634820,COGS 14A,A01,092681,Staff,1,13,100,99
1650239640843,COGS 14B,A01,083073,Cheng; Tzu-Han,0,8,50,50
1650239646868,COGS 17,A01,092677,Staff,33,0,75,42
1650239652895,COGS 100,A01,083619,Staff,1,21,60,59
1650239658923,COGS 101A,A01,083621,Davis; Joshua Daniel,0,21,60,60
1650239664946,COGS 101B,A01,091572,Staff,5,0,60,55
1650239670969,COGS 101C,A01,083625,Delgado; Tania,20,0,30,10
1650239676995,COGS 107A,A01,083627,Boyle; Mary E. T.,1,7,60,59
1650239683017,COGS 118A,A01,083075,Staff,15,0,60,45
1650239689045,CSE 3,A50,083646,Miranda; Gregory Joseph,22,0,38,16
1650239689045,CSE 3,A51,083647,Miranda; Gregory Joseph,37,0,37,0
1650239695070,CSE 8A,A50,083650,Miranda; Gregory Joseph,0,18,40,40
1650239701098,CSE 11,A01,083080,Cao; Yingjun,0,68,40,40
1650239707123,CSE 12,A01,083652,Staff,0,9,100,100
1650239713233,CSE 15L,A01,083654,Staff,0,1,50,50
1650239713233,CSE 15L,A02,083655,Staff,5,0,50,45
1650239719256,CSE 20,A01,083657,Staff,53,0,80,27
1650239725283,CSE 30,A01,083084,Eldon; John,0,70,40,40
1650239731310,CSE 100,A01,083659,Cao; Yingjun,0,63,50,50
1650239737333,CSE 134B,A01,083661,Powell; Thomas Allan,0,27,65,65
1650239743356,CSE 140,A01,083663,Staff,1,0,75,74
1650239749381,CSE 140L,A01,083088,Eldon; John,0,4,75,75
1650239755406,CSE 175,A01,083665,Kumar; Rakesh,8,0,25,17
1650239761432,CSE 190,A00,092507,Dubnov; Shlomo,14,0,20,6
1650239767466,ECE 45,A01,083139,Staff,0,13,40,40
1650239773491,ECE 65,A50,083695,Staff,0,5,30,30
1650239779514,ECE 109,A01,091882,Touri; Behrouz,47,0,70,23
1650239785537,ECE 180,A00,083140,Abi Samra; Nicholas Camill,24,0,30,6
1650239785537,ECE 180,B00,083141,Abi Samra; Nicholas Camill,7,0,30,23
1650239791560,MATH 10A,A01,083735,Patchell; Gregory David,11,0,30,19
1650239791560,MATH 10A,A02,083736,Patchell; Gregory David,28,0,30,2
1650239791560,MATH 10A,A03,083737,Patchell; Gregory David,26,0,30,4
1650239797588,MATH 10B,A01,083207,Staff,0,6,30,30
1650239797588,MATH 10B,A02,083208,Staff,0,5,30,30
1650239797588,MATH 10B,B01,083739,Staff,17,0,30,13
1650239797588,MATH 10B,B02,083740,Staff,29,0,30,1
1650239803611,MATH 18,A01,083743,Staff,7,0,30,23
1650239803611,MATH 18,A02,083744,Staff,28,0,30,2
1650239803611,MATH 18,A03,083745,Staff,23,0,30,7
1650239803611,MATH 18,A04,083746,Staff,27,0,30,3
1650239803611,MATH 18,B01,083748,Staff,0,10,30,30
1650239803611,MATH 18,B02,083749,Staff,0,8,30,30
1650239803611,MATH 18,B03,083750,Staff,0,7,30,30
1650239803611,MATH 18,B04,083751,Staff,0,8,30,30
1650239809633,MATH 20A,A01,083754,Staff,26,0,40,14
1650239815656,MATH 20B,A01,083756,Staff,1,6,30,29
1650239815656,MATH 20B,A02,083757,Staff,0,6,30,30
1650239821683,MATH 20C,A01,083760,Staff,0,12,30,30
1650239821683,MATH 20C,A02,083761,Staff,0,13,30,30
1650239821683,MATH 20C,B01,083762,Staff,14,0,30,16
1650239821683,MATH 20C,B02,083763,Staff,28,0,30,2
1650239827710,MATH 20D,A01,083765,Staff,1,2,30,29
1650239827710,MATH 20D,A02,083766,Staff,8,0,30,22
1650239827710,MATH 20D,A03,083767,Staff,28,0,30,2
1650239833735,MATH 20E,A01,083771,Staff,8,0,30,22
1650239833735,MATH 20E,A02,083772,Staff,21,0,30,9
1650239833735,MATH 20E,B01,083773,Staff,0,0,30,30
1650239833735,MATH 20E,B02,083774,Staff,12,0,30,18
1650239839759,MATH 103A,A01,083777,Staff,0,9,30,30
1650239839759,MATH 103A,A02,083778,Staff,0,10,30,30
1650239839759,MATH 103A,B01,083779,Staff,0,10,30,30
1650239839759,MATH 103A,B02,083780,Staff,0,9,30,30
1650239845793,MATH 105,A01,085443,Staff,0,17,30,30
1650239851818,MATH 109,A01,083213,Anzaldo; Leesa B,0,3,30,30
1650239851818,MATH 109,A02,083214,Anzaldo; Leesa B,0,6,30,30
1650239851818,MATH 109,B01,083215,Anzaldo; Leesa B,0,4,30,30
1650239851818,MATH 109,B02,083216,Anzaldo; Leesa B,1,4,30,29
1650239857848,MATH 142A,A01,083219,Chow; Bennett,0,12,30,30
1650239857848,MATH 142A,A02,083220,Chow; Bennett,0,11,30,30
1650239857848,MATH 142A,B01,083221,Chow; Bennett,0,11,30,30
1650239857848,MATH 142A,B02,083222,Chow; Bennett,0,12,30,30
1650239863873,MATH 193A,A01,083224,Staff,0,5,30,30
1650239863873,MATH 193A,A02,083225,Staff,0,4,30,30
1650239863873,MATH 193A,A03,083781,Staff,0,2,30,30
1650239863873,MATH 193A,A04,083782,Staff,0,1,30,30
1650239869898,MATH 197,001,091859,McAuley; Julian John,9998,0,9999,1
1650239875951,COGS 9,A01,083615,Staff,0,14,60,60
1650239881974,COGS 11,A01,083617,Boyle; Mary E. T.,24,0,40,16
1650239888001,COGS 13,A01,083071,Staff,0,30,40,40
1650239894036,COGS 14A,A01,092681,Staff,1,13,100,99
1650239900063,COGS 14B,A01,083073,Cheng; Tzu-Han,0,8,50,50
1650239906089,COGS 17,A01,092677,Staff,33,0,75,42
1650239912111,COGS 100,A01,083619,Staff,1,21,60,59
1650239918137,COGS 101A,A01,083621,Davis; Joshua Daniel,0,21,60,60
1650239924162,COGS 101B,A01,091572,Staff,5,0,60,55
1650239930188,COGS 101C,A01,083625,Delgado; Tania,20,0,30,10
1650239936210,COGS 107A,A01,083627,Boyle; Mary E. T.,1,7,60,59
1650239942239,COGS 118A,A01,083075,Staff,15,0,60,45
1650239948267,CSE 3,A50,083646,Miranda; Gregory Joseph,22,0,38,16
1650239948267,CSE 3,A51,083647,Miranda; Gregory Joseph,37,0,37,0
1650239954291,CSE 8A,A50,083650,Miranda; Gregory Joseph,0,18,40,40
1650239960314,CSE 11,A01,083080,Cao; Yingjun,0,68,40,40
1650239966337,CSE 12,A01,083652,Staff,0,9,100,100
1650239972362,CSE 15L,A01,083654,Staff,0,1,50,50
1650239972362,CSE 15L,A02,083655,Staff,5,0,50,45
1650239978389,CSE 20,A01,083657,Staff,53,0,80,27
1650239984410,CSE 30,A01,083084,Eldon; John,0,70,40,40
1650239990437,CSE 100,A01,083659,Cao; Yingjun,0,63,50,50
1650239996462,CSE 134B,A01,083661,Powell; Thomas Allan,0,27,65,65
1650240002485,CSE 140,A01,083663,Staff,1,0,75,74
1650240008512,CSE 140L,A01,083088,Eldon; John,0,4,75,75
1650240014535,CSE 175,A01,083665,Kumar; Rakesh,8,0,25,17
1650240020561,CSE 190,A00,092507,Dubnov; Shlomo,14,0,20,6
1650240026584,ECE 45,A01,083139,Staff,0,13,40,40
1650240032607,ECE 65,A50,083695,Staff,0,5,30,30
1650240038638,ECE 109,A01,091882,Touri; Behrouz,47,0,70,23
1650240044665,ECE 180,A00,083140,Abi Samra; Nicholas Camill,24,0,30,6
1650240044665,ECE 180,B00,083141,Abi Samra; Nicholas Camill,7,0,30,23
1650240050690,MATH 10A,A01,083735,Patchell; Gregory David,11,0,30,19
1650240050690,MATH 10A,A02,083736,Patchell; Gregory David,28,0,30,2
1650240050690,MATH 10A,A03,083737,Patchell; Gregory David,26,0,30,4
1650240056712,MATH 10B,A01,083207,Staff,0,6,30,30
1650240056712,MATH 10B,A02,083208,Staff,0,5,30,30
1650240056712,MATH 10B,B01,083739,Staff,17,0,30,13
1650240056712,MATH 10B,B02,083740,Staff,29,0,30,1
1650240062742,MATH 18,A01,083743,Staff,7,0,30,23
1650240062742,MATH 18,A02,083744,Staff,28,0,30,2
1650240062742,MATH 18,A03,083745,Staff,23,0,30,7
1650240062742,MATH 18,A04,083746,Staff,27,0,30,3
1650240062742,MATH 18,B01,083748,Staff,0,10,30,30
1650240062742,MATH 18,B02,083749,Staff,0,8,30,30
1650240062742,MATH 18,B03,083750,Staff,0,7,30,30
1650240062742,MATH 18,B04,083751,Staff,0,8,30,30
1650240068768,MATH 20A,A01,083754,Staff,26,0,40,14
1650240074793,MATH 20B,A01,083756,Staff,1,6,30,29
1650240074793,MATH 20B,A02,083757,Staff,0,6,30,30
1650240080818,MATH 20C,A01,083760,Staff,0,12,30,30
1650240080818,MATH 20C,A02,083761,Staff,0,13,30,30
1650240080818,MATH 20C,B01,083762,Staff,14,0,30,16
1650240080818,MATH 20C,B02,083763,Staff,28,0,30,2
1650240086842,MATH 20D,A01,083765,Staff,1,2,30,29
1650240086842,MATH 20D,A02,083766,Staff,8,0,30,22
1650240086842,MATH 20D,A03,083767,Staff,28,0,30,2
1650240092868,MATH 20E,A01,083771,Staff,8,0,30,22
1650240092868,MATH 20E,A02,083772,Staff,21,0,30,9
1650240092868,MATH 20E,B01,083773,Staff,0,0,30,30
1650240092868,MATH 20E,B02,083774,Staff,12,0,30,18
1650240098893,MATH 103A,A01,083777,Staff,0,9,30,30
1650240098893,MATH 103A,A02,083778,Staff,0,10,30,30
1650240098893,MATH 103A,B01,083779,Staff,0,10,30,30
1650240098893,MATH 103A,B02,083780,Staff,0,9,30,30
1650240104919,MATH 105,A01,085443,Staff,0,17,30,30
1650240110945,MATH 109,A01,083213,Anzaldo; Leesa B,0,3,30,30
1650240110945,MATH 109,A02,083214,Anzaldo; Leesa B,0,6,30,30
1650240110945,MATH 109,B01,083215,Anzaldo; Leesa B,0,4,30,30
1650240110945,MATH 109,B02,083216,Anzaldo; Leesa B,1,4,30,29
1650240116974,MATH 142A,A01,083219,Chow; Bennett,0,12,30,30
1650240116974,MATH 142A,A02,083220,Chow; Bennett,0,11,30,30
1650240116974,MATH 142A,B01,083221,Chow; Bennett,0,11,30,30
1650240116974,MATH 142A,B02,083222,Chow; Bennett,0,12,30,30
1650240123003,MATH 193A,A01,083224,Staff,0,5,30,30
1650240123003,MATH 193A,A02,083225,Staff,0,4,30,30
1650240123003,MATH 193A,A03,083781,Staff,0,2,30,30
1650240123003,MATH 193A,A04,083782,Staff,0,1,30,30
1650240129030,MATH 197,001,091859,McAuley; Julian John,9998,0,9999,1
1650240135088,COGS 9,A01,083615,Staff,0,14,60,60
1650240141113,COGS 11,A01,083617,Boyle; Mary E. T.,24,0,40,16
1650240147141,COGS 13,A01,083071,Staff,0,30,40,40
1650240153166,COGS 14A,A01,092681,Staff,1,13,100,99
1650240159196,COGS 14B,A01,083073,Cheng; Tzu-Han,0,8,50,50
1650240165224,COGS 17,A01,092677,Staff,33,0,75,42
1650240171255,COGS 100,A01,083619,Staff,1,21,60,59
1650240177286,COGS 101A,A01,083621,Davis; Joshua Daniel,0,21,60,60
1650240183308,COGS 101B,A01,091572,Staff,5,0,60,55
1650240189339,COGS 101C,A01,083625,Delgado; Tania,20,0,30,10
1650240195361,COGS 107A,A01,083627,Boyle; Mary E. T.,1,7,60,59
1650240201387,COGS 118A,A01,083075,Staff,15,0,60,45
1650240207413,CSE 3,A50,083646,Miranda; Gregory Joseph,22,0,38,16
1650240207413,CSE 3,A51,083647,Miranda; Gregory Joseph,37,0,37,0
1650240213440,CSE 8A,A50,083650,Miranda; Gregory Joseph,0,18,40,40
1650240219464,CSE 11,A01,083080,Cao; Yingjun,0,68,40,40
1650240225491,CSE 12,A01,083652,Staff,0,9,100,100
1650240231516,CSE 15L,A01,083654,Staff,0,1,50,50
1650240231516,CSE 15L,A02,083655,Staff,5,0,50,45
1650240237541,CSE 20,A01,083657,Staff,53,0,80,27
1650240243564,CSE 30,A01,083084,Eldon; John,0,70,40,40
1650240249586,CSE 100,A01,083659,Cao; Yingjun,0,63,50,50
1650240255613,CSE 134B,A01,083661,Powell; Thomas Allan,0,27,65,65
1650240261640,CSE 140,A01,083663,Staff,1,0,75,74
1650240267670,CSE 140L,A01,083088,Eldon; John,0,4,75,75
1650240273692,CSE 175,A01,083665,Kumar; Rakesh,8,0,25,17
1650240279716,CSE 190,A00,092507,Dubnov; Shlomo,14,0,20,6
1650240285751,ECE 45,A01,083139,Staff,0,13,40,40
1650240291774,ECE 65,A50,083695,Staff,0,5,30,30
1650240297796,ECE 109,A01,091882,Touri; Behrouz,47,0,70,23
1650240303822,ECE 180,A00,083140,Abi Samra; Nicholas Camill,24,0,30,6
1650240303822,ECE 180,B00,083141,Abi Samra; Nicholas Camill,7,0,30,23
1650240309934,MATH 10A,A01,083735,Patchell; Gregory David,11,0,30,19
1650240309934,MATH 10A,A02,083736,Patchell; Gregory David,28,0,30,2
1650240309934,MATH 10A,A03,083737,Patchell; Gregory David,26,0,30,4
1650240315958,MATH 10B,A01,083207,Staff,0,6,30,30
1650240315958,MATH 10B,A02,083208,Staff,0,5,30,30
1650240315958,MATH 10B,B01,083739,Staff,17,0,30,13
1650240315958,MATH 10B,B02,083740,Staff,29,0,30,1
1650240321990,MATH 18,A01,083743,Staff,7,0,30,23
1650240321990,MATH 18,A02,083744,Staff,28,0,30,2
1650240321990,MATH 18,A03,083745,Staff,23,0,30,7
1650240321990,MATH 18,A04,083746,Staff,27,0,30,3
1650240321990,MATH 18,B01,083748,Staff,0,10,30,30
1650240321990,MATH 18,B02,083749,Staff,0,8,30,30
1650240321990,MATH 18,B03,083750,Staff,0,7,30,30
1650240321990,MATH 18,B04,083751,Staff,0,8,30,30
1650240328014,MATH 20A,A01,083754,Staff,26,0,40,14
1650240334038,MATH 20B,A01,083756,Staff,1,6,30,29
1650240334038,MATH 20B,A02,083757,Staff,0,6,30,30
1650240340063,MATH 20C,A01,083760,Staff,0,12,30,30
1650240340063,MATH 20C,A02,083761,Staff,0,13,30,30
1650240340063,MATH 20C,B01,083762,Staff,14,0,30,16
1650240340063,MATH 20C,B02,083763,Staff,28,0,30,2
1650240346087,MATH 20D,A01,083765,Staff,1,2,30,29
1650240346087,MATH 20D,A02,083766,Staff,8,0,30,22
1650240346087,MATH 20D,A03,083767,Staff,28,0,30,2
1650240352114,MATH 20E,A01,083771,Staff,8,0,30,22
1650240352114,MATH 20E,A02,083772,Staff,21,0,30,9
1650240352114,MATH 20E,B01,083773,Staff,0,0,30,30
1650240352114,MATH 20E,B02,083774,Staff,12,0,30,18
1650240358143,MATH 103A,A01,083777,Staff,0,9,30,30
1650240358143,MATH 103A,A02,083778,Staff,0,10,30,30
1650240358143,MATH 103A,B01,083779,Staff,0,10,30,30
1650240358143,MATH 103A,B02,083780,Staff,0,9,30,30
1650240364172,MATH 105,A01,085443,Staff,0,17,30,30
1650240370199,MATH 109,A01,083213,Anzaldo; Leesa B,0,3,30,30
1650240370199,MATH 109,A02,083214,Anzaldo; Leesa B,0,6,30,30
1650240370199,MATH 109,B01,083215,Anzaldo; Leesa B,0,4,30,30
1650240370199,MATH 109,B02,083216,Anzaldo; Leesa B,1,4,30,29
1650240376223,MATH 142A,A01,083219,Chow; Bennett,0,12,30,30
1650240376223,MATH 142A,A02,083220,Chow; Bennett,0,11,30,30
1650240376223,MATH 142A,B01,083221,Chow; Bennett,0,11,30,30
1650240376223,MATH 142A,B02,083222,Chow; Bennett,0,12,30,30
1650240382248,MATH 193A,A01,083224,Staff,0,5,30,30
1650240382248,MATH 193A,A02,083225,Staff,0,4,30,30
1650240382248,MATH 193A,A03,083781,Staff,0,2,30,30
1650240382248,MATH 193A,A04,083782,Staff,0,1,30,30
1650240388274,MATH 197,001,091859,McAuley; Julian John,9998,0,9999,1
1650240394330,COGS 9,A01,083615,Staff,0,14,60,60
1650240400357,COGS 11,A01,083617,Boyle; Mary E. T.,24,0,40,16
1650240406380,COGS 13,A01,083071,Staff,0,30,40,40
1650240412406,COGS 14A,A01,092681,Staff,1,13,100,99
1650240418430,COGS 14B,A01,083073,Cheng; Tzu-Han,0,8,50,50
1650240424453,COGS 17,A01,092677,Staff,33,0,75,42
1650240430479,COGS 100,A01,083619,Staff,1,21,60,59
1650240436506,COGS 101A,A01,083621,Davis; Joshua Daniel,0,21,60,60
1650240442536,COGS 101B,A01,091572,Staff,5,0,60,55
1650240448562,COGS 101C,A01,083625,Delgado; Tania,20,0,30,10
1650240454583,COGS 107A,A01,083627,Boyle; Mary E. T.,1,7,60,59
1650240460607,COGS 118A,A01,083075,Staff,15,0,60,45
1650240466633,CSE 3,A50,083646,Miranda; Gregory Joseph,22,0,38,16
1650240466633,CSE 3,A51,083647,Miranda; Gregory Joseph,37,0,37,0
1650240472658,CSE 8A,A50,083650,Miranda; Gregory Joseph,0,18,40,40
1650240478682,CSE 11,A01,083080,Cao; Yingjun,0,68,40,40
1650240484706,CSE 12,A01,083652,Staff,0,9,100,100
1650240490733,CSE 15L,A01,083654,Staff,0,1,50,50
1650240490733,CSE 15L,A02,083655,Staff,5,0,50,45
1650240496757,CSE 20,A01,083657,Staff,53,0,80,27
1650240502782,CSE 30,A01,083084,Eldon; John,0,70,40,40
1650240508805,CSE 100,A01,083659,Cao; Yingjun,0,64,50,50
1650240514833,CSE 134B,A01,083661,Powell; Thomas Allan,0,27,65,65
1650240520859,CSE 140,A01,083663,Staff,1,0,75,74
1650240526886,CSE 140L,A01,083088,Eldon; John,0,4,75,75
1650240532909,CSE 175,A01,083665,Kumar; Rakesh,8,0,25,17
1650240538935,CSE 190,A00,092507,Dubnov; Shlomo,14,0,20,6
1650240544957,ECE 45,A01,083139,Staff,0,13,40,40
1650240550981,ECE 65,A50,083695,Staff,0,5,30,30
1650240557007,ECE 109,A01,091882,Touri; Behrouz,47,0,70,23
1650240563030,ECE 180,A00,083140,Abi Samra; Nicholas Camill,24,0,30,6
1650240563030,ECE 180,B00,083141,Abi Samra; Nicholas Camill,7,0,30,23
1650240569058,MATH 10A,A01,083735,Patchell; Gregory David,11,0,30,19
1650240569058,MATH 10A,A02,083736,Patchell; Gregory David,28,0,30,2
1650240569058,MATH 10A,A03,083737,Patchell; Gregory David,26,0,30,4
1650240575095,MATH 10B,A01,083207,Staff,0,6,30,30
1650240575095,MATH 10B,A02,083208,Staff,0,5,30,30
1650240575095,MATH 10B,B01,083739,Staff,17,0,30,13
1650240575095,MATH 10B,B02,083740,Staff,29,0,30,1
1650240581119,MATH 18,A01,083743,Staff,7,0,30,23
1650240581119,MATH 18,A02,083744,Staff,28,0,30,2
1650240581119,MATH 18,A03,083745,Staff,23,0,30,7
1650240581119,MATH 18,A04,083746,Staff,27,0,30,3
1650240581119,MATH 18,B01,083748,Staff,0,10,30,30
1650240581119,MATH 18,B02,083749,Staff,0,8,30,30
1650240581119,MATH 18,B03,083750,Staff,0,7,30,30
1650240581119,MATH 18,B04,083751,Staff,0,8,30,30
1650240587143,MATH 20A,A01,083754,Staff,26,0,40,14
1650240593172,MATH 20B,A01,083756,Staff,1,6,30,29
1650240593172,MATH 20B,A02,083757,Staff,0,6,30,30
1650240599196,MATH 20C,A01,083760,Staff,0,12,30,30
1650240599196,MATH 20C,A02,083761,Staff,0,13,30,30
1650240599196,MATH 20C,B01,083762,Staff,14,0,30,16
1650240599196,MATH 20C,B02,083763,Staff,28,0,30,2
1650240605223,MATH 20D,A01,083765,Staff,1,2,30,29
1650240605223,MATH 20D,A02,083766,Staff,8,0,30,22
1650240605223,MATH 20D,A03,083767,Staff,28,0,30,2
1650240611251,MATH 20E,A01,083771,Staff,8,0,30,22
1650240611251,MATH 20E,A02,083772,Staff,21,0,30,9
1650240611251,MATH 20E,B01,083773,Staff,0,0,30,30
1650240611251,MATH 20E,B02,083774,Staff,12,0,30,18
1650240617280,MATH 103A,A01,083777,Staff,0,9,30,30
1650240617280,MATH 103A,A02,083778,Staff,0,10,30,30
1650240617280,MATH 103A,B01,083779,Staff,0,10,30,30
1650240617280,MATH 103A,B02,083780,Staff,0,9,30,30
1650240623303,MATH 105,A01,085443,Staff,0,17,30,30
1650240629326,MATH 109,A01,083213,Anzaldo; Leesa B,0,3,30,30
1650240629326,MATH 109,A02,083214,Anzaldo; Leesa B,0,6,30,30
1650240629326,MATH 109,B01,083215,Anzaldo; Leesa B,0,4,30,30
1650240629326,MATH 109,B02,083216,Anzaldo; Leesa B,1,4,30,29
1650240635350,MATH 142A,A01,083219,Chow; Bennett,0,12,30,30
1650240635350,MATH 142A,A02,083220,Chow; Bennett,0,11,30,30
1650240635350,MATH 142A,B01,083221,Chow; Bennett,0,11,30,30
1650240635350,MATH 142A,B02,083222,Chow; Bennett,0,12,30,30
1650240641378,MATH 193A,A01,083224,Staff,0,5,30,30
1650240641378,MATH 193A,A02,083225,Staff,0,4,30,30
1650240641378,MATH 193A,A03,083781,Staff,0,2,30,30
1650240641378,MATH 193A,A04,083782,Staff,0,1,30,30
1650240647405,MATH 197,001,091859,McAuley; Julian John,9998,0,9999,1
1650240653454,COGS 9,A01,083615,Staff,0,14,60,60
1650240659478,COGS 11,A01,083617,Boyle; Mary E. T.,24,0,40,16
1650240665500,COGS 13,A01,083071,Staff,0,30,40,40
1650240671525,COGS 14A,A01,092681,Staff,1,13,100,99
1650240677556,COGS 14B,A01,083073,Cheng; Tzu-Han,0,8,50,50
1650240683582,COGS 17,A01,092677,Staff,33,0,75,42
1650240689623,COGS 100,A01,083619,Staff,1,21,60,59
1650240695646,COGS 101A,A01,083621,Davis; Joshua Daniel,0,21,60,60
1650240701673,COGS 101B,A01,091572,Staff,5,0,60,55
1650240707698,COGS 101C,A01,083625,Delgado; Tania,20,0,30,10
1650240713730,COGS 107A,A01,083627,Boyle; Mary E. T.,1,7,60,59
1650240719754,COGS 118A,A01,083075,Staff,15,0,60,45
1650240725780,CSE 3,A50,083646,Miranda; Gregory Joseph,22,0,38,16
1650240725780,CSE 3,A51,083647,Miranda; Gregory Joseph,37,0,37,0
1650240731808,CSE 8A,A50,083650,Miranda; Gregory Joseph,0,18,40,40
1650240737833,CSE 11,A01,083080,Cao; Yingjun,0,68,40,40
1650240743856,CSE 12,A01,083652,Staff,0,9,100,100
1650240749884,CSE 15L,A01,083654,Staff,0,1,50,50
1650240749884,CSE 15L,A02,083655,Staff,5,0,50,45
1650240755919,CSE 20,A01,083657,Staff,53,0,80,27
1650240761947,CSE 30,A01,083084,Eldon; John,0,70,40,40
1650240767976,CSE 100,A01,083659,Cao; Yingjun,0,64,50,50
1650240774000,CSE 134B,A01,083661,Powell; Thomas Allan,0,27,65,65
1650240780039,CSE 140,A01,083663,Staff,1,0,75,74
1650240786066,CSE 140L,A01,083088,Eldon; John,0,4,75,75
1650240792090,CSE 175,A01,083665,Kumar; Rakesh,8,0,25,17
1650240798114,CSE 190,A00,092507,Dubnov; Shlomo,14,0,20,6
1650240804139,ECE 45,A01,083139,Staff,0,13,40,40
1650240810169,ECE 65,A50,083695,Staff,0,5,30,30
1650240816192,ECE 109,A01,091882,Touri; Behrouz,47,0,70,23
1650240822218,ECE 180,A00,083140,Abi Samra; Nicholas Camill,24,0,30,6
1650240822218,ECE 180,B00,083141,Abi Samra; Nicholas Camill,7,0,30,23
1650240828239,MATH 10A,A01,083735,Patchell; Gregory David,11,0,30,19
1650240828239,MATH 10A,A02,083736,Patchell; Gregory David,28,0,30,2
1650240828239,MATH 10A,A03,083737,Patchell; Gregory David,26,0,30,4
1650240834262,MATH 10B,A01,083207,Staff,0,6,30,30
1650240834262,MATH 10B,A02,083208,Staff,0,5,30,30
1650240834262,MATH 10B,B01,083739,Staff,17,0,30,13
1650240834262,MATH 10B,B02,083740,Staff,29,0,30,1
1650240840289,MATH 18,A01,083743,Staff,7,0,30,23
1650240840289,MATH 18,A02,083744,Staff,28,0,30,2
1650240840289,MATH 18,A03,083745,Staff,23,0,30,7
1650240840289,MATH 18,A04,083746,Staff,27,0,30,3
1650240840289,MATH 18,B01,083748,Staff,0,10,30,30
1650240840289,MATH 18,B02,083749,Staff,0,8,30,30
1650240840289,MATH 18,B03,083750,Staff,0,7,30,30
1650240840289,MATH 18,B04,083751,Staff,0,8,30,30
1650240846314,MATH 20A,A01,083754,Staff,26,0,40,14
1650240852337,MATH 20B,A01,083756,Staff,1,6,30,29
1650240852337,MATH 20B,A02,083757,Staff,0,6,30,30
1650240858361,MATH 20C,A01,083760,Staff,0,12,30,30
1650240858361,MATH 20C,A02,083761,Staff,0,13,30,30
1650240858361,MATH 20C,B01,083762,Staff,14,0,30,16
1650240858361,MATH 20C,B02,083763,Staff,28,0,30,2
1650240864391,MATH 20D,A01,083765,Staff,1,2,30,29
1650240864391,MATH 20D,A02,083766,Staff,8,0,30,22
1650240864391,MATH 20D,A03,083767,Staff,28,0,30,2
1650240870443,MATH 20E,A01,083771,Staff,8,0,30,22
1650240870443,MATH 20E,A02,083772,Staff,21,0,30,9
1650240870443,MATH 20E,B01,083773,Staff,0,0,30,30
1650240870443,MATH 20E,B02,083774,Staff,12,0,30,18
1650240876469,MATH 103A,A01,083777,Staff,0,9,30,30
1650240876469,MATH 103A,A02,083778,Staff,0,10,30,30
1650240876469,MATH 103A,B01,083779,Staff,0,10,30,30
1650240876469,MATH 103A,B02,083780,Staff,0,9,30,30
1650240882493,MATH 105,A01,085443,Staff,0,17,30,30
1650240888516,MATH 109,A01,083213,Anzaldo; Leesa B,0,3,30,30
1650240888516,MATH 109,A02,083214,Anzaldo; Leesa B,0,6,30,30
1650240888516,MATH 109,B01,083215,Anzaldo; Leesa B,0,4,30,30
1650240888516,MATH 109,B02,083216,Anzaldo; Leesa B,1,4,30,29
1650240894544,MATH 142A,A01,083219,Chow; Bennett,0,12,30,30
1650240894544,MATH 142A,A02,083220,Chow; Bennett,0,11,30,30
1650240894544,MATH 142A,B01,083221,Chow; Bennett,0,11,30,30
1650240894544,MATH 142A,B02,083222,Chow; Bennett,0,12,30,30
1650240900572,MATH 193A,A01,083224,Staff,0,5,30,30
1650240900572,MATH 193A,A02,083225,Staff,0,4,30,30
1650240900572,MATH 193A,A03,083781,Staff,0,2,30,30
1650240900572,MATH 193A,A04,083782,Staff,0,1,30,30
1650240906690,MATH 197,001,091859,McAuley; Julian John,9998,0,9999,1
1650240912739,COGS 9,A01,083615,Staff,0,14,60,60
1650240918762,COGS 11,A01,083617,Boyle; Mary E. T.,24,0,40,16
1650240924791,COGS 13,A01,083071,Staff,0,30,40,40
1650240930817,COGS 14A,A01,092681,Staff,1,13,100,99
1650240936845,COGS 14B,A01,083073,Cheng; Tzu-Han,0,8,50,50
1650240942869,COGS 17,A01,092677,Staff,33,0,75,42
1650240948900,COGS 100,A01,083619,Staff,1,21,60,59
1650240954923,COGS 101A,A01,083621,Davis; Joshua Daniel,0,21,60,60
1650240960960,COGS 101B,A01,091572,Staff,5,0,60,55
1650240966987,COGS 101C,A01,083625,Delgado; Tania,20,0,30,10
1650240973021,COGS 107A,A01,083627,Boyle; Mary E. T.,1,7,60,59
1650240979046,COGS 118A,A01,083075,Staff,15,0,60,45
1650240985069,CSE 3,A50,083646,Miranda; Gregory Joseph,22,0,38,16
1650240985069,CSE 3,A51,083647,Miranda; Gregory Joseph,37,0,37,0
1650240991093,CSE 8A,A50,083650,Miranda; Gregory Joseph,0,18,40,40
1650240997117,CSE 11,A01,083080,Cao; Yingjun,0,68,40,40
1650241003151,CSE 12,A01,083652,Staff,0,9,100,100
1650241009184,CSE 15L,A01,083654,Staff,0,1,50,50
1650241009184,CSE 15L,A02,083655,Staff,5,0,50,45
1650241015208,CSE 20,A01,083657,Staff,53,0,80,27
1650241021234,CSE 30,A01,083084,Eldon; John,0,70,40,40
1650241027257,CSE 100,A01,083659,Cao; Yingjun,0,64,50,50
1650241033283,CSE 134B,A01,083661,Powell; Thomas Allan,0,27,65,65
1650241039307,CSE 140,A01,083663,Staff,1,0,75,74
1650241045333,CSE 140L,A01,083088,Eldon; John,0,4,75,75
1650241051359,CSE 175,A01,083665,Kumar; Rakesh,8,0,25,17
1650241057387,CSE 190,A00,092507,Dubnov; Shlomo,14,0,20,6
1650241063411,ECE 45,A01,083139,Staff,0,13,40,40
1650241069436,ECE 65,A50,083695,Staff,0,5,30,30
1650241075465,ECE 109,A01,091882,Touri; Behrouz,47,0,70,23
1650241081490,ECE 180,A00,083140,Abi Samra; Nicholas Camill,24,0,30,6
1650241081490,ECE 180,B00,083141,Abi Samra; Nicholas Camill,7,0,30,23
1650241087517,MATH 10A,A01,083735,Patchell; Gregory David,11,0,30,19
1650241087517,MATH 10A,A02,083736,Patchell; Gregory David,28,0,30,2
1650241087517,MATH 10A,A03,083737,Patchell; Gregory David,26,0,30,4
1650241093545,MATH 10B,A01,083207,Staff,0,6,30,30
1650241093545,MATH 10B,A02,083208,Staff,0,5,30,30
1650241093545,MATH 10B,B01,083739,Staff,17,0,30,13
1650241093545,MATH 10B,B02,083740,Staff,29,0,30,1
1650241099575,MATH 18,A01,083743,Staff,7,0,30,23
1650241099575,MATH 18,A02,083744,Staff,28,0,30,2
1650241099575,MATH 18,A03,083745,Staff,23,0,30,7
1650241099575,MATH 18,A04,083746,Staff,27,0,30,3
1650241099575,MATH 18,B01,083748,Staff,0,10,30,30
1650241099575,MATH 18,B02,083749,Staff,0,8,30,30
1650241099575,MATH 18,B03,083750,Staff,0,7,30,30
1650241099575,MATH 18,B04,083751,Staff,0,8,30,30
1650241105600,MATH 20A,A01,083754,Staff,26,0,40,14
1650241111626,MATH 20B,A01,083756,Staff,1,6,30,29
1650241111626,MATH 20B,A02,083757,Staff,0,6,30,30
1650241117649,MATH 20C,A01,083760,Staff,0,12,30,30
1650241117649,MATH 20C,A02,083761,Staff,0,13,30,30
1650241117649,MATH 20C,B01,083762,Staff,14,0,30,16
1650241117649,MATH 20C,B02,083763,Staff,28,0,30,2
1650241123680,MATH 20D,A01,083765,Staff,1,2,30,29
1650241123680,MATH 20D,A02,083766,Staff,8,0,30,22
1650241123680,MATH 20D,A03,083767,Staff,28,0,30,2
1650241129715,MATH 20E,A01,083771,Staff,8,0,30,22
1650241129715,MATH 20E,A02,083772,Staff,21,0,30,9
1650241129715,MATH 20E,B01,083773,Staff,0,0,30,30
1650241129715,MATH 20E,B02,083774,Staff,12,0,30,18
1650241135750,MATH 103A,A01,083777,Staff,0,9,30,30
1650241135750,MATH 103A,A02,083778,Staff,0,10,30,30
1650241135750,MATH 103A,B01,083779,Staff,0,10,30,30
1650241135750,MATH 103A,B02,083780,Staff,0,9,30,30
1650241141783,MATH 105,A01,085443,Staff,0,17,30,30
1650241147808,MATH 109,A01,083213,Anzaldo; Leesa B,0,3,30,30
1650241147808,MATH 109,A02,083214,Anzaldo; Leesa B,0,6,30,30
1650241147808,MATH 109,B01,083215,Anzaldo; Leesa B,0,4,30,30
1650241147808,MATH 109,B02,083216,Anzaldo; Leesa B,1,4,30,29
1650241153841,MATH 142A,A01,083219,Chow; Bennett,0,12,30,30
1650241153841,MATH 142A,A02,083220,Chow; Bennett,0,11,30,30
1650241153841,MATH 142A,B01,083221,Chow; Bennett,0,11,30,30
1650241153841,MATH 142A,B02,083222,Chow; Bennett,0,12,30,30
1650241159865,MATH 193A,A01,083224,Staff,0,5,30,30
1650241159865,MATH 193A,A02,083225,Staff,0,4,30,30
1650241159865,MATH 193A,A03,083781,Staff,0,2,30,30
1650241159865,MATH 193A,A04,083782,Staff,0,1,30,30
1650241165898,MATH 197,001,091859,McAuley; Julian John,9998,0,9999,1
1650241171951,COGS 9,A01,083615,Staff,0,14,60,60
1650241177987,COGS 11,A01,083617,Boyle; Mary E. T.,24,0,40,16
1650241184010,COGS 13,A01,083071,Staff,0,30,40,40
1650241190039,COGS 14A,A01,092681,Staff,1,13,100,99
1650241196063,COGS 14B,A01,083073,Cheng; Tzu-Han,0,8,50,50
1650241202086,COGS 17,A01,092677,Staff,33,0,75,42
1650241208115,COGS 100,A01,083619,Staff,1,21,60,59
1650241214139,COGS 101A,A01,083621,Davis; Joshua Daniel,0,21,60,60
1650241220163,COGS 101B,A01,091572,Staff,5,0,60,55
1650241226187,COGS 101C,A01,083625,Delgado; Tania,20,0,30,10
1650241232210,COGS 107A,A01,083627,Boyle; Mary E. T.,1,7,60,59
1650241238234,COGS 118A,A01,083075,Staff,15,0,60,45
1650241244260,CSE 3,A50,083646,Miranda; Gregory Joseph,22,0,38,16
1650241244260,CSE 3,A51,083647,Miranda; Gregory Joseph,37,0,37,0
1650241250286,CSE 8A,A50,083650,Miranda; Gregory Joseph,0,18,40,40
1650241256310,CSE 11,A01,083080,Cao; Yingjun,0,68,40,40
1650241262349,CSE 12,A01,083652,Staff,0,9,100,100
1650241268375,CSE 15L,A01,083654,Staff,0,1,50,50
1650241268375,CSE 15L,A02,083655,Staff,5,0,50,45
1650241274401,CSE 20,A01,083657,Staff,53,0,80,27
1650241280428,CSE 30,A01,083084,Eldon; John,0,70,40,40
1650241286454,CSE 100,A01,083659,Cao; Yingjun,0,64,50,50
1650241292481,CSE 134B,A01,083661,Powell; Thomas Allan,0,27,65,65
1650241298507,CSE 140,A01,083663,Staff,1,0,75,74
1650241304543,CSE 140L,A01,083088,Eldon; John,0,4,75,75
1650241310568,CSE 175,A01,083665,Kumar; Rakesh,8,0,25,17
1650241316597,CSE 190,A00,092507,Dubnov; Shlomo,14,0,20,6
1650241322630,ECE 45,A01,083139,Staff,0,13,40,40
1650241328656,ECE 65,A50,083695,Staff,0,5,30,30
1650241334680,ECE 109,A01,091882,Touri; Behrouz,47,0,70,23
1650241340703,ECE 180,A00,083140,Abi Samra; Nicholas Camill,24,0,30,6
1650241340703,ECE 180,B00,083141,Abi Samra; Nicholas Camill,7,0,30,23
1650241346728,MATH 10A,A01,083735,Patchell; Gregory David,11,0,30,19
1650241346728,MATH 10A,A02,083736,Patchell; Gregory David,28,0,30,2
1650241346728,MATH 10A,A03,083737,Patchell; Gregory David,26,0,30,4
1650241352752,MATH 10B,A01,083207,Staff,0,6,30,30
1650241352752,MATH 10B,A02,083208,Staff,0,5,30,30
1650241352752,MATH 10B,B01,083739,Staff,17,0,30,13
1650241352752,MATH 10B,B02,083740,Staff,29,0,30,1
1650241358777,MATH 18,A01,083743,Staff,7,0,30,23
1650241358777,MATH 18,A02,083744,Staff,28,0,30,2
1650241358777,MATH 18,A03,083745,Staff,23,0,30,7
1650241358777,MATH 18,A04,083746,Staff,27,0,30,3
1650241358777,MATH 18,B01,083748,Staff,0,10,30,30
1650241358777,MATH 18,B02,083749,Staff,0,8,30,30
1650241358777,MATH 18,B03,083750,Staff,0,7,30,30
1650241358777,MATH 18,B04,083751,Staff,0,8,30,30
1650241364802,MATH 20A,A01,083754,Staff,26,0,40,14
1650241370825,MATH 20B,A01,083756,Staff,1,6,30,29
1650241370825,MATH 20B,A02,083757,Staff,0,6,30,30
1650241376854,MATH 20C,A01,083760,Staff,0,12,30,30
1650241376854,MATH 20C,A02,083761,Staff,0,13,30,30
1650241376854,MATH 20C,B01,083762,Staff,14,0,30,16
1650241376854,MATH 20C,B02,083763,Staff,28,0,30,2
1650241382882,MATH 20D,A01,083765,Staff,1,2,30,29
1650241382882,MATH 20D,A02,083766,Staff,8,0,30,22
1650241382882,MATH 20D,A03,083767,Staff,28,0,30,2
1650241388909,MATH 20E,A01,083771,Staff,8,0,30,22
1650241388909,MATH 20E,A02,083772,Staff,21,0,30,9
1650241388909,MATH 20E,B01,083773,Staff,0,0,30,30
1650241388909,MATH 20E,B02,083774,Staff,12,0,30,18
1650241394937,MATH 103A,A01,083777,Staff,0,9,30,30
1650241394937,MATH 103A,A02,083778,Staff,0,10,30,30
1650241394937,MATH 103A,B01,083779,Staff,0,10,30,30
1650241394937,MATH 103A,B02,083780,Staff,0,9,30,30
1650241400964,MATH 105,A01,085443,Staff,0,17,30,30
1650241406988,MATH 109,A01,083213,Anzaldo; Leesa B,0,3,30,30
1650241406988,MATH 109,A02,083214,Anzaldo; Leesa B,0,6,30,30
1650241406988,MATH 109,B01,083215,Anzaldo; Leesa B,0,4,30,30
1650241406988,MATH 109,B02,083216,Anzaldo; Leesa B,1,4,30,29
1650241413023,MATH 142A,A01,083219,Chow; Bennett,0,12,30,30
1650241413023,MATH 142A,A02,083220,Chow; Bennett,0,11,30,30
1650241413023,MATH 142A,B01,083221,Chow; Bennett,0,11,30,30
1650241413023,MATH 142A,B02,083222,Chow; Bennett,0,12,30,30
1650241419047,MATH 193A,A01,083224,Staff,0,5,30,30
1650241419047,MATH 193A,A02,083225,Staff,0,4,30,30
1650241419047,MATH 193A,A03,083781,Staff,0,2,30,30
1650241419047,MATH 193A,A04,083782,Staff,0,1,30,30
1650241425070,MATH 197,001,091859,McAuley; Julian John,9998,0,9999,1
1650241431121,COGS 9,A01,083615,Staff,0,14,60,60
1650241437145,COGS 11,A01,083617,Boyle; Mary E. T.,24,0,40,16
1650241443171,COGS 13,A01,083071,Staff,0,30,40,40
1650241449195,COGS 14A,A01,092681,Staff,1,13,100,99
1650241455219,COGS 14B,A01,083073,Cheng; Tzu-Han,0,8,50,50
1650241461244,COGS 17,A01,092677,Staff,33,0,75,42
1650241467267,COGS 100,A01,083619,Staff,1,21,60,59
1650241473291,COGS 101A,A01,083621,Davis; Joshua Daniel,0,21,60,60
1650241479315,COGS 101B,A01,091572,Staff,5,0,60,55
1650241485344,COGS 101C,A01,083625,Delgado; Tania,20,0,30,10
1650241491369,COGS 107A,A01,083627,Boyle; Mary E. T.,1,7,60,59
1650241497488,COGS 118A,A01,083075,Staff,15,0,60,45
1650241503519,CSE 3,A50,083646,Miranda; Gregory Joseph,22,0,38,16
1650241503519,CSE 3,A51,083647,Miranda; Gregory Joseph,37,0,37,0
1650241509541,CSE 8A,A50,083650,Miranda; Gregory Joseph,0,18,40,40
1650241515566,CSE 11,A01,083080,Cao; Yingjun,0,68,40,40
1650241521591,CSE 12,A01,083652,Staff,0,9,100,100
1650241527616,CSE 15L,A01,083654,Staff,0,1,50,50
1650241527616,CSE 15L,A02,083655,Staff,5,0,50,45
1650241533642,CSE 20,A01,083657,Staff,53,0,80,27
1650241539670,CSE 30,A01,083084,Eldon; John,0,70,40,40
1650241545693,CSE 100,A01,083659,Cao; Yingjun,0,64,50,50
1650241551717,CSE 134B,A01,083661,Powell; Thomas Allan,0,27,65,65
1650241557740,CSE 140,A01,083663,Staff,1,0,75,74
1650241563765,CSE 140L,A01,083088,Eldon; John,0,4,75,75
1650241569786,CSE 175,A01,083665,Kumar; Rakesh,8,0,25,17
1650241575811,CSE 190,A00,092507,Dubnov; Shlomo,14,0,20,6
1650241581836,ECE 45,A01,083139,Staff,0,13,40,40
1650241587859,ECE 65,A50,083695,Staff,0,5,30,30
1650241593884,ECE 109,A01,091882,Touri; Behrouz,47,0,70,23
1650241599907,ECE 180,A00,083140,Abi Samra; Nicholas Camill,24,0,30,6
1650241599907,ECE 180,B00,083141,Abi Samra; Nicholas Camill,7,0,30,23
1650241605930,MATH 10A,A01,083735,Patchell; Gregory David,11,0,30,19
1650241605930,MATH 10A,A02,083736,Patchell; Gregory David,28,0,30,2
1650241605930,MATH 10A,A03,083737,Patchell; Gregory David,26,0,30,4
1650241611958,MATH 10B,A01,083207,Staff,0,6,30,30
1650241611958,MATH 10B,A02,083208,Staff,0,5,30,30
1650241611958,MATH 10B,B01,083739,Staff,17,0,30,13
1650241611958,MATH 10B,B02,083740,Staff,29,0,30,1
1650241617987,MATH 18,A01,083743,Staff,7,0,30,23
1650241617987,MATH 18,A02,083744,Staff,28,0,30,2
1650241617987,MATH 18,A03,083745,Staff,23,0,30,7
1650241617987,MATH 18,A04,083746,Staff,27,0,30,3
1650241617987,MATH 18,B01,083748,Staff,0,10,30,30
1650241617987,MATH 18,B02,083749,Staff,0,8,30,30
1650241617987,MATH 18,B03,083750,Staff,0,7,30,30
1650241617987,MATH 18,B04,083751,Staff,0,8,30,30
1650241624010,MATH 20A,A01,083754,Staff,26,0,40,14
1650241630048,MATH 20B,A01,083756,Staff,1,6,30,29
1650241630048,MATH 20B,A02,083757,Staff,0,6,30,30
1650241636072,MATH 20C,A01,083760,Staff,0,12,30,30
1650241636072,MATH 20C,A02,083761,Staff,0,13,30,30
1650241636072,MATH 20C,B01,083762,Staff,14,0,30,16
1650241636072,MATH 20C,B02,083763,Staff,28,0,30,2
1650241642093,MATH 20D,A01,083765,Staff,1,2,30,29
1650241642093,MATH 20D,A02,083766,Staff,8,0,30,22
1650241642093,MATH 20D,A03,083767,Staff,28,0,30,2
1650241648120,MATH 20E,A01,083771,Staff,8,0,30,22
1650241648120,MATH 20E,A02,083772,Staff,21,0,30,9
1650241648120,MATH 20E,B01,083773,Staff,0,0,30,30
1650241648120,MATH 20E,B02,083774,Staff,12,0,30,18
1650241654148,MATH 103A,A01,083777,Staff,0,9,30,30
1650241654148,MATH 103A,A02,083778,Staff,0,10,30,30
1650241654148,MATH 103A,B01,083779,Staff,0,10,30,30
1650241654148,MATH 103A,B02,083780,Staff,0,9,30,30
1650241660174,MATH 105,A01,085443,Staff,0,17,30,30
1650241666197,MATH 109,A01,083213,Anzaldo; Leesa B,0,3,30,30
1650241666197,MATH 109,A02,083214,Anzaldo; Leesa B,0,6,30,30
1650241666197,MATH 109,B01,083215,Anzaldo; Leesa B,0,4,30,30
1650241666197,MATH 109,B02,083216,Anzaldo; Leesa B,1,4,30,29
1650241672221,MATH 142A,A01,083219,Chow; Bennett,0,12,30,30
1650241672221,MATH 142A,A02,083220,Chow; Bennett,0,11,30,30
1650241672221,MATH 142A,B01,083221,Chow; Bennett,0,11,30,30
1650241672221,MATH 142A,B02,083222,Chow; Bennett,0,12,30,30
1650241678245,MATH 193A,A01,083224,Staff,0,5,30,30
1650241678245,MATH 193A,A02,083225,Staff,0,4,30,30
1650241678245,MATH 193A,A03,083781,Staff,0,2,30,30
1650241678245,MATH 193A,A04,083782,Staff,0,1,30,30
1650241684271,MATH 197,001,091859,McAuley; Julian John,9998,0,9999,1
1650241690323,COGS 9,A01,083615,Staff,0,14,60,60
1650241696347,COGS 11,A01,083617,Boyle; Mary E. T.,24,0,40,16
1650241702370,COGS 13,A01,083071,Staff,0,30,40,40
1650241708393,COGS 14A,A01,092681,Staff,1,13,100,99
1650241714414,COGS 14B,A01,083073,Cheng; Tzu-Han,0,8,50,50
1650241720446,COGS 17,A01,092677,Staff,33,0,75,42
1650241726468,COGS 100,A01,083619,Staff,1,21,60,59
1650241732496,COGS 101A,A01,083621,Davis; Joshua Daniel,0,21,60,60
1650241738518,COGS 101B,A01,091572,Staff,5,0,60,55
1650241744544,COGS 101C,A01,083625,Delgado; Tania,20,0,30,10
1650241750568,COGS 107A,A01,083627,Boyle; Mary E. T.,1,7,60,59
1650241756598,COGS 118A,A01,083075,Staff,15,0,60,45
1650241762634,CSE 3,A50,083646,Miranda; Gregory Joseph,22,0,38,16
1650241762634,CSE 3,A51,083647,Miranda; Gregory Joseph,37,0,37,0
1650241768658,CSE 8A,A50,083650,Miranda; Gregory Joseph,0,18,40,40
1650241774680,CSE 11,A01,083080,Cao; Yingjun,0,68,40,40
1650241780706,CSE 12,A01,083652,Staff,0,9,100,100
1650241786732,CSE 15L,A01,083654,Staff,0,1,50,50
1650241786732,CSE 15L,A02,083655,Staff,5,0,50,45
1650241792758,CSE 20,A01,083657,Staff,53,0,80,27
1650241798785,CSE 30,A01,083084,Eldon; John,0,70,40,40
1650241804813,CSE 100,A01,083659,Cao; Yingjun,0,64,50,50
1650241810838,CSE 134B,A01,083661,Powell; Thomas Allan,0,27,65,65
1650241816863,CSE 140,A01,083663,Staff,1,0,75,74
1650241822888,CSE 140L,A01,083088,Eldon; John,0,4,75,75
1650241828913,CSE 175,A01,083665,Kumar; Rakesh,8,0,25,17
1650241834937,CSE 190,A00,092507,Dubnov; Shlomo,14,0,20,6
1650241840962,ECE 45,A01,083139,Staff,0,13,40,40
1650241847002,ECE 65,A50,083695,Staff,0,5,30,30
1650241853029,ECE 109,A01,091882,Touri; Behrouz,47,0,70,23
1650241859052,ECE 180,A00,083140,Abi Samra; Nicholas Camill,24,0,30,6
1650241859052,ECE 180,B00,083141,Abi Samra; Nicholas Camill,7,0,30,23
1650241865085,MATH 10A,A01,083735,Patchell; Gregory David,11,0,30,19
1650241865085,MATH 10A,A02,083736,Patchell; Gregory David,28,0,30,2
1650241865085,MATH 10A,A03,083737,Patchell; Gregory David,26,0,30,4
1650241871109,MATH 10B,A01,083207,Staff,0,6,30,30
1650241871109,MATH 10B,A02,083208,Staff,0,5,30,30
1650241871109,MATH 10B,B01,083739,Staff,17,0,30,13
1650241871109,MATH 10B,B02,083740,Staff,29,0,30,1
1650241877139,MATH 18,A01,083743,Staff,7,0,30,23
1650241877139,MATH 18,A02,083744,Staff,28,0,30,2
1650241877139,MATH 18,A03,083745,Staff,23,0,30,7
1650241877139,MATH 18,A04,083746,Staff,27,0,30,3
1650241877139,MATH 18,B01,083748,Staff,0,10,30,30
1650241877139,MATH 18,B02,083749,Staff,0,8,30,30
1650241877139,MATH 18,B03,083750,Staff,0,7,30,30
1650241877139,MATH 18,B04,083751,Staff,0,8,30,30
1650241883165,MATH 20A,A01,083754,Staff,26,0,40,14
1650241889188,MATH 20B,A01,083756,Staff,1,6,30,29
1650241889188,MATH 20B,A02,083757,Staff,0,6,30,30
1650241895213,MATH 20C,A01,083760,Staff,0,12,30,30
1650241895213,MATH 20C,A02,083761,Staff,0,13,30,30
1650241895213,MATH 20C,B01,083762,Staff,14,0,30,16
1650241895213,MATH 20C,B02,083763,Staff,28,0,30,2
1650241901236,MATH 20D,A01,083765,Staff,1,2,30,29
1650241901236,MATH 20D,A02,083766,Staff,8,0,30,22
1650241901236,MATH 20D,A03,083767,Staff,28,0,30,2
1650241907260,MATH 20E,A01,083771,Staff,8,0,30,22
1650241907260,MATH 20E,A02,083772,Staff,21,0,30,9
1650241907260,MATH 20E,B01,083773,Staff,0,0,30,30
1650241907260,MATH 20E,B02,083774,Staff,12,0,30,18
1650241913288,MATH 103A,A01,083777,Staff,0,9,30,30
1650241913288,MATH 103A,A02,083778,Staff,0,10,30,30
1650241913288,MATH 103A,B01,083779,Staff,0,10,30,30
1650241913288,MATH 103A,B02,083780,Staff,0,9,30,30
1650241919315,MATH 105,A01,085443,Staff,0,17,30,30
1650241925339,MATH 109,A01,083213,Anzaldo; Leesa B,0,3,30,30
1650241925339,MATH 109,A02,083214,Anzaldo; Leesa B,0,6,30,30
1650241925339,MATH 109,B01,083215,Anzaldo; Leesa B,0,4,30,30
1650241925339,MATH 109,B02,083216,Anzaldo; Leesa B,1,4,30,29
1650241931362,MATH 142A,A01,083219,Chow; Bennett,0,12,30,30
1650241931362,MATH 142A,A02,083220,Chow; Bennett,0,11,30,30
1650241931362,MATH 142A,B01,083221,Chow; Bennett,0,11,30,30
1650241931362,MATH 142A,B02,083222,Chow; Bennett,0,12,30,30
1650241937386,MATH 193A,A01,083224,Staff,0,5,30,30
1650241937386,MATH 193A,A02,083225,Staff,0,4,30,30
1650241937386,MATH 193A,A03,083781,Staff,0,2,30,30
1650241937386,MATH 193A,A04,083782,Staff,0,1,30,30
1650241943410,MATH 197,001,091859,McAuley; Julian John,9998,0,9999,1
1650241949466,COGS 9,A01,083615,Staff,0,14,60,60
1650241955493,COGS 11,A01,083617,Boyle; Mary E. T.,24,0,40,16
1650241961515,COGS 13,A01,083071,Staff,0,30,40,40
1650241967539,COGS 14A,A01,092681,Staff,1,13,100,99
1650241973566,COGS 14B,A01,083073,Cheng; Tzu-Han,0,8,50,50
1650241979590,COGS 17,A01,092677,Staff,33,0,75,42
1650241985616,COGS 100,A01,083619,Staff,1,21,60,59
1650241991648,COGS 101A,A01,083621,Davis; Joshua Daniel,0,21,60,60
1650241997685,COGS 101B,A01,091572,Staff,5,0,60,55
1650242003706,COGS 101C,A01,083625,Delgado; Tania,20,0,30,10
1650242009733,COGS 107A,A01,083627,Boyle; Mary E. T.,1,7,60,59
1650242015768,COGS 118A,A01,083075,Staff,15,0,60,45
1650242021798,CSE 3,A50,083646,Miranda; Gregory Joseph,22,0,38,16
1650242021798,CSE 3,A51,083647,Miranda; Gregory Joseph,37,0,37,0
1650242027822,CSE 8A,A50,083650,Miranda; Gregory Joseph,0,18,40,40
1650242033850,CSE 11,A01,083080,Cao; Yingjun,0,68,40,40
1650242039875,CSE 12,A01,083652,Staff,0,9,100,100
1650242045899,CSE 15L,A01,083654,Staff,0,1,50,50
1650242045899,CSE 15L,A02,083655,Staff,5,0,50,45
1650242051923,CSE 20,A01,083657,Staff,53,0,80,27
1650242057949,CSE 30,A01,083084,Eldon; John,0,70,40,40
1650242063973,CSE 100,A01,083659,Cao; Yingjun,0,64,50,50
1650242070005,CSE 134B,A01,083661,Powell; Thomas Allan,0,27,65,65
1650242076037,CSE 140,A01,083663,Staff,1,0,75,74
1650242082060,CSE 140L,A01,083088,Eldon; John,0,4,75,75
1650242088086,CSE 175,A01,083665,Kumar; Rakesh,8,0,25,17
1650242094199,CSE 190,A00,092507,Dubnov; Shlomo,14,0,20,6
1650242100222,ECE 45,A01,083139,Staff,0,13,40,40
1650242106247,ECE 65,A50,083695,Staff,0,5,30,30
1650242112269,ECE 109,A01,091882,Touri; Behrouz,47,0,70,23
1650242118294,ECE 180,A00,083140,Abi Samra; Nicholas Camill,24,0,30,6
1650242118294,ECE 180,B00,083141,Abi Samra; Nicholas Camill,7,0,30,23
1650242124318,MATH 10A,A01,083735,Patchell; Gregory David,11,0,30,19
1650242124318,MATH 10A,A02,083736,Patchell; Gregory David,28,0,30,2
1650242124318,MATH 10A,A03,083737,Patchell; Gregory David,26,0,30,4
1650242130343,MATH 10B,A01,083207,Staff,0,6,30,30
1650242130343,MATH 10B,A02,083208,Staff,0,5,30,30
1650242130343,MATH 10B,B01,083739,Staff,17,0,30,13
1650242130343,MATH 10B,B02,083740,Staff,29,0,30,1
1650242136367,MATH 18,A01,083743,Staff,7,0,30,23
1650242136367,MATH 18,A02,083744,Staff,28,0,30,2
1650242136367,MATH 18,A03,083745,Staff,23,0,30,7
1650242136367,MATH 18,A04,083746,Staff,27,0,30,3
1650242136367,MATH 18,B01,083748,Staff,0,10,30,30
1650242136367,MATH 18,B02,083749,Staff,0,8,30,30
1650242136367,MATH 18,B03,083750,Staff,0,7,30,30
1650242136367,MATH 18,B04,083751,Staff,0,8,30,30
1650242142390,MATH 20A,A01,083754,Staff,26,0,40,14
1650242148415,MATH 20B,A01,083756,Staff,1,6,30,29
1650242148415,MATH 20B,A02,083757,Staff,0,6,30,30
1650242154438,MATH 20C,A01,083760,Staff,0,12,30,30
1650242154438,MATH 20C,A02,083761,Staff,0,13,30,30
1650242154438,MATH 20C,B01,083762,Staff,14,0,30,16
1650242154438,MATH 20C,B02,083763,Staff,28,0,30,2
1650242160465,MATH 20D,A01,083765,Staff,1,2,30,29
1650242160465,MATH 20D,A02,083766,Staff,8,0,30,22
1650242160465,MATH 20D,A03,083767,Staff,28,0,30,2
1650242166493,MATH 20E,A01,083771,Staff,8,0,30,22
1650242166493,MATH 20E,A02,083772,Staff,21,0,30,9
1650242166493,MATH 20E,B01,083773,Staff,0,0,30,30
1650242166493,MATH 20E,B02,083774,Staff,12,0,30,18
1650242172516,MATH 103A,A01,083777,Staff,0,9,30,30
1650242172516,MATH 103A,A02,083778,Staff,0,10,30,30
1650242172516,MATH 103A,B01,083779,Staff,0,10,30,30
1650242172516,MATH 103A,B02,083780,Staff,0,9,30,30
1650242178538,MATH 105,A01,085443,Staff,0,17,30,30
1650242184565,MATH 109,A01,083213,Anzaldo; Leesa B,0,4,30,30
1650242184565,MATH 109,A02,083214,Anzaldo; Leesa B,0,6,30,30
1650242184565,MATH 109,B01,083215,Anzaldo; Leesa B,0,4,30,30
1650242184565,MATH 109,B02,083216,Anzaldo; Leesa B,1,4,30,29
1650242190593,MATH 142A,A01,083219,Chow; Bennett,0,12,30,30
1650242190593,MATH 142A,A02,083220,Chow; Bennett,0,11,30,30
1650242190593,MATH 142A,B01,083221,Chow; Bennett,0,11,30,30
1650242190593,MATH 142A,B02,083222,Chow; Bennett,0,12,30,30
1650242196615,MATH 193A,A01,083224,Staff,0,5,30,30
1650242196615,MATH 193A,A02,083225,Staff,0,4,30,30
1650242196615,MATH 193A,A03,083781,Staff,0,2,30,30
1650242196615,MATH 193A,A04,083782,Staff,0,1,30,30
1650242202636,MATH 197,001,091859,McAuley; Julian John,9998,0,9999,1
1650242208697,COGS 9,A01,083615,Staff,0,14,60,60
1650242214724,COGS 11,A01,083617,Boyle; Mary E. T.,24,0,40,16
1650242220750,COGS 13,A01,083071,Staff,0,30,40,40
1650242226773,COGS 14A,A01,092681,Staff,1,13,100,99
1650242232796,COGS 14B,A01,083073,Cheng; Tzu-Han,0,8,50,50
1650242238823,COGS 17,A01,092677,Staff,33,0,75,42
1650242244849,COGS 100,A01,083619,Staff,1,21,60,59
1650242250876,COGS 101A,A01,083621,Davis; Joshua Daniel,0,21,60,60
1650242256900,COGS 101B,A01,091572,Staff,5,0,60,55
1650242262932,COGS 101C,A01,083625,Delgado; Tania,20,0,30,10
1650242268957,COGS 107A,A01,083627,Boyle; Mary E. T.,1,7,60,59
1650242274990,COGS 118A,A01,083075,Staff,15,0,60,45
1650242281014,CSE 3,A50,083646,Miranda; Gregory Joseph,22,0,38,16
1650242281014,CSE 3,A51,083647,Miranda; Gregory Joseph,37,0,37,0
1650242287038,CSE 8A,A50,083650,Miranda; Gregory Joseph,0,18,40,40
1650242293066,CSE 11,A01,083080,Cao; Yingjun,0,68,40,40
1650242299089,CSE 12,A01,083652,Staff,0,9,100,100
1650242305130,CSE 15L,A01,083654,Staff,0,1,50,50
1650242305130,CSE 15L,A02,083655,Staff,5,0,50,45
1650242311154,CSE 20,A01,083657,Staff,53,0,80,27
1650242317180,CSE 30,A01,083084,Eldon; John,0,70,40,40
1650242323202,CSE 100,A01,083659,Cao; Yingjun,0,64,50,50
1650242329224,CSE 134B,A01,083661,Powell; Thomas Allan,0,27,65,65
1650242335248,CSE 140,A01,083663,Staff,1,0,75,74
1650242341272,CSE 140L,A01,083088,Eldon; John,0,4,75,75
1650242347306,CSE 175,A01,083665,Kumar; Rakesh,8,0,25,17
1650242353337,CSE 190,A00,092507,Dubnov; Shlomo,14,0,20,6
1650242359359,ECE 45,A01,083139,Staff,0,13,40,40
1650242365384,ECE 65,A50,083695,Staff,0,5,30,30
1650242371405,ECE 109,A01,091882,Touri; Behrouz,47,0,70,23
1650242377433,ECE 180,A00,083140,Abi Samra; Nicholas Camill,24,0,30,6
1650242377433,ECE 180,B00,083141,Abi Samra; Nicholas Camill,7,0,30,23
1650242383455,MATH 10A,A01,083735,Patchell; Gregory David,11,0,30,19
1650242383455,MATH 10A,A02,083736,Patchell; Gregory David,28,0,30,2
1650242383455,MATH 10A,A03,083737,Patchell; Gregory David,26,0,30,4
1650242389484,MATH 10B,A01,083207,Staff,0,6,30,30
1650242389484,MATH 10B,A02,083208,Staff,0,5,30,30
1650242389484,MATH 10B,B01,083739,Staff,17,0,30,13
1650242389484,MATH 10B,B02,083740,Staff,29,0,30,1
1650242395511,MATH 18,A01,083743,Staff,7,0,30,23
1650242395511,MATH 18,A02,083744,Staff,28,0,30,2
1650242395511,MATH 18,A03,083745,Staff,23,0,30,7
1650242395511,MATH 18,A04,083746,Staff,27,0,30,3
1650242395511,MATH 18,B01,083748,Staff,0,10,30,30
1650242395511,MATH 18,B02,083749,Staff,0,8,30,30
1650242395511,MATH 18,B03,083750,Staff,0,7,30,30
1650242395511,MATH 18,B04,083751,Staff,0,8,30,30
1650242401532,MATH 20A,A01,083754,Staff,26,0,40,14
1650242407565,MATH 20B,A01,083756,Staff,1,6,30,29
1650242407565,MATH 20B,A02,083757,Staff,0,6,30,30
1650242413595,MATH 20C,A01,083760,Staff,0,12,30,30
1650242413595,MATH 20C,A02,083761,Staff,0,13,30,30
1650242413595,MATH 20C,B01,083762,Staff,14,0,30,16
1650242413595,MATH 20C,B02,083763,Staff,28,0,30,2
1650242419627,MATH 20D,A01,083765,Staff,1,2,30,29
1650242419627,MATH 20D,A02,083766,Staff,8,0,30,22
1650242419627,MATH 20D,A03,083767,Staff,28,0,30,2
1650242425654,MATH 20E,A01,083771,Staff,8,0,30,22
1650242425654,MATH 20E,A02,083772,Staff,21,0,30,9
1650242425654,MATH 20E,B01,083773,Staff,0,0,30,30
1650242425654,MATH 20E,B02,083774,Staff,12,0,30,18
1650242431682,MATH 103A,A01,083777,Staff,0,9,30,30
1650242431682,MATH 103A,A02,083778,Staff,0,10,30,30
1650242431682,MATH 103A,B01,083779,Staff,0,10,30,30
1650242431682,MATH 103A,B02,083780,Staff,0,9,30,30
1650242437704,MATH 105,A01,085443,Staff,0,17,30,30
1650242443728,MATH 109,A01,083213,Anzaldo; Leesa B,0,4,30,30
1650242443728,MATH 109,A02,083214,Anzaldo; Leesa B,0,6,30,30
1650242443728,MATH 109,B01,083215,Anzaldo; Leesa B,0,4,30,30
1650242443728,MATH 109,B02,083216,Anzaldo; Leesa B,1,4,30,29
1650242449774,MATH 142A,A01,083219,Chow; Bennett,0,12,30,30
1650242449774,MATH 142A,A02,083220,Chow; Bennett,0,11,30,30
1650242449774,MATH 142A,B01,083221,Chow; Bennett,0,11,30,30
1650242449774,MATH 142A,B02,083222,Chow; Bennett,0,12,30,30
1650242455802,MATH 193A,A01,083224,Staff,0,5,30,30
1650242455802,MATH 193A,A02,083225,Staff,0,4,30,30
1650242455802,MATH 193A,A03,083781,Staff,0,2,30,30
1650242455802,MATH 193A,A04,083782,Staff,0,1,30,30
1650242461826,MATH 197,001,091859,McAuley; Julian John,9998,0,9999,1
1650242467887,COGS 9,A01,083615,Staff,0,14,60,60
1650242473909,COGS 11,A01,083617,Boyle; Mary E. T.,24,0,40,16
1650242479933,COGS 13,A01,083071,Staff,0,30,40,40
1650242485959,COGS 14A,A01,092681,Staff,1,13,100,99
1650242491986,COGS 14B,A01,083073,Cheng; Tzu-Han,0,8,50,50
1650242498020,COGS 17,A01,092677,Staff,33,0,75,42
1650242504046,COGS 100,A01,083619,Staff,1,21,60,59
1650242510071,COGS 101A,A01,083621,Davis; Joshua Daniel,0,21,60,60
1650242516100,COGS 101B,A01,091572,Staff,5,0,60,55
1650242522125,COGS 101C,A01,083625,Delgado; Tania,20,0,30,10
1650242528153,COGS 107A,A01,083627,Boyle; Mary E. T.,1,7,60,59
1650242534180,COGS 118A,A01,083075,Staff,15,0,60,45
1650242540202,CSE 3,A50,083646,Miranda; Gregory Joseph,22,0,38,16
1650242540202,CSE 3,A51,083647,Miranda; Gregory Joseph,37,0,37,0
1650242546227,CSE 8A,A50,083650,Miranda; Gregory Joseph,0,18,40,40
1650242552252,CSE 11,A01,083080,Cao; Yingjun,0,69,40,40
1650242558277,CSE 12,A01,083652,Staff,0,9,100,100
1650242564305,CSE 15L,A01,083654,Staff,0,1,50,50
1650242564305,CSE 15L,A02,083655,Staff,5,0,50,45
1650242570328,CSE 20,A01,083657,Staff,53,0,80,27
1650242576351,CSE 30,A01,083084,Eldon; John,0,70,40,40
1650242582376,CSE 100,A01,083659,Cao; Yingjun,0,64,50,50
1650242588403,CSE 134B,A01,083661,Powell; Thomas Allan,0,27,65,65
1650242594428,CSE 140,A01,083663,Staff,0,0,75,75
1650242600457,CSE 140L,A01,083088,Eldon; John,0,4,75,75
1650242606481,CSE 175,A01,083665,Kumar; Rakesh,8,0,25,17
1650242612511,CSE 190,A00,092507,Dubnov; Shlomo,14,0,20,6
1650242618561,ECE 45,A01,083139,Staff,0,13,40,40
1650242624586,ECE 65,A50,083695,Staff,0,5,30,30
1650242630612,ECE 109,A01,091882,Touri; Behrouz,47,0,70,23
1650242636639,ECE 180,A00,083140,Abi Samra; Nicholas Camill,24,0,30,6
1650242636639,ECE 180,B00,083141,Abi Samra; Nicholas Camill,7,0,30,23
1650242642667,MATH 10A,A01,083735,Patchell; Gregory David,11,0,30,19
1650242642667,MATH 10A,A02,083736,Patchell; Gregory David,28,0,30,2
1650242642667,MATH 10A,A03,083737,Patchell; Gregory David,26,0,30,4
1650242648692,MATH 10B,A01,083207,Staff,0,6,30,30
1650242648692,MATH 10B,A02,083208,Staff,0,5,30,30
1650242648692,MATH 10B,B01,083739,Staff,17,0,30,13
1650242648692,MATH 10B,B02,083740,Staff,29,0,30,1
1650242654722,MATH 18,A01,083743,Staff,7,0,30,23
1650242654722,MATH 18,A02,083744,Staff,28,0,30,2
1650242654722,MATH 18,A03,083745,Staff,23,0,30,7
1650242654722,MATH 18,A04,083746,Staff,27,0,30,3
1650242654722,MATH 18,B01,083748,Staff,0,10,30,30
1650242654722,MATH 18,B02,083749,Staff,0,8,30,30
1650242654722,MATH 18,B03,083750,Staff,0,7,30,30
1650242654722,MATH 18,B04,083751,Staff,0,8,30,30
1650242660746,MATH 20A,A01,083754,Staff,26,0,40,14
1650242666770,MATH 20B,A01,083756,Staff,1,6,30,29
1650242666770,MATH 20B,A02,083757,Staff,0,6,30,30
1650242672794,MATH 20C,A01,083760,Staff,0,12,30,30
1650242672794,MATH 20C,A02,083761,Staff,0,13,30,30
1650242672794,MATH 20C,B01,083762,Staff,14,0,30,16
1650242672794,MATH 20C,B02,083763,Staff,28,0,30,2
1650242678818,MATH 20D,A01,083765,Staff,1,2,30,29
1650242678818,MATH 20D,A02,083766,Staff,8,0,30,22
1650242678818,MATH 20D,A03,083767,Staff,28,0,30,2
1650242684844,MATH 20E,A01,083771,Staff,8,0,30,22
1650242684844,MATH 20E,A02,083772,Staff,21,0,30,9
1650242684844,MATH 20E,B01,083773,Staff,0,0,30,30
1650242684844,MATH 20E,B02,083774,Staff,12,0,30,18
1650242690956,MATH 103A,A01,083777,Staff,0,9,30,30
1650242690956,MATH 103A,A02,083778,Staff,0,10,30,30
1650242690956,MATH 103A,B01,083779,Staff,0,10,30,30
1650242690956,MATH 103A,B02,083780,Staff,0,9,30,30
1650242696980,MATH 105,A01,085443,Staff,0,17,30,30
1650242703005,MATH 109,A01,083213,Anzaldo; Leesa B,0,4,30,30
1650242703005,MATH 109,A02,083214,Anzaldo; Leesa B,0,6,30,30
1650242703005,MATH 109,B01,083215,Anzaldo; Leesa B,0,4,30,30
1650242703005,MATH 109,B02,083216,Anzaldo; Leesa B,1,4,30,29
1650242709027,MATH 142A,A01,083219,Chow; Bennett,0,12,30,30
1650242709027,MATH 142A,A02,083220,Chow; Bennett,0,11,30,30
1650242709027,MATH 142A,B01,083221,Chow; Bennett,0,11,30,30
1650242709027,MATH 142A,B02,083222,Chow; Bennett,0,12,30,30
1650242715055,MATH 193A,A01,083224,Staff,0,5,30,30
1650242715055,MATH 193A,A02,083225,Staff,0,4,30,30
1650242715055,MATH 193A,A03,083781,Staff,0,2,30,30
1650242715055,MATH 193A,A04,083782,Staff,0,1,30,30
1650242721080,MATH 197,001,091859,McAuley; Julian John,9998,0,9999,1
1650242727130,COGS 9,A01,083615,Staff,0,14,60,60
1650242733162,COGS 11,A01,083617,Boyle; Mary E. T.,24,0,40,16
1650242739188,COGS 13,A01,083071,Staff,0,30,40,40
1650242745210,COGS 14A,A01,092681,Staff,1,13,100,99
1650242751233,COGS 14B,A01,083073,Cheng; Tzu-Han,0,8,50,50
1650242757256,COGS 17,A01,092677,Staff,33,0,75,42
1650242763279,COGS 100,A01,083619,Staff,1,21,60,59
1650242769301,COGS 101A,A01,083621,Davis; Joshua Daniel,0,20,60,60
1650242775326,COGS 101B,A01,091572,Staff,5,0,60,55
1650242781351,COGS 101C,A01,083625,Delgado; Tania,20,0,30,10
1650242787374,COGS 107A,A01,083627,Boyle; Mary E. T.,1,7,60,59
1650242793397,COGS 118A,A01,083075,Staff,15,0,60,45
1650242799425,CSE 3,A50,083646,Miranda; Gregory Joseph,22,0,38,16
1650242799425,CSE 3,A51,083647,Miranda; Gregory Joseph,37,0,37,0
1650242805451,CSE 8A,A50,083650,Miranda; Gregory Joseph,0,18,40,40
1650242811474,CSE 11,A01,083080,Cao; Yingjun,0,69,40,40
1650242817500,CSE 12,A01,083652,Staff,0,9,100,100
1650242823525,CSE 15L,A01,083654,Staff,0,1,50,50
1650242823525,CSE 15L,A02,083655,Staff,5,0,50,45
1650242829553,CSE 20,A01,083657,Staff,53,0,80,27
1650242835577,CSE 30,A01,083084,Eldon; John,0,70,40,40
1650242841602,CSE 100,A01,083659,Cao; Yingjun,0,64,50,50
1650242847624,CSE 134B,A01,083661,Powell; Thomas Allan,0,27,65,65
1650242853650,CSE 140,A01,083663,Staff,0,0,75,75
1650242859681,CSE 140L,A01,083088,Eldon; John,0,5,75,75
1650242865704,CSE 175,A01,083665,Kumar; Rakesh,8,0,25,17
1650242871727,CSE 190,A00,092507,Dubnov; Shlomo,14,0,20,6
1650242877752,ECE 45,A01,083139,Staff,0,13,40,40
1650242883778,ECE 65,A50,083695,Staff,0,5,30,30
1650242889802,ECE 109,A01,091882,Touri; Behrouz,47,0,70,23
1650242895825,ECE 180,A00,083140,Abi Samra; Nicholas Camill,24,0,30,6
1650242895825,ECE 180,B00,083141,Abi Samra; Nicholas Camill,7,0,30,23
1650242901853,MATH 10A,A01,083735,Patchell; Gregory David,11,0,30,19
1650242901853,MATH 10A,A02,083736,Patchell; Gregory David,28,0,30,2
1650242901853,MATH 10A,A03,083737,Patchell; Gregory David,26,0,30,4
1650242907882,MATH 10B,A01,083207,Staff,0,6,30,30
1650242907882,MATH 10B,A02,083208,Staff,0,5,30,30
1650242907882,MATH 10B,B01,083739,Staff,17,0,30,13
1650242907882,MATH 10B,B02,083740,Staff,29,0,30,1
1650242913911,MATH 18,A01,083743,Staff,7,0,30,23
1650242913911,MATH 18,A02,083744,Staff,28,0,30,2
1650242913911,MATH 18,A03,083745,Staff,23,0,30,7
1650242913911,MATH 18,A04,083746,Staff,27,0,30,3
1650242913911,MATH 18,B01,083748,Staff,0,10,30,30
1650242913911,MATH 18,B02,083749,Staff,0,8,30,30
1650242913911,MATH 18,B03,083750,Staff,0,7,30,30
1650242913911,MATH 18,B04,083751,Staff,0,8,30,30
1650242919934,MATH 20A,A01,083754,Staff,26,0,40,14
1650242925958,MATH 20B,A01,083756,Staff,1,6,30,29
1650242925958,MATH 20B,A02,083757,Staff,0,6,30,30
1650242931982,MATH 20C,A01,083760,Staff,0,12,30,30
1650242931982,MATH 20C,A02,083761,Staff,0,13,30,30
1650242931982,MATH 20C,B01,083762,Staff,14,0,30,16
1650242931982,MATH 20C,B02,083763,Staff,28,0,30,2
1650242938007,MATH 20D,A01,083765,Staff,1,2,30,29
1650242938007,MATH 20D,A02,083766,Staff,8,0,30,22
1650242938007,MATH 20D,A03,083767,Staff,28,0,30,2
1650242944031,MATH 20E,A01,083771,Staff,8,0,30,22
1650242944031,MATH 20E,A02,083772,Staff,21,0,30,9
1650242944031,MATH 20E,B01,083773,Staff,0,0,30,30
1650242944031,MATH 20E,B02,083774,Staff,12,0,30,18
1650242950055,MATH 103A,A01,083777,Staff,0,9,30,30
1650242950055,MATH 103A,A02,083778,Staff,0,10,30,30
1650242950055,MATH 103A,B01,083779,Staff,0,10,30,30
1650242950055,MATH 103A,B02,083780,Staff,0,9,30,30
1650242956080,MATH 105,A01,085443,Staff,0,17,30,30
1650242962104,MATH 109,A01,083213,Anzaldo; Leesa B,0,4,30,30
1650242962104,MATH 109,A02,083214,Anzaldo; Leesa B,0,6,30,30
1650242962104,MATH 109,B01,083215,Anzaldo; Leesa B,0,4,30,30
1650242962104,MATH 109,B02,083216,Anzaldo; Leesa B,1,4,30,29
1650242968133,MATH 142A,A01,083219,Chow; Bennett,0,12,30,30
1650242968133,MATH 142A,A02,083220,Chow; Bennett,0,11,30,30
1650242968133,MATH 142A,B01,083221,Chow; Bennett,0,11,30,30
1650242968133,MATH 142A,B02,083222,Chow; Bennett,0,12,30,30
1650242974156,MATH 193A,A01,083224,Staff,0,5,30,30
1650242974156,MATH 193A,A02,083225,Staff,0,4,30,30
1650242974156,MATH 193A,A03,083781,Staff,0,2,30,30
1650242974156,MATH 193A,A04,083782,Staff,0,1,30,30
1650242980182,MATH 197,001,091859,McAuley; Julian John,9998,0,9999,1
1650242986232,COGS 9,A01,083615,Staff,0,14,60,60
1650242992255,COGS 11,A01,083617,Boyle; Mary E. T.,24,0,40,16
1650242998277,COGS 13,A01,083071,Staff,0,30,40,40
1650243004298,COGS 14A,A01,092681,Staff,1,13,100,99
1650243010324,COGS 14B,A01,083073,Cheng; Tzu-Han,0,8,50,50
1650243016360,COGS 17,A01,092677,Staff,33,0,75,42
1650243022386,COGS 100,A01,083619,Staff,1,21,60,59
1650243028413,COGS 101A,A01,083621,Davis; Joshua Daniel,0,20,60,60
1650243034438,COGS 101B,A01,091572,Staff,5,0,60,55
1650243040463,COGS 101C,A01,083625,Delgado; Tania,20,0,30,10
1650243046494,COGS 107A,A01,083627,Boyle; Mary E. T.,1,7,60,59
1650243052519,COGS 118A,A01,083075,Staff,15,0,60,45
1650243058549,CSE 3,A50,083646,Miranda; Gregory Joseph,22,0,38,16
1650243058549,CSE 3,A51,083647,Miranda; Gregory Joseph,37,0,37,0
1650243064611,CSE 8A,A50,083650,Miranda; Gregory Joseph,0,18,40,40
1650243070638,CSE 11,A01,083080,Cao; Yingjun,0,69,40,40
1650243076662,CSE 12,A01,083652,Staff,0,9,100,100
1650243082685,CSE 15L,A01,083654,Staff,0,1,50,50
1650243082685,CSE 15L,A02,083655,Staff,5,0,50,45
1650243088711,CSE 20,A01,083657,Staff,53,0,80,27
1650243094736,CSE 30,A01,083084,Eldon; John,0,70,40,40
1650243100765,CSE 100,A01,083659,Cao; Yingjun,0,64,50,50
1650243106789,CSE 134B,A01,083661,Powell; Thomas Allan,0,27,65,65
1650243112817,CSE 140,A01,083663,Staff,0,0,75,75
1650243118841,CSE 140L,A01,083088,Eldon; John,0,5,75,75
1650243124867,CSE 175,A01,083665,Kumar; Rakesh,8,0,25,17
1650243130891,CSE 190,A00,092507,Dubnov; Shlomo,14,0,20,6
1650243136915,ECE 45,A01,083139,Staff,0,13,40,40
1650243142939,ECE 65,A50,083695,Staff,0,5,30,30
1650243148964,ECE 109,A01,091882,Touri; Behrouz,47,0,70,23
1650243154988,ECE 180,A00,083140,Abi Samra; Nicholas Camill,24,0,30,6
1650243154988,ECE 180,B00,083141,Abi Samra; Nicholas Camill,7,0,30,23
1650243161013,MATH 10A,A01,083735,Patchell; Gregory David,11,0,30,19
1650243161013,MATH 10A,A02,083736,Patchell; Gregory David,28,0,30,2
1650243161013,MATH 10A,A03,083737,Patchell; Gregory David,26,0,30,4
1650243167041,MATH 10B,A01,083207,Staff,0,6,30,30
1650243167041,MATH 10B,A02,083208,Staff,0,5,30,30
1650243167041,MATH 10B,B01,083739,Staff,17,0,30,13
1650243167041,MATH 10B,B02,083740,Staff,29,0,30,1
1650243173066,MATH 18,A01,083743,Staff,7,0,30,23
1650243173066,MATH 18,A02,083744,Staff,28,0,30,2
1650243173066,MATH 18,A03,083745,Staff,23,0,30,7
1650243173066,MATH 18,A04,083746,Staff,27,0,30,3
1650243173066,MATH 18,B01,083748,Staff,0,10,30,30
1650243173066,MATH 18,B02,083749,Staff,0,8,30,30
1650243173066,MATH 18,B03,083750,Staff,0,7,30,30
1650243173066,MATH 18,B04,083751,Staff,0,8,30,30
1650243179096,MATH 20A,A01,083754,Staff,26,0,40,14
1650243185122,MATH 20B,A01,083756,Staff,1,6,30,29
1650243185122,MATH 20B,A02,083757,Staff,0,6,30,30
1650243191148,MATH 20C,A01,083760,Staff,0,12,30,30
1650243191148,MATH 20C,A02,083761,Staff,0,13,30,30
1650243191148,MATH 20C,B01,083762,Staff,14,0,30,16
1650243191148,MATH 20C,B02,083763,Staff,28,0,30,2
1650243197174,MATH 20D,A01,083765,Staff,1,2,30,29
1650243197174,MATH 20D,A02,083766,Staff,8,0,30,22
1650243197174,MATH 20D,A03,083767,Staff,28,0,30,2
1650243203199,MATH 20E,A01,083771,Staff,8,0,30,22
1650243203199,MATH 20E,A02,083772,Staff,21,0,30,9
1650243203199,MATH 20E,B01,083773,Staff,0,0,30,30
1650243203199,MATH 20E,B02,083774,Staff,12,0,30,18
1650243209223,MATH 103A,A01,083777,Staff,0,9,30,30
1650243209223,MATH 103A,A02,083778,Staff,0,10,30,30
1650243209223,MATH 103A,B01,083779,Staff,0,10,30,30
1650243209223,MATH 103A,B02,083780,Staff,0,9,30,30
1650243215246,MATH 105,A01,085443,Staff,0,17,30,30
1650243221270,MATH 109,A01,083213,Anzaldo; Leesa B,0,4,30,30
1650243221270,MATH 109,A02,083214,Anzaldo; Leesa B,0,6,30,30
1650243221270,MATH 109,B01,083215,Anzaldo; Leesa B,0,4,30,30
1650243221270,MATH 109,B02,083216,Anzaldo; Leesa B,1,4,30,29
1650243227295,MATH 142A,A01,083219,Chow; Bennett,0,12,30,30
1650243227295,MATH 142A,A02,083220,Chow; Bennett,0,11,30,30
1650243227295,MATH 142A,B01,083221,Chow; Bennett,0,11,30,30
1650243227295,MATH 142A,B02,083222,Chow; Bennett,0,12,30,30
1650243233325,MATH 193A,A01,083224,Staff,0,5,30,30
1650243233325,MATH 193A,A02,083225,Staff,0,4,30,30
1650243233325,MATH 193A,A03,083781,Staff,0,2,30,30
1650243233325,MATH 193A,A04,083782,Staff,0,1,30,30
1650243239348,MATH 197,001,091859,McAuley; Julian John,9998,0,9999,1
1650243245407,COGS 9,A01,083615,Staff,0,14,60,60
1650243251434,COGS 11,A01,083617,Boyle; Mary E. T.,24,0,40,16
1650243257459,COGS 13,A01,083071,Staff,0,30,40,40
1650243263484,COGS 14A,A01,092681,Staff,1,13,100,99
1650243269509,COGS 14B,A01,083073,Cheng; Tzu-Han,0,8,50,50
1650243275534,COGS 17,A01,092677,Staff,33,0,75,42
1650243281646,COGS 100,A01,083619,Staff,1,21,60,59
1650243287673,COGS 101A,A01,083621,Davis; Joshua Daniel,0,20,60,60
1650243293699,COGS 101B,A01,091572,Staff,5,0,60,55
1650243299726,COGS 101C,A01,083625,Delgado; Tania,20,0,30,10
1650243305753,COGS 107A,A01,083627,Boyle; Mary E. T.,1,7,60,59
1650243311779,COGS 118A,A01,083075,Staff,15,0,60,45
1650243317802,CSE 3,A50,083646,Miranda; Gregory Joseph,22,0,38,16
1650243317802,CSE 3,A51,083647,Miranda; Gregory Joseph,37,0,37,0
1650243323830,CSE 8A,A50,083650,Miranda; Gregory Joseph,0,18,40,40
1650243329853,CSE 11,A01,083080,Cao; Yingjun,0,69,40,40
1650243335882,CSE 12,A01,083652,Staff,0,9,100,100
1650243341908,CSE 15L,A01,083654,Staff,0,1,50,50
1650243341908,CSE 15L,A02,083655,Staff,5,0,50,45
1650243347932,CSE 20,A01,083657,Staff,53,0,80,27
1650243353955,CSE 30,A01,083084,Eldon; John,0,70,40,40
1650243359984,CSE 100,A01,083659,Cao; Yingjun,0,64,50,50
1650243366008,CSE 134B,A01,083661,Powell; Thomas Allan,0,27,65,65
1650243372040,CSE 140,A01,083663,Staff,0,0,75,75
1650243378077,CSE 140L,A01,083088,Eldon; John,0,5,75,75
1650243384102,CSE 175,A01,083665,Kumar; Rakesh,8,0,25,17
1650243390124,CSE 190,A00,092507,Dubnov; Shlomo,14,0,20,6
1650243396150,ECE 45,A01,083139,Staff,0,13,40,40
1650243402178,ECE 65,A50,083695,Staff,0,5,30,30
1650243408203,ECE 109,A01,091882,Touri; Behrouz,47,0,70,23
1650243414229,ECE 180,A00,083140,Abi Samra; Nicholas Camill,24,0,30,6
1650243414229,ECE 180,B00,083141,Abi Samra; Nicholas Camill,7,0,30,23
1650243420254,MATH 10A,A01,083735,Patchell; Gregory David,11,0,30,19
1650243420254,MATH 10A,A02,083736,Patchell; Gregory David,28,0,30,2
1650243420254,MATH 10A,A03,083737,Patchell; Gregory David,26,0,30,4
1650243426277,MATH 10B,A01,083207,Staff,0,6,30,30
1650243426277,MATH 10B,A02,083208,Staff,0,5,30,30
1650243426277,MATH 10B,B01,083739,Staff,17,0,30,13
1650243426277,MATH 10B,B02,083740,Staff,29,0,30,1
1650243432301,MATH 18,A01,083743,Staff,7,0,30,23
1650243432301,MATH 18,A02,083744,Staff,28,0,30,2
1650243432301,MATH 18,A03,083745,Staff,23,0,30,7
1650243432301,MATH 18,A04,083746,Staff,27,0,30,3
1650243432301,MATH 18,B01,083748,Staff,0,10,30,30
1650243432301,MATH 18,B02,083749,Staff,0,8,30,30
1650243432301,MATH 18,B03,083750,Staff,0,7,30,30
1650243432301,MATH 18,B04,083751,Staff,0,8,30,30
1650243438331,MATH 20A,A01,083754,Staff,26,0,40,14
1650243444358,MATH 20B,A01,083756,Staff,1,6,30,29
1650243444358,MATH 20B,A02,083757,Staff,0,6,30,30
1650243450386,MATH 20C,A01,083760,Staff,0,12,30,30
1650243450386,MATH 20C,A02,083761,Staff,0,13,30,30
1650243450386,MATH 20C,B01,083762,Staff,14,0,30,16
1650243450386,MATH 20C,B02,083763,Staff,28,0,30,2
1650243456410,MATH 20D,A01,083765,Staff,1,2,30,29
1650243456410,MATH 20D,A02,083766,Staff,8,0,30,22
1650243456410,MATH 20D,A03,083767,Staff,28,0,30,2
1650243462435,MATH 20E,A01,083771,Staff,8,0,30,22
1650243462435,MATH 20E,A02,083772,Staff,21,0,30,9
1650243462435,MATH 20E,B01,083773,Staff,0,0,30,30
1650243462435,MATH 20E,B02,083774,Staff,12,0,30,18
1650243468462,MATH 103A,A01,083777,Staff,0,9,30,30
1650243468462,MATH 103A,A02,083778,Staff,0,10,30,30
1650243468462,MATH 103A,B01,083779,Staff,0,10,30,30
1650243468462,MATH 103A,B02,083780,Staff,0,9,30,30
1650243474484,MATH 105,A01,085443,Staff,0,17,30,30
1650243480521,MATH 109,A01,083213,Anzaldo; Leesa B,0,4,30,30
1650243480521,MATH 109,A02,083214,Anzaldo; Leesa B,0,6,30,30
1650243480521,MATH 109,B01,083215,Anzaldo; Leesa B,0,4,30,30
1650243480521,MATH 109,B02,083216,Anzaldo; Leesa B,1,4,30,29
1650243486544,MATH 142A,A01,083219,Chow; Bennett,0,12,30,30
1650243486544,MATH 142A,A02,083220,Chow; Bennett,0,11,30,30
1650243486544,MATH 142A,B01,083221,Chow; Bennett,0,11,30,30
1650243486544,MATH 142A,B02,083222,Chow; Bennett,0,12,30,30
1650243492571,MATH 193A,A01,083224,Staff,0,5,30,30
1650243492571,MATH 193A,A02,083225,Staff,0,4,30,30
1650243492571,MATH 193A,A03,083781,Staff,0,2,30,30
1650243492571,MATH 193A,A04,083782,Staff,0,1,30,30
1650243498596,MATH 197,001,091859,McAuley; Julian John,9998,0,9999,1
1650243504652,COGS 9,A01,083615,Staff,0,14,60,60
1650243510675,COGS 11,A01,083617,Boyle; Mary E. T.,24,0,40,16
1650243516701,COGS 13,A01,083071,Staff,0,30,40,40
1650243522728,COGS 14A,A01,092681,Staff,1,13,100,99
1650243528752,COGS 14B,A01,083073,Cheng; Tzu-Han,0,8,50,50
1650243534774,COGS 17,A01,092677,Staff,33,0,75,42
1650243540799,COGS 100,A01,083619,Staff,1,21,60,59
1650243546825,COGS 101A,A01,083621,Davis; Joshua Daniel,0,20,60,60
1650243552848,COGS 101B,A01,091572,Staff,5,0,60,55
1650243558875,COGS 101C,A01,083625,Delgado; Tania,20,0,30,10
1650243564899,COGS 107A,A01,083627,Boyle; Mary E. T.,1,7,60,59
1650243570921,COGS 118A,A01,083075,Staff,15,0,60,45
1650243576948,CSE 3,A50,083646,Miranda; Gregory Joseph,22,0,38,16
1650243576948,CSE 3,A51,083647,Miranda; Gregory Joseph,37,0,37,0
1650243582971,CSE 8A,A50,083650,Miranda; Gregory Joseph,0,18,40,40
1650243588995,CSE 11,A01,083080,Cao; Yingjun,0,69,40,40
1650243595017,CSE 12,A01,083652,Staff,0,9,100,100
1650243601050,CSE 15L,A01,083654,Staff,0,1,50,50
1650243601050,CSE 15L,A02,083655,Staff,5,0,50,45
1650243607073,CSE 20,A01,083657,Staff,53,0,80,27
1650243613097,CSE 30,A01,083084,Eldon; John,0,70,40,40
1650243619120,CSE 100,A01,083659,Cao; Yingjun,0,64,50,50
1650243625147,CSE 134B,A01,083661,Powell; Thomas Allan,0,27,65,65
1650243631171,CSE 140,A01,083663,Staff,0,0,75,75
1650243637196,CSE 140L,A01,083088,Eldon; John,0,5,75,75
1650243643221,CSE 175,A01,083665,Kumar; Rakesh,8,0,25,17
1650243649245,CSE 190,A00,092507,Dubnov; Shlomo,14,0,20,6
1650243655271,ECE 45,A01,083139,Staff,0,13,40,40
1650243661296,ECE 65,A50,083695,Staff,0,5,30,30
1650243667320,ECE 109,A01,091882,Touri; Behrouz,47,0,70,23
1650243673346,ECE 180,A00,083140,Abi Samra; Nicholas Camill,24,0,30,6
1650243673346,ECE 180,B00,083141,Abi Samra; Nicholas Camill,7,0,30,23
1650243679372,MATH 10A,A01,083735,Patchell; Gregory David,11,0,30,19
1650243679372,MATH 10A,A02,083736,Patchell; Gregory David,28,0,30,2
1650243679372,MATH 10A,A03,083737,Patchell; Gregory David,26,0,30,4
1650243685396,MATH 10B,A01,083207,Staff,0,6,30,30
1650243685396,MATH 10B,A02,083208,Staff,0,5,30,30
1650243685396,MATH 10B,B01,083739,Staff,17,0,30,13
1650243685396,MATH 10B,B02,083740,Staff,29,0,30,1
1650243691419,MATH 18,A01,083743,Staff,7,0,30,23
1650243691419,MATH 18,A02,083744,Staff,28,0,30,2
1650243691419,MATH 18,A03,083745,Staff,23,0,30,7
1650243691419,MATH 18,A04,083746,Staff,27,0,30,3
1650243691419,MATH 18,B01,083748,Staff,0,10,30,30
1650243691419,MATH 18,B02,083749,Staff,0,8,30,30
1650243691419,MATH 18,B03,083750,Staff,0,7,30,30
1650243691419,MATH 18,B04,083751,Staff,0,8,30,30
1650243697444,MATH 20A,A01,083754,Staff,26,0,40,14
1650243703467,MATH 20B,A01,083756,Staff,1,6,30,29
1650243703467,MATH 20B,A02,083757,Staff,0,6,30,30
1650243709495,MATH 20C,A01,083760,Staff,0,12,30,30
1650243709495,MATH 20C,A02,083761,Staff,0,13,30,30
1650243709495,MATH 20C,B01,083762,Staff,14,0,30,16
1650243709495,MATH 20C,B02,083763,Staff,28,0,30,2
1650243715519,MATH 20D,A01,083765,Staff,1,2,30,29
1650243715519,MATH 20D,A02,083766,Staff,8,0,30,22
1650243715519,MATH 20D,A03,083767,Staff,28,0,30,2
1650243721548,MATH 20E,A01,083771,Staff,8,0,30,22
1650243721548,MATH 20E,A02,083772,Staff,21,0,30,9
1650243721548,MATH 20E,B01,083773,Staff,0,0,30,30
1650243721548,MATH 20E,B02,083774,Staff,12,0,30,18
1650243727575,MATH 103A,A01,083777,Staff,0,9,30,30
1650243727575,MATH 103A,A02,083778,Staff,0,10,30,30
1650243727575,MATH 103A,B01,083779,Staff,0,10,30,30
1650243727575,MATH 103A,B02,083780,Staff,0,9,30,30
1650243733607,MATH 105,A01,085443,Staff,0,17,30,30
1650243739632,MATH 109,A01,083213,Anzaldo; Leesa B,0,4,30,30
1650243739632,MATH 109,A02,083214,Anzaldo; Leesa B,0,6,30,30
1650243739632,MATH 109,B01,083215,Anzaldo; Leesa B,0,4,30,30
1650243739632,MATH 109,B02,083216,Anzaldo; Leesa B,1,4,30,29
1650243745656,MATH 142A,A01,083219,Chow; Bennett,0,12,30,30
1650243745656,MATH 142A,A02,083220,Chow; Bennett,0,11,30,30
1650243745656,MATH 142A,B01,083221,Chow; Bennett,0,11,30,30
1650243745656,MATH 142A,B02,083222,Chow; Bennett,0,12,30,30
1650243751679,MATH 193A,A01,083224,Staff,0,5,30,30
1650243751679,MATH 193A,A02,083225,Staff,0,4,30,30
1650243751679,MATH 193A,A03,083781,Staff,0,2,30,30
1650243751679,MATH 193A,A04,083782,Staff,0,1,30,30
1650243757709,MATH 197,001,091859,McAuley; Julian John,9998,0,9999,1
1650243763761,COGS 9,A01,083615,Staff,0,14,60,60
1650243769783,COGS 11,A01,083617,Boyle; Mary E. T.,24,0,40,16
1650243775807,COGS 13,A01,083071,Staff,0,30,40,40
1650243781830,COGS 14A,A01,092681,Staff,1,13,100,99
1650243787856,COGS 14B,A01,083073,Cheng; Tzu-Han,0,8,50,50
1650243793878,COGS 17,A01,092677,Staff,33,0,75,42
1650243799905,COGS 100,A01,083619,Staff,1,21,60,59
1650243805929,COGS 101A,A01,083621,Davis; Joshua Daniel,0,20,60,60
1650243811957,COGS 101B,A01,091572,Staff,5,0,60,55
1650243817981,COGS 101C,A01,083625,Delgado; Tania,20,0,30,10
1650243824010,COGS 107A,A01,083627,Boyle; Mary E. T.,1,7,60,59
1650243830036,COGS 118A,A01,083075,Staff,15,0,60,45
1650243836059,CSE 3,A50,083646,Miranda; Gregory Joseph,22,0,38,16
1650243836059,CSE 3,A51,083647,Miranda; Gregory Joseph,37,0,37,0
1650243842084,CSE 8A,A50,083650,Miranda; Gregory Joseph,0,18,40,40
1650243848113,CSE 11,A01,083080,Cao; Yingjun,0,69,40,40
1650243854137,CSE 12,A01,083652,Staff,0,9,100,100
1650243860161,CSE 15L,A01,083654,Staff,0,1,50,50
1650243860161,CSE 15L,A02,083655,Staff,5,0,50,45
1650243866190,CSE 20,A01,083657,Staff,53,0,80,27
1650243872216,CSE 30,A01,083084,Eldon; John,0,70,40,40
1650243878313,CSE 100,A01,083659,Cao; Yingjun,0,64,50,50
1650243884337,CSE 134B,A01,083661,Powell; Thomas Allan,0,27,65,65
1650243890360,CSE 140,A01,083663,Staff,0,0,75,75
1650243896383,CSE 140L,A01,083088,Eldon; John,0,5,75,75
1650243902407,CSE 175,A01,083665,Kumar; Rakesh,8,0,25,17
1650243908429,CSE 190,A00,092507,Dubnov; Shlomo,14,0,20,6
1650243920356,ECE 45,A01,083139,Staff,0,13,40,40
1650243926381,ECE 65,A50,083695,Staff,0,5,30,30
1650243932406,ECE 109,A01,091882,Touri; Behrouz,47,0,70,23
1650243938432,ECE 180,A00,083140,Abi Samra; Nicholas Camill,24,0,30,6
1650243938432,ECE 180,B00,083141,Abi Samra; Nicholas Camill,7,0,30,23
1650243944471,MATH 10A,A01,083735,Patchell; Gregory David,11,0,30,19
1650243944471,MATH 10A,A02,083736,Patchell; Gregory David,28,0,30,2
1650243944471,MATH 10A,A03,083737,Patchell; Gregory David,26,0,30,4
1650243950498,MATH 10B,A01,083207,Staff,0,6,30,30
1650243950498,MATH 10B,A02,083208,Staff,0,5,30,30
1650243950498,MATH 10B,B01,083739,Staff,17,0,30,13
1650243950498,MATH 10B,B02,083740,Staff,29,0,30,1
1650243956521,MATH 18,A01,083743,Staff,7,0,30,23
1650243956521,MATH 18,A02,083744,Staff,28,0,30,2
1650243956521,MATH 18,A03,083745,Staff,23,0,30,7
1650243956521,MATH 18,A04,083746,Staff,27,0,30,3
1650243956521,MATH 18,B01,083748,Staff,0,10,30,30
1650243956521,MATH 18,B02,083749,Staff,0,8,30,30
1650243956521,MATH 18,B03,083750,Staff,0,7,30,30
1650243956521,MATH 18,B04,083751,Staff,0,9,30,30
1650243962545,MATH 20A,A01,083754,Staff,26,0,40,14
1650243968570,MATH 20B,A01,083756,Staff,1,6,30,29
1650243968570,MATH 20B,A02,083757,Staff,0,6,30,30
1650243974598,MATH 20C,A01,083760,Staff,0,12,30,30
1650243974598,MATH 20C,A02,083761,Staff,0,13,30,30
1650243974598,MATH 20C,B01,083762,Staff,14,0,30,16
1650243974598,MATH 20C,B02,083763,Staff,28,0,30,2
1650243980625,MATH 20D,A01,083765,Staff,1,2,30,29
1650243980625,MATH 20D,A02,083766,Staff,8,0,30,22
1650243980625,MATH 20D,A03,083767,Staff,28,0,30,2
1650243986650,MATH 20E,A01,083771,Staff,8,0,30,22
1650243986650,MATH 20E,A02,083772,Staff,21,0,30,9
1650243986650,MATH 20E,B01,083773,Staff,0,0,30,30
1650243986650,MATH 20E,B02,083774,Staff,12,0,30,18
1650243992679,MATH 103A,A01,083777,Staff,0,9,30,30
1650243992679,MATH 103A,A02,083778,Staff,0,10,30,30
1650243992679,MATH 103A,B01,083779,Staff,0,10,30,30
1650243992679,MATH 103A,B02,083780,Staff,0,9,30,30
1650243998702,MATH 105,A01,085443,Staff,0,17,30,30
1650244004726,MATH 109,A01,083213,Anzaldo; Leesa B,0,4,30,30
1650244004726,MATH 109,A02,083214,Anzaldo; Leesa B,0,6,30,30
1650244004726,MATH 109,B01,083215,Anzaldo; Leesa B,0,4,30,30
1650244004726,MATH 109,B02,083216,Anzaldo; Leesa B,1,4,30,29
1650244010751,MATH 142A,A01,083219,Chow; Bennett,0,12,30,30
1650244010751,MATH 142A,A02,083220,Chow; Bennett,0,11,30,30
1650244010751,MATH 142A,B01,083221,Chow; Bennett,0,11,30,30
1650244010751,MATH 142A,B02,083222,Chow; Bennett,0,12,30,30
1650244016773,MATH 193A,A01,083224,Staff,0,5,30,30
1650244016773,MATH 193A,A02,083225,Staff,0,4,30,30
1650244016773,MATH 193A,A03,083781,Staff,0,2,30,30
1650244016773,MATH 193A,A04,083782,Staff,0,1,30,30
1650244022798,MATH 197,001,091859,McAuley; Julian John,9998,0,9999,1
1650244028883,COGS 9,A01,083615,Staff,0,14,60,60
1650244034911,COGS 11,A01,083617,Boyle; Mary E. T.,24,0,40,16
1650244040937,COGS 13,A01,083071,Staff,0,30,40,40
1650244046963,COGS 14A,A01,092681,Staff,1,13,100,99
1650244052987,COGS 14B,A01,083073,Cheng; Tzu-Han,0,8,50,50
1650244059029,COGS 17,A01,092677,Staff,33,0,75,42
1650244065054,COGS 100,A01,083619,Staff,1,21,60,59
1650244071080,COGS 101A,A01,083621,Davis; Joshua Daniel,0,20,60,60
1650244077107,COGS 101B,A01,091572,Staff,5,0,60,55
1650244083134,COGS 101C,A01,083625,Delgado; Tania,20,0,30,10
1650244089162,COGS 107A,A01,083627,Boyle; Mary E. T.,1,7,60,59
1650244095187,COGS 118A,A01,083075,Staff,15,0,60,45
1650244101210,CSE 3,A50,083646,Miranda; Gregory Joseph,22,0,38,16
1650244101210,CSE 3,A51,083647,Miranda; Gregory Joseph,37,0,37,0
1650244107232,CSE 8A,A50,083650,Miranda; Gregory Joseph,0,18,40,40
1650244113257,CSE 11,A01,083080,Cao; Yingjun,0,69,40,40
1650244119280,CSE 12,A01,083652,Staff,0,9,100,100
1650244125303,CSE 15L,A01,083654,Staff,0,1,50,50
1650244125303,CSE 15L,A02,083655,Staff,5,0,50,45
1650244131326,CSE 20,A01,083657,Staff,53,0,80,27
1650244137348,CSE 30,A01,083084,Eldon; John,0,70,40,40
1650244143377,CSE 100,A01,083659,Cao; Yingjun,0,64,50,50
1650244149409,CSE 134B,A01,083661,Powell; Thomas Allan,0,27,65,65
1650244155434,CSE 140,A01,083663,Staff,0,0,75,75
1650244161464,CSE 140L,A01,083088,Eldon; John,0,5,75,75
1650244167489,CSE 175,A01,083665,Kumar; Rakesh,8,0,25,17
1650244173510,CSE 190,A00,092507,Dubnov; Shlomo,14,0,20,6
1650244179537,ECE 45,A01,083139,Staff,0,13,40,40
1650244185566,ECE 65,A50,083695,Staff,0,5,30,30
1650244191592,ECE 109,A01,091882,Touri; Behrouz,47,0,70,23
1650244197618,ECE 180,A00,083140,Abi Samra; Nicholas Camill,24,0,30,6
1650244197618,ECE 180,B00,083141,Abi Samra; Nicholas Camill,7,0,30,23
1650244203643,MATH 10A,A01,083735,Patchell; Gregory David,11,0,30,19
1650244203643,MATH 10A,A02,083736,Patchell; Gregory David,28,0,30,2
1650244203643,MATH 10A,A03,083737,Patchell; Gregory David,26,0,30,4
1650244209666,MATH 10B,A01,083207,Staff,0,6,30,30
1650244209666,MATH 10B,A02,083208,Staff,0,5,30,30
1650244209666,MATH 10B,B01,083739,Staff,17,0,30,13
1650244209666,MATH 10B,B02,083740,Staff,29,0,30,1
1650244215690,MATH 18,A01,083743,Staff,7,0,30,23
1650244215690,MATH 18,A02,083744,Staff,28,0,30,2
1650244215690,MATH 18,A03,083745,Staff,23,0,30,7
1650244215690,MATH 18,A04,083746,Staff,27,0,30,3
1650244215690,MATH 18,B01,083748,Staff,0,10,30,30
1650244215690,MATH 18,B02,083749,Staff,0,8,30,30
1650244215690,MATH 18,B03,083750,Staff,0,7,30,30
1650244215690,MATH 18,B04,083751,Staff,0,9,30,30
1650244221716,MATH 20A,A01,083754,Staff,26,0,40,14
1650244227738,MATH 20B,A01,083756,Staff,1,6,30,29
1650244227738,MATH 20B,A02,083757,Staff,0,6,30,30
1650244233766,MATH 20C,A01,083760,Staff,0,12,30,30
1650244233766,MATH 20C,A02,083761,Staff,0,13,30,30
1650244233766,MATH 20C,B01,083762,Staff,14,0,30,16
1650244233766,MATH 20C,B02,083763,Staff,28,0,30,2
1650244239788,MATH 20D,A01,083765,Staff,1,2,30,29
1650244239788,MATH 20D,A02,083766,Staff,8,0,30,22
1650244239788,MATH 20D,A03,083767,Staff,28,0,30,2
1650244245818,MATH 20E,A01,083771,Staff,8,0,30,22
1650244245818,MATH 20E,A02,083772,Staff,21,0,30,9
1650244245818,MATH 20E,B01,083773,Staff,0,0,30,30
1650244245818,MATH 20E,B02,083774,Staff,12,0,30,18
1650244251851,MATH 103A,A01,083777,Staff,0,9,30,30
1650244251851,MATH 103A,A02,083778,Staff,0,10,30,30
1650244251851,MATH 103A,B01,083779,Staff,0,10,30,30
1650244251851,MATH 103A,B02,083780,Staff,0,9,30,30
1650244257882,MATH 105,A01,085443,Staff,0,17,30,30
1650244263908,MATH 109,A01,083213,Anzaldo; Leesa B,0,4,30,30
1650244263908,MATH 109,A02,083214,Anzaldo; Leesa B,0,6,30,30
1650244263908,MATH 109,B01,083215,Anzaldo; Leesa B,0,4,30,30
1650244263908,MATH 109,B02,083216,Anzaldo; Leesa B,1,4,30,29
1650244269933,MATH 142A,A01,083219,Chow; Bennett,0,12,30,30
1650244269933,MATH 142A,A02,083220,Chow; Bennett,0,11,30,30
1650244269933,MATH 142A,B01,083221,Chow; Bennett,0,11,30,30
1650244269933,MATH 142A,B02,083222,Chow; Bennett,0,12,30,30
1650244275960,MATH 193A,A01,083224,Staff,0,5,30,30
1650244275960,MATH 193A,A02,083225,Staff,0,4,30,30
1650244275960,MATH 193A,A03,083781,Staff,0,2,30,30
1650244275960,MATH 193A,A04,083782,Staff,0,1,30,30
1650244281986,MATH 197,001,091859,McAuley; Julian John,9998,0,9999,1
1650244288043,COGS 9,A01,083615,Staff,0,14,60,60
1650244294075,COGS 11,A01,083617,Boyle; Mary E. T.,24,0,40,16
1650244300103,COGS 13,A01,083071,Staff,0,30,40,40
1650244306128,COGS 14A,A01,092681,Staff,1,13,100,99
1650244312151,COGS 14B,A01,083073,Cheng; Tzu-Han,0,8,50,50
1650244318177,COGS 17,A01,092677,Staff,33,0,75,42
1650244324200,COGS 100,A01,083619,Staff,1,21,60,59
1650244330224,COGS 101A,A01,083621,Davis; Joshua Daniel,0,20,60,60
1650244336247,COGS 101B,A01,091572,Staff,5,0,60,55
1650244342272,COGS 101C,A01,083625,Delgado; Tania,20,0,30,10
1650244348295,COGS 107A,A01,083627,Boyle; Mary E. T.,1,7,60,59
1650244354319,COGS 118A,A01,083075,Staff,15,0,60,45
1650244360347,CSE 3,A50,083646,Miranda; Gregory Joseph,22,0,38,16
1650244360347,CSE 3,A51,083647,Miranda; Gregory Joseph,37,0,37,0
1650244366371,CSE 8A,A50,083650,Miranda; Gregory Joseph,0,18,40,40
1650244372399,CSE 11,A01,083080,Cao; Yingjun,0,69,40,40
1650244378430,CSE 12,A01,083652,Staff,0,9,100,100
1650244384454,CSE 15L,A01,083654,Staff,0,1,50,50
1650244384454,CSE 15L,A02,083655,Staff,5,0,50,45
1650244390479,CSE 20,A01,083657,Staff,53,0,80,27
1650244396506,CSE 30,A01,083084,Eldon; John,0,70,40,40
1650244402531,CSE 100,A01,083659,Cao; Yingjun,0,64,50,50
1650244408555,CSE 134B,A01,083661,Powell; Thomas Allan,0,27,65,65
1650244414592,CSE 140,A01,083663,Staff,0,0,75,75
1650244420619,CSE 140L,A01,083088,Eldon; John,0,5,75,75
1650244426645,CSE 175,A01,083665,Kumar; Rakesh,8,0,25,17
1650244432669,CSE 190,A00,092507,Dubnov; Shlomo,14,0,20,6
1650244438701,ECE 45,A01,083139,Staff,0,13,40,40
1650244444729,ECE 65,A50,083695,Staff,0,5,30,30
1650244450754,ECE 109,A01,091882,Touri; Behrouz,47,0,70,23
1650244456779,ECE 180,A00,083140,Abi Samra; Nicholas Camill,24,0,30,6
1650244456779,ECE 180,B00,083141,Abi Samra; Nicholas Camill,7,0,30,23
1650244462804,MATH 10A,A01,083735,Patchell; Gregory David,11,0,30,19
1650244462804,MATH 10A,A02,083736,Patchell; Gregory David,28,0,30,2
1650244462804,MATH 10A,A03,083737,Patchell; Gregory David,26,0,30,4
1650244468831,MATH 10B,A01,083207,Staff,0,6,30,30
1650244468831,MATH 10B,A02,083208,Staff,0,5,30,30
1650244468831,MATH 10B,B01,083739,Staff,17,0,30,13
1650244468831,MATH 10B,B02,083740,Staff,29,0,30,1
1650244474861,MATH 18,A01,083743,Staff,7,0,30,23
1650244474861,MATH 18,A02,083744,Staff,28,0,30,2
1650244474861,MATH 18,A03,083745,Staff,23,0,30,7
1650244474861,MATH 18,A04,083746,Staff,27,0,30,3
1650244474861,MATH 18,B01,083748,Staff,0,10,30,30
1650244474861,MATH 18,B02,083749,Staff,0,8,30,30
1650244474861,MATH 18,B03,083750,Staff,0,7,30,30
1650244474861,MATH 18,B04,083751,Staff,0,9,30,30
1650244480975,MATH 20A,A01,083754,Staff,26,0,40,14
1650244486998,MATH 20B,A01,083756,Staff,1,6,30,29
1650244486998,MATH 20B,A02,083757,Staff,0,7,30,30
1650244493027,MATH 20C,A01,083760,Staff,0,12,30,30
1650244493027,MATH 20C,A02,083761,Staff,0,13,30,30
1650244493027,MATH 20C,B01,083762,Staff,14,0,30,16
1650244493027,MATH 20C,B02,083763,Staff,28,0,30,2
1650244499053,MATH 20D,A01,083765,Staff,1,2,30,29
1650244499053,MATH 20D,A02,083766,Staff,8,0,30,22
1650244499053,MATH 20D,A03,083767,Staff,28,0,30,2
1650244505082,MATH 20E,A01,083771,Staff,8,0,30,22
1650244505082,MATH 20E,A02,083772,Staff,21,0,30,9
1650244505082,MATH 20E,B01,083773,Staff,0,0,30,30
1650244505082,MATH 20E,B02,083774,Staff,12,0,30,18
1650244511107,MATH 103A,A01,083777,Staff,0,9,30,30
1650244511107,MATH 103A,A02,083778,Staff,0,10,30,30
1650244511107,MATH 103A,B01,083779,Staff,0,10,30,30
1650244511107,MATH 103A,B02,083780,Staff,0,9,30,30
1650244517134,MATH 105,A01,085443,Staff,0,17,30,30
1650244523170,MATH 109,A01,083213,Anzaldo; Leesa B,0,4,30,30
1650244523170,MATH 109,A02,083214,Anzaldo; Leesa B,0,6,30,30
1650244523170,MATH 109,B01,083215,Anzaldo; Leesa B,0,4,30,30
1650244523170,MATH 109,B02,083216,Anzaldo; Leesa B,1,4,30,29
1650244529196,MATH 142A,A01,083219,Chow; Bennett,0,12,30,30
1650244529196,MATH 142A,A02,083220,Chow; Bennett,0,11,30,30
1650244529196,MATH 142A,B01,083221,Chow; Bennett,0,11,30,30
1650244529196,MATH 142A,B02,083222,Chow; Bennett,0,12,30,30
1650244535220,MATH 193A,A01,083224,Staff,0,5,30,30
1650244535220,MATH 193A,A02,083225,Staff,0,4,30,30
1650244535220,MATH 193A,A03,083781,Staff,0,2,30,30
1650244535220,MATH 193A,A04,083782,Staff,0,1,30,30
1650244541243,MATH 197,001,091859,McAuley; Julian John,9998,0,9999,1
1650244547294,COGS 9,A01,083615,Staff,0,14,60,60
1650244553327,COGS 11,A01,083617,Boyle; Mary E. T.,24,0,40,16
1650244559361,COGS 13,A01,083071,Staff,0,30,40,40
1650244565389,COGS 14A,A01,092681,Staff,1,13,100,99
1650244571414,COGS 14B,A01,083073,Cheng; Tzu-Han,0,8,50,50
1650244577438,COGS 17,A01,092677,Staff,33,0,75,42
1650244583467,COGS 100,A01,083619,Staff,1,21,60,59
1650244589495,COGS 101A,A01,083621,Davis; Joshua Daniel,0,20,60,60
1650244595527,COGS 101B,A01,091572,Staff,5,0,60,55
1650244601551,COGS 101C,A01,083625,Delgado; Tania,20,0,30,10
1650244607575,COGS 107A,A01,083627,Boyle; Mary E. T.,1,7,60,59
1650244613598,COGS 118A,A01,083075,Staff,15,0,60,45
1650244619628,CSE 3,A50,083646,Miranda; Gregory Joseph,22,0,38,16
1650244619628,CSE 3,A51,083647,Miranda; Gregory Joseph,37,0,37,0
1650244625652,CSE 8A,A50,083650,Miranda; Gregory Joseph,0,18,40,40
1650244631679,CSE 11,A01,083080,Cao; Yingjun,0,69,40,40
1650244637701,CSE 12,A01,083652,Staff,0,9,100,100
1650244643737,CSE 15L,A01,083654,Staff,0,1,50,50
1650244643737,CSE 15L,A02,083655,Staff,5,0,50,45
1650244649765,CSE 20,A01,083657,Staff,53,0,80,27
1650244655791,CSE 30,A01,083084,Eldon; John,0,70,40,40
1650244661815,CSE 100,A01,083659,Cao; Yingjun,0,64,50,50
1650244667840,CSE 134B,A01,083661,Powell; Thomas Allan,0,27,65,65
1650244673869,CSE 140,A01,083663,Staff,0,0,75,75
1650244679908,CSE 140L,A01,083088,Eldon; John,0,5,75,75
1650244685933,CSE 175,A01,083665,Kumar; Rakesh,8,0,25,17
1650244691961,CSE 190,A00,092507,Dubnov; Shlomo,14,0,20,6
1650244697991,ECE 45,A01,083139,Staff,0,13,40,40
1650244704030,ECE 65,A50,083695,Staff,0,5,30,30
1650244710056,ECE 109,A01,091882,Touri; Behrouz,47,0,70,23
1650244716087,ECE 180,A00,083140,Abi Samra; Nicholas Camill,24,0,30,6
1650244716087,ECE 180,B00,083141,Abi Samra; Nicholas Camill,7,0,30,23
1650244722173,MATH 10A,A01,083735,Patchell; Gregory David,11,0,30,19
1650244722173,MATH 10A,A02,083736,Patchell; Gregory David,28,0,30,2
1650244722173,MATH 10A,A03,083737,Patchell; Gregory David,26,0,30,4
1650244728200,MATH 10B,A01,083207,Staff,0,6,30,30
1650244728200,MATH 10B,A02,083208,Staff,0,5,30,30
1650244728200,MATH 10B,B01,083739,Staff,17,0,30,13
1650244728200,MATH 10B,B02,083740,Staff,29,0,30,1
1650244734227,MATH 18,A01,083743,Staff,7,0,30,23
1650244734227,MATH 18,A02,083744,Staff,28,0,30,2
1650244734227,MATH 18,A03,083745,Staff,23,0,30,7
1650244734227,MATH 18,A04,083746,Staff,27,0,30,3
1650244734227,MATH 18,B01,083748,Staff,0,10,30,30
1650244734227,MATH 18,B02,083749,Staff,0,8,30,30
1650244734227,MATH 18,B03,083750,Staff,0,7,30,30
1650244734227,MATH 18,B04,083751,Staff,0,9,30,30
1650244740250,MATH 20A,A01,083754,Staff,26,0,40,14
1650244746273,MATH 20B,A01,083756,Staff,1,6,30,29
1650244746273,MATH 20B,A02,083757,Staff,0,7,30,30
1650244752299,MATH 20C,A01,083760,Staff,0,12,30,30
1650244752299,MATH 20C,A02,083761,Staff,0,13,30,30
1650244752299,MATH 20C,B01,083762,Staff,14,0,30,16
1650244752299,MATH 20C,B02,083763,Staff,28,0,30,2
1650244758323,MATH 20D,A01,083765,Staff,1,2,30,29
1650244758323,MATH 20D,A02,083766,Staff,8,0,30,22
1650244758323,MATH 20D,A03,083767,Staff,28,0,30,2
1650244764346,MATH 20E,A01,083771,Staff,8,0,30,22
1650244764346,MATH 20E,A02,083772,Staff,21,0,30,9
1650244764346,MATH 20E,B01,083773,Staff,0,0,30,30
1650244764346,MATH 20E,B02,083774,Staff,12,0,30,18
1650244770370,MATH 103A,A01,083777,Staff,0,9,30,30
1650244770370,MATH 103A,A02,083778,Staff,0,10,30,30
1650244770370,MATH 103A,B01,083779,Staff,0,10,30,30
1650244770370,MATH 103A,B02,083780,Staff,0,9,30,30
1650244776394,MATH 105,A01,085443,Staff,0,17,30,30
1650244782418,MATH 109,A01,083213,Anzaldo; Leesa B,0,4,30,30
1650244782418,MATH 109,A02,083214,Anzaldo; Leesa B,0,6,30,30
1650244782418,MATH 109,B01,083215,Anzaldo; Leesa B,0,4,30,30
1650244782418,MATH 109,B02,083216,Anzaldo; Leesa B,1,4,30,29
1650244788442,MATH 142A,A01,083219,Chow; Bennett,0,12,30,30
1650244788442,MATH 142A,A02,083220,Chow; Bennett,0,11,30,30
1650244788442,MATH 142A,B01,083221,Chow; Bennett,0,11,30,30
1650244788442,MATH 142A,B02,083222,Chow; Bennett,0,12,30,30
1650244794466,MATH 193A,A01,083224,Staff,0,5,30,30
1650244794466,MATH 193A,A02,083225,Staff,0,4,30,30
1650244794466,MATH 193A,A03,083781,Staff,0,2,30,30
1650244794466,MATH 193A,A04,083782,Staff,0,1,30,30
1650244800490,MATH 197,001,091859,McAuley; Julian John,9998,0,9999,1
1650244806539,COGS 9,A01,083615,Staff,0,14,60,60
1650244812561,COGS 11,A01,083617,Boyle; Mary E. T.,24,0,40,16
1650244818587,COGS 13,A01,083071,Staff,0,30,40,40
1650244824614,COGS 14A,A01,092681,Staff,1,13,100,99
1650244830646,COGS 14B,A01,083073,Cheng; Tzu-Han,0,8,50,50
1650244836672,COGS 17,A01,092677,Staff,33,0,75,42
1650244842698,COGS 100,A01,083619,Staff,1,21,60,59
1650244848722,COGS 101A,A01,083621,Davis; Joshua Daniel,0,20,60,60
1650244854748,COGS 101B,A01,091572,Staff,5,0,60,55
1650244860770,COGS 101C,A01,083625,Delgado; Tania,20,0,30,10
1650244866797,COGS 107A,A01,083627,Boyle; Mary E. T.,1,7,60,59
1650244872822,COGS 118A,A01,083075,Staff,15,0,60,45
1650244878844,CSE 3,A50,083646,Miranda; Gregory Joseph,22,0,38,16
1650244878844,CSE 3,A51,083647,Miranda; Gregory Joseph,37,0,37,0
1650244884865,CSE 8A,A50,083650,Miranda; Gregory Joseph,0,18,40,40
1650244890892,CSE 11,A01,083080,Cao; Yingjun,0,69,40,40
1650244896921,CSE 12,A01,083652,Staff,0,9,100,100
1650244902945,CSE 15L,A01,083654,Staff,0,1,50,50
1650244902945,CSE 15L,A02,083655,Staff,5,0,50,45
1650244908972,CSE 20,A01,083657,Staff,53,0,80,27
1650244914999,CSE 30,A01,083084,Eldon; John,0,70,40,40
1650244921024,CSE 100,A01,083659,Cao; Yingjun,0,64,50,50
1650244927063,CSE 134B,A01,083661,Powell; Thomas Allan,0,27,65,65
1650244933089,CSE 140,A01,083663,Staff,0,0,75,75
1650244939113,CSE 140L,A01,083088,Eldon; John,0,5,75,75
1650244945140,CSE 175,A01,083665,Kumar; Rakesh,8,0,25,17
1650244951165,CSE 190,A00,092507,Dubnov; Shlomo,14,0,20,6
1650244957189,ECE 45,A01,083139,Staff,0,13,40,40
1650244963211,ECE 65,A50,083695,Staff,0,5,30,30
1650244969234,ECE 109,A01,091882,Touri; Behrouz,47,0,70,23
1650244975260,ECE 180,A00,083140,Abi Samra; Nicholas Camill,24,0,30,6
1650244975260,ECE 180,B00,083141,Abi Samra; Nicholas Camill,7,0,30,23
1650244981287,MATH 10A,A01,083735,Patchell; Gregory David,11,0,30,19
1650244981287,MATH 10A,A02,083736,Patchell; Gregory David,28,0,30,2
1650244981287,MATH 10A,A03,083737,Patchell; Gregory David,26,0,30,4
1650244987315,MATH 10B,A01,083207,Staff,0,6,30,30
1650244987315,MATH 10B,A02,083208,Staff,0,5,30,30
1650244987315,MATH 10B,B01,083739,Staff,17,0,30,13
1650244987315,MATH 10B,B02,083740,Staff,29,0,30,1
1650244993345,MATH 18,A01,083743,Staff,7,0,30,23
1650244993345,MATH 18,A02,083744,Staff,28,0,30,2
1650244993345,MATH 18,A03,083745,Staff,23,0,30,7
1650244993345,MATH 18,A04,083746,Staff,27,0,30,3
1650244993345,MATH 18,B01,083748,Staff,0,10,30,30
1650244993345,MATH 18,B02,083749,Staff,0,8,30,30
1650244993345,MATH 18,B03,083750,Staff,0,7,30,30
1650244993345,MATH 18,B04,083751,Staff,0,9,30,30
1650244999374,MATH 20A,A01,083754,Staff,26,0,40,14
1650245005401,MATH 20B,A01,083756,Staff,1,6,30,29
1650245005401,MATH 20B,A02,083757,Staff,0,7,30,30
1650245011431,MATH 20C,A01,083760,Staff,0,12,30,30
1650245011431,MATH 20C,A02,083761,Staff,0,13,30,30
1650245011431,MATH 20C,B01,083762,Staff,14,0,30,16
1650245011431,MATH 20C,B02,083763,Staff,28,0,30,2
1650245017459,MATH 20D,A01,083765,Staff,1,2,30,29
1650245017459,MATH 20D,A02,083766,Staff,8,0,30,22
1650245017459,MATH 20D,A03,083767,Staff,28,0,30,2
1650245023483,MATH 20E,A01,083771,Staff,8,0,30,22
1650245023483,MATH 20E,A02,083772,Staff,21,0,30,9
1650245023483,MATH 20E,B01,083773,Staff,0,0,30,30
1650245023483,MATH 20E,B02,083774,Staff,12,0,30,18
1650245029517,MATH 103A,A01,083777,Staff,0,9,30,30
1650245029517,MATH 103A,A02,083778,Staff,0,10,30,30
1650245029517,MATH 103A,B01,083779,Staff,0,10,30,30
1650245029517,MATH 103A,B02,083780,Staff,0,9,30,30
1650245035544,MATH 105,A01,085443,Staff,0,17,30,30
1650245041573,MATH 109,A01,083213,Anzaldo; Leesa B,0,4,30,30
1650245041573,MATH 109,A02,083214,Anzaldo; Leesa B,0,6,30,30
1650245041573,MATH 109,B01,083215,Anzaldo; Leesa B,0,4,30,30
1650245041573,MATH 109,B02,083216,Anzaldo; Leesa B,1,4,30,29
1650245047597,MATH 142A,A01,083219,Chow; Bennett,0,12,30,30
1650245047597,MATH 142A,A02,083220,Chow; Bennett,0,11,30,30
1650245047597,MATH 142A,B01,083221,Chow; Bennett,0,11,30,30
1650245047597,MATH 142A,B02,083222,Chow; Bennett,0,12,30,30
1650245053623,MATH 193A,A01,083224,Staff,0,5,30,30
1650245053623,MATH 193A,A02,083225,Staff,0,4,30,30
1650245053623,MATH 193A,A03,083781,Staff,0,2,30,30
1650245053623,MATH 193A,A04,083782,Staff,0,1,30,30
1650245059648,MATH 197,001,091859,McAuley; Julian John,9998,0,9999,1
1650245065710,COGS 9,A01,083615,Staff,0,14,60,60
1650245071806,COGS 11,A01,083617,Boyle; Mary E. T.,24,0,40,16
1650245077833,COGS 13,A01,083071,Staff,0,30,40,40
1650245083857,COGS 14A,A01,092681,Staff,1,13,100,99
1650245089884,COGS 14B,A01,083073,Cheng; Tzu-Han,0,8,50,50
1650245095908,COGS 17,A01,092677,Staff,33,0,75,42
1650245101938,COGS 100,A01,083619,Staff,1,21,60,59
1650245107965,COGS 101A,A01,083621,Davis; Joshua Daniel,0,20,60,60
1650245113995,COGS 101B,A01,091572,Staff,5,0,60,55
1650245120034,COGS 101C,A01,083625,Delgado; Tania,20,0,30,10
1650245126059,COGS 107A,A01,083627,Boyle; Mary E. T.,1,7,60,59
1650245132084,COGS 118A,A01,083075,Staff,15,0,60,45
1650245138108,CSE 3,A50,083646,Miranda; Gregory Joseph,22,0,38,16
1650245138108,CSE 3,A51,083647,Miranda; Gregory Joseph,37,0,37,0
1650245144140,CSE 8A,A50,083650,Miranda; Gregory Joseph,0,18,40,40
1650245150164,CSE 11,A01,083080,Cao; Yingjun,0,69,40,40
1650245156185,CSE 12,A01,083652,Staff,0,9,100,100
1650245162212,CSE 15L,A01,083654,Staff,0,1,50,50
1650245162212,CSE 15L,A02,083655,Staff,5,0,50,45
1650245168244,CSE 20,A01,083657,Staff,53,0,80,27
1650245174278,CSE 30,A01,083084,Eldon; John,0,70,40,40
1650245180303,CSE 100,A01,083659,Cao; Yingjun,0,64,50,50
1650245186327,CSE 134B,A01,083661,Powell; Thomas Allan,0,27,65,65
1650245192351,CSE 140,A01,083663,Staff,0,0,75,75
1650245198375,CSE 140L,A01,083088,Eldon; John,0,5,75,75
1650245204401,CSE 175,A01,083665,Kumar; Rakesh,8,0,25,17
1650245210427,CSE 190,A00,092507,Dubnov; Shlomo,14,0,20,6
1650245216451,ECE 45,A01,083139,Staff,0,13,40,40
1650245222475,ECE 65,A50,083695,Staff,0,5,30,30
1650245228502,ECE 109,A01,091882,Touri; Behrouz,47,0,70,23
1650245234530,ECE 180,A00,083140,Abi Samra; Nicholas Camill,24,0,30,6
1650245234530,ECE 180,B00,083141,Abi Samra; Nicholas Camill,7,0,30,23
1650245240558,MATH 10A,A01,083735,Patchell; Gregory David,11,0,30,19
1650245240558,MATH 10A,A02,083736,Patchell; Gregory David,28,0,30,2
1650245240558,MATH 10A,A03,083737,Patchell; Gregory David,26,0,30,4
1650245246581,MATH 10B,A01,083207,Staff,0,6,30,30
1650245246581,MATH 10B,A02,083208,Staff,0,5,30,30
1650245246581,MATH 10B,B01,083739,Staff,17,0,30,13
1650245246581,MATH 10B,B02,083740,Staff,29,0,30,1
1650245252605,MATH 18,A01,083743,Staff,7,0,30,23
1650245252605,MATH 18,A02,083744,Staff,28,0,30,2
1650245252605,MATH 18,A03,083745,Staff,23,0,30,7
1650245252605,MATH 18,A04,083746,Staff,27,0,30,3
1650245252605,MATH 18,B01,083748,Staff,0,10,30,30
1650245252605,MATH 18,B02,083749,Staff,0,8,30,30
1650245252605,MATH 18,B03,083750,Staff,0,7,30,30
1650245252605,MATH 18,B04,083751,Staff,0,9,30,30
1650245258628,MATH 20A,A01,083754,Staff,26,0,40,14
1650245264654,MATH 20B,A01,083756,Staff,1,6,30,29
1650245264654,MATH 20B,A02,083757,Staff,0,7,30,30
1650245270682,MATH 20C,A01,083760,Staff,0,12,30,30
1650245270682,MATH 20C,A02,083761,Staff,0,13,30,30
1650245270682,MATH 20C,B01,083762,Staff,14,0,30,16
1650245270682,MATH 20C,B02,083763,Staff,28,0,30,2
1650245276705,MATH 20D,A01,083765,Staff,1,2,30,29
1650245276705,MATH 20D,A02,083766,Staff,8,0,30,22
1650245276705,MATH 20D,A03,083767,Staff,28,0,30,2
1650245282729,MATH 20E,A01,083771,Staff,8,0,30,22
1650245282729,MATH 20E,A02,083772,Staff,21,0,30,9
1650245282729,MATH 20E,B01,083773,Staff,0,0,30,30
1650245282729,MATH 20E,B02,083774,Staff,12,0,30,18
1650245288758,MATH 103A,A01,083777,Staff,0,9,30,30
1650245288758,MATH 103A,A02,083778,Staff,0,10,30,30
1650245288758,MATH 103A,B01,083779,Staff,0,10,30,30
1650245288758,MATH 103A,B02,083780,Staff,0,9,30,30
1650245294782,MATH 105,A01,085443,Staff,0,17,30,30
1650245300808,MATH 109,A01,083213,Anzaldo; Leesa B,0,4,30,30
1650245300808,MATH 109,A02,083214,Anzaldo; Leesa B,0,6,30,30
1650245300808,MATH 109,B01,083215,Anzaldo; Leesa B,0,4,30,30
1650245300808,MATH 109,B02,083216,Anzaldo; Leesa B,1,4,30,29
1650245306837,MATH 142A,A01,083219,Chow; Bennett,0,12,30,30
1650245306837,MATH 142A,A02,083220,Chow; Bennett,0,11,30,30
1650245306837,MATH 142A,B01,083221,Chow; Bennett,0,11,30,30
1650245306837,MATH 142A,B02,083222,Chow; Bennett,0,12,30,30
1650245312861,MATH 193A,A01,083224,Staff,0,5,30,30
1650245312861,MATH 193A,A02,083225,Staff,0,4,30,30
1650245312861,MATH 193A,A03,083781,Staff,0,2,30,30
1650245312861,MATH 193A,A04,083782,Staff,0,1,30,30
1650245318885,MATH 197,001,091859,McAuley; Julian John,9998,0,9999,1
1650245324939,COGS 9,A01,083615,Staff,0,14,60,60
1650245330962,COGS 11,A01,083617,Boyle; Mary E. T.,24,0,40,16
1650245336985,COGS 13,A01,083071,Staff,0,30,40,40
1650245343009,COGS 14A,A01,092681,Staff,1,13,100,99
1650245349033,COGS 14B,A01,083073,Cheng; Tzu-Han,0,8,50,50
1650245355056,COGS 17,A01,092677,Staff,33,0,75,42
1650245361086,COGS 100,A01,083619,Staff,1,21,60,59
1650245367109,COGS 101A,A01,083621,Davis; Joshua Daniel,0,20,60,60
1650245373134,COGS 101B,A01,091572,Staff,5,0,60,55
1650245379160,COGS 101C,A01,083625,Delgado; Tania,20,0,30,10
1650245385185,COGS 107A,A01,083627,Boyle; Mary E. T.,1,7,60,59
1650245391211,COGS 118A,A01,083075,Staff,15,0,60,45
1650245397234,CSE 3,A50,083646,Miranda; Gregory Joseph,22,0,38,16
1650245397234,CSE 3,A51,083647,Miranda; Gregory Joseph,37,0,37,0
1650245403262,CSE 8A,A50,083650,Miranda; Gregory Joseph,0,18,40,40
1650245409285,CSE 11,A01,083080,Cao; Yingjun,0,69,40,40
1650245415312,CSE 12,A01,083652,Staff,0,9,100,100
1650245421337,CSE 15L,A01,083654,Staff,0,1,50,50
1650245421337,CSE 15L,A02,083655,Staff,5,0,50,45
1650245427362,CSE 20,A01,083657,Staff,53,0,80,27
1650245433393,CSE 30,A01,083084,Eldon; John,0,70,40,40
1650245439418,CSE 100,A01,083659,Cao; Yingjun,0,64,50,50
1650245445443,CSE 134B,A01,083661,Powell; Thomas Allan,0,27,65,65
1650245451471,CSE 140,A01,083663,Staff,0,0,75,75
1650245457499,CSE 140L,A01,083088,Eldon; John,0,5,75,75
1650245463525,CSE 175,A01,083665,Kumar; Rakesh,8,0,25,17
1650245469551,CSE 190,A00,092507,Dubnov; Shlomo,14,0,20,6
1650245475578,ECE 45,A01,083139,Staff,0,13,40,40
1650245481607,ECE 65,A50,083695,Staff,0,5,30,30
1650245487634,ECE 109,A01,091882,Touri; Behrouz,47,0,70,23
1650245493658,ECE 180,A00,083140,Abi Samra; Nicholas Camill,24,0,30,6
1650245493658,ECE 180,B00,083141,Abi Samra; Nicholas Camill,7,0,30,23
1650245499686,MATH 10A,A01,083735,Patchell; Gregory David,11,0,30,19
1650245499686,MATH 10A,A02,083736,Patchell; Gregory David,28,0,30,2
1650245499686,MATH 10A,A03,083737,Patchell; Gregory David,26,0,30,4
1650245505709,MATH 10B,A01,083207,Staff,0,6,30,30
1650245505709,MATH 10B,A02,083208,Staff,0,5,30,30
1650245505709,MATH 10B,B01,083739,Staff,17,0,30,13
1650245505709,MATH 10B,B02,083740,Staff,29,0,30,1
1650245511732,MATH 18,A01,083743,Staff,7,0,30,23
1650245511732,MATH 18,A02,083744,Staff,28,0,30,2
1650245511732,MATH 18,A03,083745,Staff,23,0,30,7
1650245511732,MATH 18,A04,083746,Staff,27,0,30,3
1650245511732,MATH 18,B01,083748,Staff,0,10,30,30
1650245511732,MATH 18,B02,083749,Staff,0,8,30,30
1650245511732,MATH 18,B03,083750,Staff,0,7,30,30
1650245511732,MATH 18,B04,083751,Staff,0,9,30,30
1650245517758,MATH 20A,A01,083754,Staff,26,0,40,14
1650245523785,MATH 20B,A01,083756,Staff,1,6,30,29
1650245523785,MATH 20B,A02,083757,Staff,0,7,30,30
1650245529828,MATH 20C,A01,083760,Staff,0,12,30,30
1650245529828,MATH 20C,A02,083761,Staff,0,13,30,30
1650245529828,MATH 20C,B01,083762,Staff,14,0,30,16
1650245529828,MATH 20C,B02,083763,Staff,28,0,30,2
1650245535855,MATH 20D,A01,083765,Staff,1,2,30,29
1650245535855,MATH 20D,A02,083766,Staff,8,0,30,22
1650245535855,MATH 20D,A03,083767,Staff,28,0,30,2
1650245541884,MATH 20E,A01,083771,Staff,8,0,30,22
1650245541884,MATH 20E,A02,083772,Staff,21,0,30,9
1650245541884,MATH 20E,B01,083773,Staff,0,0,30,30
1650245541884,MATH 20E,B02,083774,Staff,12,0,30,18
1650245547915,MATH 103A,A01,083777,Staff,0,9,30,30
1650245547915,MATH 103A,A02,083778,Staff,0,10,30,30
1650245547915,MATH 103A,B01,083779,Staff,0,10,30,30
1650245547915,MATH 103A,B02,083780,Staff,0,9,30,30
1650245553944,MATH 105,A01,085443,Staff,0,17,30,30
1650245559973,MATH 109,A01,083213,Anzaldo; Leesa B,0,4,30,30
1650245559973,MATH 109,A02,083214,Anzaldo; Leesa B,0,6,30,30
1650245559973,MATH 109,B01,083215,Anzaldo; Leesa B,0,4,30,30
1650245559973,MATH 109,B02,083216,Anzaldo; Leesa B,1,4,30,29
1650245565999,MATH 142A,A01,083219,Chow; Bennett,0,12,30,30
1650245565999,MATH 142A,A02,083220,Chow; Bennett,0,11,30,30
1650245565999,MATH 142A,B01,083221,Chow; Bennett,0,11,30,30
1650245565999,MATH 142A,B02,083222,Chow; Bennett,0,12,30,30
1650245572026,MATH 193A,A01,083224,Staff,0,5,30,30
1650245572026,MATH 193A,A02,083225,Staff,0,4,30,30
1650245572026,MATH 193A,A03,083781,Staff,0,2,30,30
1650245572026,MATH 193A,A04,083782,Staff,0,1,30,30
1650245578052,MATH 197,001,091859,McAuley; Julian John,9998,0,9999,1
1650245584117,COGS 9,A01,083615,Staff,0,14,60,60
1650245590144,COGS 11,A01,083617,Boyle; Mary E. T.,24,0,40,16
1650245596173,COGS 13,A01,083071,Staff,0,30,40,40
1650245602197,COGS 14A,A01,092681,Staff,1,13,100,99
1650245608222,COGS 14B,A01,083073,Cheng; Tzu-Han,0,8,50,50
1650245614248,COGS 17,A01,092677,Staff,33,0,75,42
1650245620273,COGS 100,A01,083619,Staff,1,21,60,59
1650245626298,COGS 101A,A01,083621,Davis; Joshua Daniel,0,20,60,60
1650245632325,COGS 101B,A01,091572,Staff,5,0,60,55
1650245638353,COGS 101C,A01,083625,Delgado; Tania,20,0,30,10
1650245644380,COGS 107A,A01,083627,Boyle; Mary E. T.,1,7,60,59
1650245650403,COGS 118A,A01,083075,Staff,15,0,60,45
1650245656429,CSE 3,A50,083646,Miranda; Gregory Joseph,22,0,38,16
1650245656429,CSE 3,A51,083647,Miranda; Gregory Joseph,37,0,37,0
1650245662455,CSE 8A,A50,083650,Miranda; Gregory Joseph,0,18,40,40
1650245668566,CSE 11,A01,083080,Cao; Yingjun,0,69,40,40
1650245674593,CSE 12,A01,083652,Staff,0,9,100,100
1650245680620,CSE 15L,A01,083654,Staff,0,1,50,50
1650245680620,CSE 15L,A02,083655,Staff,5,0,50,45
1650245686647,CSE 20,A01,083657,Staff,53,0,80,27
1650245692670,CSE 30,A01,083084,Eldon; John,0,70,40,40
1650245698695,CSE 100,A01,083659,Cao; Yingjun,0,64,50,50
1650245704722,CSE 134B,A01,083661,Powell; Thomas Allan,0,27,65,65
1650245710744,CSE 140,A01,083663,Staff,0,0,75,75
1650245716771,CSE 140L,A01,083088,Eldon; John,0,5,75,75
1650245722807,CSE 175,A01,083665,Kumar; Rakesh,8,0,25,17
1650245728828,CSE 190,A00,092507,Dubnov; Shlomo,14,0,20,6
1650245734859,ECE 45,A01,083139,Staff,0,13,40,40
1650245740881,ECE 65,A50,083695,Staff,0,5,30,30
1650245746906,ECE 109,A01,091882,Touri; Behrouz,47,0,70,23
1650245752928,ECE 180,A00,083140,Abi Samra; Nicholas Camill,24,0,30,6
1650245752928,ECE 180,B00,083141,Abi Samra; Nicholas Camill,7,0,30,23
1650245758957,MATH 10A,A01,083735,Patchell; Gregory David,11,0,30,19
1650245758957,MATH 10A,A02,083736,Patchell; Gregory David,28,0,30,2
1650245758957,MATH 10A,A03,083737,Patchell; Gregory David,26,0,30,4
1650245764984,MATH 10B,A01,083207,Staff,0,6,30,30
1650245764984,MATH 10B,A02,083208,Staff,0,5,30,30
1650245764984,MATH 10B,B01,083739,Staff,17,0,30,13
1650245764984,MATH 10B,B02,083740,Staff,29,0,30,1
1650245771023,MATH 18,A01,083743,Staff,7,0,30,23
1650245771023,MATH 18,A02,083744,Staff,28,0,30,2
1650245771023,MATH 18,A03,083745,Staff,23,0,30,7
1650245771023,MATH 18,A04,083746,Staff,27,0,30,3
1650245771023,MATH 18,B01,083748,Staff,0,10,30,30
1650245771023,MATH 18,B02,083749,Staff,0,8,30,30
1650245771023,MATH 18,B03,083750,Staff,0,7,30,30
1650245771023,MATH 18,B04,083751,Staff,0,9,30,30
1650245777055,MATH 20A,A01,083754,Staff,26,0,40,14
1650245783086,MATH 20B,A01,083756,Staff,1,6,30,29
1650245783086,MATH 20B,A02,083757,Staff,0,7,30,30
1650245789111,MATH 20C,A01,083760,Staff,0,12,30,30
1650245789111,MATH 20C,A02,083761,Staff,0,13,30,30
1650245789111,MATH 20C,B01,083762,Staff,14,0,30,16
1650245789111,MATH 20C,B02,083763,Staff,28,0,30,2
1650245795134,MATH 20D,A01,083765,Staff,1,2,30,29
1650245795134,MATH 20D,A02,083766,Staff,8,0,30,22
1650245795134,MATH 20D,A03,083767,Staff,28,0,30,2
1650245801158,MATH 20E,A01,083771,Staff,8,0,30,22
1650245801158,MATH 20E,A02,083772,Staff,21,0,30,9
1650245801158,MATH 20E,B01,083773,Staff,0,0,30,30
1650245801158,MATH 20E,B02,083774,Staff,12,0,30,18
1650245807185,MATH 103A,A01,083777,Staff,0,9,30,30
1650245807185,MATH 103A,A02,083778,Staff,0,10,30,30
1650245807185,MATH 103A,B01,083779,Staff,0,10,30,30
1650245807185,MATH 103A,B02,083780,Staff,0,9,30,30
1650245813224,MATH 105,A01,085443,Staff,0,17,30,30
1650245819253,MATH 109,A01,083213,Anzaldo; Leesa B,0,4,30,30
1650245819253,MATH 109,A02,083214,Anzaldo; Leesa B,0,6,30,30
1650245819253,MATH 109,B01,083215,Anzaldo; Leesa B,0,4,30,30
1650245819253,MATH 109,B02,083216,Anzaldo; Leesa B,1,4,30,29
1650245825277,MATH 142A,A01,083219,Chow; Bennett,0,12,30,30
1650245825277,MATH 142A,A02,083220,Chow; Bennett,0,11,30,30
1650245825277,MATH 142A,B01,083221,Chow; Bennett,0,11,30,30
1650245825277,MATH 142A,B02,083222,Chow; Bennett,0,12,30,30
1650245831313,MATH 193A,A01,083224,Staff,0,5,30,30
1650245831313,MATH 193A,A02,083225,Staff,0,4,30,30
1650245831313,MATH 193A,A03,083781,Staff,0,2,30,30
1650245831313,MATH 193A,A04,083782,Staff,0,1,30,30
1650245837342,MATH 197,001,091859,McAuley; Julian John,9998,0,9999,1
1650245843398,COGS 9,A01,083615,Staff,0,14,60,60
1650245849422,COGS 11,A01,083617,Boyle; Mary E. T.,24,0,40,16
1650245855448,COGS 13,A01,083071,Staff,0,31,40,40
1650245861472,COGS 14A,A01,092681,Staff,1,13,100,99
1650245867500,COGS 14B,A01,083073,Cheng; Tzu-Han,0,8,50,50
1650245873523,COGS 17,A01,092677,Staff,33,0,75,42
1650245879547,COGS 100,A01,083619,Staff,1,21,60,59
1650245885581,COGS 101A,A01,083621,Davis; Joshua Daniel,0,21,60,60
1650245891603,COGS 101B,A01,091572,Staff,5,0,60,55
1650245897652,COGS 101C,A01,083625,Delgado; Tania,20,0,30,10
1650245903679,COGS 107A,A01,083627,Boyle; Mary E. T.,1,7,60,59
1650245909703,COGS 118A,A01,083075,Staff,15,0,60,45
1650245915739,CSE 3,A50,083646,Miranda; Gregory Joseph,22,0,38,16
1650245915739,CSE 3,A51,083647,Miranda; Gregory Joseph,37,0,37,0
1650245921769,CSE 8A,A50,083650,Miranda; Gregory Joseph,0,18,40,40
1650245927797,CSE 11,A01,083080,Cao; Yingjun,0,69,40,40
1650245933820,CSE 12,A01,083652,Staff,0,9,100,100
1650245939853,CSE 15L,A01,083654,Staff,0,1,50,50
1650245939853,CSE 15L,A02,083655,Staff,5,0,50,45
1650245945876,CSE 20,A01,083657,Staff,53,0,80,27
1650245951906,CSE 30,A01,083084,Eldon; John,0,70,40,40
1650245957932,CSE 100,A01,083659,Cao; Yingjun,0,64,50,50
1650245963954,CSE 134B,A01,083661,Powell; Thomas Allan,0,27,65,65
1650245969977,CSE 140,A01,083663,Staff,0,0,75,75
1650245975999,CSE 140L,A01,083088,Eldon; John,0,5,75,75
1650245982023,CSE 175,A01,083665,Kumar; Rakesh,8,0,25,17
1650245988051,CSE 190,A00,092507,Dubnov; Shlomo,14,0,20,6
1650245994075,ECE 45,A01,083139,Staff,0,13,40,40
1650246000102,ECE 65,A50,083695,Staff,0,5,30,30
1650246006128,ECE 109,A01,091882,Touri; Behrouz,47,0,70,23
1650246012154,ECE 180,A00,083140,Abi Samra; Nicholas Camill,24,0,30,6
1650246012154,ECE 180,B00,083141,Abi Samra; Nicholas Camill,7,0,30,23
1650246018187,MATH 10A,A01,083735,Patchell; Gregory David,11,0,30,19
1650246018187,MATH 10A,A02,083736,Patchell; Gregory David,28,0,30,2
1650246018187,MATH 10A,A03,083737,Patchell; Gregory David,26,0,30,4
1650246024209,MATH 10B,A01,083207,Staff,0,6,30,30
1650246024209,MATH 10B,A02,083208,Staff,0,5,30,30
1650246024209,MATH 10B,B01,083739,Staff,17,0,30,13
1650246024209,MATH 10B,B02,083740,Staff,29,0,30,1
1650246030236,MATH 18,A01,083743,Staff,7,0,30,23
1650246030236,MATH 18,A02,083744,Staff,28,0,30,2
1650246030236,MATH 18,A03,083745,Staff,23,0,30,7
1650246030236,MATH 18,A04,083746,Staff,27,0,30,3
1650246030236,MATH 18,B01,083748,Staff,0,10,30,30
1650246030236,MATH 18,B02,083749,Staff,0,8,30,30
1650246030236,MATH 18,B03,083750,Staff,0,7,30,30
1650246030236,MATH 18,B04,083751,Staff,0,9,30,30
1650246036260,MATH 20A,A01,083754,Staff,26,0,40,14
1650246042282,MATH 20B,A01,083756,Staff,1,6,30,29
1650246042282,MATH 20B,A02,083757,Staff,0,7,30,30
1650246048317,MATH 20C,A01,083760,Staff,0,12,30,30
1650246048317,MATH 20C,A02,083761,Staff,0,13,30,30
1650246048317,MATH 20C,B01,083762,Staff,14,0,30,16
1650246048317,MATH 20C,B02,083763,Staff,28,0,30,2
1650246054340,MATH 20D,A01,083765,Staff,1,2,30,29
1650246054340,MATH 20D,A02,083766,Staff,8,0,30,22
1650246054340,MATH 20D,A03,083767,Staff,28,0,30,2
1650246060363,MATH 20E,A01,083771,Staff,8,0,30,22
1650246060363,MATH 20E,A02,083772,Staff,21,0,30,9
1650246060363,MATH 20E,B01,083773,Staff,0,0,30,30
1650246060363,MATH 20E,B02,083774,Staff,12,0,30,18
1650246066391,MATH 103A,A01,083777,Staff,0,9,30,30
1650246066391,MATH 103A,A02,083778,Staff,0,10,30,30
1650246066391,MATH 103A,B01,083779,Staff,0,10,30,30
1650246066391,MATH 103A,B02,083780,Staff,0,9,30,30
1650246072417,MATH 105,A01,085443,Staff,0,17,30,30
1650246078445,MATH 109,A01,083213,Anzaldo; Leesa B,0,4,30,30
1650246078445,MATH 109,A02,083214,Anzaldo; Leesa B,0,6,30,30
1650246078445,MATH 109,B01,083215,Anzaldo; Leesa B,0,4,30,30
1650246078445,MATH 109,B02,083216,Anzaldo; Leesa B,1,4,30,29
1650246084472,MATH 142A,A01,083219,Chow; Bennett,0,12,30,30
1650246084472,MATH 142A,A02,083220,Chow; Bennett,0,11,30,30
1650246084472,MATH 142A,B01,083221,Chow; Bennett,0,11,30,30
1650246084472,MATH 142A,B02,083222,Chow; Bennett,0,12,30,30
1650246090496,MATH 193A,A01,083224,Staff,0,5,30,30
1650246090496,MATH 193A,A02,083225,Staff,0,4,30,30
1650246090496,MATH 193A,A03,083781,Staff,0,2,30,30
1650246090496,MATH 193A,A04,083782,Staff,0,1,30,30
1650246096525,MATH 197,001,091859,McAuley; Julian John,9998,0,9999,1
1650246102570,COGS 9,A01,083615,Staff,0,14,60,60
1650246108595,COGS 11,A01,083617,Boyle; Mary E. T.,24,0,40,16
1650246114621,COGS 13,A01,083071,Staff,0,31,40,40
1650246120645,COGS 14A,A01,092681,Staff,1,14,100,99
1650246126670,COGS 14B,A01,083073,Cheng; Tzu-Han,0,8,50,50
1650246132693,COGS 17,A01,092677,Staff,32,0,75,43
1650246138720,COGS 100,A01,083619,Staff,1,21,60,59
1650246144748,COGS 101A,A01,083621,Davis; Joshua Daniel,0,21,60,60
1650246150774,COGS 101B,A01,091572,Staff,5,0,60,55
1650246156796,COGS 101C,A01,083625,Delgado; Tania,20,0,30,10
1650246162828,COGS 107A,A01,083627,Boyle; Mary E. T.,1,7,60,59
1650246168851,COGS 118A,A01,083075,Staff,15,0,60,45
1650246174874,CSE 3,A50,083646,Miranda; Gregory Joseph,22,0,38,16
1650246174874,CSE 3,A51,083647,Miranda; Gregory Joseph,37,0,37,0
1650246180899,CSE 8A,A50,083650,Miranda; Gregory Joseph,0,18,40,40
1650246186924,CSE 11,A01,083080,Cao; Yingjun,0,69,40,40
1650246192950,CSE 12,A01,083652,Staff,0,9,100,100
1650246198976,CSE 15L,A01,083654,Staff,0,1,50,50
1650246198976,CSE 15L,A02,083655,Staff,5,0,50,45
1650246205011,CSE 20,A01,083657,Staff,53,0,80,27
1650246211034,CSE 30,A01,083084,Eldon; John,0,70,40,40
1650246217069,CSE 100,A01,083659,Cao; Yingjun,0,64,50,50
1650246223093,CSE 134B,A01,083661,Powell; Thomas Allan,0,27,65,65
1650246229117,CSE 140,A01,083663,Staff,0,0,75,75
1650246235143,CSE 140L,A01,083088,Eldon; John,0,5,75,75
1650246241170,CSE 175,A01,083665,Kumar; Rakesh,8,0,25,17
1650246247194,CSE 190,A00,092507,Dubnov; Shlomo,14,0,20,6
1650246253220,ECE 45,A01,083139,Staff,0,13,40,40
1650246259243,ECE 65,A50,083695,Staff,0,5,30,30
1650246265370,ECE 109,A01,091882,Touri; Behrouz,47,0,70,23
1650246271397,ECE 180,A00,083140,Abi Samra; Nicholas Camill,24,0,30,6
1650246271397,ECE 180,B00,083141,Abi Samra; Nicholas Camill,7,0,30,23
1650246277421,MATH 10A,A01,083735,Patchell; Gregory David,11,0,30,19
1650246277421,MATH 10A,A02,083736,Patchell; Gregory David,28,0,30,2
1650246277421,MATH 10A,A03,083737,Patchell; Gregory David,26,0,30,4
1650246283447,MATH 10B,A01,083207,Staff,0,6,30,30
1650246283447,MATH 10B,A02,083208,Staff,0,5,30,30
1650246283447,MATH 10B,B01,083739,Staff,17,0,30,13
1650246283447,MATH 10B,B02,083740,Staff,29,0,30,1
1650246289472,MATH 18,A01,083743,Staff,7,0,30,23
1650246289472,MATH 18,A02,083744,Staff,28,0,30,2
1650246289472,MATH 18,A03,083745,Staff,23,0,30,7
1650246289472,MATH 18,A04,083746,Staff,27,0,30,3
1650246289472,MATH 18,B01,083748,Staff,0,10,30,30
1650246289472,MATH 18,B02,083749,Staff,0,8,30,30
1650246289472,MATH 18,B03,083750,Staff,0,7,30,30
1650246289472,MATH 18,B04,083751,Staff,0,9,30,30
1650246295503,MATH 20A,A01,083754,Staff,26,0,40,14
1650246301530,MATH 20B,A01,083756,Staff,1,6,30,29
1650246301530,MATH 20B,A02,083757,Staff,0,7,30,30
1650246307553,MATH 20C,A01,083760,Staff,0,12,30,30
1650246307553,MATH 20C,A02,083761,Staff,0,13,30,30
1650246307553,MATH 20C,B01,083762,Staff,14,0,30,16
1650246307553,MATH 20C,B02,083763,Staff,28,0,30,2
1650246313580,MATH 20D,A01,083765,Staff,1,2,30,29
1650246313580,MATH 20D,A02,083766,Staff,8,0,30,22
1650246313580,MATH 20D,A03,083767,Staff,28,0,30,2
1650246319607,MATH 20E,A01,083771,Staff,8,0,30,22
1650246319607,MATH 20E,A02,083772,Staff,21,0,30,9
1650246319607,MATH 20E,B01,083773,Staff,0,0,30,30
1650246319607,MATH 20E,B02,083774,Staff,12,0,30,18
1650246325636,MATH 103A,A01,083777,Staff,0,9,30,30
1650246325636,MATH 103A,A02,083778,Staff,0,10,30,30
1650246325636,MATH 103A,B01,083779,Staff,0,10,30,30
1650246325636,MATH 103A,B02,083780,Staff,0,9,30,30
1650246331660,MATH 105,A01,085443,Staff,0,17,30,30
1650246337684,MATH 109,A01,083213,Anzaldo; Leesa B,0,4,30,30
1650246337684,MATH 109,A02,083214,Anzaldo; Leesa B,0,6,30,30
1650246337684,MATH 109,B01,083215,Anzaldo; Leesa B,0,4,30,30
1650246337684,MATH 109,B02,083216,Anzaldo; Leesa B,1,4,30,29
1650246343718,MATH 142A,A01,083219,Chow; Bennett,0,12,30,30
1650246343718,MATH 142A,A02,083220,Chow; Bennett,0,11,30,30
1650246343718,MATH 142A,B01,083221,Chow; Bennett,0,11,30,30
1650246343718,MATH 142A,B02,083222,Chow; Bennett,0,12,30,30
1650246349747,MATH 193A,A01,083224,Staff,0,5,30,30
1650246349747,MATH 193A,A02,083225,Staff,0,4,30,30
1650246349747,MATH 193A,A03,083781,Staff,0,2,30,30
1650246349747,MATH 193A,A04,083782,Staff,0,1,30,30
1650246355772,MATH 197,001,091859,McAuley; Julian John,9998,0,9999,1
1650246361828,COGS 9,A01,083615,Staff,0,14,60,60
1650246367855,COGS 11,A01,083617,Boyle; Mary E. T.,24,0,40,16
1650246373879,COGS 13,A01,083071,Staff,0,30,40,40
1650246379905,COGS 14A,A01,092681,Staff,1,14,100,99
1650246385928,COGS 14B,A01,083073,Cheng; Tzu-Han,0,8,50,50
1650246391950,COGS 17,A01,092677,Staff,32,0,75,43
1650246397976,COGS 100,A01,083619,Staff,1,21,60,59
1650246404000,COGS 101A,A01,083621,Davis; Joshua Daniel,0,21,60,60
1650246410024,COGS 101B,A01,091572,Staff,5,0,60,55
1650246416048,COGS 101C,A01,083625,Delgado; Tania,20,0,30,10
1650246422072,COGS 107A,A01,083627,Boyle; Mary E. T.,1,7,60,59
1650246428097,COGS 118A,A01,083075,Staff,15,0,60,45
1650246434122,CSE 3,A50,083646,Miranda; Gregory Joseph,22,0,38,16
1650246434122,CSE 3,A51,083647,Miranda; Gregory Joseph,37,0,37,0
1650246440146,CSE 8A,A50,083650,Miranda; Gregory Joseph,0,18,40,40
1650246446170,CSE 11,A01,083080,Cao; Yingjun,0,69,40,40
1650246452193,CSE 12,A01,083652,Staff,0,9,100,100
1650246458219,CSE 15L,A01,083654,Staff,0,1,50,50
1650246458219,CSE 15L,A02,083655,Staff,5,0,50,45
1650246464243,CSE 20,A01,083657,Staff,53,0,80,27
1650246470270,CSE 30,A01,083084,Eldon; John,0,70,40,40
1650246476293,CSE 100,A01,083659,Cao; Yingjun,0,64,50,50
1650246482324,CSE 134B,A01,083661,Powell; Thomas Allan,0,27,65,65
1650246488348,CSE 140,A01,083663,Staff,0,0,75,75
1650246494371,CSE 140L,A01,083088,Eldon; John,0,5,75,75
1650246500399,CSE 175,A01,083665,Kumar; Rakesh,8,0,25,17
1650246506425,CSE 190,A00,092507,Dubnov; Shlomo,14,0,20,6
1650246512452,ECE 45,A01,083139,Staff,0,13,40,40
1650246518479,ECE 65,A50,083695,Staff,0,5,30,30
1650246524501,ECE 109,A01,091882,Touri; Behrouz,47,0,70,23
1650246530524,ECE 180,A00,083140,Abi Samra; Nicholas Camill,24,0,30,6
1650246530524,ECE 180,B00,083141,Abi Samra; Nicholas Camill,7,0,30,23
1650246536552,MATH 10A,A01,083735,Patchell; Gregory David,11,0,30,19
1650246536552,MATH 10A,A02,083736,Patchell; Gregory David,28,0,30,2
1650246536552,MATH 10A,A03,083737,Patchell; Gregory David,26,0,30,4
1650246542575,MATH 10B,A01,083207,Staff,0,6,30,30
1650246542575,MATH 10B,A02,083208,Staff,0,5,30,30
1650246542575,MATH 10B,B01,083739,Staff,17,0,30,13
1650246542575,MATH 10B,B02,083740,Staff,29,0,30,1
1650246548618,MATH 18,A01,083743,Staff,7,0,30,23
1650246548618,MATH 18,A02,083744,Staff,28,0,30,2
1650246548618,MATH 18,A03,083745,Staff,23,0,30,7
1650246548618,MATH 18,A04,083746,Staff,27,0,30,3
1650246548618,MATH 18,B01,083748,Staff,0,10,30,30
1650246548618,MATH 18,B02,083749,Staff,0,8,30,30
1650246548618,MATH 18,B03,083750,Staff,0,7,30,30
1650246548618,MATH 18,B04,083751,Staff,0,9,30,30
1650246554642,MATH 20A,A01,083754,Staff,26,0,40,14
1650246560666,MATH 20B,A01,083756,Staff,1,6,30,29
1650246560666,MATH 20B,A02,083757,Staff,0,7,30,30
1650246566689,MATH 20C,A01,083760,Staff,0,12,30,30
1650246566689,MATH 20C,A02,083761,Staff,0,13,30,30
1650246566689,MATH 20C,B01,083762,Staff,14,0,30,16
1650246566689,MATH 20C,B02,083763,Staff,28,0,30,2
1650246572713,MATH 20D,A01,083765,Staff,1,2,30,29
1650246572713,MATH 20D,A02,083766,Staff,8,0,30,22
1650246572713,MATH 20D,A03,083767,Staff,28,0,30,2
1650246578737,MATH 20E,A01,083771,Staff,8,0,30,22
1650246578737,MATH 20E,A02,083772,Staff,21,0,30,9
1650246578737,MATH 20E,B01,083773,Staff,0,0,30,30
1650246578737,MATH 20E,B02,083774,Staff,12,0,30,18
1650246584766,MATH 103A,A01,083777,Staff,0,9,30,30
1650246584766,MATH 103A,A02,083778,Staff,0,10,30,30
1650246584766,MATH 103A,B01,083779,Staff,0,10,30,30
1650246584766,MATH 103A,B02,083780,Staff,0,9,30,30
1650246590791,MATH 105,A01,085443,Staff,0,17,30,30
1650246596816,MATH 109,A01,083213,Anzaldo; Leesa B,0,4,30,30
1650246596816,MATH 109,A02,083214,Anzaldo; Leesa B,0,6,30,30
1650246596816,MATH 109,B01,083215,Anzaldo; Leesa B,0,4,30,30
1650246596816,MATH 109,B02,083216,Anzaldo; Leesa B,1,4,30,29
1650246602844,MATH 142A,A01,083219,Chow; Bennett,0,12,30,30
1650246602844,MATH 142A,A02,083220,Chow; Bennett,0,11,30,30
1650246602844,MATH 142A,B01,083221,Chow; Bennett,0,11,30,30
1650246602844,MATH 142A,B02,083222,Chow; Bennett,0,12,30,30
1650246608868,MATH 193A,A01,083224,Staff,0,5,30,30
1650246608868,MATH 193A,A02,083225,Staff,0,4,30,30
1650246608868,MATH 193A,A03,083781,Staff,0,2,30,30
1650246608868,MATH 193A,A04,083782,Staff,0,1,30,30
1650246614895,MATH 197,001,091859,McAuley; Julian John,9998,0,9999,1
1650246620964,COGS 9,A01,083615,Staff,0,14,60,60
1650246626988,COGS 11,A01,083617,Boyle; Mary E. T.,24,0,40,16
1650246633016,COGS 13,A01,083071,Staff,0,30,40,40
1650246639041,COGS 14A,A01,092681,Staff,1,14,100,99
1650246645077,COGS 14B,A01,083073,Cheng; Tzu-Han,0,8,50,50
1650246651105,COGS 17,A01,092677,Staff,32,0,75,43
1650246657128,COGS 100,A01,083619,Staff,1,21,60,59
1650246663151,COGS 101A,A01,083621,Davis; Joshua Daniel,0,21,60,60
1650246669175,COGS 101B,A01,091572,Staff,5,0,60,55
1650246675197,COGS 101C,A01,083625,Delgado; Tania,20,0,30,10
1650246681223,COGS 107A,A01,083627,Boyle; Mary E. T.,1,7,60,59
1650246687254,COGS 118A,A01,083075,Staff,15,0,60,45
1650246693283,CSE 3,A50,083646,Miranda; Gregory Joseph,22,0,38,16
1650246693283,CSE 3,A51,083647,Miranda; Gregory Joseph,37,0,37,0
1650246699310,CSE 8A,A50,083650,Miranda; Gregory Joseph,0,18,40,40
1650246705337,CSE 11,A01,083080,Cao; Yingjun,0,69,40,40
1650246711360,CSE 12,A01,083652,Staff,0,9,100,100
1650246717385,CSE 15L,A01,083654,Staff,0,1,50,50
1650246717385,CSE 15L,A02,083655,Staff,5,0,50,45
1650246723415,CSE 20,A01,083657,Staff,53,0,80,27
1650246729441,CSE 30,A01,083084,Eldon; John,0,70,40,40
1650246735477,CSE 100,A01,083659,Cao; Yingjun,0,64,50,50
1650246741499,CSE 134B,A01,083661,Powell; Thomas Allan,0,27,65,65
1650246747522,CSE 140,A01,083663,Staff,0,0,75,75
1650246753543,CSE 140L,A01,083088,Eldon; John,0,5,75,75
1650246759568,CSE 175,A01,083665,Kumar; Rakesh,8,0,25,17
1650246765591,CSE 190,A00,092507,Dubnov; Shlomo,14,0,20,6
1650246771616,ECE 45,A01,083139,Staff,0,13,40,40
1650246777639,ECE 65,A50,083695,Staff,0,5,30,30
1650246783662,ECE 109,A01,091882,Touri; Behrouz,47,0,70,23
1650246789689,ECE 180,A00,083140,Abi Samra; Nicholas Camill,24,0,30,6
1650246789689,ECE 180,B00,083141,Abi Samra; Nicholas Camill,7,0,30,23
1650246795711,MATH 10A,A01,083735,Patchell; Gregory David,11,0,30,19
1650246795711,MATH 10A,A02,083736,Patchell; Gregory David,28,0,30,2
1650246795711,MATH 10A,A03,083737,Patchell; Gregory David,26,0,30,4
1650246801733,MATH 10B,A01,083207,Staff,0,6,30,30
1650246801733,MATH 10B,A02,083208,Staff,0,5,30,30
1650246801733,MATH 10B,B01,083739,Staff,17,0,30,13
1650246801733,MATH 10B,B02,083740,Staff,29,0,30,1
1650246807762,MATH 18,A01,083743,Staff,7,0,30,23
1650246807762,MATH 18,A02,083744,Staff,28,0,30,2
1650246807762,MATH 18,A03,083745,Staff,23,0,30,7
1650246807762,MATH 18,A04,083746,Staff,27,0,30,3
1650246807762,MATH 18,B01,083748,Staff,0,10,30,30
1650246807762,MATH 18,B02,083749,Staff,0,8,30,30
1650246807762,MATH 18,B03,083750,Staff,0,7,30,30
1650246807762,MATH 18,B04,083751,Staff,0,9,30,30
1650246813788,MATH 20A,A01,083754,Staff,26,0,40,14
1650246819812,MATH 20B,A01,083756,Staff,1,6,30,29
1650246819812,MATH 20B,A02,083757,Staff,0,7,30,30
1650246825836,MATH 20C,A01,083760,Staff,0,12,30,30
1650246825836,MATH 20C,A02,083761,Staff,0,13,30,30
1650246825836,MATH 20C,B01,083762,Staff,14,0,30,16
1650246825836,MATH 20C,B02,083763,Staff,28,0,30,2
1650246831864,MATH 20D,A01,083765,Staff,1,2,30,29
1650246831864,MATH 20D,A02,083766,Staff,8,0,30,22
1650246831864,MATH 20D,A03,083767,Staff,28,0,30,2
1650246837891,MATH 20E,A01,083771,Staff,7,0,30,23
1650246837891,MATH 20E,A02,083772,Staff,21,0,30,9
1650246837891,MATH 20E,B01,083773,Staff,0,0,30,30
1650246837891,MATH 20E,B02,083774,Staff,12,0,30,18
1650246843924,MATH 103A,A01,083777,Staff,0,9,30,30
1650246843924,MATH 103A,A02,083778,Staff,0,10,30,30
1650246843924,MATH 103A,B01,083779,Staff,0,10,30,30
1650246843924,MATH 103A,B02,083780,Staff,0,9,30,30
1650246849946,MATH 105,A01,085443,Staff,0,17,30,30
1650246855969,MATH 109,A01,083213,Anzaldo; Leesa B,0,4,30,30
1650246855969,MATH 109,A02,083214,Anzaldo; Leesa B,0,6,30,30
1650246855969,MATH 109,B01,083215,Anzaldo; Leesa B,0,4,30,30
1650246855969,MATH 109,B02,083216,Anzaldo; Leesa B,1,4,30,29
1650246862079,MATH 142A,A01,083219,Chow; Bennett,0,12,30,30
1650246862079,MATH 142A,A02,083220,Chow; Bennett,0,11,30,30
1650246862079,MATH 142A,B01,083221,Chow; Bennett,0,11,30,30
1650246862079,MATH 142A,B02,083222,Chow; Bennett,0,12,30,30
1650246868105,MATH 193A,A01,083224,Staff,0,5,30,30
1650246868105,MATH 193A,A02,083225,Staff,0,4,30,30
1650246868105,MATH 193A,A03,083781,Staff,0,2,30,30
1650246868105,MATH 193A,A04,083782,Staff,0,1,30,30
1650246874130,MATH 197,001,091859,McAuley; Julian John,9998,0,9999,1
1650246880188,COGS 9,A01,083615,Staff,0,14,60,60
1650246886211,COGS 11,A01,083617,Boyle; Mary E. T.,24,0,40,16
1650246892238,COGS 13,A01,083071,Staff,0,30,40,40
1650246898260,COGS 14A,A01,092681,Staff,1,14,100,99
1650246904335,COGS 14B,A01,083073,Cheng; Tzu-Han,0,8,50,50
1650246910359,COGS 17,A01,092677,Staff,32,0,75,43
1650246916382,COGS 100,A01,083619,Staff,1,21,60,59
1650246922408,COGS 101A,A01,083621,Davis; Joshua Daniel,0,21,60,60
1650246928432,COGS 101B,A01,091572,Staff,5,0,60,55
1650246934459,COGS 101C,A01,083625,Delgado; Tania,20,0,30,10
1650246940486,COGS 107A,A01,083627,Boyle; Mary E. T.,1,7,60,59
1650246946521,COGS 118A,A01,083075,Staff,15,0,60,45
1650246952553,CSE 3,A50,083646,Miranda; Gregory Joseph,22,0,38,16
1650246952553,CSE 3,A51,083647,Miranda; Gregory Joseph,37,0,37,0
1650246958577,CSE 8A,A50,083650,Miranda; Gregory Joseph,0,18,40,40
1650246964600,CSE 11,A01,083080,Cao; Yingjun,0,69,40,40
1650246970623,CSE 12,A01,083652,Staff,0,9,100,100
1650246976645,CSE 15L,A01,083654,Staff,0,1,50,50
1650246976645,CSE 15L,A02,083655,Staff,5,0,50,45
1650246982671,CSE 20,A01,083657,Staff,53,0,80,27
1650246988696,CSE 30,A01,083084,Eldon; John,0,71,40,40
1650246994719,CSE 100,A01,083659,Cao; Yingjun,0,64,50,50
1650247000744,CSE 134B,A01,083661,Powell; Thomas Allan,0,27,65,65
1650247006768,CSE 140,A01,083663,Staff,0,0,75,75
1650247012792,CSE 140L,A01,083088,Eldon; John,0,5,75,75
1650247018829,CSE 175,A01,083665,Kumar; Rakesh,8,0,25,17
1650247024852,CSE 190,A00,092507,Dubnov; Shlomo,14,0,20,6
1650247030879,ECE 45,A01,083139,Staff,0,13,40,40
1650247036902,ECE 65,A50,083695,Staff,0,5,30,30
1650247042934,ECE 109,A01,091882,Touri; Behrouz,47,0,70,23
1650247048959,ECE 180,A00,083140,Abi Samra; Nicholas Camill,24,0,30,6
1650247048959,ECE 180,B00,083141,Abi Samra; Nicholas Camill,7,0,30,23
1650247054986,MATH 10A,A01,083735,Patchell; Gregory David,11,0,30,19
1650247054986,MATH 10A,A02,083736,Patchell; Gregory David,28,0,30,2
1650247054986,MATH 10A,A03,083737,Patchell; Gregory David,26,0,30,4
1650247061014,MATH 10B,A01,083207,Staff,0,6,30,30
1650247061014,MATH 10B,A02,083208,Staff,0,5,30,30
1650247061014,MATH 10B,B01,083739,Staff,17,0,30,13
1650247061014,MATH 10B,B02,083740,Staff,29,0,30,1
1650247067037,MATH 18,A01,083743,Staff,7,0,30,23
1650247067037,MATH 18,A02,083744,Staff,28,0,30,2
1650247067037,MATH 18,A03,083745,Staff,23,0,30,7
1650247067037,MATH 18,A04,083746,Staff,27,0,30,3
1650247067037,MATH 18,B01,083748,Staff,0,10,30,30
1650247067037,MATH 18,B02,083749,Staff,0,8,30,30
1650247067037,MATH 18,B03,083750,Staff,0,7,30,30
1650247067037,MATH 18,B04,083751,Staff,0,9,30,30
1650247073063,MATH 20A,A01,083754,Staff,26,0,40,14
1650247079100,MATH 20B,A01,083756,Staff,1,6,30,29
1650247079100,MATH 20B,A02,083757,Staff,0,7,30,30
1650247085127,MATH 20C,A01,083760,Staff,0,12,30,30
1650247085127,MATH 20C,A02,083761,Staff,0,13,30,30
1650247085127,MATH 20C,B01,083762,Staff,14,0,30,16
1650247085127,MATH 20C,B02,083763,Staff,28,0,30,2
1650247091151,MATH 20D,A01,083765,Staff,1,2,30,29
1650247091151,MATH 20D,A02,083766,Staff,8,0,30,22
1650247091151,MATH 20D,A03,083767,Staff,28,0,30,2
1650247097174,MATH 20E,A01,083771,Staff,7,0,30,23
1650247097174,MATH 20E,A02,083772,Staff,21,0,30,9
1650247097174,MATH 20E,B01,083773,Staff,0,0,30,30
1650247097174,MATH 20E,B02,083774,Staff,12,0,30,18
1650247103196,MATH 103A,A01,083777,Staff,0,9,30,30
1650247103196,MATH 103A,A02,083778,Staff,0,10,30,30
1650247103196,MATH 103A,B01,083779,Staff,0,10,30,30
1650247103196,MATH 103A,B02,083780,Staff,0,9,30,30
1650247109231,MATH 105,A01,085443,Staff,0,17,30,30
1650247115257,MATH 109,A01,083213,Anzaldo; Leesa B,0,4,30,30
1650247115257,MATH 109,A02,083214,Anzaldo; Leesa B,0,6,30,30
1650247115257,MATH 109,B01,083215,Anzaldo; Leesa B,0,4,30,30
1650247115257,MATH 109,B02,083216,Anzaldo; Leesa B,1,4,30,29
1650247121281,MATH 142A,A01,083219,Chow; Bennett,0,12,30,30
1650247121281,MATH 142A,A02,083220,Chow; Bennett,0,11,30,30
1650247121281,MATH 142A,B01,083221,Chow; Bennett,0,11,30,30
1650247121281,MATH 142A,B02,083222,Chow; Bennett,0,12,30,30
1650247127313,MATH 193A,A01,083224,Staff,0,5,30,30
1650247127313,MATH 193A,A02,083225,Staff,0,4,30,30
1650247127313,MATH 193A,A03,083781,Staff,0,2,30,30
1650247127313,MATH 193A,A04,083782,Staff,0,1,30,30
1650247133337,MATH 197,001,091859,McAuley; Julian John,9998,0,9999,1
1650247139388,COGS 9,A01,083615,Staff,0,14,60,60
1650247145414,COGS 11,A01,083617,Boyle; Mary E. T.,24,0,40,16
1650247151442,COGS 13,A01,083071,Staff,0,30,40,40
1650247157465,COGS 14A,A01,092681,Staff,1,14,100,99
1650247163488,COGS 14B,A01,083073,Cheng; Tzu-Han,0,8,50,50
1650247169512,COGS 17,A01,092677,Staff,32,0,75,43
1650247175534,COGS 100,A01,083619,Staff,1,21,60,59
1650247181557,COGS 101A,A01,083621,Davis; Joshua Daniel,0,21,60,60
1650247187580,COGS 101B,A01,091572,Staff,5,0,60,55
1650247193605,COGS 101C,A01,083625,Delgado; Tania,20,0,30,10
1650247199629,COGS 107A,A01,083627,Boyle; Mary E. T.,1,7,60,59
1650247205651,COGS 118A,A01,083075,Staff,15,0,60,45
1650247211676,CSE 3,A50,083646,Miranda; Gregory Joseph,22,0,38,16
1650247211676,CSE 3,A51,083647,Miranda; Gregory Joseph,37,0,37,0
1650247217703,CSE 8A,A50,083650,Miranda; Gregory Joseph,0,18,40,40
1650247223732,CSE 11,A01,083080,Cao; Yingjun,0,69,40,40
1650247229754,CSE 12,A01,083652,Staff,0,9,100,100
1650247235778,CSE 15L,A01,083654,Staff,0,1,50,50
1650247235778,CSE 15L,A02,083655,Staff,5,0,50,45
1650247241801,CSE 20,A01,083657,Staff,53,0,80,27
1650247247824,CSE 30,A01,083084,Eldon; John,0,71,40,40
1650247253851,CSE 100,A01,083659,Cao; Yingjun,0,64,50,50
1650247259874,CSE 134B,A01,083661,Powell; Thomas Allan,0,27,65,65
1650247265898,CSE 140,A01,083663,Staff,0,0,75,75
1650247271925,CSE 140L,A01,083088,Eldon; John,0,5,75,75
1650247277948,CSE 175,A01,083665,Kumar; Rakesh,8,0,25,17
1650247283975,CSE 190,A00,092507,Dubnov; Shlomo,14,0,20,6
1650247290002,ECE 45,A01,083139,Staff,0,13,40,40
1650247296025,ECE 65,A50,083695,Staff,0,5,30,30
1650247302049,ECE 109,A01,091882,Touri; Behrouz,47,0,70,23
1650247308073,ECE 180,A00,083140,Abi Samra; Nicholas Camill,24,0,30,6
1650247308073,ECE 180,B00,083141,Abi Samra; Nicholas Camill,7,0,30,23
1650247314099,MATH 10A,A01,083735,Patchell; Gregory David,11,0,30,19
1650247314099,MATH 10A,A02,083736,Patchell; Gregory David,28,0,30,2
1650247314099,MATH 10A,A03,083737,Patchell; Gregory David,26,0,30,4
1650247320126,MATH 10B,A01,083207,Staff,0,6,30,30
1650247320126,MATH 10B,A02,083208,Staff,0,5,30,30
1650247320126,MATH 10B,B01,083739,Staff,17,0,30,13
1650247320126,MATH 10B,B02,083740,Staff,29,0,30,1
1650247326152,MATH 18,A01,083743,Staff,7,0,30,23
1650247326152,MATH 18,A02,083744,Staff,28,0,30,2
1650247326152,MATH 18,A03,083745,Staff,23,0,30,7
1650247326152,MATH 18,A04,083746,Staff,27,0,30,3
1650247326152,MATH 18,B01,083748,Staff,0,10,30,30
1650247326152,MATH 18,B02,083749,Staff,0,8,30,30
1650247326152,MATH 18,B03,083750,Staff,0,7,30,30
1650247326152,MATH 18,B04,083751,Staff,0,9,30,30
1650247332177,MATH 20A,A01,083754,Staff,26,0,40,14
1650247338208,MATH 20B,A01,083756,Staff,1,6,30,29
1650247338208,MATH 20B,A02,083757,Staff,0,7,30,30
1650247344234,MATH 20C,A01,083760,Staff,0,12,30,30
1650247344234,MATH 20C,A02,083761,Staff,0,13,30,30
1650247344234,MATH 20C,B01,083762,Staff,14,0,30,16
1650247344234,MATH 20C,B02,083763,Staff,28,0,30,2
1650247350258,MATH 20D,A01,083765,Staff,1,2,30,29
1650247350258,MATH 20D,A02,083766,Staff,8,0,30,22
1650247350258,MATH 20D,A03,083767,Staff,28,0,30,2
1650247356288,MATH 20E,A01,083771,Staff,7,0,30,23
1650247356288,MATH 20E,A02,083772,Staff,21,0,30,9
1650247356288,MATH 20E,B01,083773,Staff,0,0,30,30
1650247356288,MATH 20E,B02,083774,Staff,12,0,30,18
1650247362316,MATH 103A,A01,083777,Staff,0,9,30,30
1650247362316,MATH 103A,A02,083778,Staff,0,10,30,30
1650247362316,MATH 103A,B01,083779,Staff,0,10,30,30
1650247362316,MATH 103A,B02,083780,Staff,0,9,30,30
1650247368340,MATH 105,A01,085443,Staff,0,17,30,30
1650247374366,MATH 109,A01,083213,Anzaldo; Leesa B,0,4,30,30
1650247374366,MATH 109,A02,083214,Anzaldo; Leesa B,0,6,30,30
1650247374366,MATH 109,B01,083215,Anzaldo; Leesa B,0,4,30,30
1650247374366,MATH 109,B02,083216,Anzaldo; Leesa B,1,4,30,29
1650247380391,MATH 142A,A01,083219,Chow; Bennett,0,12,30,30
1650247380391,MATH 142A,A02,083220,Chow; Bennett,0,11,30,30
1650247380391,MATH 142A,B01,083221,Chow; Bennett,0,11,30,30
1650247380391,MATH 142A,B02,083222,Chow; Bennett,0,12,30,30
1650247386417,MATH 193A,A01,083224,Staff,0,5,30,30
1650247386417,MATH 193A,A02,083225,Staff,0,4,30,30
1650247386417,MATH 193A,A03,083781,Staff,0,2,30,30
1650247386417,MATH 193A,A04,083782,Staff,0,1,30,30
1650247392443,MATH 197,001,091859,McAuley; Julian John,9998,0,9999,1
1650247398494,COGS 9,A01,083615,Staff,0,14,60,60
1650247404517,COGS 11,A01,083617,Boyle; Mary E. T.,24,0,40,16
1650247410547,COGS 13,A01,083071,Staff,0,30,40,40
1650247416572,COGS 14A,A01,092681,Staff,1,14,100,99
1650247422597,COGS 14B,A01,083073,Cheng; Tzu-Han,0,8,50,50
1650247428620,COGS 17,A01,092677,Staff,32,0,75,43
1650247434648,COGS 100,A01,083619,Staff,1,21,60,59
1650247440672,COGS 101A,A01,083621,Davis; Joshua Daniel,0,21,60,60
1650247446697,COGS 101B,A01,091572,Staff,5,0,60,55
1650247452820,COGS 101C,A01,083625,Delgado; Tania,20,0,30,10
1650247458845,COGS 107A,A01,083627,Boyle; Mary E. T.,1,7,60,59
1650247464871,COGS 118A,A01,083075,Staff,15,0,60,45
1650247470901,CSE 3,A50,083646,Miranda; Gregory Joseph,22,0,38,16
1650247470901,CSE 3,A51,083647,Miranda; Gregory Joseph,37,0,37,0
1650247476924,CSE 8A,A50,083650,Miranda; Gregory Joseph,0,18,40,40
1650247482951,CSE 11,A01,083080,Cao; Yingjun,0,69,40,40
1650247488984,CSE 12,A01,083652,Staff,0,9,100,100
1650247495008,CSE 15L,A01,083654,Staff,0,1,50,50
1650247495008,CSE 15L,A02,083655,Staff,5,0,50,45
1650247501035,CSE 20,A01,083657,Staff,53,0,80,27
1650247507067,CSE 30,A01,083084,Eldon; John,0,71,40,40
1650247513089,CSE 100,A01,083659,Cao; Yingjun,0,64,50,50
1650247519111,CSE 134B,A01,083661,Powell; Thomas Allan,0,27,65,65
1650247525138,CSE 140,A01,083663,Staff,0,0,75,75
1650247531171,CSE 140L,A01,083088,Eldon; John,0,5,75,75
1650247537207,CSE 175,A01,083665,Kumar; Rakesh,8,0,25,17
1650247543233,CSE 190,A00,092507,Dubnov; Shlomo,14,0,20,6
1650247549263,ECE 45,A01,083139,Staff,0,13,40,40
1650247555292,ECE 65,A50,083695,Staff,0,5,30,30
1650247561319,ECE 109,A01,091882,Touri; Behrouz,47,0,70,23
1650247567351,ECE 180,A00,083140,Abi Samra; Nicholas Camill,24,0,30,6
1650247567351,ECE 180,B00,083141,Abi Samra; Nicholas Camill,7,0,30,23
1650247573379,MATH 10A,A01,083735,Patchell; Gregory David,11,0,30,19
1650247573379,MATH 10A,A02,083736,Patchell; Gregory David,28,0,30,2
1650247573379,MATH 10A,A03,083737,Patchell; Gregory David,26,0,30,4
1650247579414,MATH 10B,A01,083207,Staff,0,6,30,30
1650247579414,MATH 10B,A02,083208,Staff,0,5,30,30
1650247579414,MATH 10B,B01,083739,Staff,17,0,30,13
1650247579414,MATH 10B,B02,083740,Staff,29,0,30,1
1650247585440,MATH 18,A01,083743,Staff,7,0,30,23
1650247585440,MATH 18,A02,083744,Staff,28,0,30,2
1650247585440,MATH 18,A03,083745,Staff,23,0,30,7
1650247585440,MATH 18,A04,083746,Staff,27,0,30,3
1650247585440,MATH 18,B01,083748,Staff,0,10,30,30
1650247585440,MATH 18,B02,083749,Staff,0,8,30,30
1650247585440,MATH 18,B03,083750,Staff,0,7,30,30
1650247585440,MATH 18,B04,083751,Staff,0,9,30,30
1650247591464,MATH 20A,A01,083754,Staff,26,0,40,14
1650247597489,MATH 20B,A01,083756,Staff,1,6,30,29
1650247597489,MATH 20B,A02,083757,Staff,0,7,30,30
1650247603517,MATH 20C,A01,083760,Staff,0,12,30,30
1650247603517,MATH 20C,A02,083761,Staff,0,13,30,30
1650247603517,MATH 20C,B01,083762,Staff,14,0,30,16
1650247603517,MATH 20C,B02,083763,Staff,28,0,30,2
1650247609541,MATH 20D,A01,083765,Staff,1,2,30,29
1650247609541,MATH 20D,A02,083766,Staff,8,0,30,22
1650247609541,MATH 20D,A03,083767,Staff,28,0,30,2
1650247615569,MATH 20E,A01,083771,Staff,7,0,30,23
1650247615569,MATH 20E,A02,083772,Staff,21,0,30,9
1650247615569,MATH 20E,B01,083773,Staff,0,0,30,30
1650247615569,MATH 20E,B02,083774,Staff,12,0,30,18
1650247621617,MATH 103A,A01,083777,Staff,0,9,30,30
1650247621617,MATH 103A,A02,083778,Staff,0,10,30,30
1650247621617,MATH 103A,B01,083779,Staff,0,10,30,30
1650247621617,MATH 103A,B02,083780,Staff,0,9,30,30
1650247627641,MATH 105,A01,085443,Staff,0,17,30,30
1650247633670,MATH 109,A01,083213,Anzaldo; Leesa B,0,5,30,30
1650247633670,MATH 109,A02,083214,Anzaldo; Leesa B,0,6,30,30
1650247633670,MATH 109,B01,083215,Anzaldo; Leesa B,0,4,30,30
1650247633670,MATH 109,B02,083216,Anzaldo; Leesa B,1,4,30,29
1650247639696,MATH 142A,A01,083219,Chow; Bennett,0,12,30,30
1650247639696,MATH 142A,A02,083220,Chow; Bennett,0,11,30,30
1650247639696,MATH 142A,B01,083221,Chow; Bennett,0,11,30,30
1650247639696,MATH 142A,B02,083222,Chow; Bennett,0,12,30,30
1650247645723,MATH 193A,A01,083224,Staff,0,5,30,30
1650247645723,MATH 193A,A02,083225,Staff,0,4,30,30
1650247645723,MATH 193A,A03,083781,Staff,0,2,30,30
1650247645723,MATH 193A,A04,083782,Staff,0,1,30,30
1650247651749,MATH 197,001,091859,McAuley; Julian John,9998,0,9999,1
1650247657808,COGS 9,A01,083615,Staff,0,14,60,60
1650247663831,COGS 11,A01,083617,Boyle; Mary E. T.,24,0,40,16
1650247669867,COGS 13,A01,083071,Staff,0,30,40,40
1650247675896,COGS 14A,A01,092681,Staff,1,14,100,99
1650247681919,COGS 14B,A01,083073,Cheng; Tzu-Han,0,8,50,50
1650247687946,COGS 17,A01,092677,Staff,32,0,75,43
1650247693969,COGS 100,A01,083619,Staff,1,21,60,59
1650247699995,COGS 101A,A01,083621,Davis; Joshua Daniel,0,21,60,60
1650247706025,COGS 101B,A01,091572,Staff,5,0,60,55
1650247712050,COGS 101C,A01,083625,Delgado; Tania,20,0,30,10
1650247718077,COGS 107A,A01,083627,Boyle; Mary E. T.,1,7,60,59
1650247724100,COGS 118A,A01,083075,Staff,15,0,60,45
1650247730132,CSE 3,A50,083646,Miranda; Gregory Joseph,22,0,38,16
1650247730132,CSE 3,A51,083647,Miranda; Gregory Joseph,37,0,37,0
1650247736156,CSE 8A,A50,083650,Miranda; Gregory Joseph,0,18,40,40
1650247742181,CSE 11,A01,083080,Cao; Yingjun,0,69,40,40
1650247748207,CSE 12,A01,083652,Staff,0,9,100,100
1650247754230,CSE 15L,A01,083654,Staff,0,1,50,50
1650247754230,CSE 15L,A02,083655,Staff,5,0,50,45
1650247760254,CSE 20,A01,083657,Staff,53,0,80,27
1650247766277,CSE 30,A01,083084,Eldon; John,0,71,40,40
1650247772301,CSE 100,A01,083659,Cao; Yingjun,0,64,50,50
1650247778325,CSE 134B,A01,083661,Powell; Thomas Allan,0,27,65,65
1650247784352,CSE 140,A01,083663,Staff,0,0,75,75
1650247790376,CSE 140L,A01,083088,Eldon; John,0,5,75,75
1650247796399,CSE 175,A01,083665,Kumar; Rakesh,8,0,25,17
1650247802423,CSE 190,A00,092507,Dubnov; Shlomo,14,0,20,6
1650247808450,ECE 45,A01,083139,Staff,0,13,40,40
1650247814477,ECE 65,A50,083695,Staff,0,5,30,30
1650247820503,ECE 109,A01,091882,Touri; Behrouz,47,0,70,23
1650247826526,ECE 180,A00,083140,Abi Samra; Nicholas Camill,24,0,30,6
1650247826526,ECE 180,B00,083141,Abi Samra; Nicholas Camill,7,0,30,23
1650247832552,MATH 10A,A01,083735,Patchell; Gregory David,11,0,30,19
1650247832552,MATH 10A,A02,083736,Patchell; Gregory David,28,0,30,2
1650247832552,MATH 10A,A03,083737,Patchell; Gregory David,26,0,30,4
1650247838579,MATH 10B,A01,083207,Staff,0,6,30,30
1650247838579,MATH 10B,A02,083208,Staff,0,5,30,30
1650247838579,MATH 10B,B01,083739,Staff,17,0,30,13
1650247838579,MATH 10B,B02,083740,Staff,29,0,30,1
1650247844606,MATH 18,A01,083743,Staff,7,0,30,23
1650247844606,MATH 18,A02,083744,Staff,28,0,30,2
1650247844606,MATH 18,A03,083745,Staff,23,0,30,7
1650247844606,MATH 18,A04,083746,Staff,27,0,30,3
1650247844606,MATH 18,B01,083748,Staff,0,10,30,30
1650247844606,MATH 18,B02,083749,Staff,0,8,30,30
1650247844606,MATH 18,B03,083750,Staff,0,7,30,30
1650247844606,MATH 18,B04,083751,Staff,0,9,30,30
1650247850632,MATH 20A,A01,083754,Staff,26,0,40,14
1650247856656,MATH 20B,A01,083756,Staff,1,6,30,29
1650247856656,MATH 20B,A02,083757,Staff,0,7,30,30
1650247862679,MATH 20C,A01,083760,Staff,0,12,30,30
1650247862679,MATH 20C,A02,083761,Staff,0,13,30,30
1650247862679,MATH 20C,B01,083762,Staff,14,0,30,16
1650247862679,MATH 20C,B02,083763,Staff,28,0,30,2
1650247868703,MATH 20D,A01,083765,Staff,1,2,30,29
1650247868703,MATH 20D,A02,083766,Staff,8,0,30,22
1650247868703,MATH 20D,A03,083767,Staff,28,0,30,2
1650247874727,MATH 20E,A01,083771,Staff,7,0,30,23
1650247874727,MATH 20E,A02,083772,Staff,21,0,30,9
1650247874727,MATH 20E,B01,083773,Staff,0,0,30,30
1650247874727,MATH 20E,B02,083774,Staff,12,0,30,18
1650247880757,MATH 103A,A01,083777,Staff,0,9,30,30
1650247880757,MATH 103A,A02,083778,Staff,0,10,30,30
1650247880757,MATH 103A,B01,083779,Staff,0,10,30,30
1650247880757,MATH 103A,B02,083780,Staff,0,9,30,30
1650247886784,MATH 105,A01,085443,Staff,0,17,30,30
1650247892814,MATH 109,A01,083213,Anzaldo; Leesa B,0,5,30,30
1650247892814,MATH 109,A02,083214,Anzaldo; Leesa B,0,6,30,30
1650247892814,MATH 109,B01,083215,Anzaldo; Leesa B,0,4,30,30
1650247892814,MATH 109,B02,083216,Anzaldo; Leesa B,1,4,30,29
1650247898844,MATH 142A,A01,083219,Chow; Bennett,0,12,30,30
1650247898844,MATH 142A,A02,083220,Chow; Bennett,0,11,30,30
1650247898844,MATH 142A,B01,083221,Chow; Bennett,0,11,30,30
1650247898844,MATH 142A,B02,083222,Chow; Bennett,0,12,30,30
1650247904871,MATH 193A,A01,083224,Staff,0,5,30,30
1650247904871,MATH 193A,A02,083225,Staff,0,4,30,30
1650247904871,MATH 193A,A03,083781,Staff,0,2,30,30
1650247904871,MATH 193A,A04,083782,Staff,0,1,30,30
1650247910897,MATH 197,001,091859,McAuley; Julian John,9998,0,9999,1
1650247916953,COGS 9,A01,083615,Staff,0,14,60,60
1650247922977,COGS 11,A01,083617,Boyle; Mary E. T.,24,0,40,16
1650247929007,COGS 13,A01,083071,Staff,0,30,40,40
1650247935050,COGS 14A,A01,092681,Staff,1,14,100,99
1650247941075,COGS 14B,A01,083073,Cheng; Tzu-Han,0,8,50,50
1650247947101,COGS 17,A01,092677,Staff,32,0,75,43
1650247953127,COGS 100,A01,083619,Staff,1,21,60,59
1650247959156,COGS 101A,A01,083621,Davis; Joshua Daniel,0,21,60,60
1650247965183,COGS 101B,A01,091572,Staff,5,0,60,55
1650247971208,COGS 101C,A01,083625,Delgado; Tania,20,0,30,10
1650247977236,COGS 107A,A01,083627,Boyle; Mary E. T.,1,7,60,59
1650247983263,COGS 118A,A01,083075,Staff,15,0,60,45
1650247989293,CSE 3,A50,083646,Miranda; Gregory Joseph,22,0,38,16
1650247989293,CSE 3,A51,083647,Miranda; Gregory Joseph,37,0,37,0
1650247995317,CSE 8A,A50,083650,Miranda; Gregory Joseph,0,18,40,40
1650248001342,CSE 11,A01,083080,Cao; Yingjun,0,69,40,40
1650248007370,CSE 12,A01,083652,Staff,0,9,100,100
1650248013393,CSE 15L,A01,083654,Staff,0,1,50,50
1650248013393,CSE 15L,A02,083655,Staff,5,0,50,45
1650248019416,CSE 20,A01,083657,Staff,53,0,80,27
1650248025443,CSE 30,A01,083084,Eldon; John,0,71,40,40
1650248031468,CSE 100,A01,083659,Cao; Yingjun,0,64,50,50
1650248037491,CSE 134B,A01,083661,Powell; Thomas Allan,0,27,65,65
1650248043514,CSE 140,A01,083663,Staff,0,0,75,75
1650248049627,CSE 140L,A01,083088,Eldon; John,0,5,75,75
1650248055650,CSE 175,A01,083665,Kumar; Rakesh,8,0,25,17
1650248061672,CSE 190,A00,092507,Dubnov; Shlomo,14,0,20,6
1650248067703,ECE 45,A01,083139,Staff,0,13,40,40
1650248073725,ECE 65,A50,083695,Staff,0,5,30,30
1650248079749,ECE 109,A01,091882,Touri; Behrouz,47,0,70,23
1650248085775,ECE 180,A00,083140,Abi Samra; Nicholas Camill,24,0,30,6
1650248085775,ECE 180,B00,083141,Abi Samra; Nicholas Camill,7,0,30,23
1650248091805,MATH 10A,A01,083735,Patchell; Gregory David,11,0,30,19
1650248091805,MATH 10A,A02,083736,Patchell; Gregory David,28,0,30,2
1650248091805,MATH 10A,A03,083737,Patchell; Gregory David,26,0,30,4
1650248097828,MATH 10B,A01,083207,Staff,0,6,30,30
1650248097828,MATH 10B,A02,083208,Staff,0,5,30,30
1650248097828,MATH 10B,B01,083739,Staff,17,0,30,13
1650248097828,MATH 10B,B02,083740,Staff,29,0,30,1
1650248103855,MATH 18,A01,083743,Staff,7,0,30,23
1650248103855,MATH 18,A02,083744,Staff,28,0,30,2
1650248103855,MATH 18,A03,083745,Staff,23,0,30,7
1650248103855,MATH 18,A04,083746,Staff,27,0,30,3
1650248103855,MATH 18,B01,083748,Staff,0,10,30,30
1650248103855,MATH 18,B02,083749,Staff,0,8,30,30
1650248103855,MATH 18,B03,083750,Staff,0,7,30,30
1650248103855,MATH 18,B04,083751,Staff,0,9,30,30
1650248109888,MATH 20A,A01,083754,Staff,26,0,40,14
1650248115911,MATH 20B,A01,083756,Staff,1,6,30,29
1650248115911,MATH 20B,A02,083757,Staff,0,7,30,30
1650248121934,MATH 20C,A01,083760,Staff,0,12,30,30
1650248121934,MATH 20C,A02,083761,Staff,0,13,30,30
1650248121934,MATH 20C,B01,083762,Staff,14,0,30,16
1650248121934,MATH 20C,B02,083763,Staff,28,0,30,2
1650248127961,MATH 20D,A01,083765,Staff,1,2,30,29
1650248127961,MATH 20D,A02,083766,Staff,8,0,30,22
1650248127961,MATH 20D,A03,083767,Staff,28,0,30,2
1650248133990,MATH 20E,A01,083771,Staff,7,0,30,23
1650248133990,MATH 20E,A02,083772,Staff,21,0,30,9
1650248133990,MATH 20E,B01,083773,Staff,0,0,30,30
1650248133990,MATH 20E,B02,083774,Staff,12,0,30,18
1650248140014,MATH 103A,A01,083777,Staff,0,9,30,30
1650248140014,MATH 103A,A02,083778,Staff,0,10,30,30
1650248140014,MATH 103A,B01,083779,Staff,0,10,30,30
1650248140014,MATH 103A,B02,083780,Staff,0,9,30,30
1650248146038,MATH 105,A01,085443,Staff,0,17,30,30
1650248152063,MATH 109,A01,083213,Anzaldo; Leesa B,0,5,30,30
1650248152063,MATH 109,A02,083214,Anzaldo; Leesa B,0,6,30,30
1650248152063,MATH 109,B01,083215,Anzaldo; Leesa B,0,4,30,30
1650248152063,MATH 109,B02,083216,Anzaldo; Leesa B,1,4,30,29
1650248158093,MATH 142A,A01,083219,Chow; Bennett,0,12,30,30
1650248158093,MATH 142A,A02,083220,Chow; Bennett,0,11,30,30
1650248158093,MATH 142A,B01,083221,Chow; Bennett,0,11,30,30
1650248158093,MATH 142A,B02,083222,Chow; Bennett,0,12,30,30
1650248164117,MATH 193A,A01,083224,Staff,0,5,30,30
1650248164117,MATH 193A,A02,083225,Staff,0,4,30,30
1650248164117,MATH 193A,A03,083781,Staff,0,2,30,30
1650248164117,MATH 193A,A04,083782,Staff,0,1,30,30
1650248170140,MATH 197,001,091859,McAuley; Julian John,9998,0,9999,1
1650248176192,COGS 9,A01,083615,Staff,0,14,60,60
1650248182215,COGS 11,A01,083617,Boyle; Mary E. T.,24,0,40,16
1650248188241,COGS 13,A01,083071,Staff,0,30,40,40
1650248194267,COGS 14A,A01,092681,Staff,1,14,100,99
1650248200289,COGS 14B,A01,083073,Cheng; Tzu-Han,0,8,50,50
1650248206315,COGS 17,A01,092677,Staff,32,0,75,43
1650248212353,COGS 100,A01,083619,Staff,1,21,60,59
1650248218379,COGS 101A,A01,083621,Davis; Joshua Daniel,0,21,60,60
1650248224402,COGS 101B,A01,091572,Staff,5,0,60,55
1650248230426,COGS 101C,A01,083625,Delgado; Tania,20,0,30,10
1650248236471,COGS 107A,A01,083627,Boyle; Mary E. T.,1,7,60,59
1650248242493,COGS 118A,A01,083075,Staff,15,0,60,45
1650248248520,CSE 3,A50,083646,Miranda; Gregory Joseph,22,0,38,16
1650248248520,CSE 3,A51,083647,Miranda; Gregory Joseph,37,0,37,0
1650248254547,CSE 8A,A50,083650,Miranda; Gregory Joseph,0,18,40,40
1650248260573,CSE 11,A01,083080,Cao; Yingjun,0,69,40,40
1650248266606,CSE 12,A01,083652,Staff,0,9,100,100
1650248272633,CSE 15L,A01,083654,Staff,0,1,50,50
1650248272633,CSE 15L,A02,083655,Staff,5,0,50,45
1650248278657,CSE 20,A01,083657,Staff,53,0,80,27
1650248284679,CSE 30,A01,083084,Eldon; John,0,71,40,40
1650248290701,CSE 100,A01,083659,Cao; Yingjun,0,64,50,50
1650248296724,CSE 134B,A01,083661,Powell; Thomas Allan,0,27,65,65
1650248302756,CSE 140,A01,083663,Staff,0,0,75,75
1650248308785,CSE 140L,A01,083088,Eldon; John,0,5,75,75
1650248314808,CSE 175,A01,083665,Kumar; Rakesh,8,0,25,17
1650248320832,CSE 190,A00,092507,Dubnov; Shlomo,14,0,20,6
1650248326882,ECE 45,A01,083139,Staff,0,13,40,40
1650248332907,ECE 65,A50,083695,Staff,0,5,30,30
1650248338931,ECE 109,A01,091882,Touri; Behrouz,47,0,70,23
1650248344959,ECE 180,A00,083140,Abi Samra; Nicholas Camill,24,0,30,6
1650248344959,ECE 180,B00,083141,Abi Samra; Nicholas Camill,7,0,30,23
1650248350984,MATH 10A,A01,083735,Patchell; Gregory David,11,0,30,19
1650248350984,MATH 10A,A02,083736,Patchell; Gregory David,28,0,30,2
1650248350984,MATH 10A,A03,083737,Patchell; Gregory David,26,0,30,4
1650248357013,MATH 10B,A01,083207,Staff,0,6,30,30
1650248357013,MATH 10B,A02,083208,Staff,0,5,30,30
1650248357013,MATH 10B,B01,083739,Staff,17,0,30,13
1650248357013,MATH 10B,B02,083740,Staff,29,0,30,1
1650248363038,MATH 18,A01,083743,Staff,7,0,30,23
1650248363038,MATH 18,A02,083744,Staff,28,0,30,2
1650248363038,MATH 18,A03,083745,Staff,23,0,30,7
1650248363038,MATH 18,A04,083746,Staff,27,0,30,3
1650248363038,MATH 18,B01,083748,Staff,0,10,30,30
1650248363038,MATH 18,B02,083749,Staff,0,8,30,30
1650248363038,MATH 18,B03,083750,Staff,0,7,30,30
1650248363038,MATH 18,B04,083751,Staff,0,9,30,30
1650248369060,MATH 20A,A01,083754,Staff,26,0,40,14
1650248375084,MATH 20B,A01,083756,Staff,1,6,30,29
1650248375084,MATH 20B,A02,083757,Staff,0,7,30,30
1650248381109,MATH 20C,A01,083760,Staff,0,12,30,30
1650248381109,MATH 20C,A02,083761,Staff,0,13,30,30
1650248381109,MATH 20C,B01,083762,Staff,14,0,30,16
1650248381109,MATH 20C,B02,083763,Staff,28,0,30,2
1650248387132,MATH 20D,A01,083765,Staff,1,2,30,29
1650248387132,MATH 20D,A02,083766,Staff,8,0,30,22
1650248387132,MATH 20D,A03,083767,Staff,28,0,30,2
1650248393163,MATH 20E,A01,083771,Staff,7,0,30,23
1650248393163,MATH 20E,A02,083772,Staff,21,0,30,9
1650248393163,MATH 20E,B01,083773,Staff,0,0,30,30
1650248393163,MATH 20E,B02,083774,Staff,12,0,30,18
1650248399190,MATH 103A,A01,083777,Staff,0,9,30,30
1650248399190,MATH 103A,A02,083778,Staff,0,10,30,30
1650248399190,MATH 103A,B01,083779,Staff,0,10,30,30
1650248399190,MATH 103A,B02,083780,Staff,0,9,30,30
1650248405215,MATH 105,A01,085443,Staff,0,17,30,30
1650248411244,MATH 109,A01,083213,Anzaldo; Leesa B,0,5,30,30
1650248411244,MATH 109,A02,083214,Anzaldo; Leesa B,0,6,30,30
1650248411244,MATH 109,B01,083215,Anzaldo; Leesa B,0,4,30,30
1650248411244,MATH 109,B02,083216,Anzaldo; Leesa B,1,4,30,29
1650248417272,MATH 142A,A01,083219,Chow; Bennett,0,12,30,30
1650248417272,MATH 142A,A02,083220,Chow; Bennett,0,11,30,30
1650248417272,MATH 142A,B01,083221,Chow; Bennett,0,11,30,30
1650248417272,MATH 142A,B02,083222,Chow; Bennett,0,12,30,30
1650248423295,MATH 193A,A01,083224,Staff,0,5,30,30
1650248423295,MATH 193A,A02,083225,Staff,0,4,30,30
1650248423295,MATH 193A,A03,083781,Staff,0,2,30,30
1650248423295,MATH 193A,A04,083782,Staff,0,1,30,30
1650248429318,MATH 197,001,091859,McAuley; Julian John,9998,0,9999,1
1650248435375,COGS 9,A01,083615,Staff,0,14,60,60
1650248441400,COGS 11,A01,083617,Boyle; Mary E. T.,24,0,40,16
1650248447427,COGS 13,A01,083071,Staff,0,30,40,40
1650248453453,COGS 14A,A01,092681,Staff,1,14,100,99
1650248459480,COGS 14B,A01,083073,Cheng; Tzu-Han,0,8,50,50
1650248465504,COGS 17,A01,092677,Staff,32,0,75,43
1650248471527,COGS 100,A01,083619,Staff,1,21,60,59
1650248477555,COGS 101A,A01,083621,Davis; Joshua Daniel,0,21,60,60
1650248483591,COGS 101B,A01,091572,Staff,5,0,60,55
1650248489616,COGS 101C,A01,083625,Delgado; Tania,20,0,30,10
1650248495644,COGS 107A,A01,083627,Boyle; Mary E. T.,1,7,60,59
1650248501668,COGS 118A,A01,083075,Staff,15,0,60,45
1650248507691,CSE 3,A50,083646,Miranda; Gregory Joseph,22,0,38,16
1650248507691,CSE 3,A51,083647,Miranda; Gregory Joseph,37,0,37,0
1650248513717,CSE 8A,A50,083650,Miranda; Gregory Joseph,0,18,40,40
1650248519740,CSE 11,A01,083080,Cao; Yingjun,0,70,40,40
1650248525767,CSE 12,A01,083652,Staff,0,9,100,100
1650248531790,CSE 15L,A01,083654,Staff,0,1,50,50
1650248531790,CSE 15L,A02,083655,Staff,5,0,50,45
1650248537814,CSE 20,A01,083657,Staff,53,0,80,27
1650248543840,CSE 30,A01,083084,Eldon; John,0,71,40,40
1650248549864,CSE 100,A01,083659,Cao; Yingjun,0,64,50,50
1650248555890,CSE 134B,A01,083661,Powell; Thomas Allan,0,27,65,65
1650248561924,CSE 140,A01,083663,Staff,0,0,75,75
1650248567950,CSE 140L,A01,083088,Eldon; John,0,5,75,75
1650248573982,CSE 175,A01,083665,Kumar; Rakesh,8,0,25,17
1650248580009,CSE 190,A00,092507,Dubnov; Shlomo,14,0,20,6
1650248586032,ECE 45,A01,083139,Staff,0,13,40,40
1650248592055,ECE 65,A50,083695,Staff,0,5,30,30
1650248598078,ECE 109,A01,091882,Touri; Behrouz,47,0,70,23
1650248604109,ECE 180,A00,083140,Abi Samra; Nicholas Camill,24,0,30,6
1650248604109,ECE 180,B00,083141,Abi Samra; Nicholas Camill,7,0,30,23
1650248610139,MATH 10A,A01,083735,Patchell; Gregory David,11,0,30,19
1650248610139,MATH 10A,A02,083736,Patchell; Gregory David,28,0,30,2
1650248610139,MATH 10A,A03,083737,Patchell; Gregory David,26,0,30,4
1650248616162,MATH 10B,A01,083207,Staff,0,6,30,30
1650248616162,MATH 10B,A02,083208,Staff,0,5,30,30
1650248616162,MATH 10B,B01,083739,Staff,17,0,30,13
1650248616162,MATH 10B,B02,083740,Staff,29,0,30,1
1650248622193,MATH 18,A01,083743,Staff,7,0,30,23
1650248622193,MATH 18,A02,083744,Staff,28,0,30,2
1650248622193,MATH 18,A03,083745,Staff,23,0,30,7
1650248622193,MATH 18,A04,083746,Staff,27,0,30,3
1650248622193,MATH 18,B01,083748,Staff,0,10,30,30
1650248622193,MATH 18,B02,083749,Staff,0,8,30,30
1650248622193,MATH 18,B03,083750,Staff,0,7,30,30
1650248622193,MATH 18,B04,083751,Staff,0,9,30,30
1650248628217,MATH 20A,A01,083754,Staff,26,0,40,14
1650248634239,MATH 20B,A01,083756,Staff,1,6,30,29
1650248634239,MATH 20B,A02,083757,Staff,0,7,30,30
1650248640262,MATH 20C,A01,083760,Staff,0,12,30,30
1650248640262,MATH 20C,A02,083761,Staff,0,13,30,30
1650248640262,MATH 20C,B01,083762,Staff,14,0,30,16
1650248640262,MATH 20C,B02,083763,Staff,28,0,30,2
1650248646378,MATH 20D,A01,083765,Staff,1,2,30,29
1650248646378,MATH 20D,A02,083766,Staff,8,0,30,22
1650248646378,MATH 20D,A03,083767,Staff,28,0,30,2
1650248652402,MATH 20E,A01,083771,Staff,7,0,30,23
1650248652402,MATH 20E,A02,083772,Staff,21,0,30,9
1650248652402,MATH 20E,B01,083773,Staff,0,0,30,30
1650248652402,MATH 20E,B02,083774,Staff,12,0,30,18
1650248658427,MATH 103A,A01,083777,Staff,0,9,30,30
1650248658427,MATH 103A,A02,083778,Staff,0,10,30,30
1650248658427,MATH 103A,B01,083779,Staff,0,10,30,30
1650248658427,MATH 103A,B02,083780,Staff,0,9,30,30
1650248664450,MATH 105,A01,085443,Staff,0,17,30,30
1650248670476,MATH 109,A01,083213,Anzaldo; Leesa B,0,5,30,30
1650248670476,MATH 109,A02,083214,Anzaldo; Leesa B,0,6,30,30
1650248670476,MATH 109,B01,083215,Anzaldo; Leesa B,0,4,30,30
1650248670476,MATH 109,B02,083216,Anzaldo; Leesa B,1,4,30,29
1650248676505,MATH 142A,A01,083219,Chow; Bennett,0,12,30,30
1650248676505,MATH 142A,A02,083220,Chow; Bennett,0,11,30,30
1650248676505,MATH 142A,B01,083221,Chow; Bennett,0,11,30,30
1650248676505,MATH 142A,B02,083222,Chow; Bennett,0,12,30,30
1650248682530,MATH 193A,A01,083224,Staff,0,5,30,30
1650248682530,MATH 193A,A02,083225,Staff,0,4,30,30
1650248682530,MATH 193A,A03,083781,Staff,0,2,30,30
1650248682530,MATH 193A,A04,083782,Staff,0,1,30,30
1650248688554,MATH 197,001,091859,McAuley; Julian John,9998,0,9999,1
1650248694609,COGS 9,A01,083615,Staff,0,14,60,60
1650248700634,COGS 11,A01,083617,Boyle; Mary E. T.,24,0,40,16
1650248706657,COGS 13,A01,083071,Staff,0,30,40,40
1650248712680,COGS 14A,A01,092681,Staff,1,14,100,99
1650248718705,COGS 14B,A01,083073,Cheng; Tzu-Han,0,8,50,50
1650248724735,COGS 17,A01,092677,Staff,31,0,75,44
1650248730764,COGS 100,A01,083619,Staff,1,21,60,59
1650248736789,COGS 101A,A01,083621,Davis; Joshua Daniel,0,21,60,60
1650248742813,COGS 101B,A01,091572,Staff,5,0,60,55
1650248748845,COGS 101C,A01,083625,Delgado; Tania,20,0,30,10
1650248754871,COGS 107A,A01,083627,Boyle; Mary E. T.,1,7,60,59
1650248760897,COGS 118A,A01,083075,Staff,15,0,60,45
1650248766926,CSE 3,A50,083646,Miranda; Gregory Joseph,22,0,38,16
1650248766926,CSE 3,A51,083647,Miranda; Gregory Joseph,37,0,37,0
1650248772953,CSE 8A,A50,083650,Miranda; Gregory Joseph,0,18,40,40
1650248778979,CSE 11,A01,083080,Cao; Yingjun,0,70,40,40
1650248785001,CSE 12,A01,083652,Staff,0,9,100,100
1650248791028,CSE 15L,A01,083654,Staff,0,1,50,50
1650248791028,CSE 15L,A02,083655,Staff,5,0,50,45
1650248797054,CSE 20,A01,083657,Staff,53,0,80,27
1650248803100,CSE 30,A01,083084,Eldon; John,0,71,40,40
1650248809123,CSE 100,A01,083659,Cao; Yingjun,0,64,50,50
1650248815147,CSE 134B,A01,083661,Powell; Thomas Allan,0,27,65,65
1650248821170,CSE 140,A01,083663,Staff,0,0,75,75
1650248827193,CSE 140L,A01,083088,Eldon; John,0,5,75,75
1650248833220,CSE 175,A01,083665,Kumar; Rakesh,8,0,25,17
1650248839251,CSE 190,A00,092507,Dubnov; Shlomo,14,0,20,6
1650248845278,ECE 45,A01,083139,Staff,0,13,40,40
1650248851309,ECE 65,A50,083695,Staff,0,5,30,30
1650248857340,ECE 109,A01,091882,Touri; Behrouz,47,0,70,23
1650248863363,ECE 180,A00,083140,Abi Samra; Nicholas Camill,24,0,30,6
1650248863363,ECE 180,B00,083141,Abi Samra; Nicholas Camill,7,0,30,23
1650248869391,MATH 10A,A01,083735,Patchell; Gregory David,11,0,30,19
1650248869391,MATH 10A,A02,083736,Patchell; Gregory David,28,0,30,2
1650248869391,MATH 10A,A03,083737,Patchell; Gregory David,26,0,30,4
1650248875420,MATH 10B,A01,083207,Staff,0,6,30,30
1650248875420,MATH 10B,A02,083208,Staff,0,5,30,30
1650248875420,MATH 10B,B01,083739,Staff,17,0,30,13
1650248875420,MATH 10B,B02,083740,Staff,29,0,30,1
1650248881446,MATH 18,A01,083743,Staff,7,0,30,23
1650248881446,MATH 18,A02,083744,Staff,28,0,30,2
1650248881446,MATH 18,A03,083745,Staff,23,0,30,7
1650248881446,MATH 18,A04,083746,Staff,27,0,30,3
1650248881446,MATH 18,B01,083748,Staff,0,10,30,30
1650248881446,MATH 18,B02,083749,Staff,0,8,30,30
1650248881446,MATH 18,B03,083750,Staff,0,7,30,30
1650248881446,MATH 18,B04,083751,Staff,0,9,30,30
1650248887472,MATH 20A,A01,083754,Staff,26,0,40,14
1650248893499,MATH 20B,A01,083756,Staff,1,6,30,29
1650248893499,MATH 20B,A02,083757,Staff,0,7,30,30
1650248899533,MATH 20C,A01,083760,Staff,0,12,30,30
1650248899533,MATH 20C,A02,083761,Staff,0,13,30,30
1650248899533,MATH 20C,B01,083762,Staff,14,0,30,16
1650248899533,MATH 20C,B02,083763,Staff,28,0,30,2
1650248905559,MATH 20D,A01,083765,Staff,1,2,30,29
1650248905559,MATH 20D,A02,083766,Staff,8,0,30,22
1650248905559,MATH 20D,A03,083767,Staff,28,0,30,2
1650248911584,MATH 20E,A01,083771,Staff,7,0,30,23
1650248911584,MATH 20E,A02,083772,Staff,21,0,30,9
1650248911584,MATH 20E,B01,083773,Staff,0,0,30,30
1650248911584,MATH 20E,B02,083774,Staff,12,0,30,18
1650248917609,MATH 103A,A01,083777,Staff,0,9,30,30
1650248917609,MATH 103A,A02,083778,Staff,0,10,30,30
1650248917609,MATH 103A,B01,083779,Staff,0,10,30,30
1650248917609,MATH 103A,B02,083780,Staff,0,9,30,30
1650248923634,MATH 105,A01,085443,Staff,0,17,30,30
1650248929658,MATH 109,A01,083213,Anzaldo; Leesa B,0,5,30,30
1650248929658,MATH 109,A02,083214,Anzaldo; Leesa B,0,6,30,30
1650248929658,MATH 109,B01,083215,Anzaldo; Leesa B,0,4,30,30
1650248929658,MATH 109,B02,083216,Anzaldo; Leesa B,1,4,30,29
1650248935683,MATH 142A,A01,083219,Chow; Bennett,0,12,30,30
1650248935683,MATH 142A,A02,083220,Chow; Bennett,0,11,30,30
1650248935683,MATH 142A,B01,083221,Chow; Bennett,0,11,30,30
1650248935683,MATH 142A,B02,083222,Chow; Bennett,0,12,30,30
1650248941706,MATH 193A,A01,083224,Staff,0,5,30,30
1650248941706,MATH 193A,A02,083225,Staff,0,4,30,30
1650248941706,MATH 193A,A03,083781,Staff,0,2,30,30
1650248941706,MATH 193A,A04,083782,Staff,0,1,30,30
1650248947731,MATH 197,001,091859,McAuley; Julian John,9998,0,9999,1
1650248953781,COGS 9,A01,083615,Staff,0,14,60,60
1650248959807,COGS 11,A01,083617,Boyle; Mary E. T.,24,0,40,16
1650248965830,COGS 13,A01,083071,Staff,0,30,40,40
1650248971859,COGS 14A,A01,092681,Staff,1,14,100,99
1650248977883,COGS 14B,A01,083073,Cheng; Tzu-Han,0,8,50,50
1650248983906,COGS 17,A01,092677,Staff,31,0,75,44
1650248989930,COGS 100,A01,083619,Staff,1,21,60,59
1650248995961,COGS 101A,A01,083621,Davis; Joshua Daniel,0,21,60,60
1650249001983,COGS 101B,A01,091572,Staff,5,0,60,55
1650249008016,COGS 101C,A01,083625,Delgado; Tania,20,0,30,10
1650249014042,COGS 107A,A01,083627,Boyle; Mary E. T.,1,7,60,59
1650249020065,COGS 118A,A01,083075,Staff,15,0,60,45
1650249026091,CSE 3,A50,083646,Miranda; Gregory Joseph,22,0,38,16
1650249026091,CSE 3,A51,083647,Miranda; Gregory Joseph,37,0,37,0
1650249032155,CSE 8A,A50,083650,Miranda; Gregory Joseph,0,18,40,40
1650249038180,CSE 11,A01,083080,Cao; Yingjun,0,70,40,40
1650249044204,CSE 12,A01,083652,Staff,0,9,100,100
1650249050231,CSE 15L,A01,083654,Staff,0,1,50,50
1650249050231,CSE 15L,A02,083655,Staff,5,0,50,45
1650249056257,CSE 20,A01,083657,Staff,53,0,80,27
1650249062280,CSE 30,A01,083084,Eldon; John,0,71,40,40
1650249068306,CSE 100,A01,083659,Cao; Yingjun,0,64,50,50
1650249074333,CSE 134B,A01,083661,Powell; Thomas Allan,0,27,65,65
1650249080358,CSE 140,A01,083663,Staff,0,0,75,75
1650249086384,CSE 140L,A01,083088,Eldon; John,0,5,75,75
1650249092411,CSE 175,A01,083665,Kumar; Rakesh,8,0,25,17
1650249098434,CSE 190,A00,092507,Dubnov; Shlomo,14,0,20,6
1650249104461,ECE 45,A01,083139,Staff,0,13,40,40
1650249110485,ECE 65,A50,083695,Staff,0,5,30,30
1650249116509,ECE 109,A01,091882,Touri; Behrouz,47,0,70,23
1650249122533,ECE 180,A00,083140,Abi Samra; Nicholas Camill,24,0,30,6
1650249122533,ECE 180,B00,083141,Abi Samra; Nicholas Camill,7,0,30,23
1650249128559,MATH 10A,A01,083735,Patchell; Gregory David,11,0,30,19
1650249128559,MATH 10A,A02,083736,Patchell; Gregory David,28,0,30,2
1650249128559,MATH 10A,A03,083737,Patchell; Gregory David,26,0,30,4
1650249134587,MATH 10B,A01,083207,Staff,0,6,30,30
1650249134587,MATH 10B,A02,083208,Staff,0,5,30,30
1650249134587,MATH 10B,B01,083739,Staff,17,0,30,13
1650249134587,MATH 10B,B02,083740,Staff,29,0,30,1
1650249140615,MATH 18,A01,083743,Staff,6,0,30,24
1650249140615,MATH 18,A02,083744,Staff,28,0,30,2
1650249140615,MATH 18,A03,083745,Staff,23,0,30,7
1650249140615,MATH 18,A04,083746,Staff,27,0,30,3
1650249140615,MATH 18,B01,083748,Staff,0,10,30,30
1650249140615,MATH 18,B02,083749,Staff,0,8,30,30
1650249140615,MATH 18,B03,083750,Staff,0,7,30,30
1650249140615,MATH 18,B04,083751,Staff,0,9,30,30
1650249146638,MATH 20A,A01,083754,Staff,26,0,40,14
1650249152665,MATH 20B,A01,083756,Staff,1,6,30,29
1650249152665,MATH 20B,A02,083757,Staff,0,7,30,30
1650249158690,MATH 20C,A01,083760,Staff,0,12,30,30
1650249158690,MATH 20C,A02,083761,Staff,0,13,30,30
1650249158690,MATH 20C,B01,083762,Staff,14,0,30,16
1650249158690,MATH 20C,B02,083763,Staff,28,0,30,2
1650249164716,MATH 20D,A01,083765,Staff,1,2,30,29
1650249164716,MATH 20D,A02,083766,Staff,8,0,30,22
1650249164716,MATH 20D,A03,083767,Staff,28,0,30,2
1650249170738,MATH 20E,A01,083771,Staff,7,0,30,23
1650249170738,MATH 20E,A02,083772,Staff,21,0,30,9
1650249170738,MATH 20E,B01,083773,Staff,0,0,30,30
1650249170738,MATH 20E,B02,083774,Staff,12,0,30,18
1650249176762,MATH 103A,A01,083777,Staff,0,9,30,30
1650249176762,MATH 103A,A02,083778,Staff,0,10,30,30
1650249176762,MATH 103A,B01,083779,Staff,0,10,30,30
1650249176762,MATH 103A,B02,083780,Staff,0,9,30,30
1650249182788,MATH 105,A01,085443,Staff,0,17,30,30
1650249188812,MATH 109,A01,083213,Anzaldo; Leesa B,0,5,30,30
1650249188812,MATH 109,A02,083214,Anzaldo; Leesa B,0,6,30,30
1650249188812,MATH 109,B01,083215,Anzaldo; Leesa B,0,4,30,30
1650249188812,MATH 109,B02,083216,Anzaldo; Leesa B,1,4,30,29
1650249194839,MATH 142A,A01,083219,Chow; Bennett,0,12,30,30
1650249194839,MATH 142A,A02,083220,Chow; Bennett,0,11,30,30
1650249194839,MATH 142A,B01,083221,Chow; Bennett,0,11,30,30
1650249194839,MATH 142A,B02,083222,Chow; Bennett,0,12,30,30
1650249200866,MATH 193A,A01,083224,Staff,0,5,30,30
1650249200866,MATH 193A,A02,083225,Staff,0,4,30,30
1650249200866,MATH 193A,A03,083781,Staff,0,2,30,30
1650249200866,MATH 193A,A04,083782,Staff,0,1,30,30
1650249206891,MATH 197,001,091859,McAuley; Julian John,9998,0,9999,1
1650249212949,COGS 9,A01,083615,Staff,0,14,60,60
1650249218976,COGS 11,A01,083617,Boyle; Mary E. T.,24,0,40,16
1650249225000,COGS 13,A01,083071,Staff,0,30,40,40
1650249231023,COGS 14A,A01,092681,Staff,1,14,100,99
1650249237127,COGS 14B,A01,083073,Cheng; Tzu-Han,0,8,50,50
1650249243153,COGS 17,A01,092677,Staff,31,0,75,44
1650249249180,COGS 100,A01,083619,Staff,1,21,60,59
1650249255207,COGS 101A,A01,083621,Davis; Joshua Daniel,0,21,60,60
1650249261233,COGS 101B,A01,091572,Staff,5,0,60,55
1650249267256,COGS 101C,A01,083625,Delgado; Tania,20,0,30,10
1650249273279,COGS 107A,A01,083627,Boyle; Mary E. T.,1,7,60,59
1650249279303,COGS 118A,A01,083075,Staff,15,0,60,45
1650249285327,CSE 3,A50,083646,Miranda; Gregory Joseph,22,0,38,16
1650249285327,CSE 3,A51,083647,Miranda; Gregory Joseph,37,0,37,0
1650249291350,CSE 8A,A50,083650,Miranda; Gregory Joseph,0,18,40,40
1650249297374,CSE 11,A01,083080,Cao; Yingjun,0,70,40,40
1650249303399,CSE 12,A01,083652,Staff,0,9,100,100
1650249309422,CSE 15L,A01,083654,Staff,0,1,50,50
1650249309422,CSE 15L,A02,083655,Staff,5,0,50,45
1650249315449,CSE 20,A01,083657,Staff,53,0,80,27
1650249321474,CSE 30,A01,083084,Eldon; John,0,71,40,40
1650249327496,CSE 100,A01,083659,Cao; Yingjun,0,64,50,50
1650249333520,CSE 134B,A01,083661,Powell; Thomas Allan,0,27,65,65
1650249339544,CSE 140,A01,083663,Staff,0,0,75,75
1650249345569,CSE 140L,A01,083088,Eldon; John,0,5,75,75
1650249351599,CSE 175,A01,083665,Kumar; Rakesh,8,0,25,17
1650249357620,CSE 190,A00,092507,Dubnov; Shlomo,14,0,20,6
1650249363643,ECE 45,A01,083139,Staff,0,13,40,40
1650249369676,ECE 65,A50,083695,Staff,0,5,30,30
1650249375703,ECE 109,A01,091882,Touri; Behrouz,47,0,70,23
1650249381726,ECE 180,A00,083140,Abi Samra; Nicholas Camill,24,0,30,6
1650249381726,ECE 180,B00,083141,Abi Samra; Nicholas Camill,7,0,30,23
1650249387749,MATH 10A,A01,083735,Patchell; Gregory David,11,0,30,19
1650249387749,MATH 10A,A02,083736,Patchell; Gregory David,28,0,30,2
1650249387749,MATH 10A,A03,083737,Patchell; Gregory David,26,0,30,4
1650249393772,MATH 10B,A01,083207,Staff,0,6,30,30
1650249393772,MATH 10B,A02,083208,Staff,0,5,30,30
1650249393772,MATH 10B,B01,083739,Staff,17,0,30,13
1650249393772,MATH 10B,B02,083740,Staff,29,0,30,1
1650249399807,MATH 18,A01,083743,Staff,6,0,30,24
1650249399807,MATH 18,A02,083744,Staff,28,0,30,2
1650249399807,MATH 18,A03,083745,Staff,23,0,30,7
1650249399807,MATH 18,A04,083746,Staff,27,0,30,3
1650249399807,MATH 18,B01,083748,Staff,0,10,30,30
1650249399807,MATH 18,B02,083749,Staff,0,8,30,30
1650249399807,MATH 18,B03,083750,Staff,0,7,30,30
1650249399807,MATH 18,B04,083751,Staff,0,9,30,30
1650249405845,MATH 20A,A01,083754,Staff,26,0,40,14
1650249411873,MATH 20B,A01,083756,Staff,1,6,30,29
1650249411873,MATH 20B,A02,083757,Staff,0,7,30,30
1650249417900,MATH 20C,A01,083760,Staff,0,12,30,30
1650249417900,MATH 20C,A02,083761,Staff,0,13,30,30
1650249417900,MATH 20C,B01,083762,Staff,14,0,30,16
1650249417900,MATH 20C,B02,083763,Staff,28,0,30,2
1650249423926,MATH 20D,A01,083765,Staff,1,2,30,29
1650249423926,MATH 20D,A02,083766,Staff,8,0,30,22
1650249423926,MATH 20D,A03,083767,Staff,28,0,30,2
1650249429949,MATH 20E,A01,083771,Staff,7,0,30,23
1650249429949,MATH 20E,A02,083772,Staff,21,0,30,9
1650249429949,MATH 20E,B01,083773,Staff,0,0,30,30
1650249429949,MATH 20E,B02,083774,Staff,12,0,30,18
1650249435973,MATH 103A,A01,083777,Staff,0,9,30,30
1650249435973,MATH 103A,A02,083778,Staff,0,10,30,30
1650249435973,MATH 103A,B01,083779,Staff,0,10,30,30
1650249435973,MATH 103A,B02,083780,Staff,0,10,30,30
1650249441997,MATH 105,A01,085443,Staff,0,17,30,30
1650249448023,MATH 109,A01,083213,Anzaldo; Leesa B,0,5,30,30
1650249448023,MATH 109,A02,083214,Anzaldo; Leesa B,0,6,30,30
1650249448023,MATH 109,B01,083215,Anzaldo; Leesa B,0,4,30,30
1650249448023,MATH 109,B02,083216,Anzaldo; Leesa B,1,4,30,29
1650249454047,MATH 142A,A01,083219,Chow; Bennett,0,12,30,30
1650249454047,MATH 142A,A02,083220,Chow; Bennett,0,11,30,30
1650249454047,MATH 142A,B01,083221,Chow; Bennett,0,11,30,30
1650249454047,MATH 142A,B02,083222,Chow; Bennett,0,12,30,30
1650249460073,MATH 193A,A01,083224,Staff,0,5,30,30
1650249460073,MATH 193A,A02,083225,Staff,0,4,30,30
1650249460073,MATH 193A,A03,083781,Staff,0,2,30,30
1650249460073,MATH 193A,A04,083782,Staff,0,1,30,30
1650249466100,MATH 197,001,091859,McAuley; Julian John,9998,0,9999,1
1650249472153,COGS 9,A01,083615,Staff,0,14,60,60
1650249478176,COGS 11,A01,083617,Boyle; Mary E. T.,24,0,40,16
1650249484198,COGS 13,A01,083071,Staff,0,30,40,40
1650249490221,COGS 14A,A01,092681,Staff,1,14,100,99
1650249496247,COGS 14B,A01,083073,Cheng; Tzu-Han,0,8,50,50
1650249502294,COGS 17,A01,092677,Staff,31,0,75,44
1650249508319,COGS 100,A01,083619,Staff,1,21,60,59
1650249514342,COGS 101A,A01,083621,Davis; Joshua Daniel,0,21,60,60
1650249520376,COGS 101B,A01,091572,Staff,5,0,60,55
1650249526405,COGS 101C,A01,083625,Delgado; Tania,20,0,30,10
1650249532427,COGS 107A,A01,083627,Boyle; Mary E. T.,1,7,60,59
1650249538451,COGS 118A,A01,083075,Staff,15,0,60,45
1650249544476,CSE 3,A50,083646,Miranda; Gregory Joseph,22,0,38,16
1650249544476,CSE 3,A51,083647,Miranda; Gregory Joseph,37,0,37,0
1650249550502,CSE 8A,A50,083650,Miranda; Gregory Joseph,0,18,40,40
1650249556527,CSE 11,A01,083080,Cao; Yingjun,0,70,40,40
1650249562552,CSE 12,A01,083652,Staff,0,9,100,100
1650249568578,CSE 15L,A01,083654,Staff,0,1,50,50
1650249568578,CSE 15L,A02,083655,Staff,5,0,50,45
1650249574613,CSE 20,A01,083657,Staff,53,0,80,27
1650249580640,CSE 30,A01,083084,Eldon; John,0,71,40,40
1650249586663,CSE 100,A01,083659,Cao; Yingjun,0,64,50,50
1650249592694,CSE 134B,A01,083661,Powell; Thomas Allan,0,27,65,65
1650249598726,CSE 140,A01,083663,Staff,0,0,75,75
1650249604752,CSE 140L,A01,083088,Eldon; John,0,5,75,75
1650249610785,CSE 175,A01,083665,Kumar; Rakesh,8,0,25,17
1650249616809,CSE 190,A00,092507,Dubnov; Shlomo,14,0,20,6
1650249622832,ECE 45,A01,083139,Staff,0,13,40,40
1650249628855,ECE 65,A50,083695,Staff,0,5,30,30
1650249634880,ECE 109,A01,091882,Touri; Behrouz,47,0,70,23
1650249640903,ECE 180,A00,083140,Abi Samra; Nicholas Camill,24,0,30,6
1650249640903,ECE 180,B00,083141,Abi Samra; Nicholas Camill,7,0,30,23
1650249646928,MATH 10A,A01,083735,Patchell; Gregory David,11,0,30,19
1650249646928,MATH 10A,A02,083736,Patchell; Gregory David,28,0,30,2
1650249646928,MATH 10A,A03,083737,Patchell; Gregory David,26,0,30,4
1650249652952,MATH 10B,A01,083207,Staff,0,6,30,30
1650249652952,MATH 10B,A02,083208,Staff,0,5,30,30
1650249652952,MATH 10B,B01,083739,Staff,17,0,30,13
1650249652952,MATH 10B,B02,083740,Staff,29,0,30,1
1650249658983,MATH 18,A01,083743,Staff,7,0,30,23
1650249658983,MATH 18,A02,083744,Staff,28,0,30,2
1650249658983,MATH 18,A03,083745,Staff,23,0,30,7
1650249658983,MATH 18,A04,083746,Staff,27,0,30,3
1650249658983,MATH 18,B01,083748,Staff,0,10,30,30
1650249658983,MATH 18,B02,083749,Staff,0,8,30,30
1650249658983,MATH 18,B03,083750,Staff,0,7,30,30
1650249658983,MATH 18,B04,083751,Staff,0,9,30,30
1650249665008,MATH 20A,A01,083754,Staff,26,0,40,14
1650249671035,MATH 20B,A01,083756,Staff,1,6,30,29
1650249671035,MATH 20B,A02,083757,Staff,0,7,30,30
1650249677063,MATH 20C,A01,083760,Staff,0,12,30,30
1650249677063,MATH 20C,A02,083761,Staff,0,13,30,30
1650249677063,MATH 20C,B01,083762,Staff,14,0,30,16
1650249677063,MATH 20C,B02,083763,Staff,28,0,30,2
1650249683090,MATH 20D,A01,083765,Staff,1,2,30,29
1650249683090,MATH 20D,A02,083766,Staff,8,0,30,22
1650249683090,MATH 20D,A03,083767,Staff,28,0,30,2
1650249689117,MATH 20E,A01,083771,Staff,7,0,30,23
1650249689117,MATH 20E,A02,083772,Staff,21,0,30,9
1650249689117,MATH 20E,B01,083773,Staff,0,0,30,30
1650249689117,MATH 20E,B02,083774,Staff,12,0,30,18
1650249695141,MATH 103A,A01,083777,Staff,0,9,30,30
1650249695141,MATH 103A,A02,083778,Staff,0,10,30,30
1650249695141,MATH 103A,B01,083779,Staff,0,10,30,30
1650249695141,MATH 103A,B02,083780,Staff,0,10,30,30
1650249701172,MATH 105,A01,085443,Staff,0,17,30,30
1650249707196,MATH 109,A01,083213,Anzaldo; Leesa B,0,5,30,30
1650249707196,MATH 109,A02,083214,Anzaldo; Leesa B,0,6,30,30
1650249707196,MATH 109,B01,083215,Anzaldo; Leesa B,0,4,30,30
1650249707196,MATH 109,B02,083216,Anzaldo; Leesa B,1,4,30,29
1650249713219,MATH 142A,A01,083219,Chow; Bennett,0,12,30,30
1650249713219,MATH 142A,A02,083220,Chow; Bennett,0,11,30,30
1650249713219,MATH 142A,B01,083221,Chow; Bennett,0,11,30,30
1650249713219,MATH 142A,B02,083222,Chow; Bennett,0,12,30,30
1650249719243,MATH 193A,A01,083224,Staff,0,5,30,30
1650249719243,MATH 193A,A02,083225,Staff,0,4,30,30
1650249719243,MATH 193A,A03,083781,Staff,0,2,30,30
1650249719243,MATH 193A,A04,083782,Staff,0,1,30,30
1650249725273,MATH 197,001,091859,McAuley; Julian John,9998,0,9999,1
1650249731329,COGS 9,A01,083615,Staff,0,14,60,60
1650249737352,COGS 11,A01,083617,Boyle; Mary E. T.,24,0,40,16
1650249743380,COGS 13,A01,083071,Staff,0,30,40,40
1650249749407,COGS 14A,A01,092681,Staff,1,14,100,99
1650249755433,COGS 14B,A01,083073,Cheng; Tzu-Han,0,8,50,50
1650249761457,COGS 17,A01,092677,Staff,31,0,75,44
1650249767489,COGS 100,A01,083619,Staff,1,21,60,59
1650249773512,COGS 101A,A01,083621,Davis; Joshua Daniel,0,21,60,60
1650249779536,COGS 101B,A01,091572,Staff,5,0,60,55
1650249785559,COGS 101C,A01,083625,Delgado; Tania,20,0,30,10
1650249791587,COGS 107A,A01,083627,Boyle; Mary E. T.,1,7,60,59
1650249797610,COGS 118A,A01,083075,Staff,15,0,60,45
1650249803637,CSE 3,A50,083646,Miranda; Gregory Joseph,22,0,38,16
1650249803637,CSE 3,A51,083647,Miranda; Gregory Joseph,37,0,37,0
1650249809665,CSE 8A,A50,083650,Miranda; Gregory Joseph,0,18,40,40
1650249815689,CSE 11,A01,083080,Cao; Yingjun,0,70,40,40
1650249821715,CSE 12,A01,083652,Staff,0,9,100,100
1650249827741,CSE 15L,A01,083654,Staff,0,1,50,50
1650249827741,CSE 15L,A02,083655,Staff,5,0,50,45
1650249833853,CSE 20,A01,083657,Staff,53,0,80,27
1650249839876,CSE 30,A01,083084,Eldon; John,0,71,40,40
1650249845900,CSE 100,A01,083659,Cao; Yingjun,0,64,50,50
1650249851932,CSE 134B,A01,083661,Powell; Thomas Allan,0,27,65,65
1650249857958,CSE 140,A01,083663,Staff,0,0,75,75
1650249863985,CSE 140L,A01,083088,Eldon; John,0,5,75,75
1650249870027,CSE 175,A01,083665,Kumar; Rakesh,8,0,25,17
1650249876052,CSE 190,A00,092507,Dubnov; Shlomo,14,0,20,6
1650249882076,ECE 45,A01,083139,Staff,0,13,40,40
1650249888111,ECE 65,A50,083695,Staff,0,5,30,30
1650249894145,ECE 109,A01,091882,Touri; Behrouz,47,0,70,23
1650249900167,ECE 180,A00,083140,Abi Samra; Nicholas Camill,24,0,30,6
1650249900167,ECE 180,B00,083141,Abi Samra; Nicholas Camill,7,0,30,23
1650249906196,MATH 10A,A01,083735,Patchell; Gregory David,11,0,30,19
1650249906196,MATH 10A,A02,083736,Patchell; Gregory David,28,0,30,2
1650249906196,MATH 10A,A03,083737,Patchell; Gregory David,26,0,30,4
1650249912218,MATH 10B,A01,083207,Staff,0,6,30,30
1650249912218,MATH 10B,A02,083208,Staff,0,5,30,30
1650249912218,MATH 10B,B01,083739,Staff,17,0,30,13
1650249912218,MATH 10B,B02,083740,Staff,29,0,30,1
1650249918248,MATH 18,A01,083743,Staff,7,0,30,23
1650249918248,MATH 18,A02,083744,Staff,28,0,30,2
1650249918248,MATH 18,A03,083745,Staff,23,0,30,7
1650249918248,MATH 18,A04,083746,Staff,27,0,30,3
1650249918248,MATH 18,B01,083748,Staff,0,10,30,30
1650249918248,MATH 18,B02,083749,Staff,0,8,30,30
1650249918248,MATH 18,B03,083750,Staff,0,7,30,30
1650249918248,MATH 18,B04,083751,Staff,0,9,30,30
1650249924283,MATH 20A,A01,083754,Staff,26,0,40,14
1650249930305,MATH 20B,A01,083756,Staff,1,6,30,29
1650249930305,MATH 20B,A02,083757,Staff,0,7,30,30
1650249936329,MATH 20C,A01,083760,Staff,0,12,30,30
1650249936329,MATH 20C,A02,083761,Staff,0,13,30,30
1650249936329,MATH 20C,B01,083762,Staff,14,0,30,16
1650249936329,MATH 20C,B02,083763,Staff,28,0,30,2
1650249942357,MATH 20D,A01,083765,Staff,1,2,30,29
1650249942357,MATH 20D,A02,083766,Staff,8,0,30,22
1650249942357,MATH 20D,A03,083767,Staff,28,0,30,2
1650249948384,MATH 20E,A01,083771,Staff,7,0,30,23
1650249948384,MATH 20E,A02,083772,Staff,21,0,30,9
1650249948384,MATH 20E,B01,083773,Staff,0,0,30,30
1650249948384,MATH 20E,B02,083774,Staff,12,0,30,18
1650249954417,MATH 103A,A01,083777,Staff,0,9,30,30
1650249954417,MATH 103A,A02,083778,Staff,0,10,30,30
1650249954417,MATH 103A,B01,083779,Staff,0,10,30,30
1650249954417,MATH 103A,B02,083780,Staff,0,10,30,30
1650249960441,MATH 105,A01,085443,Staff,0,17,30,30
1650249966470,MATH 109,A01,083213,Anzaldo; Leesa B,0,5,30,30
1650249966470,MATH 109,A02,083214,Anzaldo; Leesa B,0,6,30,30
1650249966470,MATH 109,B01,083215,Anzaldo; Leesa B,0,4,30,30
1650249966470,MATH 109,B02,083216,Anzaldo; Leesa B,1,4,30,29
1650249972494,MATH 142A,A01,083219,Chow; Bennett,0,12,30,30
1650249972494,MATH 142A,A02,083220,Chow; Bennett,0,11,30,30
1650249972494,MATH 142A,B01,083221,Chow; Bennett,0,11,30,30
1650249972494,MATH 142A,B02,083222,Chow; Bennett,0,12,30,30
1650249978518,MATH 193A,A01,083224,Staff,0,5,30,30
1650249978518,MATH 193A,A02,083225,Staff,0,4,30,30
1650249978518,MATH 193A,A03,083781,Staff,0,2,30,30
1650249978518,MATH 193A,A04,083782,Staff,0,1,30,30
1650249984540,MATH 197,001,091859,McAuley; Julian John,9998,0,9999,1
1650249990600,COGS 9,A01,083615,Staff,0,14,60,60
1650249996627,COGS 11,A01,083617,Boyle; Mary E. T.,24,0,40,16
1650250002649,COGS 13,A01,083071,Staff,0,30,40,40
1650250008676,COGS 14A,A01,092681,Staff,1,14,100,99
1650250014703,COGS 14B,A01,083073,Cheng; Tzu-Han,0,8,50,50
1650250020729,COGS 17,A01,092677,Staff,31,0,75,44
1650250026755,COGS 100,A01,083619,Staff,1,21,60,59
1650250032776,COGS 101A,A01,083621,Davis; Joshua Daniel,0,21,60,60
1650250038802,COGS 101B,A01,091572,Staff,5,0,60,55
1650250044825,COGS 101C,A01,083625,Delgado; Tania,20,0,30,10
1650250050853,COGS 107A,A01,083627,Boyle; Mary E. T.,1,7,60,59
1650250056884,COGS 118A,A01,083075,Staff,15,0,60,45
1650250062909,CSE 3,A50,083646,Miranda; Gregory Joseph,22,0,38,16
1650250062909,CSE 3,A51,083647,Miranda; Gregory Joseph,37,0,37,0
1650250068933,CSE 8A,A50,083650,Miranda; Gregory Joseph,0,18,40,40
1650250074959,CSE 11,A01,083080,Cao; Yingjun,0,70,40,40
1650250080983,CSE 12,A01,083652,Staff,0,9,100,100
1650250087009,CSE 15L,A01,083654,Staff,0,1,50,50
1650250087009,CSE 15L,A02,083655,Staff,5,0,50,45
1650250093032,CSE 20,A01,083657,Staff,53,0,80,27
1650250099060,CSE 30,A01,083084,Eldon; John,0,71,40,40
1650250105083,CSE 100,A01,083659,Cao; Yingjun,0,64,50,50
1650250111117,CSE 134B,A01,083661,Powell; Thomas Allan,0,27,65,65
1650250117141,CSE 140,A01,083663,Staff,0,0,75,75
1650250123164,CSE 140L,A01,083088,Eldon; John,0,5,75,75
1650250129188,CSE 175,A01,083665,Kumar; Rakesh,8,0,25,17
1650250135212,CSE 190,A00,092507,Dubnov; Shlomo,14,0,20,6
1650250141238,ECE 45,A01,083139,Staff,0,13,40,40
1650250147271,ECE 65,A50,083695,Staff,0,5,30,30
1650250153299,ECE 109,A01,091882,Touri; Behrouz,47,0,70,23
1650250159323,ECE 180,A00,083140,Abi Samra; Nicholas Camill,24,0,30,6
1650250159323,ECE 180,B00,083141,Abi Samra; Nicholas Camill,7,0,30,23
1650250165350,MATH 10A,A01,083735,Patchell; Gregory David,11,0,30,19
1650250165350,MATH 10A,A02,083736,Patchell; Gregory David,28,0,30,2
1650250165350,MATH 10A,A03,083737,Patchell; Gregory David,26,0,30,4
1650250171373,MATH 10B,A01,083207,Staff,0,6,30,30
1650250171373,MATH 10B,A02,083208,Staff,0,5,30,30
1650250171373,MATH 10B,B01,083739,Staff,17,0,30,13
1650250171373,MATH 10B,B02,083740,Staff,29,0,30,1
1650250177404,MATH 18,A01,083743,Staff,7,0,30,23
1650250177404,MATH 18,A02,083744,Staff,28,0,30,2
1650250177404,MATH 18,A03,083745,Staff,23,0,30,7
1650250177404,MATH 18,A04,083746,Staff,27,0,30,3
1650250177404,MATH 18,B01,083748,Staff,0,10,30,30
1650250177404,MATH 18,B02,083749,Staff,0,8,30,30
1650250177404,MATH 18,B03,083750,Staff,0,7,30,30
1650250177404,MATH 18,B04,083751,Staff,0,9,30,30
1650250183427,MATH 20A,A01,083754,Staff,26,0,40,14
1650250189451,MATH 20B,A01,083756,Staff,1,6,30,29
1650250189451,MATH 20B,A02,083757,Staff,0,7,30,30
1650250195476,MATH 20C,A01,083760,Staff,0,13,30,30
1650250195476,MATH 20C,A02,083761,Staff,0,13,30,30
1650250195476,MATH 20C,B01,083762,Staff,14,0,30,16
1650250195476,MATH 20C,B02,083763,Staff,28,0,30,2
1650250201504,MATH 20D,A01,083765,Staff,1,2,30,29
1650250201504,MATH 20D,A02,083766,Staff,8,0,30,22
1650250201504,MATH 20D,A03,083767,Staff,28,0,30,2
1650250207531,MATH 20E,A01,083771,Staff,7,0,30,23
1650250207531,MATH 20E,A02,083772,Staff,21,0,30,9
1650250207531,MATH 20E,B01,083773,Staff,0,0,30,30
1650250207531,MATH 20E,B02,083774,Staff,12,0,30,18
1650250213556,MATH 103A,A01,083777,Staff,0,9,30,30
1650250213556,MATH 103A,A02,083778,Staff,0,10,30,30
1650250213556,MATH 103A,B01,083779,Staff,0,10,30,30
1650250213556,MATH 103A,B02,083780,Staff,0,10,30,30
1650250219579,MATH 105,A01,085443,Staff,0,17,30,30
1650250225603,MATH 109,A01,083213,Anzaldo; Leesa B,0,5,30,30
1650250225603,MATH 109,A02,083214,Anzaldo; Leesa B,0,6,30,30
1650250225603,MATH 109,B01,083215,Anzaldo; Leesa B,0,4,30,30
1650250225603,MATH 109,B02,083216,Anzaldo; Leesa B,1,4,30,29
1650250231628,MATH 142A,A01,083219,Chow; Bennett,0,12,30,30
1650250231628,MATH 142A,A02,083220,Chow; Bennett,0,11,30,30
1650250231628,MATH 142A,B01,083221,Chow; Bennett,0,11,30,30
1650250231628,MATH 142A,B02,083222,Chow; Bennett,0,12,30,30
1650250237662,MATH 193A,A01,083224,Staff,0,5,30,30
1650250237662,MATH 193A,A02,083225,Staff,0,4,30,30
1650250237662,MATH 193A,A03,083781,Staff,0,2,30,30
1650250237662,MATH 193A,A04,083782,Staff,0,1,30,30
1650250243688,MATH 197,001,091859,McAuley; Julian John,9998,0,9999,1
1650250249804,COGS 9,A01,083615,Staff,0,14,60,60
1650250255829,COGS 11,A01,083617,Boyle; Mary E. T.,24,0,40,16
1650250261855,COGS 13,A01,083071,Staff,0,30,40,40
1650250267881,COGS 14A,A01,092681,Staff,1,14,100,99
1650250273910,COGS 14B,A01,083073,Cheng; Tzu-Han,0,8,50,50
1650250279935,COGS 17,A01,092677,Staff,31,0,75,44
1650250285957,COGS 100,A01,083619,Staff,1,21,60,59
1650250291984,COGS 101A,A01,083621,Davis; Joshua Daniel,0,21,60,60
1650250298010,COGS 101B,A01,091572,Staff,5,0,60,55
1650250304035,COGS 101C,A01,083625,Delgado; Tania,20,0,30,10
1650250310059,COGS 107A,A01,083627,Boyle; Mary E. T.,1,7,60,59
1650250316094,COGS 118A,A01,083075,Staff,15,0,60,45
1650250322121,CSE 3,A50,083646,Miranda; Gregory Joseph,22,0,38,16
1650250322121,CSE 3,A51,083647,Miranda; Gregory Joseph,37,0,37,0
1650250328151,CSE 8A,A50,083650,Miranda; Gregory Joseph,0,18,40,40
1650250334176,CSE 11,A01,083080,Cao; Yingjun,0,70,40,40
1650250340201,CSE 12,A01,083652,Staff,0,9,100,100
1650250346232,CSE 15L,A01,083654,Staff,0,1,50,50
1650250346232,CSE 15L,A02,083655,Staff,5,0,50,45
1650250352255,CSE 20,A01,083657,Staff,53,0,80,27
1650250358279,CSE 30,A01,083084,Eldon; John,0,71,40,40
1650250364305,CSE 100,A01,083659,Cao; Yingjun,0,64,50,50
1650250370328,CSE 134B,A01,083661,Powell; Thomas Allan,0,27,65,65
1650250376354,CSE 140,A01,083663,Staff,0,0,75,75
1650250382379,CSE 140L,A01,083088,Eldon; John,0,5,75,75
1650250388406,CSE 175,A01,083665,Kumar; Rakesh,8,0,25,17
1650250394429,CSE 190,A00,092507,Dubnov; Shlomo,14,0,20,6
1650250400451,ECE 45,A01,083139,Staff,0,13,40,40
1650250406474,ECE 65,A50,083695,Staff,0,5,30,30
1650250412499,ECE 109,A01,091882,Touri; Behrouz,47,0,70,23
1650250418523,ECE 180,A00,083140,Abi Samra; Nicholas Camill,24,0,30,6
1650250418523,ECE 180,B00,083141,Abi Samra; Nicholas Camill,7,0,30,23
1650250424548,MATH 10A,A01,083735,Patchell; Gregory David,11,0,30,19
1650250424548,MATH 10A,A02,083736,Patchell; Gregory David,28,0,30,2
1650250424548,MATH 10A,A03,083737,Patchell; Gregory David,26,0,30,4
1650250430666,MATH 10B,A01,083207,Staff,0,6,30,30
1650250430666,MATH 10B,A02,083208,Staff,0,5,30,30
1650250430666,MATH 10B,B01,083739,Staff,17,0,30,13
1650250430666,MATH 10B,B02,083740,Staff,29,0,30,1
1650250436690,MATH 18,A01,083743,Staff,7,0,30,23
1650250436690,MATH 18,A02,083744,Staff,28,0,30,2
1650250436690,MATH 18,A03,083745,Staff,23,0,30,7
1650250436690,MATH 18,A04,083746,Staff,27,0,30,3
1650250436690,MATH 18,B01,083748,Staff,0,10,30,30
1650250436690,MATH 18,B02,083749,Staff,0,8,30,30
1650250436690,MATH 18,B03,083750,Staff,0,7,30,30
1650250436690,MATH 18,B04,083751,Staff,0,9,30,30
1650250442722,MATH 20A,A01,083754,Staff,26,0,40,14
1650250448746,MATH 20B,A01,083756,Staff,1,6,30,29
1650250448746,MATH 20B,A02,083757,Staff,0,7,30,30
1650250454776,MATH 20C,A01,083760,Staff,0,12,30,30
1650250454776,MATH 20C,A02,083761,Staff,0,13,30,30
1650250454776,MATH 20C,B01,083762,Staff,14,0,30,16
1650250454776,MATH 20C,B02,083763,Staff,28,0,30,2
1650250460804,MATH 20D,A01,083765,Staff,1,2,30,29
1650250460804,MATH 20D,A02,083766,Staff,8,0,30,22
1650250460804,MATH 20D,A03,083767,Staff,28,0,30,2
1650250466832,MATH 20E,A01,083771,Staff,7,0,30,23
1650250466832,MATH 20E,A02,083772,Staff,21,0,30,9
1650250466832,MATH 20E,B01,083773,Staff,0,0,30,30
1650250466832,MATH 20E,B02,083774,Staff,12,0,30,18
1650250472854,MATH 103A,A01,083777,Staff,0,9,30,30
1650250472854,MATH 103A,A02,083778,Staff,0,10,30,30
1650250472854,MATH 103A,B01,083779,Staff,0,10,30,30
1650250472854,MATH 103A,B02,083780,Staff,0,10,30,30
1650250478878,MATH 105,A01,085443,Staff,0,17,30,30
1650250484906,MATH 109,A01,083213,Anzaldo; Leesa B,0,5,30,30
1650250484906,MATH 109,A02,083214,Anzaldo; Leesa B,0,6,30,30
1650250484906,MATH 109,B01,083215,Anzaldo; Leesa B,0,4,30,30
1650250484906,MATH 109,B02,083216,Anzaldo; Leesa B,1,4,30,29
1650250490934,MATH 142A,A01,083219,Chow; Bennett,0,12,30,30
1650250490934,MATH 142A,A02,083220,Chow; Bennett,0,11,30,30
1650250490934,MATH 142A,B01,083221,Chow; Bennett,0,11,30,30
1650250490934,MATH 142A,B02,083222,Chow; Bennett,0,12,30,30
1650250496957,MATH 193A,A01,083224,Staff,0,5,30,30
1650250496957,MATH 193A,A02,083225,Staff,0,4,30,30
1650250496957,MATH 193A,A03,083781,Staff,0,2,30,30
1650250496957,MATH 193A,A04,083782,Staff,0,1,30,30
1650250502984,MATH 197,001,091859,McAuley; Julian John,9998,0,9999,1
1650250509036,COGS 9,A01,083615,Staff,0,14,60,60
1650250515060,COGS 11,A01,083617,Boyle; Mary E. T.,24,0,40,16
1650250521084,COGS 13,A01,083071,Staff,0,30,40,40
1650250527108,COGS 14A,A01,092681,Staff,1,14,100,99
1650250533134,COGS 14B,A01,083073,Cheng; Tzu-Han,0,8,50,50
1650250539158,COGS 17,A01,092677,Staff,31,0,75,44
1650250545182,COGS 100,A01,083619,Staff,1,21,60,59
1650250551219,COGS 101A,A01,083621,Davis; Joshua Daniel,0,21,60,60
1650250557247,COGS 101B,A01,091572,Staff,5,0,60,55
1650250563274,COGS 101C,A01,083625,Delgado; Tania,20,0,30,10
1650250569305,COGS 107A,A01,083627,Boyle; Mary E. T.,1,7,60,59
1650250575328,COGS 118A,A01,083075,Staff,15,0,60,45
1650250581353,CSE 3,A50,083646,Miranda; Gregory Joseph,22,0,38,16
1650250581353,CSE 3,A51,083647,Miranda; Gregory Joseph,37,0,37,0
1650250587378,CSE 8A,A50,083650,Miranda; Gregory Joseph,0,18,40,40
1650250593401,CSE 11,A01,083080,Cao; Yingjun,0,71,40,40
1650250599424,CSE 12,A01,083652,Staff,0,9,100,100
1650250605449,CSE 15L,A01,083654,Staff,0,1,50,50
1650250605449,CSE 15L,A02,083655,Staff,5,0,50,45
1650250611481,CSE 20,A01,083657,Staff,53,0,80,27
1650250617504,CSE 30,A01,083084,Eldon; John,0,71,40,40
1650250623528,CSE 100,A01,083659,Cao; Yingjun,0,64,50,50
1650250629552,CSE 134B,A01,083661,Powell; Thomas Allan,0,27,65,65
1650250635576,CSE 140,A01,083663,Staff,0,0,75,75
1650250641598,CSE 140L,A01,083088,Eldon; John,0,5,75,75
1650250647620,CSE 175,A01,083665,Kumar; Rakesh,8,0,25,17
1650250653643,CSE 190,A00,092507,Dubnov; Shlomo,14,0,20,6
1650250659672,ECE 45,A01,083139,Staff,0,13,40,40
1650250665694,ECE 65,A50,083695,Staff,0,5,30,30
1650250671754,ECE 109,A01,091882,Touri; Behrouz,47,0,70,23
1650250677787,ECE 180,A00,083140,Abi Samra; Nicholas Camill,24,0,30,6
1650250677787,ECE 180,B00,083141,Abi Samra; Nicholas Camill,7,0,30,23
1650250683810,MATH 10A,A01,083735,Patchell; Gregory David,11,0,30,19
1650250683810,MATH 10A,A02,083736,Patchell; Gregory David,28,0,30,2
1650250683810,MATH 10A,A03,083737,Patchell; Gregory David,26,0,30,4
1650250689835,MATH 10B,A01,083207,Staff,0,6,30,30
1650250689835,MATH 10B,A02,083208,Staff,0,5,30,30
1650250689835,MATH 10B,B01,083739,Staff,17,0,30,13
1650250689835,MATH 10B,B02,083740,Staff,29,0,30,1
1650250695868,MATH 18,A01,083743,Staff,7,0,30,23
1650250695868,MATH 18,A02,083744,Staff,28,0,30,2
1650250695868,MATH 18,A03,083745,Staff,23,0,30,7
1650250695868,MATH 18,A04,083746,Staff,27,0,30,3
1650250695868,MATH 18,B01,083748,Staff,0,10,30,30
1650250695868,MATH 18,B02,083749,Staff,0,8,30,30
1650250695868,MATH 18,B03,083750,Staff,0,7,30,30
1650250695868,MATH 18,B04,083751,Staff,0,9,30,30
1650250701892,MATH 20A,A01,083754,Staff,26,0,40,14
1650250707921,MATH 20B,A01,083756,Staff,1,6,30,29
1650250707921,MATH 20B,A02,083757,Staff,0,7,30,30
1650250713944,MATH 20C,A01,083760,Staff,0,12,30,30
1650250713944,MATH 20C,A02,083761,Staff,0,13,30,30
1650250713944,MATH 20C,B01,083762,Staff,14,0,30,16
1650250713944,MATH 20C,B02,083763,Staff,28,0,30,2
1650250719968,MATH 20D,A01,083765,Staff,1,2,30,29
1650250719968,MATH 20D,A02,083766,Staff,8,0,30,22
1650250719968,MATH 20D,A03,083767,Staff,28,0,30,2
1650250725990,MATH 20E,A01,083771,Staff,7,0,30,23
1650250725990,MATH 20E,A02,083772,Staff,21,0,30,9
1650250725990,MATH 20E,B01,083773,Staff,0,0,30,30
1650250725990,MATH 20E,B02,083774,Staff,12,0,30,18
1650250732014,MATH 103A,A01,083777,Staff,0,9,30,30
1650250732014,MATH 103A,A02,083778,Staff,0,10,30,30
1650250732014,MATH 103A,B01,083779,Staff,0,10,30,30
1650250732014,MATH 103A,B02,083780,Staff,0,10,30,30
1650250738038,MATH 105,A01,085443,Staff,0,17,30,30
1650250744067,MATH 109,A01,083213,Anzaldo; Leesa B,0,5,30,30
1650250744067,MATH 109,A02,083214,Anzaldo; Leesa B,0,6,30,30
1650250744067,MATH 109,B01,083215,Anzaldo; Leesa B,0,4,30,30
1650250744067,MATH 109,B02,083216,Anzaldo; Leesa B,1,4,30,29
1650250750090,MATH 142A,A01,083219,Chow; Bennett,0,12,30,30
1650250750090,MATH 142A,A02,083220,Chow; Bennett,0,11,30,30
1650250750090,MATH 142A,B01,083221,Chow; Bennett,0,11,30,30
1650250750090,MATH 142A,B02,083222,Chow; Bennett,0,12,30,30
1650250756122,MATH 193A,A01,083224,Staff,0,5,30,30
1650250756122,MATH 193A,A02,083225,Staff,0,4,30,30
1650250756122,MATH 193A,A03,083781,Staff,0,2,30,30
1650250756122,MATH 193A,A04,083782,Staff,0,1,30,30
1650250762157,MATH 197,001,091859,McAuley; Julian John,9998,0,9999,1
1650250768213,COGS 9,A01,083615,Staff,0,14,60,60
1650250774239,COGS 11,A01,083617,Boyle; Mary E. T.,24,0,40,16
1650250780267,COGS 13,A01,083071,Staff,0,30,40,40
1650250786292,COGS 14A,A01,092681,Staff,1,14,100,99
1650250792315,COGS 14B,A01,083073,Cheng; Tzu-Han,0,8,50,50
1650250798341,COGS 17,A01,092677,Staff,31,0,75,44
1650250804366,COGS 100,A01,083619,Staff,1,21,60,59
1650250810390,COGS 101A,A01,083621,Davis; Joshua Daniel,0,21,60,60
1650250816421,COGS 101B,A01,091572,Staff,5,0,60,55
1650250822445,COGS 101C,A01,083625,Delgado; Tania,20,0,30,10
1650250828468,COGS 107A,A01,083627,Boyle; Mary E. T.,1,7,60,59
1650250834535,COGS 118A,A01,083075,Staff,15,0,60,45
1650250840560,CSE 3,A50,083646,Miranda; Gregory Joseph,22,0,38,16
1650250840560,CSE 3,A51,083647,Miranda; Gregory Joseph,37,0,37,0
1650250846599,CSE 8A,A50,083650,Miranda; Gregory Joseph,0,18,40,40
1650250852625,CSE 11,A01,083080,Cao; Yingjun,0,71,40,40
1650250858648,CSE 12,A01,083652,Staff,0,9,100,100
1650250864678,CSE 15L,A01,083654,Staff,0,1,50,50
1650250864678,CSE 15L,A02,083655,Staff,5,0,50,45
1650250870708,CSE 20,A01,083657,Staff,53,0,80,27
1650250876731,CSE 30,A01,083084,Eldon; John,0,71,40,40
1650250882758,CSE 100,A01,083659,Cao; Yingjun,0,64,50,50
1650250888779,CSE 134B,A01,083661,Powell; Thomas Allan,0,27,65,65
1650250894805,CSE 140,A01,083663,Staff,0,0,75,75
1650250900831,CSE 140L,A01,083088,Eldon; John,0,5,75,75
1650250906855,CSE 175,A01,083665,Kumar; Rakesh,8,0,25,17
1650250912879,CSE 190,A00,092507,Dubnov; Shlomo,14,0,20,6
1650250918902,ECE 45,A01,083139,Staff,0,13,40,40
1650250924927,ECE 65,A50,083695,Staff,0,5,30,30
1650250930952,ECE 109,A01,091882,Touri; Behrouz,47,0,70,23
1650250936979,ECE 180,A00,083140,Abi Samra; Nicholas Camill,24,0,30,6
1650250936979,ECE 180,B00,083141,Abi Samra; Nicholas Camill,7,0,30,23
1650250943005,MATH 10A,A01,083735,Patchell; Gregory David,11,0,30,19
1650250943005,MATH 10A,A02,083736,Patchell; Gregory David,28,0,30,2
1650250943005,MATH 10A,A03,083737,Patchell; Gregory David,26,0,30,4
1650250949029,MATH 10B,A01,083207,Staff,0,6,30,30
1650250949029,MATH 10B,A02,083208,Staff,0,5,30,30
1650250949029,MATH 10B,B01,083739,Staff,17,0,30,13
1650250949029,MATH 10B,B02,083740,Staff,29,0,30,1
1650250955059,MATH 18,A01,083743,Staff,7,0,30,23
1650250955059,MATH 18,A02,083744,Staff,28,0,30,2
1650250955059,MATH 18,A03,083745,Staff,23,0,30,7
1650250955059,MATH 18,A04,083746,Staff,27,0,30,3
1650250955059,MATH 18,B01,083748,Staff,0,10,30,30
1650250955059,MATH 18,B02,083749,Staff,0,8,30,30
1650250955059,MATH 18,B03,083750,Staff,0,7,30,30
1650250955059,MATH 18,B04,083751,Staff,0,9,30,30
1650250961086,MATH 20A,A01,083754,Staff,26,0,40,14
1650250967110,MATH 20B,A01,083756,Staff,1,6,30,29
1650250967110,MATH 20B,A02,083757,Staff,0,7,30,30
1650250973137,MATH 20C,A01,083760,Staff,0,12,30,30
1650250973137,MATH 20C,A02,083761,Staff,0,13,30,30
1650250973137,MATH 20C,B01,083762,Staff,14,0,30,16
1650250973137,MATH 20C,B02,083763,Staff,28,0,30,2
1650250979173,MATH 20D,A01,083765,Staff,1,2,30,29
1650250979173,MATH 20D,A02,083766,Staff,8,0,30,22
1650250979173,MATH 20D,A03,083767,Staff,28,0,30,2
1650250985216,MATH 20E,A01,083771,Staff,7,0,30,23
1650250985216,MATH 20E,A02,083772,Staff,21,0,30,9
1650250985216,MATH 20E,B01,083773,Staff,0,0,30,30
1650250985216,MATH 20E,B02,083774,Staff,12,0,30,18
1650250991240,MATH 103A,A01,083777,Staff,0,9,30,30
1650250991240,MATH 103A,A02,083778,Staff,0,10,30,30
1650250991240,MATH 103A,B01,083779,Staff,0,10,30,30
1650250991240,MATH 103A,B02,083780,Staff,0,10,30,30
1650250997265,MATH 105,A01,085443,Staff,0,17,30,30
1650251003292,MATH 109,A01,083213,Anzaldo; Leesa B,0,5,30,30
1650251003292,MATH 109,A02,083214,Anzaldo; Leesa B,0,6,30,30
1650251003292,MATH 109,B01,083215,Anzaldo; Leesa B,0,4,30,30
1650251003292,MATH 109,B02,083216,Anzaldo; Leesa B,1,4,30,29
1650251009315,MATH 142A,A01,083219,Chow; Bennett,0,12,30,30
1650251009315,MATH 142A,A02,083220,Chow; Bennett,0,11,30,30
1650251009315,MATH 142A,B01,083221,Chow; Bennett,0,11,30,30
1650251009315,MATH 142A,B02,083222,Chow; Bennett,0,12,30,30
1650251015339,MATH 193A,A01,083224,Staff,0,5,30,30
1650251015339,MATH 193A,A02,083225,Staff,0,4,30,30
1650251015339,MATH 193A,A03,083781,Staff,0,2,30,30
1650251015339,MATH 193A,A04,083782,Staff,0,1,30,30
1650251021362,MATH 197,001,091859,McAuley; Julian John,9998,0,9999,1
1650251027497,COGS 9,A01,083615,Staff,0,14,60,60
1650251033523,COGS 11,A01,083617,Boyle; Mary E. T.,24,0,40,16
1650251039546,COGS 13,A01,083071,Staff,0,30,40,40
1650251045576,COGS 14A,A01,092681,Staff,1,14,100,99
1650251051603,COGS 14B,A01,083073,Cheng; Tzu-Han,0,8,50,50
1650251057629,COGS 17,A01,092677,Staff,31,0,75,44
1650251063653,COGS 100,A01,083619,Staff,1,21,60,59
1650251069678,COGS 101A,A01,083621,Davis; Joshua Daniel,0,21,60,60
1650251075705,COGS 101B,A01,091572,Staff,5,0,60,55
1650251081728,COGS 101C,A01,083625,Delgado; Tania,20,0,30,10
1650251087762,COGS 107A,A01,083627,Boyle; Mary E. T.,1,7,60,59
1650251093786,COGS 118A,A01,083075,Staff,15,0,60,45
1650251099813,CSE 3,A50,083646,Miranda; Gregory Joseph,22,0,38,16
1650251099813,CSE 3,A51,083647,Miranda; Gregory Joseph,37,0,37,0
1650251105840,CSE 8A,A50,083650,Miranda; Gregory Joseph,0,18,40,40
1650251111864,CSE 11,A01,083080,Cao; Yingjun,0,71,40,40
1650251117888,CSE 12,A01,083652,Staff,0,9,100,100
1650251123920,CSE 15L,A01,083654,Staff,0,1,50,50
1650251123920,CSE 15L,A02,083655,Staff,5,0,50,45
1650251129944,CSE 20,A01,083657,Staff,53,0,80,27
1650251135971,CSE 30,A01,083084,Eldon; John,0,71,40,40
1650251141998,CSE 100,A01,083659,Cao; Yingjun,0,64,50,50
1650251148025,CSE 134B,A01,083661,Powell; Thomas Allan,0,27,65,65
1650251154049,CSE 140,A01,083663,Staff,0,0,75,75
1650251160082,CSE 140L,A01,083088,Eldon; John,0,5,75,75
1650251166107,CSE 175,A01,083665,Kumar; Rakesh,8,0,25,17
1650251172132,CSE 190,A00,092507,Dubnov; Shlomo,14,0,20,6
1650251178159,ECE 45,A01,083139,Staff,0,13,40,40
1650251184186,ECE 65,A50,083695,Staff,0,5,30,30
1650251190213,ECE 109,A01,091882,Touri; Behrouz,47,0,70,23
1650251196236,ECE 180,A00,083140,Abi Samra; Nicholas Camill,24,0,30,6
1650251196236,ECE 180,B00,083141,Abi Samra; Nicholas Camill,7,0,30,23
1650251202261,MATH 10A,A01,083735,Patchell; Gregory David,11,0,30,19
1650251202261,MATH 10A,A02,083736,Patchell; Gregory David,28,0,30,2
1650251202261,MATH 10A,A03,083737,Patchell; Gregory David,26,0,30,4
1650251208286,MATH 10B,A01,083207,Staff,0,6,30,30
1650251208286,MATH 10B,A02,083208,Staff,0,5,30,30
1650251208286,MATH 10B,B01,083739,Staff,17,0,30,13
1650251208286,MATH 10B,B02,083740,Staff,29,0,30,1
1650251214317,MATH 18,A01,083743,Staff,7,0,30,23
1650251214317,MATH 18,A02,083744,Staff,28,0,30,2
1650251214317,MATH 18,A03,083745,Staff,23,0,30,7
1650251214317,MATH 18,A04,083746,Staff,27,0,30,3
1650251214317,MATH 18,B01,083748,Staff,0,10,30,30
1650251214317,MATH 18,B02,083749,Staff,0,8,30,30
1650251214317,MATH 18,B03,083750,Staff,0,7,30,30
1650251214317,MATH 18,B04,083751,Staff,0,9,30,30
1650251220351,MATH 20A,A01,083754,Staff,26,0,40,14
1650251226377,MATH 20B,A01,083756,Staff,1,6,30,29
1650251226377,MATH 20B,A02,083757,Staff,0,7,30,30
1650251232402,MATH 20C,A01,083760,Staff,0,12,30,30
1650251232402,MATH 20C,A02,083761,Staff,0,13,30,30
1650251232402,MATH 20C,B01,083762,Staff,14,0,30,16
1650251232402,MATH 20C,B02,083763,Staff,28,0,30,2
1650251238425,MATH 20D,A01,083765,Staff,1,2,30,29
1650251238425,MATH 20D,A02,083766,Staff,8,0,30,22
1650251238425,MATH 20D,A03,083767,Staff,28,0,30,2
1650251244451,MATH 20E,A01,083771,Staff,7,0,30,23
1650251244451,MATH 20E,A02,083772,Staff,21,0,30,9
1650251244451,MATH 20E,B01,083773,Staff,0,0,30,30
1650251244451,MATH 20E,B02,083774,Staff,12,0,30,18
1650251250472,MATH 103A,A01,083777,Staff,0,9,30,30
1650251250472,MATH 103A,A02,083778,Staff,0,10,30,30
1650251250472,MATH 103A,B01,083779,Staff,0,10,30,30
1650251250472,MATH 103A,B02,083780,Staff,0,10,30,30
1650251256495,MATH 105,A01,085443,Staff,0,17,30,30
1650251262523,MATH 109,A01,083213,Anzaldo; Leesa B,0,5,30,30
1650251262523,MATH 109,A02,083214,Anzaldo; Leesa B,0,6,30,30
1650251262523,MATH 109,B01,083215,Anzaldo; Leesa B,0,4,30,30
1650251262523,MATH 109,B02,083216,Anzaldo; Leesa B,1,4,30,29
1650251268545,MATH 142A,A01,083219,Chow; Bennett,0,12,30,30
1650251268545,MATH 142A,A02,083220,Chow; Bennett,0,11,30,30
1650251268545,MATH 142A,B01,083221,Chow; Bennett,0,11,30,30
1650251268545,MATH 142A,B02,083222,Chow; Bennett,0,12,30,30
1650251274570,MATH 193A,A01,083224,Staff,0,5,30,30
1650251274570,MATH 193A,A02,083225,Staff,0,4,30,30
1650251274570,MATH 193A,A03,083781,Staff,0,2,30,30
1650251274570,MATH 193A,A04,083782,Staff,0,1,30,30
1650251280601,MATH 197,001,091859,McAuley; Julian John,9998,0,9999,1
1650251286661,COGS 9,A01,083615,Staff,0,14,60,60
1650251292683,COGS 11,A01,083617,Boyle; Mary E. T.,24,0,40,16
1650251298707,COGS 13,A01,083071,Staff,0,30,40,40
1650251304733,COGS 14A,A01,092681,Staff,1,14,100,99
1650251310756,COGS 14B,A01,083073,Cheng; Tzu-Han,0,8,50,50
1650251316779,COGS 17,A01,092677,Staff,31,0,75,44
1650251322811,COGS 100,A01,083619,Staff,1,21,60,59
1650251328835,COGS 101A,A01,083621,Davis; Joshua Daniel,0,21,60,60
1650251334859,COGS 101B,A01,091572,Staff,5,0,60,55
1650251340881,COGS 101C,A01,083625,Delgado; Tania,20,0,30,10
1650251346906,COGS 107A,A01,083627,Boyle; Mary E. T.,1,7,60,59
1650251352931,COGS 118A,A01,083075,Staff,15,0,60,45
1650251358956,CSE 3,A50,083646,Miranda; Gregory Joseph,22,0,38,16
1650251358956,CSE 3,A51,083647,Miranda; Gregory Joseph,37,0,37,0
1650251364982,CSE 8A,A50,083650,Miranda; Gregory Joseph,0,18,40,40
1650251371006,CSE 11,A01,083080,Cao; Yingjun,0,71,40,40
1650251377032,CSE 12,A01,083652,Staff,0,9,100,100
1650251383060,CSE 15L,A01,083654,Staff,0,1,50,50
1650251383060,CSE 15L,A02,083655,Staff,5,0,50,45
1650251389084,CSE 20,A01,083657,Staff,53,0,80,27
1650251395107,CSE 30,A01,083084,Eldon; John,0,71,40,40
1650251401130,CSE 100,A01,083659,Cao; Yingjun,0,64,50,50
1650251407159,CSE 134B,A01,083661,Powell; Thomas Allan,0,27,65,65
1650251413183,CSE 140,A01,083663,Staff,0,0,75,75
1650251419205,CSE 140L,A01,083088,Eldon; John,0,5,75,75
1650251425229,CSE 175,A01,083665,Kumar; Rakesh,8,0,25,17
1650251431253,CSE 190,A00,092507,Dubnov; Shlomo,14,0,20,6
1650251437276,ECE 45,A01,083139,Staff,0,13,40,40
1650251443300,ECE 65,A50,083695,Staff,0,5,30,30
1650251449323,ECE 109,A01,091882,Touri; Behrouz,47,0,70,23
1650251455357,ECE 180,A00,083140,Abi Samra; Nicholas Camill,24,0,30,6
1650251455357,ECE 180,B00,083141,Abi Samra; Nicholas Camill,7,0,30,23
1650251461385,MATH 10A,A01,083735,Patchell; Gregory David,11,0,30,19
1650251461385,MATH 10A,A02,083736,Patchell; Gregory David,28,0,30,2
1650251461385,MATH 10A,A03,083737,Patchell; Gregory David,26,0,30,4
1650251467409,MATH 10B,A01,083207,Staff,0,6,30,30
1650251467409,MATH 10B,A02,083208,Staff,0,5,30,30
1650251467409,MATH 10B,B01,083739,Staff,17,0,30,13
1650251467409,MATH 10B,B02,083740,Staff,29,0,30,1
1650251473440,MATH 18,A01,083743,Staff,7,0,30,23
1650251473440,MATH 18,A02,083744,Staff,28,0,30,2
1650251473440,MATH 18,A03,083745,Staff,23,0,30,7
1650251473440,MATH 18,A04,083746,Staff,27,0,30,3
1650251473440,MATH 18,B01,083748,Staff,0,10,30,30
1650251473440,MATH 18,B02,083749,Staff,0,8,30,30
1650251473440,MATH 18,B03,083750,Staff,0,7,30,30
1650251473440,MATH 18,B04,083751,Staff,0,9,30,30
1650251479466,MATH 20A,A01,083754,Staff,26,0,40,14
1650251485494,MATH 20B,A01,083756,Staff,1,6,30,29
1650251485494,MATH 20B,A02,083757,Staff,0,7,30,30
1650251491517,MATH 20C,A01,083760,Staff,0,12,30,30
1650251491517,MATH 20C,A02,083761,Staff,0,13,30,30
1650251491517,MATH 20C,B01,083762,Staff,14,0,30,16
1650251491517,MATH 20C,B02,083763,Staff,28,0,30,2
1650251497541,MATH 20D,A01,083765,Staff,1,2,30,29
1650251497541,MATH 20D,A02,083766,Staff,8,0,30,22
1650251497541,MATH 20D,A03,083767,Staff,28,0,30,2
1650251503573,MATH 20E,A01,083771,Staff,7,0,30,23
1650251503573,MATH 20E,A02,083772,Staff,21,0,30,9
1650251503573,MATH 20E,B01,083773,Staff,0,0,30,30
1650251503573,MATH 20E,B02,083774,Staff,12,0,30,18
1650251509600,MATH 103A,A01,083777,Staff,0,9,30,30
1650251509600,MATH 103A,A02,083778,Staff,0,10,30,30
1650251509600,MATH 103A,B01,083779,Staff,0,10,30,30
1650251509600,MATH 103A,B02,083780,Staff,0,10,30,30
1650251515634,MATH 105,A01,085443,Staff,0,17,30,30
1650251521664,MATH 109,A01,083213,Anzaldo; Leesa B,0,5,30,30
1650251521664,MATH 109,A02,083214,Anzaldo; Leesa B,0,6,30,30
1650251521664,MATH 109,B01,083215,Anzaldo; Leesa B,0,4,30,30
1650251521664,MATH 109,B02,083216,Anzaldo; Leesa B,1,4,30,29
1650251527687,MATH 142A,A01,083219,Chow; Bennett,0,12,30,30
1650251527687,MATH 142A,A02,083220,Chow; Bennett,0,11,30,30
1650251527687,MATH 142A,B01,083221,Chow; Bennett,0,11,30,30
1650251527687,MATH 142A,B02,083222,Chow; Bennett,0,12,30,30
1650251533716,MATH 193A,A01,083224,Staff,0,5,30,30
1650251533716,MATH 193A,A02,083225,Staff,0,4,30,30
1650251533716,MATH 193A,A03,083781,Staff,0,2,30,30
1650251533716,MATH 193A,A04,083782,Staff,0,1,30,30
1650251539740,MATH 197,001,091859,McAuley; Julian John,9998,0,9999,1
1650251545796,COGS 9,A01,083615,Staff,0,14,60,60
1650251551826,COGS 11,A01,083617,Boyle; Mary E. T.,24,0,40,16
1650251557852,COGS 13,A01,083071,Staff,0,30,40,40
1650251563879,COGS 14A,A01,092681,Staff,1,14,100,99
1650251569902,COGS 14B,A01,083073,Cheng; Tzu-Han,0,8,50,50
1650251575927,COGS 17,A01,092677,Staff,31,0,75,44
1650251581953,COGS 100,A01,083619,Staff,1,21,60,59
1650251587980,COGS 101A,A01,083621,Davis; Joshua Daniel,0,21,60,60
1650251594003,COGS 101B,A01,091572,Staff,5,0,60,55
1650251600026,COGS 101C,A01,083625,Delgado; Tania,20,0,30,10
1650251606050,COGS 107A,A01,083627,Boyle; Mary E. T.,1,7,60,59
1650251612076,COGS 118A,A01,083075,Staff,15,0,60,45
1650251618203,CSE 3,A50,083646,Miranda; Gregory Joseph,22,0,38,16
1650251618203,CSE 3,A51,083647,Miranda; Gregory Joseph,37,0,37,0
1650251624227,CSE 8A,A50,083650,Miranda; Gregory Joseph,0,18,40,40
1650251630254,CSE 11,A01,083080,Cao; Yingjun,0,71,40,40
1650251636277,CSE 12,A01,083652,Staff,0,9,100,100
1650251642301,CSE 15L,A01,083654,Staff,0,1,50,50
1650251642301,CSE 15L,A02,083655,Staff,5,0,50,45
1650251648327,CSE 20,A01,083657,Staff,53,0,80,27
1650251654351,CSE 30,A01,083084,Eldon; John,0,71,40,40
1650251660375,CSE 100,A01,083659,Cao; Yingjun,0,64,50,50
1650251666399,CSE 134B,A01,083661,Powell; Thomas Allan,0,27,65,65
1650251672425,CSE 140,A01,083663,Staff,0,0,75,75
1650251678451,CSE 140L,A01,083088,Eldon; John,0,5,75,75
1650251684474,CSE 175,A01,083665,Kumar; Rakesh,8,0,25,17
1650251690502,CSE 190,A00,092507,Dubnov; Shlomo,14,0,20,6
1650251696526,ECE 45,A01,083139,Staff,0,13,40,40
1650251702552,ECE 65,A50,083695,Staff,0,5,30,30
1650251708577,ECE 109,A01,091882,Touri; Behrouz,47,0,70,23
1650251714600,ECE 180,A00,083140,Abi Samra; Nicholas Camill,24,0,30,6
1650251714600,ECE 180,B00,083141,Abi Samra; Nicholas Camill,7,0,30,23
1650251720625,MATH 10A,A01,083735,Patchell; Gregory David,11,0,30,19
1650251720625,MATH 10A,A02,083736,Patchell; Gregory David,28,0,30,2
1650251720625,MATH 10A,A03,083737,Patchell; Gregory David,26,0,30,4
1650251726649,MATH 10B,A01,083207,Staff,0,6,30,30
1650251726649,MATH 10B,A02,083208,Staff,0,5,30,30
1650251726649,MATH 10B,B01,083739,Staff,17,0,30,13
1650251726649,MATH 10B,B02,083740,Staff,29,0,30,1
1650251732679,MATH 18,A01,083743,Staff,7,0,30,23
1650251732679,MATH 18,A02,083744,Staff,28,0,30,2
1650251732679,MATH 18,A03,083745,Staff,23,0,30,7
1650251732679,MATH 18,A04,083746,Staff,27,0,30,3
1650251732679,MATH 18,B01,083748,Staff,0,10,30,30
1650251732679,MATH 18,B02,083749,Staff,0,8,30,30
1650251732679,MATH 18,B03,083750,Staff,0,7,30,30
1650251732679,MATH 18,B04,083751,Staff,0,9,30,30
1650251738705,MATH 20A,A01,083754,Staff,26,0,40,14
1650251744729,MATH 20B,A01,083756,Staff,1,6,30,29
1650251744729,MATH 20B,A02,083757,Staff,0,7,30,30
1650251750784,MATH 20C,A01,083760,Staff,0,12,30,30
1650251750784,MATH 20C,A02,083761,Staff,0,13,30,30
1650251750784,MATH 20C,B01,083762,Staff,14,0,30,16
1650251750784,MATH 20C,B02,083763,Staff,28,0,30,2
1650251756810,MATH 20D,A01,083765,Staff,1,2,30,29
1650251756810,MATH 20D,A02,083766,Staff,8,0,30,22
1650251756810,MATH 20D,A03,083767,Staff,28,0,30,2
1650251762838,MATH 20E,A01,083771,Staff,7,0,30,23
1650251762838,MATH 20E,A02,083772,Staff,20,0,30,10
1650251762838,MATH 20E,B01,083773,Staff,0,0,30,30
1650251762838,MATH 20E,B02,083774,Staff,12,0,30,18
1650251768865,MATH 103A,A01,083777,Staff,0,9,30,30
1650251768865,MATH 103A,A02,083778,Staff,0,10,30,30
1650251768865,MATH 103A,B01,083779,Staff,0,10,30,30
1650251768865,MATH 103A,B02,083780,Staff,0,10,30,30
1650251774893,MATH 105,A01,085443,Staff,0,17,30,30
1650251780916,MATH 109,A01,083213,Anzaldo; Leesa B,0,5,30,30
1650251780916,MATH 109,A02,083214,Anzaldo; Leesa B,0,6,30,30
1650251780916,MATH 109,B01,083215,Anzaldo; Leesa B,0,4,30,30
1650251780916,MATH 109,B02,083216,Anzaldo; Leesa B,1,4,30,29
1650251786941,MATH 142A,A01,083219,Chow; Bennett,0,12,30,30
1650251786941,MATH 142A,A02,083220,Chow; Bennett,0,11,30,30
1650251786941,MATH 142A,B01,083221,Chow; Bennett,0,11,30,30
1650251786941,MATH 142A,B02,083222,Chow; Bennett,0,12,30,30
1650251792966,MATH 193A,A01,083224,Staff,0,5,30,30
1650251792966,MATH 193A,A02,083225,Staff,0,4,30,30
1650251792966,MATH 193A,A03,083781,Staff,0,2,30,30
1650251792966,MATH 193A,A04,083782,Staff,0,1,30,30
1650251798988,MATH 197,001,091859,McAuley; Julian John,9998,0,9999,1
1650251805062,COGS 9,A01,083615,Staff,0,14,60,60
1650251811090,COGS 11,A01,083617,Boyle; Mary E. T.,24,0,40,16
1650251817114,COGS 13,A01,083071,Staff,0,30,40,40
1650251823141,COGS 14A,A01,092681,Staff,1,14,100,99
1650251829168,COGS 14B,A01,083073,Cheng; Tzu-Han,0,8,50,50
1650251835191,COGS 17,A01,092677,Staff,31,0,75,44
1650251841214,COGS 100,A01,083619,Staff,1,21,60,59
1650251852035,COGS 101A,A01,083621,Davis; Joshua Daniel,0,21,60,60
1650251858059,COGS 101B,A01,091572,Staff,5,0,60,55
1650251864083,COGS 101C,A01,083625,Delgado; Tania,20,0,30,10
1650251870107,COGS 107A,A01,083627,Boyle; Mary E. T.,1,7,60,59
1650251876144,COGS 118A,A01,083075,Staff,15,0,60,45
1650251882185,CSE 3,A50,083646,Miranda; Gregory Joseph,22,0,38,16
1650251882185,CSE 3,A51,083647,Miranda; Gregory Joseph,37,0,37,0
1650251888213,CSE 8A,A50,083650,Miranda; Gregory Joseph,0,18,40,40
1650251894240,CSE 11,A01,083080,Cao; Yingjun,0,71,40,40
1650251900263,CSE 12,A01,083652,Staff,0,9,100,100
1650251906285,CSE 15L,A01,083654,Staff,0,1,50,50
1650251906285,CSE 15L,A02,083655,Staff,5,0,50,45
1650251912314,CSE 20,A01,083657,Staff,53,0,80,27
1650251918338,CSE 30,A01,083084,Eldon; John,0,71,40,40
1650251924362,CSE 100,A01,083659,Cao; Yingjun,0,64,50,50
1650251930387,CSE 134B,A01,083661,Powell; Thomas Allan,0,27,65,65
1650251936410,CSE 140,A01,083663,Staff,0,0,75,75
1650251942438,CSE 140L,A01,083088,Eldon; John,0,5,75,75
1650251948488,CSE 175,A01,083665,Kumar; Rakesh,8,0,25,17
1650251954515,CSE 190,A00,092507,Dubnov; Shlomo,14,0,20,6
1650251960539,ECE 45,A01,083139,Staff,0,13,40,40
1650251966564,ECE 65,A50,083695,Staff,0,5,30,30
1650251972593,ECE 109,A01,091882,Touri; Behrouz,47,0,70,23
1650251978619,ECE 180,A00,083140,Abi Samra; Nicholas Camill,24,0,30,6
1650251978619,ECE 180,B00,083141,Abi Samra; Nicholas Camill,7,0,30,23
1650251984643,MATH 10A,A01,083735,Patchell; Gregory David,11,0,30,19
1650251984643,MATH 10A,A02,083736,Patchell; Gregory David,28,0,30,2
1650251984643,MATH 10A,A03,083737,Patchell; Gregory David,26,0,30,4
1650251990671,MATH 10B,A01,083207,Staff,0,6,30,30
1650251990671,MATH 10B,A02,083208,Staff,0,5,30,30
1650251990671,MATH 10B,B01,083739,Staff,17,0,30,13
1650251990671,MATH 10B,B02,083740,Staff,29,0,30,1
1650251996697,MATH 18,A01,083743,Staff,7,0,30,23
1650251996697,MATH 18,A02,083744,Staff,28,0,30,2
1650251996697,MATH 18,A03,083745,Staff,23,0,30,7
1650251996697,MATH 18,A04,083746,Staff,27,0,30,3
1650251996697,MATH 18,B01,083748,Staff,0,10,30,30
1650251996697,MATH 18,B02,083749,Staff,0,8,30,30
1650251996697,MATH 18,B03,083750,Staff,0,7,30,30
1650251996697,MATH 18,B04,083751,Staff,0,9,30,30
1650252002721,MATH 20A,A01,083754,Staff,26,0,40,14
1650252008749,MATH 20B,A01,083756,Staff,1,6,30,29
1650252008749,MATH 20B,A02,083757,Staff,0,7,30,30
1650252014777,MATH 20C,A01,083760,Staff,0,12,30,30
1650252014777,MATH 20C,A02,083761,Staff,0,13,30,30
1650252014777,MATH 20C,B01,083762,Staff,14,0,30,16
1650252014777,MATH 20C,B02,083763,Staff,28,0,30,2
1650252020811,MATH 20D,A01,083765,Staff,1,2,30,29
1650252020811,MATH 20D,A02,083766,Staff,8,0,30,22
1650252020811,MATH 20D,A03,083767,Staff,28,0,30,2
1650252026836,MATH 20E,A01,083771,Staff,7,0,30,23
1650252026836,MATH 20E,A02,083772,Staff,20,0,30,10
1650252026836,MATH 20E,B01,083773,Staff,0,0,30,30
1650252026836,MATH 20E,B02,083774,Staff,12,0,30,18
1650252032872,MATH 103A,A01,083777,Staff,0,9,30,30
1650252032872,MATH 103A,A02,083778,Staff,0,10,30,30
1650252032872,MATH 103A,B01,083779,Staff,0,10,30,30
1650252032872,MATH 103A,B02,083780,Staff,0,10,30,30
1650252038896,MATH 105,A01,085443,Staff,0,17,30,30
1650252044920,MATH 109,A01,083213,Anzaldo; Leesa B,0,5,30,30
1650252044920,MATH 109,A02,083214,Anzaldo; Leesa B,0,6,30,30
1650252044920,MATH 109,B01,083215,Anzaldo; Leesa B,0,4,30,30
1650252044920,MATH 109,B02,083216,Anzaldo; Leesa B,1,4,30,29
1650252050945,MATH 142A,A01,083219,Chow; Bennett,0,12,30,30
1650252050945,MATH 142A,A02,083220,Chow; Bennett,0,11,30,30
1650252050945,MATH 142A,B01,083221,Chow; Bennett,0,11,30,30
1650252050945,MATH 142A,B02,083222,Chow; Bennett,0,12,30,30
1650252056972,MATH 193A,A01,083224,Staff,0,5,30,30
1650252056972,MATH 193A,A02,083225,Staff,0,4,30,30
1650252056972,MATH 193A,A03,083781,Staff,0,2,30,30
1650252056972,MATH 193A,A04,083782,Staff,0,1,30,30
1650252063012,MATH 197,001,091859,McAuley; Julian John,9998,0,9999,1
1650252069064,COGS 9,A01,083615,Staff,0,14,60,60
1650252075088,COGS 11,A01,083617,Boyle; Mary E. T.,24,0,40,16
1650252081111,COGS 13,A01,083071,Staff,0,30,40,40
1650252087136,COGS 14A,A01,092681,Staff,1,14,100,99
1650252093159,COGS 14B,A01,083073,Cheng; Tzu-Han,0,8,50,50
1650252099185,COGS 17,A01,092677,Staff,30,0,75,45
1650252105215,COGS 100,A01,083619,Staff,1,21,60,59
1650252111239,COGS 101A,A01,083621,Davis; Joshua Daniel,0,21,60,60
1650252117263,COGS 101B,A01,091572,Staff,4,0,60,56
1650252123293,COGS 101C,A01,083625,Delgado; Tania,20,0,30,10
1650252129318,COGS 107A,A01,083627,Boyle; Mary E. T.,1,7,60,59
1650252135341,COGS 118A,A01,083075,Staff,15,0,60,45
1650252141365,CSE 3,A50,083646,Miranda; Gregory Joseph,22,0,38,16
1650252141365,CSE 3,A51,083647,Miranda; Gregory Joseph,37,0,37,0
1650252147388,CSE 8A,A50,083650,Miranda; Gregory Joseph,0,18,40,40
1650252153428,CSE 11,A01,083080,Cao; Yingjun,0,71,40,40
1650252159449,CSE 12,A01,083652,Staff,0,9,100,100
1650252165472,CSE 15L,A01,083654,Staff,0,1,50,50
1650252165472,CSE 15L,A02,083655,Staff,5,0,50,45
1650252171497,CSE 20,A01,083657,Staff,53,0,80,27
1650252177522,CSE 30,A01,083084,Eldon; John,0,71,40,40
1650252183544,CSE 100,A01,083659,Cao; Yingjun,0,64,50,50
1650252189567,CSE 134B,A01,083661,Powell; Thomas Allan,0,27,65,65
1650252195589,CSE 140,A01,083663,Staff,0,0,75,75
1650252201612,CSE 140L,A01,083088,Eldon; John,0,5,75,75
1650252207642,CSE 175,A01,083665,Kumar; Rakesh,8,0,25,17
1650252213665,CSE 190,A00,092507,Dubnov; Shlomo,14,0,20,6
1650252219780,ECE 45,A01,083139,Staff,0,13,40,40
1650252225801,ECE 65,A50,083695,Staff,0,5,30,30
1650252231823,ECE 109,A01,091882,Touri; Behrouz,47,0,70,23
1650252237847,ECE 180,A00,083140,Abi Samra; Nicholas Camill,24,0,30,6
1650252237847,ECE 180,B00,083141,Abi Samra; Nicholas Camill,7,0,30,23
1650252243876,MATH 10A,A01,083735,Patchell; Gregory David,11,0,30,19
1650252243876,MATH 10A,A02,083736,Patchell; Gregory David,28,0,30,2
1650252243876,MATH 10A,A03,083737,Patchell; Gregory David,26,0,30,4
1650252249902,MATH 10B,A01,083207,Staff,0,6,30,30
1650252249902,MATH 10B,A02,083208,Staff,0,5,30,30
1650252249902,MATH 10B,B01,083739,Staff,17,0,30,13
1650252249902,MATH 10B,B02,083740,Staff,29,0,30,1
1650252255930,MATH 18,A01,083743,Staff,7,0,30,23
1650252255930,MATH 18,A02,083744,Staff,28,0,30,2
1650252255930,MATH 18,A03,083745,Staff,23,0,30,7
1650252255930,MATH 18,A04,083746,Staff,27,0,30,3
1650252255930,MATH 18,B01,083748,Staff,0,10,30,30
1650252255930,MATH 18,B02,083749,Staff,0,8,30,30
1650252255930,MATH 18,B03,083750,Staff,0,7,30,30
1650252255930,MATH 18,B04,083751,Staff,0,9,30,30
1650252261953,MATH 20A,A01,083754,Staff,26,0,40,14
1650252267980,MATH 20B,A01,083756,Staff,1,6,30,29
1650252267980,MATH 20B,A02,083757,Staff,0,7,30,30
1650252274004,MATH 20C,A01,083760,Staff,0,12,30,30
1650252274004,MATH 20C,A02,083761,Staff,0,13,30,30
1650252274004,MATH 20C,B01,083762,Staff,14,0,30,16
1650252274004,MATH 20C,B02,083763,Staff,28,0,30,2
1650252280027,MATH 20D,A01,083765,Staff,1,2,30,29
1650252280027,MATH 20D,A02,083766,Staff,8,0,30,22
1650252280027,MATH 20D,A03,083767,Staff,28,0,30,2
1650252286052,MATH 20E,A01,083771,Staff,7,0,30,23
1650252286052,MATH 20E,A02,083772,Staff,20,0,30,10
1650252286052,MATH 20E,B01,083773,Staff,0,0,30,30
1650252286052,MATH 20E,B02,083774,Staff,12,0,30,18
1650252292081,MATH 103A,A01,083777,Staff,0,9,30,30
1650252292081,MATH 103A,A02,083778,Staff,0,10,30,30
1650252292081,MATH 103A,B01,083779,Staff,0,10,30,30
1650252292081,MATH 103A,B02,083780,Staff,0,10,30,30
1650252298107,MATH 105,A01,085443,Staff,0,17,30,30
1650252304132,MATH 109,A01,083213,Anzaldo; Leesa B,0,5,30,30
1650252304132,MATH 109,A02,083214,Anzaldo; Leesa B,0,6,30,30
1650252304132,MATH 109,B01,083215,Anzaldo; Leesa B,0,4,30,30
1650252304132,MATH 109,B02,083216,Anzaldo; Leesa B,1,4,30,29
1650252310161,MATH 142A,A01,083219,Chow; Bennett,0,12,30,30
1650252310161,MATH 142A,A02,083220,Chow; Bennett,0,11,30,30
1650252310161,MATH 142A,B01,083221,Chow; Bennett,0,11,30,30
1650252310161,MATH 142A,B02,083222,Chow; Bennett,0,12,30,30
1650252316186,MATH 193A,A01,083224,Staff,0,5,30,30
1650252316186,MATH 193A,A02,083225,Staff,0,4,30,30
1650252316186,MATH 193A,A03,083781,Staff,0,2,30,30
1650252316186,MATH 193A,A04,083782,Staff,0,1,30,30
1650252322209,MATH 197,001,091859,McAuley; Julian John,9998,0,9999,1
1650252328259,COGS 9,A01,083615,Staff,0,14,60,60
1650252334296,COGS 11,A01,083617,Boyle; Mary E. T.,24,0,40,16
1650252340319,COGS 13,A01,083071,Staff,0,30,40,40
1650252346347,COGS 14A,A01,092681,Staff,1,14,100,99
1650252352371,COGS 14B,A01,083073,Cheng; Tzu-Han,0,8,50,50
1650252358395,COGS 17,A01,092677,Staff,30,0,75,45
1650252364423,COGS 100,A01,083619,Staff,1,21,60,59
1650252370448,COGS 101A,A01,083621,Davis; Joshua Daniel,0,21,60,60
1650252376472,COGS 101B,A01,091572,Staff,4,0,60,56
1650252382497,COGS 101C,A01,083625,Delgado; Tania,20,0,30,10
1650252388519,COGS 107A,A01,083627,Boyle; Mary E. T.,1,7,60,59
1650252394545,COGS 118A,A01,083075,Staff,15,0,60,45
1650252400573,CSE 3,A50,083646,Miranda; Gregory Joseph,22,0,38,16
1650252400573,CSE 3,A51,083647,Miranda; Gregory Joseph,37,0,37,0
1650252406597,CSE 8A,A50,083650,Miranda; Gregory Joseph,0,18,40,40
1650252412620,CSE 11,A01,083080,Cao; Yingjun,0,71,40,40
1650252418643,CSE 12,A01,083652,Staff,0,9,100,100
1650252424665,CSE 15L,A01,083654,Staff,0,1,50,50
1650252424665,CSE 15L,A02,083655,Staff,5,0,50,45
1650252430691,CSE 20,A01,083657,Staff,53,0,80,27
1650252436719,CSE 30,A01,083084,Eldon; John,0,71,40,40
1650252442747,CSE 100,A01,083659,Cao; Yingjun,0,64,50,50
1650252448771,CSE 134B,A01,083661,Powell; Thomas Allan,0,27,65,65
1650252454795,CSE 140,A01,083663,Staff,0,0,75,75
1650252460822,CSE 140L,A01,083088,Eldon; John,0,5,75,75
1650252466845,CSE 175,A01,083665,Kumar; Rakesh,8,0,25,17
1650252472871,CSE 190,A00,092507,Dubnov; Shlomo,14,0,20,6
1650252478895,ECE 45,A01,083139,Staff,0,13,40,40
1650252484928,ECE 65,A50,083695,Staff,0,5,30,30
1650252490956,ECE 109,A01,091882,Touri; Behrouz,47,0,70,23
1650252496981,ECE 180,A00,083140,Abi Samra; Nicholas Camill,24,0,30,6
1650252496981,ECE 180,B00,083141,Abi Samra; Nicholas Camill,7,0,30,23
1650252503005,MATH 10A,A01,083735,Patchell; Gregory David,11,0,30,19
1650252503005,MATH 10A,A02,083736,Patchell; Gregory David,28,0,30,2
1650252503005,MATH 10A,A03,083737,Patchell; Gregory David,26,0,30,4
1650252509029,MATH 10B,A01,083207,Staff,0,6,30,30
1650252509029,MATH 10B,A02,083208,Staff,0,5,30,30
1650252509029,MATH 10B,B01,083739,Staff,17,0,30,13
1650252509029,MATH 10B,B02,083740,Staff,29,0,30,1
1650252515058,MATH 18,A01,083743,Staff,7,0,30,23
1650252515058,MATH 18,A02,083744,Staff,28,0,30,2
1650252515058,MATH 18,A03,083745,Staff,23,0,30,7
1650252515058,MATH 18,A04,083746,Staff,27,0,30,3
1650252515058,MATH 18,B01,083748,Staff,0,10,30,30
1650252515058,MATH 18,B02,083749,Staff,0,8,30,30
1650252515058,MATH 18,B03,083750,Staff,0,7,30,30
1650252515058,MATH 18,B04,083751,Staff,0,9,30,30
1650252521083,MATH 20A,A01,083754,Staff,26,0,40,14
1650252527107,MATH 20B,A01,083756,Staff,1,6,30,29
1650252527107,MATH 20B,A02,083757,Staff,0,7,30,30
1650252533133,MATH 20C,A01,083760,Staff,0,12,30,30
1650252533133,MATH 20C,A02,083761,Staff,0,13,30,30
1650252533133,MATH 20C,B01,083762,Staff,14,0,30,16
1650252533133,MATH 20C,B02,083763,Staff,28,0,30,2
1650252539161,MATH 20D,A01,083765,Staff,1,2,30,29
1650252539161,MATH 20D,A02,083766,Staff,8,0,30,22
1650252539161,MATH 20D,A03,083767,Staff,28,0,30,2
1650252545189,MATH 20E,A01,083771,Staff,7,0,30,23
1650252545189,MATH 20E,A02,083772,Staff,20,0,30,10
1650252545189,MATH 20E,B01,083773,Staff,0,0,30,30
1650252545189,MATH 20E,B02,083774,Staff,12,0,30,18
1650252551215,MATH 103A,A01,083777,Staff,0,9,30,30
1650252551215,MATH 103A,A02,083778,Staff,0,10,30,30
1650252551215,MATH 103A,B01,083779,Staff,0,10,30,30
1650252551215,MATH 103A,B02,083780,Staff,0,10,30,30
1650252557240,MATH 105,A01,085443,Staff,0,17,30,30
1650252563262,MATH 109,A01,083213,Anzaldo; Leesa B,0,5,30,30
1650252563262,MATH 109,A02,083214,Anzaldo; Leesa B,0,6,30,30
1650252563262,MATH 109,B01,083215,Anzaldo; Leesa B,0,4,30,30
1650252563262,MATH 109,B02,083216,Anzaldo; Leesa B,1,4,30,29
1650252569286,MATH 142A,A01,083219,Chow; Bennett,0,12,30,30
1650252569286,MATH 142A,A02,083220,Chow; Bennett,0,11,30,30
1650252569286,MATH 142A,B01,083221,Chow; Bennett,0,11,30,30
1650252569286,MATH 142A,B02,083222,Chow; Bennett,0,12,30,30
1650252575321,MATH 193A,A01,083224,Staff,0,5,30,30
1650252575321,MATH 193A,A02,083225,Staff,0,4,30,30
1650252575321,MATH 193A,A03,083781,Staff,0,2,30,30
1650252575321,MATH 193A,A04,083782,Staff,0,1,30,30
1650252581343,MATH 197,001,091859,McAuley; Julian John,9998,0,9999,1
1650252587405,COGS 9,A01,083615,Staff,0,14,60,60
1650252593428,COGS 11,A01,083617,Boyle; Mary E. T.,24,0,40,16
1650252599454,COGS 13,A01,083071,Staff,0,30,40,40
1650252605478,COGS 14A,A01,092681,Staff,1,14,100,99
1650252611502,COGS 14B,A01,083073,Cheng; Tzu-Han,0,8,50,50
1650252617527,COGS 17,A01,092677,Staff,30,0,75,45
1650252623554,COGS 100,A01,083619,Staff,1,21,60,59
1650252629579,COGS 101A,A01,083621,Davis; Joshua Daniel,0,21,60,60
1650252635605,COGS 101B,A01,091572,Staff,4,0,60,56
1650252641632,COGS 101C,A01,083625,Delgado; Tania,20,0,30,10
1650252647656,COGS 107A,A01,083627,Boyle; Mary E. T.,1,7,60,59
1650252653680,COGS 118A,A01,083075,Staff,15,0,60,45
1650252659709,CSE 3,A50,083646,Miranda; Gregory Joseph,22,0,38,16
1650252659709,CSE 3,A51,083647,Miranda; Gregory Joseph,37,0,37,0
1650252665737,CSE 8A,A50,083650,Miranda; Gregory Joseph,0,18,40,40
1650252671762,CSE 11,A01,083080,Cao; Yingjun,0,71,40,40
1650252677788,CSE 12,A01,083652,Staff,0,9,100,100
1650252683811,CSE 15L,A01,083654,Staff,0,1,50,50
1650252683811,CSE 15L,A02,083655,Staff,5,0,50,45
1650252689835,CSE 20,A01,083657,Staff,53,0,80,27
1650252695861,CSE 30,A01,083084,Eldon; John,0,71,40,40
1650252701887,CSE 100,A01,083659,Cao; Yingjun,0,64,50,50
1650252707914,CSE 134B,A01,083661,Powell; Thomas Allan,0,27,65,65
1650252713952,CSE 140,A01,083663,Staff,0,0,75,75
1650252719975,CSE 140L,A01,083088,Eldon; John,0,5,75,75
1650252726006,CSE 175,A01,083665,Kumar; Rakesh,8,0,25,17
1650252732034,CSE 190,A00,092507,Dubnov; Shlomo,14,0,20,6
1650252738058,ECE 45,A01,083139,Staff,0,13,40,40
1650252744093,ECE 65,A50,083695,Staff,0,5,30,30
1650252750118,ECE 109,A01,091882,Touri; Behrouz,47,0,70,23
1650252756145,ECE 180,A00,083140,Abi Samra; Nicholas Camill,24,0,30,6
1650252756145,ECE 180,B00,083141,Abi Samra; Nicholas Camill,7,0,30,23
1650252762169,MATH 10A,A01,083735,Patchell; Gregory David,11,0,30,19
1650252762169,MATH 10A,A02,083736,Patchell; Gregory David,28,0,30,2
1650252762169,MATH 10A,A03,083737,Patchell; Gregory David,26,0,30,4
1650252768199,MATH 10B,A01,083207,Staff,0,6,30,30
1650252768199,MATH 10B,A02,083208,Staff,0,5,30,30
1650252768199,MATH 10B,B01,083739,Staff,17,0,30,13
1650252768199,MATH 10B,B02,083740,Staff,29,0,30,1
1650252774221,MATH 18,A01,083743,Staff,7,0,30,23
1650252774221,MATH 18,A02,083744,Staff,28,0,30,2
1650252774221,MATH 18,A03,083745,Staff,23,0,30,7
1650252774221,MATH 18,A04,083746,Staff,27,0,30,3
1650252774221,MATH 18,B01,083748,Staff,0,10,30,30
1650252774221,MATH 18,B02,083749,Staff,0,8,30,30
1650252774221,MATH 18,B03,083750,Staff,0,7,30,30
1650252774221,MATH 18,B04,083751,Staff,0,9,30,30
1650252780254,MATH 20A,A01,083754,Staff,26,0,40,14
1650252786279,MATH 20B,A01,083756,Staff,1,6,30,29
1650252786279,MATH 20B,A02,083757,Staff,0,7,30,30
1650252792302,MATH 20C,A01,083760,Staff,0,12,30,30
1650252792302,MATH 20C,A02,083761,Staff,0,13,30,30
1650252792302,MATH 20C,B01,083762,Staff,14,0,30,16
1650252792302,MATH 20C,B02,083763,Staff,28,0,30,2
1650252798338,MATH 20D,A01,083765,Staff,1,2,30,29
1650252798338,MATH 20D,A02,083766,Staff,8,0,30,22
1650252798338,MATH 20D,A03,083767,Staff,28,0,30,2
1650252804364,MATH 20E,A01,083771,Staff,7,0,30,23
1650252804364,MATH 20E,A02,083772,Staff,20,0,30,10
1650252804364,MATH 20E,B01,083773,Staff,0,0,30,30
1650252804364,MATH 20E,B02,083774,Staff,12,0,30,18
1650252810394,MATH 103A,A01,083777,Staff,0,9,30,30
1650252810394,MATH 103A,A02,083778,Staff,0,10,30,30
1650252810394,MATH 103A,B01,083779,Staff,0,10,30,30
1650252810394,MATH 103A,B02,083780,Staff,0,10,30,30
1650252816510,MATH 105,A01,085443,Staff,0,17,30,30
1650252822537,MATH 109,A01,083213,Anzaldo; Leesa B,0,5,30,30
1650252822537,MATH 109,A02,083214,Anzaldo; Leesa B,0,6,30,30
1650252822537,MATH 109,B01,083215,Anzaldo; Leesa B,0,4,30,30
1650252822537,MATH 109,B02,083216,Anzaldo; Leesa B,1,4,30,29
1650252828568,MATH 142A,A01,083219,Chow; Bennett,0,12,30,30
1650252828568,MATH 142A,A02,083220,Chow; Bennett,0,11,30,30
1650252828568,MATH 142A,B01,083221,Chow; Bennett,0,11,30,30
1650252828568,MATH 142A,B02,083222,Chow; Bennett,0,12,30,30
1650252834592,MATH 193A,A01,083224,Staff,0,5,30,30
1650252834592,MATH 193A,A02,083225,Staff,0,4,30,30
1650252834592,MATH 193A,A03,083781,Staff,0,2,30,30
1650252834592,MATH 193A,A04,083782,Staff,0,1,30,30
1650252840618,MATH 197,001,091859,McAuley; Julian John,9998,0,9999,1
1650252846667,COGS 9,A01,083615,Staff,0,14,60,60
1650252852690,COGS 11,A01,083617,Boyle; Mary E. T.,24,0,40,16
1650252858715,COGS 13,A01,083071,Staff,0,30,40,40
1650252864738,COGS 14A,A01,092681,Staff,1,14,100,99
1650252870762,COGS 14B,A01,083073,Cheng; Tzu-Han,0,8,50,50
1650252876789,COGS 17,A01,092677,Staff,30,0,75,45
1650252882818,COGS 100,A01,083619,Staff,1,21,60,59
1650252888846,COGS 101A,A01,083621,Davis; Joshua Daniel,0,21,60,60
1650252894873,COGS 101B,A01,091572,Staff,4,0,60,56
1650252900906,COGS 101C,A01,083625,Delgado; Tania,20,0,30,10
1650252906930,COGS 107A,A01,083627,Boyle; Mary E. T.,1,8,60,59
1650252912959,COGS 118A,A01,083075,Staff,15,0,60,45
1650252918984,CSE 3,A50,083646,Miranda; Gregory Joseph,22,0,38,16
1650252918984,CSE 3,A51,083647,Miranda; Gregory Joseph,37,0,37,0
1650252925010,CSE 8A,A50,083650,Miranda; Gregory Joseph,0,18,40,40
1650252931040,CSE 11,A01,083080,Cao; Yingjun,0,71,40,40
1650252937067,CSE 12,A01,083652,Staff,0,9,100,100
1650252943092,CSE 15L,A01,083654,Staff,0,1,50,50
1650252943092,CSE 15L,A02,083655,Staff,5,0,50,45
1650252949139,CSE 20,A01,083657,Staff,53,0,80,27
1650252955161,CSE 30,A01,083084,Eldon; John,0,71,40,40
1650252961206,CSE 100,A01,083659,Cao; Yingjun,0,64,50,50
1650252967232,CSE 134B,A01,083661,Powell; Thomas Allan,0,27,65,65
1650252973254,CSE 140,A01,083663,Staff,0,0,75,75
1650252979280,CSE 140L,A01,083088,Eldon; John,0,5,75,75
1650252985304,CSE 175,A01,083665,Kumar; Rakesh,8,0,25,17
1650252991329,CSE 190,A00,092507,Dubnov; Shlomo,14,0,20,6
1650252997356,ECE 45,A01,083139,Staff,0,13,40,40
1650253003389,ECE 65,A50,083695,Staff,0,5,30,30
1650253009413,ECE 109,A01,091882,Touri; Behrouz,47,0,70,23
1650253015440,ECE 180,A00,083140,Abi Samra; Nicholas Camill,24,0,30,6
1650253015440,ECE 180,B00,083141,Abi Samra; Nicholas Camill,7,0,30,23
1650253021464,MATH 10A,A01,083735,Patchell; Gregory David,11,0,30,19
1650253021464,MATH 10A,A02,083736,Patchell; Gregory David,28,0,30,2
1650253021464,MATH 10A,A03,083737,Patchell; Gregory David,26,0,30,4
1650253027493,MATH 10B,A01,083207,Staff,0,6,30,30
1650253027493,MATH 10B,A02,083208,Staff,0,5,30,30
1650253027493,MATH 10B,B01,083739,Staff,17,0,30,13
1650253027493,MATH 10B,B02,083740,Staff,29,0,30,1
1650253033530,MATH 18,A01,083743,Staff,7,0,30,23
1650253033530,MATH 18,A02,083744,Staff,28,0,30,2
1650253033530,MATH 18,A03,083745,Staff,23,0,30,7
1650253033530,MATH 18,A04,083746,Staff,27,0,30,3
1650253033530,MATH 18,B01,083748,Staff,0,10,30,30
1650253033530,MATH 18,B02,083749,Staff,0,8,30,30
1650253033530,MATH 18,B03,083750,Staff,0,7,30,30
1650253033530,MATH 18,B04,083751,Staff,0,9,30,30
1650253039555,MATH 20A,A01,083754,Staff,26,0,40,14
1650253045579,MATH 20B,A01,083756,Staff,1,6,30,29
1650253045579,MATH 20B,A02,083757,Staff,0,7,30,30
1650253051606,MATH 20C,A01,083760,Staff,0,12,30,30
1650253051606,MATH 20C,A02,083761,Staff,0,13,30,30
1650253051606,MATH 20C,B01,083762,Staff,14,0,30,16
1650253051606,MATH 20C,B02,083763,Staff,28,0,30,2
1650253057629,MATH 20D,A01,083765,Staff,1,2,30,29
1650253057629,MATH 20D,A02,083766,Staff,8,0,30,22
1650253057629,MATH 20D,A03,083767,Staff,28,0,30,2
1650253063652,MATH 20E,A01,083771,Staff,7,0,30,23
1650253063652,MATH 20E,A02,083772,Staff,20,0,30,10
1650253063652,MATH 20E,B01,083773,Staff,0,0,30,30
1650253063652,MATH 20E,B02,083774,Staff,12,0,30,18
1650253069677,MATH 103A,A01,083777,Staff,0,9,30,30
1650253069677,MATH 103A,A02,083778,Staff,0,10,30,30
1650253069677,MATH 103A,B01,083779,Staff,0,10,30,30
1650253069677,MATH 103A,B02,083780,Staff,0,10,30,30
1650253075701,MATH 105,A01,085443,Staff,0,17,30,30
1650253081739,MATH 109,A01,083213,Anzaldo; Leesa B,0,5,30,30
1650253081739,MATH 109,A02,083214,Anzaldo; Leesa B,0,6,30,30
1650253081739,MATH 109,B01,083215,Anzaldo; Leesa B,0,4,30,30
1650253081739,MATH 109,B02,083216,Anzaldo; Leesa B,1,4,30,29
1650253087768,MATH 142A,A01,083219,Chow; Bennett,0,12,30,30
1650253087768,MATH 142A,A02,083220,Chow; Bennett,0,11,30,30
1650253087768,MATH 142A,B01,083221,Chow; Bennett,0,11,30,30
1650253087768,MATH 142A,B02,083222,Chow; Bennett,0,12,30,30
1650253093801,MATH 193A,A01,083224,Staff,0,5,30,30
1650253093801,MATH 193A,A02,083225,Staff,0,4,30,30
1650253093801,MATH 193A,A03,083781,Staff,0,2,30,30
1650253093801,MATH 193A,A04,083782,Staff,0,1,30,30
1650253099824,MATH 197,001,091859,McAuley; Julian John,9998,0,9999,1
1650253105876,COGS 9,A01,083615,Staff,0,14,60,60
1650253111903,COGS 11,A01,083617,Boyle; Mary E. T.,24,0,40,16
1650253117932,COGS 13,A01,083071,Staff,0,30,40,40
1650253123960,COGS 14A,A01,092681,Staff,1,14,100,99
1650253129984,COGS 14B,A01,083073,Cheng; Tzu-Han,0,8,50,50
1650253136006,COGS 17,A01,092677,Staff,30,0,75,45
1650253142036,COGS 100,A01,083619,Staff,1,21,60,59
1650253148074,COGS 101A,A01,083621,Davis; Joshua Daniel,0,21,60,60
1650253154100,COGS 101B,A01,091572,Staff,4,0,60,56
1650253160141,COGS 101C,A01,083625,Delgado; Tania,20,0,30,10
1650253166165,COGS 107A,A01,083627,Boyle; Mary E. T.,1,8,60,59
1650253172191,COGS 118A,A01,083075,Staff,15,0,60,45
1650253178218,CSE 3,A50,083646,Miranda; Gregory Joseph,22,0,38,16
1650253178218,CSE 3,A51,083647,Miranda; Gregory Joseph,37,0,37,0
1650253184241,CSE 8A,A50,083650,Miranda; Gregory Joseph,0,18,40,40
1650253190269,CSE 11,A01,083080,Cao; Yingjun,0,71,40,40
1650253196296,CSE 12,A01,083652,Staff,0,9,100,100
1650253202322,CSE 15L,A01,083654,Staff,0,1,50,50
1650253202322,CSE 15L,A02,083655,Staff,5,0,50,45
1650253208345,CSE 20,A01,083657,Staff,53,0,80,27
1650253214368,CSE 30,A01,083084,Eldon; John,0,71,40,40
1650253220392,CSE 100,A01,083659,Cao; Yingjun,0,64,50,50
1650253226426,CSE 134B,A01,083661,Powell; Thomas Allan,0,27,65,65
1650253232448,CSE 140,A01,083663,Staff,0,0,75,75
1650253238476,CSE 140L,A01,083088,Eldon; John,0,5,75,75
1650253244500,CSE 175,A01,083665,Kumar; Rakesh,8,0,25,17
1650253250535,CSE 190,A00,092507,Dubnov; Shlomo,14,0,20,6
1650253256563,ECE 45,A01,083139,Staff,0,13,40,40
1650253262587,ECE 65,A50,083695,Staff,0,5,30,30
1650253268621,ECE 109,A01,091882,Touri; Behrouz,47,0,70,23
1650253274647,ECE 180,A00,083140,Abi Samra; Nicholas Camill,24,0,30,6
1650253274647,ECE 180,B00,083141,Abi Samra; Nicholas Camill,7,0,30,23
1650253280674,MATH 10A,A01,083735,Patchell; Gregory David,11,0,30,19
1650253280674,MATH 10A,A02,083736,Patchell; Gregory David,28,0,30,2
1650253280674,MATH 10A,A03,083737,Patchell; Gregory David,26,0,30,4
1650253286701,MATH 10B,A01,083207,Staff,0,6,30,30
1650253286701,MATH 10B,A02,083208,Staff,0,5,30,30
1650253286701,MATH 10B,B01,083739,Staff,17,0,30,13
1650253286701,MATH 10B,B02,083740,Staff,29,0,30,1
1650253292732,MATH 18,A01,083743,Staff,7,0,30,23
1650253292732,MATH 18,A02,083744,Staff,28,0,30,2
1650253292732,MATH 18,A03,083745,Staff,23,0,30,7
1650253292732,MATH 18,A04,083746,Staff,27,0,30,3
1650253292732,MATH 18,B01,083748,Staff,0,10,30,30
1650253292732,MATH 18,B02,083749,Staff,0,8,30,30
1650253292732,MATH 18,B03,083750,Staff,1,7,30,29
1650253292732,MATH 18,B04,083751,Staff,0,9,30,30
1650253298768,MATH 20A,A01,083754,Staff,26,0,40,14
1650253304792,MATH 20B,A01,083756,Staff,1,6,30,29
1650253304792,MATH 20B,A02,083757,Staff,0,7,30,30
1650253310829,MATH 20C,A01,083760,Staff,0,12,30,30
1650253310829,MATH 20C,A02,083761,Staff,0,13,30,30
1650253310829,MATH 20C,B01,083762,Staff,14,0,30,16
1650253310829,MATH 20C,B02,083763,Staff,28,0,30,2
1650253316852,MATH 20D,A01,083765,Staff,1,2,30,29
1650253316852,MATH 20D,A02,083766,Staff,8,0,30,22
1650253316852,MATH 20D,A03,083767,Staff,28,0,30,2
1650253322875,MATH 20E,A01,083771,Staff,7,0,30,23
1650253322875,MATH 20E,A02,083772,Staff,20,0,30,10
1650253322875,MATH 20E,B01,083773,Staff,0,0,30,30
1650253322875,MATH 20E,B02,083774,Staff,12,0,30,18
1650253328899,MATH 103A,A01,083777,Staff,0,9,30,30
1650253328899,MATH 103A,A02,083778,Staff,0,10,30,30
1650253328899,MATH 103A,B01,083779,Staff,0,10,30,30
1650253328899,MATH 103A,B02,083780,Staff,0,10,30,30
1650253334923,MATH 105,A01,085443,Staff,0,17,30,30
1650253340951,MATH 109,A01,083213,Anzaldo; Leesa B,0,5,30,30
1650253340951,MATH 109,A02,083214,Anzaldo; Leesa B,0,6,30,30
1650253340951,MATH 109,B01,083215,Anzaldo; Leesa B,0,4,30,30
1650253340951,MATH 109,B02,083216,Anzaldo; Leesa B,1,4,30,29
1650253346976,MATH 142A,A01,083219,Chow; Bennett,0,12,30,30
1650253346976,MATH 142A,A02,083220,Chow; Bennett,0,11,30,30
1650253346976,MATH 142A,B01,083221,Chow; Bennett,0,11,30,30
1650253346976,MATH 142A,B02,083222,Chow; Bennett,0,12,30,30
1650253352998,MATH 193A,A01,083224,Staff,0,5,30,30
1650253352998,MATH 193A,A02,083225,Staff,0,4,30,30
1650253352998,MATH 193A,A03,083781,Staff,0,2,30,30
1650253352998,MATH 193A,A04,083782,Staff,0,1,30,30
1650253359022,MATH 197,001,091859,McAuley; Julian John,9998,0,9999,1
1650253365070,COGS 9,A01,083615,Staff,0,14,60,60
1650253371095,COGS 11,A01,083617,Boyle; Mary E. T.,24,0,40,16
1650253377128,COGS 13,A01,083071,Staff,0,30,40,40
1650253383151,COGS 14A,A01,092681,Staff,1,14,100,99
1650253389177,COGS 14B,A01,083073,Cheng; Tzu-Han,0,8,50,50
1650253395200,COGS 17,A01,092677,Staff,30,0,75,45
1650253401222,COGS 100,A01,083619,Staff,1,21,60,59
1650253407333,COGS 101A,A01,083621,Davis; Joshua Daniel,0,21,60,60
1650253413354,COGS 101B,A01,091572,Staff,4,0,60,56
1650253419389,COGS 101C,A01,083625,Delgado; Tania,20,0,30,10
1650253425415,COGS 107A,A01,083627,Boyle; Mary E. T.,1,8,60,59
1650253431449,COGS 118A,A01,083075,Staff,15,0,60,45
1650253437472,CSE 3,A50,083646,Miranda; Gregory Joseph,22,0,38,16
1650253437472,CSE 3,A51,083647,Miranda; Gregory Joseph,37,0,37,0
1650253443494,CSE 8A,A50,083650,Miranda; Gregory Joseph,0,18,40,40
1650253449519,CSE 11,A01,083080,Cao; Yingjun,0,71,40,40
1650253455541,CSE 12,A01,083652,Staff,0,9,100,100
1650253461565,CSE 15L,A01,083654,Staff,0,1,50,50
1650253461565,CSE 15L,A02,083655,Staff,5,0,50,45
1650253467588,CSE 20,A01,083657,Staff,53,0,80,27
1650253473611,CSE 30,A01,083084,Eldon; John,0,71,40,40
1650253479633,CSE 100,A01,083659,Cao; Yingjun,0,64,50,50
1650253485670,CSE 134B,A01,083661,Powell; Thomas Allan,0,27,65,65
1650253491693,CSE 140,A01,083663,Staff,0,0,75,75
1650253497716,CSE 140L,A01,083088,Eldon; John,0,5,75,75
1650253503744,CSE 175,A01,083665,Kumar; Rakesh,8,0,25,17
1650253509766,CSE 190,A00,092507,Dubnov; Shlomo,14,0,20,6
1650253515796,ECE 45,A01,083139,Staff,0,13,40,40
1650253521818,ECE 65,A50,083695,Staff,0,5,30,30
1650253527842,ECE 109,A01,091882,Touri; Behrouz,47,0,70,23
1650253533865,ECE 180,A00,083140,Abi Samra; Nicholas Camill,24,0,30,6
1650253533865,ECE 180,B00,083141,Abi Samra; Nicholas Camill,7,0,30,23
1650253539887,MATH 10A,A01,083735,Patchell; Gregory David,11,0,30,19
1650253539887,MATH 10A,A02,083736,Patchell; Gregory David,28,0,30,2
1650253539887,MATH 10A,A03,083737,Patchell; Gregory David,26,0,30,4
1650253545910,MATH 10B,A01,083207,Staff,0,6,30,30
1650253545910,MATH 10B,A02,083208,Staff,0,5,30,30
1650253545910,MATH 10B,B01,083739,Staff,17,0,30,13
1650253545910,MATH 10B,B02,083740,Staff,29,0,30,1
1650253551940,MATH 18,A01,083743,Staff,7,0,30,23
1650253551940,MATH 18,A02,083744,Staff,28,0,30,2
1650253551940,MATH 18,A03,083745,Staff,23,0,30,7
1650253551940,MATH 18,A04,083746,Staff,27,0,30,3
1650253551940,MATH 18,B01,083748,Staff,0,10,30,30
1650253551940,MATH 18,B02,083749,Staff,0,8,30,30
1650253551940,MATH 18,B03,083750,Staff,1,7,30,29
1650253551940,MATH 18,B04,083751,Staff,0,9,30,30
1650253557963,MATH 20A,A01,083754,Staff,26,0,40,14
1650253563985,MATH 20B,A01,083756,Staff,1,6,30,29
1650253563985,MATH 20B,A02,083757,Staff,0,7,30,30
1650253570010,MATH 20C,A01,083760,Staff,0,12,30,30
1650253570010,MATH 20C,A02,083761,Staff,0,13,30,30
1650253570010,MATH 20C,B01,083762,Staff,14,0,30,16
1650253570010,MATH 20C,B02,083763,Staff,28,0,30,2
1650253576034,MATH 20D,A01,083765,Staff,1,2,30,29
1650253576034,MATH 20D,A02,083766,Staff,8,0,30,22
1650253576034,MATH 20D,A03,083767,Staff,28,0,30,2
1650253582063,MATH 20E,A01,083771,Staff,7,0,30,23
1650253582063,MATH 20E,A02,083772,Staff,20,0,30,10
1650253582063,MATH 20E,B01,083773,Staff,0,0,30,30
1650253582063,MATH 20E,B02,083774,Staff,12,0,30,18
1650253588092,MATH 103A,A01,083777,Staff,0,9,30,30
1650253588092,MATH 103A,A02,083778,Staff,0,10,30,30
1650253588092,MATH 103A,B01,083779,Staff,0,10,30,30
1650253588092,MATH 103A,B02,083780,Staff,0,10,30,30
1650253594118,MATH 105,A01,085443,Staff,0,17,30,30
1650253600148,MATH 109,A01,083213,Anzaldo; Leesa B,0,5,30,30
1650253600148,MATH 109,A02,083214,Anzaldo; Leesa B,0,6,30,30
1650253600148,MATH 109,B01,083215,Anzaldo; Leesa B,0,4,30,30
1650253600148,MATH 109,B02,083216,Anzaldo; Leesa B,1,4,30,29
1650253606182,MATH 142A,A01,083219,Chow; Bennett,0,12,30,30
1650253606182,MATH 142A,A02,083220,Chow; Bennett,0,11,30,30
1650253606182,MATH 142A,B01,083221,Chow; Bennett,0,11,30,30
1650253606182,MATH 142A,B02,083222,Chow; Bennett,0,12,30,30
1650253612209,MATH 193A,A01,083224,Staff,0,5,30,30
1650253612209,MATH 193A,A02,083225,Staff,0,4,30,30
1650253612209,MATH 193A,A03,083781,Staff,0,2,30,30
1650253612209,MATH 193A,A04,083782,Staff,0,1,30,30
1650253618229,MATH 197,001,091859,McAuley; Julian John,9998,0,9999,1
1650253624278,COGS 9,A01,083615,Staff,0,14,60,60
1650253630300,COGS 11,A01,083617,Boyle; Mary E. T.,24,0,40,16
1650253636326,COGS 13,A01,083071,Staff,0,30,40,40
1650253642349,COGS 14A,A01,092681,Staff,1,14,100,99
1650253648373,COGS 14B,A01,083073,Cheng; Tzu-Han,0,8,50,50
1650253654397,COGS 17,A01,092677,Staff,30,0,75,45
1650253660428,COGS 100,A01,083619,Staff,1,21,60,59
1650253666462,COGS 101A,A01,083621,Davis; Joshua Daniel,0,21,60,60
1650253672487,COGS 101B,A01,091572,Staff,4,0,60,56
1650253678508,COGS 101C,A01,083625,Delgado; Tania,20,0,30,10
1650253684531,COGS 107A,A01,083627,Boyle; Mary E. T.,1,8,60,59
1650253690556,COGS 118A,A01,083075,Staff,15,0,60,45
1650253696579,CSE 3,A50,083646,Miranda; Gregory Joseph,22,0,38,16
1650253696579,CSE 3,A51,083647,Miranda; Gregory Joseph,37,0,37,0
1650253702607,CSE 8A,A50,083650,Miranda; Gregory Joseph,0,18,40,40
1650253708634,CSE 11,A01,083080,Cao; Yingjun,0,71,40,40
1650253714657,CSE 12,A01,083652,Staff,0,9,100,100
1650253720682,CSE 15L,A01,083654,Staff,0,1,50,50
1650253720682,CSE 15L,A02,083655,Staff,5,0,50,45
1650253726708,CSE 20,A01,083657,Staff,53,0,80,27
1650253732742,CSE 30,A01,083084,Eldon; John,0,71,40,40
1650253738767,CSE 100,A01,083659,Cao; Yingjun,0,64,50,50
1650253744790,CSE 134B,A01,083661,Powell; Thomas Allan,0,27,65,65
1650253750813,CSE 140,A01,083663,Staff,0,0,75,75
1650253756840,CSE 140L,A01,083088,Eldon; John,0,5,75,75
1650253762863,CSE 175,A01,083665,Kumar; Rakesh,8,0,25,17
1650253768886,CSE 190,A00,092507,Dubnov; Shlomo,14,0,20,6
1650253774909,ECE 45,A01,083139,Staff,0,13,40,40
1650253780936,ECE 65,A50,083695,Staff,0,5,30,30
1650253786967,ECE 109,A01,091882,Touri; Behrouz,47,0,70,23
1650253792991,ECE 180,A00,083140,Abi Samra; Nicholas Camill,24,0,30,6
1650253792991,ECE 180,B00,083141,Abi Samra; Nicholas Camill,7,0,30,23
1650253799019,MATH 10A,A01,083735,Patchell; Gregory David,11,0,30,19
1650253799019,MATH 10A,A02,083736,Patchell; Gregory David,28,0,30,2
1650253799019,MATH 10A,A03,083737,Patchell; Gregory David,26,0,30,4
1650253805051,MATH 10B,A01,083207,Staff,0,6,30,30
1650253805051,MATH 10B,A02,083208,Staff,0,5,30,30
1650253805051,MATH 10B,B01,083739,Staff,17,0,30,13
1650253805051,MATH 10B,B02,083740,Staff,29,0,30,1
1650253811079,MATH 18,A01,083743,Staff,7,0,30,23
1650253811079,MATH 18,A02,083744,Staff,28,0,30,2
1650253811079,MATH 18,A03,083745,Staff,23,0,30,7
1650253811079,MATH 18,A04,083746,Staff,27,0,30,3
1650253811079,MATH 18,B01,083748,Staff,0,10,30,30
1650253811079,MATH 18,B02,083749,Staff,0,8,30,30
1650253811079,MATH 18,B03,083750,Staff,1,7,30,29
1650253811079,MATH 18,B04,083751,Staff,0,9,30,30
1650253817103,MATH 20A,A01,083754,Staff,26,0,40,14
1650253823130,MATH 20B,A01,083756,Staff,1,6,30,29
1650253823130,MATH 20B,A02,083757,Staff,0,7,30,30
1650253829153,MATH 20C,A01,083760,Staff,0,12,30,30
1650253829153,MATH 20C,A02,083761,Staff,0,13,30,30
1650253829153,MATH 20C,B01,083762,Staff,14,0,30,16
1650253829153,MATH 20C,B02,083763,Staff,28,0,30,2
1650253835178,MATH 20D,A01,083765,Staff,1,2,30,29
1650253835178,MATH 20D,A02,083766,Staff,8,0,30,22
1650253835178,MATH 20D,A03,083767,Staff,28,0,30,2
1650253841202,MATH 20E,A01,083771,Staff,7,0,30,23
1650253841202,MATH 20E,A02,083772,Staff,20,0,30,10
1650253841202,MATH 20E,B01,083773,Staff,0,0,30,30
1650253841202,MATH 20E,B02,083774,Staff,12,0,30,18
1650253847232,MATH 103A,A01,083777,Staff,0,9,30,30
1650253847232,MATH 103A,A02,083778,Staff,0,10,30,30
1650253847232,MATH 103A,B01,083779,Staff,0,10,30,30
1650253847232,MATH 103A,B02,083780,Staff,0,10,30,30
1650253853256,MATH 105,A01,085443,Staff,0,17,30,30
1650253859296,MATH 109,A01,083213,Anzaldo; Leesa B,0,5,30,30
1650253859296,MATH 109,A02,083214,Anzaldo; Leesa B,0,6,30,30
1650253859296,MATH 109,B01,083215,Anzaldo; Leesa B,0,4,30,30
1650253859296,MATH 109,B02,083216,Anzaldo; Leesa B,1,4,30,29
1650253865326,MATH 142A,A01,083219,Chow; Bennett,0,12,30,30
1650253865326,MATH 142A,A02,083220,Chow; Bennett,0,11,30,30
1650253865326,MATH 142A,B01,083221,Chow; Bennett,0,11,30,30
1650253865326,MATH 142A,B02,083222,Chow; Bennett,0,12,30,30
1650253871353,MATH 193A,A01,083224,Staff,0,5,30,30
1650253871353,MATH 193A,A02,083225,Staff,0,4,30,30
1650253871353,MATH 193A,A03,083781,Staff,0,2,30,30
1650253871353,MATH 193A,A04,083782,Staff,0,1,30,30
1650253877377,MATH 197,001,091859,McAuley; Julian John,9998,0,9999,1
1650253883427,COGS 9,A01,083615,Staff,0,14,60,60
1650253889452,COGS 11,A01,083617,Boyle; Mary E. T.,24,0,40,16
1650253895477,COGS 13,A01,083071,Staff,0,30,40,40
1650253901500,COGS 14A,A01,092681,Staff,1,14,100,99
1650253907529,COGS 14B,A01,083073,Cheng; Tzu-Han,0,8,50,50
1650253913557,COGS 17,A01,092677,Staff,30,0,75,45
1650253919586,COGS 100,A01,083619,Staff,1,21,60,59
1650253925613,COGS 101A,A01,083621,Davis; Joshua Daniel,0,21,60,60
1650253931638,COGS 101B,A01,091572,Staff,4,0,60,56
1650253937661,COGS 101C,A01,083625,Delgado; Tania,20,0,30,10
1650253943685,COGS 107A,A01,083627,Boyle; Mary E. T.,1,8,60,59
1650253949709,COGS 118A,A01,083075,Staff,15,0,60,45
1650253955737,CSE 3,A50,083646,Miranda; Gregory Joseph,22,0,38,16
1650253955737,CSE 3,A51,083647,Miranda; Gregory Joseph,37,0,37,0
1650253961761,CSE 8A,A50,083650,Miranda; Gregory Joseph,0,18,40,40
1650253967785,CSE 11,A01,083080,Cao; Yingjun,0,71,40,40
1650253973812,CSE 12,A01,083652,Staff,0,9,100,100
1650253979835,CSE 15L,A01,083654,Staff,0,1,50,50
1650253979835,CSE 15L,A02,083655,Staff,5,0,50,45
1650253985865,CSE 20,A01,083657,Staff,53,0,80,27
1650253991900,CSE 30,A01,083084,Eldon; John,0,71,40,40
1650253997927,CSE 100,A01,083659,Cao; Yingjun,0,64,50,50
1650254004039,CSE 134B,A01,083661,Powell; Thomas Allan,0,27,65,65
1650254010063,CSE 140,A01,083663,Staff,0,0,75,75
1650254016086,CSE 140L,A01,083088,Eldon; John,0,5,75,75
1650254022111,CSE 175,A01,083665,Kumar; Rakesh,8,0,25,17
1650254028134,CSE 190,A00,092507,Dubnov; Shlomo,14,0,20,6
1650254034158,ECE 45,A01,083139,Staff,0,13,40,40
1650254040180,ECE 65,A50,083695,Staff,0,5,30,30
1650254046207,ECE 109,A01,091882,Touri; Behrouz,47,0,70,23
1650254052230,ECE 180,A00,083140,Abi Samra; Nicholas Camill,24,0,30,6
1650254052230,ECE 180,B00,083141,Abi Samra; Nicholas Camill,7,0,30,23
1650254058258,MATH 10A,A01,083735,Patchell; Gregory David,11,0,30,19
1650254058258,MATH 10A,A02,083736,Patchell; Gregory David,28,0,30,2
1650254058258,MATH 10A,A03,083737,Patchell; Gregory David,26,0,30,4
1650254064281,MATH 10B,A01,083207,Staff,0,6,30,30
1650254064281,MATH 10B,A02,083208,Staff,0,5,30,30
1650254064281,MATH 10B,B01,083739,Staff,17,0,30,13
1650254064281,MATH 10B,B02,083740,Staff,29,0,30,1
1650254070311,MATH 18,A01,083743,Staff,7,0,30,23
1650254070311,MATH 18,A02,083744,Staff,28,0,30,2
1650254070311,MATH 18,A03,083745,Staff,23,0,30,7
1650254070311,MATH 18,A04,083746,Staff,27,0,30,3
1650254070311,MATH 18,B01,083748,Staff,0,10,30,30
1650254070311,MATH 18,B02,083749,Staff,0,8,30,30
1650254070311,MATH 18,B03,083750,Staff,1,7,30,29
1650254070311,MATH 18,B04,083751,Staff,0,9,30,30
1650254076335,MATH 20A,A01,083754,Staff,26,0,40,14
1650254082365,MATH 20B,A01,083756,Staff,1,6,30,29
1650254082365,MATH 20B,A02,083757,Staff,0,7,30,30
1650254088396,MATH 20C,A01,083760,Staff,0,12,30,30
1650254088396,MATH 20C,A02,083761,Staff,0,13,30,30
1650254088396,MATH 20C,B01,083762,Staff,14,0,30,16
1650254088396,MATH 20C,B02,083763,Staff,28,0,30,2
1650254094422,MATH 20D,A01,083765,Staff,1,2,30,29
1650254094422,MATH 20D,A02,083766,Staff,8,0,30,22
1650254094422,MATH 20D,A03,083767,Staff,28,0,30,2
1650254100459,MATH 20E,A01,083771,Staff,7,0,30,23
1650254100459,MATH 20E,A02,083772,Staff,20,0,30,10
1650254100459,MATH 20E,B01,083773,Staff,0,0,30,30
1650254100459,MATH 20E,B02,083774,Staff,12,0,30,18
1650254106486,MATH 103A,A01,083777,Staff,0,9,30,30
1650254106486,MATH 103A,A02,083778,Staff,0,10,30,30
1650254106486,MATH 103A,B01,083779,Staff,0,10,30,30
1650254106486,MATH 103A,B02,083780,Staff,0,10,30,30
1650254112513,MATH 105,A01,085443,Staff,0,17,30,30
1650254118540,MATH 109,A01,083213,Anzaldo; Leesa B,0,5,30,30
1650254118540,MATH 109,A02,083214,Anzaldo; Leesa B,0,6,30,30
1650254118540,MATH 109,B01,083215,Anzaldo; Leesa B,0,4,30,30
1650254118540,MATH 109,B02,083216,Anzaldo; Leesa B,1,4,30,29
1650254124572,MATH 142A,A01,083219,Chow; Bennett,0,12,30,30
1650254124572,MATH 142A,A02,083220,Chow; Bennett,0,11,30,30
1650254124572,MATH 142A,B01,083221,Chow; Bennett,0,11,30,30
1650254124572,MATH 142A,B02,083222,Chow; Bennett,0,12,30,30
1650254130599,MATH 193A,A01,083224,Staff,0,5,30,30
1650254130599,MATH 193A,A02,083225,Staff,0,4,30,30
1650254130599,MATH 193A,A03,083781,Staff,0,2,30,30
1650254130599,MATH 193A,A04,083782,Staff,0,1,30,30
1650254136625,MATH 197,001,091859,McAuley; Julian John,9998,0,9999,1
1650254142705,COGS 9,A01,083615,Staff,0,14,60,60
1650254148732,COGS 11,A01,083617,Boyle; Mary E. T.,24,0,40,16
1650254154756,COGS 13,A01,083071,Staff,0,30,40,40
1650254160780,COGS 14A,A01,092681,Staff,1,14,100,99
1650254166807,COGS 14B,A01,083073,Cheng; Tzu-Han,0,8,50,50
1650254172832,COGS 17,A01,092677,Staff,30,0,75,45
1650254178865,COGS 100,A01,083619,Staff,1,21,60,59
1650254184896,COGS 101A,A01,083621,Davis; Joshua Daniel,0,21,60,60
1650254190922,COGS 101B,A01,091572,Staff,4,0,60,56
1650254196953,COGS 101C,A01,083625,Delgado; Tania,20,0,30,10
1650254202980,COGS 107A,A01,083627,Boyle; Mary E. T.,1,8,60,59
1650254209007,COGS 118A,A01,083075,Staff,15,0,60,45
1650254215032,CSE 3,A50,083646,Miranda; Gregory Joseph,22,0,38,16
1650254215032,CSE 3,A51,083647,Miranda; Gregory Joseph,37,0,37,0
1650254221058,CSE 8A,A50,083650,Miranda; Gregory Joseph,0,18,40,40
1650254227083,CSE 11,A01,083080,Cao; Yingjun,0,71,40,40
1650254233132,CSE 12,A01,083652,Staff,0,9,100,100
1650254239158,CSE 15L,A01,083654,Staff,0,1,50,50
1650254239158,CSE 15L,A02,083655,Staff,5,0,50,45
1650254245182,CSE 20,A01,083657,Staff,53,0,80,27
1650254251215,CSE 30,A01,083084,Eldon; John,0,71,40,40
1650254257239,CSE 100,A01,083659,Cao; Yingjun,0,64,50,50
1650254263261,CSE 134B,A01,083661,Powell; Thomas Allan,0,27,65,65
1650254269289,CSE 140,A01,083663,Staff,0,0,75,75
1650254275312,CSE 140L,A01,083088,Eldon; John,0,5,75,75
1650254281355,CSE 175,A01,083665,Kumar; Rakesh,8,0,25,17
1650254287382,CSE 190,A00,092507,Dubnov; Shlomo,14,0,20,6
1650254293409,ECE 45,A01,083139,Staff,0,13,40,40
1650254299435,ECE 65,A50,083695,Staff,0,5,30,30
1650254305459,ECE 109,A01,091882,Touri; Behrouz,47,0,70,23
1650254311486,ECE 180,A00,083140,Abi Samra; Nicholas Camill,24,0,30,6
1650254311486,ECE 180,B00,083141,Abi Samra; Nicholas Camill,7,0,30,23
1650254317510,MATH 10A,A01,083735,Patchell; Gregory David,11,0,30,19
1650254317510,MATH 10A,A02,083736,Patchell; Gregory David,28,0,30,2
1650254317510,MATH 10A,A03,083737,Patchell; Gregory David,26,0,30,4
1650254323531,MATH 10B,A01,083207,Staff,0,6,30,30
1650254323531,MATH 10B,A02,083208,Staff,0,5,30,30
1650254323531,MATH 10B,B01,083739,Staff,17,0,30,13
1650254323531,MATH 10B,B02,083740,Staff,29,0,30,1
1650254329557,MATH 18,A01,083743,Staff,7,0,30,23
1650254329557,MATH 18,A02,083744,Staff,28,0,30,2
1650254329557,MATH 18,A03,083745,Staff,23,0,30,7
1650254329557,MATH 18,A04,083746,Staff,27,0,30,3
1650254329557,MATH 18,B01,083748,Staff,0,10,30,30
1650254329557,MATH 18,B02,083749,Staff,0,8,30,30
1650254329557,MATH 18,B03,083750,Staff,1,7,30,29
1650254329557,MATH 18,B04,083751,Staff,0,9,30,30
1650254335583,MATH 20A,A01,083754,Staff,26,0,40,14
1650254341606,MATH 20B,A01,083756,Staff,1,6,30,29
1650254341606,MATH 20B,A02,083757,Staff,0,7,30,30
1650254347632,MATH 20C,A01,083760,Staff,0,12,30,30
1650254347632,MATH 20C,A02,083761,Staff,0,13,30,30
1650254347632,MATH 20C,B01,083762,Staff,14,0,30,16
1650254347632,MATH 20C,B02,083763,Staff,28,0,30,2
1650254353655,MATH 20D,A01,083765,Staff,1,2,30,29
1650254353655,MATH 20D,A02,083766,Staff,8,0,30,22
1650254353655,MATH 20D,A03,083767,Staff,28,0,30,2
1650254359679,MATH 20E,A01,083771,Staff,7,0,30,23
1650254359679,MATH 20E,A02,083772,Staff,20,0,30,10
1650254359679,MATH 20E,B01,083773,Staff,0,0,30,30
1650254359679,MATH 20E,B02,083774,Staff,12,0,30,18
1650254365703,MATH 103A,A01,083777,Staff,0,9,30,30
1650254365703,MATH 103A,A02,083778,Staff,0,10,30,30
1650254365703,MATH 103A,B01,083779,Staff,0,10,30,30
1650254365703,MATH 103A,B02,083780,Staff,0,10,30,30
1650254371729,MATH 105,A01,085443,Staff,0,17,30,30
1650254377762,MATH 109,A01,083213,Anzaldo; Leesa B,0,5,30,30
1650254377762,MATH 109,A02,083214,Anzaldo; Leesa B,0,6,30,30
1650254377762,MATH 109,B01,083215,Anzaldo; Leesa B,0,4,30,30
1650254377762,MATH 109,B02,083216,Anzaldo; Leesa B,1,4,30,29
1650254383784,MATH 142A,A01,083219,Chow; Bennett,0,12,30,30
1650254383784,MATH 142A,A02,083220,Chow; Bennett,0,11,30,30
1650254383784,MATH 142A,B01,083221,Chow; Bennett,0,11,30,30
1650254383784,MATH 142A,B02,083222,Chow; Bennett,0,12,30,30
1650254389808,MATH 193A,A01,083224,Staff,0,5,30,30
1650254389808,MATH 193A,A02,083225,Staff,0,4,30,30
1650254389808,MATH 193A,A03,083781,Staff,0,2,30,30
1650254389808,MATH 193A,A04,083782,Staff,0,1,30,30
1650254395833,MATH 197,001,091859,McAuley; Julian John,9998,0,9999,1
1650254401884,COGS 9,A01,083615,Staff,0,14,60,60
1650254407907,COGS 11,A01,083617,Boyle; Mary E. T.,24,0,40,16
1650254413934,COGS 13,A01,083071,Staff,0,30,40,40
1650254419958,COGS 14A,A01,092681,Staff,1,14,100,99
1650254425981,COGS 14B,A01,083073,Cheng; Tzu-Han,0,9,50,50
1650254432009,COGS 17,A01,092677,Staff,30,0,75,45
1650254438034,COGS 100,A01,083619,Staff,1,21,60,59
1650254444062,COGS 101A,A01,083621,Davis; Joshua Daniel,0,21,60,60
1650254450087,COGS 101B,A01,091572,Staff,4,0,60,56
1650254456111,COGS 101C,A01,083625,Delgado; Tania,20,0,30,10
1650254462135,COGS 107A,A01,083627,Boyle; Mary E. T.,1,8,60,59
1650254468160,COGS 118A,A01,083075,Staff,15,0,60,45
1650254474187,CSE 3,A50,083646,Miranda; Gregory Joseph,22,0,38,16
1650254474187,CSE 3,A51,083647,Miranda; Gregory Joseph,37,0,37,0
1650254480215,CSE 8A,A50,083650,Miranda; Gregory Joseph,0,18,40,40
1650254486240,CSE 11,A01,083080,Cao; Yingjun,0,71,40,40
1650254492266,CSE 12,A01,083652,Staff,0,9,100,100
1650254498290,CSE 15L,A01,083654,Staff,0,1,50,50
1650254498290,CSE 15L,A02,083655,Staff,5,0,50,45
1650254504313,CSE 20,A01,083657,Staff,53,0,80,27
1650254510340,CSE 30,A01,083084,Eldon; John,0,71,40,40
1650254516364,CSE 100,A01,083659,Cao; Yingjun,0,64,50,50
1650254522389,CSE 134B,A01,083661,Powell; Thomas Allan,0,27,65,65
1650254528414,CSE 140,A01,083663,Staff,0,0,75,75
1650254534441,CSE 140L,A01,083088,Eldon; John,0,5,75,75
1650254540468,CSE 175,A01,083665,Kumar; Rakesh,8,0,25,17
1650254546496,CSE 190,A00,092507,Dubnov; Shlomo,14,0,20,6
1650254552523,ECE 45,A01,083139,Staff,0,13,40,40
1650254558547,ECE 65,A50,083695,Staff,0,5,30,30
1650254564572,ECE 109,A01,091882,Touri; Behrouz,47,0,70,23
1650254570600,ECE 180,A00,083140,Abi Samra; Nicholas Camill,24,0,30,6
1650254570600,ECE 180,B00,083141,Abi Samra; Nicholas Camill,7,0,30,23
1650254576661,MATH 10A,A01,083735,Patchell; Gregory David,11,0,30,19
1650254576661,MATH 10A,A02,083736,Patchell; Gregory David,28,0,30,2
1650254576661,MATH 10A,A03,083737,Patchell; Gregory David,26,0,30,4
1650254582691,MATH 10B,A01,083207,Staff,0,6,30,30
1650254582691,MATH 10B,A02,083208,Staff,0,5,30,30
1650254582691,MATH 10B,B01,083739,Staff,17,0,30,13
1650254582691,MATH 10B,B02,083740,Staff,29,0,30,1
1650254588718,MATH 18,A01,083743,Staff,7,0,30,23
1650254588718,MATH 18,A02,083744,Staff,28,0,30,2
1650254588718,MATH 18,A03,083745,Staff,23,0,30,7
1650254588718,MATH 18,A04,083746,Staff,27,0,30,3
1650254588718,MATH 18,B01,083748,Staff,0,10,30,30
1650254588718,MATH 18,B02,083749,Staff,0,8,30,30
1650254588718,MATH 18,B03,083750,Staff,1,7,30,29
1650254588718,MATH 18,B04,083751,Staff,0,9,30,30
1650254594745,MATH 20A,A01,083754,Staff,26,0,40,14
1650254600845,MATH 20B,A01,083756,Staff,1,6,30,29
1650254600845,MATH 20B,A02,083757,Staff,0,7,30,30
1650254606869,MATH 20C,A01,083760,Staff,0,12,30,30
1650254606869,MATH 20C,A02,083761,Staff,0,13,30,30
1650254606869,MATH 20C,B01,083762,Staff,14,0,30,16
1650254606869,MATH 20C,B02,083763,Staff,28,0,30,2
1650254612897,MATH 20D,A01,083765,Staff,1,2,30,29
1650254612897,MATH 20D,A02,083766,Staff,8,0,30,22
1650254612897,MATH 20D,A03,083767,Staff,28,0,30,2
1650254618921,MATH 20E,A01,083771,Staff,7,0,30,23
1650254618921,MATH 20E,A02,083772,Staff,20,0,30,10
1650254618921,MATH 20E,B01,083773,Staff,0,0,30,30
1650254618921,MATH 20E,B02,083774,Staff,12,0,30,18
1650254624949,MATH 103A,A01,083777,Staff,0,9,30,30
1650254624949,MATH 103A,A02,083778,Staff,0,10,30,30
1650254624949,MATH 103A,B01,083779,Staff,0,10,30,30
1650254624949,MATH 103A,B02,083780,Staff,0,10,30,30
1650254630975,MATH 105,A01,085443,Staff,0,17,30,30
1650254637003,MATH 109,A01,083213,Anzaldo; Leesa B,0,5,30,30
1650254637003,MATH 109,A02,083214,Anzaldo; Leesa B,0,6,30,30
1650254637003,MATH 109,B01,083215,Anzaldo; Leesa B,0,4,30,30
1650254637003,MATH 109,B02,083216,Anzaldo; Leesa B,1,4,30,29
1650254643026,MATH 142A,A01,083219,Chow; Bennett,0,12,30,30
1650254643026,MATH 142A,A02,083220,Chow; Bennett,0,11,30,30
1650254643026,MATH 142A,B01,083221,Chow; Bennett,0,11,30,30
1650254643026,MATH 142A,B02,083222,Chow; Bennett,0,12,30,30
1650254649063,MATH 193A,A01,083224,Staff,0,5,30,30
1650254649063,MATH 193A,A02,083225,Staff,0,4,30,30
1650254649063,MATH 193A,A03,083781,Staff,0,2,30,30
1650254649063,MATH 193A,A04,083782,Staff,0,1,30,30
1650254655095,MATH 197,001,091859,McAuley; Julian John,9998,0,9999,1
1650254661156,COGS 9,A01,083615,Staff,0,14,60,60
1650254667181,COGS 11,A01,083617,Boyle; Mary E. T.,24,0,40,16
1650254673203,COGS 13,A01,083071,Staff,0,30,40,40
1650254679228,COGS 14A,A01,092681,Staff,1,14,100,99
1650254685251,COGS 14B,A01,083073,Cheng; Tzu-Han,0,9,50,50
1650254691278,COGS 17,A01,092677,Staff,30,0,75,45
1650254697301,COGS 100,A01,083619,Staff,1,21,60,59
1650254703329,COGS 101A,A01,083621,Davis; Joshua Daniel,0,21,60,60
1650254709351,COGS 101B,A01,091572,Staff,4,0,60,56
1650254715374,COGS 101C,A01,083625,Delgado; Tania,20,0,30,10
1650254721400,COGS 107A,A01,083627,Boyle; Mary E. T.,1,8,60,59
1650254727423,COGS 118A,A01,083075,Staff,15,0,60,45
1650254733446,CSE 3,A50,083646,Miranda; Gregory Joseph,22,0,38,16
1650254733446,CSE 3,A51,083647,Miranda; Gregory Joseph,37,0,37,0
1650254739469,CSE 8A,A50,083650,Miranda; Gregory Joseph,0,19,40,40
1650254745494,CSE 11,A01,083080,Cao; Yingjun,0,71,40,40
1650254751517,CSE 12,A01,083652,Staff,0,9,100,100
1650254757542,CSE 15L,A01,083654,Staff,0,1,50,50
1650254757542,CSE 15L,A02,083655,Staff,5,0,50,45
1650254763568,CSE 20,A01,083657,Staff,53,0,80,27
1650254769591,CSE 30,A01,083084,Eldon; John,0,71,40,40
1650254775624,CSE 100,A01,083659,Cao; Yingjun,0,64,50,50
1650254781647,CSE 134B,A01,083661,Powell; Thomas Allan,0,27,65,65
1650254787681,CSE 140,A01,083663,Staff,0,0,75,75
1650254793716,CSE 140L,A01,083088,Eldon; John,0,5,75,75
1650254799743,CSE 175,A01,083665,Kumar; Rakesh,8,0,25,17
1650254805784,CSE 190,A00,092507,Dubnov; Shlomo,14,0,20,6
1650254811811,ECE 45,A01,083139,Staff,0,13,40,40
1650254817834,ECE 65,A50,083695,Staff,0,5,30,30
1650254823857,ECE 109,A01,091882,Touri; Behrouz,47,0,70,23
1650254829882,ECE 180,A00,083140,Abi Samra; Nicholas Camill,24,0,30,6
1650254829882,ECE 180,B00,083141,Abi Samra; Nicholas Camill,7,0,30,23
1650254835910,MATH 10A,A01,083735,Patchell; Gregory David,11,0,30,19
1650254835910,MATH 10A,A02,083736,Patchell; Gregory David,28,0,30,2
1650254835910,MATH 10A,A03,083737,Patchell; Gregory David,26,0,30,4
1650254841935,MATH 10B,A01,083207,Staff,0,6,30,30
1650254841935,MATH 10B,A02,083208,Staff,0,5,30,30
1650254841935,MATH 10B,B01,083739,Staff,17,0,30,13
1650254841935,MATH 10B,B02,083740,Staff,29,0,30,1
1650254847969,MATH 18,A01,083743,Staff,7,0,30,23
1650254847969,MATH 18,A02,083744,Staff,28,0,30,2
1650254847969,MATH 18,A03,083745,Staff,23,0,30,7
1650254847969,MATH 18,A04,083746,Staff,27,0,30,3
1650254847969,MATH 18,B01,083748,Staff,0,10,30,30
1650254847969,MATH 18,B02,083749,Staff,0,8,30,30
1650254847969,MATH 18,B03,083750,Staff,1,7,30,29
1650254847969,MATH 18,B04,083751,Staff,0,9,30,30
1650254853990,MATH 20A,A01,083754,Staff,26,0,40,14
1650254860016,MATH 20B,A01,083756,Staff,1,6,30,29
1650254860016,MATH 20B,A02,083757,Staff,0,7,30,30
1650254866044,MATH 20C,A01,083760,Staff,0,12,30,30
1650254866044,MATH 20C,A02,083761,Staff,0,13,30,30
1650254866044,MATH 20C,B01,083762,Staff,14,0,30,16
1650254866044,MATH 20C,B02,083763,Staff,28,0,30,2
1650254872082,MATH 20D,A01,083765,Staff,1,2,30,29
1650254872082,MATH 20D,A02,083766,Staff,8,0,30,22
1650254872082,MATH 20D,A03,083767,Staff,28,0,30,2
1650254878105,MATH 20E,A01,083771,Staff,7,0,30,23
1650254878105,MATH 20E,A02,083772,Staff,20,0,30,10
1650254878105,MATH 20E,B01,083773,Staff,0,0,30,30
1650254878105,MATH 20E,B02,083774,Staff,12,0,30,18
1650254884128,MATH 103A,A01,083777,Staff,0,9,30,30
1650254884128,MATH 103A,A02,083778,Staff,0,10,30,30
1650254884128,MATH 103A,B01,083779,Staff,0,10,30,30
1650254884128,MATH 103A,B02,083780,Staff,0,10,30,30
1650254890153,MATH 105,A01,085443,Staff,0,17,30,30
1650254896178,MATH 109,A01,083213,Anzaldo; Leesa B,0,5,30,30
1650254896178,MATH 109,A02,083214,Anzaldo; Leesa B,0,6,30,30
1650254896178,MATH 109,B01,083215,Anzaldo; Leesa B,0,4,30,30
1650254896178,MATH 109,B02,083216,Anzaldo; Leesa B,1,4,30,29
1650254902202,MATH 142A,A01,083219,Chow; Bennett,0,12,30,30
1650254902202,MATH 142A,A02,083220,Chow; Bennett,0,11,30,30
1650254902202,MATH 142A,B01,083221,Chow; Bennett,0,11,30,30
1650254902202,MATH 142A,B02,083222,Chow; Bennett,0,12,30,30
1650254908225,MATH 193A,A01,083224,Staff,0,5,30,30
1650254908225,MATH 193A,A02,083225,Staff,0,4,30,30
1650254908225,MATH 193A,A03,083781,Staff,0,2,30,30
1650254908225,MATH 193A,A04,083782,Staff,0,1,30,30
1650254914258,MATH 197,001,091859,McAuley; Julian John,9998,0,9999,1
1650254920314,COGS 9,A01,083615,Staff,0,14,60,60
1650254926336,COGS 11,A01,083617,Boyle; Mary E. T.,24,0,40,16
1650254932360,COGS 13,A01,083071,Staff,0,30,40,40
1650254938384,COGS 14A,A01,092681,Staff,1,14,100,99
1650254944410,COGS 14B,A01,083073,Cheng; Tzu-Han,0,9,50,50
1650254950433,COGS 17,A01,092677,Staff,30,0,75,45
1650254956460,COGS 100,A01,083619,Staff,1,21,60,59
1650254962491,COGS 101A,A01,083621,Davis; Joshua Daniel,0,21,60,60
1650254968516,COGS 101B,A01,091572,Staff,4,0,60,56
1650254974546,COGS 101C,A01,083625,Delgado; Tania,20,0,30,10
1650254980572,COGS 107A,A01,083627,Boyle; Mary E. T.,1,8,60,59
1650254986600,COGS 118A,A01,083075,Staff,14,0,60,46
1650254992624,CSE 3,A50,083646,Miranda; Gregory Joseph,22,0,38,16
1650254992624,CSE 3,A51,083647,Miranda; Gregory Joseph,37,0,37,0
1650254998648,CSE 8A,A50,083650,Miranda; Gregory Joseph,0,19,40,40
1650255004674,CSE 11,A01,083080,Cao; Yingjun,0,71,40,40
1650255010699,CSE 12,A01,083652,Staff,0,9,100,100
1650255016722,CSE 15L,A01,083654,Staff,0,1,50,50
1650255016722,CSE 15L,A02,083655,Staff,5,0,50,45
1650255022745,CSE 20,A01,083657,Staff,53,0,80,27
1650255028770,CSE 30,A01,083084,Eldon; John,0,71,40,40
1650255034798,CSE 100,A01,083659,Cao; Yingjun,0,64,50,50
1650255040824,CSE 134B,A01,083661,Powell; Thomas Allan,0,27,65,65
1650255046853,CSE 140,A01,083663,Staff,0,0,75,75
1650255052883,CSE 140L,A01,083088,Eldon; John,0,5,75,75
1650255058928,CSE 175,A01,083665,Kumar; Rakesh,8,0,25,17
1650255064951,CSE 190,A00,092507,Dubnov; Shlomo,14,0,20,6
1650255070973,ECE 45,A01,083139,Staff,0,13,40,40
1650255077009,ECE 65,A50,083695,Staff,0,5,30,30
1650255083036,ECE 109,A01,091882,Touri; Behrouz,47,0,70,23
1650255089061,ECE 180,A00,083140,Abi Samra; Nicholas Camill,24,0,30,6
1650255089061,ECE 180,B00,083141,Abi Samra; Nicholas Camill,7,0,30,23
1650255095104,MATH 10A,A01,083735,Patchell; Gregory David,11,0,30,19
1650255095104,MATH 10A,A02,083736,Patchell; Gregory David,28,0,30,2
1650255095104,MATH 10A,A03,083737,Patchell; Gregory David,26,0,30,4
1650255101129,MATH 10B,A01,083207,Staff,0,6,30,30
1650255101129,MATH 10B,A02,083208,Staff,0,5,30,30
1650255101129,MATH 10B,B01,083739,Staff,17,0,30,13
1650255101129,MATH 10B,B02,083740,Staff,29,0,30,1
1650255107159,MATH 18,A01,083743,Staff,7,0,30,23
1650255107159,MATH 18,A02,083744,Staff,28,0,30,2
1650255107159,MATH 18,A03,083745,Staff,23,0,30,7
1650255107159,MATH 18,A04,083746,Staff,27,0,30,3
1650255107159,MATH 18,B01,083748,Staff,0,10,30,30
1650255107159,MATH 18,B02,083749,Staff,0,8,30,30
1650255107159,MATH 18,B03,083750,Staff,1,7,30,29
1650255107159,MATH 18,B04,083751,Staff,0,9,30,30
1650255113186,MATH 20A,A01,083754,Staff,26,0,40,14
1650255119215,MATH 20B,A01,083756,Staff,1,6,30,29
1650255119215,MATH 20B,A02,083757,Staff,0,7,30,30
1650255125238,MATH 20C,A01,083760,Staff,0,12,30,30
1650255125238,MATH 20C,A02,083761,Staff,0,13,30,30
1650255125238,MATH 20C,B01,083762,Staff,14,0,30,16
1650255125238,MATH 20C,B02,083763,Staff,28,0,30,2
1650255131262,MATH 20D,A01,083765,Staff,1,2,30,29
1650255131262,MATH 20D,A02,083766,Staff,8,0,30,22
1650255131262,MATH 20D,A03,083767,Staff,28,0,30,2
1650255137292,MATH 20E,A01,083771,Staff,7,0,30,23
1650255137292,MATH 20E,A02,083772,Staff,20,0,30,10
1650255137292,MATH 20E,B01,083773,Staff,0,0,30,30
1650255137292,MATH 20E,B02,083774,Staff,12,0,30,18
1650255143318,MATH 103A,A01,083777,Staff,0,9,30,30
1650255143318,MATH 103A,A02,083778,Staff,0,10,30,30
1650255143318,MATH 103A,B01,083779,Staff,0,10,30,30
1650255143318,MATH 103A,B02,083780,Staff,0,10,30,30
1650255149343,MATH 105,A01,085443,Staff,0,17,30,30
1650255155376,MATH 109,A01,083213,Anzaldo; Leesa B,0,5,30,30
1650255155376,MATH 109,A02,083214,Anzaldo; Leesa B,0,6,30,30
1650255155376,MATH 109,B01,083215,Anzaldo; Leesa B,0,4,30,30
1650255155376,MATH 109,B02,083216,Anzaldo; Leesa B,1,4,30,29
1650255161401,MATH 142A,A01,083219,Chow; Bennett,0,12,30,30
1650255161401,MATH 142A,A02,083220,Chow; Bennett,0,11,30,30
1650255161401,MATH 142A,B01,083221,Chow; Bennett,0,11,30,30
1650255161401,MATH 142A,B02,083222,Chow; Bennett,0,12,30,30
1650255167424,MATH 193A,A01,083224,Staff,0,5,30,30
1650255167424,MATH 193A,A02,083225,Staff,0,4,30,30
1650255167424,MATH 193A,A03,083781,Staff,0,2,30,30
1650255167424,MATH 193A,A04,083782,Staff,0,1,30,30
1650255173457,MATH 197,001,091859,McAuley; Julian John,9998,0,9999,1
1650255179513,COGS 9,A01,083615,Staff,0,14,60,60
1650255185538,COGS 11,A01,083617,Boyle; Mary E. T.,24,0,40,16
1650255191648,COGS 13,A01,083071,Staff,0,30,40,40
1650255197676,COGS 14A,A01,092681,Staff,1,14,100,99
1650255203706,COGS 14B,A01,083073,Cheng; Tzu-Han,0,9,50,50
1650255209729,COGS 17,A01,092677,Staff,30,0,75,45
1650255215752,COGS 100,A01,083619,Staff,1,21,60,59
1650255221774,COGS 101A,A01,083621,Davis; Joshua Daniel,0,21,60,60
1650255227799,COGS 101B,A01,091572,Staff,4,0,60,56
1650255233821,COGS 101C,A01,083625,Delgado; Tania,20,0,30,10
1650255239845,COGS 107A,A01,083627,Boyle; Mary E. T.,1,8,60,59
1650255245868,COGS 118A,A01,083075,Staff,14,0,60,46
1650255251894,CSE 3,A50,083646,Miranda; Gregory Joseph,22,0,38,16
1650255251894,CSE 3,A51,083647,Miranda; Gregory Joseph,37,0,37,0
1650255257917,CSE 8A,A50,083650,Miranda; Gregory Joseph,0,19,40,40
1650255263941,CSE 11,A01,083080,Cao; Yingjun,0,71,40,40
1650255269968,CSE 12,A01,083652,Staff,0,9,100,100
1650255275992,CSE 15L,A01,083654,Staff,0,1,50,50
1650255275992,CSE 15L,A02,083655,Staff,5,0,50,45
1650255282017,CSE 20,A01,083657,Staff,53,0,80,27
1650255288045,CSE 30,A01,083084,Eldon; John,0,71,40,40
1650255294072,CSE 100,A01,083659,Cao; Yingjun,0,64,50,50
1650255300097,CSE 134B,A01,083661,Powell; Thomas Allan,0,27,65,65
1650255306120,CSE 140,A01,083663,Staff,0,0,75,75
1650255312145,CSE 140L,A01,083088,Eldon; John,0,5,75,75
1650255318171,CSE 175,A01,083665,Kumar; Rakesh,8,0,25,17
1650255324195,CSE 190,A00,092507,Dubnov; Shlomo,14,0,20,6
1650255330218,ECE 45,A01,083139,Staff,0,13,40,40
1650255336241,ECE 65,A50,083695,Staff,0,5,30,30
1650255342265,ECE 109,A01,091882,Touri; Behrouz,47,0,70,23
1650255348288,ECE 180,A00,083140,Abi Samra; Nicholas Camill,24,0,30,6
1650255348288,ECE 180,B00,083141,Abi Samra; Nicholas Camill,7,0,30,23
1650255354317,MATH 10A,A01,083735,Patchell; Gregory David,11,0,30,19
1650255354317,MATH 10A,A02,083736,Patchell; Gregory David,28,0,30,2
1650255354317,MATH 10A,A03,083737,Patchell; Gregory David,26,0,30,4
1650255360351,MATH 10B,A01,083207,Staff,0,6,30,30
1650255360351,MATH 10B,A02,083208,Staff,0,5,30,30
1650255360351,MATH 10B,B01,083739,Staff,17,0,30,13
1650255360351,MATH 10B,B02,083740,Staff,29,0,30,1
1650255366375,MATH 18,A01,083743,Staff,7,0,30,23
1650255366375,MATH 18,A02,083744,Staff,28,0,30,2
1650255366375,MATH 18,A03,083745,Staff,23,0,30,7
1650255366375,MATH 18,A04,083746,Staff,27,0,30,3
1650255366375,MATH 18,B01,083748,Staff,0,10,30,30
1650255366375,MATH 18,B02,083749,Staff,0,8,30,30
1650255366375,MATH 18,B03,083750,Staff,1,7,30,29
1650255366375,MATH 18,B04,083751,Staff,0,9,30,30
1650255372401,MATH 20A,A01,083754,Staff,26,0,40,14
1650255378426,MATH 20B,A01,083756,Staff,1,6,30,29
1650255378426,MATH 20B,A02,083757,Staff,0,7,30,30
1650255384456,MATH 20C,A01,083760,Staff,0,12,30,30
1650255384456,MATH 20C,A02,083761,Staff,0,13,30,30
1650255384456,MATH 20C,B01,083762,Staff,14,0,30,16
1650255384456,MATH 20C,B02,083763,Staff,28,0,30,2
1650255390482,MATH 20D,A01,083765,Staff,1,2,30,29
1650255390482,MATH 20D,A02,083766,Staff,8,0,30,22
1650255390482,MATH 20D,A03,083767,Staff,28,0,30,2
1650255396510,MATH 20E,A01,083771,Staff,7,0,30,23
1650255396510,MATH 20E,A02,083772,Staff,20,0,30,10
1650255396510,MATH 20E,B01,083773,Staff,0,0,30,30
1650255396510,MATH 20E,B02,083774,Staff,12,0,30,18
1650255402540,MATH 103A,A01,083777,Staff,0,9,30,30
1650255402540,MATH 103A,A02,083778,Staff,0,10,30,30
1650255402540,MATH 103A,B01,083779,Staff,0,10,30,30
1650255402540,MATH 103A,B02,083780,Staff,0,10,30,30
1650255408567,MATH 105,A01,085443,Staff,0,17,30,30
1650255414591,MATH 109,A01,083213,Anzaldo; Leesa B,0,5,30,30
1650255414591,MATH 109,A02,083214,Anzaldo; Leesa B,0,6,30,30
1650255414591,MATH 109,B01,083215,Anzaldo; Leesa B,0,4,30,30
1650255414591,MATH 109,B02,083216,Anzaldo; Leesa B,1,4,30,29
1650255420613,MATH 142A,A01,083219,Chow; Bennett,0,12,30,30
1650255420613,MATH 142A,A02,083220,Chow; Bennett,0,11,30,30
1650255420613,MATH 142A,B01,083221,Chow; Bennett,0,11,30,30
1650255420613,MATH 142A,B02,083222,Chow; Bennett,0,12,30,30
1650255426644,MATH 193A,A01,083224,Staff,0,5,30,30
1650255426644,MATH 193A,A02,083225,Staff,0,4,30,30
1650255426644,MATH 193A,A03,083781,Staff,0,2,30,30
1650255426644,MATH 193A,A04,083782,Staff,0,1,30,30
1650255432668,MATH 197,001,091859,McAuley; Julian John,9998,0,9999,1
1650255438723,COGS 9,A01,083615,Staff,0,14,60,60
1650255444764,COGS 11,A01,083617,Boyle; Mary E. T.,24,0,40,16
1650255450790,COGS 13,A01,083071,Staff,0,30,40,40
1650255456814,COGS 14A,A01,092681,Staff,1,14,100,99
1650255462839,COGS 14B,A01,083073,Cheng; Tzu-Han,0,9,50,50
1650255468865,COGS 17,A01,092677,Staff,30,0,75,45
1650255474889,COGS 100,A01,083619,Staff,1,21,60,59
1650255480913,COGS 101A,A01,083621,Davis; Joshua Daniel,0,21,60,60
1650255486936,COGS 101B,A01,091572,Staff,4,0,60,56
1650255492960,COGS 101C,A01,083625,Delgado; Tania,20,0,30,10
1650255498984,COGS 107A,A01,083627,Boyle; Mary E. T.,1,8,60,59
1650255505019,COGS 118A,A01,083075,Staff,14,0,60,46
1650255511045,CSE 3,A50,083646,Miranda; Gregory Joseph,22,0,38,16
1650255511045,CSE 3,A51,083647,Miranda; Gregory Joseph,37,0,37,0
1650255517076,CSE 8A,A50,083650,Miranda; Gregory Joseph,0,19,40,40
1650255523102,CSE 11,A01,083080,Cao; Yingjun,0,71,40,40
1650255529130,CSE 12,A01,083652,Staff,0,9,100,100
1650255535153,CSE 15L,A01,083654,Staff,0,1,50,50
1650255535153,CSE 15L,A02,083655,Staff,5,0,50,45
1650255541178,CSE 20,A01,083657,Staff,53,0,80,27
1650255547205,CSE 30,A01,083084,Eldon; John,0,71,40,40
1650255553228,CSE 100,A01,083659,Cao; Yingjun,0,64,50,50
1650255559254,CSE 134B,A01,083661,Powell; Thomas Allan,0,27,65,65
1650255565280,CSE 140,A01,083663,Staff,0,0,75,75
1650255571304,CSE 140L,A01,083088,Eldon; John,0,5,75,75
1650255577326,CSE 175,A01,083665,Kumar; Rakesh,8,0,25,17
1650255583350,CSE 190,A00,092507,Dubnov; Shlomo,14,0,20,6
1650255589381,ECE 45,A01,083139,Staff,0,13,40,40
1650255595409,ECE 65,A50,083695,Staff,0,5,30,30
1650255601441,ECE 109,A01,091882,Touri; Behrouz,47,0,70,23
1650255607467,ECE 180,A00,083140,Abi Samra; Nicholas Camill,24,0,30,6
1650255607467,ECE 180,B00,083141,Abi Samra; Nicholas Camill,7,0,30,23
1650255613497,MATH 10A,A01,083735,Patchell; Gregory David,11,0,30,19
1650255613497,MATH 10A,A02,083736,Patchell; Gregory David,28,0,30,2
1650255613497,MATH 10A,A03,083737,Patchell; Gregory David,26,0,30,4
1650255619524,MATH 10B,A01,083207,Staff,0,6,30,30
1650255619524,MATH 10B,A02,083208,Staff,0,5,30,30
1650255619524,MATH 10B,B01,083739,Staff,17,0,30,13
1650255619524,MATH 10B,B02,083740,Staff,29,0,30,1
1650255625554,MATH 18,A01,083743,Staff,7,0,30,23
1650255625554,MATH 18,A02,083744,Staff,28,0,30,2
1650255625554,MATH 18,A03,083745,Staff,23,0,30,7
1650255625554,MATH 18,A04,083746,Staff,27,0,30,3
1650255625554,MATH 18,B01,083748,Staff,0,10,30,30
1650255625554,MATH 18,B02,083749,Staff,0,8,30,30
1650255625554,MATH 18,B03,083750,Staff,1,7,30,29
1650255625554,MATH 18,B04,083751,Staff,0,9,30,30
1650255631578,MATH 20A,A01,083754,Staff,26,0,40,14
1650255637605,MATH 20B,A01,083756,Staff,1,6,30,29
1650255637605,MATH 20B,A02,083757,Staff,0,7,30,30
1650255643629,MATH 20C,A01,083760,Staff,0,12,30,30
1650255643629,MATH 20C,A02,083761,Staff,0,13,30,30
1650255643629,MATH 20C,B01,083762,Staff,14,0,30,16
1650255643629,MATH 20C,B02,083763,Staff,28,0,30,2
1650255649653,MATH 20D,A01,083765,Staff,1,2,30,29
1650255649653,MATH 20D,A02,083766,Staff,8,0,30,22
1650255649653,MATH 20D,A03,083767,Staff,28,0,30,2
1650255655677,MATH 20E,A01,083771,Staff,7,0,30,23
1650255655677,MATH 20E,A02,083772,Staff,20,0,30,10
1650255655677,MATH 20E,B01,083773,Staff,0,0,30,30
1650255655677,MATH 20E,B02,083774,Staff,12,0,30,18
1650255661707,MATH 103A,A01,083777,Staff,0,9,30,30
1650255661707,MATH 103A,A02,083778,Staff,0,10,30,30
1650255661707,MATH 103A,B01,083779,Staff,0,10,30,30
1650255661707,MATH 103A,B02,083780,Staff,0,10,30,30
1650255667739,MATH 105,A01,085443,Staff,0,17,30,30
1650255673764,MATH 109,A01,083213,Anzaldo; Leesa B,0,5,30,30
1650255673764,MATH 109,A02,083214,Anzaldo; Leesa B,0,6,30,30
1650255673764,MATH 109,B01,083215,Anzaldo; Leesa B,0,4,30,30
1650255673764,MATH 109,B02,083216,Anzaldo; Leesa B,1,4,30,29
1650255679788,MATH 142A,A01,083219,Chow; Bennett,0,12,30,30
1650255679788,MATH 142A,A02,083220,Chow; Bennett,0,11,30,30
1650255679788,MATH 142A,B01,083221,Chow; Bennett,0,11,30,30
1650255679788,MATH 142A,B02,083222,Chow; Bennett,0,12,30,30
1650255685811,MATH 193A,A01,083224,Staff,0,5,30,30
1650255685811,MATH 193A,A02,083225,Staff,0,4,30,30
1650255685811,MATH 193A,A03,083781,Staff,0,2,30,30
1650255685811,MATH 193A,A04,083782,Staff,0,1,30,30
1650255691832,MATH 197,001,091859,McAuley; Julian John,9998,0,9999,1
1650255697883,COGS 9,A01,083615,Staff,0,14,60,60
1650255703913,COGS 11,A01,083617,Boyle; Mary E. T.,24,0,40,16
1650255709936,COGS 13,A01,083071,Staff,0,30,40,40
1650255715962,COGS 14A,A01,092681,Staff,1,14,100,99
1650255721986,COGS 14B,A01,083073,Cheng; Tzu-Han,0,9,50,50
1650255728009,COGS 17,A01,092677,Staff,30,0,75,45
1650255734032,COGS 100,A01,083619,Staff,1,21,60,59
1650255740055,COGS 101A,A01,083621,Davis; Joshua Daniel,0,21,60,60
1650255746084,COGS 101B,A01,091572,Staff,4,0,60,56
1650255752108,COGS 101C,A01,083625,Delgado; Tania,20,0,30,10
1650255758132,COGS 107A,A01,083627,Boyle; Mary E. T.,1,8,60,59
1650255764157,COGS 118A,A01,083075,Staff,14,0,60,46
1650255770179,CSE 3,A50,083646,Miranda; Gregory Joseph,22,0,38,16
1650255770179,CSE 3,A51,083647,Miranda; Gregory Joseph,37,0,37,0
1650255776202,CSE 8A,A50,083650,Miranda; Gregory Joseph,0,19,40,40
1650255782225,CSE 11,A01,083080,Cao; Yingjun,0,71,40,40
1650255788336,CSE 12,A01,083652,Staff,0,9,100,100
1650255794358,CSE 15L,A01,083654,Staff,0,1,50,50
1650255794358,CSE 15L,A02,083655,Staff,5,0,50,45
1650255800382,CSE 20,A01,083657,Staff,53,0,80,27
1650255806405,CSE 30,A01,083084,Eldon; John,0,71,40,40
1650255812432,CSE 100,A01,083659,Cao; Yingjun,0,64,50,50
1650255818456,CSE 134B,A01,083661,Powell; Thomas Allan,0,27,65,65
1650255824478,CSE 140,A01,083663,Staff,0,0,75,75
1650255830505,CSE 140L,A01,083088,Eldon; John,0,5,75,75
1650255836529,CSE 175,A01,083665,Kumar; Rakesh,8,0,25,17
1650255842551,CSE 190,A00,092507,Dubnov; Shlomo,14,0,20,6
1650255848578,ECE 45,A01,083139,Staff,0,13,40,40
1650255854602,ECE 65,A50,083695,Staff,0,5,30,30
1650255860628,ECE 109,A01,091882,Touri; Behrouz,47,0,70,23
1650255866653,ECE 180,A00,083140,Abi Samra; Nicholas Camill,24,0,30,6
1650255866653,ECE 180,B00,083141,Abi Samra; Nicholas Camill,7,0,30,23
1650255872680,MATH 10A,A01,083735,Patchell; Gregory David,11,0,30,19
1650255872680,MATH 10A,A02,083736,Patchell; Gregory David,28,0,30,2
1650255872680,MATH 10A,A03,083737,Patchell; Gregory David,26,0,30,4
1650255878708,MATH 10B,A01,083207,Staff,0,6,30,30
1650255878708,MATH 10B,A02,083208,Staff,0,5,30,30
1650255878708,MATH 10B,B01,083739,Staff,17,0,30,13
1650255878708,MATH 10B,B02,083740,Staff,29,0,30,1
1650255884738,MATH 18,A01,083743,Staff,7,0,30,23
1650255884738,MATH 18,A02,083744,Staff,28,0,30,2
1650255884738,MATH 18,A03,083745,Staff,23,0,30,7
1650255884738,MATH 18,A04,083746,Staff,27,0,30,3
1650255884738,MATH 18,B01,083748,Staff,0,10,30,30
1650255884738,MATH 18,B02,083749,Staff,0,8,30,30
1650255884738,MATH 18,B03,083750,Staff,1,7,30,29
1650255884738,MATH 18,B04,083751,Staff,0,9,30,30
1650255890762,MATH 20A,A01,083754,Staff,26,0,40,14
1650255896785,MATH 20B,A01,083756,Staff,1,6,30,29
1650255896785,MATH 20B,A02,083757,Staff,0,7,30,30
1650255902810,MATH 20C,A01,083760,Staff,0,12,30,30
1650255902810,MATH 20C,A02,083761,Staff,0,13,30,30
1650255902810,MATH 20C,B01,083762,Staff,14,0,30,16
1650255902810,MATH 20C,B02,083763,Staff,28,0,30,2
1650255908832,MATH 20D,A01,083765,Staff,1,2,30,29
1650255908832,MATH 20D,A02,083766,Staff,8,0,30,22
1650255908832,MATH 20D,A03,083767,Staff,28,0,30,2
1650255914856,MATH 20E,A01,083771,Staff,7,0,30,23
1650255914856,MATH 20E,A02,083772,Staff,20,0,30,10
1650255914856,MATH 20E,B01,083773,Staff,0,0,30,30
1650255914856,MATH 20E,B02,083774,Staff,12,0,30,18
1650255920914,MATH 103A,A01,083777,Staff,0,9,30,30
1650255920914,MATH 103A,A02,083778,Staff,0,10,30,30
1650255920914,MATH 103A,B01,083779,Staff,0,10,30,30
1650255920914,MATH 103A,B02,083780,Staff,0,10,30,30
1650255926939,MATH 105,A01,085443,Staff,0,17,30,30
1650255932964,MATH 109,A01,083213,Anzaldo; Leesa B,0,5,30,30
1650255932964,MATH 109,A02,083214,Anzaldo; Leesa B,0,6,30,30
1650255932964,MATH 109,B01,083215,Anzaldo; Leesa B,0,4,30,30
1650255932964,MATH 109,B02,083216,Anzaldo; Leesa B,1,4,30,29
1650255938993,MATH 142A,A01,083219,Chow; Bennett,0,12,30,30
1650255938993,MATH 142A,A02,083220,Chow; Bennett,0,11,30,30
1650255938993,MATH 142A,B01,083221,Chow; Bennett,0,11,30,30
1650255938993,MATH 142A,B02,083222,Chow; Bennett,0,12,30,30
1650255945015,MATH 193A,A01,083224,Staff,0,5,30,30
1650255945015,MATH 193A,A02,083225,Staff,0,4,30,30
1650255945015,MATH 193A,A03,083781,Staff,0,2,30,30
1650255945015,MATH 193A,A04,083782,Staff,0,1,30,30
1650255951041,MATH 197,001,091859,McAuley; Julian John,9998,0,9999,1
1650255957100,COGS 9,A01,083615,Staff,0,14,60,60
1650255963126,COGS 11,A01,083617,Boyle; Mary E. T.,24,0,40,16
1650255969152,COGS 13,A01,083071,Staff,0,30,40,40
1650255975177,COGS 14A,A01,092681,Staff,1,14,100,99
1650255981199,COGS 14B,A01,083073,Cheng; Tzu-Han,0,9,50,50
1650255987224,COGS 17,A01,092677,Staff,30,0,75,45
1650255993254,COGS 100,A01,083619,Staff,1,21,60,59
1650255999282,COGS 101A,A01,083621,Davis; Joshua Daniel,0,21,60,60
1650256005305,COGS 101B,A01,091572,Staff,4,0,60,56
1650256011328,COGS 101C,A01,083625,Delgado; Tania,20,0,30,10
1650256017353,COGS 107A,A01,083627,Boyle; Mary E. T.,1,8,60,59
1650256023379,COGS 118A,A01,083075,Staff,14,0,60,46
1650256029407,CSE 3,A50,083646,Miranda; Gregory Joseph,22,0,38,16
1650256029407,CSE 3,A51,083647,Miranda; Gregory Joseph,37,0,37,0
1650256035431,CSE 8A,A50,083650,Miranda; Gregory Joseph,0,19,40,40
1650256041462,CSE 11,A01,083080,Cao; Yingjun,0,71,40,40
1650256047485,CSE 12,A01,083652,Staff,0,9,100,100
1650256053512,CSE 15L,A01,083654,Staff,0,1,50,50
1650256053512,CSE 15L,A02,083655,Staff,5,0,50,45
1650256059538,CSE 20,A01,083657,Staff,53,0,80,27
1650256065563,CSE 30,A01,083084,Eldon; John,0,71,40,40
1650256071587,CSE 100,A01,083659,Cao; Yingjun,0,64,50,50
1650256077618,CSE 134B,A01,083661,Powell; Thomas Allan,0,27,65,65
1650256083640,CSE 140,A01,083663,Staff,0,0,75,75
1650256089665,CSE 140L,A01,083088,Eldon; John,0,5,75,75
1650256095689,CSE 175,A01,083665,Kumar; Rakesh,8,0,25,17
1650256101721,CSE 190,A00,092507,Dubnov; Shlomo,14,0,20,6
1650256107748,ECE 45,A01,083139,Staff,0,13,40,40
1650256113772,ECE 65,A50,083695,Staff,0,5,30,30
1650256119800,ECE 109,A01,091882,Touri; Behrouz,47,0,70,23
1650256125831,ECE 180,A00,083140,Abi Samra; Nicholas Camill,24,0,30,6
1650256125831,ECE 180,B00,083141,Abi Samra; Nicholas Camill,7,0,30,23
1650256131858,MATH 10A,A01,083735,Patchell; Gregory David,11,0,30,19
1650256131858,MATH 10A,A02,083736,Patchell; Gregory David,28,0,30,2
1650256131858,MATH 10A,A03,083737,Patchell; Gregory David,26,0,30,4
1650256137882,MATH 10B,A01,083207,Staff,0,6,30,30
1650256137882,MATH 10B,A02,083208,Staff,0,5,30,30
1650256137882,MATH 10B,B01,083739,Staff,17,0,30,13
1650256137882,MATH 10B,B02,083740,Staff,29,0,30,1
1650256143908,MATH 18,A01,083743,Staff,7,0,30,23
1650256143908,MATH 18,A02,083744,Staff,28,0,30,2
1650256143908,MATH 18,A03,083745,Staff,23,0,30,7
1650256143908,MATH 18,A04,083746,Staff,27,0,30,3
1650256143908,MATH 18,B01,083748,Staff,0,10,30,30
1650256143908,MATH 18,B02,083749,Staff,0,9,30,30
1650256143908,MATH 18,B03,083750,Staff,1,7,30,29
1650256143908,MATH 18,B04,083751,Staff,0,9,30,30
1650256149932,MATH 20A,A01,083754,Staff,26,0,40,14
1650256155957,MATH 20B,A01,083756,Staff,1,6,30,29
1650256155957,MATH 20B,A02,083757,Staff,0,7,30,30
1650256161981,MATH 20C,A01,083760,Staff,0,12,30,30
1650256161981,MATH 20C,A02,083761,Staff,0,13,30,30
1650256161981,MATH 20C,B01,083762,Staff,14,0,30,16
1650256161981,MATH 20C,B02,083763,Staff,28,0,30,2
1650256168009,MATH 20D,A01,083765,Staff,1,2,30,29
1650256168009,MATH 20D,A02,083766,Staff,8,0,30,22
1650256168009,MATH 20D,A03,083767,Staff,28,0,30,2
1650256174036,MATH 20E,A01,083771,Staff,7,0,30,23
1650256174036,MATH 20E,A02,083772,Staff,20,0,30,10
1650256174036,MATH 20E,B01,083773,Staff,0,0,30,30
1650256174036,MATH 20E,B02,083774,Staff,12,0,30,18
1650256180069,MATH 103A,A01,083777,Staff,0,9,30,30
1650256180069,MATH 103A,A02,083778,Staff,0,10,30,30
1650256180069,MATH 103A,B01,083779,Staff,0,10,30,30
1650256180069,MATH 103A,B02,083780,Staff,0,10,30,30
1650256186091,MATH 105,A01,085443,Staff,0,17,30,30
1650256192114,MATH 109,A01,083213,Anzaldo; Leesa B,0,5,30,30
1650256192114,MATH 109,A02,083214,Anzaldo; Leesa B,0,6,30,30
1650256192114,MATH 109,B01,083215,Anzaldo; Leesa B,0,4,30,30
1650256192114,MATH 109,B02,083216,Anzaldo; Leesa B,1,4,30,29
1650256198137,MATH 142A,A01,083219,Chow; Bennett,0,12,30,30
1650256198137,MATH 142A,A02,083220,Chow; Bennett,0,11,30,30
1650256198137,MATH 142A,B01,083221,Chow; Bennett,0,11,30,30
1650256198137,MATH 142A,B02,083222,Chow; Bennett,0,12,30,30
1650256204164,MATH 193A,A01,083224,Staff,0,5,30,30
1650256204164,MATH 193A,A02,083225,Staff,0,4,30,30
1650256204164,MATH 193A,A03,083781,Staff,0,2,30,30
1650256204164,MATH 193A,A04,083782,Staff,0,1,30,30
1650256210186,MATH 197,001,091859,McAuley; Julian John,9998,0,9999,1
1650256216233,COGS 9,A01,083615,Staff,0,14,60,60
1650256222258,COGS 11,A01,083617,Boyle; Mary E. T.,24,0,40,16
1650256228281,COGS 13,A01,083071,Staff,0,31,40,40
1650256234303,COGS 14A,A01,092681,Staff,1,15,100,99
1650256240327,COGS 14B,A01,083073,Cheng; Tzu-Han,0,9,50,50
1650256246349,COGS 17,A01,092677,Staff,30,0,75,45
1650256252373,COGS 100,A01,083619,Staff,1,21,60,59
1650256258400,COGS 101A,A01,083621,Davis; Joshua Daniel,0,21,60,60
1650256264423,COGS 101B,A01,091572,Staff,4,0,60,56
1650256270462,COGS 101C,A01,083625,Delgado; Tania,20,0,30,10
1650256276493,COGS 107A,A01,083627,Boyle; Mary E. T.,1,8,60,59
1650256282517,COGS 118A,A01,083075,Staff,14,0,60,46
1650256288559,CSE 3,A50,083646,Miranda; Gregory Joseph,22,0,38,16
1650256288559,CSE 3,A51,083647,Miranda; Gregory Joseph,37,0,37,0
1650256294587,CSE 8A,A50,083650,Miranda; Gregory Joseph,0,19,40,40
1650256300612,CSE 11,A01,083080,Cao; Yingjun,0,71,40,40
1650256306634,CSE 12,A01,083652,Staff,0,9,100,100
1650256312656,CSE 15L,A01,083654,Staff,0,1,50,50
1650256312656,CSE 15L,A02,083655,Staff,5,0,50,45
1650256318684,CSE 20,A01,083657,Staff,53,0,80,27
1650256324711,CSE 30,A01,083084,Eldon; John,0,71,40,40
1650256330732,CSE 100,A01,083659,Cao; Yingjun,0,64,50,50
1650256336756,CSE 134B,A01,083661,Powell; Thomas Allan,0,27,65,65
1650256342788,CSE 140,A01,083663,Staff,0,0,75,75
1650256348813,CSE 140L,A01,083088,Eldon; John,0,5,75,75
1650256354835,CSE 175,A01,083665,Kumar; Rakesh,8,0,25,17
1650256360856,CSE 190,A00,092507,Dubnov; Shlomo,14,0,20,6
1650256366881,ECE 45,A01,083139,Staff,0,14,40,40
1650256372905,ECE 65,A50,083695,Staff,0,5,30,30
1650256378928,ECE 109,A01,091882,Touri; Behrouz,47,0,70,23
1650256385041,ECE 180,A00,083140,Abi Samra; Nicholas Camill,24,0,30,6
1650256385041,ECE 180,B00,083141,Abi Samra; Nicholas Camill,7,0,30,23
1650256391064,MATH 10A,A01,083735,Patchell; Gregory David,11,0,30,19
1650256391064,MATH 10A,A02,083736,Patchell; Gregory David,28,0,30,2
1650256391064,MATH 10A,A03,083737,Patchell; Gregory David,26,0,30,4
1650256397088,MATH 10B,A01,083207,Staff,0,6,30,30
1650256397088,MATH 10B,A02,083208,Staff,0,5,30,30
1650256397088,MATH 10B,B01,083739,Staff,17,0,30,13
1650256397088,MATH 10B,B02,083740,Staff,29,0,30,1
1650256403120,MATH 18,A01,083743,Staff,7,0,30,23
1650256403120,MATH 18,A02,083744,Staff,28,0,30,2
1650256403120,MATH 18,A03,083745,Staff,23,0,30,7
1650256403120,MATH 18,A04,083746,Staff,27,0,30,3
1650256403120,MATH 18,B01,083748,Staff,0,10,30,30
1650256403120,MATH 18,B02,083749,Staff,0,9,30,30
1650256403120,MATH 18,B03,083750,Staff,1,7,30,29
1650256403120,MATH 18,B04,083751,Staff,0,9,30,30
1650256409144,MATH 20A,A01,083754,Staff,26,0,40,14
1650256415167,MATH 20B,A01,083756,Staff,1,6,30,29
1650256415167,MATH 20B,A02,083757,Staff,0,7,30,30
1650256421193,MATH 20C,A01,083760,Staff,0,12,30,30
1650256421193,MATH 20C,A02,083761,Staff,0,13,30,30
1650256421193,MATH 20C,B01,083762,Staff,14,0,30,16
1650256421193,MATH 20C,B02,083763,Staff,28,0,30,2
1650256427223,MATH 20D,A01,083765,Staff,1,2,30,29
1650256427223,MATH 20D,A02,083766,Staff,8,0,30,22
1650256427223,MATH 20D,A03,083767,Staff,28,0,30,2
1650256433254,MATH 20E,A01,083771,Staff,7,0,30,23
1650256433254,MATH 20E,A02,083772,Staff,20,0,30,10
1650256433254,MATH 20E,B01,083773,Staff,0,0,30,30
1650256433254,MATH 20E,B02,083774,Staff,12,0,30,18
1650256439274,MATH 103A,A01,083777,Staff,0,9,30,30
1650256439274,MATH 103A,A02,083778,Staff,0,10,30,30
1650256439274,MATH 103A,B01,083779,Staff,0,10,30,30
1650256439274,MATH 103A,B02,083780,Staff,0,10,30,30
1650256445297,MATH 105,A01,085443,Staff,0,17,30,30
1650256451323,MATH 109,A01,083213,Anzaldo; Leesa B,0,5,30,30
1650256451323,MATH 109,A02,083214,Anzaldo; Leesa B,0,6,30,30
1650256451323,MATH 109,B01,083215,Anzaldo; Leesa B,0,4,30,30
1650256451323,MATH 109,B02,083216,Anzaldo; Leesa B,1,4,30,29
1650256457345,MATH 142A,A01,083219,Chow; Bennett,0,12,30,30
1650256457345,MATH 142A,A02,083220,Chow; Bennett,0,11,30,30
1650256457345,MATH 142A,B01,083221,Chow; Bennett,0,11,30,30
1650256457345,MATH 142A,B02,083222,Chow; Bennett,0,12,30,30
1650256463370,MATH 193A,A01,083224,Staff,0,5,30,30
1650256463370,MATH 193A,A02,083225,Staff,0,4,30,30
1650256463370,MATH 193A,A03,083781,Staff,0,2,30,30
1650256463370,MATH 193A,A04,083782,Staff,0,1,30,30
1650256469394,MATH 197,001,091859,McAuley; Julian John,9998,0,9999,1
1650256475450,COGS 9,A01,083615,Staff,0,14,60,60
1650256481482,COGS 11,A01,083617,Boyle; Mary E. T.,24,0,40,16
1650256487513,COGS 13,A01,083071,Staff,0,31,40,40
1650256493535,COGS 14A,A01,092681,Staff,1,15,100,99
1650256499586,COGS 14B,A01,083073,Cheng; Tzu-Han,0,9,50,50
1650256505614,COGS 17,A01,092677,Staff,30,0,75,45
1650256511639,COGS 100,A01,083619,Staff,1,21,60,59
1650256517662,COGS 101A,A01,083621,Davis; Joshua Daniel,0,21,60,60
1650256523685,COGS 101B,A01,091572,Staff,4,0,60,56
1650256529709,COGS 101C,A01,083625,Delgado; Tania,20,0,30,10
1650256535735,COGS 107A,A01,083627,Boyle; Mary E. T.,1,8,60,59
1650256541757,COGS 118A,A01,083075,Staff,14,0,60,46
1650256547785,CSE 3,A50,083646,Miranda; Gregory Joseph,22,0,38,16
1650256547785,CSE 3,A51,083647,Miranda; Gregory Joseph,37,0,37,0
1650256553807,CSE 8A,A50,083650,Miranda; Gregory Joseph,0,19,40,40
1650256559834,CSE 11,A01,083080,Cao; Yingjun,0,71,40,40
1650256565865,CSE 12,A01,083652,Staff,0,9,100,100
1650256571888,CSE 15L,A01,083654,Staff,0,1,50,50
1650256571888,CSE 15L,A02,083655,Staff,5,0,50,45
1650256577911,CSE 20,A01,083657,Staff,53,0,80,27
1650256583934,CSE 30,A01,083084,Eldon; John,0,71,40,40
1650256589957,CSE 100,A01,083659,Cao; Yingjun,0,64,50,50
1650256595983,CSE 134B,A01,083661,Powell; Thomas Allan,0,27,65,65
1650256602012,CSE 140,A01,083663,Staff,0,0,75,75
1650256608034,CSE 140L,A01,083088,Eldon; John,0,5,75,75
1650256614058,CSE 175,A01,083665,Kumar; Rakesh,8,0,25,17
1650256620083,CSE 190,A00,092507,Dubnov; Shlomo,14,0,20,6
1650256626108,ECE 45,A01,083139,Staff,0,14,40,40
1650256632134,ECE 65,A50,083695,Staff,0,5,30,30
1650256638160,ECE 109,A01,091882,Touri; Behrouz,47,0,70,23
1650256644193,ECE 180,A00,083140,Abi Samra; Nicholas Camill,24,0,30,6
1650256644193,ECE 180,B00,083141,Abi Samra; Nicholas Camill,7,0,30,23
1650256650216,MATH 10A,A01,083735,Patchell; Gregory David,11,0,30,19
1650256650216,MATH 10A,A02,083736,Patchell; Gregory David,28,0,30,2
1650256650216,MATH 10A,A03,083737,Patchell; Gregory David,26,0,30,4
1650256656239,MATH 10B,A01,083207,Staff,0,6,30,30
1650256656239,MATH 10B,A02,083208,Staff,0,5,30,30
1650256656239,MATH 10B,B01,083739,Staff,17,0,30,13
1650256656239,MATH 10B,B02,083740,Staff,29,0,30,1
1650256662264,MATH 18,A01,083743,Staff,7,0,30,23
1650256662264,MATH 18,A02,083744,Staff,28,0,30,2
1650256662264,MATH 18,A03,083745,Staff,23,0,30,7
1650256662264,MATH 18,A04,083746,Staff,27,0,30,3
1650256662264,MATH 18,B01,083748,Staff,0,10,30,30
1650256662264,MATH 18,B02,083749,Staff,0,9,30,30
1650256662264,MATH 18,B03,083750,Staff,1,7,30,29
1650256662264,MATH 18,B04,083751,Staff,0,9,30,30
1650256668291,MATH 20A,A01,083754,Staff,26,0,40,14
1650256674315,MATH 20B,A01,083756,Staff,1,6,30,29
1650256674315,MATH 20B,A02,083757,Staff,0,7,30,30
1650256680344,MATH 20C,A01,083760,Staff,0,12,30,30
1650256680344,MATH 20C,A02,083761,Staff,0,13,30,30
1650256680344,MATH 20C,B01,083762,Staff,14,0,30,16
1650256680344,MATH 20C,B02,083763,Staff,28,0,30,2
1650256686394,MATH 20D,A01,083765,Staff,1,2,30,29
1650256686394,MATH 20D,A02,083766,Staff,8,0,30,22
1650256686394,MATH 20D,A03,083767,Staff,28,0,30,2
1650256692416,MATH 20E,A01,083771,Staff,7,0,30,23
1650256692416,MATH 20E,A02,083772,Staff,20,0,30,10
1650256692416,MATH 20E,B01,083773,Staff,0,0,30,30
1650256692416,MATH 20E,B02,083774,Staff,12,0,30,18
1650256698443,MATH 103A,A01,083777,Staff,0,9,30,30
1650256698443,MATH 103A,A02,083778,Staff,0,10,30,30
1650256698443,MATH 103A,B01,083779,Staff,0,10,30,30
1650256698443,MATH 103A,B02,083780,Staff,0,10,30,30
1650256704469,MATH 105,A01,085443,Staff,0,17,30,30
1650256710491,MATH 109,A01,083213,Anzaldo; Leesa B,0,5,30,30
1650256710491,MATH 109,A02,083214,Anzaldo; Leesa B,0,6,30,30
1650256710491,MATH 109,B01,083215,Anzaldo; Leesa B,0,4,30,30
1650256710491,MATH 109,B02,083216,Anzaldo; Leesa B,1,4,30,29
1650256716523,MATH 142A,A01,083219,Chow; Bennett,0,12,30,30
1650256716523,MATH 142A,A02,083220,Chow; Bennett,0,11,30,30
1650256716523,MATH 142A,B01,083221,Chow; Bennett,0,11,30,30
1650256716523,MATH 142A,B02,083222,Chow; Bennett,0,12,30,30
1650256722549,MATH 193A,A01,083224,Staff,0,5,30,30
1650256722549,MATH 193A,A02,083225,Staff,0,4,30,30
1650256722549,MATH 193A,A03,083781,Staff,0,2,30,30
1650256722549,MATH 193A,A04,083782,Staff,0,1,30,30
1650256728571,MATH 197,001,091859,McAuley; Julian John,9998,0,9999,1
1650256734625,COGS 9,A01,083615,Staff,0,14,60,60
1650256740649,COGS 11,A01,083617,Boyle; Mary E. T.,24,0,40,16
1650256746673,COGS 13,A01,083071,Staff,0,31,40,40
1650256752695,COGS 14A,A01,092681,Staff,1,15,100,99
1650256758728,COGS 14B,A01,083073,Cheng; Tzu-Han,0,9,50,50
1650256764754,COGS 17,A01,092677,Staff,30,0,75,45
1650256770777,COGS 100,A01,083619,Staff,1,21,60,59
1650256776802,COGS 101A,A01,083621,Davis; Joshua Daniel,0,21,60,60
1650256782828,COGS 101B,A01,091572,Staff,4,0,60,56
1650256788856,COGS 101C,A01,083625,Delgado; Tania,20,0,30,10
1650256794885,COGS 107A,A01,083627,Boyle; Mary E. T.,1,8,60,59
1650256800910,COGS 118A,A01,083075,Staff,14,0,60,46
1650256806934,CSE 3,A50,083646,Miranda; Gregory Joseph,22,0,38,16
1650256806934,CSE 3,A51,083647,Miranda; Gregory Joseph,37,0,37,0
1650256812962,CSE 8A,A50,083650,Miranda; Gregory Joseph,0,19,40,40
1650256818988,CSE 11,A01,083080,Cao; Yingjun,0,71,40,40
1650256825014,CSE 12,A01,083652,Staff,0,9,100,100
1650256831040,CSE 15L,A01,083654,Staff,0,1,50,50
1650256831040,CSE 15L,A02,083655,Staff,5,0,50,45
1650256837063,CSE 20,A01,083657,Staff,53,0,80,27
1650256843085,CSE 30,A01,083084,Eldon; John,0,71,40,40
1650256849108,CSE 100,A01,083659,Cao; Yingjun,0,64,50,50
1650256855138,CSE 134B,A01,083661,Powell; Thomas Allan,0,27,65,65
1650256861163,CSE 140,A01,083663,Staff,0,0,75,75
1650256867189,CSE 140L,A01,083088,Eldon; John,0,5,75,75
1650256873216,CSE 175,A01,083665,Kumar; Rakesh,8,0,25,17
1650256879241,CSE 190,A00,092507,Dubnov; Shlomo,14,0,20,6
1650256885265,ECE 45,A01,083139,Staff,0,13,40,40
1650256891296,ECE 65,A50,083695,Staff,0,5,30,30
1650256897319,ECE 109,A01,091882,Touri; Behrouz,47,0,70,23
1650256903343,ECE 180,A00,083140,Abi Samra; Nicholas Camill,24,0,30,6
1650256903343,ECE 180,B00,083141,Abi Samra; Nicholas Camill,7,0,30,23
1650256909377,MATH 10A,A01,083735,Patchell; Gregory David,11,0,30,19
1650256909377,MATH 10A,A02,083736,Patchell; Gregory David,28,0,30,2
1650256909377,MATH 10A,A03,083737,Patchell; Gregory David,26,0,30,4
1650256915405,MATH 10B,A01,083207,Staff,0,6,30,30
1650256915405,MATH 10B,A02,083208,Staff,0,5,30,30
1650256915405,MATH 10B,B01,083739,Staff,17,0,30,13
1650256915405,MATH 10B,B02,083740,Staff,29,0,30,1
1650256921435,MATH 18,A01,083743,Staff,7,0,30,23
1650256921435,MATH 18,A02,083744,Staff,28,0,30,2
1650256921435,MATH 18,A03,083745,Staff,23,0,30,7
1650256921435,MATH 18,A04,083746,Staff,27,0,30,3
1650256921435,MATH 18,B01,083748,Staff,0,10,30,30
1650256921435,MATH 18,B02,083749,Staff,0,9,30,30
1650256921435,MATH 18,B03,083750,Staff,1,7,30,29
1650256921435,MATH 18,B04,083751,Staff,0,9,30,30
1650256927466,MATH 20A,A01,083754,Staff,26,0,40,14
1650256933490,MATH 20B,A01,083756,Staff,1,6,30,29
1650256933490,MATH 20B,A02,083757,Staff,0,7,30,30
1650256939517,MATH 20C,A01,083760,Staff,0,12,30,30
1650256939517,MATH 20C,A02,083761,Staff,0,13,30,30
1650256939517,MATH 20C,B01,083762,Staff,14,0,30,16
1650256939517,MATH 20C,B02,083763,Staff,28,0,30,2
1650256945542,MATH 20D,A01,083765,Staff,1,2,30,29
1650256945542,MATH 20D,A02,083766,Staff,8,0,30,22
1650256945542,MATH 20D,A03,083767,Staff,28,0,30,2
1650256951568,MATH 20E,A01,083771,Staff,7,0,30,23
1650256951568,MATH 20E,A02,083772,Staff,20,0,30,10
1650256951568,MATH 20E,B01,083773,Staff,0,0,30,30
1650256951568,MATH 20E,B02,083774,Staff,12,0,30,18
1650256957593,MATH 103A,A01,083777,Staff,0,9,30,30
1650256957593,MATH 103A,A02,083778,Staff,0,10,30,30
1650256957593,MATH 103A,B01,083779,Staff,0,10,30,30
1650256957593,MATH 103A,B02,083780,Staff,0,10,30,30
1650256963627,MATH 105,A01,085443,Staff,0,17,30,30
1650256969651,MATH 109,A01,083213,Anzaldo; Leesa B,0,5,30,30
1650256969651,MATH 109,A02,083214,Anzaldo; Leesa B,0,6,30,30
1650256969651,MATH 109,B01,083215,Anzaldo; Leesa B,0,4,30,30
1650256969651,MATH 109,B02,083216,Anzaldo; Leesa B,1,4,30,29
1650256975681,MATH 142A,A01,083219,Chow; Bennett,0,12,30,30
1650256975681,MATH 142A,A02,083220,Chow; Bennett,0,11,30,30
1650256975681,MATH 142A,B01,083221,Chow; Bennett,0,11,30,30
1650256975681,MATH 142A,B02,083222,Chow; Bennett,0,12,30,30
1650256981819,MATH 193A,A01,083224,Staff,0,5,30,30
1650256981819,MATH 193A,A02,083225,Staff,0,4,30,30
1650256981819,MATH 193A,A03,083781,Staff,0,2,30,30
1650256981819,MATH 193A,A04,083782,Staff,0,1,30,30
1650256987841,MATH 197,001,091859,McAuley; Julian John,9998,0,9999,1
1650256993899,COGS 9,A01,083615,Staff,0,14,60,60
1650256999922,COGS 11,A01,083617,Boyle; Mary E. T.,24,0,40,16
1650257005946,COGS 13,A01,083071,Staff,0,31,40,40
1650257011970,COGS 14A,A01,092681,Staff,1,15,100,99
1650257017996,COGS 14B,A01,083073,Cheng; Tzu-Han,0,9,50,50
1650257024018,COGS 17,A01,092677,Staff,30,0,75,45
1650257030045,COGS 100,A01,083619,Staff,1,21,60,59
1650257036074,COGS 101A,A01,083621,Davis; Joshua Daniel,0,21,60,60
1650257042098,COGS 101B,A01,091572,Staff,4,0,60,56
1650257048121,COGS 101C,A01,083625,Delgado; Tania,20,0,30,10
1650257054144,COGS 107A,A01,083627,Boyle; Mary E. T.,1,8,60,59
1650257060167,COGS 118A,A01,083075,Staff,14,0,60,46
1650257066192,CSE 3,A50,083646,Miranda; Gregory Joseph,22,0,38,16
1650257066192,CSE 3,A51,083647,Miranda; Gregory Joseph,37,0,37,0
1650257072214,CSE 8A,A50,083650,Miranda; Gregory Joseph,0,19,40,40
1650257078255,CSE 11,A01,083080,Cao; Yingjun,0,71,40,40
1650257084287,CSE 12,A01,083652,Staff,0,9,100,100
1650257090311,CSE 15L,A01,083654,Staff,0,1,50,50
1650257090311,CSE 15L,A02,083655,Staff,5,0,50,45
1650257096337,CSE 20,A01,083657,Staff,53,0,80,27
1650257102364,CSE 30,A01,083084,Eldon; John,0,72,40,40
1650257108389,CSE 100,A01,083659,Cao; Yingjun,0,64,50,50
1650257114413,CSE 134B,A01,083661,Powell; Thomas Allan,0,27,65,65
1650257120436,CSE 140,A01,083663,Staff,0,0,75,75
1650257126464,CSE 140L,A01,083088,Eldon; John,0,5,75,75
1650257132489,CSE 175,A01,083665,Kumar; Rakesh,8,0,25,17
1650257138514,CSE 190,A00,092507,Dubnov; Shlomo,14,0,20,6
1650257144537,ECE 45,A01,083139,Staff,0,13,40,40
1650257150561,ECE 65,A50,083695,Staff,0,5,30,30
1650257156588,ECE 109,A01,091882,Touri; Behrouz,47,0,70,23
1650257163853,ECE 180,A00,083140,Abi Samra; Nicholas Camill,24,0,30,6
1650257163853,ECE 180,B00,083141,Abi Samra; Nicholas Camill,7,0,30,23
1650257169884,MATH 10A,A01,083735,Patchell; Gregory David,11,0,30,19
1650257169884,MATH 10A,A02,083736,Patchell; Gregory David,28,0,30,2
1650257169884,MATH 10A,A03,083737,Patchell; Gregory David,26,0,30,4
1650257175908,MATH 10B,A01,083207,Staff,0,6,30,30
1650257175908,MATH 10B,A02,083208,Staff,0,5,30,30
1650257175908,MATH 10B,B01,083739,Staff,17,0,30,13
1650257175908,MATH 10B,B02,083740,Staff,29,0,30,1
1650257181933,MATH 18,A01,083743,Staff,7,0,30,23
1650257181933,MATH 18,A02,083744,Staff,28,0,30,2
1650257181933,MATH 18,A03,083745,Staff,23,0,30,7
1650257181933,MATH 18,A04,083746,Staff,27,0,30,3
1650257181933,MATH 18,B01,083748,Staff,0,10,30,30
1650257181933,MATH 18,B02,083749,Staff,0,9,30,30
1650257181933,MATH 18,B03,083750,Staff,1,7,30,29
1650257181933,MATH 18,B04,083751,Staff,0,9,30,30
1650257187960,MATH 20A,A01,083754,Staff,26,0,40,14
1650257193984,MATH 20B,A01,083756,Staff,1,6,30,29
1650257193984,MATH 20B,A02,083757,Staff,0,7,30,30
1650257200009,MATH 20C,A01,083760,Staff,0,12,30,30
1650257200009,MATH 20C,A02,083761,Staff,0,13,30,30
1650257200009,MATH 20C,B01,083762,Staff,14,0,30,16
1650257200009,MATH 20C,B02,083763,Staff,28,0,30,2
1650257206033,MATH 20D,A01,083765,Staff,1,2,30,29
1650257206033,MATH 20D,A02,083766,Staff,8,0,30,22
1650257206033,MATH 20D,A03,083767,Staff,28,0,30,2
1650257212057,MATH 20E,A01,083771,Staff,7,0,30,23
1650257212057,MATH 20E,A02,083772,Staff,20,0,30,10
1650257212057,MATH 20E,B01,083773,Staff,0,0,30,30
1650257212057,MATH 20E,B02,083774,Staff,12,0,30,18
1650257218084,MATH 103A,A01,083777,Staff,0,9,30,30
1650257218084,MATH 103A,A02,083778,Staff,0,10,30,30
1650257218084,MATH 103A,B01,083779,Staff,0,10,30,30
1650257218084,MATH 103A,B02,083780,Staff,0,10,30,30
1650257224107,MATH 105,A01,085443,Staff,0,17,30,30
1650257230131,MATH 109,A01,083213,Anzaldo; Leesa B,0,5,30,30
1650257230131,MATH 109,A02,083214,Anzaldo; Leesa B,0,6,30,30
1650257230131,MATH 109,B01,083215,Anzaldo; Leesa B,0,4,30,30
1650257230131,MATH 109,B02,083216,Anzaldo; Leesa B,1,4,30,29
1650257236156,MATH 142A,A01,083219,Chow; Bennett,0,12,30,30
1650257236156,MATH 142A,A02,083220,Chow; Bennett,0,11,30,30
1650257236156,MATH 142A,B01,083221,Chow; Bennett,0,11,30,30
1650257236156,MATH 142A,B02,083222,Chow; Bennett,0,12,30,30
1650257242185,MATH 193A,A01,083224,Staff,0,5,30,30
1650257242185,MATH 193A,A02,083225,Staff,0,4,30,30
1650257242185,MATH 193A,A03,083781,Staff,0,2,30,30
1650257242185,MATH 193A,A04,083782,Staff,0,1,30,30
1650257248211,MATH 197,001,091859,McAuley; Julian John,9998,0,9999,1
1650257254280,COGS 9,A01,083615,Staff,0,14,60,60
1650257260305,COGS 11,A01,083617,Boyle; Mary E. T.,24,0,40,16
1650257266335,COGS 13,A01,083071,Staff,0,31,40,40
1650257272360,COGS 14A,A01,092681,Staff,1,15,100,99
1650257278382,COGS 14B,A01,083073,Cheng; Tzu-Han,0,9,50,50
1650257284408,COGS 17,A01,092677,Staff,30,0,75,45
1650257290431,COGS 100,A01,083619,Staff,1,22,60,59
1650257296455,COGS 101A,A01,083621,Davis; Joshua Daniel,0,21,60,60
1650257302477,COGS 101B,A01,091572,Staff,4,0,60,56
1650257308503,COGS 101C,A01,083625,Delgado; Tania,20,0,30,10
1650257314531,COGS 107A,A01,083627,Boyle; Mary E. T.,1,8,60,59
1650257320555,COGS 118A,A01,083075,Staff,14,0,60,46
1650257326585,CSE 3,A50,083646,Miranda; Gregory Joseph,22,0,38,16
1650257326585,CSE 3,A51,083647,Miranda; Gregory Joseph,37,0,37,0
1650257332608,CSE 8A,A50,083650,Miranda; Gregory Joseph,0,19,40,40
1650257338633,CSE 11,A01,083080,Cao; Yingjun,0,71,40,40
1650257344658,CSE 12,A01,083652,Staff,0,9,100,100
1650257350682,CSE 15L,A01,083654,Staff,0,1,50,50
1650257350682,CSE 15L,A02,083655,Staff,5,0,50,45
1650257356706,CSE 20,A01,083657,Staff,53,0,80,27
1650257362732,CSE 30,A01,083084,Eldon; John,0,72,40,40
1650257368761,CSE 100,A01,083659,Cao; Yingjun,0,64,50,50
1650257374785,CSE 134B,A01,083661,Powell; Thomas Allan,0,27,65,65
1650257380810,CSE 140,A01,083663,Staff,0,0,75,75
1650257386837,CSE 140L,A01,083088,Eldon; John,0,5,75,75
1650257392860,CSE 175,A01,083665,Kumar; Rakesh,8,0,25,17
1650257398885,CSE 190,A00,092507,Dubnov; Shlomo,14,0,20,6
1650257404912,ECE 45,A01,083139,Staff,0,13,40,40
1650257410946,ECE 65,A50,083695,Staff,0,5,30,30
1650257416980,ECE 109,A01,091882,Touri; Behrouz,47,0,70,23
1650257423004,ECE 180,A00,083140,Abi Samra; Nicholas Camill,24,0,30,6
1650257423004,ECE 180,B00,083141,Abi Samra; Nicholas Camill,7,0,30,23
1650257429028,MATH 10A,A01,083735,Patchell; Gregory David,11,0,30,19
1650257429028,MATH 10A,A02,083736,Patchell; Gregory David,28,0,30,2
1650257429028,MATH 10A,A03,083737,Patchell; Gregory David,26,0,30,4
1650257435051,MATH 10B,A01,083207,Staff,0,6,30,30
1650257435051,MATH 10B,A02,083208,Staff,0,5,30,30
1650257435051,MATH 10B,B01,083739,Staff,17,0,30,13
1650257435051,MATH 10B,B02,083740,Staff,29,0,30,1
1650257441080,MATH 18,A01,083743,Staff,7,0,30,23
1650257441080,MATH 18,A02,083744,Staff,28,0,30,2
1650257441080,MATH 18,A03,083745,Staff,23,0,30,7
1650257441080,MATH 18,A04,083746,Staff,27,0,30,3
1650257441080,MATH 18,B01,083748,Staff,0,10,30,30
1650257441080,MATH 18,B02,083749,Staff,0,9,30,30
1650257441080,MATH 18,B03,083750,Staff,1,7,30,29
1650257441080,MATH 18,B04,083751,Staff,0,9,30,30
1650257447107,MATH 20A,A01,083754,Staff,26,0,40,14
1650257453140,MATH 20B,A01,083756,Staff,1,6,30,29
1650257453140,MATH 20B,A02,083757,Staff,0,7,30,30
1650257459162,MATH 20C,A01,083760,Staff,0,12,30,30
1650257459162,MATH 20C,A02,083761,Staff,0,13,30,30
1650257459162,MATH 20C,B01,083762,Staff,14,0,30,16
1650257459162,MATH 20C,B02,083763,Staff,28,0,30,2
1650257465185,MATH 20D,A01,083765,Staff,1,2,30,29
1650257465185,MATH 20D,A02,083766,Staff,8,0,30,22
1650257465185,MATH 20D,A03,083767,Staff,28,0,30,2
1650257471220,MATH 20E,A01,083771,Staff,7,0,30,23
1650257471220,MATH 20E,A02,083772,Staff,20,0,30,10
1650257471220,MATH 20E,B01,083773,Staff,0,0,30,30
1650257471220,MATH 20E,B02,083774,Staff,12,0,30,18
1650257477247,MATH 103A,A01,083777,Staff,0,9,30,30
1650257477247,MATH 103A,A02,083778,Staff,0,10,30,30
1650257477247,MATH 103A,B01,083779,Staff,0,10,30,30
1650257477247,MATH 103A,B02,083780,Staff,0,10,30,30
1650257483274,MATH 105,A01,085443,Staff,0,17,30,30
1650257489298,MATH 109,A01,083213,Anzaldo; Leesa B,0,5,30,30
1650257489298,MATH 109,A02,083214,Anzaldo; Leesa B,0,6,30,30
1650257489298,MATH 109,B01,083215,Anzaldo; Leesa B,0,4,30,30
1650257489298,MATH 109,B02,083216,Anzaldo; Leesa B,1,4,30,29
1650257495326,MATH 142A,A01,083219,Chow; Bennett,0,12,30,30
1650257495326,MATH 142A,A02,083220,Chow; Bennett,0,11,30,30
1650257495326,MATH 142A,B01,083221,Chow; Bennett,0,11,30,30
1650257495326,MATH 142A,B02,083222,Chow; Bennett,0,12,30,30
1650257501355,MATH 193A,A01,083224,Staff,0,5,30,30
1650257501355,MATH 193A,A02,083225,Staff,0,4,30,30
1650257501355,MATH 193A,A03,083781,Staff,0,2,30,30
1650257501355,MATH 193A,A04,083782,Staff,0,1,30,30
1650257507384,MATH 197,001,091859,McAuley; Julian John,9998,0,9999,1
1650257513435,COGS 9,A01,083615,Staff,0,14,60,60
1650257519464,COGS 11,A01,083617,Boyle; Mary E. T.,24,0,40,16
1650257525487,COGS 13,A01,083071,Staff,0,31,40,40
1650257531511,COGS 14A,A01,092681,Staff,1,15,100,99
1650257537538,COGS 14B,A01,083073,Cheng; Tzu-Han,0,9,50,50
1650257543560,COGS 17,A01,092677,Staff,30,0,75,45
1650257549587,COGS 100,A01,083619,Staff,1,22,60,59
1650257555614,COGS 101A,A01,083621,Davis; Joshua Daniel,0,21,60,60
1650257561638,COGS 101B,A01,091572,Staff,4,0,60,56
1650257567662,COGS 101C,A01,083625,Delgado; Tania,20,0,30,10
1650257573763,COGS 107A,A01,083627,Boyle; Mary E. T.,1,8,60,59
1650257579787,COGS 118A,A01,083075,Staff,14,0,60,46
1650257585816,CSE 3,A50,083646,Miranda; Gregory Joseph,22,0,38,16
1650257585816,CSE 3,A51,083647,Miranda; Gregory Joseph,37,0,37,0
1650257591855,CSE 8A,A50,083650,Miranda; Gregory Joseph,0,19,40,40
1650257597877,CSE 11,A01,083080,Cao; Yingjun,0,71,40,40
1650257603903,CSE 12,A01,083652,Staff,0,9,100,100
1650257609928,CSE 15L,A01,083654,Staff,0,1,50,50
1650257609928,CSE 15L,A02,083655,Staff,5,0,50,45
1650257615950,CSE 20,A01,083657,Staff,53,0,80,27
1650257621984,CSE 30,A01,083084,Eldon; John,0,73,40,40
1650257628016,CSE 100,A01,083659,Cao; Yingjun,0,64,50,50
1650257634041,CSE 134B,A01,083661,Powell; Thomas Allan,0,27,65,65
1650257640064,CSE 140,A01,083663,Staff,0,0,75,75
1650257646094,CSE 140L,A01,083088,Eldon; John,0,5,75,75
1650257652118,CSE 175,A01,083665,Kumar; Rakesh,8,0,25,17
1650257658144,CSE 190,A00,092507,Dubnov; Shlomo,14,0,20,6
1650257664170,ECE 45,A01,083139,Staff,0,13,40,40
1650257670203,ECE 65,A50,083695,Staff,0,5,30,30
1650257676239,ECE 109,A01,091882,Touri; Behrouz,47,0,70,23
1650257682273,ECE 180,A00,083140,Abi Samra; Nicholas Camill,24,0,30,6
1650257682273,ECE 180,B00,083141,Abi Samra; Nicholas Camill,7,0,30,23
1650257688300,MATH 10A,A01,083735,Patchell; Gregory David,11,0,30,19
1650257688300,MATH 10A,A02,083736,Patchell; Gregory David,28,0,30,2
1650257688300,MATH 10A,A03,083737,Patchell; Gregory David,26,0,30,4
1650257694340,MATH 10B,A01,083207,Staff,0,6,30,30
1650257694340,MATH 10B,A02,083208,Staff,0,5,30,30
1650257694340,MATH 10B,B01,083739,Staff,17,0,30,13
1650257694340,MATH 10B,B02,083740,Staff,29,0,30,1
1650257700370,MATH 18,A01,083743,Staff,7,0,30,23
1650257700370,MATH 18,A02,083744,Staff,28,0,30,2
1650257700370,MATH 18,A03,083745,Staff,23,0,30,7
1650257700370,MATH 18,A04,083746,Staff,27,0,30,3
1650257700370,MATH 18,B01,083748,Staff,0,10,30,30
1650257700370,MATH 18,B02,083749,Staff,0,9,30,30
1650257700370,MATH 18,B03,083750,Staff,1,7,30,29
1650257700370,MATH 18,B04,083751,Staff,0,9,30,30
1650257706393,MATH 20A,A01,083754,Staff,26,0,40,14
1650257712420,MATH 20B,A01,083756,Staff,1,6,30,29
1650257712420,MATH 20B,A02,083757,Staff,0,7,30,30
1650257718449,MATH 20C,A01,083760,Staff,0,12,30,30
1650257718449,MATH 20C,A02,083761,Staff,0,13,30,30
1650257718449,MATH 20C,B01,083762,Staff,14,0,30,16
1650257718449,MATH 20C,B02,083763,Staff,28,0,30,2
1650257724475,MATH 20D,A01,083765,Staff,1,2,30,29
1650257724475,MATH 20D,A02,083766,Staff,8,0,30,22
1650257724475,MATH 20D,A03,083767,Staff,28,0,30,2
1650257730499,MATH 20E,A01,083771,Staff,6,0,30,24
1650257730499,MATH 20E,A02,083772,Staff,20,0,30,10
1650257730499,MATH 20E,B01,083773,Staff,0,0,30,30
1650257730499,MATH 20E,B02,083774,Staff,12,0,30,18
1650257736537,MATH 103A,A01,083777,Staff,0,9,30,30
1650257736537,MATH 103A,A02,083778,Staff,0,10,30,30
1650257736537,MATH 103A,B01,083779,Staff,0,10,30,30
1650257736537,MATH 103A,B02,083780,Staff,0,10,30,30
1650257742559,MATH 105,A01,085443,Staff,0,17,30,30
1650257748582,MATH 109,A01,083213,Anzaldo; Leesa B,0,5,30,30
1650257748582,MATH 109,A02,083214,Anzaldo; Leesa B,0,6,30,30
1650257748582,MATH 109,B01,083215,Anzaldo; Leesa B,0,4,30,30
1650257748582,MATH 109,B02,083216,Anzaldo; Leesa B,1,4,30,29
1650257754609,MATH 142A,A01,083219,Chow; Bennett,0,12,30,30
1650257754609,MATH 142A,A02,083220,Chow; Bennett,0,11,30,30
1650257754609,MATH 142A,B01,083221,Chow; Bennett,0,11,30,30
1650257754609,MATH 142A,B02,083222,Chow; Bennett,0,12,30,30
1650257760633,MATH 193A,A01,083224,Staff,0,5,30,30
1650257760633,MATH 193A,A02,083225,Staff,0,4,30,30
1650257760633,MATH 193A,A03,083781,Staff,0,2,30,30
1650257760633,MATH 193A,A04,083782,Staff,0,1,30,30
1650257766657,MATH 197,001,091859,McAuley; Julian John,9998,0,9999,1
1650257772713,COGS 9,A01,083615,Staff,0,14,60,60
1650257778739,COGS 11,A01,083617,Boyle; Mary E. T.,24,0,40,16
1650257784762,COGS 13,A01,083071,Staff,0,31,40,40
1650257790801,COGS 14A,A01,092681,Staff,1,15,100,99
1650257796825,COGS 14B,A01,083073,Cheng; Tzu-Han,0,9,50,50
1650257802849,COGS 17,A01,092677,Staff,30,0,75,45
1650257808873,COGS 100,A01,083619,Staff,1,22,60,59
1650257814897,COGS 101A,A01,083621,Davis; Joshua Daniel,0,21,60,60
1650257820923,COGS 101B,A01,091572,Staff,4,0,60,56
1650257826945,COGS 101C,A01,083625,Delgado; Tania,20,0,30,10
1650257832968,COGS 107A,A01,083627,Boyle; Mary E. T.,1,8,60,59
1650257838995,COGS 118A,A01,083075,Staff,14,0,60,46
1650257845030,CSE 3,A50,083646,Miranda; Gregory Joseph,22,0,38,16
1650257845030,CSE 3,A51,083647,Miranda; Gregory Joseph,37,0,37,0
1650257851058,CSE 8A,A50,083650,Miranda; Gregory Joseph,0,19,40,40
1650257857088,CSE 11,A01,083080,Cao; Yingjun,0,70,40,40
1650257863116,CSE 12,A01,083652,Staff,0,9,100,100
1650257869142,CSE 15L,A01,083654,Staff,0,1,50,50
1650257869142,CSE 15L,A02,083655,Staff,5,0,50,45
1650257875167,CSE 20,A01,083657,Staff,53,0,80,27
1650257881191,CSE 30,A01,083084,Eldon; John,0,73,40,40
1650257887214,CSE 100,A01,083659,Cao; Yingjun,0,64,50,50
1650257893236,CSE 134B,A01,083661,Powell; Thomas Allan,0,27,65,65
1650257899260,CSE 140,A01,083663,Staff,0,0,75,75
1650257905282,CSE 140L,A01,083088,Eldon; John,0,5,75,75
1650257911306,CSE 175,A01,083665,Kumar; Rakesh,8,0,25,17
1650257917332,CSE 190,A00,092507,Dubnov; Shlomo,14,0,20,6
1650257923354,ECE 45,A01,083139,Staff,0,13,40,40
1650257929377,ECE 65,A50,083695,Staff,0,5,30,30
1650257935401,ECE 109,A01,091882,Touri; Behrouz,47,0,70,23
1650257941424,ECE 180,A00,083140,Abi Samra; Nicholas Camill,24,0,30,6
1650257941424,ECE 180,B00,083141,Abi Samra; Nicholas Camill,7,0,30,23
1650257947461,MATH 10A,A01,083735,Patchell; Gregory David,11,0,30,19
1650257947461,MATH 10A,A02,083736,Patchell; Gregory David,28,0,30,2
1650257947461,MATH 10A,A03,083737,Patchell; Gregory David,26,0,30,4
1650257953492,MATH 10B,A01,083207,Staff,0,6,30,30
1650257953492,MATH 10B,A02,083208,Staff,0,5,30,30
1650257953492,MATH 10B,B01,083739,Staff,17,0,30,13
1650257953492,MATH 10B,B02,083740,Staff,29,0,30,1
1650257959532,MATH 18,A01,083743,Staff,7,0,30,23
1650257959532,MATH 18,A02,083744,Staff,28,0,30,2
1650257959532,MATH 18,A03,083745,Staff,23,0,30,7
1650257959532,MATH 18,A04,083746,Staff,27,0,30,3
1650257959532,MATH 18,B01,083748,Staff,0,10,30,30
1650257959532,MATH 18,B02,083749,Staff,0,9,30,30
1650257959532,MATH 18,B03,083750,Staff,1,7,30,29
1650257959532,MATH 18,B04,083751,Staff,0,9,30,30
1650257965557,MATH 20A,A01,083754,Staff,26,0,40,14
1650257971580,MATH 20B,A01,083756,Staff,1,6,30,29
1650257971580,MATH 20B,A02,083757,Staff,0,7,30,30
1650257977603,MATH 20C,A01,083760,Staff,0,12,30,30
1650257977603,MATH 20C,A02,083761,Staff,0,13,30,30
1650257977603,MATH 20C,B01,083762,Staff,14,0,30,16
1650257977603,MATH 20C,B02,083763,Staff,28,0,30,2
1650257983628,MATH 20D,A01,083765,Staff,1,2,30,29
1650257983628,MATH 20D,A02,083766,Staff,8,0,30,22
1650257983628,MATH 20D,A03,083767,Staff,28,0,30,2
1650257989655,MATH 20E,A01,083771,Staff,6,0,30,24
1650257989655,MATH 20E,A02,083772,Staff,20,0,30,10
1650257989655,MATH 20E,B01,083773,Staff,0,0,30,30
1650257989655,MATH 20E,B02,083774,Staff,12,0,30,18
1650257995684,MATH 103A,A01,083777,Staff,0,9,30,30
1650257995684,MATH 103A,A02,083778,Staff,0,10,30,30
1650257995684,MATH 103A,B01,083779,Staff,0,10,30,30
1650257995684,MATH 103A,B02,083780,Staff,0,10,30,30
1650258001717,MATH 105,A01,085443,Staff,0,17,30,30
1650258007742,MATH 109,A01,083213,Anzaldo; Leesa B,0,5,30,30
1650258007742,MATH 109,A02,083214,Anzaldo; Leesa B,0,6,30,30
1650258007742,MATH 109,B01,083215,Anzaldo; Leesa B,0,4,30,30
1650258007742,MATH 109,B02,083216,Anzaldo; Leesa B,1,4,30,29
1650258013768,MATH 142A,A01,083219,Chow; Bennett,0,12,30,30
1650258013768,MATH 142A,A02,083220,Chow; Bennett,0,11,30,30
1650258013768,MATH 142A,B01,083221,Chow; Bennett,0,11,30,30
1650258013768,MATH 142A,B02,083222,Chow; Bennett,0,12,30,30
1650258019790,MATH 193A,A01,083224,Staff,0,5,30,30
1650258019790,MATH 193A,A02,083225,Staff,0,4,30,30
1650258019790,MATH 193A,A03,083781,Staff,0,2,30,30
1650258019790,MATH 193A,A04,083782,Staff,0,1,30,30
1650258025817,MATH 197,001,091859,McAuley; Julian John,9998,0,9999,1
1650258031867,COGS 9,A01,083615,Staff,0,14,60,60
1650258037890,COGS 11,A01,083617,Boyle; Mary E. T.,24,0,40,16
1650258043921,COGS 13,A01,083071,Staff,0,31,40,40
1650258049948,COGS 14A,A01,092681,Staff,1,15,100,99
1650258055971,COGS 14B,A01,083073,Cheng; Tzu-Han,0,9,50,50
1650258061994,COGS 17,A01,092677,Staff,30,0,75,45
1650258068017,COGS 100,A01,083619,Staff,1,22,60,59
1650258074041,COGS 101A,A01,083621,Davis; Joshua Daniel,0,21,60,60
1650258080063,COGS 101B,A01,091572,Staff,4,0,60,56
1650258086094,COGS 101C,A01,083625,Delgado; Tania,20,0,30,10
1650258092118,COGS 107A,A01,083627,Boyle; Mary E. T.,1,8,60,59
1650258098142,COGS 118A,A01,083075,Staff,14,0,60,46
1650258104171,CSE 3,A50,083646,Miranda; Gregory Joseph,22,0,38,16
1650258104171,CSE 3,A51,083647,Miranda; Gregory Joseph,37,0,37,0
1650258110197,CSE 8A,A50,083650,Miranda; Gregory Joseph,0,19,40,40
1650258116219,CSE 11,A01,083080,Cao; Yingjun,0,71,40,40
1650258122242,CSE 12,A01,083652,Staff,0,9,100,100
1650258128267,CSE 15L,A01,083654,Staff,0,1,50,50
1650258128267,CSE 15L,A02,083655,Staff,5,0,50,45
1650258134294,CSE 20,A01,083657,Staff,53,0,80,27
1650258140321,CSE 30,A01,083084,Eldon; John,0,73,40,40
1650258146345,CSE 100,A01,083659,Cao; Yingjun,0,64,50,50
1650258152369,CSE 134B,A01,083661,Powell; Thomas Allan,0,27,65,65
1650258158395,CSE 140,A01,083663,Staff,0,0,75,75
1650258164420,CSE 140L,A01,083088,Eldon; John,0,5,75,75
1650258170533,CSE 175,A01,083665,Kumar; Rakesh,8,0,25,17
1650258176555,CSE 190,A00,092507,Dubnov; Shlomo,14,0,20,6
1650258182579,ECE 45,A01,083139,Staff,0,13,40,40
1650258188603,ECE 65,A50,083695,Staff,0,5,30,30
1650258194626,ECE 109,A01,091882,Touri; Behrouz,47,0,70,23
1650258200653,ECE 180,A00,083140,Abi Samra; Nicholas Camill,24,0,30,6
1650258200653,ECE 180,B00,083141,Abi Samra; Nicholas Camill,7,0,30,23
1650258206680,MATH 10A,A01,083735,Patchell; Gregory David,11,0,30,19
1650258206680,MATH 10A,A02,083736,Patchell; Gregory David,28,0,30,2
1650258206680,MATH 10A,A03,083737,Patchell; Gregory David,26,0,30,4
1650258212704,MATH 10B,A01,083207,Staff,0,6,30,30
1650258212704,MATH 10B,A02,083208,Staff,0,5,30,30
1650258212704,MATH 10B,B01,083739,Staff,17,0,30,13
1650258212704,MATH 10B,B02,083740,Staff,29,0,30,1
1650258218730,MATH 18,A01,083743,Staff,7,0,30,23
1650258218730,MATH 18,A02,083744,Staff,28,0,30,2
1650258218730,MATH 18,A03,083745,Staff,23,0,30,7
1650258218730,MATH 18,A04,083746,Staff,27,0,30,3
1650258218730,MATH 18,B01,083748,Staff,0,10,30,30
1650258218730,MATH 18,B02,083749,Staff,0,9,30,30
1650258218730,MATH 18,B03,083750,Staff,1,7,30,29
1650258218730,MATH 18,B04,083751,Staff,0,9,30,30
1650258224754,MATH 20A,A01,083754,Staff,26,0,40,14
1650258230782,MATH 20B,A01,083756,Staff,1,6,30,29
1650258230782,MATH 20B,A02,083757,Staff,0,7,30,30
1650258236806,MATH 20C,A01,083760,Staff,0,13,30,30
1650258236806,MATH 20C,A02,083761,Staff,0,13,30,30
1650258236806,MATH 20C,B01,083762,Staff,14,0,30,16
1650258236806,MATH 20C,B02,083763,Staff,28,0,30,2
1650258242831,MATH 20D,A01,083765,Staff,1,2,30,29
1650258242831,MATH 20D,A02,083766,Staff,8,0,30,22
1650258242831,MATH 20D,A03,083767,Staff,28,0,30,2
1650258248862,MATH 20E,A01,083771,Staff,6,0,30,24
1650258248862,MATH 20E,A02,083772,Staff,20,0,30,10
1650258248862,MATH 20E,B01,083773,Staff,0,0,30,30
1650258248862,MATH 20E,B02,083774,Staff,12,0,30,18
1650258254896,MATH 103A,A01,083777,Staff,0,9,30,30
1650258254896,MATH 103A,A02,083778,Staff,0,10,30,30
1650258254896,MATH 103A,B01,083779,Staff,0,10,30,30
1650258254896,MATH 103A,B02,083780,Staff,0,10,30,30
1650258260918,MATH 105,A01,085443,Staff,0,17,30,30
1650258266946,MATH 109,A01,083213,Anzaldo; Leesa B,0,5,30,30
1650258266946,MATH 109,A02,083214,Anzaldo; Leesa B,0,6,30,30
1650258266946,MATH 109,B01,083215,Anzaldo; Leesa B,0,4,30,30
1650258266946,MATH 109,B02,083216,Anzaldo; Leesa B,1,4,30,29
1650258272975,MATH 142A,A01,083219,Chow; Bennett,0,12,30,30
1650258272975,MATH 142A,A02,083220,Chow; Bennett,0,11,30,30
1650258272975,MATH 142A,B01,083221,Chow; Bennett,0,11,30,30
1650258272975,MATH 142A,B02,083222,Chow; Bennett,0,12,30,30
1650258279000,MATH 193A,A01,083224,Staff,0,5,30,30
1650258279000,MATH 193A,A02,083225,Staff,0,4,30,30
1650258279000,MATH 193A,A03,083781,Staff,0,2,30,30
1650258279000,MATH 193A,A04,083782,Staff,0,1,30,30
1650258285023,MATH 197,001,091859,McAuley; Julian John,9998,0,9999,1
1650258291083,COGS 9,A01,083615,Staff,0,14,60,60
1650258297110,COGS 11,A01,083617,Boyle; Mary E. T.,24,0,40,16
1650258303134,COGS 13,A01,083071,Staff,0,31,40,40
1650258309159,COGS 14A,A01,092681,Staff,1,15,100,99
1650258315185,COGS 14B,A01,083073,Cheng; Tzu-Han,0,9,50,50
1650258321210,COGS 17,A01,092677,Staff,30,0,75,45
1650258327235,COGS 100,A01,083619,Staff,1,22,60,59
1650258333267,COGS 101A,A01,083621,Davis; Joshua Daniel,0,21,60,60
1650258339290,COGS 101B,A01,091572,Staff,4,0,60,56
1650258345317,COGS 101C,A01,083625,Delgado; Tania,20,0,30,10
1650258351345,COGS 107A,A01,083627,Boyle; Mary E. T.,1,8,60,59
1650258357368,COGS 118A,A01,083075,Staff,13,0,60,47
1650258363396,CSE 3,A50,083646,Miranda; Gregory Joseph,22,0,38,16
1650258363396,CSE 3,A51,083647,Miranda; Gregory Joseph,37,0,37,0
1650258369424,CSE 8A,A50,083650,Miranda; Gregory Joseph,0,19,40,40
1650258375447,CSE 11,A01,083080,Cao; Yingjun,0,71,40,40
1650258381472,CSE 12,A01,083652,Staff,0,9,100,100
1650258387515,CSE 15L,A01,083654,Staff,0,1,50,50
1650258387515,CSE 15L,A02,083655,Staff,5,0,50,45
1650258404527,CSE 20,A01,083657,Staff,53,0,80,27
1650258410550,CSE 30,A01,083084,Eldon; John,0,73,40,40
1650258416573,CSE 100,A01,083659,Cao; Yingjun,0,64,50,50
1650258422600,CSE 134B,A01,083661,Powell; Thomas Allan,0,27,65,65
1650258428622,CSE 140,A01,083663,Staff,0,0,75,75
1650258434648,CSE 140L,A01,083088,Eldon; John,0,5,75,75
1650258440674,CSE 175,A01,083665,Kumar; Rakesh,8,0,25,17
1650258446698,CSE 190,A00,092507,Dubnov; Shlomo,14,0,20,6
1650258452723,ECE 45,A01,083139,Staff,0,13,40,40
1650258458747,ECE 65,A50,083695,Staff,0,5,30,30
1650258464773,ECE 109,A01,091882,Touri; Behrouz,47,0,70,23
1650258470798,ECE 180,A00,083140,Abi Samra; Nicholas Camill,24,0,30,6
1650258470798,ECE 180,B00,083141,Abi Samra; Nicholas Camill,7,0,30,23
1650258476822,MATH 10A,A01,083735,Patchell; Gregory David,11,0,30,19
1650258476822,MATH 10A,A02,083736,Patchell; Gregory David,28,0,30,2
1650258476822,MATH 10A,A03,083737,Patchell; Gregory David,26,0,30,4
1650258482857,MATH 10B,A01,083207,Staff,0,6,30,30
1650258482857,MATH 10B,A02,083208,Staff,0,5,30,30
1650258482857,MATH 10B,B01,083739,Staff,17,0,30,13
1650258482857,MATH 10B,B02,083740,Staff,29,0,30,1
1650258488880,MATH 18,A01,083743,Staff,7,0,30,23
1650258488880,MATH 18,A02,083744,Staff,28,0,30,2
1650258488880,MATH 18,A03,083745,Staff,23,0,30,7
1650258488880,MATH 18,A04,083746,Staff,27,0,30,3
1650258488880,MATH 18,B01,083748,Staff,0,10,30,30
1650258488880,MATH 18,B02,083749,Staff,0,9,30,30
1650258488880,MATH 18,B03,083750,Staff,1,7,30,29
1650258488880,MATH 18,B04,083751,Staff,0,9,30,30
1650258494903,MATH 20A,A01,083754,Staff,26,0,40,14
1650258500932,MATH 20B,A01,083756,Staff,1,6,30,29
1650258500932,MATH 20B,A02,083757,Staff,0,7,30,30
1650258506956,MATH 20C,A01,083760,Staff,0,13,30,30
1650258506956,MATH 20C,A02,083761,Staff,0,13,30,30
1650258506956,MATH 20C,B01,083762,Staff,14,0,30,16
1650258506956,MATH 20C,B02,083763,Staff,28,0,30,2
1650258512992,MATH 20D,A01,083765,Staff,1,2,30,29
1650258512992,MATH 20D,A02,083766,Staff,8,0,30,22
1650258512992,MATH 20D,A03,083767,Staff,28,0,30,2
1650258519020,MATH 20E,A01,083771,Staff,6,0,30,24
1650258519020,MATH 20E,A02,083772,Staff,20,0,30,10
1650258519020,MATH 20E,B01,083773,Staff,0,0,30,30
1650258519020,MATH 20E,B02,083774,Staff,12,0,30,18
1650258525049,MATH 103A,A01,083777,Staff,0,9,30,30
1650258525049,MATH 103A,A02,083778,Staff,0,10,30,30
1650258525049,MATH 103A,B01,083779,Staff,0,10,30,30
1650258525049,MATH 103A,B02,083780,Staff,0,10,30,30
1650258531073,MATH 105,A01,085443,Staff,0,17,30,30
1650258537104,MATH 109,A01,083213,Anzaldo; Leesa B,0,5,30,30
1650258537104,MATH 109,A02,083214,Anzaldo; Leesa B,0,6,30,30
1650258537104,MATH 109,B01,083215,Anzaldo; Leesa B,0,4,30,30
1650258537104,MATH 109,B02,083216,Anzaldo; Leesa B,1,4,30,29
1650258543133,MATH 142A,A01,083219,Chow; Bennett,0,12,30,30
1650258543133,MATH 142A,A02,083220,Chow; Bennett,0,11,30,30
1650258543133,MATH 142A,B01,083221,Chow; Bennett,0,11,30,30
1650258543133,MATH 142A,B02,083222,Chow; Bennett,0,12,30,30
1650258549157,MATH 193A,A01,083224,Staff,0,5,30,30
1650258549157,MATH 193A,A02,083225,Staff,0,4,30,30
1650258549157,MATH 193A,A03,083781,Staff,0,2,30,30
1650258549157,MATH 193A,A04,083782,Staff,0,1,30,30
1650258555184,MATH 197,001,091859,McAuley; Julian John,9998,0,9999,1
1650258561245,COGS 9,A01,083615,Staff,0,14,60,60
1650258567271,COGS 11,A01,083617,Boyle; Mary E. T.,24,0,40,16
1650258573301,COGS 13,A01,083071,Staff,0,31,40,40
1650258579328,COGS 14A,A01,092681,Staff,1,15,100,99
1650258585351,COGS 14B,A01,083073,Cheng; Tzu-Han,0,9,50,50
1650258591378,COGS 17,A01,092677,Staff,30,0,75,45
1650258597402,COGS 100,A01,083619,Staff,1,22,60,59
1650258603439,COGS 101A,A01,083621,Davis; Joshua Daniel,0,21,60,60
1650258609463,COGS 101B,A01,091572,Staff,4,0,60,56
1650258615490,COGS 101C,A01,083625,Delgado; Tania,20,0,30,10
1650258621517,COGS 107A,A01,083627,Boyle; Mary E. T.,1,8,60,59
1650258627542,COGS 118A,A01,083075,Staff,13,0,60,47
1650258633566,CSE 3,A50,083646,Miranda; Gregory Joseph,22,0,38,16
1650258633566,CSE 3,A51,083647,Miranda; Gregory Joseph,37,0,37,0
1650258639596,CSE 8A,A50,083650,Miranda; Gregory Joseph,0,19,40,40
1650258645621,CSE 11,A01,083080,Cao; Yingjun,0,71,40,40
1650258651644,CSE 12,A01,083652,Staff,0,9,100,100
1650258657667,CSE 15L,A01,083654,Staff,0,1,50,50
1650258657667,CSE 15L,A02,083655,Staff,5,0,50,45
1650258663693,CSE 20,A01,083657,Staff,53,0,80,27
1650258669719,CSE 30,A01,083084,Eldon; John,0,73,40,40
1650258675750,CSE 100,A01,083659,Cao; Yingjun,0,64,50,50
1650258681772,CSE 134B,A01,083661,Powell; Thomas Allan,0,27,65,65
1650258687797,CSE 140,A01,083663,Staff,0,0,75,75
1650258693824,CSE 140L,A01,083088,Eldon; John,0,5,75,75
1650258699855,CSE 175,A01,083665,Kumar; Rakesh,8,0,25,17
1650258705879,CSE 190,A00,092507,Dubnov; Shlomo,14,0,20,6
1650258711911,ECE 45,A01,083139,Staff,0,13,40,40
1650258717938,ECE 65,A50,083695,Staff,0,5,30,30
1650258723963,ECE 109,A01,091882,Touri; Behrouz,47,0,70,23
1650258729987,ECE 180,A00,083140,Abi Samra; Nicholas Camill,24,0,30,6
1650258729987,ECE 180,B00,083141,Abi Samra; Nicholas Camill,7,0,30,23
1650258736012,MATH 10A,A01,083735,Patchell; Gregory David,11,0,30,19
1650258736012,MATH 10A,A02,083736,Patchell; Gregory David,28,0,30,2
1650258736012,MATH 10A,A03,083737,Patchell; Gregory David,26,0,30,4
1650258742036,MATH 10B,A01,083207,Staff,0,6,30,30
1650258742036,MATH 10B,A02,083208,Staff,0,5,30,30
1650258742036,MATH 10B,B01,083739,Staff,17,0,30,13
1650258742036,MATH 10B,B02,083740,Staff,29,0,30,1
1650258748061,MATH 18,A01,083743,Staff,7,0,30,23
1650258748061,MATH 18,A02,083744,Staff,28,0,30,2
1650258748061,MATH 18,A03,083745,Staff,23,0,30,7
1650258748061,MATH 18,A04,083746,Staff,27,0,30,3
1650258748061,MATH 18,B01,083748,Staff,0,10,30,30
1650258748061,MATH 18,B02,083749,Staff,0,9,30,30
1650258748061,MATH 18,B03,083750,Staff,1,7,30,29
1650258748061,MATH 18,B04,083751,Staff,0,9,30,30
1650258754084,MATH 20A,A01,083754,Staff,26,0,40,14
1650258760111,MATH 20B,A01,083756,Staff,1,6,30,29
1650258760111,MATH 20B,A02,083757,Staff,0,7,30,30
1650258766147,MATH 20C,A01,083760,Staff,0,13,30,30
1650258766147,MATH 20C,A02,083761,Staff,0,13,30,30
1650258766147,MATH 20C,B01,083762,Staff,14,0,30,16
1650258766147,MATH 20C,B02,083763,Staff,28,0,30,2
1650258772176,MATH 20D,A01,083765,Staff,1,2,30,29
1650258772176,MATH 20D,A02,083766,Staff,8,0,30,22
1650258772176,MATH 20D,A03,083767,Staff,28,0,30,2
1650258778309,MATH 20E,A01,083771,Staff,6,0,30,24
1650258778309,MATH 20E,A02,083772,Staff,20,0,30,10
1650258778309,MATH 20E,B01,083773,Staff,0,0,30,30
1650258778309,MATH 20E,B02,083774,Staff,12,0,30,18
1650258784332,MATH 103A,A01,083777,Staff,0,9,30,30
1650258784332,MATH 103A,A02,083778,Staff,0,10,30,30
1650258784332,MATH 103A,B01,083779,Staff,0,10,30,30
1650258784332,MATH 103A,B02,083780,Staff,0,10,30,30
1650258790356,MATH 105,A01,085443,Staff,0,17,30,30
1650258796379,MATH 109,A01,083213,Anzaldo; Leesa B,0,5,30,30
1650258796379,MATH 109,A02,083214,Anzaldo; Leesa B,0,6,30,30
1650258796379,MATH 109,B01,083215,Anzaldo; Leesa B,0,4,30,30
1650258796379,MATH 109,B02,083216,Anzaldo; Leesa B,1,4,30,29
1650258802404,MATH 142A,A01,083219,Chow; Bennett,0,12,30,30
1650258802404,MATH 142A,A02,083220,Chow; Bennett,0,11,30,30
1650258802404,MATH 142A,B01,083221,Chow; Bennett,0,11,30,30
1650258802404,MATH 142A,B02,083222,Chow; Bennett,0,12,30,30
1650258808431,MATH 193A,A01,083224,Staff,0,5,30,30
1650258808431,MATH 193A,A02,083225,Staff,0,4,30,30
1650258808431,MATH 193A,A03,083781,Staff,0,2,30,30
1650258808431,MATH 193A,A04,083782,Staff,0,1,30,30
1650258814457,MATH 197,001,091859,McAuley; Julian John,9998,0,9999,1
1650258820521,COGS 9,A01,083615,Staff,0,14,60,60
1650258826548,COGS 11,A01,083617,Boyle; Mary E. T.,24,0,40,16
1650258832572,COGS 13,A01,083071,Staff,0,31,40,40
1650258838594,COGS 14A,A01,092681,Staff,1,15,100,99
1650258844623,COGS 14B,A01,083073,Cheng; Tzu-Han,0,9,50,50
1650258850647,COGS 17,A01,092677,Staff,30,0,75,45
1650258856670,COGS 100,A01,083619,Staff,1,22,60,59
1650258862698,COGS 101A,A01,083621,Davis; Joshua Daniel,0,21,60,60
1650258868721,COGS 101B,A01,091572,Staff,4,0,60,56
1650258874748,COGS 101C,A01,083625,Delgado; Tania,20,0,30,10
1650258880783,COGS 107A,A01,083627,Boyle; Mary E. T.,1,8,60,59
1650258886811,COGS 118A,A01,083075,Staff,13,0,60,47
1650258892835,CSE 3,A50,083646,Miranda; Gregory Joseph,22,0,38,16
1650258892835,CSE 3,A51,083647,Miranda; Gregory Joseph,37,0,37,0
1650258898859,CSE 8A,A50,083650,Miranda; Gregory Joseph,0,19,40,40
1650258904889,CSE 11,A01,083080,Cao; Yingjun,0,71,40,40
1650258910916,CSE 12,A01,083652,Staff,0,9,100,100
1650258916947,CSE 15L,A01,083654,Staff,0,1,50,50
1650258916947,CSE 15L,A02,083655,Staff,5,0,50,45
1650258922979,CSE 20,A01,083657,Staff,53,0,80,27
1650258929005,CSE 30,A01,083084,Eldon; John,0,73,40,40
1650258935029,CSE 100,A01,083659,Cao; Yingjun,0,64,50,50
1650258941054,CSE 134B,A01,083661,Powell; Thomas Allan,0,27,65,65
1650258947080,CSE 140,A01,083663,Staff,0,0,75,75
1650258953107,CSE 140L,A01,083088,Eldon; John,0,5,75,75
1650258959132,CSE 175,A01,083665,Kumar; Rakesh,8,0,25,17
1650258965156,CSE 190,A00,092507,Dubnov; Shlomo,14,0,20,6
1650258971182,ECE 45,A01,083139,Staff,0,13,40,40
1650258977204,ECE 65,A50,083695,Staff,0,5,30,30
1650258983229,ECE 109,A01,091882,Touri; Behrouz,47,0,70,23
1650258989259,ECE 180,A00,083140,Abi Samra; Nicholas Camill,24,0,30,6
1650258989259,ECE 180,B00,083141,Abi Samra; Nicholas Camill,7,0,30,23
1650258995287,MATH 10A,A01,083735,Patchell; Gregory David,11,0,30,19
1650258995287,MATH 10A,A02,083736,Patchell; Gregory David,28,0,30,2
1650258995287,MATH 10A,A03,083737,Patchell; Gregory David,26,0,30,4
1650259001311,MATH 10B,A01,083207,Staff,0,6,30,30
1650259001311,MATH 10B,A02,083208,Staff,0,5,30,30
1650259001311,MATH 10B,B01,083739,Staff,17,0,30,13
1650259001311,MATH 10B,B02,083740,Staff,29,0,30,1
1650259007337,MATH 18,A01,083743,Staff,7,0,30,23
1650259007337,MATH 18,A02,083744,Staff,28,0,30,2
1650259007337,MATH 18,A03,083745,Staff,23,0,30,7
1650259007337,MATH 18,A04,083746,Staff,27,0,30,3
1650259007337,MATH 18,B01,083748,Staff,0,10,30,30
1650259007337,MATH 18,B02,083749,Staff,0,9,30,30
1650259007337,MATH 18,B03,083750,Staff,1,7,30,29
1650259007337,MATH 18,B04,083751,Staff,0,9,30,30
1650259013362,MATH 20A,A01,083754,Staff,26,0,40,14
1650259019389,MATH 20B,A01,083756,Staff,1,6,30,29
1650259019389,MATH 20B,A02,083757,Staff,0,7,30,30
1650259025413,MATH 20C,A01,083760,Staff,0,13,30,30
1650259025413,MATH 20C,A02,083761,Staff,0,13,30,30
1650259025413,MATH 20C,B01,083762,Staff,14,0,30,16
1650259025413,MATH 20C,B02,083763,Staff,28,0,30,2
1650259031445,MATH 20D,A01,083765,Staff,1,2,30,29
1650259031445,MATH 20D,A02,083766,Staff,8,0,30,22
1650259031445,MATH 20D,A03,083767,Staff,28,0,30,2
1650259037481,MATH 20E,A01,083771,Staff,6,0,30,24
1650259037481,MATH 20E,A02,083772,Staff,20,0,30,10
1650259037481,MATH 20E,B01,083773,Staff,0,0,30,30
1650259037481,MATH 20E,B02,083774,Staff,12,0,30,18
1650259043506,MATH 103A,A01,083777,Staff,0,9,30,30
1650259043506,MATH 103A,A02,083778,Staff,0,10,30,30
1650259043506,MATH 103A,B01,083779,Staff,0,10,30,30
1650259043506,MATH 103A,B02,083780,Staff,0,10,30,30
1650259049530,MATH 105,A01,085443,Staff,0,17,30,30
1650259055555,MATH 109,A01,083213,Anzaldo; Leesa B,0,5,30,30
1650259055555,MATH 109,A02,083214,Anzaldo; Leesa B,0,6,30,30
1650259055555,MATH 109,B01,083215,Anzaldo; Leesa B,0,4,30,30
1650259055555,MATH 109,B02,083216,Anzaldo; Leesa B,1,4,30,29
1650259061579,MATH 142A,A01,083219,Chow; Bennett,0,12,30,30
1650259061579,MATH 142A,A02,083220,Chow; Bennett,0,11,30,30
1650259061579,MATH 142A,B01,083221,Chow; Bennett,0,11,30,30
1650259061579,MATH 142A,B02,083222,Chow; Bennett,0,12,30,30
1650259067602,MATH 193A,A01,083224,Staff,0,5,30,30
1650259067602,MATH 193A,A02,083225,Staff,0,4,30,30
1650259067602,MATH 193A,A03,083781,Staff,0,2,30,30
1650259067602,MATH 193A,A04,083782,Staff,0,1,30,30
1650259073627,MATH 197,001,091859,McAuley; Julian John,9998,0,9999,1
1650259079684,COGS 9,A01,083615,Staff,0,14,60,60
1650259085710,COGS 11,A01,083617,Boyle; Mary E. T.,24,0,40,16
1650259091737,COGS 13,A01,083071,Staff,0,31,40,40
1650259097767,COGS 14A,A01,092681,Staff,1,15,100,99
1650259103799,COGS 14B,A01,083073,Cheng; Tzu-Han,0,9,50,50
1650259109826,COGS 17,A01,092677,Staff,30,0,75,45
1650259115853,COGS 100,A01,083619,Staff,1,22,60,59
1650259121882,COGS 101A,A01,083621,Davis; Joshua Daniel,0,21,60,60
1650259127905,COGS 101B,A01,091572,Staff,4,0,60,56
1650259133942,COGS 101C,A01,083625,Delgado; Tania,20,0,30,10
1650259139977,COGS 107A,A01,083627,Boyle; Mary E. T.,1,8,60,59
1650259146004,COGS 118A,A01,083075,Staff,13,0,60,47
1650259152032,CSE 3,A50,083646,Miranda; Gregory Joseph,22,0,38,16
1650259152032,CSE 3,A51,083647,Miranda; Gregory Joseph,37,0,37,0
1650259158061,CSE 8A,A50,083650,Miranda; Gregory Joseph,0,19,40,40
1650259164085,CSE 11,A01,083080,Cao; Yingjun,0,71,40,40
1650259170130,CSE 12,A01,083652,Staff,0,9,100,100
1650259176156,CSE 15L,A01,083654,Staff,0,1,50,50
1650259176156,CSE 15L,A02,083655,Staff,5,0,50,45
1650259182187,CSE 20,A01,083657,Staff,53,0,80,27
1650259188230,CSE 30,A01,083084,Eldon; John,0,73,40,40
1650259194255,CSE 100,A01,083659,Cao; Yingjun,0,64,50,50
1650259200292,CSE 134B,A01,083661,Powell; Thomas Allan,0,27,65,65
1650259206318,CSE 140,A01,083663,Staff,0,0,75,75
1650259212341,CSE 140L,A01,083088,Eldon; John,0,5,75,75
1650259218368,CSE 175,A01,083665,Kumar; Rakesh,8,0,25,17
1650259224414,CSE 190,A00,092507,Dubnov; Shlomo,14,0,20,6
1650259230441,ECE 45,A01,083139,Staff,0,13,40,40
1650259236464,ECE 65,A50,083695,Staff,0,5,30,30
1650259242492,ECE 109,A01,091882,Touri; Behrouz,47,0,70,23
1650259248517,ECE 180,A00,083140,Abi Samra; Nicholas Camill,24,0,30,6
1650259248517,ECE 180,B00,083141,Abi Samra; Nicholas Camill,7,0,30,23
1650259254556,MATH 10A,A01,083735,Patchell; Gregory David,11,0,30,19
1650259254556,MATH 10A,A02,083736,Patchell; Gregory David,28,0,30,2
1650259254556,MATH 10A,A03,083737,Patchell; Gregory David,26,0,30,4
1650259260583,MATH 10B,A01,083207,Staff,0,6,30,30
1650259260583,MATH 10B,A02,083208,Staff,0,5,30,30
1650259260583,MATH 10B,B01,083739,Staff,17,0,30,13
1650259260583,MATH 10B,B02,083740,Staff,29,0,30,1
1650259266613,MATH 18,A01,083743,Staff,7,0,30,23
1650259266613,MATH 18,A02,083744,Staff,28,0,30,2
1650259266613,MATH 18,A03,083745,Staff,23,0,30,7
1650259266613,MATH 18,A04,083746,Staff,27,0,30,3
1650259266613,MATH 18,B01,083748,Staff,0,10,30,30
1650259266613,MATH 18,B02,083749,Staff,0,9,30,30
1650259266613,MATH 18,B03,083750,Staff,1,7,30,29
1650259266613,MATH 18,B04,083751,Staff,0,9,30,30
1650259272635,MATH 20A,A01,083754,Staff,26,0,40,14
1650259278660,MATH 20B,A01,083756,Staff,1,6,30,29
1650259278660,MATH 20B,A02,083757,Staff,0,7,30,30
1650259284687,MATH 20C,A01,083760,Staff,0,13,30,30
1650259284687,MATH 20C,A02,083761,Staff,0,13,30,30
1650259284687,MATH 20C,B01,083762,Staff,14,0,30,16
1650259284687,MATH 20C,B02,083763,Staff,28,0,30,2
1650259290708,MATH 20D,A01,083765,Staff,1,2,30,29
1650259290708,MATH 20D,A02,083766,Staff,8,0,30,22
1650259290708,MATH 20D,A03,083767,Staff,28,0,30,2
1650259296738,MATH 20E,A01,083771,Staff,6,0,30,24
1650259296738,MATH 20E,A02,083772,Staff,20,0,30,10
1650259296738,MATH 20E,B01,083773,Staff,0,0,30,30
1650259296738,MATH 20E,B02,083774,Staff,12,0,30,18
1650259302763,MATH 103A,A01,083777,Staff,0,9,30,30
1650259302763,MATH 103A,A02,083778,Staff,0,10,30,30
1650259302763,MATH 103A,B01,083779,Staff,0,10,30,30
1650259302763,MATH 103A,B02,083780,Staff,0,10,30,30
1650259308788,MATH 105,A01,085443,Staff,0,17,30,30
1650259314836,MATH 109,A01,083213,Anzaldo; Leesa B,0,5,30,30
1650259314836,MATH 109,A02,083214,Anzaldo; Leesa B,0,6,30,30
1650259314836,MATH 109,B01,083215,Anzaldo; Leesa B,0,4,30,30
1650259314836,MATH 109,B02,083216,Anzaldo; Leesa B,1,4,30,29
1650259320868,MATH 142A,A01,083219,Chow; Bennett,0,12,30,30
1650259320868,MATH 142A,A02,083220,Chow; Bennett,0,11,30,30
1650259320868,MATH 142A,B01,083221,Chow; Bennett,0,11,30,30
1650259320868,MATH 142A,B02,083222,Chow; Bennett,0,12,30,30
1650259326892,MATH 193A,A01,083224,Staff,0,5,30,30
1650259326892,MATH 193A,A02,083225,Staff,0,4,30,30
1650259326892,MATH 193A,A03,083781,Staff,0,2,30,30
1650259326892,MATH 193A,A04,083782,Staff,0,1,30,30
1650259332916,MATH 197,001,091859,McAuley; Julian John,9998,0,9999,1
1650259338971,COGS 9,A01,083615,Staff,0,14,60,60
1650259344999,COGS 11,A01,083617,Boyle; Mary E. T.,24,0,40,16
1650259351032,COGS 13,A01,083071,Staff,0,31,40,40
1650259357062,COGS 14A,A01,092681,Staff,1,15,100,99
1650259363087,COGS 14B,A01,083073,Cheng; Tzu-Han,0,9,50,50
1650259369213,COGS 17,A01,092677,Staff,30,0,75,45
1650259375235,COGS 100,A01,083619,Staff,1,23,60,59
1650259381260,COGS 101A,A01,083621,Davis; Joshua Daniel,0,21,60,60
1650259387284,COGS 101B,A01,091572,Staff,4,0,60,56
1650259393319,COGS 101C,A01,083625,Delgado; Tania,20,0,30,10
1650259399350,COGS 107A,A01,083627,Boyle; Mary E. T.,1,8,60,59
1650259405383,COGS 118A,A01,083075,Staff,13,0,60,47
1650259411409,CSE 3,A50,083646,Miranda; Gregory Joseph,22,0,38,16
1650259411409,CSE 3,A51,083647,Miranda; Gregory Joseph,37,0,37,0
1650259417439,CSE 8A,A50,083650,Miranda; Gregory Joseph,0,19,40,40
1650259423467,CSE 11,A01,083080,Cao; Yingjun,0,71,40,40
1650259429500,CSE 12,A01,083652,Staff,0,9,100,100
1650259435531,CSE 15L,A01,083654,Staff,0,1,50,50
1650259435531,CSE 15L,A02,083655,Staff,5,0,50,45
1650259441565,CSE 20,A01,083657,Staff,53,0,80,27
1650259447588,CSE 30,A01,083084,Eldon; John,0,74,40,40
1650259453628,CSE 100,A01,083659,Cao; Yingjun,0,64,50,50
1650259459658,CSE 134B,A01,083661,Powell; Thomas Allan,0,27,65,65
1650259465685,CSE 140,A01,083663,Staff,0,0,75,75
1650259471707,CSE 140L,A01,083088,Eldon; John,0,5,75,75
1650259477734,CSE 175,A01,083665,Kumar; Rakesh,8,0,25,17
1650259483756,CSE 190,A00,092507,Dubnov; Shlomo,14,0,20,6
1650259489779,ECE 45,A01,083139,Staff,0,13,40,40
1650259495805,ECE 65,A50,083695,Staff,0,5,30,30
1650259501829,ECE 109,A01,091882,Touri; Behrouz,47,0,70,23
1650259507855,ECE 180,A00,083140,Abi Samra; Nicholas Camill,24,0,30,6
1650259507855,ECE 180,B00,083141,Abi Samra; Nicholas Camill,7,0,30,23
1650259513887,MATH 10A,A01,083735,Patchell; Gregory David,11,0,30,19
1650259513887,MATH 10A,A02,083736,Patchell; Gregory David,28,0,30,2
1650259513887,MATH 10A,A03,083737,Patchell; Gregory David,26,0,30,4
1650259519914,MATH 10B,A01,083207,Staff,0,6,30,30
1650259519914,MATH 10B,A02,083208,Staff,0,5,30,30
1650259519914,MATH 10B,B01,083739,Staff,17,0,30,13
1650259519914,MATH 10B,B02,083740,Staff,29,0,30,1
1650259525942,MATH 18,A01,083743,Staff,7,0,30,23
1650259525942,MATH 18,A02,083744,Staff,28,0,30,2
1650259525942,MATH 18,A03,083745,Staff,23,0,30,7
1650259525942,MATH 18,A04,083746,Staff,27,0,30,3
1650259525942,MATH 18,B01,083748,Staff,0,10,30,30
1650259525942,MATH 18,B02,083749,Staff,0,9,30,30
1650259525942,MATH 18,B03,083750,Staff,1,7,30,29
1650259525942,MATH 18,B04,083751,Staff,0,9,30,30
1650259531966,MATH 20A,A01,083754,Staff,26,0,40,14
1650259537990,MATH 20B,A01,083756,Staff,1,6,30,29
1650259537990,MATH 20B,A02,083757,Staff,0,7,30,30
1650259544025,MATH 20C,A01,083760,Staff,0,13,30,30
1650259544025,MATH 20C,A02,083761,Staff,0,13,30,30
1650259544025,MATH 20C,B01,083762,Staff,14,0,30,16
1650259544025,MATH 20C,B02,083763,Staff,28,0,30,2
1650259550050,MATH 20D,A01,083765,Staff,1,2,30,29
1650259550050,MATH 20D,A02,083766,Staff,8,0,30,22
1650259550050,MATH 20D,A03,083767,Staff,28,0,30,2
1650259556076,MATH 20E,A01,083771,Staff,6,0,30,24
1650259556076,MATH 20E,A02,083772,Staff,20,0,30,10
1650259556076,MATH 20E,B01,083773,Staff,0,0,30,30
1650259556076,MATH 20E,B02,083774,Staff,12,0,30,18
1650259562098,MATH 103A,A01,083777,Staff,0,9,30,30
1650259562098,MATH 103A,A02,083778,Staff,0,10,30,30
1650259562098,MATH 103A,B01,083779,Staff,0,10,30,30
1650259562098,MATH 103A,B02,083780,Staff,0,10,30,30
1650259568126,MATH 105,A01,085443,Staff,0,17,30,30
1650259574164,MATH 109,A01,083213,Anzaldo; Leesa B,0,5,30,30
1650259574164,MATH 109,A02,083214,Anzaldo; Leesa B,0,6,30,30
1650259574164,MATH 109,B01,083215,Anzaldo; Leesa B,0,4,30,30
1650259574164,MATH 109,B02,083216,Anzaldo; Leesa B,1,4,30,29
1650259580189,MATH 142A,A01,083219,Chow; Bennett,0,12,30,30
1650259580189,MATH 142A,A02,083220,Chow; Bennett,0,11,30,30
1650259580189,MATH 142A,B01,083221,Chow; Bennett,0,11,30,30
1650259580189,MATH 142A,B02,083222,Chow; Bennett,0,12,30,30
1650259586214,MATH 193A,A01,083224,Staff,0,5,30,30
1650259586214,MATH 193A,A02,083225,Staff,0,4,30,30
1650259586214,MATH 193A,A03,083781,Staff,0,2,30,30
1650259586214,MATH 193A,A04,083782,Staff,0,1,30,30
1650259592242,MATH 197,001,091859,McAuley; Julian John,9998,0,9999,1
1650259598302,COGS 9,A01,083615,Staff,0,14,60,60
1650259604328,COGS 11,A01,083617,Boyle; Mary E. T.,24,0,40,16
1650259610358,COGS 13,A01,083071,Staff,0,31,40,40
1650259616381,COGS 14A,A01,092681,Staff,0,14,100,100
1650259622408,COGS 14B,A01,083073,Cheng; Tzu-Han,0,9,50,50
1650259628431,COGS 17,A01,092677,Staff,30,0,75,45
1650259634460,COGS 100,A01,083619,Staff,0,21,60,60
1650259640488,COGS 101A,A01,083621,Davis; Joshua Daniel,0,21,60,60
1650259646513,COGS 101B,A01,091572,Staff,4,0,60,56
1650259652536,COGS 101C,A01,083625,Delgado; Tania,20,0,30,10
1650259658564,COGS 107A,A01,083627,Boyle; Mary E. T.,0,7,60,60
1650259664591,COGS 118A,A01,083075,Staff,13,0,60,47
1650259670615,CSE 3,A50,083646,Miranda; Gregory Joseph,22,0,38,16
1650259670615,CSE 3,A51,083647,Miranda; Gregory Joseph,37,0,37,0
1650259676639,CSE 8A,A50,083650,Miranda; Gregory Joseph,0,19,40,40
1650259682676,CSE 11,A01,083080,Cao; Yingjun,0,71,40,40
1650259688699,CSE 12,A01,083652,Staff,0,9,100,100
1650259694726,CSE 15L,A01,083654,Staff,0,1,50,50
1650259694726,CSE 15L,A02,083655,Staff,5,0,50,45
1650259700749,CSE 20,A01,083657,Staff,53,0,80,27
1650259706775,CSE 30,A01,083084,Eldon; John,0,74,40,40
1650259712805,CSE 100,A01,083659,Cao; Yingjun,0,64,50,50
1650259718827,CSE 134B,A01,083661,Powell; Thomas Allan,0,27,65,65
1650259724851,CSE 140,A01,083663,Staff,0,0,75,75
1650259730875,CSE 140L,A01,083088,Eldon; John,0,5,75,75
1650259736899,CSE 175,A01,083665,Kumar; Rakesh,8,0,25,17
1650259742923,CSE 190,A00,092507,Dubnov; Shlomo,14,0,20,6
1650259748954,ECE 45,A01,083139,Staff,0,14,40,40
1650259754981,ECE 65,A50,083695,Staff,0,5,30,30
1650259761006,ECE 109,A01,091882,Touri; Behrouz,47,0,70,23
1650259767030,ECE 180,A00,083140,Abi Samra; Nicholas Camill,24,0,30,6
1650259767030,ECE 180,B00,083141,Abi Samra; Nicholas Camill,7,0,30,23
1650259773057,MATH 10A,A01,083735,Patchell; Gregory David,11,0,30,19
1650259773057,MATH 10A,A02,083736,Patchell; Gregory David,28,0,30,2
1650259773057,MATH 10A,A03,083737,Patchell; Gregory David,26,0,30,4
1650259779080,MATH 10B,A01,083207,Staff,0,6,30,30
1650259779080,MATH 10B,A02,083208,Staff,0,5,30,30
1650259779080,MATH 10B,B01,083739,Staff,17,0,30,13
1650259779080,MATH 10B,B02,083740,Staff,29,0,30,1
1650259785105,MATH 18,A01,083743,Staff,7,0,30,23
1650259785105,MATH 18,A02,083744,Staff,28,0,30,2
1650259785105,MATH 18,A03,083745,Staff,23,0,30,7
1650259785105,MATH 18,A04,083746,Staff,27,0,30,3
1650259785105,MATH 18,B01,083748,Staff,0,10,30,30
1650259785105,MATH 18,B02,083749,Staff,0,9,30,30
1650259785105,MATH 18,B03,083750,Staff,1,6,30,29
1650259785105,MATH 18,B04,083751,Staff,0,9,30,30
1650259791137,MATH 20A,A01,083754,Staff,26,0,40,14
1650259797162,MATH 20B,A01,083756,Staff,0,5,30,30
1650259797162,MATH 20B,A02,083757,Staff,0,7,30,30
1650259803192,MATH 20C,A01,083760,Staff,0,13,30,30
1650259803192,MATH 20C,A02,083761,Staff,0,13,30,30
1650259803192,MATH 20C,B01,083762,Staff,14,0,30,16
1650259803192,MATH 20C,B02,083763,Staff,28,0,30,2
1650259809228,MATH 20D,A01,083765,Staff,0,1,30,30
1650259809228,MATH 20D,A02,083766,Staff,8,0,30,22
1650259809228,MATH 20D,A03,083767,Staff,28,0,30,2
1650259815267,MATH 20E,A01,083771,Staff,6,0,30,24
1650259815267,MATH 20E,A02,083772,Staff,20,0,30,10
1650259815267,MATH 20E,B01,083773,Staff,0,0,30,30
1650259815267,MATH 20E,B02,083774,Staff,12,0,30,18
1650259821294,MATH 103A,A01,083777,Staff,0,9,30,30
1650259821294,MATH 103A,A02,083778,Staff,0,10,30,30
1650259821294,MATH 103A,B01,083779,Staff,0,10,30,30
1650259821294,MATH 103A,B02,083780,Staff,0,10,30,30
1650259827316,MATH 105,A01,085443,Staff,0,17,30,30
1650259833346,MATH 109,A01,083213,Anzaldo; Leesa B,0,5,30,30
1650259833346,MATH 109,A02,083214,Anzaldo; Leesa B,0,6,30,30
1650259833346,MATH 109,B01,083215,Anzaldo; Leesa B,0,4,30,30
1650259833346,MATH 109,B02,083216,Anzaldo; Leesa B,0,3,30,30
1650259839373,MATH 142A,A01,083219,Chow; Bennett,0,12,30,30
1650259839373,MATH 142A,A02,083220,Chow; Bennett,0,11,30,30
1650259839373,MATH 142A,B01,083221,Chow; Bennett,0,11,30,30
1650259839373,MATH 142A,B02,083222,Chow; Bennett,0,12,30,30
1650259845399,MATH 193A,A01,083224,Staff,0,5,30,30
1650259845399,MATH 193A,A02,083225,Staff,0,4,30,30
1650259845399,MATH 193A,A03,083781,Staff,0,2,30,30
1650259845399,MATH 193A,A04,083782,Staff,0,1,30,30
1650259851422,MATH 197,001,091859,McAuley; Julian John,9998,0,9999,1
1650259857488,COGS 9,A01,083615,Staff,0,14,60,60
1650259863511,COGS 11,A01,083617,Boyle; Mary E. T.,24,0,40,16
1650259869535,COGS 13,A01,083071,Staff,0,31,40,40
1650259875562,COGS 14A,A01,092681,Staff,0,14,100,100
1650259881585,COGS 14B,A01,083073,Cheng; Tzu-Han,0,9,50,50
1650259887611,COGS 17,A01,092677,Staff,30,0,75,45
1650259893637,COGS 100,A01,083619,Staff,0,21,60,60
1650259899666,COGS 101A,A01,083621,Davis; Joshua Daniel,0,21,60,60
1650259905691,COGS 101B,A01,091572,Staff,4,0,60,56
1650259911715,COGS 101C,A01,083625,Delgado; Tania,20,0,30,10
1650259917755,COGS 107A,A01,083627,Boyle; Mary E. T.,0,7,60,60
1650259923785,COGS 118A,A01,083075,Staff,13,0,60,47
1650259929810,CSE 3,A50,083646,Miranda; Gregory Joseph,22,0,38,16
1650259929810,CSE 3,A51,083647,Miranda; Gregory Joseph,37,0,37,0
1650259935833,CSE 8A,A50,083650,Miranda; Gregory Joseph,0,19,40,40
1650259941862,CSE 11,A01,083080,Cao; Yingjun,0,71,40,40
1650259947887,CSE 12,A01,083652,Staff,0,9,100,100
1650259953913,CSE 15L,A01,083654,Staff,0,1,50,50
1650259953913,CSE 15L,A02,083655,Staff,5,0,50,45
1650259959937,CSE 20,A01,083657,Staff,53,0,80,27
1650259966034,CSE 30,A01,083084,Eldon; John,0,74,40,40
1650259972062,CSE 100,A01,083659,Cao; Yingjun,0,64,50,50
1650259978085,CSE 134B,A01,083661,Powell; Thomas Allan,0,27,65,65
1650259984114,CSE 140,A01,083663,Staff,0,0,75,75
1650259990138,CSE 140L,A01,083088,Eldon; John,0,5,75,75
1650259996166,CSE 175,A01,083665,Kumar; Rakesh,8,0,25,17
1650260002189,CSE 190,A00,092507,Dubnov; Shlomo,14,0,20,6
1650260008222,ECE 45,A01,083139,Staff,0,14,40,40
1650260014250,ECE 65,A50,083695,Staff,0,5,30,30
1650260020276,ECE 109,A01,091882,Touri; Behrouz,47,0,70,23
1650260026304,ECE 180,A00,083140,Abi Samra; Nicholas Camill,24,0,30,6
1650260026304,ECE 180,B00,083141,Abi Samra; Nicholas Camill,7,0,30,23
1650260032328,MATH 10A,A01,083735,Patchell; Gregory David,11,0,30,19
1650260032328,MATH 10A,A02,083736,Patchell; Gregory David,28,0,30,2
1650260032328,MATH 10A,A03,083737,Patchell; Gregory David,26,0,30,4
1650260038355,MATH 10B,A01,083207,Staff,0,6,30,30
1650260038355,MATH 10B,A02,083208,Staff,0,5,30,30
1650260038355,MATH 10B,B01,083739,Staff,17,0,30,13
1650260038355,MATH 10B,B02,083740,Staff,29,0,30,1
1650260044378,MATH 18,A01,083743,Staff,7,0,30,23
1650260044378,MATH 18,A02,083744,Staff,28,0,30,2
1650260044378,MATH 18,A03,083745,Staff,23,0,30,7
1650260044378,MATH 18,A04,083746,Staff,27,0,30,3
1650260044378,MATH 18,B01,083748,Staff,0,10,30,30
1650260044378,MATH 18,B02,083749,Staff,0,9,30,30
1650260044378,MATH 18,B03,083750,Staff,1,6,30,29
1650260044378,MATH 18,B04,083751,Staff,0,9,30,30
1650260050403,MATH 20A,A01,083754,Staff,26,0,40,14
1650260056426,MATH 20B,A01,083756,Staff,0,5,30,30
1650260056426,MATH 20B,A02,083757,Staff,0,7,30,30
1650260062449,MATH 20C,A01,083760,Staff,0,13,30,30
1650260062449,MATH 20C,A02,083761,Staff,0,13,30,30
1650260062449,MATH 20C,B01,083762,Staff,14,0,30,16
1650260062449,MATH 20C,B02,083763,Staff,28,0,30,2
1650260068475,MATH 20D,A01,083765,Staff,0,1,30,30
1650260068475,MATH 20D,A02,083766,Staff,8,0,30,22
1650260068475,MATH 20D,A03,083767,Staff,28,0,30,2
1650260074499,MATH 20E,A01,083771,Staff,6,0,30,24
1650260074499,MATH 20E,A02,083772,Staff,20,0,30,10
1650260074499,MATH 20E,B01,083773,Staff,0,0,30,30
1650260074499,MATH 20E,B02,083774,Staff,12,0,30,18
1650260080527,MATH 103A,A01,083777,Staff,0,9,30,30
1650260080527,MATH 103A,A02,083778,Staff,0,10,30,30
1650260080527,MATH 103A,B01,083779,Staff,0,10,30,30
1650260080527,MATH 103A,B02,083780,Staff,0,10,30,30
1650260086551,MATH 105,A01,085443,Staff,0,17,30,30
1650260092575,MATH 109,A01,083213,Anzaldo; Leesa B,0,5,30,30
1650260092575,MATH 109,A02,083214,Anzaldo; Leesa B,0,6,30,30
1650260092575,MATH 109,B01,083215,Anzaldo; Leesa B,0,4,30,30
1650260092575,MATH 109,B02,083216,Anzaldo; Leesa B,0,3,30,30
1650260098604,MATH 142A,A01,083219,Chow; Bennett,0,12,30,30
1650260098604,MATH 142A,A02,083220,Chow; Bennett,0,11,30,30
1650260098604,MATH 142A,B01,083221,Chow; Bennett,0,11,30,30
1650260098604,MATH 142A,B02,083222,Chow; Bennett,0,12,30,30
1650260104627,MATH 193A,A01,083224,Staff,0,5,30,30
1650260104627,MATH 193A,A02,083225,Staff,0,4,30,30
1650260104627,MATH 193A,A03,083781,Staff,0,2,30,30
1650260104627,MATH 193A,A04,083782,Staff,0,1,30,30
1650260110656,MATH 197,001,091859,McAuley; Julian John,9998,0,9999,1
1650260116708,COGS 9,A01,083615,Staff,0,14,60,60
1650260122734,COGS 11,A01,083617,Boyle; Mary E. T.,24,0,40,16
1650260128767,COGS 13,A01,083071,Staff,0,31,40,40
1650260134791,COGS 14A,A01,092681,Staff,0,14,100,100
1650260140818,COGS 14B,A01,083073,Cheng; Tzu-Han,0,9,50,50
1650260146842,COGS 17,A01,092677,Staff,30,0,75,45
1650260152866,COGS 100,A01,083619,Staff,0,21,60,60
1650260158893,COGS 101A,A01,083621,Davis; Joshua Daniel,0,21,60,60
1650260164919,COGS 101B,A01,091572,Staff,4,0,60,56
1650260170942,COGS 101C,A01,083625,Delgado; Tania,20,0,30,10
1650260176969,COGS 107A,A01,083627,Boyle; Mary E. T.,0,7,60,60
1650260182992,COGS 118A,A01,083075,Staff,13,0,60,47
1650260189016,CSE 3,A50,083646,Miranda; Gregory Joseph,22,0,38,16
1650260189016,CSE 3,A51,083647,Miranda; Gregory Joseph,37,0,37,0
1650260195040,CSE 8A,A50,083650,Miranda; Gregory Joseph,0,19,40,40
1650260201068,CSE 11,A01,083080,Cao; Yingjun,0,71,40,40
1650260207092,CSE 12,A01,083652,Staff,0,9,100,100
1650260213118,CSE 15L,A01,083654,Staff,0,1,50,50
1650260213118,CSE 15L,A02,083655,Staff,5,0,50,45
1650260219144,CSE 20,A01,083657,Staff,53,0,80,27
1650260225168,CSE 30,A01,083084,Eldon; John,0,74,40,40
1650260231195,CSE 100,A01,083659,Cao; Yingjun,0,64,50,50
1650260237219,CSE 134B,A01,083661,Powell; Thomas Allan,0,27,65,65
1650260243241,CSE 140,A01,083663,Staff,0,0,75,75
1650260249263,CSE 140L,A01,083088,Eldon; John,0,5,75,75
1650260255290,CSE 175,A01,083665,Kumar; Rakesh,8,0,25,17
1650260261314,CSE 190,A00,092507,Dubnov; Shlomo,14,0,20,6
1650260267340,ECE 45,A01,083139,Staff,0,14,40,40
1650260273367,ECE 65,A50,083695,Staff,0,5,30,30
1650260279392,ECE 109,A01,091882,Touri; Behrouz,47,0,70,23
1650260285413,ECE 180,A00,083140,Abi Samra; Nicholas Camill,24,0,30,6
1650260285413,ECE 180,B00,083141,Abi Samra; Nicholas Camill,7,0,30,23
1650260291442,MATH 10A,A01,083735,Patchell; Gregory David,11,0,30,19
1650260291442,MATH 10A,A02,083736,Patchell; Gregory David,28,0,30,2
1650260291442,MATH 10A,A03,083737,Patchell; Gregory David,26,0,30,4
1650260297468,MATH 10B,A01,083207,Staff,0,6,30,30
1650260297468,MATH 10B,A02,083208,Staff,0,5,30,30
1650260297468,MATH 10B,B01,083739,Staff,17,0,30,13
1650260297468,MATH 10B,B02,083740,Staff,29,0,30,1
1650260303498,MATH 18,A01,083743,Staff,7,0,30,23
1650260303498,MATH 18,A02,083744,Staff,28,0,30,2
1650260303498,MATH 18,A03,083745,Staff,23,0,30,7
1650260303498,MATH 18,A04,083746,Staff,27,0,30,3
1650260303498,MATH 18,B01,083748,Staff,0,10,30,30
1650260303498,MATH 18,B02,083749,Staff,0,9,30,30
1650260303498,MATH 18,B03,083750,Staff,1,6,30,29
1650260303498,MATH 18,B04,083751,Staff,0,9,30,30
1650260309521,MATH 20A,A01,083754,Staff,26,0,40,14
1650260315544,MATH 20B,A01,083756,Staff,0,5,30,30
1650260315544,MATH 20B,A02,083757,Staff,0,7,30,30
1650260321568,MATH 20C,A01,083760,Staff,0,13,30,30
1650260321568,MATH 20C,A02,083761,Staff,0,13,30,30
1650260321568,MATH 20C,B01,083762,Staff,14,0,30,16
1650260321568,MATH 20C,B02,083763,Staff,28,0,30,2
1650260327593,MATH 20D,A01,083765,Staff,0,1,30,30
1650260327593,MATH 20D,A02,083766,Staff,8,0,30,22
1650260327593,MATH 20D,A03,083767,Staff,28,0,30,2
1650260333620,MATH 20E,A01,083771,Staff,6,0,30,24
1650260333620,MATH 20E,A02,083772,Staff,20,0,30,10
1650260333620,MATH 20E,B01,083773,Staff,0,0,30,30
1650260333620,MATH 20E,B02,083774,Staff,12,0,30,18
1650260339644,MATH 103A,A01,083777,Staff,0,9,30,30
1650260339644,MATH 103A,A02,083778,Staff,0,10,30,30
1650260339644,MATH 103A,B01,083779,Staff,0,10,30,30
1650260339644,MATH 103A,B02,083780,Staff,0,10,30,30
1650260345668,MATH 105,A01,085443,Staff,0,17,30,30
1650260351698,MATH 109,A01,083213,Anzaldo; Leesa B,0,5,30,30
1650260351698,MATH 109,A02,083214,Anzaldo; Leesa B,0,6,30,30
1650260351698,MATH 109,B01,083215,Anzaldo; Leesa B,0,4,30,30
1650260351698,MATH 109,B02,083216,Anzaldo; Leesa B,0,3,30,30
1650260357733,MATH 142A,A01,083219,Chow; Bennett,0,12,30,30
1650260357733,MATH 142A,A02,083220,Chow; Bennett,0,11,30,30
1650260357733,MATH 142A,B01,083221,Chow; Bennett,0,11,30,30
1650260357733,MATH 142A,B02,083222,Chow; Bennett,0,12,30,30
1650260363756,MATH 193A,A01,083224,Staff,0,5,30,30
1650260363756,MATH 193A,A02,083225,Staff,0,4,30,30
1650260363756,MATH 193A,A03,083781,Staff,0,2,30,30
1650260363756,MATH 193A,A04,083782,Staff,0,1,30,30
1650260369780,MATH 197,001,091859,McAuley; Julian John,9998,0,9999,1
1650260375848,COGS 9,A01,083615,Staff,0,14,60,60
1650260381873,COGS 11,A01,083617,Boyle; Mary E. T.,24,0,40,16
1650260387899,COGS 13,A01,083071,Staff,0,31,40,40
1650260393923,COGS 14A,A01,092681,Staff,0,14,100,100
1650260399947,COGS 14B,A01,083073,Cheng; Tzu-Han,0,9,50,50
1650260405970,COGS 17,A01,092677,Staff,30,0,75,45
1650260412007,COGS 100,A01,083619,Staff,0,21,60,60
1650260418030,COGS 101A,A01,083621,Davis; Joshua Daniel,0,21,60,60
1650260424061,COGS 101B,A01,091572,Staff,4,0,60,56
1650260430088,COGS 101C,A01,083625,Delgado; Tania,20,0,30,10
1650260436115,COGS 107A,A01,083627,Boyle; Mary E. T.,0,7,60,60
1650260442139,COGS 118A,A01,083075,Staff,13,0,60,47
1650260448167,CSE 3,A50,083646,Miranda; Gregory Joseph,22,0,38,16
1650260448167,CSE 3,A51,083647,Miranda; Gregory Joseph,37,0,37,0
1650260454192,CSE 8A,A50,083650,Miranda; Gregory Joseph,0,19,40,40
1650260460226,CSE 11,A01,083080,Cao; Yingjun,0,71,40,40
1650260466259,CSE 12,A01,083652,Staff,0,9,100,100
1650260472282,CSE 15L,A01,083654,Staff,0,1,50,50
1650260472282,CSE 15L,A02,083655,Staff,5,0,50,45
1650260478306,CSE 20,A01,083657,Staff,53,0,80,27
1650260484342,CSE 30,A01,083084,Eldon; John,0,74,40,40
1650260490368,CSE 100,A01,083659,Cao; Yingjun,0,64,50,50
1650260496394,CSE 134B,A01,083661,Powell; Thomas Allan,0,27,65,65
1650260502417,CSE 140,A01,083663,Staff,0,0,75,75
1650260508442,CSE 140L,A01,083088,Eldon; John,0,5,75,75
1650260514465,CSE 175,A01,083665,Kumar; Rakesh,8,0,25,17
1650260520497,CSE 190,A00,092507,Dubnov; Shlomo,14,0,20,6
1650260526523,ECE 45,A01,083139,Staff,0,14,40,40
1650260532545,ECE 65,A50,083695,Staff,0,5,30,30
1650260538568,ECE 109,A01,091882,Touri; Behrouz,46,0,70,24
1650260544591,ECE 180,A00,083140,Abi Samra; Nicholas Camill,24,0,30,6
1650260544591,ECE 180,B00,083141,Abi Samra; Nicholas Camill,7,0,30,23
1650260550614,MATH 10A,A01,083735,Patchell; Gregory David,11,0,30,19
1650260550614,MATH 10A,A02,083736,Patchell; Gregory David,28,0,30,2
1650260550614,MATH 10A,A03,083737,Patchell; Gregory David,26,0,30,4
1650260556639,MATH 10B,A01,083207,Staff,0,6,30,30
1650260556639,MATH 10B,A02,083208,Staff,0,5,30,30
1650260556639,MATH 10B,B01,083739,Staff,17,0,30,13
1650260556639,MATH 10B,B02,083740,Staff,29,0,30,1
1650260562768,MATH 18,A01,083743,Staff,7,0,30,23
1650260562768,MATH 18,A02,083744,Staff,28,0,30,2
1650260562768,MATH 18,A03,083745,Staff,23,0,30,7
1650260562768,MATH 18,A04,083746,Staff,27,0,30,3
1650260562768,MATH 18,B01,083748,Staff,0,10,30,30
1650260562768,MATH 18,B02,083749,Staff,0,9,30,30
1650260562768,MATH 18,B03,083750,Staff,1,6,30,29
1650260562768,MATH 18,B04,083751,Staff,0,9,30,30
1650260568790,MATH 20A,A01,083754,Staff,26,0,40,14
1650260574816,MATH 20B,A01,083756,Staff,0,5,30,30
1650260574816,MATH 20B,A02,083757,Staff,0,7,30,30
1650260580845,MATH 20C,A01,083760,Staff,0,13,30,30
1650260580845,MATH 20C,A02,083761,Staff,0,13,30,30
1650260580845,MATH 20C,B01,083762,Staff,14,0,30,16
1650260580845,MATH 20C,B02,083763,Staff,28,0,30,2
1650260586875,MATH 20D,A01,083765,Staff,0,1,30,30
1650260586875,MATH 20D,A02,083766,Staff,8,0,30,22
1650260586875,MATH 20D,A03,083767,Staff,28,0,30,2
1650260592906,MATH 20E,A01,083771,Staff,6,0,30,24
1650260592906,MATH 20E,A02,083772,Staff,20,0,30,10
1650260592906,MATH 20E,B01,083773,Staff,0,0,30,30
1650260592906,MATH 20E,B02,083774,Staff,12,0,30,18
1650260598930,MATH 103A,A01,083777,Staff,0,9,30,30
1650260598930,MATH 103A,A02,083778,Staff,0,10,30,30
1650260598930,MATH 103A,B01,083779,Staff,0,10,30,30
1650260598930,MATH 103A,B02,083780,Staff,0,10,30,30
1650260604960,MATH 105,A01,085443,Staff,0,17,30,30
1650260610990,MATH 109,A01,083213,Anzaldo; Leesa B,0,5,30,30
1650260610990,MATH 109,A02,083214,Anzaldo; Leesa B,0,6,30,30
1650260610990,MATH 109,B01,083215,Anzaldo; Leesa B,0,4,30,30
1650260610990,MATH 109,B02,083216,Anzaldo; Leesa B,0,3,30,30
1650260617023,MATH 142A,A01,083219,Chow; Bennett,0,12,30,30
1650260617023,MATH 142A,A02,083220,Chow; Bennett,0,11,30,30
1650260617023,MATH 142A,B01,083221,Chow; Bennett,0,11,30,30
1650260617023,MATH 142A,B02,083222,Chow; Bennett,0,12,30,30
1650260623045,MATH 193A,A01,083224,Staff,0,5,30,30
1650260623045,MATH 193A,A02,083225,Staff,0,4,30,30
1650260623045,MATH 193A,A03,083781,Staff,0,2,30,30
1650260623045,MATH 193A,A04,083782,Staff,0,1,30,30
1650260629072,MATH 197,001,091859,McAuley; Julian John,9998,0,9999,1
1650260635126,COGS 9,A01,083615,Staff,0,14,60,60
1650260641152,COGS 11,A01,083617,Boyle; Mary E. T.,24,0,40,16
1650260647175,COGS 13,A01,083071,Staff,0,31,40,40
1650260653199,COGS 14A,A01,092681,Staff,0,14,100,100
1650260659225,COGS 14B,A01,083073,Cheng; Tzu-Han,0,9,50,50
1650260665248,COGS 17,A01,092677,Staff,30,0,75,45
1650260671271,COGS 100,A01,083619,Staff,0,21,60,60
1650260677295,COGS 101A,A01,083621,Davis; Joshua Daniel,0,21,60,60
1650260683323,COGS 101B,A01,091572,Staff,4,0,60,56
1650260689347,COGS 101C,A01,083625,Delgado; Tania,20,0,30,10
1650260695370,COGS 107A,A01,083627,Boyle; Mary E. T.,0,7,60,60
1650260701393,COGS 118A,A01,083075,Staff,13,0,60,47
1650260707418,CSE 3,A50,083646,Miranda; Gregory Joseph,22,0,38,16
1650260707418,CSE 3,A51,083647,Miranda; Gregory Joseph,37,0,37,0
1650260713441,CSE 8A,A50,083650,Miranda; Gregory Joseph,0,19,40,40
1650260719464,CSE 11,A01,083080,Cao; Yingjun,0,71,40,40
1650260725486,CSE 12,A01,083652,Staff,0,9,100,100
1650260731515,CSE 15L,A01,083654,Staff,0,1,50,50
1650260731515,CSE 15L,A02,083655,Staff,5,0,50,45
1650260737537,CSE 20,A01,083657,Staff,53,0,80,27
1650260743561,CSE 30,A01,083084,Eldon; John,0,74,40,40
1650260749584,CSE 100,A01,083659,Cao; Yingjun,0,64,50,50
1650260755611,CSE 134B,A01,083661,Powell; Thomas Allan,0,27,65,65
1650260761635,CSE 140,A01,083663,Staff,0,0,75,75
1650260767666,CSE 140L,A01,083088,Eldon; John,0,5,75,75
1650260773693,CSE 175,A01,083665,Kumar; Rakesh,8,0,25,17
1650260779715,CSE 190,A00,092507,Dubnov; Shlomo,14,0,20,6
1650260785741,ECE 45,A01,083139,Staff,0,14,40,40
1650260791767,ECE 65,A50,083695,Staff,0,5,30,30
1650260797788,ECE 109,A01,091882,Touri; Behrouz,46,0,70,24
1650260803812,ECE 180,A00,083140,Abi Samra; Nicholas Camill,24,0,30,6
1650260803812,ECE 180,B00,083141,Abi Samra; Nicholas Camill,7,0,30,23
1650260809836,MATH 10A,A01,083735,Patchell; Gregory David,11,0,30,19
1650260809836,MATH 10A,A02,083736,Patchell; Gregory David,28,0,30,2
1650260809836,MATH 10A,A03,083737,Patchell; Gregory David,26,0,30,4
1650260815865,MATH 10B,A01,083207,Staff,0,6,30,30
1650260815865,MATH 10B,A02,083208,Staff,0,5,30,30
1650260815865,MATH 10B,B01,083739,Staff,17,0,30,13
1650260815865,MATH 10B,B02,083740,Staff,29,0,30,1
1650260821892,MATH 18,A01,083743,Staff,7,0,30,23
1650260821892,MATH 18,A02,083744,Staff,28,0,30,2
1650260821892,MATH 18,A03,083745,Staff,23,0,30,7
1650260821892,MATH 18,A04,083746,Staff,27,0,30,3
1650260821892,MATH 18,B01,083748,Staff,0,11,30,30
1650260821892,MATH 18,B02,083749,Staff,0,9,30,30
1650260821892,MATH 18,B03,083750,Staff,1,6,30,29
1650260821892,MATH 18,B04,083751,Staff,0,9,30,30
1650260827916,MATH 20A,A01,083754,Staff,26,0,40,14
1650260833937,MATH 20B,A01,083756,Staff,0,5,30,30
1650260833937,MATH 20B,A02,083757,Staff,0,7,30,30
1650260839962,MATH 20C,A01,083760,Staff,0,13,30,30
1650260839962,MATH 20C,A02,083761,Staff,0,13,30,30
1650260839962,MATH 20C,B01,083762,Staff,14,0,30,16
1650260839962,MATH 20C,B02,083763,Staff,28,0,30,2
1650260845987,MATH 20D,A01,083765,Staff,0,1,30,30
1650260845987,MATH 20D,A02,083766,Staff,8,0,30,22
1650260845987,MATH 20D,A03,083767,Staff,28,0,30,2
1650260852010,MATH 20E,A01,083771,Staff,6,0,30,24
1650260852010,MATH 20E,A02,083772,Staff,20,0,30,10
1650260852010,MATH 20E,B01,083773,Staff,0,0,30,30
1650260852010,MATH 20E,B02,083774,Staff,12,0,30,18
1650260858042,MATH 103A,A01,083777,Staff,0,9,30,30
1650260858042,MATH 103A,A02,083778,Staff,0,10,30,30
1650260858042,MATH 103A,B01,083779,Staff,0,10,30,30
1650260858042,MATH 103A,B02,083780,Staff,0,10,30,30
1650260864067,MATH 105,A01,085443,Staff,0,17,30,30
1650260870095,MATH 109,A01,083213,Anzaldo; Leesa B,0,5,30,30
1650260870095,MATH 109,A02,083214,Anzaldo; Leesa B,0,6,30,30
1650260870095,MATH 109,B01,083215,Anzaldo; Leesa B,0,4,30,30
1650260870095,MATH 109,B02,083216,Anzaldo; Leesa B,0,3,30,30
1650260876122,MATH 142A,A01,083219,Chow; Bennett,0,12,30,30
1650260876122,MATH 142A,A02,083220,Chow; Bennett,0,11,30,30
1650260876122,MATH 142A,B01,083221,Chow; Bennett,0,11,30,30
1650260876122,MATH 142A,B02,083222,Chow; Bennett,0,12,30,30
1650260882146,MATH 193A,A01,083224,Staff,0,5,30,30
1650260882146,MATH 193A,A02,083225,Staff,0,4,30,30
1650260882146,MATH 193A,A03,083781,Staff,0,2,30,30
1650260882146,MATH 193A,A04,083782,Staff,0,1,30,30
1650260888171,MATH 197,001,091859,McAuley; Julian John,9998,0,9999,1
1650260894234,COGS 9,A01,083615,Staff,0,14,60,60
1650260900256,COGS 11,A01,083617,Boyle; Mary E. T.,24,0,40,16
1650260906284,COGS 13,A01,083071,Staff,0,31,40,40
1650260912306,COGS 14A,A01,092681,Staff,0,14,100,100
1650260918328,COGS 14B,A01,083073,Cheng; Tzu-Han,0,9,50,50
1650260924353,COGS 17,A01,092677,Staff,30,0,75,45
1650260930378,COGS 100,A01,083619,Staff,0,21,60,60
1650260936401,COGS 101A,A01,083621,Davis; Joshua Daniel,0,21,60,60
1650260942424,COGS 101B,A01,091572,Staff,4,0,60,56
1650260948464,COGS 101C,A01,083625,Delgado; Tania,20,0,30,10
1650260954490,COGS 107A,A01,083627,Boyle; Mary E. T.,0,7,60,60
1650260960514,COGS 118A,A01,083075,Staff,13,0,60,47
1650260966541,CSE 3,A50,083646,Miranda; Gregory Joseph,22,0,38,16
1650260966541,CSE 3,A51,083647,Miranda; Gregory Joseph,37,0,37,0
1650260972569,CSE 8A,A50,083650,Miranda; Gregory Joseph,0,19,40,40
1650260978600,CSE 11,A01,083080,Cao; Yingjun,0,71,40,40
1650260984624,CSE 12,A01,083652,Staff,0,9,100,100
1650260990675,CSE 15L,A01,083654,Staff,0,1,50,50
1650260990675,CSE 15L,A02,083655,Staff,5,0,50,45
1650260996699,CSE 20,A01,083657,Staff,53,0,80,27
1650261002725,CSE 30,A01,083084,Eldon; John,0,74,40,40
1650261008752,CSE 100,A01,083659,Cao; Yingjun,0,64,50,50
1650261014776,CSE 134B,A01,083661,Powell; Thomas Allan,0,27,65,65
1650261020805,CSE 140,A01,083663,Staff,0,0,75,75
1650261026828,CSE 140L,A01,083088,Eldon; John,0,5,75,75
1650261032852,CSE 175,A01,083665,Kumar; Rakesh,8,0,25,17
1650261038883,CSE 190,A00,092507,Dubnov; Shlomo,14,0,20,6
1650261044905,ECE 45,A01,083139,Staff,0,14,40,40
1650261050935,ECE 65,A50,083695,Staff,0,5,30,30
1650261056962,ECE 109,A01,091882,Touri; Behrouz,46,0,70,24
1650261062984,ECE 180,A00,083140,Abi Samra; Nicholas Camill,24,0,30,6
1650261062984,ECE 180,B00,083141,Abi Samra; Nicholas Camill,7,0,30,23
1650261069008,MATH 10A,A01,083735,Patchell; Gregory David,11,0,30,19
1650261069008,MATH 10A,A02,083736,Patchell; Gregory David,28,0,30,2
1650261069008,MATH 10A,A03,083737,Patchell; Gregory David,26,0,30,4
1650261075031,MATH 10B,A01,083207,Staff,0,6,30,30
1650261075031,MATH 10B,A02,083208,Staff,0,5,30,30
1650261075031,MATH 10B,B01,083739,Staff,17,0,30,13
1650261075031,MATH 10B,B02,083740,Staff,29,0,30,1
1650261081063,MATH 18,A01,083743,Staff,7,0,30,23
1650261081063,MATH 18,A02,083744,Staff,28,0,30,2
1650261081063,MATH 18,A03,083745,Staff,23,0,30,7
1650261081063,MATH 18,A04,083746,Staff,27,0,30,3
1650261081063,MATH 18,B01,083748,Staff,0,11,30,30
1650261081063,MATH 18,B02,083749,Staff,0,9,30,30
1650261081063,MATH 18,B03,083750,Staff,1,6,30,29
1650261081063,MATH 18,B04,083751,Staff,0,9,30,30
1650261087086,MATH 20A,A01,083754,Staff,26,0,40,14
1650261093113,MATH 20B,A01,083756,Staff,0,5,30,30
1650261093113,MATH 20B,A02,083757,Staff,0,7,30,30
1650261099139,MATH 20C,A01,083760,Staff,0,13,30,30
1650261099139,MATH 20C,A02,083761,Staff,0,13,30,30
1650261099139,MATH 20C,B01,083762,Staff,14,0,30,16
1650261099139,MATH 20C,B02,083763,Staff,28,0,30,2
1650261105162,MATH 20D,A01,083765,Staff,0,1,30,30
1650261105162,MATH 20D,A02,083766,Staff,8,0,30,22
1650261105162,MATH 20D,A03,083767,Staff,28,0,30,2
1650261111189,MATH 20E,A01,083771,Staff,6,0,30,24
1650261111189,MATH 20E,A02,083772,Staff,20,0,30,10
1650261111189,MATH 20E,B01,083773,Staff,0,0,30,30
1650261111189,MATH 20E,B02,083774,Staff,12,0,30,18
1650261117212,MATH 103A,A01,083777,Staff,0,9,30,30
1650261117212,MATH 103A,A02,083778,Staff,0,10,30,30
1650261117212,MATH 103A,B01,083779,Staff,0,10,30,30
1650261117212,MATH 103A,B02,083780,Staff,0,10,30,30
1650261123234,MATH 105,A01,085443,Staff,0,17,30,30
1650261129257,MATH 109,A01,083213,Anzaldo; Leesa B,0,5,30,30
1650261129257,MATH 109,A02,083214,Anzaldo; Leesa B,0,6,30,30
1650261129257,MATH 109,B01,083215,Anzaldo; Leesa B,0,4,30,30
1650261129257,MATH 109,B02,083216,Anzaldo; Leesa B,0,3,30,30
1650261135284,MATH 142A,A01,083219,Chow; Bennett,0,12,30,30
1650261135284,MATH 142A,A02,083220,Chow; Bennett,0,11,30,30
1650261135284,MATH 142A,B01,083221,Chow; Bennett,0,11,30,30
1650261135284,MATH 142A,B02,083222,Chow; Bennett,0,12,30,30
1650261141308,MATH 193A,A01,083224,Staff,0,5,30,30
1650261141308,MATH 193A,A02,083225,Staff,0,4,30,30
1650261141308,MATH 193A,A03,083781,Staff,0,2,30,30
1650261141308,MATH 193A,A04,083782,Staff,0,1,30,30
1650261147332,MATH 197,001,091859,McAuley; Julian John,9998,0,9999,1
1650261153473,COGS 9,A01,083615,Staff,0,14,60,60
1650261159498,COGS 11,A01,083617,Boyle; Mary E. T.,24,0,40,16
1650261165521,COGS 13,A01,083071,Staff,0,31,40,40
1650261171548,COGS 14A,A01,092681,Staff,0,14,100,100
1650261177570,COGS 14B,A01,083073,Cheng; Tzu-Han,0,9,50,50
1650261183592,COGS 17,A01,092677,Staff,30,0,75,45
1650261189613,COGS 100,A01,083619,Staff,0,21,60,60
1650261195636,COGS 101A,A01,083621,Davis; Joshua Daniel,0,21,60,60
1650261201658,COGS 101B,A01,091572,Staff,4,0,60,56
1650261207690,COGS 101C,A01,083625,Delgado; Tania,20,0,30,10
1650261213713,COGS 107A,A01,083627,Boyle; Mary E. T.,0,7,60,60
1650261219734,COGS 118A,A01,083075,Staff,13,0,60,47
1650261225758,CSE 3,A50,083646,Miranda; Gregory Joseph,22,0,38,16
1650261225758,CSE 3,A51,083647,Miranda; Gregory Joseph,37,0,37,0
1650261231780,CSE 8A,A50,083650,Miranda; Gregory Joseph,0,19,40,40
1650261237810,CSE 11,A01,083080,Cao; Yingjun,0,71,40,40
1650261243832,CSE 12,A01,083652,Staff,0,9,100,100
1650261249857,CSE 15L,A01,083654,Staff,0,1,50,50
1650261249857,CSE 15L,A02,083655,Staff,5,0,50,45
1650261255883,CSE 20,A01,083657,Staff,53,0,80,27
1650261261906,CSE 30,A01,083084,Eldon; John,0,74,40,40
1650261267930,CSE 100,A01,083659,Cao; Yingjun,0,64,50,50
1650261273964,CSE 134B,A01,083661,Powell; Thomas Allan,0,27,65,65
1650261279990,CSE 140,A01,083663,Staff,0,0,75,75
1650261286013,CSE 140L,A01,083088,Eldon; John,0,5,75,75
1650261292038,CSE 175,A01,083665,Kumar; Rakesh,8,0,25,17
1650261298063,CSE 190,A00,092507,Dubnov; Shlomo,14,0,20,6
1650261304086,ECE 45,A01,083139,Staff,0,14,40,40
1650261310118,ECE 65,A50,083695,Staff,0,5,30,30
1650261316145,ECE 109,A01,091882,Touri; Behrouz,46,0,70,24
1650261322177,ECE 180,A00,083140,Abi Samra; Nicholas Camill,24,0,30,6
1650261322177,ECE 180,B00,083141,Abi Samra; Nicholas Camill,7,0,30,23
1650261328202,MATH 10A,A01,083735,Patchell; Gregory David,11,0,30,19
1650261328202,MATH 10A,A02,083736,Patchell; Gregory David,28,0,30,2
1650261328202,MATH 10A,A03,083737,Patchell; Gregory David,26,0,30,4
1650261334232,MATH 10B,A01,083207,Staff,0,6,30,30
1650261334232,MATH 10B,A02,083208,Staff,0,5,30,30
1650261334232,MATH 10B,B01,083739,Staff,17,0,30,13
1650261334232,MATH 10B,B02,083740,Staff,29,0,30,1
1650261340260,MATH 18,A01,083743,Staff,7,0,30,23
1650261340260,MATH 18,A02,083744,Staff,28,0,30,2
1650261340260,MATH 18,A03,083745,Staff,23,0,30,7
1650261340260,MATH 18,A04,083746,Staff,27,0,30,3
1650261340260,MATH 18,B01,083748,Staff,0,11,30,30
1650261340260,MATH 18,B02,083749,Staff,0,9,30,30
1650261340260,MATH 18,B03,083750,Staff,1,6,30,29
1650261340260,MATH 18,B04,083751,Staff,0,9,30,30
1650261346282,MATH 20A,A01,083754,Staff,26,0,40,14
1650261352306,MATH 20B,A01,083756,Staff,0,5,30,30
1650261352306,MATH 20B,A02,083757,Staff,0,7,30,30
1650261358357,MATH 20C,A01,083760,Staff,0,13,30,30
1650261358357,MATH 20C,A02,083761,Staff,0,13,30,30
1650261358357,MATH 20C,B01,083762,Staff,14,0,30,16
1650261358357,MATH 20C,B02,083763,Staff,28,0,30,2
1650261364381,MATH 20D,A01,083765,Staff,0,1,30,30
1650261364381,MATH 20D,A02,083766,Staff,8,0,30,22
1650261364381,MATH 20D,A03,083767,Staff,28,0,30,2
1650261370404,MATH 20E,A01,083771,Staff,6,0,30,24
1650261370404,MATH 20E,A02,083772,Staff,20,0,30,10
1650261370404,MATH 20E,B01,083773,Staff,0,0,30,30
1650261370404,MATH 20E,B02,083774,Staff,12,0,30,18
1650261376432,MATH 103A,A01,083777,Staff,0,9,30,30
1650261376432,MATH 103A,A02,083778,Staff,0,10,30,30
1650261376432,MATH 103A,B01,083779,Staff,0,10,30,30
1650261376432,MATH 103A,B02,083780,Staff,0,10,30,30
1650261382456,MATH 105,A01,085443,Staff,0,17,30,30
1650261388486,MATH 109,A01,083213,Anzaldo; Leesa B,0,5,30,30
1650261388486,MATH 109,A02,083214,Anzaldo; Leesa B,0,6,30,30
1650261388486,MATH 109,B01,083215,Anzaldo; Leesa B,0,4,30,30
1650261388486,MATH 109,B02,083216,Anzaldo; Leesa B,0,3,30,30
1650261394513,MATH 142A,A01,083219,Chow; Bennett,0,12,30,30
1650261394513,MATH 142A,A02,083220,Chow; Bennett,0,11,30,30
1650261394513,MATH 142A,B01,083221,Chow; Bennett,0,11,30,30
1650261394513,MATH 142A,B02,083222,Chow; Bennett,0,12,30,30
1650261400537,MATH 193A,A01,083224,Staff,0,5,30,30
1650261400537,MATH 193A,A02,083225,Staff,0,4,30,30
1650261400537,MATH 193A,A03,083781,Staff,0,2,30,30
1650261400537,MATH 193A,A04,083782,Staff,0,1,30,30
1650261406562,MATH 197,001,091859,McAuley; Julian John,9998,0,9999,1
1650261412626,COGS 9,A01,083615,Staff,0,14,60,60
1650261418650,COGS 11,A01,083617,Boyle; Mary E. T.,24,0,40,16
1650261424675,COGS 13,A01,083071,Staff,0,31,40,40
1650261430717,COGS 14A,A01,092681,Staff,0,14,100,100
1650261436745,COGS 14B,A01,083073,Cheng; Tzu-Han,0,9,50,50
1650261442768,COGS 17,A01,092677,Staff,30,0,75,45
1650261448791,COGS 100,A01,083619,Staff,0,21,60,60
1650261454813,COGS 101A,A01,083621,Davis; Joshua Daniel,0,21,60,60
1650261460839,COGS 101B,A01,091572,Staff,4,0,60,56
1650261466863,COGS 101C,A01,083625,Delgado; Tania,20,0,30,10
1650261472886,COGS 107A,A01,083627,Boyle; Mary E. T.,0,7,60,60
1650261478918,COGS 118A,A01,083075,Staff,13,0,60,47
1650261484943,CSE 3,A50,083646,Miranda; Gregory Joseph,22,0,38,16
1650261484943,CSE 3,A51,083647,Miranda; Gregory Joseph,37,0,37,0
1650261490967,CSE 8A,A50,083650,Miranda; Gregory Joseph,0,20,40,40
1650261496990,CSE 11,A01,083080,Cao; Yingjun,0,71,40,40
1650261503016,CSE 12,A01,083652,Staff,0,9,100,100
1650261509040,CSE 15L,A01,083654,Staff,0,1,50,50
1650261509040,CSE 15L,A02,083655,Staff,5,0,50,45
1650261515070,CSE 20,A01,083657,Staff,53,0,80,27
1650261521096,CSE 30,A01,083084,Eldon; John,0,74,40,40
1650261527127,CSE 100,A01,083659,Cao; Yingjun,0,64,50,50
1650261533149,CSE 134B,A01,083661,Powell; Thomas Allan,0,27,65,65
1650261539176,CSE 140,A01,083663,Staff,0,0,75,75
1650261545203,CSE 140L,A01,083088,Eldon; John,0,5,75,75
1650261551231,CSE 175,A01,083665,Kumar; Rakesh,8,0,25,17
1650261557255,CSE 190,A00,092507,Dubnov; Shlomo,14,0,20,6
1650261563278,ECE 45,A01,083139,Staff,0,14,40,40
1650261569311,ECE 65,A50,083695,Staff,0,5,30,30
1650261575334,ECE 109,A01,091882,Touri; Behrouz,46,0,70,24
1650261581358,ECE 180,A00,083140,Abi Samra; Nicholas Camill,24,0,30,6
1650261581358,ECE 180,B00,083141,Abi Samra; Nicholas Camill,7,0,30,23
1650261587393,MATH 10A,A01,083735,Patchell; Gregory David,11,0,30,19
1650261587393,MATH 10A,A02,083736,Patchell; Gregory David,28,0,30,2
1650261587393,MATH 10A,A03,083737,Patchell; Gregory David,26,0,30,4
1650261593416,MATH 10B,A01,083207,Staff,0,6,30,30
1650261593416,MATH 10B,A02,083208,Staff,0,5,30,30
1650261593416,MATH 10B,B01,083739,Staff,17,0,30,13
1650261593416,MATH 10B,B02,083740,Staff,29,0,30,1
1650261599444,MATH 18,A01,083743,Staff,7,0,30,23
1650261599444,MATH 18,A02,083744,Staff,28,0,30,2
1650261599444,MATH 18,A03,083745,Staff,23,0,30,7
1650261599444,MATH 18,A04,083746,Staff,27,0,30,3
1650261599444,MATH 18,B01,083748,Staff,0,11,30,30
1650261599444,MATH 18,B02,083749,Staff,0,9,30,30
1650261599444,MATH 18,B03,083750,Staff,1,6,30,29
1650261599444,MATH 18,B04,083751,Staff,0,9,30,30
1650261605476,MATH 20A,A01,083754,Staff,26,0,40,14
1650261611499,MATH 20B,A01,083756,Staff,0,5,30,30
1650261611499,MATH 20B,A02,083757,Staff,0,7,30,30
1650261617524,MATH 20C,A01,083760,Staff,0,13,30,30
1650261617524,MATH 20C,A02,083761,Staff,0,13,30,30
1650261617524,MATH 20C,B01,083762,Staff,14,0,30,16
1650261617524,MATH 20C,B02,083763,Staff,28,0,30,2
1650261623549,MATH 20D,A01,083765,Staff,0,1,30,30
1650261623549,MATH 20D,A02,083766,Staff,8,0,30,22
1650261623549,MATH 20D,A03,083767,Staff,28,0,30,2
1650261629577,MATH 20E,A01,083771,Staff,6,0,30,24
1650261629577,MATH 20E,A02,083772,Staff,20,0,30,10
1650261629577,MATH 20E,B01,083773,Staff,0,0,30,30
1650261629577,MATH 20E,B02,083774,Staff,12,0,30,18
1650261635607,MATH 103A,A01,083777,Staff,0,9,30,30
1650261635607,MATH 103A,A02,083778,Staff,0,10,30,30
1650261635607,MATH 103A,B01,083779,Staff,0,10,30,30
1650261635607,MATH 103A,B02,083780,Staff,0,10,30,30
1650261641636,MATH 105,A01,085443,Staff,0,17,30,30
1650261647662,MATH 109,A01,083213,Anzaldo; Leesa B,0,5,30,30
1650261647662,MATH 109,A02,083214,Anzaldo; Leesa B,0,6,30,30
1650261647662,MATH 109,B01,083215,Anzaldo; Leesa B,0,4,30,30
1650261647662,MATH 109,B02,083216,Anzaldo; Leesa B,0,3,30,30
1650261653690,MATH 142A,A01,083219,Chow; Bennett,0,12,30,30
1650261653690,MATH 142A,A02,083220,Chow; Bennett,0,11,30,30
1650261653690,MATH 142A,B01,083221,Chow; Bennett,0,11,30,30
1650261653690,MATH 142A,B02,083222,Chow; Bennett,0,12,30,30
1650261659722,MATH 193A,A01,083224,Staff,0,5,30,30
1650261659722,MATH 193A,A02,083225,Staff,0,4,30,30
1650261659722,MATH 193A,A03,083781,Staff,0,2,30,30
1650261659722,MATH 193A,A04,083782,Staff,0,1,30,30
1650261665750,MATH 197,001,091859,McAuley; Julian John,9998,0,9999,1
1650261671817,COGS 9,A01,083615,Staff,0,14,60,60
1650261677846,COGS 11,A01,083617,Boyle; Mary E. T.,24,0,40,16
1650261683868,COGS 13,A01,083071,Staff,0,31,40,40
1650261689896,COGS 14A,A01,092681,Staff,0,14,100,100
1650261695924,COGS 14B,A01,083073,Cheng; Tzu-Han,0,9,50,50
1650261701950,COGS 17,A01,092677,Staff,30,0,75,45
1650261707975,COGS 100,A01,083619,Staff,0,21,60,60
1650261713998,COGS 101A,A01,083621,Davis; Joshua Daniel,0,21,60,60
1650261720022,COGS 101B,A01,091572,Staff,4,0,60,56
1650261726045,COGS 101C,A01,083625,Delgado; Tania,20,0,30,10
1650261732069,COGS 107A,A01,083627,Boyle; Mary E. T.,0,7,60,60
1650261738095,COGS 118A,A01,083075,Staff,13,0,60,47
1650261744133,CSE 3,A50,083646,Miranda; Gregory Joseph,22,0,38,16
1650261744133,CSE 3,A51,083647,Miranda; Gregory Joseph,37,0,37,0
1650261750270,CSE 8A,A50,083650,Miranda; Gregory Joseph,0,20,40,40
1650261756320,CSE 11,A01,083080,Cao; Yingjun,0,71,40,40
1650261762359,CSE 12,A01,083652,Staff,0,9,100,100
1650261768390,CSE 15L,A01,083654,Staff,0,1,50,50
1650261768390,CSE 15L,A02,083655,Staff,5,0,50,45
1650261774422,CSE 20,A01,083657,Staff,53,0,80,27
1650261780454,CSE 30,A01,083084,Eldon; John,0,74,40,40
1650261786478,CSE 100,A01,083659,Cao; Yingjun,0,64,50,50
1650261792507,CSE 134B,A01,083661,Powell; Thomas Allan,0,27,65,65
1650261798535,CSE 140,A01,083663,Staff,0,0,75,75
1650261804586,CSE 140L,A01,083088,Eldon; John,0,5,75,75
1650261810622,CSE 175,A01,083665,Kumar; Rakesh,8,0,25,17
1650261816649,CSE 190,A00,092507,Dubnov; Shlomo,14,0,20,6
1650261822671,ECE 45,A01,083139,Staff,0,14,40,40
1650261828718,ECE 65,A50,083695,Staff,0,5,30,30
1650261834744,ECE 109,A01,091882,Touri; Behrouz,46,0,70,24
1650261840771,ECE 180,A00,083140,Abi Samra; Nicholas Camill,24,0,30,6
1650261840771,ECE 180,B00,083141,Abi Samra; Nicholas Camill,7,0,30,23
1650261846814,MATH 10A,A01,083735,Patchell; Gregory David,11,0,30,19
1650261846814,MATH 10A,A02,083736,Patchell; Gregory David,28,0,30,2
1650261846814,MATH 10A,A03,083737,Patchell; Gregory David,26,0,30,4
1650261852840,MATH 10B,A01,083207,Staff,0,6,30,30
1650261852840,MATH 10B,A02,083208,Staff,0,5,30,30
1650261852840,MATH 10B,B01,083739,Staff,17,0,30,13
1650261852840,MATH 10B,B02,083740,Staff,29,0,30,1
1650261858867,MATH 18,A01,083743,Staff,7,0,30,23
1650261858867,MATH 18,A02,083744,Staff,28,0,30,2
1650261858867,MATH 18,A03,083745,Staff,23,0,30,7
1650261858867,MATH 18,A04,083746,Staff,27,0,30,3
1650261858867,MATH 18,B01,083748,Staff,0,11,30,30
1650261858867,MATH 18,B02,083749,Staff,0,9,30,30
1650261858867,MATH 18,B03,083750,Staff,1,6,30,29
1650261858867,MATH 18,B04,083751,Staff,0,9,30,30
1650261864889,MATH 20A,A01,083754,Staff,26,0,40,14
1650261870913,MATH 20B,A01,083756,Staff,0,5,30,30
1650261870913,MATH 20B,A02,083757,Staff,0,7,30,30
1650261876940,MATH 20C,A01,083760,Staff,0,13,30,30
1650261876940,MATH 20C,A02,083761,Staff,0,13,30,30
1650261876940,MATH 20C,B01,083762,Staff,14,0,30,16
1650261876940,MATH 20C,B02,083763,Staff,28,0,30,2
1650261882965,MATH 20D,A01,083765,Staff,0,1,30,30
1650261882965,MATH 20D,A02,083766,Staff,8,0,30,22
1650261882965,MATH 20D,A03,083767,Staff,28,0,30,2
1650261888990,MATH 20E,A01,083771,Staff,6,0,30,24
1650261888990,MATH 20E,A02,083772,Staff,20,0,30,10
1650261888990,MATH 20E,B01,083773,Staff,0,0,30,30
1650261888990,MATH 20E,B02,083774,Staff,12,0,30,18
1650261895015,MATH 103A,A01,083777,Staff,0,9,30,30
1650261895015,MATH 103A,A02,083778,Staff,0,10,30,30
1650261895015,MATH 103A,B01,083779,Staff,0,10,30,30
1650261895015,MATH 103A,B02,083780,Staff,0,10,30,30
1650261901042,MATH 105,A01,085443,Staff,0,17,30,30
1650261907072,MATH 109,A01,083213,Anzaldo; Leesa B,0,5,30,30
1650261907072,MATH 109,A02,083214,Anzaldo; Leesa B,0,6,30,30
1650261907072,MATH 109,B01,083215,Anzaldo; Leesa B,0,4,30,30
1650261907072,MATH 109,B02,083216,Anzaldo; Leesa B,0,3,30,30
1650261913096,MATH 142A,A01,083219,Chow; Bennett,0,12,30,30
1650261913096,MATH 142A,A02,083220,Chow; Bennett,0,11,30,30
1650261913096,MATH 142A,B01,083221,Chow; Bennett,0,11,30,30
1650261913096,MATH 142A,B02,083222,Chow; Bennett,0,12,30,30
1650261919124,MATH 193A,A01,083224,Staff,0,5,30,30
1650261919124,MATH 193A,A02,083225,Staff,0,4,30,30
1650261919124,MATH 193A,A03,083781,Staff,0,2,30,30
1650261919124,MATH 193A,A04,083782,Staff,0,1,30,30
1650261925150,MATH 197,001,091859,McAuley; Julian John,9998,0,9999,1
1650261931204,COGS 9,A01,083615,Staff,0,14,60,60
1650261937230,COGS 11,A01,083617,Boyle; Mary E. T.,24,0,40,16
1650261943258,COGS 13,A01,083071,Staff,0,31,40,40
1650261949282,COGS 14A,A01,092681,Staff,0,14,100,100
1650261955312,COGS 14B,A01,083073,Cheng; Tzu-Han,0,9,50,50
1650261961338,COGS 17,A01,092677,Staff,30,0,75,45
1650261967370,COGS 100,A01,083619,Staff,0,22,60,60
1650261973394,COGS 101A,A01,083621,Davis; Joshua Daniel,0,21,60,60
1650261979421,COGS 101B,A01,091572,Staff,4,0,60,56
1650261985444,COGS 101C,A01,083625,Delgado; Tania,20,0,30,10
1650261991468,COGS 107A,A01,083627,Boyle; Mary E. T.,0,8,60,60
1650261997491,COGS 118A,A01,083075,Staff,13,0,60,47
1650262003518,CSE 3,A50,083646,Miranda; Gregory Joseph,22,0,38,16
1650262003518,CSE 3,A51,083647,Miranda; Gregory Joseph,37,0,37,0
1650262009550,CSE 8A,A50,083650,Miranda; Gregory Joseph,0,20,40,40
1650262015573,CSE 11,A01,083080,Cao; Yingjun,0,71,40,40
1650262021599,CSE 12,A01,083652,Staff,0,9,100,100
1650262027627,CSE 15L,A01,083654,Staff,0,1,50,50
1650262027627,CSE 15L,A02,083655,Staff,5,0,50,45
1650262033650,CSE 20,A01,083657,Staff,53,0,80,27
1650262039673,CSE 30,A01,083084,Eldon; John,0,74,40,40
1650262045696,CSE 100,A01,083659,Cao; Yingjun,0,64,50,50
1650262051723,CSE 134B,A01,083661,Powell; Thomas Allan,0,27,65,65
1650262057747,CSE 140,A01,083663,Staff,0,0,75,75
1650262063772,CSE 140L,A01,083088,Eldon; John,0,5,75,75
1650262069797,CSE 175,A01,083665,Kumar; Rakesh,8,0,25,17
1650262075829,CSE 190,A00,092507,Dubnov; Shlomo,14,0,20,6
1650262081853,ECE 45,A01,083139,Staff,0,14,40,40
1650262087889,ECE 65,A50,083695,Staff,0,5,30,30
1650262093913,ECE 109,A01,091882,Touri; Behrouz,46,0,70,24
1650262099952,ECE 180,A00,083140,Abi Samra; Nicholas Camill,24,0,30,6
1650262099952,ECE 180,B00,083141,Abi Samra; Nicholas Camill,7,0,30,23
1650262106000,MATH 10A,A01,083735,Patchell; Gregory David,11,0,30,19
1650262106000,MATH 10A,A02,083736,Patchell; Gregory David,28,0,30,2
1650262106000,MATH 10A,A03,083737,Patchell; Gregory David,26,0,30,4
1650262112029,MATH 10B,A01,083207,Staff,0,6,30,30
1650262112029,MATH 10B,A02,083208,Staff,0,5,30,30
1650262112029,MATH 10B,B01,083739,Staff,17,0,30,13
1650262112029,MATH 10B,B02,083740,Staff,29,0,30,1
1650262118059,MATH 18,A01,083743,Staff,7,0,30,23
1650262118059,MATH 18,A02,083744,Staff,28,0,30,2
1650262118059,MATH 18,A03,083745,Staff,23,0,30,7
1650262118059,MATH 18,A04,083746,Staff,27,0,30,3
1650262118059,MATH 18,B01,083748,Staff,0,11,30,30
1650262118059,MATH 18,B02,083749,Staff,0,9,30,30
1650262118059,MATH 18,B03,083750,Staff,1,6,30,29
1650262118059,MATH 18,B04,083751,Staff,0,9,30,30
1650262124093,MATH 20A,A01,083754,Staff,26,0,40,14
1650262130116,MATH 20B,A01,083756,Staff,0,5,30,30
1650262130116,MATH 20B,A02,083757,Staff,0,7,30,30
1650262136139,MATH 20C,A01,083760,Staff,0,13,30,30
1650262136139,MATH 20C,A02,083761,Staff,0,13,30,30
1650262136139,MATH 20C,B01,083762,Staff,14,0,30,16
1650262136139,MATH 20C,B02,083763,Staff,28,0,30,2
1650262142170,MATH 20D,A01,083765,Staff,0,1,30,30
1650262142170,MATH 20D,A02,083766,Staff,8,0,30,22
1650262142170,MATH 20D,A03,083767,Staff,28,0,30,2
1650262148202,MATH 20E,A01,083771,Staff,6,0,30,24
1650262148202,MATH 20E,A02,083772,Staff,20,0,30,10
1650262148202,MATH 20E,B01,083773,Staff,0,0,30,30
1650262148202,MATH 20E,B02,083774,Staff,12,0,30,18
1650262154229,MATH 103A,A01,083777,Staff,0,9,30,30
1650262154229,MATH 103A,A02,083778,Staff,0,10,30,30
1650262154229,MATH 103A,B01,083779,Staff,0,10,30,30
1650262154229,MATH 103A,B02,083780,Staff,0,10,30,30
1650262160252,MATH 105,A01,085443,Staff,0,17,30,30
1650262166274,MATH 109,A01,083213,Anzaldo; Leesa B,0,5,30,30
1650262166274,MATH 109,A02,083214,Anzaldo; Leesa B,0,6,30,30
1650262166274,MATH 109,B01,083215,Anzaldo; Leesa B,0,4,30,30
1650262166274,MATH 109,B02,083216,Anzaldo; Leesa B,0,3,30,30
1650262172303,MATH 142A,A01,083219,Chow; Bennett,0,12,30,30
1650262172303,MATH 142A,A02,083220,Chow; Bennett,0,11,30,30
1650262172303,MATH 142A,B01,083221,Chow; Bennett,0,11,30,30
1650262172303,MATH 142A,B02,083222,Chow; Bennett,0,12,30,30
1650262178333,MATH 193A,A01,083224,Staff,0,5,30,30
1650262178333,MATH 193A,A02,083225,Staff,0,4,30,30
1650262178333,MATH 193A,A03,083781,Staff,0,2,30,30
1650262178333,MATH 193A,A04,083782,Staff,0,1,30,30
1650262184364,MATH 197,001,091859,McAuley; Julian John,9998,0,9999,1
1650262190417,COGS 9,A01,083615,Staff,0,14,60,60
1650262196439,COGS 11,A01,083617,Boyle; Mary E. T.,24,0,40,16
1650262202468,COGS 13,A01,083071,Staff,0,31,40,40
1650262208502,COGS 14A,A01,092681,Staff,0,14,100,100
1650262214526,COGS 14B,A01,083073,Cheng; Tzu-Han,0,9,50,50
1650262220558,COGS 17,A01,092677,Staff,30,0,75,45
1650262226582,COGS 100,A01,083619,Staff,0,22,60,60
1650262232605,COGS 101A,A01,083621,Davis; Joshua Daniel,0,21,60,60
1650262238630,COGS 101B,A01,091572,Staff,4,0,60,56
1650262244654,COGS 101C,A01,083625,Delgado; Tania,20,0,30,10
1650262250707,COGS 107A,A01,083627,Boyle; Mary E. T.,0,8,60,60
1650262256736,COGS 118A,A01,083075,Staff,13,0,60,47
1650262262760,CSE 3,A50,083646,Miranda; Gregory Joseph,22,0,38,16
1650262262760,CSE 3,A51,083647,Miranda; Gregory Joseph,37,0,37,0
1650262268792,CSE 8A,A50,083650,Miranda; Gregory Joseph,0,20,40,40
1650262274821,CSE 11,A01,083080,Cao; Yingjun,0,71,40,40
1650262280852,CSE 12,A01,083652,Staff,0,9,100,100
1650262286879,CSE 15L,A01,083654,Staff,0,1,50,50
1650262286879,CSE 15L,A02,083655,Staff,5,0,50,45
1650262292905,CSE 20,A01,083657,Staff,53,0,80,27
1650262298932,CSE 30,A01,083084,Eldon; John,0,74,40,40
1650262304965,CSE 100,A01,083659,Cao; Yingjun,0,64,50,50
1650262310988,CSE 134B,A01,083661,Powell; Thomas Allan,0,27,65,65
1650262317017,CSE 140,A01,083663,Staff,0,0,75,75
1650262323053,CSE 140L,A01,083088,Eldon; John,0,5,75,75
1650262329076,CSE 175,A01,083665,Kumar; Rakesh,8,0,25,17
1650262335100,CSE 190,A00,092507,Dubnov; Shlomo,14,0,20,6
1650262341125,ECE 45,A01,083139,Staff,0,14,40,40
1650262347238,ECE 65,A50,083695,Staff,0,5,30,30
1650262353263,ECE 109,A01,091882,Touri; Behrouz,46,0,70,24
1650262359290,ECE 180,A00,083140,Abi Samra; Nicholas Camill,24,0,30,6
1650262359290,ECE 180,B00,083141,Abi Samra; Nicholas Camill,7,0,30,23
1650262365323,MATH 10A,A01,083735,Patchell; Gregory David,11,0,30,19
1650262365323,MATH 10A,A02,083736,Patchell; Gregory David,28,0,30,2
1650262365323,MATH 10A,A03,083737,Patchell; Gregory David,26,0,30,4
1650262371347,MATH 10B,A01,083207,Staff,0,6,30,30
1650262371347,MATH 10B,A02,083208,Staff,0,5,30,30
1650262371347,MATH 10B,B01,083739,Staff,17,0,30,13
1650262371347,MATH 10B,B02,083740,Staff,29,0,30,1
1650262377376,MATH 18,A01,083743,Staff,7,0,30,23
1650262377376,MATH 18,A02,083744,Staff,28,0,30,2
1650262377376,MATH 18,A03,083745,Staff,23,0,30,7
1650262377376,MATH 18,A04,083746,Staff,27,0,30,3
1650262377376,MATH 18,B01,083748,Staff,0,11,30,30
1650262377376,MATH 18,B02,083749,Staff,0,9,30,30
1650262377376,MATH 18,B03,083750,Staff,1,6,30,29
1650262377376,MATH 18,B04,083751,Staff,0,9,30,30
1650262383406,MATH 20A,A01,083754,Staff,26,0,40,14
1650262389435,MATH 20B,A01,083756,Staff,0,5,30,30
1650262389435,MATH 20B,A02,083757,Staff,0,7,30,30
1650262395460,MATH 20C,A01,083760,Staff,0,13,30,30
1650262395460,MATH 20C,A02,083761,Staff,0,13,30,30
1650262395460,MATH 20C,B01,083762,Staff,14,0,30,16
1650262395460,MATH 20C,B02,083763,Staff,28,0,30,2
1650262401490,MATH 20D,A01,083765,Staff,0,1,30,30
1650262401490,MATH 20D,A02,083766,Staff,8,0,30,22
1650262401490,MATH 20D,A03,083767,Staff,28,0,30,2
1650262407518,MATH 20E,A01,083771,Staff,6,0,30,24
1650262407518,MATH 20E,A02,083772,Staff,20,0,30,10
1650262407518,MATH 20E,B01,083773,Staff,0,0,30,30
1650262407518,MATH 20E,B02,083774,Staff,12,0,30,18
1650262413540,MATH 103A,A01,083777,Staff,0,9,30,30
1650262413540,MATH 103A,A02,083778,Staff,0,10,30,30
1650262413540,MATH 103A,B01,083779,Staff,0,10,30,30
1650262413540,MATH 103A,B02,083780,Staff,0,10,30,30
1650262419567,MATH 105,A01,085443,Staff,0,17,30,30
1650262425592,MATH 109,A01,083213,Anzaldo; Leesa B,0,5,30,30
1650262425592,MATH 109,A02,083214,Anzaldo; Leesa B,0,6,30,30
1650262425592,MATH 109,B01,083215,Anzaldo; Leesa B,0,4,30,30
1650262425592,MATH 109,B02,083216,Anzaldo; Leesa B,0,3,30,30
1650262431618,MATH 142A,A01,083219,Chow; Bennett,0,12,30,30
1650262431618,MATH 142A,A02,083220,Chow; Bennett,0,11,30,30
1650262431618,MATH 142A,B01,083221,Chow; Bennett,0,11,30,30
1650262431618,MATH 142A,B02,083222,Chow; Bennett,0,12,30,30
1650262437642,MATH 193A,A01,083224,Staff,0,5,30,30
1650262437642,MATH 193A,A02,083225,Staff,0,4,30,30
1650262437642,MATH 193A,A03,083781,Staff,0,2,30,30
1650262437642,MATH 193A,A04,083782,Staff,0,1,30,30
1650262443671,MATH 197,001,091859,McAuley; Julian John,9998,0,9999,1
1650262449725,COGS 9,A01,083615,Staff,0,14,60,60
1650262455751,COGS 11,A01,083617,Boyle; Mary E. T.,24,0,40,16
1650262461778,COGS 13,A01,083071,Staff,0,31,40,40
1650262467810,COGS 14A,A01,092681,Staff,0,14,100,100
1650262473834,COGS 14B,A01,083073,Cheng; Tzu-Han,0,9,50,50
1650262479861,COGS 17,A01,092677,Staff,30,0,75,45
1650262485884,COGS 100,A01,083619,Staff,0,22,60,60
1650262491908,COGS 101A,A01,083621,Davis; Joshua Daniel,0,21,60,60
1650262497935,COGS 101B,A01,091572,Staff,4,0,60,56
1650262503971,COGS 101C,A01,083625,Delgado; Tania,20,0,30,10
1650262509994,COGS 107A,A01,083627,Boyle; Mary E. T.,0,8,60,60
1650262516019,COGS 118A,A01,083075,Staff,13,0,60,47
1650262522050,CSE 3,A50,083646,Miranda; Gregory Joseph,22,0,38,16
1650262522050,CSE 3,A51,083647,Miranda; Gregory Joseph,37,0,37,0
1650262528074,CSE 8A,A50,083650,Miranda; Gregory Joseph,0,20,40,40
1650262534108,CSE 11,A01,083080,Cao; Yingjun,0,71,40,40
1650262540132,CSE 12,A01,083652,Staff,0,9,100,100
1650262546159,CSE 15L,A01,083654,Staff,0,1,50,50
1650262546159,CSE 15L,A02,083655,Staff,5,0,50,45
1650262552183,CSE 20,A01,083657,Staff,53,0,80,27
1650262558206,CSE 30,A01,083084,Eldon; John,0,74,40,40
1650262564232,CSE 100,A01,083659,Cao; Yingjun,0,64,50,50
1650262570260,CSE 134B,A01,083661,Powell; Thomas Allan,0,27,65,65
1650262576286,CSE 140,A01,083663,Staff,0,0,75,75
1650262582313,CSE 140L,A01,083088,Eldon; John,0,5,75,75
1650262588337,CSE 175,A01,083665,Kumar; Rakesh,8,0,25,17
1650262594367,CSE 190,A00,092507,Dubnov; Shlomo,14,0,20,6
1650262600389,ECE 45,A01,083139,Staff,0,14,40,40
1650262606413,ECE 65,A50,083695,Staff,0,5,30,30
1650262612438,ECE 109,A01,091882,Touri; Behrouz,46,0,70,24
1650262618460,ECE 180,A00,083140,Abi Samra; Nicholas Camill,24,0,30,6
1650262618460,ECE 180,B00,083141,Abi Samra; Nicholas Camill,7,0,30,23
1650262624491,MATH 10A,A01,083735,Patchell; Gregory David,11,0,30,19
1650262624491,MATH 10A,A02,083736,Patchell; Gregory David,28,0,30,2
1650262624491,MATH 10A,A03,083737,Patchell; Gregory David,26,0,30,4
1650262630516,MATH 10B,A01,083207,Staff,0,6,30,30
1650262630516,MATH 10B,A02,083208,Staff,0,5,30,30
1650262630516,MATH 10B,B01,083739,Staff,17,0,30,13
1650262630516,MATH 10B,B02,083740,Staff,29,0,30,1
1650262636540,MATH 18,A01,083743,Staff,7,0,30,23
1650262636540,MATH 18,A02,083744,Staff,28,0,30,2
1650262636540,MATH 18,A03,083745,Staff,23,0,30,7
1650262636540,MATH 18,A04,083746,Staff,27,0,30,3
1650262636540,MATH 18,B01,083748,Staff,0,11,30,30
1650262636540,MATH 18,B02,083749,Staff,0,9,30,30
1650262636540,MATH 18,B03,083750,Staff,1,6,30,29
1650262636540,MATH 18,B04,083751,Staff,0,9,30,30
1650262642563,MATH 20A,A01,083754,Staff,26,0,40,14
1650262648589,MATH 20B,A01,083756,Staff,0,5,30,30
1650262648589,MATH 20B,A02,083757,Staff,0,7,30,30
1650262654616,MATH 20C,A01,083760,Staff,0,13,30,30
1650262654616,MATH 20C,A02,083761,Staff,0,13,30,30
1650262654616,MATH 20C,B01,083762,Staff,14,0,30,16
1650262654616,MATH 20C,B02,083763,Staff,28,0,30,2
1650262660640,MATH 20D,A01,083765,Staff,0,1,30,30
1650262660640,MATH 20D,A02,083766,Staff,8,0,30,22
1650262660640,MATH 20D,A03,083767,Staff,28,0,30,2
1650262666664,MATH 20E,A01,083771,Staff,6,0,30,24
1650262666664,MATH 20E,A02,083772,Staff,20,0,30,10
1650262666664,MATH 20E,B01,083773,Staff,0,0,30,30
1650262666664,MATH 20E,B02,083774,Staff,12,0,30,18
1650262672686,MATH 103A,A01,083777,Staff,0,9,30,30
1650262672686,MATH 103A,A02,083778,Staff,0,10,30,30
1650262672686,MATH 103A,B01,083779,Staff,0,10,30,30
1650262672686,MATH 103A,B02,083780,Staff,0,10,30,30
1650262678718,MATH 105,A01,085443,Staff,0,17,30,30
1650262684748,MATH 109,A01,083213,Anzaldo; Leesa B,0,5,30,30
1650262684748,MATH 109,A02,083214,Anzaldo; Leesa B,0,6,30,30
1650262684748,MATH 109,B01,083215,Anzaldo; Leesa B,0,4,30,30
1650262684748,MATH 109,B02,083216,Anzaldo; Leesa B,0,3,30,30
1650262690778,MATH 142A,A01,083219,Chow; Bennett,0,12,30,30
1650262690778,MATH 142A,A02,083220,Chow; Bennett,0,11,30,30
1650262690778,MATH 142A,B01,083221,Chow; Bennett,0,11,30,30
1650262690778,MATH 142A,B02,083222,Chow; Bennett,0,12,30,30
1650262696810,MATH 193A,A01,083224,Staff,0,5,30,30
1650262696810,MATH 193A,A02,083225,Staff,0,4,30,30
1650262696810,MATH 193A,A03,083781,Staff,0,2,30,30
1650262696810,MATH 193A,A04,083782,Staff,0,1,30,30
1650262702833,MATH 197,001,091859,McAuley; Julian John,9998,0,9999,1
1650262708895,COGS 9,A01,083615,Staff,0,14,60,60
1650262714918,COGS 11,A01,083617,Boyle; Mary E. T.,24,0,40,16
1650262720942,COGS 13,A01,083071,Staff,0,31,40,40
1650262726969,COGS 14A,A01,092681,Staff,0,14,100,100
1650262733007,COGS 14B,A01,083073,Cheng; Tzu-Han,0,9,50,50
1650262739030,COGS 17,A01,092677,Staff,30,0,75,45
1650262745078,COGS 100,A01,083619,Staff,0,22,60,60
1650262751105,COGS 101A,A01,083621,Davis; Joshua Daniel,0,21,60,60
1650262757129,COGS 101B,A01,091572,Staff,4,0,60,56
1650262763155,COGS 101C,A01,083625,Delgado; Tania,20,0,30,10
1650262769179,COGS 107A,A01,083627,Boyle; Mary E. T.,0,8,60,60
1650262775205,COGS 118A,A01,083075,Staff,13,0,60,47
1650262781230,CSE 3,A50,083646,Miranda; Gregory Joseph,22,0,38,16
1650262781230,CSE 3,A51,083647,Miranda; Gregory Joseph,37,0,37,0
1650262787256,CSE 8A,A50,083650,Miranda; Gregory Joseph,0,20,40,40
1650262793283,CSE 11,A01,083080,Cao; Yingjun,0,71,40,40
1650262799306,CSE 12,A01,083652,Staff,0,9,100,100
1650262805328,CSE 15L,A01,083654,Staff,0,1,50,50
1650262805328,CSE 15L,A02,083655,Staff,5,0,50,45
1650262811354,CSE 20,A01,083657,Staff,53,0,80,27
1650262817380,CSE 30,A01,083084,Eldon; John,0,74,40,40
1650262823410,CSE 100,A01,083659,Cao; Yingjun,0,64,50,50
1650262829437,CSE 134B,A01,083661,Powell; Thomas Allan,0,27,65,65
1650262835486,CSE 140,A01,083663,Staff,0,0,75,75
1650262841511,CSE 140L,A01,083088,Eldon; John,0,5,75,75
1650262847537,CSE 175,A01,083665,Kumar; Rakesh,8,0,25,17
1650262853559,CSE 190,A00,092507,Dubnov; Shlomo,14,0,20,6
1650262859588,ECE 45,A01,083139,Staff,0,14,40,40
1650262865618,ECE 65,A50,083695,Staff,0,5,30,30
1650262871647,ECE 109,A01,091882,Touri; Behrouz,46,0,70,24
1650262877681,ECE 180,A00,083140,Abi Samra; Nicholas Camill,24,0,30,6
1650262877681,ECE 180,B00,083141,Abi Samra; Nicholas Camill,7,0,30,23
1650262883711,MATH 10A,A01,083735,Patchell; Gregory David,11,0,30,19
1650262883711,MATH 10A,A02,083736,Patchell; Gregory David,28,0,30,2
1650262883711,MATH 10A,A03,083737,Patchell; Gregory David,26,0,30,4
1650262889736,MATH 10B,A01,083207,Staff,0,6,30,30
1650262889736,MATH 10B,A02,083208,Staff,0,5,30,30
1650262889736,MATH 10B,B01,083739,Staff,17,0,30,13
1650262889736,MATH 10B,B02,083740,Staff,29,0,30,1
1650262895765,MATH 18,A01,083743,Staff,7,0,30,23
1650262895765,MATH 18,A02,083744,Staff,28,0,30,2
1650262895765,MATH 18,A03,083745,Staff,23,0,30,7
1650262895765,MATH 18,A04,083746,Staff,27,0,30,3
1650262895765,MATH 18,B01,083748,Staff,0,11,30,30
1650262895765,MATH 18,B02,083749,Staff,0,9,30,30
1650262895765,MATH 18,B03,083750,Staff,1,7,30,29
1650262895765,MATH 18,B04,083751,Staff,0,9,30,30
1650262901800,MATH 20A,A01,083754,Staff,26,0,40,14
1650262907832,MATH 20B,A01,083756,Staff,0,5,30,30
1650262907832,MATH 20B,A02,083757,Staff,0,7,30,30
1650262913862,MATH 20C,A01,083760,Staff,0,13,30,30
1650262913862,MATH 20C,A02,083761,Staff,0,13,30,30
1650262913862,MATH 20C,B01,083762,Staff,14,0,30,16
1650262913862,MATH 20C,B02,083763,Staff,28,0,30,2
1650262919888,MATH 20D,A01,083765,Staff,0,1,30,30
1650262919888,MATH 20D,A02,083766,Staff,8,0,30,22
1650262919888,MATH 20D,A03,083767,Staff,28,0,30,2
1650262925911,MATH 20E,A01,083771,Staff,6,0,30,24
1650262925911,MATH 20E,A02,083772,Staff,20,0,30,10
1650262925911,MATH 20E,B01,083773,Staff,0,0,30,30
1650262925911,MATH 20E,B02,083774,Staff,12,0,30,18
1650262931935,MATH 103A,A01,083777,Staff,0,9,30,30
1650262931935,MATH 103A,A02,083778,Staff,0,10,30,30
1650262931935,MATH 103A,B01,083779,Staff,0,10,30,30
1650262931935,MATH 103A,B02,083780,Staff,0,10,30,30
1650262937967,MATH 105,A01,085443,Staff,0,17,30,30
1650262944078,MATH 109,A01,083213,Anzaldo; Leesa B,0,5,30,30
1650262944078,MATH 109,A02,083214,Anzaldo; Leesa B,0,6,30,30
1650262944078,MATH 109,B01,083215,Anzaldo; Leesa B,0,4,30,30
1650262944078,MATH 109,B02,083216,Anzaldo; Leesa B,0,3,30,30
1650262950106,MATH 142A,A01,083219,Chow; Bennett,0,12,30,30
1650262950106,MATH 142A,A02,083220,Chow; Bennett,0,11,30,30
1650262950106,MATH 142A,B01,083221,Chow; Bennett,0,11,30,30
1650262950106,MATH 142A,B02,083222,Chow; Bennett,0,12,30,30
1650262956130,MATH 193A,A01,083224,Staff,0,5,30,30
1650262956130,MATH 193A,A02,083225,Staff,0,4,30,30
1650262956130,MATH 193A,A03,083781,Staff,0,2,30,30
1650262956130,MATH 193A,A04,083782,Staff,0,1,30,30
1650262962153,MATH 197,001,091859,McAuley; Julian John,9998,0,9999,1
1650262968203,COGS 9,A01,083615,Staff,0,14,60,60
1650262974230,COGS 11,A01,083617,Boyle; Mary E. T.,24,0,40,16
1650262980259,COGS 13,A01,083071,Staff,0,31,40,40
1650262986282,COGS 14A,A01,092681,Staff,0,14,100,100
1650262992304,COGS 14B,A01,083073,Cheng; Tzu-Han,0,9,50,50
1650262998333,COGS 17,A01,092677,Staff,30,0,75,45
1650263004356,COGS 100,A01,083619,Staff,0,22,60,60
1650263010384,COGS 101A,A01,083621,Davis; Joshua Daniel,0,21,60,60
1650263016406,COGS 101B,A01,091572,Staff,4,0,60,56
1650263022429,COGS 101C,A01,083625,Delgado; Tania,20,0,30,10
1650263028455,COGS 107A,A01,083627,Boyle; Mary E. T.,0,8,60,60
1650263034477,COGS 118A,A01,083075,Staff,13,0,60,47
1650263040501,CSE 3,A50,083646,Miranda; Gregory Joseph,22,0,38,16
1650263040501,CSE 3,A51,083647,Miranda; Gregory Joseph,37,0,37,0
1650263046524,CSE 8A,A50,083650,Miranda; Gregory Joseph,0,20,40,40
1650263052553,CSE 11,A01,083080,Cao; Yingjun,0,71,40,40
1650263058577,CSE 12,A01,083652,Staff,0,9,100,100
1650263064601,CSE 15L,A01,083654,Staff,0,1,50,50
1650263064601,CSE 15L,A02,083655,Staff,5,0,50,45
1650263070645,CSE 20,A01,083657,Staff,53,0,80,27
1650263076679,CSE 30,A01,083084,Eldon; John,0,74,40,40
1650263082706,CSE 100,A01,083659,Cao; Yingjun,0,64,50,50
1650263088733,CSE 134B,A01,083661,Powell; Thomas Allan,0,27,65,65
1650263094759,CSE 140,A01,083663,Staff,0,0,75,75
1650263100784,CSE 140L,A01,083088,Eldon; John,0,5,75,75
1650263106818,CSE 175,A01,083665,Kumar; Rakesh,8,0,25,17
1650263112844,CSE 190,A00,092507,Dubnov; Shlomo,14,0,20,6
1650263118873,ECE 45,A01,083139,Staff,0,14,40,40
1650263124907,ECE 65,A50,083695,Staff,0,5,30,30
1650263130931,ECE 109,A01,091882,Touri; Behrouz,46,0,70,24
1650263136972,ECE 180,A00,083140,Abi Samra; Nicholas Camill,24,0,30,6
1650263136972,ECE 180,B00,083141,Abi Samra; Nicholas Camill,7,0,30,23
1650263142999,MATH 10A,A01,083735,Patchell; Gregory David,11,0,30,19
1650263142999,MATH 10A,A02,083736,Patchell; Gregory David,28,0,30,2
1650263142999,MATH 10A,A03,083737,Patchell; Gregory David,26,0,30,4
1650263149031,MATH 10B,A01,083207,Staff,0,6,30,30
1650263149031,MATH 10B,A02,083208,Staff,0,5,30,30
1650263149031,MATH 10B,B01,083739,Staff,17,0,30,13
1650263149031,MATH 10B,B02,083740,Staff,29,0,30,1
1650263155067,MATH 18,A01,083743,Staff,7,0,30,23
1650263155067,MATH 18,A02,083744,Staff,28,0,30,2
1650263155067,MATH 18,A03,083745,Staff,23,0,30,7
1650263155067,MATH 18,A04,083746,Staff,27,0,30,3
1650263155067,MATH 18,B01,083748,Staff,0,11,30,30
1650263155067,MATH 18,B02,083749,Staff,0,9,30,30
1650263155067,MATH 18,B03,083750,Staff,1,7,30,29
1650263155067,MATH 18,B04,083751,Staff,0,9,30,30
1650263161092,MATH 20A,A01,083754,Staff,26,0,40,14
1650263167127,MATH 20B,A01,083756,Staff,0,5,30,30
1650263167127,MATH 20B,A02,083757,Staff,0,7,30,30
1650263173151,MATH 20C,A01,083760,Staff,0,13,30,30
1650263173151,MATH 20C,A02,083761,Staff,0,13,30,30
1650263173151,MATH 20C,B01,083762,Staff,14,0,30,16
1650263173151,MATH 20C,B02,083763,Staff,28,0,30,2
1650263179178,MATH 20D,A01,083765,Staff,0,1,30,30
1650263179178,MATH 20D,A02,083766,Staff,8,0,30,22
1650263179178,MATH 20D,A03,083767,Staff,28,0,30,2
1650263185251,MATH 20E,A01,083771,Staff,6,0,30,24
1650263185251,MATH 20E,A02,083772,Staff,20,0,30,10
1650263185251,MATH 20E,B01,083773,Staff,0,0,30,30
1650263185251,MATH 20E,B02,083774,Staff,12,0,30,18
1650263191279,MATH 103A,A01,083777,Staff,0,9,30,30
1650263191279,MATH 103A,A02,083778,Staff,0,10,30,30
1650263191279,MATH 103A,B01,083779,Staff,0,10,30,30
1650263191279,MATH 103A,B02,083780,Staff,0,10,30,30
1650263197301,MATH 105,A01,085443,Staff,0,17,30,30
1650263203330,MATH 109,A01,083213,Anzaldo; Leesa B,0,5,30,30
1650263203330,MATH 109,A02,083214,Anzaldo; Leesa B,0,6,30,30
1650263203330,MATH 109,B01,083215,Anzaldo; Leesa B,0,4,30,30
1650263203330,MATH 109,B02,083216,Anzaldo; Leesa B,0,3,30,30
1650263209361,MATH 142A,A01,083219,Chow; Bennett,0,12,30,30
1650263209361,MATH 142A,A02,083220,Chow; Bennett,0,11,30,30
1650263209361,MATH 142A,B01,083221,Chow; Bennett,0,11,30,30
1650263209361,MATH 142A,B02,083222,Chow; Bennett,0,12,30,30
1650263215393,MATH 193A,A01,083224,Staff,0,5,30,30
1650263215393,MATH 193A,A02,083225,Staff,0,4,30,30
1650263215393,MATH 193A,A03,083781,Staff,0,2,30,30
1650263215393,MATH 193A,A04,083782,Staff,0,1,30,30
1650263221420,MATH 197,001,091859,McAuley; Julian John,9998,0,9999,1
1650263227477,COGS 9,A01,083615,Staff,0,14,60,60
1650263233513,COGS 11,A01,083617,Boyle; Mary E. T.,24,0,40,16
1650263239536,COGS 13,A01,083071,Staff,0,31,40,40
1650263245561,COGS 14A,A01,092681,Staff,0,14,100,100
1650263251584,COGS 14B,A01,083073,Cheng; Tzu-Han,0,9,50,50
1650263257608,COGS 17,A01,092677,Staff,30,0,75,45
1650263263633,COGS 100,A01,083619,Staff,0,22,60,60
1650263269663,COGS 101A,A01,083621,Davis; Joshua Daniel,0,21,60,60
1650263275692,COGS 101B,A01,091572,Staff,4,0,60,56
1650263281717,COGS 101C,A01,083625,Delgado; Tania,20,0,30,10
1650263287745,COGS 107A,A01,083627,Boyle; Mary E. T.,0,8,60,60
1650263293793,COGS 118A,A01,083075,Staff,13,0,60,47
1650263299819,CSE 3,A50,083646,Miranda; Gregory Joseph,22,0,38,16
1650263299819,CSE 3,A51,083647,Miranda; Gregory Joseph,37,0,37,0
1650263305848,CSE 8A,A50,083650,Miranda; Gregory Joseph,0,20,40,40
1650263311890,CSE 11,A01,083080,Cao; Yingjun,0,71,40,40
1650263317925,CSE 12,A01,083652,Staff,0,9,100,100
1650263323955,CSE 15L,A01,083654,Staff,0,1,50,50
1650263323955,CSE 15L,A02,083655,Staff,5,0,50,45
1650263329982,CSE 20,A01,083657,Staff,53,0,80,27
1650263336004,CSE 30,A01,083084,Eldon; John,0,74,40,40
1650263342030,CSE 100,A01,083659,Cao; Yingjun,0,64,50,50
1650263348070,CSE 134B,A01,083661,Powell; Thomas Allan,0,27,65,65
1650263354097,CSE 140,A01,083663,Staff,0,0,75,75
1650263360131,CSE 140L,A01,083088,Eldon; John,0,5,75,75
1650263366156,CSE 175,A01,083665,Kumar; Rakesh,8,0,25,17
1650263372183,CSE 190,A00,092507,Dubnov; Shlomo,14,0,20,6
1650263378207,ECE 45,A01,083139,Staff,0,14,40,40
1650263384238,ECE 65,A50,083695,Staff,0,5,30,30
1650263390263,ECE 109,A01,091882,Touri; Behrouz,46,0,70,24
1650263396286,ECE 180,A00,083140,Abi Samra; Nicholas Camill,24,0,30,6
1650263396286,ECE 180,B00,083141,Abi Samra; Nicholas Camill,7,0,30,23
1650263402310,MATH 10A,A01,083735,Patchell; Gregory David,11,0,30,19
1650263402310,MATH 10A,A02,083736,Patchell; Gregory David,28,0,30,2
1650263402310,MATH 10A,A03,083737,Patchell; Gregory David,26,0,30,4
1650263408333,MATH 10B,A01,083207,Staff,0,6,30,30
1650263408333,MATH 10B,A02,083208,Staff,0,5,30,30
1650263408333,MATH 10B,B01,083739,Staff,17,0,30,13
1650263408333,MATH 10B,B02,083740,Staff,29,0,30,1
1650263414358,MATH 18,A01,083743,Staff,7,0,30,23
1650263414358,MATH 18,A02,083744,Staff,28,0,30,2
1650263414358,MATH 18,A03,083745,Staff,23,0,30,7
1650263414358,MATH 18,A04,083746,Staff,27,0,30,3
1650263414358,MATH 18,B01,083748,Staff,0,11,30,30
1650263414358,MATH 18,B02,083749,Staff,0,9,30,30
1650263414358,MATH 18,B03,083750,Staff,1,7,30,29
1650263414358,MATH 18,B04,083751,Staff,0,9,30,30
1650263420386,MATH 20A,A01,083754,Staff,26,0,40,14
1650263426411,MATH 20B,A01,083756,Staff,0,5,30,30
1650263426411,MATH 20B,A02,083757,Staff,0,7,30,30
1650263432465,MATH 20C,A01,083760,Staff,0,13,30,30
1650263432465,MATH 20C,A02,083761,Staff,0,13,30,30
1650263432465,MATH 20C,B01,083762,Staff,14,0,30,16
1650263432465,MATH 20C,B02,083763,Staff,28,0,30,2
1650263438499,MATH 20D,A01,083765,Staff,0,1,30,30
1650263438499,MATH 20D,A02,083766,Staff,8,0,30,22
1650263438499,MATH 20D,A03,083767,Staff,28,0,30,2
1650263444527,MATH 20E,A01,083771,Staff,6,0,30,24
1650263444527,MATH 20E,A02,083772,Staff,20,0,30,10
1650263444527,MATH 20E,B01,083773,Staff,0,0,30,30
1650263444527,MATH 20E,B02,083774,Staff,12,0,30,18
1650263450555,MATH 103A,A01,083777,Staff,0,9,30,30
1650263450555,MATH 103A,A02,083778,Staff,0,10,30,30
1650263450555,MATH 103A,B01,083779,Staff,0,10,30,30
1650263450555,MATH 103A,B02,083780,Staff,0,10,30,30
1650263456581,MATH 105,A01,085443,Staff,0,17,30,30
1650263462607,MATH 109,A01,083213,Anzaldo; Leesa B,0,5,30,30
1650263462607,MATH 109,A02,083214,Anzaldo; Leesa B,0,6,30,30
1650263462607,MATH 109,B01,083215,Anzaldo; Leesa B,0,4,30,30
1650263462607,MATH 109,B02,083216,Anzaldo; Leesa B,0,3,30,30
1650263468634,MATH 142A,A01,083219,Chow; Bennett,0,12,30,30
1650263468634,MATH 142A,A02,083220,Chow; Bennett,0,11,30,30
1650263468634,MATH 142A,B01,083221,Chow; Bennett,0,11,30,30
1650263468634,MATH 142A,B02,083222,Chow; Bennett,0,12,30,30
1650263474659,MATH 193A,A01,083224,Staff,0,5,30,30
1650263474659,MATH 193A,A02,083225,Staff,0,4,30,30
1650263474659,MATH 193A,A03,083781,Staff,0,2,30,30
1650263474659,MATH 193A,A04,083782,Staff,0,1,30,30
1650263480687,MATH 197,001,091859,McAuley; Julian John,9998,0,9999,1
1650263486767,COGS 9,A01,083615,Staff,0,14,60,60
1650263492790,COGS 11,A01,083617,Boyle; Mary E. T.,24,0,40,16
1650263498816,COGS 13,A01,083071,Staff,0,31,40,40
1650263504842,COGS 14A,A01,092681,Staff,0,14,100,100
1650263510866,COGS 14B,A01,083073,Cheng; Tzu-Han,0,9,50,50
1650263516898,COGS 17,A01,092677,Staff,30,0,75,45
1650263522925,COGS 100,A01,083619,Staff,0,22,60,60
1650263528951,COGS 101A,A01,083621,Davis; Joshua Daniel,0,21,60,60
1650263535074,COGS 101B,A01,091572,Staff,4,0,60,56
1650263541106,COGS 101C,A01,083625,Delgado; Tania,20,0,30,10
1650263547130,COGS 107A,A01,083627,Boyle; Mary E. T.,0,8,60,60
1650263553152,COGS 118A,A01,083075,Staff,13,0,60,47
1650263559177,CSE 3,A50,083646,Miranda; Gregory Joseph,22,0,38,16
1650263559177,CSE 3,A51,083647,Miranda; Gregory Joseph,37,0,37,0
1650263565204,CSE 8A,A50,083650,Miranda; Gregory Joseph,0,20,40,40
1650263571233,CSE 11,A01,083080,Cao; Yingjun,0,71,40,40
1650263577256,CSE 12,A01,083652,Staff,0,10,100,100
1650263583284,CSE 15L,A01,083654,Staff,0,1,50,50
1650263583284,CSE 15L,A02,083655,Staff,4,0,50,46
1650263589308,CSE 20,A01,083657,Staff,53,0,80,27
1650263595333,CSE 30,A01,083084,Eldon; John,0,74,40,40
1650263601357,CSE 100,A01,083659,Cao; Yingjun,0,64,50,50
1650263607383,CSE 134B,A01,083661,Powell; Thomas Allan,0,27,65,65
1650263613407,CSE 140,A01,083663,Staff,0,0,75,75
1650263619434,CSE 140L,A01,083088,Eldon; John,0,5,75,75
1650263625499,CSE 175,A01,083665,Kumar; Rakesh,8,0,25,17
1650263631531,CSE 190,A00,092507,Dubnov; Shlomo,14,0,20,6
1650263637557,ECE 45,A01,083139,Staff,0,14,40,40
1650263643581,ECE 65,A50,083695,Staff,0,5,30,30
1650263649607,ECE 109,A01,091882,Touri; Behrouz,46,0,70,24
1650263655634,ECE 180,A00,083140,Abi Samra; Nicholas Camill,24,0,30,6
1650263655634,ECE 180,B00,083141,Abi Samra; Nicholas Camill,7,0,30,23
1650263661658,MATH 10A,A01,083735,Patchell; Gregory David,11,0,30,19
1650263661658,MATH 10A,A02,083736,Patchell; Gregory David,28,0,30,2
1650263661658,MATH 10A,A03,083737,Patchell; Gregory David,26,0,30,4
1650263667696,MATH 10B,A01,083207,Staff,0,6,30,30
1650263667696,MATH 10B,A02,083208,Staff,0,5,30,30
1650263667696,MATH 10B,B01,083739,Staff,17,0,30,13
1650263667696,MATH 10B,B02,083740,Staff,29,0,30,1
1650263673722,MATH 18,A01,083743,Staff,7,0,30,23
1650263673722,MATH 18,A02,083744,Staff,27,0,30,3
1650263673722,MATH 18,A03,083745,Staff,23,0,30,7
1650263673722,MATH 18,A04,083746,Staff,27,0,30,3
1650263673722,MATH 18,B01,083748,Staff,0,11,30,30
1650263673722,MATH 18,B02,083749,Staff,0,9,30,30
1650263673722,MATH 18,B03,083750,Staff,1,7,30,29
1650263673722,MATH 18,B04,083751,Staff,0,9,30,30
1650263679744,MATH 20A,A01,083754,Staff,26,0,40,14
1650263685769,MATH 20B,A01,083756,Staff,0,5,30,30
1650263685769,MATH 20B,A02,083757,Staff,0,7,30,30
1650263691794,MATH 20C,A01,083760,Staff,0,13,30,30
1650263691794,MATH 20C,A02,083761,Staff,0,13,30,30
1650263691794,MATH 20C,B01,083762,Staff,14,0,30,16
1650263691794,MATH 20C,B02,083763,Staff,28,0,30,2
1650263697819,MATH 20D,A01,083765,Staff,0,1,30,30
1650263697819,MATH 20D,A02,083766,Staff,8,0,30,22
1650263697819,MATH 20D,A03,083767,Staff,28,0,30,2
1650263703844,MATH 20E,A01,083771,Staff,6,0,30,24
1650263703844,MATH 20E,A02,083772,Staff,20,0,30,10
1650263703844,MATH 20E,B01,083773,Staff,0,0,30,30
1650263703844,MATH 20E,B02,083774,Staff,12,0,30,18
1650263709873,MATH 103A,A01,083777,Staff,0,9,30,30
1650263709873,MATH 103A,A02,083778,Staff,0,10,30,30
1650263709873,MATH 103A,B01,083779,Staff,0,10,30,30
1650263709873,MATH 103A,B02,083780,Staff,0,10,30,30
1650263715899,MATH 105,A01,085443,Staff,0,17,30,30
1650263721927,MATH 109,A01,083213,Anzaldo; Leesa B,0,5,30,30
1650263721927,MATH 109,A02,083214,Anzaldo; Leesa B,0,6,30,30
1650263721927,MATH 109,B01,083215,Anzaldo; Leesa B,0,4,30,30
1650263721927,MATH 109,B02,083216,Anzaldo; Leesa B,0,3,30,30
1650263727955,MATH 142A,A01,083219,Chow; Bennett,0,12,30,30
1650263727955,MATH 142A,A02,083220,Chow; Bennett,0,11,30,30
1650263727955,MATH 142A,B01,083221,Chow; Bennett,0,11,30,30
1650263727955,MATH 142A,B02,083222,Chow; Bennett,0,12,30,30
1650263733983,MATH 193A,A01,083224,Staff,0,5,30,30
1650263733983,MATH 193A,A02,083225,Staff,0,4,30,30
1650263733983,MATH 193A,A03,083781,Staff,0,2,30,30
1650263733983,MATH 193A,A04,083782,Staff,0,1,30,30
1650263740008,MATH 197,001,091859,McAuley; Julian John,9998,0,9999,1
1650263746059,COGS 9,A01,083615,Staff,0,14,60,60
1650263752085,COGS 11,A01,083617,Boyle; Mary E. T.,24,0,40,16
1650263758116,COGS 13,A01,083071,Staff,0,31,40,40
1650263764140,COGS 14A,A01,092681,Staff,0,14,100,100
1650263770164,COGS 14B,A01,083073,Cheng; Tzu-Han,0,9,50,50
1650263776185,COGS 17,A01,092677,Staff,30,0,75,45
1650263782229,COGS 100,A01,083619,Staff,0,22,60,60
1650263788255,COGS 101A,A01,083621,Davis; Joshua Daniel,0,21,60,60
1650263794281,COGS 101B,A01,091572,Staff,4,0,60,56
1650263800310,COGS 101C,A01,083625,Delgado; Tania,20,0,30,10
1650263806334,COGS 107A,A01,083627,Boyle; Mary E. T.,0,8,60,60
1650263812358,COGS 118A,A01,083075,Staff,13,0,60,47
1650263818387,CSE 3,A50,083646,Miranda; Gregory Joseph,22,0,38,16
1650263818387,CSE 3,A51,083647,Miranda; Gregory Joseph,37,0,37,0
1650263824415,CSE 8A,A50,083650,Miranda; Gregory Joseph,0,20,40,40
1650263830439,CSE 11,A01,083080,Cao; Yingjun,0,71,40,40
1650263836464,CSE 12,A01,083652,Staff,0,10,100,100
1650263842490,CSE 15L,A01,083654,Staff,0,1,50,50
1650263842490,CSE 15L,A02,083655,Staff,4,0,50,46
1650263848514,CSE 20,A01,083657,Staff,53,0,80,27
1650263854539,CSE 30,A01,083084,Eldon; John,0,74,40,40
1650263860563,CSE 100,A01,083659,Cao; Yingjun,0,64,50,50
1650263866596,CSE 134B,A01,083661,Powell; Thomas Allan,0,27,65,65
1650263872625,CSE 140,A01,083663,Staff,0,0,75,75
1650263878650,CSE 140L,A01,083088,Eldon; John,0,5,75,75
1650263884674,CSE 175,A01,083665,Kumar; Rakesh,8,0,25,17
1650263890698,CSE 190,A00,092507,Dubnov; Shlomo,14,0,20,6
1650263896724,ECE 45,A01,083139,Staff,0,14,40,40
1650263902747,ECE 65,A50,083695,Staff,0,5,30,30
1650263908772,ECE 109,A01,091882,Touri; Behrouz,46,0,70,24
1650263914796,ECE 180,A00,083140,Abi Samra; Nicholas Camill,24,0,30,6
1650263914796,ECE 180,B00,083141,Abi Samra; Nicholas Camill,7,0,30,23
1650263920831,MATH 10A,A01,083735,Patchell; Gregory David,11,0,30,19
1650263920831,MATH 10A,A02,083736,Patchell; Gregory David,28,0,30,2
1650263920831,MATH 10A,A03,083737,Patchell; Gregory David,26,0,30,4
1650263926857,MATH 10B,A01,083207,Staff,0,7,30,30
1650263926857,MATH 10B,A02,083208,Staff,0,5,30,30
1650263926857,MATH 10B,B01,083739,Staff,17,0,30,13
1650263926857,MATH 10B,B02,083740,Staff,29,0,30,1
1650263932883,MATH 18,A01,083743,Staff,7,0,30,23
1650263932883,MATH 18,A02,083744,Staff,27,0,30,3
1650263932883,MATH 18,A03,083745,Staff,23,0,30,7
1650263932883,MATH 18,A04,083746,Staff,27,0,30,3
1650263932883,MATH 18,B01,083748,Staff,0,11,30,30
1650263932883,MATH 18,B02,083749,Staff,0,9,30,30
1650263932883,MATH 18,B03,083750,Staff,1,7,30,29
1650263932883,MATH 18,B04,083751,Staff,0,9,30,30
1650263938910,MATH 20A,A01,083754,Staff,26,0,40,14
1650263944933,MATH 20B,A01,083756,Staff,0,5,30,30
1650263944933,MATH 20B,A02,083757,Staff,0,7,30,30
1650263950960,MATH 20C,A01,083760,Staff,0,13,30,30
1650263950960,MATH 20C,A02,083761,Staff,0,13,30,30
1650263950960,MATH 20C,B01,083762,Staff,14,0,30,16
1650263950960,MATH 20C,B02,083763,Staff,28,0,30,2
1650263956994,MATH 20D,A01,083765,Staff,0,1,30,30
1650263956994,MATH 20D,A02,083766,Staff,8,0,30,22
1650263956994,MATH 20D,A03,083767,Staff,28,0,30,2
1650263963019,MATH 20E,A01,083771,Staff,6,0,30,24
1650263963019,MATH 20E,A02,083772,Staff,20,0,30,10
1650263963019,MATH 20E,B01,083773,Staff,0,0,30,30
1650263963019,MATH 20E,B02,083774,Staff,12,0,30,18
1650263969044,MATH 103A,A01,083777,Staff,0,9,30,30
1650263969044,MATH 103A,A02,083778,Staff,0,10,30,30
1650263969044,MATH 103A,B01,083779,Staff,0,10,30,30
1650263969044,MATH 103A,B02,083780,Staff,0,10,30,30
1650263975068,MATH 105,A01,085443,Staff,0,17,30,30
1650263981095,MATH 109,A01,083213,Anzaldo; Leesa B,0,5,30,30
1650263981095,MATH 109,A02,083214,Anzaldo; Leesa B,0,6,30,30
1650263981095,MATH 109,B01,083215,Anzaldo; Leesa B,0,4,30,30
1650263981095,MATH 109,B02,083216,Anzaldo; Leesa B,0,3,30,30
1650264004356,MATH 142A,A01,083219,Chow; Bennett,0,12,30,30
1650264004356,MATH 142A,A02,083220,Chow; Bennett,0,11,30,30
1650264004356,MATH 142A,B01,083221,Chow; Bennett,0,11,30,30
1650264004356,MATH 142A,B02,083222,Chow; Bennett,0,12,30,30
1650264010381,MATH 193A,A01,083224,Staff,0,5,30,30
1650264010381,MATH 193A,A02,083225,Staff,0,4,30,30
1650264010381,MATH 193A,A03,083781,Staff,0,2,30,30
1650264010381,MATH 193A,A04,083782,Staff,0,1,30,30
1650264016408,MATH 197,001,091859,McAuley; Julian John,9998,0,9999,1
1650264022464,COGS 9,A01,083615,Staff,0,14,60,60
1650264028493,COGS 11,A01,083617,Boyle; Mary E. T.,24,0,40,16
1650264034519,COGS 13,A01,083071,Staff,0,31,40,40
1650264040546,COGS 14A,A01,092681,Staff,0,14,100,100
1650264046569,COGS 14B,A01,083073,Cheng; Tzu-Han,0,9,50,50
1650264052595,COGS 17,A01,092677,Staff,30,0,75,45
1650264058618,COGS 100,A01,083619,Staff,0,22,60,60
1650264064648,COGS 101A,A01,083621,Davis; Joshua Daniel,0,21,60,60
1650264070674,COGS 101B,A01,091572,Staff,4,0,60,56
1650264076710,COGS 101C,A01,083625,Delgado; Tania,20,0,30,10
1650264082736,COGS 107A,A01,083627,Boyle; Mary E. T.,0,8,60,60
1650264088763,COGS 118A,A01,083075,Staff,13,0,60,47
1650264094789,CSE 3,A50,083646,Miranda; Gregory Joseph,22,0,38,16
1650264094789,CSE 3,A51,083647,Miranda; Gregory Joseph,37,0,37,0
1650264100818,CSE 8A,A50,083650,Miranda; Gregory Joseph,0,20,40,40
1650264106843,CSE 11,A01,083080,Cao; Yingjun,0,71,40,40
1650264112870,CSE 12,A01,083652,Staff,0,10,100,100
1650264118893,CSE 15L,A01,083654,Staff,0,1,50,50
1650264118893,CSE 15L,A02,083655,Staff,4,0,50,46
1650264124926,CSE 20,A01,083657,Staff,53,0,80,27
1650264130970,CSE 30,A01,083084,Eldon; John,0,74,40,40
1650264136994,CSE 100,A01,083659,Cao; Yingjun,0,64,50,50
1650264143022,CSE 134B,A01,083661,Powell; Thomas Allan,0,27,65,65
1650264149133,CSE 140,A01,083663,Staff,0,0,75,75
1650264155160,CSE 140L,A01,083088,Eldon; John,0,5,75,75
1650264161184,CSE 175,A01,083665,Kumar; Rakesh,8,0,25,17
1650264167208,CSE 190,A00,092507,Dubnov; Shlomo,14,0,20,6
1650264173239,ECE 45,A01,083139,Staff,0,14,40,40
1650264179263,ECE 65,A50,083695,Staff,0,5,30,30
1650264185287,ECE 109,A01,091882,Touri; Behrouz,46,0,70,24
1650264191310,ECE 180,A00,083140,Abi Samra; Nicholas Camill,24,0,30,6
1650264191310,ECE 180,B00,083141,Abi Samra; Nicholas Camill,7,0,30,23
1650264197339,MATH 10A,A01,083735,Patchell; Gregory David,11,0,30,19
1650264197339,MATH 10A,A02,083736,Patchell; Gregory David,28,0,30,2
1650264197339,MATH 10A,A03,083737,Patchell; Gregory David,26,0,30,4
1650264203367,MATH 10B,A01,083207,Staff,0,6,30,30
1650264203367,MATH 10B,A02,083208,Staff,0,6,30,30
1650264203367,MATH 10B,B01,083739,Staff,17,0,30,13
1650264203367,MATH 10B,B02,083740,Staff,29,0,30,1
1650264209396,MATH 18,A01,083743,Staff,7,0,30,23
1650264209396,MATH 18,A02,083744,Staff,27,0,30,3
1650264209396,MATH 18,A03,083745,Staff,23,0,30,7
1650264209396,MATH 18,A04,083746,Staff,27,0,30,3
1650264209396,MATH 18,B01,083748,Staff,0,11,30,30
1650264209396,MATH 18,B02,083749,Staff,0,9,30,30
1650264209396,MATH 18,B03,083750,Staff,1,7,30,29
1650264209396,MATH 18,B04,083751,Staff,0,9,30,30
1650264215421,MATH 20A,A01,083754,Staff,26,0,40,14
1650264221443,MATH 20B,A01,083756,Staff,0,5,30,30
1650264221443,MATH 20B,A02,083757,Staff,0,7,30,30
1650264227477,MATH 20C,A01,083760,Staff,0,13,30,30
1650264227477,MATH 20C,A02,083761,Staff,0,13,30,30
1650264227477,MATH 20C,B01,083762,Staff,14,0,30,16
1650264227477,MATH 20C,B02,083763,Staff,28,0,30,2
1650264233512,MATH 20D,A01,083765,Staff,0,1,30,30
1650264233512,MATH 20D,A02,083766,Staff,8,0,30,22
1650264233512,MATH 20D,A03,083767,Staff,28,0,30,2
1650264239536,MATH 20E,A01,083771,Staff,6,0,30,24
1650264239536,MATH 20E,A02,083772,Staff,20,0,30,10
1650264239536,MATH 20E,B01,083773,Staff,0,0,30,30
1650264239536,MATH 20E,B02,083774,Staff,12,0,30,18
1650264245559,MATH 103A,A01,083777,Staff,0,9,30,30
1650264245559,MATH 103A,A02,083778,Staff,0,10,30,30
1650264245559,MATH 103A,B01,083779,Staff,0,10,30,30
1650264245559,MATH 103A,B02,083780,Staff,0,10,30,30
1650264251582,MATH 105,A01,085443,Staff,0,17,30,30
1650264257606,MATH 109,A01,083213,Anzaldo; Leesa B,0,5,30,30
1650264257606,MATH 109,A02,083214,Anzaldo; Leesa B,0,6,30,30
1650264257606,MATH 109,B01,083215,Anzaldo; Leesa B,0,4,30,30
1650264257606,MATH 109,B02,083216,Anzaldo; Leesa B,0,3,30,30
1650264263630,MATH 142A,A01,083219,Chow; Bennett,0,12,30,30
1650264263630,MATH 142A,A02,083220,Chow; Bennett,0,11,30,30
1650264263630,MATH 142A,B01,083221,Chow; Bennett,0,11,30,30
1650264263630,MATH 142A,B02,083222,Chow; Bennett,0,12,30,30
1650264269658,MATH 193A,A01,083224,Staff,0,5,30,30
1650264269658,MATH 193A,A02,083225,Staff,0,4,30,30
1650264269658,MATH 193A,A03,083781,Staff,0,2,30,30
1650264269658,MATH 193A,A04,083782,Staff,0,1,30,30
1650264275680,MATH 197,001,091859,McAuley; Julian John,9998,0,9999,1
1650264281731,COGS 9,A01,083615,Staff,0,14,60,60
1650264287755,COGS 11,A01,083617,Boyle; Mary E. T.,24,0,40,16
1650264293779,COGS 13,A01,083071,Staff,0,31,40,40
1650264299802,COGS 14A,A01,092681,Staff,0,14,100,100
1650264305827,COGS 14B,A01,083073,Cheng; Tzu-Han,0,9,50,50
1650264311853,COGS 17,A01,092677,Staff,30,0,75,45
1650264317880,COGS 100,A01,083619,Staff,0,22,60,60
1650264323903,COGS 101A,A01,083621,Davis; Joshua Daniel,0,21,60,60
1650264329929,COGS 101B,A01,091572,Staff,4,0,60,56
1650264335956,COGS 101C,A01,083625,Delgado; Tania,20,0,30,10
1650264341980,COGS 107A,A01,083627,Boyle; Mary E. T.,0,8,60,60
1650264348006,COGS 118A,A01,083075,Staff,13,0,60,47
1650264354031,CSE 3,A50,083646,Miranda; Gregory Joseph,22,0,38,16
1650264354031,CSE 3,A51,083647,Miranda; Gregory Joseph,37,0,37,0
1650264360063,CSE 8A,A50,083650,Miranda; Gregory Joseph,0,20,40,40
1650264366087,CSE 11,A01,083080,Cao; Yingjun,0,71,40,40
1650264372112,CSE 12,A01,083652,Staff,0,10,100,100
1650264378136,CSE 15L,A01,083654,Staff,0,1,50,50
1650264378136,CSE 15L,A02,083655,Staff,4,0,50,46
1650264384158,CSE 20,A01,083657,Staff,53,0,80,27
1650264390188,CSE 30,A01,083084,Eldon; John,0,74,40,40
1650264396215,CSE 100,A01,083659,Cao; Yingjun,0,64,50,50
1650264402241,CSE 134B,A01,083661,Powell; Thomas Allan,0,27,65,65
1650264408266,CSE 140,A01,083663,Staff,0,0,75,75
1650264414301,CSE 140L,A01,083088,Eldon; John,0,5,75,75
1650264420324,CSE 175,A01,083665,Kumar; Rakesh,8,0,25,17
1650264426350,CSE 190,A00,092507,Dubnov; Shlomo,14,0,20,6
1650264432375,ECE 45,A01,083139,Staff,0,14,40,40
1650264438412,ECE 65,A50,083695,Staff,0,5,30,30
1650264444443,ECE 109,A01,091882,Touri; Behrouz,46,0,70,24
1650264450465,ECE 180,A00,083140,Abi Samra; Nicholas Camill,24,0,30,6
1650264450465,ECE 180,B00,083141,Abi Samra; Nicholas Camill,7,0,30,23
1650264456489,MATH 10A,A01,083735,Patchell; Gregory David,11,0,30,19
1650264456489,MATH 10A,A02,083736,Patchell; Gregory David,28,0,30,2
1650264456489,MATH 10A,A03,083737,Patchell; Gregory David,26,0,30,4
1650264462513,MATH 10B,A01,083207,Staff,0,6,30,30
1650264462513,MATH 10B,A02,083208,Staff,0,6,30,30
1650264462513,MATH 10B,B01,083739,Staff,17,0,30,13
1650264462513,MATH 10B,B02,083740,Staff,29,0,30,1
1650264468540,MATH 18,A01,083743,Staff,7,0,30,23
1650264468540,MATH 18,A02,083744,Staff,27,0,30,3
1650264468540,MATH 18,A03,083745,Staff,23,0,30,7
1650264468540,MATH 18,A04,083746,Staff,27,0,30,3
1650264468540,MATH 18,B01,083748,Staff,0,11,30,30
1650264468540,MATH 18,B02,083749,Staff,0,9,30,30
1650264468540,MATH 18,B03,083750,Staff,1,7,30,29
1650264468540,MATH 18,B04,083751,Staff,0,9,30,30
1650264474565,MATH 20A,A01,083754,Staff,26,0,40,14
1650264480598,MATH 20B,A01,083756,Staff,0,5,30,30
1650264480598,MATH 20B,A02,083757,Staff,0,7,30,30
1650264486624,MATH 20C,A01,083760,Staff,0,13,30,30
1650264486624,MATH 20C,A02,083761,Staff,0,13,30,30
1650264486624,MATH 20C,B01,083762,Staff,14,0,30,16
1650264486624,MATH 20C,B02,083763,Staff,28,0,30,2
1650264492646,MATH 20D,A01,083765,Staff,0,1,30,30
1650264492646,MATH 20D,A02,083766,Staff,8,0,30,22
1650264492646,MATH 20D,A03,083767,Staff,28,0,30,2
1650264498671,MATH 20E,A01,083771,Staff,6,0,30,24
1650264498671,MATH 20E,A02,083772,Staff,20,0,30,10
1650264498671,MATH 20E,B01,083773,Staff,0,0,30,30
1650264498671,MATH 20E,B02,083774,Staff,12,0,30,18
1650264504695,MATH 103A,A01,083777,Staff,0,9,30,30
1650264504695,MATH 103A,A02,083778,Staff,0,10,30,30
1650264504695,MATH 103A,B01,083779,Staff,0,10,30,30
1650264504695,MATH 103A,B02,083780,Staff,0,10,30,30
1650264510726,MATH 105,A01,085443,Staff,0,17,30,30
1650264516750,MATH 109,A01,083213,Anzaldo; Leesa B,0,5,30,30
1650264516750,MATH 109,A02,083214,Anzaldo; Leesa B,0,6,30,30
1650264516750,MATH 109,B01,083215,Anzaldo; Leesa B,0,4,30,30
1650264516750,MATH 109,B02,083216,Anzaldo; Leesa B,0,3,30,30
1650264522774,MATH 142A,A01,083219,Chow; Bennett,0,12,30,30
1650264522774,MATH 142A,A02,083220,Chow; Bennett,0,11,30,30
1650264522774,MATH 142A,B01,083221,Chow; Bennett,0,11,30,30
1650264522774,MATH 142A,B02,083222,Chow; Bennett,0,12,30,30
1650264528801,MATH 193A,A01,083224,Staff,0,5,30,30
1650264528801,MATH 193A,A02,083225,Staff,0,4,30,30
1650264528801,MATH 193A,A03,083781,Staff,0,2,30,30
1650264528801,MATH 193A,A04,083782,Staff,0,1,30,30
1650264534826,MATH 197,001,091859,McAuley; Julian John,9998,0,9999,1
1650264540879,COGS 9,A01,083615,Staff,0,14,60,60
1650264546902,COGS 11,A01,083617,Boyle; Mary E. T.,24,0,40,16
1650264552925,COGS 13,A01,083071,Staff,0,31,40,40
1650264558949,COGS 14A,A01,092681,Staff,0,14,100,100
1650264564972,COGS 14B,A01,083073,Cheng; Tzu-Han,0,9,50,50
1650264570995,COGS 17,A01,092677,Staff,30,0,75,45
1650264577018,COGS 100,A01,083619,Staff,0,22,60,60
1650264583045,COGS 101A,A01,083621,Davis; Joshua Daniel,0,21,60,60
1650264589071,COGS 101B,A01,091572,Staff,4,0,60,56
1650264595098,COGS 101C,A01,083625,Delgado; Tania,20,0,30,10
1650264601127,COGS 107A,A01,083627,Boyle; Mary E. T.,0,8,60,60
1650264607159,COGS 118A,A01,083075,Staff,13,0,60,47
1650264613183,CSE 3,A50,083646,Miranda; Gregory Joseph,22,0,38,16
1650264613183,CSE 3,A51,083647,Miranda; Gregory Joseph,37,0,37,0
1650264619220,CSE 8A,A50,083650,Miranda; Gregory Joseph,0,20,40,40
1650264625252,CSE 11,A01,083080,Cao; Yingjun,0,71,40,40
1650264631282,CSE 12,A01,083652,Staff,0,10,100,100
1650264637308,CSE 15L,A01,083654,Staff,0,1,50,50
1650264637308,CSE 15L,A02,083655,Staff,4,0,50,46
1650264643330,CSE 20,A01,083657,Staff,53,0,80,27
1650264649355,CSE 30,A01,083084,Eldon; John,0,74,40,40
1650264655385,CSE 100,A01,083659,Cao; Yingjun,0,64,50,50
1650264661409,CSE 134B,A01,083661,Powell; Thomas Allan,0,27,65,65
1650264667433,CSE 140,A01,083663,Staff,0,0,75,75
1650264673461,CSE 140L,A01,083088,Eldon; John,0,5,75,75
1650264679484,CSE 175,A01,083665,Kumar; Rakesh,8,0,25,17
1650264685508,CSE 190,A00,092507,Dubnov; Shlomo,14,0,20,6
1650264691532,ECE 45,A01,083139,Staff,0,14,40,40
1650264697584,ECE 65,A50,083695,Staff,0,5,30,30
1650264703615,ECE 109,A01,091882,Touri; Behrouz,46,0,70,24
1650264709645,ECE 180,A00,083140,Abi Samra; Nicholas Camill,24,0,30,6
1650264709645,ECE 180,B00,083141,Abi Samra; Nicholas Camill,7,0,30,23
1650264715683,MATH 10A,A01,083735,Patchell; Gregory David,11,0,30,19
1650264715683,MATH 10A,A02,083736,Patchell; Gregory David,28,0,30,2
1650264715683,MATH 10A,A03,083737,Patchell; Gregory David,26,0,30,4
1650264721708,MATH 10B,A01,083207,Staff,0,6,30,30
1650264721708,MATH 10B,A02,083208,Staff,0,6,30,30
1650264721708,MATH 10B,B01,083739,Staff,17,0,30,13
1650264721708,MATH 10B,B02,083740,Staff,29,0,30,1
1650264727739,MATH 18,A01,083743,Staff,7,0,30,23
1650264727739,MATH 18,A02,083744,Staff,27,0,30,3
1650264727739,MATH 18,A03,083745,Staff,23,0,30,7
1650264727739,MATH 18,A04,083746,Staff,27,0,30,3
1650264727739,MATH 18,B01,083748,Staff,0,11,30,30
1650264727739,MATH 18,B02,083749,Staff,0,9,30,30
1650264727739,MATH 18,B03,083750,Staff,1,7,30,29
1650264727739,MATH 18,B04,083751,Staff,0,9,30,30
1650264733764,MATH 20A,A01,083754,Staff,26,0,40,14
1650264739788,MATH 20B,A01,083756,Staff,0,5,30,30
1650264739788,MATH 20B,A02,083757,Staff,0,7,30,30
1650264745938,MATH 20C,A01,083760,Staff,0,13,30,30
1650264745938,MATH 20C,A02,083761,Staff,0,13,30,30
1650264745938,MATH 20C,B01,083762,Staff,14,0,30,16
1650264745938,MATH 20C,B02,083763,Staff,28,0,30,2
1650264751962,MATH 20D,A01,083765,Staff,0,1,30,30
1650264751962,MATH 20D,A02,083766,Staff,8,0,30,22
1650264751962,MATH 20D,A03,083767,Staff,28,0,30,2
1650264757995,MATH 20E,A01,083771,Staff,6,0,30,24
1650264757995,MATH 20E,A02,083772,Staff,20,0,30,10
1650264757995,MATH 20E,B01,083773,Staff,0,0,30,30
1650264757995,MATH 20E,B02,083774,Staff,12,0,30,18
1650264764021,MATH 103A,A01,083777,Staff,0,9,30,30
1650264764021,MATH 103A,A02,083778,Staff,0,10,30,30
1650264764021,MATH 103A,B01,083779,Staff,0,10,30,30
1650264764021,MATH 103A,B02,083780,Staff,0,10,30,30
1650264770045,MATH 105,A01,085443,Staff,0,17,30,30
1650264776073,MATH 109,A01,083213,Anzaldo; Leesa B,0,5,30,30
1650264776073,MATH 109,A02,083214,Anzaldo; Leesa B,0,6,30,30
1650264776073,MATH 109,B01,083215,Anzaldo; Leesa B,0,4,30,30
1650264776073,MATH 109,B02,083216,Anzaldo; Leesa B,0,3,30,30
1650264782102,MATH 142A,A01,083219,Chow; Bennett,0,12,30,30
1650264782102,MATH 142A,A02,083220,Chow; Bennett,0,11,30,30
1650264782102,MATH 142A,B01,083221,Chow; Bennett,0,11,30,30
1650264782102,MATH 142A,B02,083222,Chow; Bennett,0,12,30,30
1650264788130,MATH 193A,A01,083224,Staff,0,5,30,30
1650264788130,MATH 193A,A02,083225,Staff,0,4,30,30
1650264788130,MATH 193A,A03,083781,Staff,0,2,30,30
1650264788130,MATH 193A,A04,083782,Staff,0,1,30,30
1650264794156,MATH 197,001,091859,McAuley; Julian John,9998,0,9999,1
1650264800229,COGS 9,A01,083615,Staff,0,14,60,60
1650264806253,COGS 11,A01,083617,Boyle; Mary E. T.,24,0,40,16
1650264812279,COGS 13,A01,083071,Staff,0,31,40,40
1650264818305,COGS 14A,A01,092681,Staff,0,14,100,100
1650264824333,COGS 14B,A01,083073,Cheng; Tzu-Han,0,9,50,50
1650264830357,COGS 17,A01,092677,Staff,30,0,75,45
1650264836383,COGS 100,A01,083619,Staff,0,22,60,60
1650264842410,COGS 101A,A01,083621,Davis; Joshua Daniel,0,21,60,60
1650264848435,COGS 101B,A01,091572,Staff,4,0,60,56
1650264854469,COGS 101C,A01,083625,Delgado; Tania,20,0,30,10
1650264860502,COGS 107A,A01,083627,Boyle; Mary E. T.,0,8,60,60
1650264866527,COGS 118A,A01,083075,Staff,13,0,60,47
1650264872560,CSE 3,A50,083646,Miranda; Gregory Joseph,22,0,38,16
1650264872560,CSE 3,A51,083647,Miranda; Gregory Joseph,37,0,37,0
1650264878587,CSE 8A,A50,083650,Miranda; Gregory Joseph,0,20,40,40
1650264884610,CSE 11,A01,083080,Cao; Yingjun,0,71,40,40
1650264890639,CSE 12,A01,083652,Staff,0,10,100,100
1650264896663,CSE 15L,A01,083654,Staff,0,1,50,50
1650264896663,CSE 15L,A02,083655,Staff,4,0,50,46
1650264902690,CSE 20,A01,083657,Staff,53,0,80,27
1650264908725,CSE 30,A01,083084,Eldon; John,0,74,40,40
1650264914763,CSE 100,A01,083659,Cao; Yingjun,0,64,50,50
1650264920786,CSE 134B,A01,083661,Powell; Thomas Allan,0,27,65,65
1650264926822,CSE 140,A01,083663,Staff,0,0,75,75
1650264932859,CSE 140L,A01,083088,Eldon; John,0,5,75,75
1650264938897,CSE 175,A01,083665,Kumar; Rakesh,8,0,25,17
1650264944920,CSE 190,A00,092507,Dubnov; Shlomo,14,0,20,6
1650264950953,ECE 45,A01,083139,Staff,0,14,40,40
1650264956991,ECE 65,A50,083695,Staff,0,5,30,30
1650264963019,ECE 109,A01,091882,Touri; Behrouz,46,0,70,24
1650264969053,ECE 180,A00,083140,Abi Samra; Nicholas Camill,24,0,30,6
1650264969053,ECE 180,B00,083141,Abi Samra; Nicholas Camill,7,0,30,23
1650264975087,MATH 10A,A01,083735,Patchell; Gregory David,11,0,30,19
1650264975087,MATH 10A,A02,083736,Patchell; Gregory David,28,0,30,2
1650264975087,MATH 10A,A03,083737,Patchell; Gregory David,26,0,30,4
1650264981116,MATH 10B,A01,083207,Staff,0,6,30,30
1650264981116,MATH 10B,A02,083208,Staff,0,6,30,30
1650264981116,MATH 10B,B01,083739,Staff,17,0,30,13
1650264981116,MATH 10B,B02,083740,Staff,29,0,30,1
1650264987146,MATH 18,A01,083743,Staff,7,0,30,23
1650264987146,MATH 18,A02,083744,Staff,27,0,30,3
1650264987146,MATH 18,A03,083745,Staff,23,0,30,7
1650264987146,MATH 18,A04,083746,Staff,27,0,30,3
1650264987146,MATH 18,B01,083748,Staff,0,11,30,30
1650264987146,MATH 18,B02,083749,Staff,0,9,30,30
1650264987146,MATH 18,B03,083750,Staff,1,8,30,29
1650264987146,MATH 18,B04,083751,Staff,0,9,30,30
1650264993179,MATH 20A,A01,083754,Staff,26,0,40,14
1650264999230,MATH 20B,A01,083756,Staff,0,5,30,30
1650264999230,MATH 20B,A02,083757,Staff,0,7,30,30
1650265005257,MATH 20C,A01,083760,Staff,0,13,30,30
1650265005257,MATH 20C,A02,083761,Staff,0,13,30,30
1650265005257,MATH 20C,B01,083762,Staff,14,0,30,16
1650265005257,MATH 20C,B02,083763,Staff,28,0,30,2
1650265011284,MATH 20D,A01,083765,Staff,0,1,30,30
1650265011284,MATH 20D,A02,083766,Staff,8,0,30,22
1650265011284,MATH 20D,A03,083767,Staff,28,0,30,2
1650265017312,MATH 20E,A01,083771,Staff,6,0,30,24
1650265017312,MATH 20E,A02,083772,Staff,20,0,30,10
1650265017312,MATH 20E,B01,083773,Staff,0,0,30,30
1650265017312,MATH 20E,B02,083774,Staff,12,0,30,18
1650265023339,MATH 103A,A01,083777,Staff,0,9,30,30
1650265023339,MATH 103A,A02,083778,Staff,0,10,30,30
1650265023339,MATH 103A,B01,083779,Staff,0,10,30,30
1650265023339,MATH 103A,B02,083780,Staff,0,10,30,30
1650265029364,MATH 105,A01,085443,Staff,0,17,30,30
1650265035390,MATH 109,A01,083213,Anzaldo; Leesa B,0,5,30,30
1650265035390,MATH 109,A02,083214,Anzaldo; Leesa B,0,6,30,30
1650265035390,MATH 109,B01,083215,Anzaldo; Leesa B,0,4,30,30
1650265035390,MATH 109,B02,083216,Anzaldo; Leesa B,0,3,30,30
1650265041414,MATH 142A,A01,083219,Chow; Bennett,0,12,30,30
1650265041414,MATH 142A,A02,083220,Chow; Bennett,0,11,30,30
1650265041414,MATH 142A,B01,083221,Chow; Bennett,0,11,30,30
1650265041414,MATH 142A,B02,083222,Chow; Bennett,0,12,30,30
1650265047436,MATH 193A,A01,083224,Staff,0,5,30,30
1650265047436,MATH 193A,A02,083225,Staff,0,4,30,30
1650265047436,MATH 193A,A03,083781,Staff,0,2,30,30
1650265047436,MATH 193A,A04,083782,Staff,0,1,30,30
1650265053458,MATH 197,001,091859,McAuley; Julian John,9998,0,9999,1
1650265059511,COGS 9,A01,083615,Staff,0,14,60,60
1650265065537,COGS 11,A01,083617,Boyle; Mary E. T.,24,0,40,16
1650265071562,COGS 13,A01,083071,Staff,0,31,40,40
1650265077592,COGS 14A,A01,092681,Staff,0,14,100,100
1650265083625,COGS 14B,A01,083073,Cheng; Tzu-Han,0,9,50,50
1650265089649,COGS 17,A01,092677,Staff,30,0,75,45
1650265095677,COGS 100,A01,083619,Staff,0,22,60,60
1650265101699,COGS 101A,A01,083621,Davis; Joshua Daniel,0,21,60,60
1650265107733,COGS 101B,A01,091572,Staff,4,0,60,56
1650265113755,COGS 101C,A01,083625,Delgado; Tania,20,0,30,10
1650265119779,COGS 107A,A01,083627,Boyle; Mary E. T.,0,8,60,60
1650265125805,COGS 118A,A01,083075,Staff,13,0,60,47
1650265131829,CSE 3,A50,083646,Miranda; Gregory Joseph,22,0,38,16
1650265131829,CSE 3,A51,083647,Miranda; Gregory Joseph,37,0,37,0
1650265137853,CSE 8A,A50,083650,Miranda; Gregory Joseph,0,20,40,40
1650265143887,CSE 11,A01,083080,Cao; Yingjun,0,71,40,40
1650265149910,CSE 12,A01,083652,Staff,0,10,100,100
1650265155952,CSE 15L,A01,083654,Staff,0,1,50,50
1650265155952,CSE 15L,A02,083655,Staff,4,0,50,46
1650265161983,CSE 20,A01,083657,Staff,53,0,80,27
1650265168006,CSE 30,A01,083084,Eldon; John,0,74,40,40
1650265174030,CSE 100,A01,083659,Cao; Yingjun,0,64,50,50
1650265180057,CSE 134B,A01,083661,Powell; Thomas Allan,0,27,65,65
1650265186093,CSE 140,A01,083663,Staff,0,0,75,75
1650265192120,CSE 140L,A01,083088,Eldon; John,0,5,75,75
1650265198145,CSE 175,A01,083665,Kumar; Rakesh,8,0,25,17
1650265204175,CSE 190,A00,092507,Dubnov; Shlomo,14,0,20,6
1650265210229,ECE 45,A01,083139,Staff,0,14,40,40
1650265216257,ECE 65,A50,083695,Staff,0,5,30,30
1650265222282,ECE 109,A01,091882,Touri; Behrouz,46,0,70,24
1650265228305,ECE 180,A00,083140,Abi Samra; Nicholas Camill,24,0,30,6
1650265228305,ECE 180,B00,083141,Abi Samra; Nicholas Camill,7,0,30,23
1650265234334,MATH 10A,A01,083735,Patchell; Gregory David,11,0,30,19
1650265234334,MATH 10A,A02,083736,Patchell; Gregory David,28,0,30,2
1650265234334,MATH 10A,A03,083737,Patchell; Gregory David,26,0,30,4
1650265240358,MATH 10B,A01,083207,Staff,0,6,30,30
1650265240358,MATH 10B,A02,083208,Staff,0,6,30,30
1650265240358,MATH 10B,B01,083739,Staff,17,0,30,13
1650265240358,MATH 10B,B02,083740,Staff,29,0,30,1
1650265246389,MATH 18,A01,083743,Staff,7,0,30,23
1650265246389,MATH 18,A02,083744,Staff,27,0,30,3
1650265246389,MATH 18,A03,083745,Staff,23,0,30,7
1650265246389,MATH 18,A04,083746,Staff,27,0,30,3
1650265246389,MATH 18,B01,083748,Staff,0,11,30,30
1650265246389,MATH 18,B02,083749,Staff,0,9,30,30
1650265246389,MATH 18,B03,083750,Staff,1,8,30,29
1650265246389,MATH 18,B04,083751,Staff,0,9,30,30
1650265252416,MATH 20A,A01,083754,Staff,26,0,40,14
1650265258444,MATH 20B,A01,083756,Staff,0,5,30,30
1650265258444,MATH 20B,A02,083757,Staff,0,7,30,30
1650265264468,MATH 20C,A01,083760,Staff,0,13,30,30
1650265264468,MATH 20C,A02,083761,Staff,0,13,30,30
1650265264468,MATH 20C,B01,083762,Staff,14,0,30,16
1650265264468,MATH 20C,B02,083763,Staff,28,0,30,2
1650265270492,MATH 20D,A01,083765,Staff,0,1,30,30
1650265270492,MATH 20D,A02,083766,Staff,8,0,30,22
1650265270492,MATH 20D,A03,083767,Staff,28,0,30,2
1650265276521,MATH 20E,A01,083771,Staff,6,0,30,24
1650265276521,MATH 20E,A02,083772,Staff,20,0,30,10
1650265276521,MATH 20E,B01,083773,Staff,0,0,30,30
1650265276521,MATH 20E,B02,083774,Staff,12,0,30,18
1650265282553,MATH 103A,A01,083777,Staff,0,9,30,30
1650265282553,MATH 103A,A02,083778,Staff,0,10,30,30
1650265282553,MATH 103A,B01,083779,Staff,0,10,30,30
1650265282553,MATH 103A,B02,083780,Staff,0,10,30,30
1650265288580,MATH 105,A01,085443,Staff,0,17,30,30
1650265294620,MATH 109,A01,083213,Anzaldo; Leesa B,0,5,30,30
1650265294620,MATH 109,A02,083214,Anzaldo; Leesa B,0,6,30,30
1650265294620,MATH 109,B01,083215,Anzaldo; Leesa B,0,4,30,30
1650265294620,MATH 109,B02,083216,Anzaldo; Leesa B,0,3,30,30
1650265300643,MATH 142A,A01,083219,Chow; Bennett,0,12,30,30
1650265300643,MATH 142A,A02,083220,Chow; Bennett,0,11,30,30
1650265300643,MATH 142A,B01,083221,Chow; Bennett,0,11,30,30
1650265300643,MATH 142A,B02,083222,Chow; Bennett,0,12,30,30
1650265306670,MATH 193A,A01,083224,Staff,0,5,30,30
1650265306670,MATH 193A,A02,083225,Staff,0,4,30,30
1650265306670,MATH 193A,A03,083781,Staff,0,2,30,30
1650265306670,MATH 193A,A04,083782,Staff,0,1,30,30
1650265312694,MATH 197,001,091859,McAuley; Julian John,9998,0,9999,1
1650265318775,COGS 9,A01,083615,Staff,0,14,60,60
1650265324798,COGS 11,A01,083617,Boyle; Mary E. T.,24,0,40,16
1650265330824,COGS 13,A01,083071,Staff,0,31,40,40
1650265336925,COGS 14A,A01,092681,Staff,0,14,100,100
1650265342955,COGS 14B,A01,083073,Cheng; Tzu-Han,0,10,50,50
1650265348981,COGS 17,A01,092677,Staff,30,0,75,45
1650265355013,COGS 100,A01,083619,Staff,0,22,60,60
1650265361042,COGS 101A,A01,083621,Davis; Joshua Daniel,0,21,60,60
1650265367065,COGS 101B,A01,091572,Staff,4,0,60,56
1650265373089,COGS 101C,A01,083625,Delgado; Tania,19,0,30,11
1650265379113,COGS 107A,A01,083627,Boyle; Mary E. T.,0,8,60,60
1650265385142,COGS 118A,A01,083075,Staff,13,0,60,47
1650265391171,CSE 3,A50,083646,Miranda; Gregory Joseph,22,0,38,16
1650265391171,CSE 3,A51,083647,Miranda; Gregory Joseph,37,0,37,0
1650265397199,CSE 8A,A50,083650,Miranda; Gregory Joseph,0,20,40,40
1650265403221,CSE 11,A01,083080,Cao; Yingjun,0,71,40,40
1650265409244,CSE 12,A01,083652,Staff,0,10,100,100
1650265415271,CSE 15L,A01,083654,Staff,0,1,50,50
1650265415271,CSE 15L,A02,083655,Staff,4,0,50,46
1650265421295,CSE 20,A01,083657,Staff,53,0,80,27
1650265427322,CSE 30,A01,083084,Eldon; John,0,74,40,40
1650265433351,CSE 100,A01,083659,Cao; Yingjun,0,64,50,50
1650265439388,CSE 134B,A01,083661,Powell; Thomas Allan,0,27,65,65
1650265445423,CSE 140,A01,083663,Staff,0,0,75,75
1650265451449,CSE 140L,A01,083088,Eldon; John,0,5,75,75
1650265457484,CSE 175,A01,083665,Kumar; Rakesh,8,0,25,17
1650265463508,CSE 190,A00,092507,Dubnov; Shlomo,14,0,20,6
1650265469530,ECE 45,A01,083139,Staff,0,14,40,40
1650265475557,ECE 65,A50,083695,Staff,0,5,30,30
1650265481585,ECE 109,A01,091882,Touri; Behrouz,46,0,70,24
1650265487607,ECE 180,A00,083140,Abi Samra; Nicholas Camill,24,0,30,6
1650265487607,ECE 180,B00,083141,Abi Samra; Nicholas Camill,7,0,30,23
1650265493636,MATH 10A,A01,083735,Patchell; Gregory David,11,0,30,19
1650265493636,MATH 10A,A02,083736,Patchell; Gregory David,28,0,30,2
1650265493636,MATH 10A,A03,083737,Patchell; Gregory David,26,0,30,4
1650265499661,MATH 10B,A01,083207,Staff,0,6,30,30
1650265499661,MATH 10B,A02,083208,Staff,0,6,30,30
1650265499661,MATH 10B,B01,083739,Staff,17,0,30,13
1650265499661,MATH 10B,B02,083740,Staff,29,0,30,1
1650265505690,MATH 18,A01,083743,Staff,7,0,30,23
1650265505690,MATH 18,A02,083744,Staff,27,0,30,3
1650265505690,MATH 18,A03,083745,Staff,23,0,30,7
1650265505690,MATH 18,A04,083746,Staff,27,0,30,3
1650265505690,MATH 18,B01,083748,Staff,0,11,30,30
1650265505690,MATH 18,B02,083749,Staff,0,9,30,30
1650265505690,MATH 18,B03,083750,Staff,1,8,30,29
1650265505690,MATH 18,B04,083751,Staff,0,9,30,30
1650265511727,MATH 20A,A01,083754,Staff,26,0,40,14
1650265517756,MATH 20B,A01,083756,Staff,0,5,30,30
1650265517756,MATH 20B,A02,083757,Staff,0,7,30,30
1650265523791,MATH 20C,A01,083760,Staff,0,13,30,30
1650265523791,MATH 20C,A02,083761,Staff,0,13,30,30
1650265523791,MATH 20C,B01,083762,Staff,14,0,30,16
1650265523791,MATH 20C,B02,083763,Staff,28,0,30,2
1650265529814,MATH 20D,A01,083765,Staff,0,1,30,30
1650265529814,MATH 20D,A02,083766,Staff,8,0,30,22
1650265529814,MATH 20D,A03,083767,Staff,28,0,30,2
1650265535844,MATH 20E,A01,083771,Staff,6,0,30,24
1650265535844,MATH 20E,A02,083772,Staff,20,0,30,10
1650265535844,MATH 20E,B01,083773,Staff,0,0,30,30
1650265535844,MATH 20E,B02,083774,Staff,11,0,30,19
1650265541869,MATH 103A,A01,083777,Staff,0,9,30,30
1650265541869,MATH 103A,A02,083778,Staff,0,10,30,30
1650265541869,MATH 103A,B01,083779,Staff,0,10,30,30
1650265541869,MATH 103A,B02,083780,Staff,0,10,30,30
1650265547892,MATH 105,A01,085443,Staff,0,17,30,30
1650265553922,MATH 109,A01,083213,Anzaldo; Leesa B,0,5,30,30
1650265553922,MATH 109,A02,083214,Anzaldo; Leesa B,0,6,30,30
1650265553922,MATH 109,B01,083215,Anzaldo; Leesa B,0,4,30,30
1650265553922,MATH 109,B02,083216,Anzaldo; Leesa B,0,3,30,30
1650265559948,MATH 142A,A01,083219,Chow; Bennett,0,12,30,30
1650265559948,MATH 142A,A02,083220,Chow; Bennett,0,11,30,30
1650265559948,MATH 142A,B01,083221,Chow; Bennett,0,11,30,30
1650265559948,MATH 142A,B02,083222,Chow; Bennett,0,12,30,30
1650265565980,MATH 193A,A01,083224,Staff,0,5,30,30
1650265565980,MATH 193A,A02,083225,Staff,0,4,30,30
1650265565980,MATH 193A,A03,083781,Staff,0,2,30,30
1650265565980,MATH 193A,A04,083782,Staff,0,1,30,30
1650265572006,MATH 197,001,091859,McAuley; Julian John,9998,0,9999,1
1650265578068,COGS 9,A01,083615,Staff,0,14,60,60
1650265584094,COGS 11,A01,083617,Boyle; Mary E. T.,24,0,40,16
1650265590121,COGS 13,A01,083071,Staff,0,31,40,40
1650265596144,COGS 14A,A01,092681,Staff,0,14,100,100
1650265602172,COGS 14B,A01,083073,Cheng; Tzu-Han,0,9,50,50
1650265608198,COGS 17,A01,092677,Staff,30,0,75,45
1650265614225,COGS 100,A01,083619,Staff,0,22,60,60
1650265620253,COGS 101A,A01,083621,Davis; Joshua Daniel,0,21,60,60
1650265626288,COGS 101B,A01,091572,Staff,4,0,60,56
1650265632312,COGS 101C,A01,083625,Delgado; Tania,19,0,30,11
1650265638337,COGS 107A,A01,083627,Boyle; Mary E. T.,0,8,60,60
1650265644368,COGS 118A,A01,083075,Staff,13,0,60,47
1650265650393,CSE 3,A50,083646,Miranda; Gregory Joseph,22,0,38,16
1650265650393,CSE 3,A51,083647,Miranda; Gregory Joseph,37,0,37,0
1650265656422,CSE 8A,A50,083650,Miranda; Gregory Joseph,0,21,40,40
1650265662452,CSE 11,A01,083080,Cao; Yingjun,0,71,40,40
1650265668487,CSE 12,A01,083652,Staff,0,10,100,100
1650265674511,CSE 15L,A01,083654,Staff,0,1,50,50
1650265674511,CSE 15L,A02,083655,Staff,4,0,50,46
1650265680536,CSE 20,A01,083657,Staff,53,0,80,27
1650265686564,CSE 30,A01,083084,Eldon; John,0,74,40,40
1650265692590,CSE 100,A01,083659,Cao; Yingjun,0,64,50,50
1650265698621,CSE 134B,A01,083661,Powell; Thomas Allan,0,27,65,65
1650265704671,CSE 140,A01,083663,Staff,0,0,75,75
1650265710703,CSE 140L,A01,083088,Eldon; John,0,5,75,75
1650265716729,CSE 175,A01,083665,Kumar; Rakesh,8,0,25,17
1650265722754,CSE 190,A00,092507,Dubnov; Shlomo,14,0,20,6
1650265728792,ECE 45,A01,083139,Staff,0,14,40,40
1650265734816,ECE 65,A50,083695,Staff,0,5,30,30
1650265740844,ECE 109,A01,091882,Touri; Behrouz,46,0,70,24
1650265746869,ECE 180,A00,083140,Abi Samra; Nicholas Camill,24,0,30,6
1650265746869,ECE 180,B00,083141,Abi Samra; Nicholas Camill,7,0,30,23
1650265752900,MATH 10A,A01,083735,Patchell; Gregory David,11,0,30,19
1650265752900,MATH 10A,A02,083736,Patchell; Gregory David,28,0,30,2
1650265752900,MATH 10A,A03,083737,Patchell; Gregory David,26,0,30,4
1650265758928,MATH 10B,A01,083207,Staff,0,6,30,30
1650265758928,MATH 10B,A02,083208,Staff,0,6,30,30
1650265758928,MATH 10B,B01,083739,Staff,17,0,30,13
1650265758928,MATH 10B,B02,083740,Staff,29,0,30,1
1650265764959,MATH 18,A01,083743,Staff,7,0,30,23
1650265764959,MATH 18,A02,083744,Staff,27,0,30,3
1650265764959,MATH 18,A03,083745,Staff,23,0,30,7
1650265764959,MATH 18,A04,083746,Staff,27,0,30,3
1650265764959,MATH 18,B01,083748,Staff,0,11,30,30
1650265764959,MATH 18,B02,083749,Staff,0,9,30,30
1650265764959,MATH 18,B03,083750,Staff,1,8,30,29
1650265764959,MATH 18,B04,083751,Staff,0,9,30,30
1650265770985,MATH 20A,A01,083754,Staff,26,0,40,14
1650265777008,MATH 20B,A01,083756,Staff,0,5,30,30
1650265777008,MATH 20B,A02,083757,Staff,0,7,30,30
1650265783035,MATH 20C,A01,083760,Staff,0,13,30,30
1650265783035,MATH 20C,A02,083761,Staff,0,13,30,30
1650265783035,MATH 20C,B01,083762,Staff,14,0,30,16
1650265783035,MATH 20C,B02,083763,Staff,28,0,30,2
1650265789063,MATH 20D,A01,083765,Staff,0,1,30,30
1650265789063,MATH 20D,A02,083766,Staff,8,0,30,22
1650265789063,MATH 20D,A03,083767,Staff,28,0,30,2
1650265795093,MATH 20E,A01,083771,Staff,6,0,30,24
1650265795093,MATH 20E,A02,083772,Staff,20,0,30,10
1650265795093,MATH 20E,B01,083773,Staff,0,0,30,30
1650265795093,MATH 20E,B02,083774,Staff,11,0,30,19
1650265801117,MATH 103A,A01,083777,Staff,0,9,30,30
1650265801117,MATH 103A,A02,083778,Staff,0,10,30,30
1650265801117,MATH 103A,B01,083779,Staff,0,10,30,30
1650265801117,MATH 103A,B02,083780,Staff,0,10,30,30
1650265807141,MATH 105,A01,085443,Staff,0,17,30,30
1650265813171,MATH 109,A01,083213,Anzaldo; Leesa B,0,5,30,30
1650265813171,MATH 109,A02,083214,Anzaldo; Leesa B,0,6,30,30
1650265813171,MATH 109,B01,083215,Anzaldo; Leesa B,0,4,30,30
1650265813171,MATH 109,B02,083216,Anzaldo; Leesa B,0,3,30,30
1650265819198,MATH 142A,A01,083219,Chow; Bennett,0,12,30,30
1650265819198,MATH 142A,A02,083220,Chow; Bennett,0,11,30,30
1650265819198,MATH 142A,B01,083221,Chow; Bennett,0,11,30,30
1650265819198,MATH 142A,B02,083222,Chow; Bennett,0,12,30,30
1650265825221,MATH 193A,A01,083224,Staff,0,5,30,30
1650265825221,MATH 193A,A02,083225,Staff,0,4,30,30
1650265825221,MATH 193A,A03,083781,Staff,0,2,30,30
1650265825221,MATH 193A,A04,083782,Staff,0,1,30,30
1650265831248,MATH 197,001,091859,McAuley; Julian John,9998,0,9999,1
1650265837336,COGS 9,A01,083615,Staff,0,14,60,60
1650265843362,COGS 11,A01,083617,Boyle; Mary E. T.,24,0,40,16
1650265849387,COGS 13,A01,083071,Staff,0,31,40,40
1650265855413,COGS 14A,A01,092681,Staff,0,14,100,100
1650265861446,COGS 14B,A01,083073,Cheng; Tzu-Han,0,9,50,50
1650265867475,COGS 17,A01,092677,Staff,30,0,75,45
1650265873513,COGS 100,A01,083619,Staff,0,22,60,60
1650265879540,COGS 101A,A01,083621,Davis; Joshua Daniel,0,21,60,60
1650265885565,COGS 101B,A01,091572,Staff,4,0,60,56
1650265891613,COGS 101C,A01,083625,Delgado; Tania,19,0,30,11
1650265897657,COGS 107A,A01,083627,Boyle; Mary E. T.,0,8,60,60
1650265903694,COGS 118A,A01,083075,Staff,13,0,60,47
1650265909720,CSE 3,A50,083646,Miranda; Gregory Joseph,22,0,38,16
1650265909720,CSE 3,A51,083647,Miranda; Gregory Joseph,37,0,37,0
1650265915746,CSE 8A,A50,083650,Miranda; Gregory Joseph,0,21,40,40
1650265921776,CSE 11,A01,083080,Cao; Yingjun,0,72,40,40
1650265927802,CSE 12,A01,083652,Staff,0,10,100,100
1650265933920,CSE 15L,A01,083654,Staff,0,1,50,50
1650265933920,CSE 15L,A02,083655,Staff,4,0,50,46
1650265939946,CSE 20,A01,083657,Staff,53,0,80,27
1650265945975,CSE 30,A01,083084,Eldon; John,0,74,40,40
1650265952003,CSE 100,A01,083659,Cao; Yingjun,0,64,50,50
1650265958026,CSE 134B,A01,083661,Powell; Thomas Allan,0,27,65,65
1650265964050,CSE 140,A01,083663,Staff,0,0,75,75
1650265970074,CSE 140L,A01,083088,Eldon; John,0,5,75,75
1650265976102,CSE 175,A01,083665,Kumar; Rakesh,8,0,25,17
1650265982129,CSE 190,A00,092507,Dubnov; Shlomo,14,0,20,6
1650265988157,ECE 45,A01,083139,Staff,0,14,40,40
1650265994184,ECE 65,A50,083695,Staff,0,5,30,30
1650266000212,ECE 109,A01,091882,Touri; Behrouz,46,0,70,24
1650266006240,ECE 180,A00,083140,Abi Samra; Nicholas Camill,24,0,30,6
1650266006240,ECE 180,B00,083141,Abi Samra; Nicholas Camill,7,0,30,23
1650266012269,MATH 10A,A01,083735,Patchell; Gregory David,11,0,30,19
1650266012269,MATH 10A,A02,083736,Patchell; Gregory David,28,0,30,2
1650266012269,MATH 10A,A03,083737,Patchell; Gregory David,26,0,30,4
1650266018297,MATH 10B,A01,083207,Staff,0,6,30,30
1650266018297,MATH 10B,A02,083208,Staff,0,6,30,30
1650266018297,MATH 10B,B01,083739,Staff,17,0,30,13
1650266018297,MATH 10B,B02,083740,Staff,29,0,30,1
1650266024324,MATH 18,A01,083743,Staff,7,0,30,23
1650266024324,MATH 18,A02,083744,Staff,27,0,30,3
1650266024324,MATH 18,A03,083745,Staff,23,0,30,7
1650266024324,MATH 18,A04,083746,Staff,27,0,30,3
1650266024324,MATH 18,B01,083748,Staff,0,11,30,30
1650266024324,MATH 18,B02,083749,Staff,0,9,30,30
1650266024324,MATH 18,B03,083750,Staff,1,8,30,29
1650266024324,MATH 18,B04,083751,Staff,0,9,30,30
1650266030355,MATH 20A,A01,083754,Staff,26,0,40,14
1650266036385,MATH 20B,A01,083756,Staff,0,5,30,30
1650266036385,MATH 20B,A02,083757,Staff,0,7,30,30
1650266042411,MATH 20C,A01,083760,Staff,0,13,30,30
1650266042411,MATH 20C,A02,083761,Staff,0,13,30,30
1650266042411,MATH 20C,B01,083762,Staff,14,0,30,16
1650266042411,MATH 20C,B02,083763,Staff,28,0,30,2
1650266048442,MATH 20D,A01,083765,Staff,0,1,30,30
1650266048442,MATH 20D,A02,083766,Staff,8,0,30,22
1650266048442,MATH 20D,A03,083767,Staff,28,0,30,2
1650266054472,MATH 20E,A01,083771,Staff,6,0,30,24
1650266054472,MATH 20E,A02,083772,Staff,20,0,30,10
1650266054472,MATH 20E,B01,083773,Staff,0,0,30,30
1650266054472,MATH 20E,B02,083774,Staff,11,0,30,19
1650266060501,MATH 103A,A01,083777,Staff,0,9,30,30
1650266060501,MATH 103A,A02,083778,Staff,0,10,30,30
1650266060501,MATH 103A,B01,083779,Staff,0,10,30,30
1650266060501,MATH 103A,B02,083780,Staff,0,10,30,30
1650266066531,MATH 105,A01,085443,Staff,0,17,30,30
1650266072561,MATH 109,A01,083213,Anzaldo; Leesa B,0,5,30,30
1650266072561,MATH 109,A02,083214,Anzaldo; Leesa B,0,6,30,30
1650266072561,MATH 109,B01,083215,Anzaldo; Leesa B,0,4,30,30
1650266072561,MATH 109,B02,083216,Anzaldo; Leesa B,0,3,30,30
1650266078590,MATH 142A,A01,083219,Chow; Bennett,0,12,30,30
1650266078590,MATH 142A,A02,083220,Chow; Bennett,0,11,30,30
1650266078590,MATH 142A,B01,083221,Chow; Bennett,0,11,30,30
1650266078590,MATH 142A,B02,083222,Chow; Bennett,0,12,30,30
1650266084617,MATH 193A,A01,083224,Staff,0,5,30,30
1650266084617,MATH 193A,A02,083225,Staff,0,4,30,30
1650266084617,MATH 193A,A03,083781,Staff,0,2,30,30
1650266084617,MATH 193A,A04,083782,Staff,0,1,30,30
1650266090643,MATH 197,001,091859,McAuley; Julian John,9998,0,9999,1
1650266096700,COGS 9,A01,083615,Staff,0,14,60,60
1650266102728,COGS 11,A01,083617,Boyle; Mary E. T.,24,0,40,16
1650266108752,COGS 13,A01,083071,Staff,0,31,40,40
1650266114776,COGS 14A,A01,092681,Staff,0,14,100,100
1650266120803,COGS 14B,A01,083073,Cheng; Tzu-Han,0,9,50,50
1650266126831,COGS 17,A01,092677,Staff,30,0,75,45
1650266132858,COGS 100,A01,083619,Staff,0,22,60,60
1650266138881,COGS 101A,A01,083621,Davis; Joshua Daniel,0,21,60,60
1650266144908,COGS 101B,A01,091572,Staff,4,0,60,56
1650266150936,COGS 101C,A01,083625,Delgado; Tania,19,0,30,11
1650266156963,COGS 107A,A01,083627,Boyle; Mary E. T.,0,8,60,60
1650266162991,COGS 118A,A01,083075,Staff,13,0,60,47
1650266169013,CSE 3,A50,083646,Miranda; Gregory Joseph,22,0,38,16
1650266169013,CSE 3,A51,083647,Miranda; Gregory Joseph,37,0,37,0
1650266175039,CSE 8A,A50,083650,Miranda; Gregory Joseph,0,21,40,40
1650266181065,CSE 11,A01,083080,Cao; Yingjun,0,73,40,40
1650266187089,CSE 12,A01,083652,Staff,0,10,100,100
1650266193116,CSE 15L,A01,083654,Staff,0,1,50,50
1650266193116,CSE 15L,A02,083655,Staff,4,0,50,46
1650266199143,CSE 20,A01,083657,Staff,53,0,80,27
1650266205167,CSE 30,A01,083084,Eldon; John,0,74,40,40
1650266211199,CSE 100,A01,083659,Cao; Yingjun,0,64,50,50
1650266217223,CSE 134B,A01,083661,Powell; Thomas Allan,0,27,65,65
1650266223250,CSE 140,A01,083663,Staff,0,0,75,75
1650266229278,CSE 140L,A01,083088,Eldon; John,0,5,75,75
1650266235303,CSE 175,A01,083665,Kumar; Rakesh,8,0,25,17
1650266241331,CSE 190,A00,092507,Dubnov; Shlomo,14,0,20,6
1650266247355,ECE 45,A01,083139,Staff,0,14,40,40
1650266253382,ECE 65,A50,083695,Staff,0,5,30,30
1650266259409,ECE 109,A01,091882,Touri; Behrouz,46,0,70,24
1650266265433,ECE 180,A00,083140,Abi Samra; Nicholas Camill,24,0,30,6
1650266265433,ECE 180,B00,083141,Abi Samra; Nicholas Camill,7,0,30,23
1650266271458,MATH 10A,A01,083735,Patchell; Gregory David,11,0,30,19
1650266271458,MATH 10A,A02,083736,Patchell; Gregory David,28,0,30,2
1650266271458,MATH 10A,A03,083737,Patchell; Gregory David,26,0,30,4
1650266277486,MATH 10B,A01,083207,Staff,0,6,30,30
1650266277486,MATH 10B,A02,083208,Staff,0,6,30,30
1650266277486,MATH 10B,B01,083739,Staff,17,0,30,13
1650266277486,MATH 10B,B02,083740,Staff,29,0,30,1
1650266283511,MATH 18,A01,083743,Staff,7,0,30,23
1650266283511,MATH 18,A02,083744,Staff,27,0,30,3
1650266283511,MATH 18,A03,083745,Staff,23,0,30,7
1650266283511,MATH 18,A04,083746,Staff,27,0,30,3
1650266283511,MATH 18,B01,083748,Staff,0,11,30,30
1650266283511,MATH 18,B02,083749,Staff,0,9,30,30
1650266283511,MATH 18,B03,083750,Staff,1,8,30,29
1650266283511,MATH 18,B04,083751,Staff,0,9,30,30
1650266289536,MATH 20A,A01,083754,Staff,26,0,40,14
1650266295562,MATH 20B,A01,083756,Staff,0,5,30,30
1650266295562,MATH 20B,A02,083757,Staff,0,7,30,30
1650266301588,MATH 20C,A01,083760,Staff,0,13,30,30
1650266301588,MATH 20C,A02,083761,Staff,0,13,30,30
1650266301588,MATH 20C,B01,083762,Staff,14,0,30,16
1650266301588,MATH 20C,B02,083763,Staff,28,0,30,2
1650266307614,MATH 20D,A01,083765,Staff,0,1,30,30
1650266307614,MATH 20D,A02,083766,Staff,8,0,30,22
1650266307614,MATH 20D,A03,083767,Staff,28,0,30,2
1650266313638,MATH 20E,A01,083771,Staff,6,0,30,24
1650266313638,MATH 20E,A02,083772,Staff,20,0,30,10
1650266313638,MATH 20E,B01,083773,Staff,0,0,30,30
1650266313638,MATH 20E,B02,083774,Staff,11,0,30,19
1650266319660,MATH 103A,A01,083777,Staff,0,9,30,30
1650266319660,MATH 103A,A02,083778,Staff,0,10,30,30
1650266319660,MATH 103A,B01,083779,Staff,0,10,30,30
1650266319660,MATH 103A,B02,083780,Staff,0,10,30,30
1650266325686,MATH 105,A01,085443,Staff,0,17,30,30
1650266331711,MATH 109,A01,083213,Anzaldo; Leesa B,0,5,30,30
1650266331711,MATH 109,A02,083214,Anzaldo; Leesa B,0,6,30,30
1650266331711,MATH 109,B01,083215,Anzaldo; Leesa B,0,4,30,30
1650266331711,MATH 109,B02,083216,Anzaldo; Leesa B,0,3,30,30
1650266337740,MATH 142A,A01,083219,Chow; Bennett,0,12,30,30
1650266337740,MATH 142A,A02,083220,Chow; Bennett,0,11,30,30
1650266337740,MATH 142A,B01,083221,Chow; Bennett,0,11,30,30
1650266337740,MATH 142A,B02,083222,Chow; Bennett,0,12,30,30
1650266343768,MATH 193A,A01,083224,Staff,0,5,30,30
1650266343768,MATH 193A,A02,083225,Staff,0,4,30,30
1650266343768,MATH 193A,A03,083781,Staff,0,2,30,30
1650266343768,MATH 193A,A04,083782,Staff,0,1,30,30
1650266349792,MATH 197,001,091859,McAuley; Julian John,9998,0,9999,1
1650266355859,COGS 9,A01,083615,Staff,0,14,60,60
1650266361887,COGS 11,A01,083617,Boyle; Mary E. T.,24,0,40,16
1650266367917,COGS 13,A01,083071,Staff,0,31,40,40
1650266373948,COGS 14A,A01,092681,Staff,0,14,100,100
1650266379975,COGS 14B,A01,083073,Cheng; Tzu-Han,0,9,50,50
1650266385998,COGS 17,A01,092677,Staff,30,0,75,45
1650266392024,COGS 100,A01,083619,Staff,0,22,60,60
1650266398049,COGS 101A,A01,083621,Davis; Joshua Daniel,0,21,60,60
1650266404076,COGS 101B,A01,091572,Staff,4,0,60,56
1650266410102,COGS 101C,A01,083625,Delgado; Tania,19,0,30,11
1650266416139,COGS 107A,A01,083627,Boyle; Mary E. T.,0,8,60,60
1650266422163,COGS 118A,A01,083075,Staff,13,0,60,47
1650266428186,CSE 3,A50,083646,Miranda; Gregory Joseph,22,0,38,16
1650266428186,CSE 3,A51,083647,Miranda; Gregory Joseph,37,0,37,0
1650266434217,CSE 8A,A50,083650,Miranda; Gregory Joseph,0,21,40,40
1650266440246,CSE 11,A01,083080,Cao; Yingjun,0,73,40,40
1650266446273,CSE 12,A01,083652,Staff,0,10,100,100
1650266452298,CSE 15L,A01,083654,Staff,0,1,50,50
1650266452298,CSE 15L,A02,083655,Staff,4,0,50,46
1650266458325,CSE 20,A01,083657,Staff,53,0,80,27
1650266464351,CSE 30,A01,083084,Eldon; John,0,74,40,40
1650266470378,CSE 100,A01,083659,Cao; Yingjun,0,64,50,50
1650266476405,CSE 134B,A01,083661,Powell; Thomas Allan,0,27,65,65
1650266482432,CSE 140,A01,083663,Staff,0,0,75,75
1650266488459,CSE 140L,A01,083088,Eldon; John,0,5,75,75
1650266494484,CSE 175,A01,083665,Kumar; Rakesh,8,0,25,17
1650266500510,CSE 190,A00,092507,Dubnov; Shlomo,14,0,20,6
1650266506539,ECE 45,A01,083139,Staff,0,14,40,40
1650266512566,ECE 65,A50,083695,Staff,0,5,30,30
1650266518595,ECE 109,A01,091882,Touri; Behrouz,46,0,70,24
1650266524634,ECE 180,A00,083140,Abi Samra; Nicholas Camill,24,0,30,6
1650266524634,ECE 180,B00,083141,Abi Samra; Nicholas Camill,7,0,30,23
1650266530751,MATH 10A,A01,083735,Patchell; Gregory David,11,0,30,19
1650266530751,MATH 10A,A02,083736,Patchell; Gregory David,28,0,30,2
1650266530751,MATH 10A,A03,083737,Patchell; Gregory David,26,0,30,4
1650266536779,MATH 10B,A01,083207,Staff,0,6,30,30
1650266536779,MATH 10B,A02,083208,Staff,0,6,30,30
1650266536779,MATH 10B,B01,083739,Staff,17,0,30,13
1650266536779,MATH 10B,B02,083740,Staff,29,0,30,1
1650266542810,MATH 18,A01,083743,Staff,7,0,30,23
1650266542810,MATH 18,A02,083744,Staff,27,0,30,3
1650266542810,MATH 18,A03,083745,Staff,23,0,30,7
1650266542810,MATH 18,A04,083746,Staff,27,0,30,3
1650266542810,MATH 18,B01,083748,Staff,0,11,30,30
1650266542810,MATH 18,B02,083749,Staff,0,9,30,30
1650266542810,MATH 18,B03,083750,Staff,1,8,30,29
1650266542810,MATH 18,B04,083751,Staff,0,9,30,30
1650266548849,MATH 20A,A01,083754,Staff,26,0,40,14
1650266554881,MATH 20B,A01,083756,Staff,0,5,30,30
1650266554881,MATH 20B,A02,083757,Staff,0,7,30,30
1650266560906,MATH 20C,A01,083760,Staff,0,13,30,30
1650266560906,MATH 20C,A02,083761,Staff,0,13,30,30
1650266560906,MATH 20C,B01,083762,Staff,14,0,30,16
1650266560906,MATH 20C,B02,083763,Staff,28,0,30,2
1650266566930,MATH 20D,A01,083765,Staff,0,1,30,30
1650266566930,MATH 20D,A02,083766,Staff,8,0,30,22
1650266566930,MATH 20D,A03,083767,Staff,28,0,30,2
1650266572955,MATH 20E,A01,083771,Staff,6,0,30,24
1650266572955,MATH 20E,A02,083772,Staff,20,0,30,10
1650266572955,MATH 20E,B01,083773,Staff,0,0,30,30
1650266572955,MATH 20E,B02,083774,Staff,11,0,30,19
1650266578984,MATH 103A,A01,083777,Staff,0,9,30,30
1650266578984,MATH 103A,A02,083778,Staff,0,10,30,30
1650266578984,MATH 103A,B01,083779,Staff,0,10,30,30
1650266578984,MATH 103A,B02,083780,Staff,0,10,30,30
1650266585016,MATH 105,A01,085443,Staff,0,17,30,30
1650266591041,MATH 109,A01,083213,Anzaldo; Leesa B,0,5,30,30
1650266591041,MATH 109,A02,083214,Anzaldo; Leesa B,0,6,30,30
1650266591041,MATH 109,B01,083215,Anzaldo; Leesa B,0,4,30,30
1650266591041,MATH 109,B02,083216,Anzaldo; Leesa B,0,3,30,30
1650266597065,MATH 142A,A01,083219,Chow; Bennett,0,12,30,30
1650266597065,MATH 142A,A02,083220,Chow; Bennett,0,11,30,30
1650266597065,MATH 142A,B01,083221,Chow; Bennett,0,11,30,30
1650266597065,MATH 142A,B02,083222,Chow; Bennett,0,12,30,30
1650266603092,MATH 193A,A01,083224,Staff,0,5,30,30
1650266603092,MATH 193A,A02,083225,Staff,0,4,30,30
1650266603092,MATH 193A,A03,083781,Staff,0,2,30,30
1650266603092,MATH 193A,A04,083782,Staff,0,1,30,30
1650266609119,MATH 197,001,091859,McAuley; Julian John,9998,0,9999,1
1650266615183,COGS 9,A01,083615,Staff,0,14,60,60
1650266621207,COGS 11,A01,083617,Boyle; Mary E. T.,24,0,40,16
1650266627230,COGS 13,A01,083071,Staff,0,31,40,40
1650266633259,COGS 14A,A01,092681,Staff,0,14,100,100
1650266639282,COGS 14B,A01,083073,Cheng; Tzu-Han,0,9,50,50
1650266645310,COGS 17,A01,092677,Staff,30,0,75,45
1650266651337,COGS 100,A01,083619,Staff,0,22,60,60
1650266657372,COGS 101A,A01,083621,Davis; Joshua Daniel,0,21,60,60
1650266663400,COGS 101B,A01,091572,Staff,4,0,60,56
1650266669423,COGS 101C,A01,083625,Delgado; Tania,19,0,30,11
1650266675453,COGS 107A,A01,083627,Boyle; Mary E. T.,0,8,60,60
1650266681485,COGS 118A,A01,083075,Staff,13,0,60,47
1650266687510,CSE 3,A50,083646,Miranda; Gregory Joseph,22,0,38,16
1650266687510,CSE 3,A51,083647,Miranda; Gregory Joseph,37,0,37,0
1650266693532,CSE 8A,A50,083650,Miranda; Gregory Joseph,0,21,40,40
1650266699555,CSE 11,A01,083080,Cao; Yingjun,0,73,40,40
1650266705582,CSE 12,A01,083652,Staff,0,10,100,100
1650266711608,CSE 15L,A01,083654,Staff,0,1,50,50
1650266711608,CSE 15L,A02,083655,Staff,4,0,50,46
1650266717643,CSE 20,A01,083657,Staff,53,0,80,27
1650266723668,CSE 30,A01,083084,Eldon; John,0,74,40,40
1650266729696,CSE 100,A01,083659,Cao; Yingjun,0,64,50,50
1650266735721,CSE 134B,A01,083661,Powell; Thomas Allan,0,27,65,65
1650266741748,CSE 140,A01,083663,Staff,0,0,75,75
1650266747772,CSE 140L,A01,083088,Eldon; John,0,5,75,75
1650266753796,CSE 175,A01,083665,Kumar; Rakesh,8,0,25,17
1650266759818,CSE 190,A00,092507,Dubnov; Shlomo,14,0,20,6
1650266765841,ECE 45,A01,083139,Staff,0,14,40,40
1650266771865,ECE 65,A50,083695,Staff,0,5,30,30
1650266777888,ECE 109,A01,091882,Touri; Behrouz,46,0,70,24
1650266783916,ECE 180,A00,083140,Abi Samra; Nicholas Camill,24,0,30,6
1650266783916,ECE 180,B00,083141,Abi Samra; Nicholas Camill,7,0,30,23
1650266789941,MATH 10A,A01,083735,Patchell; Gregory David,11,0,30,19
1650266789941,MATH 10A,A02,083736,Patchell; Gregory David,28,0,30,2
1650266789941,MATH 10A,A03,083737,Patchell; Gregory David,26,0,30,4
1650266795977,MATH 10B,A01,083207,Staff,0,6,30,30
1650266795977,MATH 10B,A02,083208,Staff,0,6,30,30
1650266795977,MATH 10B,B01,083739,Staff,17,0,30,13
1650266795977,MATH 10B,B02,083740,Staff,29,0,30,1
1650266802002,MATH 18,A01,083743,Staff,7,0,30,23
1650266802002,MATH 18,A02,083744,Staff,27,0,30,3
1650266802002,MATH 18,A03,083745,Staff,23,0,30,7
1650266802002,MATH 18,A04,083746,Staff,27,0,30,3
1650266802002,MATH 18,B01,083748,Staff,0,11,30,30
1650266802002,MATH 18,B02,083749,Staff,0,9,30,30
1650266802002,MATH 18,B03,083750,Staff,1,8,30,29
1650266802002,MATH 18,B04,083751,Staff,0,9,30,30
1650266808029,MATH 20A,A01,083754,Staff,26,0,40,14
1650266814055,MATH 20B,A01,083756,Staff,0,5,30,30
1650266814055,MATH 20B,A02,083757,Staff,0,7,30,30
1650266820095,MATH 20C,A01,083760,Staff,0,13,30,30
1650266820095,MATH 20C,A02,083761,Staff,0,13,30,30
1650266820095,MATH 20C,B01,083762,Staff,14,0,30,16
1650266820095,MATH 20C,B02,083763,Staff,28,0,30,2
1650266826121,MATH 20D,A01,083765,Staff,0,1,30,30
1650266826121,MATH 20D,A02,083766,Staff,8,0,30,22
1650266826121,MATH 20D,A03,083767,Staff,28,0,30,2
1650266832146,MATH 20E,A01,083771,Staff,6,0,30,24
1650266832146,MATH 20E,A02,083772,Staff,20,0,30,10
1650266832146,MATH 20E,B01,083773,Staff,0,0,30,30
1650266832146,MATH 20E,B02,083774,Staff,11,0,30,19
1650266838174,MATH 103A,A01,083777,Staff,0,9,30,30
1650266838174,MATH 103A,A02,083778,Staff,0,10,30,30
1650266838174,MATH 103A,B01,083779,Staff,0,10,30,30
1650266838174,MATH 103A,B02,083780,Staff,0,10,30,30
1650266844202,MATH 105,A01,085443,Staff,0,17,30,30
1650266850228,MATH 109,A01,083213,Anzaldo; Leesa B,0,5,30,30
1650266850228,MATH 109,A02,083214,Anzaldo; Leesa B,0,6,30,30
1650266850228,MATH 109,B01,083215,Anzaldo; Leesa B,0,4,30,30
1650266850228,MATH 109,B02,083216,Anzaldo; Leesa B,0,3,30,30
1650266856258,MATH 142A,A01,083219,Chow; Bennett,0,12,30,30
1650266856258,MATH 142A,A02,083220,Chow; Bennett,0,11,30,30
1650266856258,MATH 142A,B01,083221,Chow; Bennett,0,11,30,30
1650266856258,MATH 142A,B02,083222,Chow; Bennett,0,12,30,30
1650266862291,MATH 193A,A01,083224,Staff,0,5,30,30
1650266862291,MATH 193A,A02,083225,Staff,0,4,30,30
1650266862291,MATH 193A,A03,083781,Staff,0,2,30,30
1650266862291,MATH 193A,A04,083782,Staff,0,1,30,30
1650266868317,MATH 197,001,091859,McAuley; Julian John,9998,0,9999,1
1650266874367,COGS 9,A01,083615,Staff,0,14,60,60
1650266880391,COGS 11,A01,083617,Boyle; Mary E. T.,24,0,40,16
1650266886414,COGS 13,A01,083071,Staff,0,31,40,40
1650266892440,COGS 14A,A01,092681,Staff,0,14,100,100
1650266898465,COGS 14B,A01,083073,Cheng; Tzu-Han,0,9,50,50
1650266904489,COGS 17,A01,092677,Staff,30,0,75,45
1650266910525,COGS 100,A01,083619,Staff,0,22,60,60
1650266916552,COGS 101A,A01,083621,Davis; Joshua Daniel,0,21,60,60
1650266922622,COGS 101B,A01,091572,Staff,4,0,60,56
1650266928646,COGS 101C,A01,083625,Delgado; Tania,19,0,30,11
1650266934700,COGS 107A,A01,083627,Boyle; Mary E. T.,0,8,60,60
1650266940725,COGS 118A,A01,083075,Staff,13,0,60,47
1650266946752,CSE 3,A50,083646,Miranda; Gregory Joseph,22,0,38,16
1650266946752,CSE 3,A51,083647,Miranda; Gregory Joseph,37,0,37,0
1650266952775,CSE 8A,A50,083650,Miranda; Gregory Joseph,0,21,40,40
1650266958807,CSE 11,A01,083080,Cao; Yingjun,0,73,40,40
1650266964835,CSE 12,A01,083652,Staff,0,10,100,100
1650266970859,CSE 15L,A01,083654,Staff,0,1,50,50
1650266970859,CSE 15L,A02,083655,Staff,4,0,50,46
1650266976895,CSE 20,A01,083657,Staff,53,0,80,27
1650266982937,CSE 30,A01,083084,Eldon; John,0,74,40,40
1650266988960,CSE 100,A01,083659,Cao; Yingjun,0,64,50,50
1650266994984,CSE 134B,A01,083661,Powell; Thomas Allan,0,27,65,65
1650267001008,CSE 140,A01,083663,Staff,0,0,75,75
1650267007035,CSE 140L,A01,083088,Eldon; John,0,5,75,75
1650267013060,CSE 175,A01,083665,Kumar; Rakesh,8,0,25,17
1650267019083,CSE 190,A00,092507,Dubnov; Shlomo,14,0,20,6
1650267025112,ECE 45,A01,083139,Staff,0,14,40,40
1650267031146,ECE 65,A50,083695,Staff,0,5,30,30
1650267037172,ECE 109,A01,091882,Touri; Behrouz,45,0,70,25
1650267043197,ECE 180,A00,083140,Abi Samra; Nicholas Camill,24,0,30,6
1650267043197,ECE 180,B00,083141,Abi Samra; Nicholas Camill,7,0,30,23
1650267049224,MATH 10A,A01,083735,Patchell; Gregory David,11,0,30,19
1650267049224,MATH 10A,A02,083736,Patchell; Gregory David,28,0,30,2
1650267049224,MATH 10A,A03,083737,Patchell; Gregory David,26,0,30,4
1650267055251,MATH 10B,A01,083207,Staff,0,6,30,30
1650267055251,MATH 10B,A02,083208,Staff,0,6,30,30
1650267055251,MATH 10B,B01,083739,Staff,17,0,30,13
1650267055251,MATH 10B,B02,083740,Staff,29,0,30,1
1650267061276,MATH 18,A01,083743,Staff,7,0,30,23
1650267061276,MATH 18,A02,083744,Staff,27,0,30,3
1650267061276,MATH 18,A03,083745,Staff,23,0,30,7
1650267061276,MATH 18,A04,083746,Staff,27,0,30,3
1650267061276,MATH 18,B01,083748,Staff,0,11,30,30
1650267061276,MATH 18,B02,083749,Staff,0,9,30,30
1650267061276,MATH 18,B03,083750,Staff,1,8,30,29
1650267061276,MATH 18,B04,083751,Staff,0,9,30,30
1650267067300,MATH 20A,A01,083754,Staff,26,0,40,14
1650267073334,MATH 20B,A01,083756,Staff,0,5,30,30
1650267073334,MATH 20B,A02,083757,Staff,0,7,30,30
1650267079365,MATH 20C,A01,083760,Staff,0,13,30,30
1650267079365,MATH 20C,A02,083761,Staff,0,13,30,30
1650267079365,MATH 20C,B01,083762,Staff,14,0,30,16
1650267079365,MATH 20C,B02,083763,Staff,28,0,30,2
1650267085389,MATH 20D,A01,083765,Staff,0,1,30,30
1650267085389,MATH 20D,A02,083766,Staff,8,0,30,22
1650267085389,MATH 20D,A03,083767,Staff,28,0,30,2
1650267091413,MATH 20E,A01,083771,Staff,6,0,30,24
1650267091413,MATH 20E,A02,083772,Staff,20,0,30,10
1650267091413,MATH 20E,B01,083773,Staff,0,0,30,30
1650267091413,MATH 20E,B02,083774,Staff,11,0,30,19
1650267097444,MATH 103A,A01,083777,Staff,0,9,30,30
1650267097444,MATH 103A,A02,083778,Staff,0,10,30,30
1650267097444,MATH 103A,B01,083779,Staff,0,10,30,30
1650267097444,MATH 103A,B02,083780,Staff,0,10,30,30
1650267103466,MATH 105,A01,085443,Staff,0,17,30,30
1650267109491,MATH 109,A01,083213,Anzaldo; Leesa B,0,5,30,30
1650267109491,MATH 109,A02,083214,Anzaldo; Leesa B,0,6,30,30
1650267109491,MATH 109,B01,083215,Anzaldo; Leesa B,0,4,30,30
1650267109491,MATH 109,B02,083216,Anzaldo; Leesa B,0,3,30,30
1650267115521,MATH 142A,A01,083219,Chow; Bennett,0,12,30,30
1650267115521,MATH 142A,A02,083220,Chow; Bennett,0,11,30,30
1650267115521,MATH 142A,B01,083221,Chow; Bennett,0,11,30,30
1650267115521,MATH 142A,B02,083222,Chow; Bennett,0,12,30,30
1650267121550,MATH 193A,A01,083224,Staff,0,5,30,30
1650267121550,MATH 193A,A02,083225,Staff,0,4,30,30
1650267121550,MATH 193A,A03,083781,Staff,0,2,30,30
1650267121550,MATH 193A,A04,083782,Staff,0,1,30,30
1650267127663,MATH 197,001,091859,McAuley; Julian John,9998,0,9999,1
1650267134190,COGS 9,A01,083615,Staff,0,14,60,60
1650267140214,COGS 11,A01,083617,Boyle; Mary E. T.,24,0,40,16
1650267146241,COGS 13,A01,083071,Staff,0,31,40,40
1650267152268,COGS 14A,A01,092681,Staff,0,14,100,100
1650267158292,COGS 14B,A01,083073,Cheng; Tzu-Han,0,9,50,50
1650267164317,COGS 17,A01,092677,Staff,30,0,75,45
1650267170340,COGS 100,A01,083619,Staff,0,22,60,60
1650267176369,COGS 101A,A01,083621,Davis; Joshua Daniel,0,21,60,60
1650267182395,COGS 101B,A01,091572,Staff,4,0,60,56
1650267188419,COGS 101C,A01,083625,Delgado; Tania,19,0,30,11
1650267194450,COGS 107A,A01,083627,Boyle; Mary E. T.,0,8,60,60
1650267200477,COGS 118A,A01,083075,Staff,13,0,60,47
1650267206505,CSE 3,A50,083646,Miranda; Gregory Joseph,22,0,38,16
1650267206505,CSE 3,A51,083647,Miranda; Gregory Joseph,37,0,37,0
1650267212532,CSE 8A,A50,083650,Miranda; Gregory Joseph,0,21,40,40
1650267218557,CSE 11,A01,083080,Cao; Yingjun,0,73,40,40
1650267224581,CSE 12,A01,083652,Staff,0,10,100,100
1650267230612,CSE 15L,A01,083654,Staff,0,1,50,50
1650267230612,CSE 15L,A02,083655,Staff,4,0,50,46
1650267236634,CSE 20,A01,083657,Staff,53,0,80,27
1650267242665,CSE 30,A01,083084,Eldon; John,0,74,40,40
1650267248689,CSE 100,A01,083659,Cao; Yingjun,0,64,50,50
1650267254715,CSE 134B,A01,083661,Powell; Thomas Allan,0,27,65,65
1650267260739,CSE 140,A01,083663,Staff,0,0,75,75
1650267266763,CSE 140L,A01,083088,Eldon; John,0,5,75,75
1650267272791,CSE 175,A01,083665,Kumar; Rakesh,8,0,25,17
1650267278813,CSE 190,A00,092507,Dubnov; Shlomo,14,0,20,6
1650267284837,ECE 45,A01,083139,Staff,0,14,40,40
1650267290864,ECE 65,A50,083695,Staff,0,5,30,30
1650267296891,ECE 109,A01,091882,Touri; Behrouz,45,0,70,25
1650267302915,ECE 180,A00,083140,Abi Samra; Nicholas Camill,24,0,30,6
1650267302915,ECE 180,B00,083141,Abi Samra; Nicholas Camill,7,0,30,23
1650267308942,MATH 10A,A01,083735,Patchell; Gregory David,11,0,30,19
1650267308942,MATH 10A,A02,083736,Patchell; Gregory David,28,0,30,2
1650267308942,MATH 10A,A03,083737,Patchell; Gregory David,26,0,30,4
1650267314966,MATH 10B,A01,083207,Staff,0,6,30,30
1650267314966,MATH 10B,A02,083208,Staff,0,6,30,30
1650267314966,MATH 10B,B01,083739,Staff,17,0,30,13
1650267314966,MATH 10B,B02,083740,Staff,29,0,30,1
1650267320992,MATH 18,A01,083743,Staff,7,0,30,23
1650267320992,MATH 18,A02,083744,Staff,27,0,30,3
1650267320992,MATH 18,A03,083745,Staff,23,0,30,7
1650267320992,MATH 18,A04,083746,Staff,27,0,30,3
1650267320992,MATH 18,B01,083748,Staff,0,11,30,30
1650267320992,MATH 18,B02,083749,Staff,0,9,30,30
1650267320992,MATH 18,B03,083750,Staff,1,8,30,29
1650267320992,MATH 18,B04,083751,Staff,0,9,30,30
1650267327015,MATH 20A,A01,083754,Staff,26,0,40,14
1650267333039,MATH 20B,A01,083756,Staff,0,5,30,30
1650267333039,MATH 20B,A02,083757,Staff,0,7,30,30
1650267339066,MATH 20C,A01,083760,Staff,0,13,30,30
1650267339066,MATH 20C,A02,083761,Staff,0,13,30,30
1650267339066,MATH 20C,B01,083762,Staff,14,0,30,16
1650267339066,MATH 20C,B02,083763,Staff,28,0,30,2
1650267345090,MATH 20D,A01,083765,Staff,0,1,30,30
1650267345090,MATH 20D,A02,083766,Staff,8,0,30,22
1650267345090,MATH 20D,A03,083767,Staff,28,0,30,2
1650267351123,MATH 20E,A01,083771,Staff,6,0,30,24
1650267351123,MATH 20E,A02,083772,Staff,20,0,30,10
1650267351123,MATH 20E,B01,083773,Staff,0,0,30,30
1650267351123,MATH 20E,B02,083774,Staff,11,0,30,19
1650267357152,MATH 103A,A01,083777,Staff,0,9,30,30
1650267357152,MATH 103A,A02,083778,Staff,0,10,30,30
1650267357152,MATH 103A,B01,083779,Staff,0,10,30,30
1650267357152,MATH 103A,B02,083780,Staff,0,10,30,30
1650267363178,MATH 105,A01,085443,Staff,0,17,30,30
1650267369208,MATH 109,A01,083213,Anzaldo; Leesa B,0,5,30,30
1650267369208,MATH 109,A02,083214,Anzaldo; Leesa B,0,6,30,30
1650267369208,MATH 109,B01,083215,Anzaldo; Leesa B,0,4,30,30
1650267369208,MATH 109,B02,083216,Anzaldo; Leesa B,0,3,30,30
1650267375232,MATH 142A,A01,083219,Chow; Bennett,0,12,30,30
1650267375232,MATH 142A,A02,083220,Chow; Bennett,0,11,30,30
1650267375232,MATH 142A,B01,083221,Chow; Bennett,0,11,30,30
1650267375232,MATH 142A,B02,083222,Chow; Bennett,0,12,30,30
1650267381261,MATH 193A,A01,083224,Staff,0,5,30,30
1650267381261,MATH 193A,A02,083225,Staff,0,4,30,30
1650267381261,MATH 193A,A03,083781,Staff,0,2,30,30
1650267381261,MATH 193A,A04,083782,Staff,0,1,30,30
1650267387283,MATH 197,001,091859,McAuley; Julian John,9998,0,9999,1
1650267393342,COGS 9,A01,083615,Staff,0,14,60,60
1650267399369,COGS 11,A01,083617,Boyle; Mary E. T.,24,0,40,16
1650267405396,COGS 13,A01,083071,Staff,0,31,40,40
1650267411423,COGS 14A,A01,092681,Staff,0,14,100,100
1650267417450,COGS 14B,A01,083073,Cheng; Tzu-Han,0,9,50,50
1650267423473,COGS 17,A01,092677,Staff,30,0,75,45
1650267429494,COGS 100,A01,083619,Staff,0,22,60,60
1650267435517,COGS 101A,A01,083621,Davis; Joshua Daniel,0,21,60,60
1650267441543,COGS 101B,A01,091572,Staff,4,0,60,56
1650267447569,COGS 101C,A01,083625,Delgado; Tania,19,0,30,11
1650267453592,COGS 107A,A01,083627,Boyle; Mary E. T.,0,8,60,60
1650267459617,COGS 118A,A01,083075,Staff,13,0,60,47
1650267465644,CSE 3,A50,083646,Miranda; Gregory Joseph,22,0,38,16
1650267465644,CSE 3,A51,083647,Miranda; Gregory Joseph,37,0,37,0
1650267471671,CSE 8A,A50,083650,Miranda; Gregory Joseph,0,22,40,40
1650267477698,CSE 11,A01,083080,Cao; Yingjun,0,73,40,40
1650267483743,CSE 12,A01,083652,Staff,0,10,100,100
1650267489770,CSE 15L,A01,083654,Staff,0,1,50,50
1650267489770,CSE 15L,A02,083655,Staff,4,0,50,46
1650267495796,CSE 20,A01,083657,Staff,53,0,80,27
1650267501824,CSE 30,A01,083084,Eldon; John,0,74,40,40
1650267507852,CSE 100,A01,083659,Cao; Yingjun,0,64,50,50
1650267513877,CSE 134B,A01,083661,Powell; Thomas Allan,0,27,65,65
1650267519900,CSE 140,A01,083663,Staff,0,0,75,75
1650267525924,CSE 140L,A01,083088,Eldon; John,0,5,75,75
1650267531957,CSE 175,A01,083665,Kumar; Rakesh,8,0,25,17
1650267537981,CSE 190,A00,092507,Dubnov; Shlomo,14,0,20,6
1650267544013,ECE 45,A01,083139,Staff,0,14,40,40
1650267550038,ECE 65,A50,083695,Staff,0,5,30,30
1650267556064,ECE 109,A01,091882,Touri; Behrouz,45,0,70,25
1650267562086,ECE 180,A00,083140,Abi Samra; Nicholas Camill,24,0,30,6
1650267562086,ECE 180,B00,083141,Abi Samra; Nicholas Camill,7,0,30,23
1650267568115,MATH 10A,A01,083735,Patchell; Gregory David,11,0,30,19
1650267568115,MATH 10A,A02,083736,Patchell; Gregory David,28,0,30,2
1650267568115,MATH 10A,A03,083737,Patchell; Gregory David,26,0,30,4
1650267574143,MATH 10B,A01,083207,Staff,0,6,30,30
1650267574143,MATH 10B,A02,083208,Staff,0,6,30,30
1650267574143,MATH 10B,B01,083739,Staff,17,0,30,13
1650267574143,MATH 10B,B02,083740,Staff,29,0,30,1
1650267580181,MATH 18,A01,083743,Staff,7,0,30,23
1650267580181,MATH 18,A02,083744,Staff,27,0,30,3
1650267580181,MATH 18,A03,083745,Staff,23,0,30,7
1650267580181,MATH 18,A04,083746,Staff,27,0,30,3
1650267580181,MATH 18,B01,083748,Staff,0,11,30,30
1650267580181,MATH 18,B02,083749,Staff,0,9,30,30
1650267580181,MATH 18,B03,083750,Staff,1,8,30,29
1650267580181,MATH 18,B04,083751,Staff,0,9,30,30
1650267586209,MATH 20A,A01,083754,Staff,26,0,40,14
1650267592235,MATH 20B,A01,083756,Staff,0,5,30,30
1650267592235,MATH 20B,A02,083757,Staff,0,7,30,30
1650267598262,MATH 20C,A01,083760,Staff,0,13,30,30
1650267598262,MATH 20C,A02,083761,Staff,0,13,30,30
1650267598262,MATH 20C,B01,083762,Staff,14,0,30,16
1650267598262,MATH 20C,B02,083763,Staff,28,0,30,2
1650267604286,MATH 20D,A01,083765,Staff,0,1,30,30
1650267604286,MATH 20D,A02,083766,Staff,8,0,30,22
1650267604286,MATH 20D,A03,083767,Staff,28,0,30,2
1650267610315,MATH 20E,A01,083771,Staff,6,0,30,24
1650267610315,MATH 20E,A02,083772,Staff,20,0,30,10
1650267610315,MATH 20E,B01,083773,Staff,0,0,30,30
1650267610315,MATH 20E,B02,083774,Staff,11,0,30,19
1650267616348,MATH 103A,A01,083777,Staff,0,9,30,30
1650267616348,MATH 103A,A02,083778,Staff,0,10,30,30
1650267616348,MATH 103A,B01,083779,Staff,0,10,30,30
1650267616348,MATH 103A,B02,083780,Staff,0,10,30,30
1650267622372,MATH 105,A01,085443,Staff,0,17,30,30
1650267628403,MATH 109,A01,083213,Anzaldo; Leesa B,0,5,30,30
1650267628403,MATH 109,A02,083214,Anzaldo; Leesa B,0,6,30,30
1650267628403,MATH 109,B01,083215,Anzaldo; Leesa B,0,4,30,30
1650267628403,MATH 109,B02,083216,Anzaldo; Leesa B,0,3,30,30
1650267634433,MATH 142A,A01,083219,Chow; Bennett,0,12,30,30
1650267634433,MATH 142A,A02,083220,Chow; Bennett,0,11,30,30
1650267634433,MATH 142A,B01,083221,Chow; Bennett,0,11,30,30
1650267634433,MATH 142A,B02,083222,Chow; Bennett,0,12,30,30
1650267640461,MATH 193A,A01,083224,Staff,0,5,30,30
1650267640461,MATH 193A,A02,083225,Staff,0,4,30,30
1650267640461,MATH 193A,A03,083781,Staff,0,2,30,30
1650267640461,MATH 193A,A04,083782,Staff,0,1,30,30
1650267646484,MATH 197,001,091859,McAuley; Julian John,9998,0,9999,1
1650267652551,COGS 9,A01,083615,Staff,0,14,60,60
1650267658574,COGS 11,A01,083617,Boyle; Mary E. T.,24,0,40,16
1650267664601,COGS 13,A01,083071,Staff,0,31,40,40
1650267670628,COGS 14A,A01,092681,Staff,0,14,100,100
1650267676654,COGS 14B,A01,083073,Cheng; Tzu-Han,0,9,50,50
1650267682678,COGS 17,A01,092677,Staff,30,0,75,45
1650267688704,COGS 100,A01,083619,Staff,0,22,60,60
1650267694726,COGS 101A,A01,083621,Davis; Joshua Daniel,0,21,60,60
1650267700753,COGS 101B,A01,091572,Staff,4,0,60,56
1650267706780,COGS 101C,A01,083625,Delgado; Tania,19,0,30,11
1650267712813,COGS 107A,A01,083627,Boyle; Mary E. T.,0,8,60,60
1650267718927,COGS 118A,A01,083075,Staff,13,0,60,47
1650267724958,CSE 3,A50,083646,Miranda; Gregory Joseph,22,0,38,16
1650267724958,CSE 3,A51,083647,Miranda; Gregory Joseph,37,0,37,0
1650267731000,CSE 8A,A50,083650,Miranda; Gregory Joseph,0,22,40,40
1650267737027,CSE 11,A01,083080,Cao; Yingjun,0,73,40,40
1650267743050,CSE 12,A01,083652,Staff,0,10,100,100
1650267749075,CSE 15L,A01,083654,Staff,0,1,50,50
1650267749075,CSE 15L,A02,083655,Staff,4,0,50,46
1650267755098,CSE 20,A01,083657,Staff,53,0,80,27
1650267761123,CSE 30,A01,083084,Eldon; John,0,74,40,40
1650267767156,CSE 100,A01,083659,Cao; Yingjun,0,64,50,50
1650267773179,CSE 134B,A01,083661,Powell; Thomas Allan,0,27,65,65
1650267779203,CSE 140,A01,083663,Staff,0,0,75,75
1650267785224,CSE 140L,A01,083088,Eldon; John,0,5,75,75
1650267791250,CSE 175,A01,083665,Kumar; Rakesh,8,0,25,17
1650267797274,CSE 190,A00,092507,Dubnov; Shlomo,14,0,20,6
1650267803299,ECE 45,A01,083139,Staff,0,14,40,40
1650267809326,ECE 65,A50,083695,Staff,0,5,30,30
1650267815352,ECE 109,A01,091882,Touri; Behrouz,45,0,70,25
1650267821386,ECE 180,A00,083140,Abi Samra; Nicholas Camill,24,0,30,6
1650267821386,ECE 180,B00,083141,Abi Samra; Nicholas Camill,7,0,30,23
1650267827477,MATH 10A,A01,083735,Patchell; Gregory David,11,0,30,19
1650267827477,MATH 10A,A02,083736,Patchell; Gregory David,28,0,30,2
1650267827477,MATH 10A,A03,083737,Patchell; Gregory David,26,0,30,4
1650267833501,MATH 10B,A01,083207,Staff,0,6,30,30
1650267833501,MATH 10B,A02,083208,Staff,0,6,30,30
1650267833501,MATH 10B,B01,083739,Staff,17,0,30,13
1650267833501,MATH 10B,B02,083740,Staff,29,0,30,1
1650267839530,MATH 18,A01,083743,Staff,7,0,30,23
1650267839530,MATH 18,A02,083744,Staff,27,0,30,3
1650267839530,MATH 18,A03,083745,Staff,23,0,30,7
1650267839530,MATH 18,A04,083746,Staff,27,0,30,3
1650267839530,MATH 18,B01,083748,Staff,0,11,30,30
1650267839530,MATH 18,B02,083749,Staff,0,9,30,30
1650267839530,MATH 18,B03,083750,Staff,1,8,30,29
1650267839530,MATH 18,B04,083751,Staff,0,9,30,30
1650267845554,MATH 20A,A01,083754,Staff,26,0,40,14
1650267851582,MATH 20B,A01,083756,Staff,0,5,30,30
1650267851582,MATH 20B,A02,083757,Staff,0,7,30,30
1650267857606,MATH 20C,A01,083760,Staff,0,13,30,30
1650267857606,MATH 20C,A02,083761,Staff,0,13,30,30
1650267857606,MATH 20C,B01,083762,Staff,14,0,30,16
1650267857606,MATH 20C,B02,083763,Staff,28,0,30,2
1650267863630,MATH 20D,A01,083765,Staff,0,1,30,30
1650267863630,MATH 20D,A02,083766,Staff,8,0,30,22
1650267863630,MATH 20D,A03,083767,Staff,28,0,30,2
1650267869657,MATH 20E,A01,083771,Staff,6,0,30,24
1650267869657,MATH 20E,A02,083772,Staff,20,0,30,10
1650267869657,MATH 20E,B01,083773,Staff,0,0,30,30
1650267869657,MATH 20E,B02,083774,Staff,11,0,30,19
1650267875680,MATH 103A,A01,083777,Staff,0,9,30,30
1650267875680,MATH 103A,A02,083778,Staff,0,10,30,30
1650267875680,MATH 103A,B01,083779,Staff,0,10,30,30
1650267875680,MATH 103A,B02,083780,Staff,0,10,30,30
1650267881707,MATH 105,A01,085443,Staff,0,17,30,30
1650267887736,MATH 109,A01,083213,Anzaldo; Leesa B,0,5,30,30
1650267887736,MATH 109,A02,083214,Anzaldo; Leesa B,0,6,30,30
1650267887736,MATH 109,B01,083215,Anzaldo; Leesa B,0,4,30,30
1650267887736,MATH 109,B02,083216,Anzaldo; Leesa B,0,3,30,30
1650267893764,MATH 142A,A01,083219,Chow; Bennett,0,12,30,30
1650267893764,MATH 142A,A02,083220,Chow; Bennett,0,11,30,30
1650267893764,MATH 142A,B01,083221,Chow; Bennett,0,11,30,30
1650267893764,MATH 142A,B02,083222,Chow; Bennett,0,12,30,30
1650267899789,MATH 193A,A01,083224,Staff,0,5,30,30
1650267899789,MATH 193A,A02,083225,Staff,0,4,30,30
1650267899789,MATH 193A,A03,083781,Staff,0,2,30,30
1650267899789,MATH 193A,A04,083782,Staff,0,1,30,30
1650267905821,MATH 197,001,091859,McAuley; Julian John,9998,0,9999,1
1650267911872,COGS 9,A01,083615,Staff,0,14,60,60
1650267917899,COGS 11,A01,083617,Boyle; Mary E. T.,24,0,40,16
1650267923925,COGS 13,A01,083071,Staff,0,31,40,40
1650267929948,COGS 14A,A01,092681,Staff,0,14,100,100
1650267935975,COGS 14B,A01,083073,Cheng; Tzu-Han,0,9,50,50
1650267942009,COGS 17,A01,092677,Staff,29,0,75,46
1650267948033,COGS 100,A01,083619,Staff,0,22,60,60
1650267954071,COGS 101A,A01,083621,Davis; Joshua Daniel,0,21,60,60
1650267960097,COGS 101B,A01,091572,Staff,4,0,60,56
1650267966122,COGS 101C,A01,083625,Delgado; Tania,19,0,30,11
1650267972146,COGS 107A,A01,083627,Boyle; Mary E. T.,0,8,60,60
1650267978177,COGS 118A,A01,083075,Staff,13,0,60,47
1650267984209,CSE 3,A50,083646,Miranda; Gregory Joseph,22,0,38,16
1650267984209,CSE 3,A51,083647,Miranda; Gregory Joseph,37,0,37,0
1650267990232,CSE 8A,A50,083650,Miranda; Gregory Joseph,0,22,40,40
1650267996259,CSE 11,A01,083080,Cao; Yingjun,0,73,40,40
1650268002282,CSE 12,A01,083652,Staff,0,10,100,100
1650268008305,CSE 15L,A01,083654,Staff,0,1,50,50
1650268008305,CSE 15L,A02,083655,Staff,4,0,50,46
1650268014332,CSE 20,A01,083657,Staff,53,0,80,27
1650268020355,CSE 30,A01,083084,Eldon; John,0,74,40,40
1650268026386,CSE 100,A01,083659,Cao; Yingjun,0,64,50,50
1650268032409,CSE 134B,A01,083661,Powell; Thomas Allan,0,27,65,65
1650268038435,CSE 140,A01,083663,Staff,0,0,75,75
1650268044463,CSE 140L,A01,083088,Eldon; John,0,5,75,75
1650268050488,CSE 175,A01,083665,Kumar; Rakesh,8,0,25,17
1650268056514,CSE 190,A00,092507,Dubnov; Shlomo,14,0,20,6
1650268062539,ECE 45,A01,083139,Staff,0,14,40,40
1650268068565,ECE 65,A50,083695,Staff,0,5,30,30
1650268074590,ECE 109,A01,091882,Touri; Behrouz,45,0,70,25
1650268080780,ECE 180,A00,083140,Abi Samra; Nicholas Camill,24,0,30,6
1650268080780,ECE 180,B00,083141,Abi Samra; Nicholas Camill,7,0,30,23
1650268086814,MATH 10A,A01,083735,Patchell; Gregory David,11,0,30,19
1650268086814,MATH 10A,A02,083736,Patchell; Gregory David,28,0,30,2
1650268086814,MATH 10A,A03,083737,Patchell; Gregory David,26,0,30,4
1650268092839,MATH 10B,A01,083207,Staff,0,6,30,30
1650268092839,MATH 10B,A02,083208,Staff,0,6,30,30
1650268092839,MATH 10B,B01,083739,Staff,17,0,30,13
1650268092839,MATH 10B,B02,083740,Staff,29,0,30,1
1650268098868,MATH 18,A01,083743,Staff,7,0,30,23
1650268098868,MATH 18,A02,083744,Staff,27,0,30,3
1650268098868,MATH 18,A03,083745,Staff,23,0,30,7
1650268098868,MATH 18,A04,083746,Staff,27,0,30,3
1650268098868,MATH 18,B01,083748,Staff,0,11,30,30
1650268098868,MATH 18,B02,083749,Staff,0,9,30,30
1650268098868,MATH 18,B03,083750,Staff,1,8,30,29
1650268098868,MATH 18,B04,083751,Staff,0,9,30,30
1650268104894,MATH 20A,A01,083754,Staff,26,0,40,14
1650268110919,MATH 20B,A01,083756,Staff,0,5,30,30
1650268110919,MATH 20B,A02,083757,Staff,0,7,30,30
1650268116944,MATH 20C,A01,083760,Staff,0,13,30,30
1650268116944,MATH 20C,A02,083761,Staff,0,13,30,30
1650268116944,MATH 20C,B01,083762,Staff,14,0,30,16
1650268116944,MATH 20C,B02,083763,Staff,28,0,30,2
1650268122968,MATH 20D,A01,083765,Staff,0,1,30,30
1650268122968,MATH 20D,A02,083766,Staff,8,0,30,22
1650268122968,MATH 20D,A03,083767,Staff,28,0,30,2
1650268128998,MATH 20E,A01,083771,Staff,6,0,30,24
1650268128998,MATH 20E,A02,083772,Staff,20,0,30,10
1650268128998,MATH 20E,B01,083773,Staff,0,0,30,30
1650268128998,MATH 20E,B02,083774,Staff,11,0,30,19
1650268135027,MATH 103A,A01,083777,Staff,0,9,30,30
1650268135027,MATH 103A,A02,083778,Staff,0,10,30,30
1650268135027,MATH 103A,B01,083779,Staff,0,10,30,30
1650268135027,MATH 103A,B02,083780,Staff,0,10,30,30
1650268141053,MATH 105,A01,085443,Staff,0,17,30,30
1650268147092,MATH 109,A01,083213,Anzaldo; Leesa B,0,5,30,30
1650268147092,MATH 109,A02,083214,Anzaldo; Leesa B,0,6,30,30
1650268147092,MATH 109,B01,083215,Anzaldo; Leesa B,0,4,30,30
1650268147092,MATH 109,B02,083216,Anzaldo; Leesa B,0,3,30,30
1650268153126,MATH 142A,A01,083219,Chow; Bennett,0,12,30,30
1650268153126,MATH 142A,A02,083220,Chow; Bennett,0,11,30,30
1650268153126,MATH 142A,B01,083221,Chow; Bennett,0,11,30,30
1650268153126,MATH 142A,B02,083222,Chow; Bennett,0,12,30,30
1650268159151,MATH 193A,A01,083224,Staff,0,5,30,30
1650268159151,MATH 193A,A02,083225,Staff,0,4,30,30
1650268159151,MATH 193A,A03,083781,Staff,0,2,30,30
1650268159151,MATH 193A,A04,083782,Staff,0,1,30,30
1650268165173,MATH 197,001,091859,McAuley; Julian John,9998,0,9999,1
1650268171250,COGS 9,A01,083615,Staff,0,14,60,60
1650268177273,COGS 11,A01,083617,Boyle; Mary E. T.,24,0,40,16
1650268183300,COGS 13,A01,083071,Staff,0,31,40,40
1650268189326,COGS 14A,A01,092681,Staff,0,14,100,100
1650268195350,COGS 14B,A01,083073,Cheng; Tzu-Han,0,9,50,50
1650268201379,COGS 17,A01,092677,Staff,29,0,75,46
1650268207402,COGS 100,A01,083619,Staff,0,22,60,60
1650268213432,COGS 101A,A01,083621,Davis; Joshua Daniel,0,21,60,60
1650268219456,COGS 101B,A01,091572,Staff,4,0,60,56
1650268225479,COGS 101C,A01,083625,Delgado; Tania,19,0,30,11
1650268231504,COGS 107A,A01,083627,Boyle; Mary E. T.,0,8,60,60
1650268237529,COGS 118A,A01,083075,Staff,13,0,60,47
1650268243568,CSE 3,A50,083646,Miranda; Gregory Joseph,22,0,38,16
1650268243568,CSE 3,A51,083647,Miranda; Gregory Joseph,37,0,37,0
1650268249593,CSE 8A,A50,083650,Miranda; Gregory Joseph,0,22,40,40
1650268255618,CSE 11,A01,083080,Cao; Yingjun,0,73,40,40
1650268261643,CSE 12,A01,083652,Staff,0,10,100,100
1650268267669,CSE 15L,A01,083654,Staff,0,1,50,50
1650268267669,CSE 15L,A02,083655,Staff,3,0,50,47
1650268273695,CSE 20,A01,083657,Staff,53,0,80,27
1650268279721,CSE 30,A01,083084,Eldon; John,0,74,40,40
1650268285778,CSE 100,A01,083659,Cao; Yingjun,0,64,50,50
1650268291802,CSE 134B,A01,083661,Powell; Thomas Allan,0,27,65,65
1650268297829,CSE 140,A01,083663,Staff,0,0,75,75
1650268303852,CSE 140L,A01,083088,Eldon; John,0,5,75,75
1650268309880,CSE 175,A01,083665,Kumar; Rakesh,8,0,25,17
1650268315995,CSE 190,A00,092507,Dubnov; Shlomo,14,0,20,6
1650268322018,ECE 45,A01,083139,Staff,0,14,40,40
1650268328053,ECE 65,A50,083695,Staff,0,5,30,30
1650268334076,ECE 109,A01,091882,Touri; Behrouz,45,0,70,25
1650268340100,ECE 180,A00,083140,Abi Samra; Nicholas Camill,24,0,30,6
1650268340100,ECE 180,B00,083141,Abi Samra; Nicholas Camill,7,0,30,23
1650268346123,MATH 10A,A01,083735,Patchell; Gregory David,11,0,30,19
1650268346123,MATH 10A,A02,083736,Patchell; Gregory David,28,0,30,2
1650268346123,MATH 10A,A03,083737,Patchell; Gregory David,26,0,30,4
1650268352147,MATH 10B,A01,083207,Staff,0,6,30,30
1650268352147,MATH 10B,A02,083208,Staff,0,6,30,30
1650268352147,MATH 10B,B01,083739,Staff,17,0,30,13
1650268352147,MATH 10B,B02,083740,Staff,29,0,30,1
1650268358182,MATH 18,A01,083743,Staff,7,0,30,23
1650268358182,MATH 18,A02,083744,Staff,27,0,30,3
1650268358182,MATH 18,A03,083745,Staff,23,0,30,7
1650268358182,MATH 18,A04,083746,Staff,27,0,30,3
1650268358182,MATH 18,B01,083748,Staff,0,11,30,30
1650268358182,MATH 18,B02,083749,Staff,0,9,30,30
1650268358182,MATH 18,B03,083750,Staff,1,8,30,29
1650268358182,MATH 18,B04,083751,Staff,0,9,30,30
1650268364218,MATH 20A,A01,083754,Staff,26,0,40,14
1650268370248,MATH 20B,A01,083756,Staff,0,5,30,30
1650268370248,MATH 20B,A02,083757,Staff,0,7,30,30
1650268376275,MATH 20C,A01,083760,Staff,0,13,30,30
1650268376275,MATH 20C,A02,083761,Staff,0,13,30,30
1650268376275,MATH 20C,B01,083762,Staff,14,0,30,16
1650268376275,MATH 20C,B02,083763,Staff,28,0,30,2
1650268382301,MATH 20D,A01,083765,Staff,0,1,30,30
1650268382301,MATH 20D,A02,083766,Staff,8,0,30,22
1650268382301,MATH 20D,A03,083767,Staff,28,0,30,2
1650268388324,MATH 20E,A01,083771,Staff,6,0,30,24
1650268388324,MATH 20E,A02,083772,Staff,20,0,30,10
1650268388324,MATH 20E,B01,083773,Staff,0,0,30,30
1650268388324,MATH 20E,B02,083774,Staff,11,0,30,19
1650268394356,MATH 103A,A01,083777,Staff,0,9,30,30
1650268394356,MATH 103A,A02,083778,Staff,0,10,30,30
1650268394356,MATH 103A,B01,083779,Staff,0,10,30,30
1650268394356,MATH 103A,B02,083780,Staff,0,10,30,30
1650268400380,MATH 105,A01,085443,Staff,0,17,30,30
1650268406403,MATH 109,A01,083213,Anzaldo; Leesa B,0,5,30,30
1650268406403,MATH 109,A02,083214,Anzaldo; Leesa B,0,6,30,30
1650268406403,MATH 109,B01,083215,Anzaldo; Leesa B,0,4,30,30
1650268406403,MATH 109,B02,083216,Anzaldo; Leesa B,0,3,30,30
1650268412440,MATH 142A,A01,083219,Chow; Bennett,0,12,30,30
1650268412440,MATH 142A,A02,083220,Chow; Bennett,0,11,30,30
1650268412440,MATH 142A,B01,083221,Chow; Bennett,0,11,30,30
1650268412440,MATH 142A,B02,083222,Chow; Bennett,0,12,30,30
1650268418467,MATH 193A,A01,083224,Staff,0,5,30,30
1650268418467,MATH 193A,A02,083225,Staff,0,4,30,30
1650268418467,MATH 193A,A03,083781,Staff,0,2,30,30
1650268418467,MATH 193A,A04,083782,Staff,0,1,30,30
1650268424493,MATH 197,001,091859,McAuley; Julian John,9998,0,9999,1
1650268430553,COGS 9,A01,083615,Staff,0,14,60,60
1650268436577,COGS 11,A01,083617,Boyle; Mary E. T.,24,0,40,16
1650268442599,COGS 13,A01,083071,Staff,0,31,40,40
1650268448621,COGS 14A,A01,092681,Staff,0,14,100,100
1650268454648,COGS 14B,A01,083073,Cheng; Tzu-Han,0,9,50,50
1650268460672,COGS 17,A01,092677,Staff,29,0,75,46
1650268466757,COGS 100,A01,083619,Staff,0,22,60,60
1650268472780,COGS 101A,A01,083621,Davis; Joshua Daniel,0,21,60,60
1650268478802,COGS 101B,A01,091572,Staff,4,0,60,56
1650268484825,COGS 101C,A01,083625,Delgado; Tania,19,0,30,11
1650268490848,COGS 107A,A01,083627,Boyle; Mary E. T.,0,8,60,60
1650268496876,COGS 118A,A01,083075,Staff,13,0,60,47
1650268502907,CSE 3,A50,083646,Miranda; Gregory Joseph,22,0,38,16
1650268502907,CSE 3,A51,083647,Miranda; Gregory Joseph,37,0,37,0
1650268508934,CSE 8A,A50,083650,Miranda; Gregory Joseph,0,22,40,40
1650268514963,CSE 11,A01,083080,Cao; Yingjun,0,73,40,40
1650268520985,CSE 12,A01,083652,Staff,0,10,100,100
1650268527010,CSE 15L,A01,083654,Staff,0,1,50,50
1650268527010,CSE 15L,A02,083655,Staff,4,0,50,46
1650268533039,CSE 20,A01,083657,Staff,53,0,80,27
1650268539062,CSE 30,A01,083084,Eldon; John,0,74,40,40
1650268545085,CSE 100,A01,083659,Cao; Yingjun,0,64,50,50
1650268551111,CSE 134B,A01,083661,Powell; Thomas Allan,0,27,65,65
1650268557136,CSE 140,A01,083663,Staff,0,0,75,75
1650268563157,CSE 140L,A01,083088,Eldon; John,0,5,75,75
1650268569180,CSE 175,A01,083665,Kumar; Rakesh,8,0,25,17
1650268575204,CSE 190,A00,092507,Dubnov; Shlomo,14,0,20,6
1650268581227,ECE 45,A01,083139,Staff,0,14,40,40
1650268587252,ECE 65,A50,083695,Staff,0,5,30,30
1650268593278,ECE 109,A01,091882,Touri; Behrouz,45,0,70,25
1650268599301,ECE 180,A00,083140,Abi Samra; Nicholas Camill,24,0,30,6
1650268599301,ECE 180,B00,083141,Abi Samra; Nicholas Camill,7,0,30,23
1650268605324,MATH 10A,A01,083735,Patchell; Gregory David,11,0,30,19
1650268605324,MATH 10A,A02,083736,Patchell; Gregory David,28,0,30,2
1650268605324,MATH 10A,A03,083737,Patchell; Gregory David,26,0,30,4
1650268611353,MATH 10B,A01,083207,Staff,0,6,30,30
1650268611353,MATH 10B,A02,083208,Staff,0,6,30,30
1650268611353,MATH 10B,B01,083739,Staff,17,0,30,13
1650268611353,MATH 10B,B02,083740,Staff,29,0,30,1
1650268617391,MATH 18,A01,083743,Staff,7,0,30,23
1650268617391,MATH 18,A02,083744,Staff,27,0,30,3
1650268617391,MATH 18,A03,083745,Staff,23,0,30,7
1650268617391,MATH 18,A04,083746,Staff,27,0,30,3
1650268617391,MATH 18,B01,083748,Staff,0,11,30,30
1650268617391,MATH 18,B02,083749,Staff,0,9,30,30
1650268617391,MATH 18,B03,083750,Staff,1,8,30,29
1650268617391,MATH 18,B04,083751,Staff,0,9,30,30
1650268623416,MATH 20A,A01,083754,Staff,26,0,40,14
1650268629440,MATH 20B,A01,083756,Staff,0,5,30,30
1650268629440,MATH 20B,A02,083757,Staff,0,7,30,30
1650268635466,MATH 20C,A01,083760,Staff,0,13,30,30
1650268635466,MATH 20C,A02,083761,Staff,0,13,30,30
1650268635466,MATH 20C,B01,083762,Staff,14,0,30,16
1650268635466,MATH 20C,B02,083763,Staff,28,0,30,2
1650268641489,MATH 20D,A01,083765,Staff,0,1,30,30
1650268641489,MATH 20D,A02,083766,Staff,8,0,30,22
1650268641489,MATH 20D,A03,083767,Staff,28,0,30,2
1650268647514,MATH 20E,A01,083771,Staff,6,0,30,24
1650268647514,MATH 20E,A02,083772,Staff,20,0,30,10
1650268647514,MATH 20E,B01,083773,Staff,0,0,30,30
1650268647514,MATH 20E,B02,083774,Staff,11,0,30,19
1650268653539,MATH 103A,A01,083777,Staff,0,9,30,30
1650268653539,MATH 103A,A02,083778,Staff,0,10,30,30
1650268653539,MATH 103A,B01,083779,Staff,0,10,30,30
1650268653539,MATH 103A,B02,083780,Staff,0,10,30,30
1650268659563,MATH 105,A01,085443,Staff,0,17,30,30
1650268665592,MATH 109,A01,083213,Anzaldo; Leesa B,0,5,30,30
1650268665592,MATH 109,A02,083214,Anzaldo; Leesa B,0,6,30,30
1650268665592,MATH 109,B01,083215,Anzaldo; Leesa B,0,4,30,30
1650268665592,MATH 109,B02,083216,Anzaldo; Leesa B,0,3,30,30
1650268671616,MATH 142A,A01,083219,Chow; Bennett,0,12,30,30
1650268671616,MATH 142A,A02,083220,Chow; Bennett,0,11,30,30
1650268671616,MATH 142A,B01,083221,Chow; Bennett,0,11,30,30
1650268671616,MATH 142A,B02,083222,Chow; Bennett,0,12,30,30
1650268677639,MATH 193A,A01,083224,Staff,0,5,30,30
1650268677639,MATH 193A,A02,083225,Staff,0,4,30,30
1650268677639,MATH 193A,A03,083781,Staff,0,2,30,30
1650268677639,MATH 193A,A04,083782,Staff,0,2,30,30
1650268683661,MATH 197,001,091859,McAuley; Julian John,9998,0,9999,1
1650268689725,COGS 9,A01,083615,Staff,0,14,60,60
1650268695749,COGS 11,A01,083617,Boyle; Mary E. T.,24,0,40,16
1650268701772,COGS 13,A01,083071,Staff,0,31,40,40
1650268707798,COGS 14A,A01,092681,Staff,0,14,100,100
1650268713821,COGS 14B,A01,083073,Cheng; Tzu-Han,0,9,50,50
1650268719845,COGS 17,A01,092677,Staff,29,0,75,46
1650268725867,COGS 100,A01,083619,Staff,0,22,60,60
1650268731899,COGS 101A,A01,083621,Davis; Joshua Daniel,0,21,60,60
1650268737924,COGS 101B,A01,091572,Staff,4,0,60,56
1650268743948,COGS 101C,A01,083625,Delgado; Tania,19,0,30,11
1650268749975,COGS 107A,A01,083627,Boyle; Mary E. T.,0,8,60,60
1650268755997,COGS 118A,A01,083075,Staff,13,0,60,47
1650268762021,CSE 3,A50,083646,Miranda; Gregory Joseph,22,0,38,16
1650268762021,CSE 3,A51,083647,Miranda; Gregory Joseph,37,0,37,0
1650268768045,CSE 8A,A50,083650,Miranda; Gregory Joseph,0,22,40,40
1650268774068,CSE 11,A01,083080,Cao; Yingjun,0,73,40,40
1650268780093,CSE 12,A01,083652,Staff,0,10,100,100
1650268786132,CSE 15L,A01,083654,Staff,0,1,50,50
1650268786132,CSE 15L,A02,083655,Staff,4,0,50,46
1650268792159,CSE 20,A01,083657,Staff,53,0,80,27
1650268798186,CSE 30,A01,083084,Eldon; John,0,74,40,40
1650268804210,CSE 100,A01,083659,Cao; Yingjun,0,64,50,50
1650268810239,CSE 134B,A01,083661,Powell; Thomas Allan,0,27,65,65
1650268816266,CSE 140,A01,083663,Staff,0,0,75,75
1650268822291,CSE 140L,A01,083088,Eldon; John,0,5,75,75
1650268828318,CSE 175,A01,083665,Kumar; Rakesh,8,0,25,17
1650268834341,CSE 190,A00,092507,Dubnov; Shlomo,14,0,20,6
1650268840367,ECE 45,A01,083139,Staff,0,14,40,40
1650268846393,ECE 65,A50,083695,Staff,0,5,30,30
1650268852419,ECE 109,A01,091882,Touri; Behrouz,45,0,70,25
1650268858445,ECE 180,A00,083140,Abi Samra; Nicholas Camill,24,0,30,6
1650268858445,ECE 180,B00,083141,Abi Samra; Nicholas Camill,7,0,30,23
1650268864481,MATH 10A,A01,083735,Patchell; Gregory David,11,0,30,19
1650268864481,MATH 10A,A02,083736,Patchell; Gregory David,28,0,30,2
1650268864481,MATH 10A,A03,083737,Patchell; Gregory David,26,0,30,4
1650268870503,MATH 10B,A01,083207,Staff,0,6,30,30
1650268870503,MATH 10B,A02,083208,Staff,0,6,30,30
1650268870503,MATH 10B,B01,083739,Staff,17,0,30,13
1650268870503,MATH 10B,B02,083740,Staff,29,0,30,1
1650268876527,MATH 18,A01,083743,Staff,7,0,30,23
1650268876527,MATH 18,A02,083744,Staff,27,0,30,3
1650268876527,MATH 18,A03,083745,Staff,23,0,30,7
1650268876527,MATH 18,A04,083746,Staff,27,0,30,3
1650268876527,MATH 18,B01,083748,Staff,0,11,30,30
1650268876527,MATH 18,B02,083749,Staff,0,9,30,30
1650268876527,MATH 18,B03,083750,Staff,1,8,30,29
1650268876527,MATH 18,B04,083751,Staff,0,9,30,30
1650268882554,MATH 20A,A01,083754,Staff,26,0,40,14
1650268888583,MATH 20B,A01,083756,Staff,0,5,30,30
1650268888583,MATH 20B,A02,083757,Staff,0,7,30,30
1650268894605,MATH 20C,A01,083760,Staff,0,13,30,30
1650268894605,MATH 20C,A02,083761,Staff,0,13,30,30
1650268894605,MATH 20C,B01,083762,Staff,14,0,30,16
1650268894605,MATH 20C,B02,083763,Staff,28,0,30,2
1650268900629,MATH 20D,A01,083765,Staff,0,1,30,30
1650268900629,MATH 20D,A02,083766,Staff,8,0,30,22
1650268900629,MATH 20D,A03,083767,Staff,28,0,30,2
1650268906654,MATH 20E,A01,083771,Staff,6,0,30,24
1650268906654,MATH 20E,A02,083772,Staff,20,0,30,10
1650268906654,MATH 20E,B01,083773,Staff,0,0,30,30
1650268906654,MATH 20E,B02,083774,Staff,11,0,30,19
1650268912752,MATH 103A,A01,083777,Staff,0,9,30,30
1650268912752,MATH 103A,A02,083778,Staff,0,10,30,30
1650268912752,MATH 103A,B01,083779,Staff,0,10,30,30
1650268912752,MATH 103A,B02,083780,Staff,0,10,30,30
1650268918784,MATH 105,A01,085443,Staff,0,17,30,30
1650268924805,MATH 109,A01,083213,Anzaldo; Leesa B,0,5,30,30
1650268924805,MATH 109,A02,083214,Anzaldo; Leesa B,0,6,30,30
1650268924805,MATH 109,B01,083215,Anzaldo; Leesa B,0,4,30,30
1650268924805,MATH 109,B02,083216,Anzaldo; Leesa B,0,3,30,30
1650268930829,MATH 142A,A01,083219,Chow; Bennett,0,12,30,30
1650268930829,MATH 142A,A02,083220,Chow; Bennett,0,11,30,30
1650268930829,MATH 142A,B01,083221,Chow; Bennett,0,11,30,30
1650268930829,MATH 142A,B02,083222,Chow; Bennett,0,12,30,30
1650268936855,MATH 193A,A01,083224,Staff,0,5,30,30
1650268936855,MATH 193A,A02,083225,Staff,0,5,30,30
1650268936855,MATH 193A,A03,083781,Staff,0,2,30,30
1650268936855,MATH 193A,A04,083782,Staff,0,1,30,30
1650268942891,MATH 197,001,091859,McAuley; Julian John,9998,0,9999,1
1650268948944,COGS 9,A01,083615,Staff,0,14,60,60
1650268954968,COGS 11,A01,083617,Boyle; Mary E. T.,24,0,40,16
1650268960996,COGS 13,A01,083071,Staff,0,31,40,40
1650268967022,COGS 14A,A01,092681,Staff,0,14,100,100
1650268973047,COGS 14B,A01,083073,Cheng; Tzu-Han,0,9,50,50
1650268979071,COGS 17,A01,092677,Staff,29,0,75,46
1650268985108,COGS 100,A01,083619,Staff,0,22,60,60
1650268991134,COGS 101A,A01,083621,Davis; Joshua Daniel,0,21,60,60
1650268997171,COGS 101B,A01,091572,Staff,4,0,60,56
1650269003206,COGS 101C,A01,083625,Delgado; Tania,19,0,30,11
1650269009232,COGS 107A,A01,083627,Boyle; Mary E. T.,0,8,60,60
1650269015263,COGS 118A,A01,083075,Staff,13,0,60,47
1650269021288,CSE 3,A50,083646,Miranda; Gregory Joseph,22,0,38,16
1650269021288,CSE 3,A51,083647,Miranda; Gregory Joseph,37,0,37,0
1650269027313,CSE 8A,A50,083650,Miranda; Gregory Joseph,0,22,40,40
1650269033337,CSE 11,A01,083080,Cao; Yingjun,0,73,40,40
1650269039362,CSE 12,A01,083652,Staff,0,10,100,100
1650269045385,CSE 15L,A01,083654,Staff,0,1,50,50
1650269045385,CSE 15L,A02,083655,Staff,4,0,50,46
1650269051414,CSE 20,A01,083657,Staff,53,0,80,27
1650269057454,CSE 30,A01,083084,Eldon; John,0,74,40,40
1650269063480,CSE 100,A01,083659,Cao; Yingjun,0,64,50,50
1650269069512,CSE 134B,A01,083661,Powell; Thomas Allan,0,27,65,65
1650269075546,CSE 140,A01,083663,Staff,0,0,75,75
1650269081579,CSE 140L,A01,083088,Eldon; John,0,5,75,75
1650269087612,CSE 175,A01,083665,Kumar; Rakesh,8,0,25,17
1650269093644,CSE 190,A00,092507,Dubnov; Shlomo,14,0,20,6
1650269099669,ECE 45,A01,083139,Staff,0,14,40,40
1650269105701,ECE 65,A50,083695,Staff,0,5,30,30
1650269111731,ECE 109,A01,091882,Touri; Behrouz,45,0,70,25
1650269117755,ECE 180,A00,083140,Abi Samra; Nicholas Camill,24,0,30,6
1650269117755,ECE 180,B00,083141,Abi Samra; Nicholas Camill,7,0,30,23
1650269123896,MATH 10A,A01,083735,Patchell; Gregory David,11,0,30,19
1650269123896,MATH 10A,A02,083736,Patchell; Gregory David,28,0,30,2
1650269123896,MATH 10A,A03,083737,Patchell; Gregory David,26,0,30,4
1650269129920,MATH 10B,A01,083207,Staff,0,6,30,30
1650269129920,MATH 10B,A02,083208,Staff,0,6,30,30
1650269129920,MATH 10B,B01,083739,Staff,17,0,30,13
1650269129920,MATH 10B,B02,083740,Staff,29,0,30,1
1650269135949,MATH 18,A01,083743,Staff,7,0,30,23
1650269135949,MATH 18,A02,083744,Staff,27,0,30,3
1650269135949,MATH 18,A03,083745,Staff,23,0,30,7
1650269135949,MATH 18,A04,083746,Staff,27,0,30,3
1650269135949,MATH 18,B01,083748,Staff,0,11,30,30
1650269135949,MATH 18,B02,083749,Staff,0,9,30,30
1650269135949,MATH 18,B03,083750,Staff,1,8,30,29
1650269135949,MATH 18,B04,083751,Staff,0,9,30,30
1650269141974,MATH 20A,A01,083754,Staff,26,0,40,14
1650269148017,MATH 20B,A01,083756,Staff,0,5,30,30
1650269148017,MATH 20B,A02,083757,Staff,0,7,30,30
1650269154050,MATH 20C,A01,083760,Staff,0,13,30,30
1650269154050,MATH 20C,A02,083761,Staff,0,13,30,30
1650269154050,MATH 20C,B01,083762,Staff,14,0,30,16
1650269154050,MATH 20C,B02,083763,Staff,28,0,30,2
1650269160086,MATH 20D,A01,083765,Staff,0,1,30,30
1650269160086,MATH 20D,A02,083766,Staff,8,0,30,22
1650269160086,MATH 20D,A03,083767,Staff,28,0,30,2
1650269166110,MATH 20E,A01,083771,Staff,6,0,30,24
1650269166110,MATH 20E,A02,083772,Staff,20,0,30,10
1650269166110,MATH 20E,B01,083773,Staff,0,0,30,30
1650269166110,MATH 20E,B02,083774,Staff,11,0,30,19
1650269172138,MATH 103A,A01,083777,Staff,0,9,30,30
1650269172138,MATH 103A,A02,083778,Staff,0,10,30,30
1650269172138,MATH 103A,B01,083779,Staff,0,10,30,30
1650269172138,MATH 103A,B02,083780,Staff,0,10,30,30
1650269178192,MATH 105,A01,085443,Staff,0,17,30,30
1650269184311,MATH 109,A01,083213,Anzaldo; Leesa B,0,5,30,30
1650269184311,MATH 109,A02,083214,Anzaldo; Leesa B,0,6,30,30
1650269184311,MATH 109,B01,083215,Anzaldo; Leesa B,0,4,30,30
1650269184311,MATH 109,B02,083216,Anzaldo; Leesa B,0,3,30,30
1650269190340,MATH 142A,A01,083219,Chow; Bennett,0,12,30,30
1650269190340,MATH 142A,A02,083220,Chow; Bennett,0,11,30,30
1650269190340,MATH 142A,B01,083221,Chow; Bennett,0,11,30,30
1650269190340,MATH 142A,B02,083222,Chow; Bennett,0,12,30,30
1650269196366,MATH 193A,A01,083224,Staff,0,5,30,30
1650269196366,MATH 193A,A02,083225,Staff,0,5,30,30
1650269196366,MATH 193A,A03,083781,Staff,0,2,30,30
1650269196366,MATH 193A,A04,083782,Staff,0,1,30,30
1650269202393,MATH 197,001,091859,McAuley; Julian John,9998,0,9999,1
1650269208463,COGS 9,A01,083615,Staff,0,14,60,60
1650269214492,COGS 11,A01,083617,Boyle; Mary E. T.,24,0,40,16
1650269220533,COGS 13,A01,083071,Staff,0,31,40,40
1650269226559,COGS 14A,A01,092681,Staff,0,14,100,100
1650269232582,COGS 14B,A01,083073,Cheng; Tzu-Han,0,9,50,50
1650269238605,COGS 17,A01,092677,Staff,29,0,75,46
1650269244632,COGS 100,A01,083619,Staff,0,22,60,60
1650269250658,COGS 101A,A01,083621,Davis; Joshua Daniel,0,21,60,60
1650269256689,COGS 101B,A01,091572,Staff,4,0,60,56
1650269262713,COGS 101C,A01,083625,Delgado; Tania,19,0,30,11
1650269268739,COGS 107A,A01,083627,Boyle; Mary E. T.,0,8,60,60
1650269274765,COGS 118A,A01,083075,Staff,13,0,60,47
1650269280887,CSE 3,A50,083646,Miranda; Gregory Joseph,22,0,38,16
1650269280887,CSE 3,A51,083647,Miranda; Gregory Joseph,37,0,37,0
1650269286917,CSE 8A,A50,083650,Miranda; Gregory Joseph,0,22,40,40
1650269292946,CSE 11,A01,083080,Cao; Yingjun,0,73,40,40
1650269299005,CSE 12,A01,083652,Staff,0,10,100,100
1650269305028,CSE 15L,A01,083654,Staff,0,1,50,50
1650269305028,CSE 15L,A02,083655,Staff,4,0,50,46
1650269311058,CSE 20,A01,083657,Staff,53,0,80,27
1650269317083,CSE 30,A01,083084,Eldon; John,0,74,40,40
1650269323109,CSE 100,A01,083659,Cao; Yingjun,0,64,50,50
1650269329137,CSE 134B,A01,083661,Powell; Thomas Allan,0,28,65,65
1650269335161,CSE 140,A01,083663,Staff,0,0,75,75
1650269341186,CSE 140L,A01,083088,Eldon; John,0,5,75,75
1650269347213,CSE 175,A01,083665,Kumar; Rakesh,8,0,25,17
1650269353244,CSE 190,A00,092507,Dubnov; Shlomo,14,0,20,6
1650269359276,ECE 45,A01,083139,Staff,0,14,40,40
1650269365304,ECE 65,A50,083695,Staff,0,4,30,30
1650269371330,ECE 109,A01,091882,Touri; Behrouz,45,0,70,25
1650269377362,ECE 180,A00,083140,Abi Samra; Nicholas Camill,24,0,30,6
1650269377362,ECE 180,B00,083141,Abi Samra; Nicholas Camill,7,0,30,23
1650269383396,MATH 10A,A01,083735,Patchell; Gregory David,11,0,30,19
1650269383396,MATH 10A,A02,083736,Patchell; Gregory David,28,0,30,2
1650269383396,MATH 10A,A03,083737,Patchell; Gregory David,26,0,30,4
1650269389422,MATH 10B,A01,083207,Staff,0,6,30,30
1650269389422,MATH 10B,A02,083208,Staff,0,6,30,30
1650269389422,MATH 10B,B01,083739,Staff,17,0,30,13
1650269389422,MATH 10B,B02,083740,Staff,29,0,30,1
1650269395460,MATH 18,A01,083743,Staff,7,0,30,23
1650269395460,MATH 18,A02,083744,Staff,27,0,30,3
1650269395460,MATH 18,A03,083745,Staff,23,0,30,7
1650269395460,MATH 18,A04,083746,Staff,27,0,30,3
1650269395460,MATH 18,B01,083748,Staff,0,11,30,30
1650269395460,MATH 18,B02,083749,Staff,0,9,30,30
1650269395460,MATH 18,B03,083750,Staff,1,8,30,29
1650269395460,MATH 18,B04,083751,Staff,0,9,30,30
1650269401487,MATH 20A,A01,083754,Staff,26,0,40,14
1650269407515,MATH 20B,A01,083756,Staff,0,5,30,30
1650269407515,MATH 20B,A02,083757,Staff,0,7,30,30
1650269413542,MATH 20C,A01,083760,Staff,0,13,30,30
1650269413542,MATH 20C,A02,083761,Staff,0,13,30,30
1650269413542,MATH 20C,B01,083762,Staff,14,0,30,16
1650269413542,MATH 20C,B02,083763,Staff,28,0,30,2
1650269419568,MATH 20D,A01,083765,Staff,0,1,30,30
1650269419568,MATH 20D,A02,083766,Staff,8,0,30,22
1650269419568,MATH 20D,A03,083767,Staff,28,0,30,2
1650269425594,MATH 20E,A01,083771,Staff,6,0,30,24
1650269425594,MATH 20E,A02,083772,Staff,20,0,30,10
1650269425594,MATH 20E,B01,083773,Staff,0,0,30,30
1650269425594,MATH 20E,B02,083774,Staff,11,0,30,19
1650269431642,MATH 103A,A01,083777,Staff,0,9,30,30
1650269431642,MATH 103A,A02,083778,Staff,0,10,30,30
1650269431642,MATH 103A,B01,083779,Staff,0,10,30,30
1650269431642,MATH 103A,B02,083780,Staff,0,10,30,30
1650269437671,MATH 105,A01,085443,Staff,0,17,30,30
1650269443697,MATH 109,A01,083213,Anzaldo; Leesa B,0,5,30,30
1650269443697,MATH 109,A02,083214,Anzaldo; Leesa B,0,6,30,30
1650269443697,MATH 109,B01,083215,Anzaldo; Leesa B,0,4,30,30
1650269443697,MATH 109,B02,083216,Anzaldo; Leesa B,0,3,30,30
1650269449730,MATH 142A,A01,083219,Chow; Bennett,0,12,30,30
1650269449730,MATH 142A,A02,083220,Chow; Bennett,0,11,30,30
1650269449730,MATH 142A,B01,083221,Chow; Bennett,0,11,30,30
1650269449730,MATH 142A,B02,083222,Chow; Bennett,0,12,30,30
1650269455772,MATH 193A,A01,083224,Staff,0,5,30,30
1650269455772,MATH 193A,A02,083225,Staff,0,5,30,30
1650269455772,MATH 193A,A03,083781,Staff,0,2,30,30
1650269455772,MATH 193A,A04,083782,Staff,0,1,30,30
1650269461802,MATH 197,001,091859,McAuley; Julian John,9998,0,9999,1
1650269467934,COGS 9,A01,083615,Staff,0,14,60,60
1650269473956,COGS 11,A01,083617,Boyle; Mary E. T.,24,0,40,16
1650269479989,COGS 13,A01,083071,Staff,0,31,40,40
1650269486013,COGS 14A,A01,092681,Staff,0,14,100,100
1650269492038,COGS 14B,A01,083073,Cheng; Tzu-Han,0,9,50,50
1650269498065,COGS 17,A01,092677,Staff,29,0,75,46
1650269504165,COGS 100,A01,083619,Staff,0,22,60,60
1650269510190,COGS 101A,A01,083621,Davis; Joshua Daniel,0,21,60,60
1650269516219,COGS 101B,A01,091572,Staff,4,0,60,56
1650269522251,COGS 101C,A01,083625,Delgado; Tania,19,0,30,11
1650269528275,COGS 107A,A01,083627,Boyle; Mary E. T.,0,8,60,60
1650269534299,COGS 118A,A01,083075,Staff,13,0,60,47
1650269540328,CSE 3,A50,083646,Miranda; Gregory Joseph,22,0,38,16
1650269540328,CSE 3,A51,083647,Miranda; Gregory Joseph,37,0,37,0
1650269546351,CSE 8A,A50,083650,Miranda; Gregory Joseph,0,22,40,40
1650269552377,CSE 11,A01,083080,Cao; Yingjun,0,73,40,40
1650269558403,CSE 12,A01,083652,Staff,0,10,100,100
1650269564431,CSE 15L,A01,083654,Staff,0,1,50,50
1650269564431,CSE 15L,A02,083655,Staff,4,0,50,46
1650269570456,CSE 20,A01,083657,Staff,53,0,80,27
1650269576487,CSE 30,A01,083084,Eldon; John,0,74,40,40
1650269582514,CSE 100,A01,083659,Cao; Yingjun,0,64,50,50
1650269588538,CSE 134B,A01,083661,Powell; Thomas Allan,0,28,65,65
1650269594563,CSE 140,A01,083663,Staff,0,0,75,75
1650269600591,CSE 140L,A01,083088,Eldon; John,0,5,75,75
1650269606616,CSE 175,A01,083665,Kumar; Rakesh,8,0,25,17
1650269612643,CSE 190,A00,092507,Dubnov; Shlomo,14,0,20,6
1650269618674,ECE 45,A01,083139,Staff,0,15,40,40
1650269624701,ECE 65,A50,083695,Staff,0,4,30,30
1650269630732,ECE 109,A01,091882,Touri; Behrouz,45,0,70,25
1650269636761,ECE 180,A00,083140,Abi Samra; Nicholas Camill,24,0,30,6
1650269636761,ECE 180,B00,083141,Abi Samra; Nicholas Camill,7,0,30,23
1650269642787,MATH 10A,A01,083735,Patchell; Gregory David,11,0,30,19
1650269642787,MATH 10A,A02,083736,Patchell; Gregory David,28,0,30,2
1650269642787,MATH 10A,A03,083737,Patchell; Gregory David,26,0,30,4
1650269648820,MATH 10B,A01,083207,Staff,0,6,30,30
1650269648820,MATH 10B,A02,083208,Staff,0,6,30,30
1650269648820,MATH 10B,B01,083739,Staff,17,0,30,13
1650269648820,MATH 10B,B02,083740,Staff,29,0,30,1
1650269654848,MATH 18,A01,083743,Staff,7,0,30,23
1650269654848,MATH 18,A02,083744,Staff,27,0,30,3
1650269654848,MATH 18,A03,083745,Staff,23,0,30,7
1650269654848,MATH 18,A04,083746,Staff,27,0,30,3
1650269654848,MATH 18,B01,083748,Staff,0,11,30,30
1650269654848,MATH 18,B02,083749,Staff,0,9,30,30
1650269654848,MATH 18,B03,083750,Staff,1,8,30,29
1650269654848,MATH 18,B04,083751,Staff,0,9,30,30
1650269660873,MATH 20A,A01,083754,Staff,26,0,40,14
1650269666904,MATH 20B,A01,083756,Staff,0,5,30,30
1650269666904,MATH 20B,A02,083757,Staff,0,7,30,30
1650269672933,MATH 20C,A01,083760,Staff,0,13,30,30
1650269672933,MATH 20C,A02,083761,Staff,0,13,30,30
1650269672933,MATH 20C,B01,083762,Staff,14,0,30,16
1650269672933,MATH 20C,B02,083763,Staff,28,0,30,2
1650269678959,MATH 20D,A01,083765,Staff,0,1,30,30
1650269678959,MATH 20D,A02,083766,Staff,8,0,30,22
1650269678959,MATH 20D,A03,083767,Staff,28,0,30,2
1650269684986,MATH 20E,A01,083771,Staff,6,0,30,24
1650269684986,MATH 20E,A02,083772,Staff,20,0,30,10
1650269684986,MATH 20E,B01,083773,Staff,0,0,30,30
1650269684986,MATH 20E,B02,083774,Staff,11,0,30,19
1650269691021,MATH 103A,A01,083777,Staff,0,9,30,30
1650269691021,MATH 103A,A02,083778,Staff,0,10,30,30
1650269691021,MATH 103A,B01,083779,Staff,0,10,30,30
1650269691021,MATH 103A,B02,083780,Staff,0,10,30,30
1650269697048,MATH 105,A01,085443,Staff,0,17,30,30
1650269703075,MATH 109,A01,083213,Anzaldo; Leesa B,0,5,30,30
1650269703075,MATH 109,A02,083214,Anzaldo; Leesa B,0,6,30,30
1650269703075,MATH 109,B01,083215,Anzaldo; Leesa B,0,4,30,30
1650269703075,MATH 109,B02,083216,Anzaldo; Leesa B,0,3,30,30
1650269709105,MATH 142A,A01,083219,Chow; Bennett,0,12,30,30
1650269709105,MATH 142A,A02,083220,Chow; Bennett,0,11,30,30
1650269709105,MATH 142A,B01,083221,Chow; Bennett,0,11,30,30
1650269709105,MATH 142A,B02,083222,Chow; Bennett,0,12,30,30
1650269715131,MATH 193A,A01,083224,Staff,0,5,30,30
1650269715131,MATH 193A,A02,083225,Staff,0,5,30,30
1650269715131,MATH 193A,A03,083781,Staff,0,2,30,30
1650269715131,MATH 193A,A04,083782,Staff,0,1,30,30
1650269721155,MATH 197,001,091859,McAuley; Julian John,9998,0,9999,1
1650269727232,COGS 9,A01,083615,Staff,0,14,60,60
1650269733258,COGS 11,A01,083617,Boyle; Mary E. T.,24,0,40,16
1650269739281,COGS 13,A01,083071,Staff,0,31,40,40
1650269745306,COGS 14A,A01,092681,Staff,0,14,100,100
1650269751334,COGS 14B,A01,083073,Cheng; Tzu-Han,0,9,50,50
1650269757358,COGS 17,A01,092677,Staff,29,0,75,46
1650269763383,COGS 100,A01,083619,Staff,0,22,60,60
1650269769407,COGS 101A,A01,083621,Davis; Joshua Daniel,0,21,60,60
1650269775430,COGS 101B,A01,091572,Staff,4,0,60,56
1650269781464,COGS 101C,A01,083625,Delgado; Tania,19,0,30,11
1650269787493,COGS 107A,A01,083627,Boyle; Mary E. T.,0,8,60,60
1650269793518,COGS 118A,A01,083075,Staff,13,0,60,47
1650269799550,CSE 3,A50,083646,Miranda; Gregory Joseph,22,0,38,16
1650269799550,CSE 3,A51,083647,Miranda; Gregory Joseph,37,0,37,0
1650269805582,CSE 8A,A50,083650,Miranda; Gregory Joseph,0,22,40,40
1650269811606,CSE 11,A01,083080,Cao; Yingjun,0,73,40,40
1650269817629,CSE 12,A01,083652,Staff,0,10,100,100
1650269823653,CSE 15L,A01,083654,Staff,0,1,50,50
1650269823653,CSE 15L,A02,083655,Staff,4,0,50,46
1650269829679,CSE 20,A01,083657,Staff,53,0,80,27
1650269835705,CSE 30,A01,083084,Eldon; John,0,74,40,40
1650269841730,CSE 100,A01,083659,Cao; Yingjun,0,64,50,50
1650269847755,CSE 134B,A01,083661,Powell; Thomas Allan,0,29,65,65
1650269853778,CSE 140,A01,083663,Staff,0,0,75,75
1650269859808,CSE 140L,A01,083088,Eldon; John,0,5,75,75
1650269865832,CSE 175,A01,083665,Kumar; Rakesh,8,0,25,17
1650269871863,CSE 190,A00,092507,Dubnov; Shlomo,14,0,20,6
1650269877893,ECE 45,A01,083139,Staff,0,15,40,40
1650269883919,ECE 65,A50,083695,Staff,0,4,30,30
1650269889945,ECE 109,A01,091882,Touri; Behrouz,45,0,70,25
1650269895974,ECE 180,A00,083140,Abi Samra; Nicholas Camill,24,0,30,6
1650269895974,ECE 180,B00,083141,Abi Samra; Nicholas Camill,7,0,30,23
1650269901999,MATH 10A,A01,083735,Patchell; Gregory David,11,0,30,19
1650269901999,MATH 10A,A02,083736,Patchell; Gregory David,28,0,30,2
1650269901999,MATH 10A,A03,083737,Patchell; Gregory David,26,0,30,4
1650269908023,MATH 10B,A01,083207,Staff,0,6,30,30
1650269908023,MATH 10B,A02,083208,Staff,0,6,30,30
1650269908023,MATH 10B,B01,083739,Staff,17,0,30,13
1650269908023,MATH 10B,B02,083740,Staff,29,0,30,1
1650269914064,MATH 18,A01,083743,Staff,7,0,30,23
1650269914064,MATH 18,A02,083744,Staff,27,0,30,3
1650269914064,MATH 18,A03,083745,Staff,23,0,30,7
1650269914064,MATH 18,A04,083746,Staff,27,0,30,3
1650269914064,MATH 18,B01,083748,Staff,0,11,30,30
1650269914064,MATH 18,B02,083749,Staff,0,9,30,30
1650269914064,MATH 18,B03,083750,Staff,1,8,30,29
1650269914064,MATH 18,B04,083751,Staff,0,9,30,30
1650269920091,MATH 20A,A01,083754,Staff,26,0,40,14
1650269926126,MATH 20B,A01,083756,Staff,0,5,30,30
1650269926126,MATH 20B,A02,083757,Staff,0,7,30,30
1650269932151,MATH 20C,A01,083760,Staff,0,13,30,30
1650269932151,MATH 20C,A02,083761,Staff,0,13,30,30
1650269932151,MATH 20C,B01,083762,Staff,14,0,30,16
1650269932151,MATH 20C,B02,083763,Staff,28,0,30,2
1650269938177,MATH 20D,A01,083765,Staff,0,1,30,30
1650269938177,MATH 20D,A02,083766,Staff,8,0,30,22
1650269938177,MATH 20D,A03,083767,Staff,28,0,30,2
1650269944211,MATH 20E,A01,083771,Staff,6,0,30,24
1650269944211,MATH 20E,A02,083772,Staff,20,0,30,10
1650269944211,MATH 20E,B01,083773,Staff,0,0,30,30
1650269944211,MATH 20E,B02,083774,Staff,11,0,30,19
1650269950244,MATH 103A,A01,083777,Staff,0,9,30,30
1650269950244,MATH 103A,A02,083778,Staff,0,10,30,30
1650269950244,MATH 103A,B01,083779,Staff,0,10,30,30
1650269950244,MATH 103A,B02,083780,Staff,0,10,30,30
1650269956268,MATH 105,A01,085443,Staff,0,17,30,30
1650269962293,MATH 109,A01,083213,Anzaldo; Leesa B,0,5,30,30
1650269962293,MATH 109,A02,083214,Anzaldo; Leesa B,0,6,30,30
1650269962293,MATH 109,B01,083215,Anzaldo; Leesa B,0,4,30,30
1650269962293,MATH 109,B02,083216,Anzaldo; Leesa B,0,3,30,30
1650269968329,MATH 142A,A01,083219,Chow; Bennett,0,12,30,30
1650269968329,MATH 142A,A02,083220,Chow; Bennett,0,11,30,30
1650269968329,MATH 142A,B01,083221,Chow; Bennett,0,11,30,30
1650269968329,MATH 142A,B02,083222,Chow; Bennett,0,12,30,30
1650269974359,MATH 193A,A01,083224,Staff,0,5,30,30
1650269974359,MATH 193A,A02,083225,Staff,0,5,30,30
1650269974359,MATH 193A,A03,083781,Staff,0,2,30,30
1650269974359,MATH 193A,A04,083782,Staff,0,1,30,30
1650269980384,MATH 197,001,091859,McAuley; Julian John,9998,0,9999,1
1650269986445,COGS 9,A01,083615,Staff,0,14,60,60
1650269992474,COGS 11,A01,083617,Boyle; Mary E. T.,24,0,40,16
1650269998500,COGS 13,A01,083071,Staff,0,31,40,40
1650270004527,COGS 14A,A01,092681,Staff,0,14,100,100
1650270010552,COGS 14B,A01,083073,Cheng; Tzu-Han,0,9,50,50
1650270016581,COGS 17,A01,092677,Staff,29,0,75,46
1650270022617,COGS 100,A01,083619,Staff,0,22,60,60
1650270028641,COGS 101A,A01,083621,Davis; Joshua Daniel,0,21,60,60
1650270034667,COGS 101B,A01,091572,Staff,4,0,60,56
1650270040697,COGS 101C,A01,083625,Delgado; Tania,19,0,30,11
1650270046724,COGS 107A,A01,083627,Boyle; Mary E. T.,0,8,60,60
1650270052749,COGS 118A,A01,083075,Staff,13,0,60,47
1650270058779,CSE 3,A50,083646,Miranda; Gregory Joseph,22,0,38,16
1650270058779,CSE 3,A51,083647,Miranda; Gregory Joseph,37,0,37,0
1650270064811,CSE 8A,A50,083650,Miranda; Gregory Joseph,0,22,40,40
1650270070841,CSE 11,A01,083080,Cao; Yingjun,0,73,40,40
1650270076871,CSE 12,A01,083652,Staff,0,10,100,100
1650270082900,CSE 15L,A01,083654,Staff,0,1,50,50
1650270082900,CSE 15L,A02,083655,Staff,4,0,50,46
1650270088928,CSE 20,A01,083657,Staff,53,0,80,27
1650270094954,CSE 30,A01,083084,Eldon; John,0,74,40,40
1650270101069,CSE 100,A01,083659,Cao; Yingjun,0,64,50,50
1650270107094,CSE 134B,A01,083661,Powell; Thomas Allan,0,29,65,65
1650270113120,CSE 140,A01,083663,Staff,0,0,75,75
1650270119149,CSE 140L,A01,083088,Eldon; John,0,5,75,75
1650270125175,CSE 175,A01,083665,Kumar; Rakesh,8,0,25,17
1650270131213,CSE 190,A00,092507,Dubnov; Shlomo,14,0,20,6
1650270137243,ECE 45,A01,083139,Staff,0,15,40,40
1650270143269,ECE 65,A50,083695,Staff,0,4,30,30
1650270149296,ECE 109,A01,091882,Touri; Behrouz,45,0,70,25
1650270155322,ECE 180,A00,083140,Abi Samra; Nicholas Camill,24,0,30,6
1650270155322,ECE 180,B00,083141,Abi Samra; Nicholas Camill,7,0,30,23
1650270161357,MATH 10A,A01,083735,Patchell; Gregory David,11,0,30,19
1650270161357,MATH 10A,A02,083736,Patchell; Gregory David,28,0,30,2
1650270161357,MATH 10A,A03,083737,Patchell; Gregory David,26,0,30,4
1650270167391,MATH 10B,A01,083207,Staff,0,6,30,30
1650270167391,MATH 10B,A02,083208,Staff,0,6,30,30
1650270167391,MATH 10B,B01,083739,Staff,17,0,30,13
1650270167391,MATH 10B,B02,083740,Staff,29,0,30,1
1650270173418,MATH 18,A01,083743,Staff,7,0,30,23
1650270173418,MATH 18,A02,083744,Staff,27,0,30,3
1650270173418,MATH 18,A03,083745,Staff,23,0,30,7
1650270173418,MATH 18,A04,083746,Staff,27,0,30,3
1650270173418,MATH 18,B01,083748,Staff,0,11,30,30
1650270173418,MATH 18,B02,083749,Staff,0,9,30,30
1650270173418,MATH 18,B03,083750,Staff,1,8,30,29
1650270173418,MATH 18,B04,083751,Staff,0,9,30,30
1650270179443,MATH 20A,A01,083754,Staff,26,0,40,14
1650270185470,MATH 20B,A01,083756,Staff,0,5,30,30
1650270185470,MATH 20B,A02,083757,Staff,0,7,30,30
1650270191497,MATH 20C,A01,083760,Staff,0,13,30,30
1650270191497,MATH 20C,A02,083761,Staff,0,13,30,30
1650270191497,MATH 20C,B01,083762,Staff,14,0,30,16
1650270191497,MATH 20C,B02,083763,Staff,28,0,30,2
1650270197526,MATH 20D,A01,083765,Staff,0,1,30,30
1650270197526,MATH 20D,A02,083766,Staff,8,0,30,22
1650270197526,MATH 20D,A03,083767,Staff,28,0,30,2
1650270203551,MATH 20E,A01,083771,Staff,6,0,30,24
1650270203551,MATH 20E,A02,083772,Staff,20,0,30,10
1650270203551,MATH 20E,B01,083773,Staff,0,0,30,30
1650270203551,MATH 20E,B02,083774,Staff,10,0,30,20
1650270209593,MATH 103A,A01,083777,Staff,0,9,30,30
1650270209593,MATH 103A,A02,083778,Staff,0,10,30,30
1650270209593,MATH 103A,B01,083779,Staff,0,10,30,30
1650270209593,MATH 103A,B02,083780,Staff,0,10,30,30
1650270215620,MATH 105,A01,085443,Staff,0,17,30,30
1650270221650,MATH 109,A01,083213,Anzaldo; Leesa B,0,5,30,30
1650270221650,MATH 109,A02,083214,Anzaldo; Leesa B,0,6,30,30
1650270221650,MATH 109,B01,083215,Anzaldo; Leesa B,0,4,30,30
1650270221650,MATH 109,B02,083216,Anzaldo; Leesa B,0,3,30,30
1650270227676,MATH 142A,A01,083219,Chow; Bennett,0,12,30,30
1650270227676,MATH 142A,A02,083220,Chow; Bennett,0,11,30,30
1650270227676,MATH 142A,B01,083221,Chow; Bennett,0,11,30,30
1650270227676,MATH 142A,B02,083222,Chow; Bennett,0,12,30,30
1650270233701,MATH 193A,A01,083224,Staff,0,5,30,30
1650270233701,MATH 193A,A02,083225,Staff,0,5,30,30
1650270233701,MATH 193A,A03,083781,Staff,0,2,30,30
1650270233701,MATH 193A,A04,083782,Staff,0,1,30,30
1650270239729,MATH 197,001,091859,McAuley; Julian John,9998,0,9999,1
1650270245802,COGS 9,A01,083615,Staff,0,14,60,60
1650270251827,COGS 11,A01,083617,Boyle; Mary E. T.,24,0,40,16
1650270257854,COGS 13,A01,083071,Staff,0,31,40,40
1650270263882,COGS 14A,A01,092681,Staff,0,14,100,100
1650270269913,COGS 14B,A01,083073,Cheng; Tzu-Han,0,9,50,50
1650270275940,COGS 17,A01,092677,Staff,29,0,75,46
1650270281967,COGS 100,A01,083619,Staff,0,22,60,60
1650270287996,COGS 101A,A01,083621,Davis; Joshua Daniel,0,21,60,60
1650270294027,COGS 101B,A01,091572,Staff,4,0,60,56
1650270300052,COGS 101C,A01,083625,Delgado; Tania,19,0,30,11
1650270306076,COGS 107A,A01,083627,Boyle; Mary E. T.,0,8,60,60
1650270312103,COGS 118A,A01,083075,Staff,13,0,60,47
1650270318129,CSE 3,A50,083646,Miranda; Gregory Joseph,22,0,38,16
1650270318129,CSE 3,A51,083647,Miranda; Gregory Joseph,37,0,37,0
1650270324154,CSE 8A,A50,083650,Miranda; Gregory Joseph,0,22,40,40
1650270330181,CSE 11,A01,083080,Cao; Yingjun,0,73,40,40
1650270336206,CSE 12,A01,083652,Staff,0,10,100,100
1650270342234,CSE 15L,A01,083654,Staff,0,1,50,50
1650270342234,CSE 15L,A02,083655,Staff,4,0,50,46
1650270348257,CSE 20,A01,083657,Staff,53,0,80,27
1650270354286,CSE 30,A01,083084,Eldon; John,0,74,40,40
1650270360316,CSE 100,A01,083659,Cao; Yingjun,0,64,50,50
1650270366341,CSE 134B,A01,083661,Powell; Thomas Allan,0,29,65,65
1650270372370,CSE 140,A01,083663,Staff,0,0,75,75
1650270378395,CSE 140L,A01,083088,Eldon; John,0,5,75,75
1650270384424,CSE 175,A01,083665,Kumar; Rakesh,8,0,25,17
1650270390454,CSE 190,A00,092507,Dubnov; Shlomo,14,0,20,6
1650270396481,ECE 45,A01,083139,Staff,0,15,40,40
1650270402505,ECE 65,A50,083695,Staff,0,4,30,30
1650270408529,ECE 109,A01,091882,Touri; Behrouz,45,0,70,25
1650270414553,ECE 180,A00,083140,Abi Samra; Nicholas Camill,24,0,30,6
1650270414553,ECE 180,B00,083141,Abi Samra; Nicholas Camill,7,0,30,23
1650270420579,MATH 10A,A01,083735,Patchell; Gregory David,11,0,30,19
1650270420579,MATH 10A,A02,083736,Patchell; Gregory David,28,0,30,2
1650270420579,MATH 10A,A03,083737,Patchell; Gregory David,26,0,30,4
1650270426609,MATH 10B,A01,083207,Staff,0,6,30,30
1650270426609,MATH 10B,A02,083208,Staff,0,6,30,30
1650270426609,MATH 10B,B01,083739,Staff,17,0,30,13
1650270426609,MATH 10B,B02,083740,Staff,29,0,30,1
1650270432634,MATH 18,A01,083743,Staff,7,0,30,23
1650270432634,MATH 18,A02,083744,Staff,27,0,30,3
1650270432634,MATH 18,A03,083745,Staff,23,0,30,7
1650270432634,MATH 18,A04,083746,Staff,27,0,30,3
1650270432634,MATH 18,B01,083748,Staff,0,11,30,30
1650270432634,MATH 18,B02,083749,Staff,0,9,30,30
1650270432634,MATH 18,B03,083750,Staff,1,8,30,29
1650270432634,MATH 18,B04,083751,Staff,0,9,30,30
1650270438661,MATH 20A,A01,083754,Staff,26,0,40,14
1650270444692,MATH 20B,A01,083756,Staff,0,5,30,30
1650270444692,MATH 20B,A02,083757,Staff,0,7,30,30
1650270450717,MATH 20C,A01,083760,Staff,0,13,30,30
1650270450717,MATH 20C,A02,083761,Staff,0,13,30,30
1650270450717,MATH 20C,B01,083762,Staff,14,0,30,16
1650270450717,MATH 20C,B02,083763,Staff,28,0,30,2
1650270456745,MATH 20D,A01,083765,Staff,0,1,30,30
1650270456745,MATH 20D,A02,083766,Staff,8,0,30,22
1650270456745,MATH 20D,A03,083767,Staff,28,0,30,2
1650270462770,MATH 20E,A01,083771,Staff,6,0,30,24
1650270462770,MATH 20E,A02,083772,Staff,20,0,30,10
1650270462770,MATH 20E,B01,083773,Staff,0,0,30,30
1650270462770,MATH 20E,B02,083774,Staff,11,0,30,19
1650270468801,MATH 103A,A01,083777,Staff,0,9,30,30
1650270468801,MATH 103A,A02,083778,Staff,0,10,30,30
1650270468801,MATH 103A,B01,083779,Staff,0,10,30,30
1650270468801,MATH 103A,B02,083780,Staff,0,10,30,30
1650270474830,MATH 105,A01,085443,Staff,0,17,30,30
1650270480854,MATH 109,A01,083213,Anzaldo; Leesa B,0,5,30,30
1650270480854,MATH 109,A02,083214,Anzaldo; Leesa B,0,6,30,30
1650270480854,MATH 109,B01,083215,Anzaldo; Leesa B,0,4,30,30
1650270480854,MATH 109,B02,083216,Anzaldo; Leesa B,0,3,30,30
1650270486885,MATH 142A,A01,083219,Chow; Bennett,0,12,30,30
1650270486885,MATH 142A,A02,083220,Chow; Bennett,0,11,30,30
1650270486885,MATH 142A,B01,083221,Chow; Bennett,0,11,30,30
1650270486885,MATH 142A,B02,083222,Chow; Bennett,0,12,30,30
1650270492910,MATH 193A,A01,083224,Staff,0,5,30,30
1650270492910,MATH 193A,A02,083225,Staff,0,5,30,30
1650270492910,MATH 193A,A03,083781,Staff,0,2,30,30
1650270492910,MATH 193A,A04,083782,Staff,0,1,30,30
1650270498935,MATH 197,001,091859,McAuley; Julian John,9998,0,9999,1
1650270504990,COGS 9,A01,083615,Staff,0,14,60,60
1650270511024,COGS 11,A01,083617,Boyle; Mary E. T.,24,0,40,16
1650270517053,COGS 13,A01,083071,Staff,0,31,40,40
1650270523077,COGS 14A,A01,092681,Staff,0,15,100,100
1650270529102,COGS 14B,A01,083073,Cheng; Tzu-Han,0,9,50,50
1650270535124,COGS 17,A01,092677,Staff,29,0,75,46
1650270541152,COGS 100,A01,083619,Staff,0,23,60,60
1650270547180,COGS 101A,A01,083621,Davis; Joshua Daniel,0,21,60,60
1650270553205,COGS 101B,A01,091572,Staff,4,0,60,56
1650270559229,COGS 101C,A01,083625,Delgado; Tania,19,0,30,11
1650270565254,COGS 107A,A01,083627,Boyle; Mary E. T.,0,8,60,60
1650270571281,COGS 118A,A01,083075,Staff,13,0,60,47
1650270577306,CSE 3,A50,083646,Miranda; Gregory Joseph,22,0,38,16
1650270577306,CSE 3,A51,083647,Miranda; Gregory Joseph,37,0,37,0
1650270583334,CSE 8A,A50,083650,Miranda; Gregory Joseph,0,22,40,40
1650270589357,CSE 11,A01,083080,Cao; Yingjun,0,73,40,40
1650270595380,CSE 12,A01,083652,Staff,0,10,100,100
1650270601404,CSE 15L,A01,083654,Staff,0,1,50,50
1650270601404,CSE 15L,A02,083655,Staff,4,0,50,46
1650270607467,CSE 20,A01,083657,Staff,53,0,80,27
1650270613491,CSE 30,A01,083084,Eldon; John,0,74,40,40
1650270619514,CSE 100,A01,083659,Cao; Yingjun,0,65,50,50
1650270625537,CSE 134B,A01,083661,Powell; Thomas Allan,0,28,65,65
1650270631562,CSE 140,A01,083663,Staff,0,0,75,75
1650270637594,CSE 140L,A01,083088,Eldon; John,0,5,75,75
1650270643618,CSE 175,A01,083665,Kumar; Rakesh,8,0,25,17
1650270649659,CSE 190,A00,092507,Dubnov; Shlomo,14,0,20,6
1650270655683,ECE 45,A01,083139,Staff,0,15,40,40
1650270661712,ECE 65,A50,083695,Staff,0,4,30,30
1650270667738,ECE 109,A01,091882,Touri; Behrouz,45,0,70,25
1650270673762,ECE 180,A00,083140,Abi Samra; Nicholas Camill,24,0,30,6
1650270673762,ECE 180,B00,083141,Abi Samra; Nicholas Camill,7,0,30,23
1650270679788,MATH 10A,A01,083735,Patchell; Gregory David,11,0,30,19
1650270679788,MATH 10A,A02,083736,Patchell; Gregory David,28,0,30,2
1650270679788,MATH 10A,A03,083737,Patchell; Gregory David,26,0,30,4
1650270685813,MATH 10B,A01,083207,Staff,0,6,30,30
1650270685813,MATH 10B,A02,083208,Staff,0,6,30,30
1650270685813,MATH 10B,B01,083739,Staff,17,0,30,13
1650270685813,MATH 10B,B02,083740,Staff,29,0,30,1
1650270691839,MATH 18,A01,083743,Staff,7,0,30,23
1650270691839,MATH 18,A02,083744,Staff,27,0,30,3
1650270691839,MATH 18,A03,083745,Staff,23,0,30,7
1650270691839,MATH 18,A04,083746,Staff,27,0,30,3
1650270691839,MATH 18,B01,083748,Staff,0,11,30,30
1650270691839,MATH 18,B02,083749,Staff,0,9,30,30
1650270691839,MATH 18,B03,083750,Staff,1,8,30,29
1650270691839,MATH 18,B04,083751,Staff,0,9,30,30
1650270697939,MATH 20A,A01,083754,Staff,26,0,40,14
1650270703968,MATH 20B,A01,083756,Staff,0,5,30,30
1650270703968,MATH 20B,A02,083757,Staff,0,7,30,30
1650270709994,MATH 20C,A01,083760,Staff,0,13,30,30
1650270709994,MATH 20C,A02,083761,Staff,0,13,30,30
1650270709994,MATH 20C,B01,083762,Staff,14,0,30,16
1650270709994,MATH 20C,B02,083763,Staff,28,0,30,2
1650270716022,MATH 20D,A01,083765,Staff,0,1,30,30
1650270716022,MATH 20D,A02,083766,Staff,8,0,30,22
1650270716022,MATH 20D,A03,083767,Staff,28,0,30,2
1650270722047,MATH 20E,A01,083771,Staff,6,0,30,24
1650270722047,MATH 20E,A02,083772,Staff,20,0,30,10
1650270722047,MATH 20E,B01,083773,Staff,0,0,30,30
1650270722047,MATH 20E,B02,083774,Staff,11,0,30,19
1650270728078,MATH 103A,A01,083777,Staff,0,9,30,30
1650270728078,MATH 103A,A02,083778,Staff,0,10,30,30
1650270728078,MATH 103A,B01,083779,Staff,0,10,30,30
1650270728078,MATH 103A,B02,083780,Staff,0,10,30,30
1650270734102,MATH 105,A01,085443,Staff,0,17,30,30
1650270740131,MATH 109,A01,083213,Anzaldo; Leesa B,0,5,30,30
1650270740131,MATH 109,A02,083214,Anzaldo; Leesa B,0,6,30,30
1650270740131,MATH 109,B01,083215,Anzaldo; Leesa B,0,4,30,30
1650270740131,MATH 109,B02,083216,Anzaldo; Leesa B,0,3,30,30
1650270746156,MATH 142A,A01,083219,Chow; Bennett,0,12,30,30
1650270746156,MATH 142A,A02,083220,Chow; Bennett,0,11,30,30
1650270746156,MATH 142A,B01,083221,Chow; Bennett,0,11,30,30
1650270746156,MATH 142A,B02,083222,Chow; Bennett,0,12,30,30
1650270752180,MATH 193A,A01,083224,Staff,0,5,30,30
1650270752180,MATH 193A,A02,083225,Staff,0,5,30,30
1650270752180,MATH 193A,A03,083781,Staff,0,2,30,30
1650270752180,MATH 193A,A04,083782,Staff,0,1,30,30
1650270758207,MATH 197,001,091859,McAuley; Julian John,9998,0,9999,1
1650270764278,COGS 9,A01,083615,Staff,0,14,60,60
1650270770302,COGS 11,A01,083617,Boyle; Mary E. T.,24,0,40,16
1650270776328,COGS 13,A01,083071,Staff,0,31,40,40
1650270782353,COGS 14A,A01,092681,Staff,0,15,100,100
1650270788377,COGS 14B,A01,083073,Cheng; Tzu-Han,0,9,50,50
1650270794401,COGS 17,A01,092677,Staff,29,0,75,46
1650270800428,COGS 100,A01,083619,Staff,0,23,60,60
1650270806451,COGS 101A,A01,083621,Davis; Joshua Daniel,0,21,60,60
1650270812474,COGS 101B,A01,091572,Staff,4,0,60,56
1650270818498,COGS 101C,A01,083625,Delgado; Tania,19,0,30,11
1650270824524,COGS 107A,A01,083627,Boyle; Mary E. T.,0,8,60,60
1650270830553,COGS 118A,A01,083075,Staff,13,0,60,47
1650270836576,CSE 3,A50,083646,Miranda; Gregory Joseph,22,0,38,16
1650270836576,CSE 3,A51,083647,Miranda; Gregory Joseph,37,0,37,0
1650270842603,CSE 8A,A50,083650,Miranda; Gregory Joseph,0,22,40,40
1650270848632,CSE 11,A01,083080,Cao; Yingjun,0,73,40,40
1650270854661,CSE 12,A01,083652,Staff,0,10,100,100
1650270860685,CSE 15L,A01,083654,Staff,0,1,50,50
1650270860685,CSE 15L,A02,083655,Staff,4,0,50,46
1650270866709,CSE 20,A01,083657,Staff,53,0,80,27
1650270872732,CSE 30,A01,083084,Eldon; John,0,74,40,40
1650270878759,CSE 100,A01,083659,Cao; Yingjun,0,65,50,50
1650270884799,CSE 134B,A01,083661,Powell; Thomas Allan,0,28,65,65
1650270890823,CSE 140,A01,083663,Staff,0,0,75,75
1650270896846,CSE 140L,A01,083088,Eldon; John,0,5,75,75
1650270902870,CSE 175,A01,083665,Kumar; Rakesh,8,0,25,17
1650270908892,CSE 190,A00,092507,Dubnov; Shlomo,14,0,20,6
1650270914918,ECE 45,A01,083139,Staff,0,15,40,40
1650270920943,ECE 65,A50,083695,Staff,0,4,30,30
1650270926969,ECE 109,A01,091882,Touri; Behrouz,45,0,70,25
1650270932992,ECE 180,A00,083140,Abi Samra; Nicholas Camill,24,0,30,6
1650270932992,ECE 180,B00,083141,Abi Samra; Nicholas Camill,7,0,30,23
1650270939016,MATH 10A,A01,083735,Patchell; Gregory David,11,0,30,19
1650270939016,MATH 10A,A02,083736,Patchell; Gregory David,28,0,30,2
1650270939016,MATH 10A,A03,083737,Patchell; Gregory David,26,0,30,4
1650270945041,MATH 10B,A01,083207,Staff,0,6,30,30
1650270945041,MATH 10B,A02,083208,Staff,0,6,30,30
1650270945041,MATH 10B,B01,083739,Staff,17,0,30,13
1650270945041,MATH 10B,B02,083740,Staff,29,0,30,1
1650270951074,MATH 18,A01,083743,Staff,7,0,30,23
1650270951074,MATH 18,A02,083744,Staff,27,0,30,3
1650270951074,MATH 18,A03,083745,Staff,23,0,30,7
1650270951074,MATH 18,A04,083746,Staff,27,0,30,3
1650270951074,MATH 18,B01,083748,Staff,0,11,30,30
1650270951074,MATH 18,B02,083749,Staff,0,9,30,30
1650270951074,MATH 18,B03,083750,Staff,1,8,30,29
1650270951074,MATH 18,B04,083751,Staff,0,9,30,30
1650270957101,MATH 20A,A01,083754,Staff,26,0,40,14
1650270963129,MATH 20B,A01,083756,Staff,0,5,30,30
1650270963129,MATH 20B,A02,083757,Staff,0,7,30,30
1650270969153,MATH 20C,A01,083760,Staff,0,13,30,30
1650270969153,MATH 20C,A02,083761,Staff,0,13,30,30
1650270969153,MATH 20C,B01,083762,Staff,14,0,30,16
1650270969153,MATH 20C,B02,083763,Staff,28,0,30,2
1650270975177,MATH 20D,A01,083765,Staff,0,1,30,30
1650270975177,MATH 20D,A02,083766,Staff,8,0,30,22
1650270975177,MATH 20D,A03,083767,Staff,28,0,30,2
1650270981203,MATH 20E,A01,083771,Staff,6,0,30,24
1650270981203,MATH 20E,A02,083772,Staff,20,0,30,10
1650270981203,MATH 20E,B01,083773,Staff,0,0,30,30
1650270981203,MATH 20E,B02,083774,Staff,11,0,30,19
1650270987225,MATH 103A,A01,083777,Staff,0,9,30,30
1650270987225,MATH 103A,A02,083778,Staff,0,10,30,30
1650270987225,MATH 103A,B01,083779,Staff,0,10,30,30
1650270987225,MATH 103A,B02,083780,Staff,0,10,30,30
1650270993248,MATH 105,A01,085443,Staff,0,17,30,30
1650270999277,MATH 109,A01,083213,Anzaldo; Leesa B,0,5,30,30
1650270999277,MATH 109,A02,083214,Anzaldo; Leesa B,0,6,30,30
1650270999277,MATH 109,B01,083215,Anzaldo; Leesa B,0,4,30,30
1650270999277,MATH 109,B02,083216,Anzaldo; Leesa B,0,3,30,30
1650271005305,MATH 142A,A01,083219,Chow; Bennett,0,12,30,30
1650271005305,MATH 142A,A02,083220,Chow; Bennett,0,11,30,30
1650271005305,MATH 142A,B01,083221,Chow; Bennett,0,11,30,30
1650271005305,MATH 142A,B02,083222,Chow; Bennett,0,12,30,30
1650271011334,MATH 193A,A01,083224,Staff,0,5,30,30
1650271011334,MATH 193A,A02,083225,Staff,0,5,30,30
1650271011334,MATH 193A,A03,083781,Staff,0,2,30,30
1650271011334,MATH 193A,A04,083782,Staff,0,1,30,30
1650271017359,MATH 197,001,091859,McAuley; Julian John,9998,0,9999,1
1650271023406,COGS 9,A01,083615,Staff,0,14,60,60
1650271029430,COGS 11,A01,083617,Boyle; Mary E. T.,24,0,40,16
1650271035455,COGS 13,A01,083071,Staff,0,31,40,40
1650271041479,COGS 14A,A01,092681,Staff,0,15,100,100
1650271047505,COGS 14B,A01,083073,Cheng; Tzu-Han,0,9,50,50
1650271053531,COGS 17,A01,092677,Staff,29,0,75,46
1650271059557,COGS 100,A01,083619,Staff,0,23,60,60
1650271065584,COGS 101A,A01,083621,Davis; Joshua Daniel,0,21,60,60
1650271071608,COGS 101B,A01,091572,Staff,4,0,60,56
1650271077632,COGS 101C,A01,083625,Delgado; Tania,19,0,30,11
1650271083656,COGS 107A,A01,083627,Boyle; Mary E. T.,0,8,60,60
1650271089678,COGS 118A,A01,083075,Staff,13,0,60,47
1650271095701,CSE 3,A50,083646,Miranda; Gregory Joseph,22,0,38,16
1650271095701,CSE 3,A51,083647,Miranda; Gregory Joseph,37,0,37,0
1650271101728,CSE 8A,A50,083650,Miranda; Gregory Joseph,0,22,40,40
1650271107754,CSE 11,A01,083080,Cao; Yingjun,0,73,40,40
1650271113777,CSE 12,A01,083652,Staff,0,10,100,100
1650271119801,CSE 15L,A01,083654,Staff,0,1,50,50
1650271119801,CSE 15L,A02,083655,Staff,4,0,50,46
1650271125825,CSE 20,A01,083657,Staff,53,0,80,27
1650271131849,CSE 30,A01,083084,Eldon; John,0,74,40,40
1650271137881,CSE 100,A01,083659,Cao; Yingjun,0,65,50,50
1650271143907,CSE 134B,A01,083661,Powell; Thomas Allan,0,28,65,65
1650271149930,CSE 140,A01,083663,Staff,0,0,75,75
1650271155955,CSE 140L,A01,083088,Eldon; John,0,5,75,75
1650271161981,CSE 175,A01,083665,Kumar; Rakesh,8,0,25,17
1650271168009,CSE 190,A00,092507,Dubnov; Shlomo,14,0,20,6
1650271174033,ECE 45,A01,083139,Staff,0,15,40,40
1650271180062,ECE 65,A50,083695,Staff,0,4,30,30
1650271186086,ECE 109,A01,091882,Touri; Behrouz,45,0,70,25
1650271192107,ECE 180,A00,083140,Abi Samra; Nicholas Camill,24,0,30,6
1650271192107,ECE 180,B00,083141,Abi Samra; Nicholas Camill,7,0,30,23
1650271198133,MATH 10A,A01,083735,Patchell; Gregory David,11,0,30,19
1650271198133,MATH 10A,A02,083736,Patchell; Gregory David,28,0,30,2
1650271198133,MATH 10A,A03,083737,Patchell; Gregory David,26,0,30,4
1650271204158,MATH 10B,A01,083207,Staff,0,6,30,30
1650271204158,MATH 10B,A02,083208,Staff,0,6,30,30
1650271204158,MATH 10B,B01,083739,Staff,17,0,30,13
1650271204158,MATH 10B,B02,083740,Staff,29,0,30,1
1650271210189,MATH 18,A01,083743,Staff,7,0,30,23
1650271210189,MATH 18,A02,083744,Staff,27,0,30,3
1650271210189,MATH 18,A03,083745,Staff,23,0,30,7
1650271210189,MATH 18,A04,083746,Staff,27,0,30,3
1650271210189,MATH 18,B01,083748,Staff,0,11,30,30
1650271210189,MATH 18,B02,083749,Staff,0,9,30,30
1650271210189,MATH 18,B03,083750,Staff,1,8,30,29
1650271210189,MATH 18,B04,083751,Staff,0,9,30,30
1650271216212,MATH 20A,A01,083754,Staff,26,0,40,14
1650271222237,MATH 20B,A01,083756,Staff,0,5,30,30
1650271222237,MATH 20B,A02,083757,Staff,0,7,30,30
1650271228260,MATH 20C,A01,083760,Staff,0,13,30,30
1650271228260,MATH 20C,A02,083761,Staff,0,13,30,30
1650271228260,MATH 20C,B01,083762,Staff,14,0,30,16
1650271228260,MATH 20C,B02,083763,Staff,28,0,30,2
1650271234284,MATH 20D,A01,083765,Staff,0,1,30,30
1650271234284,MATH 20D,A02,083766,Staff,8,0,30,22
1650271234284,MATH 20D,A03,083767,Staff,28,0,30,2
1650271240309,MATH 20E,A01,083771,Staff,6,0,30,24
1650271240309,MATH 20E,A02,083772,Staff,20,0,30,10
1650271240309,MATH 20E,B01,083773,Staff,0,0,30,30
1650271240309,MATH 20E,B02,083774,Staff,11,0,30,19
1650271246335,MATH 103A,A01,083777,Staff,0,9,30,30
1650271246335,MATH 103A,A02,083778,Staff,0,10,30,30
1650271246335,MATH 103A,B01,083779,Staff,0,10,30,30
1650271246335,MATH 103A,B02,083780,Staff,0,10,30,30
1650271252359,MATH 105,A01,085443,Staff,0,17,30,30
1650271267648,MATH 109,A01,083213,Anzaldo; Leesa B,0,5,30,30
1650271267648,MATH 109,A02,083214,Anzaldo; Leesa B,0,6,30,30
1650271267648,MATH 109,B01,083215,Anzaldo; Leesa B,0,4,30,30
1650271267648,MATH 109,B02,083216,Anzaldo; Leesa B,0,3,30,30
1650271273674,MATH 142A,A01,083219,Chow; Bennett,0,12,30,30
1650271273674,MATH 142A,A02,083220,Chow; Bennett,0,11,30,30
1650271273674,MATH 142A,B01,083221,Chow; Bennett,0,11,30,30
1650271273674,MATH 142A,B02,083222,Chow; Bennett,0,12,30,30
1650271279698,MATH 193A,A01,083224,Staff,0,5,30,30
1650271279698,MATH 193A,A02,083225,Staff,0,5,30,30
1650271279698,MATH 193A,A03,083781,Staff,0,2,30,30
1650271279698,MATH 193A,A04,083782,Staff,0,1,30,30
1650271285735,MATH 197,001,091859,McAuley; Julian John,9998,0,9999,1
1650271291794,COGS 9,A01,083615,Staff,0,14,60,60
1650271297890,COGS 11,A01,083617,Boyle; Mary E. T.,24,0,40,16
1650271303914,COGS 13,A01,083071,Staff,0,31,40,40
1650271309939,COGS 14A,A01,092681,Staff,0,15,100,100
1650271315965,COGS 14B,A01,083073,Cheng; Tzu-Han,0,9,50,50
1650271321995,COGS 17,A01,092677,Staff,29,0,75,46
1650271328022,COGS 100,A01,083619,Staff,0,23,60,60
1650271334046,COGS 101A,A01,083621,Davis; Joshua Daniel,0,21,60,60
1650271340074,COGS 101B,A01,091572,Staff,4,0,60,56
1650271346104,COGS 101C,A01,083625,Delgado; Tania,19,0,30,11
1650271352128,COGS 107A,A01,083627,Boyle; Mary E. T.,0,8,60,60
1650271358153,COGS 118A,A01,083075,Staff,13,0,60,47
1650271364177,CSE 3,A50,083646,Miranda; Gregory Joseph,22,0,38,16
1650271364177,CSE 3,A51,083647,Miranda; Gregory Joseph,37,0,37,0
1650271370201,CSE 8A,A50,083650,Miranda; Gregory Joseph,0,22,40,40
1650271376227,CSE 11,A01,083080,Cao; Yingjun,0,73,40,40
1650271382254,CSE 12,A01,083652,Staff,0,10,100,100
1650271388278,CSE 15L,A01,083654,Staff,0,1,50,50
1650271388278,CSE 15L,A02,083655,Staff,4,0,50,46
1650271394303,CSE 20,A01,083657,Staff,53,0,80,27
1650271400326,CSE 30,A01,083084,Eldon; John,0,74,40,40
1650271406349,CSE 100,A01,083659,Cao; Yingjun,0,65,50,50
1650271412374,CSE 134B,A01,083661,Powell; Thomas Allan,0,28,65,65
1650271418406,CSE 140,A01,083663,Staff,0,0,75,75
1650271424433,CSE 140L,A01,083088,Eldon; John,0,5,75,75
1650271430457,CSE 175,A01,083665,Kumar; Rakesh,8,0,25,17
1650271436481,CSE 190,A00,092507,Dubnov; Shlomo,14,0,20,6
1650271442504,ECE 45,A01,083139,Staff,0,15,40,40
1650271448528,ECE 65,A50,083695,Staff,0,4,30,30
1650271454553,ECE 109,A01,091882,Touri; Behrouz,45,0,70,25
1650271460580,ECE 180,A00,083140,Abi Samra; Nicholas Camill,24,0,30,6
1650271460580,ECE 180,B00,083141,Abi Samra; Nicholas Camill,7,0,30,23
1650271466609,MATH 10A,A01,083735,Patchell; Gregory David,11,0,30,19
1650271466609,MATH 10A,A02,083736,Patchell; Gregory David,28,0,30,2
1650271466609,MATH 10A,A03,083737,Patchell; Gregory David,26,0,30,4
1650271472638,MATH 10B,A01,083207,Staff,0,6,30,30
1650271472638,MATH 10B,A02,083208,Staff,0,6,30,30
1650271472638,MATH 10B,B01,083739,Staff,17,0,30,13
1650271472638,MATH 10B,B02,083740,Staff,29,0,30,1
1650271478666,MATH 18,A01,083743,Staff,7,0,30,23
1650271478666,MATH 18,A02,083744,Staff,27,0,30,3
1650271478666,MATH 18,A03,083745,Staff,23,0,30,7
1650271478666,MATH 18,A04,083746,Staff,27,0,30,3
1650271478666,MATH 18,B01,083748,Staff,0,11,30,30
1650271478666,MATH 18,B02,083749,Staff,0,9,30,30
1650271478666,MATH 18,B03,083750,Staff,1,8,30,29
1650271478666,MATH 18,B04,083751,Staff,0,9,30,30
1650271484689,MATH 20A,A01,083754,Staff,26,0,40,14
1650271490713,MATH 20B,A01,083756,Staff,0,5,30,30
1650271490713,MATH 20B,A02,083757,Staff,0,7,30,30
1650271496745,MATH 20C,A01,083760,Staff,0,13,30,30
1650271496745,MATH 20C,A02,083761,Staff,0,13,30,30
1650271496745,MATH 20C,B01,083762,Staff,14,0,30,16
1650271496745,MATH 20C,B02,083763,Staff,28,0,30,2
1650271502778,MATH 20D,A01,083765,Staff,0,1,30,30
1650271502778,MATH 20D,A02,083766,Staff,8,0,30,22
1650271502778,MATH 20D,A03,083767,Staff,28,0,30,2
1650271508807,MATH 20E,A01,083771,Staff,6,0,30,24
1650271508807,MATH 20E,A02,083772,Staff,20,0,30,10
1650271508807,MATH 20E,B01,083773,Staff,0,0,30,30
1650271508807,MATH 20E,B02,083774,Staff,11,0,30,19
1650271514838,MATH 103A,A01,083777,Staff,0,9,30,30
1650271514838,MATH 103A,A02,083778,Staff,0,10,30,30
1650271514838,MATH 103A,B01,083779,Staff,0,10,30,30
1650271514838,MATH 103A,B02,083780,Staff,0,10,30,30
1650271520861,MATH 105,A01,085443,Staff,0,17,30,30
1650271526887,MATH 109,A01,083213,Anzaldo; Leesa B,0,5,30,30
1650271526887,MATH 109,A02,083214,Anzaldo; Leesa B,0,6,30,30
1650271526887,MATH 109,B01,083215,Anzaldo; Leesa B,0,4,30,30
1650271526887,MATH 109,B02,083216,Anzaldo; Leesa B,0,3,30,30
1650271532913,MATH 142A,A01,083219,Chow; Bennett,0,12,30,30
1650271532913,MATH 142A,A02,083220,Chow; Bennett,0,11,30,30
1650271532913,MATH 142A,B01,083221,Chow; Bennett,0,11,30,30
1650271532913,MATH 142A,B02,083222,Chow; Bennett,0,12,30,30
1650271538948,MATH 193A,A01,083224,Staff,0,5,30,30
1650271538948,MATH 193A,A02,083225,Staff,0,5,30,30
1650271538948,MATH 193A,A03,083781,Staff,0,2,30,30
1650271538948,MATH 193A,A04,083782,Staff,0,1,30,30
1650271544978,MATH 197,001,091859,McAuley; Julian John,9998,0,9999,1
1650271551034,COGS 9,A01,083615,Staff,0,14,60,60
1650271557060,COGS 11,A01,083617,Boyle; Mary E. T.,24,0,40,16
1650271563085,COGS 13,A01,083071,Staff,0,31,40,40
1650271569113,COGS 14A,A01,092681,Staff,0,15,100,100
1650271575138,COGS 14B,A01,083073,Cheng; Tzu-Han,0,9,50,50
1650271581161,COGS 17,A01,092677,Staff,29,0,75,46
1650271587186,COGS 100,A01,083619,Staff,0,23,60,60
1650271593209,COGS 101A,A01,083621,Davis; Joshua Daniel,0,21,60,60
1650271599231,COGS 101B,A01,091572,Staff,4,0,60,56
1650271605257,COGS 101C,A01,083625,Delgado; Tania,19,0,30,11
1650271611283,COGS 107A,A01,083627,Boyle; Mary E. T.,0,8,60,60
1650271617307,COGS 118A,A01,083075,Staff,13,0,60,47
1650271623331,CSE 3,A50,083646,Miranda; Gregory Joseph,22,0,38,16
1650271623331,CSE 3,A51,083647,Miranda; Gregory Joseph,37,0,37,0
1650271629366,CSE 8A,A50,083650,Miranda; Gregory Joseph,0,22,40,40
1650271635391,CSE 11,A01,083080,Cao; Yingjun,0,73,40,40
1650271641416,CSE 12,A01,083652,Staff,0,10,100,100
1650271647440,CSE 15L,A01,083654,Staff,0,1,50,50
1650271647440,CSE 15L,A02,083655,Staff,4,0,50,46
1650271653466,CSE 20,A01,083657,Staff,53,0,80,27
1650271659502,CSE 30,A01,083084,Eldon; John,0,74,40,40
1650271665525,CSE 100,A01,083659,Cao; Yingjun,0,65,50,50
1650271671548,CSE 134B,A01,083661,Powell; Thomas Allan,0,28,65,65
1650271677575,CSE 140,A01,083663,Staff,0,0,75,75
1650271683598,CSE 140L,A01,083088,Eldon; John,0,5,75,75
1650271689621,CSE 175,A01,083665,Kumar; Rakesh,8,0,25,17
1650271695647,CSE 190,A00,092507,Dubnov; Shlomo,14,0,20,6
1650271701671,ECE 45,A01,083139,Staff,0,15,40,40
1650271707698,ECE 65,A50,083695,Staff,0,4,30,30
1650271713722,ECE 109,A01,091882,Touri; Behrouz,45,0,70,25
1650271719746,ECE 180,A00,083140,Abi Samra; Nicholas Camill,24,0,30,6
1650271719746,ECE 180,B00,083141,Abi Samra; Nicholas Camill,7,0,30,23
1650271725768,MATH 10A,A01,083735,Patchell; Gregory David,11,0,30,19
1650271725768,MATH 10A,A02,083736,Patchell; Gregory David,28,0,30,2
1650271725768,MATH 10A,A03,083737,Patchell; Gregory David,26,0,30,4
1650271731792,MATH 10B,A01,083207,Staff,0,6,30,30
1650271731792,MATH 10B,A02,083208,Staff,0,6,30,30
1650271731792,MATH 10B,B01,083739,Staff,17,0,30,13
1650271731792,MATH 10B,B02,083740,Staff,29,0,30,1
1650271737815,MATH 18,A01,083743,Staff,7,0,30,23
1650271737815,MATH 18,A02,083744,Staff,27,0,30,3
1650271737815,MATH 18,A03,083745,Staff,23,0,30,7
1650271737815,MATH 18,A04,083746,Staff,27,0,30,3
1650271737815,MATH 18,B01,083748,Staff,0,11,30,30
1650271737815,MATH 18,B02,083749,Staff,0,9,30,30
1650271737815,MATH 18,B03,083750,Staff,1,8,30,29
1650271737815,MATH 18,B04,083751,Staff,0,9,30,30
1650271743846,MATH 20A,A01,083754,Staff,26,0,40,14
1650271749872,MATH 20B,A01,083756,Staff,0,5,30,30
1650271749872,MATH 20B,A02,083757,Staff,0,7,30,30
1650271755896,MATH 20C,A01,083760,Staff,0,13,30,30
1650271755896,MATH 20C,A02,083761,Staff,0,13,30,30
1650271755896,MATH 20C,B01,083762,Staff,14,0,30,16
1650271755896,MATH 20C,B02,083763,Staff,28,0,30,2
1650271761924,MATH 20D,A01,083765,Staff,0,1,30,30
1650271761924,MATH 20D,A02,083766,Staff,8,0,30,22
1650271761924,MATH 20D,A03,083767,Staff,28,0,30,2
1650271767950,MATH 20E,A01,083771,Staff,6,0,30,24
1650271767950,MATH 20E,A02,083772,Staff,20,0,30,10
1650271767950,MATH 20E,B01,083773,Staff,0,0,30,30
1650271767950,MATH 20E,B02,083774,Staff,11,0,30,19
1650271773975,MATH 103A,A01,083777,Staff,0,9,30,30
1650271773975,MATH 103A,A02,083778,Staff,0,10,30,30
1650271773975,MATH 103A,B01,083779,Staff,0,10,30,30
1650271773975,MATH 103A,B02,083780,Staff,0,10,30,30
1650271779999,MATH 105,A01,085443,Staff,0,17,30,30
1650271786030,MATH 109,A01,083213,Anzaldo; Leesa B,0,5,30,30
1650271786030,MATH 109,A02,083214,Anzaldo; Leesa B,0,6,30,30
1650271786030,MATH 109,B01,083215,Anzaldo; Leesa B,0,4,30,30
1650271786030,MATH 109,B02,083216,Anzaldo; Leesa B,0,3,30,30
1650271792063,MATH 142A,A01,083219,Chow; Bennett,0,12,30,30
1650271792063,MATH 142A,A02,083220,Chow; Bennett,0,11,30,30
1650271792063,MATH 142A,B01,083221,Chow; Bennett,0,11,30,30
1650271792063,MATH 142A,B02,083222,Chow; Bennett,0,12,30,30
1650271798095,MATH 193A,A01,083224,Staff,0,5,30,30
1650271798095,MATH 193A,A02,083225,Staff,0,5,30,30
1650271798095,MATH 193A,A03,083781,Staff,0,2,30,30
1650271798095,MATH 193A,A04,083782,Staff,0,1,30,30
1650271804124,MATH 197,001,091859,McAuley; Julian John,9998,0,9999,1
1650271810188,COGS 9,A01,083615,Staff,0,14,60,60
1650271816227,COGS 11,A01,083617,Boyle; Mary E. T.,24,0,40,16
1650271822262,COGS 13,A01,083071,Staff,0,31,40,40
1650271828297,COGS 14A,A01,092681,Staff,0,15,100,100
1650271834321,COGS 14B,A01,083073,Cheng; Tzu-Han,0,9,50,50
1650271840349,COGS 17,A01,092677,Staff,29,0,75,46
1650271846371,COGS 100,A01,083619,Staff,0,23,60,60
1650271852395,COGS 101A,A01,083621,Davis; Joshua Daniel,0,21,60,60
1650271858424,COGS 101B,A01,091572,Staff,4,0,60,56
1650271864448,COGS 101C,A01,083625,Delgado; Tania,19,0,30,11
1650271870478,COGS 107A,A01,083627,Boyle; Mary E. T.,0,8,60,60
1650271876502,COGS 118A,A01,083075,Staff,13,0,60,47
1650271882534,CSE 3,A50,083646,Miranda; Gregory Joseph,22,0,38,16
1650271882534,CSE 3,A51,083647,Miranda; Gregory Joseph,37,0,37,0
1650271888571,CSE 8A,A50,083650,Miranda; Gregory Joseph,0,22,40,40
1650271894668,CSE 11,A01,083080,Cao; Yingjun,0,73,40,40
1650271900694,CSE 12,A01,083652,Staff,0,10,100,100
1650271906718,CSE 15L,A01,083654,Staff,0,1,50,50
1650271906718,CSE 15L,A02,083655,Staff,4,0,50,46
1650271912747,CSE 20,A01,083657,Staff,53,0,80,27
1650271918783,CSE 30,A01,083084,Eldon; John,0,74,40,40
1650271924809,CSE 100,A01,083659,Cao; Yingjun,0,65,50,50
1650271930851,CSE 134B,A01,083661,Powell; Thomas Allan,0,28,65,65
1650271936876,CSE 140,A01,083663,Staff,0,0,75,75
1650271942901,CSE 140L,A01,083088,Eldon; John,0,5,75,75
1650271948926,CSE 175,A01,083665,Kumar; Rakesh,8,0,25,17
1650271954953,CSE 190,A00,092507,Dubnov; Shlomo,14,0,20,6
1650271960980,ECE 45,A01,083139,Staff,0,15,40,40
1650271967005,ECE 65,A50,083695,Staff,0,4,30,30
1650271973028,ECE 109,A01,091882,Touri; Behrouz,45,0,70,25
1650271979054,ECE 180,A00,083140,Abi Samra; Nicholas Camill,24,0,30,6
1650271979054,ECE 180,B00,083141,Abi Samra; Nicholas Camill,7,0,30,23
1650271985079,MATH 10A,A01,083735,Patchell; Gregory David,11,0,30,19
1650271985079,MATH 10A,A02,083736,Patchell; Gregory David,28,0,30,2
1650271985079,MATH 10A,A03,083737,Patchell; Gregory David,26,0,30,4
1650271991104,MATH 10B,A01,083207,Staff,0,6,30,30
1650271991104,MATH 10B,A02,083208,Staff,0,6,30,30
1650271991104,MATH 10B,B01,083739,Staff,17,0,30,13
1650271991104,MATH 10B,B02,083740,Staff,29,0,30,1
1650271997137,MATH 18,A01,083743,Staff,7,0,30,23
1650271997137,MATH 18,A02,083744,Staff,27,0,30,3
1650271997137,MATH 18,A03,083745,Staff,23,0,30,7
1650271997137,MATH 18,A04,083746,Staff,27,0,30,3
1650271997137,MATH 18,B01,083748,Staff,0,11,30,30
1650271997137,MATH 18,B02,083749,Staff,0,9,30,30
1650271997137,MATH 18,B03,083750,Staff,1,8,30,29
1650271997137,MATH 18,B04,083751,Staff,0,9,30,30
1650272003161,MATH 20A,A01,083754,Staff,26,0,40,14
1650272009187,MATH 20B,A01,083756,Staff,0,5,30,30
1650272009187,MATH 20B,A02,083757,Staff,0,7,30,30
1650272015212,MATH 20C,A01,083760,Staff,0,13,30,30
1650272015212,MATH 20C,A02,083761,Staff,0,13,30,30
1650272015212,MATH 20C,B01,083762,Staff,14,0,30,16
1650272015212,MATH 20C,B02,083763,Staff,28,0,30,2
1650272021257,MATH 20D,A01,083765,Staff,0,1,30,30
1650272021257,MATH 20D,A02,083766,Staff,8,0,30,22
1650272021257,MATH 20D,A03,083767,Staff,28,0,30,2
1650272027291,MATH 20E,A01,083771,Staff,6,0,30,24
1650272027291,MATH 20E,A02,083772,Staff,20,0,30,10
1650272027291,MATH 20E,B01,083773,Staff,0,0,30,30
1650272027291,MATH 20E,B02,083774,Staff,11,0,30,19
1650272033325,MATH 103A,A01,083777,Staff,0,9,30,30
1650272033325,MATH 103A,A02,083778,Staff,0,10,30,30
1650272033325,MATH 103A,B01,083779,Staff,0,10,30,30
1650272033325,MATH 103A,B02,083780,Staff,0,10,30,30
1650272039349,MATH 105,A01,085443,Staff,0,17,30,30
1650272045373,MATH 109,A01,083213,Anzaldo; Leesa B,0,5,30,30
1650272045373,MATH 109,A02,083214,Anzaldo; Leesa B,0,6,30,30
1650272045373,MATH 109,B01,083215,Anzaldo; Leesa B,0,4,30,30
1650272045373,MATH 109,B02,083216,Anzaldo; Leesa B,0,3,30,30
1650272051410,MATH 142A,A01,083219,Chow; Bennett,0,12,30,30
1650272051410,MATH 142A,A02,083220,Chow; Bennett,0,11,30,30
1650272051410,MATH 142A,B01,083221,Chow; Bennett,0,11,30,30
1650272051410,MATH 142A,B02,083222,Chow; Bennett,0,12,30,30
1650272057434,MATH 193A,A01,083224,Staff,0,5,30,30
1650272057434,MATH 193A,A02,083225,Staff,0,5,30,30
1650272057434,MATH 193A,A03,083781,Staff,0,2,30,30
1650272057434,MATH 193A,A04,083782,Staff,0,1,30,30
1650272063462,MATH 197,001,091859,McAuley; Julian John,9998,0,9999,1
1650272069526,COGS 9,A01,083615,Staff,0,14,60,60
1650272075555,COGS 11,A01,083617,Boyle; Mary E. T.,24,0,40,16
1650272081579,COGS 13,A01,083071,Staff,0,31,40,40
1650272087601,COGS 14A,A01,092681,Staff,0,15,100,100
1650272093631,COGS 14B,A01,083073,Cheng; Tzu-Han,0,9,50,50
1650272099658,COGS 17,A01,092677,Staff,29,0,75,46
1650272105683,COGS 100,A01,083619,Staff,0,23,60,60
1650272111711,COGS 101A,A01,083621,Davis; Joshua Daniel,0,21,60,60
1650272117744,COGS 101B,A01,091572,Staff,4,0,60,56
1650272123775,COGS 101C,A01,083625,Delgado; Tania,19,0,30,11
1650272129806,COGS 107A,A01,083627,Boyle; Mary E. T.,0,8,60,60
1650272135830,COGS 118A,A01,083075,Staff,13,0,60,47
1650272141856,CSE 3,A50,083646,Miranda; Gregory Joseph,22,0,38,16
1650272141856,CSE 3,A51,083647,Miranda; Gregory Joseph,37,0,37,0
1650272147881,CSE 8A,A50,083650,Miranda; Gregory Joseph,0,22,40,40
1650272153905,CSE 11,A01,083080,Cao; Yingjun,0,73,40,40
1650272159930,CSE 12,A01,083652,Staff,0,10,100,100
1650272165953,CSE 15L,A01,083654,Staff,0,1,50,50
1650272165953,CSE 15L,A02,083655,Staff,4,0,50,46
1650272171978,CSE 20,A01,083657,Staff,53,0,80,27
1650272178008,CSE 30,A01,083084,Eldon; John,0,74,40,40
1650272184034,CSE 100,A01,083659,Cao; Yingjun,0,65,50,50
1650272190062,CSE 134B,A01,083661,Powell; Thomas Allan,0,28,65,65
1650272196087,CSE 140,A01,083663,Staff,0,0,75,75
1650272202113,CSE 140L,A01,083088,Eldon; John,0,5,75,75
1650272208136,CSE 175,A01,083665,Kumar; Rakesh,8,0,25,17
1650272214173,CSE 190,A00,092507,Dubnov; Shlomo,14,0,20,6
1650272220202,ECE 45,A01,083139,Staff,0,15,40,40
1650272226224,ECE 65,A50,083695,Staff,0,4,30,30
1650272232276,ECE 109,A01,091882,Touri; Behrouz,45,0,70,25
1650272238309,ECE 180,A00,083140,Abi Samra; Nicholas Camill,24,0,30,6
1650272238309,ECE 180,B00,083141,Abi Samra; Nicholas Camill,7,0,30,23
1650272244332,MATH 10A,A01,083735,Patchell; Gregory David,11,0,30,19
1650272244332,MATH 10A,A02,083736,Patchell; Gregory David,28,0,30,2
1650272244332,MATH 10A,A03,083737,Patchell; Gregory David,26,0,30,4
1650272250361,MATH 10B,A01,083207,Staff,0,6,30,30
1650272250361,MATH 10B,A02,083208,Staff,0,6,30,30
1650272250361,MATH 10B,B01,083739,Staff,17,0,30,13
1650272250361,MATH 10B,B02,083740,Staff,29,0,30,1
1650272256388,MATH 18,A01,083743,Staff,7,0,30,23
1650272256388,MATH 18,A02,083744,Staff,27,0,30,3
1650272256388,MATH 18,A03,083745,Staff,23,0,30,7
1650272256388,MATH 18,A04,083746,Staff,27,0,30,3
1650272256388,MATH 18,B01,083748,Staff,0,11,30,30
1650272256388,MATH 18,B02,083749,Staff,0,9,30,30
1650272256388,MATH 18,B03,083750,Staff,1,8,30,29
1650272256388,MATH 18,B04,083751,Staff,0,9,30,30
1650272262413,MATH 20A,A01,083754,Staff,26,0,40,14
1650272268439,MATH 20B,A01,083756,Staff,0,5,30,30
1650272268439,MATH 20B,A02,083757,Staff,0,7,30,30
1650272274466,MATH 20C,A01,083760,Staff,0,13,30,30
1650272274466,MATH 20C,A02,083761,Staff,0,13,30,30
1650272274466,MATH 20C,B01,083762,Staff,14,0,30,16
1650272274466,MATH 20C,B02,083763,Staff,28,0,30,2
1650272280489,MATH 20D,A01,083765,Staff,0,1,30,30
1650272280489,MATH 20D,A02,083766,Staff,8,0,30,22
1650272280489,MATH 20D,A03,083767,Staff,28,0,30,2
1650272286518,MATH 20E,A01,083771,Staff,6,0,30,24
1650272286518,MATH 20E,A02,083772,Staff,20,0,30,10
1650272286518,MATH 20E,B01,083773,Staff,0,0,30,30
1650272286518,MATH 20E,B02,083774,Staff,11,0,30,19
1650272292549,MATH 103A,A01,083777,Staff,0,9,30,30
1650272292549,MATH 103A,A02,083778,Staff,0,10,30,30
1650272292549,MATH 103A,B01,083779,Staff,0,10,30,30
1650272292549,MATH 103A,B02,083780,Staff,0,10,30,30
1650272298572,MATH 105,A01,085443,Staff,0,17,30,30
1650272304600,MATH 109,A01,083213,Anzaldo; Leesa B,0,5,30,30
1650272304600,MATH 109,A02,083214,Anzaldo; Leesa B,0,6,30,30
1650272304600,MATH 109,B01,083215,Anzaldo; Leesa B,0,4,30,30
1650272304600,MATH 109,B02,083216,Anzaldo; Leesa B,0,3,30,30
1650272310625,MATH 142A,A01,083219,Chow; Bennett,0,12,30,30
1650272310625,MATH 142A,A02,083220,Chow; Bennett,0,11,30,30
1650272310625,MATH 142A,B01,083221,Chow; Bennett,0,11,30,30
1650272310625,MATH 142A,B02,083222,Chow; Bennett,0,12,30,30
1650272316652,MATH 193A,A01,083224,Staff,0,5,30,30
1650272316652,MATH 193A,A02,083225,Staff,0,5,30,30
1650272316652,MATH 193A,A03,083781,Staff,0,2,30,30
1650272316652,MATH 193A,A04,083782,Staff,0,1,30,30
1650272322674,MATH 197,001,091859,McAuley; Julian John,9998,0,9999,1
1650272328734,COGS 9,A01,083615,Staff,0,14,60,60
1650272334768,COGS 11,A01,083617,Boyle; Mary E. T.,24,0,40,16
1650272340796,COGS 13,A01,083071,Staff,0,31,40,40
1650272346820,COGS 14A,A01,092681,Staff,0,15,100,100
1650272352844,COGS 14B,A01,083073,Cheng; Tzu-Han,0,9,50,50
1650272358870,COGS 17,A01,092677,Staff,29,0,75,46
1650272364899,COGS 100,A01,083619,Staff,0,23,60,60
1650272370923,COGS 101A,A01,083621,Davis; Joshua Daniel,0,21,60,60
1650272376945,COGS 101B,A01,091572,Staff,4,0,60,56
1650272382969,COGS 101C,A01,083625,Delgado; Tania,19,0,30,11
1650272389001,COGS 107A,A01,083627,Boyle; Mary E. T.,0,8,60,60
1650272395025,COGS 118A,A01,083075,Staff,13,0,60,47
1650272401055,CSE 3,A50,083646,Miranda; Gregory Joseph,22,0,38,16
1650272401055,CSE 3,A51,083647,Miranda; Gregory Joseph,37,0,37,0
1650272407093,CSE 8A,A50,083650,Miranda; Gregory Joseph,0,22,40,40
1650272413118,CSE 11,A01,083080,Cao; Yingjun,0,73,40,40
1650272419145,CSE 12,A01,083652,Staff,0,10,100,100
1650272425170,CSE 15L,A01,083654,Staff,0,1,50,50
1650272425170,CSE 15L,A02,083655,Staff,4,0,50,46
1650272431213,CSE 20,A01,083657,Staff,53,0,80,27
1650272437238,CSE 30,A01,083084,Eldon; John,0,74,40,40
1650272443268,CSE 100,A01,083659,Cao; Yingjun,0,65,50,50
1650272449292,CSE 134B,A01,083661,Powell; Thomas Allan,0,28,65,65
1650272455321,CSE 140,A01,083663,Staff,0,0,75,75
1650272461347,CSE 140L,A01,083088,Eldon; John,0,5,75,75
1650272467375,CSE 175,A01,083665,Kumar; Rakesh,8,0,25,17
1650272473413,CSE 190,A00,092507,Dubnov; Shlomo,14,0,20,6
1650272479436,ECE 45,A01,083139,Staff,0,15,40,40
1650272485464,ECE 65,A50,083695,Staff,0,4,30,30
1650272491577,ECE 109,A01,091882,Touri; Behrouz,45,0,70,25
1650272497603,ECE 180,A00,083140,Abi Samra; Nicholas Camill,24,0,30,6
1650272497603,ECE 180,B00,083141,Abi Samra; Nicholas Camill,7,0,30,23
1650272503634,MATH 10A,A01,083735,Patchell; Gregory David,11,0,30,19
1650272503634,MATH 10A,A02,083736,Patchell; Gregory David,28,0,30,2
1650272503634,MATH 10A,A03,083737,Patchell; Gregory David,26,0,30,4
1650272509659,MATH 10B,A01,083207,Staff,0,6,30,30
1650272509659,MATH 10B,A02,083208,Staff,0,6,30,30
1650272509659,MATH 10B,B01,083739,Staff,17,0,30,13
1650272509659,MATH 10B,B02,083740,Staff,29,0,30,1
1650272515693,MATH 18,A01,083743,Staff,7,0,30,23
1650272515693,MATH 18,A02,083744,Staff,27,0,30,3
1650272515693,MATH 18,A03,083745,Staff,23,0,30,7
1650272515693,MATH 18,A04,083746,Staff,27,0,30,3
1650272515693,MATH 18,B01,083748,Staff,0,11,30,30
1650272515693,MATH 18,B02,083749,Staff,0,9,30,30
1650272515693,MATH 18,B03,083750,Staff,1,8,30,29
1650272515693,MATH 18,B04,083751,Staff,0,9,30,30
1650272521729,MATH 20A,A01,083754,Staff,26,0,40,14
1650272527757,MATH 20B,A01,083756,Staff,0,5,30,30
1650272527757,MATH 20B,A02,083757,Staff,0,7,30,30
1650272533781,MATH 20C,A01,083760,Staff,0,13,30,30
1650272533781,MATH 20C,A02,083761,Staff,0,13,30,30
1650272533781,MATH 20C,B01,083762,Staff,14,0,30,16
1650272533781,MATH 20C,B02,083763,Staff,28,0,30,2
1650272539808,MATH 20D,A01,083765,Staff,0,1,30,30
1650272539808,MATH 20D,A02,083766,Staff,8,0,30,22
1650272539808,MATH 20D,A03,083767,Staff,28,0,30,2
1650272545836,MATH 20E,A01,083771,Staff,6,0,30,24
1650272545836,MATH 20E,A02,083772,Staff,20,0,30,10
1650272545836,MATH 20E,B01,083773,Staff,0,0,30,30
1650272545836,MATH 20E,B02,083774,Staff,11,0,30,19
1650272551865,MATH 103A,A01,083777,Staff,0,9,30,30
1650272551865,MATH 103A,A02,083778,Staff,0,10,30,30
1650272551865,MATH 103A,B01,083779,Staff,0,10,30,30
1650272551865,MATH 103A,B02,083780,Staff,0,10,30,30
1650272557890,MATH 105,A01,085443,Staff,0,17,30,30
1650272563918,MATH 109,A01,083213,Anzaldo; Leesa B,0,5,30,30
1650272563918,MATH 109,A02,083214,Anzaldo; Leesa B,0,6,30,30
1650272563918,MATH 109,B01,083215,Anzaldo; Leesa B,0,4,30,30
1650272563918,MATH 109,B02,083216,Anzaldo; Leesa B,0,3,30,30
1650272569959,MATH 142A,A01,083219,Chow; Bennett,0,12,30,30
1650272569959,MATH 142A,A02,083220,Chow; Bennett,0,11,30,30
1650272569959,MATH 142A,B01,083221,Chow; Bennett,0,11,30,30
1650272569959,MATH 142A,B02,083222,Chow; Bennett,0,12,30,30
1650272575987,MATH 193A,A01,083224,Staff,0,5,30,30
1650272575987,MATH 193A,A02,083225,Staff,0,5,30,30
1650272575987,MATH 193A,A03,083781,Staff,0,2,30,30
1650272575987,MATH 193A,A04,083782,Staff,0,1,30,30
1650272582013,MATH 197,001,091859,McAuley; Julian John,9998,0,9999,1
1650272588064,COGS 9,A01,083615,Staff,0,14,60,60
1650272594091,COGS 11,A01,083617,Boyle; Mary E. T.,24,0,40,16
1650272600116,COGS 13,A01,083071,Staff,0,31,40,40
1650272606143,COGS 14A,A01,092681,Staff,0,15,100,100
1650272612168,COGS 14B,A01,083073,Cheng; Tzu-Han,0,9,50,50
1650272618192,COGS 17,A01,092677,Staff,29,0,75,46
1650272624221,COGS 100,A01,083619,Staff,0,23,60,60
1650272630246,COGS 101A,A01,083621,Davis; Joshua Daniel,0,21,60,60
1650272636270,COGS 101B,A01,091572,Staff,4,0,60,56
1650272642306,COGS 101C,A01,083625,Delgado; Tania,19,0,30,11
1650272648331,COGS 107A,A01,083627,Boyle; Mary E. T.,0,8,60,60
1650272654358,COGS 118A,A01,083075,Staff,13,0,60,47
1650272660384,CSE 3,A50,083646,Miranda; Gregory Joseph,22,0,38,16
1650272660384,CSE 3,A51,083647,Miranda; Gregory Joseph,37,0,37,0
1650272666418,CSE 8A,A50,083650,Miranda; Gregory Joseph,0,22,40,40
1650272672443,CSE 11,A01,083080,Cao; Yingjun,0,73,40,40
1650272678469,CSE 12,A01,083652,Staff,0,10,100,100
1650272684499,CSE 15L,A01,083654,Staff,0,1,50,50
1650272684499,CSE 15L,A02,083655,Staff,4,0,50,46
1650272690526,CSE 20,A01,083657,Staff,53,0,80,27
1650272696554,CSE 30,A01,083084,Eldon; John,0,74,40,40
1650272702584,CSE 100,A01,083659,Cao; Yingjun,0,65,50,50
1650272708609,CSE 134B,A01,083661,Powell; Thomas Allan,0,28,65,65
1650272714634,CSE 140,A01,083663,Staff,0,0,75,75
1650272720659,CSE 140L,A01,083088,Eldon; John,0,5,75,75
1650272726685,CSE 175,A01,083665,Kumar; Rakesh,8,0,25,17
1650272732712,CSE 190,A00,092507,Dubnov; Shlomo,14,0,20,6
1650272738737,ECE 45,A01,083139,Staff,0,15,40,40
1650272744764,ECE 65,A50,083695,Staff,0,4,30,30
1650272750790,ECE 109,A01,091882,Touri; Behrouz,45,0,70,25
1650272756826,ECE 180,A00,083140,Abi Samra; Nicholas Camill,24,0,30,6
1650272756826,ECE 180,B00,083141,Abi Samra; Nicholas Camill,7,0,30,23
1650272762877,MATH 10A,A01,083735,Patchell; Gregory David,11,0,30,19
1650272762877,MATH 10A,A02,083736,Patchell; Gregory David,28,0,30,2
1650272762877,MATH 10A,A03,083737,Patchell; Gregory David,26,0,30,4
1650272768903,MATH 10B,A01,083207,Staff,0,6,30,30
1650272768903,MATH 10B,A02,083208,Staff,0,6,30,30
1650272768903,MATH 10B,B01,083739,Staff,17,0,30,13
1650272768903,MATH 10B,B02,083740,Staff,29,0,30,1
1650272774931,MATH 18,A01,083743,Staff,7,0,30,23
1650272774931,MATH 18,A02,083744,Staff,27,0,30,3
1650272774931,MATH 18,A03,083745,Staff,23,0,30,7
1650272774931,MATH 18,A04,083746,Staff,27,0,30,3
1650272774931,MATH 18,B01,083748,Staff,0,11,30,30
1650272774931,MATH 18,B02,083749,Staff,0,9,30,30
1650272774931,MATH 18,B03,083750,Staff,1,8,30,29
1650272774931,MATH 18,B04,083751,Staff,0,9,30,30
1650272780956,MATH 20A,A01,083754,Staff,26,0,40,14
1650272786991,MATH 20B,A01,083756,Staff,0,5,30,30
1650272786991,MATH 20B,A02,083757,Staff,0,7,30,30
1650272793029,MATH 20C,A01,083760,Staff,0,13,30,30
1650272793029,MATH 20C,A02,083761,Staff,0,13,30,30
1650272793029,MATH 20C,B01,083762,Staff,14,0,30,16
1650272793029,MATH 20C,B02,083763,Staff,28,0,30,2
1650272799056,MATH 20D,A01,083765,Staff,0,1,30,30
1650272799056,MATH 20D,A02,083766,Staff,8,0,30,22
1650272799056,MATH 20D,A03,083767,Staff,28,0,30,2
1650272805088,MATH 20E,A01,083771,Staff,6,0,30,24
1650272805088,MATH 20E,A02,083772,Staff,20,0,30,10
1650272805088,MATH 20E,B01,083773,Staff,0,0,30,30
1650272805088,MATH 20E,B02,083774,Staff,11,0,30,19
1650272811114,MATH 103A,A01,083777,Staff,0,9,30,30
1650272811114,MATH 103A,A02,083778,Staff,0,10,30,30
1650272811114,MATH 103A,B01,083779,Staff,0,10,30,30
1650272811114,MATH 103A,B02,083780,Staff,0,10,30,30
1650272817139,MATH 105,A01,085443,Staff,0,17,30,30
1650272823169,MATH 109,A01,083213,Anzaldo; Leesa B,0,5,30,30
1650272823169,MATH 109,A02,083214,Anzaldo; Leesa B,0,6,30,30
1650272823169,MATH 109,B01,083215,Anzaldo; Leesa B,0,4,30,30
1650272823169,MATH 109,B02,083216,Anzaldo; Leesa B,0,3,30,30
1650272829204,MATH 142A,A01,083219,Chow; Bennett,0,12,30,30
1650272829204,MATH 142A,A02,083220,Chow; Bennett,0,11,30,30
1650272829204,MATH 142A,B01,083221,Chow; Bennett,0,11,30,30
1650272829204,MATH 142A,B02,083222,Chow; Bennett,0,12,30,30
1650272835234,MATH 193A,A01,083224,Staff,0,5,30,30
1650272835234,MATH 193A,A02,083225,Staff,0,5,30,30
1650272835234,MATH 193A,A03,083781,Staff,0,2,30,30
1650272835234,MATH 193A,A04,083782,Staff,0,1,30,30
1650272841260,MATH 197,001,091859,McAuley; Julian John,9998,0,9999,1
1650272847337,COGS 9,A01,083615,Staff,0,14,60,60
1650272853368,COGS 11,A01,083617,Boyle; Mary E. T.,24,0,40,16
1650272859395,COGS 13,A01,083071,Staff,0,31,40,40
1650272865425,COGS 14A,A01,092681,Staff,0,15,100,100
1650272871455,COGS 14B,A01,083073,Cheng; Tzu-Han,0,9,50,50
1650272877481,COGS 17,A01,092677,Staff,29,0,75,46
1650272883505,COGS 100,A01,083619,Staff,0,23,60,60
1650272889531,COGS 101A,A01,083621,Davis; Joshua Daniel,0,21,60,60
1650272895559,COGS 101B,A01,091572,Staff,4,0,60,56
1650272901586,COGS 101C,A01,083625,Delgado; Tania,19,0,30,11
1650272907612,COGS 107A,A01,083627,Boyle; Mary E. T.,0,8,60,60
1650272913641,COGS 118A,A01,083075,Staff,13,0,60,47
1650272919667,CSE 3,A50,083646,Miranda; Gregory Joseph,22,0,38,16
1650272919667,CSE 3,A51,083647,Miranda; Gregory Joseph,37,0,37,0
1650272925692,CSE 8A,A50,083650,Miranda; Gregory Joseph,0,22,40,40
1650272931724,CSE 11,A01,083080,Cao; Yingjun,0,73,40,40
1650272937748,CSE 12,A01,083652,Staff,0,10,100,100
1650272943776,CSE 15L,A01,083654,Staff,0,1,50,50
1650272943776,CSE 15L,A02,083655,Staff,4,0,50,46
1650272949802,CSE 20,A01,083657,Staff,53,0,80,27
1650272955837,CSE 30,A01,083084,Eldon; John,0,74,40,40
1650272961864,CSE 100,A01,083659,Cao; Yingjun,0,65,50,50
1650272967895,CSE 134B,A01,083661,Powell; Thomas Allan,0,28,65,65
1650272973920,CSE 140,A01,083663,Staff,0,0,75,75
1650272979945,CSE 140L,A01,083088,Eldon; John,0,5,75,75
1650272985970,CSE 175,A01,083665,Kumar; Rakesh,8,0,25,17
1650272991996,CSE 190,A00,092507,Dubnov; Shlomo,14,0,20,6
1650272998027,ECE 45,A01,083139,Staff,0,15,40,40
1650273004054,ECE 65,A50,083695,Staff,0,4,30,30
1650273010083,ECE 109,A01,091882,Touri; Behrouz,45,0,70,25
1650273016114,ECE 180,A00,083140,Abi Samra; Nicholas Camill,24,0,30,6
1650273016114,ECE 180,B00,083141,Abi Samra; Nicholas Camill,7,0,30,23
1650273022142,MATH 10A,A01,083735,Patchell; Gregory David,11,0,30,19
1650273022142,MATH 10A,A02,083736,Patchell; Gregory David,28,0,30,2
1650273022142,MATH 10A,A03,083737,Patchell; Gregory David,26,0,30,4
1650273028176,MATH 10B,A01,083207,Staff,0,6,30,30
1650273028176,MATH 10B,A02,083208,Staff,0,6,30,30
1650273028176,MATH 10B,B01,083739,Staff,17,0,30,13
1650273028176,MATH 10B,B02,083740,Staff,29,0,30,1
1650273034206,MATH 18,A01,083743,Staff,7,0,30,23
1650273034206,MATH 18,A02,083744,Staff,27,0,30,3
1650273034206,MATH 18,A03,083745,Staff,23,0,30,7
1650273034206,MATH 18,A04,083746,Staff,27,0,30,3
1650273034206,MATH 18,B01,083748,Staff,0,11,30,30
1650273034206,MATH 18,B02,083749,Staff,0,9,30,30
1650273034206,MATH 18,B03,083750,Staff,1,8,30,29
1650273034206,MATH 18,B04,083751,Staff,0,9,30,30
1650273040237,MATH 20A,A01,083754,Staff,26,0,40,14
1650273046267,MATH 20B,A01,083756,Staff,0,5,30,30
1650273046267,MATH 20B,A02,083757,Staff,0,7,30,30
1650273052300,MATH 20C,A01,083760,Staff,0,13,30,30
1650273052300,MATH 20C,A02,083761,Staff,0,13,30,30
1650273052300,MATH 20C,B01,083762,Staff,14,0,30,16
1650273052300,MATH 20C,B02,083763,Staff,28,0,30,2
1650273058346,MATH 20D,A01,083765,Staff,0,1,30,30
1650273058346,MATH 20D,A02,083766,Staff,8,0,30,22
1650273058346,MATH 20D,A03,083767,Staff,28,0,30,2
1650273064371,MATH 20E,A01,083771,Staff,6,0,30,24
1650273064371,MATH 20E,A02,083772,Staff,20,0,30,10
1650273064371,MATH 20E,B01,083773,Staff,0,0,30,30
1650273064371,MATH 20E,B02,083774,Staff,11,0,30,19
1650273070397,MATH 103A,A01,083777,Staff,0,9,30,30
1650273070397,MATH 103A,A02,083778,Staff,0,10,30,30
1650273070397,MATH 103A,B01,083779,Staff,0,10,30,30
1650273070397,MATH 103A,B02,083780,Staff,0,10,30,30
1650273076422,MATH 105,A01,085443,Staff,0,17,30,30
1650273082457,MATH 109,A01,083213,Anzaldo; Leesa B,0,5,30,30
1650273082457,MATH 109,A02,083214,Anzaldo; Leesa B,0,6,30,30
1650273082457,MATH 109,B01,083215,Anzaldo; Leesa B,0,4,30,30
1650273082457,MATH 109,B02,083216,Anzaldo; Leesa B,0,3,30,30
1650273088585,MATH 142A,A01,083219,Chow; Bennett,0,12,30,30
1650273088585,MATH 142A,A02,083220,Chow; Bennett,0,11,30,30
1650273088585,MATH 142A,B01,083221,Chow; Bennett,0,11,30,30
1650273088585,MATH 142A,B02,083222,Chow; Bennett,0,12,30,30
1650273094611,MATH 193A,A01,083224,Staff,0,5,30,30
1650273094611,MATH 193A,A02,083225,Staff,0,5,30,30
1650273094611,MATH 193A,A03,083781,Staff,0,2,30,30
1650273094611,MATH 193A,A04,083782,Staff,0,1,30,30
1650273100642,MATH 197,001,091859,McAuley; Julian John,9998,0,9999,1
1650273106699,COGS 9,A01,083615,Staff,0,14,60,60
1650273112729,COGS 11,A01,083617,Boyle; Mary E. T.,24,0,40,16
1650273118754,COGS 13,A01,083071,Staff,0,31,40,40
1650273124780,COGS 14A,A01,092681,Staff,0,15,100,100
1650273130804,COGS 14B,A01,083073,Cheng; Tzu-Han,0,9,50,50
1650273136832,COGS 17,A01,092677,Staff,29,0,75,46
1650273142859,COGS 100,A01,083619,Staff,0,23,60,60
1650273148884,COGS 101A,A01,083621,Davis; Joshua Daniel,0,21,60,60
1650273154914,COGS 101B,A01,091572,Staff,4,0,60,56
1650273160950,COGS 101C,A01,083625,Delgado; Tania,19,0,30,11
1650273166975,COGS 107A,A01,083627,Boyle; Mary E. T.,0,8,60,60
1650273173003,COGS 118A,A01,083075,Staff,13,0,60,47
1650273179040,CSE 3,A50,083646,Miranda; Gregory Joseph,22,0,38,16
1650273179040,CSE 3,A51,083647,Miranda; Gregory Joseph,37,0,37,0
1650273185064,CSE 8A,A50,083650,Miranda; Gregory Joseph,0,22,40,40
1650273191091,CSE 11,A01,083080,Cao; Yingjun,0,73,40,40
1650273197116,CSE 12,A01,083652,Staff,0,10,100,100
1650273203145,CSE 15L,A01,083654,Staff,0,1,50,50
1650273203145,CSE 15L,A02,083655,Staff,4,0,50,46
1650273209173,CSE 20,A01,083657,Staff,53,0,80,27
1650273215201,CSE 30,A01,083084,Eldon; John,0,74,40,40
1650273221229,CSE 100,A01,083659,Cao; Yingjun,0,65,50,50
1650273227254,CSE 134B,A01,083661,Powell; Thomas Allan,0,29,65,65
1650273233281,CSE 140,A01,083663,Staff,0,0,75,75
1650273239307,CSE 140L,A01,083088,Eldon; John,0,6,75,75
1650273245344,CSE 175,A01,083665,Kumar; Rakesh,8,0,25,17
1650273251369,CSE 190,A00,092507,Dubnov; Shlomo,14,0,20,6
1650273257396,ECE 45,A01,083139,Staff,0,15,40,40
1650273263426,ECE 65,A50,083695,Staff,0,4,30,30
1650273269452,ECE 109,A01,091882,Touri; Behrouz,45,0,70,25
1650273275484,ECE 180,A00,083140,Abi Samra; Nicholas Camill,24,0,30,6
1650273275484,ECE 180,B00,083141,Abi Samra; Nicholas Camill,7,0,30,23
1650273281511,MATH 10A,A01,083735,Patchell; Gregory David,11,0,30,19
1650273281511,MATH 10A,A02,083736,Patchell; Gregory David,28,0,30,2
1650273281511,MATH 10A,A03,083737,Patchell; Gregory David,26,0,30,4
1650273287536,MATH 10B,A01,083207,Staff,0,6,30,30
1650273287536,MATH 10B,A02,083208,Staff,0,6,30,30
1650273287536,MATH 10B,B01,083739,Staff,17,0,30,13
1650273287536,MATH 10B,B02,083740,Staff,29,0,30,1
1650273293565,MATH 18,A01,083743,Staff,7,0,30,23
1650273293565,MATH 18,A02,083744,Staff,27,0,30,3
1650273293565,MATH 18,A03,083745,Staff,23,0,30,7
1650273293565,MATH 18,A04,083746,Staff,27,0,30,3
1650273293565,MATH 18,B01,083748,Staff,0,11,30,30
1650273293565,MATH 18,B02,083749,Staff,0,9,30,30
1650273293565,MATH 18,B03,083750,Staff,1,8,30,29
1650273293565,MATH 18,B04,083751,Staff,0,9,30,30
1650273299591,MATH 20A,A01,083754,Staff,26,0,40,14
1650273305619,MATH 20B,A01,083756,Staff,0,5,30,30
1650273305619,MATH 20B,A02,083757,Staff,0,7,30,30
1650273311648,MATH 20C,A01,083760,Staff,0,13,30,30
1650273311648,MATH 20C,A02,083761,Staff,0,13,30,30
1650273311648,MATH 20C,B01,083762,Staff,14,0,30,16
1650273311648,MATH 20C,B02,083763,Staff,28,0,30,2
1650273317672,MATH 20D,A01,083765,Staff,0,1,30,30
1650273317672,MATH 20D,A02,083766,Staff,8,0,30,22
1650273317672,MATH 20D,A03,083767,Staff,28,0,30,2
1650273323704,MATH 20E,A01,083771,Staff,6,0,30,24
1650273323704,MATH 20E,A02,083772,Staff,20,0,30,10
1650273323704,MATH 20E,B01,083773,Staff,0,0,30,30
1650273323704,MATH 20E,B02,083774,Staff,11,0,30,19
1650273329730,MATH 103A,A01,083777,Staff,0,9,30,30
1650273329730,MATH 103A,A02,083778,Staff,0,10,30,30
1650273329730,MATH 103A,B01,083779,Staff,0,10,30,30
1650273329730,MATH 103A,B02,083780,Staff,0,10,30,30
1650273335758,MATH 105,A01,085443,Staff,0,17,30,30
1650273341786,MATH 109,A01,083213,Anzaldo; Leesa B,0,5,30,30
1650273341786,MATH 109,A02,083214,Anzaldo; Leesa B,0,6,30,30
1650273341786,MATH 109,B01,083215,Anzaldo; Leesa B,0,4,30,30
1650273341786,MATH 109,B02,083216,Anzaldo; Leesa B,0,3,30,30
1650273347815,MATH 142A,A01,083219,Chow; Bennett,0,12,30,30
1650273347815,MATH 142A,A02,083220,Chow; Bennett,0,11,30,30
1650273347815,MATH 142A,B01,083221,Chow; Bennett,0,11,30,30
1650273347815,MATH 142A,B02,083222,Chow; Bennett,0,12,30,30
1650273353841,MATH 193A,A01,083224,Staff,0,5,30,30
1650273353841,MATH 193A,A02,083225,Staff,0,5,30,30
1650273353841,MATH 193A,A03,083781,Staff,0,2,30,30
1650273353841,MATH 193A,A04,083782,Staff,0,1,30,30
1650273359868,MATH 197,001,091859,McAuley; Julian John,9998,0,9999,1
1650273365941,COGS 9,A01,083615,Staff,0,14,60,60
1650273371965,COGS 11,A01,083617,Boyle; Mary E. T.,24,0,40,16
1650273377990,COGS 13,A01,083071,Staff,0,31,40,40
1650273384015,COGS 14A,A01,092681,Staff,0,15,100,100
1650273390043,COGS 14B,A01,083073,Cheng; Tzu-Han,0,9,50,50
1650273396068,COGS 17,A01,092677,Staff,29,0,75,46
1650273402092,COGS 100,A01,083619,Staff,0,23,60,60
1650273408116,COGS 101A,A01,083621,Davis; Joshua Daniel,0,21,60,60
1650273414140,COGS 101B,A01,091572,Staff,4,0,60,56
1650273420182,COGS 101C,A01,083625,Delgado; Tania,19,0,30,11
1650273426210,COGS 107A,A01,083627,Boyle; Mary E. T.,0,8,60,60
1650273432234,COGS 118A,A01,083075,Staff,13,0,60,47
1650273438261,CSE 3,A50,083646,Miranda; Gregory Joseph,22,0,38,16
1650273438261,CSE 3,A51,083647,Miranda; Gregory Joseph,37,0,37,0
1650273444290,CSE 8A,A50,083650,Miranda; Gregory Joseph,0,22,40,40
1650273450316,CSE 11,A01,083080,Cao; Yingjun,0,73,40,40
1650273456340,CSE 12,A01,083652,Staff,0,10,100,100
1650273462374,CSE 15L,A01,083654,Staff,0,1,50,50
1650273462374,CSE 15L,A02,083655,Staff,4,0,50,46
1650273468399,CSE 20,A01,083657,Staff,53,0,80,27
1650273474423,CSE 30,A01,083084,Eldon; John,0,74,40,40
1650273480446,CSE 100,A01,083659,Cao; Yingjun,0,65,50,50
1650273486469,CSE 134B,A01,083661,Powell; Thomas Allan,0,29,65,65
1650273492493,CSE 140,A01,083663,Staff,0,0,75,75
1650273498515,CSE 140L,A01,083088,Eldon; John,0,6,75,75
1650273504543,CSE 175,A01,083665,Kumar; Rakesh,8,0,25,17
1650273510568,CSE 190,A00,092507,Dubnov; Shlomo,14,0,20,6
1650273516592,ECE 45,A01,083139,Staff,0,15,40,40
1650273522615,ECE 65,A50,083695,Staff,0,4,30,30
1650273528640,ECE 109,A01,091882,Touri; Behrouz,45,0,70,25
1650273534667,ECE 180,A00,083140,Abi Samra; Nicholas Camill,24,0,30,6
1650273534667,ECE 180,B00,083141,Abi Samra; Nicholas Camill,7,0,30,23
1650273540697,MATH 10A,A01,083735,Patchell; Gregory David,11,0,30,19
1650273540697,MATH 10A,A02,083736,Patchell; Gregory David,28,0,30,2
1650273540697,MATH 10A,A03,083737,Patchell; Gregory David,26,0,30,4
1650273546727,MATH 10B,A01,083207,Staff,0,6,30,30
1650273546727,MATH 10B,A02,083208,Staff,0,6,30,30
1650273546727,MATH 10B,B01,083739,Staff,17,0,30,13
1650273546727,MATH 10B,B02,083740,Staff,29,0,30,1
1650273552755,MATH 18,A01,083743,Staff,7,0,30,23
1650273552755,MATH 18,A02,083744,Staff,27,0,30,3
1650273552755,MATH 18,A03,083745,Staff,23,0,30,7
1650273552755,MATH 18,A04,083746,Staff,27,0,30,3
1650273552755,MATH 18,B01,083748,Staff,0,11,30,30
1650273552755,MATH 18,B02,083749,Staff,0,9,30,30
1650273552755,MATH 18,B03,083750,Staff,1,8,30,29
1650273552755,MATH 18,B04,083751,Staff,0,9,30,30
1650273558779,MATH 20A,A01,083754,Staff,26,0,40,14
1650273564804,MATH 20B,A01,083756,Staff,0,5,30,30
1650273564804,MATH 20B,A02,083757,Staff,0,7,30,30
1650273570838,MATH 20C,A01,083760,Staff,0,13,30,30
1650273570838,MATH 20C,A02,083761,Staff,0,13,30,30
1650273570838,MATH 20C,B01,083762,Staff,14,0,30,16
1650273570838,MATH 20C,B02,083763,Staff,28,0,30,2
1650273576861,MATH 20D,A01,083765,Staff,0,1,30,30
1650273576861,MATH 20D,A02,083766,Staff,8,0,30,22
1650273576861,MATH 20D,A03,083767,Staff,28,0,30,2
1650273582894,MATH 20E,A01,083771,Staff,6,0,30,24
1650273582894,MATH 20E,A02,083772,Staff,20,0,30,10
1650273582894,MATH 20E,B01,083773,Staff,0,0,30,30
1650273582894,MATH 20E,B02,083774,Staff,11,0,30,19
1650273588920,MATH 103A,A01,083777,Staff,0,9,30,30
1650273588920,MATH 103A,A02,083778,Staff,0,10,30,30
1650273588920,MATH 103A,B01,083779,Staff,0,10,30,30
1650273588920,MATH 103A,B02,083780,Staff,0,10,30,30
1650273594944,MATH 105,A01,085443,Staff,0,17,30,30
1650273600972,MATH 109,A01,083213,Anzaldo; Leesa B,0,5,30,30
1650273600972,MATH 109,A02,083214,Anzaldo; Leesa B,0,6,30,30
1650273600972,MATH 109,B01,083215,Anzaldo; Leesa B,0,4,30,30
1650273600972,MATH 109,B02,083216,Anzaldo; Leesa B,0,3,30,30
1650273607003,MATH 142A,A01,083219,Chow; Bennett,0,12,30,30
1650273607003,MATH 142A,A02,083220,Chow; Bennett,0,11,30,30
1650273607003,MATH 142A,B01,083221,Chow; Bennett,0,11,30,30
1650273607003,MATH 142A,B02,083222,Chow; Bennett,0,12,30,30
1650273613027,MATH 193A,A01,083224,Staff,0,5,30,30
1650273613027,MATH 193A,A02,083225,Staff,0,5,30,30
1650273613027,MATH 193A,A03,083781,Staff,0,2,30,30
1650273613027,MATH 193A,A04,083782,Staff,0,1,30,30
1650273619052,MATH 197,001,091859,McAuley; Julian John,9998,0,9999,1
1650273625115,COGS 9,A01,083615,Staff,0,14,60,60
1650273631139,COGS 11,A01,083617,Boyle; Mary E. T.,24,0,40,16
1650273637167,COGS 13,A01,083071,Staff,0,31,40,40
1650273643193,COGS 14A,A01,092681,Staff,0,15,100,100
1650273649224,COGS 14B,A01,083073,Cheng; Tzu-Han,0,9,50,50
1650273655251,COGS 17,A01,092677,Staff,29,0,75,46
1650273661280,COGS 100,A01,083619,Staff,0,23,60,60
1650273667308,COGS 101A,A01,083621,Davis; Joshua Daniel,0,21,60,60
1650273673334,COGS 101B,A01,091572,Staff,4,0,60,56
1650273679440,COGS 101C,A01,083625,Delgado; Tania,19,0,30,11
1650273685464,COGS 107A,A01,083627,Boyle; Mary E. T.,0,8,60,60
1650273691497,COGS 118A,A01,083075,Staff,13,0,60,47
1650273697524,CSE 3,A50,083646,Miranda; Gregory Joseph,22,0,38,16
1650273697524,CSE 3,A51,083647,Miranda; Gregory Joseph,37,0,37,0
1650273703553,CSE 8A,A50,083650,Miranda; Gregory Joseph,0,22,40,40
1650273709579,CSE 11,A01,083080,Cao; Yingjun,0,73,40,40
1650273715602,CSE 12,A01,083652,Staff,0,10,100,100
1650273721630,CSE 15L,A01,083654,Staff,0,1,50,50
1650273721630,CSE 15L,A02,083655,Staff,4,0,50,46
1650273727656,CSE 20,A01,083657,Staff,53,0,80,27
1650273733682,CSE 30,A01,083084,Eldon; John,0,74,40,40
1650273739714,CSE 100,A01,083659,Cao; Yingjun,0,65,50,50
1650273745742,CSE 134B,A01,083661,Powell; Thomas Allan,0,29,65,65
1650273751770,CSE 140,A01,083663,Staff,0,0,75,75
1650273757795,CSE 140L,A01,083088,Eldon; John,0,6,75,75
1650273763825,CSE 175,A01,083665,Kumar; Rakesh,8,0,25,17
1650273769850,CSE 190,A00,092507,Dubnov; Shlomo,14,0,20,6
1650273775876,ECE 45,A01,083139,Staff,0,15,40,40
1650273781901,ECE 65,A50,083695,Staff,0,4,30,30
1650273787928,ECE 109,A01,091882,Touri; Behrouz,45,0,70,25
1650273793957,ECE 180,A00,083140,Abi Samra; Nicholas Camill,24,0,30,6
1650273793957,ECE 180,B00,083141,Abi Samra; Nicholas Camill,7,0,30,23
1650273799992,MATH 10A,A01,083735,Patchell; Gregory David,11,0,30,19
1650273799992,MATH 10A,A02,083736,Patchell; Gregory David,28,0,30,2
1650273799992,MATH 10A,A03,083737,Patchell; Gregory David,26,0,30,4
1650273806023,MATH 10B,A01,083207,Staff,0,6,30,30
1650273806023,MATH 10B,A02,083208,Staff,0,6,30,30
1650273806023,MATH 10B,B01,083739,Staff,17,0,30,13
1650273806023,MATH 10B,B02,083740,Staff,29,0,30,1
1650273812059,MATH 18,A01,083743,Staff,7,0,30,23
1650273812059,MATH 18,A02,083744,Staff,27,0,30,3
1650273812059,MATH 18,A03,083745,Staff,23,0,30,7
1650273812059,MATH 18,A04,083746,Staff,27,0,30,3
1650273812059,MATH 18,B01,083748,Staff,0,11,30,30
1650273812059,MATH 18,B02,083749,Staff,0,9,30,30
1650273812059,MATH 18,B03,083750,Staff,1,8,30,29
1650273812059,MATH 18,B04,083751,Staff,0,9,30,30
1650273818083,MATH 20A,A01,083754,Staff,26,0,40,14
1650273824110,MATH 20B,A01,083756,Staff,0,5,30,30
1650273824110,MATH 20B,A02,083757,Staff,0,7,30,30
1650273830139,MATH 20C,A01,083760,Staff,0,13,30,30
1650273830139,MATH 20C,A02,083761,Staff,0,13,30,30
1650273830139,MATH 20C,B01,083762,Staff,14,0,30,16
1650273830139,MATH 20C,B02,083763,Staff,28,0,30,2
1650273836166,MATH 20D,A01,083765,Staff,0,1,30,30
1650273836166,MATH 20D,A02,083766,Staff,8,0,30,22
1650273836166,MATH 20D,A03,083767,Staff,28,0,30,2
1650273842190,MATH 20E,A01,083771,Staff,6,0,30,24
1650273842190,MATH 20E,A02,083772,Staff,20,0,30,10
1650273842190,MATH 20E,B01,083773,Staff,0,0,30,30
1650273842190,MATH 20E,B02,083774,Staff,11,0,30,19
1650273848216,MATH 103A,A01,083777,Staff,0,9,30,30
1650273848216,MATH 103A,A02,083778,Staff,0,10,30,30
1650273848216,MATH 103A,B01,083779,Staff,0,10,30,30
1650273848216,MATH 103A,B02,083780,Staff,0,10,30,30
1650273854246,MATH 105,A01,085443,Staff,0,17,30,30
1650273860270,MATH 109,A01,083213,Anzaldo; Leesa B,0,5,30,30
1650273860270,MATH 109,A02,083214,Anzaldo; Leesa B,0,6,30,30
1650273860270,MATH 109,B01,083215,Anzaldo; Leesa B,0,4,30,30
1650273860270,MATH 109,B02,083216,Anzaldo; Leesa B,0,3,30,30
1650273866298,MATH 142A,A01,083219,Chow; Bennett,0,12,30,30
1650273866298,MATH 142A,A02,083220,Chow; Bennett,0,11,30,30
1650273866298,MATH 142A,B01,083221,Chow; Bennett,0,11,30,30
1650273866298,MATH 142A,B02,083222,Chow; Bennett,0,12,30,30
1650273872326,MATH 193A,A01,083224,Staff,0,5,30,30
1650273872326,MATH 193A,A02,083225,Staff,0,5,30,30
1650273872326,MATH 193A,A03,083781,Staff,0,2,30,30
1650273872326,MATH 193A,A04,083782,Staff,0,1,30,30
1650273878353,MATH 197,001,091859,McAuley; Julian John,9998,0,9999,1
1650273884414,COGS 9,A01,083615,Staff,0,14,60,60
1650273890445,COGS 11,A01,083617,Boyle; Mary E. T.,24,0,40,16
1650273896472,COGS 13,A01,083071,Staff,0,31,40,40
1650273902496,COGS 14A,A01,092681,Staff,0,15,100,100
1650273908527,COGS 14B,A01,083073,Cheng; Tzu-Han,0,9,50,50
1650273914555,COGS 17,A01,092677,Staff,29,0,75,46
1650273920582,COGS 100,A01,083619,Staff,0,23,60,60
1650273926607,COGS 101A,A01,083621,Davis; Joshua Daniel,0,21,60,60
1650273932637,COGS 101B,A01,091572,Staff,4,0,60,56
1650273938666,COGS 101C,A01,083625,Delgado; Tania,19,0,30,11
1650273944691,COGS 107A,A01,083627,Boyle; Mary E. T.,0,8,60,60
1650273950715,COGS 118A,A01,083075,Staff,13,0,60,47
1650273956745,CSE 3,A50,083646,Miranda; Gregory Joseph,22,0,38,16
1650273956745,CSE 3,A51,083647,Miranda; Gregory Joseph,37,0,37,0
1650273962768,CSE 8A,A50,083650,Miranda; Gregory Joseph,0,22,40,40
1650273968793,CSE 11,A01,083080,Cao; Yingjun,0,73,40,40
1650273974820,CSE 12,A01,083652,Staff,0,10,100,100
1650273980845,CSE 15L,A01,083654,Staff,0,1,50,50
1650273980845,CSE 15L,A02,083655,Staff,4,0,50,46
1650273986874,CSE 20,A01,083657,Staff,53,0,80,27
1650273992899,CSE 30,A01,083084,Eldon; John,0,74,40,40
1650273998929,CSE 100,A01,083659,Cao; Yingjun,0,65,50,50
1650274004958,CSE 134B,A01,083661,Powell; Thomas Allan,0,29,65,65
1650274010987,CSE 140,A01,083663,Staff,0,0,75,75
1650274017011,CSE 140L,A01,083088,Eldon; John,0,6,75,75
1650274023038,CSE 175,A01,083665,Kumar; Rakesh,8,0,25,17
1650274029067,CSE 190,A00,092507,Dubnov; Shlomo,14,0,20,6
1650274035096,ECE 45,A01,083139,Staff,0,15,40,40
1650274041123,ECE 65,A50,083695,Staff,0,4,30,30
1650274047148,ECE 109,A01,091882,Touri; Behrouz,44,0,70,26
1650274053176,ECE 180,A00,083140,Abi Samra; Nicholas Camill,24,0,30,6
1650274053176,ECE 180,B00,083141,Abi Samra; Nicholas Camill,7,0,30,23
1650274059204,MATH 10A,A01,083735,Patchell; Gregory David,11,0,30,19
1650274059204,MATH 10A,A02,083736,Patchell; Gregory David,28,0,30,2
1650274059204,MATH 10A,A03,083737,Patchell; Gregory David,26,0,30,4
1650274065232,MATH 10B,A01,083207,Staff,0,6,30,30
1650274065232,MATH 10B,A02,083208,Staff,0,6,30,30
1650274065232,MATH 10B,B01,083739,Staff,17,0,30,13
1650274065232,MATH 10B,B02,083740,Staff,29,0,30,1
1650274071260,MATH 18,A01,083743,Staff,7,0,30,23
1650274071260,MATH 18,A02,083744,Staff,27,0,30,3
1650274071260,MATH 18,A03,083745,Staff,23,0,30,7
1650274071260,MATH 18,A04,083746,Staff,27,0,30,3
1650274071260,MATH 18,B01,083748,Staff,0,11,30,30
1650274071260,MATH 18,B02,083749,Staff,0,9,30,30
1650274071260,MATH 18,B03,083750,Staff,1,8,30,29
1650274071260,MATH 18,B04,083751,Staff,0,9,30,30
1650274077284,MATH 20A,A01,083754,Staff,26,0,40,14
1650274083310,MATH 20B,A01,083756,Staff,0,5,30,30
1650274083310,MATH 20B,A02,083757,Staff,0,7,30,30
1650274089335,MATH 20C,A01,083760,Staff,0,13,30,30
1650274089335,MATH 20C,A02,083761,Staff,0,13,30,30
1650274089335,MATH 20C,B01,083762,Staff,14,0,30,16
1650274089335,MATH 20C,B02,083763,Staff,28,0,30,2
1650274095362,MATH 20D,A01,083765,Staff,0,1,30,30
1650274095362,MATH 20D,A02,083766,Staff,8,0,30,22
1650274095362,MATH 20D,A03,083767,Staff,28,0,30,2
1650274101391,MATH 20E,A01,083771,Staff,6,0,30,24
1650274101391,MATH 20E,A02,083772,Staff,20,0,30,10
1650274101391,MATH 20E,B01,083773,Staff,0,0,30,30
1650274101391,MATH 20E,B02,083774,Staff,11,0,30,19
1650274107419,MATH 103A,A01,083777,Staff,0,9,30,30
1650274107419,MATH 103A,A02,083778,Staff,0,10,30,30
1650274107419,MATH 103A,B01,083779,Staff,0,10,30,30
1650274107419,MATH 103A,B02,083780,Staff,0,10,30,30
1650274113443,MATH 105,A01,085443,Staff,0,17,30,30
1650274119475,MATH 109,A01,083213,Anzaldo; Leesa B,0,5,30,30
1650274119475,MATH 109,A02,083214,Anzaldo; Leesa B,0,6,30,30
1650274119475,MATH 109,B01,083215,Anzaldo; Leesa B,0,4,30,30
1650274119475,MATH 109,B02,083216,Anzaldo; Leesa B,0,3,30,30
1650274125518,MATH 142A,A01,083219,Chow; Bennett,0,12,30,30
1650274125518,MATH 142A,A02,083220,Chow; Bennett,0,11,30,30
1650274125518,MATH 142A,B01,083221,Chow; Bennett,0,11,30,30
1650274125518,MATH 142A,B02,083222,Chow; Bennett,0,12,30,30
1650274131540,MATH 193A,A01,083224,Staff,0,5,30,30
1650274131540,MATH 193A,A02,083225,Staff,0,5,30,30
1650274131540,MATH 193A,A03,083781,Staff,0,2,30,30
1650274131540,MATH 193A,A04,083782,Staff,0,1,30,30
1650274137563,MATH 197,001,091859,McAuley; Julian John,9998,0,9999,1
1650274143637,COGS 9,A01,083615,Staff,0,14,60,60
1650274149662,COGS 11,A01,083617,Boyle; Mary E. T.,24,0,40,16
1650274155686,COGS 13,A01,083071,Staff,0,31,40,40
1650274161709,COGS 14A,A01,092681,Staff,0,15,100,100
1650274167736,COGS 14B,A01,083073,Cheng; Tzu-Han,0,9,50,50
1650274173765,COGS 17,A01,092677,Staff,29,0,75,46
1650274179793,COGS 100,A01,083619,Staff,0,23,60,60
1650274185817,COGS 101A,A01,083621,Davis; Joshua Daniel,0,21,60,60
1650274191842,COGS 101B,A01,091572,Staff,4,0,60,56
1650274197868,COGS 101C,A01,083625,Delgado; Tania,19,0,30,11
1650274203895,COGS 107A,A01,083627,Boyle; Mary E. T.,0,8,60,60
1650274209922,COGS 118A,A01,083075,Staff,13,0,60,47
1650274215947,CSE 3,A50,083646,Miranda; Gregory Joseph,22,0,38,16
1650274215947,CSE 3,A51,083647,Miranda; Gregory Joseph,37,0,37,0
1650274221973,CSE 8A,A50,083650,Miranda; Gregory Joseph,0,22,40,40
1650274228000,CSE 11,A01,083080,Cao; Yingjun,0,73,40,40
1650274234024,CSE 12,A01,083652,Staff,0,10,100,100
1650274240048,CSE 15L,A01,083654,Staff,0,1,50,50
1650274240048,CSE 15L,A02,083655,Staff,4,0,50,46
1650274246073,CSE 20,A01,083657,Staff,53,0,80,27
1650274252101,CSE 30,A01,083084,Eldon; John,0,74,40,40
1650274258126,CSE 100,A01,083659,Cao; Yingjun,0,65,50,50
1650274264156,CSE 134B,A01,083661,Powell; Thomas Allan,0,28,65,65
1650274270182,CSE 140,A01,083663,Staff,0,0,75,75
1650274276296,CSE 140L,A01,083088,Eldon; John,0,6,75,75
1650274282327,CSE 175,A01,083665,Kumar; Rakesh,8,0,25,17
1650274288353,CSE 190,A00,092507,Dubnov; Shlomo,14,0,20,6
1650274294383,ECE 45,A01,083139,Staff,0,15,40,40
1650274300412,ECE 65,A50,083695,Staff,0,4,30,30
1650274306439,ECE 109,A01,091882,Touri; Behrouz,44,0,70,26
1650274312465,ECE 180,A00,083140,Abi Samra; Nicholas Camill,24,0,30,6
1650274312465,ECE 180,B00,083141,Abi Samra; Nicholas Camill,7,0,30,23
1650274318495,MATH 10A,A01,083735,Patchell; Gregory David,11,0,30,19
1650274318495,MATH 10A,A02,083736,Patchell; Gregory David,28,0,30,2
1650274318495,MATH 10A,A03,083737,Patchell; Gregory David,26,0,30,4
1650274324524,MATH 10B,A01,083207,Staff,0,6,30,30
1650274324524,MATH 10B,A02,083208,Staff,0,6,30,30
1650274324524,MATH 10B,B01,083739,Staff,17,0,30,13
1650274324524,MATH 10B,B02,083740,Staff,29,0,30,1
1650274330549,MATH 18,A01,083743,Staff,7,0,30,23
1650274330549,MATH 18,A02,083744,Staff,27,0,30,3
1650274330549,MATH 18,A03,083745,Staff,23,0,30,7
1650274330549,MATH 18,A04,083746,Staff,27,0,30,3
1650274330549,MATH 18,B01,083748,Staff,0,11,30,30
1650274330549,MATH 18,B02,083749,Staff,0,9,30,30
1650274330549,MATH 18,B03,083750,Staff,1,8,30,29
1650274330549,MATH 18,B04,083751,Staff,0,9,30,30
1650274336572,MATH 20A,A01,083754,Staff,26,0,40,14
1650274342608,MATH 20B,A01,083756,Staff,0,5,30,30
1650274342608,MATH 20B,A02,083757,Staff,0,7,30,30
1650274348637,MATH 20C,A01,083760,Staff,0,13,30,30
1650274348637,MATH 20C,A02,083761,Staff,0,13,30,30
1650274348637,MATH 20C,B01,083762,Staff,14,0,30,16
1650274348637,MATH 20C,B02,083763,Staff,28,0,30,2
1650274354662,MATH 20D,A01,083765,Staff,0,1,30,30
1650274354662,MATH 20D,A02,083766,Staff,8,0,30,22
1650274354662,MATH 20D,A03,083767,Staff,28,0,30,2
1650274360694,MATH 20E,A01,083771,Staff,6,0,30,24
1650274360694,MATH 20E,A02,083772,Staff,20,0,30,10
1650274360694,MATH 20E,B01,083773,Staff,0,0,30,30
1650274360694,MATH 20E,B02,083774,Staff,11,0,30,19
1650274366720,MATH 103A,A01,083777,Staff,0,9,30,30
1650274366720,MATH 103A,A02,083778,Staff,0,10,30,30
1650274366720,MATH 103A,B01,083779,Staff,0,10,30,30
1650274366720,MATH 103A,B02,083780,Staff,0,10,30,30
1650274372743,MATH 105,A01,085443,Staff,0,17,30,30
1650274378766,MATH 109,A01,083213,Anzaldo; Leesa B,0,5,30,30
1650274378766,MATH 109,A02,083214,Anzaldo; Leesa B,0,6,30,30
1650274378766,MATH 109,B01,083215,Anzaldo; Leesa B,0,4,30,30
1650274378766,MATH 109,B02,083216,Anzaldo; Leesa B,0,3,30,30
1650274384795,MATH 142A,A01,083219,Chow; Bennett,0,12,30,30
1650274384795,MATH 142A,A02,083220,Chow; Bennett,0,11,30,30
1650274384795,MATH 142A,B01,083221,Chow; Bennett,0,11,30,30
1650274384795,MATH 142A,B02,083222,Chow; Bennett,0,12,30,30
1650274390828,MATH 193A,A01,083224,Staff,0,5,30,30
1650274390828,MATH 193A,A02,083225,Staff,0,5,30,30
1650274390828,MATH 193A,A03,083781,Staff,0,2,30,30
1650274390828,MATH 193A,A04,083782,Staff,0,1,30,30
1650274396864,MATH 197,001,091859,McAuley; Julian John,9998,0,9999,1
1650274402919,COGS 9,A01,083615,Staff,0,14,60,60
1650274408943,COGS 11,A01,083617,Boyle; Mary E. T.,24,0,40,16
1650274414970,COGS 13,A01,083071,Staff,0,31,40,40
1650274421000,COGS 14A,A01,092681,Staff,0,15,100,100
1650274427027,COGS 14B,A01,083073,Cheng; Tzu-Han,0,9,50,50
1650274433054,COGS 17,A01,092677,Staff,29,0,75,46
1650274439085,COGS 100,A01,083619,Staff,0,23,60,60
1650274445110,COGS 101A,A01,083621,Davis; Joshua Daniel,0,21,60,60
1650274451135,COGS 101B,A01,091572,Staff,4,0,60,56
1650274457163,COGS 101C,A01,083625,Delgado; Tania,19,0,30,11
1650274463190,COGS 107A,A01,083627,Boyle; Mary E. T.,0,8,60,60
1650274469214,COGS 118A,A01,083075,Staff,13,0,60,47
1650274475238,CSE 3,A50,083646,Miranda; Gregory Joseph,22,0,38,16
1650274475238,CSE 3,A51,083647,Miranda; Gregory Joseph,37,0,37,0
1650274481266,CSE 8A,A50,083650,Miranda; Gregory Joseph,0,22,40,40
1650274487290,CSE 11,A01,083080,Cao; Yingjun,0,74,40,40
1650274493314,CSE 12,A01,083652,Staff,0,10,100,100
1650274499341,CSE 15L,A01,083654,Staff,0,1,50,50
1650274499341,CSE 15L,A02,083655,Staff,4,0,50,46
1650274505368,CSE 20,A01,083657,Staff,53,0,80,27
1650274511392,CSE 30,A01,083084,Eldon; John,0,74,40,40
1650274517417,CSE 100,A01,083659,Cao; Yingjun,0,65,50,50
1650274523442,CSE 134B,A01,083661,Powell; Thomas Allan,0,28,65,65
1650274529466,CSE 140,A01,083663,Staff,0,0,75,75
1650274535493,CSE 140L,A01,083088,Eldon; John,0,6,75,75
1650274541518,CSE 175,A01,083665,Kumar; Rakesh,8,0,25,17
1650274547546,CSE 190,A00,092507,Dubnov; Shlomo,14,0,20,6
1650274553571,ECE 45,A01,083139,Staff,0,15,40,40
1650274559597,ECE 65,A50,083695,Staff,0,4,30,30
1650274565633,ECE 109,A01,091882,Touri; Behrouz,44,0,70,26
1650274571662,ECE 180,A00,083140,Abi Samra; Nicholas Camill,24,0,30,6
1650274571662,ECE 180,B00,083141,Abi Samra; Nicholas Camill,7,0,30,23
1650274577689,MATH 10A,A01,083735,Patchell; Gregory David,11,0,30,19
1650274577689,MATH 10A,A02,083736,Patchell; Gregory David,28,0,30,2
1650274577689,MATH 10A,A03,083737,Patchell; Gregory David,26,0,30,4
1650274583717,MATH 10B,A01,083207,Staff,0,6,30,30
1650274583717,MATH 10B,A02,083208,Staff,0,6,30,30
1650274583717,MATH 10B,B01,083739,Staff,17,0,30,13
1650274583717,MATH 10B,B02,083740,Staff,29,0,30,1
1650274589748,MATH 18,A01,083743,Staff,7,0,30,23
1650274589748,MATH 18,A02,083744,Staff,27,0,30,3
1650274589748,MATH 18,A03,083745,Staff,23,0,30,7
1650274589748,MATH 18,A04,083746,Staff,27,0,30,3
1650274589748,MATH 18,B01,083748,Staff,0,11,30,30
1650274589748,MATH 18,B02,083749,Staff,0,9,30,30
1650274589748,MATH 18,B03,083750,Staff,1,8,30,29
1650274589748,MATH 18,B04,083751,Staff,0,9,30,30
1650274595773,MATH 20A,A01,083754,Staff,26,0,40,14
1650274601797,MATH 20B,A01,083756,Staff,0,5,30,30
1650274601797,MATH 20B,A02,083757,Staff,0,7,30,30
1650274607827,MATH 20C,A01,083760,Staff,0,13,30,30
1650274607827,MATH 20C,A02,083761,Staff,0,13,30,30
1650274607827,MATH 20C,B01,083762,Staff,14,0,30,16
1650274607827,MATH 20C,B02,083763,Staff,28,0,30,2
1650274613853,MATH 20D,A01,083765,Staff,0,1,30,30
1650274613853,MATH 20D,A02,083766,Staff,8,0,30,22
1650274613853,MATH 20D,A03,083767,Staff,28,0,30,2
1650274619878,MATH 20E,A01,083771,Staff,6,0,30,24
1650274619878,MATH 20E,A02,083772,Staff,20,0,30,10
1650274619878,MATH 20E,B01,083773,Staff,0,0,30,30
1650274619878,MATH 20E,B02,083774,Staff,11,0,30,19
1650274625906,MATH 103A,A01,083777,Staff,0,9,30,30
1650274625906,MATH 103A,A02,083778,Staff,0,10,30,30
1650274625906,MATH 103A,B01,083779,Staff,0,10,30,30
1650274625906,MATH 103A,B02,083780,Staff,0,10,30,30
1650274631931,MATH 105,A01,085443,Staff,0,17,30,30
1650274637960,MATH 109,A01,083213,Anzaldo; Leesa B,0,5,30,30
1650274637960,MATH 109,A02,083214,Anzaldo; Leesa B,0,6,30,30
1650274637960,MATH 109,B01,083215,Anzaldo; Leesa B,0,4,30,30
1650274637960,MATH 109,B02,083216,Anzaldo; Leesa B,0,3,30,30
1650274643987,MATH 142A,A01,083219,Chow; Bennett,0,12,30,30
1650274643987,MATH 142A,A02,083220,Chow; Bennett,0,11,30,30
1650274643987,MATH 142A,B01,083221,Chow; Bennett,0,11,30,30
1650274643987,MATH 142A,B02,083222,Chow; Bennett,0,12,30,30
1650274650014,MATH 193A,A01,083224,Staff,0,5,30,30
1650274650014,MATH 193A,A02,083225,Staff,0,5,30,30
1650274650014,MATH 193A,A03,083781,Staff,0,2,30,30
1650274650014,MATH 193A,A04,083782,Staff,0,1,30,30
1650274656038,MATH 197,001,091859,McAuley; Julian John,9998,0,9999,1
1650274662106,COGS 9,A01,083615,Staff,0,14,60,60
1650274668134,COGS 11,A01,083617,Boyle; Mary E. T.,24,0,40,16
1650274674169,COGS 13,A01,083071,Staff,0,31,40,40
1650274680194,COGS 14A,A01,092681,Staff,0,15,100,100
1650274686223,COGS 14B,A01,083073,Cheng; Tzu-Han,0,9,50,50
1650274692248,COGS 17,A01,092677,Staff,28,0,75,47
1650274698271,COGS 100,A01,083619,Staff,0,23,60,60
1650274704294,COGS 101A,A01,083621,Davis; Joshua Daniel,0,21,60,60
1650274710319,COGS 101B,A01,091572,Staff,4,0,60,56
1650274716344,COGS 101C,A01,083625,Delgado; Tania,19,0,30,11
1650274722367,COGS 107A,A01,083627,Boyle; Mary E. T.,0,8,60,60
1650274728389,COGS 118A,A01,083075,Staff,13,0,60,47
1650274734413,CSE 3,A50,083646,Miranda; Gregory Joseph,22,0,38,16
1650274734413,CSE 3,A51,083647,Miranda; Gregory Joseph,37,0,37,0
1650274740444,CSE 8A,A50,083650,Miranda; Gregory Joseph,0,22,40,40
1650274746467,CSE 11,A01,083080,Cao; Yingjun,0,74,40,40
1650274752491,CSE 12,A01,083652,Staff,0,10,100,100
1650274758514,CSE 15L,A01,083654,Staff,0,1,50,50
1650274758514,CSE 15L,A02,083655,Staff,4,0,50,46
1650274764538,CSE 20,A01,083657,Staff,53,0,80,27
1650274770568,CSE 30,A01,083084,Eldon; John,0,74,40,40
1650274776592,CSE 100,A01,083659,Cao; Yingjun,0,65,50,50
1650274782618,CSE 134B,A01,083661,Powell; Thomas Allan,0,28,65,65
1650274788645,CSE 140,A01,083663,Staff,0,0,75,75
1650274794673,CSE 140L,A01,083088,Eldon; John,0,6,75,75
1650274800702,CSE 175,A01,083665,Kumar; Rakesh,8,0,25,17
1650274806728,CSE 190,A00,092507,Dubnov; Shlomo,14,0,20,6
1650274812750,ECE 45,A01,083139,Staff,0,15,40,40
1650274818777,ECE 65,A50,083695,Staff,0,4,30,30
1650274824804,ECE 109,A01,091882,Touri; Behrouz,44,0,70,26
1650274830832,ECE 180,A00,083140,Abi Samra; Nicholas Camill,24,0,30,6
1650274830832,ECE 180,B00,083141,Abi Samra; Nicholas Camill,7,0,30,23
1650274836860,MATH 10A,A01,083735,Patchell; Gregory David,11,0,30,19
1650274836860,MATH 10A,A02,083736,Patchell; Gregory David,28,0,30,2
1650274836860,MATH 10A,A03,083737,Patchell; Gregory David,26,0,30,4
1650274842887,MATH 10B,A01,083207,Staff,0,6,30,30
1650274842887,MATH 10B,A02,083208,Staff,0,6,30,30
1650274842887,MATH 10B,B01,083739,Staff,17,0,30,13
1650274842887,MATH 10B,B02,083740,Staff,29,0,30,1
1650274848912,MATH 18,A01,083743,Staff,7,0,30,23
1650274848912,MATH 18,A02,083744,Staff,27,0,30,3
1650274848912,MATH 18,A03,083745,Staff,23,0,30,7
1650274848912,MATH 18,A04,083746,Staff,27,0,30,3
1650274848912,MATH 18,B01,083748,Staff,0,11,30,30
1650274848912,MATH 18,B02,083749,Staff,0,9,30,30
1650274848912,MATH 18,B03,083750,Staff,1,8,30,29
1650274848912,MATH 18,B04,083751,Staff,0,9,30,30
1650274854936,MATH 20A,A01,083754,Staff,26,0,40,14
1650274860963,MATH 20B,A01,083756,Staff,0,5,30,30
1650274860963,MATH 20B,A02,083757,Staff,0,7,30,30
1650274866992,MATH 20C,A01,083760,Staff,0,13,30,30
1650274866992,MATH 20C,A02,083761,Staff,0,13,30,30
1650274866992,MATH 20C,B01,083762,Staff,14,0,30,16
1650274866992,MATH 20C,B02,083763,Staff,28,0,30,2
1650274873120,MATH 20D,A01,083765,Staff,0,1,30,30
1650274873120,MATH 20D,A02,083766,Staff,8,0,30,22
1650274873120,MATH 20D,A03,083767,Staff,28,0,30,2
1650274879151,MATH 20E,A01,083771,Staff,6,0,30,24
1650274879151,MATH 20E,A02,083772,Staff,20,0,30,10
1650274879151,MATH 20E,B01,083773,Staff,0,0,30,30
1650274879151,MATH 20E,B02,083774,Staff,11,0,30,19
1650274885183,MATH 103A,A01,083777,Staff,0,9,30,30
1650274885183,MATH 103A,A02,083778,Staff,0,10,30,30
1650274885183,MATH 103A,B01,083779,Staff,0,10,30,30
1650274885183,MATH 103A,B02,083780,Staff,0,10,30,30
1650274891207,MATH 105,A01,085443,Staff,0,17,30,30
1650274897241,MATH 109,A01,083213,Anzaldo; Leesa B,0,5,30,30
1650274897241,MATH 109,A02,083214,Anzaldo; Leesa B,0,6,30,30
1650274897241,MATH 109,B01,083215,Anzaldo; Leesa B,0,4,30,30
1650274897241,MATH 109,B02,083216,Anzaldo; Leesa B,0,3,30,30
1650274903270,MATH 142A,A01,083219,Chow; Bennett,0,12,30,30
1650274903270,MATH 142A,A02,083220,Chow; Bennett,0,11,30,30
1650274903270,MATH 142A,B01,083221,Chow; Bennett,0,11,30,30
1650274903270,MATH 142A,B02,083222,Chow; Bennett,0,12,30,30
1650274909301,MATH 193A,A01,083224,Staff,0,5,30,30
1650274909301,MATH 193A,A02,083225,Staff,0,5,30,30
1650274909301,MATH 193A,A03,083781,Staff,0,2,30,30
1650274909301,MATH 193A,A04,083782,Staff,0,1,30,30
1650274915324,MATH 197,001,091859,McAuley; Julian John,9998,0,9999,1
1650274921392,COGS 9,A01,083615,Staff,0,14,60,60
1650274927418,COGS 11,A01,083617,Boyle; Mary E. T.,24,0,40,16
1650274933444,COGS 13,A01,083071,Staff,0,31,40,40
1650274939470,COGS 14A,A01,092681,Staff,0,15,100,100
1650274945494,COGS 14B,A01,083073,Cheng; Tzu-Han,0,9,50,50
1650274951520,COGS 17,A01,092677,Staff,29,0,75,46
1650274957546,COGS 100,A01,083619,Staff,0,23,60,60
1650274963569,COGS 101A,A01,083621,Davis; Joshua Daniel,0,21,60,60
1650274969593,COGS 101B,A01,091572,Staff,4,0,60,56
1650274975618,COGS 101C,A01,083625,Delgado; Tania,19,0,30,11
1650274981646,COGS 107A,A01,083627,Boyle; Mary E. T.,0,8,60,60
1650274987678,COGS 118A,A01,083075,Staff,13,0,60,47
1650274993702,CSE 3,A50,083646,Miranda; Gregory Joseph,22,0,38,16
1650274993702,CSE 3,A51,083647,Miranda; Gregory Joseph,37,0,37,0
1650274999726,CSE 8A,A50,083650,Miranda; Gregory Joseph,0,22,40,40
1650275005752,CSE 11,A01,083080,Cao; Yingjun,0,74,40,40
1650275011775,CSE 12,A01,083652,Staff,0,10,100,100
1650275017797,CSE 15L,A01,083654,Staff,0,1,50,50
1650275017797,CSE 15L,A02,083655,Staff,4,0,50,46
1650275023820,CSE 20,A01,083657,Staff,53,0,80,27
1650275029844,CSE 30,A01,083084,Eldon; John,0,74,40,40
1650275035871,CSE 100,A01,083659,Cao; Yingjun,0,65,50,50
1650275041898,CSE 134B,A01,083661,Powell; Thomas Allan,0,28,65,65
1650275047925,CSE 140,A01,083663,Staff,0,0,75,75
1650275053959,CSE 140L,A01,083088,Eldon; John,0,6,75,75
1650275059982,CSE 175,A01,083665,Kumar; Rakesh,8,0,25,17
1650275066008,CSE 190,A00,092507,Dubnov; Shlomo,14,0,20,6
1650275072033,ECE 45,A01,083139,Staff,0,15,40,40
1650275078059,ECE 65,A50,083695,Staff,0,4,30,30
1650275084086,ECE 109,A01,091882,Touri; Behrouz,44,0,70,26
1650275090110,ECE 180,A00,083140,Abi Samra; Nicholas Camill,24,0,30,6
1650275090110,ECE 180,B00,083141,Abi Samra; Nicholas Camill,7,0,30,23
1650275096138,MATH 10A,A01,083735,Patchell; Gregory David,11,0,30,19
1650275096138,MATH 10A,A02,083736,Patchell; Gregory David,28,0,30,2
1650275096138,MATH 10A,A03,083737,Patchell; Gregory David,26,0,30,4
1650275102162,MATH 10B,A01,083207,Staff,0,6,30,30
1650275102162,MATH 10B,A02,083208,Staff,0,6,30,30
1650275102162,MATH 10B,B01,083739,Staff,17,0,30,13
1650275102162,MATH 10B,B02,083740,Staff,29,0,30,1
1650275108191,MATH 18,A01,083743,Staff,7,0,30,23
1650275108191,MATH 18,A02,083744,Staff,27,0,30,3
1650275108191,MATH 18,A03,083745,Staff,23,0,30,7
1650275108191,MATH 18,A04,083746,Staff,27,0,30,3
1650275108191,MATH 18,B01,083748,Staff,0,11,30,30
1650275108191,MATH 18,B02,083749,Staff,0,9,30,30
1650275108191,MATH 18,B03,083750,Staff,1,8,30,29
1650275108191,MATH 18,B04,083751,Staff,0,9,30,30
1650275114223,MATH 20A,A01,083754,Staff,26,0,40,14
1650275120247,MATH 20B,A01,083756,Staff,0,5,30,30
1650275120247,MATH 20B,A02,083757,Staff,0,7,30,30
1650275126271,MATH 20C,A01,083760,Staff,0,13,30,30
1650275126271,MATH 20C,A02,083761,Staff,0,13,30,30
1650275126271,MATH 20C,B01,083762,Staff,14,0,30,16
1650275126271,MATH 20C,B02,083763,Staff,28,0,30,2
1650275132298,MATH 20D,A01,083765,Staff,0,1,30,30
1650275132298,MATH 20D,A02,083766,Staff,8,0,30,22
1650275132298,MATH 20D,A03,083767,Staff,28,0,30,2
1650275138334,MATH 20E,A01,083771,Staff,6,0,30,24
1650275138334,MATH 20E,A02,083772,Staff,20,0,30,10
1650275138334,MATH 20E,B01,083773,Staff,0,0,30,30
1650275138334,MATH 20E,B02,083774,Staff,11,0,30,19
1650275144361,MATH 103A,A01,083777,Staff,0,9,30,30
1650275144361,MATH 103A,A02,083778,Staff,0,10,30,30
1650275144361,MATH 103A,B01,083779,Staff,0,10,30,30
1650275144361,MATH 103A,B02,083780,Staff,0,10,30,30
1650275150388,MATH 105,A01,085443,Staff,0,17,30,30
1650275156411,MATH 109,A01,083213,Anzaldo; Leesa B,0,5,30,30
1650275156411,MATH 109,A02,083214,Anzaldo; Leesa B,0,6,30,30
1650275156411,MATH 109,B01,083215,Anzaldo; Leesa B,0,4,30,30
1650275156411,MATH 109,B02,083216,Anzaldo; Leesa B,0,3,30,30
1650275162435,MATH 142A,A01,083219,Chow; Bennett,0,12,30,30
1650275162435,MATH 142A,A02,083220,Chow; Bennett,0,11,30,30
1650275162435,MATH 142A,B01,083221,Chow; Bennett,0,11,30,30
1650275162435,MATH 142A,B02,083222,Chow; Bennett,0,12,30,30
1650275168460,MATH 193A,A01,083224,Staff,0,5,30,30
1650275168460,MATH 193A,A02,083225,Staff,0,5,30,30
1650275168460,MATH 193A,A03,083781,Staff,0,2,30,30
1650275168460,MATH 193A,A04,083782,Staff,0,1,30,30
1650275174483,MATH 197,001,091859,McAuley; Julian John,9998,0,9999,1
1650275180546,COGS 9,A01,083615,Staff,0,14,60,60
1650275186579,COGS 11,A01,083617,Boyle; Mary E. T.,24,0,40,16
1650275192601,COGS 13,A01,083071,Staff,0,31,40,40
1650275198628,COGS 14A,A01,092681,Staff,0,15,100,100
1650275204665,COGS 14B,A01,083073,Cheng; Tzu-Han,0,9,50,50
1650275210689,COGS 17,A01,092677,Staff,29,0,75,46
1650275216730,COGS 100,A01,083619,Staff,0,23,60,60
1650275222754,COGS 101A,A01,083621,Davis; Joshua Daniel,0,21,60,60
1650275228806,COGS 101B,A01,091572,Staff,4,0,60,56
1650275234833,COGS 101C,A01,083625,Delgado; Tania,19,0,30,11
1650275240857,COGS 107A,A01,083627,Boyle; Mary E. T.,0,8,60,60
1650275246889,COGS 118A,A01,083075,Staff,13,0,60,47
1650275252912,CSE 3,A50,083646,Miranda; Gregory Joseph,22,0,38,16
1650275252912,CSE 3,A51,083647,Miranda; Gregory Joseph,37,0,37,0
1650275258935,CSE 8A,A50,083650,Miranda; Gregory Joseph,0,22,40,40
1650275264960,CSE 11,A01,083080,Cao; Yingjun,0,74,40,40
1650275270987,CSE 12,A01,083652,Staff,0,10,100,100
1650275277012,CSE 15L,A01,083654,Staff,0,1,50,50
1650275277012,CSE 15L,A02,083655,Staff,4,0,50,46
1650275283040,CSE 20,A01,083657,Staff,53,0,80,27
1650275289063,CSE 30,A01,083084,Eldon; John,0,74,40,40
1650275295087,CSE 100,A01,083659,Cao; Yingjun,0,65,50,50
1650275301116,CSE 134B,A01,083661,Powell; Thomas Allan,0,28,65,65
1650275307142,CSE 140,A01,083663,Staff,0,0,75,75
1650275313167,CSE 140L,A01,083088,Eldon; John,0,6,75,75
1650275319191,CSE 175,A01,083665,Kumar; Rakesh,8,0,25,17
1650275325218,CSE 190,A00,092507,Dubnov; Shlomo,14,0,20,6
1650275331241,ECE 45,A01,083139,Staff,0,15,40,40
1650275337264,ECE 65,A50,083695,Staff,0,4,30,30
1650275343290,ECE 109,A01,091882,Touri; Behrouz,44,0,70,26
1650275349314,ECE 180,A00,083140,Abi Samra; Nicholas Camill,24,0,30,6
1650275349314,ECE 180,B00,083141,Abi Samra; Nicholas Camill,7,0,30,23
1650275355337,MATH 10A,A01,083735,Patchell; Gregory David,11,0,30,19
1650275355337,MATH 10A,A02,083736,Patchell; Gregory David,28,0,30,2
1650275355337,MATH 10A,A03,083737,Patchell; Gregory David,26,0,30,4
1650275361361,MATH 10B,A01,083207,Staff,0,6,30,30
1650275361361,MATH 10B,A02,083208,Staff,0,6,30,30
1650275361361,MATH 10B,B01,083739,Staff,17,0,30,13
1650275361361,MATH 10B,B02,083740,Staff,29,0,30,1
1650275367385,MATH 18,A01,083743,Staff,7,0,30,23
1650275367385,MATH 18,A02,083744,Staff,27,0,30,3
1650275367385,MATH 18,A03,083745,Staff,23,0,30,7
1650275367385,MATH 18,A04,083746,Staff,27,0,30,3
1650275367385,MATH 18,B01,083748,Staff,0,11,30,30
1650275367385,MATH 18,B02,083749,Staff,0,9,30,30
1650275367385,MATH 18,B03,083750,Staff,1,8,30,29
1650275367385,MATH 18,B04,083751,Staff,0,9,30,30
1650275373409,MATH 20A,A01,083754,Staff,26,0,40,14
1650275379432,MATH 20B,A01,083756,Staff,0,5,30,30
1650275379432,MATH 20B,A02,083757,Staff,0,7,30,30
1650275385458,MATH 20C,A01,083760,Staff,0,13,30,30
1650275385458,MATH 20C,A02,083761,Staff,0,13,30,30
1650275385458,MATH 20C,B01,083762,Staff,14,0,30,16
1650275385458,MATH 20C,B02,083763,Staff,28,0,30,2
1650275391482,MATH 20D,A01,083765,Staff,0,1,30,30
1650275391482,MATH 20D,A02,083766,Staff,8,0,30,22
1650275391482,MATH 20D,A03,083767,Staff,28,0,30,2
1650275397519,MATH 20E,A01,083771,Staff,6,0,30,24
1650275397519,MATH 20E,A02,083772,Staff,20,0,30,10
1650275397519,MATH 20E,B01,083773,Staff,0,0,30,30
1650275397519,MATH 20E,B02,083774,Staff,11,0,30,19
1650275403542,MATH 103A,A01,083777,Staff,0,9,30,30
1650275403542,MATH 103A,A02,083778,Staff,0,10,30,30
1650275403542,MATH 103A,B01,083779,Staff,0,10,30,30
1650275403542,MATH 103A,B02,083780,Staff,0,10,30,30
1650275409563,MATH 105,A01,085443,Staff,0,17,30,30
1650275415586,MATH 109,A01,083213,Anzaldo; Leesa B,0,5,30,30
1650275415586,MATH 109,A02,083214,Anzaldo; Leesa B,0,6,30,30
1650275415586,MATH 109,B01,083215,Anzaldo; Leesa B,0,4,30,30
1650275415586,MATH 109,B02,083216,Anzaldo; Leesa B,0,3,30,30
1650275421619,MATH 142A,A01,083219,Chow; Bennett,0,12,30,30
1650275421619,MATH 142A,A02,083220,Chow; Bennett,0,11,30,30
1650275421619,MATH 142A,B01,083221,Chow; Bennett,0,11,30,30
1650275421619,MATH 142A,B02,083222,Chow; Bennett,0,12,30,30
1650275427647,MATH 193A,A01,083224,Staff,0,5,30,30
1650275427647,MATH 193A,A02,083225,Staff,0,5,30,30
1650275427647,MATH 193A,A03,083781,Staff,0,2,30,30
1650275427647,MATH 193A,A04,083782,Staff,0,1,30,30
1650275433670,MATH 197,001,091859,McAuley; Julian John,9998,0,9999,1
1650275439740,COGS 9,A01,083615,Staff,0,14,60,60
1650275445762,COGS 11,A01,083617,Boyle; Mary E. T.,24,0,40,16
1650275451787,COGS 13,A01,083071,Staff,0,31,40,40
1650275457838,COGS 14A,A01,092681,Staff,0,15,100,100
1650275463951,COGS 14B,A01,083073,Cheng; Tzu-Han,0,9,50,50
1650275469977,COGS 17,A01,092677,Staff,29,0,75,46
1650275476002,COGS 100,A01,083619,Staff,0,23,60,60
1650275482043,COGS 101A,A01,083621,Davis; Joshua Daniel,0,21,60,60
1650275488067,COGS 101B,A01,091572,Staff,4,0,60,56
1650275494089,COGS 101C,A01,083625,Delgado; Tania,19,0,30,11
1650275500113,COGS 107A,A01,083627,Boyle; Mary E. T.,0,8,60,60
1650275506141,COGS 118A,A01,083075,Staff,13,0,60,47
1650275512179,CSE 3,A50,083646,Miranda; Gregory Joseph,22,0,38,16
1650275512179,CSE 3,A51,083647,Miranda; Gregory Joseph,37,0,37,0
1650275518204,CSE 8A,A50,083650,Miranda; Gregory Joseph,0,22,40,40
1650275524227,CSE 11,A01,083080,Cao; Yingjun,0,74,40,40
1650275530251,CSE 12,A01,083652,Staff,0,10,100,100
1650275536275,CSE 15L,A01,083654,Staff,0,1,50,50
1650275536275,CSE 15L,A02,083655,Staff,4,0,50,46
1650275542298,CSE 20,A01,083657,Staff,53,0,80,27
1650275548325,CSE 30,A01,083084,Eldon; John,0,74,40,40
1650275554351,CSE 100,A01,083659,Cao; Yingjun,0,65,50,50
1650275560377,CSE 134B,A01,083661,Powell; Thomas Allan,0,28,65,65
1650275566407,CSE 140,A01,083663,Staff,0,0,75,75
1650275572433,CSE 140L,A01,083088,Eldon; John,0,6,75,75
1650275578457,CSE 175,A01,083665,Kumar; Rakesh,8,0,25,17
1650275584480,CSE 190,A00,092507,Dubnov; Shlomo,14,0,20,6
1650275590506,ECE 45,A01,083139,Staff,0,15,40,40
1650275596533,ECE 65,A50,083695,Staff,0,4,30,30
1650275602558,ECE 109,A01,091882,Touri; Behrouz,44,0,70,26
1650275608583,ECE 180,A00,083140,Abi Samra; Nicholas Camill,24,0,30,6
1650275608583,ECE 180,B00,083141,Abi Samra; Nicholas Camill,7,0,30,23
1650275614607,MATH 10A,A01,083735,Patchell; Gregory David,11,0,30,19
1650275614607,MATH 10A,A02,083736,Patchell; Gregory David,28,0,30,2
1650275614607,MATH 10A,A03,083737,Patchell; Gregory David,26,0,30,4
1650275620631,MATH 10B,A01,083207,Staff,0,6,30,30
1650275620631,MATH 10B,A02,083208,Staff,0,6,30,30
1650275620631,MATH 10B,B01,083739,Staff,17,0,30,13
1650275620631,MATH 10B,B02,083740,Staff,29,0,30,1
1650275626654,MATH 18,A01,083743,Staff,7,0,30,23
1650275626654,MATH 18,A02,083744,Staff,27,0,30,3
1650275626654,MATH 18,A03,083745,Staff,23,0,30,7
1650275626654,MATH 18,A04,083746,Staff,27,0,30,3
1650275626654,MATH 18,B01,083748,Staff,0,11,30,30
1650275626654,MATH 18,B02,083749,Staff,0,9,30,30
1650275626654,MATH 18,B03,083750,Staff,1,8,30,29
1650275626654,MATH 18,B04,083751,Staff,0,9,30,30
1650275632680,MATH 20A,A01,083754,Staff,26,0,40,14
1650275638705,MATH 20B,A01,083756,Staff,0,5,30,30
1650275638705,MATH 20B,A02,083757,Staff,0,7,30,30
1650275644728,MATH 20C,A01,083760,Staff,0,13,30,30
1650275644728,MATH 20C,A02,083761,Staff,0,13,30,30
1650275644728,MATH 20C,B01,083762,Staff,14,0,30,16
1650275644728,MATH 20C,B02,083763,Staff,28,0,30,2
1650275650753,MATH 20D,A01,083765,Staff,0,1,30,30
1650275650753,MATH 20D,A02,083766,Staff,8,0,30,22
1650275650753,MATH 20D,A03,083767,Staff,28,0,30,2
1650275656780,MATH 20E,A01,083771,Staff,6,0,30,24
1650275656780,MATH 20E,A02,083772,Staff,20,0,30,10
1650275656780,MATH 20E,B01,083773,Staff,0,0,30,30
1650275656780,MATH 20E,B02,083774,Staff,11,0,30,19
1650275662809,MATH 103A,A01,083777,Staff,0,10,30,30
1650275662809,MATH 103A,A02,083778,Staff,0,10,30,30
1650275662809,MATH 103A,B01,083779,Staff,0,10,30,30
1650275662809,MATH 103A,B02,083780,Staff,0,10,30,30
1650275668832,MATH 105,A01,085443,Staff,0,17,30,30
1650275674856,MATH 109,A01,083213,Anzaldo; Leesa B,0,5,30,30
1650275674856,MATH 109,A02,083214,Anzaldo; Leesa B,0,6,30,30
1650275674856,MATH 109,B01,083215,Anzaldo; Leesa B,0,4,30,30
1650275674856,MATH 109,B02,083216,Anzaldo; Leesa B,0,3,30,30
1650275680882,MATH 142A,A01,083219,Chow; Bennett,0,12,30,30
1650275680882,MATH 142A,A02,083220,Chow; Bennett,0,11,30,30
1650275680882,MATH 142A,B01,083221,Chow; Bennett,0,11,30,30
1650275680882,MATH 142A,B02,083222,Chow; Bennett,0,12,30,30
1650275686906,MATH 193A,A01,083224,Staff,0,5,30,30
1650275686906,MATH 193A,A02,083225,Staff,0,5,30,30
1650275686906,MATH 193A,A03,083781,Staff,0,2,30,30
1650275686906,MATH 193A,A04,083782,Staff,0,1,30,30
1650275692932,MATH 197,001,091859,McAuley; Julian John,9998,0,9999,1
1650275698986,COGS 9,A01,083615,Staff,0,14,60,60
1650275705022,COGS 11,A01,083617,Boyle; Mary E. T.,24,0,40,16
1650275711051,COGS 13,A01,083071,Staff,0,31,40,40
1650275717077,COGS 14A,A01,092681,Staff,0,15,100,100
1650275723101,COGS 14B,A01,083073,Cheng; Tzu-Han,0,9,50,50
1650275729124,COGS 17,A01,092677,Staff,29,0,75,46
1650275735149,COGS 100,A01,083619,Staff,0,23,60,60
1650275741172,COGS 101A,A01,083621,Davis; Joshua Daniel,0,21,60,60
1650275747196,COGS 101B,A01,091572,Staff,4,0,60,56
1650275753225,COGS 101C,A01,083625,Delgado; Tania,19,0,30,11
1650275759254,COGS 107A,A01,083627,Boyle; Mary E. T.,0,8,60,60
1650275765276,COGS 118A,A01,083075,Staff,13,0,60,47
1650275771302,CSE 3,A50,083646,Miranda; Gregory Joseph,22,0,38,16
1650275771302,CSE 3,A51,083647,Miranda; Gregory Joseph,37,0,37,0
1650275777332,CSE 8A,A50,083650,Miranda; Gregory Joseph,0,22,40,40
1650275783359,CSE 11,A01,083080,Cao; Yingjun,0,74,40,40
1650275789382,CSE 12,A01,083652,Staff,0,10,100,100
1650275795407,CSE 15L,A01,083654,Staff,0,1,50,50
1650275795407,CSE 15L,A02,083655,Staff,4,0,50,46
1650275801436,CSE 20,A01,083657,Staff,53,0,80,27
1650275807460,CSE 30,A01,083084,Eldon; John,0,74,40,40
1650275813485,CSE 100,A01,083659,Cao; Yingjun,0,65,50,50
1650275819523,CSE 134B,A01,083661,Powell; Thomas Allan,0,28,65,65
1650275825547,CSE 140,A01,083663,Staff,0,0,75,75
1650275831577,CSE 140L,A01,083088,Eldon; John,0,6,75,75
1650275837628,CSE 175,A01,083665,Kumar; Rakesh,8,0,25,17
1650275843656,CSE 190,A00,092507,Dubnov; Shlomo,14,0,20,6
1650275849683,ECE 45,A01,083139,Staff,0,15,40,40
1650275855717,ECE 65,A50,083695,Staff,0,4,30,30
1650275861748,ECE 109,A01,091882,Touri; Behrouz,44,0,70,26
1650275867782,ECE 180,A00,083140,Abi Samra; Nicholas Camill,24,0,30,6
1650275867782,ECE 180,B00,083141,Abi Samra; Nicholas Camill,7,0,30,23
1650275873807,MATH 10A,A01,083735,Patchell; Gregory David,11,0,30,19
1650275873807,MATH 10A,A02,083736,Patchell; Gregory David,28,0,30,2
1650275873807,MATH 10A,A03,083737,Patchell; Gregory David,26,0,30,4
1650275879838,MATH 10B,A01,083207,Staff,0,6,30,30
1650275879838,MATH 10B,A02,083208,Staff,0,6,30,30
1650275879838,MATH 10B,B01,083739,Staff,17,0,30,13
1650275879838,MATH 10B,B02,083740,Staff,29,0,30,1
1650275885864,MATH 18,A01,083743,Staff,7,0,30,23
1650275885864,MATH 18,A02,083744,Staff,27,0,30,3
1650275885864,MATH 18,A03,083745,Staff,23,0,30,7
1650275885864,MATH 18,A04,083746,Staff,27,0,30,3
1650275885864,MATH 18,B01,083748,Staff,0,11,30,30
1650275885864,MATH 18,B02,083749,Staff,0,9,30,30
1650275885864,MATH 18,B03,083750,Staff,1,8,30,29
1650275885864,MATH 18,B04,083751,Staff,0,9,30,30
1650275891887,MATH 20A,A01,083754,Staff,26,0,40,14
1650275897917,MATH 20B,A01,083756,Staff,0,5,30,30
1650275897917,MATH 20B,A02,083757,Staff,0,7,30,30
1650275903942,MATH 20C,A01,083760,Staff,0,13,30,30
1650275903942,MATH 20C,A02,083761,Staff,0,13,30,30
1650275903942,MATH 20C,B01,083762,Staff,14,0,30,16
1650275903942,MATH 20C,B02,083763,Staff,28,0,30,2
1650275909969,MATH 20D,A01,083765,Staff,0,1,30,30
1650275909969,MATH 20D,A02,083766,Staff,8,0,30,22
1650275909969,MATH 20D,A03,083767,Staff,28,0,30,2
1650275915997,MATH 20E,A01,083771,Staff,6,0,30,24
1650275915997,MATH 20E,A02,083772,Staff,20,0,30,10
1650275915997,MATH 20E,B01,083773,Staff,0,0,30,30
1650275915997,MATH 20E,B02,083774,Staff,11,0,30,19
1650275922021,MATH 103A,A01,083777,Staff,0,10,30,30
1650275922021,MATH 103A,A02,083778,Staff,0,10,30,30
1650275922021,MATH 103A,B01,083779,Staff,0,10,30,30
1650275922021,MATH 103A,B02,083780,Staff,0,10,30,30
1650275928045,MATH 105,A01,085443,Staff,0,17,30,30
1650275934073,MATH 109,A01,083213,Anzaldo; Leesa B,0,5,30,30
1650275934073,MATH 109,A02,083214,Anzaldo; Leesa B,0,6,30,30
1650275934073,MATH 109,B01,083215,Anzaldo; Leesa B,0,4,30,30
1650275934073,MATH 109,B02,083216,Anzaldo; Leesa B,0,3,30,30
1650275940099,MATH 142A,A01,083219,Chow; Bennett,0,12,30,30
1650275940099,MATH 142A,A02,083220,Chow; Bennett,0,11,30,30
1650275940099,MATH 142A,B01,083221,Chow; Bennett,0,11,30,30
1650275940099,MATH 142A,B02,083222,Chow; Bennett,0,12,30,30
1650275946124,MATH 193A,A01,083224,Staff,0,5,30,30
1650275946124,MATH 193A,A02,083225,Staff,0,5,30,30
1650275946124,MATH 193A,A03,083781,Staff,0,2,30,30
1650275946124,MATH 193A,A04,083782,Staff,0,1,30,30
1650275952148,MATH 197,001,091859,McAuley; Julian John,9998,0,9999,1
1650275958223,COGS 9,A01,083615,Staff,0,14,60,60
1650275964248,COGS 11,A01,083617,Boyle; Mary E. T.,24,0,40,16
1650275970272,COGS 13,A01,083071,Staff,0,31,40,40
1650275976299,COGS 14A,A01,092681,Staff,0,15,100,100
1650275982324,COGS 14B,A01,083073,Cheng; Tzu-Han,0,9,50,50
1650275988348,COGS 17,A01,092677,Staff,29,0,75,46
1650275994374,COGS 100,A01,083619,Staff,0,23,60,60
1650276000399,COGS 101A,A01,083621,Davis; Joshua Daniel,0,21,60,60
1650276006426,COGS 101B,A01,091572,Staff,4,0,60,56
1650276012454,COGS 101C,A01,083625,Delgado; Tania,19,0,30,11
1650276018479,COGS 107A,A01,083627,Boyle; Mary E. T.,0,8,60,60
1650276024503,COGS 118A,A01,083075,Staff,13,0,60,47
1650276030527,CSE 3,A50,083646,Miranda; Gregory Joseph,22,0,38,16
1650276030527,CSE 3,A51,083647,Miranda; Gregory Joseph,37,0,37,0
1650276036554,CSE 8A,A50,083650,Miranda; Gregory Joseph,0,22,40,40
1650276042579,CSE 11,A01,083080,Cao; Yingjun,0,74,40,40
1650276048605,CSE 12,A01,083652,Staff,0,10,100,100
1650276054633,CSE 15L,A01,083654,Staff,0,1,50,50
1650276054633,CSE 15L,A02,083655,Staff,4,0,50,46
1650276060746,CSE 20,A01,083657,Staff,53,0,80,27
1650276066769,CSE 30,A01,083084,Eldon; John,0,74,40,40
1650276072796,CSE 100,A01,083659,Cao; Yingjun,0,65,50,50
1650276078825,CSE 134B,A01,083661,Powell; Thomas Allan,0,28,65,65
1650276084853,CSE 140,A01,083663,Staff,0,0,75,75
1650276090877,CSE 140L,A01,083088,Eldon; John,0,6,75,75
1650276096901,CSE 175,A01,083665,Kumar; Rakesh,8,0,25,17
1650276102929,CSE 190,A00,092507,Dubnov; Shlomo,14,0,20,6
1650276108957,ECE 45,A01,083139,Staff,0,15,40,40
1650276114981,ECE 65,A50,083695,Staff,0,4,30,30
1650276121004,ECE 109,A01,091882,Touri; Behrouz,44,0,70,26
1650276127027,ECE 180,A00,083140,Abi Samra; Nicholas Camill,24,0,30,6
1650276127027,ECE 180,B00,083141,Abi Samra; Nicholas Camill,7,0,30,23
1650276133056,MATH 10A,A01,083735,Patchell; Gregory David,11,0,30,19
1650276133056,MATH 10A,A02,083736,Patchell; Gregory David,28,0,30,2
1650276133056,MATH 10A,A03,083737,Patchell; Gregory David,26,0,30,4
1650276139083,MATH 10B,A01,083207,Staff,0,6,30,30
1650276139083,MATH 10B,A02,083208,Staff,0,6,30,30
1650276139083,MATH 10B,B01,083739,Staff,17,0,30,13
1650276139083,MATH 10B,B02,083740,Staff,29,0,30,1
1650276145106,MATH 18,A01,083743,Staff,7,0,30,23
1650276145106,MATH 18,A02,083744,Staff,27,0,30,3
1650276145106,MATH 18,A03,083745,Staff,23,0,30,7
1650276145106,MATH 18,A04,083746,Staff,27,0,30,3
1650276145106,MATH 18,B01,083748,Staff,0,11,30,30
1650276145106,MATH 18,B02,083749,Staff,0,9,30,30
1650276145106,MATH 18,B03,083750,Staff,1,8,30,29
1650276145106,MATH 18,B04,083751,Staff,0,9,30,30
1650276151133,MATH 20A,A01,083754,Staff,26,0,40,14
1650276157161,MATH 20B,A01,083756,Staff,0,5,30,30
1650276157161,MATH 20B,A02,083757,Staff,0,7,30,30
1650276163206,MATH 20C,A01,083760,Staff,0,13,30,30
1650276163206,MATH 20C,A02,083761,Staff,0,13,30,30
1650276163206,MATH 20C,B01,083762,Staff,14,0,30,16
1650276163206,MATH 20C,B02,083763,Staff,28,0,30,2
1650276169233,MATH 20D,A01,083765,Staff,0,1,30,30
1650276169233,MATH 20D,A02,083766,Staff,8,0,30,22
1650276169233,MATH 20D,A03,083767,Staff,28,0,30,2
1650276175257,MATH 20E,A01,083771,Staff,6,0,30,24
1650276175257,MATH 20E,A02,083772,Staff,20,0,30,10
1650276175257,MATH 20E,B01,083773,Staff,0,0,30,30
1650276175257,MATH 20E,B02,083774,Staff,11,0,30,19
1650276181286,MATH 103A,A01,083777,Staff,0,10,30,30
1650276181286,MATH 103A,A02,083778,Staff,0,10,30,30
1650276181286,MATH 103A,B01,083779,Staff,0,10,30,30
1650276181286,MATH 103A,B02,083780,Staff,0,10,30,30
1650276187314,MATH 105,A01,085443,Staff,0,17,30,30
1650276193340,MATH 109,A01,083213,Anzaldo; Leesa B,0,5,30,30
1650276193340,MATH 109,A02,083214,Anzaldo; Leesa B,0,6,30,30
1650276193340,MATH 109,B01,083215,Anzaldo; Leesa B,0,4,30,30
1650276193340,MATH 109,B02,083216,Anzaldo; Leesa B,0,3,30,30
1650276199364,MATH 142A,A01,083219,Chow; Bennett,0,12,30,30
1650276199364,MATH 142A,A02,083220,Chow; Bennett,0,11,30,30
1650276199364,MATH 142A,B01,083221,Chow; Bennett,0,11,30,30
1650276199364,MATH 142A,B02,083222,Chow; Bennett,0,12,30,30
1650276205391,MATH 193A,A01,083224,Staff,0,5,30,30
1650276205391,MATH 193A,A02,083225,Staff,0,5,30,30
1650276205391,MATH 193A,A03,083781,Staff,0,2,30,30
1650276205391,MATH 193A,A04,083782,Staff,0,1,30,30
1650276211452,MATH 197,001,091859,McAuley; Julian John,9998,0,9999,1
1650276217506,COGS 9,A01,083615,Staff,0,14,60,60
1650276223550,COGS 11,A01,083617,Boyle; Mary E. T.,24,0,40,16
1650276229573,COGS 13,A01,083071,Staff,0,31,40,40
1650276235603,COGS 14A,A01,092681,Staff,0,15,100,100
1650276241627,COGS 14B,A01,083073,Cheng; Tzu-Han,0,9,50,50
1650276247650,COGS 17,A01,092677,Staff,29,0,75,46
1650276253675,COGS 100,A01,083619,Staff,0,23,60,60
1650276259698,COGS 101A,A01,083621,Davis; Joshua Daniel,0,21,60,60
1650276265723,COGS 101B,A01,091572,Staff,4,0,60,56
1650276271747,COGS 101C,A01,083625,Delgado; Tania,19,0,30,11
1650276277773,COGS 107A,A01,083627,Boyle; Mary E. T.,0,8,60,60
1650276283805,COGS 118A,A01,083075,Staff,13,0,60,47
1650276289834,CSE 3,A50,083646,Miranda; Gregory Joseph,21,0,38,17
1650276289834,CSE 3,A51,083647,Miranda; Gregory Joseph,37,0,37,0
1650276295864,CSE 8A,A50,083650,Miranda; Gregory Joseph,0,22,40,40
1650276301892,CSE 11,A01,083080,Cao; Yingjun,0,74,40,40
1650276307919,CSE 12,A01,083652,Staff,0,10,100,100
1650276313948,CSE 15L,A01,083654,Staff,0,1,50,50
1650276313948,CSE 15L,A02,083655,Staff,4,0,50,46
1650276319972,CSE 20,A01,083657,Staff,53,0,80,27
1650276325996,CSE 30,A01,083084,Eldon; John,0,74,40,40
1650276332021,CSE 100,A01,083659,Cao; Yingjun,0,65,50,50
1650276338047,CSE 134B,A01,083661,Powell; Thomas Allan,0,28,65,65
1650276344078,CSE 140,A01,083663,Staff,0,0,75,75
1650276350101,CSE 140L,A01,083088,Eldon; John,0,6,75,75
1650276356125,CSE 175,A01,083665,Kumar; Rakesh,8,0,25,17
1650276362153,CSE 190,A00,092507,Dubnov; Shlomo,14,0,20,6
1650276368180,ECE 45,A01,083139,Staff,0,15,40,40
1650276374205,ECE 65,A50,083695,Staff,0,4,30,30
1650276380228,ECE 109,A01,091882,Touri; Behrouz,44,0,70,26
1650276386255,ECE 180,A00,083140,Abi Samra; Nicholas Camill,24,0,30,6
1650276386255,ECE 180,B00,083141,Abi Samra; Nicholas Camill,7,0,30,23
1650276392279,MATH 10A,A01,083735,Patchell; Gregory David,11,0,30,19
1650276392279,MATH 10A,A02,083736,Patchell; Gregory David,28,0,30,2
1650276392279,MATH 10A,A03,083737,Patchell; Gregory David,26,0,30,4
1650276398303,MATH 10B,A01,083207,Staff,0,6,30,30
1650276398303,MATH 10B,A02,083208,Staff,0,6,30,30
1650276398303,MATH 10B,B01,083739,Staff,17,0,30,13
1650276398303,MATH 10B,B02,083740,Staff,29,0,30,1
1650276404330,MATH 18,A01,083743,Staff,7,0,30,23
1650276404330,MATH 18,A02,083744,Staff,27,0,30,3
1650276404330,MATH 18,A03,083745,Staff,23,0,30,7
1650276404330,MATH 18,A04,083746,Staff,27,0,30,3
1650276404330,MATH 18,B01,083748,Staff,0,11,30,30
1650276404330,MATH 18,B02,083749,Staff,0,9,30,30
1650276404330,MATH 18,B03,083750,Staff,1,8,30,29
1650276404330,MATH 18,B04,083751,Staff,0,9,30,30
1650276410356,MATH 20A,A01,083754,Staff,26,0,40,14
1650276416383,MATH 20B,A01,083756,Staff,0,5,30,30
1650276416383,MATH 20B,A02,083757,Staff,0,7,30,30
1650276422408,MATH 20C,A01,083760,Staff,0,13,30,30
1650276422408,MATH 20C,A02,083761,Staff,0,13,30,30
1650276422408,MATH 20C,B01,083762,Staff,14,0,30,16
1650276422408,MATH 20C,B02,083763,Staff,28,0,30,2
1650276428436,MATH 20D,A01,083765,Staff,0,1,30,30
1650276428436,MATH 20D,A02,083766,Staff,8,0,30,22
1650276428436,MATH 20D,A03,083767,Staff,28,0,30,2
1650276434462,MATH 20E,A01,083771,Staff,6,0,30,24
1650276434462,MATH 20E,A02,083772,Staff,20,0,30,10
1650276434462,MATH 20E,B01,083773,Staff,0,0,30,30
1650276434462,MATH 20E,B02,083774,Staff,11,0,30,19
1650276440490,MATH 103A,A01,083777,Staff,0,10,30,30
1650276440490,MATH 103A,A02,083778,Staff,0,10,30,30
1650276440490,MATH 103A,B01,083779,Staff,0,10,30,30
1650276440490,MATH 103A,B02,083780,Staff,0,10,30,30
1650276446521,MATH 105,A01,085443,Staff,0,17,30,30
1650276452550,MATH 109,A01,083213,Anzaldo; Leesa B,0,5,30,30
1650276452550,MATH 109,A02,083214,Anzaldo; Leesa B,0,6,30,30
1650276452550,MATH 109,B01,083215,Anzaldo; Leesa B,0,4,30,30
1650276452550,MATH 109,B02,083216,Anzaldo; Leesa B,0,3,30,30
1650276458579,MATH 142A,A01,083219,Chow; Bennett,0,12,30,30
1650276458579,MATH 142A,A02,083220,Chow; Bennett,0,11,30,30
1650276458579,MATH 142A,B01,083221,Chow; Bennett,0,11,30,30
1650276458579,MATH 142A,B02,083222,Chow; Bennett,0,12,30,30
1650276464605,MATH 193A,A01,083224,Staff,0,5,30,30
1650276464605,MATH 193A,A02,083225,Staff,0,5,30,30
1650276464605,MATH 193A,A03,083781,Staff,0,2,30,30
1650276464605,MATH 193A,A04,083782,Staff,0,1,30,30
1650276470629,MATH 197,001,091859,McAuley; Julian John,9998,0,9999,1
1650276476701,COGS 9,A01,083615,Staff,0,14,60,60
1650276482730,COGS 11,A01,083617,Boyle; Mary E. T.,24,0,40,16
1650276488759,COGS 13,A01,083071,Staff,0,31,40,40
1650276494789,COGS 14A,A01,092681,Staff,0,15,100,100
1650276500815,COGS 14B,A01,083073,Cheng; Tzu-Han,0,9,50,50
1650276506849,COGS 17,A01,092677,Staff,29,0,75,46
1650276512873,COGS 100,A01,083619,Staff,0,23,60,60
1650276518900,COGS 101A,A01,083621,Davis; Joshua Daniel,0,21,60,60
1650276524923,COGS 101B,A01,091572,Staff,4,0,60,56
1650276530951,COGS 101C,A01,083625,Delgado; Tania,19,0,30,11
1650276536981,COGS 107A,A01,083627,Boyle; Mary E. T.,0,8,60,60
1650276543004,COGS 118A,A01,083075,Staff,13,0,60,47
1650276549030,CSE 3,A50,083646,Miranda; Gregory Joseph,21,0,38,17
1650276549030,CSE 3,A51,083647,Miranda; Gregory Joseph,37,0,37,0
1650276555064,CSE 8A,A50,083650,Miranda; Gregory Joseph,0,22,40,40
1650276561096,CSE 11,A01,083080,Cao; Yingjun,0,74,40,40
1650276567136,CSE 12,A01,083652,Staff,0,10,100,100
1650276573164,CSE 15L,A01,083654,Staff,0,1,50,50
1650276573164,CSE 15L,A02,083655,Staff,4,0,50,46
1650276579206,CSE 20,A01,083657,Staff,53,0,80,27
1650276585230,CSE 30,A01,083084,Eldon; John,0,74,40,40
1650276591263,CSE 100,A01,083659,Cao; Yingjun,0,65,50,50
1650276597292,CSE 134B,A01,083661,Powell; Thomas Allan,0,28,65,65
1650276603321,CSE 140,A01,083663,Staff,0,0,75,75
1650276609346,CSE 140L,A01,083088,Eldon; John,0,6,75,75
1650276615371,CSE 175,A01,083665,Kumar; Rakesh,8,0,25,17
1650276621395,CSE 190,A00,092507,Dubnov; Shlomo,14,0,20,6
1650276627420,ECE 45,A01,083139,Staff,0,15,40,40
1650276633450,ECE 65,A50,083695,Staff,0,4,30,30
1650276639477,ECE 109,A01,091882,Touri; Behrouz,44,0,70,26
1650276645505,ECE 180,A00,083140,Abi Samra; Nicholas Camill,24,0,30,6
1650276645505,ECE 180,B00,083141,Abi Samra; Nicholas Camill,7,0,30,23
1650276651529,MATH 10A,A01,083735,Patchell; Gregory David,11,0,30,19
1650276651529,MATH 10A,A02,083736,Patchell; Gregory David,28,0,30,2
1650276651529,MATH 10A,A03,083737,Patchell; Gregory David,26,0,30,4
1650276657663,MATH 10B,A01,083207,Staff,0,6,30,30
1650276657663,MATH 10B,A02,083208,Staff,0,6,30,30
1650276657663,MATH 10B,B01,083739,Staff,17,0,30,13
1650276657663,MATH 10B,B02,083740,Staff,29,0,30,1
1650276663693,MATH 18,A01,083743,Staff,7,0,30,23
1650276663693,MATH 18,A02,083744,Staff,27,0,30,3
1650276663693,MATH 18,A03,083745,Staff,23,0,30,7
1650276663693,MATH 18,A04,083746,Staff,27,0,30,3
1650276663693,MATH 18,B01,083748,Staff,0,11,30,30
1650276663693,MATH 18,B02,083749,Staff,0,9,30,30
1650276663693,MATH 18,B03,083750,Staff,1,8,30,29
1650276663693,MATH 18,B04,083751,Staff,0,9,30,30
1650276669728,MATH 20A,A01,083754,Staff,26,0,40,14
1650276675755,MATH 20B,A01,083756,Staff,0,5,30,30
1650276675755,MATH 20B,A02,083757,Staff,0,7,30,30
1650276681795,MATH 20C,A01,083760,Staff,0,13,30,30
1650276681795,MATH 20C,A02,083761,Staff,0,13,30,30
1650276681795,MATH 20C,B01,083762,Staff,14,0,30,16
1650276681795,MATH 20C,B02,083763,Staff,28,0,30,2
1650276687819,MATH 20D,A01,083765,Staff,0,1,30,30
1650276687819,MATH 20D,A02,083766,Staff,8,0,30,22
1650276687819,MATH 20D,A03,083767,Staff,28,0,30,2
1650276693845,MATH 20E,A01,083771,Staff,6,0,30,24
1650276693845,MATH 20E,A02,083772,Staff,20,0,30,10
1650276693845,MATH 20E,B01,083773,Staff,0,0,30,30
1650276693845,MATH 20E,B02,083774,Staff,11,0,30,19
1650276699874,MATH 103A,A01,083777,Staff,0,10,30,30
1650276699874,MATH 103A,A02,083778,Staff,0,10,30,30
1650276699874,MATH 103A,B01,083779,Staff,0,10,30,30
1650276699874,MATH 103A,B02,083780,Staff,0,10,30,30
1650276705897,MATH 105,A01,085443,Staff,0,17,30,30
1650276711921,MATH 109,A01,083213,Anzaldo; Leesa B,0,5,30,30
1650276711921,MATH 109,A02,083214,Anzaldo; Leesa B,0,6,30,30
1650276711921,MATH 109,B01,083215,Anzaldo; Leesa B,0,4,30,30
1650276711921,MATH 109,B02,083216,Anzaldo; Leesa B,0,3,30,30
1650276717946,MATH 142A,A01,083219,Chow; Bennett,0,12,30,30
1650276717946,MATH 142A,A02,083220,Chow; Bennett,0,11,30,30
1650276717946,MATH 142A,B01,083221,Chow; Bennett,0,11,30,30
1650276717946,MATH 142A,B02,083222,Chow; Bennett,0,12,30,30
1650276723975,MATH 193A,A01,083224,Staff,0,5,30,30
1650276723975,MATH 193A,A02,083225,Staff,0,5,30,30
1650276723975,MATH 193A,A03,083781,Staff,0,2,30,30
1650276723975,MATH 193A,A04,083782,Staff,0,1,30,30
1650276729998,MATH 197,001,091859,McAuley; Julian John,9998,0,9999,1
1650276736072,COGS 9,A01,083615,Staff,0,14,60,60
1650276742099,COGS 11,A01,083617,Boyle; Mary E. T.,24,0,40,16
1650276748131,COGS 13,A01,083071,Staff,0,31,40,40
1650276754155,COGS 14A,A01,092681,Staff,0,15,100,100
1650276760179,COGS 14B,A01,083073,Cheng; Tzu-Han,0,9,50,50
1650276766204,COGS 17,A01,092677,Staff,29,0,75,46
1650276772239,COGS 100,A01,083619,Staff,0,23,60,60
1650276778284,COGS 101A,A01,083621,Davis; Joshua Daniel,0,21,60,60
1650276784308,COGS 101B,A01,091572,Staff,4,0,60,56
1650276790342,COGS 101C,A01,083625,Delgado; Tania,19,0,30,11
1650276796366,COGS 107A,A01,083627,Boyle; Mary E. T.,0,8,60,60
1650276802391,COGS 118A,A01,083075,Staff,13,0,60,47
1650276808416,CSE 3,A50,083646,Miranda; Gregory Joseph,21,0,38,17
1650276808416,CSE 3,A51,083647,Miranda; Gregory Joseph,37,0,37,0
1650276814441,CSE 8A,A50,083650,Miranda; Gregory Joseph,0,22,40,40
1650276820468,CSE 11,A01,083080,Cao; Yingjun,0,74,40,40
1650276826512,CSE 12,A01,083652,Staff,0,10,100,100
1650276832547,CSE 15L,A01,083654,Staff,0,1,50,50
1650276832547,CSE 15L,A02,083655,Staff,4,0,50,46
1650276838573,CSE 20,A01,083657,Staff,53,0,80,27
1650276844609,CSE 30,A01,083084,Eldon; John,0,74,40,40
1650276850633,CSE 100,A01,083659,Cao; Yingjun,0,65,50,50
1650276856661,CSE 134B,A01,083661,Powell; Thomas Allan,0,28,65,65
1650276862687,CSE 140,A01,083663,Staff,0,0,75,75
1650276868715,CSE 140L,A01,083088,Eldon; John,0,6,75,75
1650276874762,CSE 175,A01,083665,Kumar; Rakesh,8,0,25,17
1650276880788,CSE 190,A00,092507,Dubnov; Shlomo,14,0,20,6
1650276886811,ECE 45,A01,083139,Staff,0,15,40,40
1650276892837,ECE 65,A50,083695,Staff,0,4,30,30
1650276898864,ECE 109,A01,091882,Touri; Behrouz,44,0,70,26
1650276904898,ECE 180,A00,083140,Abi Samra; Nicholas Camill,24,0,30,6
1650276904898,ECE 180,B00,083141,Abi Samra; Nicholas Camill,7,0,30,23
1650276910920,MATH 10A,A01,083735,Patchell; Gregory David,11,0,30,19
1650276910920,MATH 10A,A02,083736,Patchell; Gregory David,28,0,30,2
1650276910920,MATH 10A,A03,083737,Patchell; Gregory David,26,0,30,4
1650276916945,MATH 10B,A01,083207,Staff,0,6,30,30
1650276916945,MATH 10B,A02,083208,Staff,0,6,30,30
1650276916945,MATH 10B,B01,083739,Staff,17,0,30,13
1650276916945,MATH 10B,B02,083740,Staff,29,0,30,1
1650276922975,MATH 18,A01,083743,Staff,7,0,30,23
1650276922975,MATH 18,A02,083744,Staff,27,0,30,3
1650276922975,MATH 18,A03,083745,Staff,23,0,30,7
1650276922975,MATH 18,A04,083746,Staff,27,0,30,3
1650276922975,MATH 18,B01,083748,Staff,0,11,30,30
1650276922975,MATH 18,B02,083749,Staff,0,9,30,30
1650276922975,MATH 18,B03,083750,Staff,1,8,30,29
1650276922975,MATH 18,B04,083751,Staff,0,9,30,30
1650276929021,MATH 20A,A01,083754,Staff,26,0,40,14
1650276935047,MATH 20B,A01,083756,Staff,0,5,30,30
1650276935047,MATH 20B,A02,083757,Staff,0,7,30,30
1650276941070,MATH 20C,A01,083760,Staff,0,13,30,30
1650276941070,MATH 20C,A02,083761,Staff,0,13,30,30
1650276941070,MATH 20C,B01,083762,Staff,14,0,30,16
1650276941070,MATH 20C,B02,083763,Staff,28,0,30,2
1650276947098,MATH 20D,A01,083765,Staff,0,1,30,30
1650276947098,MATH 20D,A02,083766,Staff,8,0,30,22
1650276947098,MATH 20D,A03,083767,Staff,28,0,30,2
1650276953126,MATH 20E,A01,083771,Staff,6,0,30,24
1650276953126,MATH 20E,A02,083772,Staff,20,0,30,10
1650276953126,MATH 20E,B01,083773,Staff,0,0,30,30
1650276953126,MATH 20E,B02,083774,Staff,11,0,30,19
1650276959160,MATH 103A,A01,083777,Staff,0,10,30,30
1650276959160,MATH 103A,A02,083778,Staff,0,10,30,30
1650276959160,MATH 103A,B01,083779,Staff,0,10,30,30
1650276959160,MATH 103A,B02,083780,Staff,0,10,30,30
1650276965182,MATH 105,A01,085443,Staff,0,17,30,30
1650276971218,MATH 109,A01,083213,Anzaldo; Leesa B,0,5,30,30
1650276971218,MATH 109,A02,083214,Anzaldo; Leesa B,0,6,30,30
1650276971218,MATH 109,B01,083215,Anzaldo; Leesa B,0,4,30,30
1650276971218,MATH 109,B02,083216,Anzaldo; Leesa B,0,3,30,30
1650276977243,MATH 142A,A01,083219,Chow; Bennett,0,12,30,30
1650276977243,MATH 142A,A02,083220,Chow; Bennett,0,11,30,30
1650276977243,MATH 142A,B01,083221,Chow; Bennett,0,11,30,30
1650276977243,MATH 142A,B02,083222,Chow; Bennett,0,12,30,30
1650276983278,MATH 193A,A01,083224,Staff,0,5,30,30
1650276983278,MATH 193A,A02,083225,Staff,0,5,30,30
1650276983278,MATH 193A,A03,083781,Staff,0,2,30,30
1650276983278,MATH 193A,A04,083782,Staff,0,1,30,30
1650276989301,MATH 197,001,091859,McAuley; Julian John,9998,0,9999,1
1650276995387,COGS 9,A01,083615,Staff,0,14,60,60
1650277001424,COGS 11,A01,083617,Boyle; Mary E. T.,24,0,40,16
1650277007457,COGS 13,A01,083071,Staff,0,31,40,40
1650277013489,COGS 14A,A01,092681,Staff,0,15,100,100
1650277019519,COGS 14B,A01,083073,Cheng; Tzu-Han,0,9,50,50
1650277025546,COGS 17,A01,092677,Staff,29,0,75,46
1650277031571,COGS 100,A01,083619,Staff,0,23,60,60
1650277037609,COGS 101A,A01,083621,Davis; Joshua Daniel,0,21,60,60
1650277043633,COGS 101B,A01,091572,Staff,4,0,60,56
1650277049659,COGS 101C,A01,083625,Delgado; Tania,19,0,30,11
1650277055686,COGS 107A,A01,083627,Boyle; Mary E. T.,0,8,60,60
1650277061709,COGS 118A,A01,083075,Staff,13,0,60,47
1650277067738,CSE 3,A50,083646,Miranda; Gregory Joseph,21,0,38,17
1650277067738,CSE 3,A51,083647,Miranda; Gregory Joseph,37,0,37,0
1650277073767,CSE 8A,A50,083650,Miranda; Gregory Joseph,0,22,40,40
1650277079807,CSE 11,A01,083080,Cao; Yingjun,0,74,40,40
1650277085836,CSE 12,A01,083652,Staff,0,10,100,100
1650277091865,CSE 15L,A01,083654,Staff,0,1,50,50
1650277091865,CSE 15L,A02,083655,Staff,4,0,50,46
1650277097889,CSE 20,A01,083657,Staff,53,0,80,27
1650277103922,CSE 30,A01,083084,Eldon; John,0,74,40,40
1650277109946,CSE 100,A01,083659,Cao; Yingjun,0,65,50,50
1650277115976,CSE 134B,A01,083661,Powell; Thomas Allan,0,28,65,65
1650277122004,CSE 140,A01,083663,Staff,0,0,75,75
1650277128030,CSE 140L,A01,083088,Eldon; John,0,6,75,75
1650277134055,CSE 175,A01,083665,Kumar; Rakesh,8,0,25,17
1650277140083,CSE 190,A00,092507,Dubnov; Shlomo,14,0,20,6
1650277146107,ECE 45,A01,083139,Staff,0,15,40,40
1650277152130,ECE 65,A50,083695,Staff,0,4,30,30
1650277158159,ECE 109,A01,091882,Touri; Behrouz,44,0,70,26
1650277164182,ECE 180,A00,083140,Abi Samra; Nicholas Camill,24,0,30,6
1650277164182,ECE 180,B00,083141,Abi Samra; Nicholas Camill,7,0,30,23
1650277170210,MATH 10A,A01,083735,Patchell; Gregory David,11,0,30,19
1650277170210,MATH 10A,A02,083736,Patchell; Gregory David,28,0,30,2
1650277170210,MATH 10A,A03,083737,Patchell; Gregory David,26,0,30,4
1650277176242,MATH 10B,A01,083207,Staff,0,6,30,30
1650277176242,MATH 10B,A02,083208,Staff,0,6,30,30
1650277176242,MATH 10B,B01,083739,Staff,17,0,30,13
1650277176242,MATH 10B,B02,083740,Staff,29,0,30,1
1650277182268,MATH 18,A01,083743,Staff,7,0,30,23
1650277182268,MATH 18,A02,083744,Staff,27,0,30,3
1650277182268,MATH 18,A03,083745,Staff,23,0,30,7
1650277182268,MATH 18,A04,083746,Staff,27,0,30,3
1650277182268,MATH 18,B01,083748,Staff,0,11,30,30
1650277182268,MATH 18,B02,083749,Staff,0,9,30,30
1650277182268,MATH 18,B03,083750,Staff,1,8,30,29
1650277182268,MATH 18,B04,083751,Staff,0,9,30,30
1650277188293,MATH 20A,A01,083754,Staff,26,0,40,14
1650277194331,MATH 20B,A01,083756,Staff,0,5,30,30
1650277194331,MATH 20B,A02,083757,Staff,0,7,30,30
1650277200364,MATH 20C,A01,083760,Staff,0,13,30,30
1650277200364,MATH 20C,A02,083761,Staff,0,13,30,30
1650277200364,MATH 20C,B01,083762,Staff,14,0,30,16
1650277200364,MATH 20C,B02,083763,Staff,28,0,30,2
1650277206388,MATH 20D,A01,083765,Staff,0,1,30,30
1650277206388,MATH 20D,A02,083766,Staff,8,0,30,22
1650277206388,MATH 20D,A03,083767,Staff,28,0,30,2
1650277212423,MATH 20E,A01,083771,Staff,6,0,30,24
1650277212423,MATH 20E,A02,083772,Staff,20,0,30,10
1650277212423,MATH 20E,B01,083773,Staff,0,0,30,30
1650277212423,MATH 20E,B02,083774,Staff,11,0,30,19
1650277218446,MATH 103A,A01,083777,Staff,0,10,30,30
1650277218446,MATH 103A,A02,083778,Staff,0,10,30,30
1650277218446,MATH 103A,B01,083779,Staff,0,10,30,30
1650277218446,MATH 103A,B02,083780,Staff,0,10,30,30
1650277224471,MATH 105,A01,085443,Staff,0,17,30,30
1650277230502,MATH 109,A01,083213,Anzaldo; Leesa B,0,5,30,30
1650277230502,MATH 109,A02,083214,Anzaldo; Leesa B,0,6,30,30
1650277230502,MATH 109,B01,083215,Anzaldo; Leesa B,0,4,30,30
1650277230502,MATH 109,B02,083216,Anzaldo; Leesa B,0,3,30,30
1650277236528,MATH 142A,A01,083219,Chow; Bennett,0,12,30,30
1650277236528,MATH 142A,A02,083220,Chow; Bennett,0,11,30,30
1650277236528,MATH 142A,B01,083221,Chow; Bennett,0,11,30,30
1650277236528,MATH 142A,B02,083222,Chow; Bennett,0,12,30,30
1650277242554,MATH 193A,A01,083224,Staff,0,5,30,30
1650277242554,MATH 193A,A02,083225,Staff,0,5,30,30
1650277242554,MATH 193A,A03,083781,Staff,0,2,30,30
1650277242554,MATH 193A,A04,083782,Staff,0,1,30,30
1650277248578,MATH 197,001,091859,McAuley; Julian John,9998,0,9999,1
1650277254769,COGS 9,A01,083615,Staff,0,14,60,60
1650277260793,COGS 11,A01,083617,Boyle; Mary E. T.,24,0,40,16
1650277266838,COGS 13,A01,083071,Staff,0,31,40,40
1650277272879,COGS 14A,A01,092681,Staff,0,15,100,100
1650277278903,COGS 14B,A01,083073,Cheng; Tzu-Han,0,9,50,50
1650277284940,COGS 17,A01,092677,Staff,29,0,75,46
1650277290971,COGS 100,A01,083619,Staff,0,23,60,60
1650277297026,COGS 101A,A01,083621,Davis; Joshua Daniel,0,21,60,60
1650277303057,COGS 101B,A01,091572,Staff,4,0,60,56
1650277309101,COGS 101C,A01,083625,Delgado; Tania,19,0,30,11
1650277315126,COGS 107A,A01,083627,Boyle; Mary E. T.,0,8,60,60
1650277321151,COGS 118A,A01,083075,Staff,13,0,60,47
1650277327184,CSE 3,A50,083646,Miranda; Gregory Joseph,21,0,38,17
1650277327184,CSE 3,A51,083647,Miranda; Gregory Joseph,37,0,37,0
1650277333208,CSE 8A,A50,083650,Miranda; Gregory Joseph,0,22,40,40
1650277339234,CSE 11,A01,083080,Cao; Yingjun,0,74,40,40
1650277345286,CSE 12,A01,083652,Staff,0,10,100,100
1650277351323,CSE 15L,A01,083654,Staff,0,1,50,50
1650277351323,CSE 15L,A02,083655,Staff,4,0,50,46
1650277357353,CSE 20,A01,083657,Staff,53,0,80,27
1650277363401,CSE 30,A01,083084,Eldon; John,0,74,40,40
1650277369446,CSE 100,A01,083659,Cao; Yingjun,0,65,50,50
1650277375488,CSE 134B,A01,083661,Powell; Thomas Allan,0,28,65,65
1650277381537,CSE 140,A01,083663,Staff,0,0,75,75
1650277387562,CSE 140L,A01,083088,Eldon; John,0,6,75,75
1650277393611,CSE 175,A01,083665,Kumar; Rakesh,8,0,25,17
1650277399638,CSE 190,A00,092507,Dubnov; Shlomo,14,0,20,6
1650277405664,ECE 45,A01,083139,Staff,0,15,40,40
1650277411693,ECE 65,A50,083695,Staff,0,4,30,30
1650277417726,ECE 109,A01,091882,Touri; Behrouz,44,0,70,26
1650277423753,ECE 180,A00,083140,Abi Samra; Nicholas Camill,24,0,30,6
1650277423753,ECE 180,B00,083141,Abi Samra; Nicholas Camill,7,0,30,23
1650277429794,MATH 10A,A01,083735,Patchell; Gregory David,11,0,30,19
1650277429794,MATH 10A,A02,083736,Patchell; Gregory David,28,0,30,2
1650277429794,MATH 10A,A03,083737,Patchell; Gregory David,26,0,30,4
1650277435824,MATH 10B,A01,083207,Staff,0,6,30,30
1650277435824,MATH 10B,A02,083208,Staff,0,6,30,30
1650277435824,MATH 10B,B01,083739,Staff,17,0,30,13
1650277435824,MATH 10B,B02,083740,Staff,29,0,30,1
1650277441853,MATH 18,A01,083743,Staff,7,0,30,23
1650277441853,MATH 18,A02,083744,Staff,27,0,30,3
1650277441853,MATH 18,A03,083745,Staff,23,0,30,7
1650277441853,MATH 18,A04,083746,Staff,27,0,30,3
1650277441853,MATH 18,B01,083748,Staff,0,11,30,30
1650277441853,MATH 18,B02,083749,Staff,0,9,30,30
1650277441853,MATH 18,B03,083750,Staff,1,8,30,29
1650277441853,MATH 18,B04,083751,Staff,0,9,30,30
1650277447890,MATH 20A,A01,083754,Staff,26,0,40,14
1650277453925,MATH 20B,A01,083756,Staff,0,5,30,30
1650277453925,MATH 20B,A02,083757,Staff,0,7,30,30
1650277459957,MATH 20C,A01,083760,Staff,0,13,30,30
1650277459957,MATH 20C,A02,083761,Staff,0,13,30,30
1650277459957,MATH 20C,B01,083762,Staff,14,0,30,16
1650277459957,MATH 20C,B02,083763,Staff,28,0,30,2
1650277465984,MATH 20D,A01,083765,Staff,0,1,30,30
1650277465984,MATH 20D,A02,083766,Staff,8,0,30,22
1650277465984,MATH 20D,A03,083767,Staff,28,0,30,2
1650277472015,MATH 20E,A01,083771,Staff,6,0,30,24
1650277472015,MATH 20E,A02,083772,Staff,20,0,30,10
1650277472015,MATH 20E,B01,083773,Staff,0,0,30,30
1650277472015,MATH 20E,B02,083774,Staff,11,0,30,19
1650277478052,MATH 103A,A01,083777,Staff,0,10,30,30
1650277478052,MATH 103A,A02,083778,Staff,0,10,30,30
1650277478052,MATH 103A,B01,083779,Staff,0,10,30,30
1650277478052,MATH 103A,B02,083780,Staff,0,10,30,30
1650277484081,MATH 105,A01,085443,Staff,0,17,30,30
1650277490110,MATH 109,A01,083213,Anzaldo; Leesa B,0,5,30,30
1650277490110,MATH 109,A02,083214,Anzaldo; Leesa B,0,6,30,30
1650277490110,MATH 109,B01,083215,Anzaldo; Leesa B,0,4,30,30
1650277490110,MATH 109,B02,083216,Anzaldo; Leesa B,0,3,30,30
1650277496147,MATH 142A,A01,083219,Chow; Bennett,0,12,30,30
1650277496147,MATH 142A,A02,083220,Chow; Bennett,0,11,30,30
1650277496147,MATH 142A,B01,083221,Chow; Bennett,0,11,30,30
1650277496147,MATH 142A,B02,083222,Chow; Bennett,0,12,30,30
1650277502172,MATH 193A,A01,083224,Staff,0,5,30,30
1650277502172,MATH 193A,A02,083225,Staff,0,5,30,30
1650277502172,MATH 193A,A03,083781,Staff,0,2,30,30
1650277502172,MATH 193A,A04,083782,Staff,0,1,30,30
1650277508199,MATH 197,001,091859,McAuley; Julian John,9998,0,9999,1
1650277514275,COGS 9,A01,083615,Staff,0,14,60,60
1650277520298,COGS 11,A01,083617,Boyle; Mary E. T.,24,0,40,16
1650277526326,COGS 13,A01,083071,Staff,0,31,40,40
1650277532351,COGS 14A,A01,092681,Staff,0,15,100,100
1650277538376,COGS 14B,A01,083073,Cheng; Tzu-Han,0,9,50,50
1650277544399,COGS 17,A01,092677,Staff,29,0,75,46
1650277550424,COGS 100,A01,083619,Staff,0,23,60,60
1650277556449,COGS 101A,A01,083621,Davis; Joshua Daniel,0,21,60,60
1650277562489,COGS 101B,A01,091572,Staff,4,0,60,56
1650277568513,COGS 101C,A01,083625,Delgado; Tania,19,0,30,11
1650277574537,COGS 107A,A01,083627,Boyle; Mary E. T.,0,8,60,60
1650277580560,COGS 118A,A01,083075,Staff,13,0,60,47
1650277586589,CSE 3,A50,083646,Miranda; Gregory Joseph,21,0,38,17
1650277586589,CSE 3,A51,083647,Miranda; Gregory Joseph,37,0,37,0
1650277592630,CSE 8A,A50,083650,Miranda; Gregory Joseph,0,22,40,40
1650277598655,CSE 11,A01,083080,Cao; Yingjun,0,74,40,40
1650277604677,CSE 12,A01,083652,Staff,0,10,100,100
1650277610712,CSE 15L,A01,083654,Staff,0,1,50,50
1650277610712,CSE 15L,A02,083655,Staff,4,0,50,46
1650277616737,CSE 20,A01,083657,Staff,53,0,80,27
1650277622764,CSE 30,A01,083084,Eldon; John,0,74,40,40
1650277628806,CSE 100,A01,083659,Cao; Yingjun,0,65,50,50
1650277634829,CSE 134B,A01,083661,Powell; Thomas Allan,0,28,65,65
1650277640854,CSE 140,A01,083663,Staff,0,0,75,75
1650277646878,CSE 140L,A01,083088,Eldon; John,0,6,75,75
1650277652913,CSE 175,A01,083665,Kumar; Rakesh,8,0,25,17
1650277658939,CSE 190,A00,092507,Dubnov; Shlomo,14,0,20,6
1650277664966,ECE 45,A01,083139,Staff,0,15,40,40
1650277670991,ECE 65,A50,083695,Staff,0,4,30,30
1650277677023,ECE 109,A01,091882,Touri; Behrouz,44,0,70,26
1650277683069,ECE 180,A00,083140,Abi Samra; Nicholas Camill,24,0,30,6
1650277683069,ECE 180,B00,083141,Abi Samra; Nicholas Camill,7,0,30,23
1650277689103,MATH 10A,A01,083735,Patchell; Gregory David,11,0,30,19
1650277689103,MATH 10A,A02,083736,Patchell; Gregory David,28,0,30,2
1650277689103,MATH 10A,A03,083737,Patchell; Gregory David,26,0,30,4
1650277695133,MATH 10B,A01,083207,Staff,0,6,30,30
1650277695133,MATH 10B,A02,083208,Staff,0,6,30,30
1650277695133,MATH 10B,B01,083739,Staff,17,0,30,13
1650277695133,MATH 10B,B02,083740,Staff,29,0,30,1
1650277701168,MATH 18,A01,083743,Staff,7,0,30,23
1650277701168,MATH 18,A02,083744,Staff,27,0,30,3
1650277701168,MATH 18,A03,083745,Staff,23,0,30,7
1650277701168,MATH 18,A04,083746,Staff,27,0,30,3
1650277701168,MATH 18,B01,083748,Staff,0,11,30,30
1650277701168,MATH 18,B02,083749,Staff,0,9,30,30
1650277701168,MATH 18,B03,083750,Staff,1,8,30,29
1650277701168,MATH 18,B04,083751,Staff,0,9,30,30
1650277707197,MATH 20A,A01,083754,Staff,26,0,40,14
1650277713232,MATH 20B,A01,083756,Staff,0,5,30,30
1650277713232,MATH 20B,A02,083757,Staff,0,7,30,30
1650277719265,MATH 20C,A01,083760,Staff,0,13,30,30
1650277719265,MATH 20C,A02,083761,Staff,0,13,30,30
1650277719265,MATH 20C,B01,083762,Staff,14,0,30,16
1650277719265,MATH 20C,B02,083763,Staff,28,0,30,2
1650277725298,MATH 20D,A01,083765,Staff,0,1,30,30
1650277725298,MATH 20D,A02,083766,Staff,8,0,30,22
1650277725298,MATH 20D,A03,083767,Staff,28,0,30,2
1650277731322,MATH 20E,A01,083771,Staff,6,0,30,24
1650277731322,MATH 20E,A02,083772,Staff,20,0,30,10
1650277731322,MATH 20E,B01,083773,Staff,0,0,30,30
1650277731322,MATH 20E,B02,083774,Staff,11,0,30,19
1650277737349,MATH 103A,A01,083777,Staff,0,10,30,30
1650277737349,MATH 103A,A02,083778,Staff,0,10,30,30
1650277737349,MATH 103A,B01,083779,Staff,0,10,30,30
1650277737349,MATH 103A,B02,083780,Staff,0,10,30,30
1650277743378,MATH 105,A01,085443,Staff,0,17,30,30
1650277749408,MATH 109,A01,083213,Anzaldo; Leesa B,0,5,30,30
1650277749408,MATH 109,A02,083214,Anzaldo; Leesa B,0,6,30,30
1650277749408,MATH 109,B01,083215,Anzaldo; Leesa B,0,4,30,30
1650277749408,MATH 109,B02,083216,Anzaldo; Leesa B,0,3,30,30
1650277755444,MATH 142A,A01,083219,Chow; Bennett,0,12,30,30
1650277755444,MATH 142A,A02,083220,Chow; Bennett,0,11,30,30
1650277755444,MATH 142A,B01,083221,Chow; Bennett,0,11,30,30
1650277755444,MATH 142A,B02,083222,Chow; Bennett,0,12,30,30
1650277761491,MATH 193A,A01,083224,Staff,0,5,30,30
1650277761491,MATH 193A,A02,083225,Staff,0,5,30,30
1650277761491,MATH 193A,A03,083781,Staff,0,2,30,30
1650277761491,MATH 193A,A04,083782,Staff,0,1,30,30
1650277767544,MATH 197,001,091859,McAuley; Julian John,9998,0,9999,1
1650277773618,COGS 9,A01,083615,Staff,0,14,60,60
1650277779648,COGS 11,A01,083617,Boyle; Mary E. T.,24,0,40,16
1650277785681,COGS 13,A01,083071,Staff,0,31,40,40
1650277791705,COGS 14A,A01,092681,Staff,0,15,100,100
1650277797728,COGS 14B,A01,083073,Cheng; Tzu-Han,0,9,50,50
1650277803751,COGS 17,A01,092677,Staff,29,0,75,46
1650277809778,COGS 100,A01,083619,Staff,0,23,60,60
1650277815802,COGS 101A,A01,083621,Davis; Joshua Daniel,0,21,60,60
1650277821837,COGS 101B,A01,091572,Staff,4,0,60,56
1650277827862,COGS 101C,A01,083625,Delgado; Tania,19,0,30,11
1650277833886,COGS 107A,A01,083627,Boyle; Mary E. T.,0,8,60,60
1650277839912,COGS 118A,A01,083075,Staff,13,0,60,47
1650277846026,CSE 3,A50,083646,Miranda; Gregory Joseph,21,0,38,17
1650277846026,CSE 3,A51,083647,Miranda; Gregory Joseph,37,0,37,0
1650277852067,CSE 8A,A50,083650,Miranda; Gregory Joseph,0,22,40,40
1650277858095,CSE 11,A01,083080,Cao; Yingjun,0,74,40,40
1650277864122,CSE 12,A01,083652,Staff,0,10,100,100
1650277870149,CSE 15L,A01,083654,Staff,0,1,50,50
1650277870149,CSE 15L,A02,083655,Staff,4,0,50,46
1650277876177,CSE 20,A01,083657,Staff,53,0,80,27
1650277882201,CSE 30,A01,083084,Eldon; John,0,74,40,40
1650277888227,CSE 100,A01,083659,Cao; Yingjun,0,65,50,50
1650277894255,CSE 134B,A01,083661,Powell; Thomas Allan,0,28,65,65
1650277900278,CSE 140,A01,083663,Staff,0,0,75,75
1650277906308,CSE 140L,A01,083088,Eldon; John,0,6,75,75
1650277912334,CSE 175,A01,083665,Kumar; Rakesh,8,0,25,17
1650277918371,CSE 190,A00,092507,Dubnov; Shlomo,14,0,20,6
1650277924395,ECE 45,A01,083139,Staff,0,15,40,40
1650277930424,ECE 65,A50,083695,Staff,0,4,30,30
1650277936455,ECE 109,A01,091882,Touri; Behrouz,43,0,70,27
1650277942480,ECE 180,A00,083140,Abi Samra; Nicholas Camill,24,0,30,6
1650277942480,ECE 180,B00,083141,Abi Samra; Nicholas Camill,7,0,30,23
1650277948508,MATH 10A,A01,083735,Patchell; Gregory David,11,0,30,19
1650277948508,MATH 10A,A02,083736,Patchell; Gregory David,28,0,30,2
1650277948508,MATH 10A,A03,083737,Patchell; Gregory David,26,0,30,4
1650277954534,MATH 10B,A01,083207,Staff,0,6,30,30
1650277954534,MATH 10B,A02,083208,Staff,0,6,30,30
1650277954534,MATH 10B,B01,083739,Staff,17,0,30,13
1650277954534,MATH 10B,B02,083740,Staff,29,0,30,1
1650277960562,MATH 18,A01,083743,Staff,7,0,30,23
1650277960562,MATH 18,A02,083744,Staff,27,0,30,3
1650277960562,MATH 18,A03,083745,Staff,23,0,30,7
1650277960562,MATH 18,A04,083746,Staff,27,0,30,3
1650277960562,MATH 18,B01,083748,Staff,0,11,30,30
1650277960562,MATH 18,B02,083749,Staff,0,9,30,30
1650277960562,MATH 18,B03,083750,Staff,1,8,30,29
1650277960562,MATH 18,B04,083751,Staff,0,9,30,30
1650277966590,MATH 20A,A01,083754,Staff,26,0,40,14
1650277972617,MATH 20B,A01,083756,Staff,0,5,30,30
1650277972617,MATH 20B,A02,083757,Staff,0,7,30,30
1650277978641,MATH 20C,A01,083760,Staff,0,13,30,30
1650277978641,MATH 20C,A02,083761,Staff,0,13,30,30
1650277978641,MATH 20C,B01,083762,Staff,14,0,30,16
1650277978641,MATH 20C,B02,083763,Staff,28,0,30,2
1650277984664,MATH 20D,A01,083765,Staff,0,1,30,30
1650277984664,MATH 20D,A02,083766,Staff,8,0,30,22
1650277984664,MATH 20D,A03,083767,Staff,28,0,30,2
1650277990696,MATH 20E,A01,083771,Staff,6,0,30,24
1650277990696,MATH 20E,A02,083772,Staff,20,0,30,10
1650277990696,MATH 20E,B01,083773,Staff,0,0,30,30
1650277990696,MATH 20E,B02,083774,Staff,11,0,30,19
1650277996730,MATH 103A,A01,083777,Staff,0,10,30,30
1650277996730,MATH 103A,A02,083778,Staff,0,10,30,30
1650277996730,MATH 103A,B01,083779,Staff,0,10,30,30
1650277996730,MATH 103A,B02,083780,Staff,0,10,30,30
1650278002779,MATH 105,A01,085443,Staff,0,17,30,30
1650278008805,MATH 109,A01,083213,Anzaldo; Leesa B,0,5,30,30
1650278008805,MATH 109,A02,083214,Anzaldo; Leesa B,0,6,30,30
1650278008805,MATH 109,B01,083215,Anzaldo; Leesa B,0,4,30,30
1650278008805,MATH 109,B02,083216,Anzaldo; Leesa B,0,3,30,30
1650278014834,MATH 142A,A01,083219,Chow; Bennett,0,12,30,30
1650278014834,MATH 142A,A02,083220,Chow; Bennett,0,11,30,30
1650278014834,MATH 142A,B01,083221,Chow; Bennett,0,11,30,30
1650278014834,MATH 142A,B02,083222,Chow; Bennett,0,12,30,30
1650278020861,MATH 193A,A01,083224,Staff,0,5,30,30
1650278020861,MATH 193A,A02,083225,Staff,0,5,30,30
1650278020861,MATH 193A,A03,083781,Staff,0,2,30,30
1650278020861,MATH 193A,A04,083782,Staff,0,1,30,30
1650278026887,MATH 197,001,091859,McAuley; Julian John,9998,0,9999,1
1650278032976,COGS 9,A01,083615,Staff,0,14,60,60
1650278039003,COGS 11,A01,083617,Boyle; Mary E. T.,24,0,40,16
1650278045033,COGS 13,A01,083071,Staff,0,31,40,40
1650278051057,COGS 14A,A01,092681,Staff,0,15,100,100
1650278057088,COGS 14B,A01,083073,Cheng; Tzu-Han,0,9,50,50
1650278063117,COGS 17,A01,092677,Staff,29,0,75,46
1650278069141,COGS 100,A01,083619,Staff,0,23,60,60
1650278075180,COGS 101A,A01,083621,Davis; Joshua Daniel,0,21,60,60
1650278081236,COGS 101B,A01,091572,Staff,4,0,60,56
1650278087273,COGS 101C,A01,083625,Delgado; Tania,19,0,30,11
1650278093297,COGS 107A,A01,083627,Boyle; Mary E. T.,0,8,60,60
1650278099329,COGS 118A,A01,083075,Staff,13,0,60,47
1650278105361,CSE 3,A50,083646,Miranda; Gregory Joseph,21,0,38,17
1650278105361,CSE 3,A51,083647,Miranda; Gregory Joseph,37,0,37,0
1650278111386,CSE 8A,A50,083650,Miranda; Gregory Joseph,0,22,40,40
1650278117410,CSE 11,A01,083080,Cao; Yingjun,0,74,40,40
1650278123451,CSE 12,A01,083652,Staff,0,10,100,100
1650278129479,CSE 15L,A01,083654,Staff,0,1,50,50
1650278129479,CSE 15L,A02,083655,Staff,4,0,50,46
1650278135505,CSE 20,A01,083657,Staff,53,0,80,27
1650278141530,CSE 30,A01,083084,Eldon; John,0,74,40,40
1650278147555,CSE 100,A01,083659,Cao; Yingjun,0,65,50,50
1650278153580,CSE 134B,A01,083661,Powell; Thomas Allan,0,28,65,65
1650278159604,CSE 140,A01,083663,Staff,0,0,75,75
1650278165626,CSE 140L,A01,083088,Eldon; John,0,6,75,75
1650278171653,CSE 175,A01,083665,Kumar; Rakesh,8,0,25,17
1650278177697,CSE 190,A00,092507,Dubnov; Shlomo,14,0,20,6
1650278183723,ECE 45,A01,083139,Staff,0,15,40,40
1650278189748,ECE 65,A50,083695,Staff,0,4,30,30
1650278195776,ECE 109,A01,091882,Touri; Behrouz,43,0,70,27
1650278201800,ECE 180,A00,083140,Abi Samra; Nicholas Camill,24,0,30,6
1650278201800,ECE 180,B00,083141,Abi Samra; Nicholas Camill,7,0,30,23
1650278207832,MATH 10A,A01,083735,Patchell; Gregory David,11,0,30,19
1650278207832,MATH 10A,A02,083736,Patchell; Gregory David,28,0,30,2
1650278207832,MATH 10A,A03,083737,Patchell; Gregory David,26,0,30,4
1650278213869,MATH 10B,A01,083207,Staff,0,6,30,30
1650278213869,MATH 10B,A02,083208,Staff,0,6,30,30
1650278213869,MATH 10B,B01,083739,Staff,17,0,30,13
1650278213869,MATH 10B,B02,083740,Staff,29,0,30,1
1650278219894,MATH 18,A01,083743,Staff,7,0,30,23
1650278219894,MATH 18,A02,083744,Staff,27,0,30,3
1650278219894,MATH 18,A03,083745,Staff,23,0,30,7
1650278219894,MATH 18,A04,083746,Staff,27,0,30,3
1650278219894,MATH 18,B01,083748,Staff,0,11,30,30
1650278219894,MATH 18,B02,083749,Staff,0,9,30,30
1650278219894,MATH 18,B03,083750,Staff,1,8,30,29
1650278219894,MATH 18,B04,083751,Staff,0,9,30,30
1650278225921,MATH 20A,A01,083754,Staff,26,0,40,14
1650278231947,MATH 20B,A01,083756,Staff,0,5,30,30
1650278231947,MATH 20B,A02,083757,Staff,0,7,30,30
1650278237972,MATH 20C,A01,083760,Staff,0,13,30,30
1650278237972,MATH 20C,A02,083761,Staff,0,13,30,30
1650278237972,MATH 20C,B01,083762,Staff,14,0,30,16
1650278237972,MATH 20C,B02,083763,Staff,28,0,30,2
1650278244001,MATH 20D,A01,083765,Staff,0,1,30,30
1650278244001,MATH 20D,A02,083766,Staff,8,0,30,22
1650278244001,MATH 20D,A03,083767,Staff,28,0,30,2
1650278250034,MATH 20E,A01,083771,Staff,6,0,30,24
1650278250034,MATH 20E,A02,083772,Staff,20,0,30,10
1650278250034,MATH 20E,B01,083773,Staff,0,0,30,30
1650278250034,MATH 20E,B02,083774,Staff,11,0,30,19
1650278256065,MATH 103A,A01,083777,Staff,0,10,30,30
1650278256065,MATH 103A,A02,083778,Staff,0,10,30,30
1650278256065,MATH 103A,B01,083779,Staff,0,10,30,30
1650278256065,MATH 103A,B02,083780,Staff,0,10,30,30
1650278262094,MATH 105,A01,085443,Staff,0,17,30,30
1650278268120,MATH 109,A01,083213,Anzaldo; Leesa B,0,5,30,30
1650278268120,MATH 109,A02,083214,Anzaldo; Leesa B,0,6,30,30
1650278268120,MATH 109,B01,083215,Anzaldo; Leesa B,0,4,30,30
1650278268120,MATH 109,B02,083216,Anzaldo; Leesa B,0,3,30,30
1650278274153,MATH 142A,A01,083219,Chow; Bennett,0,12,30,30
1650278274153,MATH 142A,A02,083220,Chow; Bennett,0,11,30,30
1650278274153,MATH 142A,B01,083221,Chow; Bennett,0,11,30,30
1650278274153,MATH 142A,B02,083222,Chow; Bennett,0,12,30,30
1650278280183,MATH 193A,A01,083224,Staff,0,5,30,30
1650278280183,MATH 193A,A02,083225,Staff,0,5,30,30
1650278280183,MATH 193A,A03,083781,Staff,0,2,30,30
1650278280183,MATH 193A,A04,083782,Staff,0,1,30,30
1650278286207,MATH 197,001,091859,McAuley; Julian John,9998,0,9999,1
1650278292284,COGS 9,A01,083615,Staff,0,14,60,60
1650278298309,COGS 11,A01,083617,Boyle; Mary E. T.,24,0,40,16
1650278304334,COGS 13,A01,083071,Staff,0,31,40,40
1650278310360,COGS 14A,A01,092681,Staff,0,15,100,100
1650278316383,COGS 14B,A01,083073,Cheng; Tzu-Han,0,9,50,50
1650278322411,COGS 17,A01,092677,Staff,29,0,75,46
1650278328445,COGS 100,A01,083619,Staff,0,23,60,60
1650278334474,COGS 101A,A01,083621,Davis; Joshua Daniel,0,21,60,60
1650278340506,COGS 101B,A01,091572,Staff,4,0,60,56
1650278346531,COGS 101C,A01,083625,Delgado; Tania,19,0,30,11
1650278352558,COGS 107A,A01,083627,Boyle; Mary E. T.,0,8,60,60
1650278358581,COGS 118A,A01,083075,Staff,13,0,60,47
1650278364613,CSE 3,A50,083646,Miranda; Gregory Joseph,21,0,38,17
1650278364613,CSE 3,A51,083647,Miranda; Gregory Joseph,37,0,37,0
1650278370637,CSE 8A,A50,083650,Miranda; Gregory Joseph,0,22,40,40
1650278376667,CSE 11,A01,083080,Cao; Yingjun,0,74,40,40
1650278382689,CSE 12,A01,083652,Staff,0,10,100,100
1650278388717,CSE 15L,A01,083654,Staff,0,1,50,50
1650278388717,CSE 15L,A02,083655,Staff,4,0,50,46
1650278394742,CSE 20,A01,083657,Staff,53,0,80,27
1650278400771,CSE 30,A01,083084,Eldon; John,0,74,40,40
1650278406795,CSE 100,A01,083659,Cao; Yingjun,0,65,50,50
1650278412820,CSE 134B,A01,083661,Powell; Thomas Allan,0,28,65,65
1650278418843,CSE 140,A01,083663,Staff,0,0,75,75
1650278424871,CSE 140L,A01,083088,Eldon; John,0,6,75,75
1650278430896,CSE 175,A01,083665,Kumar; Rakesh,8,0,25,17
1650278436923,CSE 190,A00,092507,Dubnov; Shlomo,14,0,20,6
1650278443045,ECE 45,A01,083139,Staff,0,15,40,40
1650278449071,ECE 65,A50,083695,Staff,0,4,30,30
1650278455097,ECE 109,A01,091882,Touri; Behrouz,43,0,70,27
1650278461133,ECE 180,A00,083140,Abi Samra; Nicholas Camill,24,0,30,6
1650278461133,ECE 180,B00,083141,Abi Samra; Nicholas Camill,7,0,30,23
1650278467159,MATH 10A,A01,083735,Patchell; Gregory David,11,0,30,19
1650278467159,MATH 10A,A02,083736,Patchell; Gregory David,28,0,30,2
1650278467159,MATH 10A,A03,083737,Patchell; Gregory David,26,0,30,4
1650278473186,MATH 10B,A01,083207,Staff,0,6,30,30
1650278473186,MATH 10B,A02,083208,Staff,0,6,30,30
1650278473186,MATH 10B,B01,083739,Staff,17,0,30,13
1650278473186,MATH 10B,B02,083740,Staff,29,0,30,1
1650278479214,MATH 18,A01,083743,Staff,7,0,30,23
1650278479214,MATH 18,A02,083744,Staff,27,0,30,3
1650278479214,MATH 18,A03,083745,Staff,23,0,30,7
1650278479214,MATH 18,A04,083746,Staff,27,0,30,3
1650278479214,MATH 18,B01,083748,Staff,0,11,30,30
1650278479214,MATH 18,B02,083749,Staff,0,9,30,30
1650278479214,MATH 18,B03,083750,Staff,1,8,30,29
1650278479214,MATH 18,B04,083751,Staff,0,9,30,30
1650278485241,MATH 20A,A01,083754,Staff,26,0,40,14
1650278491268,MATH 20B,A01,083756,Staff,0,5,30,30
1650278491268,MATH 20B,A02,083757,Staff,0,7,30,30
1650278497292,MATH 20C,A01,083760,Staff,0,13,30,30
1650278497292,MATH 20C,A02,083761,Staff,0,13,30,30
1650278497292,MATH 20C,B01,083762,Staff,14,0,30,16
1650278497292,MATH 20C,B02,083763,Staff,28,0,30,2
1650278503318,MATH 20D,A01,083765,Staff,0,1,30,30
1650278503318,MATH 20D,A02,083766,Staff,8,0,30,22
1650278503318,MATH 20D,A03,083767,Staff,28,0,30,2
1650278509344,MATH 20E,A01,083771,Staff,6,0,30,24
1650278509344,MATH 20E,A02,083772,Staff,20,0,30,10
1650278509344,MATH 20E,B01,083773,Staff,0,0,30,30
1650278509344,MATH 20E,B02,083774,Staff,11,0,30,19
1650278515383,MATH 103A,A01,083777,Staff,0,10,30,30
1650278515383,MATH 103A,A02,083778,Staff,0,10,30,30
1650278515383,MATH 103A,B01,083779,Staff,0,10,30,30
1650278515383,MATH 103A,B02,083780,Staff,0,10,30,30
1650278521410,MATH 105,A01,085443,Staff,0,17,30,30
1650278527443,MATH 109,A01,083213,Anzaldo; Leesa B,0,5,30,30
1650278527443,MATH 109,A02,083214,Anzaldo; Leesa B,0,6,30,30
1650278527443,MATH 109,B01,083215,Anzaldo; Leesa B,0,4,30,30
1650278527443,MATH 109,B02,083216,Anzaldo; Leesa B,0,3,30,30
1650278533472,MATH 142A,A01,083219,Chow; Bennett,0,12,30,30
1650278533472,MATH 142A,A02,083220,Chow; Bennett,0,11,30,30
1650278533472,MATH 142A,B01,083221,Chow; Bennett,0,11,30,30
1650278533472,MATH 142A,B02,083222,Chow; Bennett,0,12,30,30
1650278539496,MATH 193A,A01,083224,Staff,0,5,30,30
1650278539496,MATH 193A,A02,083225,Staff,0,5,30,30
1650278539496,MATH 193A,A03,083781,Staff,0,2,30,30
1650278539496,MATH 193A,A04,083782,Staff,0,1,30,30
1650278545520,MATH 197,001,091859,McAuley; Julian John,9998,0,9999,1
1650278551584,COGS 9,A01,083615,Staff,0,14,60,60
1650278557615,COGS 11,A01,083617,Boyle; Mary E. T.,24,0,40,16
1650278563640,COGS 13,A01,083071,Staff,0,31,40,40
1650278569669,COGS 14A,A01,092681,Staff,0,15,100,100
1650278575693,COGS 14B,A01,083073,Cheng; Tzu-Han,0,9,50,50
1650278581717,COGS 17,A01,092677,Staff,29,0,75,46
1650278587745,COGS 100,A01,083619,Staff,0,23,60,60
1650278593769,COGS 101A,A01,083621,Davis; Joshua Daniel,0,21,60,60
1650278599797,COGS 101B,A01,091572,Staff,4,0,60,56
1650278605824,COGS 101C,A01,083625,Delgado; Tania,19,0,30,11
1650278611849,COGS 107A,A01,083627,Boyle; Mary E. T.,0,8,60,60
1650278617872,COGS 118A,A01,083075,Staff,13,0,60,47
1650278623898,CSE 3,A50,083646,Miranda; Gregory Joseph,21,0,38,17
1650278623898,CSE 3,A51,083647,Miranda; Gregory Joseph,37,0,37,0
1650278629935,CSE 8A,A50,083650,Miranda; Gregory Joseph,0,22,40,40
1650278635961,CSE 11,A01,083080,Cao; Yingjun,0,74,40,40
1650278641987,CSE 12,A01,083652,Staff,0,10,100,100
1650278648018,CSE 15L,A01,083654,Staff,0,1,50,50
1650278648018,CSE 15L,A02,083655,Staff,4,0,50,46
1650278654043,CSE 20,A01,083657,Staff,53,0,80,27
1650278660066,CSE 30,A01,083084,Eldon; John,0,74,40,40
1650278666092,CSE 100,A01,083659,Cao; Yingjun,0,65,50,50
1650278672121,CSE 134B,A01,083661,Powell; Thomas Allan,0,28,65,65
1650278678147,CSE 140,A01,083663,Staff,0,0,75,75
1650278684174,CSE 140L,A01,083088,Eldon; John,0,6,75,75
1650278690200,CSE 175,A01,083665,Kumar; Rakesh,8,0,25,17
1650278696225,CSE 190,A00,092507,Dubnov; Shlomo,14,0,20,6
1650278702257,ECE 45,A01,083139,Staff,0,15,40,40
1650278708287,ECE 65,A50,083695,Staff,0,4,30,30
1650278714316,ECE 109,A01,091882,Touri; Behrouz,43,0,70,27
1650278720347,ECE 180,A00,083140,Abi Samra; Nicholas Camill,24,0,30,6
1650278720347,ECE 180,B00,083141,Abi Samra; Nicholas Camill,7,0,30,23
1650278726379,MATH 10A,A01,083735,Patchell; Gregory David,11,0,30,19
1650278726379,MATH 10A,A02,083736,Patchell; Gregory David,28,0,30,2
1650278726379,MATH 10A,A03,083737,Patchell; Gregory David,26,0,30,4
1650278732404,MATH 10B,A01,083207,Staff,0,6,30,30
1650278732404,MATH 10B,A02,083208,Staff,0,6,30,30
1650278732404,MATH 10B,B01,083739,Staff,17,0,30,13
1650278732404,MATH 10B,B02,083740,Staff,29,0,30,1
1650278738433,MATH 18,A01,083743,Staff,7,0,30,23
1650278738433,MATH 18,A02,083744,Staff,27,0,30,3
1650278738433,MATH 18,A03,083745,Staff,23,0,30,7
1650278738433,MATH 18,A04,083746,Staff,27,0,30,3
1650278738433,MATH 18,B01,083748,Staff,0,11,30,30
1650278738433,MATH 18,B02,083749,Staff,0,9,30,30
1650278738433,MATH 18,B03,083750,Staff,1,8,30,29
1650278738433,MATH 18,B04,083751,Staff,0,9,30,30
1650278744460,MATH 20A,A01,083754,Staff,26,0,40,14
1650278750485,MATH 20B,A01,083756,Staff,0,5,30,30
1650278750485,MATH 20B,A02,083757,Staff,0,7,30,30
1650278756511,MATH 20C,A01,083760,Staff,0,13,30,30
1650278756511,MATH 20C,A02,083761,Staff,0,13,30,30
1650278756511,MATH 20C,B01,083762,Staff,14,0,30,16
1650278756511,MATH 20C,B02,083763,Staff,28,0,30,2
1650278762538,MATH 20D,A01,083765,Staff,0,1,30,30
1650278762538,MATH 20D,A02,083766,Staff,8,0,30,22
1650278762538,MATH 20D,A03,083767,Staff,28,0,30,2
1650278768564,MATH 20E,A01,083771,Staff,6,0,30,24
1650278768564,MATH 20E,A02,083772,Staff,20,0,30,10
1650278768564,MATH 20E,B01,083773,Staff,0,0,30,30
1650278768564,MATH 20E,B02,083774,Staff,11,0,30,19
1650278774589,MATH 103A,A01,083777,Staff,0,10,30,30
1650278774589,MATH 103A,A02,083778,Staff,0,10,30,30
1650278774589,MATH 103A,B01,083779,Staff,0,10,30,30
1650278774589,MATH 103A,B02,083780,Staff,0,10,30,30
1650278780616,MATH 105,A01,085443,Staff,0,17,30,30
1650278786648,MATH 109,A01,083213,Anzaldo; Leesa B,0,5,30,30
1650278786648,MATH 109,A02,083214,Anzaldo; Leesa B,0,6,30,30
1650278786648,MATH 109,B01,083215,Anzaldo; Leesa B,0,4,30,30
1650278786648,MATH 109,B02,083216,Anzaldo; Leesa B,0,3,30,30
1650278792681,MATH 142A,A01,083219,Chow; Bennett,0,12,30,30
1650278792681,MATH 142A,A02,083220,Chow; Bennett,0,11,30,30
1650278792681,MATH 142A,B01,083221,Chow; Bennett,0,11,30,30
1650278792681,MATH 142A,B02,083222,Chow; Bennett,0,12,30,30
1650278798707,MATH 193A,A01,083224,Staff,0,5,30,30
1650278798707,MATH 193A,A02,083225,Staff,0,5,30,30
1650278798707,MATH 193A,A03,083781,Staff,0,2,30,30
1650278798707,MATH 193A,A04,083782,Staff,0,1,30,30
1650278804734,MATH 197,001,091859,McAuley; Julian John,9998,0,9999,1
1650278810796,COGS 9,A01,083615,Staff,0,14,60,60
1650278816824,COGS 11,A01,083617,Boyle; Mary E. T.,24,0,40,16
1650278822854,COGS 13,A01,083071,Staff,0,31,40,40
1650278828883,COGS 14A,A01,092681,Staff,0,15,100,100
1650278834911,COGS 14B,A01,083073,Cheng; Tzu-Han,0,9,50,50
1650278840935,COGS 17,A01,092677,Staff,29,0,75,46
1650278846962,COGS 100,A01,083619,Staff,0,23,60,60
1650278852986,COGS 101A,A01,083621,Davis; Joshua Daniel,0,21,60,60
1650278859010,COGS 101B,A01,091572,Staff,4,0,60,56
1650278865041,COGS 101C,A01,083625,Delgado; Tania,19,0,30,11
1650278871063,COGS 107A,A01,083627,Boyle; Mary E. T.,0,8,60,60
1650278877086,COGS 118A,A01,083075,Staff,13,0,60,47
1650278883117,CSE 3,A50,083646,Miranda; Gregory Joseph,21,0,38,17
1650278883117,CSE 3,A51,083647,Miranda; Gregory Joseph,37,0,37,0
1650278889145,CSE 8A,A50,083650,Miranda; Gregory Joseph,0,22,40,40
1650278895169,CSE 11,A01,083080,Cao; Yingjun,0,74,40,40
1650278901194,CSE 12,A01,083652,Staff,0,10,100,100
1650278907217,CSE 15L,A01,083654,Staff,0,1,50,50
1650278907217,CSE 15L,A02,083655,Staff,4,0,50,46
1650278913252,CSE 20,A01,083657,Staff,53,0,80,27
1650278919279,CSE 30,A01,083084,Eldon; John,0,74,40,40
1650278925303,CSE 100,A01,083659,Cao; Yingjun,0,65,50,50
1650278931327,CSE 134B,A01,083661,Powell; Thomas Allan,0,28,65,65
1650278937352,CSE 140,A01,083663,Staff,0,0,75,75
1650278943380,CSE 140L,A01,083088,Eldon; John,0,6,75,75
1650278949406,CSE 175,A01,083665,Kumar; Rakesh,8,0,25,17
1650278955436,CSE 190,A00,092507,Dubnov; Shlomo,14,0,20,6
1650278961459,ECE 45,A01,083139,Staff,0,15,40,40
1650278967502,ECE 65,A50,083695,Staff,0,4,30,30
1650278973532,ECE 109,A01,091882,Touri; Behrouz,43,0,70,27
1650278979559,ECE 180,A00,083140,Abi Samra; Nicholas Camill,24,0,30,6
1650278979559,ECE 180,B00,083141,Abi Samra; Nicholas Camill,7,0,30,23
1650278985587,MATH 10A,A01,083735,Patchell; Gregory David,11,0,30,19
1650278985587,MATH 10A,A02,083736,Patchell; Gregory David,28,0,30,2
1650278985587,MATH 10A,A03,083737,Patchell; Gregory David,26,0,30,4
1650278991613,MATH 10B,A01,083207,Staff,0,6,30,30
1650278991613,MATH 10B,A02,083208,Staff,0,6,30,30
1650278991613,MATH 10B,B01,083739,Staff,17,0,30,13
1650278991613,MATH 10B,B02,083740,Staff,29,0,30,1
1650278997641,MATH 18,A01,083743,Staff,7,0,30,23
1650278997641,MATH 18,A02,083744,Staff,27,0,30,3
1650278997641,MATH 18,A03,083745,Staff,23,0,30,7
1650278997641,MATH 18,A04,083746,Staff,27,0,30,3
1650278997641,MATH 18,B01,083748,Staff,0,11,30,30
1650278997641,MATH 18,B02,083749,Staff,0,9,30,30
1650278997641,MATH 18,B03,083750,Staff,1,8,30,29
1650278997641,MATH 18,B04,083751,Staff,0,9,30,30
1650279003667,MATH 20A,A01,083754,Staff,26,0,40,14
1650279009695,MATH 20B,A01,083756,Staff,0,5,30,30
1650279009695,MATH 20B,A02,083757,Staff,0,7,30,30
1650279015721,MATH 20C,A01,083760,Staff,0,13,30,30
1650279015721,MATH 20C,A02,083761,Staff,0,13,30,30
1650279015721,MATH 20C,B01,083762,Staff,14,0,30,16
1650279015721,MATH 20C,B02,083763,Staff,28,0,30,2
1650279021745,MATH 20D,A01,083765,Staff,0,1,30,30
1650279021745,MATH 20D,A02,083766,Staff,8,0,30,22
1650279021745,MATH 20D,A03,083767,Staff,28,0,30,2
1650279027774,MATH 20E,A01,083771,Staff,6,0,30,24
1650279027774,MATH 20E,A02,083772,Staff,20,0,30,10
1650279027774,MATH 20E,B01,083773,Staff,0,0,30,30
1650279027774,MATH 20E,B02,083774,Staff,11,0,30,19
1650279033802,MATH 103A,A01,083777,Staff,0,10,30,30
1650279033802,MATH 103A,A02,083778,Staff,0,10,30,30
1650279033802,MATH 103A,B01,083779,Staff,0,10,30,30
1650279033802,MATH 103A,B02,083780,Staff,0,10,30,30
1650279039908,MATH 105,A01,085443,Staff,0,17,30,30
1650279045935,MATH 109,A01,083213,Anzaldo; Leesa B,0,5,30,30
1650279045935,MATH 109,A02,083214,Anzaldo; Leesa B,0,6,30,30
1650279045935,MATH 109,B01,083215,Anzaldo; Leesa B,0,4,30,30
1650279045935,MATH 109,B02,083216,Anzaldo; Leesa B,0,3,30,30
1650279051962,MATH 142A,A01,083219,Chow; Bennett,0,12,30,30
1650279051962,MATH 142A,A02,083220,Chow; Bennett,0,11,30,30
1650279051962,MATH 142A,B01,083221,Chow; Bennett,0,11,30,30
1650279051962,MATH 142A,B02,083222,Chow; Bennett,0,12,30,30
1650279057987,MATH 193A,A01,083224,Staff,0,5,30,30
1650279057987,MATH 193A,A02,083225,Staff,0,5,30,30
1650279057987,MATH 193A,A03,083781,Staff,0,2,30,30
1650279057987,MATH 193A,A04,083782,Staff,0,1,30,30
1650279064015,MATH 197,001,091859,McAuley; Julian John,9998,0,9999,1
1650279070107,COGS 9,A01,083615,Staff,0,14,60,60
1650279076139,COGS 11,A01,083617,Boyle; Mary E. T.,24,0,40,16
1650279082164,COGS 13,A01,083071,Staff,0,31,40,40
1650279088189,COGS 14A,A01,092681,Staff,0,15,100,100
1650279094215,COGS 14B,A01,083073,Cheng; Tzu-Han,0,9,50,50
1650279100245,COGS 17,A01,092677,Staff,29,0,75,46
1650279106271,COGS 100,A01,083619,Staff,0,23,60,60
1650279112297,COGS 101A,A01,083621,Davis; Joshua Daniel,0,21,60,60
1650279118326,COGS 101B,A01,091572,Staff,4,0,60,56
1650279124372,COGS 101C,A01,083625,Delgado; Tania,19,0,30,11
1650279130398,COGS 107A,A01,083627,Boyle; Mary E. T.,0,8,60,60
1650279136422,COGS 118A,A01,083075,Staff,13,0,60,47
1650279142455,CSE 3,A50,083646,Miranda; Gregory Joseph,21,0,38,17
1650279142455,CSE 3,A51,083647,Miranda; Gregory Joseph,37,0,37,0
1650279148483,CSE 8A,A50,083650,Miranda; Gregory Joseph,0,22,40,40
1650279154513,CSE 11,A01,083080,Cao; Yingjun,0,74,40,40
1650279160541,CSE 12,A01,083652,Staff,0,10,100,100
1650279166569,CSE 15L,A01,083654,Staff,0,1,50,50
1650279166569,CSE 15L,A02,083655,Staff,4,0,50,46
1650279172593,CSE 20,A01,083657,Staff,53,0,80,27
1650279178618,CSE 30,A01,083084,Eldon; John,0,74,40,40
1650279184649,CSE 100,A01,083659,Cao; Yingjun,0,65,50,50
1650279190678,CSE 134B,A01,083661,Powell; Thomas Allan,0,28,65,65
1650279196707,CSE 140,A01,083663,Staff,0,0,75,75
1650279202735,CSE 140L,A01,083088,Eldon; John,0,6,75,75
1650279208761,CSE 175,A01,083665,Kumar; Rakesh,8,0,25,17
1650279214787,CSE 190,A00,092507,Dubnov; Shlomo,14,0,20,6
1650279220812,ECE 45,A01,083139,Staff,0,15,40,40
1650279226841,ECE 65,A50,083695,Staff,0,4,30,30
1650279232883,ECE 109,A01,091882,Touri; Behrouz,43,0,70,27
1650279238908,ECE 180,A00,083140,Abi Samra; Nicholas Camill,24,0,30,6
1650279238908,ECE 180,B00,083141,Abi Samra; Nicholas Camill,7,0,30,23
1650279244935,MATH 10A,A01,083735,Patchell; Gregory David,11,0,30,19
1650279244935,MATH 10A,A02,083736,Patchell; Gregory David,28,0,30,2
1650279244935,MATH 10A,A03,083737,Patchell; Gregory David,26,0,30,4
1650279250965,MATH 10B,A01,083207,Staff,0,6,30,30
1650279250965,MATH 10B,A02,083208,Staff,0,6,30,30
1650279250965,MATH 10B,B01,083739,Staff,17,0,30,13
1650279250965,MATH 10B,B02,083740,Staff,29,0,30,1
1650279256994,MATH 18,A01,083743,Staff,7,0,30,23
1650279256994,MATH 18,A02,083744,Staff,27,0,30,3
1650279256994,MATH 18,A03,083745,Staff,23,0,30,7
1650279256994,MATH 18,A04,083746,Staff,27,0,30,3
1650279256994,MATH 18,B01,083748,Staff,0,11,30,30
1650279256994,MATH 18,B02,083749,Staff,0,9,30,30
1650279256994,MATH 18,B03,083750,Staff,1,8,30,29
1650279256994,MATH 18,B04,083751,Staff,0,9,30,30
1650279263017,MATH 20A,A01,083754,Staff,26,0,40,14
1650279269043,MATH 20B,A01,083756,Staff,0,5,30,30
1650279269043,MATH 20B,A02,083757,Staff,0,7,30,30
1650279275075,MATH 20C,A01,083760,Staff,0,13,30,30
1650279275075,MATH 20C,A02,083761,Staff,0,13,30,30
1650279275075,MATH 20C,B01,083762,Staff,14,0,30,16
1650279275075,MATH 20C,B02,083763,Staff,28,0,30,2
1650279281104,MATH 20D,A01,083765,Staff,0,1,30,30
1650279281104,MATH 20D,A02,083766,Staff,8,0,30,22
1650279281104,MATH 20D,A03,083767,Staff,28,0,30,2
1650279287135,MATH 20E,A01,083771,Staff,6,0,30,24
1650279287135,MATH 20E,A02,083772,Staff,20,0,30,10
1650279287135,MATH 20E,B01,083773,Staff,0,0,30,30
1650279287135,MATH 20E,B02,083774,Staff,11,0,30,19
1650279293174,MATH 103A,A01,083777,Staff,0,10,30,30
1650279293174,MATH 103A,A02,083778,Staff,0,10,30,30
1650279293174,MATH 103A,B01,083779,Staff,0,10,30,30
1650279293174,MATH 103A,B02,083780,Staff,0,10,30,30
1650279299199,MATH 105,A01,085443,Staff,0,17,30,30
1650279305225,MATH 109,A01,083213,Anzaldo; Leesa B,0,5,30,30
1650279305225,MATH 109,A02,083214,Anzaldo; Leesa B,0,6,30,30
1650279305225,MATH 109,B01,083215,Anzaldo; Leesa B,0,4,30,30
1650279305225,MATH 109,B02,083216,Anzaldo; Leesa B,0,3,30,30
1650279311251,MATH 142A,A01,083219,Chow; Bennett,0,12,30,30
1650279311251,MATH 142A,A02,083220,Chow; Bennett,0,11,30,30
1650279311251,MATH 142A,B01,083221,Chow; Bennett,0,11,30,30
1650279311251,MATH 142A,B02,083222,Chow; Bennett,0,12,30,30
1650279317280,MATH 193A,A01,083224,Staff,0,5,30,30
1650279317280,MATH 193A,A02,083225,Staff,0,5,30,30
1650279317280,MATH 193A,A03,083781,Staff,0,2,30,30
1650279317280,MATH 193A,A04,083782,Staff,0,1,30,30
1650279323304,MATH 197,001,091859,McAuley; Julian John,9998,0,9999,1
1650279329365,COGS 9,A01,083615,Staff,0,14,60,60
1650279335389,COGS 11,A01,083617,Boyle; Mary E. T.,24,0,40,16
1650279341416,COGS 13,A01,083071,Staff,0,31,40,40
1650279347440,COGS 14A,A01,092681,Staff,0,15,100,100
1650279353466,COGS 14B,A01,083073,Cheng; Tzu-Han,0,9,50,50
1650279359491,COGS 17,A01,092677,Staff,29,0,75,46
1650279365519,COGS 100,A01,083619,Staff,0,23,60,60
1650279371550,COGS 101A,A01,083621,Davis; Joshua Daniel,0,21,60,60
1650279377580,COGS 101B,A01,091572,Staff,4,0,60,56
1650279383605,COGS 101C,A01,083625,Delgado; Tania,19,0,30,11
1650279389633,COGS 107A,A01,083627,Boyle; Mary E. T.,0,8,60,60
1650279395657,COGS 118A,A01,083075,Staff,13,0,60,47
1650279401689,CSE 3,A50,083646,Miranda; Gregory Joseph,21,0,38,17
1650279401689,CSE 3,A51,083647,Miranda; Gregory Joseph,37,0,37,0
1650279407718,CSE 8A,A50,083650,Miranda; Gregory Joseph,0,22,40,40
1650279413742,CSE 11,A01,083080,Cao; Yingjun,0,74,40,40
1650279419770,CSE 12,A01,083652,Staff,0,10,100,100
1650279425794,CSE 15L,A01,083654,Staff,0,1,50,50
1650279425794,CSE 15L,A02,083655,Staff,4,0,50,46
1650279431823,CSE 20,A01,083657,Staff,53,0,80,27
1650279437849,CSE 30,A01,083084,Eldon; John,0,74,40,40
1650279443877,CSE 100,A01,083659,Cao; Yingjun,0,65,50,50
1650279449902,CSE 134B,A01,083661,Powell; Thomas Allan,0,28,65,65
1650279455925,CSE 140,A01,083663,Staff,0,0,75,75
1650279461952,CSE 140L,A01,083088,Eldon; John,0,6,75,75
1650279467976,CSE 175,A01,083665,Kumar; Rakesh,8,0,25,17
1650279474006,CSE 190,A00,092507,Dubnov; Shlomo,14,0,20,6
1650279480029,ECE 45,A01,083139,Staff,0,15,40,40
1650279486054,ECE 65,A50,083695,Staff,0,4,30,30
1650279492078,ECE 109,A01,091882,Touri; Behrouz,43,0,70,27
1650279498110,ECE 180,A00,083140,Abi Samra; Nicholas Camill,24,0,30,6
1650279498110,ECE 180,B00,083141,Abi Samra; Nicholas Camill,7,0,30,23
1650279504142,MATH 10A,A01,083735,Patchell; Gregory David,11,0,30,19
1650279504142,MATH 10A,A02,083736,Patchell; Gregory David,28,0,30,2
1650279504142,MATH 10A,A03,083737,Patchell; Gregory David,26,0,30,4
1650279510173,MATH 10B,A01,083207,Staff,0,6,30,30
1650279510173,MATH 10B,A02,083208,Staff,0,6,30,30
1650279510173,MATH 10B,B01,083739,Staff,17,0,30,13
1650279510173,MATH 10B,B02,083740,Staff,29,0,30,1
1650279516199,MATH 18,A01,083743,Staff,7,0,30,23
1650279516199,MATH 18,A02,083744,Staff,27,0,30,3
1650279516199,MATH 18,A03,083745,Staff,23,0,30,7
1650279516199,MATH 18,A04,083746,Staff,27,0,30,3
1650279516199,MATH 18,B01,083748,Staff,0,11,30,30
1650279516199,MATH 18,B02,083749,Staff,0,9,30,30
1650279516199,MATH 18,B03,083750,Staff,1,8,30,29
1650279516199,MATH 18,B04,083751,Staff,0,9,30,30
1650279522226,MATH 20A,A01,083754,Staff,26,0,40,14
1650279528256,MATH 20B,A01,083756,Staff,0,5,30,30
1650279528256,MATH 20B,A02,083757,Staff,0,7,30,30
1650279534287,MATH 20C,A01,083760,Staff,0,13,30,30
1650279534287,MATH 20C,A02,083761,Staff,0,13,30,30
1650279534287,MATH 20C,B01,083762,Staff,14,0,30,16
1650279534287,MATH 20C,B02,083763,Staff,28,0,30,2
1650279540310,MATH 20D,A01,083765,Staff,0,1,30,30
1650279540310,MATH 20D,A02,083766,Staff,8,0,30,22
1650279540310,MATH 20D,A03,083767,Staff,28,0,30,2
1650279546335,MATH 20E,A01,083771,Staff,6,0,30,24
1650279546335,MATH 20E,A02,083772,Staff,20,0,30,10
1650279546335,MATH 20E,B01,083773,Staff,0,0,30,30
1650279546335,MATH 20E,B02,083774,Staff,11,0,30,19
1650279552378,MATH 103A,A01,083777,Staff,0,10,30,30
1650279552378,MATH 103A,A02,083778,Staff,0,10,30,30
1650279552378,MATH 103A,B01,083779,Staff,0,10,30,30
1650279552378,MATH 103A,B02,083780,Staff,0,10,30,30
1650279558406,MATH 105,A01,085443,Staff,0,17,30,30
1650279564431,MATH 109,A01,083213,Anzaldo; Leesa B,0,5,30,30
1650279564431,MATH 109,A02,083214,Anzaldo; Leesa B,0,6,30,30
1650279564431,MATH 109,B01,083215,Anzaldo; Leesa B,0,4,30,30
1650279564431,MATH 109,B02,083216,Anzaldo; Leesa B,0,3,30,30
1650279570457,MATH 142A,A01,083219,Chow; Bennett,0,12,30,30
1650279570457,MATH 142A,A02,083220,Chow; Bennett,0,11,30,30
1650279570457,MATH 142A,B01,083221,Chow; Bennett,0,11,30,30
1650279570457,MATH 142A,B02,083222,Chow; Bennett,0,12,30,30
1650279576493,MATH 193A,A01,083224,Staff,0,5,30,30
1650279576493,MATH 193A,A02,083225,Staff,0,5,30,30
1650279576493,MATH 193A,A03,083781,Staff,0,2,30,30
1650279576493,MATH 193A,A04,083782,Staff,0,1,30,30
1650279582519,MATH 197,001,091859,McAuley; Julian John,9998,0,9999,1
1650279588573,COGS 9,A01,083615,Staff,0,14,60,60
1650279594599,COGS 11,A01,083617,Boyle; Mary E. T.,24,0,40,16
1650279600638,COGS 13,A01,083071,Staff,0,31,40,40
1650279606665,COGS 14A,A01,092681,Staff,0,15,100,100
1650279612693,COGS 14B,A01,083073,Cheng; Tzu-Han,0,9,50,50
1650279618720,COGS 17,A01,092677,Staff,29,0,75,46
1650279624747,COGS 100,A01,083619,Staff,0,23,60,60
1650279630861,COGS 101A,A01,083621,Davis; Joshua Daniel,0,21,60,60
1650279636888,COGS 101B,A01,091572,Staff,4,0,60,56
1650279642917,COGS 101C,A01,083625,Delgado; Tania,19,0,30,11
1650279648942,COGS 107A,A01,083627,Boyle; Mary E. T.,0,8,60,60
1650279654971,COGS 118A,A01,083075,Staff,13,0,60,47
1650279661006,CSE 3,A50,083646,Miranda; Gregory Joseph,21,0,38,17
1650279661006,CSE 3,A51,083647,Miranda; Gregory Joseph,37,0,37,0
1650279667030,CSE 8A,A50,083650,Miranda; Gregory Joseph,0,22,40,40
1650279673055,CSE 11,A01,083080,Cao; Yingjun,0,74,40,40
1650279679081,CSE 12,A01,083652,Staff,0,10,100,100
1650279685106,CSE 15L,A01,083654,Staff,0,1,50,50
1650279685106,CSE 15L,A02,083655,Staff,4,0,50,46
1650279691135,CSE 20,A01,083657,Staff,53,0,80,27
1650279697164,CSE 30,A01,083084,Eldon; John,0,74,40,40
1650279703197,CSE 100,A01,083659,Cao; Yingjun,0,65,50,50
1650279709228,CSE 134B,A01,083661,Powell; Thomas Allan,0,28,65,65
1650279715261,CSE 140,A01,083663,Staff,0,0,75,75
1650279721287,CSE 140L,A01,083088,Eldon; John,0,6,75,75
1650279727310,CSE 175,A01,083665,Kumar; Rakesh,8,0,25,17
1650279733335,CSE 190,A00,092507,Dubnov; Shlomo,14,0,20,6
1650279739363,ECE 45,A01,083139,Staff,0,15,40,40
1650279745392,ECE 65,A50,083695,Staff,0,4,30,30
1650279751416,ECE 109,A01,091882,Touri; Behrouz,43,0,70,27
1650279757444,ECE 180,A00,083140,Abi Samra; Nicholas Camill,24,0,30,6
1650279757444,ECE 180,B00,083141,Abi Samra; Nicholas Camill,7,0,30,23
1650279763472,MATH 10A,A01,083735,Patchell; Gregory David,11,0,30,19
1650279763472,MATH 10A,A02,083736,Patchell; Gregory David,28,0,30,2
1650279763472,MATH 10A,A03,083737,Patchell; Gregory David,26,0,30,4
1650279769497,MATH 10B,A01,083207,Staff,0,6,30,30
1650279769497,MATH 10B,A02,083208,Staff,0,6,30,30
1650279769497,MATH 10B,B01,083739,Staff,17,0,30,13
1650279769497,MATH 10B,B02,083740,Staff,29,0,30,1
1650279775526,MATH 18,A01,083743,Staff,7,0,30,23
1650279775526,MATH 18,A02,083744,Staff,27,0,30,3
1650279775526,MATH 18,A03,083745,Staff,23,0,30,7
1650279775526,MATH 18,A04,083746,Staff,27,0,30,3
1650279775526,MATH 18,B01,083748,Staff,0,11,30,30
1650279775526,MATH 18,B02,083749,Staff,0,9,30,30
1650279775526,MATH 18,B03,083750,Staff,1,8,30,29
1650279775526,MATH 18,B04,083751,Staff,0,9,30,30
1650279781549,MATH 20A,A01,083754,Staff,26,0,40,14
1650279787582,MATH 20B,A01,083756,Staff,0,5,30,30
1650279787582,MATH 20B,A02,083757,Staff,0,7,30,30
1650279793683,MATH 20C,A01,083760,Staff,0,13,30,30
1650279793683,MATH 20C,A02,083761,Staff,0,13,30,30
1650279793683,MATH 20C,B01,083762,Staff,14,0,30,16
1650279793683,MATH 20C,B02,083763,Staff,28,0,30,2
1650279799714,MATH 20D,A01,083765,Staff,0,1,30,30
1650279799714,MATH 20D,A02,083766,Staff,8,0,30,22
1650279799714,MATH 20D,A03,083767,Staff,28,0,30,2
1650279805756,MATH 20E,A01,083771,Staff,6,0,30,24
1650279805756,MATH 20E,A02,083772,Staff,20,0,30,10
1650279805756,MATH 20E,B01,083773,Staff,0,0,30,30
1650279805756,MATH 20E,B02,083774,Staff,11,0,30,19
1650279811788,MATH 103A,A01,083777,Staff,0,10,30,30
1650279811788,MATH 103A,A02,083778,Staff,0,10,30,30
1650279811788,MATH 103A,B01,083779,Staff,0,10,30,30
1650279811788,MATH 103A,B02,083780,Staff,0,10,30,30
1650279817812,MATH 105,A01,085443,Staff,0,17,30,30
1650279823842,MATH 109,A01,083213,Anzaldo; Leesa B,0,5,30,30
1650279823842,MATH 109,A02,083214,Anzaldo; Leesa B,0,6,30,30
1650279823842,MATH 109,B01,083215,Anzaldo; Leesa B,0,4,30,30
1650279823842,MATH 109,B02,083216,Anzaldo; Leesa B,0,3,30,30
1650279829867,MATH 142A,A01,083219,Chow; Bennett,0,12,30,30
1650279829867,MATH 142A,A02,083220,Chow; Bennett,0,11,30,30
1650279829867,MATH 142A,B01,083221,Chow; Bennett,0,11,30,30
1650279829867,MATH 142A,B02,083222,Chow; Bennett,0,12,30,30
1650279835892,MATH 193A,A01,083224,Staff,0,5,30,30
1650279835892,MATH 193A,A02,083225,Staff,0,5,30,30
1650279835892,MATH 193A,A03,083781,Staff,0,2,30,30
1650279835892,MATH 193A,A04,083782,Staff,0,1,30,30
1650279841918,MATH 197,001,091859,McAuley; Julian John,9998,0,9999,1
1650279847987,COGS 9,A01,083615,Staff,0,14,60,60
1650279854012,COGS 11,A01,083617,Boyle; Mary E. T.,24,0,40,16
1650279860038,COGS 13,A01,083071,Staff,0,31,40,40
1650279866065,COGS 14A,A01,092681,Staff,0,15,100,100
1650279872095,COGS 14B,A01,083073,Cheng; Tzu-Han,0,9,50,50
1650279878121,COGS 17,A01,092677,Staff,29,0,75,46
1650279884150,COGS 100,A01,083619,Staff,0,23,60,60
1650279890182,COGS 101A,A01,083621,Davis; Joshua Daniel,0,21,60,60
1650279896206,COGS 101B,A01,091572,Staff,4,0,60,56
1650279902232,COGS 101C,A01,083625,Delgado; Tania,19,0,30,11
1650279908259,COGS 107A,A01,083627,Boyle; Mary E. T.,0,8,60,60
1650279914287,COGS 118A,A01,083075,Staff,13,0,60,47
1650279920314,CSE 3,A50,083646,Miranda; Gregory Joseph,21,0,38,17
1650279920314,CSE 3,A51,083647,Miranda; Gregory Joseph,37,0,37,0
1650279926342,CSE 8A,A50,083650,Miranda; Gregory Joseph,0,22,40,40
1650279932367,CSE 11,A01,083080,Cao; Yingjun,0,74,40,40
1650279938395,CSE 12,A01,083652,Staff,0,10,100,100
1650279944419,CSE 15L,A01,083654,Staff,0,1,50,50
1650279944419,CSE 15L,A02,083655,Staff,4,0,50,46
1650279950443,CSE 20,A01,083657,Staff,53,0,80,27
1650279956468,CSE 30,A01,083084,Eldon; John,0,74,40,40
1650279962498,CSE 100,A01,083659,Cao; Yingjun,0,65,50,50
1650279968523,CSE 134B,A01,083661,Powell; Thomas Allan,0,28,65,65
1650279974547,CSE 140,A01,083663,Staff,0,0,75,75
1650279980571,CSE 140L,A01,083088,Eldon; John,0,6,75,75
1650279986599,CSE 175,A01,083665,Kumar; Rakesh,8,0,25,17
1650279992629,CSE 190,A00,092507,Dubnov; Shlomo,14,0,20,6
1650279998659,ECE 45,A01,083139,Staff,0,15,40,40
1650280004682,ECE 65,A50,083695,Staff,0,4,30,30
1650280010708,ECE 109,A01,091882,Touri; Behrouz,43,0,70,27
1650280016731,ECE 180,A00,083140,Abi Samra; Nicholas Camill,24,0,30,6
1650280016731,ECE 180,B00,083141,Abi Samra; Nicholas Camill,7,0,30,23
1650280022762,MATH 10A,A01,083735,Patchell; Gregory David,11,0,30,19
1650280022762,MATH 10A,A02,083736,Patchell; Gregory David,28,0,30,2
1650280022762,MATH 10A,A03,083737,Patchell; Gregory David,26,0,30,4
1650280028793,MATH 10B,A01,083207,Staff,0,6,30,30
1650280028793,MATH 10B,A02,083208,Staff,0,6,30,30
1650280028793,MATH 10B,B01,083739,Staff,17,0,30,13
1650280028793,MATH 10B,B02,083740,Staff,29,0,30,1
1650280034828,MATH 18,A01,083743,Staff,7,0,30,23
1650280034828,MATH 18,A02,083744,Staff,27,0,30,3
1650280034828,MATH 18,A03,083745,Staff,23,0,30,7
1650280034828,MATH 18,A04,083746,Staff,27,0,30,3
1650280034828,MATH 18,B01,083748,Staff,0,11,30,30
1650280034828,MATH 18,B02,083749,Staff,0,9,30,30
1650280034828,MATH 18,B03,083750,Staff,1,8,30,29
1650280034828,MATH 18,B04,083751,Staff,0,9,30,30
1650280040862,MATH 20A,A01,083754,Staff,26,0,40,14
1650280046890,MATH 20B,A01,083756,Staff,0,5,30,30
1650280046890,MATH 20B,A02,083757,Staff,0,7,30,30
1650280052915,MATH 20C,A01,083760,Staff,0,13,30,30
1650280052915,MATH 20C,A02,083761,Staff,0,13,30,30
1650280052915,MATH 20C,B01,083762,Staff,14,0,30,16
1650280052915,MATH 20C,B02,083763,Staff,28,0,30,2
1650280058944,MATH 20D,A01,083765,Staff,0,1,30,30
1650280058944,MATH 20D,A02,083766,Staff,8,0,30,22
1650280058944,MATH 20D,A03,083767,Staff,28,0,30,2
1650280064969,MATH 20E,A01,083771,Staff,6,0,30,24
1650280064969,MATH 20E,A02,083772,Staff,20,0,30,10
1650280064969,MATH 20E,B01,083773,Staff,0,0,30,30
1650280064969,MATH 20E,B02,083774,Staff,11,0,30,19
1650280070995,MATH 103A,A01,083777,Staff,0,10,30,30
1650280070995,MATH 103A,A02,083778,Staff,0,10,30,30
1650280070995,MATH 103A,B01,083779,Staff,0,10,30,30
1650280070995,MATH 103A,B02,083780,Staff,0,10,30,30
1650280077042,MATH 105,A01,085443,Staff,0,17,30,30
1650280083074,MATH 109,A01,083213,Anzaldo; Leesa B,0,5,30,30
1650280083074,MATH 109,A02,083214,Anzaldo; Leesa B,0,6,30,30
1650280083074,MATH 109,B01,083215,Anzaldo; Leesa B,0,4,30,30
1650280083074,MATH 109,B02,083216,Anzaldo; Leesa B,0,3,30,30
1650280089106,MATH 142A,A01,083219,Chow; Bennett,0,12,30,30
1650280089106,MATH 142A,A02,083220,Chow; Bennett,0,11,30,30
1650280089106,MATH 142A,B01,083221,Chow; Bennett,0,11,30,30
1650280089106,MATH 142A,B02,083222,Chow; Bennett,0,12,30,30
1650280095133,MATH 193A,A01,083224,Staff,0,5,30,30
1650280095133,MATH 193A,A02,083225,Staff,0,5,30,30
1650280095133,MATH 193A,A03,083781,Staff,0,2,30,30
1650280095133,MATH 193A,A04,083782,Staff,0,1,30,30
1650280101158,MATH 197,001,091859,McAuley; Julian John,9998,0,9999,1
1650280107231,COGS 9,A01,083615,Staff,0,14,60,60
1650280113255,COGS 11,A01,083617,Boyle; Mary E. T.,24,0,40,16
1650280119279,COGS 13,A01,083071,Staff,0,31,40,40
1650280125302,COGS 14A,A01,092681,Staff,0,15,100,100
1650280131332,COGS 14B,A01,083073,Cheng; Tzu-Han,0,9,50,50
1650280137357,COGS 17,A01,092677,Staff,29,0,75,46
1650280143386,COGS 100,A01,083619,Staff,0,23,60,60
1650280149415,COGS 101A,A01,083621,Davis; Joshua Daniel,0,21,60,60
1650280155441,COGS 101B,A01,091572,Staff,4,0,60,56
1650280161468,COGS 101C,A01,083625,Delgado; Tania,19,0,30,11
1650280167503,COGS 107A,A01,083627,Boyle; Mary E. T.,0,8,60,60
1650280173531,COGS 118A,A01,083075,Staff,13,0,60,47
1650280179567,CSE 3,A50,083646,Miranda; Gregory Joseph,21,0,38,17
1650280179567,CSE 3,A51,083647,Miranda; Gregory Joseph,37,0,37,0
1650280185593,CSE 8A,A50,083650,Miranda; Gregory Joseph,0,22,40,40
1650280191622,CSE 11,A01,083080,Cao; Yingjun,0,74,40,40
1650280197646,CSE 12,A01,083652,Staff,0,10,100,100
1650280203674,CSE 15L,A01,083654,Staff,0,1,50,50
1650280203674,CSE 15L,A02,083655,Staff,4,0,50,46
1650280209702,CSE 20,A01,083657,Staff,53,0,80,27
1650280215732,CSE 30,A01,083084,Eldon; John,0,74,40,40
1650280233616,CSE 100,A01,083659,Cao; Yingjun,0,65,50,50
1650280239641,CSE 134B,A01,083661,Powell; Thomas Allan,0,28,65,65
1650280256864,CSE 140,A01,083663,Staff,0,0,75,75
1650280262894,CSE 140L,A01,083088,Eldon; John,0,6,75,75
1650280279997,CSE 175,A01,083665,Kumar; Rakesh,8,0,25,17
1650280286025,CSE 190,A00,092507,Dubnov; Shlomo,14,0,20,6
1650280302810,ECE 45,A01,083139,Staff,0,15,40,40
1650280308839,ECE 65,A50,083695,Staff,0,4,30,30
1650280325887,ECE 109,A01,091882,Touri; Behrouz,43,0,70,27
1650280331911,ECE 180,A00,083140,Abi Samra; Nicholas Camill,24,0,30,6
1650280331911,ECE 180,B00,083141,Abi Samra; Nicholas Camill,7,0,30,23
1650280348562,MATH 10A,A01,083735,Patchell; Gregory David,11,0,30,19
1650280348562,MATH 10A,A02,083736,Patchell; Gregory David,28,0,30,2
1650280348562,MATH 10A,A03,083737,Patchell; Gregory David,26,0,30,4
1650280354590,MATH 10B,A01,083207,Staff,0,6,30,30
1650280354590,MATH 10B,A02,083208,Staff,0,6,30,30
1650280354590,MATH 10B,B01,083739,Staff,17,0,30,13
1650280354590,MATH 10B,B02,083740,Staff,29,0,30,1
1650280371279,MATH 18,A01,083743,Staff,7,0,30,23
1650280371279,MATH 18,A02,083744,Staff,27,0,30,3
1650280371279,MATH 18,A03,083745,Staff,23,0,30,7
1650280371279,MATH 18,A04,083746,Staff,27,0,30,3
1650280371279,MATH 18,B01,083748,Staff,0,11,30,30
1650280371279,MATH 18,B02,083749,Staff,0,9,30,30
1650280371279,MATH 18,B03,083750,Staff,1,8,30,29
1650280371279,MATH 18,B04,083751,Staff,0,9,30,30
1650280377303,MATH 20A,A01,083754,Staff,26,0,40,14
1650280393524,MATH 20B,A01,083756,Staff,0,5,30,30
1650280393524,MATH 20B,A02,083757,Staff,0,7,30,30
1650280399551,MATH 20C,A01,083760,Staff,0,13,30,30
1650280399551,MATH 20C,A02,083761,Staff,0,13,30,30
1650280399551,MATH 20C,B01,083762,Staff,14,0,30,16
1650280399551,MATH 20C,B02,083763,Staff,28,0,30,2
1650280415527,MATH 20D,A01,083765,Staff,0,1,30,30
1650280415527,MATH 20D,A02,083766,Staff,8,0,30,22
1650280415527,MATH 20D,A03,083767,Staff,28,0,30,2
1650280421558,MATH 20E,A01,083771,Staff,6,0,30,24
1650280421558,MATH 20E,A02,083772,Staff,20,0,30,10
1650280421558,MATH 20E,B01,083773,Staff,0,0,30,30
1650280421558,MATH 20E,B02,083774,Staff,11,0,30,19
1650280433712,MATH 103A,A01,083777,Staff,0,10,30,30
1650280433712,MATH 103A,A02,083778,Staff,0,10,30,30
1650280433712,MATH 103A,B01,083779,Staff,0,10,30,30
1650280433712,MATH 103A,B02,083780,Staff,0,10,30,30
1650280439741,MATH 105,A01,085443,Staff,0,17,30,30
1650280445766,MATH 109,A01,083213,Anzaldo; Leesa B,0,5,30,30
1650280445766,MATH 109,A02,083214,Anzaldo; Leesa B,0,6,30,30
1650280445766,MATH 109,B01,083215,Anzaldo; Leesa B,0,4,30,30
1650280445766,MATH 109,B02,083216,Anzaldo; Leesa B,0,3,30,30
1650280451793,MATH 142A,A01,083219,Chow; Bennett,0,12,30,30
1650280451793,MATH 142A,A02,083220,Chow; Bennett,0,11,30,30
1650280451793,MATH 142A,B01,083221,Chow; Bennett,0,11,30,30
1650280451793,MATH 142A,B02,083222,Chow; Bennett,0,12,30,30
1650280457819,MATH 193A,A01,083224,Staff,0,5,30,30
1650280457819,MATH 193A,A02,083225,Staff,0,5,30,30
1650280457819,MATH 193A,A03,083781,Staff,0,2,30,30
1650280457819,MATH 193A,A04,083782,Staff,0,1,30,30
